time,subj_course_id,sec_code,sec_id,prof,available,waitlist,total,enrolled_ct
1649848550353,COGS 9,A01,083615,Staff,46,0,60,14
1649848556387,COGS 11,A01,083617,Boyle; Mary E. T.,36,0,40,4
1649848562423,COGS 13,A01,083071,Staff,21,0,40,19
1649848568451,COGS 14A,A01,092681,Staff,98,0,100,2
1649848574487,COGS 14B,A01,083073,Cheng; Tzu-Han,39,0,50,11
1649848580513,COGS 17,A01,092677,Staff,74,0,75,1
1649848586542,COGS 100,A01,083619,Staff,34,0,60,26
1649848592574,COGS 101A,A01,083621,Davis; Joshua Daniel,34,0,60,26
1649848598604,COGS 101B,A01,091572,Staff,47,0,60,13
1649848604637,COGS 101C,A01,083625,Delgado; Tania,25,0,30,5
1649848610665,COGS 107A,A01,083627,Boyle; Mary E. T.,41,0,60,19
1649848616696,COGS 118A,A01,083075,Staff,34,0,60,26
1649848622726,CSE 3,A50,083646,Miranda; Gregory Joseph,32,0,38,6
1649848622726,CSE 3,A51,083647,Miranda; Gregory Joseph,37,0,37,0
1649848628760,CSE 8A,A50,083650,Miranda; Gregory Joseph,30,0,40,10
1649848634789,CSE 11,A01,083080,Cao; Yingjun,10,0,40,30
1649848640819,CSE 12,A01,083652,Staff,84,0,100,16
1649848646848,CSE 15L,A01,083654,Staff,39,0,50,11
1649848646848,CSE 15L,A02,083655,Staff,49,0,50,1
1649848652881,CSE 20,A01,083657,Staff,73,0,80,7
1649848658917,CSE 30,A01,083084,Eldon; John,15,0,40,25
1649848664950,CSE 100,A01,083659,Cao; Yingjun,15,0,50,35
1649848670988,CSE 134B,A01,083661,Powell; Thomas Allan,0,3,65,65
1649848677018,CSE 140,A01,083663,Staff,56,0,75,19
1649848683044,CSE 140L,A01,083088,Eldon; John,52,0,75,23
1649848689072,CSE 175,A01,083665,Kumar; Rakesh,16,0,25,9
1649848695100,CSE 190,A00,092507,Staff,15,0,15,0
1649848701130,ECE 45,A01,083139,Staff,34,0,40,6
1649848707157,ECE 65,A50,083695,Staff,22,0,30,8
1649848713185,ECE 109,A01,091882,Touri; Behrouz,66,0,70,4
1649848719217,ECE 180,A00,083140,Abi Samra; Nicholas Camill,29,0,30,1
1649848719217,ECE 180,B00,083141,Abi Samra; Nicholas Camill,17,0,30,13
1649848725254,MATH 10A,A01,083735,Patchell; Gregory David,26,0,30,4
1649848725254,MATH 10A,A02,083736,Patchell; Gregory David,30,0,30,0
1649848725254,MATH 10A,A03,083737,Patchell; Gregory David,30,0,30,0
1649848731284,MATH 10B,A01,083207,Staff,21,0,30,9
1649848731284,MATH 10B,A02,083208,Staff,28,0,30,2
1649848731284,MATH 10B,B01,083739,Staff,27,0,30,3
1649848731284,MATH 10B,B02,083740,Staff,30,0,30,0
1649848737313,MATH 18,A01,083743,Staff,26,0,30,4
1649848737313,MATH 18,A02,083744,Staff,30,0,30,0
1649848737313,MATH 18,A03,083745,Staff,30,0,30,0
1649848737313,MATH 18,A04,083746,Staff,30,0,30,0
1649848737313,MATH 18,B01,083748,Staff,24,0,30,6
1649848737313,MATH 18,B02,083749,Staff,29,0,30,1
1649848737313,MATH 18,B03,083750,Staff,30,0,30,0
1649848737313,MATH 18,B04,083751,Staff,29,0,30,1
1649848743341,MATH 20A,A01,083754,Staff,39,0,40,1
1649848749370,MATH 20B,A01,083756,Staff,29,0,30,1
1649848749370,MATH 20B,A02,083757,Staff,30,0,30,0
1649848755404,MATH 20C,A01,083760,Staff,27,0,30,3
1649848755404,MATH 20C,A02,083761,Staff,30,0,30,0
1649848755404,MATH 20C,B01,083762,Staff,30,0,30,0
1649848755404,MATH 20C,B02,083763,Staff,30,0,30,0
1649848761432,MATH 20D,A01,083765,Staff,24,0,30,6
1649848761432,MATH 20D,A02,083766,Staff,30,0,30,0
1649848761432,MATH 20D,A03,083767,Staff,30,0,30,0
1649848767464,MATH 20E,A01,083771,Staff,21,0,30,9
1649848767464,MATH 20E,A02,083772,Staff,29,0,30,1
1649848767464,MATH 20E,B01,083773,Staff,25,0,30,5
1649848767464,MATH 20E,B02,083774,Staff,30,0,30,0
1649848773498,MATH 103A,A01,083777,Staff,5,0,30,25
1649848773498,MATH 103A,A02,083778,Staff,23,0,30,7
1649848773498,MATH 103A,B01,083779,Staff,17,0,30,13
1649848773498,MATH 103A,B02,083780,Staff,27,0,30,3
1649848779529,MATH 105,A01,085443,Staff,15,0,30,15
1649848785560,MATH 109,A01,083213,Anzaldo; Leesa B,28,0,30,2
1649848785560,MATH 109,A02,083214,Anzaldo; Leesa B,24,0,30,6
1649848785560,MATH 109,B01,083215,Anzaldo; Leesa B,28,0,30,2
1649848785560,MATH 109,B02,083216,Anzaldo; Leesa B,26,0,30,4
1649848791594,MATH 142A,A01,083219,Chow; Bennett,11,0,30,19
1649848791594,MATH 142A,A02,083220,Chow; Bennett,28,0,30,2
1649848791594,MATH 142A,B01,083221,Chow; Bennett,16,0,30,14
1649848791594,MATH 142A,B02,083222,Chow; Bennett,27,0,30,3
1649848797622,MATH 193A,A01,083224,Staff,0,0,30,30
1649848797622,MATH 193A,A02,083225,Staff,13,0,30,17
1649848797622,MATH 193A,A03,083781,Staff,28,0,30,2
1649848797622,MATH 193A,A04,083782,Staff,28,0,30,2
1649848803649,MATH 197,001,091859,McAuley; Julian John,9999,0,9999,0
1649848809714,COGS 9,A01,083615,Staff,46,0,60,14
1649848815741,COGS 11,A01,083617,Boyle; Mary E. T.,36,0,40,4
1649848821772,COGS 13,A01,083071,Staff,21,0,40,19
1649848827804,COGS 14A,A01,092681,Staff,98,0,100,2
1649848833832,COGS 14B,A01,083073,Cheng; Tzu-Han,39,0,50,11
1649848839862,COGS 17,A01,092677,Staff,74,0,75,1
1649848845915,COGS 100,A01,083619,Staff,34,0,60,26
1649848851941,COGS 101A,A01,083621,Davis; Joshua Daniel,34,0,60,26
1649848857968,COGS 101B,A01,091572,Staff,47,0,60,13
1649848864001,COGS 101C,A01,083625,Delgado; Tania,25,0,30,5
1649848870032,COGS 107A,A01,083627,Boyle; Mary E. T.,41,0,60,19
1649848876064,COGS 118A,A01,083075,Staff,34,0,60,26
1649848882102,CSE 3,A50,083646,Miranda; Gregory Joseph,32,0,38,6
1649848882102,CSE 3,A51,083647,Miranda; Gregory Joseph,37,0,37,0
1649848888127,CSE 8A,A50,083650,Miranda; Gregory Joseph,30,0,40,10
1649848894154,CSE 11,A01,083080,Cao; Yingjun,10,0,40,30
1649848900181,CSE 12,A01,083652,Staff,84,0,100,16
1649848906206,CSE 15L,A01,083654,Staff,39,0,50,11
1649848906206,CSE 15L,A02,083655,Staff,49,0,50,1
1649848912235,CSE 20,A01,083657,Staff,73,0,80,7
1649848918264,CSE 30,A01,083084,Eldon; John,15,0,40,25
1649848924289,CSE 100,A01,083659,Cao; Yingjun,15,0,50,35
1649848930317,CSE 134B,A01,083661,Powell; Thomas Allan,0,3,65,65
1649848936343,CSE 140,A01,083663,Staff,56,0,75,19
1649848942369,CSE 140L,A01,083088,Eldon; John,52,0,75,23
1649848948398,CSE 175,A01,083665,Kumar; Rakesh,16,0,25,9
1649848954435,CSE 190,A00,092507,Staff,15,0,15,0
1649848960459,ECE 45,A01,083139,Staff,34,0,40,6
1649848966486,ECE 65,A50,083695,Staff,22,0,30,8
1649848972517,ECE 109,A01,091882,Touri; Behrouz,66,0,70,4
1649848978543,ECE 180,A00,083140,Abi Samra; Nicholas Camill,29,0,30,1
1649848978543,ECE 180,B00,083141,Abi Samra; Nicholas Camill,17,0,30,13
1649848984566,MATH 10A,A01,083735,Patchell; Gregory David,26,0,30,4
1649848984566,MATH 10A,A02,083736,Patchell; Gregory David,30,0,30,0
1649848984566,MATH 10A,A03,083737,Patchell; Gregory David,30,0,30,0
1649848990595,MATH 10B,A01,083207,Staff,21,0,30,9
1649848990595,MATH 10B,A02,083208,Staff,28,0,30,2
1649848990595,MATH 10B,B01,083739,Staff,27,0,30,3
1649848990595,MATH 10B,B02,083740,Staff,30,0,30,0
1649848996632,MATH 18,A01,083743,Staff,26,0,30,4
1649848996632,MATH 18,A02,083744,Staff,30,0,30,0
1649848996632,MATH 18,A03,083745,Staff,30,0,30,0
1649848996632,MATH 18,A04,083746,Staff,30,0,30,0
1649848996632,MATH 18,B01,083748,Staff,24,0,30,6
1649848996632,MATH 18,B02,083749,Staff,29,0,30,1
1649848996632,MATH 18,B03,083750,Staff,30,0,30,0
1649848996632,MATH 18,B04,083751,Staff,29,0,30,1
1649849002656,MATH 20A,A01,083754,Staff,39,0,40,1
1649849008688,MATH 20B,A01,083756,Staff,29,0,30,1
1649849008688,MATH 20B,A02,083757,Staff,30,0,30,0
1649849014715,MATH 20C,A01,083760,Staff,27,0,30,3
1649849014715,MATH 20C,A02,083761,Staff,30,0,30,0
1649849014715,MATH 20C,B01,083762,Staff,30,0,30,0
1649849014715,MATH 20C,B02,083763,Staff,30,0,30,0
1649849020747,MATH 20D,A01,083765,Staff,24,0,30,6
1649849020747,MATH 20D,A02,083766,Staff,30,0,30,0
1649849020747,MATH 20D,A03,083767,Staff,30,0,30,0
1649849026781,MATH 20E,A01,083771,Staff,21,0,30,9
1649849026781,MATH 20E,A02,083772,Staff,29,0,30,1
1649849026781,MATH 20E,B01,083773,Staff,25,0,30,5
1649849026781,MATH 20E,B02,083774,Staff,30,0,30,0
1649849032815,MATH 103A,A01,083777,Staff,5,0,30,25
1649849032815,MATH 103A,A02,083778,Staff,23,0,30,7
1649849032815,MATH 103A,B01,083779,Staff,17,0,30,13
1649849032815,MATH 103A,B02,083780,Staff,27,0,30,3
1649849038842,MATH 105,A01,085443,Staff,15,0,30,15
1649849044874,MATH 109,A01,083213,Anzaldo; Leesa B,28,0,30,2
1649849044874,MATH 109,A02,083214,Anzaldo; Leesa B,24,0,30,6
1649849044874,MATH 109,B01,083215,Anzaldo; Leesa B,28,0,30,2
1649849044874,MATH 109,B02,083216,Anzaldo; Leesa B,26,0,30,4
1649849050903,MATH 142A,A01,083219,Chow; Bennett,11,0,30,19
1649849050903,MATH 142A,A02,083220,Chow; Bennett,28,0,30,2
1649849050903,MATH 142A,B01,083221,Chow; Bennett,16,0,30,14
1649849050903,MATH 142A,B02,083222,Chow; Bennett,27,0,30,3
1649849056931,MATH 193A,A01,083224,Staff,0,0,30,30
1649849056931,MATH 193A,A02,083225,Staff,13,0,30,17
1649849056931,MATH 193A,A03,083781,Staff,28,0,30,2
1649849056931,MATH 193A,A04,083782,Staff,28,0,30,2
1649849062957,MATH 197,001,091859,McAuley; Julian John,9999,0,9999,0
1649849069033,COGS 9,A01,083615,Staff,46,0,60,14
1649849075065,COGS 11,A01,083617,Boyle; Mary E. T.,36,0,40,4
1649849081093,COGS 13,A01,083071,Staff,21,0,40,19
1649849087119,COGS 14A,A01,092681,Staff,98,0,100,2
1649849093151,COGS 14B,A01,083073,Cheng; Tzu-Han,39,0,50,11
1649849099187,COGS 17,A01,092677,Staff,74,0,75,1
1649849105216,COGS 100,A01,083619,Staff,34,0,60,26
1649849111241,COGS 101A,A01,083621,Davis; Joshua Daniel,34,0,60,26
1649849117268,COGS 101B,A01,091572,Staff,47,0,60,13
1649849123383,COGS 101C,A01,083625,Delgado; Tania,25,0,30,5
1649849129414,COGS 107A,A01,083627,Boyle; Mary E. T.,41,0,60,19
1649849135440,COGS 118A,A01,083075,Staff,34,0,60,26
1649849141481,CSE 3,A50,083646,Miranda; Gregory Joseph,32,0,38,6
1649849141481,CSE 3,A51,083647,Miranda; Gregory Joseph,37,0,37,0
1649849147509,CSE 8A,A50,083650,Miranda; Gregory Joseph,30,0,40,10
1649849153539,CSE 11,A01,083080,Cao; Yingjun,10,0,40,30
1649849159566,CSE 12,A01,083652,Staff,84,0,100,16
1649849165593,CSE 15L,A01,083654,Staff,39,0,50,11
1649849165593,CSE 15L,A02,083655,Staff,49,0,50,1
1649849171620,CSE 20,A01,083657,Staff,73,0,80,7
1649849177647,CSE 30,A01,083084,Eldon; John,15,0,40,25
1649849183681,CSE 100,A01,083659,Cao; Yingjun,15,0,50,35
1649849189712,CSE 134B,A01,083661,Powell; Thomas Allan,0,3,65,65
1649849195739,CSE 140,A01,083663,Staff,56,0,75,19
1649849201765,CSE 140L,A01,083088,Eldon; John,52,0,75,23
1649849207797,CSE 175,A01,083665,Kumar; Rakesh,16,0,25,9
1649849213834,CSE 190,A00,092507,Staff,15,0,15,0
1649849219862,ECE 45,A01,083139,Staff,34,0,40,6
1649849225888,ECE 65,A50,083695,Staff,22,0,30,8
1649849231914,ECE 109,A01,091882,Touri; Behrouz,66,0,70,4
1649849237943,ECE 180,A00,083140,Abi Samra; Nicholas Camill,29,0,30,1
1649849237943,ECE 180,B00,083141,Abi Samra; Nicholas Camill,17,0,30,13
1649849243972,MATH 10A,A01,083735,Patchell; Gregory David,26,0,30,4
1649849243972,MATH 10A,A02,083736,Patchell; Gregory David,30,0,30,0
1649849243972,MATH 10A,A03,083737,Patchell; Gregory David,30,0,30,0
1649849250003,MATH 10B,A01,083207,Staff,21,0,30,9
1649849250003,MATH 10B,A02,083208,Staff,28,0,30,2
1649849250003,MATH 10B,B01,083739,Staff,27,0,30,3
1649849250003,MATH 10B,B02,083740,Staff,30,0,30,0
1649849256031,MATH 18,A01,083743,Staff,26,0,30,4
1649849256031,MATH 18,A02,083744,Staff,30,0,30,0
1649849256031,MATH 18,A03,083745,Staff,30,0,30,0
1649849256031,MATH 18,A04,083746,Staff,30,0,30,0
1649849256031,MATH 18,B01,083748,Staff,24,0,30,6
1649849256031,MATH 18,B02,083749,Staff,29,0,30,1
1649849256031,MATH 18,B03,083750,Staff,30,0,30,0
1649849256031,MATH 18,B04,083751,Staff,29,0,30,1
1649849262058,MATH 20A,A01,083754,Staff,39,0,40,1
1649849268086,MATH 20B,A01,083756,Staff,29,0,30,1
1649849268086,MATH 20B,A02,083757,Staff,30,0,30,0
1649849274117,MATH 20C,A01,083760,Staff,27,0,30,3
1649849274117,MATH 20C,A02,083761,Staff,30,0,30,0
1649849274117,MATH 20C,B01,083762,Staff,30,0,30,0
1649849274117,MATH 20C,B02,083763,Staff,30,0,30,0
1649849280145,MATH 20D,A01,083765,Staff,24,0,30,6
1649849280145,MATH 20D,A02,083766,Staff,30,0,30,0
1649849280145,MATH 20D,A03,083767,Staff,30,0,30,0
1649849286178,MATH 20E,A01,083771,Staff,21,0,30,9
1649849286178,MATH 20E,A02,083772,Staff,29,0,30,1
1649849286178,MATH 20E,B01,083773,Staff,25,0,30,5
1649849286178,MATH 20E,B02,083774,Staff,30,0,30,0
1649849292206,MATH 103A,A01,083777,Staff,5,0,30,25
1649849292206,MATH 103A,A02,083778,Staff,23,0,30,7
1649849292206,MATH 103A,B01,083779,Staff,17,0,30,13
1649849292206,MATH 103A,B02,083780,Staff,27,0,30,3
1649849298230,MATH 105,A01,085443,Staff,15,0,30,15
1649849304261,MATH 109,A01,083213,Anzaldo; Leesa B,28,0,30,2
1649849304261,MATH 109,A02,083214,Anzaldo; Leesa B,24,0,30,6
1649849304261,MATH 109,B01,083215,Anzaldo; Leesa B,28,0,30,2
1649849304261,MATH 109,B02,083216,Anzaldo; Leesa B,26,0,30,4
1649849310288,MATH 142A,A01,083219,Chow; Bennett,11,0,30,19
1649849310288,MATH 142A,A02,083220,Chow; Bennett,28,0,30,2
1649849310288,MATH 142A,B01,083221,Chow; Bennett,16,0,30,14
1649849310288,MATH 142A,B02,083222,Chow; Bennett,27,0,30,3
1649849316328,MATH 193A,A01,083224,Staff,0,0,30,30
1649849316328,MATH 193A,A02,083225,Staff,13,0,30,17
1649849316328,MATH 193A,A03,083781,Staff,28,0,30,2
1649849316328,MATH 193A,A04,083782,Staff,28,0,30,2
1649849322359,MATH 197,001,091859,McAuley; Julian John,9999,0,9999,0
1649849328435,COGS 9,A01,083615,Staff,46,0,60,14
1649849334459,COGS 11,A01,083617,Boyle; Mary E. T.,36,0,40,4
1649849340487,COGS 13,A01,083071,Staff,21,0,40,19
1649849346512,COGS 14A,A01,092681,Staff,98,0,100,2
1649849352538,COGS 14B,A01,083073,Cheng; Tzu-Han,39,0,50,11
1649849358567,COGS 17,A01,092677,Staff,74,0,75,1
1649849364599,COGS 100,A01,083619,Staff,34,0,60,26
1649849370631,COGS 101A,A01,083621,Davis; Joshua Daniel,34,0,60,26
1649849376665,COGS 101B,A01,091572,Staff,47,0,60,13
1649849382695,COGS 101C,A01,083625,Delgado; Tania,25,0,30,5
1649849388753,COGS 107A,A01,083627,Boyle; Mary E. T.,41,0,60,19
1649849394777,COGS 118A,A01,083075,Staff,34,0,60,26
1649849400806,CSE 3,A50,083646,Miranda; Gregory Joseph,32,0,38,6
1649849400806,CSE 3,A51,083647,Miranda; Gregory Joseph,37,0,37,0
1649849406832,CSE 8A,A50,083650,Miranda; Gregory Joseph,30,0,40,10
1649849412859,CSE 11,A01,083080,Cao; Yingjun,10,0,40,30
1649849418889,CSE 12,A01,083652,Staff,84,0,100,16
1649849424914,CSE 15L,A01,083654,Staff,39,0,50,11
1649849424914,CSE 15L,A02,083655,Staff,49,0,50,1
1649849430939,CSE 20,A01,083657,Staff,73,0,80,7
1649849436968,CSE 30,A01,083084,Eldon; John,15,0,40,25
1649849442991,CSE 100,A01,083659,Cao; Yingjun,15,0,50,35
1649849449018,CSE 134B,A01,083661,Powell; Thomas Allan,0,3,65,65
1649849455042,CSE 140,A01,083663,Staff,55,0,75,20
1649849461067,CSE 140L,A01,083088,Eldon; John,51,0,75,24
1649849467098,CSE 175,A01,083665,Kumar; Rakesh,16,0,25,9
1649849473128,CSE 190,A00,092507,Staff,15,0,15,0
1649849479154,ECE 45,A01,083139,Staff,34,0,40,6
1649849485185,ECE 65,A50,083695,Staff,22,0,30,8
1649849491210,ECE 109,A01,091882,Touri; Behrouz,66,0,70,4
1649849497240,ECE 180,A00,083140,Abi Samra; Nicholas Camill,29,0,30,1
1649849497240,ECE 180,B00,083141,Abi Samra; Nicholas Camill,17,0,30,13
1649849503267,MATH 10A,A01,083735,Patchell; Gregory David,26,0,30,4
1649849503267,MATH 10A,A02,083736,Patchell; Gregory David,30,0,30,0
1649849503267,MATH 10A,A03,083737,Patchell; Gregory David,30,0,30,0
1649849509296,MATH 10B,A01,083207,Staff,21,0,30,9
1649849509296,MATH 10B,A02,083208,Staff,28,0,30,2
1649849509296,MATH 10B,B01,083739,Staff,27,0,30,3
1649849509296,MATH 10B,B02,083740,Staff,30,0,30,0
1649849515335,MATH 18,A01,083743,Staff,26,0,30,4
1649849515335,MATH 18,A02,083744,Staff,30,0,30,0
1649849515335,MATH 18,A03,083745,Staff,30,0,30,0
1649849515335,MATH 18,A04,083746,Staff,30,0,30,0
1649849515335,MATH 18,B01,083748,Staff,24,0,30,6
1649849515335,MATH 18,B02,083749,Staff,29,0,30,1
1649849515335,MATH 18,B03,083750,Staff,30,0,30,0
1649849515335,MATH 18,B04,083751,Staff,29,0,30,1
1649849521358,MATH 20A,A01,083754,Staff,39,0,40,1
1649849527384,MATH 20B,A01,083756,Staff,29,0,30,1
1649849527384,MATH 20B,A02,083757,Staff,30,0,30,0
1649849533408,MATH 20C,A01,083760,Staff,27,0,30,3
1649849533408,MATH 20C,A02,083761,Staff,30,0,30,0
1649849533408,MATH 20C,B01,083762,Staff,30,0,30,0
1649849533408,MATH 20C,B02,083763,Staff,30,0,30,0
1649849539439,MATH 20D,A01,083765,Staff,24,0,30,6
1649849539439,MATH 20D,A02,083766,Staff,30,0,30,0
1649849539439,MATH 20D,A03,083767,Staff,30,0,30,0
1649849545468,MATH 20E,A01,083771,Staff,21,0,30,9
1649849545468,MATH 20E,A02,083772,Staff,29,0,30,1
1649849545468,MATH 20E,B01,083773,Staff,25,0,30,5
1649849545468,MATH 20E,B02,083774,Staff,30,0,30,0
1649849551493,MATH 103A,A01,083777,Staff,5,0,30,25
1649849551493,MATH 103A,A02,083778,Staff,23,0,30,7
1649849551493,MATH 103A,B01,083779,Staff,17,0,30,13
1649849551493,MATH 103A,B02,083780,Staff,27,0,30,3
1649849557523,MATH 105,A01,085443,Staff,15,0,30,15
1649849563555,MATH 109,A01,083213,Anzaldo; Leesa B,28,0,30,2
1649849563555,MATH 109,A02,083214,Anzaldo; Leesa B,24,0,30,6
1649849563555,MATH 109,B01,083215,Anzaldo; Leesa B,28,0,30,2
1649849563555,MATH 109,B02,083216,Anzaldo; Leesa B,26,0,30,4
1649849569583,MATH 142A,A01,083219,Chow; Bennett,11,0,30,19
1649849569583,MATH 142A,A02,083220,Chow; Bennett,28,0,30,2
1649849569583,MATH 142A,B01,083221,Chow; Bennett,16,0,30,14
1649849569583,MATH 142A,B02,083222,Chow; Bennett,27,0,30,3
1649849575615,MATH 193A,A01,083224,Staff,0,0,30,30
1649849575615,MATH 193A,A02,083225,Staff,13,0,30,17
1649849575615,MATH 193A,A03,083781,Staff,28,0,30,2
1649849575615,MATH 193A,A04,083782,Staff,28,0,30,2
1649849581641,MATH 197,001,091859,McAuley; Julian John,9999,0,9999,0
1649849587701,COGS 9,A01,083615,Staff,46,0,60,14
1649849593726,COGS 11,A01,083617,Boyle; Mary E. T.,36,0,40,4
1649849599751,COGS 13,A01,083071,Staff,21,0,40,19
1649849605778,COGS 14A,A01,092681,Staff,98,0,100,2
1649849611810,COGS 14B,A01,083073,Cheng; Tzu-Han,39,0,50,11
1649849617836,COGS 17,A01,092677,Staff,74,0,75,1
1649849623864,COGS 100,A01,083619,Staff,34,0,60,26
1649849629891,COGS 101A,A01,083621,Davis; Joshua Daniel,34,0,60,26
1649849635920,COGS 101B,A01,091572,Staff,47,0,60,13
1649849641950,COGS 101C,A01,083625,Delgado; Tania,25,0,30,5
1649849647980,COGS 107A,A01,083627,Boyle; Mary E. T.,41,0,60,19
1649849654006,COGS 118A,A01,083075,Staff,34,0,60,26
1649849660034,CSE 3,A50,083646,Miranda; Gregory Joseph,32,0,38,6
1649849660034,CSE 3,A51,083647,Miranda; Gregory Joseph,37,0,37,0
1649849666068,CSE 8A,A50,083650,Miranda; Gregory Joseph,30,0,40,10
1649849672092,CSE 11,A01,083080,Cao; Yingjun,10,0,40,30
1649849678116,CSE 12,A01,083652,Staff,84,0,100,16
1649849684143,CSE 15L,A01,083654,Staff,39,0,50,11
1649849684143,CSE 15L,A02,083655,Staff,49,0,50,1
1649849690172,CSE 20,A01,083657,Staff,73,0,80,7
1649849696199,CSE 30,A01,083084,Eldon; John,15,0,40,25
1649849702224,CSE 100,A01,083659,Cao; Yingjun,15,0,50,35
1649849708256,CSE 134B,A01,083661,Powell; Thomas Allan,0,3,65,65
1649849714288,CSE 140,A01,083663,Staff,55,0,75,20
1649849720403,CSE 140L,A01,083088,Eldon; John,51,0,75,24
1649849726428,CSE 175,A01,083665,Kumar; Rakesh,16,0,25,9
1649849732454,CSE 190,A00,092507,Staff,15,0,15,0
1649849738480,ECE 45,A01,083139,Staff,34,0,40,6
1649849744507,ECE 65,A50,083695,Staff,22,0,30,8
1649849750532,ECE 109,A01,091882,Touri; Behrouz,66,0,70,4
1649849756557,ECE 180,A00,083140,Abi Samra; Nicholas Camill,29,0,30,1
1649849756557,ECE 180,B00,083141,Abi Samra; Nicholas Camill,17,0,30,13
1649849762592,MATH 10A,A01,083735,Patchell; Gregory David,26,0,30,4
1649849762592,MATH 10A,A02,083736,Patchell; Gregory David,30,0,30,0
1649849762592,MATH 10A,A03,083737,Patchell; Gregory David,30,0,30,0
1649849768623,MATH 10B,A01,083207,Staff,21,0,30,9
1649849768623,MATH 10B,A02,083208,Staff,28,0,30,2
1649849768623,MATH 10B,B01,083739,Staff,27,0,30,3
1649849768623,MATH 10B,B02,083740,Staff,30,0,30,0
1649849774659,MATH 18,A01,083743,Staff,26,0,30,4
1649849774659,MATH 18,A02,083744,Staff,30,0,30,0
1649849774659,MATH 18,A03,083745,Staff,30,0,30,0
1649849774659,MATH 18,A04,083746,Staff,30,0,30,0
1649849774659,MATH 18,B01,083748,Staff,24,0,30,6
1649849774659,MATH 18,B02,083749,Staff,29,0,30,1
1649849774659,MATH 18,B03,083750,Staff,30,0,30,0
1649849774659,MATH 18,B04,083751,Staff,29,0,30,1
1649849780688,MATH 20A,A01,083754,Staff,39,0,40,1
1649849786718,MATH 20B,A01,083756,Staff,29,0,30,1
1649849786718,MATH 20B,A02,083757,Staff,30,0,30,0
1649849792745,MATH 20C,A01,083760,Staff,27,0,30,3
1649849792745,MATH 20C,A02,083761,Staff,30,0,30,0
1649849792745,MATH 20C,B01,083762,Staff,30,0,30,0
1649849792745,MATH 20C,B02,083763,Staff,30,0,30,0
1649849798773,MATH 20D,A01,083765,Staff,24,0,30,6
1649849798773,MATH 20D,A02,083766,Staff,30,0,30,0
1649849798773,MATH 20D,A03,083767,Staff,30,0,30,0
1649849804806,MATH 20E,A01,083771,Staff,21,0,30,9
1649849804806,MATH 20E,A02,083772,Staff,29,0,30,1
1649849804806,MATH 20E,B01,083773,Staff,25,0,30,5
1649849804806,MATH 20E,B02,083774,Staff,30,0,30,0
1649849810833,MATH 103A,A01,083777,Staff,5,0,30,25
1649849810833,MATH 103A,A02,083778,Staff,23,0,30,7
1649849810833,MATH 103A,B01,083779,Staff,17,0,30,13
1649849810833,MATH 103A,B02,083780,Staff,27,0,30,3
1649849816857,MATH 105,A01,085443,Staff,15,0,30,15
1649849822894,MATH 109,A01,083213,Anzaldo; Leesa B,28,0,30,2
1649849822894,MATH 109,A02,083214,Anzaldo; Leesa B,24,0,30,6
1649849822894,MATH 109,B01,083215,Anzaldo; Leesa B,28,0,30,2
1649849822894,MATH 109,B02,083216,Anzaldo; Leesa B,26,0,30,4
1649849840019,MATH 142A,A01,083219,Chow; Bennett,11,0,30,19
1649849840019,MATH 142A,A02,083220,Chow; Bennett,28,0,30,2
1649849840019,MATH 142A,B01,083221,Chow; Bennett,16,0,30,14
1649849840019,MATH 142A,B02,083222,Chow; Bennett,27,0,30,3
1649849846131,MATH 193A,A01,083224,Staff,0,0,30,30
1649849846131,MATH 193A,A02,083225,Staff,13,0,30,17
1649849846131,MATH 193A,A03,083781,Staff,28,0,30,2
1649849846131,MATH 193A,A04,083782,Staff,28,0,30,2
1649849862013,MATH 197,001,091859,McAuley; Julian John,9999,0,9999,0
1649849868097,COGS 9,A01,083615,Staff,46,0,60,14
1649849883804,COGS 11,A01,083617,Boyle; Mary E. T.,36,0,40,4
1649849889840,COGS 13,A01,083071,Staff,21,0,40,19
1649849906193,COGS 14A,A01,092681,Staff,98,0,100,2
1649849912223,COGS 14B,A01,083073,Cheng; Tzu-Han,39,0,50,11
1649849928899,COGS 17,A01,092677,Staff,74,0,75,1
1649849934926,COGS 100,A01,083619,Staff,34,0,60,26
1649849951150,COGS 101A,A01,083621,Davis; Joshua Daniel,34,0,60,26
1649849957186,COGS 101B,A01,091572,Staff,47,0,60,13
1649849970650,COGS 101C,A01,083625,Delgado; Tania,25,0,30,5
1649849976678,COGS 107A,A01,083627,Boyle; Mary E. T.,41,0,60,19
1649849982710,COGS 118A,A01,083075,Staff,34,0,60,26
1649849988750,CSE 3,A50,083646,Miranda; Gregory Joseph,32,0,38,6
1649849988750,CSE 3,A51,083647,Miranda; Gregory Joseph,37,0,37,0
1649849994785,CSE 8A,A50,083650,Miranda; Gregory Joseph,30,0,40,10
1649850000822,CSE 11,A01,083080,Cao; Yingjun,10,0,40,30
1649850006850,CSE 12,A01,083652,Staff,84,0,100,16
1649850012884,CSE 15L,A01,083654,Staff,39,0,50,11
1649850012884,CSE 15L,A02,083655,Staff,49,0,50,1
1649850018911,CSE 20,A01,083657,Staff,73,0,80,7
1649850024943,CSE 30,A01,083084,Eldon; John,15,0,40,25
1649850030976,CSE 100,A01,083659,Cao; Yingjun,15,0,50,35
1649850037005,CSE 134B,A01,083661,Powell; Thomas Allan,0,3,65,65
1649850043031,CSE 140,A01,083663,Staff,55,0,75,20
1649850049061,CSE 140L,A01,083088,Eldon; John,51,0,75,24
1649850055094,CSE 175,A01,083665,Kumar; Rakesh,16,0,25,9
1649850061125,CSE 190,A00,092507,Staff,15,0,15,0
1649850067150,ECE 45,A01,083139,Staff,34,0,40,6
1649850073178,ECE 65,A50,083695,Staff,22,0,30,8
1649850079204,ECE 109,A01,091882,Touri; Behrouz,66,0,70,4
1649850085234,ECE 180,A00,083140,Abi Samra; Nicholas Camill,29,0,30,1
1649850085234,ECE 180,B00,083141,Abi Samra; Nicholas Camill,17,0,30,13
1649850091267,MATH 10A,A01,083735,Patchell; Gregory David,26,0,30,4
1649850091267,MATH 10A,A02,083736,Patchell; Gregory David,30,0,30,0
1649850091267,MATH 10A,A03,083737,Patchell; Gregory David,30,0,30,0
1649850097299,MATH 10B,A01,083207,Staff,21,0,30,9
1649850097299,MATH 10B,A02,083208,Staff,28,0,30,2
1649850097299,MATH 10B,B01,083739,Staff,27,0,30,3
1649850097299,MATH 10B,B02,083740,Staff,30,0,30,0
1649850103334,MATH 18,A01,083743,Staff,26,0,30,4
1649850103334,MATH 18,A02,083744,Staff,30,0,30,0
1649850103334,MATH 18,A03,083745,Staff,30,0,30,0
1649850103334,MATH 18,A04,083746,Staff,30,0,30,0
1649850103334,MATH 18,B01,083748,Staff,24,0,30,6
1649850103334,MATH 18,B02,083749,Staff,29,0,30,1
1649850103334,MATH 18,B03,083750,Staff,30,0,30,0
1649850103334,MATH 18,B04,083751,Staff,29,0,30,1
1649850109357,MATH 20A,A01,083754,Staff,39,0,40,1
1649850115386,MATH 20B,A01,083756,Staff,29,0,30,1
1649850115386,MATH 20B,A02,083757,Staff,30,0,30,0
1649850121417,MATH 20C,A01,083760,Staff,27,0,30,3
1649850121417,MATH 20C,A02,083761,Staff,30,0,30,0
1649850121417,MATH 20C,B01,083762,Staff,30,0,30,0
1649850121417,MATH 20C,B02,083763,Staff,30,0,30,0
1649850127447,MATH 20D,A01,083765,Staff,24,0,30,6
1649850127447,MATH 20D,A02,083766,Staff,30,0,30,0
1649850127447,MATH 20D,A03,083767,Staff,30,0,30,0
1649850133481,MATH 20E,A01,083771,Staff,21,0,30,9
1649850133481,MATH 20E,A02,083772,Staff,29,0,30,1
1649850133481,MATH 20E,B01,083773,Staff,25,0,30,5
1649850133481,MATH 20E,B02,083774,Staff,30,0,30,0
1649850139517,MATH 103A,A01,083777,Staff,5,0,30,25
1649850139517,MATH 103A,A02,083778,Staff,23,0,30,7
1649850139517,MATH 103A,B01,083779,Staff,17,0,30,13
1649850139517,MATH 103A,B02,083780,Staff,27,0,30,3
1649850145548,MATH 105,A01,085443,Staff,15,0,30,15
1649850151575,MATH 109,A01,083213,Anzaldo; Leesa B,28,0,30,2
1649850151575,MATH 109,A02,083214,Anzaldo; Leesa B,24,0,30,6
1649850151575,MATH 109,B01,083215,Anzaldo; Leesa B,28,0,30,2
1649850151575,MATH 109,B02,083216,Anzaldo; Leesa B,26,0,30,4
1649850157604,MATH 142A,A01,083219,Chow; Bennett,11,0,30,19
1649850157604,MATH 142A,A02,083220,Chow; Bennett,28,0,30,2
1649850157604,MATH 142A,B01,083221,Chow; Bennett,16,0,30,14
1649850157604,MATH 142A,B02,083222,Chow; Bennett,27,0,30,3
1649850163634,MATH 193A,A01,083224,Staff,0,0,30,30
1649850163634,MATH 193A,A02,083225,Staff,13,0,30,17
1649850163634,MATH 193A,A03,083781,Staff,28,0,30,2
1649850163634,MATH 193A,A04,083782,Staff,28,0,30,2
1649850169663,MATH 197,001,091859,McAuley; Julian John,9999,0,9999,0
1649850175744,COGS 9,A01,083615,Staff,46,0,60,14
1649850181773,COGS 11,A01,083617,Boyle; Mary E. T.,36,0,40,4
1649850187802,COGS 13,A01,083071,Staff,21,0,40,19
1649850193832,COGS 14A,A01,092681,Staff,98,0,100,2
1649850199859,COGS 14B,A01,083073,Cheng; Tzu-Han,39,0,50,11
1649850205886,COGS 17,A01,092677,Staff,74,0,75,1
1649850211917,COGS 100,A01,083619,Staff,34,0,60,26
1649850217948,COGS 101A,A01,083621,Davis; Joshua Daniel,34,0,60,26
1649850223973,COGS 101B,A01,091572,Staff,47,0,60,13
1649850230006,COGS 101C,A01,083625,Delgado; Tania,25,0,30,5
1649850236036,COGS 107A,A01,083627,Boyle; Mary E. T.,41,0,60,19
1649850242063,COGS 118A,A01,083075,Staff,34,0,60,26
1649850248102,CSE 3,A50,083646,Miranda; Gregory Joseph,32,0,38,6
1649850248102,CSE 3,A51,083647,Miranda; Gregory Joseph,37,0,37,0
1649850254131,CSE 8A,A50,083650,Miranda; Gregory Joseph,30,0,40,10
1649850260164,CSE 11,A01,083080,Cao; Yingjun,10,0,40,30
1649850266189,CSE 12,A01,083652,Staff,84,0,100,16
1649850272219,CSE 15L,A01,083654,Staff,39,0,50,11
1649850272219,CSE 15L,A02,083655,Staff,49,0,50,1
1649850278246,CSE 20,A01,083657,Staff,73,0,80,7
1649850284272,CSE 30,A01,083084,Eldon; John,15,0,40,25
1649850290299,CSE 100,A01,083659,Cao; Yingjun,15,0,50,35
1649850296337,CSE 134B,A01,083661,Powell; Thomas Allan,0,3,65,65
1649850302364,CSE 140,A01,083663,Staff,55,0,75,20
1649850308394,CSE 140L,A01,083088,Eldon; John,51,0,75,24
1649850314422,CSE 175,A01,083665,Kumar; Rakesh,16,0,25,9
1649850320450,CSE 190,A00,092507,Staff,15,0,15,0
1649850326479,ECE 45,A01,083139,Staff,34,0,40,6
1649850332508,ECE 65,A50,083695,Staff,22,0,30,8
1649850338537,ECE 109,A01,091882,Touri; Behrouz,66,0,70,4
1649850344570,ECE 180,A00,083140,Abi Samra; Nicholas Camill,29,0,30,1
1649850344570,ECE 180,B00,083141,Abi Samra; Nicholas Camill,17,0,30,13
1649850350606,MATH 10A,A01,083735,Patchell; Gregory David,26,0,30,4
1649850350606,MATH 10A,A02,083736,Patchell; Gregory David,30,0,30,0
1649850350606,MATH 10A,A03,083737,Patchell; Gregory David,30,0,30,0
1649850356638,MATH 10B,A01,083207,Staff,21,0,30,9
1649850356638,MATH 10B,A02,083208,Staff,28,0,30,2
1649850356638,MATH 10B,B01,083739,Staff,27,0,30,3
1649850356638,MATH 10B,B02,083740,Staff,30,0,30,0
1649850362669,MATH 18,A01,083743,Staff,26,0,30,4
1649850362669,MATH 18,A02,083744,Staff,30,0,30,0
1649850362669,MATH 18,A03,083745,Staff,30,0,30,0
1649850362669,MATH 18,A04,083746,Staff,30,0,30,0
1649850362669,MATH 18,B01,083748,Staff,24,0,30,6
1649850362669,MATH 18,B02,083749,Staff,29,0,30,1
1649850362669,MATH 18,B03,083750,Staff,30,0,30,0
1649850362669,MATH 18,B04,083751,Staff,29,0,30,1
1649850368703,MATH 20A,A01,083754,Staff,39,0,40,1
1649850374733,MATH 20B,A01,083756,Staff,29,0,30,1
1649850374733,MATH 20B,A02,083757,Staff,30,0,30,0
1649850380761,MATH 20C,A01,083760,Staff,27,0,30,3
1649850380761,MATH 20C,A02,083761,Staff,30,0,30,0
1649850380761,MATH 20C,B01,083762,Staff,30,0,30,0
1649850380761,MATH 20C,B02,083763,Staff,30,0,30,0
1649850399029,MATH 20D,A01,083765,Staff,24,0,30,6
1649850399029,MATH 20D,A02,083766,Staff,30,0,30,0
1649850399029,MATH 20D,A03,083767,Staff,30,0,30,0
1649850405072,MATH 20E,A01,083771,Staff,21,0,30,9
1649850405072,MATH 20E,A02,083772,Staff,29,0,30,1
1649850405072,MATH 20E,B01,083773,Staff,25,0,30,5
1649850405072,MATH 20E,B02,083774,Staff,30,0,30,0
1649850415883,MATH 103A,A01,083777,Staff,5,0,30,25
1649850415883,MATH 103A,A02,083778,Staff,23,0,30,7
1649850415883,MATH 103A,B01,083779,Staff,17,0,30,13
1649850415883,MATH 103A,B02,083780,Staff,27,0,30,3
1649850421910,MATH 105,A01,085443,Staff,15,0,30,15
1649850427944,MATH 109,A01,083213,Anzaldo; Leesa B,28,0,30,2
1649850427944,MATH 109,A02,083214,Anzaldo; Leesa B,24,0,30,6
1649850427944,MATH 109,B01,083215,Anzaldo; Leesa B,28,0,30,2
1649850427944,MATH 109,B02,083216,Anzaldo; Leesa B,26,0,30,4
1649850433973,MATH 142A,A01,083219,Chow; Bennett,11,0,30,19
1649850433973,MATH 142A,A02,083220,Chow; Bennett,28,0,30,2
1649850433973,MATH 142A,B01,083221,Chow; Bennett,16,0,30,14
1649850433973,MATH 142A,B02,083222,Chow; Bennett,27,0,30,3
1649850440001,MATH 193A,A01,083224,Staff,0,0,30,30
1649850440001,MATH 193A,A02,083225,Staff,13,0,30,17
1649850440001,MATH 193A,A03,083781,Staff,28,0,30,2
1649850440001,MATH 193A,A04,083782,Staff,28,0,30,2
1649850446030,MATH 197,001,091859,McAuley; Julian John,9999,0,9999,0
1649850452091,COGS 9,A01,083615,Staff,46,0,60,14
1649850458118,COGS 11,A01,083617,Boyle; Mary E. T.,36,0,40,4
1649850464149,COGS 13,A01,083071,Staff,21,0,40,19
1649850470181,COGS 14A,A01,092681,Staff,98,0,100,2
1649850476208,COGS 14B,A01,083073,Cheng; Tzu-Han,39,0,50,11
1649850482235,COGS 17,A01,092677,Staff,74,0,75,1
1649850488265,COGS 100,A01,083619,Staff,34,0,60,26
1649850494296,COGS 101A,A01,083621,Davis; Joshua Daniel,34,0,60,26
1649850500323,COGS 101B,A01,091572,Staff,47,0,60,13
1649850506354,COGS 101C,A01,083625,Delgado; Tania,25,0,30,5
1649850512382,COGS 107A,A01,083627,Boyle; Mary E. T.,41,0,60,19
1649850518408,COGS 118A,A01,083075,Staff,34,0,60,26
1649850524441,CSE 3,A50,083646,Miranda; Gregory Joseph,32,0,38,6
1649850524441,CSE 3,A51,083647,Miranda; Gregory Joseph,37,0,37,0
1649850530470,CSE 8A,A50,083650,Miranda; Gregory Joseph,30,0,40,10
1649850536497,CSE 11,A01,083080,Cao; Yingjun,10,0,40,30
1649850542524,CSE 12,A01,083652,Staff,84,0,100,16
1649850548554,CSE 15L,A01,083654,Staff,39,0,50,11
1649850548554,CSE 15L,A02,083655,Staff,49,0,50,1
1649850554581,CSE 20,A01,083657,Staff,73,0,80,7
1649850560608,CSE 30,A01,083084,Eldon; John,15,0,40,25
1649850566636,CSE 100,A01,083659,Cao; Yingjun,15,0,50,35
1649850572661,CSE 134B,A01,083661,Powell; Thomas Allan,0,3,65,65
1649850578691,CSE 140,A01,083663,Staff,55,0,75,20
1649850584718,CSE 140L,A01,083088,Eldon; John,51,0,75,24
1649850590751,CSE 175,A01,083665,Kumar; Rakesh,16,0,25,9
1649850596781,CSE 190,A00,092507,Staff,15,0,15,0
1649850602809,ECE 45,A01,083139,Staff,34,0,40,6
1649850608843,ECE 65,A50,083695,Staff,22,0,30,8
1649850614874,ECE 109,A01,091882,Touri; Behrouz,66,0,70,4
1649850620902,ECE 180,A00,083140,Abi Samra; Nicholas Camill,29,0,30,1
1649850620902,ECE 180,B00,083141,Abi Samra; Nicholas Camill,17,0,30,13
1649850626940,MATH 10A,A01,083735,Patchell; Gregory David,26,0,30,4
1649850626940,MATH 10A,A02,083736,Patchell; Gregory David,30,0,30,0
1649850626940,MATH 10A,A03,083737,Patchell; Gregory David,30,0,30,0
1649850632973,MATH 10B,A01,083207,Staff,21,0,30,9
1649850632973,MATH 10B,A02,083208,Staff,28,0,30,2
1649850632973,MATH 10B,B01,083739,Staff,27,0,30,3
1649850632973,MATH 10B,B02,083740,Staff,30,0,30,0
1649850639004,MATH 18,A01,083743,Staff,26,0,30,4
1649850639004,MATH 18,A02,083744,Staff,30,0,30,0
1649850639004,MATH 18,A03,083745,Staff,30,0,30,0
1649850639004,MATH 18,A04,083746,Staff,30,0,30,0
1649850639004,MATH 18,B01,083748,Staff,24,0,30,6
1649850639004,MATH 18,B02,083749,Staff,29,0,30,1
1649850639004,MATH 18,B03,083750,Staff,30,0,30,0
1649850639004,MATH 18,B04,083751,Staff,29,0,30,1
1649850645029,MATH 20A,A01,083754,Staff,39,0,40,1
1649850651056,MATH 20B,A01,083756,Staff,29,0,30,1
1649850651056,MATH 20B,A02,083757,Staff,30,0,30,0
1649850657084,MATH 20C,A01,083760,Staff,27,0,30,3
1649850657084,MATH 20C,A02,083761,Staff,30,0,30,0
1649850657084,MATH 20C,B01,083762,Staff,30,0,30,0
1649850657084,MATH 20C,B02,083763,Staff,30,0,30,0
1649850663115,MATH 20D,A01,083765,Staff,24,0,30,6
1649850663115,MATH 20D,A02,083766,Staff,30,0,30,0
1649850663115,MATH 20D,A03,083767,Staff,30,0,30,0
1649850669144,MATH 20E,A01,083771,Staff,21,0,30,9
1649850669144,MATH 20E,A02,083772,Staff,29,0,30,1
1649850669144,MATH 20E,B01,083773,Staff,25,0,30,5
1649850669144,MATH 20E,B02,083774,Staff,30,0,30,0
1649850675169,MATH 103A,A01,083777,Staff,5,0,30,25
1649850675169,MATH 103A,A02,083778,Staff,23,0,30,7
1649850675169,MATH 103A,B01,083779,Staff,17,0,30,13
1649850675169,MATH 103A,B02,083780,Staff,27,0,30,3
1649850681198,MATH 105,A01,085443,Staff,15,0,30,15
1649850687225,MATH 109,A01,083213,Anzaldo; Leesa B,28,0,30,2
1649850687225,MATH 109,A02,083214,Anzaldo; Leesa B,24,0,30,6
1649850687225,MATH 109,B01,083215,Anzaldo; Leesa B,28,0,30,2
1649850687225,MATH 109,B02,083216,Anzaldo; Leesa B,26,0,30,4
1649850693252,MATH 142A,A01,083219,Chow; Bennett,11,0,30,19
1649850693252,MATH 142A,A02,083220,Chow; Bennett,28,0,30,2
1649850693252,MATH 142A,B01,083221,Chow; Bennett,16,0,30,14
1649850693252,MATH 142A,B02,083222,Chow; Bennett,27,0,30,3
1649850699278,MATH 193A,A01,083224,Staff,0,0,30,30
1649850699278,MATH 193A,A02,083225,Staff,13,0,30,17
1649850699278,MATH 193A,A03,083781,Staff,28,0,30,2
1649850699278,MATH 193A,A04,083782,Staff,28,0,30,2
1649850705308,MATH 197,001,091859,McAuley; Julian John,9999,0,9999,0
1649850711374,COGS 9,A01,083615,Staff,46,0,60,14
1649850717401,COGS 11,A01,083617,Boyle; Mary E. T.,36,0,40,4
1649850723434,COGS 13,A01,083071,Staff,21,0,40,19
1649850729463,COGS 14A,A01,092681,Staff,98,0,100,2
1649850735494,COGS 14B,A01,083073,Cheng; Tzu-Han,39,0,50,11
1649850741520,COGS 17,A01,092677,Staff,74,0,75,1
1649850747553,COGS 100,A01,083619,Staff,34,0,60,26
1649850753586,COGS 101A,A01,083621,Davis; Joshua Daniel,34,0,60,26
1649850759614,COGS 101B,A01,091572,Staff,47,0,60,13
1649850765646,COGS 101C,A01,083625,Delgado; Tania,25,0,30,5
1649850771673,COGS 107A,A01,083627,Boyle; Mary E. T.,41,0,60,19
1649850777703,COGS 118A,A01,083075,Staff,34,0,60,26
1649850783732,CSE 3,A50,083646,Miranda; Gregory Joseph,32,0,38,6
1649850783732,CSE 3,A51,083647,Miranda; Gregory Joseph,37,0,37,0
1649850789761,CSE 8A,A50,083650,Miranda; Gregory Joseph,30,0,40,10
1649850795789,CSE 11,A01,083080,Cao; Yingjun,10,0,40,30
1649850801815,CSE 12,A01,083652,Staff,84,0,100,16
1649850807839,CSE 15L,A01,083654,Staff,39,0,50,11
1649850807839,CSE 15L,A02,083655,Staff,49,0,50,1
1649850813870,CSE 20,A01,083657,Staff,73,0,80,7
1649850819894,CSE 30,A01,083084,Eldon; John,15,0,40,25
1649850825921,CSE 100,A01,083659,Cao; Yingjun,15,0,50,35
1649850831953,CSE 134B,A01,083661,Powell; Thomas Allan,0,3,65,65
1649850837980,CSE 140,A01,083663,Staff,55,0,75,20
1649850844006,CSE 140L,A01,083088,Eldon; John,51,0,75,24
1649850850031,CSE 175,A01,083665,Kumar; Rakesh,16,0,25,9
1649850856064,CSE 190,A00,092507,Staff,15,0,15,0
1649850862092,ECE 45,A01,083139,Staff,34,0,40,6
1649850868122,ECE 65,A50,083695,Staff,22,0,30,8
1649850874151,ECE 109,A01,091882,Touri; Behrouz,66,0,70,4
1649850880181,ECE 180,A00,083140,Abi Samra; Nicholas Camill,29,0,30,1
1649850880181,ECE 180,B00,083141,Abi Samra; Nicholas Camill,17,0,30,13
1649850886207,MATH 10A,A01,083735,Patchell; Gregory David,26,0,30,4
1649850886207,MATH 10A,A02,083736,Patchell; Gregory David,30,0,30,0
1649850886207,MATH 10A,A03,083737,Patchell; Gregory David,30,0,30,0
1649850892239,MATH 10B,A01,083207,Staff,21,0,30,9
1649850892239,MATH 10B,A02,083208,Staff,28,0,30,2
1649850892239,MATH 10B,B01,083739,Staff,27,0,30,3
1649850892239,MATH 10B,B02,083740,Staff,30,0,30,0
1649850898282,MATH 18,A01,083743,Staff,26,0,30,4
1649850898282,MATH 18,A02,083744,Staff,30,0,30,0
1649850898282,MATH 18,A03,083745,Staff,30,0,30,0
1649850898282,MATH 18,A04,083746,Staff,30,0,30,0
1649850898282,MATH 18,B01,083748,Staff,24,0,30,6
1649850898282,MATH 18,B02,083749,Staff,29,0,30,1
1649850898282,MATH 18,B03,083750,Staff,30,0,30,0
1649850898282,MATH 18,B04,083751,Staff,29,0,30,1
1649850904307,MATH 20A,A01,083754,Staff,39,0,40,1
1649850910334,MATH 20B,A01,083756,Staff,29,0,30,1
1649850910334,MATH 20B,A02,083757,Staff,30,0,30,0
1649850916363,MATH 20C,A01,083760,Staff,27,0,30,3
1649850916363,MATH 20C,A02,083761,Staff,30,0,30,0
1649850916363,MATH 20C,B01,083762,Staff,30,0,30,0
1649850916363,MATH 20C,B02,083763,Staff,30,0,30,0
1649850922390,MATH 20D,A01,083765,Staff,24,0,30,6
1649850922390,MATH 20D,A02,083766,Staff,30,0,30,0
1649850922390,MATH 20D,A03,083767,Staff,30,0,30,0
1649850928415,MATH 20E,A01,083771,Staff,21,0,30,9
1649850928415,MATH 20E,A02,083772,Staff,29,0,30,1
1649850928415,MATH 20E,B01,083773,Staff,25,0,30,5
1649850928415,MATH 20E,B02,083774,Staff,30,0,30,0
1649850934448,MATH 103A,A01,083777,Staff,5,0,30,25
1649850934448,MATH 103A,A02,083778,Staff,23,0,30,7
1649850934448,MATH 103A,B01,083779,Staff,17,0,30,13
1649850934448,MATH 103A,B02,083780,Staff,27,0,30,3
1649850940478,MATH 105,A01,085443,Staff,15,0,30,15
1649850946504,MATH 109,A01,083213,Anzaldo; Leesa B,28,0,30,2
1649850946504,MATH 109,A02,083214,Anzaldo; Leesa B,24,0,30,6
1649850946504,MATH 109,B01,083215,Anzaldo; Leesa B,28,0,30,2
1649850946504,MATH 109,B02,083216,Anzaldo; Leesa B,26,0,30,4
1649850952532,MATH 142A,A01,083219,Chow; Bennett,11,0,30,19
1649850952532,MATH 142A,A02,083220,Chow; Bennett,28,0,30,2
1649850952532,MATH 142A,B01,083221,Chow; Bennett,16,0,30,14
1649850952532,MATH 142A,B02,083222,Chow; Bennett,27,0,30,3
1649850958559,MATH 193A,A01,083224,Staff,0,0,30,30
1649850958559,MATH 193A,A02,083225,Staff,13,0,30,17
1649850958559,MATH 193A,A03,083781,Staff,28,0,30,2
1649850958559,MATH 193A,A04,083782,Staff,28,0,30,2
1649850964584,MATH 197,001,091859,McAuley; Julian John,9999,0,9999,0
1649850970658,COGS 9,A01,083615,Staff,46,0,60,14
1649850976684,COGS 11,A01,083617,Boyle; Mary E. T.,36,0,40,4
1649850982739,COGS 13,A01,083071,Staff,21,0,40,19
1649850988770,COGS 14A,A01,092681,Staff,98,0,100,2
1649850994882,COGS 14B,A01,083073,Cheng; Tzu-Han,39,0,50,11
1649851000908,COGS 17,A01,092677,Staff,74,0,75,1
1649851006933,COGS 100,A01,083619,Staff,34,0,60,26
1649851012963,COGS 101A,A01,083621,Davis; Joshua Daniel,34,0,60,26
1649851018989,COGS 101B,A01,091572,Staff,47,0,60,13
1649851025016,COGS 101C,A01,083625,Delgado; Tania,25,0,30,5
1649851031042,COGS 107A,A01,083627,Boyle; Mary E. T.,41,0,60,19
1649851037068,COGS 118A,A01,083075,Staff,34,0,60,26
1649851043095,CSE 3,A50,083646,Miranda; Gregory Joseph,32,0,38,6
1649851043095,CSE 3,A51,083647,Miranda; Gregory Joseph,37,0,37,0
1649851049122,CSE 8A,A50,083650,Miranda; Gregory Joseph,30,0,40,10
1649851055156,CSE 11,A01,083080,Cao; Yingjun,10,0,40,30
1649851061179,CSE 12,A01,083652,Staff,84,0,100,16
1649851067209,CSE 15L,A01,083654,Staff,39,0,50,11
1649851067209,CSE 15L,A02,083655,Staff,49,0,50,1
1649851073234,CSE 20,A01,083657,Staff,73,0,80,7
1649851079267,CSE 30,A01,083084,Eldon; John,15,0,40,25
1649851085294,CSE 100,A01,083659,Cao; Yingjun,15,0,50,35
1649851091319,CSE 134B,A01,083661,Powell; Thomas Allan,0,3,65,65
1649851097344,CSE 140,A01,083663,Staff,55,0,75,20
1649851103369,CSE 140L,A01,083088,Eldon; John,51,0,75,24
1649851109394,CSE 175,A01,083665,Kumar; Rakesh,16,0,25,9
1649851115425,CSE 190,A00,092507,Staff,15,0,15,0
1649851121453,ECE 45,A01,083139,Staff,34,0,40,6
1649851127483,ECE 65,A50,083695,Staff,22,0,30,8
1649851133513,ECE 109,A01,091882,Touri; Behrouz,66,0,70,4
1649851139544,ECE 180,A00,083140,Abi Samra; Nicholas Camill,29,0,30,1
1649851139544,ECE 180,B00,083141,Abi Samra; Nicholas Camill,17,0,30,13
1649851145573,MATH 10A,A01,083735,Patchell; Gregory David,26,0,30,4
1649851145573,MATH 10A,A02,083736,Patchell; Gregory David,30,0,30,0
1649851145573,MATH 10A,A03,083737,Patchell; Gregory David,30,0,30,0
1649851151599,MATH 10B,A01,083207,Staff,21,0,30,9
1649851151599,MATH 10B,A02,083208,Staff,28,0,30,2
1649851151599,MATH 10B,B01,083739,Staff,27,0,30,3
1649851151599,MATH 10B,B02,083740,Staff,30,0,30,0
1649851157628,MATH 18,A01,083743,Staff,26,0,30,4
1649851157628,MATH 18,A02,083744,Staff,30,0,30,0
1649851157628,MATH 18,A03,083745,Staff,30,0,30,0
1649851157628,MATH 18,A04,083746,Staff,30,0,30,0
1649851157628,MATH 18,B01,083748,Staff,24,0,30,6
1649851157628,MATH 18,B02,083749,Staff,29,0,30,1
1649851157628,MATH 18,B03,083750,Staff,30,0,30,0
1649851157628,MATH 18,B04,083751,Staff,29,0,30,1
1649851163663,MATH 20A,A01,083754,Staff,39,0,40,1
1649851169696,MATH 20B,A01,083756,Staff,29,0,30,1
1649851169696,MATH 20B,A02,083757,Staff,30,0,30,0
1649851175729,MATH 20C,A01,083760,Staff,27,0,30,3
1649851175729,MATH 20C,A02,083761,Staff,30,0,30,0
1649851175729,MATH 20C,B01,083762,Staff,30,0,30,0
1649851175729,MATH 20C,B02,083763,Staff,30,0,30,0
1649851181756,MATH 20D,A01,083765,Staff,24,0,30,6
1649851181756,MATH 20D,A02,083766,Staff,30,0,30,0
1649851181756,MATH 20D,A03,083767,Staff,30,0,30,0
1649851187783,MATH 20E,A01,083771,Staff,21,0,30,9
1649851187783,MATH 20E,A02,083772,Staff,29,0,30,1
1649851187783,MATH 20E,B01,083773,Staff,25,0,30,5
1649851187783,MATH 20E,B02,083774,Staff,30,0,30,0
1649851193812,MATH 103A,A01,083777,Staff,5,0,30,25
1649851193812,MATH 103A,A02,083778,Staff,23,0,30,7
1649851193812,MATH 103A,B01,083779,Staff,17,0,30,13
1649851193812,MATH 103A,B02,083780,Staff,27,0,30,3
1649851199841,MATH 105,A01,085443,Staff,15,0,30,15
1649851205871,MATH 109,A01,083213,Anzaldo; Leesa B,28,0,30,2
1649851205871,MATH 109,A02,083214,Anzaldo; Leesa B,24,0,30,6
1649851205871,MATH 109,B01,083215,Anzaldo; Leesa B,28,0,30,2
1649851205871,MATH 109,B02,083216,Anzaldo; Leesa B,26,0,30,4
1649851211896,MATH 142A,A01,083219,Chow; Bennett,11,0,30,19
1649851211896,MATH 142A,A02,083220,Chow; Bennett,28,0,30,2
1649851211896,MATH 142A,B01,083221,Chow; Bennett,16,0,30,14
1649851211896,MATH 142A,B02,083222,Chow; Bennett,27,0,30,3
1649851217924,MATH 193A,A01,083224,Staff,0,0,30,30
1649851217924,MATH 193A,A02,083225,Staff,13,0,30,17
1649851217924,MATH 193A,A03,083781,Staff,28,0,30,2
1649851217924,MATH 193A,A04,083782,Staff,28,0,30,2
1649851223949,MATH 197,001,091859,McAuley; Julian John,9999,0,9999,0
1649851230035,COGS 9,A01,083615,Staff,46,0,60,14
1649851236062,COGS 11,A01,083617,Boyle; Mary E. T.,36,0,40,4
1649851242099,COGS 13,A01,083071,Staff,21,0,40,19
1649851248127,COGS 14A,A01,092681,Staff,98,0,100,2
1649851254155,COGS 14B,A01,083073,Cheng; Tzu-Han,39,0,50,11
1649851260183,COGS 17,A01,092677,Staff,74,0,75,1
1649851266211,COGS 100,A01,083619,Staff,34,0,60,26
1649851272237,COGS 101A,A01,083621,Davis; Joshua Daniel,34,0,60,26
1649851278265,COGS 101B,A01,091572,Staff,47,0,60,13
1649851284297,COGS 101C,A01,083625,Delgado; Tania,25,0,30,5
1649851290323,COGS 107A,A01,083627,Boyle; Mary E. T.,41,0,60,19
1649851296348,COGS 118A,A01,083075,Staff,34,0,60,26
1649851302373,CSE 3,A50,083646,Miranda; Gregory Joseph,32,0,38,6
1649851302373,CSE 3,A51,083647,Miranda; Gregory Joseph,37,0,37,0
1649851308400,CSE 8A,A50,083650,Miranda; Gregory Joseph,30,0,40,10
1649851314424,CSE 11,A01,083080,Cao; Yingjun,10,0,40,30
1649851320451,CSE 12,A01,083652,Staff,84,0,100,16
1649851326475,CSE 15L,A01,083654,Staff,39,0,50,11
1649851326475,CSE 15L,A02,083655,Staff,49,0,50,1
1649851332505,CSE 20,A01,083657,Staff,73,0,80,7
1649851338535,CSE 30,A01,083084,Eldon; John,15,0,40,25
1649851344560,CSE 100,A01,083659,Cao; Yingjun,15,0,50,35
1649851350589,CSE 134B,A01,083661,Powell; Thomas Allan,0,3,65,65
1649851356620,CSE 140,A01,083663,Staff,55,0,75,20
1649851362655,CSE 140L,A01,083088,Eldon; John,51,0,75,24
1649851368678,CSE 175,A01,083665,Kumar; Rakesh,16,0,25,9
1649851374707,CSE 190,A00,092507,Staff,15,0,15,0
1649851380737,ECE 45,A01,083139,Staff,34,0,40,6
1649851386767,ECE 65,A50,083695,Staff,22,0,30,8
1649851392792,ECE 109,A01,091882,Touri; Behrouz,66,0,70,4
1649851398820,ECE 180,A00,083140,Abi Samra; Nicholas Camill,29,0,30,1
1649851398820,ECE 180,B00,083141,Abi Samra; Nicholas Camill,17,0,30,13
1649851404849,MATH 10A,A01,083735,Patchell; Gregory David,26,0,30,4
1649851404849,MATH 10A,A02,083736,Patchell; Gregory David,30,0,30,0
1649851404849,MATH 10A,A03,083737,Patchell; Gregory David,30,0,30,0
1649851410875,MATH 10B,A01,083207,Staff,21,0,30,9
1649851410875,MATH 10B,A02,083208,Staff,28,0,30,2
1649851410875,MATH 10B,B01,083739,Staff,27,0,30,3
1649851410875,MATH 10B,B02,083740,Staff,30,0,30,0
1649851416903,MATH 18,A01,083743,Staff,26,0,30,4
1649851416903,MATH 18,A02,083744,Staff,30,0,30,0
1649851416903,MATH 18,A03,083745,Staff,30,0,30,0
1649851416903,MATH 18,A04,083746,Staff,30,0,30,0
1649851416903,MATH 18,B01,083748,Staff,24,0,30,6
1649851416903,MATH 18,B02,083749,Staff,29,0,30,1
1649851416903,MATH 18,B03,083750,Staff,30,0,30,0
1649851416903,MATH 18,B04,083751,Staff,29,0,30,1
1649851422927,MATH 20A,A01,083754,Staff,39,0,40,1
1649851428959,MATH 20B,A01,083756,Staff,29,0,30,1
1649851428959,MATH 20B,A02,083757,Staff,30,0,30,0
1649851434985,MATH 20C,A01,083760,Staff,27,0,30,3
1649851434985,MATH 20C,A02,083761,Staff,30,0,30,0
1649851434985,MATH 20C,B01,083762,Staff,30,0,30,0
1649851434985,MATH 20C,B02,083763,Staff,30,0,30,0
1649851441012,MATH 20D,A01,083765,Staff,24,0,30,6
1649851441012,MATH 20D,A02,083766,Staff,30,0,30,0
1649851441012,MATH 20D,A03,083767,Staff,30,0,30,0
1649851447040,MATH 20E,A01,083771,Staff,21,0,30,9
1649851447040,MATH 20E,A02,083772,Staff,29,0,30,1
1649851447040,MATH 20E,B01,083773,Staff,25,0,30,5
1649851447040,MATH 20E,B02,083774,Staff,30,0,30,0
1649851453066,MATH 103A,A01,083777,Staff,5,0,30,25
1649851453066,MATH 103A,A02,083778,Staff,23,0,30,7
1649851453066,MATH 103A,B01,083779,Staff,17,0,30,13
1649851453066,MATH 103A,B02,083780,Staff,27,0,30,3
1649851459092,MATH 105,A01,085443,Staff,15,0,30,15
1649851465124,MATH 109,A01,083213,Anzaldo; Leesa B,28,0,30,2
1649851465124,MATH 109,A02,083214,Anzaldo; Leesa B,24,0,30,6
1649851465124,MATH 109,B01,083215,Anzaldo; Leesa B,28,0,30,2
1649851465124,MATH 109,B02,083216,Anzaldo; Leesa B,26,0,30,4
1649851471149,MATH 142A,A01,083219,Chow; Bennett,11,0,30,19
1649851471149,MATH 142A,A02,083220,Chow; Bennett,28,0,30,2
1649851471149,MATH 142A,B01,083221,Chow; Bennett,16,0,30,14
1649851471149,MATH 142A,B02,083222,Chow; Bennett,27,0,30,3
1649851477180,MATH 193A,A01,083224,Staff,0,0,30,30
1649851477180,MATH 193A,A02,083225,Staff,13,0,30,17
1649851477180,MATH 193A,A03,083781,Staff,28,0,30,2
1649851477180,MATH 193A,A04,083782,Staff,28,0,30,2
1649851483206,MATH 197,001,091859,McAuley; Julian John,9999,0,9999,0
1649851489272,COGS 9,A01,083615,Staff,46,0,60,14
1649851495298,COGS 11,A01,083617,Boyle; Mary E. T.,36,0,40,4
1649851501334,COGS 13,A01,083071,Staff,21,0,40,19
1649851507360,COGS 14A,A01,092681,Staff,98,0,100,2
1649851513385,COGS 14B,A01,083073,Cheng; Tzu-Han,39,0,50,11
1649851519420,COGS 17,A01,092677,Staff,74,0,75,1
1649851525451,COGS 100,A01,083619,Staff,34,0,60,26
1649851531490,COGS 101A,A01,083621,Davis; Joshua Daniel,34,0,60,26
1649851537514,COGS 101B,A01,091572,Staff,47,0,60,13
1649851543546,COGS 101C,A01,083625,Delgado; Tania,25,0,30,5
1649851549576,COGS 107A,A01,083627,Boyle; Mary E. T.,41,0,60,19
1649851555605,COGS 118A,A01,083075,Staff,34,0,60,26
1649851561631,CSE 3,A50,083646,Miranda; Gregory Joseph,32,0,38,6
1649851561631,CSE 3,A51,083647,Miranda; Gregory Joseph,37,0,37,0
1649851567657,CSE 8A,A50,083650,Miranda; Gregory Joseph,30,0,40,10
1649851573683,CSE 11,A01,083080,Cao; Yingjun,10,0,40,30
1649851579707,CSE 12,A01,083652,Staff,84,0,100,16
1649851585734,CSE 15L,A01,083654,Staff,39,0,50,11
1649851585734,CSE 15L,A02,083655,Staff,49,0,50,1
1649851591835,CSE 20,A01,083657,Staff,73,0,80,7
1649851597860,CSE 30,A01,083084,Eldon; John,15,0,40,25
1649851603899,CSE 100,A01,083659,Cao; Yingjun,15,0,50,35
1649851609930,CSE 134B,A01,083661,Powell; Thomas Allan,0,3,65,65
1649851615954,CSE 140,A01,083663,Staff,55,0,75,20
1649851621979,CSE 140L,A01,083088,Eldon; John,51,0,75,24
1649851628005,CSE 175,A01,083665,Kumar; Rakesh,16,0,25,9
1649851634037,CSE 190,A00,092507,Staff,15,0,15,0
1649851640068,ECE 45,A01,083139,Staff,34,0,40,6
1649851646093,ECE 65,A50,083695,Staff,22,0,30,8
1649851652119,ECE 109,A01,091882,Touri; Behrouz,66,0,70,4
1649851658151,ECE 180,A00,083140,Abi Samra; Nicholas Camill,29,0,30,1
1649851658151,ECE 180,B00,083141,Abi Samra; Nicholas Camill,17,0,30,13
1649851664184,MATH 10A,A01,083735,Patchell; Gregory David,26,0,30,4
1649851664184,MATH 10A,A02,083736,Patchell; Gregory David,30,0,30,0
1649851664184,MATH 10A,A03,083737,Patchell; Gregory David,30,0,30,0
1649851670217,MATH 10B,A01,083207,Staff,21,0,30,9
1649851670217,MATH 10B,A02,083208,Staff,28,0,30,2
1649851670217,MATH 10B,B01,083739,Staff,27,0,30,3
1649851670217,MATH 10B,B02,083740,Staff,30,0,30,0
1649851676251,MATH 18,A01,083743,Staff,26,0,30,4
1649851676251,MATH 18,A02,083744,Staff,30,0,30,0
1649851676251,MATH 18,A03,083745,Staff,30,0,30,0
1649851676251,MATH 18,A04,083746,Staff,30,0,30,0
1649851676251,MATH 18,B01,083748,Staff,24,0,30,6
1649851676251,MATH 18,B02,083749,Staff,29,0,30,1
1649851676251,MATH 18,B03,083750,Staff,30,0,30,0
1649851676251,MATH 18,B04,083751,Staff,29,0,30,1
1649851682279,MATH 20A,A01,083754,Staff,39,0,40,1
1649851688309,MATH 20B,A01,083756,Staff,29,0,30,1
1649851688309,MATH 20B,A02,083757,Staff,30,0,30,0
1649851694344,MATH 20C,A01,083760,Staff,27,0,30,3
1649851694344,MATH 20C,A02,083761,Staff,30,0,30,0
1649851694344,MATH 20C,B01,083762,Staff,30,0,30,0
1649851694344,MATH 20C,B02,083763,Staff,30,0,30,0
1649851700366,MATH 20D,A01,083765,Staff,24,0,30,6
1649851700366,MATH 20D,A02,083766,Staff,30,0,30,0
1649851700366,MATH 20D,A03,083767,Staff,30,0,30,0
1649851706395,MATH 20E,A01,083771,Staff,21,0,30,9
1649851706395,MATH 20E,A02,083772,Staff,29,0,30,1
1649851706395,MATH 20E,B01,083773,Staff,25,0,30,5
1649851706395,MATH 20E,B02,083774,Staff,30,0,30,0
1649851712419,MATH 103A,A01,083777,Staff,5,0,30,25
1649851712419,MATH 103A,A02,083778,Staff,23,0,30,7
1649851712419,MATH 103A,B01,083779,Staff,17,0,30,13
1649851712419,MATH 103A,B02,083780,Staff,27,0,30,3
1649851718442,MATH 105,A01,085443,Staff,15,0,30,15
1649851724468,MATH 109,A01,083213,Anzaldo; Leesa B,28,0,30,2
1649851724468,MATH 109,A02,083214,Anzaldo; Leesa B,24,0,30,6
1649851724468,MATH 109,B01,083215,Anzaldo; Leesa B,28,0,30,2
1649851724468,MATH 109,B02,083216,Anzaldo; Leesa B,26,0,30,4
1649851730507,MATH 142A,A01,083219,Chow; Bennett,11,0,30,19
1649851730507,MATH 142A,A02,083220,Chow; Bennett,28,0,30,2
1649851730507,MATH 142A,B01,083221,Chow; Bennett,16,0,30,14
1649851730507,MATH 142A,B02,083222,Chow; Bennett,27,0,30,3
1649851736530,MATH 193A,A01,083224,Staff,0,0,30,30
1649851736530,MATH 193A,A02,083225,Staff,13,0,30,17
1649851736530,MATH 193A,A03,083781,Staff,28,0,30,2
1649851736530,MATH 193A,A04,083782,Staff,28,0,30,2
1649851742555,MATH 197,001,091859,McAuley; Julian John,9999,0,9999,0
1649851748628,COGS 9,A01,083615,Staff,46,0,60,14
1649851754658,COGS 11,A01,083617,Boyle; Mary E. T.,36,0,40,4
1649851760685,COGS 13,A01,083071,Staff,21,0,40,19
1649851766712,COGS 14A,A01,092681,Staff,98,0,100,2
1649851772742,COGS 14B,A01,083073,Cheng; Tzu-Han,39,0,50,11
1649851778766,COGS 17,A01,092677,Staff,74,0,75,1
1649851784791,COGS 100,A01,083619,Staff,34,0,60,26
1649851790818,COGS 101A,A01,083621,Davis; Joshua Daniel,34,0,60,26
1649851796843,COGS 101B,A01,091572,Staff,47,0,60,13
1649851802869,COGS 101C,A01,083625,Delgado; Tania,25,0,30,5
1649851808894,COGS 107A,A01,083627,Boyle; Mary E. T.,41,0,60,19
1649851814918,COGS 118A,A01,083075,Staff,34,0,60,26
1649851820945,CSE 3,A50,083646,Miranda; Gregory Joseph,32,0,38,6
1649851820945,CSE 3,A51,083647,Miranda; Gregory Joseph,37,0,37,0
1649851826970,CSE 8A,A50,083650,Miranda; Gregory Joseph,30,0,40,10
1649851832996,CSE 11,A01,083080,Cao; Yingjun,10,0,40,30
1649851839034,CSE 12,A01,083652,Staff,84,0,100,16
1649851845059,CSE 15L,A01,083654,Staff,39,0,50,11
1649851845059,CSE 15L,A02,083655,Staff,49,0,50,1
1649851851088,CSE 20,A01,083657,Staff,73,0,80,7
1649851857115,CSE 30,A01,083084,Eldon; John,15,0,40,25
1649851863144,CSE 100,A01,083659,Cao; Yingjun,15,0,50,35
1649851869170,CSE 134B,A01,083661,Powell; Thomas Allan,0,3,65,65
1649851875195,CSE 140,A01,083663,Staff,55,0,75,20
1649851881225,CSE 140L,A01,083088,Eldon; John,51,0,75,24
1649851887261,CSE 175,A01,083665,Kumar; Rakesh,16,0,25,9
1649851893290,CSE 190,A00,092507,Staff,15,0,15,0
1649851899316,ECE 45,A01,083139,Staff,34,0,40,6
1649851905343,ECE 65,A50,083695,Staff,22,0,30,8
1649851911388,ECE 109,A01,091882,Touri; Behrouz,66,0,70,4
1649851917418,ECE 180,A00,083140,Abi Samra; Nicholas Camill,29,0,30,1
1649851917418,ECE 180,B00,083141,Abi Samra; Nicholas Camill,17,0,30,13
1649851923445,MATH 10A,A01,083735,Patchell; Gregory David,26,0,30,4
1649851923445,MATH 10A,A02,083736,Patchell; Gregory David,30,0,30,0
1649851923445,MATH 10A,A03,083737,Patchell; Gregory David,30,0,30,0
1649851929475,MATH 10B,A01,083207,Staff,21,0,30,9
1649851929475,MATH 10B,A02,083208,Staff,28,0,30,2
1649851929475,MATH 10B,B01,083739,Staff,27,0,30,3
1649851929475,MATH 10B,B02,083740,Staff,30,0,30,0
1649851935510,MATH 18,A01,083743,Staff,26,0,30,4
1649851935510,MATH 18,A02,083744,Staff,30,0,30,0
1649851935510,MATH 18,A03,083745,Staff,30,0,30,0
1649851935510,MATH 18,A04,083746,Staff,30,0,30,0
1649851935510,MATH 18,B01,083748,Staff,24,0,30,6
1649851935510,MATH 18,B02,083749,Staff,29,0,30,1
1649851935510,MATH 18,B03,083750,Staff,30,0,30,0
1649851935510,MATH 18,B04,083751,Staff,29,0,30,1
1649851941539,MATH 20A,A01,083754,Staff,39,0,40,1
1649851947564,MATH 20B,A01,083756,Staff,29,0,30,1
1649851947564,MATH 20B,A02,083757,Staff,30,0,30,0
1649851953589,MATH 20C,A01,083760,Staff,27,0,30,3
1649851953589,MATH 20C,A02,083761,Staff,30,0,30,0
1649851953589,MATH 20C,B01,083762,Staff,30,0,30,0
1649851953589,MATH 20C,B02,083763,Staff,30,0,30,0
1649851959618,MATH 20D,A01,083765,Staff,24,0,30,6
1649851959618,MATH 20D,A02,083766,Staff,30,0,30,0
1649851959618,MATH 20D,A03,083767,Staff,30,0,30,0
1649851965645,MATH 20E,A01,083771,Staff,21,0,30,9
1649851965645,MATH 20E,A02,083772,Staff,29,0,30,1
1649851965645,MATH 20E,B01,083773,Staff,25,0,30,5
1649851965645,MATH 20E,B02,083774,Staff,30,0,30,0
1649851971675,MATH 103A,A01,083777,Staff,5,0,30,25
1649851971675,MATH 103A,A02,083778,Staff,23,0,30,7
1649851971675,MATH 103A,B01,083779,Staff,17,0,30,13
1649851971675,MATH 103A,B02,083780,Staff,27,0,30,3
1649851977701,MATH 105,A01,085443,Staff,15,0,30,15
1649851983732,MATH 109,A01,083213,Anzaldo; Leesa B,28,0,30,2
1649851983732,MATH 109,A02,083214,Anzaldo; Leesa B,24,0,30,6
1649851983732,MATH 109,B01,083215,Anzaldo; Leesa B,28,0,30,2
1649851983732,MATH 109,B02,083216,Anzaldo; Leesa B,26,0,30,4
1649851989760,MATH 142A,A01,083219,Chow; Bennett,11,0,30,19
1649851989760,MATH 142A,A02,083220,Chow; Bennett,28,0,30,2
1649851989760,MATH 142A,B01,083221,Chow; Bennett,16,0,30,14
1649851989760,MATH 142A,B02,083222,Chow; Bennett,27,0,30,3
1649851995785,MATH 193A,A01,083224,Staff,0,0,30,30
1649851995785,MATH 193A,A02,083225,Staff,13,0,30,17
1649851995785,MATH 193A,A03,083781,Staff,28,0,30,2
1649851995785,MATH 193A,A04,083782,Staff,28,0,30,2
1649852001809,MATH 197,001,091859,McAuley; Julian John,9999,0,9999,0
1649852007877,COGS 9,A01,083615,Staff,46,0,60,14
1649852013913,COGS 11,A01,083617,Boyle; Mary E. T.,36,0,40,4
1649852019939,COGS 13,A01,083071,Staff,21,0,40,19
1649852025971,COGS 14A,A01,092681,Staff,98,0,100,2
1649852031997,COGS 14B,A01,083073,Cheng; Tzu-Han,39,0,50,11
1649852038025,COGS 17,A01,092677,Staff,74,0,75,1
1649852044056,COGS 100,A01,083619,Staff,34,0,60,26
1649852050084,COGS 101A,A01,083621,Davis; Joshua Daniel,34,0,60,26
1649852056115,COGS 101B,A01,091572,Staff,47,0,60,13
1649852062141,COGS 101C,A01,083625,Delgado; Tania,25,0,30,5
1649852068165,COGS 107A,A01,083627,Boyle; Mary E. T.,41,0,60,19
1649852074191,COGS 118A,A01,083075,Staff,34,0,60,26
1649852080216,CSE 3,A50,083646,Miranda; Gregory Joseph,32,0,38,6
1649852080216,CSE 3,A51,083647,Miranda; Gregory Joseph,37,0,37,0
1649852086247,CSE 8A,A50,083650,Miranda; Gregory Joseph,30,0,40,10
1649852092275,CSE 11,A01,083080,Cao; Yingjun,10,0,40,30
1649852098315,CSE 12,A01,083652,Staff,84,0,100,16
1649852104344,CSE 15L,A01,083654,Staff,39,0,50,11
1649852104344,CSE 15L,A02,083655,Staff,49,0,50,1
1649852110382,CSE 20,A01,083657,Staff,73,0,80,7
1649852116411,CSE 30,A01,083084,Eldon; John,15,0,40,25
1649852122439,CSE 100,A01,083659,Cao; Yingjun,15,0,50,35
1649852128465,CSE 134B,A01,083661,Powell; Thomas Allan,0,3,65,65
1649852134488,CSE 140,A01,083663,Staff,55,0,75,20
1649852140516,CSE 140L,A01,083088,Eldon; John,51,0,75,24
1649852146543,CSE 175,A01,083665,Kumar; Rakesh,16,0,25,9
1649852152571,CSE 190,A00,092507,Staff,15,0,15,0
1649852158600,ECE 45,A01,083139,Staff,34,0,40,6
1649852164627,ECE 65,A50,083695,Staff,22,0,30,8
1649852170661,ECE 109,A01,091882,Touri; Behrouz,66,0,70,4
1649852176688,ECE 180,A00,083140,Abi Samra; Nicholas Camill,29,0,30,1
1649852176688,ECE 180,B00,083141,Abi Samra; Nicholas Camill,17,0,30,13
1649852182723,MATH 10A,A01,083735,Patchell; Gregory David,26,0,30,4
1649852182723,MATH 10A,A02,083736,Patchell; Gregory David,30,0,30,0
1649852182723,MATH 10A,A03,083737,Patchell; Gregory David,30,0,30,0
1649852188847,MATH 10B,A01,083207,Staff,21,0,30,9
1649852188847,MATH 10B,A02,083208,Staff,28,0,30,2
1649852188847,MATH 10B,B01,083739,Staff,27,0,30,3
1649852188847,MATH 10B,B02,083740,Staff,30,0,30,0
1649852194886,MATH 18,A01,083743,Staff,26,0,30,4
1649852194886,MATH 18,A02,083744,Staff,30,0,30,0
1649852194886,MATH 18,A03,083745,Staff,30,0,30,0
1649852194886,MATH 18,A04,083746,Staff,30,0,30,0
1649852194886,MATH 18,B01,083748,Staff,24,0,30,6
1649852194886,MATH 18,B02,083749,Staff,29,0,30,1
1649852194886,MATH 18,B03,083750,Staff,30,0,30,0
1649852194886,MATH 18,B04,083751,Staff,29,0,30,1
1649852200912,MATH 20A,A01,083754,Staff,39,0,40,1
1649852206937,MATH 20B,A01,083756,Staff,29,0,30,1
1649852206937,MATH 20B,A02,083757,Staff,30,0,30,0
1649852212962,MATH 20C,A01,083760,Staff,27,0,30,3
1649852212962,MATH 20C,A02,083761,Staff,30,0,30,0
1649852212962,MATH 20C,B01,083762,Staff,30,0,30,0
1649852212962,MATH 20C,B02,083763,Staff,30,0,30,0
1649852218987,MATH 20D,A01,083765,Staff,24,0,30,6
1649852218987,MATH 20D,A02,083766,Staff,30,0,30,0
1649852218987,MATH 20D,A03,083767,Staff,30,0,30,0
1649852225019,MATH 20E,A01,083771,Staff,21,0,30,9
1649852225019,MATH 20E,A02,083772,Staff,29,0,30,1
1649852225019,MATH 20E,B01,083773,Staff,25,0,30,5
1649852225019,MATH 20E,B02,083774,Staff,30,0,30,0
1649852231047,MATH 103A,A01,083777,Staff,5,0,30,25
1649852231047,MATH 103A,A02,083778,Staff,23,0,30,7
1649852231047,MATH 103A,B01,083779,Staff,17,0,30,13
1649852231047,MATH 103A,B02,083780,Staff,27,0,30,3
1649852237079,MATH 105,A01,085443,Staff,15,0,30,15
1649852243107,MATH 109,A01,083213,Anzaldo; Leesa B,28,0,30,2
1649852243107,MATH 109,A02,083214,Anzaldo; Leesa B,24,0,30,6
1649852243107,MATH 109,B01,083215,Anzaldo; Leesa B,28,0,30,2
1649852243107,MATH 109,B02,083216,Anzaldo; Leesa B,26,0,30,4
1649852249141,MATH 142A,A01,083219,Chow; Bennett,11,0,30,19
1649852249141,MATH 142A,A02,083220,Chow; Bennett,28,0,30,2
1649852249141,MATH 142A,B01,083221,Chow; Bennett,16,0,30,14
1649852249141,MATH 142A,B02,083222,Chow; Bennett,27,0,30,3
1649852255169,MATH 193A,A01,083224,Staff,0,0,30,30
1649852255169,MATH 193A,A02,083225,Staff,13,0,30,17
1649852255169,MATH 193A,A03,083781,Staff,28,0,30,2
1649852255169,MATH 193A,A04,083782,Staff,28,0,30,2
1649852261192,MATH 197,001,091859,McAuley; Julian John,9999,0,9999,0
1649852267268,COGS 9,A01,083615,Staff,46,0,60,14
1649852273300,COGS 11,A01,083617,Boyle; Mary E. T.,36,0,40,4
1649852279323,COGS 13,A01,083071,Staff,21,0,40,19
1649852285347,COGS 14A,A01,092681,Staff,98,0,100,2
1649852291372,COGS 14B,A01,083073,Cheng; Tzu-Han,39,0,50,11
1649852297395,COGS 17,A01,092677,Staff,74,0,75,1
1649852303420,COGS 100,A01,083619,Staff,34,0,60,26
1649852309458,COGS 101A,A01,083621,Davis; Joshua Daniel,34,0,60,26
1649852315487,COGS 101B,A01,091572,Staff,47,0,60,13
1649852321518,COGS 101C,A01,083625,Delgado; Tania,25,0,30,5
1649852327550,COGS 107A,A01,083627,Boyle; Mary E. T.,41,0,60,19
1649852333578,COGS 118A,A01,083075,Staff,34,0,60,26
1649852339608,CSE 3,A50,083646,Miranda; Gregory Joseph,32,0,38,6
1649852339608,CSE 3,A51,083647,Miranda; Gregory Joseph,37,0,37,0
1649852345637,CSE 8A,A50,083650,Miranda; Gregory Joseph,30,0,40,10
1649852351674,CSE 11,A01,083080,Cao; Yingjun,10,0,40,30
1649852357704,CSE 12,A01,083652,Staff,84,0,100,16
1649852363732,CSE 15L,A01,083654,Staff,39,0,50,11
1649852363732,CSE 15L,A02,083655,Staff,49,0,50,1
1649852369767,CSE 20,A01,083657,Staff,73,0,80,7
1649852375799,CSE 30,A01,083084,Eldon; John,15,0,40,25
1649852381827,CSE 100,A01,083659,Cao; Yingjun,15,0,50,35
1649852387855,CSE 134B,A01,083661,Powell; Thomas Allan,0,3,65,65
1649852393880,CSE 140,A01,083663,Staff,55,0,75,20
1649852399908,CSE 140L,A01,083088,Eldon; John,51,0,75,24
1649852405936,CSE 175,A01,083665,Kumar; Rakesh,16,0,25,9
1649852411963,CSE 190,A00,092507,Staff,15,0,15,0
1649852417989,ECE 45,A01,083139,Staff,34,0,40,6
1649852424015,ECE 65,A50,083695,Staff,22,0,30,8
1649852430040,ECE 109,A01,091882,Touri; Behrouz,66,0,70,4
1649852436067,ECE 180,A00,083140,Abi Samra; Nicholas Camill,29,0,30,1
1649852436067,ECE 180,B00,083141,Abi Samra; Nicholas Camill,17,0,30,13
1649852442093,MATH 10A,A01,083735,Patchell; Gregory David,26,0,30,4
1649852442093,MATH 10A,A02,083736,Patchell; Gregory David,30,0,30,0
1649852442093,MATH 10A,A03,083737,Patchell; Gregory David,30,0,30,0
1649852448122,MATH 10B,A01,083207,Staff,21,0,30,9
1649852448122,MATH 10B,A02,083208,Staff,28,0,30,2
1649852448122,MATH 10B,B01,083739,Staff,27,0,30,3
1649852448122,MATH 10B,B02,083740,Staff,30,0,30,0
1649852454157,MATH 18,A01,083743,Staff,26,0,30,4
1649852454157,MATH 18,A02,083744,Staff,30,0,30,0
1649852454157,MATH 18,A03,083745,Staff,30,0,30,0
1649852454157,MATH 18,A04,083746,Staff,30,0,30,0
1649852454157,MATH 18,B01,083748,Staff,24,0,30,6
1649852454157,MATH 18,B02,083749,Staff,29,0,30,1
1649852454157,MATH 18,B03,083750,Staff,30,0,30,0
1649852454157,MATH 18,B04,083751,Staff,29,0,30,1
1649852460186,MATH 20A,A01,083754,Staff,39,0,40,1
1649852466213,MATH 20B,A01,083756,Staff,29,0,30,1
1649852466213,MATH 20B,A02,083757,Staff,30,0,30,0
1649852472241,MATH 20C,A01,083760,Staff,27,0,30,3
1649852472241,MATH 20C,A02,083761,Staff,30,0,30,0
1649852472241,MATH 20C,B01,083762,Staff,30,0,30,0
1649852472241,MATH 20C,B02,083763,Staff,30,0,30,0
1649852478270,MATH 20D,A01,083765,Staff,24,0,30,6
1649852478270,MATH 20D,A02,083766,Staff,30,0,30,0
1649852478270,MATH 20D,A03,083767,Staff,30,0,30,0
1649852484300,MATH 20E,A01,083771,Staff,21,0,30,9
1649852484300,MATH 20E,A02,083772,Staff,29,0,30,1
1649852484300,MATH 20E,B01,083773,Staff,25,0,30,5
1649852484300,MATH 20E,B02,083774,Staff,30,0,30,0
1649852490328,MATH 103A,A01,083777,Staff,5,0,30,25
1649852490328,MATH 103A,A02,083778,Staff,23,0,30,7
1649852490328,MATH 103A,B01,083779,Staff,17,0,30,13
1649852490328,MATH 103A,B02,083780,Staff,27,0,30,3
1649852496350,MATH 105,A01,085443,Staff,15,0,30,15
1649852502378,MATH 109,A01,083213,Anzaldo; Leesa B,28,0,30,2
1649852502378,MATH 109,A02,083214,Anzaldo; Leesa B,24,0,30,6
1649852502378,MATH 109,B01,083215,Anzaldo; Leesa B,28,0,30,2
1649852502378,MATH 109,B02,083216,Anzaldo; Leesa B,26,0,30,4
1649852508403,MATH 142A,A01,083219,Chow; Bennett,11,0,30,19
1649852508403,MATH 142A,A02,083220,Chow; Bennett,28,0,30,2
1649852508403,MATH 142A,B01,083221,Chow; Bennett,16,0,30,14
1649852508403,MATH 142A,B02,083222,Chow; Bennett,27,0,30,3
1649852514429,MATH 193A,A01,083224,Staff,0,0,30,30
1649852514429,MATH 193A,A02,083225,Staff,13,0,30,17
1649852514429,MATH 193A,A03,083781,Staff,28,0,30,2
1649852514429,MATH 193A,A04,083782,Staff,28,0,30,2
1649852520468,MATH 197,001,091859,McAuley; Julian John,9999,0,9999,0
1649852526533,COGS 9,A01,083615,Staff,46,0,60,14
1649852532560,COGS 11,A01,083617,Boyle; Mary E. T.,36,0,40,4
1649852538587,COGS 13,A01,083071,Staff,21,0,40,19
1649852544613,COGS 14A,A01,092681,Staff,98,0,100,2
1649852550637,COGS 14B,A01,083073,Cheng; Tzu-Han,39,0,50,11
1649852556666,COGS 17,A01,092677,Staff,74,0,75,1
1649852562692,COGS 100,A01,083619,Staff,34,0,60,26
1649852568722,COGS 101A,A01,083621,Davis; Joshua Daniel,34,0,60,26
1649852574745,COGS 101B,A01,091572,Staff,47,0,60,13
1649852580772,COGS 101C,A01,083625,Delgado; Tania,25,0,30,5
1649852586801,COGS 107A,A01,083627,Boyle; Mary E. T.,41,0,60,19
1649852592825,COGS 118A,A01,083075,Staff,34,0,60,26
1649852598853,CSE 3,A50,083646,Miranda; Gregory Joseph,32,0,38,6
1649852598853,CSE 3,A51,083647,Miranda; Gregory Joseph,37,0,37,0
1649852604882,CSE 8A,A50,083650,Miranda; Gregory Joseph,30,0,40,10
1649852610914,CSE 11,A01,083080,Cao; Yingjun,10,0,40,30
1649852616939,CSE 12,A01,083652,Staff,84,0,100,16
1649852622966,CSE 15L,A01,083654,Staff,39,0,50,11
1649852622966,CSE 15L,A02,083655,Staff,49,0,50,1
1649852629001,CSE 20,A01,083657,Staff,73,0,80,7
1649852635027,CSE 30,A01,083084,Eldon; John,15,0,40,25
1649852641055,CSE 100,A01,083659,Cao; Yingjun,15,0,50,35
1649852647081,CSE 134B,A01,083661,Powell; Thomas Allan,0,3,65,65
1649852653105,CSE 140,A01,083663,Staff,55,0,75,20
1649852659134,CSE 140L,A01,083088,Eldon; John,51,0,75,24
1649852665161,CSE 175,A01,083665,Kumar; Rakesh,16,0,25,9
1649852671185,CSE 190,A00,092507,Staff,15,0,15,0
1649852677214,ECE 45,A01,083139,Staff,34,0,40,6
1649852683244,ECE 65,A50,083695,Staff,22,0,30,8
1649852689267,ECE 109,A01,091882,Touri; Behrouz,66,0,70,4
1649852695292,ECE 180,A00,083140,Abi Samra; Nicholas Camill,29,0,30,1
1649852695292,ECE 180,B00,083141,Abi Samra; Nicholas Camill,17,0,30,13
1649852701329,MATH 10A,A01,083735,Patchell; Gregory David,26,0,30,4
1649852701329,MATH 10A,A02,083736,Patchell; Gregory David,30,0,30,0
1649852701329,MATH 10A,A03,083737,Patchell; Gregory David,30,0,30,0
1649852707356,MATH 10B,A01,083207,Staff,21,0,30,9
1649852707356,MATH 10B,A02,083208,Staff,28,0,30,2
1649852707356,MATH 10B,B01,083739,Staff,27,0,30,3
1649852707356,MATH 10B,B02,083740,Staff,30,0,30,0
1649852713390,MATH 18,A01,083743,Staff,26,0,30,4
1649852713390,MATH 18,A02,083744,Staff,30,0,30,0
1649852713390,MATH 18,A03,083745,Staff,30,0,30,0
1649852713390,MATH 18,A04,083746,Staff,30,0,30,0
1649852713390,MATH 18,B01,083748,Staff,24,0,30,6
1649852713390,MATH 18,B02,083749,Staff,29,0,30,1
1649852713390,MATH 18,B03,083750,Staff,30,0,30,0
1649852713390,MATH 18,B04,083751,Staff,29,0,30,1
1649852719437,MATH 20A,A01,083754,Staff,39,0,40,1
1649852725468,MATH 20B,A01,083756,Staff,29,0,30,1
1649852725468,MATH 20B,A02,083757,Staff,30,0,30,0
1649852731494,MATH 20C,A01,083760,Staff,27,0,30,3
1649852731494,MATH 20C,A02,083761,Staff,30,0,30,0
1649852731494,MATH 20C,B01,083762,Staff,30,0,30,0
1649852731494,MATH 20C,B02,083763,Staff,30,0,30,0
1649852737518,MATH 20D,A01,083765,Staff,24,0,30,6
1649852737518,MATH 20D,A02,083766,Staff,30,0,30,0
1649852737518,MATH 20D,A03,083767,Staff,30,0,30,0
1649852743549,MATH 20E,A01,083771,Staff,21,0,30,9
1649852743549,MATH 20E,A02,083772,Staff,29,0,30,1
1649852743549,MATH 20E,B01,083773,Staff,25,0,30,5
1649852743549,MATH 20E,B02,083774,Staff,30,0,30,0
1649852749578,MATH 103A,A01,083777,Staff,5,0,30,25
1649852749578,MATH 103A,A02,083778,Staff,23,0,30,7
1649852749578,MATH 103A,B01,083779,Staff,17,0,30,13
1649852749578,MATH 103A,B02,083780,Staff,27,0,30,3
1649852755606,MATH 105,A01,085443,Staff,15,0,30,15
1649852761635,MATH 109,A01,083213,Anzaldo; Leesa B,28,0,30,2
1649852761635,MATH 109,A02,083214,Anzaldo; Leesa B,24,0,30,6
1649852761635,MATH 109,B01,083215,Anzaldo; Leesa B,28,0,30,2
1649852761635,MATH 109,B02,083216,Anzaldo; Leesa B,26,0,30,4
1649852767666,MATH 142A,A01,083219,Chow; Bennett,11,0,30,19
1649852767666,MATH 142A,A02,083220,Chow; Bennett,28,0,30,2
1649852767666,MATH 142A,B01,083221,Chow; Bennett,16,0,30,14
1649852767666,MATH 142A,B02,083222,Chow; Bennett,27,0,30,3
1649852773692,MATH 193A,A01,083224,Staff,0,0,30,30
1649852773692,MATH 193A,A02,083225,Staff,13,0,30,17
1649852773692,MATH 193A,A03,083781,Staff,28,0,30,2
1649852773692,MATH 193A,A04,083782,Staff,28,0,30,2
1649852779717,MATH 197,001,091859,McAuley; Julian John,9999,0,9999,0
1649852785869,COGS 9,A01,083615,Staff,46,0,60,14
1649852791912,COGS 11,A01,083617,Boyle; Mary E. T.,36,0,40,4
1649852797941,COGS 13,A01,083071,Staff,21,0,40,19
1649852803967,COGS 14A,A01,092681,Staff,98,0,100,2
1649852810006,COGS 14B,A01,083073,Cheng; Tzu-Han,39,0,50,11
1649852816035,COGS 17,A01,092677,Staff,74,0,75,1
1649852822069,COGS 100,A01,083619,Staff,34,0,60,26
1649852828098,COGS 101A,A01,083621,Davis; Joshua Daniel,34,0,60,26
1649852834123,COGS 101B,A01,091572,Staff,47,0,60,13
1649852840166,COGS 101C,A01,083625,Delgado; Tania,25,0,30,5
1649852846192,COGS 107A,A01,083627,Boyle; Mary E. T.,41,0,60,19
1649852852219,COGS 118A,A01,083075,Staff,34,0,60,26
1649852858247,CSE 3,A50,083646,Miranda; Gregory Joseph,32,0,38,6
1649852858247,CSE 3,A51,083647,Miranda; Gregory Joseph,37,0,37,0
1649852864278,CSE 8A,A50,083650,Miranda; Gregory Joseph,30,0,40,10
1649852870304,CSE 11,A01,083080,Cao; Yingjun,10,0,40,30
1649852876348,CSE 12,A01,083652,Staff,84,0,100,16
1649852882373,CSE 15L,A01,083654,Staff,39,0,50,11
1649852882373,CSE 15L,A02,083655,Staff,49,0,50,1
1649852888399,CSE 20,A01,083657,Staff,73,0,80,7
1649852894425,CSE 30,A01,083084,Eldon; John,15,0,40,25
1649852900448,CSE 100,A01,083659,Cao; Yingjun,15,0,50,35
1649852906476,CSE 134B,A01,083661,Powell; Thomas Allan,0,3,65,65
1649852912499,CSE 140,A01,083663,Staff,55,0,75,20
1649852918531,CSE 140L,A01,083088,Eldon; John,51,0,75,24
1649852924558,CSE 175,A01,083665,Kumar; Rakesh,16,0,25,9
1649852930584,CSE 190,A00,092507,Staff,15,0,15,0
1649852936612,ECE 45,A01,083139,Staff,34,0,40,6
1649852942638,ECE 65,A50,083695,Staff,22,0,30,8
1649852948665,ECE 109,A01,091882,Touri; Behrouz,66,0,70,4
1649852954699,ECE 180,A00,083140,Abi Samra; Nicholas Camill,29,0,30,1
1649852954699,ECE 180,B00,083141,Abi Samra; Nicholas Camill,17,0,30,13
1649852960731,MATH 10A,A01,083735,Patchell; Gregory David,26,0,30,4
1649852960731,MATH 10A,A02,083736,Patchell; Gregory David,30,0,30,0
1649852960731,MATH 10A,A03,083737,Patchell; Gregory David,30,0,30,0
1649852966756,MATH 10B,A01,083207,Staff,21,0,30,9
1649852966756,MATH 10B,A02,083208,Staff,28,0,30,2
1649852966756,MATH 10B,B01,083739,Staff,27,0,30,3
1649852966756,MATH 10B,B02,083740,Staff,30,0,30,0
1649852972785,MATH 18,A01,083743,Staff,26,0,30,4
1649852972785,MATH 18,A02,083744,Staff,30,0,30,0
1649852972785,MATH 18,A03,083745,Staff,30,0,30,0
1649852972785,MATH 18,A04,083746,Staff,30,0,30,0
1649852972785,MATH 18,B01,083748,Staff,24,0,30,6
1649852972785,MATH 18,B02,083749,Staff,29,0,30,1
1649852972785,MATH 18,B03,083750,Staff,30,0,30,0
1649852972785,MATH 18,B04,083751,Staff,29,0,30,1
1649852978809,MATH 20A,A01,083754,Staff,39,0,40,1
1649852984853,MATH 20B,A01,083756,Staff,29,0,30,1
1649852984853,MATH 20B,A02,083757,Staff,30,0,30,0
1649852990885,MATH 20C,A01,083760,Staff,27,0,30,3
1649852990885,MATH 20C,A02,083761,Staff,30,0,30,0
1649852990885,MATH 20C,B01,083762,Staff,30,0,30,0
1649852990885,MATH 20C,B02,083763,Staff,30,0,30,0
1649852996914,MATH 20D,A01,083765,Staff,24,0,30,6
1649852996914,MATH 20D,A02,083766,Staff,30,0,30,0
1649852996914,MATH 20D,A03,083767,Staff,30,0,30,0
1649853002944,MATH 20E,A01,083771,Staff,21,0,30,9
1649853002944,MATH 20E,A02,083772,Staff,29,0,30,1
1649853002944,MATH 20E,B01,083773,Staff,25,0,30,5
1649853002944,MATH 20E,B02,083774,Staff,30,0,30,0
1649853008978,MATH 103A,A01,083777,Staff,5,0,30,25
1649853008978,MATH 103A,A02,083778,Staff,23,0,30,7
1649853008978,MATH 103A,B01,083779,Staff,17,0,30,13
1649853008978,MATH 103A,B02,083780,Staff,27,0,30,3
1649853015003,MATH 105,A01,085443,Staff,15,0,30,15
1649853021034,MATH 109,A01,083213,Anzaldo; Leesa B,28,0,30,2
1649853021034,MATH 109,A02,083214,Anzaldo; Leesa B,24,0,30,6
1649853021034,MATH 109,B01,083215,Anzaldo; Leesa B,28,0,30,2
1649853021034,MATH 109,B02,083216,Anzaldo; Leesa B,26,0,30,4
1649853027068,MATH 142A,A01,083219,Chow; Bennett,11,0,30,19
1649853027068,MATH 142A,A02,083220,Chow; Bennett,28,0,30,2
1649853027068,MATH 142A,B01,083221,Chow; Bennett,16,0,30,14
1649853027068,MATH 142A,B02,083222,Chow; Bennett,27,0,30,3
1649853033097,MATH 193A,A01,083224,Staff,0,0,30,30
1649853033097,MATH 193A,A02,083225,Staff,13,0,30,17
1649853033097,MATH 193A,A03,083781,Staff,28,0,30,2
1649853033097,MATH 193A,A04,083782,Staff,28,0,30,2
1649853039122,MATH 197,001,091859,McAuley; Julian John,9999,0,9999,0
1649853045178,COGS 9,A01,083615,Staff,46,0,60,14
1649853051209,COGS 11,A01,083617,Boyle; Mary E. T.,36,0,40,4
1649853057241,COGS 13,A01,083071,Staff,21,0,40,19
1649853063271,COGS 14A,A01,092681,Staff,98,0,100,2
1649853069308,COGS 14B,A01,083073,Cheng; Tzu-Han,39,0,50,11
1649853075332,COGS 17,A01,092677,Staff,74,0,75,1
1649853081373,COGS 100,A01,083619,Staff,34,0,60,26
1649853087398,COGS 101A,A01,083621,Davis; Joshua Daniel,34,0,60,26
1649853093424,COGS 101B,A01,091572,Staff,47,0,60,13
1649853099450,COGS 101C,A01,083625,Delgado; Tania,25,0,30,5
1649853105479,COGS 107A,A01,083627,Boyle; Mary E. T.,41,0,60,19
1649853111505,COGS 118A,A01,083075,Staff,34,0,60,26
1649853117531,CSE 3,A50,083646,Miranda; Gregory Joseph,32,0,38,6
1649853117531,CSE 3,A51,083647,Miranda; Gregory Joseph,37,0,37,0
1649853123558,CSE 8A,A50,083650,Miranda; Gregory Joseph,30,0,40,10
1649853129586,CSE 11,A01,083080,Cao; Yingjun,10,0,40,30
1649853135615,CSE 12,A01,083652,Staff,84,0,100,16
1649853141644,CSE 15L,A01,083654,Staff,39,0,50,11
1649853141644,CSE 15L,A02,083655,Staff,49,0,50,1
1649853147672,CSE 20,A01,083657,Staff,73,0,80,7
1649853153698,CSE 30,A01,083084,Eldon; John,15,0,40,25
1649853159727,CSE 100,A01,083659,Cao; Yingjun,15,0,50,35
1649853165752,CSE 134B,A01,083661,Powell; Thomas Allan,0,3,65,65
1649853171777,CSE 140,A01,083663,Staff,55,0,75,20
1649853177802,CSE 140L,A01,083088,Eldon; John,51,0,75,24
1649853183836,CSE 175,A01,083665,Kumar; Rakesh,16,0,25,9
1649853189869,CSE 190,A00,092507,Staff,15,0,15,0
1649853195901,ECE 45,A01,083139,Staff,34,0,40,6
1649853201933,ECE 65,A50,083695,Staff,22,0,30,8
1649853207958,ECE 109,A01,091882,Touri; Behrouz,66,0,70,4
1649853213987,ECE 180,A00,083140,Abi Samra; Nicholas Camill,29,0,30,1
1649853213987,ECE 180,B00,083141,Abi Samra; Nicholas Camill,17,0,30,13
1649853220015,MATH 10A,A01,083735,Patchell; Gregory David,26,0,30,4
1649853220015,MATH 10A,A02,083736,Patchell; Gregory David,30,0,30,0
1649853220015,MATH 10A,A03,083737,Patchell; Gregory David,30,0,30,0
1649853226048,MATH 10B,A01,083207,Staff,21,0,30,9
1649853226048,MATH 10B,A02,083208,Staff,28,0,30,2
1649853226048,MATH 10B,B01,083739,Staff,27,0,30,3
1649853226048,MATH 10B,B02,083740,Staff,30,0,30,0
1649853232075,MATH 18,A01,083743,Staff,26,0,30,4
1649853232075,MATH 18,A02,083744,Staff,30,0,30,0
1649853232075,MATH 18,A03,083745,Staff,30,0,30,0
1649853232075,MATH 18,A04,083746,Staff,30,0,30,0
1649853232075,MATH 18,B01,083748,Staff,24,0,30,6
1649853232075,MATH 18,B02,083749,Staff,29,0,30,1
1649853232075,MATH 18,B03,083750,Staff,30,0,30,0
1649853232075,MATH 18,B04,083751,Staff,29,0,30,1
1649853238103,MATH 20A,A01,083754,Staff,39,0,40,1
1649853244144,MATH 20B,A01,083756,Staff,29,0,30,1
1649853244144,MATH 20B,A02,083757,Staff,30,0,30,0
1649853250170,MATH 20C,A01,083760,Staff,27,0,30,3
1649853250170,MATH 20C,A02,083761,Staff,30,0,30,0
1649853250170,MATH 20C,B01,083762,Staff,30,0,30,0
1649853250170,MATH 20C,B02,083763,Staff,30,0,30,0
1649853256200,MATH 20D,A01,083765,Staff,24,0,30,6
1649853256200,MATH 20D,A02,083766,Staff,30,0,30,0
1649853256200,MATH 20D,A03,083767,Staff,30,0,30,0
1649853262234,MATH 20E,A01,083771,Staff,21,0,30,9
1649853262234,MATH 20E,A02,083772,Staff,29,0,30,1
1649853262234,MATH 20E,B01,083773,Staff,25,0,30,5
1649853262234,MATH 20E,B02,083774,Staff,30,0,30,0
1649853268259,MATH 103A,A01,083777,Staff,5,0,30,25
1649853268259,MATH 103A,A02,083778,Staff,23,0,30,7
1649853268259,MATH 103A,B01,083779,Staff,17,0,30,13
1649853268259,MATH 103A,B02,083780,Staff,27,0,30,3
1649853274289,MATH 105,A01,085443,Staff,15,0,30,15
1649853280313,MATH 109,A01,083213,Anzaldo; Leesa B,28,0,30,2
1649853280313,MATH 109,A02,083214,Anzaldo; Leesa B,24,0,30,6
1649853280313,MATH 109,B01,083215,Anzaldo; Leesa B,28,0,30,2
1649853280313,MATH 109,B02,083216,Anzaldo; Leesa B,26,0,30,4
1649853286338,MATH 142A,A01,083219,Chow; Bennett,11,0,30,19
1649853286338,MATH 142A,A02,083220,Chow; Bennett,28,0,30,2
1649853286338,MATH 142A,B01,083221,Chow; Bennett,16,0,30,14
1649853286338,MATH 142A,B02,083222,Chow; Bennett,27,0,30,3
1649853292371,MATH 193A,A01,083224,Staff,0,0,30,30
1649853292371,MATH 193A,A02,083225,Staff,13,0,30,17
1649853292371,MATH 193A,A03,083781,Staff,28,0,30,2
1649853292371,MATH 193A,A04,083782,Staff,28,0,30,2
1649853298394,MATH 197,001,091859,McAuley; Julian John,9999,0,9999,0
1649853304465,COGS 9,A01,083615,Staff,46,0,60,14
1649853310489,COGS 11,A01,083617,Boyle; Mary E. T.,36,0,40,4
1649853316526,COGS 13,A01,083071,Staff,21,0,40,19
1649853322550,COGS 14A,A01,092681,Staff,98,0,100,2
1649853328582,COGS 14B,A01,083073,Cheng; Tzu-Han,39,0,50,11
1649853334606,COGS 17,A01,092677,Staff,74,0,75,1
1649853340633,COGS 100,A01,083619,Staff,34,0,60,26
1649853346662,COGS 101A,A01,083621,Davis; Joshua Daniel,34,0,60,26
1649853352691,COGS 101B,A01,091572,Staff,47,0,60,13
1649853358718,COGS 101C,A01,083625,Delgado; Tania,25,0,30,5
1649853364743,COGS 107A,A01,083627,Boyle; Mary E. T.,41,0,60,19
1649853370775,COGS 118A,A01,083075,Staff,34,0,60,26
1649853376893,CSE 3,A50,083646,Miranda; Gregory Joseph,32,0,38,6
1649853376893,CSE 3,A51,083647,Miranda; Gregory Joseph,37,0,37,0
1649853382923,CSE 8A,A50,083650,Miranda; Gregory Joseph,30,0,40,10
1649853388952,CSE 11,A01,083080,Cao; Yingjun,10,0,40,30
1649853394987,CSE 12,A01,083652,Staff,84,0,100,16
1649853401015,CSE 15L,A01,083654,Staff,39,0,50,11
1649853401015,CSE 15L,A02,083655,Staff,49,0,50,1
1649853407044,CSE 20,A01,083657,Staff,73,0,80,7
1649853413070,CSE 30,A01,083084,Eldon; John,15,0,40,25
1649853419096,CSE 100,A01,083659,Cao; Yingjun,15,0,50,35
1649853425123,CSE 134B,A01,083661,Powell; Thomas Allan,0,3,65,65
1649853431151,CSE 140,A01,083663,Staff,55,0,75,20
1649853437175,CSE 140L,A01,083088,Eldon; John,51,0,75,24
1649853443206,CSE 175,A01,083665,Kumar; Rakesh,16,0,25,9
1649853449231,CSE 190,A00,092507,Staff,15,0,15,0
1649853455259,ECE 45,A01,083139,Staff,34,0,40,6
1649853461285,ECE 65,A50,083695,Staff,22,0,30,8
1649853467309,ECE 109,A01,091882,Touri; Behrouz,66,0,70,4
1649853473335,ECE 180,A00,083140,Abi Samra; Nicholas Camill,29,0,30,1
1649853473335,ECE 180,B00,083141,Abi Samra; Nicholas Camill,17,0,30,13
1649853479360,MATH 10A,A01,083735,Patchell; Gregory David,26,0,30,4
1649853479360,MATH 10A,A02,083736,Patchell; Gregory David,30,0,30,0
1649853479360,MATH 10A,A03,083737,Patchell; Gregory David,30,0,30,0
1649853485385,MATH 10B,A01,083207,Staff,21,0,30,9
1649853485385,MATH 10B,A02,083208,Staff,28,0,30,2
1649853485385,MATH 10B,B01,083739,Staff,27,0,30,3
1649853485385,MATH 10B,B02,083740,Staff,30,0,30,0
1649853491411,MATH 18,A01,083743,Staff,26,0,30,4
1649853491411,MATH 18,A02,083744,Staff,30,0,30,0
1649853491411,MATH 18,A03,083745,Staff,30,0,30,0
1649853491411,MATH 18,A04,083746,Staff,30,0,30,0
1649853491411,MATH 18,B01,083748,Staff,24,0,30,6
1649853491411,MATH 18,B02,083749,Staff,29,0,30,1
1649853491411,MATH 18,B03,083750,Staff,30,0,30,0
1649853491411,MATH 18,B04,083751,Staff,29,0,30,1
1649853497436,MATH 20A,A01,083754,Staff,39,0,40,1
1649853503464,MATH 20B,A01,083756,Staff,29,0,30,1
1649853503464,MATH 20B,A02,083757,Staff,30,0,30,0
1649853509493,MATH 20C,A01,083760,Staff,27,0,30,3
1649853509493,MATH 20C,A02,083761,Staff,30,0,30,0
1649853509493,MATH 20C,B01,083762,Staff,30,0,30,0
1649853509493,MATH 20C,B02,083763,Staff,30,0,30,0
1649853515517,MATH 20D,A01,083765,Staff,24,0,30,6
1649853515517,MATH 20D,A02,083766,Staff,30,0,30,0
1649853515517,MATH 20D,A03,083767,Staff,30,0,30,0
1649853521541,MATH 20E,A01,083771,Staff,21,0,30,9
1649853521541,MATH 20E,A02,083772,Staff,29,0,30,1
1649853521541,MATH 20E,B01,083773,Staff,25,0,30,5
1649853521541,MATH 20E,B02,083774,Staff,30,0,30,0
1649853527565,MATH 103A,A01,083777,Staff,5,0,30,25
1649853527565,MATH 103A,A02,083778,Staff,23,0,30,7
1649853527565,MATH 103A,B01,083779,Staff,17,0,30,13
1649853527565,MATH 103A,B02,083780,Staff,27,0,30,3
1649853533591,MATH 105,A01,085443,Staff,15,0,30,15
1649853539621,MATH 109,A01,083213,Anzaldo; Leesa B,28,0,30,2
1649853539621,MATH 109,A02,083214,Anzaldo; Leesa B,24,0,30,6
1649853539621,MATH 109,B01,083215,Anzaldo; Leesa B,28,0,30,2
1649853539621,MATH 109,B02,083216,Anzaldo; Leesa B,26,0,30,4
1649853545652,MATH 142A,A01,083219,Chow; Bennett,11,0,30,19
1649853545652,MATH 142A,A02,083220,Chow; Bennett,28,0,30,2
1649853545652,MATH 142A,B01,083221,Chow; Bennett,16,0,30,14
1649853545652,MATH 142A,B02,083222,Chow; Bennett,27,0,30,3
1649853551679,MATH 193A,A01,083224,Staff,0,0,30,30
1649853551679,MATH 193A,A02,083225,Staff,13,0,30,17
1649853551679,MATH 193A,A03,083781,Staff,28,0,30,2
1649853551679,MATH 193A,A04,083782,Staff,28,0,30,2
1649853557702,MATH 197,001,091859,McAuley; Julian John,9999,0,9999,0
1649853563761,COGS 9,A01,083615,Staff,46,0,60,14
1649853569786,COGS 11,A01,083617,Boyle; Mary E. T.,36,0,40,4
1649853575811,COGS 13,A01,083071,Staff,21,0,40,19
1649853581839,COGS 14A,A01,092681,Staff,98,0,100,2
1649853587864,COGS 14B,A01,083073,Cheng; Tzu-Han,39,0,50,11
1649853593889,COGS 17,A01,092677,Staff,74,0,75,1
1649853599917,COGS 100,A01,083619,Staff,34,0,60,26
1649853605942,COGS 101A,A01,083621,Davis; Joshua Daniel,34,0,60,26
1649853611970,COGS 101B,A01,091572,Staff,47,0,60,13
1649853617993,COGS 101C,A01,083625,Delgado; Tania,25,0,30,5
1649853624024,COGS 107A,A01,083627,Boyle; Mary E. T.,41,0,60,19
1649853630050,COGS 118A,A01,083075,Staff,34,0,60,26
1649853636074,CSE 3,A50,083646,Miranda; Gregory Joseph,32,0,38,6
1649853636074,CSE 3,A51,083647,Miranda; Gregory Joseph,37,0,37,0
1649853642110,CSE 8A,A50,083650,Miranda; Gregory Joseph,30,0,40,10
1649853648137,CSE 11,A01,083080,Cao; Yingjun,10,0,40,30
1649853654164,CSE 12,A01,083652,Staff,84,0,100,16
1649853660194,CSE 15L,A01,083654,Staff,39,0,50,11
1649853660194,CSE 15L,A02,083655,Staff,49,0,50,1
1649853666223,CSE 20,A01,083657,Staff,73,0,80,7
1649853672249,CSE 30,A01,083084,Eldon; John,15,0,40,25
1649853678272,CSE 100,A01,083659,Cao; Yingjun,15,0,50,35
1649853684297,CSE 134B,A01,083661,Powell; Thomas Allan,0,3,65,65
1649853690323,CSE 140,A01,083663,Staff,55,0,75,20
1649853696350,CSE 140L,A01,083088,Eldon; John,51,0,75,24
1649853702380,CSE 175,A01,083665,Kumar; Rakesh,16,0,25,9
1649853708403,CSE 190,A00,092507,Staff,15,0,15,0
1649853714429,ECE 45,A01,083139,Staff,34,0,40,6
1649853720458,ECE 65,A50,083695,Staff,22,0,30,8
1649853726485,ECE 109,A01,091882,Touri; Behrouz,66,0,70,4
1649853732515,ECE 180,A00,083140,Abi Samra; Nicholas Camill,29,0,30,1
1649853732515,ECE 180,B00,083141,Abi Samra; Nicholas Camill,17,0,30,13
1649853738542,MATH 10A,A01,083735,Patchell; Gregory David,26,0,30,4
1649853738542,MATH 10A,A02,083736,Patchell; Gregory David,30,0,30,0
1649853738542,MATH 10A,A03,083737,Patchell; Gregory David,30,0,30,0
1649853744572,MATH 10B,A01,083207,Staff,21,0,30,9
1649853744572,MATH 10B,A02,083208,Staff,28,0,30,2
1649853744572,MATH 10B,B01,083739,Staff,27,0,30,3
1649853744572,MATH 10B,B02,083740,Staff,30,0,30,0
1649853750607,MATH 18,A01,083743,Staff,26,0,30,4
1649853750607,MATH 18,A02,083744,Staff,30,0,30,0
1649853750607,MATH 18,A03,083745,Staff,30,0,30,0
1649853750607,MATH 18,A04,083746,Staff,30,0,30,0
1649853750607,MATH 18,B01,083748,Staff,24,0,30,6
1649853750607,MATH 18,B02,083749,Staff,29,0,30,1
1649853750607,MATH 18,B03,083750,Staff,30,0,30,0
1649853750607,MATH 18,B04,083751,Staff,29,0,30,1
1649853756630,MATH 20A,A01,083754,Staff,39,0,40,1
1649853762658,MATH 20B,A01,083756,Staff,29,0,30,1
1649853762658,MATH 20B,A02,083757,Staff,30,0,30,0
1649853768689,MATH 20C,A01,083760,Staff,27,0,30,3
1649853768689,MATH 20C,A02,083761,Staff,30,0,30,0
1649853768689,MATH 20C,B01,083762,Staff,30,0,30,0
1649853768689,MATH 20C,B02,083763,Staff,30,0,30,0
1649853774716,MATH 20D,A01,083765,Staff,24,0,30,6
1649853774716,MATH 20D,A02,083766,Staff,30,0,30,0
1649853774716,MATH 20D,A03,083767,Staff,30,0,30,0
1649853780743,MATH 20E,A01,083771,Staff,21,0,30,9
1649853780743,MATH 20E,A02,083772,Staff,29,0,30,1
1649853780743,MATH 20E,B01,083773,Staff,25,0,30,5
1649853780743,MATH 20E,B02,083774,Staff,30,0,30,0
1649853786790,MATH 103A,A01,083777,Staff,5,0,30,25
1649853786790,MATH 103A,A02,083778,Staff,23,0,30,7
1649853786790,MATH 103A,B01,083779,Staff,17,0,30,13
1649853786790,MATH 103A,B02,083780,Staff,27,0,30,3
1649853792816,MATH 105,A01,085443,Staff,15,0,30,15
1649853798842,MATH 109,A01,083213,Anzaldo; Leesa B,28,0,30,2
1649853798842,MATH 109,A02,083214,Anzaldo; Leesa B,24,0,30,6
1649853798842,MATH 109,B01,083215,Anzaldo; Leesa B,28,0,30,2
1649853798842,MATH 109,B02,083216,Anzaldo; Leesa B,26,0,30,4
1649853804870,MATH 142A,A01,083219,Chow; Bennett,11,0,30,19
1649853804870,MATH 142A,A02,083220,Chow; Bennett,28,0,30,2
1649853804870,MATH 142A,B01,083221,Chow; Bennett,16,0,30,14
1649853804870,MATH 142A,B02,083222,Chow; Bennett,27,0,30,3
1649853810895,MATH 193A,A01,083224,Staff,0,0,30,30
1649853810895,MATH 193A,A02,083225,Staff,13,0,30,17
1649853810895,MATH 193A,A03,083781,Staff,28,0,30,2
1649853810895,MATH 193A,A04,083782,Staff,28,0,30,2
1649853816919,MATH 197,001,091859,McAuley; Julian John,9999,0,9999,0
1649853822989,COGS 9,A01,083615,Staff,46,0,60,14
1649853829012,COGS 11,A01,083617,Boyle; Mary E. T.,36,0,40,4
1649853835039,COGS 13,A01,083071,Staff,21,0,40,19
1649853841065,COGS 14A,A01,092681,Staff,98,0,100,2
1649853847093,COGS 14B,A01,083073,Cheng; Tzu-Han,39,0,50,11
1649853853117,COGS 17,A01,092677,Staff,74,0,75,1
1649853859141,COGS 100,A01,083619,Staff,34,0,60,26
1649853865167,COGS 101A,A01,083621,Davis; Joshua Daniel,34,0,60,26
1649853871198,COGS 101B,A01,091572,Staff,47,0,60,13
1649853877228,COGS 101C,A01,083625,Delgado; Tania,25,0,30,5
1649853883251,COGS 107A,A01,083627,Boyle; Mary E. T.,41,0,60,19
1649853889273,COGS 118A,A01,083075,Staff,34,0,60,26
1649853895300,CSE 3,A50,083646,Miranda; Gregory Joseph,32,0,38,6
1649853895300,CSE 3,A51,083647,Miranda; Gregory Joseph,37,0,37,0
1649853901326,CSE 8A,A50,083650,Miranda; Gregory Joseph,30,0,40,10
1649853907350,CSE 11,A01,083080,Cao; Yingjun,10,0,40,30
1649853913379,CSE 12,A01,083652,Staff,84,0,100,16
1649853919414,CSE 15L,A01,083654,Staff,39,0,50,11
1649853919414,CSE 15L,A02,083655,Staff,49,0,50,1
1649853925440,CSE 20,A01,083657,Staff,73,0,80,7
1649853931469,CSE 30,A01,083084,Eldon; John,15,0,40,25
1649853937497,CSE 100,A01,083659,Cao; Yingjun,15,0,50,35
1649853943525,CSE 134B,A01,083661,Powell; Thomas Allan,0,3,65,65
1649853949553,CSE 140,A01,083663,Staff,55,0,75,20
1649853955588,CSE 140L,A01,083088,Eldon; John,51,0,75,24
1649853961613,CSE 175,A01,083665,Kumar; Rakesh,16,0,25,9
1649853967642,CSE 190,A00,092507,Staff,15,0,15,0
1649853973762,ECE 45,A01,083139,Staff,34,0,40,6
1649853979791,ECE 65,A50,083695,Staff,22,0,30,8
1649853985821,ECE 109,A01,091882,Touri; Behrouz,66,0,70,4
1649853991845,ECE 180,A00,083140,Abi Samra; Nicholas Camill,29,0,30,1
1649853991845,ECE 180,B00,083141,Abi Samra; Nicholas Camill,17,0,30,13
1649853997874,MATH 10A,A01,083735,Patchell; Gregory David,26,0,30,4
1649853997874,MATH 10A,A02,083736,Patchell; Gregory David,30,0,30,0
1649853997874,MATH 10A,A03,083737,Patchell; Gregory David,30,0,30,0
1649854003901,MATH 10B,A01,083207,Staff,21,0,30,9
1649854003901,MATH 10B,A02,083208,Staff,28,0,30,2
1649854003901,MATH 10B,B01,083739,Staff,27,0,30,3
1649854003901,MATH 10B,B02,083740,Staff,30,0,30,0
1649854009927,MATH 18,A01,083743,Staff,26,0,30,4
1649854009927,MATH 18,A02,083744,Staff,30,0,30,0
1649854009927,MATH 18,A03,083745,Staff,30,0,30,0
1649854009927,MATH 18,A04,083746,Staff,30,0,30,0
1649854009927,MATH 18,B01,083748,Staff,24,0,30,6
1649854009927,MATH 18,B02,083749,Staff,29,0,30,1
1649854009927,MATH 18,B03,083750,Staff,30,0,30,0
1649854009927,MATH 18,B04,083751,Staff,29,0,30,1
1649854015955,MATH 20A,A01,083754,Staff,39,0,40,1
1649854021979,MATH 20B,A01,083756,Staff,29,0,30,1
1649854021979,MATH 20B,A02,083757,Staff,30,0,30,0
1649854028005,MATH 20C,A01,083760,Staff,27,0,30,3
1649854028005,MATH 20C,A02,083761,Staff,30,0,30,0
1649854028005,MATH 20C,B01,083762,Staff,30,0,30,0
1649854028005,MATH 20C,B02,083763,Staff,30,0,30,0
1649854034035,MATH 20D,A01,083765,Staff,24,0,30,6
1649854034035,MATH 20D,A02,083766,Staff,30,0,30,0
1649854034035,MATH 20D,A03,083767,Staff,30,0,30,0
1649854040065,MATH 20E,A01,083771,Staff,21,0,30,9
1649854040065,MATH 20E,A02,083772,Staff,29,0,30,1
1649854040065,MATH 20E,B01,083773,Staff,25,0,30,5
1649854040065,MATH 20E,B02,083774,Staff,30,0,30,0
1649854046093,MATH 103A,A01,083777,Staff,5,0,30,25
1649854046093,MATH 103A,A02,083778,Staff,23,0,30,7
1649854046093,MATH 103A,B01,083779,Staff,17,0,30,13
1649854046093,MATH 103A,B02,083780,Staff,27,0,30,3
1649854052121,MATH 105,A01,085443,Staff,15,0,30,15
1649854058152,MATH 109,A01,083213,Anzaldo; Leesa B,28,0,30,2
1649854058152,MATH 109,A02,083214,Anzaldo; Leesa B,24,0,30,6
1649854058152,MATH 109,B01,083215,Anzaldo; Leesa B,28,0,30,2
1649854058152,MATH 109,B02,083216,Anzaldo; Leesa B,26,0,30,4
1649854064185,MATH 142A,A01,083219,Chow; Bennett,11,0,30,19
1649854064185,MATH 142A,A02,083220,Chow; Bennett,28,0,30,2
1649854064185,MATH 142A,B01,083221,Chow; Bennett,16,0,30,14
1649854064185,MATH 142A,B02,083222,Chow; Bennett,27,0,30,3
1649854070211,MATH 193A,A01,083224,Staff,0,0,30,30
1649854070211,MATH 193A,A02,083225,Staff,13,0,30,17
1649854070211,MATH 193A,A03,083781,Staff,28,0,30,2
1649854070211,MATH 193A,A04,083782,Staff,28,0,30,2
1649854076237,MATH 197,001,091859,McAuley; Julian John,9999,0,9999,0
1649854082322,COGS 9,A01,083615,Staff,46,0,60,14
1649854088354,COGS 11,A01,083617,Boyle; Mary E. T.,36,0,40,4
1649854094379,COGS 13,A01,083071,Staff,21,0,40,19
1649854100409,COGS 14A,A01,092681,Staff,98,0,100,2
1649854106449,COGS 14B,A01,083073,Cheng; Tzu-Han,39,0,50,11
1649854112474,COGS 17,A01,092677,Staff,74,0,75,1
1649854118505,COGS 100,A01,083619,Staff,34,0,60,26
1649854124540,COGS 101A,A01,083621,Davis; Joshua Daniel,34,0,60,26
1649854130573,COGS 101B,A01,091572,Staff,47,0,60,13
1649854136611,COGS 101C,A01,083625,Delgado; Tania,25,0,30,5
1649854142637,COGS 107A,A01,083627,Boyle; Mary E. T.,41,0,60,19
1649854148667,COGS 118A,A01,083075,Staff,34,0,60,26
1649854154703,CSE 3,A50,083646,Miranda; Gregory Joseph,32,0,38,6
1649854154703,CSE 3,A51,083647,Miranda; Gregory Joseph,37,0,37,0
1649854160728,CSE 8A,A50,083650,Miranda; Gregory Joseph,30,0,40,10
1649854166762,CSE 11,A01,083080,Cao; Yingjun,10,0,40,30
1649854172793,CSE 12,A01,083652,Staff,84,0,100,16
1649854178818,CSE 15L,A01,083654,Staff,39,0,50,11
1649854178818,CSE 15L,A02,083655,Staff,49,0,50,1
1649854184844,CSE 20,A01,083657,Staff,73,0,80,7
1649854190872,CSE 30,A01,083084,Eldon; John,15,0,40,25
1649854196904,CSE 100,A01,083659,Cao; Yingjun,15,0,50,35
1649854202930,CSE 134B,A01,083661,Powell; Thomas Allan,0,3,65,65
1649854208960,CSE 140,A01,083663,Staff,55,0,75,20
1649854214984,CSE 140L,A01,083088,Eldon; John,51,0,75,24
1649854221017,CSE 175,A01,083665,Kumar; Rakesh,16,0,25,9
1649854227044,CSE 190,A00,092507,Staff,15,0,15,0
1649854233080,ECE 45,A01,083139,Staff,34,0,40,6
1649854239106,ECE 65,A50,083695,Staff,22,0,30,8
1649854245131,ECE 109,A01,091882,Touri; Behrouz,66,0,70,4
1649854251158,ECE 180,A00,083140,Abi Samra; Nicholas Camill,29,0,30,1
1649854251158,ECE 180,B00,083141,Abi Samra; Nicholas Camill,17,0,30,13
1649854257196,MATH 10A,A01,083735,Patchell; Gregory David,26,0,30,4
1649854257196,MATH 10A,A02,083736,Patchell; Gregory David,30,0,30,0
1649854257196,MATH 10A,A03,083737,Patchell; Gregory David,30,0,30,0
1649854263223,MATH 10B,A01,083207,Staff,21,0,30,9
1649854263223,MATH 10B,A02,083208,Staff,28,0,30,2
1649854263223,MATH 10B,B01,083739,Staff,27,0,30,3
1649854263223,MATH 10B,B02,083740,Staff,30,0,30,0
1649854269249,MATH 18,A01,083743,Staff,26,0,30,4
1649854269249,MATH 18,A02,083744,Staff,30,0,30,0
1649854269249,MATH 18,A03,083745,Staff,30,0,30,0
1649854269249,MATH 18,A04,083746,Staff,30,0,30,0
1649854269249,MATH 18,B01,083748,Staff,24,0,30,6
1649854269249,MATH 18,B02,083749,Staff,29,0,30,1
1649854269249,MATH 18,B03,083750,Staff,30,0,30,0
1649854269249,MATH 18,B04,083751,Staff,29,0,30,1
1649854275274,MATH 20A,A01,083754,Staff,39,0,40,1
1649854281307,MATH 20B,A01,083756,Staff,29,0,30,1
1649854281307,MATH 20B,A02,083757,Staff,30,0,30,0
1649854287339,MATH 20C,A01,083760,Staff,27,0,30,3
1649854287339,MATH 20C,A02,083761,Staff,30,0,30,0
1649854287339,MATH 20C,B01,083762,Staff,30,0,30,0
1649854287339,MATH 20C,B02,083763,Staff,30,0,30,0
1649854293369,MATH 20D,A01,083765,Staff,24,0,30,6
1649854293369,MATH 20D,A02,083766,Staff,30,0,30,0
1649854293369,MATH 20D,A03,083767,Staff,30,0,30,0
1649854299400,MATH 20E,A01,083771,Staff,21,0,30,9
1649854299400,MATH 20E,A02,083772,Staff,29,0,30,1
1649854299400,MATH 20E,B01,083773,Staff,25,0,30,5
1649854299400,MATH 20E,B02,083774,Staff,30,0,30,0
1649854305433,MATH 103A,A01,083777,Staff,5,0,30,25
1649854305433,MATH 103A,A02,083778,Staff,23,0,30,7
1649854305433,MATH 103A,B01,083779,Staff,17,0,30,13
1649854305433,MATH 103A,B02,083780,Staff,27,0,30,3
1649854311461,MATH 105,A01,085443,Staff,15,0,30,15
1649854317491,MATH 109,A01,083213,Anzaldo; Leesa B,28,0,30,2
1649854317491,MATH 109,A02,083214,Anzaldo; Leesa B,24,0,30,6
1649854317491,MATH 109,B01,083215,Anzaldo; Leesa B,28,0,30,2
1649854317491,MATH 109,B02,083216,Anzaldo; Leesa B,26,0,30,4
1649854323526,MATH 142A,A01,083219,Chow; Bennett,11,0,30,19
1649854323526,MATH 142A,A02,083220,Chow; Bennett,28,0,30,2
1649854323526,MATH 142A,B01,083221,Chow; Bennett,16,0,30,14
1649854323526,MATH 142A,B02,083222,Chow; Bennett,27,0,30,3
1649854329556,MATH 193A,A01,083224,Staff,0,0,30,30
1649854329556,MATH 193A,A02,083225,Staff,13,0,30,17
1649854329556,MATH 193A,A03,083781,Staff,28,0,30,2
1649854329556,MATH 193A,A04,083782,Staff,28,0,30,2
1649854335581,MATH 197,001,091859,McAuley; Julian John,9999,0,9999,0
1649854341684,COGS 9,A01,083615,Staff,46,0,60,14
1649854347709,COGS 11,A01,083617,Boyle; Mary E. T.,36,0,40,4
1649854353735,COGS 13,A01,083071,Staff,21,0,40,19
1649854359760,COGS 14A,A01,092681,Staff,98,0,100,2
1649854365791,COGS 14B,A01,083073,Cheng; Tzu-Han,39,0,50,11
1649854371818,COGS 17,A01,092677,Staff,74,0,75,1
1649854377844,COGS 100,A01,083619,Staff,34,0,60,26
1649854383875,COGS 101A,A01,083621,Davis; Joshua Daniel,34,0,60,26
1649854389907,COGS 101B,A01,091572,Staff,47,0,60,13
1649854395935,COGS 101C,A01,083625,Delgado; Tania,25,0,30,5
1649854401960,COGS 107A,A01,083627,Boyle; Mary E. T.,41,0,60,19
1649854407985,COGS 118A,A01,083075,Staff,34,0,60,26
1649854414027,CSE 3,A50,083646,Miranda; Gregory Joseph,32,0,38,6
1649854414027,CSE 3,A51,083647,Miranda; Gregory Joseph,37,0,37,0
1649854420053,CSE 8A,A50,083650,Miranda; Gregory Joseph,30,0,40,10
1649854426083,CSE 11,A01,083080,Cao; Yingjun,10,0,40,30
1649854432117,CSE 12,A01,083652,Staff,84,0,100,16
1649854438141,CSE 15L,A01,083654,Staff,39,0,50,11
1649854438141,CSE 15L,A02,083655,Staff,49,0,50,1
1649854444167,CSE 20,A01,083657,Staff,73,0,80,7
1649854450191,CSE 30,A01,083084,Eldon; John,15,0,40,25
1649854456219,CSE 100,A01,083659,Cao; Yingjun,15,0,50,35
1649854462243,CSE 134B,A01,083661,Powell; Thomas Allan,0,3,65,65
1649854468266,CSE 140,A01,083663,Staff,55,0,75,20
1649854474298,CSE 140L,A01,083088,Eldon; John,51,0,75,24
1649854480322,CSE 175,A01,083665,Kumar; Rakesh,16,0,25,9
1649854486348,CSE 190,A00,092507,Staff,15,0,15,0
1649854492379,ECE 45,A01,083139,Staff,34,0,40,6
1649854498405,ECE 65,A50,083695,Staff,22,0,30,8
1649854504435,ECE 109,A01,091882,Touri; Behrouz,66,0,70,4
1649854510462,ECE 180,A00,083140,Abi Samra; Nicholas Camill,29,0,30,1
1649854510462,ECE 180,B00,083141,Abi Samra; Nicholas Camill,17,0,30,13
1649854516498,MATH 10A,A01,083735,Patchell; Gregory David,26,0,30,4
1649854516498,MATH 10A,A02,083736,Patchell; Gregory David,30,0,30,0
1649854516498,MATH 10A,A03,083737,Patchell; Gregory David,30,0,30,0
1649854522531,MATH 10B,A01,083207,Staff,21,0,30,9
1649854522531,MATH 10B,A02,083208,Staff,28,0,30,2
1649854522531,MATH 10B,B01,083739,Staff,27,0,30,3
1649854522531,MATH 10B,B02,083740,Staff,30,0,30,0
1649854528556,MATH 18,A01,083743,Staff,26,0,30,4
1649854528556,MATH 18,A02,083744,Staff,30,0,30,0
1649854528556,MATH 18,A03,083745,Staff,30,0,30,0
1649854528556,MATH 18,A04,083746,Staff,30,0,30,0
1649854528556,MATH 18,B01,083748,Staff,24,0,30,6
1649854528556,MATH 18,B02,083749,Staff,29,0,30,1
1649854528556,MATH 18,B03,083750,Staff,30,0,30,0
1649854528556,MATH 18,B04,083751,Staff,29,0,30,1
1649854534592,MATH 20A,A01,083754,Staff,39,0,40,1
1649854540618,MATH 20B,A01,083756,Staff,29,0,30,1
1649854540618,MATH 20B,A02,083757,Staff,30,0,30,0
1649854546648,MATH 20C,A01,083760,Staff,27,0,30,3
1649854546648,MATH 20C,A02,083761,Staff,30,0,30,0
1649854546648,MATH 20C,B01,083762,Staff,30,0,30,0
1649854546648,MATH 20C,B02,083763,Staff,30,0,30,0
1649854552681,MATH 20D,A01,083765,Staff,24,0,30,6
1649854552681,MATH 20D,A02,083766,Staff,30,0,30,0
1649854552681,MATH 20D,A03,083767,Staff,30,0,30,0
1649854558710,MATH 20E,A01,083771,Staff,21,0,30,9
1649854558710,MATH 20E,A02,083772,Staff,29,0,30,1
1649854558710,MATH 20E,B01,083773,Staff,25,0,30,5
1649854558710,MATH 20E,B02,083774,Staff,30,0,30,0
1649854564738,MATH 103A,A01,083777,Staff,5,0,30,25
1649854564738,MATH 103A,A02,083778,Staff,23,0,30,7
1649854564738,MATH 103A,B01,083779,Staff,17,0,30,13
1649854564738,MATH 103A,B02,083780,Staff,27,0,30,3
1649854570857,MATH 105,A01,085443,Staff,15,0,30,15
1649854576887,MATH 109,A01,083213,Anzaldo; Leesa B,28,0,30,2
1649854576887,MATH 109,A02,083214,Anzaldo; Leesa B,24,0,30,6
1649854576887,MATH 109,B01,083215,Anzaldo; Leesa B,28,0,30,2
1649854576887,MATH 109,B02,083216,Anzaldo; Leesa B,26,0,30,4
1649854582912,MATH 142A,A01,083219,Chow; Bennett,11,0,30,19
1649854582912,MATH 142A,A02,083220,Chow; Bennett,28,0,30,2
1649854582912,MATH 142A,B01,083221,Chow; Bennett,16,0,30,14
1649854582912,MATH 142A,B02,083222,Chow; Bennett,27,0,30,3
1649854588942,MATH 193A,A01,083224,Staff,0,0,30,30
1649854588942,MATH 193A,A02,083225,Staff,13,0,30,17
1649854588942,MATH 193A,A03,083781,Staff,28,0,30,2
1649854588942,MATH 193A,A04,083782,Staff,28,0,30,2
1649854594971,MATH 197,001,091859,McAuley; Julian John,9999,0,9999,0
1649854601040,COGS 9,A01,083615,Staff,46,0,60,14
1649854607069,COGS 11,A01,083617,Boyle; Mary E. T.,36,0,40,4
1649854613093,COGS 13,A01,083071,Staff,21,0,40,19
1649854619118,COGS 14A,A01,092681,Staff,98,0,100,2
1649854625145,COGS 14B,A01,083073,Cheng; Tzu-Han,39,0,50,11
1649854631171,COGS 17,A01,092677,Staff,74,0,75,1
1649854637202,COGS 100,A01,083619,Staff,34,0,60,26
1649854643252,COGS 101A,A01,083621,Davis; Joshua Daniel,34,0,60,26
1649854649280,COGS 101B,A01,091572,Staff,47,0,60,13
1649854655317,COGS 101C,A01,083625,Delgado; Tania,25,0,30,5
1649854661344,COGS 107A,A01,083627,Boyle; Mary E. T.,41,0,60,19
1649854667378,COGS 118A,A01,083075,Staff,34,0,60,26
1649854673409,CSE 3,A50,083646,Miranda; Gregory Joseph,32,0,38,6
1649854673409,CSE 3,A51,083647,Miranda; Gregory Joseph,37,0,37,0
1649854679447,CSE 8A,A50,083650,Miranda; Gregory Joseph,30,0,40,10
1649854685476,CSE 11,A01,083080,Cao; Yingjun,10,0,40,30
1649854691500,CSE 12,A01,083652,Staff,84,0,100,16
1649854697522,CSE 15L,A01,083654,Staff,39,0,50,11
1649854697522,CSE 15L,A02,083655,Staff,49,0,50,1
1649854703552,CSE 20,A01,083657,Staff,73,0,80,7
1649854709583,CSE 30,A01,083084,Eldon; John,15,0,40,25
1649854715606,CSE 100,A01,083659,Cao; Yingjun,15,0,50,35
1649854721632,CSE 134B,A01,083661,Powell; Thomas Allan,0,3,65,65
1649854727657,CSE 140,A01,083663,Staff,55,0,75,20
1649854733682,CSE 140L,A01,083088,Eldon; John,51,0,75,24
1649854739724,CSE 175,A01,083665,Kumar; Rakesh,16,0,25,9
1649854745749,CSE 190,A00,092507,Staff,15,0,15,0
1649854751777,ECE 45,A01,083139,Staff,34,0,40,6
1649854757803,ECE 65,A50,083695,Staff,22,0,30,8
1649854763835,ECE 109,A01,091882,Touri; Behrouz,66,0,70,4
1649854769861,ECE 180,A00,083140,Abi Samra; Nicholas Camill,29,0,30,1
1649854769861,ECE 180,B00,083141,Abi Samra; Nicholas Camill,17,0,30,13
1649854775886,MATH 10A,A01,083735,Patchell; Gregory David,26,0,30,4
1649854775886,MATH 10A,A02,083736,Patchell; Gregory David,30,0,30,0
1649854775886,MATH 10A,A03,083737,Patchell; Gregory David,30,0,30,0
1649854781911,MATH 10B,A01,083207,Staff,21,0,30,9
1649854781911,MATH 10B,A02,083208,Staff,28,0,30,2
1649854781911,MATH 10B,B01,083739,Staff,27,0,30,3
1649854781911,MATH 10B,B02,083740,Staff,30,0,30,0
1649854787940,MATH 18,A01,083743,Staff,26,0,30,4
1649854787940,MATH 18,A02,083744,Staff,30,0,30,0
1649854787940,MATH 18,A03,083745,Staff,30,0,30,0
1649854787940,MATH 18,A04,083746,Staff,30,0,30,0
1649854787940,MATH 18,B01,083748,Staff,24,0,30,6
1649854787940,MATH 18,B02,083749,Staff,29,0,30,1
1649854787940,MATH 18,B03,083750,Staff,30,0,30,0
1649854787940,MATH 18,B04,083751,Staff,29,0,30,1
1649854793964,MATH 20A,A01,083754,Staff,39,0,40,1
1649854799993,MATH 20B,A01,083756,Staff,29,0,30,1
1649854799993,MATH 20B,A02,083757,Staff,30,0,30,0
1649854806019,MATH 20C,A01,083760,Staff,27,0,30,3
1649854806019,MATH 20C,A02,083761,Staff,30,0,30,0
1649854806019,MATH 20C,B01,083762,Staff,30,0,30,0
1649854806019,MATH 20C,B02,083763,Staff,30,0,30,0
1649854812048,MATH 20D,A01,083765,Staff,24,0,30,6
1649854812048,MATH 20D,A02,083766,Staff,30,0,30,0
1649854812048,MATH 20D,A03,083767,Staff,30,0,30,0
1649854818079,MATH 20E,A01,083771,Staff,21,0,30,9
1649854818079,MATH 20E,A02,083772,Staff,29,0,30,1
1649854818079,MATH 20E,B01,083773,Staff,25,0,30,5
1649854818079,MATH 20E,B02,083774,Staff,30,0,30,0
1649854824109,MATH 103A,A01,083777,Staff,5,0,30,25
1649854824109,MATH 103A,A02,083778,Staff,23,0,30,7
1649854824109,MATH 103A,B01,083779,Staff,17,0,30,13
1649854824109,MATH 103A,B02,083780,Staff,27,0,30,3
1649854830134,MATH 105,A01,085443,Staff,15,0,30,15
1649854836166,MATH 109,A01,083213,Anzaldo; Leesa B,28,0,30,2
1649854836166,MATH 109,A02,083214,Anzaldo; Leesa B,24,0,30,6
1649854836166,MATH 109,B01,083215,Anzaldo; Leesa B,28,0,30,2
1649854836166,MATH 109,B02,083216,Anzaldo; Leesa B,26,0,30,4
1649854842191,MATH 142A,A01,083219,Chow; Bennett,11,0,30,19
1649854842191,MATH 142A,A02,083220,Chow; Bennett,28,0,30,2
1649854842191,MATH 142A,B01,083221,Chow; Bennett,16,0,30,14
1649854842191,MATH 142A,B02,083222,Chow; Bennett,27,0,30,3
1649854848220,MATH 193A,A01,083224,Staff,0,0,30,30
1649854848220,MATH 193A,A02,083225,Staff,13,0,30,17
1649854848220,MATH 193A,A03,083781,Staff,28,0,30,2
1649854848220,MATH 193A,A04,083782,Staff,28,0,30,2
1649854854245,MATH 197,001,091859,McAuley; Julian John,9999,0,9999,0
1649854860306,COGS 9,A01,083615,Staff,46,0,60,14
1649854866332,COGS 11,A01,083617,Boyle; Mary E. T.,36,0,40,4
1649854872357,COGS 13,A01,083071,Staff,21,0,40,19
1649854878381,COGS 14A,A01,092681,Staff,98,0,100,2
1649854884415,COGS 14B,A01,083073,Cheng; Tzu-Han,39,0,50,11
1649854890444,COGS 17,A01,092677,Staff,74,0,75,1
1649854896477,COGS 100,A01,083619,Staff,34,0,60,26
1649854902503,COGS 101A,A01,083621,Davis; Joshua Daniel,34,0,60,26
1649854908536,COGS 101B,A01,091572,Staff,47,0,60,13
1649854914562,COGS 101C,A01,083625,Delgado; Tania,25,0,30,5
1649854920588,COGS 107A,A01,083627,Boyle; Mary E. T.,41,0,60,19
1649854926618,COGS 118A,A01,083075,Staff,34,0,60,26
1649854932648,CSE 3,A50,083646,Miranda; Gregory Joseph,32,0,38,6
1649854932648,CSE 3,A51,083647,Miranda; Gregory Joseph,37,0,37,0
1649854938676,CSE 8A,A50,083650,Miranda; Gregory Joseph,30,0,40,10
1649854944704,CSE 11,A01,083080,Cao; Yingjun,10,0,40,30
1649854950733,CSE 12,A01,083652,Staff,84,0,100,16
1649854956758,CSE 15L,A01,083654,Staff,39,0,50,11
1649854956758,CSE 15L,A02,083655,Staff,49,0,50,1
1649854962786,CSE 20,A01,083657,Staff,73,0,80,7
1649854968814,CSE 30,A01,083084,Eldon; John,15,0,40,25
1649854974838,CSE 100,A01,083659,Cao; Yingjun,15,0,50,35
1649854980867,CSE 134B,A01,083661,Powell; Thomas Allan,0,3,65,65
1649854986892,CSE 140,A01,083663,Staff,55,0,75,20
1649854992924,CSE 140L,A01,083088,Eldon; John,51,0,75,24
1649854998957,CSE 175,A01,083665,Kumar; Rakesh,16,0,25,9
1649855004980,CSE 190,A00,092507,Staff,15,0,15,0
1649855011020,ECE 45,A01,083139,Staff,34,0,40,6
1649855017046,ECE 65,A50,083695,Staff,22,0,30,8
1649855023071,ECE 109,A01,091882,Touri; Behrouz,66,0,70,4
1649855029095,ECE 180,A00,083140,Abi Samra; Nicholas Camill,29,0,30,1
1649855029095,ECE 180,B00,083141,Abi Samra; Nicholas Camill,17,0,30,13
1649855035127,MATH 10A,A01,083735,Patchell; Gregory David,26,0,30,4
1649855035127,MATH 10A,A02,083736,Patchell; Gregory David,30,0,30,0
1649855035127,MATH 10A,A03,083737,Patchell; Gregory David,30,0,30,0
1649855041155,MATH 10B,A01,083207,Staff,21,0,30,9
1649855041155,MATH 10B,A02,083208,Staff,28,0,30,2
1649855041155,MATH 10B,B01,083739,Staff,27,0,30,3
1649855041155,MATH 10B,B02,083740,Staff,30,0,30,0
1649855047191,MATH 18,A01,083743,Staff,26,0,30,4
1649855047191,MATH 18,A02,083744,Staff,30,0,30,0
1649855047191,MATH 18,A03,083745,Staff,30,0,30,0
1649855047191,MATH 18,A04,083746,Staff,30,0,30,0
1649855047191,MATH 18,B01,083748,Staff,24,0,30,6
1649855047191,MATH 18,B02,083749,Staff,29,0,30,1
1649855047191,MATH 18,B03,083750,Staff,30,0,30,0
1649855047191,MATH 18,B04,083751,Staff,29,0,30,1
1649855053215,MATH 20A,A01,083754,Staff,39,0,40,1
1649855059251,MATH 20B,A01,083756,Staff,29,0,30,1
1649855059251,MATH 20B,A02,083757,Staff,30,0,30,0
1649855065279,MATH 20C,A01,083760,Staff,27,0,30,3
1649855065279,MATH 20C,A02,083761,Staff,30,0,30,0
1649855065279,MATH 20C,B01,083762,Staff,30,0,30,0
1649855065279,MATH 20C,B02,083763,Staff,30,0,30,0
1649855071302,MATH 20D,A01,083765,Staff,24,0,30,6
1649855071302,MATH 20D,A02,083766,Staff,30,0,30,0
1649855071302,MATH 20D,A03,083767,Staff,30,0,30,0
1649855077326,MATH 20E,A01,083771,Staff,21,0,30,9
1649855077326,MATH 20E,A02,083772,Staff,29,0,30,1
1649855077326,MATH 20E,B01,083773,Staff,25,0,30,5
1649855077326,MATH 20E,B02,083774,Staff,30,0,30,0
1649855083350,MATH 103A,A01,083777,Staff,5,0,30,25
1649855083350,MATH 103A,A02,083778,Staff,23,0,30,7
1649855083350,MATH 103A,B01,083779,Staff,17,0,30,13
1649855083350,MATH 103A,B02,083780,Staff,27,0,30,3
1649855089376,MATH 105,A01,085443,Staff,15,0,30,15
1649855095401,MATH 109,A01,083213,Anzaldo; Leesa B,28,0,30,2
1649855095401,MATH 109,A02,083214,Anzaldo; Leesa B,24,0,30,6
1649855095401,MATH 109,B01,083215,Anzaldo; Leesa B,28,0,30,2
1649855095401,MATH 109,B02,083216,Anzaldo; Leesa B,26,0,30,4
1649855101429,MATH 142A,A01,083219,Chow; Bennett,11,0,30,19
1649855101429,MATH 142A,A02,083220,Chow; Bennett,28,0,30,2
1649855101429,MATH 142A,B01,083221,Chow; Bennett,16,0,30,14
1649855101429,MATH 142A,B02,083222,Chow; Bennett,27,0,30,3
1649855107452,MATH 193A,A01,083224,Staff,0,0,30,30
1649855107452,MATH 193A,A02,083225,Staff,13,0,30,17
1649855107452,MATH 193A,A03,083781,Staff,28,0,30,2
1649855107452,MATH 193A,A04,083782,Staff,28,0,30,2
1649855113475,MATH 197,001,091859,McAuley; Julian John,9999,0,9999,0
1649855119546,COGS 9,A01,083615,Staff,46,0,60,14
1649855125575,COGS 11,A01,083617,Boyle; Mary E. T.,36,0,40,4
1649855131602,COGS 13,A01,083071,Staff,21,0,40,19
1649855137630,COGS 14A,A01,092681,Staff,98,0,100,2
1649855143655,COGS 14B,A01,083073,Cheng; Tzu-Han,39,0,50,11
1649855149685,COGS 17,A01,092677,Staff,74,0,75,1
1649855155708,COGS 100,A01,083619,Staff,34,0,60,26
1649855161824,COGS 101A,A01,083621,Davis; Joshua Daniel,34,0,60,26
1649855167851,COGS 101B,A01,091572,Staff,47,0,60,13
1649855173881,COGS 101C,A01,083625,Delgado; Tania,25,0,30,5
1649855179905,COGS 107A,A01,083627,Boyle; Mary E. T.,41,0,60,19
1649855185928,COGS 118A,A01,083075,Staff,34,0,60,26
1649855191958,CSE 3,A50,083646,Miranda; Gregory Joseph,32,0,38,6
1649855191958,CSE 3,A51,083647,Miranda; Gregory Joseph,37,0,37,0
1649855197985,CSE 8A,A50,083650,Miranda; Gregory Joseph,30,0,40,10
1649855204013,CSE 11,A01,083080,Cao; Yingjun,10,0,40,30
1649855210039,CSE 12,A01,083652,Staff,84,0,100,16
1649855216069,CSE 15L,A01,083654,Staff,39,0,50,11
1649855216069,CSE 15L,A02,083655,Staff,49,0,50,1
1649855222097,CSE 20,A01,083657,Staff,73,0,80,7
1649855228127,CSE 30,A01,083084,Eldon; John,15,0,40,25
1649855234154,CSE 100,A01,083659,Cao; Yingjun,15,0,50,35
1649855240183,CSE 134B,A01,083661,Powell; Thomas Allan,0,3,65,65
1649855246211,CSE 140,A01,083663,Staff,55,0,75,20
1649855252236,CSE 140L,A01,083088,Eldon; John,51,0,75,24
1649855258261,CSE 175,A01,083665,Kumar; Rakesh,16,0,25,9
1649855264285,CSE 190,A00,092507,Staff,15,0,15,0
1649855270318,ECE 45,A01,083139,Staff,34,0,40,6
1649855276342,ECE 65,A50,083695,Staff,22,0,30,8
1649855282370,ECE 109,A01,091882,Touri; Behrouz,66,0,70,4
1649855288402,ECE 180,A00,083140,Abi Samra; Nicholas Camill,29,0,30,1
1649855288402,ECE 180,B00,083141,Abi Samra; Nicholas Camill,17,0,30,13
1649855294437,MATH 10A,A01,083735,Patchell; Gregory David,26,0,30,4
1649855294437,MATH 10A,A02,083736,Patchell; Gregory David,30,0,30,0
1649855294437,MATH 10A,A03,083737,Patchell; Gregory David,30,0,30,0
1649855300465,MATH 10B,A01,083207,Staff,21,0,30,9
1649855300465,MATH 10B,A02,083208,Staff,28,0,30,2
1649855300465,MATH 10B,B01,083739,Staff,27,0,30,3
1649855300465,MATH 10B,B02,083740,Staff,30,0,30,0
1649855306490,MATH 18,A01,083743,Staff,26,0,30,4
1649855306490,MATH 18,A02,083744,Staff,30,0,30,0
1649855306490,MATH 18,A03,083745,Staff,30,0,30,0
1649855306490,MATH 18,A04,083746,Staff,30,0,30,0
1649855306490,MATH 18,B01,083748,Staff,24,0,30,6
1649855306490,MATH 18,B02,083749,Staff,29,0,30,1
1649855306490,MATH 18,B03,083750,Staff,30,0,30,0
1649855306490,MATH 18,B04,083751,Staff,29,0,30,1
1649855312517,MATH 20A,A01,083754,Staff,39,0,40,1
1649855318542,MATH 20B,A01,083756,Staff,29,0,30,1
1649855318542,MATH 20B,A02,083757,Staff,30,0,30,0
1649855324566,MATH 20C,A01,083760,Staff,27,0,30,3
1649855324566,MATH 20C,A02,083761,Staff,30,0,30,0
1649855324566,MATH 20C,B01,083762,Staff,30,0,30,0
1649855324566,MATH 20C,B02,083763,Staff,30,0,30,0
1649855330591,MATH 20D,A01,083765,Staff,24,0,30,6
1649855330591,MATH 20D,A02,083766,Staff,30,0,30,0
1649855330591,MATH 20D,A03,083767,Staff,30,0,30,0
1649855336617,MATH 20E,A01,083771,Staff,21,0,30,9
1649855336617,MATH 20E,A02,083772,Staff,29,0,30,1
1649855336617,MATH 20E,B01,083773,Staff,25,0,30,5
1649855336617,MATH 20E,B02,083774,Staff,30,0,30,0
1649855342649,MATH 103A,A01,083777,Staff,5,0,30,25
1649855342649,MATH 103A,A02,083778,Staff,23,0,30,7
1649855342649,MATH 103A,B01,083779,Staff,17,0,30,13
1649855342649,MATH 103A,B02,083780,Staff,27,0,30,3
1649855348685,MATH 105,A01,085443,Staff,15,0,30,15
1649855354712,MATH 109,A01,083213,Anzaldo; Leesa B,28,0,30,2
1649855354712,MATH 109,A02,083214,Anzaldo; Leesa B,24,0,30,6
1649855354712,MATH 109,B01,083215,Anzaldo; Leesa B,28,0,30,2
1649855354712,MATH 109,B02,083216,Anzaldo; Leesa B,26,0,30,4
1649855360743,MATH 142A,A01,083219,Chow; Bennett,11,0,30,19
1649855360743,MATH 142A,A02,083220,Chow; Bennett,28,0,30,2
1649855360743,MATH 142A,B01,083221,Chow; Bennett,16,0,30,14
1649855360743,MATH 142A,B02,083222,Chow; Bennett,27,0,30,3
1649855366767,MATH 193A,A01,083224,Staff,0,0,30,30
1649855366767,MATH 193A,A02,083225,Staff,13,0,30,17
1649855366767,MATH 193A,A03,083781,Staff,28,0,30,2
1649855366767,MATH 193A,A04,083782,Staff,28,0,30,2
1649855372797,MATH 197,001,091859,McAuley; Julian John,9999,0,9999,0
1649855378861,COGS 9,A01,083615,Staff,46,0,60,14
1649855384886,COGS 11,A01,083617,Boyle; Mary E. T.,36,0,40,4
1649855390925,COGS 13,A01,083071,Staff,21,0,40,19
1649855396953,COGS 14A,A01,092681,Staff,98,0,100,2
1649855402984,COGS 14B,A01,083073,Cheng; Tzu-Han,39,0,50,11
1649855409008,COGS 17,A01,092677,Staff,74,0,75,1
1649855415033,COGS 100,A01,083619,Staff,34,0,60,26
1649855421059,COGS 101A,A01,083621,Davis; Joshua Daniel,34,0,60,26
1649855427088,COGS 101B,A01,091572,Staff,47,0,60,13
1649855433121,COGS 101C,A01,083625,Delgado; Tania,25,0,30,5
1649855439146,COGS 107A,A01,083627,Boyle; Mary E. T.,41,0,60,19
1649855445175,COGS 118A,A01,083075,Staff,34,0,60,26
1649855451207,CSE 3,A50,083646,Miranda; Gregory Joseph,32,0,38,6
1649855451207,CSE 3,A51,083647,Miranda; Gregory Joseph,37,0,37,0
1649855457231,CSE 8A,A50,083650,Miranda; Gregory Joseph,30,0,40,10
1649855463258,CSE 11,A01,083080,Cao; Yingjun,10,0,40,30
1649855469289,CSE 12,A01,083652,Staff,84,0,100,16
1649855475319,CSE 15L,A01,083654,Staff,39,0,50,11
1649855475319,CSE 15L,A02,083655,Staff,49,0,50,1
1649855481348,CSE 20,A01,083657,Staff,73,0,80,7
1649855487379,CSE 30,A01,083084,Eldon; John,15,0,40,25
1649855493402,CSE 100,A01,083659,Cao; Yingjun,15,0,50,35
1649855499436,CSE 134B,A01,083661,Powell; Thomas Allan,0,3,65,65
1649855505463,CSE 140,A01,083663,Staff,55,0,75,20
1649855511488,CSE 140L,A01,083088,Eldon; John,51,0,75,24
1649855517515,CSE 175,A01,083665,Kumar; Rakesh,16,0,25,9
1649855523555,CSE 190,A00,092507,Staff,15,0,15,0
1649855529584,ECE 45,A01,083139,Staff,34,0,40,6
1649855535615,ECE 65,A50,083695,Staff,22,0,30,8
1649855541643,ECE 109,A01,091882,Touri; Behrouz,66,0,70,4
1649855547669,ECE 180,A00,083140,Abi Samra; Nicholas Camill,29,0,30,1
1649855547669,ECE 180,B00,083141,Abi Samra; Nicholas Camill,17,0,30,13
1649855553699,MATH 10A,A01,083735,Patchell; Gregory David,26,0,30,4
1649855553699,MATH 10A,A02,083736,Patchell; Gregory David,30,0,30,0
1649855553699,MATH 10A,A03,083737,Patchell; Gregory David,30,0,30,0
1649855559729,MATH 10B,A01,083207,Staff,21,0,30,9
1649855559729,MATH 10B,A02,083208,Staff,28,0,30,2
1649855559729,MATH 10B,B01,083739,Staff,27,0,30,3
1649855559729,MATH 10B,B02,083740,Staff,30,0,30,0
1649855565763,MATH 18,A01,083743,Staff,26,0,30,4
1649855565763,MATH 18,A02,083744,Staff,30,0,30,0
1649855565763,MATH 18,A03,083745,Staff,30,0,30,0
1649855565763,MATH 18,A04,083746,Staff,30,0,30,0
1649855565763,MATH 18,B01,083748,Staff,24,0,30,6
1649855565763,MATH 18,B02,083749,Staff,29,0,30,1
1649855565763,MATH 18,B03,083750,Staff,30,0,30,0
1649855565763,MATH 18,B04,083751,Staff,29,0,30,1
1649855571789,MATH 20A,A01,083754,Staff,39,0,40,1
1649855577814,MATH 20B,A01,083756,Staff,29,0,30,1
1649855577814,MATH 20B,A02,083757,Staff,30,0,30,0
1649855583845,MATH 20C,A01,083760,Staff,27,0,30,3
1649855583845,MATH 20C,A02,083761,Staff,30,0,30,0
1649855583845,MATH 20C,B01,083762,Staff,30,0,30,0
1649855583845,MATH 20C,B02,083763,Staff,30,0,30,0
1649855589867,MATH 20D,A01,083765,Staff,24,0,30,6
1649855589867,MATH 20D,A02,083766,Staff,30,0,30,0
1649855589867,MATH 20D,A03,083767,Staff,30,0,30,0
1649855595894,MATH 20E,A01,083771,Staff,21,0,30,9
1649855595894,MATH 20E,A02,083772,Staff,29,0,30,1
1649855595894,MATH 20E,B01,083773,Staff,25,0,30,5
1649855595894,MATH 20E,B02,083774,Staff,30,0,30,0
1649855601925,MATH 103A,A01,083777,Staff,5,0,30,25
1649855601925,MATH 103A,A02,083778,Staff,23,0,30,7
1649855601925,MATH 103A,B01,083779,Staff,17,0,30,13
1649855601925,MATH 103A,B02,083780,Staff,27,0,30,3
1649855607955,MATH 105,A01,085443,Staff,15,0,30,15
1649855613980,MATH 109,A01,083213,Anzaldo; Leesa B,28,0,30,2
1649855613980,MATH 109,A02,083214,Anzaldo; Leesa B,24,0,30,6
1649855613980,MATH 109,B01,083215,Anzaldo; Leesa B,28,0,30,2
1649855613980,MATH 109,B02,083216,Anzaldo; Leesa B,26,0,30,4
1649855620011,MATH 142A,A01,083219,Chow; Bennett,11,0,30,19
1649855620011,MATH 142A,A02,083220,Chow; Bennett,28,0,30,2
1649855620011,MATH 142A,B01,083221,Chow; Bennett,16,0,30,14
1649855620011,MATH 142A,B02,083222,Chow; Bennett,27,0,30,3
1649855626042,MATH 193A,A01,083224,Staff,0,0,30,30
1649855626042,MATH 193A,A02,083225,Staff,13,0,30,17
1649855626042,MATH 193A,A03,083781,Staff,28,0,30,2
1649855626042,MATH 193A,A04,083782,Staff,28,0,30,2
1649855632068,MATH 197,001,091859,McAuley; Julian John,9999,0,9999,0
1649855638129,COGS 9,A01,083615,Staff,46,0,60,14
1649855644155,COGS 11,A01,083617,Boyle; Mary E. T.,36,0,40,4
1649855650180,COGS 13,A01,083071,Staff,21,0,40,19
1649855656205,COGS 14A,A01,092681,Staff,98,0,100,2
1649855662229,COGS 14B,A01,083073,Cheng; Tzu-Han,39,0,50,11
1649855668253,COGS 17,A01,092677,Staff,74,0,75,1
1649855674276,COGS 100,A01,083619,Staff,34,0,60,26
1649855680301,COGS 101A,A01,083621,Davis; Joshua Daniel,34,0,60,26
1649855686324,COGS 101B,A01,091572,Staff,47,0,60,13
1649855692348,COGS 101C,A01,083625,Delgado; Tania,25,0,30,5
1649855698371,COGS 107A,A01,083627,Boyle; Mary E. T.,41,0,60,19
1649855704411,COGS 118A,A01,083075,Staff,34,0,60,26
1649855710437,CSE 3,A50,083646,Miranda; Gregory Joseph,32,0,38,6
1649855710437,CSE 3,A51,083647,Miranda; Gregory Joseph,37,0,37,0
1649855716461,CSE 8A,A50,083650,Miranda; Gregory Joseph,30,0,40,10
1649855722488,CSE 11,A01,083080,Cao; Yingjun,10,0,40,30
1649855728525,CSE 12,A01,083652,Staff,84,0,100,16
1649855734551,CSE 15L,A01,083654,Staff,39,0,50,11
1649855734551,CSE 15L,A02,083655,Staff,49,0,50,1
1649855740580,CSE 20,A01,083657,Staff,73,0,80,7
1649855746607,CSE 30,A01,083084,Eldon; John,15,0,40,25
1649855752632,CSE 100,A01,083659,Cao; Yingjun,15,0,50,35
1649855758731,CSE 134B,A01,083661,Powell; Thomas Allan,0,3,65,65
1649855764757,CSE 140,A01,083663,Staff,55,0,75,20
1649855770783,CSE 140L,A01,083088,Eldon; John,51,0,75,24
1649855776808,CSE 175,A01,083665,Kumar; Rakesh,16,0,25,9
1649855782833,CSE 190,A00,092507,Staff,15,0,15,0
1649855788860,ECE 45,A01,083139,Staff,34,0,40,6
1649855794886,ECE 65,A50,083695,Staff,22,0,30,8
1649855800911,ECE 109,A01,091882,Touri; Behrouz,66,0,70,4
1649855806943,ECE 180,A00,083140,Abi Samra; Nicholas Camill,29,0,30,1
1649855806943,ECE 180,B00,083141,Abi Samra; Nicholas Camill,17,0,30,13
1649855812973,MATH 10A,A01,083735,Patchell; Gregory David,26,0,30,4
1649855812973,MATH 10A,A02,083736,Patchell; Gregory David,30,0,30,0
1649855812973,MATH 10A,A03,083737,Patchell; Gregory David,30,0,30,0
1649855818997,MATH 10B,A01,083207,Staff,21,0,30,9
1649855818997,MATH 10B,A02,083208,Staff,28,0,30,2
1649855818997,MATH 10B,B01,083739,Staff,27,0,30,3
1649855818997,MATH 10B,B02,083740,Staff,30,0,30,0
1649855825026,MATH 18,A01,083743,Staff,26,0,30,4
1649855825026,MATH 18,A02,083744,Staff,30,0,30,0
1649855825026,MATH 18,A03,083745,Staff,30,0,30,0
1649855825026,MATH 18,A04,083746,Staff,30,0,30,0
1649855825026,MATH 18,B01,083748,Staff,24,0,30,6
1649855825026,MATH 18,B02,083749,Staff,29,0,30,1
1649855825026,MATH 18,B03,083750,Staff,30,0,30,0
1649855825026,MATH 18,B04,083751,Staff,29,0,30,1
1649855831049,MATH 20A,A01,083754,Staff,39,0,40,1
1649855837081,MATH 20B,A01,083756,Staff,29,0,30,1
1649855837081,MATH 20B,A02,083757,Staff,30,0,30,0
1649855843107,MATH 20C,A01,083760,Staff,27,0,30,3
1649855843107,MATH 20C,A02,083761,Staff,30,0,30,0
1649855843107,MATH 20C,B01,083762,Staff,30,0,30,0
1649855843107,MATH 20C,B02,083763,Staff,30,0,30,0
1649855849132,MATH 20D,A01,083765,Staff,24,0,30,6
1649855849132,MATH 20D,A02,083766,Staff,30,0,30,0
1649855849132,MATH 20D,A03,083767,Staff,30,0,30,0
1649855855160,MATH 20E,A01,083771,Staff,21,0,30,9
1649855855160,MATH 20E,A02,083772,Staff,29,0,30,1
1649855855160,MATH 20E,B01,083773,Staff,25,0,30,5
1649855855160,MATH 20E,B02,083774,Staff,30,0,30,0
1649855861188,MATH 103A,A01,083777,Staff,5,0,30,25
1649855861188,MATH 103A,A02,083778,Staff,23,0,30,7
1649855861188,MATH 103A,B01,083779,Staff,17,0,30,13
1649855861188,MATH 103A,B02,083780,Staff,27,0,30,3
1649855867213,MATH 105,A01,085443,Staff,15,0,30,15
1649855873239,MATH 109,A01,083213,Anzaldo; Leesa B,28,0,30,2
1649855873239,MATH 109,A02,083214,Anzaldo; Leesa B,24,0,30,6
1649855873239,MATH 109,B01,083215,Anzaldo; Leesa B,28,0,30,2
1649855873239,MATH 109,B02,083216,Anzaldo; Leesa B,26,0,30,4
1649855879280,MATH 142A,A01,083219,Chow; Bennett,11,0,30,19
1649855879280,MATH 142A,A02,083220,Chow; Bennett,28,0,30,2
1649855879280,MATH 142A,B01,083221,Chow; Bennett,16,0,30,14
1649855879280,MATH 142A,B02,083222,Chow; Bennett,27,0,30,3
1649855885309,MATH 193A,A01,083224,Staff,0,0,30,30
1649855885309,MATH 193A,A02,083225,Staff,13,0,30,17
1649855885309,MATH 193A,A03,083781,Staff,28,0,30,2
1649855885309,MATH 193A,A04,083782,Staff,28,0,30,2
1649855891336,MATH 197,001,091859,McAuley; Julian John,9999,0,9999,0
1649855897410,COGS 9,A01,083615,Staff,46,0,60,14
1649855903435,COGS 11,A01,083617,Boyle; Mary E. T.,36,0,40,4
1649855909461,COGS 13,A01,083071,Staff,21,0,40,19
1649855915489,COGS 14A,A01,092681,Staff,98,0,100,2
1649855921521,COGS 14B,A01,083073,Cheng; Tzu-Han,39,0,50,11
1649855927556,COGS 17,A01,092677,Staff,74,0,75,1
1649855933585,COGS 100,A01,083619,Staff,34,0,60,26
1649855939616,COGS 101A,A01,083621,Davis; Joshua Daniel,34,0,60,26
1649855945641,COGS 101B,A01,091572,Staff,47,0,60,13
1649855951665,COGS 101C,A01,083625,Delgado; Tania,25,0,30,5
1649855957694,COGS 107A,A01,083627,Boyle; Mary E. T.,41,0,60,19
1649855963723,COGS 118A,A01,083075,Staff,34,0,60,26
1649855969748,CSE 3,A50,083646,Miranda; Gregory Joseph,32,0,38,6
1649855969748,CSE 3,A51,083647,Miranda; Gregory Joseph,37,0,37,0
1649855975772,CSE 8A,A50,083650,Miranda; Gregory Joseph,30,0,40,10
1649855981797,CSE 11,A01,083080,Cao; Yingjun,10,0,40,30
1649855987827,CSE 12,A01,083652,Staff,84,0,100,16
1649855993856,CSE 15L,A01,083654,Staff,39,0,50,11
1649855993856,CSE 15L,A02,083655,Staff,49,0,50,1
1649855999881,CSE 20,A01,083657,Staff,73,0,80,7
1649856005913,CSE 30,A01,083084,Eldon; John,15,0,40,25
1649856011941,CSE 100,A01,083659,Cao; Yingjun,15,0,50,35
1649856017969,CSE 134B,A01,083661,Powell; Thomas Allan,0,3,65,65
1649856023997,CSE 140,A01,083663,Staff,55,0,75,20
1649856030021,CSE 140L,A01,083088,Eldon; John,51,0,75,24
1649856036047,CSE 175,A01,083665,Kumar; Rakesh,16,0,25,9
1649856042073,CSE 190,A00,092507,Staff,15,0,15,0
1649856048100,ECE 45,A01,083139,Staff,34,0,40,6
1649856054123,ECE 65,A50,083695,Staff,22,0,30,8
1649856060152,ECE 109,A01,091882,Touri; Behrouz,66,0,70,4
1649856066175,ECE 180,A00,083140,Abi Samra; Nicholas Camill,29,0,30,1
1649856066175,ECE 180,B00,083141,Abi Samra; Nicholas Camill,17,0,30,13
1649856072200,MATH 10A,A01,083735,Patchell; Gregory David,26,0,30,4
1649856072200,MATH 10A,A02,083736,Patchell; Gregory David,30,0,30,0
1649856072200,MATH 10A,A03,083737,Patchell; Gregory David,30,0,30,0
1649856078226,MATH 10B,A01,083207,Staff,21,0,30,9
1649856078226,MATH 10B,A02,083208,Staff,28,0,30,2
1649856078226,MATH 10B,B01,083739,Staff,27,0,30,3
1649856078226,MATH 10B,B02,083740,Staff,30,0,30,0
1649856084257,MATH 18,A01,083743,Staff,26,0,30,4
1649856084257,MATH 18,A02,083744,Staff,30,0,30,0
1649856084257,MATH 18,A03,083745,Staff,30,0,30,0
1649856084257,MATH 18,A04,083746,Staff,30,0,30,0
1649856084257,MATH 18,B01,083748,Staff,24,0,30,6
1649856084257,MATH 18,B02,083749,Staff,29,0,30,1
1649856084257,MATH 18,B03,083750,Staff,30,0,30,0
1649856084257,MATH 18,B04,083751,Staff,29,0,30,1
1649856090285,MATH 20A,A01,083754,Staff,39,0,40,1
1649856096309,MATH 20B,A01,083756,Staff,29,0,30,1
1649856096309,MATH 20B,A02,083757,Staff,30,0,30,0
1649856102339,MATH 20C,A01,083760,Staff,27,0,30,3
1649856102339,MATH 20C,A02,083761,Staff,30,0,30,0
1649856102339,MATH 20C,B01,083762,Staff,30,0,30,0
1649856102339,MATH 20C,B02,083763,Staff,30,0,30,0
1649856108364,MATH 20D,A01,083765,Staff,24,0,30,6
1649856108364,MATH 20D,A02,083766,Staff,30,0,30,0
1649856108364,MATH 20D,A03,083767,Staff,30,0,30,0
1649856114389,MATH 20E,A01,083771,Staff,21,0,30,9
1649856114389,MATH 20E,A02,083772,Staff,29,0,30,1
1649856114389,MATH 20E,B01,083773,Staff,25,0,30,5
1649856114389,MATH 20E,B02,083774,Staff,30,0,30,0
1649856120415,MATH 103A,A01,083777,Staff,5,0,30,25
1649856120415,MATH 103A,A02,083778,Staff,23,0,30,7
1649856120415,MATH 103A,B01,083779,Staff,17,0,30,13
1649856120415,MATH 103A,B02,083780,Staff,27,0,30,3
1649856126438,MATH 105,A01,085443,Staff,15,0,30,15
1649856132466,MATH 109,A01,083213,Anzaldo; Leesa B,28,0,30,2
1649856132466,MATH 109,A02,083214,Anzaldo; Leesa B,24,0,30,6
1649856132466,MATH 109,B01,083215,Anzaldo; Leesa B,28,0,30,2
1649856132466,MATH 109,B02,083216,Anzaldo; Leesa B,26,0,30,4
1649856138499,MATH 142A,A01,083219,Chow; Bennett,11,0,30,19
1649856138499,MATH 142A,A02,083220,Chow; Bennett,28,0,30,2
1649856138499,MATH 142A,B01,083221,Chow; Bennett,16,0,30,14
1649856138499,MATH 142A,B02,083222,Chow; Bennett,27,0,30,3
1649856144522,MATH 193A,A01,083224,Staff,0,0,30,30
1649856144522,MATH 193A,A02,083225,Staff,13,0,30,17
1649856144522,MATH 193A,A03,083781,Staff,28,0,30,2
1649856144522,MATH 193A,A04,083782,Staff,28,0,30,2
1649856150549,MATH 197,001,091859,McAuley; Julian John,9999,0,9999,0
1649856156627,COGS 9,A01,083615,Staff,46,0,60,14
1649856162657,COGS 11,A01,083617,Boyle; Mary E. T.,36,0,40,4
1649856168689,COGS 13,A01,083071,Staff,21,0,40,19
1649856174724,COGS 14A,A01,092681,Staff,98,0,100,2
1649856180749,COGS 14B,A01,083073,Cheng; Tzu-Han,39,0,50,11
1649856186772,COGS 17,A01,092677,Staff,74,0,75,1
1649856192796,COGS 100,A01,083619,Staff,34,0,60,26
1649856198820,COGS 101A,A01,083621,Davis; Joshua Daniel,34,0,60,26
1649856204850,COGS 101B,A01,091572,Staff,47,0,60,13
1649856210879,COGS 101C,A01,083625,Delgado; Tania,25,0,30,5
1649856216908,COGS 107A,A01,083627,Boyle; Mary E. T.,41,0,60,19
1649856222931,COGS 118A,A01,083075,Staff,34,0,60,26
1649856228957,CSE 3,A50,083646,Miranda; Gregory Joseph,32,0,38,6
1649856228957,CSE 3,A51,083647,Miranda; Gregory Joseph,37,0,37,0
1649856234981,CSE 8A,A50,083650,Miranda; Gregory Joseph,30,0,40,10
1649856241007,CSE 11,A01,083080,Cao; Yingjun,10,0,40,30
1649856247042,CSE 12,A01,083652,Staff,84,0,100,16
1649856253069,CSE 15L,A01,083654,Staff,39,0,50,11
1649856253069,CSE 15L,A02,083655,Staff,49,0,50,1
1649856259093,CSE 20,A01,083657,Staff,73,0,80,7
1649856265120,CSE 30,A01,083084,Eldon; John,15,0,40,25
1649856271144,CSE 100,A01,083659,Cao; Yingjun,15,0,50,35
1649856277169,CSE 134B,A01,083661,Powell; Thomas Allan,0,3,65,65
1649856283193,CSE 140,A01,083663,Staff,55,0,75,20
1649856289216,CSE 140L,A01,083088,Eldon; John,51,0,75,24
1649856295246,CSE 175,A01,083665,Kumar; Rakesh,16,0,25,9
1649856301267,CSE 190,A00,092507,Staff,15,0,15,0
1649856307292,ECE 45,A01,083139,Staff,34,0,40,6
1649856313318,ECE 65,A50,083695,Staff,22,0,30,8
1649856319350,ECE 109,A01,091882,Touri; Behrouz,66,0,70,4
1649856325375,ECE 180,A00,083140,Abi Samra; Nicholas Camill,29,0,30,1
1649856325375,ECE 180,B00,083141,Abi Samra; Nicholas Camill,17,0,30,13
1649856331403,MATH 10A,A01,083735,Patchell; Gregory David,26,0,30,4
1649856331403,MATH 10A,A02,083736,Patchell; Gregory David,30,0,30,0
1649856331403,MATH 10A,A03,083737,Patchell; Gregory David,30,0,30,0
1649856337428,MATH 10B,A01,083207,Staff,21,0,30,9
1649856337428,MATH 10B,A02,083208,Staff,28,0,30,2
1649856337428,MATH 10B,B01,083739,Staff,27,0,30,3
1649856337428,MATH 10B,B02,083740,Staff,30,0,30,0
1649856343460,MATH 18,A01,083743,Staff,26,0,30,4
1649856343460,MATH 18,A02,083744,Staff,30,0,30,0
1649856343460,MATH 18,A03,083745,Staff,30,0,30,0
1649856343460,MATH 18,A04,083746,Staff,30,0,30,0
1649856343460,MATH 18,B01,083748,Staff,24,0,30,6
1649856343460,MATH 18,B02,083749,Staff,29,0,30,1
1649856343460,MATH 18,B03,083750,Staff,30,0,30,0
1649856343460,MATH 18,B04,083751,Staff,29,0,30,1
1649856349495,MATH 20A,A01,083754,Staff,39,0,40,1
1649856355617,MATH 20B,A01,083756,Staff,29,0,30,1
1649856355617,MATH 20B,A02,083757,Staff,30,0,30,0
1649856361646,MATH 20C,A01,083760,Staff,27,0,30,3
1649856361646,MATH 20C,A02,083761,Staff,30,0,30,0
1649856361646,MATH 20C,B01,083762,Staff,30,0,30,0
1649856361646,MATH 20C,B02,083763,Staff,30,0,30,0
1649856367680,MATH 20D,A01,083765,Staff,24,0,30,6
1649856367680,MATH 20D,A02,083766,Staff,30,0,30,0
1649856367680,MATH 20D,A03,083767,Staff,30,0,30,0
1649856373709,MATH 20E,A01,083771,Staff,21,0,30,9
1649856373709,MATH 20E,A02,083772,Staff,29,0,30,1
1649856373709,MATH 20E,B01,083773,Staff,25,0,30,5
1649856373709,MATH 20E,B02,083774,Staff,30,0,30,0
1649856379753,MATH 103A,A01,083777,Staff,5,0,30,25
1649856379753,MATH 103A,A02,083778,Staff,23,0,30,7
1649856379753,MATH 103A,B01,083779,Staff,17,0,30,13
1649856379753,MATH 103A,B02,083780,Staff,27,0,30,3
1649856385778,MATH 105,A01,085443,Staff,15,0,30,15
1649856391802,MATH 109,A01,083213,Anzaldo; Leesa B,28,0,30,2
1649856391802,MATH 109,A02,083214,Anzaldo; Leesa B,24,0,30,6
1649856391802,MATH 109,B01,083215,Anzaldo; Leesa B,28,0,30,2
1649856391802,MATH 109,B02,083216,Anzaldo; Leesa B,26,0,30,4
1649856397828,MATH 142A,A01,083219,Chow; Bennett,11,0,30,19
1649856397828,MATH 142A,A02,083220,Chow; Bennett,28,0,30,2
1649856397828,MATH 142A,B01,083221,Chow; Bennett,16,0,30,14
1649856397828,MATH 142A,B02,083222,Chow; Bennett,27,0,30,3
1649856403853,MATH 193A,A01,083224,Staff,0,0,30,30
1649856403853,MATH 193A,A02,083225,Staff,13,0,30,17
1649856403853,MATH 193A,A03,083781,Staff,28,0,30,2
1649856403853,MATH 193A,A04,083782,Staff,28,0,30,2
1649856409889,MATH 197,001,091859,McAuley; Julian John,9999,0,9999,0
1649856415944,COGS 9,A01,083615,Staff,46,0,60,14
1649856421982,COGS 11,A01,083617,Boyle; Mary E. T.,36,0,40,4
1649856428009,COGS 13,A01,083071,Staff,21,0,40,19
1649856434042,COGS 14A,A01,092681,Staff,98,0,100,2
1649856440067,COGS 14B,A01,083073,Cheng; Tzu-Han,39,0,50,11
1649856446093,COGS 17,A01,092677,Staff,74,0,75,1
1649856452120,COGS 100,A01,083619,Staff,34,0,60,26
1649856458150,COGS 101A,A01,083621,Davis; Joshua Daniel,34,0,60,26
1649856464176,COGS 101B,A01,091572,Staff,47,0,60,13
1649856470205,COGS 101C,A01,083625,Delgado; Tania,25,0,30,5
1649856476236,COGS 107A,A01,083627,Boyle; Mary E. T.,41,0,60,19
1649856482269,COGS 118A,A01,083075,Staff,34,0,60,26
1649856488306,CSE 3,A50,083646,Miranda; Gregory Joseph,32,0,38,6
1649856488306,CSE 3,A51,083647,Miranda; Gregory Joseph,37,0,37,0
1649856494331,CSE 8A,A50,083650,Miranda; Gregory Joseph,30,0,40,10
1649856500358,CSE 11,A01,083080,Cao; Yingjun,10,0,40,30
1649856506386,CSE 12,A01,083652,Staff,84,0,100,16
1649856512422,CSE 15L,A01,083654,Staff,39,0,50,11
1649856512422,CSE 15L,A02,083655,Staff,49,0,50,1
1649856518448,CSE 20,A01,083657,Staff,73,0,80,7
1649856524479,CSE 30,A01,083084,Eldon; John,15,0,40,25
1649856530517,CSE 100,A01,083659,Cao; Yingjun,15,0,50,35
1649856536543,CSE 134B,A01,083661,Powell; Thomas Allan,0,3,65,65
1649856542567,CSE 140,A01,083663,Staff,55,0,75,20
1649856548592,CSE 140L,A01,083088,Eldon; John,51,0,75,24
1649856554616,CSE 175,A01,083665,Kumar; Rakesh,16,0,25,9
1649856560645,CSE 190,A00,092507,Staff,15,0,15,0
1649856566670,ECE 45,A01,083139,Staff,34,0,40,6
1649856572701,ECE 65,A50,083695,Staff,22,0,30,8
1649856578726,ECE 109,A01,091882,Touri; Behrouz,66,0,70,4
1649856584755,ECE 180,A00,083140,Abi Samra; Nicholas Camill,29,0,30,1
1649856584755,ECE 180,B00,083141,Abi Samra; Nicholas Camill,17,0,30,13
1649856590780,MATH 10A,A01,083735,Patchell; Gregory David,26,0,30,4
1649856590780,MATH 10A,A02,083736,Patchell; Gregory David,30,0,30,0
1649856590780,MATH 10A,A03,083737,Patchell; Gregory David,30,0,30,0
1649856596819,MATH 10B,A01,083207,Staff,21,0,30,9
1649856596819,MATH 10B,A02,083208,Staff,28,0,30,2
1649856596819,MATH 10B,B01,083739,Staff,27,0,30,3
1649856596819,MATH 10B,B02,083740,Staff,30,0,30,0
1649856602864,MATH 18,A01,083743,Staff,26,0,30,4
1649856602864,MATH 18,A02,083744,Staff,30,0,30,0
1649856602864,MATH 18,A03,083745,Staff,30,0,30,0
1649856602864,MATH 18,A04,083746,Staff,30,0,30,0
1649856602864,MATH 18,B01,083748,Staff,24,0,30,6
1649856602864,MATH 18,B02,083749,Staff,29,0,30,1
1649856602864,MATH 18,B03,083750,Staff,30,0,30,0
1649856602864,MATH 18,B04,083751,Staff,29,0,30,1
1649856608892,MATH 20A,A01,083754,Staff,39,0,40,1
1649856614920,MATH 20B,A01,083756,Staff,29,0,30,1
1649856614920,MATH 20B,A02,083757,Staff,30,0,30,0
1649856620945,MATH 20C,A01,083760,Staff,27,0,30,3
1649856620945,MATH 20C,A02,083761,Staff,30,0,30,0
1649856620945,MATH 20C,B01,083762,Staff,30,0,30,0
1649856620945,MATH 20C,B02,083763,Staff,30,0,30,0
1649856626972,MATH 20D,A01,083765,Staff,24,0,30,6
1649856626972,MATH 20D,A02,083766,Staff,30,0,30,0
1649856626972,MATH 20D,A03,083767,Staff,30,0,30,0
1649856632997,MATH 20E,A01,083771,Staff,21,0,30,9
1649856632997,MATH 20E,A02,083772,Staff,29,0,30,1
1649856632997,MATH 20E,B01,083773,Staff,25,0,30,5
1649856632997,MATH 20E,B02,083774,Staff,30,0,30,0
1649856639024,MATH 103A,A01,083777,Staff,5,0,30,25
1649856639024,MATH 103A,A02,083778,Staff,23,0,30,7
1649856639024,MATH 103A,B01,083779,Staff,17,0,30,13
1649856639024,MATH 103A,B02,083780,Staff,27,0,30,3
1649856645052,MATH 105,A01,085443,Staff,15,0,30,15
1649856651078,MATH 109,A01,083213,Anzaldo; Leesa B,28,0,30,2
1649856651078,MATH 109,A02,083214,Anzaldo; Leesa B,24,0,30,6
1649856651078,MATH 109,B01,083215,Anzaldo; Leesa B,28,0,30,2
1649856651078,MATH 109,B02,083216,Anzaldo; Leesa B,26,0,30,4
1649856657106,MATH 142A,A01,083219,Chow; Bennett,11,0,30,19
1649856657106,MATH 142A,A02,083220,Chow; Bennett,28,0,30,2
1649856657106,MATH 142A,B01,083221,Chow; Bennett,16,0,30,14
1649856657106,MATH 142A,B02,083222,Chow; Bennett,27,0,30,3
1649856663129,MATH 193A,A01,083224,Staff,0,0,30,30
1649856663129,MATH 193A,A02,083225,Staff,13,0,30,17
1649856663129,MATH 193A,A03,083781,Staff,28,0,30,2
1649856663129,MATH 193A,A04,083782,Staff,28,0,30,2
1649856669151,MATH 197,001,091859,McAuley; Julian John,9999,0,9999,0
1649856675223,COGS 9,A01,083615,Staff,46,0,60,14
1649856681247,COGS 11,A01,083617,Boyle; Mary E. T.,36,0,40,4
1649856687275,COGS 13,A01,083071,Staff,21,0,40,19
1649856693302,COGS 14A,A01,092681,Staff,98,0,100,2
1649856699333,COGS 14B,A01,083073,Cheng; Tzu-Han,39,0,50,11
1649856705358,COGS 17,A01,092677,Staff,74,0,75,1
1649856711384,COGS 100,A01,083619,Staff,34,0,60,26
1649856717409,COGS 101A,A01,083621,Davis; Joshua Daniel,34,0,60,26
1649856723434,COGS 101B,A01,091572,Staff,47,0,60,13
1649856729463,COGS 101C,A01,083625,Delgado; Tania,25,0,30,5
1649856735487,COGS 107A,A01,083627,Boyle; Mary E. T.,41,0,60,19
1649856741511,COGS 118A,A01,083075,Staff,34,0,60,26
1649856747545,CSE 3,A50,083646,Miranda; Gregory Joseph,32,0,38,6
1649856747545,CSE 3,A51,083647,Miranda; Gregory Joseph,37,0,37,0
1649856753584,CSE 8A,A50,083650,Miranda; Gregory Joseph,30,0,40,10
1649856759609,CSE 11,A01,083080,Cao; Yingjun,10,0,40,30
1649856765635,CSE 12,A01,083652,Staff,84,0,100,16
1649856771658,CSE 15L,A01,083654,Staff,39,0,50,11
1649856771658,CSE 15L,A02,083655,Staff,49,0,50,1
1649856777687,CSE 20,A01,083657,Staff,73,0,80,7
1649856783720,CSE 30,A01,083084,Eldon; John,15,0,40,25
1649856789753,CSE 100,A01,083659,Cao; Yingjun,15,0,50,35
1649856795778,CSE 134B,A01,083661,Powell; Thomas Allan,0,3,65,65
1649856801815,CSE 140,A01,083663,Staff,55,0,75,20
1649856807839,CSE 140L,A01,083088,Eldon; John,51,0,75,24
1649856813874,CSE 175,A01,083665,Kumar; Rakesh,16,0,25,9
1649856819898,CSE 190,A00,092507,Staff,15,0,15,0
1649856825920,ECE 45,A01,083139,Staff,34,0,40,6
1649856831944,ECE 65,A50,083695,Staff,22,0,30,8
1649856837970,ECE 109,A01,091882,Touri; Behrouz,66,0,70,4
1649856843994,ECE 180,A00,083140,Abi Samra; Nicholas Camill,29,0,30,1
1649856843994,ECE 180,B00,083141,Abi Samra; Nicholas Camill,17,0,30,13
1649856850020,MATH 10A,A01,083735,Patchell; Gregory David,26,0,30,4
1649856850020,MATH 10A,A02,083736,Patchell; Gregory David,30,0,30,0
1649856850020,MATH 10A,A03,083737,Patchell; Gregory David,30,0,30,0
1649856856049,MATH 10B,A01,083207,Staff,21,0,30,9
1649856856049,MATH 10B,A02,083208,Staff,28,0,30,2
1649856856049,MATH 10B,B01,083739,Staff,27,0,30,3
1649856856049,MATH 10B,B02,083740,Staff,30,0,30,0
1649856862074,MATH 18,A01,083743,Staff,26,0,30,4
1649856862074,MATH 18,A02,083744,Staff,30,0,30,0
1649856862074,MATH 18,A03,083745,Staff,30,0,30,0
1649856862074,MATH 18,A04,083746,Staff,30,0,30,0
1649856862074,MATH 18,B01,083748,Staff,24,0,30,6
1649856862074,MATH 18,B02,083749,Staff,29,0,30,1
1649856862074,MATH 18,B03,083750,Staff,30,0,30,0
1649856862074,MATH 18,B04,083751,Staff,29,0,30,1
1649856868098,MATH 20A,A01,083754,Staff,39,0,40,1
1649856874122,MATH 20B,A01,083756,Staff,29,0,30,1
1649856874122,MATH 20B,A02,083757,Staff,30,0,30,0
1649856880151,MATH 20C,A01,083760,Staff,27,0,30,3
1649856880151,MATH 20C,A02,083761,Staff,30,0,30,0
1649856880151,MATH 20C,B01,083762,Staff,30,0,30,0
1649856880151,MATH 20C,B02,083763,Staff,30,0,30,0
1649856886177,MATH 20D,A01,083765,Staff,24,0,30,6
1649856886177,MATH 20D,A02,083766,Staff,30,0,30,0
1649856886177,MATH 20D,A03,083767,Staff,30,0,30,0
1649856892216,MATH 20E,A01,083771,Staff,21,0,30,9
1649856892216,MATH 20E,A02,083772,Staff,29,0,30,1
1649856892216,MATH 20E,B01,083773,Staff,25,0,30,5
1649856892216,MATH 20E,B02,083774,Staff,30,0,30,0
1649856898245,MATH 103A,A01,083777,Staff,5,0,30,25
1649856898245,MATH 103A,A02,083778,Staff,23,0,30,7
1649856898245,MATH 103A,B01,083779,Staff,17,0,30,13
1649856898245,MATH 103A,B02,083780,Staff,27,0,30,3
1649856904274,MATH 105,A01,085443,Staff,15,0,30,15
1649856910299,MATH 109,A01,083213,Anzaldo; Leesa B,28,0,30,2
1649856910299,MATH 109,A02,083214,Anzaldo; Leesa B,24,0,30,6
1649856910299,MATH 109,B01,083215,Anzaldo; Leesa B,28,0,30,2
1649856910299,MATH 109,B02,083216,Anzaldo; Leesa B,26,0,30,4
1649856916323,MATH 142A,A01,083219,Chow; Bennett,11,0,30,19
1649856916323,MATH 142A,A02,083220,Chow; Bennett,28,0,30,2
1649856916323,MATH 142A,B01,083221,Chow; Bennett,16,0,30,14
1649856916323,MATH 142A,B02,083222,Chow; Bennett,27,0,30,3
1649856922349,MATH 193A,A01,083224,Staff,0,0,30,30
1649856922349,MATH 193A,A02,083225,Staff,13,0,30,17
1649856922349,MATH 193A,A03,083781,Staff,28,0,30,2
1649856922349,MATH 193A,A04,083782,Staff,28,0,30,2
1649856928377,MATH 197,001,091859,McAuley; Julian John,9999,0,9999,0
1649856934438,COGS 9,A01,083615,Staff,46,0,60,14
1649856940466,COGS 11,A01,083617,Boyle; Mary E. T.,36,0,40,4
1649856946586,COGS 13,A01,083071,Staff,21,0,40,19
1649856952610,COGS 14A,A01,092681,Staff,98,0,100,2
1649856958642,COGS 14B,A01,083073,Cheng; Tzu-Han,39,0,50,11
1649856964667,COGS 17,A01,092677,Staff,74,0,75,1
1649856970691,COGS 100,A01,083619,Staff,34,0,60,26
1649856976719,COGS 101A,A01,083621,Davis; Joshua Daniel,34,0,60,26
1649856983768,COGS 101B,A01,091572,Staff,47,0,60,13
1649856989836,COGS 101C,A01,083625,Delgado; Tania,25,0,30,5
1649856995902,COGS 107A,A01,083627,Boyle; Mary E. T.,41,0,60,19
1649857001930,COGS 118A,A01,083075,Staff,34,0,60,26
1649857007955,CSE 3,A50,083646,Miranda; Gregory Joseph,32,0,38,6
1649857007955,CSE 3,A51,083647,Miranda; Gregory Joseph,37,0,37,0
1649857013983,CSE 8A,A50,083650,Miranda; Gregory Joseph,30,0,40,10
1649857020008,CSE 11,A01,083080,Cao; Yingjun,10,0,40,30
1649857026032,CSE 12,A01,083652,Staff,84,0,100,16
1649857032055,CSE 15L,A01,083654,Staff,39,0,50,11
1649857032055,CSE 15L,A02,083655,Staff,49,0,50,1
1649857038082,CSE 20,A01,083657,Staff,73,0,80,7
1649857044110,CSE 30,A01,083084,Eldon; John,15,0,40,25
1649857050134,CSE 100,A01,083659,Cao; Yingjun,15,0,50,35
1649857056161,CSE 134B,A01,083661,Powell; Thomas Allan,0,3,65,65
1649857062187,CSE 140,A01,083663,Staff,55,0,75,20
1649857068214,CSE 140L,A01,083088,Eldon; John,51,0,75,24
1649857074237,CSE 175,A01,083665,Kumar; Rakesh,16,0,25,9
1649857080264,CSE 190,A00,092507,Staff,15,0,15,0
1649857086287,ECE 45,A01,083139,Staff,34,0,40,6
1649857092314,ECE 65,A50,083695,Staff,22,0,30,8
1649857098341,ECE 109,A01,091882,Touri; Behrouz,66,0,70,4
1649857104368,ECE 180,A00,083140,Abi Samra; Nicholas Camill,29,0,30,1
1649857104368,ECE 180,B00,083141,Abi Samra; Nicholas Camill,17,0,30,13
1649857110391,MATH 10A,A01,083735,Patchell; Gregory David,26,0,30,4
1649857110391,MATH 10A,A02,083736,Patchell; Gregory David,30,0,30,0
1649857110391,MATH 10A,A03,083737,Patchell; Gregory David,30,0,30,0
1649857116421,MATH 10B,A01,083207,Staff,21,0,30,9
1649857116421,MATH 10B,A02,083208,Staff,28,0,30,2
1649857116421,MATH 10B,B01,083739,Staff,27,0,30,3
1649857116421,MATH 10B,B02,083740,Staff,30,0,30,0
1649857122447,MATH 18,A01,083743,Staff,26,0,30,4
1649857122447,MATH 18,A02,083744,Staff,30,0,30,0
1649857122447,MATH 18,A03,083745,Staff,30,0,30,0
1649857122447,MATH 18,A04,083746,Staff,30,0,30,0
1649857122447,MATH 18,B01,083748,Staff,24,0,30,6
1649857122447,MATH 18,B02,083749,Staff,29,0,30,1
1649857122447,MATH 18,B03,083750,Staff,30,0,30,0
1649857122447,MATH 18,B04,083751,Staff,29,0,30,1
1649857128472,MATH 20A,A01,083754,Staff,39,0,40,1
1649857134501,MATH 20B,A01,083756,Staff,29,0,30,1
1649857134501,MATH 20B,A02,083757,Staff,30,0,30,0
1649857140526,MATH 20C,A01,083760,Staff,27,0,30,3
1649857140526,MATH 20C,A02,083761,Staff,30,0,30,0
1649857140526,MATH 20C,B01,083762,Staff,30,0,30,0
1649857140526,MATH 20C,B02,083763,Staff,30,0,30,0
1649857146561,MATH 20D,A01,083765,Staff,24,0,30,6
1649857146561,MATH 20D,A02,083766,Staff,30,0,30,0
1649857146561,MATH 20D,A03,083767,Staff,30,0,30,0
1649857152584,MATH 20E,A01,083771,Staff,21,0,30,9
1649857152584,MATH 20E,A02,083772,Staff,29,0,30,1
1649857152584,MATH 20E,B01,083773,Staff,25,0,30,5
1649857152584,MATH 20E,B02,083774,Staff,30,0,30,0
1649857158606,MATH 103A,A01,083777,Staff,5,0,30,25
1649857158606,MATH 103A,A02,083778,Staff,23,0,30,7
1649857158606,MATH 103A,B01,083779,Staff,17,0,30,13
1649857158606,MATH 103A,B02,083780,Staff,27,0,30,3
1649857164630,MATH 105,A01,085443,Staff,15,0,30,15
1649857170655,MATH 109,A01,083213,Anzaldo; Leesa B,28,0,30,2
1649857170655,MATH 109,A02,083214,Anzaldo; Leesa B,24,0,30,6
1649857170655,MATH 109,B01,083215,Anzaldo; Leesa B,28,0,30,2
1649857170655,MATH 109,B02,083216,Anzaldo; Leesa B,26,0,30,4
1649857176685,MATH 142A,A01,083219,Chow; Bennett,11,0,30,19
1649857176685,MATH 142A,A02,083220,Chow; Bennett,28,0,30,2
1649857176685,MATH 142A,B01,083221,Chow; Bennett,16,0,30,14
1649857176685,MATH 142A,B02,083222,Chow; Bennett,27,0,30,3
1649857182715,MATH 193A,A01,083224,Staff,0,0,30,30
1649857182715,MATH 193A,A02,083225,Staff,13,0,30,17
1649857182715,MATH 193A,A03,083781,Staff,28,0,30,2
1649857182715,MATH 193A,A04,083782,Staff,28,0,30,2
1649857188737,MATH 197,001,091859,McAuley; Julian John,9999,0,9999,0
1649857194791,COGS 9,A01,083615,Staff,46,0,60,14
1649857200819,COGS 11,A01,083617,Boyle; Mary E. T.,36,0,40,4
1649857206854,COGS 13,A01,083071,Staff,21,0,40,19
1649857212885,COGS 14A,A01,092681,Staff,98,0,100,2
1649857218911,COGS 14B,A01,083073,Cheng; Tzu-Han,39,0,50,11
1649857224937,COGS 17,A01,092677,Staff,74,0,75,1
1649857230960,COGS 100,A01,083619,Staff,34,0,60,26
1649857236985,COGS 101A,A01,083621,Davis; Joshua Daniel,34,0,60,26
1649857243013,COGS 101B,A01,091572,Staff,47,0,60,13
1649857249042,COGS 101C,A01,083625,Delgado; Tania,25,0,30,5
1649857255071,COGS 107A,A01,083627,Boyle; Mary E. T.,41,0,60,19
1649857261094,COGS 118A,A01,083075,Staff,34,0,60,26
1649857267118,CSE 3,A50,083646,Miranda; Gregory Joseph,32,0,38,6
1649857267118,CSE 3,A51,083647,Miranda; Gregory Joseph,37,0,37,0
1649857273141,CSE 8A,A50,083650,Miranda; Gregory Joseph,30,0,40,10
1649857279164,CSE 11,A01,083080,Cao; Yingjun,10,0,40,30
1649857285191,CSE 12,A01,083652,Staff,84,0,100,16
1649857291217,CSE 15L,A01,083654,Staff,39,0,50,11
1649857291217,CSE 15L,A02,083655,Staff,49,0,50,1
1649857297241,CSE 20,A01,083657,Staff,73,0,80,7
1649857303268,CSE 30,A01,083084,Eldon; John,15,0,40,25
1649857309295,CSE 100,A01,083659,Cao; Yingjun,15,0,50,35
1649857315326,CSE 134B,A01,083661,Powell; Thomas Allan,0,3,65,65
1649857321349,CSE 140,A01,083663,Staff,55,0,75,20
1649857327372,CSE 140L,A01,083088,Eldon; John,51,0,75,24
1649857333393,CSE 175,A01,083665,Kumar; Rakesh,16,0,25,9
1649857339419,CSE 190,A00,092507,Staff,15,0,15,0
1649857345446,ECE 45,A01,083139,Staff,34,0,40,6
1649857351468,ECE 65,A50,083695,Staff,22,0,30,8
1649857357497,ECE 109,A01,091882,Touri; Behrouz,66,0,70,4
1649857363520,ECE 180,A00,083140,Abi Samra; Nicholas Camill,29,0,30,1
1649857363520,ECE 180,B00,083141,Abi Samra; Nicholas Camill,17,0,30,13
1649857369544,MATH 10A,A01,083735,Patchell; Gregory David,26,0,30,4
1649857369544,MATH 10A,A02,083736,Patchell; Gregory David,30,0,30,0
1649857369544,MATH 10A,A03,083737,Patchell; Gregory David,30,0,30,0
1649857375571,MATH 10B,A01,083207,Staff,21,0,30,9
1649857375571,MATH 10B,A02,083208,Staff,28,0,30,2
1649857375571,MATH 10B,B01,083739,Staff,27,0,30,3
1649857375571,MATH 10B,B02,083740,Staff,30,0,30,0
1649857381602,MATH 18,A01,083743,Staff,26,0,30,4
1649857381602,MATH 18,A02,083744,Staff,30,0,30,0
1649857381602,MATH 18,A03,083745,Staff,30,0,30,0
1649857381602,MATH 18,A04,083746,Staff,30,0,30,0
1649857381602,MATH 18,B01,083748,Staff,24,0,30,6
1649857381602,MATH 18,B02,083749,Staff,29,0,30,1
1649857381602,MATH 18,B03,083750,Staff,30,0,30,0
1649857381602,MATH 18,B04,083751,Staff,29,0,30,1
1649857387626,MATH 20A,A01,083754,Staff,39,0,40,1
1649857393649,MATH 20B,A01,083756,Staff,29,0,30,1
1649857393649,MATH 20B,A02,083757,Staff,30,0,30,0
1649857399678,MATH 20C,A01,083760,Staff,27,0,30,3
1649857399678,MATH 20C,A02,083761,Staff,30,0,30,0
1649857399678,MATH 20C,B01,083762,Staff,30,0,30,0
1649857399678,MATH 20C,B02,083763,Staff,30,0,30,0
1649857405701,MATH 20D,A01,083765,Staff,24,0,30,6
1649857405701,MATH 20D,A02,083766,Staff,30,0,30,0
1649857405701,MATH 20D,A03,083767,Staff,30,0,30,0
1649857411726,MATH 20E,A01,083771,Staff,21,0,30,9
1649857411726,MATH 20E,A02,083772,Staff,29,0,30,1
1649857411726,MATH 20E,B01,083773,Staff,25,0,30,5
1649857411726,MATH 20E,B02,083774,Staff,30,0,30,0
1649857417751,MATH 103A,A01,083777,Staff,5,0,30,25
1649857417751,MATH 103A,A02,083778,Staff,23,0,30,7
1649857417751,MATH 103A,B01,083779,Staff,17,0,30,13
1649857417751,MATH 103A,B02,083780,Staff,27,0,30,3
1649857423775,MATH 105,A01,085443,Staff,15,0,30,15
1649857429806,MATH 109,A01,083213,Anzaldo; Leesa B,28,0,30,2
1649857429806,MATH 109,A02,083214,Anzaldo; Leesa B,24,0,30,6
1649857429806,MATH 109,B01,083215,Anzaldo; Leesa B,28,0,30,2
1649857429806,MATH 109,B02,083216,Anzaldo; Leesa B,26,0,30,4
1649857435836,MATH 142A,A01,083219,Chow; Bennett,11,0,30,19
1649857435836,MATH 142A,A02,083220,Chow; Bennett,28,0,30,2
1649857435836,MATH 142A,B01,083221,Chow; Bennett,16,0,30,14
1649857435836,MATH 142A,B02,083222,Chow; Bennett,27,0,30,3
1649857441868,MATH 193A,A01,083224,Staff,0,0,30,30
1649857441868,MATH 193A,A02,083225,Staff,13,0,30,17
1649857441868,MATH 193A,A03,083781,Staff,28,0,30,2
1649857441868,MATH 193A,A04,083782,Staff,28,0,30,2
1649857447893,MATH 197,001,091859,McAuley; Julian John,9999,0,9999,0
1649857453948,COGS 9,A01,083615,Staff,46,0,60,14
1649857459976,COGS 11,A01,083617,Boyle; Mary E. T.,36,0,40,4
1649857466004,COGS 13,A01,083071,Staff,21,0,40,19
1649857472027,COGS 14A,A01,092681,Staff,98,0,100,2
1649857478050,COGS 14B,A01,083073,Cheng; Tzu-Han,39,0,50,11
1649857484076,COGS 17,A01,092677,Staff,74,0,75,1
1649857490099,COGS 100,A01,083619,Staff,34,0,60,26
1649857496133,COGS 101A,A01,083621,Davis; Joshua Daniel,34,0,60,26
1649857502162,COGS 101B,A01,091572,Staff,47,0,60,13
1649857508189,COGS 101C,A01,083625,Delgado; Tania,25,0,30,5
1649857514212,COGS 107A,A01,083627,Boyle; Mary E. T.,41,0,60,19
1649857520238,COGS 118A,A01,083075,Staff,34,0,60,26
1649857526266,CSE 3,A50,083646,Miranda; Gregory Joseph,32,0,38,6
1649857526266,CSE 3,A51,083647,Miranda; Gregory Joseph,37,0,37,0
1649857532300,CSE 8A,A50,083650,Miranda; Gregory Joseph,30,0,40,10
1649857538325,CSE 11,A01,083080,Cao; Yingjun,10,0,40,30
1649857544438,CSE 12,A01,083652,Staff,84,0,100,16
1649857550475,CSE 15L,A01,083654,Staff,39,0,50,11
1649857550475,CSE 15L,A02,083655,Staff,49,0,50,1
1649857556499,CSE 20,A01,083657,Staff,73,0,80,7
1649857562526,CSE 30,A01,083084,Eldon; John,15,0,40,25
1649857568554,CSE 100,A01,083659,Cao; Yingjun,15,0,50,35
1649857574583,CSE 134B,A01,083661,Powell; Thomas Allan,0,3,65,65
1649857580612,CSE 140,A01,083663,Staff,55,0,75,20
1649857586645,CSE 140L,A01,083088,Eldon; John,51,0,75,24
1649857592669,CSE 175,A01,083665,Kumar; Rakesh,16,0,25,9
1649857598698,CSE 190,A00,092507,Staff,15,0,15,0
1649857604726,ECE 45,A01,083139,Staff,34,0,40,6
1649857610751,ECE 65,A50,083695,Staff,22,0,30,8
1649857616776,ECE 109,A01,091882,Touri; Behrouz,66,0,70,4
1649857622805,ECE 180,A00,083140,Abi Samra; Nicholas Camill,29,0,30,1
1649857622805,ECE 180,B00,083141,Abi Samra; Nicholas Camill,17,0,30,13
1649857628834,MATH 10A,A01,083735,Patchell; Gregory David,26,0,30,4
1649857628834,MATH 10A,A02,083736,Patchell; Gregory David,30,0,30,0
1649857628834,MATH 10A,A03,083737,Patchell; Gregory David,30,0,30,0
1649857634870,MATH 10B,A01,083207,Staff,21,0,30,9
1649857634870,MATH 10B,A02,083208,Staff,28,0,30,2
1649857634870,MATH 10B,B01,083739,Staff,27,0,30,3
1649857634870,MATH 10B,B02,083740,Staff,30,0,30,0
1649857640915,MATH 18,A01,083743,Staff,26,0,30,4
1649857640915,MATH 18,A02,083744,Staff,30,0,30,0
1649857640915,MATH 18,A03,083745,Staff,30,0,30,0
1649857640915,MATH 18,A04,083746,Staff,30,0,30,0
1649857640915,MATH 18,B01,083748,Staff,24,0,30,6
1649857640915,MATH 18,B02,083749,Staff,29,0,30,1
1649857640915,MATH 18,B03,083750,Staff,30,0,30,0
1649857640915,MATH 18,B04,083751,Staff,29,0,30,1
1649857646941,MATH 20A,A01,083754,Staff,39,0,40,1
1649857652969,MATH 20B,A01,083756,Staff,29,0,30,1
1649857652969,MATH 20B,A02,083757,Staff,30,0,30,0
1649857658999,MATH 20C,A01,083760,Staff,27,0,30,3
1649857658999,MATH 20C,A02,083761,Staff,30,0,30,0
1649857658999,MATH 20C,B01,083762,Staff,30,0,30,0
1649857658999,MATH 20C,B02,083763,Staff,30,0,30,0
1649857665026,MATH 20D,A01,083765,Staff,24,0,30,6
1649857665026,MATH 20D,A02,083766,Staff,30,0,30,0
1649857665026,MATH 20D,A03,083767,Staff,30,0,30,0
1649857671051,MATH 20E,A01,083771,Staff,21,0,30,9
1649857671051,MATH 20E,A02,083772,Staff,29,0,30,1
1649857671051,MATH 20E,B01,083773,Staff,25,0,30,5
1649857671051,MATH 20E,B02,083774,Staff,30,0,30,0
1649857677076,MATH 103A,A01,083777,Staff,5,0,30,25
1649857677076,MATH 103A,A02,083778,Staff,23,0,30,7
1649857677076,MATH 103A,B01,083779,Staff,17,0,30,13
1649857677076,MATH 103A,B02,083780,Staff,27,0,30,3
1649857683104,MATH 105,A01,085443,Staff,15,0,30,15
1649857689145,MATH 109,A01,083213,Anzaldo; Leesa B,28,0,30,2
1649857689145,MATH 109,A02,083214,Anzaldo; Leesa B,24,0,30,6
1649857689145,MATH 109,B01,083215,Anzaldo; Leesa B,28,0,30,2
1649857689145,MATH 109,B02,083216,Anzaldo; Leesa B,26,0,30,4
1649857695169,MATH 142A,A01,083219,Chow; Bennett,11,0,30,19
1649857695169,MATH 142A,A02,083220,Chow; Bennett,28,0,30,2
1649857695169,MATH 142A,B01,083221,Chow; Bennett,16,0,30,14
1649857695169,MATH 142A,B02,083222,Chow; Bennett,27,0,30,3
1649857701195,MATH 193A,A01,083224,Staff,0,0,30,30
1649857701195,MATH 193A,A02,083225,Staff,13,0,30,17
1649857701195,MATH 193A,A03,083781,Staff,28,0,30,2
1649857701195,MATH 193A,A04,083782,Staff,28,0,30,2
1649857707219,MATH 197,001,091859,McAuley; Julian John,9999,0,9999,0
1649857713277,COGS 9,A01,083615,Staff,46,0,60,14
1649857719301,COGS 11,A01,083617,Boyle; Mary E. T.,36,0,40,4
1649857725325,COGS 13,A01,083071,Staff,21,0,40,19
1649857731352,COGS 14A,A01,092681,Staff,98,0,100,2
1649857737380,COGS 14B,A01,083073,Cheng; Tzu-Han,39,0,50,11
1649857743405,COGS 17,A01,092677,Staff,74,0,75,1
1649857749429,COGS 100,A01,083619,Staff,34,0,60,26
1649857755457,COGS 101A,A01,083621,Davis; Joshua Daniel,34,0,60,26
1649857761481,COGS 101B,A01,091572,Staff,47,0,60,13
1649857767514,COGS 101C,A01,083625,Delgado; Tania,25,0,30,5
1649857773541,COGS 107A,A01,083627,Boyle; Mary E. T.,41,0,60,19
1649857779589,COGS 118A,A01,083075,Staff,34,0,60,26
1649857785614,CSE 3,A50,083646,Miranda; Gregory Joseph,32,0,38,6
1649857785614,CSE 3,A51,083647,Miranda; Gregory Joseph,37,0,37,0
1649857791642,CSE 8A,A50,083650,Miranda; Gregory Joseph,30,0,40,10
1649857797666,CSE 11,A01,083080,Cao; Yingjun,10,0,40,30
1649857803690,CSE 12,A01,083652,Staff,84,0,100,16
1649857809721,CSE 15L,A01,083654,Staff,39,0,50,11
1649857809721,CSE 15L,A02,083655,Staff,49,0,50,1
1649857815744,CSE 20,A01,083657,Staff,73,0,80,7
1649857821770,CSE 30,A01,083084,Eldon; John,15,0,40,25
1649857827804,CSE 100,A01,083659,Cao; Yingjun,15,0,50,35
1649857833841,CSE 134B,A01,083661,Powell; Thomas Allan,0,3,65,65
1649857839881,CSE 140,A01,083663,Staff,55,0,75,20
1649857845905,CSE 140L,A01,083088,Eldon; John,51,0,75,24
1649857851933,CSE 175,A01,083665,Kumar; Rakesh,16,0,25,9
1649857857958,CSE 190,A00,092507,Staff,15,0,15,0
1649857863987,ECE 45,A01,083139,Staff,34,0,40,6
1649857870009,ECE 65,A50,083695,Staff,22,0,30,8
1649857876034,ECE 109,A01,091882,Touri; Behrouz,66,0,70,4
1649857882058,ECE 180,A00,083140,Abi Samra; Nicholas Camill,29,0,30,1
1649857882058,ECE 180,B00,083141,Abi Samra; Nicholas Camill,17,0,30,13
1649857888082,MATH 10A,A01,083735,Patchell; Gregory David,26,0,30,4
1649857888082,MATH 10A,A02,083736,Patchell; Gregory David,30,0,30,0
1649857888082,MATH 10A,A03,083737,Patchell; Gregory David,30,0,30,0
1649857894118,MATH 10B,A01,083207,Staff,21,0,30,9
1649857894118,MATH 10B,A02,083208,Staff,28,0,30,2
1649857894118,MATH 10B,B01,083739,Staff,27,0,30,3
1649857894118,MATH 10B,B02,083740,Staff,30,0,30,0
1649857900141,MATH 18,A01,083743,Staff,26,0,30,4
1649857900141,MATH 18,A02,083744,Staff,30,0,30,0
1649857900141,MATH 18,A03,083745,Staff,30,0,30,0
1649857900141,MATH 18,A04,083746,Staff,30,0,30,0
1649857900141,MATH 18,B01,083748,Staff,24,0,30,6
1649857900141,MATH 18,B02,083749,Staff,29,0,30,1
1649857900141,MATH 18,B03,083750,Staff,30,0,30,0
1649857900141,MATH 18,B04,083751,Staff,29,0,30,1
1649857906165,MATH 20A,A01,083754,Staff,39,0,40,1
1649857912192,MATH 20B,A01,083756,Staff,29,0,30,1
1649857912192,MATH 20B,A02,083757,Staff,30,0,30,0
1649857918225,MATH 20C,A01,083760,Staff,27,0,30,3
1649857918225,MATH 20C,A02,083761,Staff,30,0,30,0
1649857918225,MATH 20C,B01,083762,Staff,30,0,30,0
1649857918225,MATH 20C,B02,083763,Staff,30,0,30,0
1649857924251,MATH 20D,A01,083765,Staff,24,0,30,6
1649857924251,MATH 20D,A02,083766,Staff,30,0,30,0
1649857924251,MATH 20D,A03,083767,Staff,30,0,30,0
1649857930274,MATH 20E,A01,083771,Staff,21,0,30,9
1649857930274,MATH 20E,A02,083772,Staff,29,0,30,1
1649857930274,MATH 20E,B01,083773,Staff,25,0,30,5
1649857930274,MATH 20E,B02,083774,Staff,30,0,30,0
1649857936304,MATH 103A,A01,083777,Staff,5,0,30,25
1649857936304,MATH 103A,A02,083778,Staff,23,0,30,7
1649857936304,MATH 103A,B01,083779,Staff,17,0,30,13
1649857936304,MATH 103A,B02,083780,Staff,27,0,30,3
1649857942341,MATH 105,A01,085443,Staff,15,0,30,15
1649857948368,MATH 109,A01,083213,Anzaldo; Leesa B,28,0,30,2
1649857948368,MATH 109,A02,083214,Anzaldo; Leesa B,24,0,30,6
1649857948368,MATH 109,B01,083215,Anzaldo; Leesa B,28,0,30,2
1649857948368,MATH 109,B02,083216,Anzaldo; Leesa B,26,0,30,4
1649857954391,MATH 142A,A01,083219,Chow; Bennett,11,0,30,19
1649857954391,MATH 142A,A02,083220,Chow; Bennett,28,0,30,2
1649857954391,MATH 142A,B01,083221,Chow; Bennett,16,0,30,14
1649857954391,MATH 142A,B02,083222,Chow; Bennett,27,0,30,3
1649857960421,MATH 193A,A01,083224,Staff,0,0,30,30
1649857960421,MATH 193A,A02,083225,Staff,13,0,30,17
1649857960421,MATH 193A,A03,083781,Staff,28,0,30,2
1649857960421,MATH 193A,A04,083782,Staff,28,0,30,2
1649857966444,MATH 197,001,091859,McAuley; Julian John,9999,0,9999,0
1649857972504,COGS 9,A01,083615,Staff,46,0,60,14
1649857978528,COGS 11,A01,083617,Boyle; Mary E. T.,36,0,40,4
1649857984551,COGS 13,A01,083071,Staff,21,0,40,19
1649857990576,COGS 14A,A01,092681,Staff,98,0,100,2
1649857996602,COGS 14B,A01,083073,Cheng; Tzu-Han,39,0,50,11
1649858002626,COGS 17,A01,092677,Staff,74,0,75,1
1649858008651,COGS 100,A01,083619,Staff,34,0,60,26
1649858014683,COGS 101A,A01,083621,Davis; Joshua Daniel,34,0,60,26
1649858020719,COGS 101B,A01,091572,Staff,47,0,60,13
1649858026742,COGS 101C,A01,083625,Delgado; Tania,25,0,30,5
1649858032766,COGS 107A,A01,083627,Boyle; Mary E. T.,41,0,60,19
1649858038789,COGS 118A,A01,083075,Staff,34,0,60,26
1649858044815,CSE 3,A50,083646,Miranda; Gregory Joseph,32,0,38,6
1649858044815,CSE 3,A51,083647,Miranda; Gregory Joseph,37,0,37,0
1649858050844,CSE 8A,A50,083650,Miranda; Gregory Joseph,30,0,40,10
1649858056867,CSE 11,A01,083080,Cao; Yingjun,10,0,40,30
1649858062895,CSE 12,A01,083652,Staff,84,0,100,16
1649858068918,CSE 15L,A01,083654,Staff,39,0,50,11
1649858068918,CSE 15L,A02,083655,Staff,49,0,50,1
1649858074943,CSE 20,A01,083657,Staff,73,0,80,7
1649858080965,CSE 30,A01,083084,Eldon; John,15,0,40,25
1649858086990,CSE 100,A01,083659,Cao; Yingjun,15,0,50,35
1649858093014,CSE 134B,A01,083661,Powell; Thomas Allan,0,3,65,65
1649858099038,CSE 140,A01,083663,Staff,55,0,75,20
1649858105067,CSE 140L,A01,083088,Eldon; John,51,0,75,24
1649858111090,CSE 175,A01,083665,Kumar; Rakesh,16,0,25,9
1649858117117,CSE 190,A00,092507,Staff,15,0,15,0
1649858123143,ECE 45,A01,083139,Staff,34,0,40,6
1649858129166,ECE 65,A50,083695,Staff,22,0,30,8
1649858135190,ECE 109,A01,091882,Touri; Behrouz,66,0,70,4
1649858141306,ECE 180,A00,083140,Abi Samra; Nicholas Camill,29,0,30,1
1649858141306,ECE 180,B00,083141,Abi Samra; Nicholas Camill,17,0,30,13
1649858147334,MATH 10A,A01,083735,Patchell; Gregory David,26,0,30,4
1649858147334,MATH 10A,A02,083736,Patchell; Gregory David,30,0,30,0
1649858147334,MATH 10A,A03,083737,Patchell; Gregory David,30,0,30,0
1649858153358,MATH 10B,A01,083207,Staff,21,0,30,9
1649858153358,MATH 10B,A02,083208,Staff,28,0,30,2
1649858153358,MATH 10B,B01,083739,Staff,27,0,30,3
1649858153358,MATH 10B,B02,083740,Staff,30,0,30,0
1649858159383,MATH 18,A01,083743,Staff,26,0,30,4
1649858159383,MATH 18,A02,083744,Staff,30,0,30,0
1649858159383,MATH 18,A03,083745,Staff,30,0,30,0
1649858159383,MATH 18,A04,083746,Staff,30,0,30,0
1649858159383,MATH 18,B01,083748,Staff,24,0,30,6
1649858159383,MATH 18,B02,083749,Staff,29,0,30,1
1649858159383,MATH 18,B03,083750,Staff,30,0,30,0
1649858159383,MATH 18,B04,083751,Staff,29,0,30,1
1649858165408,MATH 20A,A01,083754,Staff,39,0,40,1
1649858171434,MATH 20B,A01,083756,Staff,29,0,30,1
1649858171434,MATH 20B,A02,083757,Staff,30,0,30,0
1649858177457,MATH 20C,A01,083760,Staff,27,0,30,3
1649858177457,MATH 20C,A02,083761,Staff,30,0,30,0
1649858177457,MATH 20C,B01,083762,Staff,30,0,30,0
1649858177457,MATH 20C,B02,083763,Staff,30,0,30,0
1649858183486,MATH 20D,A01,083765,Staff,24,0,30,6
1649858183486,MATH 20D,A02,083766,Staff,30,0,30,0
1649858183486,MATH 20D,A03,083767,Staff,30,0,30,0
1649858189514,MATH 20E,A01,083771,Staff,21,0,30,9
1649858189514,MATH 20E,A02,083772,Staff,29,0,30,1
1649858189514,MATH 20E,B01,083773,Staff,25,0,30,5
1649858189514,MATH 20E,B02,083774,Staff,30,0,30,0
1649858195544,MATH 103A,A01,083777,Staff,5,0,30,25
1649858195544,MATH 103A,A02,083778,Staff,23,0,30,7
1649858195544,MATH 103A,B01,083779,Staff,17,0,30,13
1649858195544,MATH 103A,B02,083780,Staff,27,0,30,3
1649858201570,MATH 105,A01,085443,Staff,15,0,30,15
1649858207595,MATH 109,A01,083213,Anzaldo; Leesa B,28,0,30,2
1649858207595,MATH 109,A02,083214,Anzaldo; Leesa B,24,0,30,6
1649858207595,MATH 109,B01,083215,Anzaldo; Leesa B,28,0,30,2
1649858207595,MATH 109,B02,083216,Anzaldo; Leesa B,26,0,30,4
1649858213623,MATH 142A,A01,083219,Chow; Bennett,11,0,30,19
1649858213623,MATH 142A,A02,083220,Chow; Bennett,28,0,30,2
1649858213623,MATH 142A,B01,083221,Chow; Bennett,16,0,30,14
1649858213623,MATH 142A,B02,083222,Chow; Bennett,27,0,30,3
1649858219652,MATH 193A,A01,083224,Staff,0,0,30,30
1649858219652,MATH 193A,A02,083225,Staff,13,0,30,17
1649858219652,MATH 193A,A03,083781,Staff,28,0,30,2
1649858219652,MATH 193A,A04,083782,Staff,28,0,30,2
1649858225678,MATH 197,001,091859,McAuley; Julian John,9999,0,9999,0
1649858231732,COGS 9,A01,083615,Staff,46,0,60,14
1649858237760,COGS 11,A01,083617,Boyle; Mary E. T.,36,0,40,4
1649858243783,COGS 13,A01,083071,Staff,21,0,40,19
1649858249807,COGS 14A,A01,092681,Staff,98,0,100,2
1649858255832,COGS 14B,A01,083073,Cheng; Tzu-Han,39,0,50,11
1649858261860,COGS 17,A01,092677,Staff,74,0,75,1
1649858267883,COGS 100,A01,083619,Staff,34,0,60,26
1649858273905,COGS 101A,A01,083621,Davis; Joshua Daniel,34,0,60,26
1649858279929,COGS 101B,A01,091572,Staff,47,0,60,13
1649858285958,COGS 101C,A01,083625,Delgado; Tania,25,0,30,5
1649858291982,COGS 107A,A01,083627,Boyle; Mary E. T.,41,0,60,19
1649858298010,COGS 118A,A01,083075,Staff,34,0,60,26
1649858304038,CSE 3,A50,083646,Miranda; Gregory Joseph,32,0,38,6
1649858304038,CSE 3,A51,083647,Miranda; Gregory Joseph,37,0,37,0
1649858310068,CSE 8A,A50,083650,Miranda; Gregory Joseph,30,0,40,10
1649858316095,CSE 11,A01,083080,Cao; Yingjun,10,0,40,30
1649858322118,CSE 12,A01,083652,Staff,84,0,100,16
1649858328144,CSE 15L,A01,083654,Staff,39,0,50,11
1649858328144,CSE 15L,A02,083655,Staff,49,0,50,1
1649858334168,CSE 20,A01,083657,Staff,73,0,80,7
1649858340195,CSE 30,A01,083084,Eldon; John,15,0,40,25
1649858346217,CSE 100,A01,083659,Cao; Yingjun,15,0,50,35
1649858352240,CSE 134B,A01,083661,Powell; Thomas Allan,0,3,65,65
1649858358267,CSE 140,A01,083663,Staff,55,0,75,20
1649858364293,CSE 140L,A01,083088,Eldon; John,51,0,75,24
1649858370316,CSE 175,A01,083665,Kumar; Rakesh,16,0,25,9
1649858376340,CSE 190,A00,092507,Staff,15,0,15,0
1649858382367,ECE 45,A01,083139,Staff,34,0,40,6
1649858388393,ECE 65,A50,083695,Staff,22,0,30,8
1649858394423,ECE 109,A01,091882,Touri; Behrouz,66,0,70,4
1649858400456,ECE 180,A00,083140,Abi Samra; Nicholas Camill,29,0,30,1
1649858400456,ECE 180,B00,083141,Abi Samra; Nicholas Camill,17,0,30,13
1649858406479,MATH 10A,A01,083735,Patchell; Gregory David,26,0,30,4
1649858406479,MATH 10A,A02,083736,Patchell; Gregory David,30,0,30,0
1649858406479,MATH 10A,A03,083737,Patchell; Gregory David,30,0,30,0
1649858412511,MATH 10B,A01,083207,Staff,21,0,30,9
1649858412511,MATH 10B,A02,083208,Staff,28,0,30,2
1649858412511,MATH 10B,B01,083739,Staff,27,0,30,3
1649858412511,MATH 10B,B02,083740,Staff,30,0,30,0
1649858418552,MATH 18,A01,083743,Staff,26,0,30,4
1649858418552,MATH 18,A02,083744,Staff,30,0,30,0
1649858418552,MATH 18,A03,083745,Staff,30,0,30,0
1649858418552,MATH 18,A04,083746,Staff,30,0,30,0
1649858418552,MATH 18,B01,083748,Staff,24,0,30,6
1649858418552,MATH 18,B02,083749,Staff,29,0,30,1
1649858418552,MATH 18,B03,083750,Staff,30,0,30,0
1649858418552,MATH 18,B04,083751,Staff,29,0,30,1
1649858424574,MATH 20A,A01,083754,Staff,39,0,40,1
1649858430602,MATH 20B,A01,083756,Staff,29,0,30,1
1649858430602,MATH 20B,A02,083757,Staff,30,0,30,0
1649858436627,MATH 20C,A01,083760,Staff,27,0,30,3
1649858436627,MATH 20C,A02,083761,Staff,30,0,30,0
1649858436627,MATH 20C,B01,083762,Staff,30,0,30,0
1649858436627,MATH 20C,B02,083763,Staff,30,0,30,0
1649858442651,MATH 20D,A01,083765,Staff,24,0,30,6
1649858442651,MATH 20D,A02,083766,Staff,30,0,30,0
1649858442651,MATH 20D,A03,083767,Staff,30,0,30,0
1649858448675,MATH 20E,A01,083771,Staff,21,0,30,9
1649858448675,MATH 20E,A02,083772,Staff,29,0,30,1
1649858448675,MATH 20E,B01,083773,Staff,25,0,30,5
1649858448675,MATH 20E,B02,083774,Staff,30,0,30,0
1649858454702,MATH 103A,A01,083777,Staff,5,0,30,25
1649858454702,MATH 103A,A02,083778,Staff,23,0,30,7
1649858454702,MATH 103A,B01,083779,Staff,17,0,30,13
1649858454702,MATH 103A,B02,083780,Staff,27,0,30,3
1649858460726,MATH 105,A01,085443,Staff,15,0,30,15
1649858466750,MATH 109,A01,083213,Anzaldo; Leesa B,28,0,30,2
1649858466750,MATH 109,A02,083214,Anzaldo; Leesa B,24,0,30,6
1649858466750,MATH 109,B01,083215,Anzaldo; Leesa B,28,0,30,2
1649858466750,MATH 109,B02,083216,Anzaldo; Leesa B,26,0,30,4
1649858472780,MATH 142A,A01,083219,Chow; Bennett,11,0,30,19
1649858472780,MATH 142A,A02,083220,Chow; Bennett,28,0,30,2
1649858472780,MATH 142A,B01,083221,Chow; Bennett,16,0,30,14
1649858472780,MATH 142A,B02,083222,Chow; Bennett,27,0,30,3
1649858478806,MATH 193A,A01,083224,Staff,0,0,30,30
1649858478806,MATH 193A,A02,083225,Staff,13,0,30,17
1649858478806,MATH 193A,A03,083781,Staff,28,0,30,2
1649858478806,MATH 193A,A04,083782,Staff,28,0,30,2
1649858484834,MATH 197,001,091859,McAuley; Julian John,9999,0,9999,0
1649858490897,COGS 9,A01,083615,Staff,46,0,60,14
1649858496925,COGS 11,A01,083617,Boyle; Mary E. T.,36,0,40,4
1649858502953,COGS 13,A01,083071,Staff,21,0,40,19
1649858508984,COGS 14A,A01,092681,Staff,98,0,100,2
1649858515012,COGS 14B,A01,083073,Cheng; Tzu-Han,39,0,50,11
1649858521038,COGS 17,A01,092677,Staff,74,0,75,1
1649858527068,COGS 100,A01,083619,Staff,34,0,60,26
1649858533093,COGS 101A,A01,083621,Davis; Joshua Daniel,34,0,60,26
1649858539117,COGS 101B,A01,091572,Staff,47,0,60,13
1649858545140,COGS 101C,A01,083625,Delgado; Tania,25,0,30,5
1649858551169,COGS 107A,A01,083627,Boyle; Mary E. T.,41,0,60,19
1649858557195,COGS 118A,A01,083075,Staff,34,0,60,26
1649858563220,CSE 3,A50,083646,Miranda; Gregory Joseph,32,0,38,6
1649858563220,CSE 3,A51,083647,Miranda; Gregory Joseph,37,0,37,0
1649858569252,CSE 8A,A50,083650,Miranda; Gregory Joseph,30,0,40,10
1649858575281,CSE 11,A01,083080,Cao; Yingjun,10,0,40,30
1649858581308,CSE 12,A01,083652,Staff,84,0,100,16
1649858587330,CSE 15L,A01,083654,Staff,39,0,50,11
1649858587330,CSE 15L,A02,083655,Staff,49,0,50,1
1649858593354,CSE 20,A01,083657,Staff,73,0,80,7
1649858599378,CSE 30,A01,083084,Eldon; John,15,0,40,25
1649858605405,CSE 100,A01,083659,Cao; Yingjun,15,0,50,35
1649858611428,CSE 134B,A01,083661,Powell; Thomas Allan,0,3,65,65
1649858617470,CSE 140,A01,083663,Staff,55,0,75,20
1649858623494,CSE 140L,A01,083088,Eldon; John,51,0,75,24
1649858629518,CSE 175,A01,083665,Kumar; Rakesh,16,0,25,9
1649858635543,CSE 190,A00,092507,Staff,15,0,15,0
1649858641569,ECE 45,A01,083139,Staff,34,0,40,6
1649858647604,ECE 65,A50,083695,Staff,22,0,30,8
1649858653632,ECE 109,A01,091882,Touri; Behrouz,66,0,70,4
1649858659657,ECE 180,A00,083140,Abi Samra; Nicholas Camill,29,0,30,1
1649858659657,ECE 180,B00,083141,Abi Samra; Nicholas Camill,17,0,30,13
1649858665681,MATH 10A,A01,083735,Patchell; Gregory David,26,0,30,4
1649858665681,MATH 10A,A02,083736,Patchell; Gregory David,30,0,30,0
1649858665681,MATH 10A,A03,083737,Patchell; Gregory David,30,0,30,0
1649858671705,MATH 10B,A01,083207,Staff,21,0,30,9
1649858671705,MATH 10B,A02,083208,Staff,28,0,30,2
1649858671705,MATH 10B,B01,083739,Staff,27,0,30,3
1649858671705,MATH 10B,B02,083740,Staff,30,0,30,0
1649858677730,MATH 18,A01,083743,Staff,26,0,30,4
1649858677730,MATH 18,A02,083744,Staff,30,0,30,0
1649858677730,MATH 18,A03,083745,Staff,30,0,30,0
1649858677730,MATH 18,A04,083746,Staff,30,0,30,0
1649858677730,MATH 18,B01,083748,Staff,24,0,30,6
1649858677730,MATH 18,B02,083749,Staff,29,0,30,1
1649858677730,MATH 18,B03,083750,Staff,30,0,30,0
1649858677730,MATH 18,B04,083751,Staff,29,0,30,1
1649858683755,MATH 20A,A01,083754,Staff,39,0,40,1
1649858689783,MATH 20B,A01,083756,Staff,29,0,30,1
1649858689783,MATH 20B,A02,083757,Staff,30,0,30,0
1649858695806,MATH 20C,A01,083760,Staff,27,0,30,3
1649858695806,MATH 20C,A02,083761,Staff,30,0,30,0
1649858695806,MATH 20C,B01,083762,Staff,30,0,30,0
1649858695806,MATH 20C,B02,083763,Staff,30,0,30,0
1649858701833,MATH 20D,A01,083765,Staff,24,0,30,6
1649858701833,MATH 20D,A02,083766,Staff,30,0,30,0
1649858701833,MATH 20D,A03,083767,Staff,30,0,30,0
1649858707858,MATH 20E,A01,083771,Staff,21,0,30,9
1649858707858,MATH 20E,A02,083772,Staff,29,0,30,1
1649858707858,MATH 20E,B01,083773,Staff,25,0,30,5
1649858707858,MATH 20E,B02,083774,Staff,30,0,30,0
1649858713882,MATH 103A,A01,083777,Staff,5,0,30,25
1649858713882,MATH 103A,A02,083778,Staff,23,0,30,7
1649858713882,MATH 103A,B01,083779,Staff,17,0,30,13
1649858713882,MATH 103A,B02,083780,Staff,27,0,30,3
1649858719905,MATH 105,A01,085443,Staff,15,0,30,15
1649858725929,MATH 109,A01,083213,Anzaldo; Leesa B,28,0,30,2
1649858725929,MATH 109,A02,083214,Anzaldo; Leesa B,24,0,30,6
1649858725929,MATH 109,B01,083215,Anzaldo; Leesa B,28,0,30,2
1649858725929,MATH 109,B02,083216,Anzaldo; Leesa B,26,0,30,4
1649858731960,MATH 142A,A01,083219,Chow; Bennett,11,0,30,19
1649858731960,MATH 142A,A02,083220,Chow; Bennett,28,0,30,2
1649858731960,MATH 142A,B01,083221,Chow; Bennett,16,0,30,14
1649858731960,MATH 142A,B02,083222,Chow; Bennett,27,0,30,3
1649858738072,MATH 193A,A01,083224,Staff,0,0,30,30
1649858738072,MATH 193A,A02,083225,Staff,13,0,30,17
1649858738072,MATH 193A,A03,083781,Staff,28,0,30,2
1649858738072,MATH 193A,A04,083782,Staff,28,0,30,2
1649858744096,MATH 197,001,091859,McAuley; Julian John,9999,0,9999,0
1649858750153,COGS 9,A01,083615,Staff,46,0,60,14
1649858756177,COGS 11,A01,083617,Boyle; Mary E. T.,36,0,40,4
1649858762202,COGS 13,A01,083071,Staff,21,0,40,19
1649858768229,COGS 14A,A01,092681,Staff,98,0,100,2
1649858774253,COGS 14B,A01,083073,Cheng; Tzu-Han,39,0,50,11
1649858780280,COGS 17,A01,092677,Staff,74,0,75,1
1649858786304,COGS 100,A01,083619,Staff,34,0,60,26
1649858792335,COGS 101A,A01,083621,Davis; Joshua Daniel,34,0,60,26
1649858798359,COGS 101B,A01,091572,Staff,47,0,60,13
1649858804398,COGS 101C,A01,083625,Delgado; Tania,25,0,30,5
1649858810428,COGS 107A,A01,083627,Boyle; Mary E. T.,41,0,60,19
1649858816451,COGS 118A,A01,083075,Staff,34,0,60,26
1649858822480,CSE 3,A50,083646,Miranda; Gregory Joseph,32,0,38,6
1649858822480,CSE 3,A51,083647,Miranda; Gregory Joseph,37,0,37,0
1649858828503,CSE 8A,A50,083650,Miranda; Gregory Joseph,30,0,40,10
1649858834529,CSE 11,A01,083080,Cao; Yingjun,10,0,40,30
1649858840557,CSE 12,A01,083652,Staff,84,0,100,16
1649858846589,CSE 15L,A01,083654,Staff,39,0,50,11
1649858846589,CSE 15L,A02,083655,Staff,49,0,50,1
1649858852612,CSE 20,A01,083657,Staff,73,0,80,7
1649858858644,CSE 30,A01,083084,Eldon; John,15,0,40,25
1649858864669,CSE 100,A01,083659,Cao; Yingjun,15,0,50,35
1649858870691,CSE 134B,A01,083661,Powell; Thomas Allan,0,3,65,65
1649858876718,CSE 140,A01,083663,Staff,55,0,75,20
1649858882746,CSE 140L,A01,083088,Eldon; John,51,0,75,24
1649858888773,CSE 175,A01,083665,Kumar; Rakesh,16,0,25,9
1649858894806,CSE 190,A00,092507,Staff,15,0,15,0
1649858900833,ECE 45,A01,083139,Staff,34,0,40,6
1649858906857,ECE 65,A50,083695,Staff,22,0,30,8
1649858912882,ECE 109,A01,091882,Touri; Behrouz,66,0,70,4
1649858918905,ECE 180,A00,083140,Abi Samra; Nicholas Camill,29,0,30,1
1649858918905,ECE 180,B00,083141,Abi Samra; Nicholas Camill,17,0,30,13
1649858924930,MATH 10A,A01,083735,Patchell; Gregory David,26,0,30,4
1649858924930,MATH 10A,A02,083736,Patchell; Gregory David,29,0,30,1
1649858924930,MATH 10A,A03,083737,Patchell; Gregory David,30,0,30,0
1649858930956,MATH 10B,A01,083207,Staff,21,0,30,9
1649858930956,MATH 10B,A02,083208,Staff,28,0,30,2
1649858930956,MATH 10B,B01,083739,Staff,27,0,30,3
1649858930956,MATH 10B,B02,083740,Staff,30,0,30,0
1649858936995,MATH 18,A01,083743,Staff,26,0,30,4
1649858936995,MATH 18,A02,083744,Staff,30,0,30,0
1649858936995,MATH 18,A03,083745,Staff,30,0,30,0
1649858936995,MATH 18,A04,083746,Staff,30,0,30,0
1649858936995,MATH 18,B01,083748,Staff,24,0,30,6
1649858936995,MATH 18,B02,083749,Staff,29,0,30,1
1649858936995,MATH 18,B03,083750,Staff,30,0,30,0
1649858936995,MATH 18,B04,083751,Staff,29,0,30,1
1649858943024,MATH 20A,A01,083754,Staff,39,0,40,1
1649858949056,MATH 20B,A01,083756,Staff,29,0,30,1
1649858949056,MATH 20B,A02,083757,Staff,30,0,30,0
1649858955083,MATH 20C,A01,083760,Staff,27,0,30,3
1649858955083,MATH 20C,A02,083761,Staff,30,0,30,0
1649858955083,MATH 20C,B01,083762,Staff,30,0,30,0
1649858955083,MATH 20C,B02,083763,Staff,30,0,30,0
1649858961111,MATH 20D,A01,083765,Staff,24,0,30,6
1649858961111,MATH 20D,A02,083766,Staff,30,0,30,0
1649858961111,MATH 20D,A03,083767,Staff,30,0,30,0
1649858967138,MATH 20E,A01,083771,Staff,21,0,30,9
1649858967138,MATH 20E,A02,083772,Staff,29,0,30,1
1649858967138,MATH 20E,B01,083773,Staff,25,0,30,5
1649858967138,MATH 20E,B02,083774,Staff,30,0,30,0
1649858973165,MATH 103A,A01,083777,Staff,5,0,30,25
1649858973165,MATH 103A,A02,083778,Staff,23,0,30,7
1649858973165,MATH 103A,B01,083779,Staff,17,0,30,13
1649858973165,MATH 103A,B02,083780,Staff,27,0,30,3
1649858979188,MATH 105,A01,085443,Staff,15,0,30,15
1649858985217,MATH 109,A01,083213,Anzaldo; Leesa B,28,0,30,2
1649858985217,MATH 109,A02,083214,Anzaldo; Leesa B,24,0,30,6
1649858985217,MATH 109,B01,083215,Anzaldo; Leesa B,28,0,30,2
1649858985217,MATH 109,B02,083216,Anzaldo; Leesa B,26,0,30,4
1649858991245,MATH 142A,A01,083219,Chow; Bennett,11,0,30,19
1649858991245,MATH 142A,A02,083220,Chow; Bennett,28,0,30,2
1649858991245,MATH 142A,B01,083221,Chow; Bennett,16,0,30,14
1649858991245,MATH 142A,B02,083222,Chow; Bennett,27,0,30,3
1649858997269,MATH 193A,A01,083224,Staff,0,0,30,30
1649858997269,MATH 193A,A02,083225,Staff,13,0,30,17
1649858997269,MATH 193A,A03,083781,Staff,28,0,30,2
1649858997269,MATH 193A,A04,083782,Staff,28,0,30,2
1649859003307,MATH 197,001,091859,McAuley; Julian John,9999,0,9999,0
1649859009365,COGS 9,A01,083615,Staff,46,0,60,14
1649859015405,COGS 11,A01,083617,Boyle; Mary E. T.,36,0,40,4
1649859021427,COGS 13,A01,083071,Staff,21,0,40,19
1649859027454,COGS 14A,A01,092681,Staff,98,0,100,2
1649859033477,COGS 14B,A01,083073,Cheng; Tzu-Han,39,0,50,11
1649859039500,COGS 17,A01,092677,Staff,74,0,75,1
1649859045525,COGS 100,A01,083619,Staff,34,0,60,26
1649859051552,COGS 101A,A01,083621,Davis; Joshua Daniel,34,0,60,26
1649859057588,COGS 101B,A01,091572,Staff,47,0,60,13
1649859063615,COGS 101C,A01,083625,Delgado; Tania,25,0,30,5
1649859069638,COGS 107A,A01,083627,Boyle; Mary E. T.,41,0,60,19
1649859075663,COGS 118A,A01,083075,Staff,34,0,60,26
1649859081689,CSE 3,A50,083646,Miranda; Gregory Joseph,32,0,38,6
1649859081689,CSE 3,A51,083647,Miranda; Gregory Joseph,37,0,37,0
1649859087733,CSE 8A,A50,083650,Miranda; Gregory Joseph,30,0,40,10
1649859093762,CSE 11,A01,083080,Cao; Yingjun,10,0,40,30
1649859099794,CSE 12,A01,083652,Staff,84,0,100,16
1649859105818,CSE 15L,A01,083654,Staff,39,0,50,11
1649859105818,CSE 15L,A02,083655,Staff,49,0,50,1
1649859111843,CSE 20,A01,083657,Staff,73,0,80,7
1649859117877,CSE 30,A01,083084,Eldon; John,15,0,40,25
1649859123903,CSE 100,A01,083659,Cao; Yingjun,15,0,50,35
1649859129931,CSE 134B,A01,083661,Powell; Thomas Allan,0,3,65,65
1649859135957,CSE 140,A01,083663,Staff,55,0,75,20
1649859141981,CSE 140L,A01,083088,Eldon; John,51,0,75,24
1649859148003,CSE 175,A01,083665,Kumar; Rakesh,16,0,25,9
1649859154027,CSE 190,A00,092507,Staff,15,0,15,0
1649859160050,ECE 45,A01,083139,Staff,34,0,40,6
1649859166076,ECE 65,A50,083695,Staff,22,0,30,8
1649859172098,ECE 109,A01,091882,Touri; Behrouz,66,0,70,4
1649859178122,ECE 180,A00,083140,Abi Samra; Nicholas Camill,29,0,30,1
1649859178122,ECE 180,B00,083141,Abi Samra; Nicholas Camill,17,0,30,13
1649859184150,MATH 10A,A01,083735,Patchell; Gregory David,26,0,30,4
1649859184150,MATH 10A,A02,083736,Patchell; Gregory David,29,0,30,1
1649859184150,MATH 10A,A03,083737,Patchell; Gregory David,30,0,30,0
1649859190174,MATH 10B,A01,083207,Staff,21,0,30,9
1649859190174,MATH 10B,A02,083208,Staff,28,0,30,2
1649859190174,MATH 10B,B01,083739,Staff,27,0,30,3
1649859190174,MATH 10B,B02,083740,Staff,30,0,30,0
1649859196198,MATH 18,A01,083743,Staff,26,0,30,4
1649859196198,MATH 18,A02,083744,Staff,30,0,30,0
1649859196198,MATH 18,A03,083745,Staff,30,0,30,0
1649859196198,MATH 18,A04,083746,Staff,30,0,30,0
1649859196198,MATH 18,B01,083748,Staff,24,0,30,6
1649859196198,MATH 18,B02,083749,Staff,29,0,30,1
1649859196198,MATH 18,B03,083750,Staff,30,0,30,0
1649859196198,MATH 18,B04,083751,Staff,29,0,30,1
1649859202222,MATH 20A,A01,083754,Staff,39,0,40,1
1649859208256,MATH 20B,A01,083756,Staff,29,0,30,1
1649859208256,MATH 20B,A02,083757,Staff,30,0,30,0
1649859214281,MATH 20C,A01,083760,Staff,27,0,30,3
1649859214281,MATH 20C,A02,083761,Staff,30,0,30,0
1649859214281,MATH 20C,B01,083762,Staff,30,0,30,0
1649859214281,MATH 20C,B02,083763,Staff,30,0,30,0
1649859220306,MATH 20D,A01,083765,Staff,24,0,30,6
1649859220306,MATH 20D,A02,083766,Staff,30,0,30,0
1649859220306,MATH 20D,A03,083767,Staff,30,0,30,0
1649859226332,MATH 20E,A01,083771,Staff,21,0,30,9
1649859226332,MATH 20E,A02,083772,Staff,29,0,30,1
1649859226332,MATH 20E,B01,083773,Staff,25,0,30,5
1649859226332,MATH 20E,B02,083774,Staff,30,0,30,0
1649859232356,MATH 103A,A01,083777,Staff,5,0,30,25
1649859232356,MATH 103A,A02,083778,Staff,23,0,30,7
1649859232356,MATH 103A,B01,083779,Staff,17,0,30,13
1649859232356,MATH 103A,B02,083780,Staff,27,0,30,3
1649859238378,MATH 105,A01,085443,Staff,15,0,30,15
1649859244404,MATH 109,A01,083213,Anzaldo; Leesa B,28,0,30,2
1649859244404,MATH 109,A02,083214,Anzaldo; Leesa B,24,0,30,6
1649859244404,MATH 109,B01,083215,Anzaldo; Leesa B,28,0,30,2
1649859244404,MATH 109,B02,083216,Anzaldo; Leesa B,26,0,30,4
1649859250438,MATH 142A,A01,083219,Chow; Bennett,11,0,30,19
1649859250438,MATH 142A,A02,083220,Chow; Bennett,28,0,30,2
1649859250438,MATH 142A,B01,083221,Chow; Bennett,16,0,30,14
1649859250438,MATH 142A,B02,083222,Chow; Bennett,27,0,30,3
1649859256468,MATH 193A,A01,083224,Staff,0,0,30,30
1649859256468,MATH 193A,A02,083225,Staff,13,0,30,17
1649859256468,MATH 193A,A03,083781,Staff,28,0,30,2
1649859256468,MATH 193A,A04,083782,Staff,28,0,30,2
1649859262491,MATH 197,001,091859,McAuley; Julian John,9999,0,9999,0
1649859268547,COGS 9,A01,083615,Staff,46,0,60,14
1649859274571,COGS 11,A01,083617,Boyle; Mary E. T.,36,0,40,4
1649859280606,COGS 13,A01,083071,Staff,21,0,40,19
1649859286629,COGS 14A,A01,092681,Staff,98,0,100,2
1649859292653,COGS 14B,A01,083073,Cheng; Tzu-Han,39,0,50,11
1649859298685,COGS 17,A01,092677,Staff,74,0,75,1
1649859304711,COGS 100,A01,083619,Staff,34,0,60,26
1649859310734,COGS 101A,A01,083621,Davis; Joshua Daniel,34,0,60,26
1649859316759,COGS 101B,A01,091572,Staff,47,0,60,13
1649859322783,COGS 101C,A01,083625,Delgado; Tania,25,0,30,5
1649859328898,COGS 107A,A01,083627,Boyle; Mary E. T.,41,0,60,19
1649859334924,COGS 118A,A01,083075,Staff,34,0,60,26
1649859340948,CSE 3,A50,083646,Miranda; Gregory Joseph,32,0,38,6
1649859340948,CSE 3,A51,083647,Miranda; Gregory Joseph,37,0,37,0
1649859347016,CSE 8A,A50,083650,Miranda; Gregory Joseph,30,0,40,10
1649859353041,CSE 11,A01,083080,Cao; Yingjun,10,0,40,30
1649859359076,CSE 12,A01,083652,Staff,84,0,100,16
1649859365098,CSE 15L,A01,083654,Staff,39,0,50,11
1649859365098,CSE 15L,A02,083655,Staff,49,0,50,1
1649859371126,CSE 20,A01,083657,Staff,73,0,80,7
1649859377152,CSE 30,A01,083084,Eldon; John,15,0,40,25
1649859383181,CSE 100,A01,083659,Cao; Yingjun,15,0,50,35
1649859389206,CSE 134B,A01,083661,Powell; Thomas Allan,0,3,65,65
1649859395246,CSE 140,A01,083663,Staff,55,0,75,20
1649859401273,CSE 140L,A01,083088,Eldon; John,51,0,75,24
1649859407299,CSE 175,A01,083665,Kumar; Rakesh,16,0,25,9
1649859413336,CSE 190,A00,092507,Staff,15,0,15,0
1649859419359,ECE 45,A01,083139,Staff,34,0,40,6
1649859425383,ECE 65,A50,083695,Staff,22,0,30,8
1649859431406,ECE 109,A01,091882,Touri; Behrouz,66,0,70,4
1649859437444,ECE 180,A00,083140,Abi Samra; Nicholas Camill,29,0,30,1
1649859437444,ECE 180,B00,083141,Abi Samra; Nicholas Camill,17,0,30,13
1649859443472,MATH 10A,A01,083735,Patchell; Gregory David,26,0,30,4
1649859443472,MATH 10A,A02,083736,Patchell; Gregory David,29,0,30,1
1649859443472,MATH 10A,A03,083737,Patchell; Gregory David,30,0,30,0
1649859449496,MATH 10B,A01,083207,Staff,21,0,30,9
1649859449496,MATH 10B,A02,083208,Staff,28,0,30,2
1649859449496,MATH 10B,B01,083739,Staff,27,0,30,3
1649859449496,MATH 10B,B02,083740,Staff,30,0,30,0
1649859455530,MATH 18,A01,083743,Staff,26,0,30,4
1649859455530,MATH 18,A02,083744,Staff,30,0,30,0
1649859455530,MATH 18,A03,083745,Staff,30,0,30,0
1649859455530,MATH 18,A04,083746,Staff,30,0,30,0
1649859455530,MATH 18,B01,083748,Staff,24,0,30,6
1649859455530,MATH 18,B02,083749,Staff,29,0,30,1
1649859455530,MATH 18,B03,083750,Staff,30,0,30,0
1649859455530,MATH 18,B04,083751,Staff,29,0,30,1
1649859461553,MATH 20A,A01,083754,Staff,39,0,40,1
1649859467577,MATH 20B,A01,083756,Staff,29,0,30,1
1649859467577,MATH 20B,A02,083757,Staff,30,0,30,0
1649859473618,MATH 20C,A01,083760,Staff,27,0,30,3
1649859473618,MATH 20C,A02,083761,Staff,30,0,30,0
1649859473618,MATH 20C,B01,083762,Staff,30,0,30,0
1649859473618,MATH 20C,B02,083763,Staff,30,0,30,0
1649859479648,MATH 20D,A01,083765,Staff,24,0,30,6
1649859479648,MATH 20D,A02,083766,Staff,30,0,30,0
1649859479648,MATH 20D,A03,083767,Staff,30,0,30,0
1649859485688,MATH 20E,A01,083771,Staff,21,0,30,9
1649859485688,MATH 20E,A02,083772,Staff,29,0,30,1
1649859485688,MATH 20E,B01,083773,Staff,25,0,30,5
1649859485688,MATH 20E,B02,083774,Staff,30,0,30,0
1649859491728,MATH 103A,A01,083777,Staff,5,0,30,25
1649859491728,MATH 103A,A02,083778,Staff,23,0,30,7
1649859491728,MATH 103A,B01,083779,Staff,17,0,30,13
1649859491728,MATH 103A,B02,083780,Staff,27,0,30,3
1649859497756,MATH 105,A01,085443,Staff,15,0,30,15
1649859503780,MATH 109,A01,083213,Anzaldo; Leesa B,28,0,30,2
1649859503780,MATH 109,A02,083214,Anzaldo; Leesa B,24,0,30,6
1649859503780,MATH 109,B01,083215,Anzaldo; Leesa B,28,0,30,2
1649859503780,MATH 109,B02,083216,Anzaldo; Leesa B,26,0,30,4
1649859509809,MATH 142A,A01,083219,Chow; Bennett,11,0,30,19
1649859509809,MATH 142A,A02,083220,Chow; Bennett,28,0,30,2
1649859509809,MATH 142A,B01,083221,Chow; Bennett,16,0,30,14
1649859509809,MATH 142A,B02,083222,Chow; Bennett,27,0,30,3
1649859515837,MATH 193A,A01,083224,Staff,0,0,30,30
1649859515837,MATH 193A,A02,083225,Staff,13,0,30,17
1649859515837,MATH 193A,A03,083781,Staff,28,0,30,2
1649859515837,MATH 193A,A04,083782,Staff,28,0,30,2
1649859521858,MATH 197,001,091859,McAuley; Julian John,9999,0,9999,0
1649859527910,COGS 9,A01,083615,Staff,46,0,60,14
1649859533937,COGS 11,A01,083617,Boyle; Mary E. T.,36,0,40,4
1649859539961,COGS 13,A01,083071,Staff,21,0,40,19
1649859545983,COGS 14A,A01,092681,Staff,98,0,100,2
1649859552010,COGS 14B,A01,083073,Cheng; Tzu-Han,39,0,50,11
1649859558040,COGS 17,A01,092677,Staff,74,0,75,1
1649859564064,COGS 100,A01,083619,Staff,34,0,60,26
1649859570087,COGS 101A,A01,083621,Davis; Joshua Daniel,34,0,60,26
1649859576113,COGS 101B,A01,091572,Staff,47,0,60,13
1649859582140,COGS 101C,A01,083625,Delgado; Tania,25,0,30,5
1649859588163,COGS 107A,A01,083627,Boyle; Mary E. T.,41,0,60,19
1649859594189,COGS 118A,A01,083075,Staff,34,0,60,26
1649859600218,CSE 3,A50,083646,Miranda; Gregory Joseph,32,0,38,6
1649859600218,CSE 3,A51,083647,Miranda; Gregory Joseph,37,0,37,0
1649859606246,CSE 8A,A50,083650,Miranda; Gregory Joseph,30,0,40,10
1649859612278,CSE 11,A01,083080,Cao; Yingjun,10,0,40,30
1649859618309,CSE 12,A01,083652,Staff,84,0,100,16
1649859624332,CSE 15L,A01,083654,Staff,39,0,50,11
1649859624332,CSE 15L,A02,083655,Staff,49,0,50,1
1649859630360,CSE 20,A01,083657,Staff,73,0,80,7
1649859636383,CSE 30,A01,083084,Eldon; John,15,0,40,25
1649859642409,CSE 100,A01,083659,Cao; Yingjun,15,0,50,35
1649859648432,CSE 134B,A01,083661,Powell; Thomas Allan,0,3,65,65
1649859654459,CSE 140,A01,083663,Staff,55,0,75,20
1649859660487,CSE 140L,A01,083088,Eldon; John,51,0,75,24
1649859666511,CSE 175,A01,083665,Kumar; Rakesh,16,0,25,9
1649859672535,CSE 190,A00,092507,Staff,15,0,15,0
1649859678571,ECE 45,A01,083139,Staff,34,0,40,6
1649859684598,ECE 65,A50,083695,Staff,22,0,30,8
1649859690626,ECE 109,A01,091882,Touri; Behrouz,66,0,70,4
1649859696649,ECE 180,A00,083140,Abi Samra; Nicholas Camill,29,0,30,1
1649859696649,ECE 180,B00,083141,Abi Samra; Nicholas Camill,17,0,30,13
1649859702677,MATH 10A,A01,083735,Patchell; Gregory David,26,0,30,4
1649859702677,MATH 10A,A02,083736,Patchell; Gregory David,29,0,30,1
1649859702677,MATH 10A,A03,083737,Patchell; Gregory David,30,0,30,0
1649859708714,MATH 10B,A01,083207,Staff,21,0,30,9
1649859708714,MATH 10B,A02,083208,Staff,28,0,30,2
1649859708714,MATH 10B,B01,083739,Staff,27,0,30,3
1649859708714,MATH 10B,B02,083740,Staff,30,0,30,0
1649859714746,MATH 18,A01,083743,Staff,26,0,30,4
1649859714746,MATH 18,A02,083744,Staff,30,0,30,0
1649859714746,MATH 18,A03,083745,Staff,30,0,30,0
1649859714746,MATH 18,A04,083746,Staff,30,0,30,0
1649859714746,MATH 18,B01,083748,Staff,24,0,30,6
1649859714746,MATH 18,B02,083749,Staff,29,0,30,1
1649859714746,MATH 18,B03,083750,Staff,30,0,30,0
1649859714746,MATH 18,B04,083751,Staff,29,0,30,1
1649859720769,MATH 20A,A01,083754,Staff,39,0,40,1
1649859726791,MATH 20B,A01,083756,Staff,29,0,30,1
1649859726791,MATH 20B,A02,083757,Staff,30,0,30,0
1649859732816,MATH 20C,A01,083760,Staff,27,0,30,3
1649859732816,MATH 20C,A02,083761,Staff,30,0,30,0
1649859732816,MATH 20C,B01,083762,Staff,30,0,30,0
1649859732816,MATH 20C,B02,083763,Staff,30,0,30,0
1649859738840,MATH 20D,A01,083765,Staff,24,0,30,6
1649859738840,MATH 20D,A02,083766,Staff,30,0,30,0
1649859738840,MATH 20D,A03,083767,Staff,30,0,30,0
1649859744863,MATH 20E,A01,083771,Staff,21,0,30,9
1649859744863,MATH 20E,A02,083772,Staff,29,0,30,1
1649859744863,MATH 20E,B01,083773,Staff,25,0,30,5
1649859744863,MATH 20E,B02,083774,Staff,30,0,30,0
1649859750893,MATH 103A,A01,083777,Staff,5,0,30,25
1649859750893,MATH 103A,A02,083778,Staff,23,0,30,7
1649859750893,MATH 103A,B01,083779,Staff,17,0,30,13
1649859750893,MATH 103A,B02,083780,Staff,27,0,30,3
1649859756917,MATH 105,A01,085443,Staff,15,0,30,15
1649859762946,MATH 109,A01,083213,Anzaldo; Leesa B,28,0,30,2
1649859762946,MATH 109,A02,083214,Anzaldo; Leesa B,24,0,30,6
1649859762946,MATH 109,B01,083215,Anzaldo; Leesa B,28,0,30,2
1649859762946,MATH 109,B02,083216,Anzaldo; Leesa B,26,0,30,4
1649859768969,MATH 142A,A01,083219,Chow; Bennett,11,0,30,19
1649859768969,MATH 142A,A02,083220,Chow; Bennett,28,0,30,2
1649859768969,MATH 142A,B01,083221,Chow; Bennett,16,0,30,14
1649859768969,MATH 142A,B02,083222,Chow; Bennett,27,0,30,3
1649859774997,MATH 193A,A01,083224,Staff,0,0,30,30
1649859774997,MATH 193A,A02,083225,Staff,13,0,30,17
1649859774997,MATH 193A,A03,083781,Staff,28,0,30,2
1649859774997,MATH 193A,A04,083782,Staff,28,0,30,2
1649859781020,MATH 197,001,091859,McAuley; Julian John,9999,0,9999,0
1649859787074,COGS 9,A01,083615,Staff,46,0,60,14
1649859793097,COGS 11,A01,083617,Boyle; Mary E. T.,36,0,40,4
1649859799120,COGS 13,A01,083071,Staff,21,0,40,19
1649859805144,COGS 14A,A01,092681,Staff,98,0,100,2
1649859811177,COGS 14B,A01,083073,Cheng; Tzu-Han,39,0,50,11
1649859817206,COGS 17,A01,092677,Staff,74,0,75,1
1649859823232,COGS 100,A01,083619,Staff,34,0,60,26
1649859829265,COGS 101A,A01,083621,Davis; Joshua Daniel,34,0,60,26
1649859835289,COGS 101B,A01,091572,Staff,47,0,60,13
1649859841318,COGS 101C,A01,083625,Delgado; Tania,25,0,30,5
1649859847344,COGS 107A,A01,083627,Boyle; Mary E. T.,41,0,60,19
1649859853367,COGS 118A,A01,083075,Staff,34,0,60,26
1649859859391,CSE 3,A50,083646,Miranda; Gregory Joseph,32,0,38,6
1649859859391,CSE 3,A51,083647,Miranda; Gregory Joseph,37,0,37,0
1649859865418,CSE 8A,A50,083650,Miranda; Gregory Joseph,30,0,40,10
1649859871442,CSE 11,A01,083080,Cao; Yingjun,10,0,40,30
1649859877467,CSE 12,A01,083652,Staff,84,0,100,16
1649859883494,CSE 15L,A01,083654,Staff,39,0,50,11
1649859883494,CSE 15L,A02,083655,Staff,49,0,50,1
1649859889527,CSE 20,A01,083657,Staff,73,0,80,7
1649859895554,CSE 30,A01,083084,Eldon; John,15,0,40,25
1649859901579,CSE 100,A01,083659,Cao; Yingjun,15,0,50,35
1649859907609,CSE 134B,A01,083661,Powell; Thomas Allan,0,3,65,65
1649859913633,CSE 140,A01,083663,Staff,55,0,75,20
1649859919657,CSE 140L,A01,083088,Eldon; John,51,0,75,24
1649859925768,CSE 175,A01,083665,Kumar; Rakesh,16,0,25,9
1649859931792,CSE 190,A00,092507,Staff,15,0,15,0
1649859937818,ECE 45,A01,083139,Staff,34,0,40,6
1649859943844,ECE 65,A50,083695,Staff,22,0,30,8
1649859949871,ECE 109,A01,091882,Touri; Behrouz,66,0,70,4
1649859955899,ECE 180,A00,083140,Abi Samra; Nicholas Camill,29,0,30,1
1649859955899,ECE 180,B00,083141,Abi Samra; Nicholas Camill,17,0,30,13
1649859961930,MATH 10A,A01,083735,Patchell; Gregory David,26,0,30,4
1649859961930,MATH 10A,A02,083736,Patchell; Gregory David,29,0,30,1
1649859961930,MATH 10A,A03,083737,Patchell; Gregory David,30,0,30,0
1649859967959,MATH 10B,A01,083207,Staff,21,0,30,9
1649859967959,MATH 10B,A02,083208,Staff,28,0,30,2
1649859967959,MATH 10B,B01,083739,Staff,27,0,30,3
1649859967959,MATH 10B,B02,083740,Staff,30,0,30,0
1649859973991,MATH 18,A01,083743,Staff,26,0,30,4
1649859973991,MATH 18,A02,083744,Staff,30,0,30,0
1649859973991,MATH 18,A03,083745,Staff,30,0,30,0
1649859973991,MATH 18,A04,083746,Staff,30,0,30,0
1649859973991,MATH 18,B01,083748,Staff,24,0,30,6
1649859973991,MATH 18,B02,083749,Staff,29,0,30,1
1649859973991,MATH 18,B03,083750,Staff,30,0,30,0
1649859973991,MATH 18,B04,083751,Staff,29,0,30,1
1649859980014,MATH 20A,A01,083754,Staff,39,0,40,1
1649859986041,MATH 20B,A01,083756,Staff,29,0,30,1
1649859986041,MATH 20B,A02,083757,Staff,30,0,30,0
1649859992071,MATH 20C,A01,083760,Staff,27,0,30,3
1649859992071,MATH 20C,A02,083761,Staff,30,0,30,0
1649859992071,MATH 20C,B01,083762,Staff,30,0,30,0
1649859992071,MATH 20C,B02,083763,Staff,30,0,30,0
1649859998099,MATH 20D,A01,083765,Staff,24,0,30,6
1649859998099,MATH 20D,A02,083766,Staff,30,0,30,0
1649859998099,MATH 20D,A03,083767,Staff,30,0,30,0
1649860004126,MATH 20E,A01,083771,Staff,21,0,30,9
1649860004126,MATH 20E,A02,083772,Staff,29,0,30,1
1649860004126,MATH 20E,B01,083773,Staff,25,0,30,5
1649860004126,MATH 20E,B02,083774,Staff,30,0,30,0
1649860010153,MATH 103A,A01,083777,Staff,5,0,30,25
1649860010153,MATH 103A,A02,083778,Staff,23,0,30,7
1649860010153,MATH 103A,B01,083779,Staff,17,0,30,13
1649860010153,MATH 103A,B02,083780,Staff,27,0,30,3
1649860016180,MATH 105,A01,085443,Staff,15,0,30,15
1649860022204,MATH 109,A01,083213,Anzaldo; Leesa B,28,0,30,2
1649860022204,MATH 109,A02,083214,Anzaldo; Leesa B,24,0,30,6
1649860022204,MATH 109,B01,083215,Anzaldo; Leesa B,28,0,30,2
1649860022204,MATH 109,B02,083216,Anzaldo; Leesa B,26,0,30,4
1649860028227,MATH 142A,A01,083219,Chow; Bennett,11,0,30,19
1649860028227,MATH 142A,A02,083220,Chow; Bennett,28,0,30,2
1649860028227,MATH 142A,B01,083221,Chow; Bennett,16,0,30,14
1649860028227,MATH 142A,B02,083222,Chow; Bennett,27,0,30,3
1649860034259,MATH 193A,A01,083224,Staff,0,0,30,30
1649860034259,MATH 193A,A02,083225,Staff,13,0,30,17
1649860034259,MATH 193A,A03,083781,Staff,28,0,30,2
1649860034259,MATH 193A,A04,083782,Staff,28,0,30,2
1649860040294,MATH 197,001,091859,McAuley; Julian John,9999,0,9999,0
1649860046347,COGS 9,A01,083615,Staff,46,0,60,14
1649860052371,COGS 11,A01,083617,Boyle; Mary E. T.,36,0,40,4
1649860058397,COGS 13,A01,083071,Staff,21,0,40,19
1649860064422,COGS 14A,A01,092681,Staff,98,0,100,2
1649860070450,COGS 14B,A01,083073,Cheng; Tzu-Han,39,0,50,11
1649860076473,COGS 17,A01,092677,Staff,74,0,75,1
1649860082499,COGS 100,A01,083619,Staff,34,0,60,26
1649860088523,COGS 101A,A01,083621,Davis; Joshua Daniel,34,0,60,26
1649860094548,COGS 101B,A01,091572,Staff,47,0,60,13
1649860100579,COGS 101C,A01,083625,Delgado; Tania,25,0,30,5
1649860106606,COGS 107A,A01,083627,Boyle; Mary E. T.,41,0,60,19
1649860112635,COGS 118A,A01,083075,Staff,34,0,60,26
1649860118660,CSE 3,A50,083646,Miranda; Gregory Joseph,32,0,38,6
1649860118660,CSE 3,A51,083647,Miranda; Gregory Joseph,37,0,37,0
1649860124695,CSE 8A,A50,083650,Miranda; Gregory Joseph,30,0,40,10
1649860130723,CSE 11,A01,083080,Cao; Yingjun,10,0,40,30
1649860136745,CSE 12,A01,083652,Staff,84,0,100,16
1649860142782,CSE 15L,A01,083654,Staff,39,0,50,11
1649860142782,CSE 15L,A02,083655,Staff,49,0,50,1
1649860148806,CSE 20,A01,083657,Staff,73,0,80,7
1649860154830,CSE 30,A01,083084,Eldon; John,15,0,40,25
1649860160854,CSE 100,A01,083659,Cao; Yingjun,15,0,50,35
1649860166878,CSE 134B,A01,083661,Powell; Thomas Allan,0,3,65,65
1649860172913,CSE 140,A01,083663,Staff,55,0,75,20
1649860178938,CSE 140L,A01,083088,Eldon; John,51,0,75,24
1649860184967,CSE 175,A01,083665,Kumar; Rakesh,16,0,25,9
1649860190993,CSE 190,A00,092507,Staff,15,0,15,0
1649860197016,ECE 45,A01,083139,Staff,34,0,40,6
1649860203046,ECE 65,A50,083695,Staff,22,0,30,8
1649860209072,ECE 109,A01,091882,Touri; Behrouz,66,0,70,4
1649860215096,ECE 180,A00,083140,Abi Samra; Nicholas Camill,29,0,30,1
1649860215096,ECE 180,B00,083141,Abi Samra; Nicholas Camill,17,0,30,13
1649860221121,MATH 10A,A01,083735,Patchell; Gregory David,26,0,30,4
1649860221121,MATH 10A,A02,083736,Patchell; Gregory David,29,0,30,1
1649860221121,MATH 10A,A03,083737,Patchell; Gregory David,30,0,30,0
1649860227150,MATH 10B,A01,083207,Staff,21,0,30,9
1649860227150,MATH 10B,A02,083208,Staff,28,0,30,2
1649860227150,MATH 10B,B01,083739,Staff,27,0,30,3
1649860227150,MATH 10B,B02,083740,Staff,30,0,30,0
1649860233180,MATH 18,A01,083743,Staff,26,0,30,4
1649860233180,MATH 18,A02,083744,Staff,30,0,30,0
1649860233180,MATH 18,A03,083745,Staff,30,0,30,0
1649860233180,MATH 18,A04,083746,Staff,30,0,30,0
1649860233180,MATH 18,B01,083748,Staff,24,0,30,6
1649860233180,MATH 18,B02,083749,Staff,29,0,30,1
1649860233180,MATH 18,B03,083750,Staff,30,0,30,0
1649860233180,MATH 18,B04,083751,Staff,29,0,30,1
1649860239204,MATH 20A,A01,083754,Staff,39,0,40,1
1649860245228,MATH 20B,A01,083756,Staff,29,0,30,1
1649860245228,MATH 20B,A02,083757,Staff,30,0,30,0
1649860251255,MATH 20C,A01,083760,Staff,27,0,30,3
1649860251255,MATH 20C,A02,083761,Staff,30,0,30,0
1649860251255,MATH 20C,B01,083762,Staff,30,0,30,0
1649860251255,MATH 20C,B02,083763,Staff,30,0,30,0
1649860257280,MATH 20D,A01,083765,Staff,24,0,30,6
1649860257280,MATH 20D,A02,083766,Staff,30,0,30,0
1649860257280,MATH 20D,A03,083767,Staff,30,0,30,0
1649860263309,MATH 20E,A01,083771,Staff,21,0,30,9
1649860263309,MATH 20E,A02,083772,Staff,29,0,30,1
1649860263309,MATH 20E,B01,083773,Staff,25,0,30,5
1649860263309,MATH 20E,B02,083774,Staff,30,0,30,0
1649860269331,MATH 103A,A01,083777,Staff,5,0,30,25
1649860269331,MATH 103A,A02,083778,Staff,23,0,30,7
1649860269331,MATH 103A,B01,083779,Staff,17,0,30,13
1649860269331,MATH 103A,B02,083780,Staff,27,0,30,3
1649860275355,MATH 105,A01,085443,Staff,15,0,30,15
1649860281394,MATH 109,A01,083213,Anzaldo; Leesa B,28,0,30,2
1649860281394,MATH 109,A02,083214,Anzaldo; Leesa B,24,0,30,6
1649860281394,MATH 109,B01,083215,Anzaldo; Leesa B,28,0,30,2
1649860281394,MATH 109,B02,083216,Anzaldo; Leesa B,26,0,30,4
1649860287422,MATH 142A,A01,083219,Chow; Bennett,11,0,30,19
1649860287422,MATH 142A,A02,083220,Chow; Bennett,28,0,30,2
1649860287422,MATH 142A,B01,083221,Chow; Bennett,16,0,30,14
1649860287422,MATH 142A,B02,083222,Chow; Bennett,27,0,30,3
1649860293446,MATH 193A,A01,083224,Staff,0,0,30,30
1649860293446,MATH 193A,A02,083225,Staff,13,0,30,17
1649860293446,MATH 193A,A03,083781,Staff,28,0,30,2
1649860293446,MATH 193A,A04,083782,Staff,28,0,30,2
1649860299477,MATH 197,001,091859,McAuley; Julian John,9999,0,9999,0
1649860305557,COGS 9,A01,083615,Staff,46,0,60,14
1649860311582,COGS 11,A01,083617,Boyle; Mary E. T.,36,0,40,4
1649860317607,COGS 13,A01,083071,Staff,21,0,40,19
1649860323629,COGS 14A,A01,092681,Staff,98,0,100,2
1649860329669,COGS 14B,A01,083073,Cheng; Tzu-Han,39,0,50,11
1649860335697,COGS 17,A01,092677,Staff,74,0,75,1
1649860341729,COGS 100,A01,083619,Staff,34,0,60,26
1649860347754,COGS 101A,A01,083621,Davis; Joshua Daniel,34,0,60,26
1649860353787,COGS 101B,A01,091572,Staff,47,0,60,13
1649860359814,COGS 101C,A01,083625,Delgado; Tania,25,0,30,5
1649860365846,COGS 107A,A01,083627,Boyle; Mary E. T.,41,0,60,19
1649860371880,COGS 118A,A01,083075,Staff,34,0,60,26
1649860377907,CSE 3,A50,083646,Miranda; Gregory Joseph,32,0,38,6
1649860377907,CSE 3,A51,083647,Miranda; Gregory Joseph,37,0,37,0
1649860383932,CSE 8A,A50,083650,Miranda; Gregory Joseph,30,0,40,10
1649860389974,CSE 11,A01,083080,Cao; Yingjun,10,0,40,30
1649860395998,CSE 12,A01,083652,Staff,84,0,100,16
1649860402023,CSE 15L,A01,083654,Staff,39,0,50,11
1649860402023,CSE 15L,A02,083655,Staff,49,0,50,1
1649860408047,CSE 20,A01,083657,Staff,73,0,80,7
1649860414069,CSE 30,A01,083084,Eldon; John,15,0,40,25
1649860420092,CSE 100,A01,083659,Cao; Yingjun,15,0,50,35
1649860426119,CSE 134B,A01,083661,Powell; Thomas Allan,0,3,65,65
1649860432141,CSE 140,A01,083663,Staff,55,0,75,20
1649860438165,CSE 140L,A01,083088,Eldon; John,51,0,75,24
1649860444194,CSE 175,A01,083665,Kumar; Rakesh,16,0,25,9
1649860450217,CSE 190,A00,092507,Staff,15,0,15,0
1649860456249,ECE 45,A01,083139,Staff,34,0,40,6
1649860462275,ECE 65,A50,083695,Staff,22,0,30,8
1649860468300,ECE 109,A01,091882,Touri; Behrouz,66,0,70,4
1649860474323,ECE 180,A00,083140,Abi Samra; Nicholas Camill,29,0,30,1
1649860474323,ECE 180,B00,083141,Abi Samra; Nicholas Camill,17,0,30,13
1649860480346,MATH 10A,A01,083735,Patchell; Gregory David,26,0,30,4
1649860480346,MATH 10A,A02,083736,Patchell; Gregory David,29,0,30,1
1649860480346,MATH 10A,A03,083737,Patchell; Gregory David,30,0,30,0
1649860486370,MATH 10B,A01,083207,Staff,21,0,30,9
1649860486370,MATH 10B,A02,083208,Staff,28,0,30,2
1649860486370,MATH 10B,B01,083739,Staff,27,0,30,3
1649860486370,MATH 10B,B02,083740,Staff,30,0,30,0
1649860492393,MATH 18,A01,083743,Staff,26,0,30,4
1649860492393,MATH 18,A02,083744,Staff,30,0,30,0
1649860492393,MATH 18,A03,083745,Staff,30,0,30,0
1649860492393,MATH 18,A04,083746,Staff,30,0,30,0
1649860492393,MATH 18,B01,083748,Staff,24,0,30,6
1649860492393,MATH 18,B02,083749,Staff,29,0,30,1
1649860492393,MATH 18,B03,083750,Staff,30,0,30,0
1649860492393,MATH 18,B04,083751,Staff,29,0,30,1
1649860498414,MATH 20A,A01,083754,Staff,39,0,40,1
1649860504441,MATH 20B,A01,083756,Staff,29,0,30,1
1649860504441,MATH 20B,A02,083757,Staff,30,0,30,0
1649860510470,MATH 20C,A01,083760,Staff,27,0,30,3
1649860510470,MATH 20C,A02,083761,Staff,30,0,30,0
1649860510470,MATH 20C,B01,083762,Staff,30,0,30,0
1649860510470,MATH 20C,B02,083763,Staff,30,0,30,0
1649860516499,MATH 20D,A01,083765,Staff,24,0,30,6
1649860516499,MATH 20D,A02,083766,Staff,30,0,30,0
1649860516499,MATH 20D,A03,083767,Staff,30,0,30,0
1649860522617,MATH 20E,A01,083771,Staff,21,0,30,9
1649860522617,MATH 20E,A02,083772,Staff,29,0,30,1
1649860522617,MATH 20E,B01,083773,Staff,25,0,30,5
1649860522617,MATH 20E,B02,083774,Staff,30,0,30,0
1649860528645,MATH 103A,A01,083777,Staff,5,0,30,25
1649860528645,MATH 103A,A02,083778,Staff,23,0,30,7
1649860528645,MATH 103A,B01,083779,Staff,17,0,30,13
1649860528645,MATH 103A,B02,083780,Staff,27,0,30,3
1649860534674,MATH 105,A01,085443,Staff,15,0,30,15
1649860540704,MATH 109,A01,083213,Anzaldo; Leesa B,28,0,30,2
1649860540704,MATH 109,A02,083214,Anzaldo; Leesa B,24,0,30,6
1649860540704,MATH 109,B01,083215,Anzaldo; Leesa B,28,0,30,2
1649860540704,MATH 109,B02,083216,Anzaldo; Leesa B,26,0,30,4
1649860546731,MATH 142A,A01,083219,Chow; Bennett,11,0,30,19
1649860546731,MATH 142A,A02,083220,Chow; Bennett,28,0,30,2
1649860546731,MATH 142A,B01,083221,Chow; Bennett,16,0,30,14
1649860546731,MATH 142A,B02,083222,Chow; Bennett,27,0,30,3
1649860552758,MATH 193A,A01,083224,Staff,0,0,30,30
1649860552758,MATH 193A,A02,083225,Staff,13,0,30,17
1649860552758,MATH 193A,A03,083781,Staff,28,0,30,2
1649860552758,MATH 193A,A04,083782,Staff,28,0,30,2
1649860558784,MATH 197,001,091859,McAuley; Julian John,9999,0,9999,0
1649860564852,COGS 9,A01,083615,Staff,46,0,60,14
1649860570892,COGS 11,A01,083617,Boyle; Mary E. T.,36,0,40,4
1649860576919,COGS 13,A01,083071,Staff,21,0,40,19
1649860582943,COGS 14A,A01,092681,Staff,98,0,100,2
1649860588974,COGS 14B,A01,083073,Cheng; Tzu-Han,39,0,50,11
1649860594998,COGS 17,A01,092677,Staff,74,0,75,1
1649860601024,COGS 100,A01,083619,Staff,34,0,60,26
1649860607048,COGS 101A,A01,083621,Davis; Joshua Daniel,34,0,60,26
1649860613073,COGS 101B,A01,091572,Staff,47,0,60,13
1649860619099,COGS 101C,A01,083625,Delgado; Tania,25,0,30,5
1649860625123,COGS 107A,A01,083627,Boyle; Mary E. T.,41,0,60,19
1649860631146,COGS 118A,A01,083075,Staff,34,0,60,26
1649860637180,CSE 3,A50,083646,Miranda; Gregory Joseph,32,0,38,6
1649860637180,CSE 3,A51,083647,Miranda; Gregory Joseph,37,0,37,0
1649860643202,CSE 8A,A50,083650,Miranda; Gregory Joseph,30,0,40,10
1649860649226,CSE 11,A01,083080,Cao; Yingjun,10,0,40,30
1649860655260,CSE 12,A01,083652,Staff,84,0,100,16
1649860661287,CSE 15L,A01,083654,Staff,39,0,50,11
1649860661287,CSE 15L,A02,083655,Staff,49,0,50,1
1649860667312,CSE 20,A01,083657,Staff,73,0,80,7
1649860673337,CSE 30,A01,083084,Eldon; John,15,0,40,25
1649860679361,CSE 100,A01,083659,Cao; Yingjun,15,0,50,35
1649860685384,CSE 134B,A01,083661,Powell; Thomas Allan,0,3,65,65
1649860691409,CSE 140,A01,083663,Staff,55,0,75,20
1649860697432,CSE 140L,A01,083088,Eldon; John,51,0,75,24
1649860703457,CSE 175,A01,083665,Kumar; Rakesh,16,0,25,9
1649860709481,CSE 190,A00,092507,Staff,15,0,15,0
1649860715506,ECE 45,A01,083139,Staff,34,0,40,6
1649860721539,ECE 65,A50,083695,Staff,22,0,30,8
1649860727563,ECE 109,A01,091882,Touri; Behrouz,66,0,70,4
1649860733595,ECE 180,A00,083140,Abi Samra; Nicholas Camill,29,0,30,1
1649860733595,ECE 180,B00,083141,Abi Samra; Nicholas Camill,17,0,30,13
1649860739621,MATH 10A,A01,083735,Patchell; Gregory David,26,0,30,4
1649860739621,MATH 10A,A02,083736,Patchell; Gregory David,29,0,30,1
1649860739621,MATH 10A,A03,083737,Patchell; Gregory David,30,0,30,0
1649860745654,MATH 10B,A01,083207,Staff,21,0,30,9
1649860745654,MATH 10B,A02,083208,Staff,28,0,30,2
1649860745654,MATH 10B,B01,083739,Staff,27,0,30,3
1649860745654,MATH 10B,B02,083740,Staff,30,0,30,0
1649860751690,MATH 18,A01,083743,Staff,26,0,30,4
1649860751690,MATH 18,A02,083744,Staff,30,0,30,0
1649860751690,MATH 18,A03,083745,Staff,30,0,30,0
1649860751690,MATH 18,A04,083746,Staff,30,0,30,0
1649860751690,MATH 18,B01,083748,Staff,24,0,30,6
1649860751690,MATH 18,B02,083749,Staff,29,0,30,1
1649860751690,MATH 18,B03,083750,Staff,30,0,30,0
1649860751690,MATH 18,B04,083751,Staff,29,0,30,1
1649860757715,MATH 20A,A01,083754,Staff,39,0,40,1
1649860763741,MATH 20B,A01,083756,Staff,29,0,30,1
1649860763741,MATH 20B,A02,083757,Staff,30,0,30,0
1649860769765,MATH 20C,A01,083760,Staff,27,0,30,3
1649860769765,MATH 20C,A02,083761,Staff,30,0,30,0
1649860769765,MATH 20C,B01,083762,Staff,30,0,30,0
1649860769765,MATH 20C,B02,083763,Staff,30,0,30,0
1649860775789,MATH 20D,A01,083765,Staff,24,0,30,6
1649860775789,MATH 20D,A02,083766,Staff,30,0,30,0
1649860775789,MATH 20D,A03,083767,Staff,30,0,30,0
1649860781813,MATH 20E,A01,083771,Staff,21,0,30,9
1649860781813,MATH 20E,A02,083772,Staff,29,0,30,1
1649860781813,MATH 20E,B01,083773,Staff,25,0,30,5
1649860781813,MATH 20E,B02,083774,Staff,30,0,30,0
1649860787840,MATH 103A,A01,083777,Staff,5,0,30,25
1649860787840,MATH 103A,A02,083778,Staff,23,0,30,7
1649860787840,MATH 103A,B01,083779,Staff,17,0,30,13
1649860787840,MATH 103A,B02,083780,Staff,27,0,30,3
1649860793864,MATH 105,A01,085443,Staff,15,0,30,15
1649860799888,MATH 109,A01,083213,Anzaldo; Leesa B,28,0,30,2
1649860799888,MATH 109,A02,083214,Anzaldo; Leesa B,24,0,30,6
1649860799888,MATH 109,B01,083215,Anzaldo; Leesa B,28,0,30,2
1649860799888,MATH 109,B02,083216,Anzaldo; Leesa B,26,0,30,4
1649860805925,MATH 142A,A01,083219,Chow; Bennett,11,0,30,19
1649860805925,MATH 142A,A02,083220,Chow; Bennett,28,0,30,2
1649860805925,MATH 142A,B01,083221,Chow; Bennett,16,0,30,14
1649860805925,MATH 142A,B02,083222,Chow; Bennett,27,0,30,3
1649860811948,MATH 193A,A01,083224,Staff,0,0,30,30
1649860811948,MATH 193A,A02,083225,Staff,13,0,30,17
1649860811948,MATH 193A,A03,083781,Staff,28,0,30,2
1649860811948,MATH 193A,A04,083782,Staff,28,0,30,2
1649860817970,MATH 197,001,091859,McAuley; Julian John,9999,0,9999,0
1649860824023,COGS 9,A01,083615,Staff,46,0,60,14
1649860830051,COGS 11,A01,083617,Boyle; Mary E. T.,36,0,40,4
1649860836075,COGS 13,A01,083071,Staff,21,0,40,19
1649860842101,COGS 14A,A01,092681,Staff,98,0,100,2
1649860848124,COGS 14B,A01,083073,Cheng; Tzu-Han,39,0,50,11
1649860854150,COGS 17,A01,092677,Staff,74,0,75,1
1649860860240,COGS 100,A01,083619,Staff,34,0,60,26
1649860866265,COGS 101A,A01,083621,Davis; Joshua Daniel,34,0,60,26
1649860872288,COGS 101B,A01,091572,Staff,47,0,60,13
1649860878315,COGS 101C,A01,083625,Delgado; Tania,25,0,30,5
1649860884337,COGS 107A,A01,083627,Boyle; Mary E. T.,41,0,60,19
1649860890361,COGS 118A,A01,083075,Staff,34,0,60,26
1649860896386,CSE 3,A50,083646,Miranda; Gregory Joseph,32,0,38,6
1649860896386,CSE 3,A51,083647,Miranda; Gregory Joseph,37,0,37,0
1649860902414,CSE 8A,A50,083650,Miranda; Gregory Joseph,30,0,40,10
1649860908439,CSE 11,A01,083080,Cao; Yingjun,10,0,40,30
1649860914463,CSE 12,A01,083652,Staff,84,0,100,16
1649860920487,CSE 15L,A01,083654,Staff,39,0,50,11
1649860920487,CSE 15L,A02,083655,Staff,49,0,50,1
1649860926510,CSE 20,A01,083657,Staff,73,0,80,7
1649860932533,CSE 30,A01,083084,Eldon; John,15,0,40,25
1649860938556,CSE 100,A01,083659,Cao; Yingjun,15,0,50,35
1649860944578,CSE 134B,A01,083661,Powell; Thomas Allan,0,3,65,65
1649860950602,CSE 140,A01,083663,Staff,55,0,75,20
1649860956628,CSE 140L,A01,083088,Eldon; John,51,0,75,24
1649860962649,CSE 175,A01,083665,Kumar; Rakesh,16,0,25,9
1649860968672,CSE 190,A00,092507,Staff,15,0,15,0
1649860974694,ECE 45,A01,083139,Staff,34,0,40,6
1649860980717,ECE 65,A50,083695,Staff,22,0,30,8
1649860986743,ECE 109,A01,091882,Touri; Behrouz,66,0,70,4
1649860992770,ECE 180,A00,083140,Abi Samra; Nicholas Camill,29,0,30,1
1649860992770,ECE 180,B00,083141,Abi Samra; Nicholas Camill,17,0,30,13
1649860998799,MATH 10A,A01,083735,Patchell; Gregory David,26,0,30,4
1649860998799,MATH 10A,A02,083736,Patchell; Gregory David,29,0,30,1
1649860998799,MATH 10A,A03,083737,Patchell; Gregory David,30,0,30,0
1649861004823,MATH 10B,A01,083207,Staff,21,0,30,9
1649861004823,MATH 10B,A02,083208,Staff,28,0,30,2
1649861004823,MATH 10B,B01,083739,Staff,27,0,30,3
1649861004823,MATH 10B,B02,083740,Staff,30,0,30,0
1649861010851,MATH 18,A01,083743,Staff,26,0,30,4
1649861010851,MATH 18,A02,083744,Staff,30,0,30,0
1649861010851,MATH 18,A03,083745,Staff,30,0,30,0
1649861010851,MATH 18,A04,083746,Staff,30,0,30,0
1649861010851,MATH 18,B01,083748,Staff,24,0,30,6
1649861010851,MATH 18,B02,083749,Staff,29,0,30,1
1649861010851,MATH 18,B03,083750,Staff,30,0,30,0
1649861010851,MATH 18,B04,083751,Staff,29,0,30,1
1649861016877,MATH 20A,A01,083754,Staff,39,0,40,1
1649861022899,MATH 20B,A01,083756,Staff,29,0,30,1
1649861022899,MATH 20B,A02,083757,Staff,30,0,30,0
1649861028922,MATH 20C,A01,083760,Staff,27,0,30,3
1649861028922,MATH 20C,A02,083761,Staff,30,0,30,0
1649861028922,MATH 20C,B01,083762,Staff,30,0,30,0
1649861028922,MATH 20C,B02,083763,Staff,30,0,30,0
1649861034945,MATH 20D,A01,083765,Staff,24,0,30,6
1649861034945,MATH 20D,A02,083766,Staff,30,0,30,0
1649861034945,MATH 20D,A03,083767,Staff,30,0,30,0
1649861040980,MATH 20E,A01,083771,Staff,21,0,30,9
1649861040980,MATH 20E,A02,083772,Staff,29,0,30,1
1649861040980,MATH 20E,B01,083773,Staff,25,0,30,5
1649861040980,MATH 20E,B02,083774,Staff,30,0,30,0
1649861047006,MATH 103A,A01,083777,Staff,5,0,30,25
1649861047006,MATH 103A,A02,083778,Staff,23,0,30,7
1649861047006,MATH 103A,B01,083779,Staff,17,0,30,13
1649861047006,MATH 103A,B02,083780,Staff,27,0,30,3
1649861053030,MATH 105,A01,085443,Staff,15,0,30,15
1649861059054,MATH 109,A01,083213,Anzaldo; Leesa B,28,0,30,2
1649861059054,MATH 109,A02,083214,Anzaldo; Leesa B,24,0,30,6
1649861059054,MATH 109,B01,083215,Anzaldo; Leesa B,28,0,30,2
1649861059054,MATH 109,B02,083216,Anzaldo; Leesa B,26,0,30,4
1649861065078,MATH 142A,A01,083219,Chow; Bennett,11,0,30,19
1649861065078,MATH 142A,A02,083220,Chow; Bennett,28,0,30,2
1649861065078,MATH 142A,B01,083221,Chow; Bennett,16,0,30,14
1649861065078,MATH 142A,B02,083222,Chow; Bennett,27,0,30,3
1649861071102,MATH 193A,A01,083224,Staff,0,0,30,30
1649861071102,MATH 193A,A02,083225,Staff,13,0,30,17
1649861071102,MATH 193A,A03,083781,Staff,28,0,30,2
1649861071102,MATH 193A,A04,083782,Staff,28,0,30,2
1649861077127,MATH 197,001,091859,McAuley; Julian John,9999,0,9999,0
1649861083177,COGS 9,A01,083615,Staff,46,0,60,14
1649861089209,COGS 11,A01,083617,Boyle; Mary E. T.,36,0,40,4
1649861095232,COGS 13,A01,083071,Staff,21,0,40,19
1649861101255,COGS 14A,A01,092681,Staff,98,0,100,2
1649861107281,COGS 14B,A01,083073,Cheng; Tzu-Han,39,0,50,11
1649861113382,COGS 17,A01,092677,Staff,74,0,75,1
1649861119415,COGS 100,A01,083619,Staff,34,0,60,26
1649861125446,COGS 101A,A01,083621,Davis; Joshua Daniel,34,0,60,26
1649861131469,COGS 101B,A01,091572,Staff,47,0,60,13
1649861137492,COGS 101C,A01,083625,Delgado; Tania,25,0,30,5
1649861143516,COGS 107A,A01,083627,Boyle; Mary E. T.,41,0,60,19
1649861149543,COGS 118A,A01,083075,Staff,34,0,60,26
1649861155570,CSE 3,A50,083646,Miranda; Gregory Joseph,32,0,38,6
1649861155570,CSE 3,A51,083647,Miranda; Gregory Joseph,37,0,37,0
1649861161595,CSE 8A,A50,083650,Miranda; Gregory Joseph,30,0,40,10
1649861167622,CSE 11,A01,083080,Cao; Yingjun,10,0,40,30
1649861173651,CSE 12,A01,083652,Staff,84,0,100,16
1649861179674,CSE 15L,A01,083654,Staff,39,0,50,11
1649861179674,CSE 15L,A02,083655,Staff,49,0,50,1
1649861185700,CSE 20,A01,083657,Staff,73,0,80,7
1649861191732,CSE 30,A01,083084,Eldon; John,15,0,40,25
1649861197760,CSE 100,A01,083659,Cao; Yingjun,15,0,50,35
1649861203795,CSE 134B,A01,083661,Powell; Thomas Allan,0,3,65,65
1649861209817,CSE 140,A01,083663,Staff,55,0,75,20
1649861215840,CSE 140L,A01,083088,Eldon; John,51,0,75,24
1649861221862,CSE 175,A01,083665,Kumar; Rakesh,16,0,25,9
1649861227886,CSE 190,A00,092507,Staff,15,0,15,0
1649861233911,ECE 45,A01,083139,Staff,34,0,40,6
1649861239934,ECE 65,A50,083695,Staff,22,0,30,8
1649861245960,ECE 109,A01,091882,Touri; Behrouz,66,0,70,4
1649861251987,ECE 180,A00,083140,Abi Samra; Nicholas Camill,29,0,30,1
1649861251987,ECE 180,B00,083141,Abi Samra; Nicholas Camill,17,0,30,13
1649861258011,MATH 10A,A01,083735,Patchell; Gregory David,26,0,30,4
1649861258011,MATH 10A,A02,083736,Patchell; Gregory David,29,0,30,1
1649861258011,MATH 10A,A03,083737,Patchell; Gregory David,30,0,30,0
1649861264032,MATH 10B,A01,083207,Staff,21,0,30,9
1649861264032,MATH 10B,A02,083208,Staff,28,0,30,2
1649861264032,MATH 10B,B01,083739,Staff,27,0,30,3
1649861264032,MATH 10B,B02,083740,Staff,30,0,30,0
1649861270062,MATH 18,A01,083743,Staff,26,0,30,4
1649861270062,MATH 18,A02,083744,Staff,30,0,30,0
1649861270062,MATH 18,A03,083745,Staff,30,0,30,0
1649861270062,MATH 18,A04,083746,Staff,30,0,30,0
1649861270062,MATH 18,B01,083748,Staff,24,0,30,6
1649861270062,MATH 18,B02,083749,Staff,29,0,30,1
1649861270062,MATH 18,B03,083750,Staff,30,0,30,0
1649861270062,MATH 18,B04,083751,Staff,29,0,30,1
1649861276085,MATH 20A,A01,083754,Staff,39,0,40,1
1649861282106,MATH 20B,A01,083756,Staff,29,0,30,1
1649861282106,MATH 20B,A02,083757,Staff,30,0,30,0
1649861288133,MATH 20C,A01,083760,Staff,27,0,30,3
1649861288133,MATH 20C,A02,083761,Staff,30,0,30,0
1649861288133,MATH 20C,B01,083762,Staff,30,0,30,0
1649861288133,MATH 20C,B02,083763,Staff,30,0,30,0
1649861294156,MATH 20D,A01,083765,Staff,24,0,30,6
1649861294156,MATH 20D,A02,083766,Staff,30,0,30,0
1649861294156,MATH 20D,A03,083767,Staff,30,0,30,0
1649861300185,MATH 20E,A01,083771,Staff,21,0,30,9
1649861300185,MATH 20E,A02,083772,Staff,29,0,30,1
1649861300185,MATH 20E,B01,083773,Staff,25,0,30,5
1649861300185,MATH 20E,B02,083774,Staff,30,0,30,0
1649861306216,MATH 103A,A01,083777,Staff,5,0,30,25
1649861306216,MATH 103A,A02,083778,Staff,23,0,30,7
1649861306216,MATH 103A,B01,083779,Staff,17,0,30,13
1649861306216,MATH 103A,B02,083780,Staff,27,0,30,3
1649861312242,MATH 105,A01,085443,Staff,15,0,30,15
1649861318270,MATH 109,A01,083213,Anzaldo; Leesa B,28,0,30,2
1649861318270,MATH 109,A02,083214,Anzaldo; Leesa B,24,0,30,6
1649861318270,MATH 109,B01,083215,Anzaldo; Leesa B,28,0,30,2
1649861318270,MATH 109,B02,083216,Anzaldo; Leesa B,26,0,30,4
1649861324293,MATH 142A,A01,083219,Chow; Bennett,11,0,30,19
1649861324293,MATH 142A,A02,083220,Chow; Bennett,28,0,30,2
1649861324293,MATH 142A,B01,083221,Chow; Bennett,16,0,30,14
1649861324293,MATH 142A,B02,083222,Chow; Bennett,27,0,30,3
1649861330322,MATH 193A,A01,083224,Staff,0,0,30,30
1649861330322,MATH 193A,A02,083225,Staff,13,0,30,17
1649861330322,MATH 193A,A03,083781,Staff,28,0,30,2
1649861330322,MATH 193A,A04,083782,Staff,28,0,30,2
1649861336346,MATH 197,001,091859,McAuley; Julian John,9999,0,9999,0
1649861342398,COGS 9,A01,083615,Staff,46,0,60,14
1649861348425,COGS 11,A01,083617,Boyle; Mary E. T.,36,0,40,4
1649861354451,COGS 13,A01,083071,Staff,21,0,40,19
1649861360473,COGS 14A,A01,092681,Staff,98,0,100,2
1649861366502,COGS 14B,A01,083073,Cheng; Tzu-Han,39,0,50,11
1649861372529,COGS 17,A01,092677,Staff,74,0,75,1
1649861378554,COGS 100,A01,083619,Staff,34,0,60,26
1649861384582,COGS 101A,A01,083621,Davis; Joshua Daniel,34,0,60,26
1649861390604,COGS 101B,A01,091572,Staff,47,0,60,13
1649861396630,COGS 101C,A01,083625,Delgado; Tania,25,0,30,5
1649861402667,COGS 107A,A01,083627,Boyle; Mary E. T.,41,0,60,19
1649861408692,COGS 118A,A01,083075,Staff,34,0,60,26
1649861414721,CSE 3,A50,083646,Miranda; Gregory Joseph,32,0,38,6
1649861414721,CSE 3,A51,083647,Miranda; Gregory Joseph,37,0,37,0
1649861420745,CSE 8A,A50,083650,Miranda; Gregory Joseph,30,0,40,10
1649861426770,CSE 11,A01,083080,Cao; Yingjun,10,0,40,30
1649861432796,CSE 12,A01,083652,Staff,83,0,100,17
1649861438823,CSE 15L,A01,083654,Staff,38,0,50,12
1649861438823,CSE 15L,A02,083655,Staff,49,0,50,1
1649861444850,CSE 20,A01,083657,Staff,73,0,80,7
1649861450873,CSE 30,A01,083084,Eldon; John,15,0,40,25
1649861456898,CSE 100,A01,083659,Cao; Yingjun,15,0,50,35
1649861462926,CSE 134B,A01,083661,Powell; Thomas Allan,0,3,65,65
1649861468951,CSE 140,A01,083663,Staff,55,0,75,20
1649861474978,CSE 140L,A01,083088,Eldon; John,51,0,75,24
1649861481008,CSE 175,A01,083665,Kumar; Rakesh,16,0,25,9
1649861487030,CSE 190,A00,092507,Staff,15,0,15,0
1649861493057,ECE 45,A01,083139,Staff,34,0,40,6
1649861499084,ECE 65,A50,083695,Staff,22,0,30,8
1649861505110,ECE 109,A01,091882,Touri; Behrouz,66,0,70,4
1649861511132,ECE 180,A00,083140,Abi Samra; Nicholas Camill,29,0,30,1
1649861511132,ECE 180,B00,083141,Abi Samra; Nicholas Camill,17,0,30,13
1649861517161,MATH 10A,A01,083735,Patchell; Gregory David,26,0,30,4
1649861517161,MATH 10A,A02,083736,Patchell; Gregory David,29,0,30,1
1649861517161,MATH 10A,A03,083737,Patchell; Gregory David,30,0,30,0
1649861523199,MATH 10B,A01,083207,Staff,21,0,30,9
1649861523199,MATH 10B,A02,083208,Staff,28,0,30,2
1649861523199,MATH 10B,B01,083739,Staff,27,0,30,3
1649861523199,MATH 10B,B02,083740,Staff,30,0,30,0
1649861529223,MATH 18,A01,083743,Staff,26,0,30,4
1649861529223,MATH 18,A02,083744,Staff,30,0,30,0
1649861529223,MATH 18,A03,083745,Staff,30,0,30,0
1649861529223,MATH 18,A04,083746,Staff,30,0,30,0
1649861529223,MATH 18,B01,083748,Staff,24,0,30,6
1649861529223,MATH 18,B02,083749,Staff,29,0,30,1
1649861529223,MATH 18,B03,083750,Staff,30,0,30,0
1649861529223,MATH 18,B04,083751,Staff,29,0,30,1
1649861535274,MATH 20A,A01,083754,Staff,39,0,40,1
1649861541298,MATH 20B,A01,083756,Staff,29,0,30,1
1649861541298,MATH 20B,A02,083757,Staff,30,0,30,0
1649861547324,MATH 20C,A01,083760,Staff,27,0,30,3
1649861547324,MATH 20C,A02,083761,Staff,30,0,30,0
1649861547324,MATH 20C,B01,083762,Staff,30,0,30,0
1649861547324,MATH 20C,B02,083763,Staff,30,0,30,0
1649861553349,MATH 20D,A01,083765,Staff,24,0,30,6
1649861553349,MATH 20D,A02,083766,Staff,30,0,30,0
1649861553349,MATH 20D,A03,083767,Staff,30,0,30,0
1649861559378,MATH 20E,A01,083771,Staff,21,0,30,9
1649861559378,MATH 20E,A02,083772,Staff,29,0,30,1
1649861559378,MATH 20E,B01,083773,Staff,25,0,30,5
1649861559378,MATH 20E,B02,083774,Staff,30,0,30,0
1649861565401,MATH 103A,A01,083777,Staff,5,0,30,25
1649861565401,MATH 103A,A02,083778,Staff,23,0,30,7
1649861565401,MATH 103A,B01,083779,Staff,17,0,30,13
1649861565401,MATH 103A,B02,083780,Staff,27,0,30,3
1649861571424,MATH 105,A01,085443,Staff,15,0,30,15
1649861577452,MATH 109,A01,083213,Anzaldo; Leesa B,28,0,30,2
1649861577452,MATH 109,A02,083214,Anzaldo; Leesa B,24,0,30,6
1649861577452,MATH 109,B01,083215,Anzaldo; Leesa B,28,0,30,2
1649861577452,MATH 109,B02,083216,Anzaldo; Leesa B,26,0,30,4
1649861583474,MATH 142A,A01,083219,Chow; Bennett,11,0,30,19
1649861583474,MATH 142A,A02,083220,Chow; Bennett,28,0,30,2
1649861583474,MATH 142A,B01,083221,Chow; Bennett,16,0,30,14
1649861583474,MATH 142A,B02,083222,Chow; Bennett,27,0,30,3
1649861589499,MATH 193A,A01,083224,Staff,0,0,30,30
1649861589499,MATH 193A,A02,083225,Staff,13,0,30,17
1649861589499,MATH 193A,A03,083781,Staff,28,0,30,2
1649861589499,MATH 193A,A04,083782,Staff,28,0,30,2
1649861595522,MATH 197,001,091859,McAuley; Julian John,9999,0,9999,0
1649861601594,COGS 9,A01,083615,Staff,46,0,60,14
1649861607620,COGS 11,A01,083617,Boyle; Mary E. T.,36,0,40,4
1649861613644,COGS 13,A01,083071,Staff,21,0,40,19
1649861619677,COGS 14A,A01,092681,Staff,98,0,100,2
1649861625701,COGS 14B,A01,083073,Cheng; Tzu-Han,39,0,50,11
1649861631725,COGS 17,A01,092677,Staff,74,0,75,1
1649861637754,COGS 100,A01,083619,Staff,34,0,60,26
1649861643778,COGS 101A,A01,083621,Davis; Joshua Daniel,34,0,60,26
1649861649805,COGS 101B,A01,091572,Staff,47,0,60,13
1649861655829,COGS 101C,A01,083625,Delgado; Tania,25,0,30,5
1649861661857,COGS 107A,A01,083627,Boyle; Mary E. T.,41,0,60,19
1649861667884,COGS 118A,A01,083075,Staff,34,0,60,26
1649861673912,CSE 3,A50,083646,Miranda; Gregory Joseph,32,0,38,6
1649861673912,CSE 3,A51,083647,Miranda; Gregory Joseph,37,0,37,0
1649861679937,CSE 8A,A50,083650,Miranda; Gregory Joseph,30,0,40,10
1649861685963,CSE 11,A01,083080,Cao; Yingjun,10,0,40,30
1649861691987,CSE 12,A01,083652,Staff,83,0,100,17
1649861698018,CSE 15L,A01,083654,Staff,38,0,50,12
1649861698018,CSE 15L,A02,083655,Staff,49,0,50,1
1649861704047,CSE 20,A01,083657,Staff,73,0,80,7
1649861710160,CSE 30,A01,083084,Eldon; John,15,0,40,25
1649861716185,CSE 100,A01,083659,Cao; Yingjun,15,0,50,35
1649861722212,CSE 134B,A01,083661,Powell; Thomas Allan,0,3,65,65
1649861728238,CSE 140,A01,083663,Staff,55,0,75,20
1649861734264,CSE 140L,A01,083088,Eldon; John,51,0,75,24
1649861740291,CSE 175,A01,083665,Kumar; Rakesh,16,0,25,9
1649861746317,CSE 190,A00,092507,Staff,15,0,15,0
1649861752342,ECE 45,A01,083139,Staff,34,0,40,6
1649861758369,ECE 65,A50,083695,Staff,22,0,30,8
1649861764391,ECE 109,A01,091882,Touri; Behrouz,66,0,70,4
1649861770413,ECE 180,A00,083140,Abi Samra; Nicholas Camill,29,0,30,1
1649861770413,ECE 180,B00,083141,Abi Samra; Nicholas Camill,17,0,30,13
1649861776436,MATH 10A,A01,083735,Patchell; Gregory David,26,0,30,4
1649861776436,MATH 10A,A02,083736,Patchell; Gregory David,29,0,30,1
1649861776436,MATH 10A,A03,083737,Patchell; Gregory David,30,0,30,0
1649861782471,MATH 10B,A01,083207,Staff,21,0,30,9
1649861782471,MATH 10B,A02,083208,Staff,28,0,30,2
1649861782471,MATH 10B,B01,083739,Staff,27,0,30,3
1649861782471,MATH 10B,B02,083740,Staff,30,0,30,0
1649861788502,MATH 18,A01,083743,Staff,26,0,30,4
1649861788502,MATH 18,A02,083744,Staff,30,0,30,0
1649861788502,MATH 18,A03,083745,Staff,30,0,30,0
1649861788502,MATH 18,A04,083746,Staff,30,0,30,0
1649861788502,MATH 18,B01,083748,Staff,24,0,30,6
1649861788502,MATH 18,B02,083749,Staff,29,0,30,1
1649861788502,MATH 18,B03,083750,Staff,30,0,30,0
1649861788502,MATH 18,B04,083751,Staff,29,0,30,1
1649861794531,MATH 20A,A01,083754,Staff,39,0,40,1
1649861800554,MATH 20B,A01,083756,Staff,29,0,30,1
1649861800554,MATH 20B,A02,083757,Staff,30,0,30,0
1649861806581,MATH 20C,A01,083760,Staff,27,0,30,3
1649861806581,MATH 20C,A02,083761,Staff,30,0,30,0
1649861806581,MATH 20C,B01,083762,Staff,30,0,30,0
1649861806581,MATH 20C,B02,083763,Staff,30,0,30,0
1649861812606,MATH 20D,A01,083765,Staff,24,0,30,6
1649861812606,MATH 20D,A02,083766,Staff,30,0,30,0
1649861812606,MATH 20D,A03,083767,Staff,30,0,30,0
1649861818633,MATH 20E,A01,083771,Staff,21,0,30,9
1649861818633,MATH 20E,A02,083772,Staff,29,0,30,1
1649861818633,MATH 20E,B01,083773,Staff,25,0,30,5
1649861818633,MATH 20E,B02,083774,Staff,30,0,30,0
1649861824661,MATH 103A,A01,083777,Staff,5,0,30,25
1649861824661,MATH 103A,A02,083778,Staff,23,0,30,7
1649861824661,MATH 103A,B01,083779,Staff,17,0,30,13
1649861824661,MATH 103A,B02,083780,Staff,27,0,30,3
1649861830685,MATH 105,A01,085443,Staff,15,0,30,15
1649861836713,MATH 109,A01,083213,Anzaldo; Leesa B,28,0,30,2
1649861836713,MATH 109,A02,083214,Anzaldo; Leesa B,24,0,30,6
1649861836713,MATH 109,B01,083215,Anzaldo; Leesa B,28,0,30,2
1649861836713,MATH 109,B02,083216,Anzaldo; Leesa B,26,0,30,4
1649861842747,MATH 142A,A01,083219,Chow; Bennett,11,0,30,19
1649861842747,MATH 142A,A02,083220,Chow; Bennett,28,0,30,2
1649861842747,MATH 142A,B01,083221,Chow; Bennett,16,0,30,14
1649861842747,MATH 142A,B02,083222,Chow; Bennett,27,0,30,3
1649861848777,MATH 193A,A01,083224,Staff,0,0,30,30
1649861848777,MATH 193A,A02,083225,Staff,13,0,30,17
1649861848777,MATH 193A,A03,083781,Staff,28,0,30,2
1649861848777,MATH 193A,A04,083782,Staff,28,0,30,2
1649861854799,MATH 197,001,091859,McAuley; Julian John,9999,0,9999,0
1649861860858,COGS 9,A01,083615,Staff,46,0,60,14
1649861866884,COGS 11,A01,083617,Boyle; Mary E. T.,36,0,40,4
1649861872910,COGS 13,A01,083071,Staff,21,0,40,19
1649861878943,COGS 14A,A01,092681,Staff,98,0,100,2
1649861884970,COGS 14B,A01,083073,Cheng; Tzu-Han,39,0,50,11
1649861890993,COGS 17,A01,092677,Staff,74,0,75,1
1649861897018,COGS 100,A01,083619,Staff,34,0,60,26
1649861903045,COGS 101A,A01,083621,Davis; Joshua Daniel,34,0,60,26
1649861909073,COGS 101B,A01,091572,Staff,47,0,60,13
1649861915100,COGS 101C,A01,083625,Delgado; Tania,25,0,30,5
1649861921130,COGS 107A,A01,083627,Boyle; Mary E. T.,41,0,60,19
1649861927157,COGS 118A,A01,083075,Staff,34,0,60,26
1649861933181,CSE 3,A50,083646,Miranda; Gregory Joseph,32,0,38,6
1649861933181,CSE 3,A51,083647,Miranda; Gregory Joseph,37,0,37,0
1649861939203,CSE 8A,A50,083650,Miranda; Gregory Joseph,30,0,40,10
1649861945227,CSE 11,A01,083080,Cao; Yingjun,10,0,40,30
1649861951250,CSE 12,A01,083652,Staff,83,0,100,17
1649861957274,CSE 15L,A01,083654,Staff,38,0,50,12
1649861957274,CSE 15L,A02,083655,Staff,49,0,50,1
1649861963312,CSE 20,A01,083657,Staff,73,0,80,7
1649861969338,CSE 30,A01,083084,Eldon; John,15,0,40,25
1649861975362,CSE 100,A01,083659,Cao; Yingjun,15,0,50,35
1649861981390,CSE 134B,A01,083661,Powell; Thomas Allan,0,3,65,65
1649861987416,CSE 140,A01,083663,Staff,55,0,75,20
1649861993442,CSE 140L,A01,083088,Eldon; John,51,0,75,24
1649861999471,CSE 175,A01,083665,Kumar; Rakesh,16,0,25,9
1649862005503,CSE 190,A00,092507,Staff,15,0,15,0
1649862011534,ECE 45,A01,083139,Staff,34,0,40,6
1649862017561,ECE 65,A50,083695,Staff,22,0,30,8
1649862023584,ECE 109,A01,091882,Touri; Behrouz,66,0,70,4
1649862029613,ECE 180,A00,083140,Abi Samra; Nicholas Camill,29,0,30,1
1649862029613,ECE 180,B00,083141,Abi Samra; Nicholas Camill,17,0,30,13
1649862035640,MATH 10A,A01,083735,Patchell; Gregory David,26,0,30,4
1649862035640,MATH 10A,A02,083736,Patchell; Gregory David,29,0,30,1
1649862035640,MATH 10A,A03,083737,Patchell; Gregory David,30,0,30,0
1649862041675,MATH 10B,A01,083207,Staff,21,0,30,9
1649862041675,MATH 10B,A02,083208,Staff,28,0,30,2
1649862041675,MATH 10B,B01,083739,Staff,27,0,30,3
1649862041675,MATH 10B,B02,083740,Staff,30,0,30,0
1649862047720,MATH 18,A01,083743,Staff,26,0,30,4
1649862047720,MATH 18,A02,083744,Staff,30,0,30,0
1649862047720,MATH 18,A03,083745,Staff,30,0,30,0
1649862047720,MATH 18,A04,083746,Staff,30,0,30,0
1649862047720,MATH 18,B01,083748,Staff,24,0,30,6
1649862047720,MATH 18,B02,083749,Staff,29,0,30,1
1649862047720,MATH 18,B03,083750,Staff,30,0,30,0
1649862047720,MATH 18,B04,083751,Staff,29,0,30,1
1649862053744,MATH 20A,A01,083754,Staff,39,0,40,1
1649862059773,MATH 20B,A01,083756,Staff,29,0,30,1
1649862059773,MATH 20B,A02,083757,Staff,30,0,30,0
1649862065800,MATH 20C,A01,083760,Staff,27,0,30,3
1649862065800,MATH 20C,A02,083761,Staff,30,0,30,0
1649862065800,MATH 20C,B01,083762,Staff,30,0,30,0
1649862065800,MATH 20C,B02,083763,Staff,30,0,30,0
1649862071827,MATH 20D,A01,083765,Staff,24,0,30,6
1649862071827,MATH 20D,A02,083766,Staff,30,0,30,0
1649862071827,MATH 20D,A03,083767,Staff,30,0,30,0
1649862077851,MATH 20E,A01,083771,Staff,21,0,30,9
1649862077851,MATH 20E,A02,083772,Staff,29,0,30,1
1649862077851,MATH 20E,B01,083773,Staff,25,0,30,5
1649862077851,MATH 20E,B02,083774,Staff,30,0,30,0
1649862083876,MATH 103A,A01,083777,Staff,5,0,30,25
1649862083876,MATH 103A,A02,083778,Staff,23,0,30,7
1649862083876,MATH 103A,B01,083779,Staff,17,0,30,13
1649862083876,MATH 103A,B02,083780,Staff,27,0,30,3
1649862089906,MATH 105,A01,085443,Staff,15,0,30,15
1649862095930,MATH 109,A01,083213,Anzaldo; Leesa B,28,0,30,2
1649862095930,MATH 109,A02,083214,Anzaldo; Leesa B,24,0,30,6
1649862095930,MATH 109,B01,083215,Anzaldo; Leesa B,28,0,30,2
1649862095930,MATH 109,B02,083216,Anzaldo; Leesa B,26,0,30,4
1649862101955,MATH 142A,A01,083219,Chow; Bennett,11,0,30,19
1649862101955,MATH 142A,A02,083220,Chow; Bennett,28,0,30,2
1649862101955,MATH 142A,B01,083221,Chow; Bennett,16,0,30,14
1649862101955,MATH 142A,B02,083222,Chow; Bennett,27,0,30,3
1649862107990,MATH 193A,A01,083224,Staff,0,0,30,30
1649862107990,MATH 193A,A02,083225,Staff,13,0,30,17
1649862107990,MATH 193A,A03,083781,Staff,28,0,30,2
1649862107990,MATH 193A,A04,083782,Staff,28,0,30,2
1649862114015,MATH 197,001,091859,McAuley; Julian John,9999,0,9999,0
1649862120075,COGS 9,A01,083615,Staff,46,0,60,14
1649862126099,COGS 11,A01,083617,Boyle; Mary E. T.,36,0,40,4
1649862132125,COGS 13,A01,083071,Staff,21,0,40,19
1649862138146,COGS 14A,A01,092681,Staff,98,0,100,2
1649862144169,COGS 14B,A01,083073,Cheng; Tzu-Han,39,0,50,11
1649862150197,COGS 17,A01,092677,Staff,74,0,75,1
1649862156222,COGS 100,A01,083619,Staff,34,0,60,26
1649862162249,COGS 101A,A01,083621,Davis; Joshua Daniel,34,0,60,26
1649862168278,COGS 101B,A01,091572,Staff,47,0,60,13
1649862174305,COGS 101C,A01,083625,Delgado; Tania,25,0,30,5
1649862180329,COGS 107A,A01,083627,Boyle; Mary E. T.,41,0,60,19
1649862186353,COGS 118A,A01,083075,Staff,34,0,60,26
1649862192385,CSE 3,A50,083646,Miranda; Gregory Joseph,32,0,38,6
1649862192385,CSE 3,A51,083647,Miranda; Gregory Joseph,37,0,37,0
1649862198418,CSE 8A,A50,083650,Miranda; Gregory Joseph,30,0,40,10
1649862204443,CSE 11,A01,083080,Cao; Yingjun,10,0,40,30
1649862210469,CSE 12,A01,083652,Staff,82,0,100,18
1649862216498,CSE 15L,A01,083654,Staff,37,0,50,13
1649862216498,CSE 15L,A02,083655,Staff,49,0,50,1
1649862222524,CSE 20,A01,083657,Staff,73,0,80,7
1649862228548,CSE 30,A01,083084,Eldon; John,14,0,40,26
1649862234575,CSE 100,A01,083659,Cao; Yingjun,15,0,50,35
1649862240611,CSE 134B,A01,083661,Powell; Thomas Allan,0,3,65,65
1649862246633,CSE 140,A01,083663,Staff,55,0,75,20
1649862252657,CSE 140L,A01,083088,Eldon; John,51,0,75,24
1649862258683,CSE 175,A01,083665,Kumar; Rakesh,16,0,25,9
1649862264706,CSE 190,A00,092507,Staff,15,0,15,0
1649862270733,ECE 45,A01,083139,Staff,34,0,40,6
1649862276760,ECE 65,A50,083695,Staff,22,0,30,8
1649862282791,ECE 109,A01,091882,Touri; Behrouz,66,0,70,4
1649862288814,ECE 180,A00,083140,Abi Samra; Nicholas Camill,29,0,30,1
1649862288814,ECE 180,B00,083141,Abi Samra; Nicholas Camill,17,0,30,13
1649862294838,MATH 10A,A01,083735,Patchell; Gregory David,26,0,30,4
1649862294838,MATH 10A,A02,083736,Patchell; Gregory David,29,0,30,1
1649862294838,MATH 10A,A03,083737,Patchell; Gregory David,30,0,30,0
1649862300869,MATH 10B,A01,083207,Staff,21,0,30,9
1649862300869,MATH 10B,A02,083208,Staff,28,0,30,2
1649862300869,MATH 10B,B01,083739,Staff,27,0,30,3
1649862300869,MATH 10B,B02,083740,Staff,30,0,30,0
1649862306989,MATH 18,A01,083743,Staff,26,0,30,4
1649862306989,MATH 18,A02,083744,Staff,30,0,30,0
1649862306989,MATH 18,A03,083745,Staff,30,0,30,0
1649862306989,MATH 18,A04,083746,Staff,30,0,30,0
1649862306989,MATH 18,B01,083748,Staff,24,0,30,6
1649862306989,MATH 18,B02,083749,Staff,29,0,30,1
1649862306989,MATH 18,B03,083750,Staff,30,0,30,0
1649862306989,MATH 18,B04,083751,Staff,29,0,30,1
1649862313019,MATH 20A,A01,083754,Staff,39,0,40,1
1649862319045,MATH 20B,A01,083756,Staff,29,0,30,1
1649862319045,MATH 20B,A02,083757,Staff,30,0,30,0
1649862325070,MATH 20C,A01,083760,Staff,27,0,30,3
1649862325070,MATH 20C,A02,083761,Staff,30,0,30,0
1649862325070,MATH 20C,B01,083762,Staff,30,0,30,0
1649862325070,MATH 20C,B02,083763,Staff,30,0,30,0
1649862331101,MATH 20D,A01,083765,Staff,24,0,30,6
1649862331101,MATH 20D,A02,083766,Staff,30,0,30,0
1649862331101,MATH 20D,A03,083767,Staff,30,0,30,0
1649862337125,MATH 20E,A01,083771,Staff,21,0,30,9
1649862337125,MATH 20E,A02,083772,Staff,29,0,30,1
1649862337125,MATH 20E,B01,083773,Staff,25,0,30,5
1649862337125,MATH 20E,B02,083774,Staff,30,0,30,0
1649862343149,MATH 103A,A01,083777,Staff,5,0,30,25
1649862343149,MATH 103A,A02,083778,Staff,23,0,30,7
1649862343149,MATH 103A,B01,083779,Staff,17,0,30,13
1649862343149,MATH 103A,B02,083780,Staff,27,0,30,3
1649862349180,MATH 105,A01,085443,Staff,15,0,30,15
1649862355204,MATH 109,A01,083213,Anzaldo; Leesa B,28,0,30,2
1649862355204,MATH 109,A02,083214,Anzaldo; Leesa B,24,0,30,6
1649862355204,MATH 109,B01,083215,Anzaldo; Leesa B,28,0,30,2
1649862355204,MATH 109,B02,083216,Anzaldo; Leesa B,26,0,30,4
1649862361232,MATH 142A,A01,083219,Chow; Bennett,11,0,30,19
1649862361232,MATH 142A,A02,083220,Chow; Bennett,28,0,30,2
1649862361232,MATH 142A,B01,083221,Chow; Bennett,16,0,30,14
1649862361232,MATH 142A,B02,083222,Chow; Bennett,27,0,30,3
1649862367255,MATH 193A,A01,083224,Staff,0,0,30,30
1649862367255,MATH 193A,A02,083225,Staff,13,0,30,17
1649862367255,MATH 193A,A03,083781,Staff,28,0,30,2
1649862367255,MATH 193A,A04,083782,Staff,28,0,30,2
1649862373279,MATH 197,001,091859,McAuley; Julian John,9999,0,9999,0
1649862379337,COGS 9,A01,083615,Staff,46,0,60,14
1649862385359,COGS 11,A01,083617,Boyle; Mary E. T.,36,0,40,4
1649862391382,COGS 13,A01,083071,Staff,21,0,40,19
1649862397408,COGS 14A,A01,092681,Staff,98,0,100,2
1649862403434,COGS 14B,A01,083073,Cheng; Tzu-Han,39,0,50,11
1649862409466,COGS 17,A01,092677,Staff,74,0,75,1
1649862415489,COGS 100,A01,083619,Staff,34,0,60,26
1649862421516,COGS 101A,A01,083621,Davis; Joshua Daniel,34,0,60,26
1649862427544,COGS 101B,A01,091572,Staff,47,0,60,13
1649862433568,COGS 101C,A01,083625,Delgado; Tania,25,0,30,5
1649862439595,COGS 107A,A01,083627,Boyle; Mary E. T.,41,0,60,19
1649862445619,COGS 118A,A01,083075,Staff,34,0,60,26
1649862451646,CSE 3,A50,083646,Miranda; Gregory Joseph,32,0,38,6
1649862451646,CSE 3,A51,083647,Miranda; Gregory Joseph,37,0,37,0
1649862457674,CSE 8A,A50,083650,Miranda; Gregory Joseph,30,0,40,10
1649862463703,CSE 11,A01,083080,Cao; Yingjun,10,0,40,30
1649862469729,CSE 12,A01,083652,Staff,82,0,100,18
1649862475755,CSE 15L,A01,083654,Staff,37,0,50,13
1649862475755,CSE 15L,A02,083655,Staff,49,0,50,1
1649862481782,CSE 20,A01,083657,Staff,73,0,80,7
1649862487813,CSE 30,A01,083084,Eldon; John,14,0,40,26
1649862493839,CSE 100,A01,083659,Cao; Yingjun,15,0,50,35
1649862499862,CSE 134B,A01,083661,Powell; Thomas Allan,0,3,65,65
1649862505887,CSE 140,A01,083663,Staff,55,0,75,20
1649862511911,CSE 140L,A01,083088,Eldon; John,51,0,75,24
1649862517936,CSE 175,A01,083665,Kumar; Rakesh,16,0,25,9
1649862524106,CSE 190,A00,092507,Staff,15,0,15,0
1649862530135,ECE 45,A01,083139,Staff,34,0,40,6
1649862536158,ECE 65,A50,083695,Staff,22,0,30,8
1649862548058,ECE 109,A01,091882,Touri; Behrouz,66,0,70,4
1649862554092,ECE 180,A00,083140,Abi Samra; Nicholas Camill,29,0,30,1
1649862554092,ECE 180,B00,083141,Abi Samra; Nicholas Camill,17,0,30,13
1649862560115,MATH 10A,A01,083735,Patchell; Gregory David,26,0,30,4
1649862560115,MATH 10A,A02,083736,Patchell; Gregory David,29,0,30,1
1649862560115,MATH 10A,A03,083737,Patchell; Gregory David,30,0,30,0
1649862566142,MATH 10B,A01,083207,Staff,21,0,30,9
1649862566142,MATH 10B,A02,083208,Staff,28,0,30,2
1649862566142,MATH 10B,B01,083739,Staff,27,0,30,3
1649862566142,MATH 10B,B02,083740,Staff,30,0,30,0
1649862572176,MATH 18,A01,083743,Staff,26,0,30,4
1649862572176,MATH 18,A02,083744,Staff,30,0,30,0
1649862572176,MATH 18,A03,083745,Staff,30,0,30,0
1649862572176,MATH 18,A04,083746,Staff,30,0,30,0
1649862572176,MATH 18,B01,083748,Staff,24,0,30,6
1649862572176,MATH 18,B02,083749,Staff,29,0,30,1
1649862572176,MATH 18,B03,083750,Staff,30,0,30,0
1649862572176,MATH 18,B04,083751,Staff,29,0,30,1
1649862578198,MATH 20A,A01,083754,Staff,39,0,40,1
1649862584220,MATH 20B,A01,083756,Staff,29,0,30,1
1649862584220,MATH 20B,A02,083757,Staff,30,0,30,0
1649862590243,MATH 20C,A01,083760,Staff,27,0,30,3
1649862590243,MATH 20C,A02,083761,Staff,30,0,30,0
1649862590243,MATH 20C,B01,083762,Staff,30,0,30,0
1649862590243,MATH 20C,B02,083763,Staff,30,0,30,0
1649862596267,MATH 20D,A01,083765,Staff,24,0,30,6
1649862596267,MATH 20D,A02,083766,Staff,30,0,30,0
1649862596267,MATH 20D,A03,083767,Staff,30,0,30,0
1649862602290,MATH 20E,A01,083771,Staff,21,0,30,9
1649862602290,MATH 20E,A02,083772,Staff,29,0,30,1
1649862602290,MATH 20E,B01,083773,Staff,25,0,30,5
1649862602290,MATH 20E,B02,083774,Staff,30,0,30,0
1649862608320,MATH 103A,A01,083777,Staff,5,0,30,25
1649862608320,MATH 103A,A02,083778,Staff,23,0,30,7
1649862608320,MATH 103A,B01,083779,Staff,17,0,30,13
1649862608320,MATH 103A,B02,083780,Staff,27,0,30,3
1649862614345,MATH 105,A01,085443,Staff,15,0,30,15
1649862620385,MATH 109,A01,083213,Anzaldo; Leesa B,28,0,30,2
1649862620385,MATH 109,A02,083214,Anzaldo; Leesa B,24,0,30,6
1649862620385,MATH 109,B01,083215,Anzaldo; Leesa B,28,0,30,2
1649862620385,MATH 109,B02,083216,Anzaldo; Leesa B,26,0,30,4
1649862626409,MATH 142A,A01,083219,Chow; Bennett,11,0,30,19
1649862626409,MATH 142A,A02,083220,Chow; Bennett,28,0,30,2
1649862626409,MATH 142A,B01,083221,Chow; Bennett,16,0,30,14
1649862626409,MATH 142A,B02,083222,Chow; Bennett,27,0,30,3
1649862632433,MATH 193A,A01,083224,Staff,0,0,30,30
1649862632433,MATH 193A,A02,083225,Staff,13,0,30,17
1649862632433,MATH 193A,A03,083781,Staff,28,0,30,2
1649862632433,MATH 193A,A04,083782,Staff,28,0,30,2
1649862638459,MATH 197,001,091859,McAuley; Julian John,9999,0,9999,0
1649862644518,COGS 9,A01,083615,Staff,46,0,60,14
1649862650549,COGS 11,A01,083617,Boyle; Mary E. T.,36,0,40,4
1649862656577,COGS 13,A01,083071,Staff,21,0,40,19
1649862662600,COGS 14A,A01,092681,Staff,98,0,100,2
1649862668627,COGS 14B,A01,083073,Cheng; Tzu-Han,39,0,50,11
1649862674658,COGS 17,A01,092677,Staff,74,0,75,1
1649862680689,COGS 100,A01,083619,Staff,34,0,60,26
1649862686723,COGS 101A,A01,083621,Davis; Joshua Daniel,33,0,60,27
1649862692746,COGS 101B,A01,091572,Staff,47,0,60,13
1649862698772,COGS 101C,A01,083625,Delgado; Tania,25,0,30,5
1649862704794,COGS 107A,A01,083627,Boyle; Mary E. T.,41,0,60,19
1649862710820,COGS 118A,A01,083075,Staff,34,0,60,26
1649862716860,CSE 3,A50,083646,Miranda; Gregory Joseph,32,0,38,6
1649862716860,CSE 3,A51,083647,Miranda; Gregory Joseph,37,0,37,0
1649862722885,CSE 8A,A50,083650,Miranda; Gregory Joseph,30,0,40,10
1649862728908,CSE 11,A01,083080,Cao; Yingjun,9,0,40,31
1649862734933,CSE 12,A01,083652,Staff,82,0,100,18
1649862740961,CSE 15L,A01,083654,Staff,37,0,50,13
1649862740961,CSE 15L,A02,083655,Staff,49,0,50,1
1649862746987,CSE 20,A01,083657,Staff,73,0,80,7
1649862753010,CSE 30,A01,083084,Eldon; John,13,0,40,27
1649862759035,CSE 100,A01,083659,Cao; Yingjun,15,0,50,35
1649862765059,CSE 134B,A01,083661,Powell; Thomas Allan,0,3,65,65
1649862771084,CSE 140,A01,083663,Staff,55,0,75,20
1649862777119,CSE 140L,A01,083088,Eldon; John,51,0,75,24
1649862783145,CSE 175,A01,083665,Kumar; Rakesh,16,0,25,9
1649862789171,CSE 190,A00,092507,Staff,15,0,15,0
1649862795195,ECE 45,A01,083139,Staff,34,0,40,6
1649862801219,ECE 65,A50,083695,Staff,22,0,30,8
1649862807241,ECE 109,A01,091882,Touri; Behrouz,66,0,70,4
1649862813266,ECE 180,A00,083140,Abi Samra; Nicholas Camill,29,0,30,1
1649862813266,ECE 180,B00,083141,Abi Samra; Nicholas Camill,17,0,30,13
1649862819299,MATH 10A,A01,083735,Patchell; Gregory David,25,0,30,5
1649862819299,MATH 10A,A02,083736,Patchell; Gregory David,29,0,30,1
1649862819299,MATH 10A,A03,083737,Patchell; Gregory David,30,0,30,0
1649862825321,MATH 10B,A01,083207,Staff,21,0,30,9
1649862825321,MATH 10B,A02,083208,Staff,28,0,30,2
1649862825321,MATH 10B,B01,083739,Staff,27,0,30,3
1649862825321,MATH 10B,B02,083740,Staff,30,0,30,0
1649862831351,MATH 18,A01,083743,Staff,26,0,30,4
1649862831351,MATH 18,A02,083744,Staff,30,0,30,0
1649862831351,MATH 18,A03,083745,Staff,30,0,30,0
1649862831351,MATH 18,A04,083746,Staff,30,0,30,0
1649862831351,MATH 18,B01,083748,Staff,23,0,30,7
1649862831351,MATH 18,B02,083749,Staff,29,0,30,1
1649862831351,MATH 18,B03,083750,Staff,30,0,30,0
1649862831351,MATH 18,B04,083751,Staff,29,0,30,1
1649862837378,MATH 20A,A01,083754,Staff,39,0,40,1
1649862843408,MATH 20B,A01,083756,Staff,29,0,30,1
1649862843408,MATH 20B,A02,083757,Staff,30,0,30,0
1649862849435,MATH 20C,A01,083760,Staff,27,0,30,3
1649862849435,MATH 20C,A02,083761,Staff,30,0,30,0
1649862849435,MATH 20C,B01,083762,Staff,30,0,30,0
1649862849435,MATH 20C,B02,083763,Staff,30,0,30,0
1649862855462,MATH 20D,A01,083765,Staff,24,0,30,6
1649862855462,MATH 20D,A02,083766,Staff,30,0,30,0
1649862855462,MATH 20D,A03,083767,Staff,30,0,30,0
1649862861491,MATH 20E,A01,083771,Staff,21,0,30,9
1649862861491,MATH 20E,A02,083772,Staff,29,0,30,1
1649862861491,MATH 20E,B01,083773,Staff,25,0,30,5
1649862861491,MATH 20E,B02,083774,Staff,30,0,30,0
1649862867519,MATH 103A,A01,083777,Staff,5,0,30,25
1649862867519,MATH 103A,A02,083778,Staff,23,0,30,7
1649862867519,MATH 103A,B01,083779,Staff,16,0,30,14
1649862867519,MATH 103A,B02,083780,Staff,27,0,30,3
1649862873545,MATH 105,A01,085443,Staff,14,0,30,16
1649862879568,MATH 109,A01,083213,Anzaldo; Leesa B,28,0,30,2
1649862879568,MATH 109,A02,083214,Anzaldo; Leesa B,24,0,30,6
1649862879568,MATH 109,B01,083215,Anzaldo; Leesa B,28,0,30,2
1649862879568,MATH 109,B02,083216,Anzaldo; Leesa B,26,0,30,4
1649862885597,MATH 142A,A01,083219,Chow; Bennett,11,0,30,19
1649862885597,MATH 142A,A02,083220,Chow; Bennett,28,0,30,2
1649862885597,MATH 142A,B01,083221,Chow; Bennett,16,0,30,14
1649862885597,MATH 142A,B02,083222,Chow; Bennett,27,0,30,3
1649862891627,MATH 193A,A01,083224,Staff,0,0,30,30
1649862891627,MATH 193A,A02,083225,Staff,12,0,30,18
1649862891627,MATH 193A,A03,083781,Staff,28,0,30,2
1649862891627,MATH 193A,A04,083782,Staff,28,0,30,2
1649862897649,MATH 197,001,091859,McAuley; Julian John,9999,0,9999,0
1649862903803,COGS 9,A01,083615,Staff,45,0,60,15
1649862909825,COGS 11,A01,083617,Boyle; Mary E. T.,36,0,40,4
1649862915848,COGS 13,A01,083071,Staff,21,0,40,19
1649862921879,COGS 14A,A01,092681,Staff,98,0,100,2
1649862927902,COGS 14B,A01,083073,Cheng; Tzu-Han,39,0,50,11
1649862933924,COGS 17,A01,092677,Staff,74,0,75,1
1649862939950,COGS 100,A01,083619,Staff,34,0,60,26
1649862945977,COGS 101A,A01,083621,Davis; Joshua Daniel,33,0,60,27
1649862952002,COGS 101B,A01,091572,Staff,47,0,60,13
1649862958029,COGS 101C,A01,083625,Delgado; Tania,25,0,30,5
1649862964057,COGS 107A,A01,083627,Boyle; Mary E. T.,41,0,60,19
1649862970084,COGS 118A,A01,083075,Staff,34,0,60,26
1649862976111,CSE 3,A50,083646,Miranda; Gregory Joseph,31,0,38,7
1649862976111,CSE 3,A51,083647,Miranda; Gregory Joseph,37,0,37,0
1649862982134,CSE 8A,A50,083650,Miranda; Gregory Joseph,30,0,40,10
1649862988169,CSE 11,A01,083080,Cao; Yingjun,9,0,40,31
1649862994194,CSE 12,A01,083652,Staff,82,0,100,18
1649863000221,CSE 15L,A01,083654,Staff,37,0,50,13
1649863000221,CSE 15L,A02,083655,Staff,49,0,50,1
1649863006246,CSE 20,A01,083657,Staff,73,0,80,7
1649863012271,CSE 30,A01,083084,Eldon; John,13,0,40,27
1649863018297,CSE 100,A01,083659,Cao; Yingjun,15,0,50,35
1649863024319,CSE 134B,A01,083661,Powell; Thomas Allan,0,3,65,65
1649863030341,CSE 140,A01,083663,Staff,55,0,75,20
1649863036367,CSE 140L,A01,083088,Eldon; John,51,0,75,24
1649863042399,CSE 175,A01,083665,Kumar; Rakesh,16,0,25,9
1649863048421,CSE 190,A00,092507,Staff,15,0,15,0
1649863054447,ECE 45,A01,083139,Staff,34,0,40,6
1649863060481,ECE 65,A50,083695,Staff,22,0,30,8
1649863066556,ECE 109,A01,091882,Touri; Behrouz,66,0,70,4
1649863072580,ECE 180,A00,083140,Abi Samra; Nicholas Camill,29,0,30,1
1649863072580,ECE 180,B00,083141,Abi Samra; Nicholas Camill,17,0,30,13
1649863078616,MATH 10A,A01,083735,Patchell; Gregory David,25,0,30,5
1649863078616,MATH 10A,A02,083736,Patchell; Gregory David,29,0,30,1
1649863078616,MATH 10A,A03,083737,Patchell; Gregory David,30,0,30,0
1649863084640,MATH 10B,A01,083207,Staff,21,0,30,9
1649863084640,MATH 10B,A02,083208,Staff,28,0,30,2
1649863084640,MATH 10B,B01,083739,Staff,27,0,30,3
1649863084640,MATH 10B,B02,083740,Staff,30,0,30,0
1649863090668,MATH 18,A01,083743,Staff,26,0,30,4
1649863090668,MATH 18,A02,083744,Staff,30,0,30,0
1649863090668,MATH 18,A03,083745,Staff,30,0,30,0
1649863090668,MATH 18,A04,083746,Staff,30,0,30,0
1649863090668,MATH 18,B01,083748,Staff,23,0,30,7
1649863090668,MATH 18,B02,083749,Staff,29,0,30,1
1649863090668,MATH 18,B03,083750,Staff,30,0,30,0
1649863090668,MATH 18,B04,083751,Staff,29,0,30,1
1649863096691,MATH 20A,A01,083754,Staff,39,0,40,1
1649863102713,MATH 20B,A01,083756,Staff,29,0,30,1
1649863102713,MATH 20B,A02,083757,Staff,30,0,30,0
1649863108738,MATH 20C,A01,083760,Staff,27,0,30,3
1649863108738,MATH 20C,A02,083761,Staff,30,0,30,0
1649863108738,MATH 20C,B01,083762,Staff,30,0,30,0
1649863108738,MATH 20C,B02,083763,Staff,30,0,30,0
1649863114763,MATH 20D,A01,083765,Staff,24,0,30,6
1649863114763,MATH 20D,A02,083766,Staff,30,0,30,0
1649863114763,MATH 20D,A03,083767,Staff,30,0,30,0
1649863120792,MATH 20E,A01,083771,Staff,21,0,30,9
1649863120792,MATH 20E,A02,083772,Staff,29,0,30,1
1649863120792,MATH 20E,B01,083773,Staff,25,0,30,5
1649863120792,MATH 20E,B02,083774,Staff,30,0,30,0
1649863126822,MATH 103A,A01,083777,Staff,5,0,30,25
1649863126822,MATH 103A,A02,083778,Staff,23,0,30,7
1649863126822,MATH 103A,B01,083779,Staff,16,0,30,14
1649863126822,MATH 103A,B02,083780,Staff,27,0,30,3
1649863132847,MATH 105,A01,085443,Staff,14,0,30,16
1649863138877,MATH 109,A01,083213,Anzaldo; Leesa B,28,0,30,2
1649863138877,MATH 109,A02,083214,Anzaldo; Leesa B,24,0,30,6
1649863138877,MATH 109,B01,083215,Anzaldo; Leesa B,28,0,30,2
1649863138877,MATH 109,B02,083216,Anzaldo; Leesa B,26,0,30,4
1649863144905,MATH 142A,A01,083219,Chow; Bennett,11,0,30,19
1649863144905,MATH 142A,A02,083220,Chow; Bennett,28,0,30,2
1649863144905,MATH 142A,B01,083221,Chow; Bennett,16,0,30,14
1649863144905,MATH 142A,B02,083222,Chow; Bennett,27,0,30,3
1649863150943,MATH 193A,A01,083224,Staff,0,0,30,30
1649863150943,MATH 193A,A02,083225,Staff,13,0,30,17
1649863150943,MATH 193A,A03,083781,Staff,28,0,30,2
1649863150943,MATH 193A,A04,083782,Staff,28,0,30,2
1649863156966,MATH 197,001,091859,McAuley; Julian John,9999,0,9999,0
1649863163021,COGS 9,A01,083615,Staff,45,0,60,15
1649863169047,COGS 11,A01,083617,Boyle; Mary E. T.,36,0,40,4
1649863175075,COGS 13,A01,083071,Staff,21,0,40,19
1649863181097,COGS 14A,A01,092681,Staff,98,0,100,2
1649863187124,COGS 14B,A01,083073,Cheng; Tzu-Han,39,0,50,11
1649863193150,COGS 17,A01,092677,Staff,74,0,75,1
1649863199174,COGS 100,A01,083619,Staff,34,0,60,26
1649863205202,COGS 101A,A01,083621,Davis; Joshua Daniel,33,0,60,27
1649863211223,COGS 101B,A01,091572,Staff,47,0,60,13
1649863217260,COGS 101C,A01,083625,Delgado; Tania,25,0,30,5
1649863223284,COGS 107A,A01,083627,Boyle; Mary E. T.,41,0,60,19
1649863229313,COGS 118A,A01,083075,Staff,34,0,60,26
1649863235341,CSE 3,A50,083646,Miranda; Gregory Joseph,31,0,38,7
1649863235341,CSE 3,A51,083647,Miranda; Gregory Joseph,37,0,37,0
1649863241367,CSE 8A,A50,083650,Miranda; Gregory Joseph,30,0,40,10
1649863247395,CSE 11,A01,083080,Cao; Yingjun,9,0,40,31
1649863253425,CSE 12,A01,083652,Staff,82,0,100,18
1649863259449,CSE 15L,A01,083654,Staff,37,0,50,13
1649863259449,CSE 15L,A02,083655,Staff,49,0,50,1
1649863265478,CSE 20,A01,083657,Staff,73,0,80,7
1649863271501,CSE 30,A01,083084,Eldon; John,13,0,40,27
1649863277524,CSE 100,A01,083659,Cao; Yingjun,15,0,50,35
1649863283550,CSE 134B,A01,083661,Powell; Thomas Allan,0,3,65,65
1649863289575,CSE 140,A01,083663,Staff,52,0,75,23
1649863295598,CSE 140L,A01,083088,Eldon; John,48,0,75,27
1649863301625,CSE 175,A01,083665,Kumar; Rakesh,16,0,25,9
1649863307653,CSE 190,A00,092507,Staff,15,0,15,0
1649863313675,ECE 45,A01,083139,Staff,34,0,40,6
1649863319709,ECE 65,A50,083695,Staff,22,0,30,8
1649863325753,ECE 109,A01,091882,Touri; Behrouz,66,0,70,4
1649863331792,ECE 180,A00,083140,Abi Samra; Nicholas Camill,29,0,30,1
1649863331792,ECE 180,B00,083141,Abi Samra; Nicholas Camill,17,0,30,13
1649863337818,MATH 10A,A01,083735,Patchell; Gregory David,25,0,30,5
1649863337818,MATH 10A,A02,083736,Patchell; Gregory David,29,0,30,1
1649863337818,MATH 10A,A03,083737,Patchell; Gregory David,30,0,30,0
1649863343843,MATH 10B,A01,083207,Staff,21,0,30,9
1649863343843,MATH 10B,A02,083208,Staff,28,0,30,2
1649863343843,MATH 10B,B01,083739,Staff,27,0,30,3
1649863343843,MATH 10B,B02,083740,Staff,30,0,30,0
1649863349872,MATH 18,A01,083743,Staff,26,0,30,4
1649863349872,MATH 18,A02,083744,Staff,30,0,30,0
1649863349872,MATH 18,A03,083745,Staff,30,0,30,0
1649863349872,MATH 18,A04,083746,Staff,30,0,30,0
1649863349872,MATH 18,B01,083748,Staff,23,0,30,7
1649863349872,MATH 18,B02,083749,Staff,29,0,30,1
1649863349872,MATH 18,B03,083750,Staff,30,0,30,0
1649863349872,MATH 18,B04,083751,Staff,29,0,30,1
1649863355895,MATH 20A,A01,083754,Staff,39,0,40,1
1649863361918,MATH 20B,A01,083756,Staff,29,0,30,1
1649863361918,MATH 20B,A02,083757,Staff,30,0,30,0
1649863367944,MATH 20C,A01,083760,Staff,27,0,30,3
1649863367944,MATH 20C,A02,083761,Staff,30,0,30,0
1649863367944,MATH 20C,B01,083762,Staff,30,0,30,0
1649863367944,MATH 20C,B02,083763,Staff,30,0,30,0
1649863373972,MATH 20D,A01,083765,Staff,24,0,30,6
1649863373972,MATH 20D,A02,083766,Staff,30,0,30,0
1649863373972,MATH 20D,A03,083767,Staff,30,0,30,0
1649863380000,MATH 20E,A01,083771,Staff,21,0,30,9
1649863380000,MATH 20E,A02,083772,Staff,29,0,30,1
1649863380000,MATH 20E,B01,083773,Staff,25,0,30,5
1649863380000,MATH 20E,B02,083774,Staff,30,0,30,0
1649863386028,MATH 103A,A01,083777,Staff,4,0,30,26
1649863386028,MATH 103A,A02,083778,Staff,23,0,30,7
1649863386028,MATH 103A,B01,083779,Staff,15,0,30,15
1649863386028,MATH 103A,B02,083780,Staff,27,0,30,3
1649863392051,MATH 105,A01,085443,Staff,14,0,30,16
1649863398080,MATH 109,A01,083213,Anzaldo; Leesa B,28,0,30,2
1649863398080,MATH 109,A02,083214,Anzaldo; Leesa B,24,0,30,6
1649863398080,MATH 109,B01,083215,Anzaldo; Leesa B,28,0,30,2
1649863398080,MATH 109,B02,083216,Anzaldo; Leesa B,26,0,30,4
1649863404102,MATH 142A,A01,083219,Chow; Bennett,11,0,30,19
1649863404102,MATH 142A,A02,083220,Chow; Bennett,28,0,30,2
1649863404102,MATH 142A,B01,083221,Chow; Bennett,16,0,30,14
1649863404102,MATH 142A,B02,083222,Chow; Bennett,27,0,30,3
1649863410142,MATH 193A,A01,083224,Staff,0,0,30,30
1649863410142,MATH 193A,A02,083225,Staff,13,0,30,17
1649863410142,MATH 193A,A03,083781,Staff,28,0,30,2
1649863410142,MATH 193A,A04,083782,Staff,28,0,30,2
1649863416177,MATH 197,001,091859,McAuley; Julian John,9999,0,9999,0
1649863422242,COGS 9,A01,083615,Staff,45,0,60,15
1649863428275,COGS 11,A01,083617,Boyle; Mary E. T.,36,0,40,4
1649863434311,COGS 13,A01,083071,Staff,20,0,40,20
1649863440339,COGS 14A,A01,092681,Staff,98,0,100,2
1649863446368,COGS 14B,A01,083073,Cheng; Tzu-Han,39,0,50,11
1649863452392,COGS 17,A01,092677,Staff,74,0,75,1
1649863458416,COGS 100,A01,083619,Staff,34,0,60,26
1649863464442,COGS 101A,A01,083621,Davis; Joshua Daniel,32,0,60,28
1649863470471,COGS 101B,A01,091572,Staff,47,0,60,13
1649863476495,COGS 101C,A01,083625,Delgado; Tania,25,0,30,5
1649863482519,COGS 107A,A01,083627,Boyle; Mary E. T.,41,0,60,19
1649863488542,COGS 118A,A01,083075,Staff,34,0,60,26
1649863494565,CSE 3,A50,083646,Miranda; Gregory Joseph,31,0,38,7
1649863494565,CSE 3,A51,083647,Miranda; Gregory Joseph,37,0,37,0
1649863500681,CSE 8A,A50,083650,Miranda; Gregory Joseph,30,0,40,10
1649863506704,CSE 11,A01,083080,Cao; Yingjun,8,0,40,32
1649863512730,CSE 12,A01,083652,Staff,82,0,100,18
1649863518758,CSE 15L,A01,083654,Staff,37,0,50,13
1649863518758,CSE 15L,A02,083655,Staff,49,0,50,1
1649863524787,CSE 20,A01,083657,Staff,73,0,80,7
1649863530811,CSE 30,A01,083084,Eldon; John,13,0,40,27
1649863536834,CSE 100,A01,083659,Cao; Yingjun,14,0,50,36
1649863542857,CSE 134B,A01,083661,Powell; Thomas Allan,0,3,65,65
1649863548882,CSE 140,A01,083663,Staff,51,0,75,24
1649863554909,CSE 140L,A01,083088,Eldon; John,47,0,75,28
1649863560939,CSE 175,A01,083665,Kumar; Rakesh,16,0,25,9
1649863566969,CSE 190,A00,092507,Staff,15,0,15,0
1649863573001,ECE 45,A01,083139,Staff,34,0,40,6
1649863579030,ECE 65,A50,083695,Staff,22,0,30,8
1649863585080,ECE 109,A01,091882,Touri; Behrouz,66,0,70,4
1649863591112,ECE 180,A00,083140,Abi Samra; Nicholas Camill,29,0,30,1
1649863591112,ECE 180,B00,083141,Abi Samra; Nicholas Camill,17,0,30,13
1649863597136,MATH 10A,A01,083735,Patchell; Gregory David,25,0,30,5
1649863597136,MATH 10A,A02,083736,Patchell; Gregory David,29,0,30,1
1649863597136,MATH 10A,A03,083737,Patchell; Gregory David,30,0,30,0
1649863603171,MATH 10B,A01,083207,Staff,21,0,30,9
1649863603171,MATH 10B,A02,083208,Staff,28,0,30,2
1649863603171,MATH 10B,B01,083739,Staff,27,0,30,3
1649863603171,MATH 10B,B02,083740,Staff,30,0,30,0
1649863609202,MATH 18,A01,083743,Staff,26,0,30,4
1649863609202,MATH 18,A02,083744,Staff,30,0,30,0
1649863609202,MATH 18,A03,083745,Staff,30,0,30,0
1649863609202,MATH 18,A04,083746,Staff,30,0,30,0
1649863609202,MATH 18,B01,083748,Staff,23,0,30,7
1649863609202,MATH 18,B02,083749,Staff,29,0,30,1
1649863609202,MATH 18,B03,083750,Staff,30,0,30,0
1649863609202,MATH 18,B04,083751,Staff,29,0,30,1
1649863615226,MATH 20A,A01,083754,Staff,39,0,40,1
1649863621252,MATH 20B,A01,083756,Staff,29,0,30,1
1649863621252,MATH 20B,A02,083757,Staff,30,0,30,0
1649863627281,MATH 20C,A01,083760,Staff,27,0,30,3
1649863627281,MATH 20C,A02,083761,Staff,30,0,30,0
1649863627281,MATH 20C,B01,083762,Staff,30,0,30,0
1649863627281,MATH 20C,B02,083763,Staff,30,0,30,0
1649863633303,MATH 20D,A01,083765,Staff,24,0,30,6
1649863633303,MATH 20D,A02,083766,Staff,30,0,30,0
1649863633303,MATH 20D,A03,083767,Staff,30,0,30,0
1649863639329,MATH 20E,A01,083771,Staff,21,0,30,9
1649863639329,MATH 20E,A02,083772,Staff,29,0,30,1
1649863639329,MATH 20E,B01,083773,Staff,25,0,30,5
1649863639329,MATH 20E,B02,083774,Staff,30,0,30,0
1649863645364,MATH 103A,A01,083777,Staff,4,0,30,26
1649863645364,MATH 103A,A02,083778,Staff,23,0,30,7
1649863645364,MATH 103A,B01,083779,Staff,15,0,30,15
1649863645364,MATH 103A,B02,083780,Staff,27,0,30,3
1649863651394,MATH 105,A01,085443,Staff,14,0,30,16
1649863657419,MATH 109,A01,083213,Anzaldo; Leesa B,28,0,30,2
1649863657419,MATH 109,A02,083214,Anzaldo; Leesa B,24,0,30,6
1649863657419,MATH 109,B01,083215,Anzaldo; Leesa B,28,0,30,2
1649863657419,MATH 109,B02,083216,Anzaldo; Leesa B,26,0,30,4
1649863663443,MATH 142A,A01,083219,Chow; Bennett,11,0,30,19
1649863663443,MATH 142A,A02,083220,Chow; Bennett,28,0,30,2
1649863663443,MATH 142A,B01,083221,Chow; Bennett,16,0,30,14
1649863663443,MATH 142A,B02,083222,Chow; Bennett,27,0,30,3
1649863669469,MATH 193A,A01,083224,Staff,0,0,30,30
1649863669469,MATH 193A,A02,083225,Staff,13,0,30,17
1649863669469,MATH 193A,A03,083781,Staff,28,0,30,2
1649863669469,MATH 193A,A04,083782,Staff,28,0,30,2
1649863675493,MATH 197,001,091859,McAuley; Julian John,9999,0,9999,0
1649863681547,COGS 9,A01,083615,Staff,45,0,60,15
1649863687574,COGS 11,A01,083617,Boyle; Mary E. T.,36,0,40,4
1649863693601,COGS 13,A01,083071,Staff,20,0,40,20
1649863699628,COGS 14A,A01,092681,Staff,98,0,100,2
1649863705671,COGS 14B,A01,083073,Cheng; Tzu-Han,39,0,50,11
1649863711710,COGS 17,A01,092677,Staff,74,0,75,1
1649863717732,COGS 100,A01,083619,Staff,34,0,60,26
1649863723760,COGS 101A,A01,083621,Davis; Joshua Daniel,32,0,60,28
1649863729790,COGS 101B,A01,091572,Staff,47,0,60,13
1649863735814,COGS 101C,A01,083625,Delgado; Tania,25,0,30,5
1649863741841,COGS 107A,A01,083627,Boyle; Mary E. T.,41,0,60,19
1649863747865,COGS 118A,A01,083075,Staff,34,0,60,26
1649863753897,CSE 3,A50,083646,Miranda; Gregory Joseph,31,0,38,7
1649863753897,CSE 3,A51,083647,Miranda; Gregory Joseph,37,0,37,0
1649863759932,CSE 8A,A50,083650,Miranda; Gregory Joseph,30,0,40,10
1649863765957,CSE 11,A01,083080,Cao; Yingjun,8,0,40,32
1649863771984,CSE 12,A01,083652,Staff,82,0,100,18
1649863778008,CSE 15L,A01,083654,Staff,37,0,50,13
1649863778008,CSE 15L,A02,083655,Staff,49,0,50,1
1649863784031,CSE 20,A01,083657,Staff,73,0,80,7
1649863790056,CSE 30,A01,083084,Eldon; John,13,0,40,27
1649863796081,CSE 100,A01,083659,Cao; Yingjun,14,0,50,36
1649863802105,CSE 134B,A01,083661,Powell; Thomas Allan,0,3,65,65
1649863808135,CSE 140,A01,083663,Staff,51,0,75,24
1649863814178,CSE 140L,A01,083088,Eldon; John,47,0,75,28
1649863820205,CSE 175,A01,083665,Kumar; Rakesh,16,0,25,9
1649863826231,CSE 190,A00,092507,Staff,15,0,15,0
1649863832260,ECE 45,A01,083139,Staff,34,0,40,6
1649863838294,ECE 65,A50,083695,Staff,22,0,30,8
1649863844320,ECE 109,A01,091882,Touri; Behrouz,66,0,70,4
1649863850346,ECE 180,A00,083140,Abi Samra; Nicholas Camill,29,0,30,1
1649863850346,ECE 180,B00,083141,Abi Samra; Nicholas Camill,17,0,30,13
1649863856384,MATH 10A,A01,083735,Patchell; Gregory David,25,0,30,5
1649863856384,MATH 10A,A02,083736,Patchell; Gregory David,29,0,30,1
1649863856384,MATH 10A,A03,083737,Patchell; Gregory David,30,0,30,0
1649863862411,MATH 10B,A01,083207,Staff,21,0,30,9
1649863862411,MATH 10B,A02,083208,Staff,28,0,30,2
1649863862411,MATH 10B,B01,083739,Staff,27,0,30,3
1649863862411,MATH 10B,B02,083740,Staff,30,0,30,0
1649863868442,MATH 18,A01,083743,Staff,26,0,30,4
1649863868442,MATH 18,A02,083744,Staff,30,0,30,0
1649863868442,MATH 18,A03,083745,Staff,30,0,30,0
1649863868442,MATH 18,A04,083746,Staff,30,0,30,0
1649863868442,MATH 18,B01,083748,Staff,23,0,30,7
1649863868442,MATH 18,B02,083749,Staff,29,0,30,1
1649863868442,MATH 18,B03,083750,Staff,30,0,30,0
1649863868442,MATH 18,B04,083751,Staff,29,0,30,1
1649863874466,MATH 20A,A01,083754,Staff,39,0,40,1
1649863880489,MATH 20B,A01,083756,Staff,29,0,30,1
1649863880489,MATH 20B,A02,083757,Staff,30,0,30,0
1649863886517,MATH 20C,A01,083760,Staff,27,0,30,3
1649863886517,MATH 20C,A02,083761,Staff,30,0,30,0
1649863886517,MATH 20C,B01,083762,Staff,30,0,30,0
1649863886517,MATH 20C,B02,083763,Staff,30,0,30,0
1649863892761,MATH 20D,A01,083765,Staff,24,0,30,6
1649863892761,MATH 20D,A02,083766,Staff,30,0,30,0
1649863892761,MATH 20D,A03,083767,Staff,30,0,30,0
1649863898785,MATH 20E,A01,083771,Staff,21,0,30,9
1649863898785,MATH 20E,A02,083772,Staff,29,0,30,1
1649863898785,MATH 20E,B01,083773,Staff,25,0,30,5
1649863898785,MATH 20E,B02,083774,Staff,30,0,30,0
1649863904824,MATH 103A,A01,083777,Staff,3,0,30,27
1649863904824,MATH 103A,A02,083778,Staff,23,0,30,7
1649863904824,MATH 103A,B01,083779,Staff,15,0,30,15
1649863904824,MATH 103A,B02,083780,Staff,27,0,30,3
1649863910853,MATH 105,A01,085443,Staff,14,0,30,16
1649863916881,MATH 109,A01,083213,Anzaldo; Leesa B,28,0,30,2
1649863916881,MATH 109,A02,083214,Anzaldo; Leesa B,24,0,30,6
1649863916881,MATH 109,B01,083215,Anzaldo; Leesa B,28,0,30,2
1649863916881,MATH 109,B02,083216,Anzaldo; Leesa B,26,0,30,4
1649863922909,MATH 142A,A01,083219,Chow; Bennett,11,0,30,19
1649863922909,MATH 142A,A02,083220,Chow; Bennett,26,0,30,4
1649863922909,MATH 142A,B01,083221,Chow; Bennett,16,0,30,14
1649863922909,MATH 142A,B02,083222,Chow; Bennett,27,0,30,3
1649863928946,MATH 193A,A01,083224,Staff,0,0,30,30
1649863928946,MATH 193A,A02,083225,Staff,12,0,30,18
1649863928946,MATH 193A,A03,083781,Staff,28,0,30,2
1649863928946,MATH 193A,A04,083782,Staff,28,0,30,2
1649863934972,MATH 197,001,091859,McAuley; Julian John,9999,0,9999,0
1649863941045,COGS 9,A01,083615,Staff,45,0,60,15
1649863947072,COGS 11,A01,083617,Boyle; Mary E. T.,36,0,40,4
1649863953104,COGS 13,A01,083071,Staff,19,0,40,21
1649863959127,COGS 14A,A01,092681,Staff,98,0,100,2
1649863965168,COGS 14B,A01,083073,Cheng; Tzu-Han,39,0,50,11
1649863971199,COGS 17,A01,092677,Staff,74,0,75,1
1649863977222,COGS 100,A01,083619,Staff,34,0,60,26
1649863983246,COGS 101A,A01,083621,Davis; Joshua Daniel,32,0,60,28
1649863989395,COGS 101B,A01,091572,Staff,47,0,60,13
1649863995422,COGS 101C,A01,083625,Delgado; Tania,25,0,30,5
1649864001445,COGS 107A,A01,083627,Boyle; Mary E. T.,41,0,60,19
1649864007468,COGS 118A,A01,083075,Staff,34,0,60,26
1649864013503,CSE 3,A50,083646,Miranda; Gregory Joseph,31,0,38,7
1649864013503,CSE 3,A51,083647,Miranda; Gregory Joseph,37,0,37,0
1649864019526,CSE 8A,A50,083650,Miranda; Gregory Joseph,29,0,40,11
1649864025569,CSE 11,A01,083080,Cao; Yingjun,7,0,40,33
1649864031600,CSE 12,A01,083652,Staff,82,0,100,18
1649864037622,CSE 15L,A01,083654,Staff,37,0,50,13
1649864037622,CSE 15L,A02,083655,Staff,49,0,50,1
1649864043648,CSE 20,A01,083657,Staff,73,0,80,7
1649864049671,CSE 30,A01,083084,Eldon; John,13,0,40,27
1649864055698,CSE 100,A01,083659,Cao; Yingjun,13,0,50,37
1649864061725,CSE 134B,A01,083661,Powell; Thomas Allan,0,4,65,65
1649864067755,CSE 140,A01,083663,Staff,51,0,75,24
1649864073778,CSE 140L,A01,083088,Eldon; John,47,0,75,28
1649864079801,CSE 175,A01,083665,Kumar; Rakesh,16,0,25,9
1649864085825,CSE 190,A00,092507,Staff,15,0,15,0
1649864091851,ECE 45,A01,083139,Staff,34,0,40,6
1649864097965,ECE 65,A50,083695,Staff,22,0,30,8
1649864103996,ECE 109,A01,091882,Touri; Behrouz,66,0,70,4
1649864110028,ECE 180,A00,083140,Abi Samra; Nicholas Camill,29,0,30,1
1649864110028,ECE 180,B00,083141,Abi Samra; Nicholas Camill,17,0,30,13
1649864116052,MATH 10A,A01,083735,Patchell; Gregory David,25,0,30,5
1649864116052,MATH 10A,A02,083736,Patchell; Gregory David,29,0,30,1
1649864116052,MATH 10A,A03,083737,Patchell; Gregory David,30,0,30,0
1649864122077,MATH 10B,A01,083207,Staff,21,0,30,9
1649864122077,MATH 10B,A02,083208,Staff,28,0,30,2
1649864122077,MATH 10B,B01,083739,Staff,27,0,30,3
1649864122077,MATH 10B,B02,083740,Staff,30,0,30,0
1649864128102,MATH 18,A01,083743,Staff,26,0,30,4
1649864128102,MATH 18,A02,083744,Staff,30,0,30,0
1649864128102,MATH 18,A03,083745,Staff,30,0,30,0
1649864128102,MATH 18,A04,083746,Staff,30,0,30,0
1649864128102,MATH 18,B01,083748,Staff,23,0,30,7
1649864128102,MATH 18,B02,083749,Staff,29,0,30,1
1649864128102,MATH 18,B03,083750,Staff,30,0,30,0
1649864128102,MATH 18,B04,083751,Staff,29,0,30,1
1649864134123,MATH 20A,A01,083754,Staff,39,0,40,1
1649864140147,MATH 20B,A01,083756,Staff,29,0,30,1
1649864140147,MATH 20B,A02,083757,Staff,30,0,30,0
1649864146178,MATH 20C,A01,083760,Staff,27,0,30,3
1649864146178,MATH 20C,A02,083761,Staff,30,0,30,0
1649864146178,MATH 20C,B01,083762,Staff,30,0,30,0
1649864146178,MATH 20C,B02,083763,Staff,30,0,30,0
1649864152203,MATH 20D,A01,083765,Staff,24,0,30,6
1649864152203,MATH 20D,A02,083766,Staff,30,0,30,0
1649864152203,MATH 20D,A03,083767,Staff,30,0,30,0
1649864158231,MATH 20E,A01,083771,Staff,21,0,30,9
1649864158231,MATH 20E,A02,083772,Staff,29,0,30,1
1649864158231,MATH 20E,B01,083773,Staff,25,0,30,5
1649864158231,MATH 20E,B02,083774,Staff,30,0,30,0
1649864164256,MATH 103A,A01,083777,Staff,3,0,30,27
1649864164256,MATH 103A,A02,083778,Staff,23,0,30,7
1649864164256,MATH 103A,B01,083779,Staff,15,0,30,15
1649864164256,MATH 103A,B02,083780,Staff,27,0,30,3
1649864170283,MATH 105,A01,085443,Staff,14,0,30,16
1649864176310,MATH 109,A01,083213,Anzaldo; Leesa B,28,0,30,2
1649864176310,MATH 109,A02,083214,Anzaldo; Leesa B,24,0,30,6
1649864176310,MATH 109,B01,083215,Anzaldo; Leesa B,28,0,30,2
1649864176310,MATH 109,B02,083216,Anzaldo; Leesa B,26,0,30,4
1649864182333,MATH 142A,A01,083219,Chow; Bennett,11,0,30,19
1649864182333,MATH 142A,A02,083220,Chow; Bennett,26,0,30,4
1649864182333,MATH 142A,B01,083221,Chow; Bennett,16,0,30,14
1649864182333,MATH 142A,B02,083222,Chow; Bennett,27,0,30,3
1649864188354,MATH 193A,A01,083224,Staff,0,0,30,30
1649864188354,MATH 193A,A02,083225,Staff,12,0,30,18
1649864188354,MATH 193A,A03,083781,Staff,28,0,30,2
1649864188354,MATH 193A,A04,083782,Staff,28,0,30,2
1649864194379,MATH 197,001,091859,McAuley; Julian John,9999,0,9999,0
1649864200439,COGS 9,A01,083615,Staff,45,0,60,15
1649864206474,COGS 11,A01,083617,Boyle; Mary E. T.,36,0,40,4
1649864212496,COGS 13,A01,083071,Staff,19,0,40,21
1649864218522,COGS 14A,A01,092681,Staff,98,0,100,2
1649864224545,COGS 14B,A01,083073,Cheng; Tzu-Han,39,0,50,11
1649864230573,COGS 17,A01,092677,Staff,74,0,75,1
1649864236599,COGS 100,A01,083619,Staff,34,0,60,26
1649864242622,COGS 101A,A01,083621,Davis; Joshua Daniel,32,0,60,28
1649864248650,COGS 101B,A01,091572,Staff,47,0,60,13
1649864254674,COGS 101C,A01,083625,Delgado; Tania,25,0,30,5
1649864260698,COGS 107A,A01,083627,Boyle; Mary E. T.,41,0,60,19
1649864266734,COGS 118A,A01,083075,Staff,34,0,60,26
1649864272768,CSE 3,A50,083646,Miranda; Gregory Joseph,31,0,38,7
1649864272768,CSE 3,A51,083647,Miranda; Gregory Joseph,37,0,37,0
1649864278795,CSE 8A,A50,083650,Miranda; Gregory Joseph,29,0,40,11
1649864284837,CSE 11,A01,083080,Cao; Yingjun,7,0,40,33
1649864290862,CSE 12,A01,083652,Staff,82,0,100,18
1649864296890,CSE 15L,A01,083654,Staff,37,0,50,13
1649864296890,CSE 15L,A02,083655,Staff,49,0,50,1
1649864302913,CSE 20,A01,083657,Staff,73,0,80,7
1649864308937,CSE 30,A01,083084,Eldon; John,13,0,40,27
1649864314964,CSE 100,A01,083659,Cao; Yingjun,13,0,50,37
1649864320992,CSE 134B,A01,083661,Powell; Thomas Allan,0,4,65,65
1649864327018,CSE 140,A01,083663,Staff,51,0,75,24
1649864333040,CSE 140L,A01,083088,Eldon; John,47,0,75,28
1649864339064,CSE 175,A01,083665,Kumar; Rakesh,16,0,25,9
1649864345092,CSE 190,A00,092507,Staff,15,0,15,0
1649864351122,ECE 45,A01,083139,Staff,34,0,40,6
1649864357147,ECE 65,A50,083695,Staff,22,0,30,8
1649864363171,ECE 109,A01,091882,Touri; Behrouz,66,0,70,4
1649864369200,ECE 180,A00,083140,Abi Samra; Nicholas Camill,29,0,30,1
1649864369200,ECE 180,B00,083141,Abi Samra; Nicholas Camill,17,0,30,13
1649864375237,MATH 10A,A01,083735,Patchell; Gregory David,25,0,30,5
1649864375237,MATH 10A,A02,083736,Patchell; Gregory David,29,0,30,1
1649864375237,MATH 10A,A03,083737,Patchell; Gregory David,30,0,30,0
1649864381264,MATH 10B,A01,083207,Staff,21,0,30,9
1649864381264,MATH 10B,A02,083208,Staff,28,0,30,2
1649864381264,MATH 10B,B01,083739,Staff,27,0,30,3
1649864381264,MATH 10B,B02,083740,Staff,30,0,30,0
1649864387299,MATH 18,A01,083743,Staff,26,0,30,4
1649864387299,MATH 18,A02,083744,Staff,30,0,30,0
1649864387299,MATH 18,A03,083745,Staff,30,0,30,0
1649864387299,MATH 18,A04,083746,Staff,30,0,30,0
1649864387299,MATH 18,B01,083748,Staff,22,0,30,8
1649864387299,MATH 18,B02,083749,Staff,29,0,30,1
1649864387299,MATH 18,B03,083750,Staff,30,0,30,0
1649864387299,MATH 18,B04,083751,Staff,29,0,30,1
1649864393325,MATH 20A,A01,083754,Staff,39,0,40,1
1649864399348,MATH 20B,A01,083756,Staff,29,0,30,1
1649864399348,MATH 20B,A02,083757,Staff,30,0,30,0
1649864405372,MATH 20C,A01,083760,Staff,27,0,30,3
1649864405372,MATH 20C,A02,083761,Staff,30,0,30,0
1649864405372,MATH 20C,B01,083762,Staff,30,0,30,0
1649864405372,MATH 20C,B02,083763,Staff,30,0,30,0
1649864411395,MATH 20D,A01,083765,Staff,24,0,30,6
1649864411395,MATH 20D,A02,083766,Staff,30,0,30,0
1649864411395,MATH 20D,A03,083767,Staff,30,0,30,0
1649864417427,MATH 20E,A01,083771,Staff,21,0,30,9
1649864417427,MATH 20E,A02,083772,Staff,29,0,30,1
1649864417427,MATH 20E,B01,083773,Staff,25,0,30,5
1649864417427,MATH 20E,B02,083774,Staff,30,0,30,0
1649864423455,MATH 103A,A01,083777,Staff,3,0,30,27
1649864423455,MATH 103A,A02,083778,Staff,23,0,30,7
1649864423455,MATH 103A,B01,083779,Staff,15,0,30,15
1649864423455,MATH 103A,B02,083780,Staff,27,0,30,3
1649864429479,MATH 105,A01,085443,Staff,14,0,30,16
1649864435506,MATH 109,A01,083213,Anzaldo; Leesa B,28,0,30,2
1649864435506,MATH 109,A02,083214,Anzaldo; Leesa B,24,0,30,6
1649864435506,MATH 109,B01,083215,Anzaldo; Leesa B,28,0,30,2
1649864435506,MATH 109,B02,083216,Anzaldo; Leesa B,26,0,30,4
1649864441539,MATH 142A,A01,083219,Chow; Bennett,11,0,30,19
1649864441539,MATH 142A,A02,083220,Chow; Bennett,26,0,30,4
1649864441539,MATH 142A,B01,083221,Chow; Bennett,16,0,30,14
1649864441539,MATH 142A,B02,083222,Chow; Bennett,27,0,30,3
1649864447568,MATH 193A,A01,083224,Staff,0,0,30,30
1649864447568,MATH 193A,A02,083225,Staff,12,0,30,18
1649864447568,MATH 193A,A03,083781,Staff,28,0,30,2
1649864447568,MATH 193A,A04,083782,Staff,28,0,30,2
1649864453591,MATH 197,001,091859,McAuley; Julian John,9999,0,9999,0
1649864459652,COGS 9,A01,083615,Staff,45,0,60,15
1649864465677,COGS 11,A01,083617,Boyle; Mary E. T.,36,0,40,4
1649864471699,COGS 13,A01,083071,Staff,19,0,40,21
1649864477730,COGS 14A,A01,092681,Staff,98,0,100,2
1649864483773,COGS 14B,A01,083073,Cheng; Tzu-Han,39,0,50,11
1649864489798,COGS 17,A01,092677,Staff,74,0,75,1
1649864495822,COGS 100,A01,083619,Staff,34,0,60,26
1649864501847,COGS 101A,A01,083621,Davis; Joshua Daniel,32,0,60,28
1649864507870,COGS 101B,A01,091572,Staff,47,0,60,13
1649864513898,COGS 101C,A01,083625,Delgado; Tania,25,0,30,5
1649864519925,COGS 107A,A01,083627,Boyle; Mary E. T.,41,0,60,19
1649864525948,COGS 118A,A01,083075,Staff,34,0,60,26
1649864531971,CSE 3,A50,083646,Miranda; Gregory Joseph,31,0,38,7
1649864531971,CSE 3,A51,083647,Miranda; Gregory Joseph,37,0,37,0
1649864537994,CSE 8A,A50,083650,Miranda; Gregory Joseph,28,0,40,12
1649864544026,CSE 11,A01,083080,Cao; Yingjun,7,0,40,33
1649864550057,CSE 12,A01,083652,Staff,82,0,100,18
1649864556081,CSE 15L,A01,083654,Staff,37,0,50,13
1649864556081,CSE 15L,A02,083655,Staff,49,0,50,1
1649864562114,CSE 20,A01,083657,Staff,73,0,80,7
1649864568154,CSE 30,A01,083084,Eldon; John,13,0,40,27
1649864574194,CSE 100,A01,083659,Cao; Yingjun,11,0,50,39
1649864580217,CSE 134B,A01,083661,Powell; Thomas Allan,0,5,65,65
1649864586247,CSE 140,A01,083663,Staff,51,0,75,24
1649864592276,CSE 140L,A01,083088,Eldon; John,47,0,75,28
1649864598303,CSE 175,A01,083665,Kumar; Rakesh,16,0,25,9
1649864604328,CSE 190,A00,092507,Staff,15,0,15,0
1649864610357,ECE 45,A01,083139,Staff,34,0,40,6
1649864616381,ECE 65,A50,083695,Staff,22,0,30,8
1649864622417,ECE 109,A01,091882,Touri; Behrouz,66,0,70,4
1649864628445,ECE 180,A00,083140,Abi Samra; Nicholas Camill,29,0,30,1
1649864628445,ECE 180,B00,083141,Abi Samra; Nicholas Camill,17,0,30,13
1649864634473,MATH 10A,A01,083735,Patchell; Gregory David,25,0,30,5
1649864634473,MATH 10A,A02,083736,Patchell; Gregory David,29,0,30,1
1649864634473,MATH 10A,A03,083737,Patchell; Gregory David,30,0,30,0
1649864640497,MATH 10B,A01,083207,Staff,21,0,30,9
1649864640497,MATH 10B,A02,083208,Staff,28,0,30,2
1649864640497,MATH 10B,B01,083739,Staff,27,0,30,3
1649864640497,MATH 10B,B02,083740,Staff,30,0,30,0
1649864646539,MATH 18,A01,083743,Staff,26,0,30,4
1649864646539,MATH 18,A02,083744,Staff,30,0,30,0
1649864646539,MATH 18,A03,083745,Staff,30,0,30,0
1649864646539,MATH 18,A04,083746,Staff,30,0,30,0
1649864646539,MATH 18,B01,083748,Staff,22,0,30,8
1649864646539,MATH 18,B02,083749,Staff,29,0,30,1
1649864646539,MATH 18,B03,083750,Staff,30,0,30,0
1649864646539,MATH 18,B04,083751,Staff,29,0,30,1
1649864652568,MATH 20A,A01,083754,Staff,39,0,40,1
1649864658596,MATH 20B,A01,083756,Staff,29,0,30,1
1649864658596,MATH 20B,A02,083757,Staff,30,0,30,0
1649864664621,MATH 20C,A01,083760,Staff,27,0,30,3
1649864664621,MATH 20C,A02,083761,Staff,30,0,30,0
1649864664621,MATH 20C,B01,083762,Staff,30,0,30,0
1649864664621,MATH 20C,B02,083763,Staff,30,0,30,0
1649864670650,MATH 20D,A01,083765,Staff,24,0,30,6
1649864670650,MATH 20D,A02,083766,Staff,30,0,30,0
1649864670650,MATH 20D,A03,083767,Staff,30,0,30,0
1649864676676,MATH 20E,A01,083771,Staff,21,0,30,9
1649864676676,MATH 20E,A02,083772,Staff,29,0,30,1
1649864676676,MATH 20E,B01,083773,Staff,25,0,30,5
1649864676676,MATH 20E,B02,083774,Staff,30,0,30,0
1649864682707,MATH 103A,A01,083777,Staff,3,0,30,27
1649864682707,MATH 103A,A02,083778,Staff,22,0,30,8
1649864682707,MATH 103A,B01,083779,Staff,15,0,30,15
1649864682707,MATH 103A,B02,083780,Staff,26,0,30,4
1649864688730,MATH 105,A01,085443,Staff,13,0,30,17
1649864694860,MATH 109,A01,083213,Anzaldo; Leesa B,28,0,30,2
1649864694860,MATH 109,A02,083214,Anzaldo; Leesa B,24,0,30,6
1649864694860,MATH 109,B01,083215,Anzaldo; Leesa B,28,0,30,2
1649864694860,MATH 109,B02,083216,Anzaldo; Leesa B,26,0,30,4
1649864700905,MATH 142A,A01,083219,Chow; Bennett,11,0,30,19
1649864700905,MATH 142A,A02,083220,Chow; Bennett,26,0,30,4
1649864700905,MATH 142A,B01,083221,Chow; Bennett,16,0,30,14
1649864700905,MATH 142A,B02,083222,Chow; Bennett,27,0,30,3
1649864706937,MATH 193A,A01,083224,Staff,0,0,30,30
1649864706937,MATH 193A,A02,083225,Staff,12,0,30,18
1649864706937,MATH 193A,A03,083781,Staff,28,0,30,2
1649864706937,MATH 193A,A04,083782,Staff,27,0,30,3
1649864712963,MATH 197,001,091859,McAuley; Julian John,9999,0,9999,0
1649864719038,COGS 9,A01,083615,Staff,45,0,60,15
1649864725073,COGS 11,A01,083617,Boyle; Mary E. T.,36,0,40,4
1649864731097,COGS 13,A01,083071,Staff,19,0,40,21
1649864737127,COGS 14A,A01,092681,Staff,98,0,100,2
1649864743161,COGS 14B,A01,083073,Cheng; Tzu-Han,39,0,50,11
1649864749188,COGS 17,A01,092677,Staff,74,0,75,1
1649864755219,COGS 100,A01,083619,Staff,34,0,60,26
1649864761247,COGS 101A,A01,083621,Davis; Joshua Daniel,32,0,60,28
1649864767289,COGS 101B,A01,091572,Staff,47,0,60,13
1649864773315,COGS 101C,A01,083625,Delgado; Tania,25,0,30,5
1649864779344,COGS 107A,A01,083627,Boyle; Mary E. T.,41,0,60,19
1649864785367,COGS 118A,A01,083075,Staff,34,0,60,26
1649864791394,CSE 3,A50,083646,Miranda; Gregory Joseph,31,0,38,7
1649864791394,CSE 3,A51,083647,Miranda; Gregory Joseph,37,0,37,0
1649864797418,CSE 8A,A50,083650,Miranda; Gregory Joseph,28,0,40,12
1649864803443,CSE 11,A01,083080,Cao; Yingjun,7,0,40,33
1649864809469,CSE 12,A01,083652,Staff,82,0,100,18
1649864815494,CSE 15L,A01,083654,Staff,37,0,50,13
1649864815494,CSE 15L,A02,083655,Staff,49,0,50,1
1649864821534,CSE 20,A01,083657,Staff,73,0,80,7
1649864827562,CSE 30,A01,083084,Eldon; John,13,0,40,27
1649864833587,CSE 100,A01,083659,Cao; Yingjun,11,0,50,39
1649864839626,CSE 134B,A01,083661,Powell; Thomas Allan,0,5,65,65
1649864845650,CSE 140,A01,083663,Staff,51,0,75,24
1649864851674,CSE 140L,A01,083088,Eldon; John,47,0,75,28
1649864857698,CSE 175,A01,083665,Kumar; Rakesh,16,0,25,9
1649864863722,CSE 190,A00,092507,Staff,15,0,15,0
1649864869762,ECE 45,A01,083139,Staff,34,0,40,6
1649864875797,ECE 65,A50,083695,Staff,22,0,30,8
1649864881824,ECE 109,A01,091882,Touri; Behrouz,66,0,70,4
1649864887848,ECE 180,A00,083140,Abi Samra; Nicholas Camill,29,0,30,1
1649864887848,ECE 180,B00,083141,Abi Samra; Nicholas Camill,17,0,30,13
1649864893873,MATH 10A,A01,083735,Patchell; Gregory David,25,0,30,5
1649864893873,MATH 10A,A02,083736,Patchell; Gregory David,29,0,30,1
1649864893873,MATH 10A,A03,083737,Patchell; Gregory David,30,0,30,0
1649864899899,MATH 10B,A01,083207,Staff,21,0,30,9
1649864899899,MATH 10B,A02,083208,Staff,28,0,30,2
1649864899899,MATH 10B,B01,083739,Staff,27,0,30,3
1649864899899,MATH 10B,B02,083740,Staff,30,0,30,0
1649864905925,MATH 18,A01,083743,Staff,26,0,30,4
1649864905925,MATH 18,A02,083744,Staff,30,0,30,0
1649864905925,MATH 18,A03,083745,Staff,30,0,30,0
1649864905925,MATH 18,A04,083746,Staff,30,0,30,0
1649864905925,MATH 18,B01,083748,Staff,22,0,30,8
1649864905925,MATH 18,B02,083749,Staff,29,0,30,1
1649864905925,MATH 18,B03,083750,Staff,30,0,30,0
1649864905925,MATH 18,B04,083751,Staff,29,0,30,1
1649864911948,MATH 20A,A01,083754,Staff,39,0,40,1
1649864917976,MATH 20B,A01,083756,Staff,29,0,30,1
1649864917976,MATH 20B,A02,083757,Staff,30,0,30,0
1649864924000,MATH 20C,A01,083760,Staff,27,0,30,3
1649864924000,MATH 20C,A02,083761,Staff,30,0,30,0
1649864924000,MATH 20C,B01,083762,Staff,30,0,30,0
1649864924000,MATH 20C,B02,083763,Staff,30,0,30,0
1649864930027,MATH 20D,A01,083765,Staff,24,0,30,6
1649864930027,MATH 20D,A02,083766,Staff,30,0,30,0
1649864930027,MATH 20D,A03,083767,Staff,30,0,30,0
1649864936052,MATH 20E,A01,083771,Staff,21,0,30,9
1649864936052,MATH 20E,A02,083772,Staff,29,0,30,1
1649864936052,MATH 20E,B01,083773,Staff,25,0,30,5
1649864936052,MATH 20E,B02,083774,Staff,30,0,30,0
1649864942076,MATH 103A,A01,083777,Staff,3,0,30,27
1649864942076,MATH 103A,A02,083778,Staff,22,0,30,8
1649864942076,MATH 103A,B01,083779,Staff,15,0,30,15
1649864942076,MATH 103A,B02,083780,Staff,26,0,30,4
1649864948113,MATH 105,A01,085443,Staff,13,0,30,17
1649864954155,MATH 109,A01,083213,Anzaldo; Leesa B,28,0,30,2
1649864954155,MATH 109,A02,083214,Anzaldo; Leesa B,24,0,30,6
1649864954155,MATH 109,B01,083215,Anzaldo; Leesa B,28,0,30,2
1649864954155,MATH 109,B02,083216,Anzaldo; Leesa B,26,0,30,4
1649864960178,MATH 142A,A01,083219,Chow; Bennett,11,0,30,19
1649864960178,MATH 142A,A02,083220,Chow; Bennett,26,0,30,4
1649864960178,MATH 142A,B01,083221,Chow; Bennett,16,0,30,14
1649864960178,MATH 142A,B02,083222,Chow; Bennett,27,0,30,3
1649864966220,MATH 193A,A01,083224,Staff,0,0,30,30
1649864966220,MATH 193A,A02,083225,Staff,11,0,30,19
1649864966220,MATH 193A,A03,083781,Staff,28,0,30,2
1649864966220,MATH 193A,A04,083782,Staff,27,0,30,3
1649864972243,MATH 197,001,091859,McAuley; Julian John,9999,0,9999,0
1649864978294,COGS 9,A01,083615,Staff,44,0,60,16
1649864984317,COGS 11,A01,083617,Boyle; Mary E. T.,36,0,40,4
1649864990343,COGS 13,A01,083071,Staff,19,0,40,21
1649864996369,COGS 14A,A01,092681,Staff,98,0,100,2
1649865002396,COGS 14B,A01,083073,Cheng; Tzu-Han,39,0,50,11
1649865008432,COGS 17,A01,092677,Staff,74,0,75,1
1649865014456,COGS 100,A01,083619,Staff,34,0,60,26
1649865020479,COGS 101A,A01,083621,Davis; Joshua Daniel,32,0,60,28
1649865026501,COGS 101B,A01,091572,Staff,47,0,60,13
1649865032525,COGS 101C,A01,083625,Delgado; Tania,25,0,30,5
1649865038556,COGS 107A,A01,083627,Boyle; Mary E. T.,41,0,60,19
1649865044577,COGS 118A,A01,083075,Staff,34,0,60,26
1649865050606,CSE 3,A50,083646,Miranda; Gregory Joseph,31,0,38,7
1649865050606,CSE 3,A51,083647,Miranda; Gregory Joseph,37,0,37,0
1649865056631,CSE 8A,A50,083650,Miranda; Gregory Joseph,28,0,40,12
1649865062664,CSE 11,A01,083080,Cao; Yingjun,7,0,40,33
1649865068685,CSE 12,A01,083652,Staff,82,0,100,18
1649865074711,CSE 15L,A01,083654,Staff,37,0,50,13
1649865074711,CSE 15L,A02,083655,Staff,49,0,50,1
1649865080734,CSE 20,A01,083657,Staff,73,0,80,7
1649865086762,CSE 30,A01,083084,Eldon; John,13,0,40,27
1649865092787,CSE 100,A01,083659,Cao; Yingjun,11,0,50,39
1649865098811,CSE 134B,A01,083661,Powell; Thomas Allan,0,5,65,65
1649865104838,CSE 140,A01,083663,Staff,51,0,75,24
1649865110877,CSE 140L,A01,083088,Eldon; John,47,0,75,28
1649865116902,CSE 175,A01,083665,Kumar; Rakesh,16,0,25,9
1649865122940,CSE 190,A00,092507,Staff,15,0,15,0
1649865128974,ECE 45,A01,083139,Staff,34,0,40,6
1649865135007,ECE 65,A50,083695,Staff,22,0,30,8
1649865141034,ECE 109,A01,091882,Touri; Behrouz,66,0,70,4
1649865147068,ECE 180,A00,083140,Abi Samra; Nicholas Camill,29,0,30,1
1649865147068,ECE 180,B00,083141,Abi Samra; Nicholas Camill,17,0,30,13
1649865153091,MATH 10A,A01,083735,Patchell; Gregory David,25,0,30,5
1649865153091,MATH 10A,A02,083736,Patchell; Gregory David,29,0,30,1
1649865153091,MATH 10A,A03,083737,Patchell; Gregory David,30,0,30,0
1649865159114,MATH 10B,A01,083207,Staff,21,0,30,9
1649865159114,MATH 10B,A02,083208,Staff,28,0,30,2
1649865159114,MATH 10B,B01,083739,Staff,27,0,30,3
1649865159114,MATH 10B,B02,083740,Staff,30,0,30,0
1649865165142,MATH 18,A01,083743,Staff,26,0,30,4
1649865165142,MATH 18,A02,083744,Staff,30,0,30,0
1649865165142,MATH 18,A03,083745,Staff,30,0,30,0
1649865165142,MATH 18,A04,083746,Staff,30,0,30,0
1649865165142,MATH 18,B01,083748,Staff,22,0,30,8
1649865165142,MATH 18,B02,083749,Staff,29,0,30,1
1649865165142,MATH 18,B03,083750,Staff,30,0,30,0
1649865165142,MATH 18,B04,083751,Staff,29,0,30,1
1649865171166,MATH 20A,A01,083754,Staff,39,0,40,1
1649865177198,MATH 20B,A01,083756,Staff,29,0,30,1
1649865177198,MATH 20B,A02,083757,Staff,30,0,30,0
1649865183223,MATH 20C,A01,083760,Staff,27,0,30,3
1649865183223,MATH 20C,A02,083761,Staff,30,0,30,0
1649865183223,MATH 20C,B01,083762,Staff,30,0,30,0
1649865183223,MATH 20C,B02,083763,Staff,30,0,30,0
1649865189260,MATH 20D,A01,083765,Staff,24,0,30,6
1649865189260,MATH 20D,A02,083766,Staff,30,0,30,0
1649865189260,MATH 20D,A03,083767,Staff,30,0,30,0
1649865195284,MATH 20E,A01,083771,Staff,21,0,30,9
1649865195284,MATH 20E,A02,083772,Staff,29,0,30,1
1649865195284,MATH 20E,B01,083773,Staff,25,0,30,5
1649865195284,MATH 20E,B02,083774,Staff,30,0,30,0
1649865201311,MATH 103A,A01,083777,Staff,3,0,30,27
1649865201311,MATH 103A,A02,083778,Staff,21,0,30,9
1649865201311,MATH 103A,B01,083779,Staff,15,0,30,15
1649865201311,MATH 103A,B02,083780,Staff,26,0,30,4
1649865207339,MATH 105,A01,085443,Staff,13,0,30,17
1649865213367,MATH 109,A01,083213,Anzaldo; Leesa B,28,0,30,2
1649865213367,MATH 109,A02,083214,Anzaldo; Leesa B,24,0,30,6
1649865213367,MATH 109,B01,083215,Anzaldo; Leesa B,28,0,30,2
1649865213367,MATH 109,B02,083216,Anzaldo; Leesa B,26,0,30,4
1649865219410,MATH 142A,A01,083219,Chow; Bennett,11,0,30,19
1649865219410,MATH 142A,A02,083220,Chow; Bennett,26,0,30,4
1649865219410,MATH 142A,B01,083221,Chow; Bennett,16,0,30,14
1649865219410,MATH 142A,B02,083222,Chow; Bennett,27,0,30,3
1649865225440,MATH 193A,A01,083224,Staff,0,0,30,30
1649865225440,MATH 193A,A02,083225,Staff,11,0,30,19
1649865225440,MATH 193A,A03,083781,Staff,28,0,30,2
1649865225440,MATH 193A,A04,083782,Staff,27,0,30,3
1649865231475,MATH 197,001,091859,McAuley; Julian John,9999,0,9999,0
1649865237544,COGS 9,A01,083615,Staff,44,0,60,16
1649865243571,COGS 11,A01,083617,Boyle; Mary E. T.,36,0,40,4
1649865249595,COGS 13,A01,083071,Staff,19,0,40,21
1649865255619,COGS 14A,A01,092681,Staff,98,0,100,2
1649865261644,COGS 14B,A01,083073,Cheng; Tzu-Han,39,0,50,11
1649865267668,COGS 17,A01,092677,Staff,74,0,75,1
1649865273704,COGS 100,A01,083619,Staff,33,0,60,27
1649865279741,COGS 101A,A01,083621,Davis; Joshua Daniel,32,0,60,28
1649865285891,COGS 101B,A01,091572,Staff,47,0,60,13
1649865291915,COGS 101C,A01,083625,Delgado; Tania,25,0,30,5
1649865297938,COGS 107A,A01,083627,Boyle; Mary E. T.,41,0,60,19
1649865303963,COGS 118A,A01,083075,Staff,34,0,60,26
1649865309992,CSE 3,A50,083646,Miranda; Gregory Joseph,31,0,38,7
1649865309992,CSE 3,A51,083647,Miranda; Gregory Joseph,37,0,37,0
1649865316016,CSE 8A,A50,083650,Miranda; Gregory Joseph,28,0,40,12
1649865322042,CSE 11,A01,083080,Cao; Yingjun,7,0,40,33
1649865328066,CSE 12,A01,083652,Staff,82,0,100,18
1649865334098,CSE 15L,A01,083654,Staff,37,0,50,13
1649865334098,CSE 15L,A02,083655,Staff,49,0,50,1
1649865340123,CSE 20,A01,083657,Staff,73,0,80,7
1649865346147,CSE 30,A01,083084,Eldon; John,11,0,40,29
1649865352171,CSE 100,A01,083659,Cao; Yingjun,10,0,50,40
1649865358197,CSE 134B,A01,083661,Powell; Thomas Allan,0,5,65,65
1649865364231,CSE 140,A01,083663,Staff,50,0,75,25
1649865370262,CSE 140L,A01,083088,Eldon; John,46,0,75,29
1649865376293,CSE 175,A01,083665,Kumar; Rakesh,16,0,25,9
1649865382318,CSE 190,A00,092507,Staff,15,0,15,0
1649865388348,ECE 45,A01,083139,Staff,34,0,40,6
1649865394380,ECE 65,A50,083695,Staff,22,0,30,8
1649865400405,ECE 109,A01,091882,Touri; Behrouz,66,0,70,4
1649865406431,ECE 180,A00,083140,Abi Samra; Nicholas Camill,29,0,30,1
1649865406431,ECE 180,B00,083141,Abi Samra; Nicholas Camill,17,0,30,13
1649865412461,MATH 10A,A01,083735,Patchell; Gregory David,25,0,30,5
1649865412461,MATH 10A,A02,083736,Patchell; Gregory David,29,0,30,1
1649865412461,MATH 10A,A03,083737,Patchell; Gregory David,30,0,30,0
1649865418483,MATH 10B,A01,083207,Staff,21,0,30,9
1649865418483,MATH 10B,A02,083208,Staff,28,0,30,2
1649865418483,MATH 10B,B01,083739,Staff,27,0,30,3
1649865418483,MATH 10B,B02,083740,Staff,30,0,30,0
1649865424518,MATH 18,A01,083743,Staff,25,0,30,5
1649865424518,MATH 18,A02,083744,Staff,30,0,30,0
1649865424518,MATH 18,A03,083745,Staff,30,0,30,0
1649865424518,MATH 18,A04,083746,Staff,30,0,30,0
1649865424518,MATH 18,B01,083748,Staff,22,0,30,8
1649865424518,MATH 18,B02,083749,Staff,29,0,30,1
1649865424518,MATH 18,B03,083750,Staff,30,0,30,0
1649865424518,MATH 18,B04,083751,Staff,29,0,30,1
1649865430544,MATH 20A,A01,083754,Staff,39,0,40,1
1649865436579,MATH 20B,A01,083756,Staff,29,0,30,1
1649865436579,MATH 20B,A02,083757,Staff,30,0,30,0
1649865442602,MATH 20C,A01,083760,Staff,27,0,30,3
1649865442602,MATH 20C,A02,083761,Staff,30,0,30,0
1649865442602,MATH 20C,B01,083762,Staff,30,0,30,0
1649865442602,MATH 20C,B02,083763,Staff,30,0,30,0
1649865448627,MATH 20D,A01,083765,Staff,24,0,30,6
1649865448627,MATH 20D,A02,083766,Staff,30,0,30,0
1649865448627,MATH 20D,A03,083767,Staff,30,0,30,0
1649865454656,MATH 20E,A01,083771,Staff,21,0,30,9
1649865454656,MATH 20E,A02,083772,Staff,29,0,30,1
1649865454656,MATH 20E,B01,083773,Staff,25,0,30,5
1649865454656,MATH 20E,B02,083774,Staff,30,0,30,0
1649865460681,MATH 103A,A01,083777,Staff,3,0,30,27
1649865460681,MATH 103A,A02,083778,Staff,21,0,30,9
1649865460681,MATH 103A,B01,083779,Staff,15,0,30,15
1649865460681,MATH 103A,B02,083780,Staff,26,0,30,4
1649865466709,MATH 105,A01,085443,Staff,13,0,30,17
1649865472738,MATH 109,A01,083213,Anzaldo; Leesa B,28,0,30,2
1649865472738,MATH 109,A02,083214,Anzaldo; Leesa B,24,0,30,6
1649865472738,MATH 109,B01,083215,Anzaldo; Leesa B,28,0,30,2
1649865472738,MATH 109,B02,083216,Anzaldo; Leesa B,26,0,30,4
1649865478770,MATH 142A,A01,083219,Chow; Bennett,11,0,30,19
1649865478770,MATH 142A,A02,083220,Chow; Bennett,26,0,30,4
1649865478770,MATH 142A,B01,083221,Chow; Bennett,16,0,30,14
1649865478770,MATH 142A,B02,083222,Chow; Bennett,27,0,30,3
1649865484796,MATH 193A,A01,083224,Staff,0,0,30,30
1649865484796,MATH 193A,A02,083225,Staff,11,0,30,19
1649865484796,MATH 193A,A03,083781,Staff,28,0,30,2
1649865484796,MATH 193A,A04,083782,Staff,27,0,30,3
1649865490824,MATH 197,001,091859,McAuley; Julian John,9999,0,9999,0
1649865496883,COGS 9,A01,083615,Staff,44,0,60,16
1649865502914,COGS 11,A01,083617,Boyle; Mary E. T.,36,0,40,4
1649865508938,COGS 13,A01,083071,Staff,19,0,40,21
1649865514964,COGS 14A,A01,092681,Staff,98,0,100,2
1649865520989,COGS 14B,A01,083073,Cheng; Tzu-Han,39,0,50,11
1649865527015,COGS 17,A01,092677,Staff,74,0,75,1
1649865533046,COGS 100,A01,083619,Staff,33,0,60,27
1649865539087,COGS 101A,A01,083621,Davis; Joshua Daniel,32,0,60,28
1649865545111,COGS 101B,A01,091572,Staff,47,0,60,13
1649865551138,COGS 101C,A01,083625,Delgado; Tania,25,0,30,5
1649865557162,COGS 107A,A01,083627,Boyle; Mary E. T.,41,0,60,19
1649865563194,COGS 118A,A01,083075,Staff,34,0,60,26
1649865569216,CSE 3,A50,083646,Miranda; Gregory Joseph,31,0,38,7
1649865569216,CSE 3,A51,083647,Miranda; Gregory Joseph,37,0,37,0
1649865575246,CSE 8A,A50,083650,Miranda; Gregory Joseph,28,0,40,12
1649865581283,CSE 11,A01,083080,Cao; Yingjun,7,0,40,33
1649865587307,CSE 12,A01,083652,Staff,82,0,100,18
1649865593333,CSE 15L,A01,083654,Staff,37,0,50,13
1649865593333,CSE 15L,A02,083655,Staff,49,0,50,1
1649865599357,CSE 20,A01,083657,Staff,73,0,80,7
1649865605381,CSE 30,A01,083084,Eldon; John,11,0,40,29
1649865611404,CSE 100,A01,083659,Cao; Yingjun,10,0,50,40
1649865617433,CSE 134B,A01,083661,Powell; Thomas Allan,0,5,65,65
1649865623456,CSE 140,A01,083663,Staff,50,0,75,25
1649865629484,CSE 140L,A01,083088,Eldon; John,46,0,75,29
1649865635507,CSE 175,A01,083665,Kumar; Rakesh,16,0,25,9
1649865641529,CSE 190,A00,092507,Staff,15,0,15,0
1649865647559,ECE 45,A01,083139,Staff,34,0,40,6
1649865653582,ECE 65,A50,083695,Staff,22,0,30,8
1649865659606,ECE 109,A01,091882,Touri; Behrouz,66,0,70,4
1649865665653,ECE 180,A00,083140,Abi Samra; Nicholas Camill,29,0,30,1
1649865665653,ECE 180,B00,083141,Abi Samra; Nicholas Camill,17,0,30,13
1649865671681,MATH 10A,A01,083735,Patchell; Gregory David,25,0,30,5
1649865671681,MATH 10A,A02,083736,Patchell; Gregory David,29,0,30,1
1649865671681,MATH 10A,A03,083737,Patchell; Gregory David,30,0,30,0
1649865677710,MATH 10B,A01,083207,Staff,21,0,30,9
1649865677710,MATH 10B,A02,083208,Staff,28,0,30,2
1649865677710,MATH 10B,B01,083739,Staff,27,0,30,3
1649865677710,MATH 10B,B02,083740,Staff,30,0,30,0
1649865683735,MATH 18,A01,083743,Staff,25,0,30,5
1649865683735,MATH 18,A02,083744,Staff,30,0,30,0
1649865683735,MATH 18,A03,083745,Staff,30,0,30,0
1649865683735,MATH 18,A04,083746,Staff,30,0,30,0
1649865683735,MATH 18,B01,083748,Staff,22,0,30,8
1649865683735,MATH 18,B02,083749,Staff,29,0,30,1
1649865683735,MATH 18,B03,083750,Staff,30,0,30,0
1649865683735,MATH 18,B04,083751,Staff,29,0,30,1
1649865689765,MATH 20A,A01,083754,Staff,39,0,40,1
1649865695790,MATH 20B,A01,083756,Staff,29,0,30,1
1649865695790,MATH 20B,A02,083757,Staff,30,0,30,0
1649865701818,MATH 20C,A01,083760,Staff,27,0,30,3
1649865701818,MATH 20C,A02,083761,Staff,30,0,30,0
1649865701818,MATH 20C,B01,083762,Staff,30,0,30,0
1649865701818,MATH 20C,B02,083763,Staff,30,0,30,0
1649865707842,MATH 20D,A01,083765,Staff,24,0,30,6
1649865707842,MATH 20D,A02,083766,Staff,30,0,30,0
1649865707842,MATH 20D,A03,083767,Staff,30,0,30,0
1649865713875,MATH 20E,A01,083771,Staff,21,0,30,9
1649865713875,MATH 20E,A02,083772,Staff,29,0,30,1
1649865713875,MATH 20E,B01,083773,Staff,25,0,30,5
1649865713875,MATH 20E,B02,083774,Staff,30,0,30,0
1649865719911,MATH 103A,A01,083777,Staff,2,0,30,28
1649865719911,MATH 103A,A02,083778,Staff,21,0,30,9
1649865719911,MATH 103A,B01,083779,Staff,15,0,30,15
1649865719911,MATH 103A,B02,083780,Staff,26,0,30,4
1649865725932,MATH 105,A01,085443,Staff,13,0,30,17
1649865731967,MATH 109,A01,083213,Anzaldo; Leesa B,28,0,30,2
1649865731967,MATH 109,A02,083214,Anzaldo; Leesa B,24,0,30,6
1649865731967,MATH 109,B01,083215,Anzaldo; Leesa B,28,0,30,2
1649865731967,MATH 109,B02,083216,Anzaldo; Leesa B,26,0,30,4
1649865737995,MATH 142A,A01,083219,Chow; Bennett,11,0,30,19
1649865737995,MATH 142A,A02,083220,Chow; Bennett,26,0,30,4
1649865737995,MATH 142A,B01,083221,Chow; Bennett,16,0,30,14
1649865737995,MATH 142A,B02,083222,Chow; Bennett,27,0,30,3
1649865744025,MATH 193A,A01,083224,Staff,0,0,30,30
1649865744025,MATH 193A,A02,083225,Staff,11,0,30,19
1649865744025,MATH 193A,A03,083781,Staff,28,0,30,2
1649865744025,MATH 193A,A04,083782,Staff,27,0,30,3
1649865750051,MATH 197,001,091859,McAuley; Julian John,9999,0,9999,0
1649865756114,COGS 9,A01,083615,Staff,44,0,60,16
1649865762141,COGS 11,A01,083617,Boyle; Mary E. T.,36,0,40,4
1649865768164,COGS 13,A01,083071,Staff,19,0,40,21
1649865774186,COGS 14A,A01,092681,Staff,98,0,100,2
1649865780218,COGS 14B,A01,083073,Cheng; Tzu-Han,39,0,50,11
1649865786245,COGS 17,A01,092677,Staff,74,0,75,1
1649865792270,COGS 100,A01,083619,Staff,31,0,60,29
1649865798305,COGS 101A,A01,083621,Davis; Joshua Daniel,32,0,60,28
1649865804329,COGS 101B,A01,091572,Staff,46,0,60,14
1649865810352,COGS 101C,A01,083625,Delgado; Tania,25,0,30,5
1649865816383,COGS 107A,A01,083627,Boyle; Mary E. T.,40,0,60,20
1649865822407,COGS 118A,A01,083075,Staff,34,0,60,26
1649865828432,CSE 3,A50,083646,Miranda; Gregory Joseph,31,0,38,7
1649865828432,CSE 3,A51,083647,Miranda; Gregory Joseph,37,0,37,0
1649865834459,CSE 8A,A50,083650,Miranda; Gregory Joseph,28,0,40,12
1649865840483,CSE 11,A01,083080,Cao; Yingjun,6,0,40,34
1649865846509,CSE 12,A01,083652,Staff,82,0,100,18
1649865852540,CSE 15L,A01,083654,Staff,37,0,50,13
1649865852540,CSE 15L,A02,083655,Staff,49,0,50,1
1649865858565,CSE 20,A01,083657,Staff,73,0,80,7
1649865864592,CSE 30,A01,083084,Eldon; John,11,0,40,29
1649865870619,CSE 100,A01,083659,Cao; Yingjun,10,0,50,40
1649865876647,CSE 134B,A01,083661,Powell; Thomas Allan,0,5,65,65
1649865882771,CSE 140,A01,083663,Staff,50,0,75,25
1649865888798,CSE 140L,A01,083088,Eldon; John,46,0,75,29
1649865894822,CSE 175,A01,083665,Kumar; Rakesh,15,0,25,10
1649865900848,CSE 190,A00,092507,Staff,15,0,15,0
1649865906872,ECE 45,A01,083139,Staff,34,0,40,6
1649865912909,ECE 65,A50,083695,Staff,22,0,30,8
1649865918935,ECE 109,A01,091882,Touri; Behrouz,66,0,70,4
1649865924970,ECE 180,A00,083140,Abi Samra; Nicholas Camill,29,0,30,1
1649865924970,ECE 180,B00,083141,Abi Samra; Nicholas Camill,17,0,30,13
1649865930998,MATH 10A,A01,083735,Patchell; Gregory David,25,0,30,5
1649865930998,MATH 10A,A02,083736,Patchell; Gregory David,29,0,30,1
1649865930998,MATH 10A,A03,083737,Patchell; Gregory David,30,0,30,0
1649865937023,MATH 10B,A01,083207,Staff,21,0,30,9
1649865937023,MATH 10B,A02,083208,Staff,28,0,30,2
1649865937023,MATH 10B,B01,083739,Staff,27,0,30,3
1649865937023,MATH 10B,B02,083740,Staff,30,0,30,0
1649865943054,MATH 18,A01,083743,Staff,25,0,30,5
1649865943054,MATH 18,A02,083744,Staff,30,0,30,0
1649865943054,MATH 18,A03,083745,Staff,30,0,30,0
1649865943054,MATH 18,A04,083746,Staff,30,0,30,0
1649865943054,MATH 18,B01,083748,Staff,22,0,30,8
1649865943054,MATH 18,B02,083749,Staff,29,0,30,1
1649865943054,MATH 18,B03,083750,Staff,30,0,30,0
1649865943054,MATH 18,B04,083751,Staff,29,0,30,1
1649865949081,MATH 20A,A01,083754,Staff,39,0,40,1
1649865955104,MATH 20B,A01,083756,Staff,29,0,30,1
1649865955104,MATH 20B,A02,083757,Staff,30,0,30,0
1649865961132,MATH 20C,A01,083760,Staff,27,0,30,3
1649865961132,MATH 20C,A02,083761,Staff,30,0,30,0
1649865961132,MATH 20C,B01,083762,Staff,30,0,30,0
1649865961132,MATH 20C,B02,083763,Staff,30,0,30,0
1649865967158,MATH 20D,A01,083765,Staff,24,0,30,6
1649865967158,MATH 20D,A02,083766,Staff,30,0,30,0
1649865967158,MATH 20D,A03,083767,Staff,30,0,30,0
1649865973182,MATH 20E,A01,083771,Staff,21,0,30,9
1649865973182,MATH 20E,A02,083772,Staff,29,0,30,1
1649865973182,MATH 20E,B01,083773,Staff,25,0,30,5
1649865973182,MATH 20E,B02,083774,Staff,30,0,30,0
1649865979208,MATH 103A,A01,083777,Staff,2,0,30,28
1649865979208,MATH 103A,A02,083778,Staff,21,0,30,9
1649865979208,MATH 103A,B01,083779,Staff,15,0,30,15
1649865979208,MATH 103A,B02,083780,Staff,26,0,30,4
1649865985234,MATH 105,A01,085443,Staff,13,0,30,17
1649865991256,MATH 109,A01,083213,Anzaldo; Leesa B,28,0,30,2
1649865991256,MATH 109,A02,083214,Anzaldo; Leesa B,24,0,30,6
1649865991256,MATH 109,B01,083215,Anzaldo; Leesa B,28,0,30,2
1649865991256,MATH 109,B02,083216,Anzaldo; Leesa B,26,0,30,4
1649865997277,MATH 142A,A01,083219,Chow; Bennett,10,0,30,20
1649865997277,MATH 142A,A02,083220,Chow; Bennett,26,0,30,4
1649865997277,MATH 142A,B01,083221,Chow; Bennett,16,0,30,14
1649865997277,MATH 142A,B02,083222,Chow; Bennett,27,0,30,3
1649866003307,MATH 193A,A01,083224,Staff,0,0,30,30
1649866003307,MATH 193A,A02,083225,Staff,10,0,30,20
1649866003307,MATH 193A,A03,083781,Staff,28,0,30,2
1649866003307,MATH 193A,A04,083782,Staff,27,0,30,3
1649866009329,MATH 197,001,091859,McAuley; Julian John,9999,0,9999,0
1649866015390,COGS 9,A01,083615,Staff,43,0,60,17
1649866021436,COGS 11,A01,083617,Boyle; Mary E. T.,36,0,40,4
1649866027461,COGS 13,A01,083071,Staff,19,0,40,21
1649866033493,COGS 14A,A01,092681,Staff,98,0,100,2
1649866039525,COGS 14B,A01,083073,Cheng; Tzu-Han,39,0,50,11
1649866045551,COGS 17,A01,092677,Staff,74,0,75,1
1649866051575,COGS 100,A01,083619,Staff,31,0,60,29
1649866057599,COGS 101A,A01,083621,Davis; Joshua Daniel,32,0,60,28
1649866063623,COGS 101B,A01,091572,Staff,46,0,60,14
1649866069653,COGS 101C,A01,083625,Delgado; Tania,25,0,30,5
1649866075677,COGS 107A,A01,083627,Boyle; Mary E. T.,40,0,60,20
1649866081702,COGS 118A,A01,083075,Staff,34,0,60,26
1649866087724,CSE 3,A50,083646,Miranda; Gregory Joseph,31,0,38,7
1649866087724,CSE 3,A51,083647,Miranda; Gregory Joseph,37,0,37,0
1649866093752,CSE 8A,A50,083650,Miranda; Gregory Joseph,28,0,40,12
1649866099776,CSE 11,A01,083080,Cao; Yingjun,6,0,40,34
1649866105806,CSE 12,A01,083652,Staff,82,0,100,18
1649866111833,CSE 15L,A01,083654,Staff,37,0,50,13
1649866111833,CSE 15L,A02,083655,Staff,49,0,50,1
1649866117866,CSE 20,A01,083657,Staff,73,0,80,7
1649866123892,CSE 30,A01,083084,Eldon; John,11,0,40,29
1649866129914,CSE 100,A01,083659,Cao; Yingjun,10,0,50,40
1649866135944,CSE 134B,A01,083661,Powell; Thomas Allan,0,5,65,65
1649866141967,CSE 140,A01,083663,Staff,50,0,75,25
1649866147993,CSE 140L,A01,083088,Eldon; John,46,0,75,29
1649866154030,CSE 175,A01,083665,Kumar; Rakesh,15,0,25,10
1649866160054,CSE 190,A00,092507,Staff,15,0,15,0
1649866166082,ECE 45,A01,083139,Staff,34,0,40,6
1649866172105,ECE 65,A50,083695,Staff,22,0,30,8
1649866178129,ECE 109,A01,091882,Touri; Behrouz,66,0,70,4
1649866184163,ECE 180,A00,083140,Abi Samra; Nicholas Camill,29,0,30,1
1649866184163,ECE 180,B00,083141,Abi Samra; Nicholas Camill,17,0,30,13
1649866190187,MATH 10A,A01,083735,Patchell; Gregory David,25,0,30,5
1649866190187,MATH 10A,A02,083736,Patchell; Gregory David,29,0,30,1
1649866190187,MATH 10A,A03,083737,Patchell; Gregory David,30,0,30,0
1649866196231,MATH 10B,A01,083207,Staff,21,0,30,9
1649866196231,MATH 10B,A02,083208,Staff,28,0,30,2
1649866196231,MATH 10B,B01,083739,Staff,27,0,30,3
1649866196231,MATH 10B,B02,083740,Staff,30,0,30,0
1649866202261,MATH 18,A01,083743,Staff,25,0,30,5
1649866202261,MATH 18,A02,083744,Staff,30,0,30,0
1649866202261,MATH 18,A03,083745,Staff,30,0,30,0
1649866202261,MATH 18,A04,083746,Staff,30,0,30,0
1649866202261,MATH 18,B01,083748,Staff,22,0,30,8
1649866202261,MATH 18,B02,083749,Staff,29,0,30,1
1649866202261,MATH 18,B03,083750,Staff,30,0,30,0
1649866202261,MATH 18,B04,083751,Staff,29,0,30,1
1649866208300,MATH 20A,A01,083754,Staff,39,0,40,1
1649866214328,MATH 20B,A01,083756,Staff,29,0,30,1
1649866214328,MATH 20B,A02,083757,Staff,30,0,30,0
1649866220351,MATH 20C,A01,083760,Staff,27,0,30,3
1649866220351,MATH 20C,A02,083761,Staff,30,0,30,0
1649866220351,MATH 20C,B01,083762,Staff,30,0,30,0
1649866220351,MATH 20C,B02,083763,Staff,30,0,30,0
1649866226379,MATH 20D,A01,083765,Staff,24,0,30,6
1649866226379,MATH 20D,A02,083766,Staff,30,0,30,0
1649866226379,MATH 20D,A03,083767,Staff,30,0,30,0
1649866232415,MATH 20E,A01,083771,Staff,21,0,30,9
1649866232415,MATH 20E,A02,083772,Staff,29,0,30,1
1649866232415,MATH 20E,B01,083773,Staff,25,0,30,5
1649866232415,MATH 20E,B02,083774,Staff,30,0,30,0
1649866238443,MATH 103A,A01,083777,Staff,2,0,30,28
1649866238443,MATH 103A,A02,083778,Staff,21,0,30,9
1649866238443,MATH 103A,B01,083779,Staff,15,0,30,15
1649866238443,MATH 103A,B02,083780,Staff,26,0,30,4
1649866244466,MATH 105,A01,085443,Staff,13,0,30,17
1649866250494,MATH 109,A01,083213,Anzaldo; Leesa B,28,0,30,2
1649866250494,MATH 109,A02,083214,Anzaldo; Leesa B,24,0,30,6
1649866250494,MATH 109,B01,083215,Anzaldo; Leesa B,28,0,30,2
1649866250494,MATH 109,B02,083216,Anzaldo; Leesa B,26,0,30,4
1649866256530,MATH 142A,A01,083219,Chow; Bennett,10,0,30,20
1649866256530,MATH 142A,A02,083220,Chow; Bennett,26,0,30,4
1649866256530,MATH 142A,B01,083221,Chow; Bennett,16,0,30,14
1649866256530,MATH 142A,B02,083222,Chow; Bennett,27,0,30,3
1649866262562,MATH 193A,A01,083224,Staff,0,0,30,30
1649866262562,MATH 193A,A02,083225,Staff,10,0,30,20
1649866262562,MATH 193A,A03,083781,Staff,28,0,30,2
1649866262562,MATH 193A,A04,083782,Staff,27,0,30,3
1649866268588,MATH 197,001,091859,McAuley; Julian John,9999,0,9999,0
1649866274639,COGS 9,A01,083615,Staff,43,0,60,17
1649866280667,COGS 11,A01,083617,Boyle; Mary E. T.,36,0,40,4
1649866286702,COGS 13,A01,083071,Staff,19,0,40,21
1649866292725,COGS 14A,A01,092681,Staff,98,0,100,2
1649866298754,COGS 14B,A01,083073,Cheng; Tzu-Han,39,0,50,11
1649866304800,COGS 17,A01,092677,Staff,74,0,75,1
1649866310824,COGS 100,A01,083619,Staff,31,0,60,29
1649866316852,COGS 101A,A01,083621,Davis; Joshua Daniel,32,0,60,28
1649866322881,COGS 101B,A01,091572,Staff,46,0,60,14
1649866328905,COGS 101C,A01,083625,Delgado; Tania,25,0,30,5
1649866334932,COGS 107A,A01,083627,Boyle; Mary E. T.,40,0,60,20
1649866340956,COGS 118A,A01,083075,Staff,34,0,60,26
1649866346992,CSE 3,A50,083646,Miranda; Gregory Joseph,31,0,38,7
1649866346992,CSE 3,A51,083647,Miranda; Gregory Joseph,37,0,37,0
1649866353017,CSE 8A,A50,083650,Miranda; Gregory Joseph,28,0,40,12
1649866359041,CSE 11,A01,083080,Cao; Yingjun,6,0,40,34
1649866365066,CSE 12,A01,083652,Staff,82,0,100,18
1649866371089,CSE 15L,A01,083654,Staff,37,0,50,13
1649866371089,CSE 15L,A02,083655,Staff,49,0,50,1
1649866377117,CSE 20,A01,083657,Staff,73,0,80,7
1649866383142,CSE 30,A01,083084,Eldon; John,11,0,40,29
1649866389172,CSE 100,A01,083659,Cao; Yingjun,10,0,50,40
1649866395199,CSE 134B,A01,083661,Powell; Thomas Allan,0,6,65,65
1649866401237,CSE 140,A01,083663,Staff,50,0,75,25
1649866407260,CSE 140L,A01,083088,Eldon; John,46,0,75,29
1649866413282,CSE 175,A01,083665,Kumar; Rakesh,15,0,25,10
1649866419306,CSE 190,A00,092507,Staff,15,0,15,0
1649866425333,ECE 45,A01,083139,Staff,34,0,40,6
1649866431366,ECE 65,A50,083695,Staff,22,0,30,8
1649866437391,ECE 109,A01,091882,Touri; Behrouz,66,0,70,4
1649866443414,ECE 180,A00,083140,Abi Samra; Nicholas Camill,29,0,30,1
1649866443414,ECE 180,B00,083141,Abi Samra; Nicholas Camill,17,0,30,13
1649866449455,MATH 10A,A01,083735,Patchell; Gregory David,25,0,30,5
1649866449455,MATH 10A,A02,083736,Patchell; Gregory David,29,0,30,1
1649866449455,MATH 10A,A03,083737,Patchell; Gregory David,30,0,30,0
1649866455478,MATH 10B,A01,083207,Staff,21,0,30,9
1649866455478,MATH 10B,A02,083208,Staff,28,0,30,2
1649866455478,MATH 10B,B01,083739,Staff,27,0,30,3
1649866455478,MATH 10B,B02,083740,Staff,30,0,30,0
1649866461502,MATH 18,A01,083743,Staff,25,0,30,5
1649866461502,MATH 18,A02,083744,Staff,30,0,30,0
1649866461502,MATH 18,A03,083745,Staff,30,0,30,0
1649866461502,MATH 18,A04,083746,Staff,30,0,30,0
1649866461502,MATH 18,B01,083748,Staff,22,0,30,8
1649866461502,MATH 18,B02,083749,Staff,29,0,30,1
1649866461502,MATH 18,B03,083750,Staff,30,0,30,0
1649866461502,MATH 18,B04,083751,Staff,29,0,30,1
1649866467527,MATH 20A,A01,083754,Staff,39,0,40,1
1649866473555,MATH 20B,A01,083756,Staff,29,0,30,1
1649866473555,MATH 20B,A02,083757,Staff,30,0,30,0
1649866479658,MATH 20C,A01,083760,Staff,27,0,30,3
1649866479658,MATH 20C,A02,083761,Staff,30,0,30,0
1649866479658,MATH 20C,B01,083762,Staff,30,0,30,0
1649866479658,MATH 20C,B02,083763,Staff,30,0,30,0
1649866485682,MATH 20D,A01,083765,Staff,24,0,30,6
1649866485682,MATH 20D,A02,083766,Staff,30,0,30,0
1649866485682,MATH 20D,A03,083767,Staff,30,0,30,0
1649866491709,MATH 20E,A01,083771,Staff,21,0,30,9
1649866491709,MATH 20E,A02,083772,Staff,29,0,30,1
1649866491709,MATH 20E,B01,083773,Staff,25,0,30,5
1649866491709,MATH 20E,B02,083774,Staff,30,0,30,0
1649866497733,MATH 103A,A01,083777,Staff,2,0,30,28
1649866497733,MATH 103A,A02,083778,Staff,21,0,30,9
1649866497733,MATH 103A,B01,083779,Staff,15,0,30,15
1649866497733,MATH 103A,B02,083780,Staff,26,0,30,4
1649866503757,MATH 105,A01,085443,Staff,13,0,30,17
1649866509788,MATH 109,A01,083213,Anzaldo; Leesa B,28,0,30,2
1649866509788,MATH 109,A02,083214,Anzaldo; Leesa B,24,0,30,6
1649866509788,MATH 109,B01,083215,Anzaldo; Leesa B,28,0,30,2
1649866509788,MATH 109,B02,083216,Anzaldo; Leesa B,26,0,30,4
1649866515811,MATH 142A,A01,083219,Chow; Bennett,10,0,30,20
1649866515811,MATH 142A,A02,083220,Chow; Bennett,26,0,30,4
1649866515811,MATH 142A,B01,083221,Chow; Bennett,16,0,30,14
1649866515811,MATH 142A,B02,083222,Chow; Bennett,27,0,30,3
1649866521834,MATH 193A,A01,083224,Staff,0,0,30,30
1649866521834,MATH 193A,A02,083225,Staff,10,0,30,20
1649866521834,MATH 193A,A03,083781,Staff,28,0,30,2
1649866521834,MATH 193A,A04,083782,Staff,27,0,30,3
1649866527859,MATH 197,001,091859,McAuley; Julian John,9999,0,9999,0
1649866533934,COGS 9,A01,083615,Staff,43,0,60,17
1649866539959,COGS 11,A01,083617,Boyle; Mary E. T.,36,0,40,4
1649866545986,COGS 13,A01,083071,Staff,19,0,40,21
1649866552010,COGS 14A,A01,092681,Staff,98,0,100,2
1649866558036,COGS 14B,A01,083073,Cheng; Tzu-Han,39,0,50,11
1649866564059,COGS 17,A01,092677,Staff,74,0,75,1
1649866570086,COGS 100,A01,083619,Staff,31,0,60,29
1649866576112,COGS 101A,A01,083621,Davis; Joshua Daniel,32,0,60,28
1649866582142,COGS 101B,A01,091572,Staff,46,0,60,14
1649866588165,COGS 101C,A01,083625,Delgado; Tania,25,0,30,5
1649866594188,COGS 107A,A01,083627,Boyle; Mary E. T.,40,0,60,20
1649866600212,COGS 118A,A01,083075,Staff,34,0,60,26
1649866606253,CSE 3,A50,083646,Miranda; Gregory Joseph,31,0,38,7
1649866606253,CSE 3,A51,083647,Miranda; Gregory Joseph,37,0,37,0
1649866612281,CSE 8A,A50,083650,Miranda; Gregory Joseph,28,0,40,12
1649866618316,CSE 11,A01,083080,Cao; Yingjun,6,0,40,34
1649866624342,CSE 12,A01,083652,Staff,82,0,100,18
1649866630370,CSE 15L,A01,083654,Staff,37,0,50,13
1649866630370,CSE 15L,A02,083655,Staff,49,0,50,1
1649866636396,CSE 20,A01,083657,Staff,73,0,80,7
1649866642419,CSE 30,A01,083084,Eldon; John,11,0,40,29
1649866648444,CSE 100,A01,083659,Cao; Yingjun,10,0,50,40
1649866654467,CSE 134B,A01,083661,Powell; Thomas Allan,0,6,65,65
1649866660499,CSE 140,A01,083663,Staff,50,0,75,25
1649866666532,CSE 140L,A01,083088,Eldon; John,46,0,75,29
1649866672567,CSE 175,A01,083665,Kumar; Rakesh,15,0,25,10
1649866678593,CSE 190,A00,092507,Staff,15,0,15,0
1649866684627,ECE 45,A01,083139,Staff,34,0,40,6
1649866690655,ECE 65,A50,083695,Staff,22,0,30,8
1649866696692,ECE 109,A01,091882,Touri; Behrouz,66,0,70,4
1649866702718,ECE 180,A00,083140,Abi Samra; Nicholas Camill,29,0,30,1
1649866702718,ECE 180,B00,083141,Abi Samra; Nicholas Camill,16,0,30,14
1649866708745,MATH 10A,A01,083735,Patchell; Gregory David,25,0,30,5
1649866708745,MATH 10A,A02,083736,Patchell; Gregory David,29,0,30,1
1649866708745,MATH 10A,A03,083737,Patchell; Gregory David,30,0,30,0
1649866714769,MATH 10B,A01,083207,Staff,21,0,30,9
1649866714769,MATH 10B,A02,083208,Staff,28,0,30,2
1649866714769,MATH 10B,B01,083739,Staff,27,0,30,3
1649866714769,MATH 10B,B02,083740,Staff,30,0,30,0
1649866720795,MATH 18,A01,083743,Staff,25,0,30,5
1649866720795,MATH 18,A02,083744,Staff,30,0,30,0
1649866720795,MATH 18,A03,083745,Staff,30,0,30,0
1649866720795,MATH 18,A04,083746,Staff,30,0,30,0
1649866720795,MATH 18,B01,083748,Staff,22,0,30,8
1649866720795,MATH 18,B02,083749,Staff,29,0,30,1
1649866720795,MATH 18,B03,083750,Staff,30,0,30,0
1649866720795,MATH 18,B04,083751,Staff,29,0,30,1
1649866726830,MATH 20A,A01,083754,Staff,39,0,40,1
1649866732873,MATH 20B,A01,083756,Staff,29,0,30,1
1649866732873,MATH 20B,A02,083757,Staff,30,0,30,0
1649866738898,MATH 20C,A01,083760,Staff,27,0,30,3
1649866738898,MATH 20C,A02,083761,Staff,30,0,30,0
1649866738898,MATH 20C,B01,083762,Staff,30,0,30,0
1649866738898,MATH 20C,B02,083763,Staff,30,0,30,0
1649866744930,MATH 20D,A01,083765,Staff,24,0,30,6
1649866744930,MATH 20D,A02,083766,Staff,30,0,30,0
1649866744930,MATH 20D,A03,083767,Staff,30,0,30,0
1649866750953,MATH 20E,A01,083771,Staff,21,0,30,9
1649866750953,MATH 20E,A02,083772,Staff,29,0,30,1
1649866750953,MATH 20E,B01,083773,Staff,25,0,30,5
1649866750953,MATH 20E,B02,083774,Staff,30,0,30,0
1649866756977,MATH 103A,A01,083777,Staff,2,0,30,28
1649866756977,MATH 103A,A02,083778,Staff,21,0,30,9
1649866756977,MATH 103A,B01,083779,Staff,14,0,30,16
1649866756977,MATH 103A,B02,083780,Staff,26,0,30,4
1649866763000,MATH 105,A01,085443,Staff,13,0,30,17
1649866769028,MATH 109,A01,083213,Anzaldo; Leesa B,28,0,30,2
1649866769028,MATH 109,A02,083214,Anzaldo; Leesa B,24,0,30,6
1649866769028,MATH 109,B01,083215,Anzaldo; Leesa B,28,0,30,2
1649866769028,MATH 109,B02,083216,Anzaldo; Leesa B,26,0,30,4
1649866775060,MATH 142A,A01,083219,Chow; Bennett,10,0,30,20
1649866775060,MATH 142A,A02,083220,Chow; Bennett,26,0,30,4
1649866775060,MATH 142A,B01,083221,Chow; Bennett,16,0,30,14
1649866775060,MATH 142A,B02,083222,Chow; Bennett,27,0,30,3
1649866781087,MATH 193A,A01,083224,Staff,0,0,30,30
1649866781087,MATH 193A,A02,083225,Staff,10,0,30,20
1649866781087,MATH 193A,A03,083781,Staff,28,0,30,2
1649866781087,MATH 193A,A04,083782,Staff,27,0,30,3
1649866787113,MATH 197,001,091859,McAuley; Julian John,9999,0,9999,0
1649866793164,COGS 9,A01,083615,Staff,43,0,60,17
1649866799191,COGS 11,A01,083617,Boyle; Mary E. T.,36,0,40,4
1649866805238,COGS 13,A01,083071,Staff,19,0,40,21
1649866811266,COGS 14A,A01,092681,Staff,98,0,100,2
1649866817290,COGS 14B,A01,083073,Cheng; Tzu-Han,39,0,50,11
1649866823317,COGS 17,A01,092677,Staff,74,0,75,1
1649866829340,COGS 100,A01,083619,Staff,31,0,60,29
1649866835372,COGS 101A,A01,083621,Davis; Joshua Daniel,32,0,60,28
1649866841399,COGS 101B,A01,091572,Staff,46,0,60,14
1649866847440,COGS 101C,A01,083625,Delgado; Tania,25,0,30,5
1649866853471,COGS 107A,A01,083627,Boyle; Mary E. T.,40,0,60,20
1649866859498,COGS 118A,A01,083075,Staff,34,0,60,26
1649866865522,CSE 3,A50,083646,Miranda; Gregory Joseph,31,0,38,7
1649866865522,CSE 3,A51,083647,Miranda; Gregory Joseph,37,0,37,0
1649866871553,CSE 8A,A50,083650,Miranda; Gregory Joseph,28,0,40,12
1649866877576,CSE 11,A01,083080,Cao; Yingjun,6,0,40,34
1649866883599,CSE 12,A01,083652,Staff,82,0,100,18
1649866889627,CSE 15L,A01,083654,Staff,37,0,50,13
1649866889627,CSE 15L,A02,083655,Staff,49,0,50,1
1649866895661,CSE 20,A01,083657,Staff,73,0,80,7
1649866901684,CSE 30,A01,083084,Eldon; John,11,0,40,29
1649866907711,CSE 100,A01,083659,Cao; Yingjun,10,0,50,40
1649866913745,CSE 134B,A01,083661,Powell; Thomas Allan,0,10,65,65
1649866919781,CSE 140,A01,083663,Staff,47,0,75,28
1649866925813,CSE 140L,A01,083088,Eldon; John,43,0,75,32
1649866931835,CSE 175,A01,083665,Kumar; Rakesh,15,0,25,10
1649866937873,CSE 190,A00,092507,Staff,15,0,15,0
1649866943905,ECE 45,A01,083139,Staff,34,0,40,6
1649866949943,ECE 65,A50,083695,Staff,22,0,30,8
1649866955968,ECE 109,A01,091882,Touri; Behrouz,66,0,70,4
1649866961991,ECE 180,A00,083140,Abi Samra; Nicholas Camill,29,0,30,1
1649866961991,ECE 180,B00,083141,Abi Samra; Nicholas Camill,16,0,30,14
1649866968019,MATH 10A,A01,083735,Patchell; Gregory David,25,0,30,5
1649866968019,MATH 10A,A02,083736,Patchell; Gregory David,29,0,30,1
1649866968019,MATH 10A,A03,083737,Patchell; Gregory David,30,0,30,0
1649866974053,MATH 10B,A01,083207,Staff,21,0,30,9
1649866974053,MATH 10B,A02,083208,Staff,28,0,30,2
1649866974053,MATH 10B,B01,083739,Staff,26,0,30,4
1649866974053,MATH 10B,B02,083740,Staff,30,0,30,0
1649866980087,MATH 18,A01,083743,Staff,25,0,30,5
1649866980087,MATH 18,A02,083744,Staff,30,0,30,0
1649866980087,MATH 18,A03,083745,Staff,30,0,30,0
1649866980087,MATH 18,A04,083746,Staff,30,0,30,0
1649866980087,MATH 18,B01,083748,Staff,22,0,30,8
1649866980087,MATH 18,B02,083749,Staff,29,0,30,1
1649866980087,MATH 18,B03,083750,Staff,30,0,30,0
1649866980087,MATH 18,B04,083751,Staff,29,0,30,1
1649866986111,MATH 20A,A01,083754,Staff,39,0,40,1
1649866992134,MATH 20B,A01,083756,Staff,29,0,30,1
1649866992134,MATH 20B,A02,083757,Staff,30,0,30,0
1649866998164,MATH 20C,A01,083760,Staff,27,0,30,3
1649866998164,MATH 20C,A02,083761,Staff,30,0,30,0
1649866998164,MATH 20C,B01,083762,Staff,30,0,30,0
1649866998164,MATH 20C,B02,083763,Staff,30,0,30,0
1649867004200,MATH 20D,A01,083765,Staff,24,0,30,6
1649867004200,MATH 20D,A02,083766,Staff,30,0,30,0
1649867004200,MATH 20D,A03,083767,Staff,30,0,30,0
1649867010224,MATH 20E,A01,083771,Staff,21,0,30,9
1649867010224,MATH 20E,A02,083772,Staff,29,0,30,1
1649867010224,MATH 20E,B01,083773,Staff,25,0,30,5
1649867010224,MATH 20E,B02,083774,Staff,30,0,30,0
1649867016249,MATH 103A,A01,083777,Staff,2,0,30,28
1649867016249,MATH 103A,A02,083778,Staff,21,0,30,9
1649867016249,MATH 103A,B01,083779,Staff,14,0,30,16
1649867016249,MATH 103A,B02,083780,Staff,26,0,30,4
1649867022285,MATH 105,A01,085443,Staff,13,0,30,17
1649867028316,MATH 109,A01,083213,Anzaldo; Leesa B,28,0,30,2
1649867028316,MATH 109,A02,083214,Anzaldo; Leesa B,24,0,30,6
1649867028316,MATH 109,B01,083215,Anzaldo; Leesa B,28,0,30,2
1649867028316,MATH 109,B02,083216,Anzaldo; Leesa B,26,0,30,4
1649867034345,MATH 142A,A01,083219,Chow; Bennett,10,0,30,20
1649867034345,MATH 142A,A02,083220,Chow; Bennett,26,0,30,4
1649867034345,MATH 142A,B01,083221,Chow; Bennett,16,0,30,14
1649867034345,MATH 142A,B02,083222,Chow; Bennett,27,0,30,3
1649867040373,MATH 193A,A01,083224,Staff,0,1,30,30
1649867040373,MATH 193A,A02,083225,Staff,9,0,30,21
1649867040373,MATH 193A,A03,083781,Staff,28,0,30,2
1649867040373,MATH 193A,A04,083782,Staff,27,0,30,3
1649867046398,MATH 197,001,091859,McAuley; Julian John,9999,0,9999,0
1649867052452,COGS 9,A01,083615,Staff,43,0,60,17
1649867058480,COGS 11,A01,083617,Boyle; Mary E. T.,36,0,40,4
1649867064510,COGS 13,A01,083071,Staff,18,0,40,22
1649867070635,COGS 14A,A01,092681,Staff,98,0,100,2
1649867076665,COGS 14B,A01,083073,Cheng; Tzu-Han,39,0,50,11
1649867082689,COGS 17,A01,092677,Staff,74,0,75,1
1649867088714,COGS 100,A01,083619,Staff,31,0,60,29
1649867094746,COGS 101A,A01,083621,Davis; Joshua Daniel,32,0,60,28
1649867100774,COGS 101B,A01,091572,Staff,46,0,60,14
1649867106809,COGS 101C,A01,083625,Delgado; Tania,25,0,30,5
1649867112836,COGS 107A,A01,083627,Boyle; Mary E. T.,38,0,60,22
1649867118858,COGS 118A,A01,083075,Staff,34,0,60,26
1649867124882,CSE 3,A50,083646,Miranda; Gregory Joseph,31,0,38,7
1649867124882,CSE 3,A51,083647,Miranda; Gregory Joseph,37,0,37,0
1649867130913,CSE 8A,A50,083650,Miranda; Gregory Joseph,28,0,40,12
1649867136937,CSE 11,A01,083080,Cao; Yingjun,6,0,40,34
1649867142975,CSE 12,A01,083652,Staff,82,0,100,18
1649867148999,CSE 15L,A01,083654,Staff,37,0,50,13
1649867148999,CSE 15L,A02,083655,Staff,49,0,50,1
1649867155026,CSE 20,A01,083657,Staff,73,0,80,7
1649867161054,CSE 30,A01,083084,Eldon; John,11,0,40,29
1649867167089,CSE 100,A01,083659,Cao; Yingjun,10,0,50,40
1649867173115,CSE 134B,A01,083661,Powell; Thomas Allan,0,11,65,65
1649867179143,CSE 140,A01,083663,Staff,47,0,75,28
1649867185167,CSE 140L,A01,083088,Eldon; John,43,0,75,32
1649867191206,CSE 175,A01,083665,Kumar; Rakesh,15,0,25,10
1649867197230,CSE 190,A00,092507,Staff,15,0,15,0
1649867203257,ECE 45,A01,083139,Staff,34,0,40,6
1649867209285,ECE 65,A50,083695,Staff,22,0,30,8
1649867215309,ECE 109,A01,091882,Touri; Behrouz,66,0,70,4
1649867221337,ECE 180,A00,083140,Abi Samra; Nicholas Camill,29,0,30,1
1649867221337,ECE 180,B00,083141,Abi Samra; Nicholas Camill,16,0,30,14
1649867227370,MATH 10A,A01,083735,Patchell; Gregory David,25,0,30,5
1649867227370,MATH 10A,A02,083736,Patchell; Gregory David,29,0,30,1
1649867227370,MATH 10A,A03,083737,Patchell; Gregory David,30,0,30,0
1649867233394,MATH 10B,A01,083207,Staff,21,0,30,9
1649867233394,MATH 10B,A02,083208,Staff,28,0,30,2
1649867233394,MATH 10B,B01,083739,Staff,26,0,30,4
1649867233394,MATH 10B,B02,083740,Staff,30,0,30,0
1649867239426,MATH 18,A01,083743,Staff,25,0,30,5
1649867239426,MATH 18,A02,083744,Staff,30,0,30,0
1649867239426,MATH 18,A03,083745,Staff,30,0,30,0
1649867239426,MATH 18,A04,083746,Staff,30,0,30,0
1649867239426,MATH 18,B01,083748,Staff,22,0,30,8
1649867239426,MATH 18,B02,083749,Staff,29,0,30,1
1649867239426,MATH 18,B03,083750,Staff,30,0,30,0
1649867239426,MATH 18,B04,083751,Staff,29,0,30,1
1649867245453,MATH 20A,A01,083754,Staff,39,0,40,1
1649867251477,MATH 20B,A01,083756,Staff,29,0,30,1
1649867251477,MATH 20B,A02,083757,Staff,30,0,30,0
1649867257501,MATH 20C,A01,083760,Staff,27,0,30,3
1649867257501,MATH 20C,A02,083761,Staff,30,0,30,0
1649867257501,MATH 20C,B01,083762,Staff,30,0,30,0
1649867257501,MATH 20C,B02,083763,Staff,30,0,30,0
1649867263524,MATH 20D,A01,083765,Staff,24,0,30,6
1649867263524,MATH 20D,A02,083766,Staff,30,0,30,0
1649867263524,MATH 20D,A03,083767,Staff,30,0,30,0
1649867269548,MATH 20E,A01,083771,Staff,21,0,30,9
1649867269548,MATH 20E,A02,083772,Staff,29,0,30,1
1649867269548,MATH 20E,B01,083773,Staff,25,0,30,5
1649867269548,MATH 20E,B02,083774,Staff,30,0,30,0
1649867275584,MATH 103A,A01,083777,Staff,2,0,30,28
1649867275584,MATH 103A,A02,083778,Staff,21,0,30,9
1649867275584,MATH 103A,B01,083779,Staff,14,0,30,16
1649867275584,MATH 103A,B02,083780,Staff,26,0,30,4
1649867281607,MATH 105,A01,085443,Staff,13,0,30,17
1649867287632,MATH 109,A01,083213,Anzaldo; Leesa B,28,0,30,2
1649867287632,MATH 109,A02,083214,Anzaldo; Leesa B,24,0,30,6
1649867287632,MATH 109,B01,083215,Anzaldo; Leesa B,28,0,30,2
1649867287632,MATH 109,B02,083216,Anzaldo; Leesa B,26,0,30,4
1649867293669,MATH 142A,A01,083219,Chow; Bennett,10,0,30,20
1649867293669,MATH 142A,A02,083220,Chow; Bennett,26,0,30,4
1649867293669,MATH 142A,B01,083221,Chow; Bennett,16,0,30,14
1649867293669,MATH 142A,B02,083222,Chow; Bennett,27,0,30,3
1649867299694,MATH 193A,A01,083224,Staff,0,1,30,30
1649867299694,MATH 193A,A02,083225,Staff,9,0,30,21
1649867299694,MATH 193A,A03,083781,Staff,28,0,30,2
1649867299694,MATH 193A,A04,083782,Staff,27,0,30,3
1649867305717,MATH 197,001,091859,McAuley; Julian John,9999,0,9999,0
1649867311786,COGS 9,A01,083615,Staff,43,0,60,17
1649867317817,COGS 11,A01,083617,Boyle; Mary E. T.,36,0,40,4
1649867323849,COGS 13,A01,083071,Staff,19,0,40,21
1649867329873,COGS 14A,A01,092681,Staff,97,0,100,3
1649867335903,COGS 14B,A01,083073,Cheng; Tzu-Han,39,0,50,11
1649867341928,COGS 17,A01,092677,Staff,74,0,75,1
1649867347955,COGS 100,A01,083619,Staff,31,0,60,29
1649867353981,COGS 101A,A01,083621,Davis; Joshua Daniel,32,0,60,28
1649867360004,COGS 101B,A01,091572,Staff,46,0,60,14
1649867366040,COGS 101C,A01,083625,Delgado; Tania,25,0,30,5
1649867372063,COGS 107A,A01,083627,Boyle; Mary E. T.,38,0,60,22
1649867378092,COGS 118A,A01,083075,Staff,34,0,60,26
1649867384116,CSE 3,A50,083646,Miranda; Gregory Joseph,31,0,38,7
1649867384116,CSE 3,A51,083647,Miranda; Gregory Joseph,37,0,37,0
1649867390153,CSE 8A,A50,083650,Miranda; Gregory Joseph,28,0,40,12
1649867396181,CSE 11,A01,083080,Cao; Yingjun,6,0,40,34
1649867402209,CSE 12,A01,083652,Staff,82,0,100,18
1649867408234,CSE 15L,A01,083654,Staff,37,0,50,13
1649867408234,CSE 15L,A02,083655,Staff,49,0,50,1
1649867414263,CSE 20,A01,083657,Staff,73,0,80,7
1649867420289,CSE 30,A01,083084,Eldon; John,11,0,40,29
1649867426310,CSE 100,A01,083659,Cao; Yingjun,10,0,50,40
1649867432336,CSE 134B,A01,083661,Powell; Thomas Allan,0,11,65,65
1649867438361,CSE 140,A01,083663,Staff,47,0,75,28
1649867444383,CSE 140L,A01,083088,Eldon; John,43,0,75,32
1649867450406,CSE 175,A01,083665,Kumar; Rakesh,15,0,25,10
1649867456428,CSE 190,A00,092507,Staff,15,0,15,0
1649867462456,ECE 45,A01,083139,Staff,34,0,40,6
1649867468480,ECE 65,A50,083695,Staff,22,0,30,8
1649867474503,ECE 109,A01,091882,Touri; Behrouz,66,0,70,4
1649867480535,ECE 180,A00,083140,Abi Samra; Nicholas Camill,29,0,30,1
1649867480535,ECE 180,B00,083141,Abi Samra; Nicholas Camill,16,0,30,14
1649867486559,MATH 10A,A01,083735,Patchell; Gregory David,25,0,30,5
1649867486559,MATH 10A,A02,083736,Patchell; Gregory David,29,0,30,1
1649867486559,MATH 10A,A03,083737,Patchell; Gregory David,30,0,30,0
1649867492588,MATH 10B,A01,083207,Staff,21,0,30,9
1649867492588,MATH 10B,A02,083208,Staff,28,0,30,2
1649867492588,MATH 10B,B01,083739,Staff,26,0,30,4
1649867492588,MATH 10B,B02,083740,Staff,30,0,30,0
1649867498620,MATH 18,A01,083743,Staff,25,0,30,5
1649867498620,MATH 18,A02,083744,Staff,30,0,30,0
1649867498620,MATH 18,A03,083745,Staff,30,0,30,0
1649867498620,MATH 18,A04,083746,Staff,30,0,30,0
1649867498620,MATH 18,B01,083748,Staff,22,0,30,8
1649867498620,MATH 18,B02,083749,Staff,29,0,30,1
1649867498620,MATH 18,B03,083750,Staff,30,0,30,0
1649867498620,MATH 18,B04,083751,Staff,29,0,30,1
1649867504644,MATH 20A,A01,083754,Staff,39,0,40,1
1649867510685,MATH 20B,A01,083756,Staff,29,0,30,1
1649867510685,MATH 20B,A02,083757,Staff,30,0,30,0
1649867516710,MATH 20C,A01,083760,Staff,27,0,30,3
1649867516710,MATH 20C,A02,083761,Staff,30,0,30,0
1649867516710,MATH 20C,B01,083762,Staff,30,0,30,0
1649867516710,MATH 20C,B02,083763,Staff,30,0,30,0
1649867522735,MATH 20D,A01,083765,Staff,24,0,30,6
1649867522735,MATH 20D,A02,083766,Staff,30,0,30,0
1649867522735,MATH 20D,A03,083767,Staff,30,0,30,0
1649867528763,MATH 20E,A01,083771,Staff,21,0,30,9
1649867528763,MATH 20E,A02,083772,Staff,29,0,30,1
1649867528763,MATH 20E,B01,083773,Staff,25,0,30,5
1649867528763,MATH 20E,B02,083774,Staff,30,0,30,0
1649867534792,MATH 103A,A01,083777,Staff,2,0,30,28
1649867534792,MATH 103A,A02,083778,Staff,21,0,30,9
1649867534792,MATH 103A,B01,083779,Staff,14,0,30,16
1649867534792,MATH 103A,B02,083780,Staff,26,0,30,4
1649867540814,MATH 105,A01,085443,Staff,13,0,30,17
1649867546836,MATH 109,A01,083213,Anzaldo; Leesa B,28,0,30,2
1649867546836,MATH 109,A02,083214,Anzaldo; Leesa B,24,0,30,6
1649867546836,MATH 109,B01,083215,Anzaldo; Leesa B,28,0,30,2
1649867546836,MATH 109,B02,083216,Anzaldo; Leesa B,26,0,30,4
1649867552862,MATH 142A,A01,083219,Chow; Bennett,10,0,30,20
1649867552862,MATH 142A,A02,083220,Chow; Bennett,26,0,30,4
1649867552862,MATH 142A,B01,083221,Chow; Bennett,16,0,30,14
1649867552862,MATH 142A,B02,083222,Chow; Bennett,27,0,30,3
1649867558886,MATH 193A,A01,083224,Staff,0,1,30,30
1649867558886,MATH 193A,A02,083225,Staff,9,0,30,21
1649867558886,MATH 193A,A03,083781,Staff,28,0,30,2
1649867558886,MATH 193A,A04,083782,Staff,27,0,30,3
1649867564931,MATH 197,001,091859,McAuley; Julian John,9999,0,9999,0
1649867570984,COGS 9,A01,083615,Staff,43,0,60,17
1649867577021,COGS 11,A01,083617,Boyle; Mary E. T.,36,0,40,4
1649867583057,COGS 13,A01,083071,Staff,19,0,40,21
1649867589080,COGS 14A,A01,092681,Staff,97,0,100,3
1649867595104,COGS 14B,A01,083073,Cheng; Tzu-Han,39,0,50,11
1649867601128,COGS 17,A01,092677,Staff,74,0,75,1
1649867607163,COGS 100,A01,083619,Staff,31,0,60,29
1649867613187,COGS 101A,A01,083621,Davis; Joshua Daniel,32,0,60,28
1649867619211,COGS 101B,A01,091572,Staff,46,0,60,14
1649867625235,COGS 101C,A01,083625,Delgado; Tania,25,0,30,5
1649867631259,COGS 107A,A01,083627,Boyle; Mary E. T.,38,0,60,22
1649867637297,COGS 118A,A01,083075,Staff,34,0,60,26
1649867643327,CSE 3,A50,083646,Miranda; Gregory Joseph,31,0,38,7
1649867643327,CSE 3,A51,083647,Miranda; Gregory Joseph,37,0,37,0
1649867649358,CSE 8A,A50,083650,Miranda; Gregory Joseph,27,0,40,13
1649867655384,CSE 11,A01,083080,Cao; Yingjun,6,0,40,34
1649867661412,CSE 12,A01,083652,Staff,82,0,100,18
1649867667526,CSE 15L,A01,083654,Staff,37,0,50,13
1649867667526,CSE 15L,A02,083655,Staff,49,0,50,1
1649867673555,CSE 20,A01,083657,Staff,73,0,80,7
1649867679577,CSE 30,A01,083084,Eldon; John,11,0,40,29
1649867685599,CSE 100,A01,083659,Cao; Yingjun,8,0,50,42
1649867691626,CSE 134B,A01,083661,Powell; Thomas Allan,0,13,65,65
1649867697647,CSE 140,A01,083663,Staff,46,0,75,29
1649867703670,CSE 140L,A01,083088,Eldon; John,42,0,75,33
1649867709695,CSE 175,A01,083665,Kumar; Rakesh,15,0,25,10
1649867715717,CSE 190,A00,092507,Staff,15,0,15,0
1649867721740,ECE 45,A01,083139,Staff,34,0,40,6
1649867727766,ECE 65,A50,083695,Staff,22,0,30,8
1649867733789,ECE 109,A01,091882,Touri; Behrouz,66,0,70,4
1649867739817,ECE 180,A00,083140,Abi Samra; Nicholas Camill,29,0,30,1
1649867739817,ECE 180,B00,083141,Abi Samra; Nicholas Camill,16,0,30,14
1649867745845,MATH 10A,A01,083735,Patchell; Gregory David,25,0,30,5
1649867745845,MATH 10A,A02,083736,Patchell; Gregory David,29,0,30,1
1649867745845,MATH 10A,A03,083737,Patchell; Gregory David,30,0,30,0
1649867751874,MATH 10B,A01,083207,Staff,21,0,30,9
1649867751874,MATH 10B,A02,083208,Staff,28,0,30,2
1649867751874,MATH 10B,B01,083739,Staff,26,0,30,4
1649867751874,MATH 10B,B02,083740,Staff,30,0,30,0
1649867757898,MATH 18,A01,083743,Staff,25,0,30,5
1649867757898,MATH 18,A02,083744,Staff,30,0,30,0
1649867757898,MATH 18,A03,083745,Staff,30,0,30,0
1649867757898,MATH 18,A04,083746,Staff,30,0,30,0
1649867757898,MATH 18,B01,083748,Staff,22,0,30,8
1649867757898,MATH 18,B02,083749,Staff,29,0,30,1
1649867757898,MATH 18,B03,083750,Staff,30,0,30,0
1649867757898,MATH 18,B04,083751,Staff,29,0,30,1
1649867763932,MATH 20A,A01,083754,Staff,39,0,40,1
1649867769961,MATH 20B,A01,083756,Staff,29,0,30,1
1649867769961,MATH 20B,A02,083757,Staff,30,0,30,0
1649867775982,MATH 20C,A01,083760,Staff,27,0,30,3
1649867775982,MATH 20C,A02,083761,Staff,30,0,30,0
1649867775982,MATH 20C,B01,083762,Staff,30,0,30,0
1649867775982,MATH 20C,B02,083763,Staff,30,0,30,0
1649867782003,MATH 20D,A01,083765,Staff,24,0,30,6
1649867782003,MATH 20D,A02,083766,Staff,30,0,30,0
1649867782003,MATH 20D,A03,083767,Staff,30,0,30,0
1649867788030,MATH 20E,A01,083771,Staff,21,0,30,9
1649867788030,MATH 20E,A02,083772,Staff,29,0,30,1
1649867788030,MATH 20E,B01,083773,Staff,25,0,30,5
1649867788030,MATH 20E,B02,083774,Staff,30,0,30,0
1649867794057,MATH 103A,A01,083777,Staff,2,0,30,28
1649867794057,MATH 103A,A02,083778,Staff,21,0,30,9
1649867794057,MATH 103A,B01,083779,Staff,14,0,30,16
1649867794057,MATH 103A,B02,083780,Staff,26,0,30,4
1649867800088,MATH 105,A01,085443,Staff,13,0,30,17
1649867806118,MATH 109,A01,083213,Anzaldo; Leesa B,28,0,30,2
1649867806118,MATH 109,A02,083214,Anzaldo; Leesa B,24,0,30,6
1649867806118,MATH 109,B01,083215,Anzaldo; Leesa B,28,0,30,2
1649867806118,MATH 109,B02,083216,Anzaldo; Leesa B,26,0,30,4
1649867812142,MATH 142A,A01,083219,Chow; Bennett,10,0,30,20
1649867812142,MATH 142A,A02,083220,Chow; Bennett,26,0,30,4
1649867812142,MATH 142A,B01,083221,Chow; Bennett,16,0,30,14
1649867812142,MATH 142A,B02,083222,Chow; Bennett,27,0,30,3
1649867818166,MATH 193A,A01,083224,Staff,0,1,30,30
1649867818166,MATH 193A,A02,083225,Staff,8,0,30,22
1649867818166,MATH 193A,A03,083781,Staff,28,0,30,2
1649867818166,MATH 193A,A04,083782,Staff,27,0,30,3
1649867824198,MATH 197,001,091859,McAuley; Julian John,9999,0,9999,0
1649867830251,COGS 9,A01,083615,Staff,43,0,60,17
1649867836273,COGS 11,A01,083617,Boyle; Mary E. T.,36,0,40,4
1649867842314,COGS 13,A01,083071,Staff,19,0,40,21
1649867848343,COGS 14A,A01,092681,Staff,97,0,100,3
1649867854370,COGS 14B,A01,083073,Cheng; Tzu-Han,39,0,50,11
1649867860394,COGS 17,A01,092677,Staff,74,0,75,1
1649867866437,COGS 100,A01,083619,Staff,31,0,60,29
1649867872461,COGS 101A,A01,083621,Davis; Joshua Daniel,32,0,60,28
1649867878489,COGS 101B,A01,091572,Staff,46,0,60,14
1649867884514,COGS 101C,A01,083625,Delgado; Tania,25,0,30,5
1649867890537,COGS 107A,A01,083627,Boyle; Mary E. T.,38,0,60,22
1649867896561,COGS 118A,A01,083075,Staff,34,0,60,26
1649867902587,CSE 3,A50,083646,Miranda; Gregory Joseph,31,0,38,7
1649867902587,CSE 3,A51,083647,Miranda; Gregory Joseph,37,0,37,0
1649867908615,CSE 8A,A50,083650,Miranda; Gregory Joseph,27,0,40,13
1649867914641,CSE 11,A01,083080,Cao; Yingjun,6,0,40,34
1649867920672,CSE 12,A01,083652,Staff,82,0,100,18
1649867926699,CSE 15L,A01,083654,Staff,37,0,50,13
1649867926699,CSE 15L,A02,083655,Staff,49,0,50,1
1649867932728,CSE 20,A01,083657,Staff,73,0,80,7
1649867938751,CSE 30,A01,083084,Eldon; John,11,0,40,29
1649867944779,CSE 100,A01,083659,Cao; Yingjun,8,0,50,42
1649867950801,CSE 134B,A01,083661,Powell; Thomas Allan,0,13,65,65
1649867956823,CSE 140,A01,083663,Staff,46,0,75,29
1649867962849,CSE 140L,A01,083088,Eldon; John,42,0,75,33
1649867968871,CSE 175,A01,083665,Kumar; Rakesh,15,0,25,10
1649867974914,CSE 190,A00,092507,Staff,15,0,15,0
1649867980938,ECE 45,A01,083139,Staff,34,0,40,6
1649867986962,ECE 65,A50,083695,Staff,22,0,30,8
1649867992991,ECE 109,A01,091882,Touri; Behrouz,66,0,70,4
1649867999033,ECE 180,A00,083140,Abi Samra; Nicholas Camill,29,0,30,1
1649867999033,ECE 180,B00,083141,Abi Samra; Nicholas Camill,16,0,30,14
1649868005060,MATH 10A,A01,083735,Patchell; Gregory David,25,0,30,5
1649868005060,MATH 10A,A02,083736,Patchell; Gregory David,29,0,30,1
1649868005060,MATH 10A,A03,083737,Patchell; Gregory David,30,0,30,0
1649868011082,MATH 10B,A01,083207,Staff,21,0,30,9
1649868011082,MATH 10B,A02,083208,Staff,28,0,30,2
1649868011082,MATH 10B,B01,083739,Staff,26,0,30,4
1649868011082,MATH 10B,B02,083740,Staff,30,0,30,0
1649868017106,MATH 18,A01,083743,Staff,25,0,30,5
1649868017106,MATH 18,A02,083744,Staff,30,0,30,0
1649868017106,MATH 18,A03,083745,Staff,30,0,30,0
1649868017106,MATH 18,A04,083746,Staff,30,0,30,0
1649868017106,MATH 18,B01,083748,Staff,22,0,30,8
1649868017106,MATH 18,B02,083749,Staff,29,0,30,1
1649868017106,MATH 18,B03,083750,Staff,30,0,30,0
1649868017106,MATH 18,B04,083751,Staff,29,0,30,1
1649868023137,MATH 20A,A01,083754,Staff,39,0,40,1
1649868029169,MATH 20B,A01,083756,Staff,29,0,30,1
1649868029169,MATH 20B,A02,083757,Staff,30,0,30,0
1649868035194,MATH 20C,A01,083760,Staff,27,0,30,3
1649868035194,MATH 20C,A02,083761,Staff,30,0,30,0
1649868035194,MATH 20C,B01,083762,Staff,30,0,30,0
1649868035194,MATH 20C,B02,083763,Staff,30,0,30,0
1649868041226,MATH 20D,A01,083765,Staff,24,0,30,6
1649868041226,MATH 20D,A02,083766,Staff,30,0,30,0
1649868041226,MATH 20D,A03,083767,Staff,30,0,30,0
1649868047249,MATH 20E,A01,083771,Staff,21,0,30,9
1649868047249,MATH 20E,A02,083772,Staff,29,0,30,1
1649868047249,MATH 20E,B01,083773,Staff,25,0,30,5
1649868047249,MATH 20E,B02,083774,Staff,30,0,30,0
1649868053276,MATH 103A,A01,083777,Staff,2,0,30,28
1649868053276,MATH 103A,A02,083778,Staff,21,0,30,9
1649868053276,MATH 103A,B01,083779,Staff,14,0,30,16
1649868053276,MATH 103A,B02,083780,Staff,26,0,30,4
1649868059301,MATH 105,A01,085443,Staff,12,0,30,18
1649868065341,MATH 109,A01,083213,Anzaldo; Leesa B,28,0,30,2
1649868065341,MATH 109,A02,083214,Anzaldo; Leesa B,24,0,30,6
1649868065341,MATH 109,B01,083215,Anzaldo; Leesa B,28,0,30,2
1649868065341,MATH 109,B02,083216,Anzaldo; Leesa B,26,0,30,4
1649868071385,MATH 142A,A01,083219,Chow; Bennett,10,0,30,20
1649868071385,MATH 142A,A02,083220,Chow; Bennett,26,0,30,4
1649868071385,MATH 142A,B01,083221,Chow; Bennett,16,0,30,14
1649868071385,MATH 142A,B02,083222,Chow; Bennett,27,0,30,3
1649868077427,MATH 193A,A01,083224,Staff,0,1,30,30
1649868077427,MATH 193A,A02,083225,Staff,7,0,30,23
1649868077427,MATH 193A,A03,083781,Staff,28,0,30,2
1649868077427,MATH 193A,A04,083782,Staff,27,0,30,3
1649868083454,MATH 197,001,091859,McAuley; Julian John,9999,0,9999,0
1649868089507,COGS 9,A01,083615,Staff,43,0,60,17
1649868095533,COGS 11,A01,083617,Boyle; Mary E. T.,36,0,40,4
1649868101557,COGS 13,A01,083071,Staff,19,0,40,21
1649868107581,COGS 14A,A01,092681,Staff,97,0,100,3
1649868113613,COGS 14B,A01,083073,Cheng; Tzu-Han,39,0,50,11
1649868119636,COGS 17,A01,092677,Staff,74,0,75,1
1649868125660,COGS 100,A01,083619,Staff,30,0,60,30
1649868131684,COGS 101A,A01,083621,Davis; Joshua Daniel,32,0,60,28
1649868137707,COGS 101B,A01,091572,Staff,46,0,60,14
1649868143745,COGS 101C,A01,083625,Delgado; Tania,25,0,30,5
1649868149768,COGS 107A,A01,083627,Boyle; Mary E. T.,37,0,60,23
1649868155801,COGS 118A,A01,083075,Staff,34,0,60,26
1649868161827,CSE 3,A50,083646,Miranda; Gregory Joseph,31,0,38,7
1649868161827,CSE 3,A51,083647,Miranda; Gregory Joseph,37,0,37,0
1649868167855,CSE 8A,A50,083650,Miranda; Gregory Joseph,27,0,40,13
1649868173882,CSE 11,A01,083080,Cao; Yingjun,6,0,40,34
1649868179907,CSE 12,A01,083652,Staff,81,0,100,19
1649868185932,CSE 15L,A01,083654,Staff,36,0,50,14
1649868185932,CSE 15L,A02,083655,Staff,49,0,50,1
1649868191961,CSE 20,A01,083657,Staff,73,0,80,7
1649868197987,CSE 30,A01,083084,Eldon; John,11,0,40,29
1649868204023,CSE 100,A01,083659,Cao; Yingjun,8,0,50,42
1649868210054,CSE 134B,A01,083661,Powell; Thomas Allan,0,13,65,65
1649868216082,CSE 140,A01,083663,Staff,46,0,75,29
1649868222107,CSE 140L,A01,083088,Eldon; John,42,0,75,33
1649868228131,CSE 175,A01,083665,Kumar; Rakesh,15,0,25,10
1649868234154,CSE 190,A00,092507,Staff,15,0,15,0
1649868240189,ECE 45,A01,083139,Staff,34,0,40,6
1649868246221,ECE 65,A50,083695,Staff,22,0,30,8
1649868252246,ECE 109,A01,091882,Touri; Behrouz,66,0,70,4
1649868258275,ECE 180,A00,083140,Abi Samra; Nicholas Camill,29,0,30,1
1649868258275,ECE 180,B00,083141,Abi Samra; Nicholas Camill,16,0,30,14
1649868264398,MATH 10A,A01,083735,Patchell; Gregory David,25,0,30,5
1649868264398,MATH 10A,A02,083736,Patchell; Gregory David,29,0,30,1
1649868264398,MATH 10A,A03,083737,Patchell; Gregory David,30,0,30,0
1649868270427,MATH 10B,A01,083207,Staff,21,0,30,9
1649868270427,MATH 10B,A02,083208,Staff,28,0,30,2
1649868270427,MATH 10B,B01,083739,Staff,26,0,30,4
1649868270427,MATH 10B,B02,083740,Staff,30,0,30,0
1649868276459,MATH 18,A01,083743,Staff,25,0,30,5
1649868276459,MATH 18,A02,083744,Staff,30,0,30,0
1649868276459,MATH 18,A03,083745,Staff,30,0,30,0
1649868276459,MATH 18,A04,083746,Staff,30,0,30,0
1649868276459,MATH 18,B01,083748,Staff,22,0,30,8
1649868276459,MATH 18,B02,083749,Staff,29,0,30,1
1649868276459,MATH 18,B03,083750,Staff,30,0,30,0
1649868276459,MATH 18,B04,083751,Staff,29,0,30,1
1649868282483,MATH 20A,A01,083754,Staff,39,0,40,1
1649868288509,MATH 20B,A01,083756,Staff,29,0,30,1
1649868288509,MATH 20B,A02,083757,Staff,30,0,30,0
1649868294540,MATH 20C,A01,083760,Staff,27,0,30,3
1649868294540,MATH 20C,A02,083761,Staff,30,0,30,0
1649868294540,MATH 20C,B01,083762,Staff,30,0,30,0
1649868294540,MATH 20C,B02,083763,Staff,30,0,30,0
1649868300572,MATH 20D,A01,083765,Staff,24,0,30,6
1649868300572,MATH 20D,A02,083766,Staff,30,0,30,0
1649868300572,MATH 20D,A03,083767,Staff,30,0,30,0
1649868306594,MATH 20E,A01,083771,Staff,21,0,30,9
1649868306594,MATH 20E,A02,083772,Staff,29,0,30,1
1649868306594,MATH 20E,B01,083773,Staff,25,0,30,5
1649868306594,MATH 20E,B02,083774,Staff,30,0,30,0
1649868321805,MATH 103A,A01,083777,Staff,2,0,30,28
1649868321805,MATH 103A,A02,083778,Staff,21,0,30,9
1649868321805,MATH 103A,B01,083779,Staff,14,0,30,16
1649868321805,MATH 103A,B02,083780,Staff,26,0,30,4
1649868327827,MATH 105,A01,085443,Staff,12,0,30,18
1649868333854,MATH 109,A01,083213,Anzaldo; Leesa B,28,0,30,2
1649868333854,MATH 109,A02,083214,Anzaldo; Leesa B,24,0,30,6
1649868333854,MATH 109,B01,083215,Anzaldo; Leesa B,28,0,30,2
1649868333854,MATH 109,B02,083216,Anzaldo; Leesa B,26,0,30,4
1649868339880,MATH 142A,A01,083219,Chow; Bennett,10,0,30,20
1649868339880,MATH 142A,A02,083220,Chow; Bennett,26,0,30,4
1649868339880,MATH 142A,B01,083221,Chow; Bennett,16,0,30,14
1649868339880,MATH 142A,B02,083222,Chow; Bennett,27,0,30,3
1649868345902,MATH 193A,A01,083224,Staff,0,1,30,30
1649868345902,MATH 193A,A02,083225,Staff,7,0,30,23
1649868345902,MATH 193A,A03,083781,Staff,28,0,30,2
1649868345902,MATH 193A,A04,083782,Staff,27,0,30,3
1649868351931,MATH 197,001,091859,McAuley; Julian John,9999,0,9999,0
1649868357981,COGS 9,A01,083615,Staff,43,0,60,17
1649868364007,COGS 11,A01,083617,Boyle; Mary E. T.,36,0,40,4
1649868370034,COGS 13,A01,083071,Staff,19,0,40,21
1649868376060,COGS 14A,A01,092681,Staff,97,0,100,3
1649868382084,COGS 14B,A01,083073,Cheng; Tzu-Han,39,0,50,11
1649868388112,COGS 17,A01,092677,Staff,74,0,75,1
1649868394138,COGS 100,A01,083619,Staff,30,0,60,30
1649868400166,COGS 101A,A01,083621,Davis; Joshua Daniel,31,0,60,29
1649868406187,COGS 101B,A01,091572,Staff,46,0,60,14
1649868412215,COGS 101C,A01,083625,Delgado; Tania,25,0,30,5
1649868418241,COGS 107A,A01,083627,Boyle; Mary E. T.,37,0,60,23
1649868424263,COGS 118A,A01,083075,Staff,33,0,60,27
1649868430284,CSE 3,A50,083646,Miranda; Gregory Joseph,31,0,38,7
1649868430284,CSE 3,A51,083647,Miranda; Gregory Joseph,37,0,37,0
1649868436318,CSE 8A,A50,083650,Miranda; Gregory Joseph,27,0,40,13
1649868442342,CSE 11,A01,083080,Cao; Yingjun,6,0,40,34
1649868448386,CSE 12,A01,083652,Staff,81,0,100,19
1649868454409,CSE 15L,A01,083654,Staff,36,0,50,14
1649868454409,CSE 15L,A02,083655,Staff,49,0,50,1
1649868460442,CSE 20,A01,083657,Staff,73,0,80,7
1649868466472,CSE 30,A01,083084,Eldon; John,11,0,40,29
1649868472495,CSE 100,A01,083659,Cao; Yingjun,8,0,50,42
1649868478517,CSE 134B,A01,083661,Powell; Thomas Allan,0,14,65,65
1649868484545,CSE 140,A01,083663,Staff,46,0,75,29
1649868490573,CSE 140L,A01,083088,Eldon; John,42,0,75,33
1649868496624,CSE 175,A01,083665,Kumar; Rakesh,15,0,25,10
1649868502657,CSE 190,A00,092507,Staff,15,0,15,0
1649868508694,ECE 45,A01,083139,Staff,34,0,40,6
1649868514721,ECE 65,A50,083695,Staff,22,0,30,8
1649868520743,ECE 109,A01,091882,Touri; Behrouz,66,0,70,4
1649868526773,ECE 180,A00,083140,Abi Samra; Nicholas Camill,29,0,30,1
1649868526773,ECE 180,B00,083141,Abi Samra; Nicholas Camill,16,0,30,14
1649868532803,MATH 10A,A01,083735,Patchell; Gregory David,25,0,30,5
1649868532803,MATH 10A,A02,083736,Patchell; Gregory David,29,0,30,1
1649868532803,MATH 10A,A03,083737,Patchell; Gregory David,30,0,30,0
1649868538829,MATH 10B,A01,083207,Staff,21,0,30,9
1649868538829,MATH 10B,A02,083208,Staff,28,0,30,2
1649868538829,MATH 10B,B01,083739,Staff,26,0,30,4
1649868538829,MATH 10B,B02,083740,Staff,30,0,30,0
1649868544855,MATH 18,A01,083743,Staff,25,0,30,5
1649868544855,MATH 18,A02,083744,Staff,30,0,30,0
1649868544855,MATH 18,A03,083745,Staff,30,0,30,0
1649868544855,MATH 18,A04,083746,Staff,30,0,30,0
1649868544855,MATH 18,B01,083748,Staff,22,0,30,8
1649868544855,MATH 18,B02,083749,Staff,29,0,30,1
1649868544855,MATH 18,B03,083750,Staff,30,0,30,0
1649868544855,MATH 18,B04,083751,Staff,29,0,30,1
1649868550879,MATH 20A,A01,083754,Staff,39,0,40,1
1649868556904,MATH 20B,A01,083756,Staff,29,0,30,1
1649868556904,MATH 20B,A02,083757,Staff,30,0,30,0
1649868562935,MATH 20C,A01,083760,Staff,27,0,30,3
1649868562935,MATH 20C,A02,083761,Staff,30,0,30,0
1649868562935,MATH 20C,B01,083762,Staff,30,0,30,0
1649868562935,MATH 20C,B02,083763,Staff,30,0,30,0
1649868568972,MATH 20D,A01,083765,Staff,24,0,30,6
1649868568972,MATH 20D,A02,083766,Staff,30,0,30,0
1649868568972,MATH 20D,A03,083767,Staff,30,0,30,0
1649868574995,MATH 20E,A01,083771,Staff,21,0,30,9
1649868574995,MATH 20E,A02,083772,Staff,29,0,30,1
1649868574995,MATH 20E,B01,083773,Staff,25,0,30,5
1649868574995,MATH 20E,B02,083774,Staff,30,0,30,0
1649868581022,MATH 103A,A01,083777,Staff,2,0,30,28
1649868581022,MATH 103A,A02,083778,Staff,21,0,30,9
1649868581022,MATH 103A,B01,083779,Staff,14,0,30,16
1649868581022,MATH 103A,B02,083780,Staff,26,0,30,4
1649868587071,MATH 105,A01,085443,Staff,12,0,30,18
1649868593093,MATH 109,A01,083213,Anzaldo; Leesa B,28,0,30,2
1649868593093,MATH 109,A02,083214,Anzaldo; Leesa B,24,0,30,6
1649868593093,MATH 109,B01,083215,Anzaldo; Leesa B,28,0,30,2
1649868593093,MATH 109,B02,083216,Anzaldo; Leesa B,26,0,30,4
1649868599124,MATH 142A,A01,083219,Chow; Bennett,10,0,30,20
1649868599124,MATH 142A,A02,083220,Chow; Bennett,26,0,30,4
1649868599124,MATH 142A,B01,083221,Chow; Bennett,16,0,30,14
1649868599124,MATH 142A,B02,083222,Chow; Bennett,27,0,30,3
1649868605160,MATH 193A,A01,083224,Staff,0,1,30,30
1649868605160,MATH 193A,A02,083225,Staff,7,0,30,23
1649868605160,MATH 193A,A03,083781,Staff,28,0,30,2
1649868605160,MATH 193A,A04,083782,Staff,27,0,30,3
1649868611191,MATH 197,001,091859,McAuley; Julian John,9999,0,9999,0
1649868617243,COGS 9,A01,083615,Staff,43,0,60,17
1649868623271,COGS 11,A01,083617,Boyle; Mary E. T.,36,0,40,4
1649868629294,COGS 13,A01,083071,Staff,19,0,40,21
1649868635320,COGS 14A,A01,092681,Staff,97,0,100,3
1649868641349,COGS 14B,A01,083073,Cheng; Tzu-Han,39,0,50,11
1649868647378,COGS 17,A01,092677,Staff,74,0,75,1
1649868653404,COGS 100,A01,083619,Staff,30,0,60,30
1649868659429,COGS 101A,A01,083621,Davis; Joshua Daniel,31,0,60,29
1649868665455,COGS 101B,A01,091572,Staff,46,0,60,14
1649868671489,COGS 101C,A01,083625,Delgado; Tania,25,0,30,5
1649868677517,COGS 107A,A01,083627,Boyle; Mary E. T.,37,0,60,23
1649868683555,COGS 118A,A01,083075,Staff,33,0,60,27
1649868689586,CSE 3,A50,083646,Miranda; Gregory Joseph,31,0,38,7
1649868689586,CSE 3,A51,083647,Miranda; Gregory Joseph,37,0,37,0
1649868695614,CSE 8A,A50,083650,Miranda; Gregory Joseph,27,0,40,13
1649868701637,CSE 11,A01,083080,Cao; Yingjun,6,0,40,34
1649868707661,CSE 12,A01,083652,Staff,81,0,100,19
1649868713685,CSE 15L,A01,083654,Staff,36,0,50,14
1649868713685,CSE 15L,A02,083655,Staff,49,0,50,1
1649868719708,CSE 20,A01,083657,Staff,73,0,80,7
1649868725739,CSE 30,A01,083084,Eldon; John,11,0,40,29
1649868731769,CSE 100,A01,083659,Cao; Yingjun,8,0,50,42
1649868737796,CSE 134B,A01,083661,Powell; Thomas Allan,0,14,65,65
1649868743820,CSE 140,A01,083663,Staff,46,0,75,29
1649868749845,CSE 140L,A01,083088,Eldon; John,41,0,75,34
1649868755874,CSE 175,A01,083665,Kumar; Rakesh,15,0,25,10
1649868761903,CSE 190,A00,092507,Staff,15,0,15,0
1649868767933,ECE 45,A01,083139,Staff,34,0,40,6
1649868773975,ECE 65,A50,083695,Staff,22,0,30,8
1649868780005,ECE 109,A01,091882,Touri; Behrouz,66,0,70,4
1649868786031,ECE 180,A00,083140,Abi Samra; Nicholas Camill,29,0,30,1
1649868786031,ECE 180,B00,083141,Abi Samra; Nicholas Camill,16,0,30,14
1649868792065,MATH 10A,A01,083735,Patchell; Gregory David,25,0,30,5
1649868792065,MATH 10A,A02,083736,Patchell; Gregory David,29,0,30,1
1649868792065,MATH 10A,A03,083737,Patchell; Gregory David,30,0,30,0
1649868798090,MATH 10B,A01,083207,Staff,21,0,30,9
1649868798090,MATH 10B,A02,083208,Staff,28,0,30,2
1649868798090,MATH 10B,B01,083739,Staff,26,0,30,4
1649868798090,MATH 10B,B02,083740,Staff,30,0,30,0
1649868804125,MATH 18,A01,083743,Staff,25,0,30,5
1649868804125,MATH 18,A02,083744,Staff,30,0,30,0
1649868804125,MATH 18,A03,083745,Staff,30,0,30,0
1649868804125,MATH 18,A04,083746,Staff,30,0,30,0
1649868804125,MATH 18,B01,083748,Staff,22,0,30,8
1649868804125,MATH 18,B02,083749,Staff,29,0,30,1
1649868804125,MATH 18,B03,083750,Staff,30,0,30,0
1649868804125,MATH 18,B04,083751,Staff,29,0,30,1
1649868810157,MATH 20A,A01,083754,Staff,39,0,40,1
1649868816184,MATH 20B,A01,083756,Staff,29,0,30,1
1649868816184,MATH 20B,A02,083757,Staff,30,0,30,0
1649868822210,MATH 20C,A01,083760,Staff,27,0,30,3
1649868822210,MATH 20C,A02,083761,Staff,30,0,30,0
1649868822210,MATH 20C,B01,083762,Staff,30,0,30,0
1649868822210,MATH 20C,B02,083763,Staff,30,0,30,0
1649868828234,MATH 20D,A01,083765,Staff,24,0,30,6
1649868828234,MATH 20D,A02,083766,Staff,30,0,30,0
1649868828234,MATH 20D,A03,083767,Staff,30,0,30,0
1649868834258,MATH 20E,A01,083771,Staff,21,0,30,9
1649868834258,MATH 20E,A02,083772,Staff,29,0,30,1
1649868834258,MATH 20E,B01,083773,Staff,25,0,30,5
1649868834258,MATH 20E,B02,083774,Staff,30,0,30,0
1649868840283,MATH 103A,A01,083777,Staff,2,0,30,28
1649868840283,MATH 103A,A02,083778,Staff,21,0,30,9
1649868840283,MATH 103A,B01,083779,Staff,14,0,30,16
1649868840283,MATH 103A,B02,083780,Staff,26,0,30,4
1649868846305,MATH 105,A01,085443,Staff,12,0,30,18
1649868852336,MATH 109,A01,083213,Anzaldo; Leesa B,28,0,30,2
1649868852336,MATH 109,A02,083214,Anzaldo; Leesa B,24,0,30,6
1649868852336,MATH 109,B01,083215,Anzaldo; Leesa B,28,0,30,2
1649868852336,MATH 109,B02,083216,Anzaldo; Leesa B,26,0,30,4
1649868858362,MATH 142A,A01,083219,Chow; Bennett,10,0,30,20
1649868858362,MATH 142A,A02,083220,Chow; Bennett,26,0,30,4
1649868858362,MATH 142A,B01,083221,Chow; Bennett,16,0,30,14
1649868858362,MATH 142A,B02,083222,Chow; Bennett,27,0,30,3
1649868864385,MATH 193A,A01,083224,Staff,0,1,30,30
1649868864385,MATH 193A,A02,083225,Staff,7,0,30,23
1649868864385,MATH 193A,A03,083781,Staff,28,0,30,2
1649868864385,MATH 193A,A04,083782,Staff,27,0,30,3
1649868870522,MATH 197,001,091859,McAuley; Julian John,9999,0,9999,0
1649868876585,COGS 9,A01,083615,Staff,43,0,60,17
1649868882611,COGS 11,A01,083617,Boyle; Mary E. T.,36,0,40,4
1649868888634,COGS 13,A01,083071,Staff,19,0,40,21
1649868894667,COGS 14A,A01,092681,Staff,97,0,100,3
1649868900692,COGS 14B,A01,083073,Cheng; Tzu-Han,39,0,50,11
1649868906714,COGS 17,A01,092677,Staff,74,0,75,1
1649868912738,COGS 100,A01,083619,Staff,30,0,60,30
1649868918764,COGS 101A,A01,083621,Davis; Joshua Daniel,31,0,60,29
1649868924839,COGS 101B,A01,091572,Staff,45,0,60,15
1649868930872,COGS 101C,A01,083625,Delgado; Tania,25,0,30,5
1649868936896,COGS 107A,A01,083627,Boyle; Mary E. T.,35,0,60,25
1649868942918,COGS 118A,A01,083075,Staff,32,0,60,28
1649868948941,CSE 3,A50,083646,Miranda; Gregory Joseph,31,0,38,7
1649868948941,CSE 3,A51,083647,Miranda; Gregory Joseph,37,0,37,0
1649868954977,CSE 8A,A50,083650,Miranda; Gregory Joseph,27,0,40,13
1649868961008,CSE 11,A01,083080,Cao; Yingjun,6,0,40,34
1649868967032,CSE 12,A01,083652,Staff,81,0,100,19
1649868973059,CSE 15L,A01,083654,Staff,36,0,50,14
1649868973059,CSE 15L,A02,083655,Staff,49,0,50,1
1649868979082,CSE 20,A01,083657,Staff,73,0,80,7
1649868985110,CSE 30,A01,083084,Eldon; John,11,0,40,29
1649868991138,CSE 100,A01,083659,Cao; Yingjun,8,0,50,42
1649868997164,CSE 134B,A01,083661,Powell; Thomas Allan,0,15,65,65
1649869003186,CSE 140,A01,083663,Staff,46,0,75,29
1649869009210,CSE 140L,A01,083088,Eldon; John,41,0,75,34
1649869015232,CSE 175,A01,083665,Kumar; Rakesh,15,0,25,10
1649869021263,CSE 190,A00,092507,Staff,15,0,15,0
1649869027290,ECE 45,A01,083139,Staff,34,0,40,6
1649869033319,ECE 65,A50,083695,Staff,22,0,30,8
1649869039344,ECE 109,A01,091882,Touri; Behrouz,66,0,70,4
1649869045390,ECE 180,A00,083140,Abi Samra; Nicholas Camill,29,0,30,1
1649869045390,ECE 180,B00,083141,Abi Samra; Nicholas Camill,16,0,30,14
1649869051413,MATH 10A,A01,083735,Patchell; Gregory David,25,0,30,5
1649869051413,MATH 10A,A02,083736,Patchell; Gregory David,29,0,30,1
1649869051413,MATH 10A,A03,083737,Patchell; Gregory David,30,0,30,0
1649869057445,MATH 10B,A01,083207,Staff,21,0,30,9
1649869057445,MATH 10B,A02,083208,Staff,28,0,30,2
1649869057445,MATH 10B,B01,083739,Staff,26,0,30,4
1649869057445,MATH 10B,B02,083740,Staff,30,0,30,0
1649869063477,MATH 18,A01,083743,Staff,25,0,30,5
1649869063477,MATH 18,A02,083744,Staff,30,0,30,0
1649869063477,MATH 18,A03,083745,Staff,30,0,30,0
1649869063477,MATH 18,A04,083746,Staff,30,0,30,0
1649869063477,MATH 18,B01,083748,Staff,22,0,30,8
1649869063477,MATH 18,B02,083749,Staff,29,0,30,1
1649869063477,MATH 18,B03,083750,Staff,30,0,30,0
1649869063477,MATH 18,B04,083751,Staff,29,0,30,1
1649869069507,MATH 20A,A01,083754,Staff,39,0,40,1
1649869075535,MATH 20B,A01,083756,Staff,29,0,30,1
1649869075535,MATH 20B,A02,083757,Staff,30,0,30,0
1649869081565,MATH 20C,A01,083760,Staff,27,0,30,3
1649869081565,MATH 20C,A02,083761,Staff,30,0,30,0
1649869081565,MATH 20C,B01,083762,Staff,30,0,30,0
1649869081565,MATH 20C,B02,083763,Staff,30,0,30,0
1649869087589,MATH 20D,A01,083765,Staff,24,0,30,6
1649869087589,MATH 20D,A02,083766,Staff,30,0,30,0
1649869087589,MATH 20D,A03,083767,Staff,30,0,30,0
1649869093626,MATH 20E,A01,083771,Staff,20,0,30,10
1649869093626,MATH 20E,A02,083772,Staff,29,0,30,1
1649869093626,MATH 20E,B01,083773,Staff,25,0,30,5
1649869093626,MATH 20E,B02,083774,Staff,30,0,30,0
1649869099658,MATH 103A,A01,083777,Staff,2,0,30,28
1649869099658,MATH 103A,A02,083778,Staff,21,0,30,9
1649869099658,MATH 103A,B01,083779,Staff,14,0,30,16
1649869099658,MATH 103A,B02,083780,Staff,26,0,30,4
1649869105683,MATH 105,A01,085443,Staff,12,0,30,18
1649869111721,MATH 109,A01,083213,Anzaldo; Leesa B,28,0,30,2
1649869111721,MATH 109,A02,083214,Anzaldo; Leesa B,24,0,30,6
1649869111721,MATH 109,B01,083215,Anzaldo; Leesa B,28,0,30,2
1649869111721,MATH 109,B02,083216,Anzaldo; Leesa B,26,0,30,4
1649869117751,MATH 142A,A01,083219,Chow; Bennett,10,0,30,20
1649869117751,MATH 142A,A02,083220,Chow; Bennett,26,0,30,4
1649869117751,MATH 142A,B01,083221,Chow; Bennett,16,0,30,14
1649869117751,MATH 142A,B02,083222,Chow; Bennett,27,0,30,3
1649869123775,MATH 193A,A01,083224,Staff,0,1,30,30
1649869123775,MATH 193A,A02,083225,Staff,7,0,30,23
1649869123775,MATH 193A,A03,083781,Staff,28,0,30,2
1649869123775,MATH 193A,A04,083782,Staff,27,0,30,3
1649869129806,MATH 197,001,091859,McAuley; Julian John,9999,0,9999,0
1649869135868,COGS 9,A01,083615,Staff,43,0,60,17
1649869141892,COGS 11,A01,083617,Boyle; Mary E. T.,36,0,40,4
1649869147922,COGS 13,A01,083071,Staff,19,0,40,21
1649869153967,COGS 14A,A01,092681,Staff,97,0,100,3
1649869159993,COGS 14B,A01,083073,Cheng; Tzu-Han,39,0,50,11
1649869166020,COGS 17,A01,092677,Staff,74,0,75,1
1649869172061,COGS 100,A01,083619,Staff,30,0,60,30
1649869178095,COGS 101A,A01,083621,Davis; Joshua Daniel,31,0,60,29
1649869184120,COGS 101B,A01,091572,Staff,45,0,60,15
1649869190147,COGS 101C,A01,083625,Delgado; Tania,25,0,30,5
1649869196168,COGS 107A,A01,083627,Boyle; Mary E. T.,35,0,60,25
1649869202205,COGS 118A,A01,083075,Staff,32,0,60,28
1649869208237,CSE 3,A50,083646,Miranda; Gregory Joseph,31,0,38,7
1649869208237,CSE 3,A51,083647,Miranda; Gregory Joseph,37,0,37,0
1649869214267,CSE 8A,A50,083650,Miranda; Gregory Joseph,27,0,40,13
1649869220290,CSE 11,A01,083080,Cao; Yingjun,6,0,40,34
1649869226314,CSE 12,A01,083652,Staff,81,0,100,19
1649869232340,CSE 15L,A01,083654,Staff,36,0,50,14
1649869232340,CSE 15L,A02,083655,Staff,49,0,50,1
1649869238364,CSE 20,A01,083657,Staff,73,0,80,7
1649869244386,CSE 30,A01,083084,Eldon; John,11,0,40,29
1649869250412,CSE 100,A01,083659,Cao; Yingjun,8,0,50,42
1649869256439,CSE 134B,A01,083661,Powell; Thomas Allan,0,15,65,65
1649869262474,CSE 140,A01,083663,Staff,46,0,75,29
1649869268510,CSE 140L,A01,083088,Eldon; John,41,0,75,34
1649869274544,CSE 175,A01,083665,Kumar; Rakesh,15,0,25,10
1649869280568,CSE 190,A00,092507,Staff,15,0,15,0
1649869286596,ECE 45,A01,083139,Staff,33,0,40,7
1649869292621,ECE 65,A50,083695,Staff,22,0,30,8
1649869298647,ECE 109,A01,091882,Touri; Behrouz,66,0,70,4
1649869304673,ECE 180,A00,083140,Abi Samra; Nicholas Camill,29,0,30,1
1649869304673,ECE 180,B00,083141,Abi Samra; Nicholas Camill,16,0,30,14
1649869310708,MATH 10A,A01,083735,Patchell; Gregory David,25,0,30,5
1649869310708,MATH 10A,A02,083736,Patchell; Gregory David,29,0,30,1
1649869310708,MATH 10A,A03,083737,Patchell; Gregory David,30,0,30,0
1649869316730,MATH 10B,A01,083207,Staff,21,0,30,9
1649869316730,MATH 10B,A02,083208,Staff,28,0,30,2
1649869316730,MATH 10B,B01,083739,Staff,26,0,30,4
1649869316730,MATH 10B,B02,083740,Staff,30,0,30,0
1649869322758,MATH 18,A01,083743,Staff,25,0,30,5
1649869322758,MATH 18,A02,083744,Staff,30,0,30,0
1649869322758,MATH 18,A03,083745,Staff,30,0,30,0
1649869322758,MATH 18,A04,083746,Staff,30,0,30,0
1649869322758,MATH 18,B01,083748,Staff,21,0,30,9
1649869322758,MATH 18,B02,083749,Staff,29,0,30,1
1649869322758,MATH 18,B03,083750,Staff,30,0,30,0
1649869322758,MATH 18,B04,083751,Staff,29,0,30,1
1649869328783,MATH 20A,A01,083754,Staff,39,0,40,1
1649869334813,MATH 20B,A01,083756,Staff,29,0,30,1
1649869334813,MATH 20B,A02,083757,Staff,30,0,30,0
1649869340847,MATH 20C,A01,083760,Staff,27,0,30,3
1649869340847,MATH 20C,A02,083761,Staff,30,0,30,0
1649869340847,MATH 20C,B01,083762,Staff,30,0,30,0
1649869340847,MATH 20C,B02,083763,Staff,30,0,30,0
1649869346871,MATH 20D,A01,083765,Staff,24,0,30,6
1649869346871,MATH 20D,A02,083766,Staff,30,0,30,0
1649869346871,MATH 20D,A03,083767,Staff,30,0,30,0
1649869352901,MATH 20E,A01,083771,Staff,21,0,30,9
1649869352901,MATH 20E,A02,083772,Staff,29,0,30,1
1649869352901,MATH 20E,B01,083773,Staff,25,0,30,5
1649869352901,MATH 20E,B02,083774,Staff,30,0,30,0
1649869358939,MATH 103A,A01,083777,Staff,2,0,30,28
1649869358939,MATH 103A,A02,083778,Staff,21,0,30,9
1649869358939,MATH 103A,B01,083779,Staff,14,0,30,16
1649869358939,MATH 103A,B02,083780,Staff,26,0,30,4
1649869364965,MATH 105,A01,085443,Staff,11,0,30,19
1649869370995,MATH 109,A01,083213,Anzaldo; Leesa B,28,0,30,2
1649869370995,MATH 109,A02,083214,Anzaldo; Leesa B,24,0,30,6
1649869370995,MATH 109,B01,083215,Anzaldo; Leesa B,28,0,30,2
1649869370995,MATH 109,B02,083216,Anzaldo; Leesa B,26,0,30,4
1649869377038,MATH 142A,A01,083219,Chow; Bennett,10,0,30,20
1649869377038,MATH 142A,A02,083220,Chow; Bennett,26,0,30,4
1649869377038,MATH 142A,B01,083221,Chow; Bennett,16,0,30,14
1649869377038,MATH 142A,B02,083222,Chow; Bennett,27,0,30,3
1649869383061,MATH 193A,A01,083224,Staff,0,1,30,30
1649869383061,MATH 193A,A02,083225,Staff,6,0,30,24
1649869383061,MATH 193A,A03,083781,Staff,28,0,30,2
1649869383061,MATH 193A,A04,083782,Staff,27,0,30,3
1649869389083,MATH 197,001,091859,McAuley; Julian John,9999,0,9999,0
1649869395155,COGS 9,A01,083615,Staff,43,0,60,17
1649869401196,COGS 11,A01,083617,Boyle; Mary E. T.,36,0,40,4
1649869407228,COGS 13,A01,083071,Staff,17,0,40,23
1649869413254,COGS 14A,A01,092681,Staff,96,0,100,4
1649869419283,COGS 14B,A01,083073,Cheng; Tzu-Han,39,0,50,11
1649869425309,COGS 17,A01,092677,Staff,74,0,75,1
1649869431339,COGS 100,A01,083619,Staff,30,0,60,30
1649869437366,COGS 101A,A01,083621,Davis; Joshua Daniel,29,0,60,31
1649869443395,COGS 101B,A01,091572,Staff,42,0,60,18
1649869449424,COGS 101C,A01,083625,Delgado; Tania,25,0,30,5
1649869455452,COGS 107A,A01,083627,Boyle; Mary E. T.,34,0,60,26
1649869461587,COGS 118A,A01,083075,Staff,31,0,60,29
1649869467617,CSE 3,A50,083646,Miranda; Gregory Joseph,31,0,38,7
1649869467617,CSE 3,A51,083647,Miranda; Gregory Joseph,37,0,37,0
1649869473641,CSE 8A,A50,083650,Miranda; Gregory Joseph,27,0,40,13
1649869479671,CSE 11,A01,083080,Cao; Yingjun,6,0,40,34
1649869485697,CSE 12,A01,083652,Staff,81,0,100,19
1649869491724,CSE 15L,A01,083654,Staff,36,0,50,14
1649869491724,CSE 15L,A02,083655,Staff,49,0,50,1
1649869497753,CSE 20,A01,083657,Staff,73,0,80,7
1649869503777,CSE 30,A01,083084,Eldon; John,11,0,40,29
1649869509810,CSE 100,A01,083659,Cao; Yingjun,7,0,50,43
1649869515837,CSE 134B,A01,083661,Powell; Thomas Allan,0,15,65,65
1649869521873,CSE 140,A01,083663,Staff,46,0,75,29
1649869527899,CSE 140L,A01,083088,Eldon; John,41,0,75,34
1649869533946,CSE 175,A01,083665,Kumar; Rakesh,15,0,25,10
1649869539971,CSE 190,A00,092507,Staff,15,0,15,0
1649869545996,ECE 45,A01,083139,Staff,33,0,40,7
1649869552019,ECE 65,A50,083695,Staff,22,0,30,8
1649869558048,ECE 109,A01,091882,Touri; Behrouz,66,0,70,4
1649869564072,ECE 180,A00,083140,Abi Samra; Nicholas Camill,29,0,30,1
1649869564072,ECE 180,B00,083141,Abi Samra; Nicholas Camill,16,0,30,14
1649869570099,MATH 10A,A01,083735,Patchell; Gregory David,25,0,30,5
1649869570099,MATH 10A,A02,083736,Patchell; Gregory David,29,0,30,1
1649869570099,MATH 10A,A03,083737,Patchell; Gregory David,30,0,30,0
1649869576132,MATH 10B,A01,083207,Staff,21,0,30,9
1649869576132,MATH 10B,A02,083208,Staff,28,0,30,2
1649869576132,MATH 10B,B01,083739,Staff,26,0,30,4
1649869576132,MATH 10B,B02,083740,Staff,30,0,30,0
1649869582166,MATH 18,A01,083743,Staff,25,0,30,5
1649869582166,MATH 18,A02,083744,Staff,30,0,30,0
1649869582166,MATH 18,A03,083745,Staff,30,0,30,0
1649869582166,MATH 18,A04,083746,Staff,30,0,30,0
1649869582166,MATH 18,B01,083748,Staff,21,0,30,9
1649869582166,MATH 18,B02,083749,Staff,29,0,30,1
1649869582166,MATH 18,B03,083750,Staff,30,0,30,0
1649869582166,MATH 18,B04,083751,Staff,29,0,30,1
1649869588189,MATH 20A,A01,083754,Staff,39,0,40,1
1649869594210,MATH 20B,A01,083756,Staff,29,0,30,1
1649869594210,MATH 20B,A02,083757,Staff,30,0,30,0
1649869600233,MATH 20C,A01,083760,Staff,27,0,30,3
1649869600233,MATH 20C,A02,083761,Staff,30,0,30,0
1649869600233,MATH 20C,B01,083762,Staff,30,0,30,0
1649869600233,MATH 20C,B02,083763,Staff,30,0,30,0
1649869606259,MATH 20D,A01,083765,Staff,24,0,30,6
1649869606259,MATH 20D,A02,083766,Staff,30,0,30,0
1649869606259,MATH 20D,A03,083767,Staff,30,0,30,0
1649869612288,MATH 20E,A01,083771,Staff,21,0,30,9
1649869612288,MATH 20E,A02,083772,Staff,29,0,30,1
1649869612288,MATH 20E,B01,083773,Staff,25,0,30,5
1649869612288,MATH 20E,B02,083774,Staff,30,0,30,0
1649869618312,MATH 103A,A01,083777,Staff,2,0,30,28
1649869618312,MATH 103A,A02,083778,Staff,21,0,30,9
1649869618312,MATH 103A,B01,083779,Staff,14,0,30,16
1649869618312,MATH 103A,B02,083780,Staff,26,0,30,4
1649869624333,MATH 105,A01,085443,Staff,11,0,30,19
1649869630360,MATH 109,A01,083213,Anzaldo; Leesa B,28,0,30,2
1649869630360,MATH 109,A02,083214,Anzaldo; Leesa B,24,0,30,6
1649869630360,MATH 109,B01,083215,Anzaldo; Leesa B,28,0,30,2
1649869630360,MATH 109,B02,083216,Anzaldo; Leesa B,26,0,30,4
1649869636390,MATH 142A,A01,083219,Chow; Bennett,10,0,30,20
1649869636390,MATH 142A,A02,083220,Chow; Bennett,26,0,30,4
1649869636390,MATH 142A,B01,083221,Chow; Bennett,16,0,30,14
1649869636390,MATH 142A,B02,083222,Chow; Bennett,27,0,30,3
1649869642413,MATH 193A,A01,083224,Staff,0,1,30,30
1649869642413,MATH 193A,A02,083225,Staff,6,0,30,24
1649869642413,MATH 193A,A03,083781,Staff,28,0,30,2
1649869642413,MATH 193A,A04,083782,Staff,27,0,30,3
1649869648436,MATH 197,001,091859,McAuley; Julian John,9999,0,9999,0
1649869654511,COGS 9,A01,083615,Staff,43,0,60,17
1649869660535,COGS 11,A01,083617,Boyle; Mary E. T.,36,0,40,4
1649869666575,COGS 13,A01,083071,Staff,17,0,40,23
1649869672603,COGS 14A,A01,092681,Staff,96,0,100,4
1649869678630,COGS 14B,A01,083073,Cheng; Tzu-Han,39,0,50,11
1649869684653,COGS 17,A01,092677,Staff,74,0,75,1
1649869690688,COGS 100,A01,083619,Staff,30,0,60,30
1649869696714,COGS 101A,A01,083621,Davis; Joshua Daniel,28,0,60,32
1649869702736,COGS 101B,A01,091572,Staff,42,0,60,18
1649869708765,COGS 101C,A01,083625,Delgado; Tania,25,0,30,5
1649869714789,COGS 107A,A01,083627,Boyle; Mary E. T.,34,0,60,26
1649869720816,COGS 118A,A01,083075,Staff,31,0,60,29
1649869726845,CSE 3,A50,083646,Miranda; Gregory Joseph,31,0,38,7
1649869726845,CSE 3,A51,083647,Miranda; Gregory Joseph,37,0,37,0
1649869732873,CSE 8A,A50,083650,Miranda; Gregory Joseph,27,0,40,13
1649869738896,CSE 11,A01,083080,Cao; Yingjun,5,0,40,35
1649869744921,CSE 12,A01,083652,Staff,81,0,100,19
1649869750943,CSE 15L,A01,083654,Staff,36,0,50,14
1649869750943,CSE 15L,A02,083655,Staff,49,0,50,1
1649869756967,CSE 20,A01,083657,Staff,73,0,80,7
1649869763002,CSE 30,A01,083084,Eldon; John,11,0,40,29
1649869769032,CSE 100,A01,083659,Cao; Yingjun,7,0,50,43
1649869775070,CSE 134B,A01,083661,Powell; Thomas Allan,0,15,65,65
1649869781108,CSE 140,A01,083663,Staff,46,0,75,29
1649869787139,CSE 140L,A01,083088,Eldon; John,41,0,75,34
1649869793161,CSE 175,A01,083665,Kumar; Rakesh,14,0,25,11
1649869799191,CSE 190,A00,092507,Staff,15,0,15,0
1649869805225,ECE 45,A01,083139,Staff,33,0,40,7
1649869811264,ECE 65,A50,083695,Staff,22,0,30,8
1649869817296,ECE 109,A01,091882,Touri; Behrouz,66,0,70,4
1649869823321,ECE 180,A00,083140,Abi Samra; Nicholas Camill,29,0,30,1
1649869823321,ECE 180,B00,083141,Abi Samra; Nicholas Camill,16,0,30,14
1649869829347,MATH 10A,A01,083735,Patchell; Gregory David,25,0,30,5
1649869829347,MATH 10A,A02,083736,Patchell; Gregory David,29,0,30,1
1649869829347,MATH 10A,A03,083737,Patchell; Gregory David,30,0,30,0
1649869835376,MATH 10B,A01,083207,Staff,21,0,30,9
1649869835376,MATH 10B,A02,083208,Staff,28,0,30,2
1649869835376,MATH 10B,B01,083739,Staff,26,0,30,4
1649869835376,MATH 10B,B02,083740,Staff,30,0,30,0
1649869841399,MATH 18,A01,083743,Staff,25,0,30,5
1649869841399,MATH 18,A02,083744,Staff,30,0,30,0
1649869841399,MATH 18,A03,083745,Staff,30,0,30,0
1649869841399,MATH 18,A04,083746,Staff,30,0,30,0
1649869841399,MATH 18,B01,083748,Staff,21,0,30,9
1649869841399,MATH 18,B02,083749,Staff,29,0,30,1
1649869841399,MATH 18,B03,083750,Staff,30,0,30,0
1649869841399,MATH 18,B04,083751,Staff,29,0,30,1
1649869847423,MATH 20A,A01,083754,Staff,39,0,40,1
1649869853447,MATH 20B,A01,083756,Staff,29,0,30,1
1649869853447,MATH 20B,A02,083757,Staff,30,0,30,0
1649869859475,MATH 20C,A01,083760,Staff,27,0,30,3
1649869859475,MATH 20C,A02,083761,Staff,30,0,30,0
1649869859475,MATH 20C,B01,083762,Staff,30,0,30,0
1649869859475,MATH 20C,B02,083763,Staff,30,0,30,0
1649869865498,MATH 20D,A01,083765,Staff,24,0,30,6
1649869865498,MATH 20D,A02,083766,Staff,30,0,30,0
1649869865498,MATH 20D,A03,083767,Staff,30,0,30,0
1649869871528,MATH 20E,A01,083771,Staff,21,0,30,9
1649869871528,MATH 20E,A02,083772,Staff,29,0,30,1
1649869871528,MATH 20E,B01,083773,Staff,25,0,30,5
1649869871528,MATH 20E,B02,083774,Staff,30,0,30,0
1649869877557,MATH 103A,A01,083777,Staff,2,0,30,28
1649869877557,MATH 103A,A02,083778,Staff,21,0,30,9
1649869877557,MATH 103A,B01,083779,Staff,14,0,30,16
1649869877557,MATH 103A,B02,083780,Staff,26,0,30,4
1649869883583,MATH 105,A01,085443,Staff,11,0,30,19
1649869889608,MATH 109,A01,083213,Anzaldo; Leesa B,28,0,30,2
1649869889608,MATH 109,A02,083214,Anzaldo; Leesa B,24,0,30,6
1649869889608,MATH 109,B01,083215,Anzaldo; Leesa B,28,0,30,2
1649869889608,MATH 109,B02,083216,Anzaldo; Leesa B,26,0,30,4
1649869895650,MATH 142A,A01,083219,Chow; Bennett,10,0,30,20
1649869895650,MATH 142A,A02,083220,Chow; Bennett,26,0,30,4
1649869895650,MATH 142A,B01,083221,Chow; Bennett,16,0,30,14
1649869895650,MATH 142A,B02,083222,Chow; Bennett,27,0,30,3
1649869901686,MATH 193A,A01,083224,Staff,0,1,30,30
1649869901686,MATH 193A,A02,083225,Staff,6,0,30,24
1649869901686,MATH 193A,A03,083781,Staff,28,0,30,2
1649869901686,MATH 193A,A04,083782,Staff,27,0,30,3
1649869907712,MATH 197,001,091859,McAuley; Julian John,9999,0,9999,0
1649869913779,COGS 9,A01,083615,Staff,43,0,60,17
1649869919805,COGS 11,A01,083617,Boyle; Mary E. T.,36,0,40,4
1649869925842,COGS 13,A01,083071,Staff,17,0,40,23
1649869931868,COGS 14A,A01,092681,Staff,96,0,100,4
1649869937892,COGS 14B,A01,083073,Cheng; Tzu-Han,39,0,50,11
1649869943915,COGS 17,A01,092677,Staff,74,0,75,1
1649869949945,COGS 100,A01,083619,Staff,30,0,60,30
1649869955972,COGS 101A,A01,083621,Davis; Joshua Daniel,28,0,60,32
1649869961995,COGS 101B,A01,091572,Staff,42,0,60,18
1649869968025,COGS 101C,A01,083625,Delgado; Tania,25,0,30,5
1649869974053,COGS 107A,A01,083627,Boyle; Mary E. T.,34,0,60,26
1649869980075,COGS 118A,A01,083075,Staff,31,0,60,29
1649869986097,CSE 3,A50,083646,Miranda; Gregory Joseph,31,0,38,7
1649869986097,CSE 3,A51,083647,Miranda; Gregory Joseph,37,0,37,0
1649869992127,CSE 8A,A50,083650,Miranda; Gregory Joseph,26,0,40,14
1649869998149,CSE 11,A01,083080,Cao; Yingjun,4,0,40,36
1649870004173,CSE 12,A01,083652,Staff,81,0,100,19
1649870010198,CSE 15L,A01,083654,Staff,36,0,50,14
1649870010198,CSE 15L,A02,083655,Staff,49,0,50,1
1649870016220,CSE 20,A01,083657,Staff,73,0,80,7
1649870022247,CSE 30,A01,083084,Eldon; John,11,0,40,29
1649870028270,CSE 100,A01,083659,Cao; Yingjun,7,0,50,43
1649870034298,CSE 134B,A01,083661,Powell; Thomas Allan,0,16,65,65
1649870040322,CSE 140,A01,083663,Staff,46,0,75,29
1649870046361,CSE 140L,A01,083088,Eldon; John,41,0,75,34
1649870052385,CSE 175,A01,083665,Kumar; Rakesh,14,0,25,11
1649870058500,CSE 190,A00,092507,Staff,15,0,15,0
1649870064528,ECE 45,A01,083139,Staff,33,0,40,7
1649870070552,ECE 65,A50,083695,Staff,22,0,30,8
1649870076581,ECE 109,A01,091882,Touri; Behrouz,66,0,70,4
1649870082609,ECE 180,A00,083140,Abi Samra; Nicholas Camill,29,0,30,1
1649870082609,ECE 180,B00,083141,Abi Samra; Nicholas Camill,16,0,30,14
1649870088642,MATH 10A,A01,083735,Patchell; Gregory David,25,0,30,5
1649870088642,MATH 10A,A02,083736,Patchell; Gregory David,29,0,30,1
1649870088642,MATH 10A,A03,083737,Patchell; Gregory David,30,0,30,0
1649870094666,MATH 10B,A01,083207,Staff,21,0,30,9
1649870094666,MATH 10B,A02,083208,Staff,28,0,30,2
1649870094666,MATH 10B,B01,083739,Staff,26,0,30,4
1649870094666,MATH 10B,B02,083740,Staff,30,0,30,0
1649870100695,MATH 18,A01,083743,Staff,25,0,30,5
1649870100695,MATH 18,A02,083744,Staff,30,0,30,0
1649870100695,MATH 18,A03,083745,Staff,30,0,30,0
1649870100695,MATH 18,A04,083746,Staff,30,0,30,0
1649870100695,MATH 18,B01,083748,Staff,21,0,30,9
1649870100695,MATH 18,B02,083749,Staff,29,0,30,1
1649870100695,MATH 18,B03,083750,Staff,30,0,30,0
1649870100695,MATH 18,B04,083751,Staff,29,0,30,1
1649870106717,MATH 20A,A01,083754,Staff,39,0,40,1
1649870112753,MATH 20B,A01,083756,Staff,29,0,30,1
1649870112753,MATH 20B,A02,083757,Staff,30,0,30,0
1649870118786,MATH 20C,A01,083760,Staff,27,0,30,3
1649870118786,MATH 20C,A02,083761,Staff,30,0,30,0
1649870118786,MATH 20C,B01,083762,Staff,30,0,30,0
1649870118786,MATH 20C,B02,083763,Staff,30,0,30,0
1649870124827,MATH 20D,A01,083765,Staff,24,0,30,6
1649870124827,MATH 20D,A02,083766,Staff,30,0,30,0
1649870124827,MATH 20D,A03,083767,Staff,30,0,30,0
1649870130867,MATH 20E,A01,083771,Staff,21,0,30,9
1649870130867,MATH 20E,A02,083772,Staff,29,0,30,1
1649870130867,MATH 20E,B01,083773,Staff,25,0,30,5
1649870130867,MATH 20E,B02,083774,Staff,29,0,30,1
1649870136912,MATH 103A,A01,083777,Staff,1,0,30,29
1649870136912,MATH 103A,A02,083778,Staff,21,0,30,9
1649870136912,MATH 103A,B01,083779,Staff,14,0,30,16
1649870136912,MATH 103A,B02,083780,Staff,26,0,30,4
1649870142943,MATH 105,A01,085443,Staff,11,0,30,19
1649870148967,MATH 109,A01,083213,Anzaldo; Leesa B,28,0,30,2
1649870148967,MATH 109,A02,083214,Anzaldo; Leesa B,24,0,30,6
1649870148967,MATH 109,B01,083215,Anzaldo; Leesa B,28,0,30,2
1649870148967,MATH 109,B02,083216,Anzaldo; Leesa B,26,0,30,4
1649870154996,MATH 142A,A01,083219,Chow; Bennett,9,0,30,21
1649870154996,MATH 142A,A02,083220,Chow; Bennett,26,0,30,4
1649870154996,MATH 142A,B01,083221,Chow; Bennett,16,0,30,14
1649870154996,MATH 142A,B02,083222,Chow; Bennett,27,0,30,3
1649870161020,MATH 193A,A01,083224,Staff,0,1,30,30
1649870161020,MATH 193A,A02,083225,Staff,6,0,30,24
1649870161020,MATH 193A,A03,083781,Staff,28,0,30,2
1649870161020,MATH 193A,A04,083782,Staff,27,0,30,3
1649870167043,MATH 197,001,091859,McAuley; Julian John,9999,0,9999,0
1649870173112,COGS 9,A01,083615,Staff,43,0,60,17
1649870179137,COGS 11,A01,083617,Boyle; Mary E. T.,36,0,40,4
1649870185162,COGS 13,A01,083071,Staff,17,0,40,23
1649870191187,COGS 14A,A01,092681,Staff,96,0,100,4
1649870197219,COGS 14B,A01,083073,Cheng; Tzu-Han,39,0,50,11
1649870203246,COGS 17,A01,092677,Staff,74,0,75,1
1649870209269,COGS 100,A01,083619,Staff,30,0,60,30
1649870215296,COGS 101A,A01,083621,Davis; Joshua Daniel,28,0,60,32
1649870221321,COGS 101B,A01,091572,Staff,42,0,60,18
1649870227359,COGS 101C,A01,083625,Delgado; Tania,25,0,30,5
1649870233387,COGS 107A,A01,083627,Boyle; Mary E. T.,34,0,60,26
1649870239410,COGS 118A,A01,083075,Staff,31,0,60,29
1649870245445,CSE 3,A50,083646,Miranda; Gregory Joseph,31,0,38,7
1649870245445,CSE 3,A51,083647,Miranda; Gregory Joseph,37,0,37,0
1649870251482,CSE 8A,A50,083650,Miranda; Gregory Joseph,26,0,40,14
1649870257511,CSE 11,A01,083080,Cao; Yingjun,4,0,40,36
1649870263539,CSE 12,A01,083652,Staff,81,0,100,19
1649870269565,CSE 15L,A01,083654,Staff,36,0,50,14
1649870269565,CSE 15L,A02,083655,Staff,49,0,50,1
1649870275591,CSE 20,A01,083657,Staff,73,0,80,7
1649870281615,CSE 30,A01,083084,Eldon; John,11,0,40,29
1649870287640,CSE 100,A01,083659,Cao; Yingjun,6,0,50,44
1649870293670,CSE 134B,A01,083661,Powell; Thomas Allan,0,16,65,65
1649870299695,CSE 140,A01,083663,Staff,46,0,75,29
1649870305720,CSE 140L,A01,083088,Eldon; John,41,0,75,34
1649870311742,CSE 175,A01,083665,Kumar; Rakesh,14,0,25,11
1649870317771,CSE 190,A00,092507,Staff,15,0,15,0
1649870323802,ECE 45,A01,083139,Staff,33,0,40,7
1649870329829,ECE 65,A50,083695,Staff,22,0,30,8
1649870335855,ECE 109,A01,091882,Touri; Behrouz,66,0,70,4
1649870341886,ECE 180,A00,083140,Abi Samra; Nicholas Camill,29,0,30,1
1649870341886,ECE 180,B00,083141,Abi Samra; Nicholas Camill,16,0,30,14
1649870347913,MATH 10A,A01,083735,Patchell; Gregory David,25,0,30,5
1649870347913,MATH 10A,A02,083736,Patchell; Gregory David,29,0,30,1
1649870347913,MATH 10A,A03,083737,Patchell; Gregory David,30,0,30,0
1649870353941,MATH 10B,A01,083207,Staff,21,0,30,9
1649870353941,MATH 10B,A02,083208,Staff,28,0,30,2
1649870353941,MATH 10B,B01,083739,Staff,26,0,30,4
1649870353941,MATH 10B,B02,083740,Staff,30,0,30,0
1649870359970,MATH 18,A01,083743,Staff,25,0,30,5
1649870359970,MATH 18,A02,083744,Staff,30,0,30,0
1649870359970,MATH 18,A03,083745,Staff,30,0,30,0
1649870359970,MATH 18,A04,083746,Staff,30,0,30,0
1649870359970,MATH 18,B01,083748,Staff,21,0,30,9
1649870359970,MATH 18,B02,083749,Staff,29,0,30,1
1649870359970,MATH 18,B03,083750,Staff,30,0,30,0
1649870359970,MATH 18,B04,083751,Staff,29,0,30,1
1649870366004,MATH 20A,A01,083754,Staff,39,0,40,1
1649870372033,MATH 20B,A01,083756,Staff,29,0,30,1
1649870372033,MATH 20B,A02,083757,Staff,30,0,30,0
1649870378057,MATH 20C,A01,083760,Staff,27,0,30,3
1649870378057,MATH 20C,A02,083761,Staff,30,0,30,0
1649870378057,MATH 20C,B01,083762,Staff,30,0,30,0
1649870378057,MATH 20C,B02,083763,Staff,30,0,30,0
1649870384082,MATH 20D,A01,083765,Staff,24,0,30,6
1649870384082,MATH 20D,A02,083766,Staff,30,0,30,0
1649870384082,MATH 20D,A03,083767,Staff,30,0,30,0
1649870390106,MATH 20E,A01,083771,Staff,21,0,30,9
1649870390106,MATH 20E,A02,083772,Staff,29,0,30,1
1649870390106,MATH 20E,B01,083773,Staff,25,0,30,5
1649870390106,MATH 20E,B02,083774,Staff,29,0,30,1
1649870396129,MATH 103A,A01,083777,Staff,1,0,30,29
1649870396129,MATH 103A,A02,083778,Staff,21,0,30,9
1649870396129,MATH 103A,B01,083779,Staff,14,0,30,16
1649870396129,MATH 103A,B02,083780,Staff,26,0,30,4
1649870402172,MATH 105,A01,085443,Staff,11,0,30,19
1649870408196,MATH 109,A01,083213,Anzaldo; Leesa B,28,0,30,2
1649870408196,MATH 109,A02,083214,Anzaldo; Leesa B,24,0,30,6
1649870408196,MATH 109,B01,083215,Anzaldo; Leesa B,28,0,30,2
1649870408196,MATH 109,B02,083216,Anzaldo; Leesa B,27,0,30,3
1649870414235,MATH 142A,A01,083219,Chow; Bennett,9,0,30,21
1649870414235,MATH 142A,A02,083220,Chow; Bennett,26,0,30,4
1649870414235,MATH 142A,B01,083221,Chow; Bennett,16,0,30,14
1649870414235,MATH 142A,B02,083222,Chow; Bennett,27,0,30,3
1649870420260,MATH 193A,A01,083224,Staff,0,1,30,30
1649870420260,MATH 193A,A02,083225,Staff,6,0,30,24
1649870420260,MATH 193A,A03,083781,Staff,28,0,30,2
1649870420260,MATH 193A,A04,083782,Staff,27,0,30,3
1649870426290,MATH 197,001,091859,McAuley; Julian John,9999,0,9999,0
1649870432366,COGS 9,A01,083615,Staff,43,0,60,17
1649870438392,COGS 11,A01,083617,Boyle; Mary E. T.,36,0,40,4
1649870444434,COGS 13,A01,083071,Staff,17,0,40,23
1649870450461,COGS 14A,A01,092681,Staff,96,0,100,4
1649870456490,COGS 14B,A01,083073,Cheng; Tzu-Han,39,0,50,11
1649870462528,COGS 17,A01,092677,Staff,74,0,75,1
1649870468558,COGS 100,A01,083619,Staff,30,0,60,30
1649870474581,COGS 101A,A01,083621,Davis; Joshua Daniel,28,0,60,32
1649870480612,COGS 101B,A01,091572,Staff,42,0,60,18
1649870486652,COGS 101C,A01,083625,Delgado; Tania,25,0,30,5
1649870492677,COGS 107A,A01,083627,Boyle; Mary E. T.,34,0,60,26
1649870498704,COGS 118A,A01,083075,Staff,31,0,60,29
1649870504736,CSE 3,A50,083646,Miranda; Gregory Joseph,31,0,38,7
1649870504736,CSE 3,A51,083647,Miranda; Gregory Joseph,37,0,37,0
1649870510774,CSE 8A,A50,083650,Miranda; Gregory Joseph,26,0,40,14
1649870516806,CSE 11,A01,083080,Cao; Yingjun,3,0,40,37
1649870522840,CSE 12,A01,083652,Staff,81,0,100,19
1649870528868,CSE 15L,A01,083654,Staff,36,0,50,14
1649870528868,CSE 15L,A02,083655,Staff,49,0,50,1
1649870534893,CSE 20,A01,083657,Staff,73,0,80,7
1649870540916,CSE 30,A01,083084,Eldon; John,10,0,40,30
1649870546941,CSE 100,A01,083659,Cao; Yingjun,6,0,50,44
1649870552964,CSE 134B,A01,083661,Powell; Thomas Allan,0,16,65,65
1649870558994,CSE 140,A01,083663,Staff,46,0,75,29
1649870565030,CSE 140L,A01,083088,Eldon; John,41,0,75,34
1649870571061,CSE 175,A01,083665,Kumar; Rakesh,14,0,25,11
1649870577088,CSE 190,A00,092507,Staff,15,0,15,0
1649870583113,ECE 45,A01,083139,Staff,33,0,40,7
1649870589140,ECE 65,A50,083695,Staff,22,0,30,8
1649870595166,ECE 109,A01,091882,Touri; Behrouz,66,0,70,4
1649870601192,ECE 180,A00,083140,Abi Samra; Nicholas Camill,29,0,30,1
1649870601192,ECE 180,B00,083141,Abi Samra; Nicholas Camill,16,0,30,14
1649870607221,MATH 10A,A01,083735,Patchell; Gregory David,25,0,30,5
1649870607221,MATH 10A,A02,083736,Patchell; Gregory David,29,0,30,1
1649870607221,MATH 10A,A03,083737,Patchell; Gregory David,30,0,30,0
1649870613246,MATH 10B,A01,083207,Staff,21,0,30,9
1649870613246,MATH 10B,A02,083208,Staff,28,0,30,2
1649870613246,MATH 10B,B01,083739,Staff,26,0,30,4
1649870613246,MATH 10B,B02,083740,Staff,30,0,30,0
1649870619274,MATH 18,A01,083743,Staff,25,0,30,5
1649870619274,MATH 18,A02,083744,Staff,30,0,30,0
1649870619274,MATH 18,A03,083745,Staff,30,0,30,0
1649870619274,MATH 18,A04,083746,Staff,30,0,30,0
1649870619274,MATH 18,B01,083748,Staff,21,0,30,9
1649870619274,MATH 18,B02,083749,Staff,29,0,30,1
1649870619274,MATH 18,B03,083750,Staff,30,0,30,0
1649870619274,MATH 18,B04,083751,Staff,29,0,30,1
1649870625300,MATH 20A,A01,083754,Staff,39,0,40,1
1649870631329,MATH 20B,A01,083756,Staff,28,0,30,2
1649870631329,MATH 20B,A02,083757,Staff,30,0,30,0
1649870637368,MATH 20C,A01,083760,Staff,27,0,30,3
1649870637368,MATH 20C,A02,083761,Staff,30,0,30,0
1649870637368,MATH 20C,B01,083762,Staff,30,0,30,0
1649870637368,MATH 20C,B02,083763,Staff,30,0,30,0
1649870643391,MATH 20D,A01,083765,Staff,23,0,30,7
1649870643391,MATH 20D,A02,083766,Staff,30,0,30,0
1649870643391,MATH 20D,A03,083767,Staff,30,0,30,0
1649870649425,MATH 20E,A01,083771,Staff,21,0,30,9
1649870649425,MATH 20E,A02,083772,Staff,29,0,30,1
1649870649425,MATH 20E,B01,083773,Staff,25,0,30,5
1649870649425,MATH 20E,B02,083774,Staff,29,0,30,1
1649870655566,MATH 103A,A01,083777,Staff,1,0,30,29
1649870655566,MATH 103A,A02,083778,Staff,21,0,30,9
1649870655566,MATH 103A,B01,083779,Staff,14,0,30,16
1649870655566,MATH 103A,B02,083780,Staff,26,0,30,4
1649870661589,MATH 105,A01,085443,Staff,11,0,30,19
1649870667621,MATH 109,A01,083213,Anzaldo; Leesa B,28,0,30,2
1649870667621,MATH 109,A02,083214,Anzaldo; Leesa B,24,0,30,6
1649870667621,MATH 109,B01,083215,Anzaldo; Leesa B,28,0,30,2
1649870667621,MATH 109,B02,083216,Anzaldo; Leesa B,27,0,30,3
1649870673647,MATH 142A,A01,083219,Chow; Bennett,9,0,30,21
1649870673647,MATH 142A,A02,083220,Chow; Bennett,26,0,30,4
1649870673647,MATH 142A,B01,083221,Chow; Bennett,15,0,30,15
1649870673647,MATH 142A,B02,083222,Chow; Bennett,27,0,30,3
1649870679676,MATH 193A,A01,083224,Staff,0,1,30,30
1649870679676,MATH 193A,A02,083225,Staff,6,0,30,24
1649870679676,MATH 193A,A03,083781,Staff,28,0,30,2
1649870679676,MATH 193A,A04,083782,Staff,27,0,30,3
1649870685698,MATH 197,001,091859,McAuley; Julian John,9999,0,9999,0
1649870691757,COGS 9,A01,083615,Staff,43,0,60,17
1649870697780,COGS 11,A01,083617,Boyle; Mary E. T.,36,0,40,4
1649870703802,COGS 13,A01,083071,Staff,16,0,40,24
1649870709832,COGS 14A,A01,092681,Staff,96,0,100,4
1649870715860,COGS 14B,A01,083073,Cheng; Tzu-Han,38,0,50,12
1649870721884,COGS 17,A01,092677,Staff,74,0,75,1
1649870727912,COGS 100,A01,083619,Staff,30,0,60,30
1649870733944,COGS 101A,A01,083621,Davis; Joshua Daniel,28,0,60,32
1649870739977,COGS 101B,A01,091572,Staff,42,0,60,18
1649870746003,COGS 101C,A01,083625,Delgado; Tania,25,0,30,5
1649870752026,COGS 107A,A01,083627,Boyle; Mary E. T.,34,0,60,26
1649870758049,COGS 118A,A01,083075,Staff,31,0,60,29
1649870764071,CSE 3,A50,083646,Miranda; Gregory Joseph,31,0,38,7
1649870764071,CSE 3,A51,083647,Miranda; Gregory Joseph,37,0,37,0
1649870770097,CSE 8A,A50,083650,Miranda; Gregory Joseph,26,0,40,14
1649870776121,CSE 11,A01,083080,Cao; Yingjun,3,0,40,37
1649870782155,CSE 12,A01,083652,Staff,81,0,100,19
1649870788178,CSE 15L,A01,083654,Staff,36,0,50,14
1649870788178,CSE 15L,A02,083655,Staff,49,0,50,1
1649870794218,CSE 20,A01,083657,Staff,73,0,80,7
1649870800245,CSE 30,A01,083084,Eldon; John,10,0,40,30
1649870806268,CSE 100,A01,083659,Cao; Yingjun,6,0,50,44
1649870812292,CSE 134B,A01,083661,Powell; Thomas Allan,0,16,65,65
1649870818322,CSE 140,A01,083663,Staff,46,0,75,29
1649870824349,CSE 140L,A01,083088,Eldon; John,41,0,75,34
1649870830376,CSE 175,A01,083665,Kumar; Rakesh,14,0,25,11
1649870836398,CSE 190,A00,092507,Staff,15,0,15,0
1649870842431,ECE 45,A01,083139,Staff,33,0,40,7
1649870848462,ECE 65,A50,083695,Staff,22,0,30,8
1649870854494,ECE 109,A01,091882,Touri; Behrouz,66,0,70,4
1649870860519,ECE 180,A00,083140,Abi Samra; Nicholas Camill,29,0,30,1
1649870860519,ECE 180,B00,083141,Abi Samra; Nicholas Camill,16,0,30,14
1649870866543,MATH 10A,A01,083735,Patchell; Gregory David,25,0,30,5
1649870866543,MATH 10A,A02,083736,Patchell; Gregory David,29,0,30,1
1649870866543,MATH 10A,A03,083737,Patchell; Gregory David,30,0,30,0
1649870872568,MATH 10B,A01,083207,Staff,21,0,30,9
1649870872568,MATH 10B,A02,083208,Staff,28,0,30,2
1649870872568,MATH 10B,B01,083739,Staff,26,0,30,4
1649870872568,MATH 10B,B02,083740,Staff,30,0,30,0
1649870878593,MATH 18,A01,083743,Staff,25,0,30,5
1649870878593,MATH 18,A02,083744,Staff,30,0,30,0
1649870878593,MATH 18,A03,083745,Staff,30,0,30,0
1649870878593,MATH 18,A04,083746,Staff,30,0,30,0
1649870878593,MATH 18,B01,083748,Staff,21,0,30,9
1649870878593,MATH 18,B02,083749,Staff,29,0,30,1
1649870878593,MATH 18,B03,083750,Staff,30,0,30,0
1649870878593,MATH 18,B04,083751,Staff,29,0,30,1
1649870884614,MATH 20A,A01,083754,Staff,39,0,40,1
1649870890650,MATH 20B,A01,083756,Staff,28,0,30,2
1649870890650,MATH 20B,A02,083757,Staff,30,0,30,0
1649870896679,MATH 20C,A01,083760,Staff,27,0,30,3
1649870896679,MATH 20C,A02,083761,Staff,30,0,30,0
1649870896679,MATH 20C,B01,083762,Staff,30,0,30,0
1649870896679,MATH 20C,B02,083763,Staff,30,0,30,0
1649870902706,MATH 20D,A01,083765,Staff,23,0,30,7
1649870902706,MATH 20D,A02,083766,Staff,30,0,30,0
1649870902706,MATH 20D,A03,083767,Staff,30,0,30,0
1649870908733,MATH 20E,A01,083771,Staff,21,0,30,9
1649870908733,MATH 20E,A02,083772,Staff,29,0,30,1
1649870908733,MATH 20E,B01,083773,Staff,25,0,30,5
1649870908733,MATH 20E,B02,083774,Staff,29,0,30,1
1649870914756,MATH 103A,A01,083777,Staff,1,0,30,29
1649870914756,MATH 103A,A02,083778,Staff,21,0,30,9
1649870914756,MATH 103A,B01,083779,Staff,14,0,30,16
1649870914756,MATH 103A,B02,083780,Staff,26,0,30,4
1649870920778,MATH 105,A01,085443,Staff,11,0,30,19
1649870926802,MATH 109,A01,083213,Anzaldo; Leesa B,28,0,30,2
1649870926802,MATH 109,A02,083214,Anzaldo; Leesa B,24,0,30,6
1649870926802,MATH 109,B01,083215,Anzaldo; Leesa B,28,0,30,2
1649870926802,MATH 109,B02,083216,Anzaldo; Leesa B,27,0,30,3
1649870932828,MATH 142A,A01,083219,Chow; Bennett,9,0,30,21
1649870932828,MATH 142A,A02,083220,Chow; Bennett,26,0,30,4
1649870932828,MATH 142A,B01,083221,Chow; Bennett,15,0,30,15
1649870932828,MATH 142A,B02,083222,Chow; Bennett,27,0,30,3
1649870938856,MATH 193A,A01,083224,Staff,0,1,30,30
1649870938856,MATH 193A,A02,083225,Staff,6,0,30,24
1649870938856,MATH 193A,A03,083781,Staff,28,0,30,2
1649870938856,MATH 193A,A04,083782,Staff,27,0,30,3
1649870944896,MATH 197,001,091859,McAuley; Julian John,9999,0,9999,0
1649870950948,COGS 9,A01,083615,Staff,43,0,60,17
1649870956983,COGS 11,A01,083617,Boyle; Mary E. T.,36,0,40,4
1649870963010,COGS 13,A01,083071,Staff,16,0,40,24
1649870969050,COGS 14A,A01,092681,Staff,96,0,100,4
1649870975076,COGS 14B,A01,083073,Cheng; Tzu-Han,38,0,50,12
1649870981128,COGS 17,A01,092677,Staff,74,0,75,1
1649870987151,COGS 100,A01,083619,Staff,30,0,60,30
1649870993177,COGS 101A,A01,083621,Davis; Joshua Daniel,28,0,60,32
1649870999205,COGS 101B,A01,091572,Staff,42,0,60,18
1649871005237,COGS 101C,A01,083625,Delgado; Tania,25,0,30,5
1649871011280,COGS 107A,A01,083627,Boyle; Mary E. T.,34,0,60,26
1649871017326,COGS 118A,A01,083075,Staff,31,0,60,29
1649871023353,CSE 3,A50,083646,Miranda; Gregory Joseph,31,0,38,7
1649871023353,CSE 3,A51,083647,Miranda; Gregory Joseph,37,0,37,0
1649871029378,CSE 8A,A50,083650,Miranda; Gregory Joseph,26,0,40,14
1649871035402,CSE 11,A01,083080,Cao; Yingjun,3,0,40,37
1649871041428,CSE 12,A01,083652,Staff,81,0,100,19
1649871047456,CSE 15L,A01,083654,Staff,36,0,50,14
1649871047456,CSE 15L,A02,083655,Staff,49,0,50,1
1649871053480,CSE 20,A01,083657,Staff,73,0,80,7
1649871059510,CSE 30,A01,083084,Eldon; John,10,0,40,30
1649871065539,CSE 100,A01,083659,Cao; Yingjun,5,0,50,45
1649871071602,CSE 134B,A01,083661,Powell; Thomas Allan,0,16,65,65
1649871077626,CSE 140,A01,083663,Staff,46,0,75,29
1649871083663,CSE 140L,A01,083088,Eldon; John,41,0,75,34
1649871089687,CSE 175,A01,083665,Kumar; Rakesh,14,0,25,11
1649871095708,CSE 190,A00,092507,Staff,15,0,15,0
1649871101737,ECE 45,A01,083139,Staff,33,0,40,7
1649871107763,ECE 65,A50,083695,Staff,22,0,30,8
1649871113795,ECE 109,A01,091882,Touri; Behrouz,66,0,70,4
1649871119823,ECE 180,A00,083140,Abi Samra; Nicholas Camill,29,0,30,1
1649871119823,ECE 180,B00,083141,Abi Samra; Nicholas Camill,16,0,30,14
1649871125846,MATH 10A,A01,083735,Patchell; Gregory David,25,0,30,5
1649871125846,MATH 10A,A02,083736,Patchell; Gregory David,29,0,30,1
1649871125846,MATH 10A,A03,083737,Patchell; Gregory David,30,0,30,0
1649871131870,MATH 10B,A01,083207,Staff,21,0,30,9
1649871131870,MATH 10B,A02,083208,Staff,28,0,30,2
1649871131870,MATH 10B,B01,083739,Staff,26,0,30,4
1649871131870,MATH 10B,B02,083740,Staff,30,0,30,0
1649871137896,MATH 18,A01,083743,Staff,25,0,30,5
1649871137896,MATH 18,A02,083744,Staff,30,0,30,0
1649871137896,MATH 18,A03,083745,Staff,29,0,30,1
1649871137896,MATH 18,A04,083746,Staff,30,0,30,0
1649871137896,MATH 18,B01,083748,Staff,20,0,30,10
1649871137896,MATH 18,B02,083749,Staff,29,0,30,1
1649871137896,MATH 18,B03,083750,Staff,30,0,30,0
1649871137896,MATH 18,B04,083751,Staff,29,0,30,1
1649871143922,MATH 20A,A01,083754,Staff,39,0,40,1
1649871149945,MATH 20B,A01,083756,Staff,28,0,30,2
1649871149945,MATH 20B,A02,083757,Staff,30,0,30,0
1649871155977,MATH 20C,A01,083760,Staff,27,0,30,3
1649871155977,MATH 20C,A02,083761,Staff,30,0,30,0
1649871155977,MATH 20C,B01,083762,Staff,30,0,30,0
1649871155977,MATH 20C,B02,083763,Staff,30,0,30,0
1649871162004,MATH 20D,A01,083765,Staff,23,0,30,7
1649871162004,MATH 20D,A02,083766,Staff,30,0,30,0
1649871162004,MATH 20D,A03,083767,Staff,30,0,30,0
1649871168028,MATH 20E,A01,083771,Staff,21,0,30,9
1649871168028,MATH 20E,A02,083772,Staff,29,0,30,1
1649871168028,MATH 20E,B01,083773,Staff,25,0,30,5
1649871168028,MATH 20E,B02,083774,Staff,29,0,30,1
1649871174056,MATH 103A,A01,083777,Staff,1,0,30,29
1649871174056,MATH 103A,A02,083778,Staff,21,0,30,9
1649871174056,MATH 103A,B01,083779,Staff,14,0,30,16
1649871174056,MATH 103A,B02,083780,Staff,26,0,30,4
1649871180079,MATH 105,A01,085443,Staff,11,0,30,19
1649871186103,MATH 109,A01,083213,Anzaldo; Leesa B,28,0,30,2
1649871186103,MATH 109,A02,083214,Anzaldo; Leesa B,24,0,30,6
1649871186103,MATH 109,B01,083215,Anzaldo; Leesa B,28,0,30,2
1649871186103,MATH 109,B02,083216,Anzaldo; Leesa B,27,0,30,3
1649871192130,MATH 142A,A01,083219,Chow; Bennett,9,0,30,21
1649871192130,MATH 142A,A02,083220,Chow; Bennett,26,0,30,4
1649871192130,MATH 142A,B01,083221,Chow; Bennett,15,0,30,15
1649871192130,MATH 142A,B02,083222,Chow; Bennett,27,0,30,3
1649871198155,MATH 193A,A01,083224,Staff,0,1,30,30
1649871198155,MATH 193A,A02,083225,Staff,6,0,30,24
1649871198155,MATH 193A,A03,083781,Staff,28,0,30,2
1649871198155,MATH 193A,A04,083782,Staff,27,0,30,3
1649871204177,MATH 197,001,091859,McAuley; Julian John,9999,0,9999,0
1649871210234,COGS 9,A01,083615,Staff,43,0,60,17
1649871216256,COGS 11,A01,083617,Boyle; Mary E. T.,36,0,40,4
1649871222282,COGS 13,A01,083071,Staff,16,0,40,24
1649871228306,COGS 14A,A01,092681,Staff,96,0,100,4
1649871234333,COGS 14B,A01,083073,Cheng; Tzu-Han,38,0,50,12
1649871240359,COGS 17,A01,092677,Staff,74,0,75,1
1649871246478,COGS 100,A01,083619,Staff,30,0,60,30
1649871252515,COGS 101A,A01,083621,Davis; Joshua Daniel,28,0,60,32
1649871258537,COGS 101B,A01,091572,Staff,42,0,60,18
1649871264568,COGS 101C,A01,083625,Delgado; Tania,25,0,30,5
1649871270592,COGS 107A,A01,083627,Boyle; Mary E. T.,33,0,60,27
1649871276615,COGS 118A,A01,083075,Staff,31,0,60,29
1649871282638,CSE 3,A50,083646,Miranda; Gregory Joseph,31,0,38,7
1649871282638,CSE 3,A51,083647,Miranda; Gregory Joseph,37,0,37,0
1649871288668,CSE 8A,A50,083650,Miranda; Gregory Joseph,25,0,40,15
1649871294695,CSE 11,A01,083080,Cao; Yingjun,2,0,40,38
1649871300727,CSE 12,A01,083652,Staff,81,0,100,19
1649871306749,CSE 15L,A01,083654,Staff,36,0,50,14
1649871306749,CSE 15L,A02,083655,Staff,49,0,50,1
1649871312773,CSE 20,A01,083657,Staff,73,0,80,7
1649871318807,CSE 30,A01,083084,Eldon; John,9,0,40,31
1649871324834,CSE 100,A01,083659,Cao; Yingjun,5,0,50,45
1649871330862,CSE 134B,A01,083661,Powell; Thomas Allan,0,16,65,65
1649871336896,CSE 140,A01,083663,Staff,45,0,75,30
1649871342926,CSE 140L,A01,083088,Eldon; John,40,0,75,35
1649871348949,CSE 175,A01,083665,Kumar; Rakesh,14,0,25,11
1649871354972,CSE 190,A00,092507,Staff,15,0,15,0
1649871360999,ECE 45,A01,083139,Staff,33,0,40,7
1649871367022,ECE 65,A50,083695,Staff,22,0,30,8
1649871373054,ECE 109,A01,091882,Touri; Behrouz,66,0,70,4
1649871379084,ECE 180,A00,083140,Abi Samra; Nicholas Camill,29,0,30,1
1649871379084,ECE 180,B00,083141,Abi Samra; Nicholas Camill,16,0,30,14
1649871385112,MATH 10A,A01,083735,Patchell; Gregory David,25,0,30,5
1649871385112,MATH 10A,A02,083736,Patchell; Gregory David,29,0,30,1
1649871385112,MATH 10A,A03,083737,Patchell; Gregory David,30,0,30,0
1649871391144,MATH 10B,A01,083207,Staff,21,0,30,9
1649871391144,MATH 10B,A02,083208,Staff,28,0,30,2
1649871391144,MATH 10B,B01,083739,Staff,26,0,30,4
1649871391144,MATH 10B,B02,083740,Staff,30,0,30,0
1649871397180,MATH 18,A01,083743,Staff,25,0,30,5
1649871397180,MATH 18,A02,083744,Staff,30,0,30,0
1649871397180,MATH 18,A03,083745,Staff,29,0,30,1
1649871397180,MATH 18,A04,083746,Staff,30,0,30,0
1649871397180,MATH 18,B01,083748,Staff,20,0,30,10
1649871397180,MATH 18,B02,083749,Staff,29,0,30,1
1649871397180,MATH 18,B03,083750,Staff,30,0,30,0
1649871397180,MATH 18,B04,083751,Staff,29,0,30,1
1649871403219,MATH 20A,A01,083754,Staff,39,0,40,1
1649871409242,MATH 20B,A01,083756,Staff,28,0,30,2
1649871409242,MATH 20B,A02,083757,Staff,30,0,30,0
1649871415278,MATH 20C,A01,083760,Staff,27,0,30,3
1649871415278,MATH 20C,A02,083761,Staff,30,0,30,0
1649871415278,MATH 20C,B01,083762,Staff,30,0,30,0
1649871415278,MATH 20C,B02,083763,Staff,30,0,30,0
1649871421309,MATH 20D,A01,083765,Staff,23,0,30,7
1649871421309,MATH 20D,A02,083766,Staff,30,0,30,0
1649871421309,MATH 20D,A03,083767,Staff,30,0,30,0
1649871427332,MATH 20E,A01,083771,Staff,21,0,30,9
1649871427332,MATH 20E,A02,083772,Staff,29,0,30,1
1649871427332,MATH 20E,B01,083773,Staff,25,0,30,5
1649871427332,MATH 20E,B02,083774,Staff,29,0,30,1
1649871433361,MATH 103A,A01,083777,Staff,1,0,30,29
1649871433361,MATH 103A,A02,083778,Staff,21,0,30,9
1649871433361,MATH 103A,B01,083779,Staff,14,0,30,16
1649871433361,MATH 103A,B02,083780,Staff,26,0,30,4
1649871439422,MATH 105,A01,085443,Staff,11,0,30,19
1649871445446,MATH 109,A01,083213,Anzaldo; Leesa B,28,0,30,2
1649871445446,MATH 109,A02,083214,Anzaldo; Leesa B,24,0,30,6
1649871445446,MATH 109,B01,083215,Anzaldo; Leesa B,28,0,30,2
1649871445446,MATH 109,B02,083216,Anzaldo; Leesa B,27,0,30,3
1649871451513,MATH 142A,A01,083219,Chow; Bennett,9,0,30,21
1649871451513,MATH 142A,A02,083220,Chow; Bennett,26,0,30,4
1649871451513,MATH 142A,B01,083221,Chow; Bennett,15,0,30,15
1649871451513,MATH 142A,B02,083222,Chow; Bennett,27,0,30,3
1649871457536,MATH 193A,A01,083224,Staff,0,1,30,30
1649871457536,MATH 193A,A02,083225,Staff,6,0,30,24
1649871457536,MATH 193A,A03,083781,Staff,28,0,30,2
1649871457536,MATH 193A,A04,083782,Staff,27,0,30,3
1649871463570,MATH 197,001,091859,McAuley; Julian John,9999,0,9999,0
1649871469631,COGS 9,A01,083615,Staff,43,0,60,17
1649871475657,COGS 11,A01,083617,Boyle; Mary E. T.,36,0,40,4
1649871481680,COGS 13,A01,083071,Staff,16,0,40,24
1649871487708,COGS 14A,A01,092681,Staff,96,0,100,4
1649871493733,COGS 14B,A01,083073,Cheng; Tzu-Han,38,0,50,12
1649871499757,COGS 17,A01,092677,Staff,74,0,75,1
1649871505782,COGS 100,A01,083619,Staff,30,0,60,30
1649871511810,COGS 101A,A01,083621,Davis; Joshua Daniel,28,0,60,32
1649871517847,COGS 101B,A01,091572,Staff,42,0,60,18
1649871523873,COGS 101C,A01,083625,Delgado; Tania,25,0,30,5
1649871529895,COGS 107A,A01,083627,Boyle; Mary E. T.,33,0,60,27
1649871535918,COGS 118A,A01,083075,Staff,31,0,60,29
1649871541953,CSE 3,A50,083646,Miranda; Gregory Joseph,30,0,38,8
1649871541953,CSE 3,A51,083647,Miranda; Gregory Joseph,37,0,37,0
1649871547991,CSE 8A,A50,083650,Miranda; Gregory Joseph,25,0,40,15
1649871554016,CSE 11,A01,083080,Cao; Yingjun,2,0,40,38
1649871560049,CSE 12,A01,083652,Staff,81,0,100,19
1649871566076,CSE 15L,A01,083654,Staff,36,0,50,14
1649871566076,CSE 15L,A02,083655,Staff,49,0,50,1
1649871572110,CSE 20,A01,083657,Staff,73,0,80,7
1649871578132,CSE 30,A01,083084,Eldon; John,9,0,40,31
1649871584155,CSE 100,A01,083659,Cao; Yingjun,5,0,50,45
1649871590185,CSE 134B,A01,083661,Powell; Thomas Allan,0,16,65,65
1649871596221,CSE 140,A01,083663,Staff,44,0,75,31
1649871602263,CSE 140L,A01,083088,Eldon; John,39,0,75,36
1649871608287,CSE 175,A01,083665,Kumar; Rakesh,14,0,25,11
1649871614312,CSE 190,A00,092507,Staff,15,0,15,0
1649871620348,ECE 45,A01,083139,Staff,33,0,40,7
1649871626374,ECE 65,A50,083695,Staff,22,0,30,8
1649871632405,ECE 109,A01,091882,Touri; Behrouz,66,0,70,4
1649871638433,ECE 180,A00,083140,Abi Samra; Nicholas Camill,29,0,30,1
1649871638433,ECE 180,B00,083141,Abi Samra; Nicholas Camill,16,0,30,14
1649871644461,MATH 10A,A01,083735,Patchell; Gregory David,25,0,30,5
1649871644461,MATH 10A,A02,083736,Patchell; Gregory David,29,0,30,1
1649871644461,MATH 10A,A03,083737,Patchell; Gregory David,30,0,30,0
1649871650485,MATH 10B,A01,083207,Staff,21,0,30,9
1649871650485,MATH 10B,A02,083208,Staff,28,0,30,2
1649871650485,MATH 10B,B01,083739,Staff,26,0,30,4
1649871650485,MATH 10B,B02,083740,Staff,30,0,30,0
1649871656529,MATH 18,A01,083743,Staff,25,0,30,5
1649871656529,MATH 18,A02,083744,Staff,30,0,30,0
1649871656529,MATH 18,A03,083745,Staff,29,0,30,1
1649871656529,MATH 18,A04,083746,Staff,30,0,30,0
1649871656529,MATH 18,B01,083748,Staff,20,0,30,10
1649871656529,MATH 18,B02,083749,Staff,29,0,30,1
1649871656529,MATH 18,B03,083750,Staff,30,0,30,0
1649871656529,MATH 18,B04,083751,Staff,29,0,30,1
1649871662552,MATH 20A,A01,083754,Staff,39,0,40,1
1649871668579,MATH 20B,A01,083756,Staff,28,0,30,2
1649871668579,MATH 20B,A02,083757,Staff,30,0,30,0
1649871674606,MATH 20C,A01,083760,Staff,27,0,30,3
1649871674606,MATH 20C,A02,083761,Staff,30,0,30,0
1649871674606,MATH 20C,B01,083762,Staff,30,0,30,0
1649871674606,MATH 20C,B02,083763,Staff,30,0,30,0
1649871680629,MATH 20D,A01,083765,Staff,23,0,30,7
1649871680629,MATH 20D,A02,083766,Staff,30,0,30,0
1649871680629,MATH 20D,A03,083767,Staff,30,0,30,0
1649871686656,MATH 20E,A01,083771,Staff,21,0,30,9
1649871686656,MATH 20E,A02,083772,Staff,29,0,30,1
1649871686656,MATH 20E,B01,083773,Staff,25,0,30,5
1649871686656,MATH 20E,B02,083774,Staff,29,0,30,1
1649871692689,MATH 103A,A01,083777,Staff,1,0,30,29
1649871692689,MATH 103A,A02,083778,Staff,21,0,30,9
1649871692689,MATH 103A,B01,083779,Staff,14,0,30,16
1649871692689,MATH 103A,B02,083780,Staff,26,0,30,4
1649871698713,MATH 105,A01,085443,Staff,11,0,30,19
1649871704737,MATH 109,A01,083213,Anzaldo; Leesa B,28,0,30,2
1649871704737,MATH 109,A02,083214,Anzaldo; Leesa B,24,0,30,6
1649871704737,MATH 109,B01,083215,Anzaldo; Leesa B,28,0,30,2
1649871704737,MATH 109,B02,083216,Anzaldo; Leesa B,27,0,30,3
1649871710769,MATH 142A,A01,083219,Chow; Bennett,8,0,30,22
1649871710769,MATH 142A,A02,083220,Chow; Bennett,26,0,30,4
1649871710769,MATH 142A,B01,083221,Chow; Bennett,15,0,30,15
1649871710769,MATH 142A,B02,083222,Chow; Bennett,27,0,30,3
1649871716802,MATH 193A,A01,083224,Staff,0,1,30,30
1649871716802,MATH 193A,A02,083225,Staff,6,0,30,24
1649871716802,MATH 193A,A03,083781,Staff,28,0,30,2
1649871716802,MATH 193A,A04,083782,Staff,27,0,30,3
1649871722839,MATH 197,001,091859,McAuley; Julian John,9999,0,9999,0
1649871728895,COGS 9,A01,083615,Staff,43,0,60,17
1649871734932,COGS 11,A01,083617,Boyle; Mary E. T.,36,0,40,4
1649871740977,COGS 13,A01,083071,Staff,16,0,40,24
1649871747001,COGS 14A,A01,092681,Staff,96,0,100,4
1649871753024,COGS 14B,A01,083073,Cheng; Tzu-Han,38,0,50,12
1649871759050,COGS 17,A01,092677,Staff,74,0,75,1
1649871765074,COGS 100,A01,083619,Staff,30,0,60,30
1649871771107,COGS 101A,A01,083621,Davis; Joshua Daniel,28,0,60,32
1649871777132,COGS 101B,A01,091572,Staff,42,0,60,18
1649871783162,COGS 101C,A01,083625,Delgado; Tania,25,0,30,5
1649871789184,COGS 107A,A01,083627,Boyle; Mary E. T.,33,0,60,27
1649871795215,COGS 118A,A01,083075,Staff,31,0,60,29
1649871801245,CSE 3,A50,083646,Miranda; Gregory Joseph,30,0,38,8
1649871801245,CSE 3,A51,083647,Miranda; Gregory Joseph,37,0,37,0
1649871807269,CSE 8A,A50,083650,Miranda; Gregory Joseph,25,0,40,15
1649871813304,CSE 11,A01,083080,Cao; Yingjun,2,0,40,38
1649871819328,CSE 12,A01,083652,Staff,81,0,100,19
1649871825354,CSE 15L,A01,083654,Staff,36,0,50,14
1649871825354,CSE 15L,A02,083655,Staff,49,0,50,1
1649871831380,CSE 20,A01,083657,Staff,73,0,80,7
1649871837402,CSE 30,A01,083084,Eldon; John,9,0,40,31
1649871843510,CSE 100,A01,083659,Cao; Yingjun,5,0,50,45
1649871849541,CSE 134B,A01,083661,Powell; Thomas Allan,0,16,65,65
1649871855570,CSE 140,A01,083663,Staff,44,0,75,31
1649871861594,CSE 140L,A01,083088,Eldon; John,39,0,75,36
1649871867623,CSE 175,A01,083665,Kumar; Rakesh,14,0,25,11
1649871873647,CSE 190,A00,092507,Staff,15,0,15,0
1649871879674,ECE 45,A01,083139,Staff,33,0,40,7
1649871885707,ECE 65,A50,083695,Staff,22,0,30,8
1649871891729,ECE 109,A01,091882,Touri; Behrouz,65,0,70,5
1649871897760,ECE 180,A00,083140,Abi Samra; Nicholas Camill,29,0,30,1
1649871897760,ECE 180,B00,083141,Abi Samra; Nicholas Camill,16,0,30,14
1649871903784,MATH 10A,A01,083735,Patchell; Gregory David,25,0,30,5
1649871903784,MATH 10A,A02,083736,Patchell; Gregory David,29,0,30,1
1649871903784,MATH 10A,A03,083737,Patchell; Gregory David,30,0,30,0
1649871909812,MATH 10B,A01,083207,Staff,21,0,30,9
1649871909812,MATH 10B,A02,083208,Staff,28,0,30,2
1649871909812,MATH 10B,B01,083739,Staff,26,0,30,4
1649871909812,MATH 10B,B02,083740,Staff,30,0,30,0
1649871915836,MATH 18,A01,083743,Staff,25,0,30,5
1649871915836,MATH 18,A02,083744,Staff,30,0,30,0
1649871915836,MATH 18,A03,083745,Staff,29,0,30,1
1649871915836,MATH 18,A04,083746,Staff,30,0,30,0
1649871915836,MATH 18,B01,083748,Staff,19,0,30,11
1649871915836,MATH 18,B02,083749,Staff,29,0,30,1
1649871915836,MATH 18,B03,083750,Staff,30,0,30,0
1649871915836,MATH 18,B04,083751,Staff,29,0,30,1
1649871921869,MATH 20A,A01,083754,Staff,39,0,40,1
1649871927892,MATH 20B,A01,083756,Staff,28,0,30,2
1649871927892,MATH 20B,A02,083757,Staff,30,0,30,0
1649871933919,MATH 20C,A01,083760,Staff,27,0,30,3
1649871933919,MATH 20C,A02,083761,Staff,30,0,30,0
1649871933919,MATH 20C,B01,083762,Staff,30,0,30,0
1649871933919,MATH 20C,B02,083763,Staff,30,0,30,0
1649871939947,MATH 20D,A01,083765,Staff,23,0,30,7
1649871939947,MATH 20D,A02,083766,Staff,30,0,30,0
1649871939947,MATH 20D,A03,083767,Staff,30,0,30,0
1649871945976,MATH 20E,A01,083771,Staff,21,0,30,9
1649871945976,MATH 20E,A02,083772,Staff,29,0,30,1
1649871945976,MATH 20E,B01,083773,Staff,25,0,30,5
1649871945976,MATH 20E,B02,083774,Staff,29,0,30,1
1649871952001,MATH 103A,A01,083777,Staff,1,0,30,29
1649871952001,MATH 103A,A02,083778,Staff,21,0,30,9
1649871952001,MATH 103A,B01,083779,Staff,14,0,30,16
1649871952001,MATH 103A,B02,083780,Staff,25,0,30,5
1649871958028,MATH 105,A01,085443,Staff,11,0,30,19
1649871964064,MATH 109,A01,083213,Anzaldo; Leesa B,28,0,30,2
1649871964064,MATH 109,A02,083214,Anzaldo; Leesa B,24,0,30,6
1649871964064,MATH 109,B01,083215,Anzaldo; Leesa B,28,0,30,2
1649871964064,MATH 109,B02,083216,Anzaldo; Leesa B,27,0,30,3
1649871970088,MATH 142A,A01,083219,Chow; Bennett,8,0,30,22
1649871970088,MATH 142A,A02,083220,Chow; Bennett,26,0,30,4
1649871970088,MATH 142A,B01,083221,Chow; Bennett,14,0,30,16
1649871970088,MATH 142A,B02,083222,Chow; Bennett,27,0,30,3
1649871976124,MATH 193A,A01,083224,Staff,0,1,30,30
1649871976124,MATH 193A,A02,083225,Staff,6,0,30,24
1649871976124,MATH 193A,A03,083781,Staff,28,0,30,2
1649871976124,MATH 193A,A04,083782,Staff,27,0,30,3
1649871982153,MATH 197,001,091859,McAuley; Julian John,9999,0,9999,0
1649871988221,COGS 9,A01,083615,Staff,43,0,60,17
1649871994249,COGS 11,A01,083617,Boyle; Mary E. T.,36,0,40,4
1649872000276,COGS 13,A01,083071,Staff,16,0,40,24
1649872006299,COGS 14A,A01,092681,Staff,96,0,100,4
1649872012326,COGS 14B,A01,083073,Cheng; Tzu-Han,38,0,50,12
1649872018349,COGS 17,A01,092677,Staff,74,0,75,1
1649872024383,COGS 100,A01,083619,Staff,30,0,60,30
1649872030412,COGS 101A,A01,083621,Davis; Joshua Daniel,28,0,60,32
1649872036437,COGS 101B,A01,091572,Staff,42,0,60,18
1649872042465,COGS 101C,A01,083625,Delgado; Tania,25,0,30,5
1649872048488,COGS 107A,A01,083627,Boyle; Mary E. T.,33,0,60,27
1649872054510,COGS 118A,A01,083075,Staff,31,0,60,29
1649872060534,CSE 3,A50,083646,Miranda; Gregory Joseph,30,0,38,8
1649872060534,CSE 3,A51,083647,Miranda; Gregory Joseph,37,0,37,0
1649872066570,CSE 8A,A50,083650,Miranda; Gregory Joseph,25,0,40,15
1649872072599,CSE 11,A01,083080,Cao; Yingjun,2,0,40,38
1649872078636,CSE 12,A01,083652,Staff,81,0,100,19
1649872084656,CSE 15L,A01,083654,Staff,36,0,50,14
1649872084656,CSE 15L,A02,083655,Staff,49,0,50,1
1649872090679,CSE 20,A01,083657,Staff,73,0,80,7
1649872096721,CSE 30,A01,083084,Eldon; John,9,0,40,31
1649872102753,CSE 100,A01,083659,Cao; Yingjun,5,0,50,45
1649872108776,CSE 134B,A01,083661,Powell; Thomas Allan,0,16,65,65
1649872114800,CSE 140,A01,083663,Staff,44,0,75,31
1649872120827,CSE 140L,A01,083088,Eldon; John,39,0,75,36
1649872126859,CSE 175,A01,083665,Kumar; Rakesh,14,0,25,11
1649872132888,CSE 190,A00,092507,Staff,15,0,15,0
1649872138911,ECE 45,A01,083139,Staff,32,0,40,8
1649872144933,ECE 65,A50,083695,Staff,22,0,30,8
1649872150962,ECE 109,A01,091882,Touri; Behrouz,65,0,70,5
1649872156995,ECE 180,A00,083140,Abi Samra; Nicholas Camill,29,0,30,1
1649872156995,ECE 180,B00,083141,Abi Samra; Nicholas Camill,16,0,30,14
1649872163018,MATH 10A,A01,083735,Patchell; Gregory David,25,0,30,5
1649872163018,MATH 10A,A02,083736,Patchell; Gregory David,29,0,30,1
1649872163018,MATH 10A,A03,083737,Patchell; Gregory David,30,0,30,0
1649872169047,MATH 10B,A01,083207,Staff,21,0,30,9
1649872169047,MATH 10B,A02,083208,Staff,28,0,30,2
1649872169047,MATH 10B,B01,083739,Staff,26,0,30,4
1649872169047,MATH 10B,B02,083740,Staff,30,0,30,0
1649872175081,MATH 18,A01,083743,Staff,25,0,30,5
1649872175081,MATH 18,A02,083744,Staff,30,0,30,0
1649872175081,MATH 18,A03,083745,Staff,29,0,30,1
1649872175081,MATH 18,A04,083746,Staff,30,0,30,0
1649872175081,MATH 18,B01,083748,Staff,19,0,30,11
1649872175081,MATH 18,B02,083749,Staff,29,0,30,1
1649872175081,MATH 18,B03,083750,Staff,30,0,30,0
1649872175081,MATH 18,B04,083751,Staff,29,0,30,1
1649872181105,MATH 20A,A01,083754,Staff,39,0,40,1
1649872187127,MATH 20B,A01,083756,Staff,28,0,30,2
1649872187127,MATH 20B,A02,083757,Staff,30,0,30,0
1649872193154,MATH 20C,A01,083760,Staff,27,0,30,3
1649872193154,MATH 20C,A02,083761,Staff,30,0,30,0
1649872193154,MATH 20C,B01,083762,Staff,30,0,30,0
1649872193154,MATH 20C,B02,083763,Staff,30,0,30,0
1649872199177,MATH 20D,A01,083765,Staff,23,0,30,7
1649872199177,MATH 20D,A02,083766,Staff,30,0,30,0
1649872199177,MATH 20D,A03,083767,Staff,30,0,30,0
1649872205201,MATH 20E,A01,083771,Staff,21,0,30,9
1649872205201,MATH 20E,A02,083772,Staff,29,0,30,1
1649872205201,MATH 20E,B01,083773,Staff,25,0,30,5
1649872205201,MATH 20E,B02,083774,Staff,29,0,30,1
1649872211228,MATH 103A,A01,083777,Staff,1,0,30,29
1649872211228,MATH 103A,A02,083778,Staff,21,0,30,9
1649872211228,MATH 103A,B01,083779,Staff,14,0,30,16
1649872211228,MATH 103A,B02,083780,Staff,25,0,30,5
1649872217250,MATH 105,A01,085443,Staff,11,0,30,19
1649872223279,MATH 109,A01,083213,Anzaldo; Leesa B,28,0,30,2
1649872223279,MATH 109,A02,083214,Anzaldo; Leesa B,24,0,30,6
1649872223279,MATH 109,B01,083215,Anzaldo; Leesa B,28,0,30,2
1649872223279,MATH 109,B02,083216,Anzaldo; Leesa B,27,0,30,3
1649872229302,MATH 142A,A01,083219,Chow; Bennett,8,0,30,22
1649872229302,MATH 142A,A02,083220,Chow; Bennett,26,0,30,4
1649872229302,MATH 142A,B01,083221,Chow; Bennett,14,0,30,16
1649872229302,MATH 142A,B02,083222,Chow; Bennett,27,0,30,3
1649872235330,MATH 193A,A01,083224,Staff,0,1,30,30
1649872235330,MATH 193A,A02,083225,Staff,6,0,30,24
1649872235330,MATH 193A,A03,083781,Staff,28,0,30,2
1649872235330,MATH 193A,A04,083782,Staff,27,0,30,3
1649872241352,MATH 197,001,091859,McAuley; Julian John,9999,0,9999,0
1649872247401,COGS 9,A01,083615,Staff,43,0,60,17
1649872253430,COGS 11,A01,083617,Boyle; Mary E. T.,36,0,40,4
1649872259456,COGS 13,A01,083071,Staff,16,0,40,24
1649872265482,COGS 14A,A01,092681,Staff,96,0,100,4
1649872271525,COGS 14B,A01,083073,Cheng; Tzu-Han,38,0,50,12
1649872277551,COGS 17,A01,092677,Staff,74,0,75,1
1649872283579,COGS 100,A01,083619,Staff,30,0,60,30
1649872289617,COGS 101A,A01,083621,Davis; Joshua Daniel,27,0,60,33
1649872295655,COGS 101B,A01,091572,Staff,41,0,60,19
1649872301678,COGS 101C,A01,083625,Delgado; Tania,25,0,30,5
1649872307705,COGS 107A,A01,083627,Boyle; Mary E. T.,32,0,60,28
1649872313730,COGS 118A,A01,083075,Staff,30,0,60,30
1649872319752,CSE 3,A50,083646,Miranda; Gregory Joseph,30,0,38,8
1649872319752,CSE 3,A51,083647,Miranda; Gregory Joseph,37,0,37,0
1649872325779,CSE 8A,A50,083650,Miranda; Gregory Joseph,25,0,40,15
1649872331808,CSE 11,A01,083080,Cao; Yingjun,2,0,40,38
1649872337836,CSE 12,A01,083652,Staff,81,0,100,19
1649872343858,CSE 15L,A01,083654,Staff,36,0,50,14
1649872343858,CSE 15L,A02,083655,Staff,49,0,50,1
1649872349885,CSE 20,A01,083657,Staff,73,0,80,7
1649872355913,CSE 30,A01,083084,Eldon; John,9,0,40,31
1649872361936,CSE 100,A01,083659,Cao; Yingjun,5,0,50,45
1649872367972,CSE 134B,A01,083661,Powell; Thomas Allan,0,17,65,65
1649872373994,CSE 140,A01,083663,Staff,44,0,75,31
1649872380017,CSE 140L,A01,083088,Eldon; John,38,0,75,37
1649872386044,CSE 175,A01,083665,Kumar; Rakesh,14,0,25,11
1649872392068,CSE 190,A00,092507,Staff,15,0,15,0
1649872398094,ECE 45,A01,083139,Staff,32,0,40,8
1649872404118,ECE 65,A50,083695,Staff,22,0,30,8
1649872410153,ECE 109,A01,091882,Touri; Behrouz,65,0,70,5
1649872416177,ECE 180,A00,083140,Abi Samra; Nicholas Camill,29,0,30,1
1649872416177,ECE 180,B00,083141,Abi Samra; Nicholas Camill,16,0,30,14
1649872422208,MATH 10A,A01,083735,Patchell; Gregory David,25,0,30,5
1649872422208,MATH 10A,A02,083736,Patchell; Gregory David,29,0,30,1
1649872422208,MATH 10A,A03,083737,Patchell; Gregory David,30,0,30,0
1649872428235,MATH 10B,A01,083207,Staff,21,0,30,9
1649872428235,MATH 10B,A02,083208,Staff,28,0,30,2
1649872428235,MATH 10B,B01,083739,Staff,26,0,30,4
1649872428235,MATH 10B,B02,083740,Staff,30,0,30,0
1649872434259,MATH 18,A01,083743,Staff,25,0,30,5
1649872434259,MATH 18,A02,083744,Staff,30,0,30,0
1649872434259,MATH 18,A03,083745,Staff,29,0,30,1
1649872434259,MATH 18,A04,083746,Staff,30,0,30,0
1649872434259,MATH 18,B01,083748,Staff,19,0,30,11
1649872434259,MATH 18,B02,083749,Staff,29,0,30,1
1649872434259,MATH 18,B03,083750,Staff,30,0,30,0
1649872434259,MATH 18,B04,083751,Staff,29,0,30,1
1649872440372,MATH 20A,A01,083754,Staff,39,0,40,1
1649872446396,MATH 20B,A01,083756,Staff,28,0,30,2
1649872446396,MATH 20B,A02,083757,Staff,30,0,30,0
1649872452429,MATH 20C,A01,083760,Staff,27,0,30,3
1649872452429,MATH 20C,A02,083761,Staff,30,0,30,0
1649872452429,MATH 20C,B01,083762,Staff,30,0,30,0
1649872452429,MATH 20C,B02,083763,Staff,30,0,30,0
1649872458457,MATH 20D,A01,083765,Staff,23,0,30,7
1649872458457,MATH 20D,A02,083766,Staff,30,0,30,0
1649872458457,MATH 20D,A03,083767,Staff,30,0,30,0
1649872464481,MATH 20E,A01,083771,Staff,21,0,30,9
1649872464481,MATH 20E,A02,083772,Staff,29,0,30,1
1649872464481,MATH 20E,B01,083773,Staff,25,0,30,5
1649872464481,MATH 20E,B02,083774,Staff,29,0,30,1
1649872470514,MATH 103A,A01,083777,Staff,1,0,30,29
1649872470514,MATH 103A,A02,083778,Staff,21,0,30,9
1649872470514,MATH 103A,B01,083779,Staff,14,0,30,16
1649872470514,MATH 103A,B02,083780,Staff,25,0,30,5
1649872476541,MATH 105,A01,085443,Staff,11,0,30,19
1649872482566,MATH 109,A01,083213,Anzaldo; Leesa B,28,0,30,2
1649872482566,MATH 109,A02,083214,Anzaldo; Leesa B,24,0,30,6
1649872482566,MATH 109,B01,083215,Anzaldo; Leesa B,28,0,30,2
1649872482566,MATH 109,B02,083216,Anzaldo; Leesa B,27,0,30,3
1649872488602,MATH 142A,A01,083219,Chow; Bennett,8,0,30,22
1649872488602,MATH 142A,A02,083220,Chow; Bennett,26,0,30,4
1649872488602,MATH 142A,B01,083221,Chow; Bennett,14,0,30,16
1649872488602,MATH 142A,B02,083222,Chow; Bennett,27,0,30,3
1649872494637,MATH 193A,A01,083224,Staff,0,1,30,30
1649872494637,MATH 193A,A02,083225,Staff,6,0,30,24
1649872494637,MATH 193A,A03,083781,Staff,28,0,30,2
1649872494637,MATH 193A,A04,083782,Staff,27,0,30,3
1649872500662,MATH 197,001,091859,McAuley; Julian John,9999,0,9999,0
1649872506716,COGS 9,A01,083615,Staff,43,0,60,17
1649872512739,COGS 11,A01,083617,Boyle; Mary E. T.,36,0,40,4
1649872518770,COGS 13,A01,083071,Staff,16,0,40,24
1649872524805,COGS 14A,A01,092681,Staff,95,0,100,5
1649872530835,COGS 14B,A01,083073,Cheng; Tzu-Han,38,0,50,12
1649872536862,COGS 17,A01,092677,Staff,73,0,75,2
1649872542899,COGS 100,A01,083619,Staff,29,0,60,31
1649872548922,COGS 101A,A01,083621,Davis; Joshua Daniel,27,0,60,33
1649872554945,COGS 101B,A01,091572,Staff,41,0,60,19
1649872560970,COGS 101C,A01,083625,Delgado; Tania,25,0,30,5
1649872566998,COGS 107A,A01,083627,Boyle; Mary E. T.,32,0,60,28
1649872573024,COGS 118A,A01,083075,Staff,30,0,60,30
1649872579047,CSE 3,A50,083646,Miranda; Gregory Joseph,30,0,38,8
1649872579047,CSE 3,A51,083647,Miranda; Gregory Joseph,37,0,37,0
1649872585070,CSE 8A,A50,083650,Miranda; Gregory Joseph,25,0,40,15
1649872591098,CSE 11,A01,083080,Cao; Yingjun,1,0,40,39
1649872597129,CSE 12,A01,083652,Staff,81,0,100,19
1649872603155,CSE 15L,A01,083654,Staff,36,0,50,14
1649872603155,CSE 15L,A02,083655,Staff,49,0,50,1
1649872609181,CSE 20,A01,083657,Staff,73,0,80,7
1649872615204,CSE 30,A01,083084,Eldon; John,9,0,40,31
1649872621235,CSE 100,A01,083659,Cao; Yingjun,4,0,50,46
1649872627262,CSE 134B,A01,083661,Powell; Thomas Allan,0,17,65,65
1649872633294,CSE 140,A01,083663,Staff,44,0,75,31
1649872639328,CSE 140L,A01,083088,Eldon; John,38,0,75,37
1649872645374,CSE 175,A01,083665,Kumar; Rakesh,14,0,25,11
1649872651399,CSE 190,A00,092507,Staff,15,0,15,0
1649872657422,ECE 45,A01,083139,Staff,32,0,40,8
1649872663450,ECE 65,A50,083695,Staff,22,0,30,8
1649872669475,ECE 109,A01,091882,Touri; Behrouz,65,0,70,5
1649872675508,ECE 180,A00,083140,Abi Samra; Nicholas Camill,29,0,30,1
1649872675508,ECE 180,B00,083141,Abi Samra; Nicholas Camill,16,0,30,14
1649872681530,MATH 10A,A01,083735,Patchell; Gregory David,25,0,30,5
1649872681530,MATH 10A,A02,083736,Patchell; Gregory David,29,0,30,1
1649872681530,MATH 10A,A03,083737,Patchell; Gregory David,30,0,30,0
1649872687560,MATH 10B,A01,083207,Staff,21,0,30,9
1649872687560,MATH 10B,A02,083208,Staff,28,0,30,2
1649872687560,MATH 10B,B01,083739,Staff,26,0,30,4
1649872687560,MATH 10B,B02,083740,Staff,30,0,30,0
1649872693582,MATH 18,A01,083743,Staff,25,0,30,5
1649872693582,MATH 18,A02,083744,Staff,30,0,30,0
1649872693582,MATH 18,A03,083745,Staff,29,0,30,1
1649872693582,MATH 18,A04,083746,Staff,30,0,30,0
1649872693582,MATH 18,B01,083748,Staff,19,0,30,11
1649872693582,MATH 18,B02,083749,Staff,29,0,30,1
1649872693582,MATH 18,B03,083750,Staff,30,0,30,0
1649872693582,MATH 18,B04,083751,Staff,29,0,30,1
1649872699605,MATH 20A,A01,083754,Staff,39,0,40,1
1649872705629,MATH 20B,A01,083756,Staff,28,0,30,2
1649872705629,MATH 20B,A02,083757,Staff,30,0,30,0
1649872711658,MATH 20C,A01,083760,Staff,26,0,30,4
1649872711658,MATH 20C,A02,083761,Staff,30,0,30,0
1649872711658,MATH 20C,B01,083762,Staff,30,0,30,0
1649872711658,MATH 20C,B02,083763,Staff,30,0,30,0
1649872717684,MATH 20D,A01,083765,Staff,23,0,30,7
1649872717684,MATH 20D,A02,083766,Staff,30,0,30,0
1649872717684,MATH 20D,A03,083767,Staff,30,0,30,0
1649872723707,MATH 20E,A01,083771,Staff,21,0,30,9
1649872723707,MATH 20E,A02,083772,Staff,29,0,30,1
1649872723707,MATH 20E,B01,083773,Staff,25,0,30,5
1649872723707,MATH 20E,B02,083774,Staff,29,0,30,1
1649872729733,MATH 103A,A01,083777,Staff,1,0,30,29
1649872729733,MATH 103A,A02,083778,Staff,21,0,30,9
1649872729733,MATH 103A,B01,083779,Staff,13,0,30,17
1649872729733,MATH 103A,B02,083780,Staff,25,0,30,5
1649872735756,MATH 105,A01,085443,Staff,10,0,30,20
1649872741788,MATH 109,A01,083213,Anzaldo; Leesa B,28,0,30,2
1649872741788,MATH 109,A02,083214,Anzaldo; Leesa B,24,0,30,6
1649872741788,MATH 109,B01,083215,Anzaldo; Leesa B,27,0,30,3
1649872741788,MATH 109,B02,083216,Anzaldo; Leesa B,27,0,30,3
1649872747818,MATH 142A,A01,083219,Chow; Bennett,8,0,30,22
1649872747818,MATH 142A,A02,083220,Chow; Bennett,26,0,30,4
1649872747818,MATH 142A,B01,083221,Chow; Bennett,14,0,30,16
1649872747818,MATH 142A,B02,083222,Chow; Bennett,27,0,30,3
1649872753850,MATH 193A,A01,083224,Staff,0,1,30,30
1649872753850,MATH 193A,A02,083225,Staff,5,0,30,25
1649872753850,MATH 193A,A03,083781,Staff,28,0,30,2
1649872753850,MATH 193A,A04,083782,Staff,27,0,30,3
1649872759885,MATH 197,001,091859,McAuley; Julian John,9999,0,9999,0
1649872765945,COGS 9,A01,083615,Staff,43,0,60,17
1649872771974,COGS 11,A01,083617,Boyle; Mary E. T.,36,0,40,4
1649872777997,COGS 13,A01,083071,Staff,16,0,40,24
1649872784035,COGS 14A,A01,092681,Staff,95,0,100,5
1649872790065,COGS 14B,A01,083073,Cheng; Tzu-Han,38,0,50,12
1649872796089,COGS 17,A01,092677,Staff,73,0,75,2
1649872802113,COGS 100,A01,083619,Staff,29,0,60,31
1649872808140,COGS 101A,A01,083621,Davis; Joshua Daniel,27,0,60,33
1649872814167,COGS 101B,A01,091572,Staff,40,0,60,20
1649872820189,COGS 101C,A01,083625,Delgado; Tania,25,0,30,5
1649872826223,COGS 107A,A01,083627,Boyle; Mary E. T.,32,0,60,28
1649872832258,COGS 118A,A01,083075,Staff,30,0,60,30
1649872838284,CSE 3,A50,083646,Miranda; Gregory Joseph,30,0,38,8
1649872838284,CSE 3,A51,083647,Miranda; Gregory Joseph,37,0,37,0
1649872844324,CSE 8A,A50,083650,Miranda; Gregory Joseph,25,0,40,15
1649872850352,CSE 11,A01,083080,Cao; Yingjun,1,0,40,39
1649872856375,CSE 12,A01,083652,Staff,81,0,100,19
1649872862408,CSE 15L,A01,083654,Staff,36,0,50,14
1649872862408,CSE 15L,A02,083655,Staff,49,0,50,1
1649872868452,CSE 20,A01,083657,Staff,73,0,80,7
1649872874476,CSE 30,A01,083084,Eldon; John,9,0,40,31
1649872880498,CSE 100,A01,083659,Cao; Yingjun,4,0,50,46
1649872886525,CSE 134B,A01,083661,Powell; Thomas Allan,0,17,65,65
1649872892548,CSE 140,A01,083663,Staff,44,0,75,31
1649872898574,CSE 140L,A01,083088,Eldon; John,38,0,75,37
1649872904601,CSE 175,A01,083665,Kumar; Rakesh,14,0,25,11
1649872910632,CSE 190,A00,092507,Staff,15,0,15,0
1649872916659,ECE 45,A01,083139,Staff,32,0,40,8
1649872922682,ECE 65,A50,083695,Staff,22,0,30,8
1649872928706,ECE 109,A01,091882,Touri; Behrouz,65,0,70,5
1649872934733,ECE 180,A00,083140,Abi Samra; Nicholas Camill,29,0,30,1
1649872934733,ECE 180,B00,083141,Abi Samra; Nicholas Camill,16,0,30,14
1649872940756,MATH 10A,A01,083735,Patchell; Gregory David,25,0,30,5
1649872940756,MATH 10A,A02,083736,Patchell; Gregory David,29,0,30,1
1649872940756,MATH 10A,A03,083737,Patchell; Gregory David,30,0,30,0
1649872946781,MATH 10B,A01,083207,Staff,21,0,30,9
1649872946781,MATH 10B,A02,083208,Staff,28,0,30,2
1649872946781,MATH 10B,B01,083739,Staff,26,0,30,4
1649872946781,MATH 10B,B02,083740,Staff,30,0,30,0
1649872952817,MATH 18,A01,083743,Staff,25,0,30,5
1649872952817,MATH 18,A02,083744,Staff,30,0,30,0
1649872952817,MATH 18,A03,083745,Staff,29,0,30,1
1649872952817,MATH 18,A04,083746,Staff,30,0,30,0
1649872952817,MATH 18,B01,083748,Staff,19,0,30,11
1649872952817,MATH 18,B02,083749,Staff,29,0,30,1
1649872952817,MATH 18,B03,083750,Staff,30,0,30,0
1649872952817,MATH 18,B04,083751,Staff,29,0,30,1
1649872958852,MATH 20A,A01,083754,Staff,39,0,40,1
1649872964875,MATH 20B,A01,083756,Staff,28,0,30,2
1649872964875,MATH 20B,A02,083757,Staff,30,0,30,0
1649872970902,MATH 20C,A01,083760,Staff,26,0,30,4
1649872970902,MATH 20C,A02,083761,Staff,30,0,30,0
1649872970902,MATH 20C,B01,083762,Staff,30,0,30,0
1649872970902,MATH 20C,B02,083763,Staff,30,0,30,0
1649872976940,MATH 20D,A01,083765,Staff,23,0,30,7
1649872976940,MATH 20D,A02,083766,Staff,30,0,30,0
1649872976940,MATH 20D,A03,083767,Staff,30,0,30,0
1649872982963,MATH 20E,A01,083771,Staff,21,0,30,9
1649872982963,MATH 20E,A02,083772,Staff,29,0,30,1
1649872982963,MATH 20E,B01,083773,Staff,25,0,30,5
1649872982963,MATH 20E,B02,083774,Staff,29,0,30,1
1649872988996,MATH 103A,A01,083777,Staff,0,0,30,30
1649872988996,MATH 103A,A02,083778,Staff,20,0,30,10
1649872988996,MATH 103A,B01,083779,Staff,13,0,30,17
1649872988996,MATH 103A,B02,083780,Staff,25,0,30,5
1649872995023,MATH 105,A01,085443,Staff,9,0,30,21
1649873001048,MATH 109,A01,083213,Anzaldo; Leesa B,28,0,30,2
1649873001048,MATH 109,A02,083214,Anzaldo; Leesa B,24,0,30,6
1649873001048,MATH 109,B01,083215,Anzaldo; Leesa B,27,0,30,3
1649873001048,MATH 109,B02,083216,Anzaldo; Leesa B,27,0,30,3
1649873007072,MATH 142A,A01,083219,Chow; Bennett,6,0,30,24
1649873007072,MATH 142A,A02,083220,Chow; Bennett,26,0,30,4
1649873007072,MATH 142A,B01,083221,Chow; Bennett,13,0,30,17
1649873007072,MATH 142A,B02,083222,Chow; Bennett,27,0,30,3
1649873013095,MATH 193A,A01,083224,Staff,0,1,30,30
1649873013095,MATH 193A,A02,083225,Staff,4,0,30,26
1649873013095,MATH 193A,A03,083781,Staff,28,0,30,2
1649873013095,MATH 193A,A04,083782,Staff,27,0,30,3
1649873019118,MATH 197,001,091859,McAuley; Julian John,9999,0,9999,0
1649873025181,COGS 9,A01,083615,Staff,43,0,60,17
1649873031292,COGS 11,A01,083617,Boyle; Mary E. T.,36,0,40,4
1649873037317,COGS 13,A01,083071,Staff,16,0,40,24
1649873043339,COGS 14A,A01,092681,Staff,95,0,100,5
1649873049366,COGS 14B,A01,083073,Cheng; Tzu-Han,38,0,50,12
1649873055396,COGS 17,A01,092677,Staff,73,0,75,2
1649873061426,COGS 100,A01,083619,Staff,28,0,60,32
1649873067449,COGS 101A,A01,083621,Davis; Joshua Daniel,27,0,60,33
1649873073473,COGS 101B,A01,091572,Staff,39,0,60,21
1649873079502,COGS 101C,A01,083625,Delgado; Tania,25,0,30,5
1649873085533,COGS 107A,A01,083627,Boyle; Mary E. T.,31,0,60,29
1649873091565,COGS 118A,A01,083075,Staff,30,0,60,30
1649873097590,CSE 3,A50,083646,Miranda; Gregory Joseph,30,0,38,8
1649873097590,CSE 3,A51,083647,Miranda; Gregory Joseph,37,0,37,0
1649873103616,CSE 8A,A50,083650,Miranda; Gregory Joseph,24,0,40,16
1649873109640,CSE 11,A01,083080,Cao; Yingjun,1,0,40,39
1649873115664,CSE 12,A01,083652,Staff,81,0,100,19
1649873121687,CSE 15L,A01,083654,Staff,36,0,50,14
1649873121687,CSE 15L,A02,083655,Staff,49,0,50,1
1649873127714,CSE 20,A01,083657,Staff,73,0,80,7
1649873133744,CSE 30,A01,083084,Eldon; John,9,0,40,31
1649873139770,CSE 100,A01,083659,Cao; Yingjun,4,0,50,46
1649873145799,CSE 134B,A01,083661,Powell; Thomas Allan,0,17,65,65
1649873151823,CSE 140,A01,083663,Staff,44,0,75,31
1649873157865,CSE 140L,A01,083088,Eldon; John,38,0,75,37
1649873163895,CSE 175,A01,083665,Kumar; Rakesh,14,0,25,11
1649873169925,CSE 190,A00,092507,Staff,15,0,15,0
1649873175953,ECE 45,A01,083139,Staff,32,0,40,8
1649873181982,ECE 65,A50,083695,Staff,22,0,30,8
1649873188017,ECE 109,A01,091882,Touri; Behrouz,65,0,70,5
1649873194043,ECE 180,A00,083140,Abi Samra; Nicholas Camill,29,0,30,1
1649873194043,ECE 180,B00,083141,Abi Samra; Nicholas Camill,16,0,30,14
1649873200067,MATH 10A,A01,083735,Patchell; Gregory David,25,0,30,5
1649873200067,MATH 10A,A02,083736,Patchell; Gregory David,29,0,30,1
1649873200067,MATH 10A,A03,083737,Patchell; Gregory David,30,0,30,0
1649873206101,MATH 10B,A01,083207,Staff,21,0,30,9
1649873206101,MATH 10B,A02,083208,Staff,28,0,30,2
1649873206101,MATH 10B,B01,083739,Staff,26,0,30,4
1649873206101,MATH 10B,B02,083740,Staff,30,0,30,0
1649873212126,MATH 18,A01,083743,Staff,25,0,30,5
1649873212126,MATH 18,A02,083744,Staff,30,0,30,0
1649873212126,MATH 18,A03,083745,Staff,29,0,30,1
1649873212126,MATH 18,A04,083746,Staff,30,0,30,0
1649873212126,MATH 18,B01,083748,Staff,19,0,30,11
1649873212126,MATH 18,B02,083749,Staff,29,0,30,1
1649873212126,MATH 18,B03,083750,Staff,30,0,30,0
1649873212126,MATH 18,B04,083751,Staff,29,0,30,1
1649873218150,MATH 20A,A01,083754,Staff,39,0,40,1
1649873224172,MATH 20B,A01,083756,Staff,28,0,30,2
1649873224172,MATH 20B,A02,083757,Staff,30,0,30,0
1649873230202,MATH 20C,A01,083760,Staff,26,0,30,4
1649873230202,MATH 20C,A02,083761,Staff,30,0,30,0
1649873230202,MATH 20C,B01,083762,Staff,30,0,30,0
1649873230202,MATH 20C,B02,083763,Staff,30,0,30,0
1649873236231,MATH 20D,A01,083765,Staff,23,0,30,7
1649873236231,MATH 20D,A02,083766,Staff,30,0,30,0
1649873236231,MATH 20D,A03,083767,Staff,30,0,30,0
1649873242259,MATH 20E,A01,083771,Staff,21,0,30,9
1649873242259,MATH 20E,A02,083772,Staff,29,0,30,1
1649873242259,MATH 20E,B01,083773,Staff,25,0,30,5
1649873242259,MATH 20E,B02,083774,Staff,29,0,30,1
1649873248288,MATH 103A,A01,083777,Staff,0,0,30,30
1649873248288,MATH 103A,A02,083778,Staff,20,0,30,10
1649873248288,MATH 103A,B01,083779,Staff,13,0,30,17
1649873248288,MATH 103A,B02,083780,Staff,25,0,30,5
1649873254321,MATH 105,A01,085443,Staff,9,0,30,21
1649873260346,MATH 109,A01,083213,Anzaldo; Leesa B,28,0,30,2
1649873260346,MATH 109,A02,083214,Anzaldo; Leesa B,24,0,30,6
1649873260346,MATH 109,B01,083215,Anzaldo; Leesa B,27,0,30,3
1649873260346,MATH 109,B02,083216,Anzaldo; Leesa B,27,0,30,3
1649873266378,MATH 142A,A01,083219,Chow; Bennett,5,0,30,25
1649873266378,MATH 142A,A02,083220,Chow; Bennett,26,0,30,4
1649873266378,MATH 142A,B01,083221,Chow; Bennett,13,0,30,17
1649873266378,MATH 142A,B02,083222,Chow; Bennett,27,0,30,3
1649873272401,MATH 193A,A01,083224,Staff,0,1,30,30
1649873272401,MATH 193A,A02,083225,Staff,4,0,30,26
1649873272401,MATH 193A,A03,083781,Staff,28,0,30,2
1649873272401,MATH 193A,A04,083782,Staff,27,0,30,3
1649873278434,MATH 197,001,091859,McAuley; Julian John,9999,0,9999,0
1649873284491,COGS 9,A01,083615,Staff,43,0,60,17
1649873290518,COGS 11,A01,083617,Boyle; Mary E. T.,36,0,40,4
1649873296541,COGS 13,A01,083071,Staff,16,0,40,24
1649873302567,COGS 14A,A01,092681,Staff,95,0,100,5
1649873308590,COGS 14B,A01,083073,Cheng; Tzu-Han,38,0,50,12
1649873314612,COGS 17,A01,092677,Staff,73,0,75,2
1649873320635,COGS 100,A01,083619,Staff,28,0,60,32
1649873326658,COGS 101A,A01,083621,Davis; Joshua Daniel,27,0,60,33
1649873332681,COGS 101B,A01,091572,Staff,39,0,60,21
1649873338705,COGS 101C,A01,083625,Delgado; Tania,25,0,30,5
1649873344732,COGS 107A,A01,083627,Boyle; Mary E. T.,31,0,60,29
1649873350753,COGS 118A,A01,083075,Staff,30,0,60,30
1649873356777,CSE 3,A50,083646,Miranda; Gregory Joseph,29,0,38,9
1649873356777,CSE 3,A51,083647,Miranda; Gregory Joseph,37,0,37,0
1649873362805,CSE 8A,A50,083650,Miranda; Gregory Joseph,24,0,40,16
1649873368828,CSE 11,A01,083080,Cao; Yingjun,1,0,40,39
1649873374859,CSE 12,A01,083652,Staff,81,0,100,19
1649873380890,CSE 15L,A01,083654,Staff,36,0,50,14
1649873380890,CSE 15L,A02,083655,Staff,49,0,50,1
1649873386913,CSE 20,A01,083657,Staff,73,0,80,7
1649873392939,CSE 30,A01,083084,Eldon; John,9,0,40,31
1649873398966,CSE 100,A01,083659,Cao; Yingjun,3,0,50,47
1649873405006,CSE 134B,A01,083661,Powell; Thomas Allan,0,17,65,65
1649873411029,CSE 140,A01,083663,Staff,43,0,75,32
1649873417051,CSE 140L,A01,083088,Eldon; John,37,0,75,38
1649873423078,CSE 175,A01,083665,Kumar; Rakesh,14,0,25,11
1649873429101,CSE 190,A00,092507,Staff,15,0,15,0
1649873435132,ECE 45,A01,083139,Staff,32,0,40,8
1649873441159,ECE 65,A50,083695,Staff,22,0,30,8
1649873447188,ECE 109,A01,091882,Touri; Behrouz,65,0,70,5
1649873453216,ECE 180,A00,083140,Abi Samra; Nicholas Camill,29,0,30,1
1649873453216,ECE 180,B00,083141,Abi Samra; Nicholas Camill,15,0,30,15
1649873459243,MATH 10A,A01,083735,Patchell; Gregory David,25,0,30,5
1649873459243,MATH 10A,A02,083736,Patchell; Gregory David,29,0,30,1
1649873459243,MATH 10A,A03,083737,Patchell; Gregory David,30,0,30,0
1649873465276,MATH 10B,A01,083207,Staff,21,0,30,9
1649873465276,MATH 10B,A02,083208,Staff,28,0,30,2
1649873465276,MATH 10B,B01,083739,Staff,26,0,30,4
1649873465276,MATH 10B,B02,083740,Staff,30,0,30,0
1649873471306,MATH 18,A01,083743,Staff,25,0,30,5
1649873471306,MATH 18,A02,083744,Staff,30,0,30,0
1649873471306,MATH 18,A03,083745,Staff,29,0,30,1
1649873471306,MATH 18,A04,083746,Staff,30,0,30,0
1649873471306,MATH 18,B01,083748,Staff,19,0,30,11
1649873471306,MATH 18,B02,083749,Staff,29,0,30,1
1649873471306,MATH 18,B03,083750,Staff,30,0,30,0
1649873471306,MATH 18,B04,083751,Staff,29,0,30,1
1649873477329,MATH 20A,A01,083754,Staff,39,0,40,1
1649873483352,MATH 20B,A01,083756,Staff,28,0,30,2
1649873483352,MATH 20B,A02,083757,Staff,30,0,30,0
1649873489376,MATH 20C,A01,083760,Staff,26,0,30,4
1649873489376,MATH 20C,A02,083761,Staff,30,0,30,0
1649873489376,MATH 20C,B01,083762,Staff,30,0,30,0
1649873489376,MATH 20C,B02,083763,Staff,30,0,30,0
1649873495411,MATH 20D,A01,083765,Staff,23,0,30,7
1649873495411,MATH 20D,A02,083766,Staff,30,0,30,0
1649873495411,MATH 20D,A03,083767,Staff,30,0,30,0
1649873501445,MATH 20E,A01,083771,Staff,21,0,30,9
1649873501445,MATH 20E,A02,083772,Staff,29,0,30,1
1649873501445,MATH 20E,B01,083773,Staff,25,0,30,5
1649873501445,MATH 20E,B02,083774,Staff,29,0,30,1
1649873507473,MATH 103A,A01,083777,Staff,0,0,30,30
1649873507473,MATH 103A,A02,083778,Staff,20,0,30,10
1649873507473,MATH 103A,B01,083779,Staff,13,0,30,17
1649873507473,MATH 103A,B02,083780,Staff,25,0,30,5
1649873513501,MATH 105,A01,085443,Staff,9,0,30,21
1649873519526,MATH 109,A01,083213,Anzaldo; Leesa B,28,0,30,2
1649873519526,MATH 109,A02,083214,Anzaldo; Leesa B,24,0,30,6
1649873519526,MATH 109,B01,083215,Anzaldo; Leesa B,27,0,30,3
1649873519526,MATH 109,B02,083216,Anzaldo; Leesa B,27,0,30,3
1649873525564,MATH 142A,A01,083219,Chow; Bennett,5,0,30,25
1649873525564,MATH 142A,A02,083220,Chow; Bennett,26,0,30,4
1649873525564,MATH 142A,B01,083221,Chow; Bennett,13,0,30,17
1649873525564,MATH 142A,B02,083222,Chow; Bennett,27,0,30,3
1649873531587,MATH 193A,A01,083224,Staff,0,1,30,30
1649873531587,MATH 193A,A02,083225,Staff,4,0,30,26
1649873531587,MATH 193A,A03,083781,Staff,28,0,30,2
1649873531587,MATH 193A,A04,083782,Staff,27,0,30,3
1649873537612,MATH 197,001,091859,McAuley; Julian John,9999,0,9999,0
1649873543664,COGS 9,A01,083615,Staff,43,0,60,17
1649873549691,COGS 11,A01,083617,Boyle; Mary E. T.,36,0,40,4
1649873555714,COGS 13,A01,083071,Staff,15,0,40,25
1649873561737,COGS 14A,A01,092681,Staff,95,0,100,5
1649873567762,COGS 14B,A01,083073,Cheng; Tzu-Han,38,0,50,12
1649873573794,COGS 17,A01,092677,Staff,73,0,75,2
1649873579817,COGS 100,A01,083619,Staff,28,0,60,32
1649873585847,COGS 101A,A01,083621,Davis; Joshua Daniel,26,0,60,34
1649873591874,COGS 101B,A01,091572,Staff,39,0,60,21
1649873597902,COGS 101C,A01,083625,Delgado; Tania,25,0,30,5
1649873603932,COGS 107A,A01,083627,Boyle; Mary E. T.,31,0,60,29
1649873609953,COGS 118A,A01,083075,Staff,30,0,60,30
1649873615979,CSE 3,A50,083646,Miranda; Gregory Joseph,29,0,38,9
1649873615979,CSE 3,A51,083647,Miranda; Gregory Joseph,37,0,37,0
1649873622006,CSE 8A,A50,083650,Miranda; Gregory Joseph,24,0,40,16
1649873628136,CSE 11,A01,083080,Cao; Yingjun,0,1,40,40
1649873634160,CSE 12,A01,083652,Staff,81,0,100,19
1649873640189,CSE 15L,A01,083654,Staff,36,0,50,14
1649873640189,CSE 15L,A02,083655,Staff,49,0,50,1
1649873646215,CSE 20,A01,083657,Staff,73,0,80,7
1649873652243,CSE 30,A01,083084,Eldon; John,9,0,40,31
1649873658266,CSE 100,A01,083659,Cao; Yingjun,3,0,50,47
1649873664287,CSE 134B,A01,083661,Powell; Thomas Allan,0,18,65,65
1649873670318,CSE 140,A01,083663,Staff,43,0,75,32
1649873676353,CSE 140L,A01,083088,Eldon; John,37,0,75,38
1649873682377,CSE 175,A01,083665,Kumar; Rakesh,14,0,25,11
1649873688404,CSE 190,A00,092507,Staff,15,0,15,0
1649873694435,ECE 45,A01,083139,Staff,32,0,40,8
1649873700459,ECE 65,A50,083695,Staff,21,0,30,9
1649873706484,ECE 109,A01,091882,Touri; Behrouz,65,0,70,5
1649873712511,ECE 180,A00,083140,Abi Samra; Nicholas Camill,29,0,30,1
1649873712511,ECE 180,B00,083141,Abi Samra; Nicholas Camill,15,0,30,15
1649873718535,MATH 10A,A01,083735,Patchell; Gregory David,25,0,30,5
1649873718535,MATH 10A,A02,083736,Patchell; Gregory David,29,0,30,1
1649873718535,MATH 10A,A03,083737,Patchell; Gregory David,30,0,30,0
1649873724562,MATH 10B,A01,083207,Staff,21,0,30,9
1649873724562,MATH 10B,A02,083208,Staff,28,0,30,2
1649873724562,MATH 10B,B01,083739,Staff,26,0,30,4
1649873724562,MATH 10B,B02,083740,Staff,30,0,30,0
1649873730597,MATH 18,A01,083743,Staff,25,0,30,5
1649873730597,MATH 18,A02,083744,Staff,30,0,30,0
1649873730597,MATH 18,A03,083745,Staff,29,0,30,1
1649873730597,MATH 18,A04,083746,Staff,30,0,30,0
1649873730597,MATH 18,B01,083748,Staff,19,0,30,11
1649873730597,MATH 18,B02,083749,Staff,29,0,30,1
1649873730597,MATH 18,B03,083750,Staff,30,0,30,0
1649873730597,MATH 18,B04,083751,Staff,29,0,30,1
1649873736626,MATH 20A,A01,083754,Staff,39,0,40,1
1649873742649,MATH 20B,A01,083756,Staff,28,0,30,2
1649873742649,MATH 20B,A02,083757,Staff,30,0,30,0
1649873748680,MATH 20C,A01,083760,Staff,26,0,30,4
1649873748680,MATH 20C,A02,083761,Staff,30,0,30,0
1649873748680,MATH 20C,B01,083762,Staff,30,0,30,0
1649873748680,MATH 20C,B02,083763,Staff,30,0,30,0
1649873754721,MATH 20D,A01,083765,Staff,23,0,30,7
1649873754721,MATH 20D,A02,083766,Staff,30,0,30,0
1649873754721,MATH 20D,A03,083767,Staff,30,0,30,0
1649873760745,MATH 20E,A01,083771,Staff,21,0,30,9
1649873760745,MATH 20E,A02,083772,Staff,29,0,30,1
1649873760745,MATH 20E,B01,083773,Staff,25,0,30,5
1649873760745,MATH 20E,B02,083774,Staff,29,0,30,1
1649873766773,MATH 103A,A01,083777,Staff,0,0,30,30
1649873766773,MATH 103A,A02,083778,Staff,20,0,30,10
1649873766773,MATH 103A,B01,083779,Staff,13,0,30,17
1649873766773,MATH 103A,B02,083780,Staff,25,0,30,5
1649873772796,MATH 105,A01,085443,Staff,9,0,30,21
1649873778835,MATH 109,A01,083213,Anzaldo; Leesa B,28,0,30,2
1649873778835,MATH 109,A02,083214,Anzaldo; Leesa B,24,0,30,6
1649873778835,MATH 109,B01,083215,Anzaldo; Leesa B,27,0,30,3
1649873778835,MATH 109,B02,083216,Anzaldo; Leesa B,27,0,30,3
1649873784859,MATH 142A,A01,083219,Chow; Bennett,4,0,30,26
1649873784859,MATH 142A,A02,083220,Chow; Bennett,26,0,30,4
1649873784859,MATH 142A,B01,083221,Chow; Bennett,13,0,30,17
1649873784859,MATH 142A,B02,083222,Chow; Bennett,27,0,30,3
1649873790888,MATH 193A,A01,083224,Staff,0,1,30,30
1649873790888,MATH 193A,A02,083225,Staff,4,0,30,26
1649873790888,MATH 193A,A03,083781,Staff,28,0,30,2
1649873790888,MATH 193A,A04,083782,Staff,27,0,30,3
1649873796917,MATH 197,001,091859,McAuley; Julian John,9999,0,9999,0
1649873802968,COGS 9,A01,083615,Staff,43,0,60,17
1649873809009,COGS 11,A01,083617,Boyle; Mary E. T.,36,0,40,4
1649873815033,COGS 13,A01,083071,Staff,15,0,40,25
1649873821057,COGS 14A,A01,092681,Staff,95,0,100,5
1649873827084,COGS 14B,A01,083073,Cheng; Tzu-Han,38,0,50,12
1649873833106,COGS 17,A01,092677,Staff,73,0,75,2
1649873839135,COGS 100,A01,083619,Staff,28,0,60,32
1649873845163,COGS 101A,A01,083621,Davis; Joshua Daniel,26,0,60,34
1649873851188,COGS 101B,A01,091572,Staff,39,0,60,21
1649873857210,COGS 101C,A01,083625,Delgado; Tania,25,0,30,5
1649873863237,COGS 107A,A01,083627,Boyle; Mary E. T.,31,0,60,29
1649873869262,COGS 118A,A01,083075,Staff,30,0,60,30
1649873875297,CSE 3,A50,083646,Miranda; Gregory Joseph,29,0,38,9
1649873875297,CSE 3,A51,083647,Miranda; Gregory Joseph,37,0,37,0
1649873881323,CSE 8A,A50,083650,Miranda; Gregory Joseph,24,0,40,16
1649873887347,CSE 11,A01,083080,Cao; Yingjun,0,1,40,40
1649873893372,CSE 12,A01,083652,Staff,81,0,100,19
1649873899404,CSE 15L,A01,083654,Staff,36,0,50,14
1649873899404,CSE 15L,A02,083655,Staff,49,0,50,1
1649873905428,CSE 20,A01,083657,Staff,73,0,80,7
1649873911452,CSE 30,A01,083084,Eldon; John,9,0,40,31
1649873917522,CSE 100,A01,083659,Cao; Yingjun,3,0,50,47
1649873923554,CSE 134B,A01,083661,Powell; Thomas Allan,0,18,65,65
1649873929586,CSE 140,A01,083663,Staff,43,0,75,32
1649873935609,CSE 140L,A01,083088,Eldon; John,37,0,75,38
1649873941633,CSE 175,A01,083665,Kumar; Rakesh,14,0,25,11
1649873947670,CSE 190,A00,092507,Staff,15,0,15,0
1649873953707,ECE 45,A01,083139,Staff,32,0,40,8
1649873959758,ECE 65,A50,083695,Staff,21,0,30,9
1649873965784,ECE 109,A01,091882,Touri; Behrouz,65,0,70,5
1649873971810,ECE 180,A00,083140,Abi Samra; Nicholas Camill,29,0,30,1
1649873971810,ECE 180,B00,083141,Abi Samra; Nicholas Camill,15,0,30,15
1649873977834,MATH 10A,A01,083735,Patchell; Gregory David,25,0,30,5
1649873977834,MATH 10A,A02,083736,Patchell; Gregory David,29,0,30,1
1649873977834,MATH 10A,A03,083737,Patchell; Gregory David,30,0,30,0
1649873983864,MATH 10B,A01,083207,Staff,21,0,30,9
1649873983864,MATH 10B,A02,083208,Staff,28,0,30,2
1649873983864,MATH 10B,B01,083739,Staff,26,0,30,4
1649873983864,MATH 10B,B02,083740,Staff,30,0,30,0
1649873989890,MATH 18,A01,083743,Staff,25,0,30,5
1649873989890,MATH 18,A02,083744,Staff,30,0,30,0
1649873989890,MATH 18,A03,083745,Staff,29,0,30,1
1649873989890,MATH 18,A04,083746,Staff,30,0,30,0
1649873989890,MATH 18,B01,083748,Staff,19,0,30,11
1649873989890,MATH 18,B02,083749,Staff,29,0,30,1
1649873989890,MATH 18,B03,083750,Staff,30,0,30,0
1649873989890,MATH 18,B04,083751,Staff,29,0,30,1
1649873995918,MATH 20A,A01,083754,Staff,39,0,40,1
1649874001942,MATH 20B,A01,083756,Staff,28,0,30,2
1649874001942,MATH 20B,A02,083757,Staff,30,0,30,0
1649874007969,MATH 20C,A01,083760,Staff,26,0,30,4
1649874007969,MATH 20C,A02,083761,Staff,30,0,30,0
1649874007969,MATH 20C,B01,083762,Staff,30,0,30,0
1649874007969,MATH 20C,B02,083763,Staff,30,0,30,0
1649874013995,MATH 20D,A01,083765,Staff,23,0,30,7
1649874013995,MATH 20D,A02,083766,Staff,30,0,30,0
1649874013995,MATH 20D,A03,083767,Staff,30,0,30,0
1649874020024,MATH 20E,A01,083771,Staff,21,0,30,9
1649874020024,MATH 20E,A02,083772,Staff,29,0,30,1
1649874020024,MATH 20E,B01,083773,Staff,25,0,30,5
1649874020024,MATH 20E,B02,083774,Staff,29,0,30,1
1649874034588,MATH 103A,A01,083777,Staff,0,0,30,30
1649874034588,MATH 103A,A02,083778,Staff,20,0,30,10
1649874034588,MATH 103A,B01,083779,Staff,13,0,30,17
1649874034588,MATH 103A,B02,083780,Staff,25,0,30,5
1649874040619,MATH 105,A01,085443,Staff,9,0,30,21
1649874046650,MATH 109,A01,083213,Anzaldo; Leesa B,28,0,30,2
1649874046650,MATH 109,A02,083214,Anzaldo; Leesa B,24,0,30,6
1649874046650,MATH 109,B01,083215,Anzaldo; Leesa B,27,0,30,3
1649874046650,MATH 109,B02,083216,Anzaldo; Leesa B,27,0,30,3
1649874052676,MATH 142A,A01,083219,Chow; Bennett,4,0,30,26
1649874052676,MATH 142A,A02,083220,Chow; Bennett,26,0,30,4
1649874052676,MATH 142A,B01,083221,Chow; Bennett,12,0,30,18
1649874052676,MATH 142A,B02,083222,Chow; Bennett,27,0,30,3
1649874058701,MATH 193A,A01,083224,Staff,0,1,30,30
1649874058701,MATH 193A,A02,083225,Staff,4,0,30,26
1649874058701,MATH 193A,A03,083781,Staff,28,0,30,2
1649874058701,MATH 193A,A04,083782,Staff,27,0,30,3
1649874064730,MATH 197,001,091859,McAuley; Julian John,9999,0,9999,0
1649874070798,COGS 9,A01,083615,Staff,42,0,60,18
1649874076831,COGS 11,A01,083617,Boyle; Mary E. T.,36,0,40,4
1649874082856,COGS 13,A01,083071,Staff,15,0,40,25
1649874088880,COGS 14A,A01,092681,Staff,95,0,100,5
1649874094904,COGS 14B,A01,083073,Cheng; Tzu-Han,38,0,50,12
1649874100928,COGS 17,A01,092677,Staff,73,0,75,2
1649874106961,COGS 100,A01,083619,Staff,28,0,60,32
1649874112984,COGS 101A,A01,083621,Davis; Joshua Daniel,26,0,60,34
1649874119014,COGS 101B,A01,091572,Staff,39,0,60,21
1649874125038,COGS 101C,A01,083625,Delgado; Tania,25,0,30,5
1649874131068,COGS 107A,A01,083627,Boyle; Mary E. T.,31,0,60,29
1649874137100,COGS 118A,A01,083075,Staff,30,0,60,30
1649874143128,CSE 3,A50,083646,Miranda; Gregory Joseph,29,0,38,9
1649874143128,CSE 3,A51,083647,Miranda; Gregory Joseph,37,0,37,0
1649874149155,CSE 8A,A50,083650,Miranda; Gregory Joseph,24,0,40,16
1649874155178,CSE 11,A01,083080,Cao; Yingjun,0,1,40,40
1649874161204,CSE 12,A01,083652,Staff,81,0,100,19
1649874167227,CSE 15L,A01,083654,Staff,36,0,50,14
1649874167227,CSE 15L,A02,083655,Staff,49,0,50,1
1649874173264,CSE 20,A01,083657,Staff,73,0,80,7
1649874179286,CSE 30,A01,083084,Eldon; John,8,0,40,32
1649874185314,CSE 100,A01,083659,Cao; Yingjun,2,0,50,48
1649874191341,CSE 134B,A01,083661,Powell; Thomas Allan,0,18,65,65
1649874197366,CSE 140,A01,083663,Staff,43,0,75,32
1649874203399,CSE 140L,A01,083088,Eldon; John,37,0,75,38
1649874209438,CSE 175,A01,083665,Kumar; Rakesh,14,0,25,11
1649874215479,CSE 190,A00,092507,Staff,15,0,15,0
1649874221501,ECE 45,A01,083139,Staff,32,0,40,8
1649874227529,ECE 65,A50,083695,Staff,21,0,30,9
1649874233647,ECE 109,A01,091882,Touri; Behrouz,65,0,70,5
1649874239683,ECE 180,A00,083140,Abi Samra; Nicholas Camill,28,0,30,2
1649874239683,ECE 180,B00,083141,Abi Samra; Nicholas Camill,13,0,30,17
1649874245712,MATH 10A,A01,083735,Patchell; Gregory David,25,0,30,5
1649874245712,MATH 10A,A02,083736,Patchell; Gregory David,29,0,30,1
1649874245712,MATH 10A,A03,083737,Patchell; Gregory David,30,0,30,0
1649874251744,MATH 10B,A01,083207,Staff,21,0,30,9
1649874251744,MATH 10B,A02,083208,Staff,28,0,30,2
1649874251744,MATH 10B,B01,083739,Staff,26,0,30,4
1649874251744,MATH 10B,B02,083740,Staff,30,0,30,0
1649874257771,MATH 18,A01,083743,Staff,25,0,30,5
1649874257771,MATH 18,A02,083744,Staff,30,0,30,0
1649874257771,MATH 18,A03,083745,Staff,29,0,30,1
1649874257771,MATH 18,A04,083746,Staff,30,0,30,0
1649874257771,MATH 18,B01,083748,Staff,19,0,30,11
1649874257771,MATH 18,B02,083749,Staff,29,0,30,1
1649874257771,MATH 18,B03,083750,Staff,30,0,30,0
1649874257771,MATH 18,B04,083751,Staff,29,0,30,1
1649874263799,MATH 20A,A01,083754,Staff,39,0,40,1
1649874269826,MATH 20B,A01,083756,Staff,28,0,30,2
1649874269826,MATH 20B,A02,083757,Staff,30,0,30,0
1649874275860,MATH 20C,A01,083760,Staff,26,0,30,4
1649874275860,MATH 20C,A02,083761,Staff,30,0,30,0
1649874275860,MATH 20C,B01,083762,Staff,30,0,30,0
1649874275860,MATH 20C,B02,083763,Staff,30,0,30,0
1649874281892,MATH 20D,A01,083765,Staff,23,0,30,7
1649874281892,MATH 20D,A02,083766,Staff,30,0,30,0
1649874281892,MATH 20D,A03,083767,Staff,30,0,30,0
1649874287929,MATH 20E,A01,083771,Staff,21,0,30,9
1649874287929,MATH 20E,A02,083772,Staff,29,0,30,1
1649874287929,MATH 20E,B01,083773,Staff,25,0,30,5
1649874287929,MATH 20E,B02,083774,Staff,29,0,30,1
1649874293952,MATH 103A,A01,083777,Staff,0,0,30,30
1649874293952,MATH 103A,A02,083778,Staff,19,0,30,11
1649874293952,MATH 103A,B01,083779,Staff,13,0,30,17
1649874293952,MATH 103A,B02,083780,Staff,25,0,30,5
1649874299975,MATH 105,A01,085443,Staff,9,0,30,21
1649874306012,MATH 109,A01,083213,Anzaldo; Leesa B,28,0,30,2
1649874306012,MATH 109,A02,083214,Anzaldo; Leesa B,24,0,30,6
1649874306012,MATH 109,B01,083215,Anzaldo; Leesa B,27,0,30,3
1649874306012,MATH 109,B02,083216,Anzaldo; Leesa B,27,0,30,3
1649874312046,MATH 142A,A01,083219,Chow; Bennett,3,0,30,27
1649874312046,MATH 142A,A02,083220,Chow; Bennett,26,0,30,4
1649874312046,MATH 142A,B01,083221,Chow; Bennett,13,0,30,17
1649874312046,MATH 142A,B02,083222,Chow; Bennett,27,0,30,3
1649874318073,MATH 193A,A01,083224,Staff,0,1,30,30
1649874318073,MATH 193A,A02,083225,Staff,4,0,30,26
1649874318073,MATH 193A,A03,083781,Staff,28,0,30,2
1649874318073,MATH 193A,A04,083782,Staff,27,0,30,3
1649874324099,MATH 197,001,091859,McAuley; Julian John,9999,0,9999,0
1649874330155,COGS 9,A01,083615,Staff,42,0,60,18
1649874336178,COGS 11,A01,083617,Boyle; Mary E. T.,36,0,40,4
1649874342205,COGS 13,A01,083071,Staff,15,0,40,25
1649874348239,COGS 14A,A01,092681,Staff,95,0,100,5
1649874354277,COGS 14B,A01,083073,Cheng; Tzu-Han,38,0,50,12
1649874360300,COGS 17,A01,092677,Staff,73,0,75,2
1649874366326,COGS 100,A01,083619,Staff,28,0,60,32
1649874372355,COGS 101A,A01,083621,Davis; Joshua Daniel,26,0,60,34
1649874378379,COGS 101B,A01,091572,Staff,39,0,60,21
1649874384409,COGS 101C,A01,083625,Delgado; Tania,25,0,30,5
1649874390436,COGS 107A,A01,083627,Boyle; Mary E. T.,31,0,60,29
1649874396469,COGS 118A,A01,083075,Staff,30,0,60,30
1649874402502,CSE 3,A50,083646,Miranda; Gregory Joseph,29,0,38,9
1649874402502,CSE 3,A51,083647,Miranda; Gregory Joseph,37,0,37,0
1649874408536,CSE 8A,A50,083650,Miranda; Gregory Joseph,24,0,40,16
1649874414562,CSE 11,A01,083080,Cao; Yingjun,0,1,40,40
1649874420598,CSE 12,A01,083652,Staff,80,0,100,20
1649874426625,CSE 15L,A01,083654,Staff,36,0,50,14
1649874426625,CSE 15L,A02,083655,Staff,49,0,50,1
1649874432650,CSE 20,A01,083657,Staff,73,0,80,7
1649874438675,CSE 30,A01,083084,Eldon; John,8,0,40,32
1649874444697,CSE 100,A01,083659,Cao; Yingjun,2,0,50,48
1649874450723,CSE 134B,A01,083661,Powell; Thomas Allan,0,18,65,65
1649874456746,CSE 140,A01,083663,Staff,43,0,75,32
1649874462773,CSE 140L,A01,083088,Eldon; John,37,0,75,38
1649874468797,CSE 175,A01,083665,Kumar; Rakesh,14,0,25,11
1649874474820,CSE 190,A00,092507,Staff,15,0,15,0
1649874480842,ECE 45,A01,083139,Staff,32,0,40,8
1649874486866,ECE 65,A50,083695,Staff,21,0,30,9
1649874492892,ECE 109,A01,091882,Touri; Behrouz,65,0,70,5
1649874498919,ECE 180,A00,083140,Abi Samra; Nicholas Camill,28,0,30,2
1649874498919,ECE 180,B00,083141,Abi Samra; Nicholas Camill,13,0,30,17
1649874504942,MATH 10A,A01,083735,Patchell; Gregory David,25,0,30,5
1649874504942,MATH 10A,A02,083736,Patchell; Gregory David,29,0,30,1
1649874504942,MATH 10A,A03,083737,Patchell; Gregory David,30,0,30,0
1649874510973,MATH 10B,A01,083207,Staff,21,0,30,9
1649874510973,MATH 10B,A02,083208,Staff,28,0,30,2
1649874510973,MATH 10B,B01,083739,Staff,26,0,30,4
1649874510973,MATH 10B,B02,083740,Staff,30,0,30,0
1649874517005,MATH 18,A01,083743,Staff,25,0,30,5
1649874517005,MATH 18,A02,083744,Staff,30,0,30,0
1649874517005,MATH 18,A03,083745,Staff,29,0,30,1
1649874517005,MATH 18,A04,083746,Staff,30,0,30,0
1649874517005,MATH 18,B01,083748,Staff,19,0,30,11
1649874517005,MATH 18,B02,083749,Staff,29,0,30,1
1649874517005,MATH 18,B03,083750,Staff,30,0,30,0
1649874517005,MATH 18,B04,083751,Staff,29,0,30,1
1649874523032,MATH 20A,A01,083754,Staff,39,0,40,1
1649874529069,MATH 20B,A01,083756,Staff,28,0,30,2
1649874529069,MATH 20B,A02,083757,Staff,30,0,30,0
1649874535096,MATH 20C,A01,083760,Staff,26,0,30,4
1649874535096,MATH 20C,A02,083761,Staff,30,0,30,0
1649874535096,MATH 20C,B01,083762,Staff,30,0,30,0
1649874535096,MATH 20C,B02,083763,Staff,30,0,30,0
1649874541143,MATH 20D,A01,083765,Staff,23,0,30,7
1649874541143,MATH 20D,A02,083766,Staff,30,0,30,0
1649874541143,MATH 20D,A03,083767,Staff,30,0,30,0
1649874547170,MATH 20E,A01,083771,Staff,21,0,30,9
1649874547170,MATH 20E,A02,083772,Staff,29,0,30,1
1649874547170,MATH 20E,B01,083773,Staff,25,0,30,5
1649874547170,MATH 20E,B02,083774,Staff,29,0,30,1
1649874553204,MATH 103A,A01,083777,Staff,0,0,30,30
1649874553204,MATH 103A,A02,083778,Staff,19,0,30,11
1649874553204,MATH 103A,B01,083779,Staff,13,0,30,17
1649874553204,MATH 103A,B02,083780,Staff,25,0,30,5
1649874559230,MATH 105,A01,085443,Staff,8,0,30,22
1649874565257,MATH 109,A01,083213,Anzaldo; Leesa B,28,0,30,2
1649874565257,MATH 109,A02,083214,Anzaldo; Leesa B,24,0,30,6
1649874565257,MATH 109,B01,083215,Anzaldo; Leesa B,27,0,30,3
1649874565257,MATH 109,B02,083216,Anzaldo; Leesa B,27,0,30,3
1649874571281,MATH 142A,A01,083219,Chow; Bennett,3,0,30,27
1649874571281,MATH 142A,A02,083220,Chow; Bennett,26,0,30,4
1649874571281,MATH 142A,B01,083221,Chow; Bennett,12,0,30,18
1649874571281,MATH 142A,B02,083222,Chow; Bennett,27,0,30,3
1649874577309,MATH 193A,A01,083224,Staff,0,1,30,30
1649874577309,MATH 193A,A02,083225,Staff,4,0,30,26
1649874577309,MATH 193A,A03,083781,Staff,28,0,30,2
1649874577309,MATH 193A,A04,083782,Staff,27,0,30,3
1649874583339,MATH 197,001,091859,McAuley; Julian John,9999,0,9999,0
1649874589398,COGS 9,A01,083615,Staff,43,0,60,17
1649874595445,COGS 11,A01,083617,Boyle; Mary E. T.,36,0,40,4
1649874601470,COGS 13,A01,083071,Staff,15,0,40,25
1649874607495,COGS 14A,A01,092681,Staff,95,0,100,5
1649874613519,COGS 14B,A01,083073,Cheng; Tzu-Han,38,0,50,12
1649874619544,COGS 17,A01,092677,Staff,73,0,75,2
1649874625567,COGS 100,A01,083619,Staff,28,0,60,32
1649874631594,COGS 101A,A01,083621,Davis; Joshua Daniel,26,0,60,34
1649874637619,COGS 101B,A01,091572,Staff,39,0,60,21
1649874643643,COGS 101C,A01,083625,Delgado; Tania,25,0,30,5
1649874649666,COGS 107A,A01,083627,Boyle; Mary E. T.,31,0,60,29
1649874655691,COGS 118A,A01,083075,Staff,30,0,60,30
1649874661719,CSE 3,A50,083646,Miranda; Gregory Joseph,29,0,38,9
1649874661719,CSE 3,A51,083647,Miranda; Gregory Joseph,37,0,37,0
1649874667744,CSE 8A,A50,083650,Miranda; Gregory Joseph,24,0,40,16
1649874673770,CSE 11,A01,083080,Cao; Yingjun,0,1,40,40
1649874679795,CSE 12,A01,083652,Staff,80,0,100,20
1649874685830,CSE 15L,A01,083654,Staff,36,0,50,14
1649874685830,CSE 15L,A02,083655,Staff,49,0,50,1
1649874691853,CSE 20,A01,083657,Staff,73,0,80,7
1649874697886,CSE 30,A01,083084,Eldon; John,8,0,40,32
1649874703909,CSE 100,A01,083659,Cao; Yingjun,2,0,50,48
1649874709933,CSE 134B,A01,083661,Powell; Thomas Allan,0,18,65,65
1649874715962,CSE 140,A01,083663,Staff,43,0,75,32
1649874722008,CSE 140L,A01,083088,Eldon; John,37,0,75,38
1649874728043,CSE 175,A01,083665,Kumar; Rakesh,14,0,25,11
1649874734070,CSE 190,A00,092507,Staff,15,0,15,0
1649874740093,ECE 45,A01,083139,Staff,32,0,40,8
1649874746124,ECE 65,A50,083695,Staff,21,0,30,9
1649874752148,ECE 109,A01,091882,Touri; Behrouz,65,0,70,5
1649874758186,ECE 180,A00,083140,Abi Samra; Nicholas Camill,28,0,30,2
1649874758186,ECE 180,B00,083141,Abi Samra; Nicholas Camill,13,0,30,17
1649874764225,MATH 10A,A01,083735,Patchell; Gregory David,25,0,30,5
1649874764225,MATH 10A,A02,083736,Patchell; Gregory David,29,0,30,1
1649874764225,MATH 10A,A03,083737,Patchell; Gregory David,30,0,30,0
1649874770248,MATH 10B,A01,083207,Staff,20,0,30,10
1649874770248,MATH 10B,A02,083208,Staff,28,0,30,2
1649874770248,MATH 10B,B01,083739,Staff,26,0,30,4
1649874770248,MATH 10B,B02,083740,Staff,30,0,30,0
1649874776294,MATH 18,A01,083743,Staff,25,0,30,5
1649874776294,MATH 18,A02,083744,Staff,29,0,30,1
1649874776294,MATH 18,A03,083745,Staff,29,0,30,1
1649874776294,MATH 18,A04,083746,Staff,30,0,30,0
1649874776294,MATH 18,B01,083748,Staff,19,0,30,11
1649874776294,MATH 18,B02,083749,Staff,29,0,30,1
1649874776294,MATH 18,B03,083750,Staff,30,0,30,0
1649874776294,MATH 18,B04,083751,Staff,29,0,30,1
1649874782321,MATH 20A,A01,083754,Staff,39,0,40,1
1649874788346,MATH 20B,A01,083756,Staff,28,0,30,2
1649874788346,MATH 20B,A02,083757,Staff,30,0,30,0
1649874794373,MATH 20C,A01,083760,Staff,26,0,30,4
1649874794373,MATH 20C,A02,083761,Staff,30,0,30,0
1649874794373,MATH 20C,B01,083762,Staff,30,0,30,0
1649874794373,MATH 20C,B02,083763,Staff,30,0,30,0
1649874800397,MATH 20D,A01,083765,Staff,23,0,30,7
1649874800397,MATH 20D,A02,083766,Staff,30,0,30,0
1649874800397,MATH 20D,A03,083767,Staff,30,0,30,0
1649874806419,MATH 20E,A01,083771,Staff,21,0,30,9
1649874806419,MATH 20E,A02,083772,Staff,29,0,30,1
1649874806419,MATH 20E,B01,083773,Staff,25,0,30,5
1649874806419,MATH 20E,B02,083774,Staff,29,0,30,1
1649874812444,MATH 103A,A01,083777,Staff,0,0,30,30
1649874812444,MATH 103A,A02,083778,Staff,19,0,30,11
1649874812444,MATH 103A,B01,083779,Staff,13,0,30,17
1649874812444,MATH 103A,B02,083780,Staff,25,0,30,5
1649874818487,MATH 105,A01,085443,Staff,8,0,30,22
1649874824515,MATH 109,A01,083213,Anzaldo; Leesa B,28,0,30,2
1649874824515,MATH 109,A02,083214,Anzaldo; Leesa B,23,0,30,7
1649874824515,MATH 109,B01,083215,Anzaldo; Leesa B,27,0,30,3
1649874824515,MATH 109,B02,083216,Anzaldo; Leesa B,27,0,30,3
1649874830644,MATH 142A,A01,083219,Chow; Bennett,3,0,30,27
1649874830644,MATH 142A,A02,083220,Chow; Bennett,26,0,30,4
1649874830644,MATH 142A,B01,083221,Chow; Bennett,11,0,30,19
1649874830644,MATH 142A,B02,083222,Chow; Bennett,26,0,30,4
1649874836666,MATH 193A,A01,083224,Staff,0,1,30,30
1649874836666,MATH 193A,A02,083225,Staff,4,0,30,26
1649874836666,MATH 193A,A03,083781,Staff,28,0,30,2
1649874836666,MATH 193A,A04,083782,Staff,27,0,30,3
1649874842696,MATH 197,001,091859,McAuley; Julian John,9999,0,9999,0
1649874848749,COGS 9,A01,083615,Staff,42,0,60,18
1649874854775,COGS 11,A01,083617,Boyle; Mary E. T.,36,0,40,4
1649874860802,COGS 13,A01,083071,Staff,15,0,40,25
1649874866839,COGS 14A,A01,092681,Staff,93,0,100,7
1649874872863,COGS 14B,A01,083073,Cheng; Tzu-Han,38,0,50,12
1649874878894,COGS 17,A01,092677,Staff,73,0,75,2
1649874884923,COGS 100,A01,083619,Staff,28,0,60,32
1649874890945,COGS 101A,A01,083621,Davis; Joshua Daniel,25,0,60,35
1649874896970,COGS 101B,A01,091572,Staff,39,0,60,21
1649874902995,COGS 101C,A01,083625,Delgado; Tania,25,0,30,5
1649874909018,COGS 107A,A01,083627,Boyle; Mary E. T.,31,0,60,29
1649874915042,COGS 118A,A01,083075,Staff,30,0,60,30
1649874921067,CSE 3,A50,083646,Miranda; Gregory Joseph,29,0,38,9
1649874921067,CSE 3,A51,083647,Miranda; Gregory Joseph,37,0,37,0
1649874927100,CSE 8A,A50,083650,Miranda; Gregory Joseph,24,0,40,16
1649874933122,CSE 11,A01,083080,Cao; Yingjun,0,2,40,40
1649874939155,CSE 12,A01,083652,Staff,80,0,100,20
1649874945181,CSE 15L,A01,083654,Staff,36,0,50,14
1649874945181,CSE 15L,A02,083655,Staff,49,0,50,1
1649874951208,CSE 20,A01,083657,Staff,73,0,80,7
1649874957231,CSE 30,A01,083084,Eldon; John,8,0,40,32
1649874963261,CSE 100,A01,083659,Cao; Yingjun,1,0,50,49
1649874969288,CSE 134B,A01,083661,Powell; Thomas Allan,0,18,65,65
1649874975328,CSE 140,A01,083663,Staff,43,0,75,32
1649874981351,CSE 140L,A01,083088,Eldon; John,37,0,75,38
1649874987374,CSE 175,A01,083665,Kumar; Rakesh,14,0,25,11
1649874993397,CSE 190,A00,092507,Staff,15,0,15,0
1649874999430,ECE 45,A01,083139,Staff,32,0,40,8
1649875005459,ECE 65,A50,083695,Staff,21,0,30,9
1649875011482,ECE 109,A01,091882,Touri; Behrouz,65,0,70,5
1649875017509,ECE 180,A00,083140,Abi Samra; Nicholas Camill,28,0,30,2
1649875017509,ECE 180,B00,083141,Abi Samra; Nicholas Camill,13,0,30,17
1649875023549,MATH 10A,A01,083735,Patchell; Gregory David,25,0,30,5
1649875023549,MATH 10A,A02,083736,Patchell; Gregory David,28,0,30,2
1649875023549,MATH 10A,A03,083737,Patchell; Gregory David,29,0,30,1
1649875029577,MATH 10B,A01,083207,Staff,20,0,30,10
1649875029577,MATH 10B,A02,083208,Staff,28,0,30,2
1649875029577,MATH 10B,B01,083739,Staff,26,0,30,4
1649875029577,MATH 10B,B02,083740,Staff,30,0,30,0
1649875035618,MATH 18,A01,083743,Staff,25,0,30,5
1649875035618,MATH 18,A02,083744,Staff,29,0,30,1
1649875035618,MATH 18,A03,083745,Staff,29,0,30,1
1649875035618,MATH 18,A04,083746,Staff,30,0,30,0
1649875035618,MATH 18,B01,083748,Staff,19,0,30,11
1649875035618,MATH 18,B02,083749,Staff,29,0,30,1
1649875035618,MATH 18,B03,083750,Staff,30,0,30,0
1649875035618,MATH 18,B04,083751,Staff,29,0,30,1
1649875041643,MATH 20A,A01,083754,Staff,39,0,40,1
1649875047669,MATH 20B,A01,083756,Staff,28,0,30,2
1649875047669,MATH 20B,A02,083757,Staff,30,0,30,0
1649875053695,MATH 20C,A01,083760,Staff,26,0,30,4
1649875053695,MATH 20C,A02,083761,Staff,30,0,30,0
1649875053695,MATH 20C,B01,083762,Staff,30,0,30,0
1649875053695,MATH 20C,B02,083763,Staff,30,0,30,0
1649875059722,MATH 20D,A01,083765,Staff,23,0,30,7
1649875059722,MATH 20D,A02,083766,Staff,30,0,30,0
1649875059722,MATH 20D,A03,083767,Staff,30,0,30,0
1649875065751,MATH 20E,A01,083771,Staff,21,0,30,9
1649875065751,MATH 20E,A02,083772,Staff,29,0,30,1
1649875065751,MATH 20E,B01,083773,Staff,25,0,30,5
1649875065751,MATH 20E,B02,083774,Staff,29,0,30,1
1649875071778,MATH 103A,A01,083777,Staff,0,0,30,30
1649875071778,MATH 103A,A02,083778,Staff,19,0,30,11
1649875071778,MATH 103A,B01,083779,Staff,12,0,30,18
1649875071778,MATH 103A,B02,083780,Staff,25,0,30,5
1649875077805,MATH 105,A01,085443,Staff,8,0,30,22
1649875083834,MATH 109,A01,083213,Anzaldo; Leesa B,28,0,30,2
1649875083834,MATH 109,A02,083214,Anzaldo; Leesa B,23,0,30,7
1649875083834,MATH 109,B01,083215,Anzaldo; Leesa B,27,0,30,3
1649875083834,MATH 109,B02,083216,Anzaldo; Leesa B,27,0,30,3
1649875089860,MATH 142A,A01,083219,Chow; Bennett,3,0,30,27
1649875089860,MATH 142A,A02,083220,Chow; Bennett,26,0,30,4
1649875089860,MATH 142A,B01,083221,Chow; Bennett,11,0,30,19
1649875089860,MATH 142A,B02,083222,Chow; Bennett,26,0,30,4
1649875095882,MATH 193A,A01,083224,Staff,0,1,30,30
1649875095882,MATH 193A,A02,083225,Staff,4,0,30,26
1649875095882,MATH 193A,A03,083781,Staff,28,0,30,2
1649875095882,MATH 193A,A04,083782,Staff,27,0,30,3
1649875101916,MATH 197,001,091859,McAuley; Julian John,9999,0,9999,0
1649875107981,COGS 9,A01,083615,Staff,42,0,60,18
1649875114006,COGS 11,A01,083617,Boyle; Mary E. T.,36,0,40,4
1649875120029,COGS 13,A01,083071,Staff,15,0,40,25
1649875126073,COGS 14A,A01,092681,Staff,93,0,100,7
1649875132096,COGS 14B,A01,083073,Cheng; Tzu-Han,38,0,50,12
1649875138122,COGS 17,A01,092677,Staff,73,0,75,2
1649875144146,COGS 100,A01,083619,Staff,28,0,60,32
1649875150174,COGS 101A,A01,083621,Davis; Joshua Daniel,26,0,60,34
1649875156201,COGS 101B,A01,091572,Staff,38,0,60,22
1649875162225,COGS 101C,A01,083625,Delgado; Tania,25,0,30,5
1649875168257,COGS 107A,A01,083627,Boyle; Mary E. T.,31,0,60,29
1649875174283,COGS 118A,A01,083075,Staff,30,0,60,30
1649875180311,CSE 3,A50,083646,Miranda; Gregory Joseph,29,0,38,9
1649875180311,CSE 3,A51,083647,Miranda; Gregory Joseph,37,0,37,0
1649875186334,CSE 8A,A50,083650,Miranda; Gregory Joseph,24,0,40,16
1649875192361,CSE 11,A01,083080,Cao; Yingjun,0,2,40,40
1649875198393,CSE 12,A01,083652,Staff,80,0,100,20
1649875204423,CSE 15L,A01,083654,Staff,36,0,50,14
1649875204423,CSE 15L,A02,083655,Staff,49,0,50,1
1649875210455,CSE 20,A01,083657,Staff,73,0,80,7
1649875216478,CSE 30,A01,083084,Eldon; John,7,0,40,33
1649875222506,CSE 100,A01,083659,Cao; Yingjun,1,0,50,49
1649875228531,CSE 134B,A01,083661,Powell; Thomas Allan,0,18,65,65
1649875234562,CSE 140,A01,083663,Staff,43,0,75,32
1649875240584,CSE 140L,A01,083088,Eldon; John,37,0,75,38
1649875246622,CSE 175,A01,083665,Kumar; Rakesh,14,0,25,11
1649875252644,CSE 190,A00,092507,Staff,15,0,15,0
1649875258671,ECE 45,A01,083139,Staff,32,0,40,8
1649875264696,ECE 65,A50,083695,Staff,21,0,30,9
1649875270737,ECE 109,A01,091882,Touri; Behrouz,65,0,70,5
1649875276770,ECE 180,A00,083140,Abi Samra; Nicholas Camill,28,0,30,2
1649875276770,ECE 180,B00,083141,Abi Samra; Nicholas Camill,13,0,30,17
1649875282796,MATH 10A,A01,083735,Patchell; Gregory David,25,0,30,5
1649875282796,MATH 10A,A02,083736,Patchell; Gregory David,28,0,30,2
1649875282796,MATH 10A,A03,083737,Patchell; Gregory David,29,0,30,1
1649875288821,MATH 10B,A01,083207,Staff,20,0,30,10
1649875288821,MATH 10B,A02,083208,Staff,28,0,30,2
1649875288821,MATH 10B,B01,083739,Staff,26,0,30,4
1649875288821,MATH 10B,B02,083740,Staff,30,0,30,0
1649875294846,MATH 18,A01,083743,Staff,25,0,30,5
1649875294846,MATH 18,A02,083744,Staff,30,0,30,0
1649875294846,MATH 18,A03,083745,Staff,29,0,30,1
1649875294846,MATH 18,A04,083746,Staff,30,0,30,0
1649875294846,MATH 18,B01,083748,Staff,19,0,30,11
1649875294846,MATH 18,B02,083749,Staff,29,0,30,1
1649875294846,MATH 18,B03,083750,Staff,29,0,30,1
1649875294846,MATH 18,B04,083751,Staff,29,0,30,1
1649875300871,MATH 20A,A01,083754,Staff,39,0,40,1
1649875306896,MATH 20B,A01,083756,Staff,28,0,30,2
1649875306896,MATH 20B,A02,083757,Staff,30,0,30,0
1649875312924,MATH 20C,A01,083760,Staff,26,0,30,4
1649875312924,MATH 20C,A02,083761,Staff,30,0,30,0
1649875312924,MATH 20C,B01,083762,Staff,30,0,30,0
1649875312924,MATH 20C,B02,083763,Staff,30,0,30,0
1649875318962,MATH 20D,A01,083765,Staff,23,0,30,7
1649875318962,MATH 20D,A02,083766,Staff,30,0,30,0
1649875318962,MATH 20D,A03,083767,Staff,30,0,30,0
1649875324988,MATH 20E,A01,083771,Staff,21,0,30,9
1649875324988,MATH 20E,A02,083772,Staff,29,0,30,1
1649875324988,MATH 20E,B01,083773,Staff,25,0,30,5
1649875324988,MATH 20E,B02,083774,Staff,29,0,30,1
1649875331013,MATH 103A,A01,083777,Staff,0,0,30,30
1649875331013,MATH 103A,A02,083778,Staff,19,0,30,11
1649875331013,MATH 103A,B01,083779,Staff,12,0,30,18
1649875331013,MATH 103A,B02,083780,Staff,25,0,30,5
1649875337038,MATH 105,A01,085443,Staff,8,0,30,22
1649875343062,MATH 109,A01,083213,Anzaldo; Leesa B,28,0,30,2
1649875343062,MATH 109,A02,083214,Anzaldo; Leesa B,23,0,30,7
1649875343062,MATH 109,B01,083215,Anzaldo; Leesa B,27,0,30,3
1649875343062,MATH 109,B02,083216,Anzaldo; Leesa B,27,0,30,3
1649875349091,MATH 142A,A01,083219,Chow; Bennett,3,0,30,27
1649875349091,MATH 142A,A02,083220,Chow; Bennett,26,0,30,4
1649875349091,MATH 142A,B01,083221,Chow; Bennett,11,0,30,19
1649875349091,MATH 142A,B02,083222,Chow; Bennett,26,0,30,4
1649875355128,MATH 193A,A01,083224,Staff,0,1,30,30
1649875355128,MATH 193A,A02,083225,Staff,4,0,30,26
1649875355128,MATH 193A,A03,083781,Staff,28,0,30,2
1649875355128,MATH 193A,A04,083782,Staff,27,0,30,3
1649875361253,MATH 197,001,091859,McAuley; Julian John,9999,0,9999,0
1649875367307,COGS 9,A01,083615,Staff,42,0,60,18
1649875373334,COGS 11,A01,083617,Boyle; Mary E. T.,36,0,40,4
1649875379358,COGS 13,A01,083071,Staff,15,0,40,25
1649875385397,COGS 14A,A01,092681,Staff,93,0,100,7
1649875391430,COGS 14B,A01,083073,Cheng; Tzu-Han,38,0,50,12
1649875397463,COGS 17,A01,092677,Staff,73,0,75,2
1649875403489,COGS 100,A01,083619,Staff,28,0,60,32
1649875409516,COGS 101A,A01,083621,Davis; Joshua Daniel,26,0,60,34
1649875415538,COGS 101B,A01,091572,Staff,38,0,60,22
1649875421658,COGS 101C,A01,083625,Delgado; Tania,25,0,30,5
1649875427686,COGS 107A,A01,083627,Boyle; Mary E. T.,31,0,60,29
1649875433710,COGS 118A,A01,083075,Staff,30,0,60,30
1649875439738,CSE 3,A50,083646,Miranda; Gregory Joseph,29,0,38,9
1649875439738,CSE 3,A51,083647,Miranda; Gregory Joseph,37,0,37,0
1649875445773,CSE 8A,A50,083650,Miranda; Gregory Joseph,24,0,40,16
1649875451804,CSE 11,A01,083080,Cao; Yingjun,0,2,40,40
1649875457838,CSE 12,A01,083652,Staff,79,0,100,21
1649875463870,CSE 15L,A01,083654,Staff,35,0,50,15
1649875463870,CSE 15L,A02,083655,Staff,49,0,50,1
1649875469895,CSE 20,A01,083657,Staff,73,0,80,7
1649875475928,CSE 30,A01,083084,Eldon; John,6,0,40,34
1649875481958,CSE 100,A01,083659,Cao; Yingjun,1,0,50,49
1649875487985,CSE 134B,A01,083661,Powell; Thomas Allan,0,19,65,65
1649875494017,CSE 140,A01,083663,Staff,42,0,75,33
1649875500041,CSE 140L,A01,083088,Eldon; John,36,0,75,39
1649875506066,CSE 175,A01,083665,Kumar; Rakesh,14,0,25,11
1649875512088,CSE 190,A00,092507,Staff,15,0,15,0
1649875518116,ECE 45,A01,083139,Staff,32,0,40,8
1649875524138,ECE 65,A50,083695,Staff,21,0,30,9
1649875530161,ECE 109,A01,091882,Touri; Behrouz,65,0,70,5
1649875536186,ECE 180,A00,083140,Abi Samra; Nicholas Camill,28,0,30,2
1649875536186,ECE 180,B00,083141,Abi Samra; Nicholas Camill,13,0,30,17
1649875542218,MATH 10A,A01,083735,Patchell; Gregory David,25,0,30,5
1649875542218,MATH 10A,A02,083736,Patchell; Gregory David,28,0,30,2
1649875542218,MATH 10A,A03,083737,Patchell; Gregory David,29,0,30,1
1649875548244,MATH 10B,A01,083207,Staff,19,0,30,11
1649875548244,MATH 10B,A02,083208,Staff,28,0,30,2
1649875548244,MATH 10B,B01,083739,Staff,26,0,30,4
1649875548244,MATH 10B,B02,083740,Staff,30,0,30,0
1649875554279,MATH 18,A01,083743,Staff,25,0,30,5
1649875554279,MATH 18,A02,083744,Staff,30,0,30,0
1649875554279,MATH 18,A03,083745,Staff,29,0,30,1
1649875554279,MATH 18,A04,083746,Staff,30,0,30,0
1649875554279,MATH 18,B01,083748,Staff,19,0,30,11
1649875554279,MATH 18,B02,083749,Staff,29,0,30,1
1649875554279,MATH 18,B03,083750,Staff,29,0,30,1
1649875554279,MATH 18,B04,083751,Staff,29,0,30,1
1649875560306,MATH 20A,A01,083754,Staff,39,0,40,1
1649875566336,MATH 20B,A01,083756,Staff,28,0,30,2
1649875566336,MATH 20B,A02,083757,Staff,30,0,30,0
1649875572366,MATH 20C,A01,083760,Staff,26,0,30,4
1649875572366,MATH 20C,A02,083761,Staff,30,0,30,0
1649875572366,MATH 20C,B01,083762,Staff,30,0,30,0
1649875572366,MATH 20C,B02,083763,Staff,30,0,30,0
1649875578393,MATH 20D,A01,083765,Staff,23,0,30,7
1649875578393,MATH 20D,A02,083766,Staff,30,0,30,0
1649875578393,MATH 20D,A03,083767,Staff,30,0,30,0
1649875584423,MATH 20E,A01,083771,Staff,21,0,30,9
1649875584423,MATH 20E,A02,083772,Staff,29,0,30,1
1649875584423,MATH 20E,B01,083773,Staff,25,0,30,5
1649875584423,MATH 20E,B02,083774,Staff,29,0,30,1
1649875590454,MATH 103A,A01,083777,Staff,0,0,30,30
1649875590454,MATH 103A,A02,083778,Staff,19,0,30,11
1649875590454,MATH 103A,B01,083779,Staff,12,0,30,18
1649875590454,MATH 103A,B02,083780,Staff,25,0,30,5
1649875596482,MATH 105,A01,085443,Staff,8,0,30,22
1649875602509,MATH 109,A01,083213,Anzaldo; Leesa B,28,0,30,2
1649875602509,MATH 109,A02,083214,Anzaldo; Leesa B,23,0,30,7
1649875602509,MATH 109,B01,083215,Anzaldo; Leesa B,27,0,30,3
1649875602509,MATH 109,B02,083216,Anzaldo; Leesa B,27,0,30,3
1649875608542,MATH 142A,A01,083219,Chow; Bennett,3,0,30,27
1649875608542,MATH 142A,A02,083220,Chow; Bennett,26,0,30,4
1649875608542,MATH 142A,B01,083221,Chow; Bennett,11,0,30,19
1649875608542,MATH 142A,B02,083222,Chow; Bennett,26,0,30,4
1649875614567,MATH 193A,A01,083224,Staff,0,1,30,30
1649875614567,MATH 193A,A02,083225,Staff,4,0,30,26
1649875614567,MATH 193A,A03,083781,Staff,28,0,30,2
1649875614567,MATH 193A,A04,083782,Staff,27,0,30,3
1649875620592,MATH 197,001,091859,McAuley; Julian John,9999,0,9999,0
1649875626644,COGS 9,A01,083615,Staff,42,0,60,18
1649875632670,COGS 11,A01,083617,Boyle; Mary E. T.,36,0,40,4
1649875638694,COGS 13,A01,083071,Staff,15,0,40,25
1649875644717,COGS 14A,A01,092681,Staff,93,0,100,7
1649875650754,COGS 14B,A01,083073,Cheng; Tzu-Han,38,0,50,12
1649875656783,COGS 17,A01,092677,Staff,73,0,75,2
1649875662808,COGS 100,A01,083619,Staff,28,0,60,32
1649875668830,COGS 101A,A01,083621,Davis; Joshua Daniel,26,0,60,34
1649875674856,COGS 101B,A01,091572,Staff,38,0,60,22
1649875680887,COGS 101C,A01,083625,Delgado; Tania,25,0,30,5
1649875686911,COGS 107A,A01,083627,Boyle; Mary E. T.,30,0,60,30
1649875692934,COGS 118A,A01,083075,Staff,30,0,60,30
1649875698962,CSE 3,A50,083646,Miranda; Gregory Joseph,29,0,38,9
1649875698962,CSE 3,A51,083647,Miranda; Gregory Joseph,37,0,37,0
1649875704988,CSE 8A,A50,083650,Miranda; Gregory Joseph,24,0,40,16
1649875711023,CSE 11,A01,083080,Cao; Yingjun,0,2,40,40
1649875717057,CSE 12,A01,083652,Staff,79,0,100,21
1649875723094,CSE 15L,A01,083654,Staff,35,0,50,15
1649875723094,CSE 15L,A02,083655,Staff,49,0,50,1
1649875729124,CSE 20,A01,083657,Staff,73,0,80,7
1649875735146,CSE 30,A01,083084,Eldon; John,5,0,40,35
1649875741171,CSE 100,A01,083659,Cao; Yingjun,1,0,50,49
1649875747204,CSE 134B,A01,083661,Powell; Thomas Allan,0,19,65,65
1649875753228,CSE 140,A01,083663,Staff,41,0,75,34
1649875759250,CSE 140L,A01,083088,Eldon; John,35,0,75,40
1649875765277,CSE 175,A01,083665,Kumar; Rakesh,14,0,25,11
1649875771309,CSE 190,A00,092507,Staff,15,0,15,0
1649875777335,ECE 45,A01,083139,Staff,32,0,40,8
1649875783358,ECE 65,A50,083695,Staff,21,0,30,9
1649875789381,ECE 109,A01,091882,Touri; Behrouz,65,0,70,5
1649875795408,ECE 180,A00,083140,Abi Samra; Nicholas Camill,28,0,30,2
1649875795408,ECE 180,B00,083141,Abi Samra; Nicholas Camill,13,0,30,17
1649875801437,MATH 10A,A01,083735,Patchell; Gregory David,25,0,30,5
1649875801437,MATH 10A,A02,083736,Patchell; Gregory David,28,0,30,2
1649875801437,MATH 10A,A03,083737,Patchell; Gregory David,29,0,30,1
1649875807468,MATH 10B,A01,083207,Staff,19,0,30,11
1649875807468,MATH 10B,A02,083208,Staff,28,0,30,2
1649875807468,MATH 10B,B01,083739,Staff,26,0,30,4
1649875807468,MATH 10B,B02,083740,Staff,30,0,30,0
1649875813499,MATH 18,A01,083743,Staff,25,0,30,5
1649875813499,MATH 18,A02,083744,Staff,30,0,30,0
1649875813499,MATH 18,A03,083745,Staff,29,0,30,1
1649875813499,MATH 18,A04,083746,Staff,30,0,30,0
1649875813499,MATH 18,B01,083748,Staff,19,0,30,11
1649875813499,MATH 18,B02,083749,Staff,29,0,30,1
1649875813499,MATH 18,B03,083750,Staff,29,0,30,1
1649875813499,MATH 18,B04,083751,Staff,29,0,30,1
1649875819527,MATH 20A,A01,083754,Staff,39,0,40,1
1649875825554,MATH 20B,A01,083756,Staff,28,0,30,2
1649875825554,MATH 20B,A02,083757,Staff,30,0,30,0
1649875831577,MATH 20C,A01,083760,Staff,26,0,30,4
1649875831577,MATH 20C,A02,083761,Staff,30,0,30,0
1649875831577,MATH 20C,B01,083762,Staff,30,0,30,0
1649875831577,MATH 20C,B02,083763,Staff,30,0,30,0
1649875837609,MATH 20D,A01,083765,Staff,23,0,30,7
1649875837609,MATH 20D,A02,083766,Staff,30,0,30,0
1649875837609,MATH 20D,A03,083767,Staff,30,0,30,0
1649875843640,MATH 20E,A01,083771,Staff,21,0,30,9
1649875843640,MATH 20E,A02,083772,Staff,29,0,30,1
1649875843640,MATH 20E,B01,083773,Staff,25,0,30,5
1649875843640,MATH 20E,B02,083774,Staff,29,0,30,1
1649875849662,MATH 103A,A01,083777,Staff,0,0,30,30
1649875849662,MATH 103A,A02,083778,Staff,19,0,30,11
1649875849662,MATH 103A,B01,083779,Staff,12,0,30,18
1649875849662,MATH 103A,B02,083780,Staff,25,0,30,5
1649875855689,MATH 105,A01,085443,Staff,8,0,30,22
1649875861717,MATH 109,A01,083213,Anzaldo; Leesa B,28,0,30,2
1649875861717,MATH 109,A02,083214,Anzaldo; Leesa B,22,0,30,8
1649875861717,MATH 109,B01,083215,Anzaldo; Leesa B,27,0,30,3
1649875861717,MATH 109,B02,083216,Anzaldo; Leesa B,27,0,30,3
1649875867737,MATH 142A,A01,083219,Chow; Bennett,3,0,30,27
1649875867737,MATH 142A,A02,083220,Chow; Bennett,26,0,30,4
1649875867737,MATH 142A,B01,083221,Chow; Bennett,11,0,30,19
1649875867737,MATH 142A,B02,083222,Chow; Bennett,26,0,30,4
1649875873770,MATH 193A,A01,083224,Staff,0,1,30,30
1649875873770,MATH 193A,A02,083225,Staff,4,0,30,26
1649875873770,MATH 193A,A03,083781,Staff,28,0,30,2
1649875873770,MATH 193A,A04,083782,Staff,27,0,30,3
1649875879795,MATH 197,001,091859,McAuley; Julian John,9999,0,9999,0
1649875885862,COGS 9,A01,083615,Staff,42,0,60,18
1649875891891,COGS 11,A01,083617,Boyle; Mary E. T.,36,0,40,4
1649875897923,COGS 13,A01,083071,Staff,15,0,40,25
1649875903946,COGS 14A,A01,092681,Staff,93,0,100,7
1649875909979,COGS 14B,A01,083073,Cheng; Tzu-Han,38,0,50,12
1649875916004,COGS 17,A01,092677,Staff,73,0,75,2
1649875922029,COGS 100,A01,083619,Staff,27,0,60,33
1649875928060,COGS 101A,A01,083621,Davis; Joshua Daniel,26,0,60,34
1649875934083,COGS 101B,A01,091572,Staff,38,0,60,22
1649875940110,COGS 101C,A01,083625,Delgado; Tania,25,0,30,5
1649875946134,COGS 107A,A01,083627,Boyle; Mary E. T.,30,0,60,30
1649875952158,COGS 118A,A01,083075,Staff,30,0,60,30
1649875958182,CSE 3,A50,083646,Miranda; Gregory Joseph,29,0,38,9
1649875958182,CSE 3,A51,083647,Miranda; Gregory Joseph,37,0,37,0
1649875964215,CSE 8A,A50,083650,Miranda; Gregory Joseph,24,0,40,16
1649875970290,CSE 11,A01,083080,Cao; Yingjun,0,3,40,40
1649875976315,CSE 12,A01,083652,Staff,79,0,100,21
1649875982345,CSE 15L,A01,083654,Staff,35,0,50,15
1649875982345,CSE 15L,A02,083655,Staff,49,0,50,1
1649875988390,CSE 20,A01,083657,Staff,73,0,80,7
1649875994417,CSE 30,A01,083084,Eldon; John,4,0,40,36
1649876000461,CSE 100,A01,083659,Cao; Yingjun,1,0,50,49
1649876006482,CSE 134B,A01,083661,Powell; Thomas Allan,0,19,65,65
1649876012509,CSE 140,A01,083663,Staff,41,0,75,34
1649876018623,CSE 140L,A01,083088,Eldon; John,35,0,75,40
1649876024653,CSE 175,A01,083665,Kumar; Rakesh,14,0,25,11
1649876030677,CSE 190,A00,092507,Staff,15,0,15,0
1649876036704,ECE 45,A01,083139,Staff,30,0,40,10
1649876042736,ECE 65,A50,083695,Staff,20,0,30,10
1649876048759,ECE 109,A01,091882,Touri; Behrouz,64,0,70,6
1649876054796,ECE 180,A00,083140,Abi Samra; Nicholas Camill,28,0,30,2
1649876054796,ECE 180,B00,083141,Abi Samra; Nicholas Camill,13,0,30,17
1649876060832,MATH 10A,A01,083735,Patchell; Gregory David,25,0,30,5
1649876060832,MATH 10A,A02,083736,Patchell; Gregory David,28,0,30,2
1649876060832,MATH 10A,A03,083737,Patchell; Gregory David,29,0,30,1
1649876066860,MATH 10B,A01,083207,Staff,19,0,30,11
1649876066860,MATH 10B,A02,083208,Staff,28,0,30,2
1649876066860,MATH 10B,B01,083739,Staff,26,0,30,4
1649876066860,MATH 10B,B02,083740,Staff,30,0,30,0
1649876072891,MATH 18,A01,083743,Staff,25,0,30,5
1649876072891,MATH 18,A02,083744,Staff,30,0,30,0
1649876072891,MATH 18,A03,083745,Staff,29,0,30,1
1649876072891,MATH 18,A04,083746,Staff,30,0,30,0
1649876072891,MATH 18,B01,083748,Staff,19,0,30,11
1649876072891,MATH 18,B02,083749,Staff,29,0,30,1
1649876072891,MATH 18,B03,083750,Staff,29,0,30,1
1649876072891,MATH 18,B04,083751,Staff,29,0,30,1
1649876078914,MATH 20A,A01,083754,Staff,39,0,40,1
1649876084939,MATH 20B,A01,083756,Staff,28,0,30,2
1649876084939,MATH 20B,A02,083757,Staff,30,0,30,0
1649876090962,MATH 20C,A01,083760,Staff,25,0,30,5
1649876090962,MATH 20C,A02,083761,Staff,30,0,30,0
1649876090962,MATH 20C,B01,083762,Staff,30,0,30,0
1649876090962,MATH 20C,B02,083763,Staff,30,0,30,0
1649876096985,MATH 20D,A01,083765,Staff,23,0,30,7
1649876096985,MATH 20D,A02,083766,Staff,30,0,30,0
1649876096985,MATH 20D,A03,083767,Staff,30,0,30,0
1649876103014,MATH 20E,A01,083771,Staff,20,0,30,10
1649876103014,MATH 20E,A02,083772,Staff,29,0,30,1
1649876103014,MATH 20E,B01,083773,Staff,25,0,30,5
1649876103014,MATH 20E,B02,083774,Staff,29,0,30,1
1649876109042,MATH 103A,A01,083777,Staff,0,0,30,30
1649876109042,MATH 103A,A02,083778,Staff,19,0,30,11
1649876109042,MATH 103A,B01,083779,Staff,12,0,30,18
1649876109042,MATH 103A,B02,083780,Staff,25,0,30,5
1649876115072,MATH 105,A01,085443,Staff,8,0,30,22
1649876121099,MATH 109,A01,083213,Anzaldo; Leesa B,28,0,30,2
1649876121099,MATH 109,A02,083214,Anzaldo; Leesa B,22,0,30,8
1649876121099,MATH 109,B01,083215,Anzaldo; Leesa B,27,0,30,3
1649876121099,MATH 109,B02,083216,Anzaldo; Leesa B,27,0,30,3
1649876127128,MATH 142A,A01,083219,Chow; Bennett,3,0,30,27
1649876127128,MATH 142A,A02,083220,Chow; Bennett,26,0,30,4
1649876127128,MATH 142A,B01,083221,Chow; Bennett,10,0,30,20
1649876127128,MATH 142A,B02,083222,Chow; Bennett,26,0,30,4
1649876133156,MATH 193A,A01,083224,Staff,0,1,30,30
1649876133156,MATH 193A,A02,083225,Staff,2,0,30,28
1649876133156,MATH 193A,A03,083781,Staff,28,0,30,2
1649876133156,MATH 193A,A04,083782,Staff,27,0,30,3
1649876139181,MATH 197,001,091859,McAuley; Julian John,9999,0,9999,0
1649876145230,COGS 9,A01,083615,Staff,41,0,60,19
1649876151262,COGS 11,A01,083617,Boyle; Mary E. T.,36,0,40,4
1649876157290,COGS 13,A01,083071,Staff,15,0,40,25
1649876163318,COGS 14A,A01,092681,Staff,93,0,100,7
1649876169342,COGS 14B,A01,083073,Cheng; Tzu-Han,38,0,50,12
1649876175365,COGS 17,A01,092677,Staff,73,0,75,2
1649876181392,COGS 100,A01,083619,Staff,27,0,60,33
1649876187417,COGS 101A,A01,083621,Davis; Joshua Daniel,26,0,60,34
1649876193439,COGS 101B,A01,091572,Staff,38,0,60,22
1649876199469,COGS 101C,A01,083625,Delgado; Tania,25,0,30,5
1649876205494,COGS 107A,A01,083627,Boyle; Mary E. T.,29,0,60,31
1649876211522,COGS 118A,A01,083075,Staff,30,0,60,30
1649876217556,CSE 3,A50,083646,Miranda; Gregory Joseph,29,0,38,9
1649876217556,CSE 3,A51,083647,Miranda; Gregory Joseph,37,0,37,0
1649876223584,CSE 8A,A50,083650,Miranda; Gregory Joseph,24,0,40,16
1649876229619,CSE 11,A01,083080,Cao; Yingjun,0,3,40,40
1649876235649,CSE 12,A01,083652,Staff,78,0,100,22
1649876241671,CSE 15L,A01,083654,Staff,35,0,50,15
1649876241671,CSE 15L,A02,083655,Staff,48,0,50,2
1649876247692,CSE 20,A01,083657,Staff,73,0,80,7
1649876253718,CSE 30,A01,083084,Eldon; John,4,0,40,36
1649876259743,CSE 100,A01,083659,Cao; Yingjun,1,0,50,49
1649876265770,CSE 134B,A01,083661,Powell; Thomas Allan,0,19,65,65
1649876271797,CSE 140,A01,083663,Staff,41,0,75,34
1649876277823,CSE 140L,A01,083088,Eldon; John,35,0,75,40
1649876283854,CSE 175,A01,083665,Kumar; Rakesh,14,0,25,11
1649876289879,CSE 190,A00,092507,Staff,15,0,15,0
1649876295905,ECE 45,A01,083139,Staff,30,0,40,10
1649876301930,ECE 65,A50,083695,Staff,20,0,30,10
1649876307954,ECE 109,A01,091882,Touri; Behrouz,64,0,70,6
1649876313984,ECE 180,A00,083140,Abi Samra; Nicholas Camill,28,0,30,2
1649876313984,ECE 180,B00,083141,Abi Samra; Nicholas Camill,13,0,30,17
1649876320015,MATH 10A,A01,083735,Patchell; Gregory David,25,0,30,5
1649876320015,MATH 10A,A02,083736,Patchell; Gregory David,28,0,30,2
1649876320015,MATH 10A,A03,083737,Patchell; Gregory David,29,0,30,1
1649876326039,MATH 10B,A01,083207,Staff,19,0,30,11
1649876326039,MATH 10B,A02,083208,Staff,28,0,30,2
1649876326039,MATH 10B,B01,083739,Staff,26,0,30,4
1649876326039,MATH 10B,B02,083740,Staff,30,0,30,0
1649876332065,MATH 18,A01,083743,Staff,25,0,30,5
1649876332065,MATH 18,A02,083744,Staff,30,0,30,0
1649876332065,MATH 18,A03,083745,Staff,29,0,30,1
1649876332065,MATH 18,A04,083746,Staff,30,0,30,0
1649876332065,MATH 18,B01,083748,Staff,19,0,30,11
1649876332065,MATH 18,B02,083749,Staff,29,0,30,1
1649876332065,MATH 18,B03,083750,Staff,29,0,30,1
1649876332065,MATH 18,B04,083751,Staff,29,0,30,1
1649876338092,MATH 20A,A01,083754,Staff,39,0,40,1
1649876344121,MATH 20B,A01,083756,Staff,28,0,30,2
1649876344121,MATH 20B,A02,083757,Staff,30,0,30,0
1649876350144,MATH 20C,A01,083760,Staff,25,0,30,5
1649876350144,MATH 20C,A02,083761,Staff,30,0,30,0
1649876350144,MATH 20C,B01,083762,Staff,30,0,30,0
1649876350144,MATH 20C,B02,083763,Staff,30,0,30,0
1649876356170,MATH 20D,A01,083765,Staff,23,0,30,7
1649876356170,MATH 20D,A02,083766,Staff,30,0,30,0
1649876356170,MATH 20D,A03,083767,Staff,30,0,30,0
1649876362199,MATH 20E,A01,083771,Staff,20,0,30,10
1649876362199,MATH 20E,A02,083772,Staff,29,0,30,1
1649876362199,MATH 20E,B01,083773,Staff,25,0,30,5
1649876362199,MATH 20E,B02,083774,Staff,29,0,30,1
1649876368238,MATH 103A,A01,083777,Staff,0,0,30,30
1649876368238,MATH 103A,A02,083778,Staff,19,0,30,11
1649876368238,MATH 103A,B01,083779,Staff,12,0,30,18
1649876368238,MATH 103A,B02,083780,Staff,25,0,30,5
1649876374265,MATH 105,A01,085443,Staff,7,0,30,23
1649876380293,MATH 109,A01,083213,Anzaldo; Leesa B,28,0,30,2
1649876380293,MATH 109,A02,083214,Anzaldo; Leesa B,22,0,30,8
1649876380293,MATH 109,B01,083215,Anzaldo; Leesa B,27,0,30,3
1649876380293,MATH 109,B02,083216,Anzaldo; Leesa B,27,0,30,3
1649876386328,MATH 142A,A01,083219,Chow; Bennett,1,0,30,29
1649876386328,MATH 142A,A02,083220,Chow; Bennett,26,0,30,4
1649876386328,MATH 142A,B01,083221,Chow; Bennett,11,0,30,19
1649876386328,MATH 142A,B02,083222,Chow; Bennett,26,0,30,4
1649876392352,MATH 193A,A01,083224,Staff,0,1,30,30
1649876392352,MATH 193A,A02,083225,Staff,2,0,30,28
1649876392352,MATH 193A,A03,083781,Staff,28,0,30,2
1649876392352,MATH 193A,A04,083782,Staff,27,0,30,3
1649876398390,MATH 197,001,091859,McAuley; Julian John,9999,0,9999,0
1649876404449,COGS 9,A01,083615,Staff,41,0,60,19
1649876410495,COGS 11,A01,083617,Boyle; Mary E. T.,36,0,40,4
1649876416518,COGS 13,A01,083071,Staff,15,0,40,25
1649876422542,COGS 14A,A01,092681,Staff,93,0,100,7
1649876428563,COGS 14B,A01,083073,Cheng; Tzu-Han,38,0,50,12
1649876434587,COGS 17,A01,092677,Staff,73,0,75,2
1649876440609,COGS 100,A01,083619,Staff,27,0,60,33
1649876446630,COGS 101A,A01,083621,Davis; Joshua Daniel,26,0,60,34
1649876452663,COGS 101B,A01,091572,Staff,38,0,60,22
1649876458690,COGS 101C,A01,083625,Delgado; Tania,25,0,30,5
1649876464711,COGS 107A,A01,083627,Boyle; Mary E. T.,29,0,60,31
1649876470736,COGS 118A,A01,083075,Staff,29,0,60,31
1649876476773,CSE 3,A50,083646,Miranda; Gregory Joseph,29,0,38,9
1649876476773,CSE 3,A51,083647,Miranda; Gregory Joseph,37,0,37,0
1649876482797,CSE 8A,A50,083650,Miranda; Gregory Joseph,24,0,40,16
1649876488820,CSE 11,A01,083080,Cao; Yingjun,0,3,40,40
1649876494845,CSE 12,A01,083652,Staff,78,0,100,22
1649876500878,CSE 15L,A01,083654,Staff,35,0,50,15
1649876500878,CSE 15L,A02,083655,Staff,48,0,50,2
1649876506908,CSE 20,A01,083657,Staff,73,0,80,7
1649876512941,CSE 30,A01,083084,Eldon; John,3,0,40,37
1649876518967,CSE 100,A01,083659,Cao; Yingjun,1,0,50,49
1649876524990,CSE 134B,A01,083661,Powell; Thomas Allan,0,19,65,65
1649876531031,CSE 140,A01,083663,Staff,41,0,75,34
1649876537057,CSE 140L,A01,083088,Eldon; John,35,0,75,40
1649876543090,CSE 175,A01,083665,Kumar; Rakesh,14,0,25,11
1649876549116,CSE 190,A00,092507,Staff,15,0,15,0
1649876555139,ECE 45,A01,083139,Staff,30,0,40,10
1649876561166,ECE 65,A50,083695,Staff,20,0,30,10
1649876567188,ECE 109,A01,091882,Touri; Behrouz,64,0,70,6
1649876573214,ECE 180,A00,083140,Abi Samra; Nicholas Camill,28,0,30,2
1649876573214,ECE 180,B00,083141,Abi Samra; Nicholas Camill,13,0,30,17
1649876579249,MATH 10A,A01,083735,Patchell; Gregory David,25,0,30,5
1649876579249,MATH 10A,A02,083736,Patchell; Gregory David,28,0,30,2
1649876579249,MATH 10A,A03,083737,Patchell; Gregory David,29,0,30,1
1649876585273,MATH 10B,A01,083207,Staff,19,0,30,11
1649876585273,MATH 10B,A02,083208,Staff,28,0,30,2
1649876585273,MATH 10B,B01,083739,Staff,26,0,30,4
1649876585273,MATH 10B,B02,083740,Staff,30,0,30,0
1649876591303,MATH 18,A01,083743,Staff,25,0,30,5
1649876591303,MATH 18,A02,083744,Staff,30,0,30,0
1649876591303,MATH 18,A03,083745,Staff,29,0,30,1
1649876591303,MATH 18,A04,083746,Staff,30,0,30,0
1649876591303,MATH 18,B01,083748,Staff,19,0,30,11
1649876591303,MATH 18,B02,083749,Staff,29,0,30,1
1649876591303,MATH 18,B03,083750,Staff,29,0,30,1
1649876591303,MATH 18,B04,083751,Staff,28,0,30,2
1649876597340,MATH 20A,A01,083754,Staff,39,0,40,1
1649876603374,MATH 20B,A01,083756,Staff,28,0,30,2
1649876603374,MATH 20B,A02,083757,Staff,30,0,30,0
1649876609422,MATH 20C,A01,083760,Staff,25,0,30,5
1649876609422,MATH 20C,A02,083761,Staff,30,0,30,0
1649876609422,MATH 20C,B01,083762,Staff,30,0,30,0
1649876609422,MATH 20C,B02,083763,Staff,30,0,30,0
1649876615556,MATH 20D,A01,083765,Staff,23,0,30,7
1649876615556,MATH 20D,A02,083766,Staff,30,0,30,0
1649876615556,MATH 20D,A03,083767,Staff,30,0,30,0
1649876621582,MATH 20E,A01,083771,Staff,20,0,30,10
1649876621582,MATH 20E,A02,083772,Staff,29,0,30,1
1649876621582,MATH 20E,B01,083773,Staff,25,0,30,5
1649876621582,MATH 20E,B02,083774,Staff,29,0,30,1
1649876627614,MATH 103A,A01,083777,Staff,0,0,30,30
1649876627614,MATH 103A,A02,083778,Staff,19,0,30,11
1649876627614,MATH 103A,B01,083779,Staff,12,0,30,18
1649876627614,MATH 103A,B02,083780,Staff,24,0,30,6
1649876633639,MATH 105,A01,085443,Staff,7,0,30,23
1649876639667,MATH 109,A01,083213,Anzaldo; Leesa B,28,0,30,2
1649876639667,MATH 109,A02,083214,Anzaldo; Leesa B,22,0,30,8
1649876639667,MATH 109,B01,083215,Anzaldo; Leesa B,27,0,30,3
1649876639667,MATH 109,B02,083216,Anzaldo; Leesa B,26,0,30,4
1649876645695,MATH 142A,A01,083219,Chow; Bennett,0,0,30,30
1649876645695,MATH 142A,A02,083220,Chow; Bennett,26,0,30,4
1649876645695,MATH 142A,B01,083221,Chow; Bennett,11,0,30,19
1649876645695,MATH 142A,B02,083222,Chow; Bennett,26,0,30,4
1649876651729,MATH 193A,A01,083224,Staff,0,1,30,30
1649876651729,MATH 193A,A02,083225,Staff,2,0,30,28
1649876651729,MATH 193A,A03,083781,Staff,28,0,30,2
1649876651729,MATH 193A,A04,083782,Staff,27,0,30,3
1649876657756,MATH 197,001,091859,McAuley; Julian John,9999,0,9999,0
1649876663809,COGS 9,A01,083615,Staff,41,0,60,19
1649876669842,COGS 11,A01,083617,Boyle; Mary E. T.,36,0,40,4
1649876675866,COGS 13,A01,083071,Staff,14,0,40,26
1649876681890,COGS 14A,A01,092681,Staff,93,0,100,7
1649876687917,COGS 14B,A01,083073,Cheng; Tzu-Han,37,0,50,13
1649876693941,COGS 17,A01,092677,Staff,73,0,75,2
1649876699970,COGS 100,A01,083619,Staff,26,0,60,34
1649876706002,COGS 101A,A01,083621,Davis; Joshua Daniel,26,0,60,34
1649876712028,COGS 101B,A01,091572,Staff,38,0,60,22
1649876718063,COGS 101C,A01,083625,Delgado; Tania,25,0,30,5
1649876724086,COGS 107A,A01,083627,Boyle; Mary E. T.,28,0,60,32
1649876730109,COGS 118A,A01,083075,Staff,29,0,60,31
1649876736132,CSE 3,A50,083646,Miranda; Gregory Joseph,29,0,38,9
1649876736132,CSE 3,A51,083647,Miranda; Gregory Joseph,37,0,37,0
1649876742155,CSE 8A,A50,083650,Miranda; Gregory Joseph,24,0,40,16
1649876748184,CSE 11,A01,083080,Cao; Yingjun,0,3,40,40
1649876754222,CSE 12,A01,083652,Staff,78,0,100,22
1649876760272,CSE 15L,A01,083654,Staff,35,0,50,15
1649876760272,CSE 15L,A02,083655,Staff,48,0,50,2
1649876766297,CSE 20,A01,083657,Staff,73,0,80,7
1649876772326,CSE 30,A01,083084,Eldon; John,2,0,40,38
1649876778353,CSE 100,A01,083659,Cao; Yingjun,1,0,50,49
1649876784377,CSE 134B,A01,083661,Powell; Thomas Allan,0,21,65,65
1649876790400,CSE 140,A01,083663,Staff,41,0,75,34
1649876796424,CSE 140L,A01,083088,Eldon; John,35,0,75,40
1649876802446,CSE 175,A01,083665,Kumar; Rakesh,14,0,25,11
1649876808469,CSE 190,A00,092507,Staff,15,0,15,0
1649876814501,ECE 45,A01,083139,Staff,30,0,40,10
1649876820537,ECE 65,A50,083695,Staff,20,0,30,10
1649876826565,ECE 109,A01,091882,Touri; Behrouz,64,0,70,6
1649876832590,ECE 180,A00,083140,Abi Samra; Nicholas Camill,28,0,30,2
1649876832590,ECE 180,B00,083141,Abi Samra; Nicholas Camill,13,0,30,17
1649876838614,MATH 10A,A01,083735,Patchell; Gregory David,25,0,30,5
1649876838614,MATH 10A,A02,083736,Patchell; Gregory David,28,0,30,2
1649876838614,MATH 10A,A03,083737,Patchell; Gregory David,29,0,30,1
1649876844638,MATH 10B,A01,083207,Staff,19,0,30,11
1649876844638,MATH 10B,A02,083208,Staff,28,0,30,2
1649876844638,MATH 10B,B01,083739,Staff,26,0,30,4
1649876844638,MATH 10B,B02,083740,Staff,30,0,30,0
1649876850677,MATH 18,A01,083743,Staff,25,0,30,5
1649876850677,MATH 18,A02,083744,Staff,30,0,30,0
1649876850677,MATH 18,A03,083745,Staff,29,0,30,1
1649876850677,MATH 18,A04,083746,Staff,30,0,30,0
1649876850677,MATH 18,B01,083748,Staff,19,0,30,11
1649876850677,MATH 18,B02,083749,Staff,29,0,30,1
1649876850677,MATH 18,B03,083750,Staff,29,0,30,1
1649876850677,MATH 18,B04,083751,Staff,28,0,30,2
1649876856701,MATH 20A,A01,083754,Staff,39,0,40,1
1649876862729,MATH 20B,A01,083756,Staff,28,0,30,2
1649876862729,MATH 20B,A02,083757,Staff,30,0,30,0
1649876868754,MATH 20C,A01,083760,Staff,25,0,30,5
1649876868754,MATH 20C,A02,083761,Staff,30,0,30,0
1649876868754,MATH 20C,B01,083762,Staff,30,0,30,0
1649876868754,MATH 20C,B02,083763,Staff,30,0,30,0
1649876874780,MATH 20D,A01,083765,Staff,22,0,30,8
1649876874780,MATH 20D,A02,083766,Staff,30,0,30,0
1649876874780,MATH 20D,A03,083767,Staff,30,0,30,0
1649876880806,MATH 20E,A01,083771,Staff,20,0,30,10
1649876880806,MATH 20E,A02,083772,Staff,29,0,30,1
1649876880806,MATH 20E,B01,083773,Staff,25,0,30,5
1649876880806,MATH 20E,B02,083774,Staff,29,0,30,1
1649876886840,MATH 103A,A01,083777,Staff,0,0,30,30
1649876886840,MATH 103A,A02,083778,Staff,17,0,30,13
1649876886840,MATH 103A,B01,083779,Staff,12,0,30,18
1649876886840,MATH 103A,B02,083780,Staff,24,0,30,6
1649876892868,MATH 105,A01,085443,Staff,7,0,30,23
1649876898890,MATH 109,A01,083213,Anzaldo; Leesa B,28,0,30,2
1649876898890,MATH 109,A02,083214,Anzaldo; Leesa B,22,0,30,8
1649876898890,MATH 109,B01,083215,Anzaldo; Leesa B,27,0,30,3
1649876898890,MATH 109,B02,083216,Anzaldo; Leesa B,26,0,30,4
1649876904921,MATH 142A,A01,083219,Chow; Bennett,0,0,30,30
1649876904921,MATH 142A,A02,083220,Chow; Bennett,26,0,30,4
1649876904921,MATH 142A,B01,083221,Chow; Bennett,11,0,30,19
1649876904921,MATH 142A,B02,083222,Chow; Bennett,26,0,30,4
1649876910949,MATH 193A,A01,083224,Staff,0,1,30,30
1649876910949,MATH 193A,A02,083225,Staff,2,0,30,28
1649876910949,MATH 193A,A03,083781,Staff,28,0,30,2
1649876910949,MATH 193A,A04,083782,Staff,27,0,30,3
1649876916979,MATH 197,001,091859,McAuley; Julian John,9999,0,9999,0
1649876923045,COGS 9,A01,083615,Staff,39,0,60,21
1649876929072,COGS 11,A01,083617,Boyle; Mary E. T.,36,0,40,4
1649876935097,COGS 13,A01,083071,Staff,14,0,40,26
1649876941120,COGS 14A,A01,092681,Staff,93,0,100,7
1649876947146,COGS 14B,A01,083073,Cheng; Tzu-Han,37,0,50,13
1649876953171,COGS 17,A01,092677,Staff,73,0,75,2
1649876959203,COGS 100,A01,083619,Staff,26,0,60,34
1649876965230,COGS 101A,A01,083621,Davis; Joshua Daniel,25,0,60,35
1649876971255,COGS 101B,A01,091572,Staff,38,0,60,22
1649876977287,COGS 101C,A01,083625,Delgado; Tania,25,0,30,5
1649876983316,COGS 107A,A01,083627,Boyle; Mary E. T.,27,0,60,33
1649876989342,COGS 118A,A01,083075,Staff,29,0,60,31
1649876995373,CSE 3,A50,083646,Miranda; Gregory Joseph,29,0,38,9
1649876995373,CSE 3,A51,083647,Miranda; Gregory Joseph,37,0,37,0
1649877001397,CSE 8A,A50,083650,Miranda; Gregory Joseph,24,0,40,16
1649877007435,CSE 11,A01,083080,Cao; Yingjun,0,3,40,40
1649877013457,CSE 12,A01,083652,Staff,78,0,100,22
1649877019482,CSE 15L,A01,083654,Staff,35,0,50,15
1649877019482,CSE 15L,A02,083655,Staff,48,0,50,2
1649877025508,CSE 20,A01,083657,Staff,73,0,80,7
1649877031537,CSE 30,A01,083084,Eldon; John,2,0,40,38
1649877037564,CSE 100,A01,083659,Cao; Yingjun,1,0,50,49
1649877043603,CSE 134B,A01,083661,Powell; Thomas Allan,0,21,65,65
1649877049629,CSE 140,A01,083663,Staff,41,0,75,34
1649877055653,CSE 140L,A01,083088,Eldon; John,35,0,75,40
1649877061676,CSE 175,A01,083665,Kumar; Rakesh,14,0,25,11
1649877067698,CSE 190,A00,092507,Staff,15,0,15,0
1649877073733,ECE 45,A01,083139,Staff,30,0,40,10
1649877079756,ECE 65,A50,083695,Staff,20,0,30,10
1649877085782,ECE 109,A01,091882,Touri; Behrouz,63,0,70,7
1649877091813,ECE 180,A00,083140,Abi Samra; Nicholas Camill,28,0,30,2
1649877091813,ECE 180,B00,083141,Abi Samra; Nicholas Camill,13,0,30,17
1649877097847,MATH 10A,A01,083735,Patchell; Gregory David,25,0,30,5
1649877097847,MATH 10A,A02,083736,Patchell; Gregory David,28,0,30,2
1649877097847,MATH 10A,A03,083737,Patchell; Gregory David,29,0,30,1
1649877103870,MATH 10B,A01,083207,Staff,19,0,30,11
1649877103870,MATH 10B,A02,083208,Staff,28,0,30,2
1649877103870,MATH 10B,B01,083739,Staff,26,0,30,4
1649877103870,MATH 10B,B02,083740,Staff,30,0,30,0
1649877109900,MATH 18,A01,083743,Staff,25,0,30,5
1649877109900,MATH 18,A02,083744,Staff,30,0,30,0
1649877109900,MATH 18,A03,083745,Staff,29,0,30,1
1649877109900,MATH 18,A04,083746,Staff,30,0,30,0
1649877109900,MATH 18,B01,083748,Staff,19,0,30,11
1649877109900,MATH 18,B02,083749,Staff,29,0,30,1
1649877109900,MATH 18,B03,083750,Staff,29,0,30,1
1649877109900,MATH 18,B04,083751,Staff,28,0,30,2
1649877115936,MATH 20A,A01,083754,Staff,39,0,40,1
1649877121971,MATH 20B,A01,083756,Staff,28,0,30,2
1649877121971,MATH 20B,A02,083757,Staff,30,0,30,0
1649877127999,MATH 20C,A01,083760,Staff,25,0,30,5
1649877127999,MATH 20C,A02,083761,Staff,30,0,30,0
1649877127999,MATH 20C,B01,083762,Staff,30,0,30,0
1649877127999,MATH 20C,B02,083763,Staff,30,0,30,0
1649877134050,MATH 20D,A01,083765,Staff,22,0,30,8
1649877134050,MATH 20D,A02,083766,Staff,30,0,30,0
1649877134050,MATH 20D,A03,083767,Staff,30,0,30,0
1649877140073,MATH 20E,A01,083771,Staff,20,0,30,10
1649877140073,MATH 20E,A02,083772,Staff,29,0,30,1
1649877140073,MATH 20E,B01,083773,Staff,25,0,30,5
1649877140073,MATH 20E,B02,083774,Staff,29,0,30,1
1649877146098,MATH 103A,A01,083777,Staff,0,0,30,30
1649877146098,MATH 103A,A02,083778,Staff,16,0,30,14
1649877146098,MATH 103A,B01,083779,Staff,11,0,30,19
1649877146098,MATH 103A,B02,083780,Staff,24,0,30,6
1649877152131,MATH 105,A01,085443,Staff,7,0,30,23
1649877158155,MATH 109,A01,083213,Anzaldo; Leesa B,28,0,30,2
1649877158155,MATH 109,A02,083214,Anzaldo; Leesa B,22,0,30,8
1649877158155,MATH 109,B01,083215,Anzaldo; Leesa B,27,0,30,3
1649877158155,MATH 109,B02,083216,Anzaldo; Leesa B,26,0,30,4
1649877164179,MATH 142A,A01,083219,Chow; Bennett,0,0,30,30
1649877164179,MATH 142A,A02,083220,Chow; Bennett,26,0,30,4
1649877164179,MATH 142A,B01,083221,Chow; Bennett,11,0,30,19
1649877164179,MATH 142A,B02,083222,Chow; Bennett,26,0,30,4
1649877170205,MATH 193A,A01,083224,Staff,0,1,30,30
1649877170205,MATH 193A,A02,083225,Staff,2,0,30,28
1649877170205,MATH 193A,A03,083781,Staff,28,0,30,2
1649877170205,MATH 193A,A04,083782,Staff,27,0,30,3
1649877176230,MATH 197,001,091859,McAuley; Julian John,9999,0,9999,0
1649877182280,COGS 9,A01,083615,Staff,38,0,60,22
1649877188307,COGS 11,A01,083617,Boyle; Mary E. T.,36,0,40,4
1649877194332,COGS 13,A01,083071,Staff,14,0,40,26
1649877200355,COGS 14A,A01,092681,Staff,93,0,100,7
1649877206458,COGS 14B,A01,083073,Cheng; Tzu-Han,37,0,50,13
1649877212484,COGS 17,A01,092677,Staff,73,0,75,2
1649877218517,COGS 100,A01,083619,Staff,26,0,60,34
1649877224540,COGS 101A,A01,083621,Davis; Joshua Daniel,25,0,60,35
1649877230571,COGS 101B,A01,091572,Staff,38,0,60,22
1649877236598,COGS 101C,A01,083625,Delgado; Tania,25,0,30,5
1649877242621,COGS 107A,A01,083627,Boyle; Mary E. T.,27,0,60,33
1649877248648,COGS 118A,A01,083075,Staff,29,0,60,31
1649877254672,CSE 3,A50,083646,Miranda; Gregory Joseph,29,0,38,9
1649877254672,CSE 3,A51,083647,Miranda; Gregory Joseph,37,0,37,0
1649877260695,CSE 8A,A50,083650,Miranda; Gregory Joseph,24,0,40,16
1649877266718,CSE 11,A01,083080,Cao; Yingjun,0,4,40,40
1649877272743,CSE 12,A01,083652,Staff,77,0,100,23
1649877278769,CSE 15L,A01,083654,Staff,34,0,50,16
1649877278769,CSE 15L,A02,083655,Staff,48,0,50,2
1649877284802,CSE 20,A01,083657,Staff,73,0,80,7
1649877290827,CSE 30,A01,083084,Eldon; John,2,0,40,38
1649877296851,CSE 100,A01,083659,Cao; Yingjun,1,0,50,49
1649877302884,CSE 134B,A01,083661,Powell; Thomas Allan,0,21,65,65
1649877308907,CSE 140,A01,083663,Staff,41,0,75,34
1649877314932,CSE 140L,A01,083088,Eldon; John,35,0,75,40
1649877320959,CSE 175,A01,083665,Kumar; Rakesh,14,0,25,11
1649877326982,CSE 190,A00,092507,Staff,15,0,15,0
1649877333018,ECE 45,A01,083139,Staff,30,0,40,10
1649877339048,ECE 65,A50,083695,Staff,20,0,30,10
1649877345075,ECE 109,A01,091882,Touri; Behrouz,63,0,70,7
1649877351097,ECE 180,A00,083140,Abi Samra; Nicholas Camill,28,0,30,2
1649877351097,ECE 180,B00,083141,Abi Samra; Nicholas Camill,13,0,30,17
1649877357124,MATH 10A,A01,083735,Patchell; Gregory David,25,0,30,5
1649877357124,MATH 10A,A02,083736,Patchell; Gregory David,28,0,30,2
1649877357124,MATH 10A,A03,083737,Patchell; Gregory David,29,0,30,1
1649877363154,MATH 10B,A01,083207,Staff,19,0,30,11
1649877363154,MATH 10B,A02,083208,Staff,28,0,30,2
1649877363154,MATH 10B,B01,083739,Staff,26,0,30,4
1649877363154,MATH 10B,B02,083740,Staff,30,0,30,0
1649877369184,MATH 18,A01,083743,Staff,25,0,30,5
1649877369184,MATH 18,A02,083744,Staff,30,0,30,0
1649877369184,MATH 18,A03,083745,Staff,29,0,30,1
1649877369184,MATH 18,A04,083746,Staff,30,0,30,0
1649877369184,MATH 18,B01,083748,Staff,19,0,30,11
1649877369184,MATH 18,B02,083749,Staff,29,0,30,1
1649877369184,MATH 18,B03,083750,Staff,29,0,30,1
1649877369184,MATH 18,B04,083751,Staff,28,0,30,2
1649877375211,MATH 20A,A01,083754,Staff,39,0,40,1
1649877381237,MATH 20B,A01,083756,Staff,28,0,30,2
1649877381237,MATH 20B,A02,083757,Staff,30,0,30,0
1649877387261,MATH 20C,A01,083760,Staff,24,0,30,6
1649877387261,MATH 20C,A02,083761,Staff,30,0,30,0
1649877387261,MATH 20C,B01,083762,Staff,30,0,30,0
1649877387261,MATH 20C,B02,083763,Staff,30,0,30,0
1649877393285,MATH 20D,A01,083765,Staff,22,0,30,8
1649877393285,MATH 20D,A02,083766,Staff,30,0,30,0
1649877393285,MATH 20D,A03,083767,Staff,30,0,30,0
1649877399312,MATH 20E,A01,083771,Staff,20,0,30,10
1649877399312,MATH 20E,A02,083772,Staff,29,0,30,1
1649877399312,MATH 20E,B01,083773,Staff,25,0,30,5
1649877399312,MATH 20E,B02,083774,Staff,29,0,30,1
1649877405339,MATH 103A,A01,083777,Staff,0,0,30,30
1649877405339,MATH 103A,A02,083778,Staff,16,0,30,14
1649877405339,MATH 103A,B01,083779,Staff,11,0,30,19
1649877405339,MATH 103A,B02,083780,Staff,23,0,30,7
1649877411365,MATH 105,A01,085443,Staff,7,0,30,23
1649877417394,MATH 109,A01,083213,Anzaldo; Leesa B,28,0,30,2
1649877417394,MATH 109,A02,083214,Anzaldo; Leesa B,22,0,30,8
1649877417394,MATH 109,B01,083215,Anzaldo; Leesa B,27,0,30,3
1649877417394,MATH 109,B02,083216,Anzaldo; Leesa B,26,0,30,4
1649877423451,MATH 142A,A01,083219,Chow; Bennett,0,0,30,30
1649877423451,MATH 142A,A02,083220,Chow; Bennett,24,0,30,6
1649877423451,MATH 142A,B01,083221,Chow; Bennett,11,0,30,19
1649877423451,MATH 142A,B02,083222,Chow; Bennett,26,0,30,4
1649877429479,MATH 193A,A01,083224,Staff,0,1,30,30
1649877429479,MATH 193A,A02,083225,Staff,1,0,30,29
1649877429479,MATH 193A,A03,083781,Staff,28,0,30,2
1649877429479,MATH 193A,A04,083782,Staff,27,0,30,3
1649877435502,MATH 197,001,091859,McAuley; Julian John,9999,0,9999,0
1649877441551,COGS 9,A01,083615,Staff,38,0,60,22
1649877447574,COGS 11,A01,083617,Boyle; Mary E. T.,36,0,40,4
1649877453601,COGS 13,A01,083071,Staff,14,0,40,26
1649877459627,COGS 14A,A01,092681,Staff,93,0,100,7
1649877465651,COGS 14B,A01,083073,Cheng; Tzu-Han,37,0,50,13
1649877471689,COGS 17,A01,092677,Staff,73,0,75,2
1649877477834,COGS 100,A01,083619,Staff,25,0,60,35
1649877483862,COGS 101A,A01,083621,Davis; Joshua Daniel,24,0,60,36
1649877489884,COGS 101B,A01,091572,Staff,38,0,60,22
1649877495909,COGS 101C,A01,083625,Delgado; Tania,25,0,30,5
1649877501933,COGS 107A,A01,083627,Boyle; Mary E. T.,26,0,60,34
1649877507955,COGS 118A,A01,083075,Staff,29,0,60,31
1649877513979,CSE 3,A50,083646,Miranda; Gregory Joseph,29,0,38,9
1649877513979,CSE 3,A51,083647,Miranda; Gregory Joseph,37,0,37,0
1649877520002,CSE 8A,A50,083650,Miranda; Gregory Joseph,22,0,40,18
1649877526029,CSE 11,A01,083080,Cao; Yingjun,0,5,40,40
1649877532056,CSE 12,A01,083652,Staff,77,0,100,23
1649877538078,CSE 15L,A01,083654,Staff,34,0,50,16
1649877538078,CSE 15L,A02,083655,Staff,48,0,50,2
1649877544102,CSE 20,A01,083657,Staff,73,0,80,7
1649877550128,CSE 30,A01,083084,Eldon; John,2,0,40,38
1649877556157,CSE 100,A01,083659,Cao; Yingjun,1,0,50,49
1649877562190,CSE 134B,A01,083661,Powell; Thomas Allan,0,21,65,65
1649877568216,CSE 140,A01,083663,Staff,41,0,75,34
1649877574239,CSE 140L,A01,083088,Eldon; John,35,0,75,40
1649877585104,CSE 175,A01,083665,Kumar; Rakesh,14,0,25,11
1649877591137,CSE 190,A00,092507,Staff,15,0,15,0
1649877597160,ECE 45,A01,083139,Staff,30,0,40,10
1649877603189,ECE 65,A50,083695,Staff,20,0,30,10
1649877609215,ECE 109,A01,091882,Touri; Behrouz,63,0,70,7
1649877615248,ECE 180,A00,083140,Abi Samra; Nicholas Camill,28,0,30,2
1649877615248,ECE 180,B00,083141,Abi Samra; Nicholas Camill,13,0,30,17
1649877621273,MATH 10A,A01,083735,Patchell; Gregory David,25,0,30,5
1649877621273,MATH 10A,A02,083736,Patchell; Gregory David,28,0,30,2
1649877621273,MATH 10A,A03,083737,Patchell; Gregory David,29,0,30,1
1649877627304,MATH 10B,A01,083207,Staff,18,0,30,12
1649877627304,MATH 10B,A02,083208,Staff,28,0,30,2
1649877627304,MATH 10B,B01,083739,Staff,26,0,30,4
1649877627304,MATH 10B,B02,083740,Staff,30,0,30,0
1649877633335,MATH 18,A01,083743,Staff,25,0,30,5
1649877633335,MATH 18,A02,083744,Staff,30,0,30,0
1649877633335,MATH 18,A03,083745,Staff,29,0,30,1
1649877633335,MATH 18,A04,083746,Staff,30,0,30,0
1649877633335,MATH 18,B01,083748,Staff,19,0,30,11
1649877633335,MATH 18,B02,083749,Staff,29,0,30,1
1649877633335,MATH 18,B03,083750,Staff,29,0,30,1
1649877633335,MATH 18,B04,083751,Staff,28,0,30,2
1649877639369,MATH 20A,A01,083754,Staff,39,0,40,1
1649877645395,MATH 20B,A01,083756,Staff,28,0,30,2
1649877645395,MATH 20B,A02,083757,Staff,30,0,30,0
1649877651418,MATH 20C,A01,083760,Staff,23,0,30,7
1649877651418,MATH 20C,A02,083761,Staff,30,0,30,0
1649877651418,MATH 20C,B01,083762,Staff,30,0,30,0
1649877651418,MATH 20C,B02,083763,Staff,30,0,30,0
1649877657441,MATH 20D,A01,083765,Staff,22,0,30,8
1649877657441,MATH 20D,A02,083766,Staff,30,0,30,0
1649877657441,MATH 20D,A03,083767,Staff,30,0,30,0
1649877663473,MATH 20E,A01,083771,Staff,20,0,30,10
1649877663473,MATH 20E,A02,083772,Staff,29,0,30,1
1649877663473,MATH 20E,B01,083773,Staff,25,0,30,5
1649877663473,MATH 20E,B02,083774,Staff,29,0,30,1
1649877669495,MATH 103A,A01,083777,Staff,0,0,30,30
1649877669495,MATH 103A,A02,083778,Staff,16,0,30,14
1649877669495,MATH 103A,B01,083779,Staff,11,0,30,19
1649877669495,MATH 103A,B02,083780,Staff,24,0,30,6
1649877675522,MATH 105,A01,085443,Staff,7,0,30,23
1649877681545,MATH 109,A01,083213,Anzaldo; Leesa B,28,0,30,2
1649877681545,MATH 109,A02,083214,Anzaldo; Leesa B,22,0,30,8
1649877681545,MATH 109,B01,083215,Anzaldo; Leesa B,27,0,30,3
1649877681545,MATH 109,B02,083216,Anzaldo; Leesa B,26,0,30,4
1649877687574,MATH 142A,A01,083219,Chow; Bennett,0,0,30,30
1649877687574,MATH 142A,A02,083220,Chow; Bennett,24,0,30,6
1649877687574,MATH 142A,B01,083221,Chow; Bennett,10,0,30,20
1649877687574,MATH 142A,B02,083222,Chow; Bennett,26,0,30,4
1649877693602,MATH 193A,A01,083224,Staff,0,1,30,30
1649877693602,MATH 193A,A02,083225,Staff,0,0,30,30
1649877693602,MATH 193A,A03,083781,Staff,28,0,30,2
1649877693602,MATH 193A,A04,083782,Staff,27,0,30,3
1649877699629,MATH 197,001,091859,McAuley; Julian John,9999,0,9999,0
1649877705689,COGS 9,A01,083615,Staff,37,0,60,23
1649877711715,COGS 11,A01,083617,Boyle; Mary E. T.,36,0,40,4
1649877717738,COGS 13,A01,083071,Staff,14,0,40,26
1649877723771,COGS 14A,A01,092681,Staff,93,0,100,7
1649877729796,COGS 14B,A01,083073,Cheng; Tzu-Han,36,0,50,14
1649877735825,COGS 17,A01,092677,Staff,73,0,75,2
1649877741848,COGS 100,A01,083619,Staff,25,0,60,35
1649877747870,COGS 101A,A01,083621,Davis; Joshua Daniel,23,0,60,37
1649877753899,COGS 101B,A01,091572,Staff,38,0,60,22
1649877759922,COGS 101C,A01,083625,Delgado; Tania,25,0,30,5
1649877765945,COGS 107A,A01,083627,Boyle; Mary E. T.,26,0,60,34
1649877771971,COGS 118A,A01,083075,Staff,29,0,60,31
1649877777996,CSE 3,A50,083646,Miranda; Gregory Joseph,29,0,38,9
1649877777996,CSE 3,A51,083647,Miranda; Gregory Joseph,37,0,37,0
1649877784019,CSE 8A,A50,083650,Miranda; Gregory Joseph,22,0,40,18
1649877790051,CSE 11,A01,083080,Cao; Yingjun,0,5,40,40
1649877796077,CSE 12,A01,083652,Staff,77,0,100,23
1649877802104,CSE 15L,A01,083654,Staff,34,0,50,16
1649877802104,CSE 15L,A02,083655,Staff,48,0,50,2
1649877808228,CSE 20,A01,083657,Staff,73,0,80,7
1649877814251,CSE 30,A01,083084,Eldon; John,2,0,40,38
1649877820285,CSE 100,A01,083659,Cao; Yingjun,0,1,50,50
1649877826311,CSE 134B,A01,083661,Powell; Thomas Allan,0,21,65,65
1649877832333,CSE 140,A01,083663,Staff,41,0,75,34
1649877838376,CSE 140L,A01,083088,Eldon; John,35,0,75,40
1649877844403,CSE 175,A01,083665,Kumar; Rakesh,14,0,25,11
1649877850436,CSE 190,A00,092507,Staff,15,0,15,0
1649877856462,ECE 45,A01,083139,Staff,30,0,40,10
1649877862491,ECE 65,A50,083695,Staff,19,0,30,11
1649877868521,ECE 109,A01,091882,Touri; Behrouz,63,0,70,7
1649877874543,ECE 180,A00,083140,Abi Samra; Nicholas Camill,28,0,30,2
1649877874543,ECE 180,B00,083141,Abi Samra; Nicholas Camill,13,0,30,17
1649877880565,MATH 10A,A01,083735,Patchell; Gregory David,25,0,30,5
1649877880565,MATH 10A,A02,083736,Patchell; Gregory David,28,0,30,2
1649877880565,MATH 10A,A03,083737,Patchell; Gregory David,29,0,30,1
1649877886588,MATH 10B,A01,083207,Staff,18,0,30,12
1649877886588,MATH 10B,A02,083208,Staff,28,0,30,2
1649877886588,MATH 10B,B01,083739,Staff,26,0,30,4
1649877886588,MATH 10B,B02,083740,Staff,30,0,30,0
1649877892615,MATH 18,A01,083743,Staff,25,0,30,5
1649877892615,MATH 18,A02,083744,Staff,30,0,30,0
1649877892615,MATH 18,A03,083745,Staff,29,0,30,1
1649877892615,MATH 18,A04,083746,Staff,30,0,30,0
1649877892615,MATH 18,B01,083748,Staff,19,0,30,11
1649877892615,MATH 18,B02,083749,Staff,29,0,30,1
1649877892615,MATH 18,B03,083750,Staff,29,0,30,1
1649877892615,MATH 18,B04,083751,Staff,28,0,30,2
1649877898643,MATH 20A,A01,083754,Staff,39,0,40,1
1649877904664,MATH 20B,A01,083756,Staff,28,0,30,2
1649877904664,MATH 20B,A02,083757,Staff,30,0,30,0
1649877910688,MATH 20C,A01,083760,Staff,23,0,30,7
1649877910688,MATH 20C,A02,083761,Staff,30,0,30,0
1649877910688,MATH 20C,B01,083762,Staff,30,0,30,0
1649877910688,MATH 20C,B02,083763,Staff,30,0,30,0
1649877916712,MATH 20D,A01,083765,Staff,22,0,30,8
1649877916712,MATH 20D,A02,083766,Staff,30,0,30,0
1649877916712,MATH 20D,A03,083767,Staff,30,0,30,0
1649877922744,MATH 20E,A01,083771,Staff,20,0,30,10
1649877922744,MATH 20E,A02,083772,Staff,29,0,30,1
1649877922744,MATH 20E,B01,083773,Staff,25,0,30,5
1649877922744,MATH 20E,B02,083774,Staff,29,0,30,1
1649877928780,MATH 103A,A01,083777,Staff,0,0,30,30
1649877928780,MATH 103A,A02,083778,Staff,15,0,30,15
1649877928780,MATH 103A,B01,083779,Staff,10,0,30,20
1649877928780,MATH 103A,B02,083780,Staff,24,0,30,6
1649877934804,MATH 105,A01,085443,Staff,7,0,30,23
1649877940830,MATH 109,A01,083213,Anzaldo; Leesa B,28,0,30,2
1649877940830,MATH 109,A02,083214,Anzaldo; Leesa B,22,0,30,8
1649877940830,MATH 109,B01,083215,Anzaldo; Leesa B,27,0,30,3
1649877940830,MATH 109,B02,083216,Anzaldo; Leesa B,26,0,30,4
1649877946858,MATH 142A,A01,083219,Chow; Bennett,0,0,30,30
1649877946858,MATH 142A,A02,083220,Chow; Bennett,24,0,30,6
1649877946858,MATH 142A,B01,083221,Chow; Bennett,10,0,30,20
1649877946858,MATH 142A,B02,083222,Chow; Bennett,26,0,30,4
1649877952881,MATH 193A,A01,083224,Staff,0,1,30,30
1649877952881,MATH 193A,A02,083225,Staff,0,0,30,30
1649877952881,MATH 193A,A03,083781,Staff,28,0,30,2
1649877952881,MATH 193A,A04,083782,Staff,27,0,30,3
1649877958910,MATH 197,001,091859,McAuley; Julian John,9999,0,9999,0
1649877964981,COGS 9,A01,083615,Staff,37,0,60,23
1649877971008,COGS 11,A01,083617,Boyle; Mary E. T.,36,0,40,4
1649877977031,COGS 13,A01,083071,Staff,14,0,40,26
1649877983054,COGS 14A,A01,092681,Staff,93,0,100,7
1649877989093,COGS 14B,A01,083073,Cheng; Tzu-Han,36,0,50,14
1649877995119,COGS 17,A01,092677,Staff,73,0,75,2
1649878001146,COGS 100,A01,083619,Staff,24,0,60,36
1649878007414,COGS 101A,A01,083621,Davis; Joshua Daniel,23,0,60,37
1649878013443,COGS 101B,A01,091572,Staff,38,0,60,22
1649878019477,COGS 101C,A01,083625,Delgado; Tania,25,0,30,5
1649878025505,COGS 107A,A01,083627,Boyle; Mary E. T.,26,0,60,34
1649878031528,COGS 118A,A01,083075,Staff,29,0,60,31
1649878037554,CSE 3,A50,083646,Miranda; Gregory Joseph,29,0,38,9
1649878037554,CSE 3,A51,083647,Miranda; Gregory Joseph,37,0,37,0
1649878043583,CSE 8A,A50,083650,Miranda; Gregory Joseph,22,0,40,18
1649878049605,CSE 11,A01,083080,Cao; Yingjun,0,5,40,40
1649878055633,CSE 12,A01,083652,Staff,77,0,100,23
1649878061665,CSE 15L,A01,083654,Staff,34,0,50,16
1649878061665,CSE 15L,A02,083655,Staff,48,0,50,2
1649878067696,CSE 20,A01,083657,Staff,73,0,80,7
1649878073719,CSE 30,A01,083084,Eldon; John,2,0,40,38
1649878079743,CSE 100,A01,083659,Cao; Yingjun,0,1,50,50
1649878085773,CSE 134B,A01,083661,Powell; Thomas Allan,0,22,65,65
1649878091810,CSE 140,A01,083663,Staff,41,0,75,34
1649878097847,CSE 140L,A01,083088,Eldon; John,35,0,75,40
1649878103887,CSE 175,A01,083665,Kumar; Rakesh,14,0,25,11
1649878109917,CSE 190,A00,092507,Staff,15,0,15,0
1649878115959,ECE 45,A01,083139,Staff,29,0,40,11
1649878121985,ECE 65,A50,083695,Staff,19,0,30,11
1649878128009,ECE 109,A01,091882,Touri; Behrouz,63,0,70,7
1649878134036,ECE 180,A00,083140,Abi Samra; Nicholas Camill,28,0,30,2
1649878134036,ECE 180,B00,083141,Abi Samra; Nicholas Camill,13,0,30,17
1649878140061,MATH 10A,A01,083735,Patchell; Gregory David,25,0,30,5
1649878140061,MATH 10A,A02,083736,Patchell; Gregory David,28,0,30,2
1649878140061,MATH 10A,A03,083737,Patchell; Gregory David,29,0,30,1
1649878146085,MATH 10B,A01,083207,Staff,18,0,30,12
1649878146085,MATH 10B,A02,083208,Staff,28,0,30,2
1649878146085,MATH 10B,B01,083739,Staff,26,0,30,4
1649878146085,MATH 10B,B02,083740,Staff,30,0,30,0
1649878152110,MATH 18,A01,083743,Staff,25,0,30,5
1649878152110,MATH 18,A02,083744,Staff,30,0,30,0
1649878152110,MATH 18,A03,083745,Staff,29,0,30,1
1649878152110,MATH 18,A04,083746,Staff,30,0,30,0
1649878152110,MATH 18,B01,083748,Staff,19,0,30,11
1649878152110,MATH 18,B02,083749,Staff,29,0,30,1
1649878152110,MATH 18,B03,083750,Staff,29,0,30,1
1649878152110,MATH 18,B04,083751,Staff,28,0,30,2
1649878158144,MATH 20A,A01,083754,Staff,39,0,40,1
1649878164166,MATH 20B,A01,083756,Staff,28,0,30,2
1649878164166,MATH 20B,A02,083757,Staff,30,0,30,0
1649878170195,MATH 20C,A01,083760,Staff,24,0,30,6
1649878170195,MATH 20C,A02,083761,Staff,29,0,30,1
1649878170195,MATH 20C,B01,083762,Staff,30,0,30,0
1649878170195,MATH 20C,B02,083763,Staff,30,0,30,0
1649878176218,MATH 20D,A01,083765,Staff,22,0,30,8
1649878176218,MATH 20D,A02,083766,Staff,30,0,30,0
1649878176218,MATH 20D,A03,083767,Staff,30,0,30,0
1649878182242,MATH 20E,A01,083771,Staff,20,0,30,10
1649878182242,MATH 20E,A02,083772,Staff,29,0,30,1
1649878182242,MATH 20E,B01,083773,Staff,25,0,30,5
1649878182242,MATH 20E,B02,083774,Staff,29,0,30,1
1649878188270,MATH 103A,A01,083777,Staff,0,0,30,30
1649878188270,MATH 103A,A02,083778,Staff,15,0,30,15
1649878188270,MATH 103A,B01,083779,Staff,10,0,30,20
1649878188270,MATH 103A,B02,083780,Staff,24,0,30,6
1649878194292,MATH 105,A01,085443,Staff,7,0,30,23
1649878200315,MATH 109,A01,083213,Anzaldo; Leesa B,28,0,30,2
1649878200315,MATH 109,A02,083214,Anzaldo; Leesa B,22,0,30,8
1649878200315,MATH 109,B01,083215,Anzaldo; Leesa B,27,0,30,3
1649878200315,MATH 109,B02,083216,Anzaldo; Leesa B,26,0,30,4
1649878206339,MATH 142A,A01,083219,Chow; Bennett,0,0,30,30
1649878206339,MATH 142A,A02,083220,Chow; Bennett,24,0,30,6
1649878206339,MATH 142A,B01,083221,Chow; Bennett,10,0,30,20
1649878206339,MATH 142A,B02,083222,Chow; Bennett,26,0,30,4
1649878212363,MATH 193A,A01,083224,Staff,0,1,30,30
1649878212363,MATH 193A,A02,083225,Staff,0,0,30,30
1649878212363,MATH 193A,A03,083781,Staff,28,0,30,2
1649878212363,MATH 193A,A04,083782,Staff,27,0,30,3
1649878218391,MATH 197,001,091859,McAuley; Julian John,9999,0,9999,0
1649878224462,COGS 9,A01,083615,Staff,37,0,60,23
1649878230491,COGS 11,A01,083617,Boyle; Mary E. T.,36,0,40,4
1649878236516,COGS 13,A01,083071,Staff,14,0,40,26
1649878242541,COGS 14A,A01,092681,Staff,93,0,100,7
1649878248566,COGS 14B,A01,083073,Cheng; Tzu-Han,36,0,50,14
1649878254592,COGS 17,A01,092677,Staff,73,0,75,2
1649878260617,COGS 100,A01,083619,Staff,24,0,60,36
1649878266660,COGS 101A,A01,083621,Davis; Joshua Daniel,23,0,60,37
1649878272687,COGS 101B,A01,091572,Staff,38,0,60,22
1649878278712,COGS 101C,A01,083625,Delgado; Tania,25,0,30,5
1649878284735,COGS 107A,A01,083627,Boyle; Mary E. T.,26,0,60,34
1649878290757,COGS 118A,A01,083075,Staff,29,0,60,31
1649878296787,CSE 3,A50,083646,Miranda; Gregory Joseph,29,0,38,9
1649878296787,CSE 3,A51,083647,Miranda; Gregory Joseph,37,0,37,0
1649878302816,CSE 8A,A50,083650,Miranda; Gregory Joseph,22,0,40,18
1649878308848,CSE 11,A01,083080,Cao; Yingjun,0,5,40,40
1649878314871,CSE 12,A01,083652,Staff,77,0,100,23
1649878320896,CSE 15L,A01,083654,Staff,34,0,50,16
1649878320896,CSE 15L,A02,083655,Staff,48,0,50,2
1649878326925,CSE 20,A01,083657,Staff,73,0,80,7
1649878332949,CSE 30,A01,083084,Eldon; John,2,0,40,38
1649878338979,CSE 100,A01,083659,Cao; Yingjun,0,1,50,50
1649878345002,CSE 134B,A01,083661,Powell; Thomas Allan,0,22,65,65
1649878351037,CSE 140,A01,083663,Staff,41,0,75,34
1649878357064,CSE 140L,A01,083088,Eldon; John,35,0,75,40
1649878363086,CSE 175,A01,083665,Kumar; Rakesh,14,0,25,11
1649878369109,CSE 190,A00,092507,Staff,15,0,15,0
1649878375133,ECE 45,A01,083139,Staff,28,0,40,12
1649878381157,ECE 65,A50,083695,Staff,19,0,30,11
1649878387189,ECE 109,A01,091882,Touri; Behrouz,62,0,70,8
1649878393215,ECE 180,A00,083140,Abi Samra; Nicholas Camill,28,0,30,2
1649878393215,ECE 180,B00,083141,Abi Samra; Nicholas Camill,13,0,30,17
1649878399251,MATH 10A,A01,083735,Patchell; Gregory David,25,0,30,5
1649878399251,MATH 10A,A02,083736,Patchell; Gregory David,28,0,30,2
1649878399251,MATH 10A,A03,083737,Patchell; Gregory David,29,0,30,1
1649878405367,MATH 10B,A01,083207,Staff,18,0,30,12
1649878405367,MATH 10B,A02,083208,Staff,28,0,30,2
1649878405367,MATH 10B,B01,083739,Staff,26,0,30,4
1649878405367,MATH 10B,B02,083740,Staff,30,0,30,0
1649878411391,MATH 18,A01,083743,Staff,25,0,30,5
1649878411391,MATH 18,A02,083744,Staff,30,0,30,0
1649878411391,MATH 18,A03,083745,Staff,29,0,30,1
1649878411391,MATH 18,A04,083746,Staff,30,0,30,0
1649878411391,MATH 18,B01,083748,Staff,19,0,30,11
1649878411391,MATH 18,B02,083749,Staff,29,0,30,1
1649878411391,MATH 18,B03,083750,Staff,29,0,30,1
1649878411391,MATH 18,B04,083751,Staff,28,0,30,2
1649878417416,MATH 20A,A01,083754,Staff,39,0,40,1
1649878423444,MATH 20B,A01,083756,Staff,28,0,30,2
1649878423444,MATH 20B,A02,083757,Staff,30,0,30,0
1649878429477,MATH 20C,A01,083760,Staff,24,0,30,6
1649878429477,MATH 20C,A02,083761,Staff,29,0,30,1
1649878429477,MATH 20C,B01,083762,Staff,30,0,30,0
1649878429477,MATH 20C,B02,083763,Staff,30,0,30,0
1649878435501,MATH 20D,A01,083765,Staff,22,0,30,8
1649878435501,MATH 20D,A02,083766,Staff,30,0,30,0
1649878435501,MATH 20D,A03,083767,Staff,30,0,30,0
1649878441530,MATH 20E,A01,083771,Staff,20,0,30,10
1649878441530,MATH 20E,A02,083772,Staff,29,0,30,1
1649878441530,MATH 20E,B01,083773,Staff,25,0,30,5
1649878441530,MATH 20E,B02,083774,Staff,29,0,30,1
1649878447557,MATH 103A,A01,083777,Staff,0,0,30,30
1649878447557,MATH 103A,A02,083778,Staff,15,0,30,15
1649878447557,MATH 103A,B01,083779,Staff,10,0,30,20
1649878447557,MATH 103A,B02,083780,Staff,24,0,30,6
1649878453600,MATH 105,A01,085443,Staff,7,0,30,23
1649878459627,MATH 109,A01,083213,Anzaldo; Leesa B,28,0,30,2
1649878459627,MATH 109,A02,083214,Anzaldo; Leesa B,22,0,30,8
1649878459627,MATH 109,B01,083215,Anzaldo; Leesa B,27,0,30,3
1649878459627,MATH 109,B02,083216,Anzaldo; Leesa B,26,0,30,4
1649878465663,MATH 142A,A01,083219,Chow; Bennett,0,0,30,30
1649878465663,MATH 142A,A02,083220,Chow; Bennett,24,0,30,6
1649878465663,MATH 142A,B01,083221,Chow; Bennett,10,0,30,20
1649878465663,MATH 142A,B02,083222,Chow; Bennett,26,0,30,4
1649878471690,MATH 193A,A01,083224,Staff,0,1,30,30
1649878471690,MATH 193A,A02,083225,Staff,0,0,30,30
1649878471690,MATH 193A,A03,083781,Staff,28,0,30,2
1649878471690,MATH 193A,A04,083782,Staff,27,0,30,3
1649878477721,MATH 197,001,091859,McAuley; Julian John,9999,0,9999,0
1649878483779,COGS 9,A01,083615,Staff,37,0,60,23
1649878489810,COGS 11,A01,083617,Boyle; Mary E. T.,36,0,40,4
1649878495833,COGS 13,A01,083071,Staff,12,0,40,28
1649878501858,COGS 14A,A01,092681,Staff,92,0,100,8
1649878507885,COGS 14B,A01,083073,Cheng; Tzu-Han,36,0,50,14
1649878513909,COGS 17,A01,092677,Staff,72,0,75,3
1649878519932,COGS 100,A01,083619,Staff,24,0,60,36
1649878525955,COGS 101A,A01,083621,Davis; Joshua Daniel,22,0,60,38
1649878531978,COGS 101B,A01,091572,Staff,38,0,60,22
1649878538002,COGS 101C,A01,083625,Delgado; Tania,25,0,30,5
1649878544028,COGS 107A,A01,083627,Boyle; Mary E. T.,26,0,60,34
1649878550052,COGS 118A,A01,083075,Staff,29,0,60,31
1649878556076,CSE 3,A50,083646,Miranda; Gregory Joseph,29,0,38,9
1649878556076,CSE 3,A51,083647,Miranda; Gregory Joseph,37,0,37,0
1649878562113,CSE 8A,A50,083650,Miranda; Gregory Joseph,22,0,40,18
1649878568136,CSE 11,A01,083080,Cao; Yingjun,0,5,40,40
1649878574168,CSE 12,A01,083652,Staff,77,0,100,23
1649878580192,CSE 15L,A01,083654,Staff,34,0,50,16
1649878580192,CSE 15L,A02,083655,Staff,48,0,50,2
1649878586215,CSE 20,A01,083657,Staff,73,0,80,7
1649878592238,CSE 30,A01,083084,Eldon; John,2,0,40,38
1649878598263,CSE 100,A01,083659,Cao; Yingjun,0,1,50,50
1649878604288,CSE 134B,A01,083661,Powell; Thomas Allan,0,22,65,65
1649878610320,CSE 140,A01,083663,Staff,41,0,75,34
1649878616347,CSE 140L,A01,083088,Eldon; John,35,0,75,40
1649878622375,CSE 175,A01,083665,Kumar; Rakesh,14,0,25,11
1649878628399,CSE 190,A00,092507,Staff,15,0,15,0
1649878634421,ECE 45,A01,083139,Staff,28,0,40,12
1649878640444,ECE 65,A50,083695,Staff,19,0,30,11
1649878646471,ECE 109,A01,091882,Touri; Behrouz,61,0,70,9
1649878652502,ECE 180,A00,083140,Abi Samra; Nicholas Camill,28,0,30,2
1649878652502,ECE 180,B00,083141,Abi Samra; Nicholas Camill,13,0,30,17
1649878658535,MATH 10A,A01,083735,Patchell; Gregory David,25,0,30,5
1649878658535,MATH 10A,A02,083736,Patchell; Gregory David,28,0,30,2
1649878658535,MATH 10A,A03,083737,Patchell; Gregory David,29,0,30,1
1649878664557,MATH 10B,A01,083207,Staff,18,0,30,12
1649878664557,MATH 10B,A02,083208,Staff,28,0,30,2
1649878664557,MATH 10B,B01,083739,Staff,26,0,30,4
1649878664557,MATH 10B,B02,083740,Staff,30,0,30,0
1649878670587,MATH 18,A01,083743,Staff,25,0,30,5
1649878670587,MATH 18,A02,083744,Staff,30,0,30,0
1649878670587,MATH 18,A03,083745,Staff,29,0,30,1
1649878670587,MATH 18,A04,083746,Staff,30,0,30,0
1649878670587,MATH 18,B01,083748,Staff,19,0,30,11
1649878670587,MATH 18,B02,083749,Staff,29,0,30,1
1649878670587,MATH 18,B03,083750,Staff,29,0,30,1
1649878670587,MATH 18,B04,083751,Staff,28,0,30,2
1649878676610,MATH 20A,A01,083754,Staff,39,0,40,1
1649878682634,MATH 20B,A01,083756,Staff,28,0,30,2
1649878682634,MATH 20B,A02,083757,Staff,30,0,30,0
1649878688657,MATH 20C,A01,083760,Staff,24,0,30,6
1649878688657,MATH 20C,A02,083761,Staff,29,0,30,1
1649878688657,MATH 20C,B01,083762,Staff,30,0,30,0
1649878688657,MATH 20C,B02,083763,Staff,30,0,30,0
1649878694683,MATH 20D,A01,083765,Staff,22,0,30,8
1649878694683,MATH 20D,A02,083766,Staff,30,0,30,0
1649878694683,MATH 20D,A03,083767,Staff,30,0,30,0
1649878700711,MATH 20E,A01,083771,Staff,20,0,30,10
1649878700711,MATH 20E,A02,083772,Staff,29,0,30,1
1649878700711,MATH 20E,B01,083773,Staff,25,0,30,5
1649878700711,MATH 20E,B02,083774,Staff,29,0,30,1
1649878706739,MATH 103A,A01,083777,Staff,0,0,30,30
1649878706739,MATH 103A,A02,083778,Staff,15,0,30,15
1649878706739,MATH 103A,B01,083779,Staff,10,0,30,20
1649878706739,MATH 103A,B02,083780,Staff,24,0,30,6
1649878712766,MATH 105,A01,085443,Staff,7,0,30,23
1649878718797,MATH 109,A01,083213,Anzaldo; Leesa B,28,0,30,2
1649878718797,MATH 109,A02,083214,Anzaldo; Leesa B,22,0,30,8
1649878718797,MATH 109,B01,083215,Anzaldo; Leesa B,27,0,30,3
1649878718797,MATH 109,B02,083216,Anzaldo; Leesa B,26,0,30,4
1649878724833,MATH 142A,A01,083219,Chow; Bennett,0,0,30,30
1649878724833,MATH 142A,A02,083220,Chow; Bennett,24,0,30,6
1649878724833,MATH 142A,B01,083221,Chow; Bennett,10,0,30,20
1649878724833,MATH 142A,B02,083222,Chow; Bennett,26,0,30,4
1649878730860,MATH 193A,A01,083224,Staff,0,1,30,30
1649878730860,MATH 193A,A02,083225,Staff,0,0,30,30
1649878730860,MATH 193A,A03,083781,Staff,28,0,30,2
1649878730860,MATH 193A,A04,083782,Staff,27,0,30,3
1649878736886,MATH 197,001,091859,McAuley; Julian John,9999,0,9999,0
1649878742964,COGS 9,A01,083615,Staff,37,0,60,23
1649878748986,COGS 11,A01,083617,Boyle; Mary E. T.,36,0,40,4
1649878755028,COGS 13,A01,083071,Staff,12,0,40,28
1649878761066,COGS 14A,A01,092681,Staff,92,0,100,8
1649878767089,COGS 14B,A01,083073,Cheng; Tzu-Han,36,0,50,14
1649878773113,COGS 17,A01,092677,Staff,72,0,75,3
1649878779149,COGS 100,A01,083619,Staff,24,0,60,36
1649878785172,COGS 101A,A01,083621,Davis; Joshua Daniel,22,0,60,38
1649878791203,COGS 101B,A01,091572,Staff,38,0,60,22
1649878797229,COGS 101C,A01,083625,Delgado; Tania,25,0,30,5
1649878803260,COGS 107A,A01,083627,Boyle; Mary E. T.,26,0,60,34
1649878809283,COGS 118A,A01,083075,Staff,29,0,60,31
1649878815310,CSE 3,A50,083646,Miranda; Gregory Joseph,29,0,38,9
1649878815310,CSE 3,A51,083647,Miranda; Gregory Joseph,37,0,37,0
1649878821334,CSE 8A,A50,083650,Miranda; Gregory Joseph,21,0,40,19
1649878827361,CSE 11,A01,083080,Cao; Yingjun,0,5,40,40
1649878833384,CSE 12,A01,083652,Staff,77,0,100,23
1649878839412,CSE 15L,A01,083654,Staff,34,0,50,16
1649878839412,CSE 15L,A02,083655,Staff,48,0,50,2
1649878845434,CSE 20,A01,083657,Staff,73,0,80,7
1649878851457,CSE 30,A01,083084,Eldon; John,2,0,40,38
1649878857482,CSE 100,A01,083659,Cao; Yingjun,0,1,50,50
1649878863505,CSE 134B,A01,083661,Powell; Thomas Allan,0,22,65,65
1649878869530,CSE 140,A01,083663,Staff,41,0,75,34
1649878875553,CSE 140L,A01,083088,Eldon; John,35,0,75,40
1649878881587,CSE 175,A01,083665,Kumar; Rakesh,14,0,25,11
1649878887611,CSE 190,A00,092507,Staff,15,0,15,0
1649878893633,ECE 45,A01,083139,Staff,28,0,40,12
1649878899656,ECE 65,A50,083695,Staff,18,0,30,12
1649878905680,ECE 109,A01,091882,Touri; Behrouz,61,0,70,9
1649878911709,ECE 180,A00,083140,Abi Samra; Nicholas Camill,28,0,30,2
1649878911709,ECE 180,B00,083141,Abi Samra; Nicholas Camill,13,0,30,17
1649878917732,MATH 10A,A01,083735,Patchell; Gregory David,25,0,30,5
1649878917732,MATH 10A,A02,083736,Patchell; Gregory David,28,0,30,2
1649878917732,MATH 10A,A03,083737,Patchell; Gregory David,29,0,30,1
1649878923759,MATH 10B,A01,083207,Staff,18,0,30,12
1649878923759,MATH 10B,A02,083208,Staff,28,0,30,2
1649878923759,MATH 10B,B01,083739,Staff,26,0,30,4
1649878923759,MATH 10B,B02,083740,Staff,30,0,30,0
1649878929788,MATH 18,A01,083743,Staff,25,0,30,5
1649878929788,MATH 18,A02,083744,Staff,30,0,30,0
1649878929788,MATH 18,A03,083745,Staff,29,0,30,1
1649878929788,MATH 18,A04,083746,Staff,30,0,30,0
1649878929788,MATH 18,B01,083748,Staff,19,0,30,11
1649878929788,MATH 18,B02,083749,Staff,29,0,30,1
1649878929788,MATH 18,B03,083750,Staff,29,0,30,1
1649878929788,MATH 18,B04,083751,Staff,28,0,30,2
1649878935822,MATH 20A,A01,083754,Staff,39,0,40,1
1649878941845,MATH 20B,A01,083756,Staff,28,0,30,2
1649878941845,MATH 20B,A02,083757,Staff,30,0,30,0
1649878947877,MATH 20C,A01,083760,Staff,24,0,30,6
1649878947877,MATH 20C,A02,083761,Staff,29,0,30,1
1649878947877,MATH 20C,B01,083762,Staff,30,0,30,0
1649878947877,MATH 20C,B02,083763,Staff,30,0,30,0
1649878953900,MATH 20D,A01,083765,Staff,22,0,30,8
1649878953900,MATH 20D,A02,083766,Staff,30,0,30,0
1649878953900,MATH 20D,A03,083767,Staff,30,0,30,0
1649878959926,MATH 20E,A01,083771,Staff,20,0,30,10
1649878959926,MATH 20E,A02,083772,Staff,29,0,30,1
1649878959926,MATH 20E,B01,083773,Staff,25,0,30,5
1649878959926,MATH 20E,B02,083774,Staff,29,0,30,1
1649878965955,MATH 103A,A01,083777,Staff,0,0,30,30
1649878965955,MATH 103A,A02,083778,Staff,14,0,30,16
1649878965955,MATH 103A,B01,083779,Staff,10,0,30,20
1649878965955,MATH 103A,B02,083780,Staff,24,0,30,6
1649878971981,MATH 105,A01,085443,Staff,6,0,30,24
1649878978009,MATH 109,A01,083213,Anzaldo; Leesa B,28,0,30,2
1649878978009,MATH 109,A02,083214,Anzaldo; Leesa B,21,0,30,9
1649878978009,MATH 109,B01,083215,Anzaldo; Leesa B,27,0,30,3
1649878978009,MATH 109,B02,083216,Anzaldo; Leesa B,26,0,30,4
1649878984038,MATH 142A,A01,083219,Chow; Bennett,0,0,30,30
1649878984038,MATH 142A,A02,083220,Chow; Bennett,24,0,30,6
1649878984038,MATH 142A,B01,083221,Chow; Bennett,8,0,30,22
1649878984038,MATH 142A,B02,083222,Chow; Bennett,26,0,30,4
1649878990074,MATH 193A,A01,083224,Staff,0,1,30,30
1649878990074,MATH 193A,A02,083225,Staff,0,0,30,30
1649878990074,MATH 193A,A03,083781,Staff,27,0,30,3
1649878990074,MATH 193A,A04,083782,Staff,27,0,30,3
1649878996108,MATH 197,001,091859,McAuley; Julian John,9999,0,9999,0
1649879002268,COGS 9,A01,083615,Staff,37,0,60,23
1649879008292,COGS 11,A01,083617,Boyle; Mary E. T.,36,0,40,4
1649879014325,COGS 13,A01,083071,Staff,12,0,40,28
1649879020350,COGS 14A,A01,092681,Staff,92,0,100,8
1649879026384,COGS 14B,A01,083073,Cheng; Tzu-Han,36,0,50,14
1649879032407,COGS 17,A01,092677,Staff,72,0,75,3
1649879038433,COGS 100,A01,083619,Staff,24,0,60,36
1649879044458,COGS 101A,A01,083621,Davis; Joshua Daniel,22,0,60,38
1649879050483,COGS 101B,A01,091572,Staff,38,0,60,22
1649879056505,COGS 101C,A01,083625,Delgado; Tania,25,0,30,5
1649879062537,COGS 107A,A01,083627,Boyle; Mary E. T.,26,0,60,34
1649879068570,COGS 118A,A01,083075,Staff,29,0,60,31
1649879074592,CSE 3,A50,083646,Miranda; Gregory Joseph,29,0,38,9
1649879074592,CSE 3,A51,083647,Miranda; Gregory Joseph,37,0,37,0
1649879080618,CSE 8A,A50,083650,Miranda; Gregory Joseph,21,0,40,19
1649879086642,CSE 11,A01,083080,Cao; Yingjun,0,6,40,40
1649879092667,CSE 12,A01,083652,Staff,77,0,100,23
1649879098690,CSE 15L,A01,083654,Staff,34,0,50,16
1649879098690,CSE 15L,A02,083655,Staff,48,0,50,2
1649879104711,CSE 20,A01,083657,Staff,73,0,80,7
1649879110749,CSE 30,A01,083084,Eldon; John,2,0,40,38
1649879116770,CSE 100,A01,083659,Cao; Yingjun,0,1,50,50
1649879122793,CSE 134B,A01,083661,Powell; Thomas Allan,0,22,65,65
1649879128818,CSE 140,A01,083663,Staff,41,0,75,34
1649879134842,CSE 140L,A01,083088,Eldon; John,34,0,75,41
1649879140865,CSE 175,A01,083665,Kumar; Rakesh,14,0,25,11
1649879146893,CSE 190,A00,092507,Staff,15,0,15,0
1649879152930,ECE 45,A01,083139,Staff,28,0,40,12
1649879158961,ECE 65,A50,083695,Staff,18,0,30,12
1649879165001,ECE 109,A01,091882,Touri; Behrouz,61,0,70,9
1649879171025,ECE 180,A00,083140,Abi Samra; Nicholas Camill,28,0,30,2
1649879171025,ECE 180,B00,083141,Abi Samra; Nicholas Camill,13,0,30,17
1649879177051,MATH 10A,A01,083735,Patchell; Gregory David,25,0,30,5
1649879177051,MATH 10A,A02,083736,Patchell; Gregory David,28,0,30,2
1649879177051,MATH 10A,A03,083737,Patchell; Gregory David,29,0,30,1
1649879183080,MATH 10B,A01,083207,Staff,17,0,30,13
1649879183080,MATH 10B,A02,083208,Staff,28,0,30,2
1649879183080,MATH 10B,B01,083739,Staff,26,0,30,4
1649879183080,MATH 10B,B02,083740,Staff,30,0,30,0
1649879189129,MATH 18,A01,083743,Staff,25,0,30,5
1649879189129,MATH 18,A02,083744,Staff,30,0,30,0
1649879189129,MATH 18,A03,083745,Staff,29,0,30,1
1649879189129,MATH 18,A04,083746,Staff,30,0,30,0
1649879189129,MATH 18,B01,083748,Staff,19,0,30,11
1649879189129,MATH 18,B02,083749,Staff,29,0,30,1
1649879189129,MATH 18,B03,083750,Staff,29,0,30,1
1649879189129,MATH 18,B04,083751,Staff,28,0,30,2
1649879195154,MATH 20A,A01,083754,Staff,39,0,40,1
1649879201178,MATH 20B,A01,083756,Staff,28,0,30,2
1649879201178,MATH 20B,A02,083757,Staff,30,0,30,0
1649879207212,MATH 20C,A01,083760,Staff,24,0,30,6
1649879207212,MATH 20C,A02,083761,Staff,29,0,30,1
1649879207212,MATH 20C,B01,083762,Staff,30,0,30,0
1649879207212,MATH 20C,B02,083763,Staff,30,0,30,0
1649879213247,MATH 20D,A01,083765,Staff,22,0,30,8
1649879213247,MATH 20D,A02,083766,Staff,30,0,30,0
1649879213247,MATH 20D,A03,083767,Staff,30,0,30,0
1649879219275,MATH 20E,A01,083771,Staff,20,0,30,10
1649879219275,MATH 20E,A02,083772,Staff,29,0,30,1
1649879219275,MATH 20E,B01,083773,Staff,25,0,30,5
1649879219275,MATH 20E,B02,083774,Staff,29,0,30,1
1649879225303,MATH 103A,A01,083777,Staff,0,0,30,30
1649879225303,MATH 103A,A02,083778,Staff,14,0,30,16
1649879225303,MATH 103A,B01,083779,Staff,10,0,30,20
1649879225303,MATH 103A,B02,083780,Staff,24,0,30,6
1649879231343,MATH 105,A01,085443,Staff,6,0,30,24
1649879237369,MATH 109,A01,083213,Anzaldo; Leesa B,27,0,30,3
1649879237369,MATH 109,A02,083214,Anzaldo; Leesa B,21,0,30,9
1649879237369,MATH 109,B01,083215,Anzaldo; Leesa B,27,0,30,3
1649879237369,MATH 109,B02,083216,Anzaldo; Leesa B,26,0,30,4
1649879243396,MATH 142A,A01,083219,Chow; Bennett,0,0,30,30
1649879243396,MATH 142A,A02,083220,Chow; Bennett,24,0,30,6
1649879243396,MATH 142A,B01,083221,Chow; Bennett,8,0,30,22
1649879243396,MATH 142A,B02,083222,Chow; Bennett,26,0,30,4
1649879249426,MATH 193A,A01,083224,Staff,0,2,30,30
1649879249426,MATH 193A,A02,083225,Staff,0,0,30,30
1649879249426,MATH 193A,A03,083781,Staff,27,0,30,3
1649879249426,MATH 193A,A04,083782,Staff,27,0,30,3
1649879255449,MATH 197,001,091859,McAuley; Julian John,9999,0,9999,0
1649879261512,COGS 9,A01,083615,Staff,37,0,60,23
1649879267534,COGS 11,A01,083617,Boyle; Mary E. T.,36,0,40,4
1649879273558,COGS 13,A01,083071,Staff,12,0,40,28
1649879279586,COGS 14A,A01,092681,Staff,91,0,100,9
1649879285628,COGS 14B,A01,083073,Cheng; Tzu-Han,36,0,50,14
1649879291665,COGS 17,A01,092677,Staff,72,0,75,3
1649879297688,COGS 100,A01,083619,Staff,24,0,60,36
1649879303728,COGS 101A,A01,083621,Davis; Joshua Daniel,22,0,60,38
1649879309755,COGS 101B,A01,091572,Staff,38,0,60,22
1649879315788,COGS 101C,A01,083625,Delgado; Tania,25,0,30,5
1649879321812,COGS 107A,A01,083627,Boyle; Mary E. T.,26,0,60,34
1649879327836,COGS 118A,A01,083075,Staff,29,0,60,31
1649879333869,CSE 3,A50,083646,Miranda; Gregory Joseph,29,0,38,9
1649879333869,CSE 3,A51,083647,Miranda; Gregory Joseph,37,0,37,0
1649879339897,CSE 8A,A50,083650,Miranda; Gregory Joseph,21,0,40,19
1649879345921,CSE 11,A01,083080,Cao; Yingjun,0,6,40,40
1649879351955,CSE 12,A01,083652,Staff,77,0,100,23
1649879357986,CSE 15L,A01,083654,Staff,34,0,50,16
1649879357986,CSE 15L,A02,083655,Staff,48,0,50,2
1649879364017,CSE 20,A01,083657,Staff,73,0,80,7
1649879370040,CSE 30,A01,083084,Eldon; John,1,0,40,39
1649879376080,CSE 100,A01,083659,Cao; Yingjun,0,1,50,50
1649879382105,CSE 134B,A01,083661,Powell; Thomas Allan,0,22,65,65
1649879388129,CSE 140,A01,083663,Staff,41,0,75,34
1649879394171,CSE 140L,A01,083088,Eldon; John,34,0,75,41
1649879400209,CSE 175,A01,083665,Kumar; Rakesh,14,0,25,11
1649879406237,CSE 190,A00,092507,Staff,15,0,15,0
1649879412265,ECE 45,A01,083139,Staff,28,0,40,12
1649879418290,ECE 65,A50,083695,Staff,18,0,30,12
1649879424320,ECE 109,A01,091882,Touri; Behrouz,61,0,70,9
1649879430347,ECE 180,A00,083140,Abi Samra; Nicholas Camill,28,0,30,2
1649879430347,ECE 180,B00,083141,Abi Samra; Nicholas Camill,13,0,30,17
1649879436378,MATH 10A,A01,083735,Patchell; Gregory David,25,0,30,5
1649879436378,MATH 10A,A02,083736,Patchell; Gregory David,28,0,30,2
1649879436378,MATH 10A,A03,083737,Patchell; Gregory David,29,0,30,1
1649879442411,MATH 10B,A01,083207,Staff,17,0,30,13
1649879442411,MATH 10B,A02,083208,Staff,28,0,30,2
1649879442411,MATH 10B,B01,083739,Staff,26,0,30,4
1649879442411,MATH 10B,B02,083740,Staff,30,0,30,0
1649879448443,MATH 18,A01,083743,Staff,25,0,30,5
1649879448443,MATH 18,A02,083744,Staff,30,0,30,0
1649879448443,MATH 18,A03,083745,Staff,29,0,30,1
1649879448443,MATH 18,A04,083746,Staff,30,0,30,0
1649879448443,MATH 18,B01,083748,Staff,19,0,30,11
1649879448443,MATH 18,B02,083749,Staff,29,0,30,1
1649879448443,MATH 18,B03,083750,Staff,29,0,30,1
1649879448443,MATH 18,B04,083751,Staff,28,0,30,2
1649879454476,MATH 20A,A01,083754,Staff,39,0,40,1
1649879460499,MATH 20B,A01,083756,Staff,28,0,30,2
1649879460499,MATH 20B,A02,083757,Staff,30,0,30,0
1649879466526,MATH 20C,A01,083760,Staff,24,0,30,6
1649879466526,MATH 20C,A02,083761,Staff,29,0,30,1
1649879466526,MATH 20C,B01,083762,Staff,30,0,30,0
1649879466526,MATH 20C,B02,083763,Staff,30,0,30,0
1649879472561,MATH 20D,A01,083765,Staff,22,0,30,8
1649879472561,MATH 20D,A02,083766,Staff,30,0,30,0
1649879472561,MATH 20D,A03,083767,Staff,30,0,30,0
1649879478590,MATH 20E,A01,083771,Staff,20,0,30,10
1649879478590,MATH 20E,A02,083772,Staff,29,0,30,1
1649879478590,MATH 20E,B01,083773,Staff,25,0,30,5
1649879478590,MATH 20E,B02,083774,Staff,29,0,30,1
1649879484615,MATH 103A,A01,083777,Staff,0,0,30,30
1649879484615,MATH 103A,A02,083778,Staff,14,0,30,16
1649879484615,MATH 103A,B01,083779,Staff,10,0,30,20
1649879484615,MATH 103A,B02,083780,Staff,24,0,30,6
1649879490641,MATH 105,A01,085443,Staff,5,0,30,25
1649879496700,MATH 109,A01,083213,Anzaldo; Leesa B,27,0,30,3
1649879496700,MATH 109,A02,083214,Anzaldo; Leesa B,21,0,30,9
1649879496700,MATH 109,B01,083215,Anzaldo; Leesa B,27,0,30,3
1649879496700,MATH 109,B02,083216,Anzaldo; Leesa B,26,0,30,4
1649879502733,MATH 142A,A01,083219,Chow; Bennett,0,0,30,30
1649879502733,MATH 142A,A02,083220,Chow; Bennett,24,0,30,6
1649879502733,MATH 142A,B01,083221,Chow; Bennett,8,0,30,22
1649879502733,MATH 142A,B02,083222,Chow; Bennett,26,0,30,4
1649879508757,MATH 193A,A01,083224,Staff,0,2,30,30
1649879508757,MATH 193A,A02,083225,Staff,0,0,30,30
1649879508757,MATH 193A,A03,083781,Staff,27,0,30,3
1649879508757,MATH 193A,A04,083782,Staff,27,0,30,3
1649879514783,MATH 197,001,091859,McAuley; Julian John,9999,0,9999,0
1649879520842,COGS 9,A01,083615,Staff,37,0,60,23
1649879526882,COGS 11,A01,083617,Boyle; Mary E. T.,36,0,40,4
1649879532920,COGS 13,A01,083071,Staff,12,0,40,28
1649879538944,COGS 14A,A01,092681,Staff,91,0,100,9
1649879544969,COGS 14B,A01,083073,Cheng; Tzu-Han,36,0,50,14
1649879550997,COGS 17,A01,092677,Staff,72,0,75,3
1649879557025,COGS 100,A01,083619,Staff,23,0,60,37
1649879563048,COGS 101A,A01,083621,Davis; Joshua Daniel,22,0,60,38
1649879569077,COGS 101B,A01,091572,Staff,38,0,60,22
1649879575102,COGS 101C,A01,083625,Delgado; Tania,25,0,30,5
1649879581137,COGS 107A,A01,083627,Boyle; Mary E. T.,26,0,60,34
1649879587165,COGS 118A,A01,083075,Staff,29,0,60,31
1649879593290,CSE 3,A50,083646,Miranda; Gregory Joseph,29,0,38,9
1649879593290,CSE 3,A51,083647,Miranda; Gregory Joseph,37,0,37,0
1649879599325,CSE 8A,A50,083650,Miranda; Gregory Joseph,21,0,40,19
1649879605363,CSE 11,A01,083080,Cao; Yingjun,0,6,40,40
1649879611397,CSE 12,A01,083652,Staff,77,0,100,23
1649879617419,CSE 15L,A01,083654,Staff,34,0,50,16
1649879617419,CSE 15L,A02,083655,Staff,48,0,50,2
1649879623451,CSE 20,A01,083657,Staff,73,0,80,7
1649879629475,CSE 30,A01,083084,Eldon; John,1,0,40,39
1649879635505,CSE 100,A01,083659,Cao; Yingjun,0,2,50,50
1649879641545,CSE 134B,A01,083661,Powell; Thomas Allan,0,22,65,65
1649879647571,CSE 140,A01,083663,Staff,41,0,75,34
1649879653594,CSE 140L,A01,083088,Eldon; John,34,0,75,41
1649879659621,CSE 175,A01,083665,Kumar; Rakesh,14,0,25,11
1649879665647,CSE 190,A00,092507,Staff,15,0,15,0
1649879671673,ECE 45,A01,083139,Staff,28,0,40,12
1649879677697,ECE 65,A50,083695,Staff,18,0,30,12
1649879683726,ECE 109,A01,091882,Touri; Behrouz,61,0,70,9
1649879689754,ECE 180,A00,083140,Abi Samra; Nicholas Camill,28,0,30,2
1649879689754,ECE 180,B00,083141,Abi Samra; Nicholas Camill,13,0,30,17
1649879695777,MATH 10A,A01,083735,Patchell; Gregory David,25,0,30,5
1649879695777,MATH 10A,A02,083736,Patchell; Gregory David,28,0,30,2
1649879695777,MATH 10A,A03,083737,Patchell; Gregory David,29,0,30,1
1649879701800,MATH 10B,A01,083207,Staff,17,0,30,13
1649879701800,MATH 10B,A02,083208,Staff,28,0,30,2
1649879701800,MATH 10B,B01,083739,Staff,26,0,30,4
1649879701800,MATH 10B,B02,083740,Staff,30,0,30,0
1649879707835,MATH 18,A01,083743,Staff,25,0,30,5
1649879707835,MATH 18,A02,083744,Staff,30,0,30,0
1649879707835,MATH 18,A03,083745,Staff,29,0,30,1
1649879707835,MATH 18,A04,083746,Staff,30,0,30,0
1649879707835,MATH 18,B01,083748,Staff,19,0,30,11
1649879707835,MATH 18,B02,083749,Staff,29,0,30,1
1649879707835,MATH 18,B03,083750,Staff,29,0,30,1
1649879707835,MATH 18,B04,083751,Staff,28,0,30,2
1649879713872,MATH 20A,A01,083754,Staff,39,0,40,1
1649879719901,MATH 20B,A01,083756,Staff,28,0,30,2
1649879719901,MATH 20B,A02,083757,Staff,30,0,30,0
1649879725929,MATH 20C,A01,083760,Staff,24,0,30,6
1649879725929,MATH 20C,A02,083761,Staff,29,0,30,1
1649879725929,MATH 20C,B01,083762,Staff,30,0,30,0
1649879725929,MATH 20C,B02,083763,Staff,30,0,30,0
1649879731970,MATH 20D,A01,083765,Staff,22,0,30,8
1649879731970,MATH 20D,A02,083766,Staff,30,0,30,0
1649879731970,MATH 20D,A03,083767,Staff,30,0,30,0
1649879737997,MATH 20E,A01,083771,Staff,20,0,30,10
1649879737997,MATH 20E,A02,083772,Staff,29,0,30,1
1649879737997,MATH 20E,B01,083773,Staff,25,0,30,5
1649879737997,MATH 20E,B02,083774,Staff,29,0,30,1
1649879744031,MATH 103A,A01,083777,Staff,0,0,30,30
1649879744031,MATH 103A,A02,083778,Staff,14,0,30,16
1649879744031,MATH 103A,B01,083779,Staff,10,0,30,20
1649879744031,MATH 103A,B02,083780,Staff,24,0,30,6
1649879755714,MATH 105,A01,085443,Staff,5,0,30,25
1649879761741,MATH 109,A01,083213,Anzaldo; Leesa B,27,0,30,3
1649879761741,MATH 109,A02,083214,Anzaldo; Leesa B,21,0,30,9
1649879761741,MATH 109,B01,083215,Anzaldo; Leesa B,27,0,30,3
1649879761741,MATH 109,B02,083216,Anzaldo; Leesa B,26,0,30,4
1649879767773,MATH 142A,A01,083219,Chow; Bennett,0,0,30,30
1649879767773,MATH 142A,A02,083220,Chow; Bennett,25,0,30,5
1649879767773,MATH 142A,B01,083221,Chow; Bennett,7,0,30,23
1649879767773,MATH 142A,B02,083222,Chow; Bennett,25,0,30,5
1649879773810,MATH 193A,A01,083224,Staff,0,2,30,30
1649879773810,MATH 193A,A02,083225,Staff,0,0,30,30
1649879773810,MATH 193A,A03,083781,Staff,26,0,30,4
1649879773810,MATH 193A,A04,083782,Staff,27,0,30,3
1649879779833,MATH 197,001,091859,McAuley; Julian John,9999,0,9999,0
1649879785889,COGS 9,A01,083615,Staff,37,0,60,23
1649879791916,COGS 11,A01,083617,Boyle; Mary E. T.,36,0,40,4
1649879797939,COGS 13,A01,083071,Staff,12,0,40,28
1649879803964,COGS 14A,A01,092681,Staff,91,0,100,9
1649879809989,COGS 14B,A01,083073,Cheng; Tzu-Han,36,0,50,14
1649879816011,COGS 17,A01,092677,Staff,72,0,75,3
1649879822034,COGS 100,A01,083619,Staff,21,0,60,39
1649879828057,COGS 101A,A01,083621,Davis; Joshua Daniel,22,0,60,38
1649879834079,COGS 101B,A01,091572,Staff,38,0,60,22
1649879840105,COGS 101C,A01,083625,Delgado; Tania,25,0,30,5
1649879846132,COGS 107A,A01,083627,Boyle; Mary E. T.,26,0,60,34
1649879852166,COGS 118A,A01,083075,Staff,29,0,60,31
1649879858193,CSE 3,A50,083646,Miranda; Gregory Joseph,29,0,38,9
1649879858193,CSE 3,A51,083647,Miranda; Gregory Joseph,37,0,37,0
1649879864216,CSE 8A,A50,083650,Miranda; Gregory Joseph,21,0,40,19
1649879870238,CSE 11,A01,083080,Cao; Yingjun,0,6,40,40
1649879876273,CSE 12,A01,083652,Staff,77,0,100,23
1649879882300,CSE 15L,A01,083654,Staff,34,0,50,16
1649879882300,CSE 15L,A02,083655,Staff,48,0,50,2
1649879888342,CSE 20,A01,083657,Staff,73,0,80,7
1649879894366,CSE 30,A01,083084,Eldon; John,1,0,40,39
1649879900391,CSE 100,A01,083659,Cao; Yingjun,0,2,50,50
1649879906414,CSE 134B,A01,083661,Powell; Thomas Allan,0,22,65,65
1649879912441,CSE 140,A01,083663,Staff,41,0,75,34
1649879918462,CSE 140L,A01,083088,Eldon; John,34,0,75,41
1649879924569,CSE 175,A01,083665,Kumar; Rakesh,14,0,25,11
1649879930590,CSE 190,A00,092507,Staff,15,0,15,0
1649879936621,ECE 45,A01,083139,Staff,28,0,40,12
1649879942651,ECE 65,A50,083695,Staff,18,0,30,12
1649879948673,ECE 109,A01,091882,Touri; Behrouz,61,0,70,9
1649879954705,ECE 180,A00,083140,Abi Samra; Nicholas Camill,28,0,30,2
1649879954705,ECE 180,B00,083141,Abi Samra; Nicholas Camill,13,0,30,17
1649879960733,MATH 10A,A01,083735,Patchell; Gregory David,25,0,30,5
1649879960733,MATH 10A,A02,083736,Patchell; Gregory David,28,0,30,2
1649879960733,MATH 10A,A03,083737,Patchell; Gregory David,29,0,30,1
1649879966764,MATH 10B,A01,083207,Staff,17,0,30,13
1649879966764,MATH 10B,A02,083208,Staff,28,0,30,2
1649879966764,MATH 10B,B01,083739,Staff,26,0,30,4
1649879966764,MATH 10B,B02,083740,Staff,30,0,30,0
1649879972787,MATH 18,A01,083743,Staff,25,0,30,5
1649879972787,MATH 18,A02,083744,Staff,30,0,30,0
1649879972787,MATH 18,A03,083745,Staff,29,0,30,1
1649879972787,MATH 18,A04,083746,Staff,30,0,30,0
1649879972787,MATH 18,B01,083748,Staff,19,0,30,11
1649879972787,MATH 18,B02,083749,Staff,29,0,30,1
1649879972787,MATH 18,B03,083750,Staff,29,0,30,1
1649879972787,MATH 18,B04,083751,Staff,28,0,30,2
1649879978821,MATH 20A,A01,083754,Staff,39,0,40,1
1649879984856,MATH 20B,A01,083756,Staff,28,0,30,2
1649879984856,MATH 20B,A02,083757,Staff,30,0,30,0
1649879990879,MATH 20C,A01,083760,Staff,24,0,30,6
1649879990879,MATH 20C,A02,083761,Staff,29,0,30,1
1649879990879,MATH 20C,B01,083762,Staff,30,0,30,0
1649879990879,MATH 20C,B02,083763,Staff,30,0,30,0
1649879996910,MATH 20D,A01,083765,Staff,22,0,30,8
1649879996910,MATH 20D,A02,083766,Staff,30,0,30,0
1649879996910,MATH 20D,A03,083767,Staff,30,0,30,0
1649880002934,MATH 20E,A01,083771,Staff,20,0,30,10
1649880002934,MATH 20E,A02,083772,Staff,29,0,30,1
1649880002934,MATH 20E,B01,083773,Staff,25,0,30,5
1649880002934,MATH 20E,B02,083774,Staff,29,0,30,1
1649880008957,MATH 103A,A01,083777,Staff,0,0,30,30
1649880008957,MATH 103A,A02,083778,Staff,14,0,30,16
1649880008957,MATH 103A,B01,083779,Staff,10,0,30,20
1649880008957,MATH 103A,B02,083780,Staff,24,0,30,6
1649880014986,MATH 105,A01,085443,Staff,5,0,30,25
1649880021010,MATH 109,A01,083213,Anzaldo; Leesa B,27,0,30,3
1649880021010,MATH 109,A02,083214,Anzaldo; Leesa B,21,0,30,9
1649880021010,MATH 109,B01,083215,Anzaldo; Leesa B,27,0,30,3
1649880021010,MATH 109,B02,083216,Anzaldo; Leesa B,26,0,30,4
1649880027038,MATH 142A,A01,083219,Chow; Bennett,0,0,30,30
1649880027038,MATH 142A,A02,083220,Chow; Bennett,25,0,30,5
1649880027038,MATH 142A,B01,083221,Chow; Bennett,6,0,30,24
1649880027038,MATH 142A,B02,083222,Chow; Bennett,25,0,30,5
1649880033077,MATH 193A,A01,083224,Staff,0,1,30,30
1649880033077,MATH 193A,A02,083225,Staff,0,0,30,30
1649880033077,MATH 193A,A03,083781,Staff,25,0,30,5
1649880033077,MATH 193A,A04,083782,Staff,27,0,30,3
1649880039104,MATH 197,001,091859,McAuley; Julian John,9999,0,9999,0
1649880045176,COGS 9,A01,083615,Staff,37,0,60,23
1649880051206,COGS 11,A01,083617,Boyle; Mary E. T.,36,0,40,4
1649880057232,COGS 13,A01,083071,Staff,12,0,40,28
1649880063274,COGS 14A,A01,092681,Staff,91,0,100,9
1649880069298,COGS 14B,A01,083073,Cheng; Tzu-Han,36,0,50,14
1649880075321,COGS 17,A01,092677,Staff,72,0,75,3
1649880081344,COGS 100,A01,083619,Staff,21,0,60,39
1649880087375,COGS 101A,A01,083621,Davis; Joshua Daniel,21,0,60,39
1649880093399,COGS 101B,A01,091572,Staff,38,0,60,22
1649880099426,COGS 101C,A01,083625,Delgado; Tania,25,0,30,5
1649880105449,COGS 107A,A01,083627,Boyle; Mary E. T.,26,0,60,34
1649880111483,COGS 118A,A01,083075,Staff,29,0,60,31
1649880117510,CSE 3,A50,083646,Miranda; Gregory Joseph,29,0,38,9
1649880117510,CSE 3,A51,083647,Miranda; Gregory Joseph,37,0,37,0
1649880123538,CSE 8A,A50,083650,Miranda; Gregory Joseph,21,0,40,19
1649880129567,CSE 11,A01,083080,Cao; Yingjun,0,6,40,40
1649880135589,CSE 12,A01,083652,Staff,77,0,100,23
1649880141613,CSE 15L,A01,083654,Staff,34,0,50,16
1649880141613,CSE 15L,A02,083655,Staff,48,0,50,2
1649880147634,CSE 20,A01,083657,Staff,73,0,80,7
1649880153668,CSE 30,A01,083084,Eldon; John,1,0,40,39
1649880159691,CSE 100,A01,083659,Cao; Yingjun,0,2,50,50
1649880165715,CSE 134B,A01,083661,Powell; Thomas Allan,0,22,65,65
1649880171740,CSE 140,A01,083663,Staff,41,0,75,34
1649880177766,CSE 140L,A01,083088,Eldon; John,34,0,75,41
1649880183791,CSE 175,A01,083665,Kumar; Rakesh,14,0,25,11
1649880189814,CSE 190,A00,092507,Staff,15,0,15,0
1649880195941,ECE 45,A01,083139,Staff,25,0,40,15
1649880201964,ECE 65,A50,083695,Staff,18,0,30,12
1649880207987,ECE 109,A01,091882,Touri; Behrouz,60,0,70,10
1649880214011,ECE 180,A00,083140,Abi Samra; Nicholas Camill,28,0,30,2
1649880214011,ECE 180,B00,083141,Abi Samra; Nicholas Camill,13,0,30,17
1649880220046,MATH 10A,A01,083735,Patchell; Gregory David,25,0,30,5
1649880220046,MATH 10A,A02,083736,Patchell; Gregory David,28,0,30,2
1649880220046,MATH 10A,A03,083737,Patchell; Gregory David,29,0,30,1
1649880226083,MATH 10B,A01,083207,Staff,17,0,30,13
1649880226083,MATH 10B,A02,083208,Staff,28,0,30,2
1649880226083,MATH 10B,B01,083739,Staff,26,0,30,4
1649880226083,MATH 10B,B02,083740,Staff,30,0,30,0
1649880232118,MATH 18,A01,083743,Staff,25,0,30,5
1649880232118,MATH 18,A02,083744,Staff,30,0,30,0
1649880232118,MATH 18,A03,083745,Staff,29,0,30,1
1649880232118,MATH 18,A04,083746,Staff,30,0,30,0
1649880232118,MATH 18,B01,083748,Staff,18,0,30,12
1649880232118,MATH 18,B02,083749,Staff,29,0,30,1
1649880232118,MATH 18,B03,083750,Staff,29,0,30,1
1649880232118,MATH 18,B04,083751,Staff,28,0,30,2
1649880238145,MATH 20A,A01,083754,Staff,39,0,40,1
1649880244179,MATH 20B,A01,083756,Staff,28,0,30,2
1649880244179,MATH 20B,A02,083757,Staff,30,0,30,0
1649880250207,MATH 20C,A01,083760,Staff,24,0,30,6
1649880250207,MATH 20C,A02,083761,Staff,29,0,30,1
1649880250207,MATH 20C,B01,083762,Staff,30,0,30,0
1649880250207,MATH 20C,B02,083763,Staff,30,0,30,0
1649880256236,MATH 20D,A01,083765,Staff,22,0,30,8
1649880256236,MATH 20D,A02,083766,Staff,30,0,30,0
1649880256236,MATH 20D,A03,083767,Staff,30,0,30,0
1649880262271,MATH 20E,A01,083771,Staff,20,0,30,10
1649880262271,MATH 20E,A02,083772,Staff,29,0,30,1
1649880262271,MATH 20E,B01,083773,Staff,25,0,30,5
1649880262271,MATH 20E,B02,083774,Staff,29,0,30,1
1649880268294,MATH 103A,A01,083777,Staff,0,0,30,30
1649880268294,MATH 103A,A02,083778,Staff,14,0,30,16
1649880268294,MATH 103A,B01,083779,Staff,10,0,30,20
1649880268294,MATH 103A,B02,083780,Staff,24,0,30,6
1649880274327,MATH 105,A01,085443,Staff,5,0,30,25
1649880280360,MATH 109,A01,083213,Anzaldo; Leesa B,27,0,30,3
1649880280360,MATH 109,A02,083214,Anzaldo; Leesa B,21,0,30,9
1649880280360,MATH 109,B01,083215,Anzaldo; Leesa B,27,0,30,3
1649880280360,MATH 109,B02,083216,Anzaldo; Leesa B,26,0,30,4
1649880286383,MATH 142A,A01,083219,Chow; Bennett,0,0,30,30
1649880286383,MATH 142A,A02,083220,Chow; Bennett,25,0,30,5
1649880286383,MATH 142A,B01,083221,Chow; Bennett,6,0,30,24
1649880286383,MATH 142A,B02,083222,Chow; Bennett,25,0,30,5
1649880292407,MATH 193A,A01,083224,Staff,0,1,30,30
1649880292407,MATH 193A,A02,083225,Staff,0,0,30,30
1649880292407,MATH 193A,A03,083781,Staff,25,0,30,5
1649880292407,MATH 193A,A04,083782,Staff,27,0,30,3
1649880298430,MATH 197,001,091859,McAuley; Julian John,9999,0,9999,0
1649880304495,COGS 9,A01,083615,Staff,37,0,60,23
1649880310517,COGS 11,A01,083617,Boyle; Mary E. T.,36,0,40,4
1649880316540,COGS 13,A01,083071,Staff,12,0,40,28
1649880322569,COGS 14A,A01,092681,Staff,91,0,100,9
1649880328596,COGS 14B,A01,083073,Cheng; Tzu-Han,35,0,50,15
1649880334624,COGS 17,A01,092677,Staff,71,0,75,4
1649880340659,COGS 100,A01,083619,Staff,21,0,60,39
1649880346682,COGS 101A,A01,083621,Davis; Joshua Daniel,20,0,60,40
1649880352704,COGS 101B,A01,091572,Staff,38,0,60,22
1649880358739,COGS 101C,A01,083625,Delgado; Tania,25,0,30,5
1649880364761,COGS 107A,A01,083627,Boyle; Mary E. T.,26,0,60,34
1649880370787,COGS 118A,A01,083075,Staff,29,0,60,31
1649880376815,CSE 3,A50,083646,Miranda; Gregory Joseph,29,0,38,9
1649880376815,CSE 3,A51,083647,Miranda; Gregory Joseph,37,0,37,0
1649880382842,CSE 8A,A50,083650,Miranda; Gregory Joseph,21,0,40,19
1649880388866,CSE 11,A01,083080,Cao; Yingjun,0,6,40,40
1649880394888,CSE 12,A01,083652,Staff,77,0,100,23
1649880400917,CSE 15L,A01,083654,Staff,34,0,50,16
1649880400917,CSE 15L,A02,083655,Staff,48,0,50,2
1649880406944,CSE 20,A01,083657,Staff,73,0,80,7
1649880412985,CSE 30,A01,083084,Eldon; John,1,0,40,39
1649880419014,CSE 100,A01,083659,Cao; Yingjun,0,2,50,50
1649880425042,CSE 134B,A01,083661,Powell; Thomas Allan,0,22,65,65
1649880431080,CSE 140,A01,083663,Staff,41,0,75,34
1649880437107,CSE 140L,A01,083088,Eldon; John,34,0,75,41
1649880443130,CSE 175,A01,083665,Kumar; Rakesh,14,0,25,11
1649880449169,CSE 190,A00,092507,Staff,15,0,15,0
1649880455191,ECE 45,A01,083139,Staff,25,0,40,15
1649880461217,ECE 65,A50,083695,Staff,18,0,30,12
1649880467241,ECE 109,A01,091882,Touri; Behrouz,60,0,70,10
1649880473266,ECE 180,A00,083140,Abi Samra; Nicholas Camill,28,0,30,2
1649880473266,ECE 180,B00,083141,Abi Samra; Nicholas Camill,13,0,30,17
1649880479309,MATH 10A,A01,083735,Patchell; Gregory David,25,0,30,5
1649880479309,MATH 10A,A02,083736,Patchell; Gregory David,28,0,30,2
1649880479309,MATH 10A,A03,083737,Patchell; Gregory David,29,0,30,1
1649880485336,MATH 10B,A01,083207,Staff,17,0,30,13
1649880485336,MATH 10B,A02,083208,Staff,28,0,30,2
1649880485336,MATH 10B,B01,083739,Staff,26,0,30,4
1649880485336,MATH 10B,B02,083740,Staff,30,0,30,0
1649880491359,MATH 18,A01,083743,Staff,25,0,30,5
1649880491359,MATH 18,A02,083744,Staff,30,0,30,0
1649880491359,MATH 18,A03,083745,Staff,29,0,30,1
1649880491359,MATH 18,A04,083746,Staff,30,0,30,0
1649880491359,MATH 18,B01,083748,Staff,18,0,30,12
1649880491359,MATH 18,B02,083749,Staff,29,0,30,1
1649880491359,MATH 18,B03,083750,Staff,29,0,30,1
1649880491359,MATH 18,B04,083751,Staff,28,0,30,2
1649880497402,MATH 20A,A01,083754,Staff,39,0,40,1
1649880503433,MATH 20B,A01,083756,Staff,28,0,30,2
1649880503433,MATH 20B,A02,083757,Staff,30,0,30,0
1649880509456,MATH 20C,A01,083760,Staff,24,0,30,6
1649880509456,MATH 20C,A02,083761,Staff,29,0,30,1
1649880509456,MATH 20C,B01,083762,Staff,30,0,30,0
1649880509456,MATH 20C,B02,083763,Staff,30,0,30,0
1649880515481,MATH 20D,A01,083765,Staff,22,0,30,8
1649880515481,MATH 20D,A02,083766,Staff,30,0,30,0
1649880515481,MATH 20D,A03,083767,Staff,30,0,30,0
1649880521505,MATH 20E,A01,083771,Staff,20,0,30,10
1649880521505,MATH 20E,A02,083772,Staff,29,0,30,1
1649880521505,MATH 20E,B01,083773,Staff,25,0,30,5
1649880521505,MATH 20E,B02,083774,Staff,29,0,30,1
1649880527530,MATH 103A,A01,083777,Staff,0,0,30,30
1649880527530,MATH 103A,A02,083778,Staff,14,0,30,16
1649880527530,MATH 103A,B01,083779,Staff,10,0,30,20
1649880527530,MATH 103A,B02,083780,Staff,24,0,30,6
1649880533555,MATH 105,A01,085443,Staff,5,0,30,25
1649880539579,MATH 109,A01,083213,Anzaldo; Leesa B,27,0,30,3
1649880539579,MATH 109,A02,083214,Anzaldo; Leesa B,21,0,30,9
1649880539579,MATH 109,B01,083215,Anzaldo; Leesa B,27,0,30,3
1649880539579,MATH 109,B02,083216,Anzaldo; Leesa B,26,0,30,4
1649880545609,MATH 142A,A01,083219,Chow; Bennett,0,0,30,30
1649880545609,MATH 142A,A02,083220,Chow; Bennett,25,0,30,5
1649880545609,MATH 142A,B01,083221,Chow; Bennett,6,0,30,24
1649880545609,MATH 142A,B02,083222,Chow; Bennett,25,0,30,5
1649880551648,MATH 193A,A01,083224,Staff,0,1,30,30
1649880551648,MATH 193A,A02,083225,Staff,0,0,30,30
1649880551648,MATH 193A,A03,083781,Staff,24,0,30,6
1649880551648,MATH 193A,A04,083782,Staff,27,0,30,3
1649880557671,MATH 197,001,091859,McAuley; Julian John,9999,0,9999,0
1649880563742,COGS 9,A01,083615,Staff,37,0,60,23
1649880569766,COGS 11,A01,083617,Boyle; Mary E. T.,36,0,40,4
1649880575792,COGS 13,A01,083071,Staff,12,0,40,28
1649880581816,COGS 14A,A01,092681,Staff,91,0,100,9
1649880587842,COGS 14B,A01,083073,Cheng; Tzu-Han,35,0,50,15
1649880593867,COGS 17,A01,092677,Staff,71,0,75,4
1649880599889,COGS 100,A01,083619,Staff,21,0,60,39
1649880605913,COGS 101A,A01,083621,Davis; Joshua Daniel,20,0,60,40
1649880611943,COGS 101B,A01,091572,Staff,38,0,60,22
1649880617967,COGS 101C,A01,083625,Delgado; Tania,25,0,30,5
1649880623994,COGS 107A,A01,083627,Boyle; Mary E. T.,26,0,60,34
1649880630019,COGS 118A,A01,083075,Staff,29,0,60,31
1649880636046,CSE 3,A50,083646,Miranda; Gregory Joseph,29,0,38,9
1649880636046,CSE 3,A51,083647,Miranda; Gregory Joseph,37,0,37,0
1649880642069,CSE 8A,A50,083650,Miranda; Gregory Joseph,21,0,40,19
1649880648100,CSE 11,A01,083080,Cao; Yingjun,0,6,40,40
1649880654129,CSE 12,A01,083652,Staff,77,0,100,23
1649880660155,CSE 15L,A01,083654,Staff,34,0,50,16
1649880660155,CSE 15L,A02,083655,Staff,48,0,50,2
1649880666180,CSE 20,A01,083657,Staff,73,0,80,7
1649880672208,CSE 30,A01,083084,Eldon; John,1,0,40,39
1649880678237,CSE 100,A01,083659,Cao; Yingjun,0,2,50,50
1649880684265,CSE 134B,A01,083661,Powell; Thomas Allan,0,22,65,65
1649880690296,CSE 140,A01,083663,Staff,41,0,75,34
1649880696330,CSE 140L,A01,083088,Eldon; John,34,0,75,41
1649880702361,CSE 175,A01,083665,Kumar; Rakesh,14,0,25,11
1649880708392,CSE 190,A00,092507,Staff,15,0,15,0
1649880714431,ECE 45,A01,083139,Staff,25,0,40,15
1649880720463,ECE 65,A50,083695,Staff,18,0,30,12
1649880726508,ECE 109,A01,091882,Touri; Behrouz,60,0,70,10
1649880732539,ECE 180,A00,083140,Abi Samra; Nicholas Camill,28,0,30,2
1649880732539,ECE 180,B00,083141,Abi Samra; Nicholas Camill,13,0,30,17
1649880738566,MATH 10A,A01,083735,Patchell; Gregory David,25,0,30,5
1649880738566,MATH 10A,A02,083736,Patchell; Gregory David,28,0,30,2
1649880738566,MATH 10A,A03,083737,Patchell; Gregory David,29,0,30,1
1649880744591,MATH 10B,A01,083207,Staff,17,0,30,13
1649880744591,MATH 10B,A02,083208,Staff,28,0,30,2
1649880744591,MATH 10B,B01,083739,Staff,26,0,30,4
1649880744591,MATH 10B,B02,083740,Staff,30,0,30,0
1649880750616,MATH 18,A01,083743,Staff,25,0,30,5
1649880750616,MATH 18,A02,083744,Staff,30,0,30,0
1649880750616,MATH 18,A03,083745,Staff,29,0,30,1
1649880750616,MATH 18,A04,083746,Staff,30,0,30,0
1649880750616,MATH 18,B01,083748,Staff,18,0,30,12
1649880750616,MATH 18,B02,083749,Staff,28,0,30,2
1649880750616,MATH 18,B03,083750,Staff,29,0,30,1
1649880750616,MATH 18,B04,083751,Staff,28,0,30,2
1649880756643,MATH 20A,A01,083754,Staff,39,0,40,1
1649880762666,MATH 20B,A01,083756,Staff,28,0,30,2
1649880762666,MATH 20B,A02,083757,Staff,30,0,30,0
1649880768688,MATH 20C,A01,083760,Staff,24,0,30,6
1649880768688,MATH 20C,A02,083761,Staff,29,0,30,1
1649880768688,MATH 20C,B01,083762,Staff,30,0,30,0
1649880768688,MATH 20C,B02,083763,Staff,30,0,30,0
1649880774712,MATH 20D,A01,083765,Staff,22,0,30,8
1649880774712,MATH 20D,A02,083766,Staff,30,0,30,0
1649880774712,MATH 20D,A03,083767,Staff,30,0,30,0
1649880780741,MATH 20E,A01,083771,Staff,20,0,30,10
1649880780741,MATH 20E,A02,083772,Staff,29,0,30,1
1649880780741,MATH 20E,B01,083773,Staff,25,0,30,5
1649880780741,MATH 20E,B02,083774,Staff,29,0,30,1
1649880786766,MATH 103A,A01,083777,Staff,0,0,30,30
1649880786766,MATH 103A,A02,083778,Staff,14,0,30,16
1649880786766,MATH 103A,B01,083779,Staff,10,0,30,20
1649880786766,MATH 103A,B02,083780,Staff,24,0,30,6
1649880792899,MATH 105,A01,085443,Staff,5,0,30,25
1649880798926,MATH 109,A01,083213,Anzaldo; Leesa B,27,0,30,3
1649880798926,MATH 109,A02,083214,Anzaldo; Leesa B,21,0,30,9
1649880798926,MATH 109,B01,083215,Anzaldo; Leesa B,27,0,30,3
1649880798926,MATH 109,B02,083216,Anzaldo; Leesa B,26,0,30,4
1649880804952,MATH 142A,A01,083219,Chow; Bennett,0,0,30,30
1649880804952,MATH 142A,A02,083220,Chow; Bennett,25,0,30,5
1649880804952,MATH 142A,B01,083221,Chow; Bennett,6,0,30,24
1649880804952,MATH 142A,B02,083222,Chow; Bennett,25,0,30,5
1649880810982,MATH 193A,A01,083224,Staff,0,1,30,30
1649880810982,MATH 193A,A02,083225,Staff,0,0,30,30
1649880810982,MATH 193A,A03,083781,Staff,24,0,30,6
1649880810982,MATH 193A,A04,083782,Staff,27,0,30,3
1649880817015,MATH 197,001,091859,McAuley; Julian John,9999,0,9999,0
1649880823089,COGS 9,A01,083615,Staff,37,0,60,23
1649880829245,COGS 11,A01,083617,Boyle; Mary E. T.,36,0,40,4
1649880835281,COGS 13,A01,083071,Staff,12,0,40,28
1649880841316,COGS 14A,A01,092681,Staff,90,0,100,10
1649880847343,COGS 14B,A01,083073,Cheng; Tzu-Han,34,0,50,16
1649880853375,COGS 17,A01,092677,Staff,71,0,75,4
1649880859404,COGS 100,A01,083619,Staff,21,0,60,39
1649880865446,COGS 101A,A01,083621,Davis; Joshua Daniel,20,0,60,40
1649880871469,COGS 101B,A01,091572,Staff,38,0,60,22
1649880877504,COGS 101C,A01,083625,Delgado; Tania,25,0,30,5
1649880883538,COGS 107A,A01,083627,Boyle; Mary E. T.,26,0,60,34
1649880889566,COGS 118A,A01,083075,Staff,29,0,60,31
1649880895604,CSE 3,A50,083646,Miranda; Gregory Joseph,29,0,38,9
1649880895604,CSE 3,A51,083647,Miranda; Gregory Joseph,37,0,37,0
1649880901639,CSE 8A,A50,083650,Miranda; Gregory Joseph,21,0,40,19
1649880907665,CSE 11,A01,083080,Cao; Yingjun,0,7,40,40
1649880913701,CSE 12,A01,083652,Staff,77,0,100,23
1649880919739,CSE 15L,A01,083654,Staff,34,0,50,16
1649880919739,CSE 15L,A02,083655,Staff,48,0,50,2
1649880925770,CSE 20,A01,083657,Staff,73,0,80,7
1649880931797,CSE 30,A01,083084,Eldon; John,1,0,40,39
1649880937820,CSE 100,A01,083659,Cao; Yingjun,0,2,50,50
1649880943845,CSE 134B,A01,083661,Powell; Thomas Allan,0,22,65,65
1649880949871,CSE 140,A01,083663,Staff,41,0,75,34
1649880955893,CSE 140L,A01,083088,Eldon; John,34,0,75,41
1649880961918,CSE 175,A01,083665,Kumar; Rakesh,14,0,25,11
1649880967945,CSE 190,A00,092507,Staff,15,0,15,0
1649880973968,ECE 45,A01,083139,Staff,25,0,40,15
1649880979990,ECE 65,A50,083695,Staff,18,0,30,12
1649880986017,ECE 109,A01,091882,Touri; Behrouz,60,0,70,10
1649880992044,ECE 180,A00,083140,Abi Samra; Nicholas Camill,28,0,30,2
1649880992044,ECE 180,B00,083141,Abi Samra; Nicholas Camill,13,0,30,17
1649880998069,MATH 10A,A01,083735,Patchell; Gregory David,25,0,30,5
1649880998069,MATH 10A,A02,083736,Patchell; Gregory David,28,0,30,2
1649880998069,MATH 10A,A03,083737,Patchell; Gregory David,29,0,30,1
1649881004106,MATH 10B,A01,083207,Staff,17,0,30,13
1649881004106,MATH 10B,A02,083208,Staff,27,0,30,3
1649881004106,MATH 10B,B01,083739,Staff,26,0,30,4
1649881004106,MATH 10B,B02,083740,Staff,30,0,30,0
1649881010129,MATH 18,A01,083743,Staff,25,0,30,5
1649881010129,MATH 18,A02,083744,Staff,30,0,30,0
1649881010129,MATH 18,A03,083745,Staff,29,0,30,1
1649881010129,MATH 18,A04,083746,Staff,30,0,30,0
1649881010129,MATH 18,B01,083748,Staff,17,0,30,13
1649881010129,MATH 18,B02,083749,Staff,28,0,30,2
1649881010129,MATH 18,B03,083750,Staff,29,0,30,1
1649881010129,MATH 18,B04,083751,Staff,28,0,30,2
1649881016154,MATH 20A,A01,083754,Staff,39,0,40,1
1649881022178,MATH 20B,A01,083756,Staff,28,0,30,2
1649881022178,MATH 20B,A02,083757,Staff,30,0,30,0
1649881028199,MATH 20C,A01,083760,Staff,24,0,30,6
1649881028199,MATH 20C,A02,083761,Staff,29,0,30,1
1649881028199,MATH 20C,B01,083762,Staff,30,0,30,0
1649881028199,MATH 20C,B02,083763,Staff,30,0,30,0
1649881034230,MATH 20D,A01,083765,Staff,22,0,30,8
1649881034230,MATH 20D,A02,083766,Staff,30,0,30,0
1649881034230,MATH 20D,A03,083767,Staff,30,0,30,0
1649881040257,MATH 20E,A01,083771,Staff,20,0,30,10
1649881040257,MATH 20E,A02,083772,Staff,29,0,30,1
1649881040257,MATH 20E,B01,083773,Staff,25,0,30,5
1649881040257,MATH 20E,B02,083774,Staff,29,0,30,1
1649881046290,MATH 103A,A01,083777,Staff,0,0,30,30
1649881046290,MATH 103A,A02,083778,Staff,14,0,30,16
1649881046290,MATH 103A,B01,083779,Staff,10,0,30,20
1649881046290,MATH 103A,B02,083780,Staff,24,0,30,6
1649881052314,MATH 105,A01,085443,Staff,5,0,30,25
1649881058336,MATH 109,A01,083213,Anzaldo; Leesa B,27,0,30,3
1649881058336,MATH 109,A02,083214,Anzaldo; Leesa B,21,0,30,9
1649881058336,MATH 109,B01,083215,Anzaldo; Leesa B,27,0,30,3
1649881058336,MATH 109,B02,083216,Anzaldo; Leesa B,26,0,30,4
1649881064370,MATH 142A,A01,083219,Chow; Bennett,0,0,30,30
1649881064370,MATH 142A,A02,083220,Chow; Bennett,25,0,30,5
1649881064370,MATH 142A,B01,083221,Chow; Bennett,6,0,30,24
1649881064370,MATH 142A,B02,083222,Chow; Bennett,24,0,30,6
1649881070397,MATH 193A,A01,083224,Staff,0,1,30,30
1649881070397,MATH 193A,A02,083225,Staff,0,0,30,30
1649881070397,MATH 193A,A03,083781,Staff,23,0,30,7
1649881070397,MATH 193A,A04,083782,Staff,27,0,30,3
1649881076418,MATH 197,001,091859,McAuley; Julian John,9999,0,9999,0
1649881082469,COGS 9,A01,083615,Staff,37,0,60,23
1649881088499,COGS 11,A01,083617,Boyle; Mary E. T.,36,0,40,4
1649881094537,COGS 13,A01,083071,Staff,12,0,40,28
1649881100569,COGS 14A,A01,092681,Staff,90,0,100,10
1649881106603,COGS 14B,A01,083073,Cheng; Tzu-Han,34,0,50,16
1649881112639,COGS 17,A01,092677,Staff,71,0,75,4
1649881118667,COGS 100,A01,083619,Staff,20,0,60,40
1649881124691,COGS 101A,A01,083621,Davis; Joshua Daniel,20,0,60,40
1649881130715,COGS 101B,A01,091572,Staff,38,0,60,22
1649881136739,COGS 101C,A01,083625,Delgado; Tania,25,0,30,5
1649881142762,COGS 107A,A01,083627,Boyle; Mary E. T.,26,0,60,34
1649881148794,COGS 118A,A01,083075,Staff,29,0,60,31
1649881154818,CSE 3,A50,083646,Miranda; Gregory Joseph,29,0,38,9
1649881154818,CSE 3,A51,083647,Miranda; Gregory Joseph,37,0,37,0
1649881160856,CSE 8A,A50,083650,Miranda; Gregory Joseph,21,0,40,19
1649881166883,CSE 11,A01,083080,Cao; Yingjun,0,7,40,40
1649881172909,CSE 12,A01,083652,Staff,77,0,100,23
1649881178936,CSE 15L,A01,083654,Staff,34,0,50,16
1649881178936,CSE 15L,A02,083655,Staff,48,0,50,2
1649881184959,CSE 20,A01,083657,Staff,73,0,80,7
1649881190983,CSE 30,A01,083084,Eldon; John,1,0,40,39
1649881197013,CSE 100,A01,083659,Cao; Yingjun,0,2,50,50
1649881203039,CSE 134B,A01,083661,Powell; Thomas Allan,0,22,65,65
1649881209064,CSE 140,A01,083663,Staff,41,0,75,34
1649881215089,CSE 140L,A01,083088,Eldon; John,34,0,75,41
1649881221113,CSE 175,A01,083665,Kumar; Rakesh,14,0,25,11
1649881227143,CSE 190,A00,092507,Staff,15,0,15,0
1649881233174,ECE 45,A01,083139,Staff,25,0,40,15
1649881239207,ECE 65,A50,083695,Staff,18,0,30,12
1649881245236,ECE 109,A01,091882,Touri; Behrouz,60,0,70,10
1649881251259,ECE 180,A00,083140,Abi Samra; Nicholas Camill,28,0,30,2
1649881251259,ECE 180,B00,083141,Abi Samra; Nicholas Camill,13,0,30,17
1649881257298,MATH 10A,A01,083735,Patchell; Gregory David,25,0,30,5
1649881257298,MATH 10A,A02,083736,Patchell; Gregory David,28,0,30,2
1649881257298,MATH 10A,A03,083737,Patchell; Gregory David,29,0,30,1
1649881263328,MATH 10B,A01,083207,Staff,16,0,30,14
1649881263328,MATH 10B,A02,083208,Staff,27,0,30,3
1649881263328,MATH 10B,B01,083739,Staff,26,0,30,4
1649881263328,MATH 10B,B02,083740,Staff,30,0,30,0
1649881269362,MATH 18,A01,083743,Staff,25,0,30,5
1649881269362,MATH 18,A02,083744,Staff,30,0,30,0
1649881269362,MATH 18,A03,083745,Staff,29,0,30,1
1649881269362,MATH 18,A04,083746,Staff,30,0,30,0
1649881269362,MATH 18,B01,083748,Staff,17,0,30,13
1649881269362,MATH 18,B02,083749,Staff,28,0,30,2
1649881269362,MATH 18,B03,083750,Staff,29,0,30,1
1649881269362,MATH 18,B04,083751,Staff,28,0,30,2
1649881275388,MATH 20A,A01,083754,Staff,39,0,40,1
1649881281422,MATH 20B,A01,083756,Staff,28,0,30,2
1649881281422,MATH 20B,A02,083757,Staff,30,0,30,0
1649881287446,MATH 20C,A01,083760,Staff,24,0,30,6
1649881287446,MATH 20C,A02,083761,Staff,29,0,30,1
1649881287446,MATH 20C,B01,083762,Staff,30,0,30,0
1649881287446,MATH 20C,B02,083763,Staff,30,0,30,0
1649881293476,MATH 20D,A01,083765,Staff,22,0,30,8
1649881293476,MATH 20D,A02,083766,Staff,30,0,30,0
1649881293476,MATH 20D,A03,083767,Staff,30,0,30,0
1649881299500,MATH 20E,A01,083771,Staff,20,0,30,10
1649881299500,MATH 20E,A02,083772,Staff,29,0,30,1
1649881299500,MATH 20E,B01,083773,Staff,25,0,30,5
1649881299500,MATH 20E,B02,083774,Staff,29,0,30,1
1649881305539,MATH 103A,A01,083777,Staff,0,0,30,30
1649881305539,MATH 103A,A02,083778,Staff,14,0,30,16
1649881305539,MATH 103A,B01,083779,Staff,10,0,30,20
1649881305539,MATH 103A,B02,083780,Staff,24,0,30,6
1649881311562,MATH 105,A01,085443,Staff,5,0,30,25
1649881317587,MATH 109,A01,083213,Anzaldo; Leesa B,27,0,30,3
1649881317587,MATH 109,A02,083214,Anzaldo; Leesa B,21,0,30,9
1649881317587,MATH 109,B01,083215,Anzaldo; Leesa B,27,0,30,3
1649881317587,MATH 109,B02,083216,Anzaldo; Leesa B,26,0,30,4
1649881323619,MATH 142A,A01,083219,Chow; Bennett,0,0,30,30
1649881323619,MATH 142A,A02,083220,Chow; Bennett,25,0,30,5
1649881323619,MATH 142A,B01,083221,Chow; Bennett,6,0,30,24
1649881323619,MATH 142A,B02,083222,Chow; Bennett,24,0,30,6
1649881329644,MATH 193A,A01,083224,Staff,0,1,30,30
1649881329644,MATH 193A,A02,083225,Staff,0,0,30,30
1649881329644,MATH 193A,A03,083781,Staff,23,0,30,7
1649881329644,MATH 193A,A04,083782,Staff,27,0,30,3
1649881335668,MATH 197,001,091859,McAuley; Julian John,9999,0,9999,0
1649881341724,COGS 9,A01,083615,Staff,37,0,60,23
1649881347748,COGS 11,A01,083617,Boyle; Mary E. T.,36,0,40,4
1649881353773,COGS 13,A01,083071,Staff,12,0,40,28
1649881359800,COGS 14A,A01,092681,Staff,89,0,100,11
1649881365824,COGS 14B,A01,083073,Cheng; Tzu-Han,34,0,50,16
1649881371854,COGS 17,A01,092677,Staff,71,0,75,4
1649881377900,COGS 100,A01,083619,Staff,20,0,60,40
1649881384020,COGS 101A,A01,083621,Davis; Joshua Daniel,20,0,60,40
1649881390044,COGS 101B,A01,091572,Staff,38,0,60,22
1649881396071,COGS 101C,A01,083625,Delgado; Tania,25,0,30,5
1649881402094,COGS 107A,A01,083627,Boyle; Mary E. T.,26,0,60,34
1649881408118,COGS 118A,A01,083075,Staff,29,0,60,31
1649881414155,CSE 3,A50,083646,Miranda; Gregory Joseph,29,0,38,9
1649881414155,CSE 3,A51,083647,Miranda; Gregory Joseph,37,0,37,0
1649881420182,CSE 8A,A50,083650,Miranda; Gregory Joseph,21,0,40,19
1649881426207,CSE 11,A01,083080,Cao; Yingjun,0,8,40,40
1649881432235,CSE 12,A01,083652,Staff,77,0,100,23
1649881438260,CSE 15L,A01,083654,Staff,34,0,50,16
1649881438260,CSE 15L,A02,083655,Staff,48,0,50,2
1649881444287,CSE 20,A01,083657,Staff,73,0,80,7
1649881450311,CSE 30,A01,083084,Eldon; John,1,0,40,39
1649881456334,CSE 100,A01,083659,Cao; Yingjun,0,2,50,50
1649881462360,CSE 134B,A01,083661,Powell; Thomas Allan,0,22,65,65
1649881468382,CSE 140,A01,083663,Staff,40,0,75,35
1649881474412,CSE 140L,A01,083088,Eldon; John,33,0,75,42
1649881480442,CSE 175,A01,083665,Kumar; Rakesh,14,0,25,11
1649881486466,CSE 190,A00,092507,Dubnov; Shlomo,15,0,15,0
1649881492498,ECE 45,A01,083139,Staff,25,0,40,15
1649881498527,ECE 65,A50,083695,Staff,18,0,30,12
1649881504551,ECE 109,A01,091882,Touri; Behrouz,60,0,70,10
1649881510576,ECE 180,A00,083140,Abi Samra; Nicholas Camill,28,0,30,2
1649881510576,ECE 180,B00,083141,Abi Samra; Nicholas Camill,13,0,30,17
1649881516600,MATH 10A,A01,083735,Patchell; Gregory David,25,0,30,5
1649881516600,MATH 10A,A02,083736,Patchell; Gregory David,28,0,30,2
1649881516600,MATH 10A,A03,083737,Patchell; Gregory David,29,0,30,1
1649881522627,MATH 10B,A01,083207,Staff,16,0,30,14
1649881522627,MATH 10B,A02,083208,Staff,26,0,30,4
1649881522627,MATH 10B,B01,083739,Staff,26,0,30,4
1649881522627,MATH 10B,B02,083740,Staff,30,0,30,0
1649881528653,MATH 18,A01,083743,Staff,25,0,30,5
1649881528653,MATH 18,A02,083744,Staff,30,0,30,0
1649881528653,MATH 18,A03,083745,Staff,29,0,30,1
1649881528653,MATH 18,A04,083746,Staff,30,0,30,0
1649881528653,MATH 18,B01,083748,Staff,17,0,30,13
1649881528653,MATH 18,B02,083749,Staff,28,0,30,2
1649881528653,MATH 18,B03,083750,Staff,29,0,30,1
1649881528653,MATH 18,B04,083751,Staff,28,0,30,2
1649881534683,MATH 20A,A01,083754,Staff,39,0,40,1
1649881540706,MATH 20B,A01,083756,Staff,28,0,30,2
1649881540706,MATH 20B,A02,083757,Staff,30,0,30,0
1649881546748,MATH 20C,A01,083760,Staff,24,0,30,6
1649881546748,MATH 20C,A02,083761,Staff,29,0,30,1
1649881546748,MATH 20C,B01,083762,Staff,30,0,30,0
1649881546748,MATH 20C,B02,083763,Staff,30,0,30,0
1649881552774,MATH 20D,A01,083765,Staff,22,0,30,8
1649881552774,MATH 20D,A02,083766,Staff,30,0,30,0
1649881552774,MATH 20D,A03,083767,Staff,30,0,30,0
1649881558806,MATH 20E,A01,083771,Staff,20,0,30,10
1649881558806,MATH 20E,A02,083772,Staff,29,0,30,1
1649881558806,MATH 20E,B01,083773,Staff,25,0,30,5
1649881558806,MATH 20E,B02,083774,Staff,29,0,30,1
1649881564831,MATH 103A,A01,083777,Staff,0,0,30,30
1649881564831,MATH 103A,A02,083778,Staff,14,0,30,16
1649881564831,MATH 103A,B01,083779,Staff,9,0,30,21
1649881564831,MATH 103A,B02,083780,Staff,24,0,30,6
1649881570855,MATH 105,A01,085443,Staff,5,0,30,25
1649881576880,MATH 109,A01,083213,Anzaldo; Leesa B,27,0,30,3
1649881576880,MATH 109,A02,083214,Anzaldo; Leesa B,21,0,30,9
1649881576880,MATH 109,B01,083215,Anzaldo; Leesa B,27,0,30,3
1649881576880,MATH 109,B02,083216,Anzaldo; Leesa B,26,0,30,4
1649881582909,MATH 142A,A01,083219,Chow; Bennett,0,0,30,30
1649881582909,MATH 142A,A02,083220,Chow; Bennett,25,0,30,5
1649881582909,MATH 142A,B01,083221,Chow; Bennett,5,0,30,25
1649881582909,MATH 142A,B02,083222,Chow; Bennett,24,0,30,6
1649881588933,MATH 193A,A01,083224,Staff,0,2,30,30
1649881588933,MATH 193A,A02,083225,Staff,0,0,30,30
1649881588933,MATH 193A,A03,083781,Staff,23,0,30,7
1649881588933,MATH 193A,A04,083782,Staff,27,0,30,3
1649881594956,MATH 197,001,091859,McAuley; Julian John,9999,0,9999,0
1649881601029,COGS 9,A01,083615,Staff,37,0,60,23
1649881607058,COGS 11,A01,083617,Boyle; Mary E. T.,36,0,40,4
1649881613085,COGS 13,A01,083071,Staff,12,0,40,28
1649881619112,COGS 14A,A01,092681,Staff,89,0,100,11
1649881625141,COGS 14B,A01,083073,Cheng; Tzu-Han,34,0,50,16
1649881631167,COGS 17,A01,092677,Staff,71,0,75,4
1649881637203,COGS 100,A01,083619,Staff,20,0,60,40
1649881643228,COGS 101A,A01,083621,Davis; Joshua Daniel,20,0,60,40
1649881649265,COGS 101B,A01,091572,Staff,38,0,60,22
1649881655286,COGS 101C,A01,083625,Delgado; Tania,25,0,30,5
1649881661309,COGS 107A,A01,083627,Boyle; Mary E. T.,26,0,60,34
1649881667334,COGS 118A,A01,083075,Staff,29,0,60,31
1649881673361,CSE 3,A50,083646,Miranda; Gregory Joseph,29,0,38,9
1649881673361,CSE 3,A51,083647,Miranda; Gregory Joseph,37,0,37,0
1649881679394,CSE 8A,A50,083650,Miranda; Gregory Joseph,21,0,40,19
1649881685425,CSE 11,A01,083080,Cao; Yingjun,0,8,40,40
1649881691454,CSE 12,A01,083652,Staff,76,0,100,24
1649881697491,CSE 15L,A01,083654,Staff,34,0,50,16
1649881697491,CSE 15L,A02,083655,Staff,48,0,50,2
1649881703524,CSE 20,A01,083657,Staff,73,0,80,7
1649881709564,CSE 30,A01,083084,Eldon; John,1,0,40,39
1649881715595,CSE 100,A01,083659,Cao; Yingjun,0,2,50,50
1649881721618,CSE 134B,A01,083661,Powell; Thomas Allan,0,22,65,65
1649881727643,CSE 140,A01,083663,Staff,40,0,75,35
1649881733671,CSE 140L,A01,083088,Eldon; John,33,0,75,42
1649881739699,CSE 175,A01,083665,Kumar; Rakesh,14,0,25,11
1649881745725,CSE 190,A00,092507,Dubnov; Shlomo,15,0,15,0
1649881751752,ECE 45,A01,083139,Staff,25,0,40,15
1649881757776,ECE 65,A50,083695,Staff,18,0,30,12
1649881763803,ECE 109,A01,091882,Touri; Behrouz,61,0,70,9
1649881769834,ECE 180,A00,083140,Abi Samra; Nicholas Camill,28,0,30,2
1649881769834,ECE 180,B00,083141,Abi Samra; Nicholas Camill,13,0,30,17
1649881775863,MATH 10A,A01,083735,Patchell; Gregory David,25,0,30,5
1649881775863,MATH 10A,A02,083736,Patchell; Gregory David,28,0,30,2
1649881775863,MATH 10A,A03,083737,Patchell; Gregory David,29,0,30,1
1649881781891,MATH 10B,A01,083207,Staff,16,0,30,14
1649881781891,MATH 10B,A02,083208,Staff,26,0,30,4
1649881781891,MATH 10B,B01,083739,Staff,26,0,30,4
1649881781891,MATH 10B,B02,083740,Staff,30,0,30,0
1649881787924,MATH 18,A01,083743,Staff,25,0,30,5
1649881787924,MATH 18,A02,083744,Staff,30,0,30,0
1649881787924,MATH 18,A03,083745,Staff,29,0,30,1
1649881787924,MATH 18,A04,083746,Staff,30,0,30,0
1649881787924,MATH 18,B01,083748,Staff,17,0,30,13
1649881787924,MATH 18,B02,083749,Staff,28,0,30,2
1649881787924,MATH 18,B03,083750,Staff,29,0,30,1
1649881787924,MATH 18,B04,083751,Staff,28,0,30,2
1649881793950,MATH 20A,A01,083754,Staff,38,0,40,2
1649881799977,MATH 20B,A01,083756,Staff,28,0,30,2
1649881799977,MATH 20B,A02,083757,Staff,30,0,30,0
1649881806000,MATH 20C,A01,083760,Staff,24,0,30,6
1649881806000,MATH 20C,A02,083761,Staff,29,0,30,1
1649881806000,MATH 20C,B01,083762,Staff,30,0,30,0
1649881806000,MATH 20C,B02,083763,Staff,30,0,30,0
1649881812027,MATH 20D,A01,083765,Staff,22,0,30,8
1649881812027,MATH 20D,A02,083766,Staff,30,0,30,0
1649881812027,MATH 20D,A03,083767,Staff,30,0,30,0
1649881818050,MATH 20E,A01,083771,Staff,20,0,30,10
1649881818050,MATH 20E,A02,083772,Staff,29,0,30,1
1649881818050,MATH 20E,B01,083773,Staff,25,0,30,5
1649881818050,MATH 20E,B02,083774,Staff,29,0,30,1
1649881824080,MATH 103A,A01,083777,Staff,0,0,30,30
1649881824080,MATH 103A,A02,083778,Staff,13,0,30,17
1649881824080,MATH 103A,B01,083779,Staff,9,0,30,21
1649881824080,MATH 103A,B02,083780,Staff,24,0,30,6
1649881830104,MATH 105,A01,085443,Staff,5,0,30,25
1649881836128,MATH 109,A01,083213,Anzaldo; Leesa B,27,0,30,3
1649881836128,MATH 109,A02,083214,Anzaldo; Leesa B,21,0,30,9
1649881836128,MATH 109,B01,083215,Anzaldo; Leesa B,27,0,30,3
1649881836128,MATH 109,B02,083216,Anzaldo; Leesa B,26,0,30,4
1649881842165,MATH 142A,A01,083219,Chow; Bennett,0,0,30,30
1649881842165,MATH 142A,A02,083220,Chow; Bennett,25,0,30,5
1649881842165,MATH 142A,B01,083221,Chow; Bennett,5,0,30,25
1649881842165,MATH 142A,B02,083222,Chow; Bennett,24,0,30,6
1649881848188,MATH 193A,A01,083224,Staff,0,2,30,30
1649881848188,MATH 193A,A02,083225,Staff,0,0,30,30
1649881848188,MATH 193A,A03,083781,Staff,23,0,30,7
1649881848188,MATH 193A,A04,083782,Staff,27,0,30,3
1649881854214,MATH 197,001,091859,McAuley; Julian John,9999,0,9999,0
1649881860291,COGS 9,A01,083615,Staff,37,0,60,23
1649881866317,COGS 11,A01,083617,Boyle; Mary E. T.,36,0,40,4
1649881872358,COGS 13,A01,083071,Staff,12,0,40,28
1649881878395,COGS 14A,A01,092681,Staff,89,0,100,11
1649881884431,COGS 14B,A01,083073,Cheng; Tzu-Han,33,0,50,17
1649881890456,COGS 17,A01,092677,Staff,71,0,75,4
1649881896488,COGS 100,A01,083619,Staff,20,0,60,40
1649881902521,COGS 101A,A01,083621,Davis; Joshua Daniel,20,0,60,40
1649881908551,COGS 101B,A01,091572,Staff,38,0,60,22
1649881914580,COGS 101C,A01,083625,Delgado; Tania,25,0,30,5
1649881920607,COGS 107A,A01,083627,Boyle; Mary E. T.,26,0,60,34
1649881926641,COGS 118A,A01,083075,Staff,29,0,60,31
1649881932681,CSE 3,A50,083646,Miranda; Gregory Joseph,29,0,38,9
1649881932681,CSE 3,A51,083647,Miranda; Gregory Joseph,37,0,37,0
1649881938706,CSE 8A,A50,083650,Miranda; Gregory Joseph,21,0,40,19
1649881944733,CSE 11,A01,083080,Cao; Yingjun,0,10,40,40
1649881950761,CSE 12,A01,083652,Staff,76,0,100,24
1649881956788,CSE 15L,A01,083654,Staff,33,0,50,17
1649881956788,CSE 15L,A02,083655,Staff,48,0,50,2
1649881962811,CSE 20,A01,083657,Staff,73,0,80,7
1649881968835,CSE 30,A01,083084,Eldon; John,1,0,40,39
1649881974865,CSE 100,A01,083659,Cao; Yingjun,0,2,50,50
1649881980998,CSE 134B,A01,083661,Powell; Thomas Allan,0,22,65,65
1649881987024,CSE 140,A01,083663,Staff,40,0,75,35
1649881993056,CSE 140L,A01,083088,Eldon; John,33,0,75,42
1649881999081,CSE 175,A01,083665,Kumar; Rakesh,14,0,25,11
1649882005104,CSE 190,A00,092507,Dubnov; Shlomo,15,0,15,0
1649882011137,ECE 45,A01,083139,Staff,25,0,40,15
1649882017161,ECE 65,A50,083695,Staff,18,0,30,12
1649882023188,ECE 109,A01,091882,Touri; Behrouz,61,0,70,9
1649882029210,ECE 180,A00,083140,Abi Samra; Nicholas Camill,28,0,30,2
1649882029210,ECE 180,B00,083141,Abi Samra; Nicholas Camill,13,0,30,17
1649882035235,MATH 10A,A01,083735,Patchell; Gregory David,25,0,30,5
1649882035235,MATH 10A,A02,083736,Patchell; Gregory David,28,0,30,2
1649882035235,MATH 10A,A03,083737,Patchell; Gregory David,29,0,30,1
1649882041259,MATH 10B,A01,083207,Staff,16,0,30,14
1649882041259,MATH 10B,A02,083208,Staff,26,0,30,4
1649882041259,MATH 10B,B01,083739,Staff,26,0,30,4
1649882041259,MATH 10B,B02,083740,Staff,30,0,30,0
1649882047299,MATH 18,A01,083743,Staff,25,0,30,5
1649882047299,MATH 18,A02,083744,Staff,30,0,30,0
1649882047299,MATH 18,A03,083745,Staff,29,0,30,1
1649882047299,MATH 18,A04,083746,Staff,30,0,30,0
1649882047299,MATH 18,B01,083748,Staff,17,0,30,13
1649882047299,MATH 18,B02,083749,Staff,28,0,30,2
1649882047299,MATH 18,B03,083750,Staff,29,0,30,1
1649882047299,MATH 18,B04,083751,Staff,28,0,30,2
1649882053324,MATH 20A,A01,083754,Staff,38,0,40,2
1649882059350,MATH 20B,A01,083756,Staff,28,0,30,2
1649882059350,MATH 20B,A02,083757,Staff,30,0,30,0
1649882065373,MATH 20C,A01,083760,Staff,24,0,30,6
1649882065373,MATH 20C,A02,083761,Staff,28,0,30,2
1649882065373,MATH 20C,B01,083762,Staff,30,0,30,0
1649882065373,MATH 20C,B02,083763,Staff,30,0,30,0
1649882071402,MATH 20D,A01,083765,Staff,22,0,30,8
1649882071402,MATH 20D,A02,083766,Staff,30,0,30,0
1649882071402,MATH 20D,A03,083767,Staff,30,0,30,0
1649882077430,MATH 20E,A01,083771,Staff,20,0,30,10
1649882077430,MATH 20E,A02,083772,Staff,29,0,30,1
1649882077430,MATH 20E,B01,083773,Staff,25,0,30,5
1649882077430,MATH 20E,B02,083774,Staff,29,0,30,1
1649882083458,MATH 103A,A01,083777,Staff,0,0,30,30
1649882083458,MATH 103A,A02,083778,Staff,12,0,30,18
1649882083458,MATH 103A,B01,083779,Staff,9,0,30,21
1649882083458,MATH 103A,B02,083780,Staff,24,0,30,6
1649882089492,MATH 105,A01,085443,Staff,4,0,30,26
1649882095513,MATH 109,A01,083213,Anzaldo; Leesa B,27,0,30,3
1649882095513,MATH 109,A02,083214,Anzaldo; Leesa B,21,0,30,9
1649882095513,MATH 109,B01,083215,Anzaldo; Leesa B,27,0,30,3
1649882095513,MATH 109,B02,083216,Anzaldo; Leesa B,26,0,30,4
1649882101537,MATH 142A,A01,083219,Chow; Bennett,0,0,30,30
1649882101537,MATH 142A,A02,083220,Chow; Bennett,24,0,30,6
1649882101537,MATH 142A,B01,083221,Chow; Bennett,5,0,30,25
1649882101537,MATH 142A,B02,083222,Chow; Bennett,24,0,30,6
1649882107573,MATH 193A,A01,083224,Staff,0,2,30,30
1649882107573,MATH 193A,A02,083225,Staff,0,0,30,30
1649882107573,MATH 193A,A03,083781,Staff,23,0,30,7
1649882107573,MATH 193A,A04,083782,Staff,27,0,30,3
1649882113600,MATH 197,001,091859,McAuley; Julian John,9999,0,9999,0
1649882119659,COGS 9,A01,083615,Staff,37,0,60,23
1649882125683,COGS 11,A01,083617,Boyle; Mary E. T.,36,0,40,4
1649882131710,COGS 13,A01,083071,Staff,11,0,40,29
1649882137733,COGS 14A,A01,092681,Staff,89,0,100,11
1649882143756,COGS 14B,A01,083073,Cheng; Tzu-Han,33,0,50,17
1649882149780,COGS 17,A01,092677,Staff,71,0,75,4
1649882155803,COGS 100,A01,083619,Staff,20,0,60,40
1649882161829,COGS 101A,A01,083621,Davis; Joshua Daniel,20,0,60,40
1649882167875,COGS 101B,A01,091572,Staff,38,0,60,22
1649882173898,COGS 101C,A01,083625,Delgado; Tania,25,0,30,5
1649882179922,COGS 107A,A01,083627,Boyle; Mary E. T.,26,0,60,34
1649882185949,COGS 118A,A01,083075,Staff,29,0,60,31
1649882192000,CSE 3,A50,083646,Miranda; Gregory Joseph,29,0,38,9
1649882192000,CSE 3,A51,083647,Miranda; Gregory Joseph,37,0,37,0
1649882198028,CSE 8A,A50,083650,Miranda; Gregory Joseph,21,0,40,19
1649882204063,CSE 11,A01,083080,Cao; Yingjun,0,11,40,40
1649882210103,CSE 12,A01,083652,Staff,76,0,100,24
1649882216128,CSE 15L,A01,083654,Staff,33,0,50,17
1649882216128,CSE 15L,A02,083655,Staff,48,0,50,2
1649882222158,CSE 20,A01,083657,Staff,73,0,80,7
1649882228182,CSE 30,A01,083084,Eldon; John,1,0,40,39
1649882234211,CSE 100,A01,083659,Cao; Yingjun,0,2,50,50
1649882240233,CSE 134B,A01,083661,Powell; Thomas Allan,0,22,65,65
1649882246265,CSE 140,A01,083663,Staff,40,0,75,35
1649882252289,CSE 140L,A01,083088,Eldon; John,33,0,75,42
1649882258318,CSE 175,A01,083665,Kumar; Rakesh,14,0,25,11
1649882264345,CSE 190,A00,092507,Dubnov; Shlomo,15,0,15,0
1649882270368,ECE 45,A01,083139,Staff,25,0,40,15
1649882276393,ECE 65,A50,083695,Staff,18,0,30,12
1649882282416,ECE 109,A01,091882,Touri; Behrouz,61,0,70,9
1649882288445,ECE 180,A00,083140,Abi Samra; Nicholas Camill,28,0,30,2
1649882288445,ECE 180,B00,083141,Abi Samra; Nicholas Camill,13,0,30,17
1649882294468,MATH 10A,A01,083735,Patchell; Gregory David,25,0,30,5
1649882294468,MATH 10A,A02,083736,Patchell; Gregory David,28,0,30,2
1649882294468,MATH 10A,A03,083737,Patchell; Gregory David,29,0,30,1
1649882300497,MATH 10B,A01,083207,Staff,16,0,30,14
1649882300497,MATH 10B,A02,083208,Staff,26,0,30,4
1649882300497,MATH 10B,B01,083739,Staff,26,0,30,4
1649882300497,MATH 10B,B02,083740,Staff,30,0,30,0
1649882306528,MATH 18,A01,083743,Staff,25,0,30,5
1649882306528,MATH 18,A02,083744,Staff,30,0,30,0
1649882306528,MATH 18,A03,083745,Staff,29,0,30,1
1649882306528,MATH 18,A04,083746,Staff,30,0,30,0
1649882306528,MATH 18,B01,083748,Staff,17,0,30,13
1649882306528,MATH 18,B02,083749,Staff,28,0,30,2
1649882306528,MATH 18,B03,083750,Staff,29,0,30,1
1649882306528,MATH 18,B04,083751,Staff,28,0,30,2
1649882312553,MATH 20A,A01,083754,Staff,38,0,40,2
1649882318577,MATH 20B,A01,083756,Staff,28,0,30,2
1649882318577,MATH 20B,A02,083757,Staff,30,0,30,0
1649882324609,MATH 20C,A01,083760,Staff,24,0,30,6
1649882324609,MATH 20C,A02,083761,Staff,28,0,30,2
1649882324609,MATH 20C,B01,083762,Staff,30,0,30,0
1649882324609,MATH 20C,B02,083763,Staff,30,0,30,0
1649882330636,MATH 20D,A01,083765,Staff,22,0,30,8
1649882330636,MATH 20D,A02,083766,Staff,30,0,30,0
1649882330636,MATH 20D,A03,083767,Staff,30,0,30,0
1649882336659,MATH 20E,A01,083771,Staff,20,0,30,10
1649882336659,MATH 20E,A02,083772,Staff,29,0,30,1
1649882336659,MATH 20E,B01,083773,Staff,25,0,30,5
1649882336659,MATH 20E,B02,083774,Staff,29,0,30,1
1649882342684,MATH 103A,A01,083777,Staff,0,0,30,30
1649882342684,MATH 103A,A02,083778,Staff,12,0,30,18
1649882342684,MATH 103A,B01,083779,Staff,9,0,30,21
1649882342684,MATH 103A,B02,083780,Staff,24,0,30,6
1649882348710,MATH 105,A01,085443,Staff,4,0,30,26
1649882354740,MATH 109,A01,083213,Anzaldo; Leesa B,27,0,30,3
1649882354740,MATH 109,A02,083214,Anzaldo; Leesa B,21,0,30,9
1649882354740,MATH 109,B01,083215,Anzaldo; Leesa B,27,0,30,3
1649882354740,MATH 109,B02,083216,Anzaldo; Leesa B,26,0,30,4
1649882360764,MATH 142A,A01,083219,Chow; Bennett,0,0,30,30
1649882360764,MATH 142A,A02,083220,Chow; Bennett,24,0,30,6
1649882360764,MATH 142A,B01,083221,Chow; Bennett,5,0,30,25
1649882360764,MATH 142A,B02,083222,Chow; Bennett,24,0,30,6
1649882366788,MATH 193A,A01,083224,Staff,0,2,30,30
1649882366788,MATH 193A,A02,083225,Staff,0,0,30,30
1649882366788,MATH 193A,A03,083781,Staff,23,0,30,7
1649882366788,MATH 193A,A04,083782,Staff,27,0,30,3
1649882372817,MATH 197,001,091859,McAuley; Julian John,9999,0,9999,0
1649882378880,COGS 9,A01,083615,Staff,37,0,60,23
1649882384904,COGS 11,A01,083617,Boyle; Mary E. T.,36,0,40,4
1649882390933,COGS 13,A01,083071,Staff,10,0,40,30
1649882396959,COGS 14A,A01,092681,Staff,89,0,100,11
1649882410234,COGS 14B,A01,083073,Cheng; Tzu-Han,33,0,50,17
1649882416258,COGS 17,A01,092677,Staff,71,0,75,4
1649882422280,COGS 100,A01,083619,Staff,20,0,60,40
1649882428303,COGS 101A,A01,083621,Davis; Joshua Daniel,20,0,60,40
1649882434325,COGS 101B,A01,091572,Staff,38,0,60,22
1649882440349,COGS 101C,A01,083625,Delgado; Tania,25,0,30,5
1649882446373,COGS 107A,A01,083627,Boyle; Mary E. T.,26,0,60,34
1649882452401,COGS 118A,A01,083075,Staff,29,0,60,31
1649882458432,CSE 3,A50,083646,Miranda; Gregory Joseph,29,0,38,9
1649882458432,CSE 3,A51,083647,Miranda; Gregory Joseph,37,0,37,0
1649882464459,CSE 8A,A50,083650,Miranda; Gregory Joseph,21,0,40,19
1649882470487,CSE 11,A01,083080,Cao; Yingjun,0,11,40,40
1649882476517,CSE 12,A01,083652,Staff,76,0,100,24
1649882482543,CSE 15L,A01,083654,Staff,33,0,50,17
1649882482543,CSE 15L,A02,083655,Staff,48,0,50,2
1649882488566,CSE 20,A01,083657,Staff,73,0,80,7
1649882494593,CSE 30,A01,083084,Eldon; John,1,0,40,39
1649882500621,CSE 100,A01,083659,Cao; Yingjun,0,2,50,50
1649882506652,CSE 134B,A01,083661,Powell; Thomas Allan,0,22,65,65
1649882512678,CSE 140,A01,083663,Staff,40,0,75,35
1649882518704,CSE 140L,A01,083088,Eldon; John,33,0,75,42
1649882524728,CSE 175,A01,083665,Kumar; Rakesh,14,0,25,11
1649882530757,CSE 190,A00,092507,Dubnov; Shlomo,15,0,15,0
1649882536784,ECE 45,A01,083139,Staff,25,0,40,15
1649882542807,ECE 65,A50,083695,Staff,18,0,30,12
1649882548842,ECE 109,A01,091882,Touri; Behrouz,61,0,70,9
1649882554884,ECE 180,A00,083140,Abi Samra; Nicholas Camill,28,0,30,2
1649882554884,ECE 180,B00,083141,Abi Samra; Nicholas Camill,13,0,30,17
1649882560913,MATH 10A,A01,083735,Patchell; Gregory David,25,0,30,5
1649882560913,MATH 10A,A02,083736,Patchell; Gregory David,28,0,30,2
1649882560913,MATH 10A,A03,083737,Patchell; Gregory David,29,0,30,1
1649882566940,MATH 10B,A01,083207,Staff,16,0,30,14
1649882566940,MATH 10B,A02,083208,Staff,26,0,30,4
1649882566940,MATH 10B,B01,083739,Staff,26,0,30,4
1649882566940,MATH 10B,B02,083740,Staff,30,0,30,0
1649882572964,MATH 18,A01,083743,Staff,25,0,30,5
1649882572964,MATH 18,A02,083744,Staff,30,0,30,0
1649882572964,MATH 18,A03,083745,Staff,29,0,30,1
1649882572964,MATH 18,A04,083746,Staff,30,0,30,0
1649882572964,MATH 18,B01,083748,Staff,17,0,30,13
1649882572964,MATH 18,B02,083749,Staff,28,0,30,2
1649882572964,MATH 18,B03,083750,Staff,29,0,30,1
1649882572964,MATH 18,B04,083751,Staff,28,0,30,2
1649882578996,MATH 20A,A01,083754,Staff,38,0,40,2
1649882585106,MATH 20B,A01,083756,Staff,28,0,30,2
1649882585106,MATH 20B,A02,083757,Staff,30,0,30,0
1649882591135,MATH 20C,A01,083760,Staff,24,0,30,6
1649882591135,MATH 20C,A02,083761,Staff,28,0,30,2
1649882591135,MATH 20C,B01,083762,Staff,30,0,30,0
1649882591135,MATH 20C,B02,083763,Staff,30,0,30,0
1649882597159,MATH 20D,A01,083765,Staff,22,0,30,8
1649882597159,MATH 20D,A02,083766,Staff,30,0,30,0
1649882597159,MATH 20D,A03,083767,Staff,30,0,30,0
1649882603194,MATH 20E,A01,083771,Staff,20,0,30,10
1649882603194,MATH 20E,A02,083772,Staff,29,0,30,1
1649882603194,MATH 20E,B01,083773,Staff,25,0,30,5
1649882603194,MATH 20E,B02,083774,Staff,29,0,30,1
1649882609222,MATH 103A,A01,083777,Staff,0,0,30,30
1649882609222,MATH 103A,A02,083778,Staff,12,0,30,18
1649882609222,MATH 103A,B01,083779,Staff,8,0,30,22
1649882609222,MATH 103A,B02,083780,Staff,24,0,30,6
1649882615245,MATH 105,A01,085443,Staff,4,0,30,26
1649882621267,MATH 109,A01,083213,Anzaldo; Leesa B,27,0,30,3
1649882621267,MATH 109,A02,083214,Anzaldo; Leesa B,21,0,30,9
1649882621267,MATH 109,B01,083215,Anzaldo; Leesa B,27,0,30,3
1649882621267,MATH 109,B02,083216,Anzaldo; Leesa B,26,0,30,4
1649882627289,MATH 142A,A01,083219,Chow; Bennett,0,0,30,30
1649882627289,MATH 142A,A02,083220,Chow; Bennett,24,0,30,6
1649882627289,MATH 142A,B01,083221,Chow; Bennett,5,0,30,25
1649882627289,MATH 142A,B02,083222,Chow; Bennett,24,0,30,6
1649882633313,MATH 193A,A01,083224,Staff,0,2,30,30
1649882633313,MATH 193A,A02,083225,Staff,0,0,30,30
1649882633313,MATH 193A,A03,083781,Staff,23,0,30,7
1649882633313,MATH 193A,A04,083782,Staff,27,0,30,3
1649882639355,MATH 197,001,091859,McAuley; Julian John,9999,0,9999,0
1649882645410,COGS 9,A01,083615,Staff,37,0,60,23
1649882651433,COGS 11,A01,083617,Boyle; Mary E. T.,36,0,40,4
1649882657460,COGS 13,A01,083071,Staff,10,0,40,30
1649882663487,COGS 14A,A01,092681,Staff,89,0,100,11
1649882669514,COGS 14B,A01,083073,Cheng; Tzu-Han,33,0,50,17
1649882675549,COGS 17,A01,092677,Staff,71,0,75,4
1649882681578,COGS 100,A01,083619,Staff,20,0,60,40
1649882687602,COGS 101A,A01,083621,Davis; Joshua Daniel,20,0,60,40
1649882693626,COGS 101B,A01,091572,Staff,38,0,60,22
1649882699650,COGS 101C,A01,083625,Delgado; Tania,25,0,30,5
1649882705675,COGS 107A,A01,083627,Boyle; Mary E. T.,26,0,60,34
1649882711705,COGS 118A,A01,083075,Staff,28,0,60,32
1649882717745,CSE 3,A50,083646,Miranda; Gregory Joseph,29,0,38,9
1649882717745,CSE 3,A51,083647,Miranda; Gregory Joseph,37,0,37,0
1649882723772,CSE 8A,A50,083650,Miranda; Gregory Joseph,21,0,40,19
1649882729800,CSE 11,A01,083080,Cao; Yingjun,0,11,40,40
1649882735826,CSE 12,A01,083652,Staff,76,0,100,24
1649882741852,CSE 15L,A01,083654,Staff,33,0,50,17
1649882741852,CSE 15L,A02,083655,Staff,48,0,50,2
1649882747882,CSE 20,A01,083657,Staff,73,0,80,7
1649882753918,CSE 30,A01,083084,Eldon; John,1,0,40,39
1649882759954,CSE 100,A01,083659,Cao; Yingjun,1,4,50,49
1649882765986,CSE 134B,A01,083661,Powell; Thomas Allan,0,22,65,65
1649882772017,CSE 140,A01,083663,Staff,40,0,75,35
1649882778042,CSE 140L,A01,083088,Eldon; John,33,0,75,42
1649882784080,CSE 175,A01,083665,Kumar; Rakesh,14,0,25,11
1649882790106,CSE 190,A00,092507,Dubnov; Shlomo,15,0,15,0
1649882796139,ECE 45,A01,083139,Staff,24,0,40,16
1649882802162,ECE 65,A50,083695,Staff,18,0,30,12
1649882808187,ECE 109,A01,091882,Touri; Behrouz,61,0,70,9
1649882814218,ECE 180,A00,083140,Abi Samra; Nicholas Camill,28,0,30,2
1649882814218,ECE 180,B00,083141,Abi Samra; Nicholas Camill,13,0,30,17
1649882820248,MATH 10A,A01,083735,Patchell; Gregory David,25,0,30,5
1649882820248,MATH 10A,A02,083736,Patchell; Gregory David,28,0,30,2
1649882820248,MATH 10A,A03,083737,Patchell; Gregory David,29,0,30,1
1649882826274,MATH 10B,A01,083207,Staff,16,0,30,14
1649882826274,MATH 10B,A02,083208,Staff,26,0,30,4
1649882826274,MATH 10B,B01,083739,Staff,26,0,30,4
1649882826274,MATH 10B,B02,083740,Staff,30,0,30,0
1649882832304,MATH 18,A01,083743,Staff,25,0,30,5
1649882832304,MATH 18,A02,083744,Staff,30,0,30,0
1649882832304,MATH 18,A03,083745,Staff,29,0,30,1
1649882832304,MATH 18,A04,083746,Staff,30,0,30,0
1649882832304,MATH 18,B01,083748,Staff,17,0,30,13
1649882832304,MATH 18,B02,083749,Staff,28,0,30,2
1649882832304,MATH 18,B03,083750,Staff,29,0,30,1
1649882832304,MATH 18,B04,083751,Staff,28,0,30,2
1649882838336,MATH 20A,A01,083754,Staff,38,0,40,2
1649882844363,MATH 20B,A01,083756,Staff,28,0,30,2
1649882844363,MATH 20B,A02,083757,Staff,30,0,30,0
1649882850387,MATH 20C,A01,083760,Staff,24,0,30,6
1649882850387,MATH 20C,A02,083761,Staff,28,0,30,2
1649882850387,MATH 20C,B01,083762,Staff,30,0,30,0
1649882850387,MATH 20C,B02,083763,Staff,30,0,30,0
1649882856421,MATH 20D,A01,083765,Staff,22,0,30,8
1649882856421,MATH 20D,A02,083766,Staff,30,0,30,0
1649882856421,MATH 20D,A03,083767,Staff,30,0,30,0
1649882862445,MATH 20E,A01,083771,Staff,19,0,30,11
1649882862445,MATH 20E,A02,083772,Staff,29,0,30,1
1649882862445,MATH 20E,B01,083773,Staff,24,0,30,6
1649882862445,MATH 20E,B02,083774,Staff,29,0,30,1
1649882868469,MATH 103A,A01,083777,Staff,0,0,30,30
1649882868469,MATH 103A,A02,083778,Staff,12,0,30,18
1649882868469,MATH 103A,B01,083779,Staff,8,0,30,22
1649882868469,MATH 103A,B02,083780,Staff,24,0,30,6
1649882874492,MATH 105,A01,085443,Staff,3,0,30,27
1649882880528,MATH 109,A01,083213,Anzaldo; Leesa B,27,0,30,3
1649882880528,MATH 109,A02,083214,Anzaldo; Leesa B,21,0,30,9
1649882880528,MATH 109,B01,083215,Anzaldo; Leesa B,27,0,30,3
1649882880528,MATH 109,B02,083216,Anzaldo; Leesa B,26,0,30,4
1649882886553,MATH 142A,A01,083219,Chow; Bennett,0,0,30,30
1649882886553,MATH 142A,A02,083220,Chow; Bennett,23,0,30,7
1649882886553,MATH 142A,B01,083221,Chow; Bennett,5,0,30,25
1649882886553,MATH 142A,B02,083222,Chow; Bennett,24,0,30,6
1649882892588,MATH 193A,A01,083224,Staff,0,2,30,30
1649882892588,MATH 193A,A02,083225,Staff,0,0,30,30
1649882892588,MATH 193A,A03,083781,Staff,23,0,30,7
1649882892588,MATH 193A,A04,083782,Staff,27,0,30,3
1649882898614,MATH 197,001,091859,McAuley; Julian John,9999,0,9999,0
1649882904671,COGS 9,A01,083615,Staff,37,0,60,23
1649882910702,COGS 11,A01,083617,Boyle; Mary E. T.,36,0,40,4
1649882916738,COGS 13,A01,083071,Staff,10,0,40,30
1649882922761,COGS 14A,A01,092681,Staff,89,0,100,11
1649882928786,COGS 14B,A01,083073,Cheng; Tzu-Han,33,0,50,17
1649882934810,COGS 17,A01,092677,Staff,70,0,75,5
1649882940833,COGS 100,A01,083619,Staff,20,0,60,40
1649882946859,COGS 101A,A01,083621,Davis; Joshua Daniel,20,0,60,40
1649882952899,COGS 101B,A01,091572,Staff,38,0,60,22
1649882958940,COGS 101C,A01,083625,Delgado; Tania,25,0,30,5
1649882964966,COGS 107A,A01,083627,Boyle; Mary E. T.,26,0,60,34
1649882970999,COGS 118A,A01,083075,Staff,28,0,60,32
1649882977025,CSE 3,A50,083646,Miranda; Gregory Joseph,29,0,38,9
1649882977025,CSE 3,A51,083647,Miranda; Gregory Joseph,37,0,37,0
1649882983049,CSE 8A,A50,083650,Miranda; Gregory Joseph,21,0,40,19
1649882989083,CSE 11,A01,083080,Cao; Yingjun,0,11,40,40
1649882995110,CSE 12,A01,083652,Staff,76,0,100,24
1649883001134,CSE 15L,A01,083654,Staff,33,0,50,17
1649883001134,CSE 15L,A02,083655,Staff,48,0,50,2
1649883007158,CSE 20,A01,083657,Staff,73,0,80,7
1649883013189,CSE 30,A01,083084,Eldon; John,1,0,40,39
1649883019212,CSE 100,A01,083659,Cao; Yingjun,1,4,50,49
1649883025243,CSE 134B,A01,083661,Powell; Thomas Allan,0,22,65,65
1649883031266,CSE 140,A01,083663,Staff,40,0,75,35
1649883037290,CSE 140L,A01,083088,Eldon; John,33,0,75,42
1649883043313,CSE 175,A01,083665,Kumar; Rakesh,14,0,25,11
1649883049343,CSE 190,A00,092507,Dubnov; Shlomo,15,0,15,0
1649883055367,ECE 45,A01,083139,Staff,24,0,40,16
1649883061390,ECE 65,A50,083695,Staff,17,0,30,13
1649883067436,ECE 109,A01,091882,Touri; Behrouz,61,0,70,9
1649883073463,ECE 180,A00,083140,Abi Samra; Nicholas Camill,28,0,30,2
1649883073463,ECE 180,B00,083141,Abi Samra; Nicholas Camill,13,0,30,17
1649883079488,MATH 10A,A01,083735,Patchell; Gregory David,25,0,30,5
1649883079488,MATH 10A,A02,083736,Patchell; Gregory David,28,0,30,2
1649883079488,MATH 10A,A03,083737,Patchell; Gregory David,29,0,30,1
1649883085515,MATH 10B,A01,083207,Staff,16,0,30,14
1649883085515,MATH 10B,A02,083208,Staff,26,0,30,4
1649883085515,MATH 10B,B01,083739,Staff,26,0,30,4
1649883085515,MATH 10B,B02,083740,Staff,30,0,30,0
1649883091547,MATH 18,A01,083743,Staff,25,0,30,5
1649883091547,MATH 18,A02,083744,Staff,30,0,30,0
1649883091547,MATH 18,A03,083745,Staff,29,0,30,1
1649883091547,MATH 18,A04,083746,Staff,30,0,30,0
1649883091547,MATH 18,B01,083748,Staff,17,0,30,13
1649883091547,MATH 18,B02,083749,Staff,28,0,30,2
1649883091547,MATH 18,B03,083750,Staff,29,0,30,1
1649883091547,MATH 18,B04,083751,Staff,28,0,30,2
1649883097577,MATH 20A,A01,083754,Staff,38,0,40,2
1649883103607,MATH 20B,A01,083756,Staff,27,0,30,3
1649883103607,MATH 20B,A02,083757,Staff,30,0,30,0
1649883109635,MATH 20C,A01,083760,Staff,24,0,30,6
1649883109635,MATH 20C,A02,083761,Staff,28,0,30,2
1649883109635,MATH 20C,B01,083762,Staff,30,0,30,0
1649883109635,MATH 20C,B02,083763,Staff,30,0,30,0
1649883115659,MATH 20D,A01,083765,Staff,22,0,30,8
1649883115659,MATH 20D,A02,083766,Staff,30,0,30,0
1649883115659,MATH 20D,A03,083767,Staff,30,0,30,0
1649883121684,MATH 20E,A01,083771,Staff,19,0,30,11
1649883121684,MATH 20E,A02,083772,Staff,29,0,30,1
1649883121684,MATH 20E,B01,083773,Staff,24,0,30,6
1649883121684,MATH 20E,B02,083774,Staff,29,0,30,1
1649883127712,MATH 103A,A01,083777,Staff,0,0,30,30
1649883127712,MATH 103A,A02,083778,Staff,12,0,30,18
1649883127712,MATH 103A,B01,083779,Staff,8,0,30,22
1649883127712,MATH 103A,B02,083780,Staff,24,0,30,6
1649883133735,MATH 105,A01,085443,Staff,3,0,30,27
1649883139763,MATH 109,A01,083213,Anzaldo; Leesa B,27,0,30,3
1649883139763,MATH 109,A02,083214,Anzaldo; Leesa B,21,0,30,9
1649883139763,MATH 109,B01,083215,Anzaldo; Leesa B,26,0,30,4
1649883139763,MATH 109,B02,083216,Anzaldo; Leesa B,26,0,30,4
1649883145791,MATH 142A,A01,083219,Chow; Bennett,0,0,30,30
1649883145791,MATH 142A,A02,083220,Chow; Bennett,23,0,30,7
1649883145791,MATH 142A,B01,083221,Chow; Bennett,4,0,30,26
1649883145791,MATH 142A,B02,083222,Chow; Bennett,24,0,30,6
1649883151816,MATH 193A,A01,083224,Staff,0,2,30,30
1649883151816,MATH 193A,A02,083225,Staff,0,0,30,30
1649883151816,MATH 193A,A03,083781,Staff,23,0,30,7
1649883151816,MATH 193A,A04,083782,Staff,26,0,30,4
1649883157848,MATH 197,001,091859,McAuley; Julian John,9999,0,9999,0
1649883163906,COGS 9,A01,083615,Staff,36,0,60,24
1649883169933,COGS 11,A01,083617,Boyle; Mary E. T.,36,0,40,4
1649883176063,COGS 13,A01,083071,Staff,8,0,40,32
1649883182101,COGS 14A,A01,092681,Staff,88,0,100,12
1649883188124,COGS 14B,A01,083073,Cheng; Tzu-Han,33,0,50,17
1649883194147,COGS 17,A01,092677,Staff,70,0,75,5
1649883200195,COGS 100,A01,083619,Staff,20,0,60,40
1649883206222,COGS 101A,A01,083621,Davis; Joshua Daniel,20,0,60,40
1649883212246,COGS 101B,A01,091572,Staff,38,0,60,22
1649883218270,COGS 101C,A01,083625,Delgado; Tania,25,0,30,5
1649883224313,COGS 107A,A01,083627,Boyle; Mary E. T.,26,0,60,34
1649883230336,COGS 118A,A01,083075,Staff,28,0,60,32
1649883236371,CSE 3,A50,083646,Miranda; Gregory Joseph,29,0,38,9
1649883236371,CSE 3,A51,083647,Miranda; Gregory Joseph,37,0,37,0
1649883242394,CSE 8A,A50,083650,Miranda; Gregory Joseph,21,0,40,19
1649883248424,CSE 11,A01,083080,Cao; Yingjun,0,13,40,40
1649883254453,CSE 12,A01,083652,Staff,76,0,100,24
1649883260479,CSE 15L,A01,083654,Staff,33,0,50,17
1649883260479,CSE 15L,A02,083655,Staff,48,0,50,2
1649883266513,CSE 20,A01,083657,Staff,72,0,80,8
1649883272542,CSE 30,A01,083084,Eldon; John,0,1,40,40
1649883278574,CSE 100,A01,083659,Cao; Yingjun,2,7,50,48
1649883284606,CSE 134B,A01,083661,Powell; Thomas Allan,0,22,65,65
1649883290628,CSE 140,A01,083663,Staff,40,0,75,35
1649883296661,CSE 140L,A01,083088,Eldon; John,32,0,75,43
1649883302692,CSE 175,A01,083665,Kumar; Rakesh,14,0,25,11
1649883308720,CSE 190,A00,092507,Dubnov; Shlomo,15,0,15,0
1649883314751,ECE 45,A01,083139,Staff,24,0,40,16
1649883320777,ECE 65,A50,083695,Staff,17,0,30,13
1649883326814,ECE 109,A01,091882,Touri; Behrouz,61,0,70,9
1649883332840,ECE 180,A00,083140,Abi Samra; Nicholas Camill,28,0,30,2
1649883332840,ECE 180,B00,083141,Abi Samra; Nicholas Camill,13,0,30,17
1649883338863,MATH 10A,A01,083735,Patchell; Gregory David,25,0,30,5
1649883338863,MATH 10A,A02,083736,Patchell; Gregory David,28,0,30,2
1649883338863,MATH 10A,A03,083737,Patchell; Gregory David,29,0,30,1
1649883344896,MATH 10B,A01,083207,Staff,16,0,30,14
1649883344896,MATH 10B,A02,083208,Staff,26,0,30,4
1649883344896,MATH 10B,B01,083739,Staff,25,0,30,5
1649883344896,MATH 10B,B02,083740,Staff,30,0,30,0
1649883350921,MATH 18,A01,083743,Staff,25,0,30,5
1649883350921,MATH 18,A02,083744,Staff,30,0,30,0
1649883350921,MATH 18,A03,083745,Staff,29,0,30,1
1649883350921,MATH 18,A04,083746,Staff,30,0,30,0
1649883350921,MATH 18,B01,083748,Staff,17,0,30,13
1649883350921,MATH 18,B02,083749,Staff,28,0,30,2
1649883350921,MATH 18,B03,083750,Staff,29,0,30,1
1649883350921,MATH 18,B04,083751,Staff,28,0,30,2
1649883356959,MATH 20A,A01,083754,Staff,38,0,40,2
1649883362986,MATH 20B,A01,083756,Staff,27,0,30,3
1649883362986,MATH 20B,A02,083757,Staff,30,0,30,0
1649883369007,MATH 20C,A01,083760,Staff,24,0,30,6
1649883369007,MATH 20C,A02,083761,Staff,28,0,30,2
1649883369007,MATH 20C,B01,083762,Staff,30,0,30,0
1649883369007,MATH 20C,B02,083763,Staff,30,0,30,0
1649883375035,MATH 20D,A01,083765,Staff,22,0,30,8
1649883375035,MATH 20D,A02,083766,Staff,30,0,30,0
1649883375035,MATH 20D,A03,083767,Staff,30,0,30,0
1649883381069,MATH 20E,A01,083771,Staff,19,0,30,11
1649883381069,MATH 20E,A02,083772,Staff,29,0,30,1
1649883381069,MATH 20E,B01,083773,Staff,24,0,30,6
1649883381069,MATH 20E,B02,083774,Staff,29,0,30,1
1649883387096,MATH 103A,A01,083777,Staff,0,0,30,30
1649883387096,MATH 103A,A02,083778,Staff,12,0,30,18
1649883387096,MATH 103A,B01,083779,Staff,8,0,30,22
1649883387096,MATH 103A,B02,083780,Staff,24,0,30,6
1649883393120,MATH 105,A01,085443,Staff,3,0,30,27
1649883399149,MATH 109,A01,083213,Anzaldo; Leesa B,27,0,30,3
1649883399149,MATH 109,A02,083214,Anzaldo; Leesa B,21,0,30,9
1649883399149,MATH 109,B01,083215,Anzaldo; Leesa B,26,0,30,4
1649883399149,MATH 109,B02,083216,Anzaldo; Leesa B,26,0,30,4
1649883405173,MATH 142A,A01,083219,Chow; Bennett,0,0,30,30
1649883405173,MATH 142A,A02,083220,Chow; Bennett,23,0,30,7
1649883405173,MATH 142A,B01,083221,Chow; Bennett,4,0,30,26
1649883405173,MATH 142A,B02,083222,Chow; Bennett,24,0,30,6
1649883411196,MATH 193A,A01,083224,Staff,0,2,30,30
1649883411196,MATH 193A,A02,083225,Staff,0,0,30,30
1649883411196,MATH 193A,A03,083781,Staff,22,0,30,8
1649883411196,MATH 193A,A04,083782,Staff,26,0,30,4
1649883417219,MATH 197,001,091859,McAuley; Julian John,9999,0,9999,0
1649883423313,COGS 9,A01,083615,Staff,36,0,60,24
1649883429357,COGS 11,A01,083617,Boyle; Mary E. T.,36,0,40,4
1649883435385,COGS 13,A01,083071,Staff,8,0,40,32
1649883441412,COGS 14A,A01,092681,Staff,88,0,100,12
1649883447436,COGS 14B,A01,083073,Cheng; Tzu-Han,33,0,50,17
1649883453469,COGS 17,A01,092677,Staff,70,0,75,5
1649883459494,COGS 100,A01,083619,Staff,19,0,60,41
1649883465518,COGS 101A,A01,083621,Davis; Joshua Daniel,20,0,60,40
1649883471545,COGS 101B,A01,091572,Staff,38,0,60,22
1649883477579,COGS 101C,A01,083625,Delgado; Tania,25,0,30,5
1649883483606,COGS 107A,A01,083627,Boyle; Mary E. T.,26,0,60,34
1649883489629,COGS 118A,A01,083075,Staff,28,0,60,32
1649883495653,CSE 3,A50,083646,Miranda; Gregory Joseph,29,0,38,9
1649883495653,CSE 3,A51,083647,Miranda; Gregory Joseph,37,0,37,0
1649883501674,CSE 8A,A50,083650,Miranda; Gregory Joseph,21,0,40,19
1649883507703,CSE 11,A01,083080,Cao; Yingjun,0,13,40,40
1649883513726,CSE 12,A01,083652,Staff,76,0,100,24
1649883519750,CSE 15L,A01,083654,Staff,33,0,50,17
1649883519750,CSE 15L,A02,083655,Staff,48,0,50,2
1649883525784,CSE 20,A01,083657,Staff,72,0,80,8
1649883531808,CSE 30,A01,083084,Eldon; John,0,1,40,40
1649883537839,CSE 100,A01,083659,Cao; Yingjun,2,7,50,48
1649883543863,CSE 134B,A01,083661,Powell; Thomas Allan,0,22,65,65
1649883549888,CSE 140,A01,083663,Staff,39,0,75,36
1649883555917,CSE 140L,A01,083088,Eldon; John,31,0,75,44
1649883561957,CSE 175,A01,083665,Kumar; Rakesh,14,0,25,11
1649883567987,CSE 190,A00,092507,Dubnov; Shlomo,15,0,15,0
1649883574021,ECE 45,A01,083139,Staff,24,0,40,16
1649883580050,ECE 65,A50,083695,Staff,17,0,30,13
1649883586086,ECE 109,A01,091882,Touri; Behrouz,61,0,70,9
1649883592112,ECE 180,A00,083140,Abi Samra; Nicholas Camill,28,0,30,2
1649883592112,ECE 180,B00,083141,Abi Samra; Nicholas Camill,13,0,30,17
1649883598144,MATH 10A,A01,083735,Patchell; Gregory David,25,0,30,5
1649883598144,MATH 10A,A02,083736,Patchell; Gregory David,28,0,30,2
1649883598144,MATH 10A,A03,083737,Patchell; Gregory David,29,0,30,1
1649883604169,MATH 10B,A01,083207,Staff,16,0,30,14
1649883604169,MATH 10B,A02,083208,Staff,26,0,30,4
1649883604169,MATH 10B,B01,083739,Staff,25,0,30,5
1649883604169,MATH 10B,B02,083740,Staff,30,0,30,0
1649883610206,MATH 18,A01,083743,Staff,25,0,30,5
1649883610206,MATH 18,A02,083744,Staff,30,0,30,0
1649883610206,MATH 18,A03,083745,Staff,29,0,30,1
1649883610206,MATH 18,A04,083746,Staff,30,0,30,0
1649883610206,MATH 18,B01,083748,Staff,17,0,30,13
1649883610206,MATH 18,B02,083749,Staff,28,0,30,2
1649883610206,MATH 18,B03,083750,Staff,29,0,30,1
1649883610206,MATH 18,B04,083751,Staff,28,0,30,2
1649883616231,MATH 20A,A01,083754,Staff,38,0,40,2
1649883622265,MATH 20B,A01,083756,Staff,27,0,30,3
1649883622265,MATH 20B,A02,083757,Staff,30,0,30,0
1649883628293,MATH 20C,A01,083760,Staff,24,0,30,6
1649883628293,MATH 20C,A02,083761,Staff,28,0,30,2
1649883628293,MATH 20C,B01,083762,Staff,30,0,30,0
1649883628293,MATH 20C,B02,083763,Staff,30,0,30,0
1649883634333,MATH 20D,A01,083765,Staff,22,0,30,8
1649883634333,MATH 20D,A02,083766,Staff,30,0,30,0
1649883634333,MATH 20D,A03,083767,Staff,30,0,30,0
1649883640364,MATH 20E,A01,083771,Staff,19,0,30,11
1649883640364,MATH 20E,A02,083772,Staff,29,0,30,1
1649883640364,MATH 20E,B01,083773,Staff,24,0,30,6
1649883640364,MATH 20E,B02,083774,Staff,29,0,30,1
1649883646397,MATH 103A,A01,083777,Staff,0,0,30,30
1649883646397,MATH 103A,A02,083778,Staff,12,0,30,18
1649883646397,MATH 103A,B01,083779,Staff,8,0,30,22
1649883646397,MATH 103A,B02,083780,Staff,24,0,30,6
1649883652431,MATH 105,A01,085443,Staff,2,0,30,28
1649883658461,MATH 109,A01,083213,Anzaldo; Leesa B,27,0,30,3
1649883658461,MATH 109,A02,083214,Anzaldo; Leesa B,21,0,30,9
1649883658461,MATH 109,B01,083215,Anzaldo; Leesa B,26,0,30,4
1649883658461,MATH 109,B02,083216,Anzaldo; Leesa B,26,0,30,4
1649883664493,MATH 142A,A01,083219,Chow; Bennett,0,0,30,30
1649883664493,MATH 142A,A02,083220,Chow; Bennett,23,0,30,7
1649883664493,MATH 142A,B01,083221,Chow; Bennett,4,0,30,26
1649883664493,MATH 142A,B02,083222,Chow; Bennett,24,0,30,6
1649883670551,MATH 193A,A01,083224,Staff,0,2,30,30
1649883670551,MATH 193A,A02,083225,Staff,0,0,30,30
1649883670551,MATH 193A,A03,083781,Staff,22,0,30,8
1649883670551,MATH 193A,A04,083782,Staff,26,0,30,4
1649883676593,MATH 197,001,091859,McAuley; Julian John,9999,0,9999,0
1649883682661,COGS 9,A01,083615,Staff,36,0,60,24
1649883688683,COGS 11,A01,083617,Boyle; Mary E. T.,36,0,40,4
1649883694718,COGS 13,A01,083071,Staff,6,0,40,34
1649883700741,COGS 14A,A01,092681,Staff,88,0,100,12
1649883706768,COGS 14B,A01,083073,Cheng; Tzu-Han,33,0,50,17
1649883712791,COGS 17,A01,092677,Staff,70,0,75,5
1649883718818,COGS 100,A01,083619,Staff,19,0,60,41
1649883724842,COGS 101A,A01,083621,Davis; Joshua Daniel,20,0,60,40
1649883730870,COGS 101B,A01,091572,Staff,38,0,60,22
1649883736896,COGS 101C,A01,083625,Delgado; Tania,25,0,30,5
1649883742932,COGS 107A,A01,083627,Boyle; Mary E. T.,25,0,60,35
1649883748962,COGS 118A,A01,083075,Staff,28,0,60,32
1649883754986,CSE 3,A50,083646,Miranda; Gregory Joseph,29,0,38,9
1649883754986,CSE 3,A51,083647,Miranda; Gregory Joseph,37,0,37,0
1649883761010,CSE 8A,A50,083650,Miranda; Gregory Joseph,21,0,40,19
1649883767040,CSE 11,A01,083080,Cao; Yingjun,0,13,40,40
1649883773139,CSE 12,A01,083652,Staff,76,0,100,24
1649883779178,CSE 15L,A01,083654,Staff,33,0,50,17
1649883779178,CSE 15L,A02,083655,Staff,48,0,50,2
1649883785201,CSE 20,A01,083657,Staff,72,0,80,8
1649883791226,CSE 30,A01,083084,Eldon; John,1,1,40,39
1649883797248,CSE 100,A01,083659,Cao; Yingjun,2,7,50,48
1649883803275,CSE 134B,A01,083661,Powell; Thomas Allan,0,22,65,65
1649883809302,CSE 140,A01,083663,Staff,39,0,75,36
1649883815325,CSE 140L,A01,083088,Eldon; John,31,0,75,44
1649883821354,CSE 175,A01,083665,Kumar; Rakesh,14,0,25,11
1649883827385,CSE 190,A00,092507,Dubnov; Shlomo,15,0,15,0
1649883833417,ECE 45,A01,083139,Staff,23,0,40,17
1649883839455,ECE 65,A50,083695,Staff,16,0,30,14
1649883845498,ECE 109,A01,091882,Touri; Behrouz,61,0,70,9
1649883851522,ECE 180,A00,083140,Abi Samra; Nicholas Camill,28,0,30,2
1649883851522,ECE 180,B00,083141,Abi Samra; Nicholas Camill,13,0,30,17
1649883857547,MATH 10A,A01,083735,Patchell; Gregory David,25,0,30,5
1649883857547,MATH 10A,A02,083736,Patchell; Gregory David,28,0,30,2
1649883857547,MATH 10A,A03,083737,Patchell; Gregory David,29,0,30,1
1649883863576,MATH 10B,A01,083207,Staff,16,0,30,14
1649883863576,MATH 10B,A02,083208,Staff,26,0,30,4
1649883863576,MATH 10B,B01,083739,Staff,25,0,30,5
1649883863576,MATH 10B,B02,083740,Staff,30,0,30,0
1649883869600,MATH 18,A01,083743,Staff,25,0,30,5
1649883869600,MATH 18,A02,083744,Staff,30,0,30,0
1649883869600,MATH 18,A03,083745,Staff,29,0,30,1
1649883869600,MATH 18,A04,083746,Staff,30,0,30,0
1649883869600,MATH 18,B01,083748,Staff,16,0,30,14
1649883869600,MATH 18,B02,083749,Staff,28,0,30,2
1649883869600,MATH 18,B03,083750,Staff,29,0,30,1
1649883869600,MATH 18,B04,083751,Staff,28,0,30,2
1649883875627,MATH 20A,A01,083754,Staff,38,0,40,2
1649883881651,MATH 20B,A01,083756,Staff,27,0,30,3
1649883881651,MATH 20B,A02,083757,Staff,30,0,30,0
1649883887680,MATH 20C,A01,083760,Staff,24,0,30,6
1649883887680,MATH 20C,A02,083761,Staff,28,0,30,2
1649883887680,MATH 20C,B01,083762,Staff,30,0,30,0
1649883887680,MATH 20C,B02,083763,Staff,30,0,30,0
1649883893715,MATH 20D,A01,083765,Staff,22,0,30,8
1649883893715,MATH 20D,A02,083766,Staff,30,0,30,0
1649883893715,MATH 20D,A03,083767,Staff,30,0,30,0
1649883899745,MATH 20E,A01,083771,Staff,18,0,30,12
1649883899745,MATH 20E,A02,083772,Staff,29,0,30,1
1649883899745,MATH 20E,B01,083773,Staff,24,0,30,6
1649883899745,MATH 20E,B02,083774,Staff,29,0,30,1
1649883905769,MATH 103A,A01,083777,Staff,0,0,30,30
1649883905769,MATH 103A,A02,083778,Staff,12,0,30,18
1649883905769,MATH 103A,B01,083779,Staff,7,0,30,23
1649883905769,MATH 103A,B02,083780,Staff,24,0,30,6
1649883911793,MATH 105,A01,085443,Staff,2,0,30,28
1649883917817,MATH 109,A01,083213,Anzaldo; Leesa B,27,0,30,3
1649883917817,MATH 109,A02,083214,Anzaldo; Leesa B,21,0,30,9
1649883917817,MATH 109,B01,083215,Anzaldo; Leesa B,26,0,30,4
1649883917817,MATH 109,B02,083216,Anzaldo; Leesa B,26,0,30,4
1649883923842,MATH 142A,A01,083219,Chow; Bennett,0,0,30,30
1649883923842,MATH 142A,A02,083220,Chow; Bennett,23,0,30,7
1649883923842,MATH 142A,B01,083221,Chow; Bennett,4,0,30,26
1649883923842,MATH 142A,B02,083222,Chow; Bennett,24,0,30,6
1649883929872,MATH 193A,A01,083224,Staff,0,2,30,30
1649883929872,MATH 193A,A02,083225,Staff,0,0,30,30
1649883929872,MATH 193A,A03,083781,Staff,22,0,30,8
1649883929872,MATH 193A,A04,083782,Staff,26,0,30,4
1649883935893,MATH 197,001,091859,McAuley; Julian John,9999,0,9999,0
1649883941950,COGS 9,A01,083615,Staff,35,0,60,25
1649883947980,COGS 11,A01,083617,Boyle; Mary E. T.,36,0,40,4
1649883954008,COGS 13,A01,083071,Staff,6,0,40,34
1649883960037,COGS 14A,A01,092681,Staff,88,0,100,12
1649883966070,COGS 14B,A01,083073,Cheng; Tzu-Han,33,0,50,17
1649883972105,COGS 17,A01,092677,Staff,70,0,75,5
1649883978138,COGS 100,A01,083619,Staff,18,0,60,42
1649883984162,COGS 101A,A01,083621,Davis; Joshua Daniel,20,0,60,40
1649883990191,COGS 101B,A01,091572,Staff,38,0,60,22
1649883996213,COGS 101C,A01,083625,Delgado; Tania,25,0,30,5
1649884002239,COGS 107A,A01,083627,Boyle; Mary E. T.,25,0,60,35
1649884008273,COGS 118A,A01,083075,Staff,28,0,60,32
1649884014318,CSE 3,A50,083646,Miranda; Gregory Joseph,29,0,38,9
1649884014318,CSE 3,A51,083647,Miranda; Gregory Joseph,37,0,37,0
1649884020349,CSE 8A,A50,083650,Miranda; Gregory Joseph,20,0,40,20
1649884026381,CSE 11,A01,083080,Cao; Yingjun,0,13,40,40
1649884032417,CSE 12,A01,083652,Staff,75,0,100,25
1649884038447,CSE 15L,A01,083654,Staff,33,0,50,17
1649884038447,CSE 15L,A02,083655,Staff,48,0,50,2
1649884044485,CSE 20,A01,083657,Staff,72,0,80,8
1649884050521,CSE 30,A01,083084,Eldon; John,1,1,40,39
1649884056550,CSE 100,A01,083659,Cao; Yingjun,2,7,50,48
1649884062580,CSE 134B,A01,083661,Powell; Thomas Allan,0,22,65,65
1649884068611,CSE 140,A01,083663,Staff,38,0,75,37
1649884074650,CSE 140L,A01,083088,Eldon; John,30,0,75,45
1649884080678,CSE 175,A01,083665,Kumar; Rakesh,14,0,25,11
1649884086716,CSE 190,A00,092507,Dubnov; Shlomo,15,0,15,0
1649884092743,ECE 45,A01,083139,Staff,22,0,40,18
1649884098766,ECE 65,A50,083695,Staff,15,0,30,15
1649884104794,ECE 109,A01,091882,Touri; Behrouz,61,0,70,9
1649884110836,ECE 180,A00,083140,Abi Samra; Nicholas Camill,28,0,30,2
1649884110836,ECE 180,B00,083141,Abi Samra; Nicholas Camill,13,0,30,17
1649884116864,MATH 10A,A01,083735,Patchell; Gregory David,25,0,30,5
1649884116864,MATH 10A,A02,083736,Patchell; Gregory David,28,0,30,2
1649884116864,MATH 10A,A03,083737,Patchell; Gregory David,29,0,30,1
1649884122887,MATH 10B,A01,083207,Staff,16,0,30,14
1649884122887,MATH 10B,A02,083208,Staff,26,0,30,4
1649884122887,MATH 10B,B01,083739,Staff,25,0,30,5
1649884122887,MATH 10B,B02,083740,Staff,30,0,30,0
1649884128916,MATH 18,A01,083743,Staff,25,0,30,5
1649884128916,MATH 18,A02,083744,Staff,30,0,30,0
1649884128916,MATH 18,A03,083745,Staff,29,0,30,1
1649884128916,MATH 18,A04,083746,Staff,30,0,30,0
1649884128916,MATH 18,B01,083748,Staff,16,0,30,14
1649884128916,MATH 18,B02,083749,Staff,28,0,30,2
1649884128916,MATH 18,B03,083750,Staff,29,0,30,1
1649884128916,MATH 18,B04,083751,Staff,28,0,30,2
1649884134944,MATH 20A,A01,083754,Staff,38,0,40,2
1649884140967,MATH 20B,A01,083756,Staff,27,0,30,3
1649884140967,MATH 20B,A02,083757,Staff,30,0,30,0
1649884146990,MATH 20C,A01,083760,Staff,24,0,30,6
1649884146990,MATH 20C,A02,083761,Staff,28,0,30,2
1649884146990,MATH 20C,B01,083762,Staff,30,0,30,0
1649884146990,MATH 20C,B02,083763,Staff,30,0,30,0
1649884153012,MATH 20D,A01,083765,Staff,22,0,30,8
1649884153012,MATH 20D,A02,083766,Staff,30,0,30,0
1649884153012,MATH 20D,A03,083767,Staff,30,0,30,0
1649884159047,MATH 20E,A01,083771,Staff,18,0,30,12
1649884159047,MATH 20E,A02,083772,Staff,29,0,30,1
1649884159047,MATH 20E,B01,083773,Staff,24,0,30,6
1649884159047,MATH 20E,B02,083774,Staff,29,0,30,1
1649884165070,MATH 103A,A01,083777,Staff,0,0,30,30
1649884165070,MATH 103A,A02,083778,Staff,12,0,30,18
1649884165070,MATH 103A,B01,083779,Staff,7,0,30,23
1649884165070,MATH 103A,B02,083780,Staff,24,0,30,6
1649884171101,MATH 105,A01,085443,Staff,2,0,30,28
1649884177124,MATH 109,A01,083213,Anzaldo; Leesa B,27,0,30,3
1649884177124,MATH 109,A02,083214,Anzaldo; Leesa B,21,0,30,9
1649884177124,MATH 109,B01,083215,Anzaldo; Leesa B,26,0,30,4
1649884177124,MATH 109,B02,083216,Anzaldo; Leesa B,26,0,30,4
1649884183154,MATH 142A,A01,083219,Chow; Bennett,0,0,30,30
1649884183154,MATH 142A,A02,083220,Chow; Bennett,23,0,30,7
1649884183154,MATH 142A,B01,083221,Chow; Bennett,4,0,30,26
1649884183154,MATH 142A,B02,083222,Chow; Bennett,24,0,30,6
1649884189182,MATH 193A,A01,083224,Staff,0,2,30,30
1649884189182,MATH 193A,A02,083225,Staff,0,1,30,30
1649884189182,MATH 193A,A03,083781,Staff,22,0,30,8
1649884189182,MATH 193A,A04,083782,Staff,26,0,30,4
1649884195207,MATH 197,001,091859,McAuley; Julian John,9999,0,9999,0
1649884201266,COGS 9,A01,083615,Staff,35,0,60,25
1649884207289,COGS 11,A01,083617,Boyle; Mary E. T.,36,0,40,4
1649884213325,COGS 13,A01,083071,Staff,6,0,40,34
1649884219347,COGS 14A,A01,092681,Staff,88,0,100,12
1649884225371,COGS 14B,A01,083073,Cheng; Tzu-Han,33,0,50,17
1649884231397,COGS 17,A01,092677,Staff,70,0,75,5
1649884237420,COGS 100,A01,083619,Staff,18,0,60,42
1649884243447,COGS 101A,A01,083621,Davis; Joshua Daniel,20,0,60,40
1649884249471,COGS 101B,A01,091572,Staff,38,0,60,22
1649884255497,COGS 101C,A01,083625,Delgado; Tania,25,0,30,5
1649884261520,COGS 107A,A01,083627,Boyle; Mary E. T.,25,0,60,35
1649884267542,COGS 118A,A01,083075,Staff,28,0,60,32
1649884273570,CSE 3,A50,083646,Miranda; Gregory Joseph,29,0,38,9
1649884273570,CSE 3,A51,083647,Miranda; Gregory Joseph,37,0,37,0
1649884279597,CSE 8A,A50,083650,Miranda; Gregory Joseph,20,0,40,20
1649884285628,CSE 11,A01,083080,Cao; Yingjun,0,13,40,40
1649884291655,CSE 12,A01,083652,Staff,75,0,100,25
1649884297683,CSE 15L,A01,083654,Staff,33,0,50,17
1649884297683,CSE 15L,A02,083655,Staff,48,0,50,2
1649884303722,CSE 20,A01,083657,Staff,71,0,80,9
1649884309754,CSE 30,A01,083084,Eldon; John,1,1,40,39
1649884315776,CSE 100,A01,083659,Cao; Yingjun,2,7,50,48
1649884321799,CSE 134B,A01,083661,Powell; Thomas Allan,0,22,65,65
1649884327826,CSE 140,A01,083663,Staff,38,0,75,37
1649884333850,CSE 140L,A01,083088,Eldon; John,30,0,75,45
1649884339883,CSE 175,A01,083665,Kumar; Rakesh,14,0,25,11
1649884345914,CSE 190,A00,092507,Dubnov; Shlomo,15,0,15,0
1649884351940,ECE 45,A01,083139,Staff,22,0,40,18
1649884357962,ECE 65,A50,083695,Staff,15,0,30,15
1649884363986,ECE 109,A01,091882,Touri; Behrouz,61,0,70,9
1649884370090,ECE 180,A00,083140,Abi Samra; Nicholas Camill,28,0,30,2
1649884370090,ECE 180,B00,083141,Abi Samra; Nicholas Camill,13,0,30,17
1649884376116,MATH 10A,A01,083735,Patchell; Gregory David,25,0,30,5
1649884376116,MATH 10A,A02,083736,Patchell; Gregory David,28,0,30,2
1649884376116,MATH 10A,A03,083737,Patchell; Gregory David,29,0,30,1
1649884382142,MATH 10B,A01,083207,Staff,16,0,30,14
1649884382142,MATH 10B,A02,083208,Staff,26,0,30,4
1649884382142,MATH 10B,B01,083739,Staff,25,0,30,5
1649884382142,MATH 10B,B02,083740,Staff,30,0,30,0
1649884388179,MATH 18,A01,083743,Staff,25,0,30,5
1649884388179,MATH 18,A02,083744,Staff,30,0,30,0
1649884388179,MATH 18,A03,083745,Staff,29,0,30,1
1649884388179,MATH 18,A04,083746,Staff,30,0,30,0
1649884388179,MATH 18,B01,083748,Staff,16,0,30,14
1649884388179,MATH 18,B02,083749,Staff,28,0,30,2
1649884388179,MATH 18,B03,083750,Staff,29,0,30,1
1649884388179,MATH 18,B04,083751,Staff,28,0,30,2
1649884394204,MATH 20A,A01,083754,Staff,38,0,40,2
1649884400227,MATH 20B,A01,083756,Staff,27,0,30,3
1649884400227,MATH 20B,A02,083757,Staff,30,0,30,0
1649884406250,MATH 20C,A01,083760,Staff,24,0,30,6
1649884406250,MATH 20C,A02,083761,Staff,28,0,30,2
1649884406250,MATH 20C,B01,083762,Staff,30,0,30,0
1649884406250,MATH 20C,B02,083763,Staff,30,0,30,0
1649884412279,MATH 20D,A01,083765,Staff,22,0,30,8
1649884412279,MATH 20D,A02,083766,Staff,30,0,30,0
1649884412279,MATH 20D,A03,083767,Staff,30,0,30,0
1649884418339,MATH 20E,A01,083771,Staff,18,0,30,12
1649884418339,MATH 20E,A02,083772,Staff,29,0,30,1
1649884418339,MATH 20E,B01,083773,Staff,24,0,30,6
1649884418339,MATH 20E,B02,083774,Staff,29,0,30,1
1649884424371,MATH 103A,A01,083777,Staff,0,0,30,30
1649884424371,MATH 103A,A02,083778,Staff,12,0,30,18
1649884424371,MATH 103A,B01,083779,Staff,7,0,30,23
1649884424371,MATH 103A,B02,083780,Staff,24,0,30,6
1649884430398,MATH 105,A01,085443,Staff,1,0,30,29
1649884436432,MATH 109,A01,083213,Anzaldo; Leesa B,27,0,30,3
1649884436432,MATH 109,A02,083214,Anzaldo; Leesa B,21,0,30,9
1649884436432,MATH 109,B01,083215,Anzaldo; Leesa B,26,0,30,4
1649884436432,MATH 109,B02,083216,Anzaldo; Leesa B,26,0,30,4
1649884442460,MATH 142A,A01,083219,Chow; Bennett,0,0,30,30
1649884442460,MATH 142A,A02,083220,Chow; Bennett,23,0,30,7
1649884442460,MATH 142A,B01,083221,Chow; Bennett,4,0,30,26
1649884442460,MATH 142A,B02,083222,Chow; Bennett,24,0,30,6
1649884448487,MATH 193A,A01,083224,Staff,0,2,30,30
1649884448487,MATH 193A,A02,083225,Staff,0,1,30,30
1649884448487,MATH 193A,A03,083781,Staff,22,0,30,8
1649884448487,MATH 193A,A04,083782,Staff,26,0,30,4
1649884454512,MATH 197,001,091859,McAuley; Julian John,9999,0,9999,0
1649884460570,COGS 9,A01,083615,Staff,35,0,60,25
1649884466616,COGS 11,A01,083617,Boyle; Mary E. T.,36,0,40,4
1649884472646,COGS 13,A01,083071,Staff,5,0,40,35
1649884478681,COGS 14A,A01,092681,Staff,88,0,100,12
1649884484704,COGS 14B,A01,083073,Cheng; Tzu-Han,32,0,50,18
1649884490732,COGS 17,A01,092677,Staff,69,0,75,6
1649884496756,COGS 100,A01,083619,Staff,18,0,60,42
1649884502786,COGS 101A,A01,083621,Davis; Joshua Daniel,19,0,60,41
1649884508809,COGS 101B,A01,091572,Staff,38,0,60,22
1649884514836,COGS 101C,A01,083625,Delgado; Tania,25,0,30,5
1649884520862,COGS 107A,A01,083627,Boyle; Mary E. T.,24,0,60,36
1649884526899,COGS 118A,A01,083075,Staff,28,0,60,32
1649884532931,CSE 3,A50,083646,Miranda; Gregory Joseph,29,0,38,9
1649884532931,CSE 3,A51,083647,Miranda; Gregory Joseph,37,0,37,0
1649884538960,CSE 8A,A50,083650,Miranda; Gregory Joseph,20,0,40,20
1649884544986,CSE 11,A01,083080,Cao; Yingjun,0,13,40,40
1649884551010,CSE 12,A01,083652,Staff,74,0,100,26
1649884557037,CSE 15L,A01,083654,Staff,32,0,50,18
1649884557037,CSE 15L,A02,083655,Staff,48,0,50,2
1649884563058,CSE 20,A01,083657,Staff,71,0,80,9
1649884569081,CSE 30,A01,083084,Eldon; John,1,1,40,39
1649884575108,CSE 100,A01,083659,Cao; Yingjun,2,7,50,48
1649884581132,CSE 134B,A01,083661,Powell; Thomas Allan,0,22,65,65
1649884587165,CSE 140,A01,083663,Staff,38,0,75,37
1649884593192,CSE 140L,A01,083088,Eldon; John,30,0,75,45
1649884599216,CSE 175,A01,083665,Kumar; Rakesh,14,0,25,11
1649884605250,CSE 190,A00,092507,Dubnov; Shlomo,15,0,15,0
1649884611274,ECE 45,A01,083139,Staff,22,0,40,18
1649884617297,ECE 65,A50,083695,Staff,15,0,30,15
1649884623325,ECE 109,A01,091882,Touri; Behrouz,61,0,70,9
1649884629346,ECE 180,A00,083140,Abi Samra; Nicholas Camill,28,0,30,2
1649884629346,ECE 180,B00,083141,Abi Samra; Nicholas Camill,13,0,30,17
1649884635385,MATH 10A,A01,083735,Patchell; Gregory David,25,0,30,5
1649884635385,MATH 10A,A02,083736,Patchell; Gregory David,28,0,30,2
1649884635385,MATH 10A,A03,083737,Patchell; Gregory David,29,0,30,1
1649884641407,MATH 10B,A01,083207,Staff,16,0,30,14
1649884641407,MATH 10B,A02,083208,Staff,26,0,30,4
1649884641407,MATH 10B,B01,083739,Staff,25,0,30,5
1649884641407,MATH 10B,B02,083740,Staff,30,0,30,0
1649884647433,MATH 18,A01,083743,Staff,25,0,30,5
1649884647433,MATH 18,A02,083744,Staff,30,0,30,0
1649884647433,MATH 18,A03,083745,Staff,29,0,30,1
1649884647433,MATH 18,A04,083746,Staff,30,0,30,0
1649884647433,MATH 18,B01,083748,Staff,16,0,30,14
1649884647433,MATH 18,B02,083749,Staff,28,0,30,2
1649884647433,MATH 18,B03,083750,Staff,29,0,30,1
1649884647433,MATH 18,B04,083751,Staff,28,0,30,2
1649884653456,MATH 20A,A01,083754,Staff,38,0,40,2
1649884659483,MATH 20B,A01,083756,Staff,27,0,30,3
1649884659483,MATH 20B,A02,083757,Staff,30,0,30,0
1649884665508,MATH 20C,A01,083760,Staff,24,0,30,6
1649884665508,MATH 20C,A02,083761,Staff,28,0,30,2
1649884665508,MATH 20C,B01,083762,Staff,30,0,30,0
1649884665508,MATH 20C,B02,083763,Staff,30,0,30,0
1649884671532,MATH 20D,A01,083765,Staff,22,0,30,8
1649884671532,MATH 20D,A02,083766,Staff,30,0,30,0
1649884671532,MATH 20D,A03,083767,Staff,30,0,30,0
1649884677566,MATH 20E,A01,083771,Staff,18,0,30,12
1649884677566,MATH 20E,A02,083772,Staff,29,0,30,1
1649884677566,MATH 20E,B01,083773,Staff,24,0,30,6
1649884677566,MATH 20E,B02,083774,Staff,29,0,30,1
1649884683601,MATH 103A,A01,083777,Staff,0,0,30,30
1649884683601,MATH 103A,A02,083778,Staff,12,0,30,18
1649884683601,MATH 103A,B01,083779,Staff,7,0,30,23
1649884683601,MATH 103A,B02,083780,Staff,24,0,30,6
1649884689630,MATH 105,A01,085443,Staff,1,0,30,29
1649884695654,MATH 109,A01,083213,Anzaldo; Leesa B,27,0,30,3
1649884695654,MATH 109,A02,083214,Anzaldo; Leesa B,21,0,30,9
1649884695654,MATH 109,B01,083215,Anzaldo; Leesa B,26,0,30,4
1649884695654,MATH 109,B02,083216,Anzaldo; Leesa B,26,0,30,4
1649884701681,MATH 142A,A01,083219,Chow; Bennett,0,0,30,30
1649884701681,MATH 142A,A02,083220,Chow; Bennett,23,0,30,7
1649884701681,MATH 142A,B01,083221,Chow; Bennett,4,0,30,26
1649884701681,MATH 142A,B02,083222,Chow; Bennett,24,0,30,6
1649884707705,MATH 193A,A01,083224,Staff,0,2,30,30
1649884707705,MATH 193A,A02,083225,Staff,0,1,30,30
1649884707705,MATH 193A,A03,083781,Staff,21,0,30,9
1649884707705,MATH 193A,A04,083782,Staff,26,0,30,4
1649884713737,MATH 197,001,091859,McAuley; Julian John,9999,0,9999,0
1649884719787,COGS 9,A01,083615,Staff,35,0,60,25
1649884725821,COGS 11,A01,083617,Boyle; Mary E. T.,36,0,40,4
1649884731856,COGS 13,A01,083071,Staff,5,0,40,35
1649884737889,COGS 14A,A01,092681,Staff,88,0,100,12
1649884743919,COGS 14B,A01,083073,Cheng; Tzu-Han,32,0,50,18
1649884749950,COGS 17,A01,092677,Staff,69,0,75,6
1649884755988,COGS 100,A01,083619,Staff,18,0,60,42
1649884762016,COGS 101A,A01,083621,Davis; Joshua Daniel,19,0,60,41
1649884768039,COGS 101B,A01,091572,Staff,38,0,60,22
1649884774077,COGS 101C,A01,083625,Delgado; Tania,25,0,30,5
1649884780106,COGS 107A,A01,083627,Boyle; Mary E. T.,24,0,60,36
1649884786130,COGS 118A,A01,083075,Staff,28,0,60,32
1649884792171,CSE 3,A50,083646,Miranda; Gregory Joseph,29,0,38,9
1649884792171,CSE 3,A51,083647,Miranda; Gregory Joseph,37,0,37,0
1649884798194,CSE 8A,A50,083650,Miranda; Gregory Joseph,20,0,40,20
1649884804222,CSE 11,A01,083080,Cao; Yingjun,0,13,40,40
1649884810254,CSE 12,A01,083652,Staff,74,0,100,26
1649884816278,CSE 15L,A01,083654,Staff,32,0,50,18
1649884816278,CSE 15L,A02,083655,Staff,48,0,50,2
1649884822303,CSE 20,A01,083657,Staff,71,0,80,9
1649884828335,CSE 30,A01,083084,Eldon; John,1,1,40,39
1649884834362,CSE 100,A01,083659,Cao; Yingjun,2,7,50,48
1649884840384,CSE 134B,A01,083661,Powell; Thomas Allan,0,22,65,65
1649884846406,CSE 140,A01,083663,Staff,38,0,75,37
1649884852429,CSE 140L,A01,083088,Eldon; John,30,0,75,45
1649884858454,CSE 175,A01,083665,Kumar; Rakesh,14,0,25,11
1649884864476,CSE 190,A00,092507,Dubnov; Shlomo,15,0,15,0
1649884870500,ECE 45,A01,083139,Staff,22,0,40,18
1649884876534,ECE 65,A50,083695,Staff,15,0,30,15
1649884882557,ECE 109,A01,091882,Touri; Behrouz,61,0,70,9
1649884888583,ECE 180,A00,083140,Abi Samra; Nicholas Camill,28,0,30,2
1649884888583,ECE 180,B00,083141,Abi Samra; Nicholas Camill,13,0,30,17
1649884894606,MATH 10A,A01,083735,Patchell; Gregory David,25,0,30,5
1649884894606,MATH 10A,A02,083736,Patchell; Gregory David,28,0,30,2
1649884894606,MATH 10A,A03,083737,Patchell; Gregory David,29,0,30,1
1649884900634,MATH 10B,A01,083207,Staff,16,0,30,14
1649884900634,MATH 10B,A02,083208,Staff,26,0,30,4
1649884900634,MATH 10B,B01,083739,Staff,25,0,30,5
1649884900634,MATH 10B,B02,083740,Staff,30,0,30,0
1649884906662,MATH 18,A01,083743,Staff,25,0,30,5
1649884906662,MATH 18,A02,083744,Staff,30,0,30,0
1649884906662,MATH 18,A03,083745,Staff,29,0,30,1
1649884906662,MATH 18,A04,083746,Staff,30,0,30,0
1649884906662,MATH 18,B01,083748,Staff,16,0,30,14
1649884906662,MATH 18,B02,083749,Staff,28,0,30,2
1649884906662,MATH 18,B03,083750,Staff,29,0,30,1
1649884906662,MATH 18,B04,083751,Staff,28,0,30,2
1649884912686,MATH 20A,A01,083754,Staff,38,0,40,2
1649884918711,MATH 20B,A01,083756,Staff,27,0,30,3
1649884918711,MATH 20B,A02,083757,Staff,30,0,30,0
1649884924737,MATH 20C,A01,083760,Staff,24,0,30,6
1649884924737,MATH 20C,A02,083761,Staff,28,0,30,2
1649884924737,MATH 20C,B01,083762,Staff,30,0,30,0
1649884924737,MATH 20C,B02,083763,Staff,30,0,30,0
1649884930761,MATH 20D,A01,083765,Staff,22,0,30,8
1649884930761,MATH 20D,A02,083766,Staff,30,0,30,0
1649884930761,MATH 20D,A03,083767,Staff,30,0,30,0
1649884936785,MATH 20E,A01,083771,Staff,18,0,30,12
1649884936785,MATH 20E,A02,083772,Staff,29,0,30,1
1649884936785,MATH 20E,B01,083773,Staff,24,0,30,6
1649884936785,MATH 20E,B02,083774,Staff,29,0,30,1
1649884942810,MATH 103A,A01,083777,Staff,0,0,30,30
1649884942810,MATH 103A,A02,083778,Staff,12,0,30,18
1649884942810,MATH 103A,B01,083779,Staff,7,0,30,23
1649884942810,MATH 103A,B02,083780,Staff,24,0,30,6
1649884948834,MATH 105,A01,085443,Staff,1,0,30,29
1649884955462,MATH 109,A01,083213,Anzaldo; Leesa B,26,0,30,4
1649884955462,MATH 109,A02,083214,Anzaldo; Leesa B,20,0,30,10
1649884955462,MATH 109,B01,083215,Anzaldo; Leesa B,26,0,30,4
1649884955462,MATH 109,B02,083216,Anzaldo; Leesa B,26,0,30,4
1649884961503,MATH 142A,A01,083219,Chow; Bennett,0,0,30,30
1649884961503,MATH 142A,A02,083220,Chow; Bennett,23,0,30,7
1649884961503,MATH 142A,B01,083221,Chow; Bennett,4,0,30,26
1649884961503,MATH 142A,B02,083222,Chow; Bennett,24,0,30,6
1649884967605,MATH 193A,A01,083224,Staff,0,2,30,30
1649884967605,MATH 193A,A02,083225,Staff,0,1,30,30
1649884967605,MATH 193A,A03,083781,Staff,21,0,30,9
1649884967605,MATH 193A,A04,083782,Staff,26,0,30,4
1649884973631,MATH 197,001,091859,McAuley; Julian John,9999,0,9999,0
1649884979696,COGS 9,A01,083615,Staff,35,0,60,25
1649884985719,COGS 11,A01,083617,Boyle; Mary E. T.,36,0,40,4
1649885002936,COGS 13,A01,083071,Staff,5,0,40,35
1649885008963,COGS 14A,A01,092681,Staff,87,0,100,13
1649885014987,COGS 14B,A01,083073,Cheng; Tzu-Han,32,0,50,18
1649885021013,COGS 17,A01,092677,Staff,68,0,75,7
1649885027036,COGS 100,A01,083619,Staff,17,0,60,43
1649885033062,COGS 101A,A01,083621,Davis; Joshua Daniel,19,0,60,41
1649885039087,COGS 101B,A01,091572,Staff,38,0,60,22
1649885045114,COGS 101C,A01,083625,Delgado; Tania,25,0,30,5
1649885051141,COGS 107A,A01,083627,Boyle; Mary E. T.,24,0,60,36
1649885057169,COGS 118A,A01,083075,Staff,28,0,60,32
1649885063200,CSE 3,A50,083646,Miranda; Gregory Joseph,28,0,38,10
1649885063200,CSE 3,A51,083647,Miranda; Gregory Joseph,37,0,37,0
1649885069228,CSE 8A,A50,083650,Miranda; Gregory Joseph,20,0,40,20
1649885075250,CSE 11,A01,083080,Cao; Yingjun,0,13,40,40
1649885081277,CSE 12,A01,083652,Staff,73,0,100,27
1649885087300,CSE 15L,A01,083654,Staff,31,0,50,19
1649885087300,CSE 15L,A02,083655,Staff,48,0,50,2
1649885093326,CSE 20,A01,083657,Staff,71,0,80,9
1649885099350,CSE 30,A01,083084,Eldon; John,1,1,40,39
1649885105374,CSE 100,A01,083659,Cao; Yingjun,2,8,50,48
1649885111405,CSE 134B,A01,083661,Powell; Thomas Allan,0,22,65,65
1649885117429,CSE 140,A01,083663,Staff,37,0,75,38
1649885123455,CSE 140L,A01,083088,Eldon; John,29,0,75,46
1649885129492,CSE 175,A01,083665,Kumar; Rakesh,14,0,25,11
1649885135519,CSE 190,A00,092507,Dubnov; Shlomo,15,0,15,0
1649885141546,ECE 45,A01,083139,Staff,21,0,40,19
1649885147569,ECE 65,A50,083695,Staff,15,0,30,15
1649885153595,ECE 109,A01,091882,Touri; Behrouz,61,0,70,9
1649885159637,ECE 180,A00,083140,Abi Samra; Nicholas Camill,28,0,30,2
1649885159637,ECE 180,B00,083141,Abi Samra; Nicholas Camill,13,0,30,17
1649885165667,MATH 10A,A01,083735,Patchell; Gregory David,25,0,30,5
1649885165667,MATH 10A,A02,083736,Patchell; Gregory David,28,0,30,2
1649885165667,MATH 10A,A03,083737,Patchell; Gregory David,29,0,30,1
1649885171704,MATH 10B,A01,083207,Staff,15,0,30,15
1649885171704,MATH 10B,A02,083208,Staff,26,0,30,4
1649885171704,MATH 10B,B01,083739,Staff,25,0,30,5
1649885171704,MATH 10B,B02,083740,Staff,30,0,30,0
1649885177744,MATH 18,A01,083743,Staff,25,0,30,5
1649885177744,MATH 18,A02,083744,Staff,30,0,30,0
1649885177744,MATH 18,A03,083745,Staff,29,0,30,1
1649885177744,MATH 18,A04,083746,Staff,30,0,30,0
1649885177744,MATH 18,B01,083748,Staff,15,0,30,15
1649885177744,MATH 18,B02,083749,Staff,28,0,30,2
1649885177744,MATH 18,B03,083750,Staff,29,0,30,1
1649885177744,MATH 18,B04,083751,Staff,28,0,30,2
1649885183766,MATH 20A,A01,083754,Staff,38,0,40,2
1649885189805,MATH 20B,A01,083756,Staff,27,0,30,3
1649885189805,MATH 20B,A02,083757,Staff,30,0,30,0
1649885195833,MATH 20C,A01,083760,Staff,24,0,30,6
1649885195833,MATH 20C,A02,083761,Staff,28,0,30,2
1649885195833,MATH 20C,B01,083762,Staff,30,0,30,0
1649885195833,MATH 20C,B02,083763,Staff,30,0,30,0
1649885201859,MATH 20D,A01,083765,Staff,22,0,30,8
1649885201859,MATH 20D,A02,083766,Staff,30,0,30,0
1649885201859,MATH 20D,A03,083767,Staff,30,0,30,0
1649885207975,MATH 20E,A01,083771,Staff,18,0,30,12
1649885207975,MATH 20E,A02,083772,Staff,29,0,30,1
1649885207975,MATH 20E,B01,083773,Staff,24,0,30,6
1649885207975,MATH 20E,B02,083774,Staff,29,0,30,1
1649885214017,MATH 103A,A01,083777,Staff,0,0,30,30
1649885214017,MATH 103A,A02,083778,Staff,12,0,30,18
1649885214017,MATH 103A,B01,083779,Staff,7,0,30,23
1649885214017,MATH 103A,B02,083780,Staff,24,0,30,6
1649885220040,MATH 105,A01,085443,Staff,1,0,30,29
1649885226064,MATH 109,A01,083213,Anzaldo; Leesa B,26,0,30,4
1649885226064,MATH 109,A02,083214,Anzaldo; Leesa B,20,0,30,10
1649885226064,MATH 109,B01,083215,Anzaldo; Leesa B,26,0,30,4
1649885226064,MATH 109,B02,083216,Anzaldo; Leesa B,26,0,30,4
1649885232089,MATH 142A,A01,083219,Chow; Bennett,0,1,30,30
1649885232089,MATH 142A,A02,083220,Chow; Bennett,23,0,30,7
1649885232089,MATH 142A,B01,083221,Chow; Bennett,3,0,30,27
1649885232089,MATH 142A,B02,083222,Chow; Bennett,24,0,30,6
1649885238118,MATH 193A,A01,083224,Staff,0,2,30,30
1649885238118,MATH 193A,A02,083225,Staff,0,1,30,30
1649885238118,MATH 193A,A03,083781,Staff,21,0,30,9
1649885238118,MATH 193A,A04,083782,Staff,26,0,30,4
1649885244155,MATH 197,001,091859,McAuley; Julian John,9999,0,9999,0
1649885250232,COGS 9,A01,083615,Staff,35,0,60,25
1649885256258,COGS 11,A01,083617,Boyle; Mary E. T.,36,0,40,4
1649885262283,COGS 13,A01,083071,Staff,5,0,40,35
1649885268318,COGS 14A,A01,092681,Staff,87,0,100,13
1649885274345,COGS 14B,A01,083073,Cheng; Tzu-Han,32,0,50,18
1649885280373,COGS 17,A01,092677,Staff,68,0,75,7
1649885286400,COGS 100,A01,083619,Staff,16,0,60,44
1649885292428,COGS 101A,A01,083621,Davis; Joshua Daniel,19,0,60,41
1649885298454,COGS 101B,A01,091572,Staff,37,0,60,23
1649885304478,COGS 101C,A01,083625,Delgado; Tania,25,0,30,5
1649885310509,COGS 107A,A01,083627,Boyle; Mary E. T.,24,0,60,36
1649885316547,COGS 118A,A01,083075,Staff,27,0,60,33
1649885322586,CSE 3,A50,083646,Miranda; Gregory Joseph,28,0,38,10
1649885322586,CSE 3,A51,083647,Miranda; Gregory Joseph,37,0,37,0
1649885328621,CSE 8A,A50,083650,Miranda; Gregory Joseph,20,0,40,20
1649885334653,CSE 11,A01,083080,Cao; Yingjun,0,13,40,40
1649885340682,CSE 12,A01,083652,Staff,73,0,100,27
1649885346706,CSE 15L,A01,083654,Staff,31,0,50,19
1649885346706,CSE 15L,A02,083655,Staff,48,0,50,2
1649885352734,CSE 20,A01,083657,Staff,71,0,80,9
1649885358759,CSE 30,A01,083084,Eldon; John,1,1,40,39
1649885364784,CSE 100,A01,083659,Cao; Yingjun,2,8,50,48
1649885370819,CSE 134B,A01,083661,Powell; Thomas Allan,0,22,65,65
1649885376846,CSE 140,A01,083663,Staff,37,0,75,38
1649885382871,CSE 140L,A01,083088,Eldon; John,29,0,75,46
1649885388908,CSE 175,A01,083665,Kumar; Rakesh,14,0,25,11
1649885394933,CSE 190,A00,092507,Dubnov; Shlomo,15,0,15,0
1649885400968,ECE 45,A01,083139,Staff,21,0,40,19
1649885406994,ECE 65,A50,083695,Staff,15,0,30,15
1649885413024,ECE 109,A01,091882,Touri; Behrouz,60,0,70,10
1649885419049,ECE 180,A00,083140,Abi Samra; Nicholas Camill,28,0,30,2
1649885419049,ECE 180,B00,083141,Abi Samra; Nicholas Camill,13,0,30,17
1649885425073,MATH 10A,A01,083735,Patchell; Gregory David,24,0,30,6
1649885425073,MATH 10A,A02,083736,Patchell; Gregory David,28,0,30,2
1649885425073,MATH 10A,A03,083737,Patchell; Gregory David,29,0,30,1
1649885431101,MATH 10B,A01,083207,Staff,15,0,30,15
1649885431101,MATH 10B,A02,083208,Staff,26,0,30,4
1649885431101,MATH 10B,B01,083739,Staff,25,0,30,5
1649885431101,MATH 10B,B02,083740,Staff,30,0,30,0
1649885437129,MATH 18,A01,083743,Staff,25,0,30,5
1649885437129,MATH 18,A02,083744,Staff,30,0,30,0
1649885437129,MATH 18,A03,083745,Staff,29,0,30,1
1649885437129,MATH 18,A04,083746,Staff,30,0,30,0
1649885437129,MATH 18,B01,083748,Staff,15,0,30,15
1649885437129,MATH 18,B02,083749,Staff,28,0,30,2
1649885437129,MATH 18,B03,083750,Staff,29,0,30,1
1649885437129,MATH 18,B04,083751,Staff,28,0,30,2
1649885443154,MATH 20A,A01,083754,Staff,38,0,40,2
1649885449178,MATH 20B,A01,083756,Staff,27,0,30,3
1649885449178,MATH 20B,A02,083757,Staff,30,0,30,0
1649885455204,MATH 20C,A01,083760,Staff,24,0,30,6
1649885455204,MATH 20C,A02,083761,Staff,28,0,30,2
1649885455204,MATH 20C,B01,083762,Staff,30,0,30,0
1649885455204,MATH 20C,B02,083763,Staff,30,0,30,0
1649885461227,MATH 20D,A01,083765,Staff,22,0,30,8
1649885461227,MATH 20D,A02,083766,Staff,30,0,30,0
1649885461227,MATH 20D,A03,083767,Staff,30,0,30,0
1649885467251,MATH 20E,A01,083771,Staff,18,0,30,12
1649885467251,MATH 20E,A02,083772,Staff,29,0,30,1
1649885467251,MATH 20E,B01,083773,Staff,24,0,30,6
1649885467251,MATH 20E,B02,083774,Staff,29,0,30,1
1649885473275,MATH 103A,A01,083777,Staff,0,0,30,30
1649885473275,MATH 103A,A02,083778,Staff,12,0,30,18
1649885473275,MATH 103A,B01,083779,Staff,7,0,30,23
1649885473275,MATH 103A,B02,083780,Staff,24,0,30,6
1649885479297,MATH 105,A01,085443,Staff,1,0,30,29
1649885485323,MATH 109,A01,083213,Anzaldo; Leesa B,26,0,30,4
1649885485323,MATH 109,A02,083214,Anzaldo; Leesa B,20,0,30,10
1649885485323,MATH 109,B01,083215,Anzaldo; Leesa B,26,0,30,4
1649885485323,MATH 109,B02,083216,Anzaldo; Leesa B,26,0,30,4
1649885491348,MATH 142A,A01,083219,Chow; Bennett,0,1,30,30
1649885491348,MATH 142A,A02,083220,Chow; Bennett,23,0,30,7
1649885491348,MATH 142A,B01,083221,Chow; Bennett,3,0,30,27
1649885491348,MATH 142A,B02,083222,Chow; Bennett,24,0,30,6
1649885497375,MATH 193A,A01,083224,Staff,0,2,30,30
1649885497375,MATH 193A,A02,083225,Staff,0,1,30,30
1649885497375,MATH 193A,A03,083781,Staff,21,0,30,9
1649885497375,MATH 193A,A04,083782,Staff,26,0,30,4
1649885503413,MATH 197,001,091859,McAuley; Julian John,9999,0,9999,0
1649885509461,COGS 9,A01,083615,Staff,35,0,60,25
1649885515488,COGS 11,A01,083617,Boyle; Mary E. T.,36,0,40,4
1649885521513,COGS 13,A01,083071,Staff,5,0,40,35
1649885527535,COGS 14A,A01,092681,Staff,87,0,100,13
1649885533574,COGS 14B,A01,083073,Cheng; Tzu-Han,32,0,50,18
1649885539596,COGS 17,A01,092677,Staff,68,0,75,7
1649885545621,COGS 100,A01,083619,Staff,16,0,60,44
1649885551661,COGS 101A,A01,083621,Davis; Joshua Daniel,18,0,60,42
1649885557692,COGS 101B,A01,091572,Staff,37,0,60,23
1649885563723,COGS 101C,A01,083625,Delgado; Tania,25,0,30,5
1649885569831,COGS 107A,A01,083627,Boyle; Mary E. T.,24,0,60,36
1649885575856,COGS 118A,A01,083075,Staff,27,0,60,33
1649885581886,CSE 3,A50,083646,Miranda; Gregory Joseph,28,0,38,10
1649885581886,CSE 3,A51,083647,Miranda; Gregory Joseph,37,0,37,0
1649885587922,CSE 8A,A50,083650,Miranda; Gregory Joseph,19,0,40,21
1649885593949,CSE 11,A01,083080,Cao; Yingjun,0,14,40,40
1649885599972,CSE 12,A01,083652,Staff,73,0,100,27
1649885605996,CSE 15L,A01,083654,Staff,31,0,50,19
1649885605996,CSE 15L,A02,083655,Staff,48,0,50,2
1649885612024,CSE 20,A01,083657,Staff,71,0,80,9
1649885618048,CSE 30,A01,083084,Eldon; John,1,1,40,39
1649885624079,CSE 100,A01,083659,Cao; Yingjun,2,8,50,48
1649885630103,CSE 134B,A01,083661,Powell; Thomas Allan,0,22,65,65
1649885636128,CSE 140,A01,083663,Staff,37,0,75,38
1649885642159,CSE 140L,A01,083088,Eldon; John,29,0,75,46
1649885648187,CSE 175,A01,083665,Kumar; Rakesh,14,0,25,11
1649885654213,CSE 190,A00,092507,Dubnov; Shlomo,15,0,15,0
1649885660235,ECE 45,A01,083139,Staff,21,0,40,19
1649885666262,ECE 65,A50,083695,Staff,14,0,30,16
1649885672285,ECE 109,A01,091882,Touri; Behrouz,60,0,70,10
1649885678312,ECE 180,A00,083140,Abi Samra; Nicholas Camill,28,0,30,2
1649885678312,ECE 180,B00,083141,Abi Samra; Nicholas Camill,13,0,30,17
1649885684335,MATH 10A,A01,083735,Patchell; Gregory David,24,0,30,6
1649885684335,MATH 10A,A02,083736,Patchell; Gregory David,28,0,30,2
1649885684335,MATH 10A,A03,083737,Patchell; Gregory David,29,0,30,1
1649885690364,MATH 10B,A01,083207,Staff,15,0,30,15
1649885690364,MATH 10B,A02,083208,Staff,26,0,30,4
1649885690364,MATH 10B,B01,083739,Staff,25,0,30,5
1649885690364,MATH 10B,B02,083740,Staff,30,0,30,0
1649885696387,MATH 18,A01,083743,Staff,25,0,30,5
1649885696387,MATH 18,A02,083744,Staff,30,0,30,0
1649885696387,MATH 18,A03,083745,Staff,29,0,30,1
1649885696387,MATH 18,A04,083746,Staff,29,0,30,1
1649885696387,MATH 18,B01,083748,Staff,15,0,30,15
1649885696387,MATH 18,B02,083749,Staff,28,0,30,2
1649885696387,MATH 18,B03,083750,Staff,29,0,30,1
1649885696387,MATH 18,B04,083751,Staff,28,0,30,2
1649885702422,MATH 20A,A01,083754,Staff,38,0,40,2
1649885708454,MATH 20B,A01,083756,Staff,27,0,30,3
1649885708454,MATH 20B,A02,083757,Staff,30,0,30,0
1649885714478,MATH 20C,A01,083760,Staff,24,0,30,6
1649885714478,MATH 20C,A02,083761,Staff,28,0,30,2
1649885714478,MATH 20C,B01,083762,Staff,30,0,30,0
1649885714478,MATH 20C,B02,083763,Staff,30,0,30,0
1649885720502,MATH 20D,A01,083765,Staff,22,0,30,8
1649885720502,MATH 20D,A02,083766,Staff,30,0,30,0
1649885720502,MATH 20D,A03,083767,Staff,30,0,30,0
1649885726548,MATH 20E,A01,083771,Staff,18,0,30,12
1649885726548,MATH 20E,A02,083772,Staff,29,0,30,1
1649885726548,MATH 20E,B01,083773,Staff,24,0,30,6
1649885726548,MATH 20E,B02,083774,Staff,29,0,30,1
1649885732585,MATH 103A,A01,083777,Staff,0,0,30,30
1649885732585,MATH 103A,A02,083778,Staff,12,0,30,18
1649885732585,MATH 103A,B01,083779,Staff,7,0,30,23
1649885732585,MATH 103A,B02,083780,Staff,24,0,30,6
1649885738612,MATH 105,A01,085443,Staff,1,0,30,29
1649885744636,MATH 109,A01,083213,Anzaldo; Leesa B,26,0,30,4
1649885744636,MATH 109,A02,083214,Anzaldo; Leesa B,20,0,30,10
1649885744636,MATH 109,B01,083215,Anzaldo; Leesa B,26,0,30,4
1649885744636,MATH 109,B02,083216,Anzaldo; Leesa B,26,0,30,4
1649885750665,MATH 142A,A01,083219,Chow; Bennett,0,1,30,30
1649885750665,MATH 142A,A02,083220,Chow; Bennett,23,0,30,7
1649885750665,MATH 142A,B01,083221,Chow; Bennett,3,0,30,27
1649885750665,MATH 142A,B02,083222,Chow; Bennett,24,0,30,6
1649885756688,MATH 193A,A01,083224,Staff,0,2,30,30
1649885756688,MATH 193A,A02,083225,Staff,0,2,30,30
1649885756688,MATH 193A,A03,083781,Staff,21,0,30,9
1649885756688,MATH 193A,A04,083782,Staff,26,0,30,4
1649885762713,MATH 197,001,091859,McAuley; Julian John,9999,0,9999,0
1649885768776,COGS 9,A01,083615,Staff,35,0,60,25
1649885774806,COGS 11,A01,083617,Boyle; Mary E. T.,36,0,40,4
1649885780829,COGS 13,A01,083071,Staff,5,0,40,35
1649885786855,COGS 14A,A01,092681,Staff,86,0,100,14
1649885792891,COGS 14B,A01,083073,Cheng; Tzu-Han,32,0,50,18
1649885798925,COGS 17,A01,092677,Staff,68,0,75,7
1649885804953,COGS 100,A01,083619,Staff,15,0,60,45
1649885810989,COGS 101A,A01,083621,Davis; Joshua Daniel,18,0,60,42
1649885817011,COGS 101B,A01,091572,Staff,37,0,60,23
1649885823037,COGS 101C,A01,083625,Delgado; Tania,25,0,30,5
1649885829076,COGS 107A,A01,083627,Boyle; Mary E. T.,24,0,60,36
1649885835098,COGS 118A,A01,083075,Staff,27,0,60,33
1649885841124,CSE 3,A50,083646,Miranda; Gregory Joseph,28,0,38,10
1649885841124,CSE 3,A51,083647,Miranda; Gregory Joseph,37,0,37,0
1649885847148,CSE 8A,A50,083650,Miranda; Gregory Joseph,19,0,40,21
1649885853173,CSE 11,A01,083080,Cao; Yingjun,0,14,40,40
1649885859200,CSE 12,A01,083652,Staff,73,0,100,27
1649885865224,CSE 15L,A01,083654,Staff,31,0,50,19
1649885865224,CSE 15L,A02,083655,Staff,48,0,50,2
1649885871248,CSE 20,A01,083657,Staff,71,0,80,9
1649885877271,CSE 30,A01,083084,Eldon; John,1,2,40,39
1649885883295,CSE 100,A01,083659,Cao; Yingjun,2,8,50,48
1649885889326,CSE 134B,A01,083661,Powell; Thomas Allan,0,23,65,65
1649885895351,CSE 140,A01,083663,Staff,37,0,75,38
1649885901374,CSE 140L,A01,083088,Eldon; John,29,0,75,46
1649885907398,CSE 175,A01,083665,Kumar; Rakesh,14,0,25,11
1649885913429,CSE 190,A00,092507,Dubnov; Shlomo,15,0,15,0
1649885919451,ECE 45,A01,083139,Staff,21,0,40,19
1649885925477,ECE 65,A50,083695,Staff,14,0,30,16
1649885931503,ECE 109,A01,091882,Touri; Behrouz,60,0,70,10
1649885937529,ECE 180,A00,083140,Abi Samra; Nicholas Camill,28,0,30,2
1649885937529,ECE 180,B00,083141,Abi Samra; Nicholas Camill,13,0,30,17
1649885943559,MATH 10A,A01,083735,Patchell; Gregory David,24,0,30,6
1649885943559,MATH 10A,A02,083736,Patchell; Gregory David,28,0,30,2
1649885943559,MATH 10A,A03,083737,Patchell; Gregory David,29,0,30,1
1649885949587,MATH 10B,A01,083207,Staff,15,0,30,15
1649885949587,MATH 10B,A02,083208,Staff,26,0,30,4
1649885949587,MATH 10B,B01,083739,Staff,25,0,30,5
1649885949587,MATH 10B,B02,083740,Staff,30,0,30,0
1649885955612,MATH 18,A01,083743,Staff,25,0,30,5
1649885955612,MATH 18,A02,083744,Staff,30,0,30,0
1649885955612,MATH 18,A03,083745,Staff,29,0,30,1
1649885955612,MATH 18,A04,083746,Staff,29,0,30,1
1649885955612,MATH 18,B01,083748,Staff,15,0,30,15
1649885955612,MATH 18,B02,083749,Staff,28,0,30,2
1649885955612,MATH 18,B03,083750,Staff,29,0,30,1
1649885955612,MATH 18,B04,083751,Staff,28,0,30,2
1649885961636,MATH 20A,A01,083754,Staff,38,0,40,2
1649885967660,MATH 20B,A01,083756,Staff,27,0,30,3
1649885967660,MATH 20B,A02,083757,Staff,30,0,30,0
1649885973684,MATH 20C,A01,083760,Staff,24,0,30,6
1649885973684,MATH 20C,A02,083761,Staff,28,0,30,2
1649885973684,MATH 20C,B01,083762,Staff,30,0,30,0
1649885973684,MATH 20C,B02,083763,Staff,30,0,30,0
1649885979721,MATH 20D,A01,083765,Staff,22,0,30,8
1649885979721,MATH 20D,A02,083766,Staff,30,0,30,0
1649885979721,MATH 20D,A03,083767,Staff,30,0,30,0
1649885985743,MATH 20E,A01,083771,Staff,18,0,30,12
1649885985743,MATH 20E,A02,083772,Staff,29,0,30,1
1649885985743,MATH 20E,B01,083773,Staff,24,0,30,6
1649885985743,MATH 20E,B02,083774,Staff,29,0,30,1
1649885991766,MATH 103A,A01,083777,Staff,0,0,30,30
1649885991766,MATH 103A,A02,083778,Staff,10,0,30,20
1649885991766,MATH 103A,B01,083779,Staff,7,0,30,23
1649885991766,MATH 103A,B02,083780,Staff,24,0,30,6
1649885997789,MATH 105,A01,085443,Staff,1,0,30,29
1649886003822,MATH 109,A01,083213,Anzaldo; Leesa B,26,0,30,4
1649886003822,MATH 109,A02,083214,Anzaldo; Leesa B,20,0,30,10
1649886003822,MATH 109,B01,083215,Anzaldo; Leesa B,26,0,30,4
1649886003822,MATH 109,B02,083216,Anzaldo; Leesa B,26,0,30,4
1649886009846,MATH 142A,A01,083219,Chow; Bennett,0,1,30,30
1649886009846,MATH 142A,A02,083220,Chow; Bennett,23,0,30,7
1649886009846,MATH 142A,B01,083221,Chow; Bennett,3,0,30,27
1649886009846,MATH 142A,B02,083222,Chow; Bennett,24,0,30,6
1649886015869,MATH 193A,A01,083224,Staff,0,2,30,30
1649886015869,MATH 193A,A02,083225,Staff,0,2,30,30
1649886015869,MATH 193A,A03,083781,Staff,21,0,30,9
1649886015869,MATH 193A,A04,083782,Staff,26,0,30,4
1649886021896,MATH 197,001,091859,McAuley; Julian John,9999,0,9999,0
1649886027960,COGS 9,A01,083615,Staff,35,0,60,25
1649886033991,COGS 11,A01,083617,Boyle; Mary E. T.,36,0,40,4
1649886040027,COGS 13,A01,083071,Staff,5,0,40,35
1649886046051,COGS 14A,A01,092681,Staff,85,0,100,15
1649886052076,COGS 14B,A01,083073,Cheng; Tzu-Han,32,0,50,18
1649886058114,COGS 17,A01,092677,Staff,68,0,75,7
1649886064135,COGS 100,A01,083619,Staff,15,0,60,45
1649886070166,COGS 101A,A01,083621,Davis; Joshua Daniel,18,0,60,42
1649886076190,COGS 101B,A01,091572,Staff,37,0,60,23
1649886082225,COGS 101C,A01,083625,Delgado; Tania,25,0,30,5
1649886088247,COGS 107A,A01,083627,Boyle; Mary E. T.,23,0,60,37
1649886094275,COGS 118A,A01,083075,Staff,27,0,60,33
1649886100299,CSE 3,A50,083646,Miranda; Gregory Joseph,28,0,38,10
1649886100299,CSE 3,A51,083647,Miranda; Gregory Joseph,37,0,37,0
1649886106331,CSE 8A,A50,083650,Miranda; Gregory Joseph,19,0,40,21
1649886112363,CSE 11,A01,083080,Cao; Yingjun,0,16,40,40
1649886118394,CSE 12,A01,083652,Staff,73,0,100,27
1649886124420,CSE 15L,A01,083654,Staff,31,0,50,19
1649886124420,CSE 15L,A02,083655,Staff,48,0,50,2
1649886130444,CSE 20,A01,083657,Staff,71,0,80,9
1649886136473,CSE 30,A01,083084,Eldon; John,1,2,40,39
1649886142507,CSE 100,A01,083659,Cao; Yingjun,2,8,50,48
1649886148530,CSE 134B,A01,083661,Powell; Thomas Allan,0,23,65,65
1649886154566,CSE 140,A01,083663,Staff,36,0,75,39
1649886160596,CSE 140L,A01,083088,Eldon; John,28,0,75,47
1649886166700,CSE 175,A01,083665,Kumar; Rakesh,14,0,25,11
1649886172729,CSE 190,A00,092507,Dubnov; Shlomo,15,0,15,0
1649886178753,ECE 45,A01,083139,Staff,21,0,40,19
1649886184777,ECE 65,A50,083695,Staff,14,0,30,16
1649886190805,ECE 109,A01,091882,Touri; Behrouz,60,0,70,10
1649886196835,ECE 180,A00,083140,Abi Samra; Nicholas Camill,28,0,30,2
1649886196835,ECE 180,B00,083141,Abi Samra; Nicholas Camill,13,0,30,17
1649886202858,MATH 10A,A01,083735,Patchell; Gregory David,24,0,30,6
1649886202858,MATH 10A,A02,083736,Patchell; Gregory David,28,0,30,2
1649886202858,MATH 10A,A03,083737,Patchell; Gregory David,29,0,30,1
1649886208887,MATH 10B,A01,083207,Staff,15,0,30,15
1649886208887,MATH 10B,A02,083208,Staff,25,0,30,5
1649886208887,MATH 10B,B01,083739,Staff,25,0,30,5
1649886208887,MATH 10B,B02,083740,Staff,30,0,30,0
1649886214912,MATH 18,A01,083743,Staff,25,0,30,5
1649886214912,MATH 18,A02,083744,Staff,30,0,30,0
1649886214912,MATH 18,A03,083745,Staff,29,0,30,1
1649886214912,MATH 18,A04,083746,Staff,29,0,30,1
1649886214912,MATH 18,B01,083748,Staff,15,0,30,15
1649886214912,MATH 18,B02,083749,Staff,28,0,30,2
1649886214912,MATH 18,B03,083750,Staff,29,0,30,1
1649886214912,MATH 18,B04,083751,Staff,28,0,30,2
1649886220937,MATH 20A,A01,083754,Staff,38,0,40,2
1649886226970,MATH 20B,A01,083756,Staff,27,0,30,3
1649886226970,MATH 20B,A02,083757,Staff,30,0,30,0
1649886232994,MATH 20C,A01,083760,Staff,24,0,30,6
1649886232994,MATH 20C,A02,083761,Staff,28,0,30,2
1649886232994,MATH 20C,B01,083762,Staff,30,0,30,0
1649886232994,MATH 20C,B02,083763,Staff,30,0,30,0
1649886239028,MATH 20D,A01,083765,Staff,22,0,30,8
1649886239028,MATH 20D,A02,083766,Staff,30,0,30,0
1649886239028,MATH 20D,A03,083767,Staff,30,0,30,0
1649886245056,MATH 20E,A01,083771,Staff,18,0,30,12
1649886245056,MATH 20E,A02,083772,Staff,29,0,30,1
1649886245056,MATH 20E,B01,083773,Staff,24,0,30,6
1649886245056,MATH 20E,B02,083774,Staff,29,0,30,1
1649886251093,MATH 103A,A01,083777,Staff,0,0,30,30
1649886251093,MATH 103A,A02,083778,Staff,9,0,30,21
1649886251093,MATH 103A,B01,083779,Staff,7,0,30,23
1649886251093,MATH 103A,B02,083780,Staff,24,0,30,6
1649886257121,MATH 105,A01,085443,Staff,1,0,30,29
1649886263148,MATH 109,A01,083213,Anzaldo; Leesa B,26,0,30,4
1649886263148,MATH 109,A02,083214,Anzaldo; Leesa B,20,0,30,10
1649886263148,MATH 109,B01,083215,Anzaldo; Leesa B,26,0,30,4
1649886263148,MATH 109,B02,083216,Anzaldo; Leesa B,26,0,30,4
1649886269172,MATH 142A,A01,083219,Chow; Bennett,0,1,30,30
1649886269172,MATH 142A,A02,083220,Chow; Bennett,23,0,30,7
1649886269172,MATH 142A,B01,083221,Chow; Bennett,3,0,30,27
1649886269172,MATH 142A,B02,083222,Chow; Bennett,24,0,30,6
1649886275194,MATH 193A,A01,083224,Staff,0,2,30,30
1649886275194,MATH 193A,A02,083225,Staff,0,2,30,30
1649886275194,MATH 193A,A03,083781,Staff,21,0,30,9
1649886275194,MATH 193A,A04,083782,Staff,26,0,30,4
1649886281215,MATH 197,001,091859,McAuley; Julian John,9999,0,9999,0
1649886287289,COGS 9,A01,083615,Staff,35,0,60,25
1649886293322,COGS 11,A01,083617,Boyle; Mary E. T.,36,0,40,4
1649886299343,COGS 13,A01,083071,Staff,5,0,40,35
1649886305364,COGS 14A,A01,092681,Staff,85,0,100,15
1649886311391,COGS 14B,A01,083073,Cheng; Tzu-Han,31,0,50,19
1649886317413,COGS 17,A01,092677,Staff,68,0,75,7
1649886323438,COGS 100,A01,083619,Staff,15,0,60,45
1649886329470,COGS 101A,A01,083621,Davis; Joshua Daniel,17,0,60,43
1649886335495,COGS 101B,A01,091572,Staff,37,0,60,23
1649886341523,COGS 101C,A01,083625,Delgado; Tania,25,0,30,5
1649886347545,COGS 107A,A01,083627,Boyle; Mary E. T.,23,0,60,37
1649886353568,COGS 118A,A01,083075,Staff,27,0,60,33
1649886359593,CSE 3,A50,083646,Miranda; Gregory Joseph,28,0,38,10
1649886359593,CSE 3,A51,083647,Miranda; Gregory Joseph,37,0,37,0
1649886365620,CSE 8A,A50,083650,Miranda; Gregory Joseph,19,0,40,21
1649886371645,CSE 11,A01,083080,Cao; Yingjun,0,15,40,40
1649886377680,CSE 12,A01,083652,Staff,73,0,100,27
1649886383703,CSE 15L,A01,083654,Staff,31,0,50,19
1649886383703,CSE 15L,A02,083655,Staff,48,0,50,2
1649886389726,CSE 20,A01,083657,Staff,71,0,80,9
1649886395758,CSE 30,A01,083084,Eldon; John,1,2,40,39
1649886401781,CSE 100,A01,083659,Cao; Yingjun,2,8,50,48
1649886407808,CSE 134B,A01,083661,Powell; Thomas Allan,0,23,65,65
1649886413831,CSE 140,A01,083663,Staff,36,0,75,39
1649886419869,CSE 140L,A01,083088,Eldon; John,28,0,75,47
1649886425901,CSE 175,A01,083665,Kumar; Rakesh,14,0,25,11
1649886431932,CSE 190,A00,092507,Dubnov; Shlomo,15,0,15,0
1649886437959,ECE 45,A01,083139,Staff,21,0,40,19
1649886443983,ECE 65,A50,083695,Staff,12,0,30,18
1649886450016,ECE 109,A01,091882,Touri; Behrouz,60,0,70,10
1649886456047,ECE 180,A00,083140,Abi Samra; Nicholas Camill,28,0,30,2
1649886456047,ECE 180,B00,083141,Abi Samra; Nicholas Camill,13,0,30,17
1649886462078,MATH 10A,A01,083735,Patchell; Gregory David,24,0,30,6
1649886462078,MATH 10A,A02,083736,Patchell; Gregory David,28,0,30,2
1649886462078,MATH 10A,A03,083737,Patchell; Gregory David,29,0,30,1
1649886468101,MATH 10B,A01,083207,Staff,15,0,30,15
1649886468101,MATH 10B,A02,083208,Staff,25,0,30,5
1649886468101,MATH 10B,B01,083739,Staff,25,0,30,5
1649886468101,MATH 10B,B02,083740,Staff,30,0,30,0
1649886474139,MATH 18,A01,083743,Staff,24,0,30,6
1649886474139,MATH 18,A02,083744,Staff,30,0,30,0
1649886474139,MATH 18,A03,083745,Staff,29,0,30,1
1649886474139,MATH 18,A04,083746,Staff,29,0,30,1
1649886474139,MATH 18,B01,083748,Staff,15,0,30,15
1649886474139,MATH 18,B02,083749,Staff,28,0,30,2
1649886474139,MATH 18,B03,083750,Staff,29,0,30,1
1649886474139,MATH 18,B04,083751,Staff,28,0,30,2
1649886480180,MATH 20A,A01,083754,Staff,38,0,40,2
1649886486213,MATH 20B,A01,083756,Staff,27,0,30,3
1649886486213,MATH 20B,A02,083757,Staff,30,0,30,0
1649886492240,MATH 20C,A01,083760,Staff,24,0,30,6
1649886492240,MATH 20C,A02,083761,Staff,28,0,30,2
1649886492240,MATH 20C,B01,083762,Staff,30,0,30,0
1649886492240,MATH 20C,B02,083763,Staff,30,0,30,0
1649886498263,MATH 20D,A01,083765,Staff,22,0,30,8
1649886498263,MATH 20D,A02,083766,Staff,30,0,30,0
1649886498263,MATH 20D,A03,083767,Staff,30,0,30,0
1649886504290,MATH 20E,A01,083771,Staff,18,0,30,12
1649886504290,MATH 20E,A02,083772,Staff,29,0,30,1
1649886504290,MATH 20E,B01,083773,Staff,24,0,30,6
1649886504290,MATH 20E,B02,083774,Staff,29,0,30,1
1649886510330,MATH 103A,A01,083777,Staff,0,0,30,30
1649886510330,MATH 103A,A02,083778,Staff,9,0,30,21
1649886510330,MATH 103A,B01,083779,Staff,7,0,30,23
1649886510330,MATH 103A,B02,083780,Staff,23,0,30,7
1649886516361,MATH 105,A01,085443,Staff,1,0,30,29
1649886522389,MATH 109,A01,083213,Anzaldo; Leesa B,26,0,30,4
1649886522389,MATH 109,A02,083214,Anzaldo; Leesa B,20,0,30,10
1649886522389,MATH 109,B01,083215,Anzaldo; Leesa B,26,0,30,4
1649886522389,MATH 109,B02,083216,Anzaldo; Leesa B,26,0,30,4
1649886528421,MATH 142A,A01,083219,Chow; Bennett,0,1,30,30
1649886528421,MATH 142A,A02,083220,Chow; Bennett,22,0,30,8
1649886528421,MATH 142A,B01,083221,Chow; Bennett,3,0,30,27
1649886528421,MATH 142A,B02,083222,Chow; Bennett,24,0,30,6
1649886534454,MATH 193A,A01,083224,Staff,0,2,30,30
1649886534454,MATH 193A,A02,083225,Staff,0,2,30,30
1649886534454,MATH 193A,A03,083781,Staff,20,0,30,10
1649886534454,MATH 193A,A04,083782,Staff,26,0,30,4
1649886540477,MATH 197,001,091859,McAuley; Julian John,9999,0,9999,0
1649886546547,COGS 9,A01,083615,Staff,35,0,60,25
1649886552577,COGS 11,A01,083617,Boyle; Mary E. T.,36,0,40,4
1649886558602,COGS 13,A01,083071,Staff,5,0,40,35
1649886564641,COGS 14A,A01,092681,Staff,85,0,100,15
1649886570673,COGS 14B,A01,083073,Cheng; Tzu-Han,31,0,50,19
1649886576703,COGS 17,A01,092677,Staff,68,0,75,7
1649886582732,COGS 100,A01,083619,Staff,15,0,60,45
1649886588764,COGS 101A,A01,083621,Davis; Joshua Daniel,17,0,60,43
1649886594792,COGS 101B,A01,091572,Staff,37,0,60,23
1649886600821,COGS 101C,A01,083625,Delgado; Tania,25,0,30,5
1649886606850,COGS 107A,A01,083627,Boyle; Mary E. T.,23,0,60,37
1649886612874,COGS 118A,A01,083075,Staff,27,0,60,33
1649886618896,CSE 3,A50,083646,Miranda; Gregory Joseph,28,0,38,10
1649886618896,CSE 3,A51,083647,Miranda; Gregory Joseph,37,0,37,0
1649886624919,CSE 8A,A50,083650,Miranda; Gregory Joseph,19,0,40,21
1649886630951,CSE 11,A01,083080,Cao; Yingjun,0,15,40,40
1649886636976,CSE 12,A01,083652,Staff,73,0,100,27
1649886642999,CSE 15L,A01,083654,Staff,31,0,50,19
1649886642999,CSE 15L,A02,083655,Staff,48,0,50,2
1649886649033,CSE 20,A01,083657,Staff,71,0,80,9
1649886655056,CSE 30,A01,083084,Eldon; John,1,2,40,39
1649886661086,CSE 100,A01,083659,Cao; Yingjun,2,9,50,48
1649886667122,CSE 134B,A01,083661,Powell; Thomas Allan,1,23,65,64
1649886673147,CSE 140,A01,083663,Staff,36,0,75,39
1649886679170,CSE 140L,A01,083088,Eldon; John,28,0,75,47
1649886685198,CSE 175,A01,083665,Kumar; Rakesh,13,0,25,12
1649886691223,CSE 190,A00,092507,Dubnov; Shlomo,15,0,15,0
1649886697248,ECE 45,A01,083139,Staff,21,0,40,19
1649886703272,ECE 65,A50,083695,Staff,12,0,30,18
1649886709296,ECE 109,A01,091882,Touri; Behrouz,60,0,70,10
1649886715326,ECE 180,A00,083140,Abi Samra; Nicholas Camill,28,0,30,2
1649886715326,ECE 180,B00,083141,Abi Samra; Nicholas Camill,13,0,30,17
1649886721349,MATH 10A,A01,083735,Patchell; Gregory David,24,0,30,6
1649886721349,MATH 10A,A02,083736,Patchell; Gregory David,28,0,30,2
1649886721349,MATH 10A,A03,083737,Patchell; Gregory David,29,0,30,1
1649886727375,MATH 10B,A01,083207,Staff,15,0,30,15
1649886727375,MATH 10B,A02,083208,Staff,25,0,30,5
1649886727375,MATH 10B,B01,083739,Staff,25,0,30,5
1649886727375,MATH 10B,B02,083740,Staff,30,0,30,0
1649886733402,MATH 18,A01,083743,Staff,24,0,30,6
1649886733402,MATH 18,A02,083744,Staff,30,0,30,0
1649886733402,MATH 18,A03,083745,Staff,29,0,30,1
1649886733402,MATH 18,A04,083746,Staff,29,0,30,1
1649886733402,MATH 18,B01,083748,Staff,15,0,30,15
1649886733402,MATH 18,B02,083749,Staff,28,0,30,2
1649886733402,MATH 18,B03,083750,Staff,29,0,30,1
1649886733402,MATH 18,B04,083751,Staff,28,0,30,2
1649886739428,MATH 20A,A01,083754,Staff,38,0,40,2
1649886745451,MATH 20B,A01,083756,Staff,27,0,30,3
1649886745451,MATH 20B,A02,083757,Staff,30,0,30,0
1649886751482,MATH 20C,A01,083760,Staff,24,0,30,6
1649886751482,MATH 20C,A02,083761,Staff,28,0,30,2
1649886751482,MATH 20C,B01,083762,Staff,30,0,30,0
1649886751482,MATH 20C,B02,083763,Staff,30,0,30,0
1649886757505,MATH 20D,A01,083765,Staff,22,0,30,8
1649886757505,MATH 20D,A02,083766,Staff,30,0,30,0
1649886757505,MATH 20D,A03,083767,Staff,30,0,30,0
1649886763606,MATH 20E,A01,083771,Staff,18,0,30,12
1649886763606,MATH 20E,A02,083772,Staff,29,0,30,1
1649886763606,MATH 20E,B01,083773,Staff,24,0,30,6
1649886763606,MATH 20E,B02,083774,Staff,29,0,30,1
1649886769632,MATH 103A,A01,083777,Staff,0,0,30,30
1649886769632,MATH 103A,A02,083778,Staff,9,0,30,21
1649886769632,MATH 103A,B01,083779,Staff,7,0,30,23
1649886769632,MATH 103A,B02,083780,Staff,24,0,30,6
1649886775671,MATH 105,A01,085443,Staff,0,0,30,30
1649886781705,MATH 109,A01,083213,Anzaldo; Leesa B,26,0,30,4
1649886781705,MATH 109,A02,083214,Anzaldo; Leesa B,20,0,30,10
1649886781705,MATH 109,B01,083215,Anzaldo; Leesa B,26,0,30,4
1649886781705,MATH 109,B02,083216,Anzaldo; Leesa B,26,0,30,4
1649886787729,MATH 142A,A01,083219,Chow; Bennett,0,1,30,30
1649886787729,MATH 142A,A02,083220,Chow; Bennett,21,0,30,9
1649886787729,MATH 142A,B01,083221,Chow; Bennett,3,0,30,27
1649886787729,MATH 142A,B02,083222,Chow; Bennett,24,0,30,6
1649886793751,MATH 193A,A01,083224,Staff,0,2,30,30
1649886793751,MATH 193A,A02,083225,Staff,0,2,30,30
1649886793751,MATH 193A,A03,083781,Staff,20,0,30,10
1649886793751,MATH 193A,A04,083782,Staff,26,0,30,4
1649886799773,MATH 197,001,091859,McAuley; Julian John,9999,0,9999,0
1649886805835,COGS 9,A01,083615,Staff,35,0,60,25
1649886811860,COGS 11,A01,083617,Boyle; Mary E. T.,36,0,40,4
1649886817894,COGS 13,A01,083071,Staff,5,0,40,35
1649886823920,COGS 14A,A01,092681,Staff,85,0,100,15
1649886829946,COGS 14B,A01,083073,Cheng; Tzu-Han,30,0,50,20
1649886835982,COGS 17,A01,092677,Staff,68,0,75,7
1649886842008,COGS 100,A01,083619,Staff,15,0,60,45
1649886848033,COGS 101A,A01,083621,Davis; Joshua Daniel,16,0,60,44
1649886854056,COGS 101B,A01,091572,Staff,37,0,60,23
1649886860095,COGS 101C,A01,083625,Delgado; Tania,25,0,30,5
1649886866127,COGS 107A,A01,083627,Boyle; Mary E. T.,21,0,60,39
1649886872149,COGS 118A,A01,083075,Staff,27,0,60,33
1649886878184,CSE 3,A50,083646,Miranda; Gregory Joseph,28,0,38,10
1649886878184,CSE 3,A51,083647,Miranda; Gregory Joseph,37,0,37,0
1649886884212,CSE 8A,A50,083650,Miranda; Gregory Joseph,19,0,40,21
1649886890259,CSE 11,A01,083080,Cao; Yingjun,0,15,40,40
1649886896288,CSE 12,A01,083652,Staff,73,0,100,27
1649886902319,CSE 15L,A01,083654,Staff,31,0,50,19
1649886902319,CSE 15L,A02,083655,Staff,48,0,50,2
1649886908342,CSE 20,A01,083657,Staff,71,0,80,9
1649886914377,CSE 30,A01,083084,Eldon; John,1,2,40,39
1649886920408,CSE 100,A01,083659,Cao; Yingjun,2,10,50,48
1649886926442,CSE 134B,A01,083661,Powell; Thomas Allan,1,23,65,64
1649886932466,CSE 140,A01,083663,Staff,36,0,75,39
1649886938495,CSE 140L,A01,083088,Eldon; John,28,0,75,47
1649886944527,CSE 175,A01,083665,Kumar; Rakesh,13,0,25,12
1649886950550,CSE 190,A00,092507,Dubnov; Shlomo,15,0,15,0
1649886956578,ECE 45,A01,083139,Staff,21,0,40,19
1649886962604,ECE 65,A50,083695,Staff,12,0,30,18
1649886968647,ECE 109,A01,091882,Touri; Behrouz,60,0,70,10
1649886974670,ECE 180,A00,083140,Abi Samra; Nicholas Camill,28,0,30,2
1649886974670,ECE 180,B00,083141,Abi Samra; Nicholas Camill,13,0,30,17
1649886980699,MATH 10A,A01,083735,Patchell; Gregory David,24,0,30,6
1649886980699,MATH 10A,A02,083736,Patchell; Gregory David,28,0,30,2
1649886980699,MATH 10A,A03,083737,Patchell; Gregory David,29,0,30,1
1649886986724,MATH 10B,A01,083207,Staff,15,0,30,15
1649886986724,MATH 10B,A02,083208,Staff,25,0,30,5
1649886986724,MATH 10B,B01,083739,Staff,25,0,30,5
1649886986724,MATH 10B,B02,083740,Staff,30,0,30,0
1649886992747,MATH 18,A01,083743,Staff,24,0,30,6
1649886992747,MATH 18,A02,083744,Staff,30,0,30,0
1649886992747,MATH 18,A03,083745,Staff,29,0,30,1
1649886992747,MATH 18,A04,083746,Staff,29,0,30,1
1649886992747,MATH 18,B01,083748,Staff,15,0,30,15
1649886992747,MATH 18,B02,083749,Staff,28,0,30,2
1649886992747,MATH 18,B03,083750,Staff,29,0,30,1
1649886992747,MATH 18,B04,083751,Staff,28,0,30,2
1649886998783,MATH 20A,A01,083754,Staff,38,0,40,2
1649887004806,MATH 20B,A01,083756,Staff,27,0,30,3
1649887004806,MATH 20B,A02,083757,Staff,30,0,30,0
1649887010834,MATH 20C,A01,083760,Staff,24,0,30,6
1649887010834,MATH 20C,A02,083761,Staff,28,0,30,2
1649887010834,MATH 20C,B01,083762,Staff,30,0,30,0
1649887010834,MATH 20C,B02,083763,Staff,30,0,30,0
1649887016866,MATH 20D,A01,083765,Staff,22,0,30,8
1649887016866,MATH 20D,A02,083766,Staff,30,0,30,0
1649887016866,MATH 20D,A03,083767,Staff,30,0,30,0
1649887022943,MATH 20E,A01,083771,Staff,18,0,30,12
1649887022943,MATH 20E,A02,083772,Staff,29,0,30,1
1649887022943,MATH 20E,B01,083773,Staff,24,0,30,6
1649887022943,MATH 20E,B02,083774,Staff,29,0,30,1
1649887028982,MATH 103A,A01,083777,Staff,0,0,30,30
1649887028982,MATH 103A,A02,083778,Staff,8,0,30,22
1649887028982,MATH 103A,B01,083779,Staff,7,0,30,23
1649887028982,MATH 103A,B02,083780,Staff,24,0,30,6
1649887035006,MATH 105,A01,085443,Staff,0,0,30,30
1649887041043,MATH 109,A01,083213,Anzaldo; Leesa B,26,0,30,4
1649887041043,MATH 109,A02,083214,Anzaldo; Leesa B,20,0,30,10
1649887041043,MATH 109,B01,083215,Anzaldo; Leesa B,26,0,30,4
1649887041043,MATH 109,B02,083216,Anzaldo; Leesa B,26,0,30,4
1649887047082,MATH 142A,A01,083219,Chow; Bennett,0,1,30,30
1649887047082,MATH 142A,A02,083220,Chow; Bennett,21,0,30,9
1649887047082,MATH 142A,B01,083221,Chow; Bennett,3,0,30,27
1649887047082,MATH 142A,B02,083222,Chow; Bennett,24,0,30,6
1649887053121,MATH 193A,A01,083224,Staff,0,3,30,30
1649887053121,MATH 193A,A02,083225,Staff,0,2,30,30
1649887053121,MATH 193A,A03,083781,Staff,20,0,30,10
1649887053121,MATH 193A,A04,083782,Staff,26,0,30,4
1649887059152,MATH 197,001,091859,McAuley; Julian John,9999,0,9999,0
1649887065219,COGS 9,A01,083615,Staff,35,0,60,25
1649887071245,COGS 11,A01,083617,Boyle; Mary E. T.,36,0,40,4
1649887077267,COGS 13,A01,083071,Staff,5,0,40,35
1649887083293,COGS 14A,A01,092681,Staff,85,0,100,15
1649887089319,COGS 14B,A01,083073,Cheng; Tzu-Han,30,0,50,20
1649887095351,COGS 17,A01,092677,Staff,68,0,75,7
1649887101399,COGS 100,A01,083619,Staff,15,0,60,45
1649887107440,COGS 101A,A01,083621,Davis; Joshua Daniel,16,0,60,44
1649887113474,COGS 101B,A01,091572,Staff,37,0,60,23
1649887119510,COGS 101C,A01,083625,Delgado; Tania,25,0,30,5
1649887125533,COGS 107A,A01,083627,Boyle; Mary E. T.,21,0,60,39
1649887131557,COGS 118A,A01,083075,Staff,27,0,60,33
1649887137581,CSE 3,A50,083646,Miranda; Gregory Joseph,28,0,38,10
1649887137581,CSE 3,A51,083647,Miranda; Gregory Joseph,37,0,37,0
1649887143610,CSE 8A,A50,083650,Miranda; Gregory Joseph,19,0,40,21
1649887149636,CSE 11,A01,083080,Cao; Yingjun,0,15,40,40
1649887155660,CSE 12,A01,083652,Staff,73,0,100,27
1649887161688,CSE 15L,A01,083654,Staff,31,0,50,19
1649887161688,CSE 15L,A02,083655,Staff,48,0,50,2
1649887167710,CSE 20,A01,083657,Staff,71,0,80,9
1649887173738,CSE 30,A01,083084,Eldon; John,1,3,40,39
1649887179768,CSE 100,A01,083659,Cao; Yingjun,2,10,50,48
1649887185792,CSE 134B,A01,083661,Powell; Thomas Allan,1,23,65,64
1649887191819,CSE 140,A01,083663,Staff,36,0,75,39
1649887197851,CSE 140L,A01,083088,Eldon; John,28,0,75,47
1649887203876,CSE 175,A01,083665,Kumar; Rakesh,13,0,25,12
1649887209911,CSE 190,A00,092507,Dubnov; Shlomo,15,0,15,0
1649887215948,ECE 45,A01,083139,Staff,21,0,40,19
1649887221972,ECE 65,A50,083695,Staff,12,0,30,18
1649887228001,ECE 109,A01,091882,Touri; Behrouz,60,0,70,10
1649887234044,ECE 180,A00,083140,Abi Samra; Nicholas Camill,28,0,30,2
1649887234044,ECE 180,B00,083141,Abi Samra; Nicholas Camill,13,0,30,17
1649887240067,MATH 10A,A01,083735,Patchell; Gregory David,24,0,30,6
1649887240067,MATH 10A,A02,083736,Patchell; Gregory David,28,0,30,2
1649887240067,MATH 10A,A03,083737,Patchell; Gregory David,29,0,30,1
1649887246102,MATH 10B,A01,083207,Staff,15,0,30,15
1649887246102,MATH 10B,A02,083208,Staff,25,0,30,5
1649887246102,MATH 10B,B01,083739,Staff,25,0,30,5
1649887246102,MATH 10B,B02,083740,Staff,30,0,30,0
1649887252134,MATH 18,A01,083743,Staff,24,0,30,6
1649887252134,MATH 18,A02,083744,Staff,30,0,30,0
1649887252134,MATH 18,A03,083745,Staff,29,0,30,1
1649887252134,MATH 18,A04,083746,Staff,29,0,30,1
1649887252134,MATH 18,B01,083748,Staff,15,0,30,15
1649887252134,MATH 18,B02,083749,Staff,28,0,30,2
1649887252134,MATH 18,B03,083750,Staff,29,0,30,1
1649887252134,MATH 18,B04,083751,Staff,28,0,30,2
1649887258170,MATH 20A,A01,083754,Staff,38,0,40,2
1649887264198,MATH 20B,A01,083756,Staff,27,0,30,3
1649887264198,MATH 20B,A02,083757,Staff,30,0,30,0
1649887270225,MATH 20C,A01,083760,Staff,24,0,30,6
1649887270225,MATH 20C,A02,083761,Staff,28,0,30,2
1649887270225,MATH 20C,B01,083762,Staff,30,0,30,0
1649887270225,MATH 20C,B02,083763,Staff,30,0,30,0
1649887276250,MATH 20D,A01,083765,Staff,22,0,30,8
1649887276250,MATH 20D,A02,083766,Staff,30,0,30,0
1649887276250,MATH 20D,A03,083767,Staff,30,0,30,0
1649887282288,MATH 20E,A01,083771,Staff,18,0,30,12
1649887282288,MATH 20E,A02,083772,Staff,29,0,30,1
1649887282288,MATH 20E,B01,083773,Staff,24,0,30,6
1649887282288,MATH 20E,B02,083774,Staff,29,0,30,1
1649887288310,MATH 103A,A01,083777,Staff,0,0,30,30
1649887288310,MATH 103A,A02,083778,Staff,8,0,30,22
1649887288310,MATH 103A,B01,083779,Staff,7,0,30,23
1649887288310,MATH 103A,B02,083780,Staff,24,0,30,6
1649887294337,MATH 105,A01,085443,Staff,0,0,30,30
1649887300360,MATH 109,A01,083213,Anzaldo; Leesa B,26,0,30,4
1649887300360,MATH 109,A02,083214,Anzaldo; Leesa B,20,0,30,10
1649887300360,MATH 109,B01,083215,Anzaldo; Leesa B,26,0,30,4
1649887300360,MATH 109,B02,083216,Anzaldo; Leesa B,25,0,30,5
1649887306389,MATH 142A,A01,083219,Chow; Bennett,0,1,30,30
1649887306389,MATH 142A,A02,083220,Chow; Bennett,21,0,30,9
1649887306389,MATH 142A,B01,083221,Chow; Bennett,3,0,30,27
1649887306389,MATH 142A,B02,083222,Chow; Bennett,23,0,30,7
1649887312415,MATH 193A,A01,083224,Staff,0,3,30,30
1649887312415,MATH 193A,A02,083225,Staff,0,2,30,30
1649887312415,MATH 193A,A03,083781,Staff,20,0,30,10
1649887312415,MATH 193A,A04,083782,Staff,26,0,30,4
1649887318440,MATH 197,001,091859,McAuley; Julian John,9999,0,9999,0
1649887324505,COGS 9,A01,083615,Staff,35,0,60,25
1649887330539,COGS 11,A01,083617,Boyle; Mary E. T.,36,0,40,4
1649887336581,COGS 13,A01,083071,Staff,5,0,40,35
1649887342604,COGS 14A,A01,092681,Staff,85,0,100,15
1649887348629,COGS 14B,A01,083073,Cheng; Tzu-Han,30,0,50,20
1649887354747,COGS 17,A01,092677,Staff,68,0,75,7
1649887360781,COGS 100,A01,083619,Staff,15,0,60,45
1649887366815,COGS 101A,A01,083621,Davis; Joshua Daniel,15,0,60,45
1649887372851,COGS 101B,A01,091572,Staff,37,0,60,23
1649887378891,COGS 101C,A01,083625,Delgado; Tania,25,0,30,5
1649887384926,COGS 107A,A01,083627,Boyle; Mary E. T.,20,0,60,40
1649887390954,COGS 118A,A01,083075,Staff,27,0,60,33
1649887396997,CSE 3,A50,083646,Miranda; Gregory Joseph,28,0,38,10
1649887396997,CSE 3,A51,083647,Miranda; Gregory Joseph,37,0,37,0
1649887403036,CSE 8A,A50,083650,Miranda; Gregory Joseph,19,0,40,21
1649887409067,CSE 11,A01,083080,Cao; Yingjun,0,15,40,40
1649887415099,CSE 12,A01,083652,Staff,73,0,100,27
1649887421124,CSE 15L,A01,083654,Staff,31,0,50,19
1649887421124,CSE 15L,A02,083655,Staff,48,0,50,2
1649887427153,CSE 20,A01,083657,Staff,71,0,80,9
1649887433175,CSE 30,A01,083084,Eldon; John,1,3,40,39
1649887439203,CSE 100,A01,083659,Cao; Yingjun,2,10,50,48
1649887445311,CSE 134B,A01,083661,Powell; Thomas Allan,1,23,65,64
1649887451332,CSE 140,A01,083663,Staff,36,0,75,39
1649887457358,CSE 140L,A01,083088,Eldon; John,28,0,75,47
1649887463389,CSE 175,A01,083665,Kumar; Rakesh,13,0,25,12
1649887469415,CSE 190,A00,092507,Dubnov; Shlomo,15,0,15,0
1649887475439,ECE 45,A01,083139,Staff,21,0,40,19
1649887481467,ECE 65,A50,083695,Staff,12,0,30,18
1649887487491,ECE 109,A01,091882,Touri; Behrouz,60,0,70,10
1649887493515,ECE 180,A00,083140,Abi Samra; Nicholas Camill,28,0,30,2
1649887493515,ECE 180,B00,083141,Abi Samra; Nicholas Camill,13,0,30,17
1649887499540,MATH 10A,A01,083735,Patchell; Gregory David,24,0,30,6
1649887499540,MATH 10A,A02,083736,Patchell; Gregory David,28,0,30,2
1649887499540,MATH 10A,A03,083737,Patchell; Gregory David,29,0,30,1
1649887505574,MATH 10B,A01,083207,Staff,15,0,30,15
1649887505574,MATH 10B,A02,083208,Staff,25,0,30,5
1649887505574,MATH 10B,B01,083739,Staff,25,0,30,5
1649887505574,MATH 10B,B02,083740,Staff,30,0,30,0
1649887511601,MATH 18,A01,083743,Staff,24,0,30,6
1649887511601,MATH 18,A02,083744,Staff,30,0,30,0
1649887511601,MATH 18,A03,083745,Staff,29,0,30,1
1649887511601,MATH 18,A04,083746,Staff,29,0,30,1
1649887511601,MATH 18,B01,083748,Staff,15,0,30,15
1649887511601,MATH 18,B02,083749,Staff,28,0,30,2
1649887511601,MATH 18,B03,083750,Staff,28,0,30,2
1649887511601,MATH 18,B04,083751,Staff,28,0,30,2
1649887517625,MATH 20A,A01,083754,Staff,38,0,40,2
1649887523646,MATH 20B,A01,083756,Staff,27,0,30,3
1649887523646,MATH 20B,A02,083757,Staff,30,0,30,0
1649887529669,MATH 20C,A01,083760,Staff,23,0,30,7
1649887529669,MATH 20C,A02,083761,Staff,28,0,30,2
1649887529669,MATH 20C,B01,083762,Staff,30,0,30,0
1649887529669,MATH 20C,B02,083763,Staff,30,0,30,0
1649887535700,MATH 20D,A01,083765,Staff,22,0,30,8
1649887535700,MATH 20D,A02,083766,Staff,30,0,30,0
1649887535700,MATH 20D,A03,083767,Staff,30,0,30,0
1649887541724,MATH 20E,A01,083771,Staff,18,0,30,12
1649887541724,MATH 20E,A02,083772,Staff,29,0,30,1
1649887541724,MATH 20E,B01,083773,Staff,24,0,30,6
1649887541724,MATH 20E,B02,083774,Staff,29,0,30,1
1649887547751,MATH 103A,A01,083777,Staff,0,0,30,30
1649887547751,MATH 103A,A02,083778,Staff,8,0,30,22
1649887547751,MATH 103A,B01,083779,Staff,7,0,30,23
1649887547751,MATH 103A,B02,083780,Staff,24,0,30,6
1649887553773,MATH 105,A01,085443,Staff,0,0,30,30
1649887559806,MATH 109,A01,083213,Anzaldo; Leesa B,25,0,30,5
1649887559806,MATH 109,A02,083214,Anzaldo; Leesa B,20,0,30,10
1649887559806,MATH 109,B01,083215,Anzaldo; Leesa B,26,0,30,4
1649887559806,MATH 109,B02,083216,Anzaldo; Leesa B,25,0,30,5
1649887565841,MATH 142A,A01,083219,Chow; Bennett,0,1,30,30
1649887565841,MATH 142A,A02,083220,Chow; Bennett,21,0,30,9
1649887565841,MATH 142A,B01,083221,Chow; Bennett,3,0,30,27
1649887565841,MATH 142A,B02,083222,Chow; Bennett,23,0,30,7
1649887571873,MATH 193A,A01,083224,Staff,0,3,30,30
1649887571873,MATH 193A,A02,083225,Staff,0,2,30,30
1649887571873,MATH 193A,A03,083781,Staff,20,0,30,10
1649887571873,MATH 193A,A04,083782,Staff,26,0,30,4
1649887577900,MATH 197,001,091859,McAuley; Julian John,9999,0,9999,0
1649887583989,COGS 9,A01,083615,Staff,35,0,60,25
1649887590023,COGS 11,A01,083617,Boyle; Mary E. T.,36,0,40,4
1649887596052,COGS 13,A01,083071,Staff,5,0,40,35
1649887602078,COGS 14A,A01,092681,Staff,85,0,100,15
1649887608100,COGS 14B,A01,083073,Cheng; Tzu-Han,30,0,50,20
1649887614129,COGS 17,A01,092677,Staff,67,0,75,8
1649887620153,COGS 100,A01,083619,Staff,15,0,60,45
1649887626186,COGS 101A,A01,083621,Davis; Joshua Daniel,15,0,60,45
1649887632216,COGS 101B,A01,091572,Staff,37,0,60,23
1649887638253,COGS 101C,A01,083625,Delgado; Tania,25,0,30,5
1649887644276,COGS 107A,A01,083627,Boyle; Mary E. T.,20,0,60,40
1649887650298,COGS 118A,A01,083075,Staff,27,0,60,33
1649887656321,CSE 3,A50,083646,Miranda; Gregory Joseph,28,0,38,10
1649887656321,CSE 3,A51,083647,Miranda; Gregory Joseph,37,0,37,0
1649887662346,CSE 8A,A50,083650,Miranda; Gregory Joseph,19,0,40,21
1649887668380,CSE 11,A01,083080,Cao; Yingjun,0,15,40,40
1649887674403,CSE 12,A01,083652,Staff,73,0,100,27
1649887680426,CSE 15L,A01,083654,Staff,31,0,50,19
1649887680426,CSE 15L,A02,083655,Staff,48,0,50,2
1649887686452,CSE 20,A01,083657,Staff,71,0,80,9
1649887692483,CSE 30,A01,083084,Eldon; John,1,3,40,39
1649887698517,CSE 100,A01,083659,Cao; Yingjun,2,10,50,48
1649887704545,CSE 134B,A01,083661,Powell; Thomas Allan,1,23,65,64
1649887710577,CSE 140,A01,083663,Staff,36,0,75,39
1649887716609,CSE 140L,A01,083088,Eldon; John,28,0,75,47
1649887722632,CSE 175,A01,083665,Kumar; Rakesh,13,0,25,12
1649887728655,CSE 190,A00,092507,Dubnov; Shlomo,15,0,15,0
1649887734678,ECE 45,A01,083139,Staff,21,0,40,19
1649887740708,ECE 65,A50,083695,Staff,12,0,30,18
1649887746736,ECE 109,A01,091882,Touri; Behrouz,60,0,70,10
1649887752764,ECE 180,A00,083140,Abi Samra; Nicholas Camill,28,0,30,2
1649887752764,ECE 180,B00,083141,Abi Samra; Nicholas Camill,13,0,30,17
1649887758789,MATH 10A,A01,083735,Patchell; Gregory David,24,0,30,6
1649887758789,MATH 10A,A02,083736,Patchell; Gregory David,28,0,30,2
1649887758789,MATH 10A,A03,083737,Patchell; Gregory David,29,0,30,1
1649887764814,MATH 10B,A01,083207,Staff,15,0,30,15
1649887764814,MATH 10B,A02,083208,Staff,25,0,30,5
1649887764814,MATH 10B,B01,083739,Staff,25,0,30,5
1649887764814,MATH 10B,B02,083740,Staff,30,0,30,0
1649887770848,MATH 18,A01,083743,Staff,24,0,30,6
1649887770848,MATH 18,A02,083744,Staff,30,0,30,0
1649887770848,MATH 18,A03,083745,Staff,29,0,30,1
1649887770848,MATH 18,A04,083746,Staff,29,0,30,1
1649887770848,MATH 18,B01,083748,Staff,15,0,30,15
1649887770848,MATH 18,B02,083749,Staff,28,0,30,2
1649887770848,MATH 18,B03,083750,Staff,28,0,30,2
1649887770848,MATH 18,B04,083751,Staff,28,0,30,2
1649887776872,MATH 20A,A01,083754,Staff,38,0,40,2
1649887782900,MATH 20B,A01,083756,Staff,27,0,30,3
1649887782900,MATH 20B,A02,083757,Staff,30,0,30,0
1649887788933,MATH 20C,A01,083760,Staff,23,0,30,7
1649887788933,MATH 20C,A02,083761,Staff,28,0,30,2
1649887788933,MATH 20C,B01,083762,Staff,30,0,30,0
1649887788933,MATH 20C,B02,083763,Staff,30,0,30,0
1649887794960,MATH 20D,A01,083765,Staff,22,0,30,8
1649887794960,MATH 20D,A02,083766,Staff,30,0,30,0
1649887794960,MATH 20D,A03,083767,Staff,30,0,30,0
1649887800991,MATH 20E,A01,083771,Staff,18,0,30,12
1649887800991,MATH 20E,A02,083772,Staff,29,0,30,1
1649887800991,MATH 20E,B01,083773,Staff,24,0,30,6
1649887800991,MATH 20E,B02,083774,Staff,29,0,30,1
1649887807016,MATH 103A,A01,083777,Staff,0,0,30,30
1649887807016,MATH 103A,A02,083778,Staff,8,0,30,22
1649887807016,MATH 103A,B01,083779,Staff,7,0,30,23
1649887807016,MATH 103A,B02,083780,Staff,24,0,30,6
1649887813044,MATH 105,A01,085443,Staff,0,0,30,30
1649887819069,MATH 109,A01,083213,Anzaldo; Leesa B,25,0,30,5
1649887819069,MATH 109,A02,083214,Anzaldo; Leesa B,19,0,30,11
1649887819069,MATH 109,B01,083215,Anzaldo; Leesa B,26,0,30,4
1649887819069,MATH 109,B02,083216,Anzaldo; Leesa B,25,0,30,5
1649887825097,MATH 142A,A01,083219,Chow; Bennett,0,1,30,30
1649887825097,MATH 142A,A02,083220,Chow; Bennett,21,0,30,9
1649887825097,MATH 142A,B01,083221,Chow; Bennett,3,0,30,27
1649887825097,MATH 142A,B02,083222,Chow; Bennett,23,0,30,7
1649887831120,MATH 193A,A01,083224,Staff,0,3,30,30
1649887831120,MATH 193A,A02,083225,Staff,0,2,30,30
1649887831120,MATH 193A,A03,083781,Staff,20,0,30,10
1649887831120,MATH 193A,A04,083782,Staff,25,0,30,5
1649887837147,MATH 197,001,091859,McAuley; Julian John,9999,0,9999,0
1649887843206,COGS 9,A01,083615,Staff,34,0,60,26
1649887849229,COGS 11,A01,083617,Boyle; Mary E. T.,36,0,40,4
1649887855254,COGS 13,A01,083071,Staff,5,0,40,35
1649887861280,COGS 14A,A01,092681,Staff,85,0,100,15
1649887867306,COGS 14B,A01,083073,Cheng; Tzu-Han,30,0,50,20
1649887873333,COGS 17,A01,092677,Staff,67,0,75,8
1649887879369,COGS 100,A01,083619,Staff,15,0,60,45
1649887885398,COGS 101A,A01,083621,Davis; Joshua Daniel,15,0,60,45
1649887891421,COGS 101B,A01,091572,Staff,37,0,60,23
1649887897444,COGS 101C,A01,083625,Delgado; Tania,25,0,30,5
1649887903467,COGS 107A,A01,083627,Boyle; Mary E. T.,20,0,60,40
1649887909490,COGS 118A,A01,083075,Staff,27,0,60,33
1649887915518,CSE 3,A50,083646,Miranda; Gregory Joseph,28,0,38,10
1649887915518,CSE 3,A51,083647,Miranda; Gregory Joseph,37,0,37,0
1649887921546,CSE 8A,A50,083650,Miranda; Gregory Joseph,19,0,40,21
1649887927569,CSE 11,A01,083080,Cao; Yingjun,0,15,40,40
1649887933598,CSE 12,A01,083652,Staff,73,0,100,27
1649887939622,CSE 15L,A01,083654,Staff,31,0,50,19
1649887939622,CSE 15L,A02,083655,Staff,48,0,50,2
1649887945657,CSE 20,A01,083657,Staff,71,0,80,9
1649887951784,CSE 30,A01,083084,Eldon; John,1,3,40,39
1649887957823,CSE 100,A01,083659,Cao; Yingjun,2,10,50,48
1649887963853,CSE 134B,A01,083661,Powell; Thomas Allan,1,23,65,64
1649887969879,CSE 140,A01,083663,Staff,36,0,75,39
1649887975905,CSE 140L,A01,083088,Eldon; John,28,0,75,47
1649887981927,CSE 175,A01,083665,Kumar; Rakesh,13,0,25,12
1649887987949,CSE 190,A00,092507,Dubnov; Shlomo,15,0,15,0
1649887993972,ECE 45,A01,083139,Staff,21,0,40,19
1649887999999,ECE 65,A50,083695,Staff,12,0,30,18
1649888006026,ECE 109,A01,091882,Touri; Behrouz,60,0,70,10
1649888012054,ECE 180,A00,083140,Abi Samra; Nicholas Camill,28,0,30,2
1649888012054,ECE 180,B00,083141,Abi Samra; Nicholas Camill,13,0,30,17
1649888018079,MATH 10A,A01,083735,Patchell; Gregory David,24,0,30,6
1649888018079,MATH 10A,A02,083736,Patchell; Gregory David,28,0,30,2
1649888018079,MATH 10A,A03,083737,Patchell; Gregory David,29,0,30,1
1649888024105,MATH 10B,A01,083207,Staff,15,0,30,15
1649888024105,MATH 10B,A02,083208,Staff,25,0,30,5
1649888024105,MATH 10B,B01,083739,Staff,25,0,30,5
1649888024105,MATH 10B,B02,083740,Staff,30,0,30,0
1649888030138,MATH 18,A01,083743,Staff,23,0,30,7
1649888030138,MATH 18,A02,083744,Staff,30,0,30,0
1649888030138,MATH 18,A03,083745,Staff,29,0,30,1
1649888030138,MATH 18,A04,083746,Staff,29,0,30,1
1649888030138,MATH 18,B01,083748,Staff,15,0,30,15
1649888030138,MATH 18,B02,083749,Staff,28,0,30,2
1649888030138,MATH 18,B03,083750,Staff,28,0,30,2
1649888030138,MATH 18,B04,083751,Staff,28,0,30,2
1649888036162,MATH 20A,A01,083754,Staff,38,0,40,2
1649888042205,MATH 20B,A01,083756,Staff,27,0,30,3
1649888042205,MATH 20B,A02,083757,Staff,30,0,30,0
1649888048239,MATH 20C,A01,083760,Staff,23,0,30,7
1649888048239,MATH 20C,A02,083761,Staff,27,0,30,3
1649888048239,MATH 20C,B01,083762,Staff,30,0,30,0
1649888048239,MATH 20C,B02,083763,Staff,30,0,30,0
1649888054261,MATH 20D,A01,083765,Staff,22,0,30,8
1649888054261,MATH 20D,A02,083766,Staff,30,0,30,0
1649888054261,MATH 20D,A03,083767,Staff,30,0,30,0
1649888060291,MATH 20E,A01,083771,Staff,17,0,30,13
1649888060291,MATH 20E,A02,083772,Staff,29,0,30,1
1649888060291,MATH 20E,B01,083773,Staff,24,0,30,6
1649888060291,MATH 20E,B02,083774,Staff,29,0,30,1
1649888066313,MATH 103A,A01,083777,Staff,0,0,30,30
1649888066313,MATH 103A,A02,083778,Staff,7,0,30,23
1649888066313,MATH 103A,B01,083779,Staff,7,0,30,23
1649888066313,MATH 103A,B02,083780,Staff,24,0,30,6
1649888072336,MATH 105,A01,085443,Staff,0,0,30,30
1649888078360,MATH 109,A01,083213,Anzaldo; Leesa B,25,0,30,5
1649888078360,MATH 109,A02,083214,Anzaldo; Leesa B,19,0,30,11
1649888078360,MATH 109,B01,083215,Anzaldo; Leesa B,26,0,30,4
1649888078360,MATH 109,B02,083216,Anzaldo; Leesa B,25,0,30,5
1649888084391,MATH 142A,A01,083219,Chow; Bennett,0,1,30,30
1649888084391,MATH 142A,A02,083220,Chow; Bennett,21,0,30,9
1649888084391,MATH 142A,B01,083221,Chow; Bennett,2,0,30,28
1649888084391,MATH 142A,B02,083222,Chow; Bennett,23,0,30,7
1649888090423,MATH 193A,A01,083224,Staff,0,3,30,30
1649888090423,MATH 193A,A02,083225,Staff,0,2,30,30
1649888090423,MATH 193A,A03,083781,Staff,20,0,30,10
1649888090423,MATH 193A,A04,083782,Staff,25,0,30,5
1649888096459,MATH 197,001,091859,McAuley; Julian John,9999,0,9999,0
1649888102523,COGS 9,A01,083615,Staff,33,0,60,27
1649888108545,COGS 11,A01,083617,Boyle; Mary E. T.,36,0,40,4
1649888114569,COGS 13,A01,083071,Staff,5,0,40,35
1649888120596,COGS 14A,A01,092681,Staff,85,0,100,15
1649888126620,COGS 14B,A01,083073,Cheng; Tzu-Han,30,0,50,20
1649888132652,COGS 17,A01,092677,Staff,67,0,75,8
1649888138675,COGS 100,A01,083619,Staff,15,0,60,45
1649888144699,COGS 101A,A01,083621,Davis; Joshua Daniel,15,0,60,45
1649888150724,COGS 101B,A01,091572,Staff,36,0,60,24
1649888156752,COGS 101C,A01,083625,Delgado; Tania,25,0,30,5
1649888162775,COGS 107A,A01,083627,Boyle; Mary E. T.,20,0,60,40
1649888168801,COGS 118A,A01,083075,Staff,27,0,60,33
1649888174829,CSE 3,A50,083646,Miranda; Gregory Joseph,28,0,38,10
1649888174829,CSE 3,A51,083647,Miranda; Gregory Joseph,37,0,37,0
1649888180853,CSE 8A,A50,083650,Miranda; Gregory Joseph,19,0,40,21
1649888186880,CSE 11,A01,083080,Cao; Yingjun,0,15,40,40
1649888192911,CSE 12,A01,083652,Staff,73,0,100,27
1649888198940,CSE 15L,A01,083654,Staff,31,0,50,19
1649888198940,CSE 15L,A02,083655,Staff,48,0,50,2
1649888204964,CSE 20,A01,083657,Staff,71,0,80,9
1649888211005,CSE 30,A01,083084,Eldon; John,1,4,40,39
1649888217047,CSE 100,A01,083659,Cao; Yingjun,2,11,50,48
1649888223072,CSE 134B,A01,083661,Powell; Thomas Allan,1,23,65,64
1649888229101,CSE 140,A01,083663,Staff,36,0,75,39
1649888235128,CSE 140L,A01,083088,Eldon; John,28,0,75,47
1649888241159,CSE 175,A01,083665,Kumar; Rakesh,13,0,25,12
1649888247183,CSE 190,A00,092507,Dubnov; Shlomo,15,0,15,0
1649888253221,ECE 45,A01,083139,Staff,21,0,40,19
1649888259244,ECE 65,A50,083695,Staff,12,0,30,18
1649888265272,ECE 109,A01,091882,Touri; Behrouz,60,0,70,10
1649888271295,ECE 180,A00,083140,Abi Samra; Nicholas Camill,28,0,30,2
1649888271295,ECE 180,B00,083141,Abi Samra; Nicholas Camill,13,0,30,17
1649888277336,MATH 10A,A01,083735,Patchell; Gregory David,24,0,30,6
1649888277336,MATH 10A,A02,083736,Patchell; Gregory David,28,0,30,2
1649888277336,MATH 10A,A03,083737,Patchell; Gregory David,29,0,30,1
1649888283359,MATH 10B,A01,083207,Staff,14,0,30,16
1649888283359,MATH 10B,A02,083208,Staff,25,0,30,5
1649888283359,MATH 10B,B01,083739,Staff,25,0,30,5
1649888283359,MATH 10B,B02,083740,Staff,30,0,30,0
1649888289386,MATH 18,A01,083743,Staff,23,0,30,7
1649888289386,MATH 18,A02,083744,Staff,30,0,30,0
1649888289386,MATH 18,A03,083745,Staff,29,0,30,1
1649888289386,MATH 18,A04,083746,Staff,29,0,30,1
1649888289386,MATH 18,B01,083748,Staff,15,0,30,15
1649888289386,MATH 18,B02,083749,Staff,28,0,30,2
1649888289386,MATH 18,B03,083750,Staff,28,0,30,2
1649888289386,MATH 18,B04,083751,Staff,28,0,30,2
1649888295422,MATH 20A,A01,083754,Staff,38,0,40,2
1649888301452,MATH 20B,A01,083756,Staff,27,0,30,3
1649888301452,MATH 20B,A02,083757,Staff,30,0,30,0
1649888307480,MATH 20C,A01,083760,Staff,23,0,30,7
1649888307480,MATH 20C,A02,083761,Staff,27,0,30,3
1649888307480,MATH 20C,B01,083762,Staff,30,0,30,0
1649888307480,MATH 20C,B02,083763,Staff,30,0,30,0
1649888313514,MATH 20D,A01,083765,Staff,22,0,30,8
1649888313514,MATH 20D,A02,083766,Staff,30,0,30,0
1649888313514,MATH 20D,A03,083767,Staff,30,0,30,0
1649888319536,MATH 20E,A01,083771,Staff,17,0,30,13
1649888319536,MATH 20E,A02,083772,Staff,29,0,30,1
1649888319536,MATH 20E,B01,083773,Staff,24,0,30,6
1649888319536,MATH 20E,B02,083774,Staff,29,0,30,1
1649888325571,MATH 103A,A01,083777,Staff,0,0,30,30
1649888325571,MATH 103A,A02,083778,Staff,7,0,30,23
1649888325571,MATH 103A,B01,083779,Staff,7,0,30,23
1649888325571,MATH 103A,B02,083780,Staff,24,0,30,6
1649888331597,MATH 105,A01,085443,Staff,0,0,30,30
1649888337620,MATH 109,A01,083213,Anzaldo; Leesa B,25,0,30,5
1649888337620,MATH 109,A02,083214,Anzaldo; Leesa B,19,0,30,11
1649888337620,MATH 109,B01,083215,Anzaldo; Leesa B,26,0,30,4
1649888337620,MATH 109,B02,083216,Anzaldo; Leesa B,25,0,30,5
1649888343648,MATH 142A,A01,083219,Chow; Bennett,0,1,30,30
1649888343648,MATH 142A,A02,083220,Chow; Bennett,21,0,30,9
1649888343648,MATH 142A,B01,083221,Chow; Bennett,1,0,30,29
1649888343648,MATH 142A,B02,083222,Chow; Bennett,23,0,30,7
1649888349671,MATH 193A,A01,083224,Staff,0,3,30,30
1649888349671,MATH 193A,A02,083225,Staff,0,2,30,30
1649888349671,MATH 193A,A03,083781,Staff,20,0,30,10
1649888349671,MATH 193A,A04,083782,Staff,25,0,30,5
1649888355696,MATH 197,001,091859,McAuley; Julian John,9999,0,9999,0
1649888361747,COGS 9,A01,083615,Staff,32,0,60,28
1649888367770,COGS 11,A01,083617,Boyle; Mary E. T.,36,0,40,4
1649888373801,COGS 13,A01,083071,Staff,5,0,40,35
1649888379824,COGS 14A,A01,092681,Staff,85,0,100,15
1649888385858,COGS 14B,A01,083073,Cheng; Tzu-Han,30,0,50,20
1649888391881,COGS 17,A01,092677,Staff,67,0,75,8
1649888397906,COGS 100,A01,083619,Staff,15,0,60,45
1649888403995,COGS 101A,A01,083621,Davis; Joshua Daniel,15,0,60,45
1649888410031,COGS 101B,A01,091572,Staff,36,0,60,24
1649888416062,COGS 101C,A01,083625,Delgado; Tania,25,0,30,5
1649888422085,COGS 107A,A01,083627,Boyle; Mary E. T.,20,0,60,40
1649888428121,COGS 118A,A01,083075,Staff,27,0,60,33
1649888434149,CSE 3,A50,083646,Miranda; Gregory Joseph,28,0,38,10
1649888434149,CSE 3,A51,083647,Miranda; Gregory Joseph,37,0,37,0
1649888440177,CSE 8A,A50,083650,Miranda; Gregory Joseph,19,0,40,21
1649888446199,CSE 11,A01,083080,Cao; Yingjun,0,15,40,40
1649888452221,CSE 12,A01,083652,Staff,73,0,100,27
1649888458245,CSE 15L,A01,083654,Staff,30,0,50,20
1649888458245,CSE 15L,A02,083655,Staff,48,0,50,2
1649888464272,CSE 20,A01,083657,Staff,71,0,80,9
1649888470295,CSE 30,A01,083084,Eldon; John,1,4,40,39
1649888476323,CSE 100,A01,083659,Cao; Yingjun,2,11,50,48
1649888482354,CSE 134B,A01,083661,Powell; Thomas Allan,1,23,65,64
1649888488390,CSE 140,A01,083663,Staff,36,0,75,39
1649888494412,CSE 140L,A01,083088,Eldon; John,28,0,75,47
1649888500437,CSE 175,A01,083665,Kumar; Rakesh,13,0,25,12
1649888506465,CSE 190,A00,092507,Dubnov; Shlomo,15,0,15,0
1649888512489,ECE 45,A01,083139,Staff,21,0,40,19
1649888518518,ECE 65,A50,083695,Staff,12,0,30,18
1649888524544,ECE 109,A01,091882,Touri; Behrouz,60,0,70,10
1649888530575,ECE 180,A00,083140,Abi Samra; Nicholas Camill,28,0,30,2
1649888530575,ECE 180,B00,083141,Abi Samra; Nicholas Camill,13,0,30,17
1649888536610,MATH 10A,A01,083735,Patchell; Gregory David,24,0,30,6
1649888536610,MATH 10A,A02,083736,Patchell; Gregory David,28,0,30,2
1649888536610,MATH 10A,A03,083737,Patchell; Gregory David,29,0,30,1
1649888542640,MATH 10B,A01,083207,Staff,14,0,30,16
1649888542640,MATH 10B,A02,083208,Staff,25,0,30,5
1649888542640,MATH 10B,B01,083739,Staff,25,0,30,5
1649888542640,MATH 10B,B02,083740,Staff,30,0,30,0
1649888555598,MATH 18,A01,083743,Staff,23,0,30,7
1649888555598,MATH 18,A02,083744,Staff,30,0,30,0
1649888555598,MATH 18,A03,083745,Staff,29,0,30,1
1649888555598,MATH 18,A04,083746,Staff,29,0,30,1
1649888555598,MATH 18,B01,083748,Staff,15,0,30,15
1649888555598,MATH 18,B02,083749,Staff,28,0,30,2
1649888555598,MATH 18,B03,083750,Staff,28,0,30,2
1649888555598,MATH 18,B04,083751,Staff,28,0,30,2
1649888561627,MATH 20A,A01,083754,Staff,38,0,40,2
1649888567652,MATH 20B,A01,083756,Staff,27,0,30,3
1649888567652,MATH 20B,A02,083757,Staff,30,0,30,0
1649888573684,MATH 20C,A01,083760,Staff,23,0,30,7
1649888573684,MATH 20C,A02,083761,Staff,26,0,30,4
1649888573684,MATH 20C,B01,083762,Staff,30,0,30,0
1649888573684,MATH 20C,B02,083763,Staff,30,0,30,0
1649888579717,MATH 20D,A01,083765,Staff,22,0,30,8
1649888579717,MATH 20D,A02,083766,Staff,30,0,30,0
1649888579717,MATH 20D,A03,083767,Staff,30,0,30,0
1649888585746,MATH 20E,A01,083771,Staff,17,0,30,13
1649888585746,MATH 20E,A02,083772,Staff,29,0,30,1
1649888585746,MATH 20E,B01,083773,Staff,24,0,30,6
1649888585746,MATH 20E,B02,083774,Staff,29,0,30,1
1649888591776,MATH 103A,A01,083777,Staff,0,0,30,30
1649888591776,MATH 103A,A02,083778,Staff,7,0,30,23
1649888591776,MATH 103A,B01,083779,Staff,7,0,30,23
1649888591776,MATH 103A,B02,083780,Staff,24,0,30,6
1649888597803,MATH 105,A01,085443,Staff,0,0,30,30
1649888603834,MATH 109,A01,083213,Anzaldo; Leesa B,25,0,30,5
1649888603834,MATH 109,A02,083214,Anzaldo; Leesa B,19,0,30,11
1649888603834,MATH 109,B01,083215,Anzaldo; Leesa B,26,0,30,4
1649888603834,MATH 109,B02,083216,Anzaldo; Leesa B,25,0,30,5
1649888609859,MATH 142A,A01,083219,Chow; Bennett,0,1,30,30
1649888609859,MATH 142A,A02,083220,Chow; Bennett,21,0,30,9
1649888609859,MATH 142A,B01,083221,Chow; Bennett,1,0,30,29
1649888609859,MATH 142A,B02,083222,Chow; Bennett,22,0,30,8
1649888615883,MATH 193A,A01,083224,Staff,0,3,30,30
1649888615883,MATH 193A,A02,083225,Staff,0,2,30,30
1649888615883,MATH 193A,A03,083781,Staff,20,0,30,10
1649888615883,MATH 193A,A04,083782,Staff,25,0,30,5
1649888621910,MATH 197,001,091859,McAuley; Julian John,9999,0,9999,0
1649888627968,COGS 9,A01,083615,Staff,31,0,60,29
1649888633992,COGS 11,A01,083617,Boyle; Mary E. T.,36,0,40,4
1649888640017,COGS 13,A01,083071,Staff,5,0,40,35
1649888646054,COGS 14A,A01,092681,Staff,85,0,100,15
1649888652078,COGS 14B,A01,083073,Cheng; Tzu-Han,30,0,50,20
1649888658101,COGS 17,A01,092677,Staff,67,0,75,8
1649888664130,COGS 100,A01,083619,Staff,14,0,60,46
1649888670162,COGS 101A,A01,083621,Davis; Joshua Daniel,15,0,60,45
1649888676188,COGS 101B,A01,091572,Staff,36,0,60,24
1649888682211,COGS 101C,A01,083625,Delgado; Tania,25,0,30,5
1649888688240,COGS 107A,A01,083627,Boyle; Mary E. T.,20,0,60,40
1649888694264,COGS 118A,A01,083075,Staff,27,0,60,33
1649888700299,CSE 3,A50,083646,Miranda; Gregory Joseph,28,0,38,10
1649888700299,CSE 3,A51,083647,Miranda; Gregory Joseph,37,0,37,0
1649888706322,CSE 8A,A50,083650,Miranda; Gregory Joseph,19,0,40,21
1649888712348,CSE 11,A01,083080,Cao; Yingjun,0,15,40,40
1649888718372,CSE 12,A01,083652,Staff,73,0,100,27
1649888724405,CSE 15L,A01,083654,Staff,30,0,50,20
1649888724405,CSE 15L,A02,083655,Staff,48,0,50,2
1649888730430,CSE 20,A01,083657,Staff,71,0,80,9
1649888736452,CSE 30,A01,083084,Eldon; John,1,4,40,39
1649888742475,CSE 100,A01,083659,Cao; Yingjun,2,11,50,48
1649888748502,CSE 134B,A01,083661,Powell; Thomas Allan,1,23,65,64
1649888754535,CSE 140,A01,083663,Staff,35,0,75,40
1649888760558,CSE 140L,A01,083088,Eldon; John,27,0,75,48
1649888766583,CSE 175,A01,083665,Kumar; Rakesh,13,0,25,12
1649888772617,CSE 190,A00,092507,Dubnov; Shlomo,15,0,15,0
1649888778642,ECE 45,A01,083139,Staff,21,0,40,19
1649888784685,ECE 65,A50,083695,Staff,12,0,30,18
1649888790707,ECE 109,A01,091882,Touri; Behrouz,60,0,70,10
1649888796731,ECE 180,A00,083140,Abi Samra; Nicholas Camill,28,0,30,2
1649888796731,ECE 180,B00,083141,Abi Samra; Nicholas Camill,13,0,30,17
1649888802763,MATH 10A,A01,083735,Patchell; Gregory David,24,0,30,6
1649888802763,MATH 10A,A02,083736,Patchell; Gregory David,28,0,30,2
1649888802763,MATH 10A,A03,083737,Patchell; Gregory David,29,0,30,1
1649888808787,MATH 10B,A01,083207,Staff,14,0,30,16
1649888808787,MATH 10B,A02,083208,Staff,25,0,30,5
1649888808787,MATH 10B,B01,083739,Staff,25,0,30,5
1649888808787,MATH 10B,B02,083740,Staff,30,0,30,0
1649888814818,MATH 18,A01,083743,Staff,23,0,30,7
1649888814818,MATH 18,A02,083744,Staff,30,0,30,0
1649888814818,MATH 18,A03,083745,Staff,29,0,30,1
1649888814818,MATH 18,A04,083746,Staff,29,0,30,1
1649888814818,MATH 18,B01,083748,Staff,14,0,30,16
1649888814818,MATH 18,B02,083749,Staff,28,0,30,2
1649888814818,MATH 18,B03,083750,Staff,28,0,30,2
1649888814818,MATH 18,B04,083751,Staff,28,0,30,2
1649888820850,MATH 20A,A01,083754,Staff,38,0,40,2
1649888826874,MATH 20B,A01,083756,Staff,27,0,30,3
1649888826874,MATH 20B,A02,083757,Staff,30,0,30,0
1649888832902,MATH 20C,A01,083760,Staff,23,0,30,7
1649888832902,MATH 20C,A02,083761,Staff,26,0,30,4
1649888832902,MATH 20C,B01,083762,Staff,30,0,30,0
1649888832902,MATH 20C,B02,083763,Staff,30,0,30,0
1649888838924,MATH 20D,A01,083765,Staff,22,0,30,8
1649888838924,MATH 20D,A02,083766,Staff,30,0,30,0
1649888838924,MATH 20D,A03,083767,Staff,30,0,30,0
1649888844948,MATH 20E,A01,083771,Staff,17,0,30,13
1649888844948,MATH 20E,A02,083772,Staff,28,0,30,2
1649888844948,MATH 20E,B01,083773,Staff,24,0,30,6
1649888844948,MATH 20E,B02,083774,Staff,29,0,30,1
1649888850972,MATH 103A,A01,083777,Staff,0,0,30,30
1649888850972,MATH 103A,A02,083778,Staff,7,0,30,23
1649888850972,MATH 103A,B01,083779,Staff,7,0,30,23
1649888850972,MATH 103A,B02,083780,Staff,24,0,30,6
1649888856995,MATH 105,A01,085443,Staff,0,0,30,30
1649888863030,MATH 109,A01,083213,Anzaldo; Leesa B,25,0,30,5
1649888863030,MATH 109,A02,083214,Anzaldo; Leesa B,19,0,30,11
1649888863030,MATH 109,B01,083215,Anzaldo; Leesa B,26,0,30,4
1649888863030,MATH 109,B02,083216,Anzaldo; Leesa B,25,0,30,5
1649888869070,MATH 142A,A01,083219,Chow; Bennett,0,1,30,30
1649888869070,MATH 142A,A02,083220,Chow; Bennett,21,0,30,9
1649888869070,MATH 142A,B01,083221,Chow; Bennett,1,0,30,29
1649888869070,MATH 142A,B02,083222,Chow; Bennett,22,0,30,8
1649888875098,MATH 193A,A01,083224,Staff,0,3,30,30
1649888875098,MATH 193A,A02,083225,Staff,0,2,30,30
1649888875098,MATH 193A,A03,083781,Staff,20,0,30,10
1649888875098,MATH 193A,A04,083782,Staff,25,0,30,5
1649888881137,MATH 197,001,091859,McAuley; Julian John,9999,0,9999,0
1649888887202,COGS 9,A01,083615,Staff,31,0,60,29
1649888893235,COGS 11,A01,083617,Boyle; Mary E. T.,36,0,40,4
1649888899259,COGS 13,A01,083071,Staff,5,0,40,35
1649888905283,COGS 14A,A01,092681,Staff,84,0,100,16
1649888911315,COGS 14B,A01,083073,Cheng; Tzu-Han,30,0,50,20
1649888917340,COGS 17,A01,092677,Staff,67,0,75,8
1649888923371,COGS 100,A01,083619,Staff,14,0,60,46
1649888929396,COGS 101A,A01,083621,Davis; Joshua Daniel,15,0,60,45
1649888935420,COGS 101B,A01,091572,Staff,36,0,60,24
1649888941455,COGS 101C,A01,083625,Delgado; Tania,25,0,30,5
1649888947484,COGS 107A,A01,083627,Boyle; Mary E. T.,19,0,60,41
1649888953508,COGS 118A,A01,083075,Staff,26,0,60,34
1649888959534,CSE 3,A50,083646,Miranda; Gregory Joseph,28,0,38,10
1649888959534,CSE 3,A51,083647,Miranda; Gregory Joseph,37,0,37,0
1649888965561,CSE 8A,A50,083650,Miranda; Gregory Joseph,18,0,40,22
1649888971584,CSE 11,A01,083080,Cao; Yingjun,0,15,40,40
1649888977607,CSE 12,A01,083652,Staff,73,0,100,27
1649888983635,CSE 15L,A01,083654,Staff,30,0,50,20
1649888983635,CSE 15L,A02,083655,Staff,48,0,50,2
1649888989659,CSE 20,A01,083657,Staff,71,0,80,9
1649888995685,CSE 30,A01,083084,Eldon; John,1,4,40,39
1649889001718,CSE 100,A01,083659,Cao; Yingjun,2,11,50,48
1649889007751,CSE 134B,A01,083661,Powell; Thomas Allan,1,23,65,64
1649889013783,CSE 140,A01,083663,Staff,35,0,75,40
1649889019810,CSE 140L,A01,083088,Eldon; John,27,0,75,48
1649889025836,CSE 175,A01,083665,Kumar; Rakesh,13,0,25,12
1649889031860,CSE 190,A00,092507,Dubnov; Shlomo,14,0,15,1
1649889037887,ECE 45,A01,083139,Staff,21,0,40,19
1649889043926,ECE 65,A50,083695,Staff,11,0,30,19
1649889049953,ECE 109,A01,091882,Touri; Behrouz,60,0,70,10
1649889055980,ECE 180,A00,083140,Abi Samra; Nicholas Camill,28,0,30,2
1649889055980,ECE 180,B00,083141,Abi Samra; Nicholas Camill,13,0,30,17
1649889062005,MATH 10A,A01,083735,Patchell; Gregory David,24,0,30,6
1649889062005,MATH 10A,A02,083736,Patchell; Gregory David,28,0,30,2
1649889062005,MATH 10A,A03,083737,Patchell; Gregory David,29,0,30,1
1649889068036,MATH 10B,A01,083207,Staff,14,0,30,16
1649889068036,MATH 10B,A02,083208,Staff,25,0,30,5
1649889068036,MATH 10B,B01,083739,Staff,25,0,30,5
1649889068036,MATH 10B,B02,083740,Staff,30,0,30,0
1649889074060,MATH 18,A01,083743,Staff,23,0,30,7
1649889074060,MATH 18,A02,083744,Staff,30,0,30,0
1649889074060,MATH 18,A03,083745,Staff,29,0,30,1
1649889074060,MATH 18,A04,083746,Staff,29,0,30,1
1649889074060,MATH 18,B01,083748,Staff,14,0,30,16
1649889074060,MATH 18,B02,083749,Staff,28,0,30,2
1649889074060,MATH 18,B03,083750,Staff,28,0,30,2
1649889074060,MATH 18,B04,083751,Staff,28,0,30,2
1649889080085,MATH 20A,A01,083754,Staff,38,0,40,2
1649889086171,MATH 20B,A01,083756,Staff,26,0,30,4
1649889086171,MATH 20B,A02,083757,Staff,30,0,30,0
1649889092192,MATH 20C,A01,083760,Staff,23,0,30,7
1649889092192,MATH 20C,A02,083761,Staff,25,0,30,5
1649889092192,MATH 20C,B01,083762,Staff,30,0,30,0
1649889092192,MATH 20C,B02,083763,Staff,30,0,30,0
1649889098217,MATH 20D,A01,083765,Staff,22,0,30,8
1649889098217,MATH 20D,A02,083766,Staff,30,0,30,0
1649889098217,MATH 20D,A03,083767,Staff,30,0,30,0
1649889104239,MATH 20E,A01,083771,Staff,17,0,30,13
1649889104239,MATH 20E,A02,083772,Staff,28,0,30,2
1649889104239,MATH 20E,B01,083773,Staff,24,0,30,6
1649889104239,MATH 20E,B02,083774,Staff,29,0,30,1
1649889110275,MATH 103A,A01,083777,Staff,0,0,30,30
1649889110275,MATH 103A,A02,083778,Staff,7,0,30,23
1649889110275,MATH 103A,B01,083779,Staff,7,0,30,23
1649889110275,MATH 103A,B02,083780,Staff,24,0,30,6
1649889116297,MATH 105,A01,085443,Staff,0,0,30,30
1649889122323,MATH 109,A01,083213,Anzaldo; Leesa B,25,0,30,5
1649889122323,MATH 109,A02,083214,Anzaldo; Leesa B,19,0,30,11
1649889122323,MATH 109,B01,083215,Anzaldo; Leesa B,26,0,30,4
1649889122323,MATH 109,B02,083216,Anzaldo; Leesa B,25,0,30,5
1649889128352,MATH 142A,A01,083219,Chow; Bennett,0,1,30,30
1649889128352,MATH 142A,A02,083220,Chow; Bennett,21,0,30,9
1649889128352,MATH 142A,B01,083221,Chow; Bennett,1,0,30,29
1649889128352,MATH 142A,B02,083222,Chow; Bennett,21,0,30,9
1649889134388,MATH 193A,A01,083224,Staff,0,3,30,30
1649889134388,MATH 193A,A02,083225,Staff,0,2,30,30
1649889134388,MATH 193A,A03,083781,Staff,19,0,30,11
1649889134388,MATH 193A,A04,083782,Staff,25,0,30,5
1649889140411,MATH 197,001,091859,McAuley; Julian John,9999,0,9999,0
1649889146570,COGS 9,A01,083615,Staff,31,0,60,29
1649889152592,COGS 11,A01,083617,Boyle; Mary E. T.,36,0,40,4
1649889158616,COGS 13,A01,083071,Staff,5,0,40,35
1649889164641,COGS 14A,A01,092681,Staff,84,0,100,16
1649889170669,COGS 14B,A01,083073,Cheng; Tzu-Han,30,0,50,20
1649889176702,COGS 17,A01,092677,Staff,67,0,75,8
1649889182729,COGS 100,A01,083619,Staff,14,0,60,46
1649889188755,COGS 101A,A01,083621,Davis; Joshua Daniel,15,0,60,45
1649889194783,COGS 101B,A01,091572,Staff,36,0,60,24
1649889200817,COGS 101C,A01,083625,Delgado; Tania,25,0,30,5
1649889206839,COGS 107A,A01,083627,Boyle; Mary E. T.,19,0,60,41
1649889212863,COGS 118A,A01,083075,Staff,26,0,60,34
1649889218887,CSE 3,A50,083646,Miranda; Gregory Joseph,28,0,38,10
1649889218887,CSE 3,A51,083647,Miranda; Gregory Joseph,37,0,37,0
1649889224913,CSE 8A,A50,083650,Miranda; Gregory Joseph,18,0,40,22
1649889230937,CSE 11,A01,083080,Cao; Yingjun,0,15,40,40
1649889236969,CSE 12,A01,083652,Staff,73,0,100,27
1649889242993,CSE 15L,A01,083654,Staff,30,0,50,20
1649889242993,CSE 15L,A02,083655,Staff,48,0,50,2
1649889249016,CSE 20,A01,083657,Staff,71,0,80,9
1649889255052,CSE 30,A01,083084,Eldon; John,1,4,40,39
1649889261074,CSE 100,A01,083659,Cao; Yingjun,2,11,50,48
1649889267097,CSE 134B,A01,083661,Powell; Thomas Allan,2,23,65,63
1649889273121,CSE 140,A01,083663,Staff,34,0,75,41
1649889279164,CSE 140L,A01,083088,Eldon; John,26,0,75,49
1649889285191,CSE 175,A01,083665,Kumar; Rakesh,13,0,25,12
1649889291214,CSE 190,A00,092507,Dubnov; Shlomo,14,0,15,1
1649889297244,ECE 45,A01,083139,Staff,20,0,40,20
1649889303268,ECE 65,A50,083695,Staff,11,0,30,19
1649889309301,ECE 109,A01,091882,Touri; Behrouz,60,0,70,10
1649889315328,ECE 180,A00,083140,Abi Samra; Nicholas Camill,27,0,30,3
1649889315328,ECE 180,B00,083141,Abi Samra; Nicholas Camill,13,0,30,17
1649889321352,MATH 10A,A01,083735,Patchell; Gregory David,24,0,30,6
1649889321352,MATH 10A,A02,083736,Patchell; Gregory David,28,0,30,2
1649889321352,MATH 10A,A03,083737,Patchell; Gregory David,29,0,30,1
1649889327380,MATH 10B,A01,083207,Staff,14,0,30,16
1649889327380,MATH 10B,A02,083208,Staff,25,0,30,5
1649889327380,MATH 10B,B01,083739,Staff,25,0,30,5
1649889327380,MATH 10B,B02,083740,Staff,30,0,30,0
1649889333412,MATH 18,A01,083743,Staff,23,0,30,7
1649889333412,MATH 18,A02,083744,Staff,30,0,30,0
1649889333412,MATH 18,A03,083745,Staff,29,0,30,1
1649889333412,MATH 18,A04,083746,Staff,29,0,30,1
1649889333412,MATH 18,B01,083748,Staff,14,0,30,16
1649889333412,MATH 18,B02,083749,Staff,28,0,30,2
1649889333412,MATH 18,B03,083750,Staff,28,0,30,2
1649889333412,MATH 18,B04,083751,Staff,28,0,30,2
1649889339436,MATH 20A,A01,083754,Staff,38,0,40,2
1649889345474,MATH 20B,A01,083756,Staff,26,0,30,4
1649889345474,MATH 20B,A02,083757,Staff,30,0,30,0
1649889351504,MATH 20C,A01,083760,Staff,23,0,30,7
1649889351504,MATH 20C,A02,083761,Staff,25,0,30,5
1649889351504,MATH 20C,B01,083762,Staff,30,0,30,0
1649889351504,MATH 20C,B02,083763,Staff,30,0,30,0
1649889357531,MATH 20D,A01,083765,Staff,22,0,30,8
1649889357531,MATH 20D,A02,083766,Staff,30,0,30,0
1649889357531,MATH 20D,A03,083767,Staff,30,0,30,0
1649889363575,MATH 20E,A01,083771,Staff,17,0,30,13
1649889363575,MATH 20E,A02,083772,Staff,28,0,30,2
1649889363575,MATH 20E,B01,083773,Staff,24,0,30,6
1649889363575,MATH 20E,B02,083774,Staff,29,0,30,1
1649889369599,MATH 103A,A01,083777,Staff,0,0,30,30
1649889369599,MATH 103A,A02,083778,Staff,7,0,30,23
1649889369599,MATH 103A,B01,083779,Staff,7,0,30,23
1649889369599,MATH 103A,B02,083780,Staff,24,0,30,6
1649889375630,MATH 105,A01,085443,Staff,0,0,30,30
1649889381654,MATH 109,A01,083213,Anzaldo; Leesa B,25,0,30,5
1649889381654,MATH 109,A02,083214,Anzaldo; Leesa B,19,0,30,11
1649889381654,MATH 109,B01,083215,Anzaldo; Leesa B,26,0,30,4
1649889381654,MATH 109,B02,083216,Anzaldo; Leesa B,25,0,30,5
1649889387677,MATH 142A,A01,083219,Chow; Bennett,0,1,30,30
1649889387677,MATH 142A,A02,083220,Chow; Bennett,21,0,30,9
1649889387677,MATH 142A,B01,083221,Chow; Bennett,1,0,30,29
1649889387677,MATH 142A,B02,083222,Chow; Bennett,21,0,30,9
1649889393712,MATH 193A,A01,083224,Staff,0,3,30,30
1649889393712,MATH 193A,A02,083225,Staff,0,2,30,30
1649889393712,MATH 193A,A03,083781,Staff,17,0,30,13
1649889393712,MATH 193A,A04,083782,Staff,25,0,30,5
1649889399745,MATH 197,001,091859,McAuley; Julian John,9999,0,9999,0
1649889405794,COGS 9,A01,083615,Staff,31,0,60,29
1649889411821,COGS 11,A01,083617,Boyle; Mary E. T.,36,0,40,4
1649889417846,COGS 13,A01,083071,Staff,4,0,40,36
1649889423872,COGS 14A,A01,092681,Staff,84,0,100,16
1649889429903,COGS 14B,A01,083073,Cheng; Tzu-Han,30,0,50,20
1649889435929,COGS 17,A01,092677,Staff,67,0,75,8
1649889441953,COGS 100,A01,083619,Staff,14,0,60,46
1649889447980,COGS 101A,A01,083621,Davis; Joshua Daniel,15,0,60,45
1649889454005,COGS 101B,A01,091572,Staff,36,0,60,24
1649889460035,COGS 101C,A01,083625,Delgado; Tania,25,0,30,5
1649889466062,COGS 107A,A01,083627,Boyle; Mary E. T.,19,0,60,41
1649889472092,COGS 118A,A01,083075,Staff,26,0,60,34
1649889478121,CSE 3,A50,083646,Miranda; Gregory Joseph,28,0,38,10
1649889478121,CSE 3,A51,083647,Miranda; Gregory Joseph,37,0,37,0
1649889484144,CSE 8A,A50,083650,Miranda; Gregory Joseph,18,0,40,22
1649889490170,CSE 11,A01,083080,Cao; Yingjun,0,15,40,40
1649889496194,CSE 12,A01,083652,Staff,73,0,100,27
1649889502218,CSE 15L,A01,083654,Staff,30,0,50,20
1649889502218,CSE 15L,A02,083655,Staff,48,0,50,2
1649889508240,CSE 20,A01,083657,Staff,71,0,80,9
1649889514268,CSE 30,A01,083084,Eldon; John,1,4,40,39
1649889520298,CSE 100,A01,083659,Cao; Yingjun,2,11,50,48
1649889526330,CSE 134B,A01,083661,Powell; Thomas Allan,2,23,65,63
1649889532357,CSE 140,A01,083663,Staff,33,0,75,42
1649889538381,CSE 140L,A01,083088,Eldon; John,25,0,75,50
1649889544407,CSE 175,A01,083665,Kumar; Rakesh,13,0,25,12
1649889550429,CSE 190,A00,092507,Dubnov; Shlomo,14,0,15,1
1649889556458,ECE 45,A01,083139,Staff,20,0,40,20
1649889562485,ECE 65,A50,083695,Staff,11,0,30,19
1649889568515,ECE 109,A01,091882,Touri; Behrouz,60,0,70,10
1649889574541,ECE 180,A00,083140,Abi Samra; Nicholas Camill,27,0,30,3
1649889574541,ECE 180,B00,083141,Abi Samra; Nicholas Camill,13,0,30,17
1649889580568,MATH 10A,A01,083735,Patchell; Gregory David,24,0,30,6
1649889580568,MATH 10A,A02,083736,Patchell; Gregory David,28,0,30,2
1649889580568,MATH 10A,A03,083737,Patchell; Gregory David,29,0,30,1
1649889586596,MATH 10B,A01,083207,Staff,15,0,30,15
1649889586596,MATH 10B,A02,083208,Staff,25,0,30,5
1649889586596,MATH 10B,B01,083739,Staff,25,0,30,5
1649889586596,MATH 10B,B02,083740,Staff,30,0,30,0
1649889592626,MATH 18,A01,083743,Staff,23,0,30,7
1649889592626,MATH 18,A02,083744,Staff,30,0,30,0
1649889592626,MATH 18,A03,083745,Staff,29,0,30,1
1649889592626,MATH 18,A04,083746,Staff,29,0,30,1
1649889592626,MATH 18,B01,083748,Staff,14,0,30,16
1649889592626,MATH 18,B02,083749,Staff,28,0,30,2
1649889592626,MATH 18,B03,083750,Staff,28,0,30,2
1649889592626,MATH 18,B04,083751,Staff,28,0,30,2
1649889598650,MATH 20A,A01,083754,Staff,38,0,40,2
1649889604673,MATH 20B,A01,083756,Staff,26,0,30,4
1649889604673,MATH 20B,A02,083757,Staff,30,0,30,0
1649889610700,MATH 20C,A01,083760,Staff,23,0,30,7
1649889610700,MATH 20C,A02,083761,Staff,25,0,30,5
1649889610700,MATH 20C,B01,083762,Staff,30,0,30,0
1649889610700,MATH 20C,B02,083763,Staff,30,0,30,0
1649889616723,MATH 20D,A01,083765,Staff,22,0,30,8
1649889616723,MATH 20D,A02,083766,Staff,30,0,30,0
1649889616723,MATH 20D,A03,083767,Staff,30,0,30,0
1649889622753,MATH 20E,A01,083771,Staff,17,0,30,13
1649889622753,MATH 20E,A02,083772,Staff,28,0,30,2
1649889622753,MATH 20E,B01,083773,Staff,24,0,30,6
1649889622753,MATH 20E,B02,083774,Staff,29,0,30,1
1649889628790,MATH 103A,A01,083777,Staff,0,0,30,30
1649889628790,MATH 103A,A02,083778,Staff,7,0,30,23
1649889628790,MATH 103A,B01,083779,Staff,7,0,30,23
1649889628790,MATH 103A,B02,083780,Staff,24,0,30,6
1649889634821,MATH 105,A01,085443,Staff,0,0,30,30
1649889640845,MATH 109,A01,083213,Anzaldo; Leesa B,25,0,30,5
1649889640845,MATH 109,A02,083214,Anzaldo; Leesa B,19,0,30,11
1649889640845,MATH 109,B01,083215,Anzaldo; Leesa B,26,0,30,4
1649889640845,MATH 109,B02,083216,Anzaldo; Leesa B,25,0,30,5
1649889646869,MATH 142A,A01,083219,Chow; Bennett,0,1,30,30
1649889646869,MATH 142A,A02,083220,Chow; Bennett,21,0,30,9
1649889646869,MATH 142A,B01,083221,Chow; Bennett,0,0,30,30
1649889646869,MATH 142A,B02,083222,Chow; Bennett,21,0,30,9
1649889652892,MATH 193A,A01,083224,Staff,0,3,30,30
1649889652892,MATH 193A,A02,083225,Staff,0,2,30,30
1649889652892,MATH 193A,A03,083781,Staff,16,0,30,14
1649889652892,MATH 193A,A04,083782,Staff,25,0,30,5
1649889658915,MATH 197,001,091859,McAuley; Julian John,9999,0,9999,0
1649889664963,COGS 9,A01,083615,Staff,31,0,60,29
1649889670990,COGS 11,A01,083617,Boyle; Mary E. T.,36,0,40,4
1649889677013,COGS 13,A01,083071,Staff,4,0,40,36
1649889683041,COGS 14A,A01,092681,Staff,84,0,100,16
1649889689070,COGS 14B,A01,083073,Cheng; Tzu-Han,30,0,50,20
1649889695102,COGS 17,A01,092677,Staff,67,0,75,8
1649889701127,COGS 100,A01,083619,Staff,14,0,60,46
1649889707149,COGS 101A,A01,083621,Davis; Joshua Daniel,15,0,60,45
1649889713171,COGS 101B,A01,091572,Staff,36,0,60,24
1649889719195,COGS 101C,A01,083625,Delgado; Tania,25,0,30,5
1649889725218,COGS 107A,A01,083627,Boyle; Mary E. T.,19,0,60,41
1649889731245,COGS 118A,A01,083075,Staff,26,0,60,34
1649889737276,CSE 3,A50,083646,Miranda; Gregory Joseph,28,0,38,10
1649889737276,CSE 3,A51,083647,Miranda; Gregory Joseph,37,0,37,0
1649889743389,CSE 8A,A50,083650,Miranda; Gregory Joseph,18,0,40,22
1649889749410,CSE 11,A01,083080,Cao; Yingjun,0,16,40,40
1649889755433,CSE 12,A01,083652,Staff,73,0,100,27
1649889761456,CSE 15L,A01,083654,Staff,30,0,50,20
1649889761456,CSE 15L,A02,083655,Staff,48,0,50,2
1649889767482,CSE 20,A01,083657,Staff,71,0,80,9
1649889773506,CSE 30,A01,083084,Eldon; John,1,4,40,39
1649889779529,CSE 100,A01,083659,Cao; Yingjun,2,12,50,48
1649889785552,CSE 134B,A01,083661,Powell; Thomas Allan,2,23,65,63
1649889791577,CSE 140,A01,083663,Staff,32,0,75,43
1649889797609,CSE 140L,A01,083088,Eldon; John,24,0,75,51
1649889803630,CSE 175,A01,083665,Kumar; Rakesh,13,0,25,12
1649889809653,CSE 190,A00,092507,Dubnov; Shlomo,14,0,15,1
1649889815694,ECE 45,A01,083139,Staff,20,0,40,20
1649889821717,ECE 65,A50,083695,Staff,11,0,30,19
1649889827747,ECE 109,A01,091882,Touri; Behrouz,60,0,70,10
1649889833770,ECE 180,A00,083140,Abi Samra; Nicholas Camill,27,0,30,3
1649889833770,ECE 180,B00,083141,Abi Samra; Nicholas Camill,13,0,30,17
1649889839800,MATH 10A,A01,083735,Patchell; Gregory David,24,0,30,6
1649889839800,MATH 10A,A02,083736,Patchell; Gregory David,28,0,30,2
1649889839800,MATH 10A,A03,083737,Patchell; Gregory David,29,0,30,1
1649889845828,MATH 10B,A01,083207,Staff,15,0,30,15
1649889845828,MATH 10B,A02,083208,Staff,25,0,30,5
1649889845828,MATH 10B,B01,083739,Staff,25,0,30,5
1649889845828,MATH 10B,B02,083740,Staff,30,0,30,0
1649889851861,MATH 18,A01,083743,Staff,23,0,30,7
1649889851861,MATH 18,A02,083744,Staff,30,0,30,0
1649889851861,MATH 18,A03,083745,Staff,29,0,30,1
1649889851861,MATH 18,A04,083746,Staff,29,0,30,1
1649889851861,MATH 18,B01,083748,Staff,14,0,30,16
1649889851861,MATH 18,B02,083749,Staff,28,0,30,2
1649889851861,MATH 18,B03,083750,Staff,28,0,30,2
1649889851861,MATH 18,B04,083751,Staff,28,0,30,2
1649889857896,MATH 20A,A01,083754,Staff,38,0,40,2
1649889863922,MATH 20B,A01,083756,Staff,26,0,30,4
1649889863922,MATH 20B,A02,083757,Staff,30,0,30,0
1649889869945,MATH 20C,A01,083760,Staff,23,0,30,7
1649889869945,MATH 20C,A02,083761,Staff,25,0,30,5
1649889869945,MATH 20C,B01,083762,Staff,30,0,30,0
1649889869945,MATH 20C,B02,083763,Staff,30,0,30,0
1649889875973,MATH 20D,A01,083765,Staff,22,0,30,8
1649889875973,MATH 20D,A02,083766,Staff,30,0,30,0
1649889875973,MATH 20D,A03,083767,Staff,30,0,30,0
1649889881997,MATH 20E,A01,083771,Staff,17,0,30,13
1649889881997,MATH 20E,A02,083772,Staff,28,0,30,2
1649889881997,MATH 20E,B01,083773,Staff,24,0,30,6
1649889881997,MATH 20E,B02,083774,Staff,29,0,30,1
1649889888020,MATH 103A,A01,083777,Staff,0,0,30,30
1649889888020,MATH 103A,A02,083778,Staff,7,0,30,23
1649889888020,MATH 103A,B01,083779,Staff,7,0,30,23
1649889888020,MATH 103A,B02,083780,Staff,24,0,30,6
1649889894043,MATH 105,A01,085443,Staff,0,0,30,30
1649889900070,MATH 109,A01,083213,Anzaldo; Leesa B,23,0,30,7
1649889900070,MATH 109,A02,083214,Anzaldo; Leesa B,19,0,30,11
1649889900070,MATH 109,B01,083215,Anzaldo; Leesa B,26,0,30,4
1649889900070,MATH 109,B02,083216,Anzaldo; Leesa B,25,0,30,5
1649889906094,MATH 142A,A01,083219,Chow; Bennett,0,1,30,30
1649889906094,MATH 142A,A02,083220,Chow; Bennett,21,0,30,9
1649889906094,MATH 142A,B01,083221,Chow; Bennett,0,0,30,30
1649889906094,MATH 142A,B02,083222,Chow; Bennett,21,0,30,9
1649889912117,MATH 193A,A01,083224,Staff,0,3,30,30
1649889912117,MATH 193A,A02,083225,Staff,0,3,30,30
1649889912117,MATH 193A,A03,083781,Staff,16,0,30,14
1649889912117,MATH 193A,A04,083782,Staff,24,0,30,6
1649889918143,MATH 197,001,091859,McAuley; Julian John,9999,0,9999,0
1649889924197,COGS 9,A01,083615,Staff,31,0,60,29
1649889930219,COGS 11,A01,083617,Boyle; Mary E. T.,36,0,40,4
1649889936242,COGS 13,A01,083071,Staff,4,0,40,36
1649889942266,COGS 14A,A01,092681,Staff,83,0,100,17
1649889948290,COGS 14B,A01,083073,Cheng; Tzu-Han,30,0,50,20
1649889954323,COGS 17,A01,092677,Staff,67,0,75,8
1649889960349,COGS 100,A01,083619,Staff,14,0,60,46
1649889966377,COGS 101A,A01,083621,Davis; Joshua Daniel,15,0,60,45
1649889972401,COGS 101B,A01,091572,Staff,36,0,60,24
1649889978432,COGS 101C,A01,083625,Delgado; Tania,25,0,30,5
1649889984461,COGS 107A,A01,083627,Boyle; Mary E. T.,19,0,60,41
1649889990490,COGS 118A,A01,083075,Staff,26,0,60,34
1649889996522,CSE 3,A50,083646,Miranda; Gregory Joseph,28,0,38,10
1649889996522,CSE 3,A51,083647,Miranda; Gregory Joseph,37,0,37,0
1649890002551,CSE 8A,A50,083650,Miranda; Gregory Joseph,18,0,40,22
1649890008574,CSE 11,A01,083080,Cao; Yingjun,0,16,40,40
1649890014600,CSE 12,A01,083652,Staff,73,0,100,27
1649890020626,CSE 15L,A01,083654,Staff,30,0,50,20
1649890020626,CSE 15L,A02,083655,Staff,48,0,50,2
1649890026653,CSE 20,A01,083657,Staff,71,0,80,9
1649890032681,CSE 30,A01,083084,Eldon; John,1,4,40,39
1649890038704,CSE 100,A01,083659,Cao; Yingjun,2,12,50,48
1649890044728,CSE 134B,A01,083661,Powell; Thomas Allan,2,23,65,63
1649890050753,CSE 140,A01,083663,Staff,32,0,75,43
1649890056787,CSE 140L,A01,083088,Eldon; John,24,0,75,51
1649890062821,CSE 175,A01,083665,Kumar; Rakesh,13,0,25,12
1649890068847,CSE 190,A00,092507,Dubnov; Shlomo,14,0,15,1
1649890074878,ECE 45,A01,083139,Staff,20,0,40,20
1649890080904,ECE 65,A50,083695,Staff,11,0,30,19
1649890086927,ECE 109,A01,091882,Touri; Behrouz,60,0,70,10
1649890092954,ECE 180,A00,083140,Abi Samra; Nicholas Camill,27,0,30,3
1649890092954,ECE 180,B00,083141,Abi Samra; Nicholas Camill,13,0,30,17
1649890098980,MATH 10A,A01,083735,Patchell; Gregory David,24,0,30,6
1649890098980,MATH 10A,A02,083736,Patchell; Gregory David,28,0,30,2
1649890098980,MATH 10A,A03,083737,Patchell; Gregory David,29,0,30,1
1649890105011,MATH 10B,A01,083207,Staff,15,0,30,15
1649890105011,MATH 10B,A02,083208,Staff,25,0,30,5
1649890105011,MATH 10B,B01,083739,Staff,25,0,30,5
1649890105011,MATH 10B,B02,083740,Staff,30,0,30,0
1649890111048,MATH 18,A01,083743,Staff,23,0,30,7
1649890111048,MATH 18,A02,083744,Staff,30,0,30,0
1649890111048,MATH 18,A03,083745,Staff,29,0,30,1
1649890111048,MATH 18,A04,083746,Staff,29,0,30,1
1649890111048,MATH 18,B01,083748,Staff,14,0,30,16
1649890111048,MATH 18,B02,083749,Staff,28,0,30,2
1649890111048,MATH 18,B03,083750,Staff,28,0,30,2
1649890111048,MATH 18,B04,083751,Staff,28,0,30,2
1649890117075,MATH 20A,A01,083754,Staff,38,0,40,2
1649890123111,MATH 20B,A01,083756,Staff,26,0,30,4
1649890123111,MATH 20B,A02,083757,Staff,30,0,30,0
1649890129142,MATH 20C,A01,083760,Staff,23,0,30,7
1649890129142,MATH 20C,A02,083761,Staff,25,0,30,5
1649890129142,MATH 20C,B01,083762,Staff,30,0,30,0
1649890129142,MATH 20C,B02,083763,Staff,30,0,30,0
1649890135172,MATH 20D,A01,083765,Staff,22,0,30,8
1649890135172,MATH 20D,A02,083766,Staff,30,0,30,0
1649890135172,MATH 20D,A03,083767,Staff,30,0,30,0
1649890141201,MATH 20E,A01,083771,Staff,17,0,30,13
1649890141201,MATH 20E,A02,083772,Staff,28,0,30,2
1649890141201,MATH 20E,B01,083773,Staff,24,0,30,6
1649890141201,MATH 20E,B02,083774,Staff,29,0,30,1
1649890147224,MATH 103A,A01,083777,Staff,0,0,30,30
1649890147224,MATH 103A,A02,083778,Staff,7,0,30,23
1649890147224,MATH 103A,B01,083779,Staff,7,0,30,23
1649890147224,MATH 103A,B02,083780,Staff,24,0,30,6
1649890153249,MATH 105,A01,085443,Staff,0,0,30,30
1649890159274,MATH 109,A01,083213,Anzaldo; Leesa B,23,0,30,7
1649890159274,MATH 109,A02,083214,Anzaldo; Leesa B,19,0,30,11
1649890159274,MATH 109,B01,083215,Anzaldo; Leesa B,26,0,30,4
1649890159274,MATH 109,B02,083216,Anzaldo; Leesa B,25,0,30,5
1649890165307,MATH 142A,A01,083219,Chow; Bennett,0,1,30,30
1649890165307,MATH 142A,A02,083220,Chow; Bennett,21,0,30,9
1649890165307,MATH 142A,B01,083221,Chow; Bennett,0,0,30,30
1649890165307,MATH 142A,B02,083222,Chow; Bennett,21,0,30,9
1649890171331,MATH 193A,A01,083224,Staff,0,3,30,30
1649890171331,MATH 193A,A02,083225,Staff,0,3,30,30
1649890171331,MATH 193A,A03,083781,Staff,16,0,30,14
1649890171331,MATH 193A,A04,083782,Staff,24,0,30,6
1649890177353,MATH 197,001,091859,McAuley; Julian John,9999,0,9999,0
1649890183418,COGS 9,A01,083615,Staff,31,0,60,29
1649890189439,COGS 11,A01,083617,Boyle; Mary E. T.,36,0,40,4
1649890195467,COGS 13,A01,083071,Staff,4,0,40,36
1649890201496,COGS 14A,A01,092681,Staff,83,0,100,17
1649890207521,COGS 14B,A01,083073,Cheng; Tzu-Han,30,0,50,20
1649890213547,COGS 17,A01,092677,Staff,67,0,75,8
1649890219572,COGS 100,A01,083619,Staff,14,0,60,46
1649890225594,COGS 101A,A01,083621,Davis; Joshua Daniel,15,0,60,45
1649890231616,COGS 101B,A01,091572,Staff,36,0,60,24
1649890237641,COGS 101C,A01,083625,Delgado; Tania,25,0,30,5
1649890243668,COGS 107A,A01,083627,Boyle; Mary E. T.,19,0,60,41
1649890249691,COGS 118A,A01,083075,Staff,26,0,60,34
1649890255715,CSE 3,A50,083646,Miranda; Gregory Joseph,28,0,38,10
1649890255715,CSE 3,A51,083647,Miranda; Gregory Joseph,37,0,37,0
1649890261738,CSE 8A,A50,083650,Miranda; Gregory Joseph,18,0,40,22
1649890267764,CSE 11,A01,083080,Cao; Yingjun,0,16,40,40
1649890273794,CSE 12,A01,083652,Staff,72,0,100,28
1649890279830,CSE 15L,A01,083654,Staff,29,0,50,21
1649890279830,CSE 15L,A02,083655,Staff,48,0,50,2
1649890285860,CSE 20,A01,083657,Staff,71,0,80,9
1649890291891,CSE 30,A01,083084,Eldon; John,1,4,40,39
1649890297919,CSE 100,A01,083659,Cao; Yingjun,2,13,50,48
1649890303943,CSE 134B,A01,083661,Powell; Thomas Allan,2,23,65,63
1649890309968,CSE 140,A01,083663,Staff,32,0,75,43
1649890315992,CSE 140L,A01,083088,Eldon; John,25,0,75,50
1649890322023,CSE 175,A01,083665,Kumar; Rakesh,13,0,25,12
1649890328058,CSE 190,A00,092507,Dubnov; Shlomo,14,0,15,1
1649890334081,ECE 45,A01,083139,Staff,20,0,40,20
1649890340200,ECE 65,A50,083695,Staff,11,0,30,19
1649890346223,ECE 109,A01,091882,Touri; Behrouz,60,0,70,10
1649890352255,ECE 180,A00,083140,Abi Samra; Nicholas Camill,27,0,30,3
1649890352255,ECE 180,B00,083141,Abi Samra; Nicholas Camill,13,0,30,17
1649890358279,MATH 10A,A01,083735,Patchell; Gregory David,24,0,30,6
1649890358279,MATH 10A,A02,083736,Patchell; Gregory David,28,0,30,2
1649890358279,MATH 10A,A03,083737,Patchell; Gregory David,29,0,30,1
1649890364313,MATH 10B,A01,083207,Staff,15,0,30,15
1649890364313,MATH 10B,A02,083208,Staff,25,0,30,5
1649890364313,MATH 10B,B01,083739,Staff,25,0,30,5
1649890364313,MATH 10B,B02,083740,Staff,30,0,30,0
1649890370338,MATH 18,A01,083743,Staff,23,0,30,7
1649890370338,MATH 18,A02,083744,Staff,30,0,30,0
1649890370338,MATH 18,A03,083745,Staff,29,0,30,1
1649890370338,MATH 18,A04,083746,Staff,29,0,30,1
1649890370338,MATH 18,B01,083748,Staff,14,0,30,16
1649890370338,MATH 18,B02,083749,Staff,28,0,30,2
1649890370338,MATH 18,B03,083750,Staff,28,0,30,2
1649890370338,MATH 18,B04,083751,Staff,28,0,30,2
1649890376366,MATH 20A,A01,083754,Staff,38,0,40,2
1649890382392,MATH 20B,A01,083756,Staff,26,0,30,4
1649890382392,MATH 20B,A02,083757,Staff,30,0,30,0
1649890388415,MATH 20C,A01,083760,Staff,23,0,30,7
1649890388415,MATH 20C,A02,083761,Staff,25,0,30,5
1649890388415,MATH 20C,B01,083762,Staff,30,0,30,0
1649890388415,MATH 20C,B02,083763,Staff,30,0,30,0
1649890394439,MATH 20D,A01,083765,Staff,22,0,30,8
1649890394439,MATH 20D,A02,083766,Staff,30,0,30,0
1649890394439,MATH 20D,A03,083767,Staff,30,0,30,0
1649890400466,MATH 20E,A01,083771,Staff,17,0,30,13
1649890400466,MATH 20E,A02,083772,Staff,28,0,30,2
1649890400466,MATH 20E,B01,083773,Staff,24,0,30,6
1649890400466,MATH 20E,B02,083774,Staff,29,0,30,1
1649890406495,MATH 103A,A01,083777,Staff,0,0,30,30
1649890406495,MATH 103A,A02,083778,Staff,5,0,30,25
1649890406495,MATH 103A,B01,083779,Staff,7,0,30,23
1649890406495,MATH 103A,B02,083780,Staff,24,0,30,6
1649890412523,MATH 105,A01,085443,Staff,0,1,30,30
1649890418550,MATH 109,A01,083213,Anzaldo; Leesa B,22,0,30,8
1649890418550,MATH 109,A02,083214,Anzaldo; Leesa B,19,0,30,11
1649890418550,MATH 109,B01,083215,Anzaldo; Leesa B,26,0,30,4
1649890418550,MATH 109,B02,083216,Anzaldo; Leesa B,25,0,30,5
1649890424572,MATH 142A,A01,083219,Chow; Bennett,0,1,30,30
1649890424572,MATH 142A,A02,083220,Chow; Bennett,20,0,30,10
1649890424572,MATH 142A,B01,083221,Chow; Bennett,0,0,30,30
1649890424572,MATH 142A,B02,083222,Chow; Bennett,21,0,30,9
1649890430601,MATH 193A,A01,083224,Staff,0,3,30,30
1649890430601,MATH 193A,A02,083225,Staff,0,3,30,30
1649890430601,MATH 193A,A03,083781,Staff,16,0,30,14
1649890430601,MATH 193A,A04,083782,Staff,23,0,30,7
1649890436628,MATH 197,001,091859,McAuley; Julian John,9999,0,9999,0
1649890442688,COGS 9,A01,083615,Staff,31,0,60,29
1649890448712,COGS 11,A01,083617,Boyle; Mary E. T.,36,0,40,4
1649890454735,COGS 13,A01,083071,Staff,4,0,40,36
1649890460760,COGS 14A,A01,092681,Staff,83,0,100,17
1649890466787,COGS 14B,A01,083073,Cheng; Tzu-Han,30,0,50,20
1649890472817,COGS 17,A01,092677,Staff,67,0,75,8
1649890478843,COGS 100,A01,083619,Staff,14,0,60,46
1649890484867,COGS 101A,A01,083621,Davis; Joshua Daniel,15,0,60,45
1649890490889,COGS 101B,A01,091572,Staff,36,0,60,24
1649890496914,COGS 101C,A01,083625,Delgado; Tania,25,0,30,5
1649890502938,COGS 107A,A01,083627,Boyle; Mary E. T.,19,0,60,41
1649890508968,COGS 118A,A01,083075,Staff,26,0,60,34
1649890514993,CSE 3,A50,083646,Miranda; Gregory Joseph,28,0,38,10
1649890514993,CSE 3,A51,083647,Miranda; Gregory Joseph,37,0,37,0
1649890521016,CSE 8A,A50,083650,Miranda; Gregory Joseph,18,0,40,22
1649890527044,CSE 11,A01,083080,Cao; Yingjun,0,17,40,40
1649890533067,CSE 12,A01,083652,Staff,72,0,100,28
1649890539091,CSE 15L,A01,083654,Staff,29,0,50,21
1649890539091,CSE 15L,A02,083655,Staff,48,0,50,2
1649890545120,CSE 20,A01,083657,Staff,71,0,80,9
1649890551144,CSE 30,A01,083084,Eldon; John,1,4,40,39
1649890557169,CSE 100,A01,083659,Cao; Yingjun,2,14,50,48
1649890563193,CSE 134B,A01,083661,Powell; Thomas Allan,2,23,65,63
1649890569223,CSE 140,A01,083663,Staff,32,0,75,43
1649890575246,CSE 140L,A01,083088,Eldon; John,25,0,75,50
1649890581268,CSE 175,A01,083665,Kumar; Rakesh,13,0,25,12
1649890587290,CSE 190,A00,092507,Dubnov; Shlomo,14,0,15,1
1649890593319,ECE 45,A01,083139,Staff,20,0,40,20
1649890599345,ECE 65,A50,083695,Staff,11,0,30,19
1649890605378,ECE 109,A01,091882,Touri; Behrouz,60,0,70,10
1649890611417,ECE 180,A00,083140,Abi Samra; Nicholas Camill,27,0,30,3
1649890611417,ECE 180,B00,083141,Abi Samra; Nicholas Camill,13,0,30,17
1649890617445,MATH 10A,A01,083735,Patchell; Gregory David,23,0,30,7
1649890617445,MATH 10A,A02,083736,Patchell; Gregory David,28,0,30,2
1649890617445,MATH 10A,A03,083737,Patchell; Gregory David,29,0,30,1
1649890623479,MATH 10B,A01,083207,Staff,15,0,30,15
1649890623479,MATH 10B,A02,083208,Staff,25,0,30,5
1649890623479,MATH 10B,B01,083739,Staff,25,0,30,5
1649890623479,MATH 10B,B02,083740,Staff,30,0,30,0
1649890629509,MATH 18,A01,083743,Staff,23,0,30,7
1649890629509,MATH 18,A02,083744,Staff,30,0,30,0
1649890629509,MATH 18,A03,083745,Staff,29,0,30,1
1649890629509,MATH 18,A04,083746,Staff,29,0,30,1
1649890629509,MATH 18,B01,083748,Staff,14,0,30,16
1649890629509,MATH 18,B02,083749,Staff,28,0,30,2
1649890629509,MATH 18,B03,083750,Staff,28,0,30,2
1649890629509,MATH 18,B04,083751,Staff,28,0,30,2
1649890635549,MATH 20A,A01,083754,Staff,38,0,40,2
1649890641573,MATH 20B,A01,083756,Staff,26,0,30,4
1649890641573,MATH 20B,A02,083757,Staff,30,0,30,0
1649890647601,MATH 20C,A01,083760,Staff,23,0,30,7
1649890647601,MATH 20C,A02,083761,Staff,25,0,30,5
1649890647601,MATH 20C,B01,083762,Staff,30,0,30,0
1649890647601,MATH 20C,B02,083763,Staff,30,0,30,0
1649890653630,MATH 20D,A01,083765,Staff,22,0,30,8
1649890653630,MATH 20D,A02,083766,Staff,30,0,30,0
1649890653630,MATH 20D,A03,083767,Staff,30,0,30,0
1649890659665,MATH 20E,A01,083771,Staff,17,0,30,13
1649890659665,MATH 20E,A02,083772,Staff,28,0,30,2
1649890659665,MATH 20E,B01,083773,Staff,24,0,30,6
1649890659665,MATH 20E,B02,083774,Staff,29,0,30,1
1649890665716,MATH 103A,A01,083777,Staff,0,0,30,30
1649890665716,MATH 103A,A02,083778,Staff,5,0,30,25
1649890665716,MATH 103A,B01,083779,Staff,7,0,30,23
1649890665716,MATH 103A,B02,083780,Staff,24,0,30,6
1649890671744,MATH 105,A01,085443,Staff,0,2,30,30
1649890677771,MATH 109,A01,083213,Anzaldo; Leesa B,22,0,30,8
1649890677771,MATH 109,A02,083214,Anzaldo; Leesa B,19,0,30,11
1649890677771,MATH 109,B01,083215,Anzaldo; Leesa B,26,0,30,4
1649890677771,MATH 109,B02,083216,Anzaldo; Leesa B,25,0,30,5
1649890683805,MATH 142A,A01,083219,Chow; Bennett,0,1,30,30
1649890683805,MATH 142A,A02,083220,Chow; Bennett,18,0,30,12
1649890683805,MATH 142A,B01,083221,Chow; Bennett,0,0,30,30
1649890683805,MATH 142A,B02,083222,Chow; Bennett,21,0,30,9
1649890689831,MATH 193A,A01,083224,Staff,0,3,30,30
1649890689831,MATH 193A,A02,083225,Staff,0,3,30,30
1649890689831,MATH 193A,A03,083781,Staff,16,0,30,14
1649890689831,MATH 193A,A04,083782,Staff,23,0,30,7
1649890695854,MATH 197,001,091859,McAuley; Julian John,9999,0,9999,0
1649890701917,COGS 9,A01,083615,Staff,31,0,60,29
1649890707940,COGS 11,A01,083617,Boyle; Mary E. T.,36,0,40,4
1649890713969,COGS 13,A01,083071,Staff,4,0,40,36
1649890720001,COGS 14A,A01,092681,Staff,83,0,100,17
1649890726034,COGS 14B,A01,083073,Cheng; Tzu-Han,30,0,50,20
1649890732060,COGS 17,A01,092677,Staff,67,0,75,8
1649890738086,COGS 100,A01,083619,Staff,14,0,60,46
1649890744119,COGS 101A,A01,083621,Davis; Joshua Daniel,15,0,60,45
1649890750143,COGS 101B,A01,091572,Staff,36,0,60,24
1649890756175,COGS 101C,A01,083625,Delgado; Tania,25,0,30,5
1649890762207,COGS 107A,A01,083627,Boyle; Mary E. T.,19,0,60,41
1649890768239,COGS 118A,A01,083075,Staff,26,0,60,34
1649890774263,CSE 3,A50,083646,Miranda; Gregory Joseph,28,0,38,10
1649890774263,CSE 3,A51,083647,Miranda; Gregory Joseph,37,0,37,0
1649890780287,CSE 8A,A50,083650,Miranda; Gregory Joseph,18,0,40,22
1649890786312,CSE 11,A01,083080,Cao; Yingjun,0,17,40,40
1649890792337,CSE 12,A01,083652,Staff,71,0,100,29
1649890798373,CSE 15L,A01,083654,Staff,28,0,50,22
1649890798373,CSE 15L,A02,083655,Staff,48,0,50,2
1649890804397,CSE 20,A01,083657,Staff,71,0,80,9
1649890810421,CSE 30,A01,083084,Eldon; John,1,4,40,39
1649890816461,CSE 100,A01,083659,Cao; Yingjun,2,14,50,48
1649890822484,CSE 134B,A01,083661,Powell; Thomas Allan,2,23,65,63
1649890828516,CSE 140,A01,083663,Staff,32,0,75,43
1649890834543,CSE 140L,A01,083088,Eldon; John,25,0,75,50
1649890840564,CSE 175,A01,083665,Kumar; Rakesh,13,0,25,12
1649890846592,CSE 190,A00,092507,Dubnov; Shlomo,14,0,15,1
1649890852631,ECE 45,A01,083139,Staff,20,0,40,20
1649890858665,ECE 65,A50,083695,Staff,11,0,30,19
1649890864693,ECE 109,A01,091882,Touri; Behrouz,60,0,70,10
1649890870717,ECE 180,A00,083140,Abi Samra; Nicholas Camill,27,0,30,3
1649890870717,ECE 180,B00,083141,Abi Samra; Nicholas Camill,13,0,30,17
1649890876740,MATH 10A,A01,083735,Patchell; Gregory David,23,0,30,7
1649890876740,MATH 10A,A02,083736,Patchell; Gregory David,28,0,30,2
1649890876740,MATH 10A,A03,083737,Patchell; Gregory David,29,0,30,1
1649890882772,MATH 10B,A01,083207,Staff,15,0,30,15
1649890882772,MATH 10B,A02,083208,Staff,25,0,30,5
1649890882772,MATH 10B,B01,083739,Staff,25,0,30,5
1649890882772,MATH 10B,B02,083740,Staff,30,0,30,0
1649890888800,MATH 18,A01,083743,Staff,23,0,30,7
1649890888800,MATH 18,A02,083744,Staff,30,0,30,0
1649890888800,MATH 18,A03,083745,Staff,29,0,30,1
1649890888800,MATH 18,A04,083746,Staff,29,0,30,1
1649890888800,MATH 18,B01,083748,Staff,14,0,30,16
1649890888800,MATH 18,B02,083749,Staff,28,0,30,2
1649890888800,MATH 18,B03,083750,Staff,28,0,30,2
1649890888800,MATH 18,B04,083751,Staff,28,0,30,2
1649890894824,MATH 20A,A01,083754,Staff,38,0,40,2
1649890900846,MATH 20B,A01,083756,Staff,26,0,30,4
1649890900846,MATH 20B,A02,083757,Staff,30,0,30,0
1649890906874,MATH 20C,A01,083760,Staff,23,0,30,7
1649890906874,MATH 20C,A02,083761,Staff,25,0,30,5
1649890906874,MATH 20C,B01,083762,Staff,30,0,30,0
1649890906874,MATH 20C,B02,083763,Staff,30,0,30,0
1649890912904,MATH 20D,A01,083765,Staff,22,0,30,8
1649890912904,MATH 20D,A02,083766,Staff,30,0,30,0
1649890912904,MATH 20D,A03,083767,Staff,30,0,30,0
1649890918930,MATH 20E,A01,083771,Staff,17,0,30,13
1649890918930,MATH 20E,A02,083772,Staff,28,0,30,2
1649890918930,MATH 20E,B01,083773,Staff,24,0,30,6
1649890918930,MATH 20E,B02,083774,Staff,29,0,30,1
1649890924956,MATH 103A,A01,083777,Staff,0,0,30,30
1649890924956,MATH 103A,A02,083778,Staff,5,0,30,25
1649890924956,MATH 103A,B01,083779,Staff,7,0,30,23
1649890924956,MATH 103A,B02,083780,Staff,24,0,30,6
1649890930983,MATH 105,A01,085443,Staff,0,2,30,30
1649890937087,MATH 109,A01,083213,Anzaldo; Leesa B,22,0,30,8
1649890937087,MATH 109,A02,083214,Anzaldo; Leesa B,19,0,30,11
1649890937087,MATH 109,B01,083215,Anzaldo; Leesa B,26,0,30,4
1649890937087,MATH 109,B02,083216,Anzaldo; Leesa B,25,0,30,5
1649890943110,MATH 142A,A01,083219,Chow; Bennett,0,1,30,30
1649890943110,MATH 142A,A02,083220,Chow; Bennett,19,0,30,11
1649890943110,MATH 142A,B01,083221,Chow; Bennett,0,0,30,30
1649890943110,MATH 142A,B02,083222,Chow; Bennett,19,0,30,11
1649890949133,MATH 193A,A01,083224,Staff,0,3,30,30
1649890949133,MATH 193A,A02,083225,Staff,0,3,30,30
1649890949133,MATH 193A,A03,083781,Staff,14,0,30,16
1649890949133,MATH 193A,A04,083782,Staff,23,0,30,7
1649890955154,MATH 197,001,091859,McAuley; Julian John,9999,0,9999,0
1649890961211,COGS 9,A01,083615,Staff,31,0,60,29
1649890967238,COGS 11,A01,083617,Boyle; Mary E. T.,36,0,40,4
1649890973260,COGS 13,A01,083071,Staff,4,0,40,36
1649890979290,COGS 14A,A01,092681,Staff,83,0,100,17
1649890985312,COGS 14B,A01,083073,Cheng; Tzu-Han,30,0,50,20
1649890991337,COGS 17,A01,092677,Staff,67,0,75,8
1649890997360,COGS 100,A01,083619,Staff,13,0,60,47
1649891003387,COGS 101A,A01,083621,Davis; Joshua Daniel,15,0,60,45
1649891009411,COGS 101B,A01,091572,Staff,36,0,60,24
1649891015437,COGS 101C,A01,083625,Delgado; Tania,25,0,30,5
1649891021458,COGS 107A,A01,083627,Boyle; Mary E. T.,18,0,60,42
1649891027482,COGS 118A,A01,083075,Staff,26,0,60,34
1649891033505,CSE 3,A50,083646,Miranda; Gregory Joseph,28,0,38,10
1649891033505,CSE 3,A51,083647,Miranda; Gregory Joseph,37,0,37,0
1649891039536,CSE 8A,A50,083650,Miranda; Gregory Joseph,18,0,40,22
1649891045562,CSE 11,A01,083080,Cao; Yingjun,0,17,40,40
1649891051586,CSE 12,A01,083652,Staff,71,0,100,29
1649891057612,CSE 15L,A01,083654,Staff,28,0,50,22
1649891057612,CSE 15L,A02,083655,Staff,48,0,50,2
1649891063639,CSE 20,A01,083657,Staff,71,0,80,9
1649891069670,CSE 30,A01,083084,Eldon; John,1,6,40,39
1649891075692,CSE 100,A01,083659,Cao; Yingjun,2,14,50,48
1649891081718,CSE 134B,A01,083661,Powell; Thomas Allan,2,23,65,63
1649891087742,CSE 140,A01,083663,Staff,32,0,75,43
1649891093768,CSE 140L,A01,083088,Eldon; John,25,0,75,50
1649891099793,CSE 175,A01,083665,Kumar; Rakesh,13,0,25,12
1649891105817,CSE 190,A00,092507,Dubnov; Shlomo,14,0,15,1
1649891111841,ECE 45,A01,083139,Staff,20,0,40,20
1649891117865,ECE 65,A50,083695,Staff,11,0,30,19
1649891123889,ECE 109,A01,091882,Touri; Behrouz,60,0,70,10
1649891129913,ECE 180,A00,083140,Abi Samra; Nicholas Camill,27,0,30,3
1649891129913,ECE 180,B00,083141,Abi Samra; Nicholas Camill,13,0,30,17
1649891135937,MATH 10A,A01,083735,Patchell; Gregory David,23,0,30,7
1649891135937,MATH 10A,A02,083736,Patchell; Gregory David,28,0,30,2
1649891135937,MATH 10A,A03,083737,Patchell; Gregory David,29,0,30,1
1649891141970,MATH 10B,A01,083207,Staff,15,0,30,15
1649891141970,MATH 10B,A02,083208,Staff,25,0,30,5
1649891141970,MATH 10B,B01,083739,Staff,25,0,30,5
1649891141970,MATH 10B,B02,083740,Staff,30,0,30,0
1649891148001,MATH 18,A01,083743,Staff,23,0,30,7
1649891148001,MATH 18,A02,083744,Staff,30,0,30,0
1649891148001,MATH 18,A03,083745,Staff,29,0,30,1
1649891148001,MATH 18,A04,083746,Staff,29,0,30,1
1649891148001,MATH 18,B01,083748,Staff,14,0,30,16
1649891148001,MATH 18,B02,083749,Staff,28,0,30,2
1649891148001,MATH 18,B03,083750,Staff,28,0,30,2
1649891148001,MATH 18,B04,083751,Staff,28,0,30,2
1649891154026,MATH 20A,A01,083754,Staff,38,0,40,2
1649891160052,MATH 20B,A01,083756,Staff,26,0,30,4
1649891160052,MATH 20B,A02,083757,Staff,30,0,30,0
1649891166074,MATH 20C,A01,083760,Staff,23,0,30,7
1649891166074,MATH 20C,A02,083761,Staff,25,0,30,5
1649891166074,MATH 20C,B01,083762,Staff,30,0,30,0
1649891166074,MATH 20C,B02,083763,Staff,30,0,30,0
1649891172097,MATH 20D,A01,083765,Staff,22,0,30,8
1649891172097,MATH 20D,A02,083766,Staff,30,0,30,0
1649891172097,MATH 20D,A03,083767,Staff,30,0,30,0
1649891178131,MATH 20E,A01,083771,Staff,17,0,30,13
1649891178131,MATH 20E,A02,083772,Staff,27,0,30,3
1649891178131,MATH 20E,B01,083773,Staff,24,0,30,6
1649891178131,MATH 20E,B02,083774,Staff,29,0,30,1
1649891184157,MATH 103A,A01,083777,Staff,0,0,30,30
1649891184157,MATH 103A,A02,083778,Staff,4,0,30,26
1649891184157,MATH 103A,B01,083779,Staff,7,0,30,23
1649891184157,MATH 103A,B02,083780,Staff,24,0,30,6
1649891190180,MATH 105,A01,085443,Staff,0,2,30,30
1649891196204,MATH 109,A01,083213,Anzaldo; Leesa B,22,0,30,8
1649891196204,MATH 109,A02,083214,Anzaldo; Leesa B,18,0,30,12
1649891196204,MATH 109,B01,083215,Anzaldo; Leesa B,26,0,30,4
1649891196204,MATH 109,B02,083216,Anzaldo; Leesa B,25,0,30,5
1649891202230,MATH 142A,A01,083219,Chow; Bennett,0,1,30,30
1649891202230,MATH 142A,A02,083220,Chow; Bennett,19,0,30,11
1649891202230,MATH 142A,B01,083221,Chow; Bennett,0,0,30,30
1649891202230,MATH 142A,B02,083222,Chow; Bennett,19,0,30,11
1649891208271,MATH 193A,A01,083224,Staff,0,2,30,30
1649891208271,MATH 193A,A02,083225,Staff,0,3,30,30
1649891208271,MATH 193A,A03,083781,Staff,13,0,30,17
1649891208271,MATH 193A,A04,083782,Staff,23,0,30,7
1649891214307,MATH 197,001,091859,McAuley; Julian John,9999,0,9999,0
1649891220369,COGS 9,A01,083615,Staff,31,0,60,29
1649891226401,COGS 11,A01,083617,Boyle; Mary E. T.,36,0,40,4
1649891232423,COGS 13,A01,083071,Staff,4,0,40,36
1649891238447,COGS 14A,A01,092681,Staff,83,0,100,17
1649891244474,COGS 14B,A01,083073,Cheng; Tzu-Han,30,0,50,20
1649891250497,COGS 17,A01,092677,Staff,67,0,75,8
1649891256520,COGS 100,A01,083619,Staff,13,0,60,47
1649891262549,COGS 101A,A01,083621,Davis; Joshua Daniel,15,0,60,45
1649891268571,COGS 101B,A01,091572,Staff,36,0,60,24
1649891274594,COGS 101C,A01,083625,Delgado; Tania,25,0,30,5
1649891280624,COGS 107A,A01,083627,Boyle; Mary E. T.,18,0,60,42
1649891286649,COGS 118A,A01,083075,Staff,26,0,60,34
1649891292682,CSE 3,A50,083646,Miranda; Gregory Joseph,28,0,38,10
1649891292682,CSE 3,A51,083647,Miranda; Gregory Joseph,37,0,37,0
1649891298709,CSE 8A,A50,083650,Miranda; Gregory Joseph,18,0,40,22
1649891304735,CSE 11,A01,083080,Cao; Yingjun,0,17,40,40
1649891310761,CSE 12,A01,083652,Staff,70,0,100,30
1649891316785,CSE 15L,A01,083654,Staff,28,0,50,22
1649891316785,CSE 15L,A02,083655,Staff,48,0,50,2
1649891322817,CSE 20,A01,083657,Staff,71,0,80,9
1649891328841,CSE 30,A01,083084,Eldon; John,1,6,40,39
1649891334875,CSE 100,A01,083659,Cao; Yingjun,2,14,50,48
1649891340902,CSE 134B,A01,083661,Powell; Thomas Allan,2,23,65,63
1649891346928,CSE 140,A01,083663,Staff,32,0,75,43
1649891352954,CSE 140L,A01,083088,Eldon; John,25,0,75,50
1649891358980,CSE 175,A01,083665,Kumar; Rakesh,13,0,25,12
1649891365005,CSE 190,A00,092507,Dubnov; Shlomo,14,0,15,1
1649891371026,ECE 45,A01,083139,Staff,20,0,40,20
1649891377048,ECE 65,A50,083695,Staff,11,0,30,19
1649891383074,ECE 109,A01,091882,Touri; Behrouz,60,0,70,10
1649891389097,ECE 180,A00,083140,Abi Samra; Nicholas Camill,27,0,30,3
1649891389097,ECE 180,B00,083141,Abi Samra; Nicholas Camill,13,0,30,17
1649891395128,MATH 10A,A01,083735,Patchell; Gregory David,23,0,30,7
1649891395128,MATH 10A,A02,083736,Patchell; Gregory David,28,0,30,2
1649891395128,MATH 10A,A03,083737,Patchell; Gregory David,29,0,30,1
1649891401156,MATH 10B,A01,083207,Staff,15,0,30,15
1649891401156,MATH 10B,A02,083208,Staff,25,0,30,5
1649891401156,MATH 10B,B01,083739,Staff,25,0,30,5
1649891401156,MATH 10B,B02,083740,Staff,30,0,30,0
1649891407186,MATH 18,A01,083743,Staff,23,0,30,7
1649891407186,MATH 18,A02,083744,Staff,30,0,30,0
1649891407186,MATH 18,A03,083745,Staff,29,0,30,1
1649891407186,MATH 18,A04,083746,Staff,29,0,30,1
1649891407186,MATH 18,B01,083748,Staff,14,0,30,16
1649891407186,MATH 18,B02,083749,Staff,28,0,30,2
1649891407186,MATH 18,B03,083750,Staff,28,0,30,2
1649891407186,MATH 18,B04,083751,Staff,28,0,30,2
1649891413210,MATH 20A,A01,083754,Staff,38,0,40,2
1649891419238,MATH 20B,A01,083756,Staff,26,0,30,4
1649891419238,MATH 20B,A02,083757,Staff,30,0,30,0
1649891425265,MATH 20C,A01,083760,Staff,23,0,30,7
1649891425265,MATH 20C,A02,083761,Staff,25,0,30,5
1649891425265,MATH 20C,B01,083762,Staff,29,0,30,1
1649891425265,MATH 20C,B02,083763,Staff,30,0,30,0
1649891431294,MATH 20D,A01,083765,Staff,22,0,30,8
1649891431294,MATH 20D,A02,083766,Staff,30,0,30,0
1649891431294,MATH 20D,A03,083767,Staff,30,0,30,0
1649891437320,MATH 20E,A01,083771,Staff,17,0,30,13
1649891437320,MATH 20E,A02,083772,Staff,27,0,30,3
1649891437320,MATH 20E,B01,083773,Staff,24,0,30,6
1649891437320,MATH 20E,B02,083774,Staff,29,0,30,1
1649891443356,MATH 103A,A01,083777,Staff,0,0,30,30
1649891443356,MATH 103A,A02,083778,Staff,4,0,30,26
1649891443356,MATH 103A,B01,083779,Staff,7,0,30,23
1649891443356,MATH 103A,B02,083780,Staff,24,0,30,6
1649891449384,MATH 105,A01,085443,Staff,0,2,30,30
1649891455411,MATH 109,A01,083213,Anzaldo; Leesa B,21,0,30,9
1649891455411,MATH 109,A02,083214,Anzaldo; Leesa B,18,0,30,12
1649891455411,MATH 109,B01,083215,Anzaldo; Leesa B,26,0,30,4
1649891455411,MATH 109,B02,083216,Anzaldo; Leesa B,25,0,30,5
1649891461439,MATH 142A,A01,083219,Chow; Bennett,0,1,30,30
1649891461439,MATH 142A,A02,083220,Chow; Bennett,19,0,30,11
1649891461439,MATH 142A,B01,083221,Chow; Bennett,0,0,30,30
1649891461439,MATH 142A,B02,083222,Chow; Bennett,19,0,30,11
1649891467463,MATH 193A,A01,083224,Staff,0,2,30,30
1649891467463,MATH 193A,A02,083225,Staff,0,3,30,30
1649891467463,MATH 193A,A03,083781,Staff,13,0,30,17
1649891467463,MATH 193A,A04,083782,Staff,23,0,30,7
1649891473487,MATH 197,001,091859,McAuley; Julian John,9999,0,9999,0
1649891479550,COGS 9,A01,083615,Staff,31,0,60,29
1649891485582,COGS 11,A01,083617,Boyle; Mary E. T.,36,0,40,4
1649891491610,COGS 13,A01,083071,Staff,4,0,40,36
1649891497633,COGS 14A,A01,092681,Staff,83,0,100,17
1649891503665,COGS 14B,A01,083073,Cheng; Tzu-Han,30,0,50,20
1649891509690,COGS 17,A01,092677,Staff,67,0,75,8
1649891515713,COGS 100,A01,083619,Staff,13,0,60,47
1649891521737,COGS 101A,A01,083621,Davis; Joshua Daniel,15,0,60,45
1649891527855,COGS 101B,A01,091572,Staff,36,0,60,24
1649891533891,COGS 101C,A01,083625,Delgado; Tania,25,0,30,5
1649891539913,COGS 107A,A01,083627,Boyle; Mary E. T.,18,0,60,42
1649891545939,COGS 118A,A01,083075,Staff,26,0,60,34
1649891551966,CSE 3,A50,083646,Miranda; Gregory Joseph,28,0,38,10
1649891551966,CSE 3,A51,083647,Miranda; Gregory Joseph,37,0,37,0
1649891557992,CSE 8A,A50,083650,Miranda; Gregory Joseph,17,0,40,23
1649891564017,CSE 11,A01,083080,Cao; Yingjun,0,20,40,40
1649891570040,CSE 12,A01,083652,Staff,70,0,100,30
1649891576064,CSE 15L,A01,083654,Staff,28,0,50,22
1649891576064,CSE 15L,A02,083655,Staff,48,0,50,2
1649891582092,CSE 20,A01,083657,Staff,71,0,80,9
1649891588113,CSE 30,A01,083084,Eldon; John,1,6,40,39
1649891594152,CSE 100,A01,083659,Cao; Yingjun,2,14,50,48
1649891600173,CSE 134B,A01,083661,Powell; Thomas Allan,2,23,65,63
1649891606196,CSE 140,A01,083663,Staff,32,0,75,43
1649891612221,CSE 140L,A01,083088,Eldon; John,25,0,75,50
1649891618254,CSE 175,A01,083665,Kumar; Rakesh,13,0,25,12
1649891624278,CSE 190,A00,092507,Dubnov; Shlomo,14,0,15,1
1649891630305,ECE 45,A01,083139,Staff,19,0,40,21
1649891636331,ECE 65,A50,083695,Staff,11,0,30,19
1649891642369,ECE 109,A01,091882,Touri; Behrouz,60,0,70,10
1649891648393,ECE 180,A00,083140,Abi Samra; Nicholas Camill,27,0,30,3
1649891648393,ECE 180,B00,083141,Abi Samra; Nicholas Camill,13,0,30,17
1649891654416,MATH 10A,A01,083735,Patchell; Gregory David,23,0,30,7
1649891654416,MATH 10A,A02,083736,Patchell; Gregory David,28,0,30,2
1649891654416,MATH 10A,A03,083737,Patchell; Gregory David,29,0,30,1
1649891660439,MATH 10B,A01,083207,Staff,15,0,30,15
1649891660439,MATH 10B,A02,083208,Staff,25,0,30,5
1649891660439,MATH 10B,B01,083739,Staff,25,0,30,5
1649891660439,MATH 10B,B02,083740,Staff,30,0,30,0
1649891666470,MATH 18,A01,083743,Staff,22,0,30,8
1649891666470,MATH 18,A02,083744,Staff,30,0,30,0
1649891666470,MATH 18,A03,083745,Staff,29,0,30,1
1649891666470,MATH 18,A04,083746,Staff,29,0,30,1
1649891666470,MATH 18,B01,083748,Staff,14,0,30,16
1649891666470,MATH 18,B02,083749,Staff,28,0,30,2
1649891666470,MATH 18,B03,083750,Staff,28,0,30,2
1649891666470,MATH 18,B04,083751,Staff,28,0,30,2
1649891672495,MATH 20A,A01,083754,Staff,38,0,40,2
1649891678523,MATH 20B,A01,083756,Staff,26,0,30,4
1649891678523,MATH 20B,A02,083757,Staff,30,0,30,0
1649891684548,MATH 20C,A01,083760,Staff,23,0,30,7
1649891684548,MATH 20C,A02,083761,Staff,25,0,30,5
1649891684548,MATH 20C,B01,083762,Staff,29,0,30,1
1649891684548,MATH 20C,B02,083763,Staff,30,0,30,0
1649891690574,MATH 20D,A01,083765,Staff,22,0,30,8
1649891690574,MATH 20D,A02,083766,Staff,30,0,30,0
1649891690574,MATH 20D,A03,083767,Staff,30,0,30,0
1649891696600,MATH 20E,A01,083771,Staff,17,0,30,13
1649891696600,MATH 20E,A02,083772,Staff,27,0,30,3
1649891696600,MATH 20E,B01,083773,Staff,24,0,30,6
1649891696600,MATH 20E,B02,083774,Staff,29,0,30,1
1649891702623,MATH 103A,A01,083777,Staff,0,0,30,30
1649891702623,MATH 103A,A02,083778,Staff,4,0,30,26
1649891702623,MATH 103A,B01,083779,Staff,7,0,30,23
1649891702623,MATH 103A,B02,083780,Staff,24,0,30,6
1649891708660,MATH 105,A01,085443,Staff,0,2,30,30
1649891714687,MATH 109,A01,083213,Anzaldo; Leesa B,21,0,30,9
1649891714687,MATH 109,A02,083214,Anzaldo; Leesa B,18,0,30,12
1649891714687,MATH 109,B01,083215,Anzaldo; Leesa B,26,0,30,4
1649891714687,MATH 109,B02,083216,Anzaldo; Leesa B,25,0,30,5
1649891720716,MATH 142A,A01,083219,Chow; Bennett,0,1,30,30
1649891720716,MATH 142A,A02,083220,Chow; Bennett,19,0,30,11
1649891720716,MATH 142A,B01,083221,Chow; Bennett,0,0,30,30
1649891720716,MATH 142A,B02,083222,Chow; Bennett,18,0,30,12
1649891726746,MATH 193A,A01,083224,Staff,0,2,30,30
1649891726746,MATH 193A,A02,083225,Staff,0,3,30,30
1649891726746,MATH 193A,A03,083781,Staff,13,0,30,17
1649891726746,MATH 193A,A04,083782,Staff,23,0,30,7
1649891732781,MATH 197,001,091859,McAuley; Julian John,9999,0,9999,0
1649891738853,COGS 9,A01,083615,Staff,31,0,60,29
1649891744882,COGS 11,A01,083617,Boyle; Mary E. T.,36,0,40,4
1649891750908,COGS 13,A01,083071,Staff,4,0,40,36
1649891756935,COGS 14A,A01,092681,Staff,83,0,100,17
1649891762964,COGS 14B,A01,083073,Cheng; Tzu-Han,30,0,50,20
1649891768992,COGS 17,A01,092677,Staff,66,0,75,9
1649891775030,COGS 100,A01,083619,Staff,13,0,60,47
1649891781056,COGS 101A,A01,083621,Davis; Joshua Daniel,15,0,60,45
1649891787092,COGS 101B,A01,091572,Staff,36,0,60,24
1649891793116,COGS 101C,A01,083625,Delgado; Tania,25,0,30,5
1649891799142,COGS 107A,A01,083627,Boyle; Mary E. T.,18,0,60,42
1649891805164,COGS 118A,A01,083075,Staff,26,0,60,34
1649891811192,CSE 3,A50,083646,Miranda; Gregory Joseph,28,0,38,10
1649891811192,CSE 3,A51,083647,Miranda; Gregory Joseph,37,0,37,0
1649891817215,CSE 8A,A50,083650,Miranda; Gregory Joseph,16,0,40,24
1649891823239,CSE 11,A01,083080,Cao; Yingjun,0,20,40,40
1649891829264,CSE 12,A01,083652,Staff,70,0,100,30
1649891835300,CSE 15L,A01,083654,Staff,28,0,50,22
1649891835300,CSE 15L,A02,083655,Staff,48,0,50,2
1649891841329,CSE 20,A01,083657,Staff,71,0,80,9
1649891847360,CSE 30,A01,083084,Eldon; John,1,6,40,39
1649891853407,CSE 100,A01,083659,Cao; Yingjun,2,14,50,48
1649891859431,CSE 134B,A01,083661,Powell; Thomas Allan,2,24,65,63
1649891865461,CSE 140,A01,083663,Staff,32,0,75,43
1649891871485,CSE 140L,A01,083088,Eldon; John,25,0,75,50
1649891877508,CSE 175,A01,083665,Kumar; Rakesh,13,0,25,12
1649891883568,CSE 190,A00,092507,Dubnov; Shlomo,14,0,15,1
1649891889599,ECE 45,A01,083139,Staff,19,0,40,21
1649891895623,ECE 65,A50,083695,Staff,11,0,30,19
1649891901647,ECE 109,A01,091882,Touri; Behrouz,60,0,70,10
1649891907672,ECE 180,A00,083140,Abi Samra; Nicholas Camill,27,0,30,3
1649891907672,ECE 180,B00,083141,Abi Samra; Nicholas Camill,13,0,30,17
1649891913710,MATH 10A,A01,083735,Patchell; Gregory David,23,0,30,7
1649891913710,MATH 10A,A02,083736,Patchell; Gregory David,28,0,30,2
1649891913710,MATH 10A,A03,083737,Patchell; Gregory David,29,0,30,1
1649891919737,MATH 10B,A01,083207,Staff,15,0,30,15
1649891919737,MATH 10B,A02,083208,Staff,25,0,30,5
1649891919737,MATH 10B,B01,083739,Staff,25,0,30,5
1649891919737,MATH 10B,B02,083740,Staff,30,0,30,0
1649891925769,MATH 18,A01,083743,Staff,22,0,30,8
1649891925769,MATH 18,A02,083744,Staff,30,0,30,0
1649891925769,MATH 18,A03,083745,Staff,29,0,30,1
1649891925769,MATH 18,A04,083746,Staff,29,0,30,1
1649891925769,MATH 18,B01,083748,Staff,14,0,30,16
1649891925769,MATH 18,B02,083749,Staff,28,0,30,2
1649891925769,MATH 18,B03,083750,Staff,28,0,30,2
1649891925769,MATH 18,B04,083751,Staff,28,0,30,2
1649891931793,MATH 20A,A01,083754,Staff,38,0,40,2
1649891937818,MATH 20B,A01,083756,Staff,26,0,30,4
1649891937818,MATH 20B,A02,083757,Staff,30,0,30,0
1649891943850,MATH 20C,A01,083760,Staff,23,0,30,7
1649891943850,MATH 20C,A02,083761,Staff,25,0,30,5
1649891943850,MATH 20C,B01,083762,Staff,29,0,30,1
1649891943850,MATH 20C,B02,083763,Staff,30,0,30,0
1649891949874,MATH 20D,A01,083765,Staff,22,0,30,8
1649891949874,MATH 20D,A02,083766,Staff,30,0,30,0
1649891949874,MATH 20D,A03,083767,Staff,30,0,30,0
1649891955907,MATH 20E,A01,083771,Staff,17,0,30,13
1649891955907,MATH 20E,A02,083772,Staff,27,0,30,3
1649891955907,MATH 20E,B01,083773,Staff,24,0,30,6
1649891955907,MATH 20E,B02,083774,Staff,29,0,30,1
1649891961932,MATH 103A,A01,083777,Staff,0,0,30,30
1649891961932,MATH 103A,A02,083778,Staff,4,0,30,26
1649891961932,MATH 103A,B01,083779,Staff,7,0,30,23
1649891961932,MATH 103A,B02,083780,Staff,24,0,30,6
1649891967956,MATH 105,A01,085443,Staff,0,2,30,30
1649891973985,MATH 109,A01,083213,Anzaldo; Leesa B,21,0,30,9
1649891973985,MATH 109,A02,083214,Anzaldo; Leesa B,18,0,30,12
1649891973985,MATH 109,B01,083215,Anzaldo; Leesa B,26,0,30,4
1649891973985,MATH 109,B02,083216,Anzaldo; Leesa B,25,0,30,5
1649891980011,MATH 142A,A01,083219,Chow; Bennett,0,1,30,30
1649891980011,MATH 142A,A02,083220,Chow; Bennett,19,0,30,11
1649891980011,MATH 142A,B01,083221,Chow; Bennett,0,0,30,30
1649891980011,MATH 142A,B02,083222,Chow; Bennett,18,0,30,12
1649891986043,MATH 193A,A01,083224,Staff,0,2,30,30
1649891986043,MATH 193A,A02,083225,Staff,0,3,30,30
1649891986043,MATH 193A,A03,083781,Staff,13,0,30,17
1649891986043,MATH 193A,A04,083782,Staff,23,0,30,7
1649891992067,MATH 197,001,091859,McAuley; Julian John,9999,0,9999,0
1649891998119,COGS 9,A01,083615,Staff,31,0,60,29
1649892004145,COGS 11,A01,083617,Boyle; Mary E. T.,36,0,40,4
1649892010174,COGS 13,A01,083071,Staff,4,0,40,36
1649892016199,COGS 14A,A01,092681,Staff,83,0,100,17
1649892022231,COGS 14B,A01,083073,Cheng; Tzu-Han,30,0,50,20
1649892028256,COGS 17,A01,092677,Staff,66,0,75,9
1649892034280,COGS 100,A01,083619,Staff,13,0,60,47
1649892049035,COGS 101A,A01,083621,Davis; Joshua Daniel,15,0,60,45
1649892055058,COGS 101B,A01,091572,Staff,36,0,60,24
1649892061084,COGS 101C,A01,083625,Delgado; Tania,25,0,30,5
1649892067108,COGS 107A,A01,083627,Boyle; Mary E. T.,18,0,60,42
1649892073131,COGS 118A,A01,083075,Staff,26,0,60,34
1649892079168,CSE 3,A50,083646,Miranda; Gregory Joseph,28,0,38,10
1649892079168,CSE 3,A51,083647,Miranda; Gregory Joseph,37,0,37,0
1649892085195,CSE 8A,A50,083650,Miranda; Gregory Joseph,16,0,40,24
1649892091219,CSE 11,A01,083080,Cao; Yingjun,0,19,40,40
1649892097242,CSE 12,A01,083652,Staff,70,0,100,30
1649892103266,CSE 15L,A01,083654,Staff,28,0,50,22
1649892103266,CSE 15L,A02,083655,Staff,48,0,50,2
1649892109301,CSE 20,A01,083657,Staff,71,0,80,9
1649892115328,CSE 30,A01,083084,Eldon; John,1,6,40,39
1649892121352,CSE 100,A01,083659,Cao; Yingjun,2,14,50,48
1649892127388,CSE 134B,A01,083661,Powell; Thomas Allan,2,24,65,63
1649892133502,CSE 140,A01,083663,Staff,32,0,75,43
1649892139525,CSE 140L,A01,083088,Eldon; John,25,0,75,50
1649892145552,CSE 175,A01,083665,Kumar; Rakesh,13,0,25,12
1649892151575,CSE 190,A00,092507,Dubnov; Shlomo,14,0,15,1
1649892157600,ECE 45,A01,083139,Staff,18,0,40,22
1649892163622,ECE 65,A50,083695,Staff,11,0,30,19
1649892169645,ECE 109,A01,091882,Touri; Behrouz,59,0,70,11
1649892175669,ECE 180,A00,083140,Abi Samra; Nicholas Camill,27,0,30,3
1649892175669,ECE 180,B00,083141,Abi Samra; Nicholas Camill,13,0,30,17
1649892181709,MATH 10A,A01,083735,Patchell; Gregory David,23,0,30,7
1649892181709,MATH 10A,A02,083736,Patchell; Gregory David,28,0,30,2
1649892181709,MATH 10A,A03,083737,Patchell; Gregory David,29,0,30,1
1649892187738,MATH 10B,A01,083207,Staff,15,0,30,15
1649892187738,MATH 10B,A02,083208,Staff,25,0,30,5
1649892187738,MATH 10B,B01,083739,Staff,25,0,30,5
1649892187738,MATH 10B,B02,083740,Staff,30,0,30,0
1649892193764,MATH 18,A01,083743,Staff,22,0,30,8
1649892193764,MATH 18,A02,083744,Staff,30,0,30,0
1649892193764,MATH 18,A03,083745,Staff,29,0,30,1
1649892193764,MATH 18,A04,083746,Staff,29,0,30,1
1649892193764,MATH 18,B01,083748,Staff,14,0,30,16
1649892193764,MATH 18,B02,083749,Staff,28,0,30,2
1649892193764,MATH 18,B03,083750,Staff,28,0,30,2
1649892193764,MATH 18,B04,083751,Staff,28,0,30,2
1649892199785,MATH 20A,A01,083754,Staff,38,0,40,2
1649892205816,MATH 20B,A01,083756,Staff,26,0,30,4
1649892205816,MATH 20B,A02,083757,Staff,30,0,30,0
1649892211842,MATH 20C,A01,083760,Staff,23,0,30,7
1649892211842,MATH 20C,A02,083761,Staff,25,0,30,5
1649892211842,MATH 20C,B01,083762,Staff,29,0,30,1
1649892211842,MATH 20C,B02,083763,Staff,30,0,30,0
1649892217867,MATH 20D,A01,083765,Staff,22,0,30,8
1649892217867,MATH 20D,A02,083766,Staff,30,0,30,0
1649892217867,MATH 20D,A03,083767,Staff,30,0,30,0
1649892223898,MATH 20E,A01,083771,Staff,17,0,30,13
1649892223898,MATH 20E,A02,083772,Staff,27,0,30,3
1649892223898,MATH 20E,B01,083773,Staff,24,0,30,6
1649892223898,MATH 20E,B02,083774,Staff,29,0,30,1
1649892229930,MATH 103A,A01,083777,Staff,0,0,30,30
1649892229930,MATH 103A,A02,083778,Staff,4,0,30,26
1649892229930,MATH 103A,B01,083779,Staff,7,0,30,23
1649892229930,MATH 103A,B02,083780,Staff,24,0,30,6
1649892235965,MATH 105,A01,085443,Staff,0,2,30,30
1649892241996,MATH 109,A01,083213,Anzaldo; Leesa B,21,0,30,9
1649892241996,MATH 109,A02,083214,Anzaldo; Leesa B,17,0,30,13
1649892241996,MATH 109,B01,083215,Anzaldo; Leesa B,25,0,30,5
1649892241996,MATH 109,B02,083216,Anzaldo; Leesa B,25,0,30,5
1649892248028,MATH 142A,A01,083219,Chow; Bennett,0,1,30,30
1649892248028,MATH 142A,A02,083220,Chow; Bennett,19,0,30,11
1649892248028,MATH 142A,B01,083221,Chow; Bennett,0,0,30,30
1649892248028,MATH 142A,B02,083222,Chow; Bennett,18,0,30,12
1649892254054,MATH 193A,A01,083224,Staff,0,2,30,30
1649892254054,MATH 193A,A02,083225,Staff,0,3,30,30
1649892254054,MATH 193A,A03,083781,Staff,13,0,30,17
1649892254054,MATH 193A,A04,083782,Staff,23,0,30,7
1649892260087,MATH 197,001,091859,McAuley; Julian John,9999,0,9999,0
1649892266147,COGS 9,A01,083615,Staff,31,0,60,29
1649892272172,COGS 11,A01,083617,Boyle; Mary E. T.,36,0,40,4
1649892278198,COGS 13,A01,083071,Staff,4,0,40,36
1649892284237,COGS 14A,A01,092681,Staff,83,0,100,17
1649892290261,COGS 14B,A01,083073,Cheng; Tzu-Han,30,0,50,20
1649892296287,COGS 17,A01,092677,Staff,66,0,75,9
1649892302317,COGS 100,A01,083619,Staff,15,0,60,45
1649892308347,COGS 101A,A01,083621,Davis; Joshua Daniel,15,0,60,45
1649892314369,COGS 101B,A01,091572,Staff,36,0,60,24
1649892320399,COGS 101C,A01,083625,Delgado; Tania,25,0,30,5
1649892326425,COGS 107A,A01,083627,Boyle; Mary E. T.,18,0,60,42
1649892332453,COGS 118A,A01,083075,Staff,26,0,60,34
1649892338480,CSE 3,A50,083646,Miranda; Gregory Joseph,28,0,38,10
1649892338480,CSE 3,A51,083647,Miranda; Gregory Joseph,37,0,37,0
1649892344504,CSE 8A,A50,083650,Miranda; Gregory Joseph,17,0,40,23
1649892350536,CSE 11,A01,083080,Cao; Yingjun,0,19,40,40
1649892356561,CSE 12,A01,083652,Staff,70,0,100,30
1649892362585,CSE 15L,A01,083654,Staff,28,0,50,22
1649892362585,CSE 15L,A02,083655,Staff,48,0,50,2
1649892368619,CSE 20,A01,083657,Staff,71,0,80,9
1649892374646,CSE 30,A01,083084,Eldon; John,1,6,40,39
1649892380679,CSE 100,A01,083659,Cao; Yingjun,2,14,50,48
1649892386702,CSE 134B,A01,083661,Powell; Thomas Allan,2,24,65,63
1649892392729,CSE 140,A01,083663,Staff,32,0,75,43
1649892398758,CSE 140L,A01,083088,Eldon; John,25,0,75,50
1649892404793,CSE 175,A01,083665,Kumar; Rakesh,13,0,25,12
1649892410817,CSE 190,A00,092507,Dubnov; Shlomo,14,0,15,1
1649892416840,ECE 45,A01,083139,Staff,18,0,40,22
1649892422871,ECE 65,A50,083695,Staff,11,0,30,19
1649892428900,ECE 109,A01,091882,Touri; Behrouz,59,0,70,11
1649892434929,ECE 180,A00,083140,Abi Samra; Nicholas Camill,27,0,30,3
1649892434929,ECE 180,B00,083141,Abi Samra; Nicholas Camill,13,0,30,17
1649892440951,MATH 10A,A01,083735,Patchell; Gregory David,23,0,30,7
1649892440951,MATH 10A,A02,083736,Patchell; Gregory David,28,0,30,2
1649892440951,MATH 10A,A03,083737,Patchell; Gregory David,29,0,30,1
1649892446975,MATH 10B,A01,083207,Staff,15,0,30,15
1649892446975,MATH 10B,A02,083208,Staff,25,0,30,5
1649892446975,MATH 10B,B01,083739,Staff,25,0,30,5
1649892446975,MATH 10B,B02,083740,Staff,30,0,30,0
1649892453000,MATH 18,A01,083743,Staff,22,0,30,8
1649892453000,MATH 18,A02,083744,Staff,30,0,30,0
1649892453000,MATH 18,A03,083745,Staff,29,0,30,1
1649892453000,MATH 18,A04,083746,Staff,29,0,30,1
1649892453000,MATH 18,B01,083748,Staff,13,0,30,17
1649892453000,MATH 18,B02,083749,Staff,28,0,30,2
1649892453000,MATH 18,B03,083750,Staff,28,0,30,2
1649892453000,MATH 18,B04,083751,Staff,28,0,30,2
1649892459036,MATH 20A,A01,083754,Staff,38,0,40,2
1649892465059,MATH 20B,A01,083756,Staff,26,0,30,4
1649892465059,MATH 20B,A02,083757,Staff,30,0,30,0
1649892471088,MATH 20C,A01,083760,Staff,23,0,30,7
1649892471088,MATH 20C,A02,083761,Staff,25,0,30,5
1649892471088,MATH 20C,B01,083762,Staff,29,0,30,1
1649892471088,MATH 20C,B02,083763,Staff,30,0,30,0
1649892477122,MATH 20D,A01,083765,Staff,22,0,30,8
1649892477122,MATH 20D,A02,083766,Staff,30,0,30,0
1649892477122,MATH 20D,A03,083767,Staff,30,0,30,0
1649892483154,MATH 20E,A01,083771,Staff,17,0,30,13
1649892483154,MATH 20E,A02,083772,Staff,27,0,30,3
1649892483154,MATH 20E,B01,083773,Staff,24,0,30,6
1649892483154,MATH 20E,B02,083774,Staff,29,0,30,1
1649892489179,MATH 103A,A01,083777,Staff,0,0,30,30
1649892489179,MATH 103A,A02,083778,Staff,4,0,30,26
1649892489179,MATH 103A,B01,083779,Staff,7,0,30,23
1649892489179,MATH 103A,B02,083780,Staff,24,0,30,6
1649892495203,MATH 105,A01,085443,Staff,0,2,30,30
1649892501226,MATH 109,A01,083213,Anzaldo; Leesa B,21,0,30,9
1649892501226,MATH 109,A02,083214,Anzaldo; Leesa B,17,0,30,13
1649892501226,MATH 109,B01,083215,Anzaldo; Leesa B,25,0,30,5
1649892501226,MATH 109,B02,083216,Anzaldo; Leesa B,25,0,30,5
1649892507255,MATH 142A,A01,083219,Chow; Bennett,0,1,30,30
1649892507255,MATH 142A,A02,083220,Chow; Bennett,19,0,30,11
1649892507255,MATH 142A,B01,083221,Chow; Bennett,0,0,30,30
1649892507255,MATH 142A,B02,083222,Chow; Bennett,18,0,30,12
1649892513278,MATH 193A,A01,083224,Staff,0,2,30,30
1649892513278,MATH 193A,A02,083225,Staff,0,3,30,30
1649892513278,MATH 193A,A03,083781,Staff,13,0,30,17
1649892513278,MATH 193A,A04,083782,Staff,23,0,30,7
1649892519300,MATH 197,001,091859,McAuley; Julian John,9999,0,9999,0
1649892525368,COGS 9,A01,083615,Staff,31,0,60,29
1649892531401,COGS 11,A01,083617,Boyle; Mary E. T.,36,0,40,4
1649892537438,COGS 13,A01,083071,Staff,4,0,40,36
1649892543466,COGS 14A,A01,092681,Staff,83,0,100,17
1649892549490,COGS 14B,A01,083073,Cheng; Tzu-Han,30,0,50,20
1649892555516,COGS 17,A01,092677,Staff,66,0,75,9
1649892561541,COGS 100,A01,083619,Staff,13,0,60,47
1649892567565,COGS 101A,A01,083621,Davis; Joshua Daniel,15,0,60,45
1649892573591,COGS 101B,A01,091572,Staff,36,0,60,24
1649892579631,COGS 101C,A01,083625,Delgado; Tania,25,0,30,5
1649892585654,COGS 107A,A01,083627,Boyle; Mary E. T.,18,0,60,42
1649892591677,COGS 118A,A01,083075,Staff,26,0,60,34
1649892597700,CSE 3,A50,083646,Miranda; Gregory Joseph,28,0,38,10
1649892597700,CSE 3,A51,083647,Miranda; Gregory Joseph,37,0,37,0
1649892603726,CSE 8A,A50,083650,Miranda; Gregory Joseph,17,0,40,23
1649892609759,CSE 11,A01,083080,Cao; Yingjun,0,19,40,40
1649892615789,CSE 12,A01,083652,Staff,70,0,100,30
1649892621829,CSE 15L,A01,083654,Staff,28,0,50,22
1649892621829,CSE 15L,A02,083655,Staff,48,0,50,2
1649892627866,CSE 20,A01,083657,Staff,71,0,80,9
1649892633889,CSE 30,A01,083084,Eldon; John,1,6,40,39
1649892639919,CSE 100,A01,083659,Cao; Yingjun,2,14,50,48
1649892645947,CSE 134B,A01,083661,Powell; Thomas Allan,2,24,65,63
1649892651973,CSE 140,A01,083663,Staff,32,0,75,43
1649892657997,CSE 140L,A01,083088,Eldon; John,25,0,75,50
1649892664028,CSE 175,A01,083665,Kumar; Rakesh,13,0,25,12
1649892670053,CSE 190,A00,092507,Dubnov; Shlomo,14,0,15,1
1649892676075,ECE 45,A01,083139,Staff,18,0,40,22
1649892682186,ECE 65,A50,083695,Staff,11,0,30,19
1649892688221,ECE 109,A01,091882,Touri; Behrouz,59,0,70,11
1649892694258,ECE 180,A00,083140,Abi Samra; Nicholas Camill,27,0,30,3
1649892694258,ECE 180,B00,083141,Abi Samra; Nicholas Camill,13,0,30,17
1649892700289,MATH 10A,A01,083735,Patchell; Gregory David,23,0,30,7
1649892700289,MATH 10A,A02,083736,Patchell; Gregory David,28,0,30,2
1649892700289,MATH 10A,A03,083737,Patchell; Gregory David,29,0,30,1
1649892706320,MATH 10B,A01,083207,Staff,15,0,30,15
1649892706320,MATH 10B,A02,083208,Staff,25,0,30,5
1649892706320,MATH 10B,B01,083739,Staff,25,0,30,5
1649892706320,MATH 10B,B02,083740,Staff,30,0,30,0
1649892712349,MATH 18,A01,083743,Staff,22,0,30,8
1649892712349,MATH 18,A02,083744,Staff,30,0,30,0
1649892712349,MATH 18,A03,083745,Staff,29,0,30,1
1649892712349,MATH 18,A04,083746,Staff,29,0,30,1
1649892712349,MATH 18,B01,083748,Staff,13,0,30,17
1649892712349,MATH 18,B02,083749,Staff,28,0,30,2
1649892712349,MATH 18,B03,083750,Staff,28,0,30,2
1649892712349,MATH 18,B04,083751,Staff,28,0,30,2
1649892718371,MATH 20A,A01,083754,Staff,38,0,40,2
1649892724395,MATH 20B,A01,083756,Staff,26,0,30,4
1649892724395,MATH 20B,A02,083757,Staff,30,0,30,0
1649892730520,MATH 20C,A01,083760,Staff,23,0,30,7
1649892730520,MATH 20C,A02,083761,Staff,25,0,30,5
1649892730520,MATH 20C,B01,083762,Staff,29,0,30,1
1649892730520,MATH 20C,B02,083763,Staff,30,0,30,0
1649892736544,MATH 20D,A01,083765,Staff,22,0,30,8
1649892736544,MATH 20D,A02,083766,Staff,30,0,30,0
1649892736544,MATH 20D,A03,083767,Staff,30,0,30,0
1649892742572,MATH 20E,A01,083771,Staff,17,0,30,13
1649892742572,MATH 20E,A02,083772,Staff,27,0,30,3
1649892742572,MATH 20E,B01,083773,Staff,24,0,30,6
1649892742572,MATH 20E,B02,083774,Staff,29,0,30,1
1649892748609,MATH 103A,A01,083777,Staff,0,0,30,30
1649892748609,MATH 103A,A02,083778,Staff,4,0,30,26
1649892748609,MATH 103A,B01,083779,Staff,7,0,30,23
1649892748609,MATH 103A,B02,083780,Staff,24,0,30,6
1649892754630,MATH 105,A01,085443,Staff,0,2,30,30
1649892760658,MATH 109,A01,083213,Anzaldo; Leesa B,21,0,30,9
1649892760658,MATH 109,A02,083214,Anzaldo; Leesa B,17,0,30,13
1649892760658,MATH 109,B01,083215,Anzaldo; Leesa B,25,0,30,5
1649892760658,MATH 109,B02,083216,Anzaldo; Leesa B,25,0,30,5
1649892766681,MATH 142A,A01,083219,Chow; Bennett,0,1,30,30
1649892766681,MATH 142A,A02,083220,Chow; Bennett,19,0,30,11
1649892766681,MATH 142A,B01,083221,Chow; Bennett,0,0,30,30
1649892766681,MATH 142A,B02,083222,Chow; Bennett,18,0,30,12
1649892772725,MATH 193A,A01,083224,Staff,0,2,30,30
1649892772725,MATH 193A,A02,083225,Staff,0,3,30,30
1649892772725,MATH 193A,A03,083781,Staff,13,0,30,17
1649892772725,MATH 193A,A04,083782,Staff,22,0,30,8
1649892778749,MATH 197,001,091859,McAuley; Julian John,9999,0,9999,0
1649892784798,COGS 9,A01,083615,Staff,30,0,60,30
1649892790820,COGS 11,A01,083617,Boyle; Mary E. T.,36,0,40,4
1649892796844,COGS 13,A01,083071,Staff,3,0,40,37
1649892802868,COGS 14A,A01,092681,Staff,83,0,100,17
1649892808891,COGS 14B,A01,083073,Cheng; Tzu-Han,29,0,50,21
1649892814931,COGS 17,A01,092677,Staff,66,0,75,9
1649892820958,COGS 100,A01,083619,Staff,13,0,60,47
1649892826997,COGS 101A,A01,083621,Davis; Joshua Daniel,15,0,60,45
1649892833025,COGS 101B,A01,091572,Staff,36,0,60,24
1649892839062,COGS 101C,A01,083625,Delgado; Tania,25,0,30,5
1649892845094,COGS 107A,A01,083627,Boyle; Mary E. T.,18,0,60,42
1649892851117,COGS 118A,A01,083075,Staff,26,0,60,34
1649892857139,CSE 3,A50,083646,Miranda; Gregory Joseph,28,0,38,10
1649892857139,CSE 3,A51,083647,Miranda; Gregory Joseph,37,0,37,0
1649892863160,CSE 8A,A50,083650,Miranda; Gregory Joseph,16,0,40,24
1649892869191,CSE 11,A01,083080,Cao; Yingjun,0,19,40,40
1649892875214,CSE 12,A01,083652,Staff,69,0,100,31
1649892881237,CSE 15L,A01,083654,Staff,28,0,50,22
1649892881237,CSE 15L,A02,083655,Staff,48,0,50,2
1649892887259,CSE 20,A01,083657,Staff,71,0,80,9
1649892893281,CSE 30,A01,083084,Eldon; John,1,6,40,39
1649892899309,CSE 100,A01,083659,Cao; Yingjun,2,14,50,48
1649892905333,CSE 134B,A01,083661,Powell; Thomas Allan,2,24,65,63
1649892911364,CSE 140,A01,083663,Staff,32,0,75,43
1649892917391,CSE 140L,A01,083088,Eldon; John,25,0,75,50
1649892923417,CSE 175,A01,083665,Kumar; Rakesh,13,0,25,12
1649892929443,CSE 190,A00,092507,Dubnov; Shlomo,14,0,15,1
1649892935464,ECE 45,A01,083139,Staff,18,0,40,22
1649892941495,ECE 65,A50,083695,Staff,11,0,30,19
1649892947521,ECE 109,A01,091882,Touri; Behrouz,59,0,70,11
1649892953547,ECE 180,A00,083140,Abi Samra; Nicholas Camill,27,0,30,3
1649892953547,ECE 180,B00,083141,Abi Samra; Nicholas Camill,13,0,30,17
1649892959572,MATH 10A,A01,083735,Patchell; Gregory David,23,0,30,7
1649892959572,MATH 10A,A02,083736,Patchell; Gregory David,28,0,30,2
1649892959572,MATH 10A,A03,083737,Patchell; Gregory David,28,0,30,2
1649892965595,MATH 10B,A01,083207,Staff,15,0,30,15
1649892965595,MATH 10B,A02,083208,Staff,25,0,30,5
1649892965595,MATH 10B,B01,083739,Staff,25,0,30,5
1649892965595,MATH 10B,B02,083740,Staff,30,0,30,0
1649892971637,MATH 18,A01,083743,Staff,22,0,30,8
1649892971637,MATH 18,A02,083744,Staff,30,0,30,0
1649892971637,MATH 18,A03,083745,Staff,29,0,30,1
1649892971637,MATH 18,A04,083746,Staff,29,0,30,1
1649892971637,MATH 18,B01,083748,Staff,13,0,30,17
1649892971637,MATH 18,B02,083749,Staff,28,0,30,2
1649892971637,MATH 18,B03,083750,Staff,28,0,30,2
1649892971637,MATH 18,B04,083751,Staff,28,0,30,2
1649892977666,MATH 20A,A01,083754,Staff,38,0,40,2
1649892983706,MATH 20B,A01,083756,Staff,26,0,30,4
1649892983706,MATH 20B,A02,083757,Staff,30,0,30,0
1649892989730,MATH 20C,A01,083760,Staff,23,0,30,7
1649892989730,MATH 20C,A02,083761,Staff,25,0,30,5
1649892989730,MATH 20C,B01,083762,Staff,29,0,30,1
1649892989730,MATH 20C,B02,083763,Staff,30,0,30,0
1649892995770,MATH 20D,A01,083765,Staff,22,0,30,8
1649892995770,MATH 20D,A02,083766,Staff,30,0,30,0
1649892995770,MATH 20D,A03,083767,Staff,30,0,30,0
1649893001797,MATH 20E,A01,083771,Staff,17,0,30,13
1649893001797,MATH 20E,A02,083772,Staff,27,0,30,3
1649893001797,MATH 20E,B01,083773,Staff,24,0,30,6
1649893001797,MATH 20E,B02,083774,Staff,29,0,30,1
1649893007832,MATH 103A,A01,083777,Staff,0,0,30,30
1649893007832,MATH 103A,A02,083778,Staff,4,0,30,26
1649893007832,MATH 103A,B01,083779,Staff,6,0,30,24
1649893007832,MATH 103A,B02,083780,Staff,24,0,30,6
1649893013866,MATH 105,A01,085443,Staff,0,2,30,30
1649893019894,MATH 109,A01,083213,Anzaldo; Leesa B,21,0,30,9
1649893019894,MATH 109,A02,083214,Anzaldo; Leesa B,17,0,30,13
1649893019894,MATH 109,B01,083215,Anzaldo; Leesa B,25,0,30,5
1649893019894,MATH 109,B02,083216,Anzaldo; Leesa B,25,0,30,5
1649893025927,MATH 142A,A01,083219,Chow; Bennett,0,1,30,30
1649893025927,MATH 142A,A02,083220,Chow; Bennett,19,0,30,11
1649893025927,MATH 142A,B01,083221,Chow; Bennett,0,0,30,30
1649893025927,MATH 142A,B02,083222,Chow; Bennett,18,0,30,12
1649893031955,MATH 193A,A01,083224,Staff,0,2,30,30
1649893031955,MATH 193A,A02,083225,Staff,0,3,30,30
1649893031955,MATH 193A,A03,083781,Staff,13,0,30,17
1649893031955,MATH 193A,A04,083782,Staff,22,0,30,8
1649893037980,MATH 197,001,091859,McAuley; Julian John,9999,0,9999,0
1649893044041,COGS 9,A01,083615,Staff,30,0,60,30
1649893050067,COGS 11,A01,083617,Boyle; Mary E. T.,36,0,40,4
1649893056091,COGS 13,A01,083071,Staff,2,0,40,38
1649893062115,COGS 14A,A01,092681,Staff,83,0,100,17
1649893068141,COGS 14B,A01,083073,Cheng; Tzu-Han,29,0,50,21
1649893074174,COGS 17,A01,092677,Staff,66,0,75,9
1649893080200,COGS 100,A01,083619,Staff,13,0,60,47
1649893086234,COGS 101A,A01,083621,Davis; Joshua Daniel,15,0,60,45
1649893092260,COGS 101B,A01,091572,Staff,36,0,60,24
1649893098284,COGS 101C,A01,083625,Delgado; Tania,25,0,30,5
1649893104309,COGS 107A,A01,083627,Boyle; Mary E. T.,18,0,60,42
1649893110339,COGS 118A,A01,083075,Staff,24,0,60,36
1649893116361,CSE 3,A50,083646,Miranda; Gregory Joseph,28,0,38,10
1649893116361,CSE 3,A51,083647,Miranda; Gregory Joseph,37,0,37,0
1649893122384,CSE 8A,A50,083650,Miranda; Gregory Joseph,15,0,40,25
1649893128407,CSE 11,A01,083080,Cao; Yingjun,0,19,40,40
1649893134431,CSE 12,A01,083652,Staff,68,0,100,32
1649893140454,CSE 15L,A01,083654,Staff,27,0,50,23
1649893140454,CSE 15L,A02,083655,Staff,48,0,50,2
1649893146482,CSE 20,A01,083657,Staff,71,0,80,9
1649893152519,CSE 30,A01,083084,Eldon; John,1,6,40,39
1649893158543,CSE 100,A01,083659,Cao; Yingjun,2,14,50,48
1649893164575,CSE 134B,A01,083661,Powell; Thomas Allan,2,24,65,63
1649893170600,CSE 140,A01,083663,Staff,32,0,75,43
1649893176627,CSE 140L,A01,083088,Eldon; John,25,0,75,50
1649893182652,CSE 175,A01,083665,Kumar; Rakesh,13,0,25,12
1649893188678,CSE 190,A00,092507,Dubnov; Shlomo,14,0,15,1
1649893194707,ECE 45,A01,083139,Staff,18,0,40,22
1649893200738,ECE 65,A50,083695,Staff,11,0,30,19
1649893206761,ECE 109,A01,091882,Touri; Behrouz,59,0,70,11
1649893212794,ECE 180,A00,083140,Abi Samra; Nicholas Camill,27,0,30,3
1649893212794,ECE 180,B00,083141,Abi Samra; Nicholas Camill,13,0,30,17
1649893218818,MATH 10A,A01,083735,Patchell; Gregory David,23,0,30,7
1649893218818,MATH 10A,A02,083736,Patchell; Gregory David,28,0,30,2
1649893218818,MATH 10A,A03,083737,Patchell; Gregory David,28,0,30,2
1649893224845,MATH 10B,A01,083207,Staff,15,0,30,15
1649893224845,MATH 10B,A02,083208,Staff,25,0,30,5
1649893224845,MATH 10B,B01,083739,Staff,25,0,30,5
1649893224845,MATH 10B,B02,083740,Staff,30,0,30,0
1649893230870,MATH 18,A01,083743,Staff,22,0,30,8
1649893230870,MATH 18,A02,083744,Staff,30,0,30,0
1649893230870,MATH 18,A03,083745,Staff,29,0,30,1
1649893230870,MATH 18,A04,083746,Staff,29,0,30,1
1649893230870,MATH 18,B01,083748,Staff,13,0,30,17
1649893230870,MATH 18,B02,083749,Staff,28,0,30,2
1649893230870,MATH 18,B03,083750,Staff,28,0,30,2
1649893230870,MATH 18,B04,083751,Staff,28,0,30,2
1649893236898,MATH 20A,A01,083754,Staff,38,0,40,2
1649893242924,MATH 20B,A01,083756,Staff,26,0,30,4
1649893242924,MATH 20B,A02,083757,Staff,30,0,30,0
1649893248949,MATH 20C,A01,083760,Staff,23,0,30,7
1649893248949,MATH 20C,A02,083761,Staff,25,0,30,5
1649893248949,MATH 20C,B01,083762,Staff,29,0,30,1
1649893248949,MATH 20C,B02,083763,Staff,30,0,30,0
1649893254971,MATH 20D,A01,083765,Staff,22,0,30,8
1649893254971,MATH 20D,A02,083766,Staff,30,0,30,0
1649893254971,MATH 20D,A03,083767,Staff,30,0,30,0
1649893261000,MATH 20E,A01,083771,Staff,17,0,30,13
1649893261000,MATH 20E,A02,083772,Staff,27,0,30,3
1649893261000,MATH 20E,B01,083773,Staff,24,0,30,6
1649893261000,MATH 20E,B02,083774,Staff,29,0,30,1
1649893267024,MATH 103A,A01,083777,Staff,0,0,30,30
1649893267024,MATH 103A,A02,083778,Staff,4,0,30,26
1649893267024,MATH 103A,B01,083779,Staff,6,0,30,24
1649893267024,MATH 103A,B02,083780,Staff,24,0,30,6
1649893273048,MATH 105,A01,085443,Staff,0,2,30,30
1649893279071,MATH 109,A01,083213,Anzaldo; Leesa B,21,0,30,9
1649893279071,MATH 109,A02,083214,Anzaldo; Leesa B,17,0,30,13
1649893279071,MATH 109,B01,083215,Anzaldo; Leesa B,25,0,30,5
1649893279071,MATH 109,B02,083216,Anzaldo; Leesa B,24,0,30,6
1649893285096,MATH 142A,A01,083219,Chow; Bennett,0,1,30,30
1649893285096,MATH 142A,A02,083220,Chow; Bennett,19,0,30,11
1649893285096,MATH 142A,B01,083221,Chow; Bennett,0,0,30,30
1649893285096,MATH 142A,B02,083222,Chow; Bennett,18,0,30,12
1649893291120,MATH 193A,A01,083224,Staff,0,2,30,30
1649893291120,MATH 193A,A02,083225,Staff,0,3,30,30
1649893291120,MATH 193A,A03,083781,Staff,13,0,30,17
1649893291120,MATH 193A,A04,083782,Staff,22,0,30,8
1649893297150,MATH 197,001,091859,McAuley; Julian John,9999,0,9999,0
1649893303205,COGS 9,A01,083615,Staff,30,0,60,30
1649893309234,COGS 11,A01,083617,Boyle; Mary E. T.,36,0,40,4
1649893315257,COGS 13,A01,083071,Staff,2,0,40,38
1649893321370,COGS 14A,A01,092681,Staff,83,0,100,17
1649893327403,COGS 14B,A01,083073,Cheng; Tzu-Han,29,0,50,21
1649893333428,COGS 17,A01,092677,Staff,66,0,75,9
1649893339467,COGS 100,A01,083619,Staff,12,0,60,48
1649893345498,COGS 101A,A01,083621,Davis; Joshua Daniel,15,0,60,45
1649893351521,COGS 101B,A01,091572,Staff,36,0,60,24
1649893357545,COGS 101C,A01,083625,Delgado; Tania,25,0,30,5
1649893363571,COGS 107A,A01,083627,Boyle; Mary E. T.,17,0,60,43
1649893369596,COGS 118A,A01,083075,Staff,23,0,60,37
1649893375620,CSE 3,A50,083646,Miranda; Gregory Joseph,26,0,38,12
1649893375620,CSE 3,A51,083647,Miranda; Gregory Joseph,37,0,37,0
1649893381650,CSE 8A,A50,083650,Miranda; Gregory Joseph,15,0,40,25
1649893387677,CSE 11,A01,083080,Cao; Yingjun,0,19,40,40
1649893393704,CSE 12,A01,083652,Staff,67,0,100,33
1649893399726,CSE 15L,A01,083654,Staff,26,0,50,24
1649893399726,CSE 15L,A02,083655,Staff,48,0,50,2
1649893405748,CSE 20,A01,083657,Staff,71,0,80,9
1649893411777,CSE 30,A01,083084,Eldon; John,1,7,40,39
1649893417801,CSE 100,A01,083659,Cao; Yingjun,2,15,50,48
1649893423830,CSE 134B,A01,083661,Powell; Thomas Allan,2,24,65,63
1649893429864,CSE 140,A01,083663,Staff,32,0,75,43
1649893435888,CSE 140L,A01,083088,Eldon; John,25,0,75,50
1649893441916,CSE 175,A01,083665,Kumar; Rakesh,13,0,25,12
1649893447945,CSE 190,A00,092507,Dubnov; Shlomo,14,0,15,1
1649893453970,ECE 45,A01,083139,Staff,18,0,40,22
1649893459993,ECE 65,A50,083695,Staff,11,0,30,19
1649893466022,ECE 109,A01,091882,Touri; Behrouz,59,0,70,11
1649893472050,ECE 180,A00,083140,Abi Samra; Nicholas Camill,27,0,30,3
1649893472050,ECE 180,B00,083141,Abi Samra; Nicholas Camill,13,0,30,17
1649893478077,MATH 10A,A01,083735,Patchell; Gregory David,23,0,30,7
1649893478077,MATH 10A,A02,083736,Patchell; Gregory David,28,0,30,2
1649893478077,MATH 10A,A03,083737,Patchell; Gregory David,28,0,30,2
1649893484105,MATH 10B,A01,083207,Staff,15,0,30,15
1649893484105,MATH 10B,A02,083208,Staff,25,0,30,5
1649893484105,MATH 10B,B01,083739,Staff,25,0,30,5
1649893484105,MATH 10B,B02,083740,Staff,30,0,30,0
1649893490146,MATH 18,A01,083743,Staff,22,0,30,8
1649893490146,MATH 18,A02,083744,Staff,29,0,30,1
1649893490146,MATH 18,A03,083745,Staff,29,0,30,1
1649893490146,MATH 18,A04,083746,Staff,29,0,30,1
1649893490146,MATH 18,B01,083748,Staff,13,0,30,17
1649893490146,MATH 18,B02,083749,Staff,27,0,30,3
1649893490146,MATH 18,B03,083750,Staff,28,0,30,2
1649893490146,MATH 18,B04,083751,Staff,28,0,30,2
1649893496172,MATH 20A,A01,083754,Staff,38,0,40,2
1649893502194,MATH 20B,A01,083756,Staff,26,0,30,4
1649893502194,MATH 20B,A02,083757,Staff,30,0,30,0
1649893508220,MATH 20C,A01,083760,Staff,23,0,30,7
1649893508220,MATH 20C,A02,083761,Staff,25,0,30,5
1649893508220,MATH 20C,B01,083762,Staff,29,0,30,1
1649893508220,MATH 20C,B02,083763,Staff,30,0,30,0
1649893514245,MATH 20D,A01,083765,Staff,21,0,30,9
1649893514245,MATH 20D,A02,083766,Staff,30,0,30,0
1649893514245,MATH 20D,A03,083767,Staff,30,0,30,0
1649893520268,MATH 20E,A01,083771,Staff,17,0,30,13
1649893520268,MATH 20E,A02,083772,Staff,27,0,30,3
1649893520268,MATH 20E,B01,083773,Staff,24,0,30,6
1649893520268,MATH 20E,B02,083774,Staff,29,0,30,1
1649893526300,MATH 103A,A01,083777,Staff,0,0,30,30
1649893526300,MATH 103A,A02,083778,Staff,3,0,30,27
1649893526300,MATH 103A,B01,083779,Staff,6,0,30,24
1649893526300,MATH 103A,B02,083780,Staff,23,0,30,7
1649893532325,MATH 105,A01,085443,Staff,0,2,30,30
1649893538353,MATH 109,A01,083213,Anzaldo; Leesa B,21,0,30,9
1649893538353,MATH 109,A02,083214,Anzaldo; Leesa B,17,0,30,13
1649893538353,MATH 109,B01,083215,Anzaldo; Leesa B,25,0,30,5
1649893538353,MATH 109,B02,083216,Anzaldo; Leesa B,24,0,30,6
1649893544385,MATH 142A,A01,083219,Chow; Bennett,0,1,30,30
1649893544385,MATH 142A,A02,083220,Chow; Bennett,19,0,30,11
1649893544385,MATH 142A,B01,083221,Chow; Bennett,0,0,30,30
1649893544385,MATH 142A,B02,083222,Chow; Bennett,18,0,30,12
1649893550409,MATH 193A,A01,083224,Staff,0,2,30,30
1649893550409,MATH 193A,A02,083225,Staff,0,3,30,30
1649893550409,MATH 193A,A03,083781,Staff,13,0,30,17
1649893550409,MATH 193A,A04,083782,Staff,22,0,30,8
1649893556442,MATH 197,001,091859,McAuley; Julian John,9999,0,9999,0
1649893562529,COGS 9,A01,083615,Staff,30,0,60,30
1649893568553,COGS 11,A01,083617,Boyle; Mary E. T.,36,0,40,4
1649893574579,COGS 13,A01,083071,Staff,2,0,40,38
1649893580603,COGS 14A,A01,092681,Staff,83,0,100,17
1649893586630,COGS 14B,A01,083073,Cheng; Tzu-Han,29,0,50,21
1649893592653,COGS 17,A01,092677,Staff,66,0,75,9
1649893598682,COGS 100,A01,083619,Staff,12,0,60,48
1649893604714,COGS 101A,A01,083621,Davis; Joshua Daniel,15,0,60,45
1649893610753,COGS 101B,A01,091572,Staff,36,0,60,24
1649893616780,COGS 101C,A01,083625,Delgado; Tania,25,0,30,5
1649893622813,COGS 107A,A01,083627,Boyle; Mary E. T.,17,0,60,43
1649893628837,COGS 118A,A01,083075,Staff,23,0,60,37
1649893634880,CSE 3,A50,083646,Miranda; Gregory Joseph,26,0,38,12
1649893634880,CSE 3,A51,083647,Miranda; Gregory Joseph,37,0,37,0
1649893640919,CSE 8A,A50,083650,Miranda; Gregory Joseph,15,0,40,25
1649893646943,CSE 11,A01,083080,Cao; Yingjun,0,19,40,40
1649893652973,CSE 12,A01,083652,Staff,67,0,100,33
1649893659001,CSE 15L,A01,083654,Staff,26,0,50,24
1649893659001,CSE 15L,A02,083655,Staff,48,0,50,2
1649893665025,CSE 20,A01,083657,Staff,71,0,80,9
1649893671047,CSE 30,A01,083084,Eldon; John,1,7,40,39
1649893677077,CSE 100,A01,083659,Cao; Yingjun,2,15,50,48
1649893683100,CSE 134B,A01,083661,Powell; Thomas Allan,2,24,65,63
1649893689124,CSE 140,A01,083663,Staff,32,0,75,43
1649893695150,CSE 140L,A01,083088,Eldon; John,25,0,75,50
1649893701177,CSE 175,A01,083665,Kumar; Rakesh,13,0,25,12
1649893707201,CSE 190,A00,092507,Dubnov; Shlomo,14,0,15,1
1649893713228,ECE 45,A01,083139,Staff,17,0,40,23
1649893719258,ECE 65,A50,083695,Staff,11,0,30,19
1649893725282,ECE 109,A01,091882,Touri; Behrouz,59,0,70,11
1649893731306,ECE 180,A00,083140,Abi Samra; Nicholas Camill,27,0,30,3
1649893731306,ECE 180,B00,083141,Abi Samra; Nicholas Camill,13,0,30,17
1649893737340,MATH 10A,A01,083735,Patchell; Gregory David,23,0,30,7
1649893737340,MATH 10A,A02,083736,Patchell; Gregory David,28,0,30,2
1649893737340,MATH 10A,A03,083737,Patchell; Gregory David,28,0,30,2
1649893743364,MATH 10B,A01,083207,Staff,15,0,30,15
1649893743364,MATH 10B,A02,083208,Staff,25,0,30,5
1649893743364,MATH 10B,B01,083739,Staff,25,0,30,5
1649893743364,MATH 10B,B02,083740,Staff,30,0,30,0
1649893749390,MATH 18,A01,083743,Staff,22,0,30,8
1649893749390,MATH 18,A02,083744,Staff,29,0,30,1
1649893749390,MATH 18,A03,083745,Staff,29,0,30,1
1649893749390,MATH 18,A04,083746,Staff,29,0,30,1
1649893749390,MATH 18,B01,083748,Staff,13,0,30,17
1649893749390,MATH 18,B02,083749,Staff,27,0,30,3
1649893749390,MATH 18,B03,083750,Staff,28,0,30,2
1649893749390,MATH 18,B04,083751,Staff,28,0,30,2
1649893755416,MATH 20A,A01,083754,Staff,38,0,40,2
1649893761442,MATH 20B,A01,083756,Staff,26,0,30,4
1649893761442,MATH 20B,A02,083757,Staff,30,0,30,0
1649893767467,MATH 20C,A01,083760,Staff,23,0,30,7
1649893767467,MATH 20C,A02,083761,Staff,25,0,30,5
1649893767467,MATH 20C,B01,083762,Staff,29,0,30,1
1649893767467,MATH 20C,B02,083763,Staff,30,0,30,0
1649893773493,MATH 20D,A01,083765,Staff,21,0,30,9
1649893773493,MATH 20D,A02,083766,Staff,30,0,30,0
1649893773493,MATH 20D,A03,083767,Staff,30,0,30,0
1649893779525,MATH 20E,A01,083771,Staff,17,0,30,13
1649893779525,MATH 20E,A02,083772,Staff,27,0,30,3
1649893779525,MATH 20E,B01,083773,Staff,24,0,30,6
1649893779525,MATH 20E,B02,083774,Staff,29,0,30,1
1649893785552,MATH 103A,A01,083777,Staff,0,0,30,30
1649893785552,MATH 103A,A02,083778,Staff,3,0,30,27
1649893785552,MATH 103A,B01,083779,Staff,6,0,30,24
1649893785552,MATH 103A,B02,083780,Staff,23,0,30,7
1649893791592,MATH 105,A01,085443,Staff,0,2,30,30
1649893797621,MATH 109,A01,083213,Anzaldo; Leesa B,21,0,30,9
1649893797621,MATH 109,A02,083214,Anzaldo; Leesa B,17,0,30,13
1649893797621,MATH 109,B01,083215,Anzaldo; Leesa B,25,0,30,5
1649893797621,MATH 109,B02,083216,Anzaldo; Leesa B,24,0,30,6
1649893803646,MATH 142A,A01,083219,Chow; Bennett,0,1,30,30
1649893803646,MATH 142A,A02,083220,Chow; Bennett,18,0,30,12
1649893803646,MATH 142A,B01,083221,Chow; Bennett,0,0,30,30
1649893803646,MATH 142A,B02,083222,Chow; Bennett,18,0,30,12
1649893809670,MATH 193A,A01,083224,Staff,0,2,30,30
1649893809670,MATH 193A,A02,083225,Staff,0,3,30,30
1649893809670,MATH 193A,A03,083781,Staff,13,0,30,17
1649893809670,MATH 193A,A04,083782,Staff,22,0,30,8
1649893815696,MATH 197,001,091859,McAuley; Julian John,9999,0,9999,0
1649893821755,COGS 9,A01,083615,Staff,30,0,60,30
1649893827785,COGS 11,A01,083617,Boyle; Mary E. T.,36,0,40,4
1649893833809,COGS 13,A01,083071,Staff,2,0,40,38
1649893839838,COGS 14A,A01,092681,Staff,83,0,100,17
1649893845878,COGS 14B,A01,083073,Cheng; Tzu-Han,29,0,50,21
1649893851902,COGS 17,A01,092677,Staff,66,0,75,9
1649893857925,COGS 100,A01,083619,Staff,11,0,60,49
1649893863949,COGS 101A,A01,083621,Davis; Joshua Daniel,15,0,60,45
1649893869972,COGS 101B,A01,091572,Staff,36,0,60,24
1649893875995,COGS 101C,A01,083625,Delgado; Tania,25,0,30,5
1649893882034,COGS 107A,A01,083627,Boyle; Mary E. T.,17,0,60,43
1649893888061,COGS 118A,A01,083075,Staff,23,0,60,37
1649893894084,CSE 3,A50,083646,Miranda; Gregory Joseph,26,0,38,12
1649893894084,CSE 3,A51,083647,Miranda; Gregory Joseph,37,0,37,0
1649893900108,CSE 8A,A50,083650,Miranda; Gregory Joseph,15,0,40,25
1649893906132,CSE 11,A01,083080,Cao; Yingjun,0,19,40,40
1649893912160,CSE 12,A01,083652,Staff,65,0,100,35
1649893918276,CSE 15L,A01,083654,Staff,24,0,50,26
1649893918276,CSE 15L,A02,083655,Staff,48,0,50,2
1649893924300,CSE 20,A01,083657,Staff,71,0,80,9
1649893930323,CSE 30,A01,083084,Eldon; John,1,8,40,39
1649893936359,CSE 100,A01,083659,Cao; Yingjun,2,15,50,48
1649893942385,CSE 134B,A01,083661,Powell; Thomas Allan,2,24,65,63
1649893948411,CSE 140,A01,083663,Staff,32,0,75,43
1649893954442,CSE 140L,A01,083088,Eldon; John,25,0,75,50
1649893960468,CSE 175,A01,083665,Kumar; Rakesh,13,0,25,12
1649893966492,CSE 190,A00,092507,Dubnov; Shlomo,14,0,15,1
1649893972518,ECE 45,A01,083139,Staff,17,0,40,23
1649893978541,ECE 65,A50,083695,Staff,11,0,30,19
1649893984569,ECE 109,A01,091882,Touri; Behrouz,59,0,70,11
1649893990605,ECE 180,A00,083140,Abi Samra; Nicholas Camill,27,0,30,3
1649893990605,ECE 180,B00,083141,Abi Samra; Nicholas Camill,13,0,30,17
1649893996628,MATH 10A,A01,083735,Patchell; Gregory David,23,0,30,7
1649893996628,MATH 10A,A02,083736,Patchell; Gregory David,28,0,30,2
1649893996628,MATH 10A,A03,083737,Patchell; Gregory David,28,0,30,2
1649894002650,MATH 10B,A01,083207,Staff,14,0,30,16
1649894002650,MATH 10B,A02,083208,Staff,25,0,30,5
1649894002650,MATH 10B,B01,083739,Staff,25,0,30,5
1649894002650,MATH 10B,B02,083740,Staff,30,0,30,0
1649894008674,MATH 18,A01,083743,Staff,22,0,30,8
1649894008674,MATH 18,A02,083744,Staff,29,0,30,1
1649894008674,MATH 18,A03,083745,Staff,29,0,30,1
1649894008674,MATH 18,A04,083746,Staff,29,0,30,1
1649894008674,MATH 18,B01,083748,Staff,13,0,30,17
1649894008674,MATH 18,B02,083749,Staff,27,0,30,3
1649894008674,MATH 18,B03,083750,Staff,28,0,30,2
1649894008674,MATH 18,B04,083751,Staff,28,0,30,2
1649894014698,MATH 20A,A01,083754,Staff,38,0,40,2
1649894020736,MATH 20B,A01,083756,Staff,26,0,30,4
1649894020736,MATH 20B,A02,083757,Staff,30,0,30,0
1649894026759,MATH 20C,A01,083760,Staff,23,0,30,7
1649894026759,MATH 20C,A02,083761,Staff,25,0,30,5
1649894026759,MATH 20C,B01,083762,Staff,29,0,30,1
1649894026759,MATH 20C,B02,083763,Staff,30,0,30,0
1649894032787,MATH 20D,A01,083765,Staff,21,0,30,9
1649894032787,MATH 20D,A02,083766,Staff,30,0,30,0
1649894032787,MATH 20D,A03,083767,Staff,30,0,30,0
1649894038810,MATH 20E,A01,083771,Staff,17,0,30,13
1649894038810,MATH 20E,A02,083772,Staff,27,0,30,3
1649894038810,MATH 20E,B01,083773,Staff,24,0,30,6
1649894038810,MATH 20E,B02,083774,Staff,29,0,30,1
1649894044846,MATH 103A,A01,083777,Staff,0,0,30,30
1649894044846,MATH 103A,A02,083778,Staff,3,0,30,27
1649894044846,MATH 103A,B01,083779,Staff,6,0,30,24
1649894044846,MATH 103A,B02,083780,Staff,22,0,30,8
1649894050873,MATH 105,A01,085443,Staff,0,2,30,30
1649894056898,MATH 109,A01,083213,Anzaldo; Leesa B,21,0,30,9
1649894056898,MATH 109,A02,083214,Anzaldo; Leesa B,16,0,30,14
1649894056898,MATH 109,B01,083215,Anzaldo; Leesa B,25,0,30,5
1649894056898,MATH 109,B02,083216,Anzaldo; Leesa B,25,0,30,5
1649894062923,MATH 142A,A01,083219,Chow; Bennett,0,1,30,30
1649894062923,MATH 142A,A02,083220,Chow; Bennett,18,0,30,12
1649894062923,MATH 142A,B01,083221,Chow; Bennett,0,0,30,30
1649894062923,MATH 142A,B02,083222,Chow; Bennett,18,0,30,12
1649894068947,MATH 193A,A01,083224,Staff,0,2,30,30
1649894068947,MATH 193A,A02,083225,Staff,0,3,30,30
1649894068947,MATH 193A,A03,083781,Staff,13,0,30,17
1649894068947,MATH 193A,A04,083782,Staff,22,0,30,8
1649894074969,MATH 197,001,091859,McAuley; Julian John,9999,0,9999,0
1649894081037,COGS 9,A01,083615,Staff,30,0,60,30
1649894087066,COGS 11,A01,083617,Boyle; Mary E. T.,36,0,40,4
1649894093097,COGS 13,A01,083071,Staff,2,0,40,38
1649894099118,COGS 14A,A01,092681,Staff,83,0,100,17
1649894105140,COGS 14B,A01,083073,Cheng; Tzu-Han,29,0,50,21
1649894111164,COGS 17,A01,092677,Staff,66,0,75,9
1649894117190,COGS 100,A01,083619,Staff,11,0,60,49
1649894123216,COGS 101A,A01,083621,Davis; Joshua Daniel,15,0,60,45
1649894129243,COGS 101B,A01,091572,Staff,36,0,60,24
1649894135272,COGS 101C,A01,083625,Delgado; Tania,25,0,30,5
1649894141294,COGS 107A,A01,083627,Boyle; Mary E. T.,17,0,60,43
1649894147317,COGS 118A,A01,083075,Staff,23,0,60,37
1649894153343,CSE 3,A50,083646,Miranda; Gregory Joseph,26,0,38,12
1649894153343,CSE 3,A51,083647,Miranda; Gregory Joseph,37,0,37,0
1649894159366,CSE 8A,A50,083650,Miranda; Gregory Joseph,14,0,40,26
1649894165388,CSE 11,A01,083080,Cao; Yingjun,0,19,40,40
1649894171411,CSE 12,A01,083652,Staff,65,0,100,35
1649894177434,CSE 15L,A01,083654,Staff,24,0,50,26
1649894177434,CSE 15L,A02,083655,Staff,48,0,50,2
1649894183460,CSE 20,A01,083657,Staff,71,0,80,9
1649894189496,CSE 30,A01,083084,Eldon; John,1,8,40,39
1649894195523,CSE 100,A01,083659,Cao; Yingjun,2,15,50,48
1649894201549,CSE 134B,A01,083661,Powell; Thomas Allan,2,23,65,63
1649894207573,CSE 140,A01,083663,Staff,32,0,75,43
1649894213603,CSE 140L,A01,083088,Eldon; John,25,0,75,50
1649894219627,CSE 175,A01,083665,Kumar; Rakesh,13,0,25,12
1649894225653,CSE 190,A00,092507,Dubnov; Shlomo,14,0,15,1
1649894231679,ECE 45,A01,083139,Staff,17,0,40,23
1649894237703,ECE 65,A50,083695,Staff,11,0,30,19
1649894243736,ECE 109,A01,091882,Touri; Behrouz,59,0,70,11
1649894249761,ECE 180,A00,083140,Abi Samra; Nicholas Camill,27,0,30,3
1649894249761,ECE 180,B00,083141,Abi Samra; Nicholas Camill,13,0,30,17
1649894255795,MATH 10A,A01,083735,Patchell; Gregory David,23,0,30,7
1649894255795,MATH 10A,A02,083736,Patchell; Gregory David,28,0,30,2
1649894255795,MATH 10A,A03,083737,Patchell; Gregory David,28,0,30,2
1649894261819,MATH 10B,A01,083207,Staff,14,0,30,16
1649894261819,MATH 10B,A02,083208,Staff,25,0,30,5
1649894261819,MATH 10B,B01,083739,Staff,25,0,30,5
1649894261819,MATH 10B,B02,083740,Staff,30,0,30,0
1649894267848,MATH 18,A01,083743,Staff,22,0,30,8
1649894267848,MATH 18,A02,083744,Staff,29,0,30,1
1649894267848,MATH 18,A03,083745,Staff,29,0,30,1
1649894267848,MATH 18,A04,083746,Staff,29,0,30,1
1649894267848,MATH 18,B01,083748,Staff,13,0,30,17
1649894267848,MATH 18,B02,083749,Staff,27,0,30,3
1649894267848,MATH 18,B03,083750,Staff,28,0,30,2
1649894267848,MATH 18,B04,083751,Staff,28,0,30,2
1649894273871,MATH 20A,A01,083754,Staff,38,0,40,2
1649894279900,MATH 20B,A01,083756,Staff,26,0,30,4
1649894279900,MATH 20B,A02,083757,Staff,30,0,30,0
1649894285924,MATH 20C,A01,083760,Staff,23,0,30,7
1649894285924,MATH 20C,A02,083761,Staff,25,0,30,5
1649894285924,MATH 20C,B01,083762,Staff,29,0,30,1
1649894285924,MATH 20C,B02,083763,Staff,30,0,30,0
1649894291951,MATH 20D,A01,083765,Staff,21,0,30,9
1649894291951,MATH 20D,A02,083766,Staff,30,0,30,0
1649894291951,MATH 20D,A03,083767,Staff,30,0,30,0
1649894297976,MATH 20E,A01,083771,Staff,17,0,30,13
1649894297976,MATH 20E,A02,083772,Staff,27,0,30,3
1649894297976,MATH 20E,B01,083773,Staff,24,0,30,6
1649894297976,MATH 20E,B02,083774,Staff,29,0,30,1
1649894304000,MATH 103A,A01,083777,Staff,0,0,30,30
1649894304000,MATH 103A,A02,083778,Staff,3,0,30,27
1649894304000,MATH 103A,B01,083779,Staff,6,0,30,24
1649894304000,MATH 103A,B02,083780,Staff,22,0,30,8
1649894310031,MATH 105,A01,085443,Staff,0,2,30,30
1649894316067,MATH 109,A01,083213,Anzaldo; Leesa B,21,0,30,9
1649894316067,MATH 109,A02,083214,Anzaldo; Leesa B,16,0,30,14
1649894316067,MATH 109,B01,083215,Anzaldo; Leesa B,25,0,30,5
1649894316067,MATH 109,B02,083216,Anzaldo; Leesa B,25,0,30,5
1649894322096,MATH 142A,A01,083219,Chow; Bennett,0,1,30,30
1649894322096,MATH 142A,A02,083220,Chow; Bennett,18,0,30,12
1649894322096,MATH 142A,B01,083221,Chow; Bennett,0,0,30,30
1649894322096,MATH 142A,B02,083222,Chow; Bennett,18,0,30,12
1649894328125,MATH 193A,A01,083224,Staff,0,2,30,30
1649894328125,MATH 193A,A02,083225,Staff,0,3,30,30
1649894328125,MATH 193A,A03,083781,Staff,13,0,30,17
1649894328125,MATH 193A,A04,083782,Staff,22,0,30,8
1649894334151,MATH 197,001,091859,McAuley; Julian John,9999,0,9999,0
1649894340217,COGS 9,A01,083615,Staff,30,0,60,30
1649894346241,COGS 11,A01,083617,Boyle; Mary E. T.,36,0,40,4
1649894352266,COGS 13,A01,083071,Staff,2,0,40,38
1649894358289,COGS 14A,A01,092681,Staff,83,0,100,17
1649894364322,COGS 14B,A01,083073,Cheng; Tzu-Han,29,0,50,21
1649894370346,COGS 17,A01,092677,Staff,66,0,75,9
1649894376373,COGS 100,A01,083619,Staff,11,0,60,49
1649894382407,COGS 101A,A01,083621,Davis; Joshua Daniel,15,0,60,45
1649894388439,COGS 101B,A01,091572,Staff,36,0,60,24
1649894394463,COGS 101C,A01,083625,Delgado; Tania,25,0,30,5
1649894400488,COGS 107A,A01,083627,Boyle; Mary E. T.,17,0,60,43
1649894406525,COGS 118A,A01,083075,Staff,23,0,60,37
1649894412559,CSE 3,A50,083646,Miranda; Gregory Joseph,26,0,38,12
1649894412559,CSE 3,A51,083647,Miranda; Gregory Joseph,37,0,37,0
1649894418584,CSE 8A,A50,083650,Miranda; Gregory Joseph,14,0,40,26
1649894424612,CSE 11,A01,083080,Cao; Yingjun,0,19,40,40
1649894430636,CSE 12,A01,083652,Staff,65,0,100,35
1649894436668,CSE 15L,A01,083654,Staff,24,0,50,26
1649894436668,CSE 15L,A02,083655,Staff,48,0,50,2
1649894442691,CSE 20,A01,083657,Staff,71,0,80,9
1649894448719,CSE 30,A01,083084,Eldon; John,1,8,40,39
1649894454749,CSE 100,A01,083659,Cao; Yingjun,2,15,50,48
1649894460784,CSE 134B,A01,083661,Powell; Thomas Allan,2,23,65,63
1649894466809,CSE 140,A01,083663,Staff,32,0,75,43
1649894472841,CSE 140L,A01,083088,Eldon; John,25,0,75,50
1649894478864,CSE 175,A01,083665,Kumar; Rakesh,13,0,25,12
1649894484887,CSE 190,A00,092507,Dubnov; Shlomo,14,0,15,1
1649894490915,ECE 45,A01,083139,Staff,17,0,40,23
1649894496939,ECE 65,A50,083695,Staff,11,0,30,19
1649894502968,ECE 109,A01,091882,Touri; Behrouz,59,0,70,11
1649894508995,ECE 180,A00,083140,Abi Samra; Nicholas Camill,27,0,30,3
1649894508995,ECE 180,B00,083141,Abi Samra; Nicholas Camill,13,0,30,17
1649894515117,MATH 10A,A01,083735,Patchell; Gregory David,23,0,30,7
1649894515117,MATH 10A,A02,083736,Patchell; Gregory David,28,0,30,2
1649894515117,MATH 10A,A03,083737,Patchell; Gregory David,28,0,30,2
1649894521145,MATH 10B,A01,083207,Staff,14,0,30,16
1649894521145,MATH 10B,A02,083208,Staff,25,0,30,5
1649894521145,MATH 10B,B01,083739,Staff,25,0,30,5
1649894521145,MATH 10B,B02,083740,Staff,30,0,30,0
1649894527170,MATH 18,A01,083743,Staff,22,0,30,8
1649894527170,MATH 18,A02,083744,Staff,29,0,30,1
1649894527170,MATH 18,A03,083745,Staff,29,0,30,1
1649894527170,MATH 18,A04,083746,Staff,29,0,30,1
1649894527170,MATH 18,B01,083748,Staff,13,0,30,17
1649894527170,MATH 18,B02,083749,Staff,27,0,30,3
1649894527170,MATH 18,B03,083750,Staff,28,0,30,2
1649894527170,MATH 18,B04,083751,Staff,28,0,30,2
1649894533195,MATH 20A,A01,083754,Staff,38,0,40,2
1649894539224,MATH 20B,A01,083756,Staff,26,0,30,4
1649894539224,MATH 20B,A02,083757,Staff,30,0,30,0
1649894545256,MATH 20C,A01,083760,Staff,23,0,30,7
1649894545256,MATH 20C,A02,083761,Staff,24,0,30,6
1649894545256,MATH 20C,B01,083762,Staff,29,0,30,1
1649894545256,MATH 20C,B02,083763,Staff,30,0,30,0
1649894551287,MATH 20D,A01,083765,Staff,21,0,30,9
1649894551287,MATH 20D,A02,083766,Staff,30,0,30,0
1649894551287,MATH 20D,A03,083767,Staff,30,0,30,0
1649894557318,MATH 20E,A01,083771,Staff,17,0,30,13
1649894557318,MATH 20E,A02,083772,Staff,27,0,30,3
1649894557318,MATH 20E,B01,083773,Staff,24,0,30,6
1649894557318,MATH 20E,B02,083774,Staff,29,0,30,1
1649894563342,MATH 103A,A01,083777,Staff,0,0,30,30
1649894563342,MATH 103A,A02,083778,Staff,3,0,30,27
1649894563342,MATH 103A,B01,083779,Staff,6,0,30,24
1649894563342,MATH 103A,B02,083780,Staff,22,0,30,8
1649894569365,MATH 105,A01,085443,Staff,0,2,30,30
1649894575388,MATH 109,A01,083213,Anzaldo; Leesa B,21,0,30,9
1649894575388,MATH 109,A02,083214,Anzaldo; Leesa B,16,0,30,14
1649894575388,MATH 109,B01,083215,Anzaldo; Leesa B,25,0,30,5
1649894575388,MATH 109,B02,083216,Anzaldo; Leesa B,25,0,30,5
1649894581418,MATH 142A,A01,083219,Chow; Bennett,0,1,30,30
1649894581418,MATH 142A,A02,083220,Chow; Bennett,18,0,30,12
1649894581418,MATH 142A,B01,083221,Chow; Bennett,0,0,30,30
1649894581418,MATH 142A,B02,083222,Chow; Bennett,18,0,30,12
1649894587446,MATH 193A,A01,083224,Staff,0,2,30,30
1649894587446,MATH 193A,A02,083225,Staff,0,3,30,30
1649894587446,MATH 193A,A03,083781,Staff,13,0,30,17
1649894587446,MATH 193A,A04,083782,Staff,22,0,30,8
1649894593477,MATH 197,001,091859,McAuley; Julian John,9999,0,9999,0
1649894599534,COGS 9,A01,083615,Staff,30,0,60,30
1649894605556,COGS 11,A01,083617,Boyle; Mary E. T.,36,0,40,4
1649894611592,COGS 13,A01,083071,Staff,1,0,40,39
1649894617615,COGS 14A,A01,092681,Staff,83,0,100,17
1649894623647,COGS 14B,A01,083073,Cheng; Tzu-Han,28,0,50,22
1649894629679,COGS 17,A01,092677,Staff,66,0,75,9
1649894635705,COGS 100,A01,083619,Staff,11,0,60,49
1649894641730,COGS 101A,A01,083621,Davis; Joshua Daniel,15,0,60,45
1649894647757,COGS 101B,A01,091572,Staff,36,0,60,24
1649894653779,COGS 101C,A01,083625,Delgado; Tania,25,0,30,5
1649894659802,COGS 107A,A01,083627,Boyle; Mary E. T.,17,0,60,43
1649894665830,COGS 118A,A01,083075,Staff,23,0,60,37
1649894671859,CSE 3,A50,083646,Miranda; Gregory Joseph,26,0,38,12
1649894671859,CSE 3,A51,083647,Miranda; Gregory Joseph,37,0,37,0
1649894677886,CSE 8A,A50,083650,Miranda; Gregory Joseph,14,0,40,26
1649894683919,CSE 11,A01,083080,Cao; Yingjun,0,20,40,40
1649894689946,CSE 12,A01,083652,Staff,65,0,100,35
1649894695969,CSE 15L,A01,083654,Staff,24,0,50,26
1649894695969,CSE 15L,A02,083655,Staff,48,0,50,2
1649894701995,CSE 20,A01,083657,Staff,71,0,80,9
1649894708027,CSE 30,A01,083084,Eldon; John,1,8,40,39
1649894714049,CSE 100,A01,083659,Cao; Yingjun,2,15,50,48
1649894720073,CSE 134B,A01,083661,Powell; Thomas Allan,2,23,65,63
1649894726101,CSE 140,A01,083663,Staff,32,0,75,43
1649894732123,CSE 140L,A01,083088,Eldon; John,25,0,75,50
1649894738162,CSE 175,A01,083665,Kumar; Rakesh,13,0,25,12
1649894744202,CSE 190,A00,092507,Dubnov; Shlomo,14,0,15,1
1649894750233,ECE 45,A01,083139,Staff,17,0,40,23
1649894756257,ECE 65,A50,083695,Staff,11,0,30,19
1649894762281,ECE 109,A01,091882,Touri; Behrouz,58,0,70,12
1649894768316,ECE 180,A00,083140,Abi Samra; Nicholas Camill,27,0,30,3
1649894768316,ECE 180,B00,083141,Abi Samra; Nicholas Camill,13,0,30,17
1649894774345,MATH 10A,A01,083735,Patchell; Gregory David,23,0,30,7
1649894774345,MATH 10A,A02,083736,Patchell; Gregory David,28,0,30,2
1649894774345,MATH 10A,A03,083737,Patchell; Gregory David,28,0,30,2
1649894780369,MATH 10B,A01,083207,Staff,14,0,30,16
1649894780369,MATH 10B,A02,083208,Staff,25,0,30,5
1649894780369,MATH 10B,B01,083739,Staff,25,0,30,5
1649894780369,MATH 10B,B02,083740,Staff,30,0,30,0
1649894786396,MATH 18,A01,083743,Staff,22,0,30,8
1649894786396,MATH 18,A02,083744,Staff,29,0,30,1
1649894786396,MATH 18,A03,083745,Staff,29,0,30,1
1649894786396,MATH 18,A04,083746,Staff,29,0,30,1
1649894786396,MATH 18,B01,083748,Staff,13,0,30,17
1649894786396,MATH 18,B02,083749,Staff,27,0,30,3
1649894786396,MATH 18,B03,083750,Staff,28,0,30,2
1649894786396,MATH 18,B04,083751,Staff,28,0,30,2
1649894792423,MATH 20A,A01,083754,Staff,38,0,40,2
1649894798447,MATH 20B,A01,083756,Staff,25,0,30,5
1649894798447,MATH 20B,A02,083757,Staff,30,0,30,0
1649894804474,MATH 20C,A01,083760,Staff,23,0,30,7
1649894804474,MATH 20C,A02,083761,Staff,24,0,30,6
1649894804474,MATH 20C,B01,083762,Staff,29,0,30,1
1649894804474,MATH 20C,B02,083763,Staff,30,0,30,0
1649894810500,MATH 20D,A01,083765,Staff,21,0,30,9
1649894810500,MATH 20D,A02,083766,Staff,30,0,30,0
1649894810500,MATH 20D,A03,083767,Staff,30,0,30,0
1649894816528,MATH 20E,A01,083771,Staff,17,0,30,13
1649894816528,MATH 20E,A02,083772,Staff,27,0,30,3
1649894816528,MATH 20E,B01,083773,Staff,24,0,30,6
1649894816528,MATH 20E,B02,083774,Staff,29,0,30,1
1649894822560,MATH 103A,A01,083777,Staff,0,0,30,30
1649894822560,MATH 103A,A02,083778,Staff,3,0,30,27
1649894822560,MATH 103A,B01,083779,Staff,6,0,30,24
1649894822560,MATH 103A,B02,083780,Staff,22,0,30,8
1649894828587,MATH 105,A01,085443,Staff,0,2,30,30
1649894834611,MATH 109,A01,083213,Anzaldo; Leesa B,21,0,30,9
1649894834611,MATH 109,A02,083214,Anzaldo; Leesa B,16,0,30,14
1649894834611,MATH 109,B01,083215,Anzaldo; Leesa B,25,0,30,5
1649894834611,MATH 109,B02,083216,Anzaldo; Leesa B,25,0,30,5
1649894840634,MATH 142A,A01,083219,Chow; Bennett,0,1,30,30
1649894840634,MATH 142A,A02,083220,Chow; Bennett,18,0,30,12
1649894840634,MATH 142A,B01,083221,Chow; Bennett,0,0,30,30
1649894840634,MATH 142A,B02,083222,Chow; Bennett,18,0,30,12
1649894846664,MATH 193A,A01,083224,Staff,0,2,30,30
1649894846664,MATH 193A,A02,083225,Staff,0,3,30,30
1649894846664,MATH 193A,A03,083781,Staff,13,0,30,17
1649894846664,MATH 193A,A04,083782,Staff,22,0,30,8
1649894852686,MATH 197,001,091859,McAuley; Julian John,9999,0,9999,0
1649894858757,COGS 9,A01,083615,Staff,30,0,60,30
1649894864793,COGS 11,A01,083617,Boyle; Mary E. T.,36,0,40,4
1649894870829,COGS 13,A01,083071,Staff,1,0,40,39
1649894876862,COGS 14A,A01,092681,Staff,83,0,100,17
1649894882887,COGS 14B,A01,083073,Cheng; Tzu-Han,28,0,50,22
1649894888911,COGS 17,A01,092677,Staff,66,0,75,9
1649894894941,COGS 100,A01,083619,Staff,11,0,60,49
1649894900965,COGS 101A,A01,083621,Davis; Joshua Daniel,15,0,60,45
1649894906989,COGS 101B,A01,091572,Staff,36,0,60,24
1649894913018,COGS 101C,A01,083625,Delgado; Tania,25,0,30,5
1649894919042,COGS 107A,A01,083627,Boyle; Mary E. T.,17,0,60,43
1649894925069,COGS 118A,A01,083075,Staff,23,0,60,37
1649894931095,CSE 3,A50,083646,Miranda; Gregory Joseph,26,0,38,12
1649894931095,CSE 3,A51,083647,Miranda; Gregory Joseph,37,0,37,0
1649894937118,CSE 8A,A50,083650,Miranda; Gregory Joseph,14,0,40,26
1649894943142,CSE 11,A01,083080,Cao; Yingjun,0,20,40,40
1649894949170,CSE 12,A01,083652,Staff,65,0,100,35
1649894955194,CSE 15L,A01,083654,Staff,24,0,50,26
1649894955194,CSE 15L,A02,083655,Staff,48,0,50,2
1649894961220,CSE 20,A01,083657,Staff,71,0,80,9
1649894967245,CSE 30,A01,083084,Eldon; John,1,8,40,39
1649894973266,CSE 100,A01,083659,Cao; Yingjun,2,15,50,48
1649894979292,CSE 134B,A01,083661,Powell; Thomas Allan,2,23,65,63
1649894985315,CSE 140,A01,083663,Staff,32,0,75,43
1649894991343,CSE 140L,A01,083088,Eldon; John,25,0,75,50
1649894997365,CSE 175,A01,083665,Kumar; Rakesh,13,0,25,12
1649895003399,CSE 190,A00,092507,Dubnov; Shlomo,14,0,15,1
1649895009438,ECE 45,A01,083139,Staff,17,0,40,23
1649895015468,ECE 65,A50,083695,Staff,11,0,30,19
1649895021495,ECE 109,A01,091882,Touri; Behrouz,58,0,70,12
1649895027525,ECE 180,A00,083140,Abi Samra; Nicholas Camill,27,0,30,3
1649895027525,ECE 180,B00,083141,Abi Samra; Nicholas Camill,13,0,30,17
1649895033550,MATH 10A,A01,083735,Patchell; Gregory David,23,0,30,7
1649895033550,MATH 10A,A02,083736,Patchell; Gregory David,28,0,30,2
1649895033550,MATH 10A,A03,083737,Patchell; Gregory David,28,0,30,2
1649895039578,MATH 10B,A01,083207,Staff,14,0,30,16
1649895039578,MATH 10B,A02,083208,Staff,25,0,30,5
1649895039578,MATH 10B,B01,083739,Staff,25,0,30,5
1649895039578,MATH 10B,B02,083740,Staff,30,0,30,0
1649895045605,MATH 18,A01,083743,Staff,22,0,30,8
1649895045605,MATH 18,A02,083744,Staff,29,0,30,1
1649895045605,MATH 18,A03,083745,Staff,29,0,30,1
1649895045605,MATH 18,A04,083746,Staff,29,0,30,1
1649895045605,MATH 18,B01,083748,Staff,13,0,30,17
1649895045605,MATH 18,B02,083749,Staff,27,0,30,3
1649895045605,MATH 18,B03,083750,Staff,28,0,30,2
1649895045605,MATH 18,B04,083751,Staff,28,0,30,2
1649895051628,MATH 20A,A01,083754,Staff,38,0,40,2
1649895057653,MATH 20B,A01,083756,Staff,25,0,30,5
1649895057653,MATH 20B,A02,083757,Staff,30,0,30,0
1649895063678,MATH 20C,A01,083760,Staff,23,0,30,7
1649895063678,MATH 20C,A02,083761,Staff,24,0,30,6
1649895063678,MATH 20C,B01,083762,Staff,29,0,30,1
1649895063678,MATH 20C,B02,083763,Staff,30,0,30,0
1649895069705,MATH 20D,A01,083765,Staff,21,0,30,9
1649895069705,MATH 20D,A02,083766,Staff,30,0,30,0
1649895069705,MATH 20D,A03,083767,Staff,30,0,30,0
1649895075730,MATH 20E,A01,083771,Staff,17,0,30,13
1649895075730,MATH 20E,A02,083772,Staff,27,0,30,3
1649895075730,MATH 20E,B01,083773,Staff,24,0,30,6
1649895075730,MATH 20E,B02,083774,Staff,29,0,30,1
1649895081772,MATH 103A,A01,083777,Staff,0,0,30,30
1649895081772,MATH 103A,A02,083778,Staff,3,0,30,27
1649895081772,MATH 103A,B01,083779,Staff,6,0,30,24
1649895081772,MATH 103A,B02,083780,Staff,22,0,30,8
1649895087801,MATH 105,A01,085443,Staff,0,2,30,30
1649895093826,MATH 109,A01,083213,Anzaldo; Leesa B,21,0,30,9
1649895093826,MATH 109,A02,083214,Anzaldo; Leesa B,16,0,30,14
1649895093826,MATH 109,B01,083215,Anzaldo; Leesa B,25,0,30,5
1649895093826,MATH 109,B02,083216,Anzaldo; Leesa B,25,0,30,5
1649895099859,MATH 142A,A01,083219,Chow; Bennett,0,1,30,30
1649895099859,MATH 142A,A02,083220,Chow; Bennett,18,0,30,12
1649895099859,MATH 142A,B01,083221,Chow; Bennett,0,0,30,30
1649895099859,MATH 142A,B02,083222,Chow; Bennett,18,0,30,12
1649895105882,MATH 193A,A01,083224,Staff,0,2,30,30
1649895105882,MATH 193A,A02,083225,Staff,0,3,30,30
1649895105882,MATH 193A,A03,083781,Staff,13,0,30,17
1649895105882,MATH 193A,A04,083782,Staff,22,0,30,8
1649895111995,MATH 197,001,091859,McAuley; Julian John,9999,0,9999,0
1649895118058,COGS 9,A01,083615,Staff,30,0,60,30
1649895124087,COGS 11,A01,083617,Boyle; Mary E. T.,36,0,40,4
1649895130110,COGS 13,A01,083071,Staff,1,0,40,39
1649895136135,COGS 14A,A01,092681,Staff,83,0,100,17
1649895142164,COGS 14B,A01,083073,Cheng; Tzu-Han,28,0,50,22
1649895148186,COGS 17,A01,092677,Staff,66,0,75,9
1649895154216,COGS 100,A01,083619,Staff,11,0,60,49
1649895160238,COGS 101A,A01,083621,Davis; Joshua Daniel,15,0,60,45
1649895166265,COGS 101B,A01,091572,Staff,36,0,60,24
1649895172288,COGS 101C,A01,083625,Delgado; Tania,25,0,30,5
1649895178323,COGS 107A,A01,083627,Boyle; Mary E. T.,17,0,60,43
1649895184352,COGS 118A,A01,083075,Staff,23,0,60,37
1649895190375,CSE 3,A50,083646,Miranda; Gregory Joseph,26,0,38,12
1649895190375,CSE 3,A51,083647,Miranda; Gregory Joseph,37,0,37,0
1649895196403,CSE 8A,A50,083650,Miranda; Gregory Joseph,13,0,40,27
1649895202426,CSE 11,A01,083080,Cao; Yingjun,0,20,40,40
1649895208453,CSE 12,A01,083652,Staff,65,0,100,35
1649895214488,CSE 15L,A01,083654,Staff,24,0,50,26
1649895214488,CSE 15L,A02,083655,Staff,48,0,50,2
1649895220514,CSE 20,A01,083657,Staff,71,0,80,9
1649895226556,CSE 30,A01,083084,Eldon; John,1,8,40,39
1649895232584,CSE 100,A01,083659,Cao; Yingjun,2,15,50,48
1649895238608,CSE 134B,A01,083661,Powell; Thomas Allan,2,23,65,63
1649895244635,CSE 140,A01,083663,Staff,32,0,75,43
1649895250658,CSE 140L,A01,083088,Eldon; John,25,0,75,50
1649895256685,CSE 175,A01,083665,Kumar; Rakesh,13,0,25,12
1649895262707,CSE 190,A00,092507,Dubnov; Shlomo,14,0,15,1
1649895268730,ECE 45,A01,083139,Staff,17,0,40,23
1649895274760,ECE 65,A50,083695,Staff,11,0,30,19
1649895280791,ECE 109,A01,091882,Touri; Behrouz,58,0,70,12
1649895286815,ECE 180,A00,083140,Abi Samra; Nicholas Camill,27,0,30,3
1649895286815,ECE 180,B00,083141,Abi Samra; Nicholas Camill,13,0,30,17
1649895292905,MATH 10A,A01,083735,Patchell; Gregory David,22,0,30,8
1649895292905,MATH 10A,A02,083736,Patchell; Gregory David,28,0,30,2
1649895292905,MATH 10A,A03,083737,Patchell; Gregory David,28,0,30,2
1649895298933,MATH 10B,A01,083207,Staff,14,0,30,16
1649895298933,MATH 10B,A02,083208,Staff,25,0,30,5
1649895298933,MATH 10B,B01,083739,Staff,25,0,30,5
1649895298933,MATH 10B,B02,083740,Staff,30,0,30,0
1649895304966,MATH 18,A01,083743,Staff,22,0,30,8
1649895304966,MATH 18,A02,083744,Staff,29,0,30,1
1649895304966,MATH 18,A03,083745,Staff,29,0,30,1
1649895304966,MATH 18,A04,083746,Staff,29,0,30,1
1649895304966,MATH 18,B01,083748,Staff,12,0,30,18
1649895304966,MATH 18,B02,083749,Staff,27,0,30,3
1649895304966,MATH 18,B03,083750,Staff,28,0,30,2
1649895304966,MATH 18,B04,083751,Staff,28,0,30,2
1649895310989,MATH 20A,A01,083754,Staff,38,0,40,2
1649895317013,MATH 20B,A01,083756,Staff,25,0,30,5
1649895317013,MATH 20B,A02,083757,Staff,30,0,30,0
1649895323038,MATH 20C,A01,083760,Staff,23,0,30,7
1649895323038,MATH 20C,A02,083761,Staff,24,0,30,6
1649895323038,MATH 20C,B01,083762,Staff,29,0,30,1
1649895323038,MATH 20C,B02,083763,Staff,30,0,30,0
1649895329066,MATH 20D,A01,083765,Staff,21,0,30,9
1649895329066,MATH 20D,A02,083766,Staff,30,0,30,0
1649895329066,MATH 20D,A03,083767,Staff,30,0,30,0
1649895335088,MATH 20E,A01,083771,Staff,17,0,30,13
1649895335088,MATH 20E,A02,083772,Staff,27,0,30,3
1649895335088,MATH 20E,B01,083773,Staff,24,0,30,6
1649895335088,MATH 20E,B02,083774,Staff,29,0,30,1
1649895341127,MATH 103A,A01,083777,Staff,0,0,30,30
1649895341127,MATH 103A,A02,083778,Staff,3,0,30,27
1649895341127,MATH 103A,B01,083779,Staff,6,0,30,24
1649895341127,MATH 103A,B02,083780,Staff,22,0,30,8
1649895347151,MATH 105,A01,085443,Staff,0,2,30,30
1649895353180,MATH 109,A01,083213,Anzaldo; Leesa B,21,0,30,9
1649895353180,MATH 109,A02,083214,Anzaldo; Leesa B,16,0,30,14
1649895353180,MATH 109,B01,083215,Anzaldo; Leesa B,25,0,30,5
1649895353180,MATH 109,B02,083216,Anzaldo; Leesa B,25,0,30,5
1649895359204,MATH 142A,A01,083219,Chow; Bennett,0,1,30,30
1649895359204,MATH 142A,A02,083220,Chow; Bennett,18,0,30,12
1649895359204,MATH 142A,B01,083221,Chow; Bennett,0,0,30,30
1649895359204,MATH 142A,B02,083222,Chow; Bennett,18,0,30,12
1649895365241,MATH 193A,A01,083224,Staff,0,2,30,30
1649895365241,MATH 193A,A02,083225,Staff,0,3,30,30
1649895365241,MATH 193A,A03,083781,Staff,13,0,30,17
1649895365241,MATH 193A,A04,083782,Staff,22,0,30,8
1649895371267,MATH 197,001,091859,McAuley; Julian John,9999,0,9999,0
1649895377336,COGS 9,A01,083615,Staff,30,0,60,30
1649895383358,COGS 11,A01,083617,Boyle; Mary E. T.,36,0,40,4
1649895389383,COGS 13,A01,083071,Staff,1,0,40,39
1649895395409,COGS 14A,A01,092681,Staff,83,0,100,17
1649895401435,COGS 14B,A01,083073,Cheng; Tzu-Han,28,0,50,22
1649895407470,COGS 17,A01,092677,Staff,66,0,75,9
1649895413498,COGS 100,A01,083619,Staff,11,0,60,49
1649895419520,COGS 101A,A01,083621,Davis; Joshua Daniel,15,0,60,45
1649895425543,COGS 101B,A01,091572,Staff,36,0,60,24
1649895431575,COGS 101C,A01,083625,Delgado; Tania,25,0,30,5
1649895437607,COGS 107A,A01,083627,Boyle; Mary E. T.,16,0,60,44
1649895443631,COGS 118A,A01,083075,Staff,23,0,60,37
1649895449660,CSE 3,A50,083646,Miranda; Gregory Joseph,26,0,38,12
1649895449660,CSE 3,A51,083647,Miranda; Gregory Joseph,37,0,37,0
1649895455688,CSE 8A,A50,083650,Miranda; Gregory Joseph,13,0,40,27
1649895461714,CSE 11,A01,083080,Cao; Yingjun,0,20,40,40
1649895467738,CSE 12,A01,083652,Staff,65,0,100,35
1649895473761,CSE 15L,A01,083654,Staff,24,0,50,26
1649895473761,CSE 15L,A02,083655,Staff,48,0,50,2
1649895479784,CSE 20,A01,083657,Staff,71,0,80,9
1649895485811,CSE 30,A01,083084,Eldon; John,1,8,40,39
1649895491834,CSE 100,A01,083659,Cao; Yingjun,2,15,50,48
1649895497860,CSE 134B,A01,083661,Powell; Thomas Allan,2,23,65,63
1649895503886,CSE 140,A01,083663,Staff,32,0,75,43
1649895509908,CSE 140L,A01,083088,Eldon; John,25,0,75,50
1649895515936,CSE 175,A01,083665,Kumar; Rakesh,13,0,25,12
1649895521959,CSE 190,A00,092507,Dubnov; Shlomo,14,0,15,1
1649895527982,ECE 45,A01,083139,Staff,17,0,40,23
1649895534007,ECE 65,A50,083695,Staff,11,0,30,19
1649895540033,ECE 109,A01,091882,Touri; Behrouz,59,0,70,11
1649895546059,ECE 180,A00,083140,Abi Samra; Nicholas Camill,27,0,30,3
1649895546059,ECE 180,B00,083141,Abi Samra; Nicholas Camill,13,0,30,17
1649895552082,MATH 10A,A01,083735,Patchell; Gregory David,22,0,30,8
1649895552082,MATH 10A,A02,083736,Patchell; Gregory David,28,0,30,2
1649895552082,MATH 10A,A03,083737,Patchell; Gregory David,28,0,30,2
1649895558106,MATH 10B,A01,083207,Staff,14,0,30,16
1649895558106,MATH 10B,A02,083208,Staff,25,0,30,5
1649895558106,MATH 10B,B01,083739,Staff,25,0,30,5
1649895558106,MATH 10B,B02,083740,Staff,30,0,30,0
1649895564141,MATH 18,A01,083743,Staff,22,0,30,8
1649895564141,MATH 18,A02,083744,Staff,29,0,30,1
1649895564141,MATH 18,A03,083745,Staff,29,0,30,1
1649895564141,MATH 18,A04,083746,Staff,29,0,30,1
1649895564141,MATH 18,B01,083748,Staff,12,0,30,18
1649895564141,MATH 18,B02,083749,Staff,27,0,30,3
1649895564141,MATH 18,B03,083750,Staff,28,0,30,2
1649895564141,MATH 18,B04,083751,Staff,28,0,30,2
1649895570165,MATH 20A,A01,083754,Staff,38,0,40,2
1649895576205,MATH 20B,A01,083756,Staff,25,0,30,5
1649895576205,MATH 20B,A02,083757,Staff,30,0,30,0
1649895582228,MATH 20C,A01,083760,Staff,23,0,30,7
1649895582228,MATH 20C,A02,083761,Staff,24,0,30,6
1649895582228,MATH 20C,B01,083762,Staff,29,0,30,1
1649895582228,MATH 20C,B02,083763,Staff,30,0,30,0
1649895588250,MATH 20D,A01,083765,Staff,21,0,30,9
1649895588250,MATH 20D,A02,083766,Staff,30,0,30,0
1649895588250,MATH 20D,A03,083767,Staff,30,0,30,0
1649895594277,MATH 20E,A01,083771,Staff,17,0,30,13
1649895594277,MATH 20E,A02,083772,Staff,27,0,30,3
1649895594277,MATH 20E,B01,083773,Staff,24,0,30,6
1649895594277,MATH 20E,B02,083774,Staff,29,0,30,1
1649895600302,MATH 103A,A01,083777,Staff,0,0,30,30
1649895600302,MATH 103A,A02,083778,Staff,3,0,30,27
1649895600302,MATH 103A,B01,083779,Staff,6,0,30,24
1649895600302,MATH 103A,B02,083780,Staff,22,0,30,8
1649895606335,MATH 105,A01,085443,Staff,0,2,30,30
1649895612360,MATH 109,A01,083213,Anzaldo; Leesa B,21,0,30,9
1649895612360,MATH 109,A02,083214,Anzaldo; Leesa B,16,0,30,14
1649895612360,MATH 109,B01,083215,Anzaldo; Leesa B,25,0,30,5
1649895612360,MATH 109,B02,083216,Anzaldo; Leesa B,25,0,30,5
1649895618387,MATH 142A,A01,083219,Chow; Bennett,0,1,30,30
1649895618387,MATH 142A,A02,083220,Chow; Bennett,18,0,30,12
1649895618387,MATH 142A,B01,083221,Chow; Bennett,0,0,30,30
1649895618387,MATH 142A,B02,083222,Chow; Bennett,18,0,30,12
1649895624426,MATH 193A,A01,083224,Staff,0,2,30,30
1649895624426,MATH 193A,A02,083225,Staff,0,3,30,30
1649895624426,MATH 193A,A03,083781,Staff,13,0,30,17
1649895624426,MATH 193A,A04,083782,Staff,22,0,30,8
1649895630455,MATH 197,001,091859,McAuley; Julian John,9999,0,9999,0
1649895636524,COGS 9,A01,083615,Staff,30,0,60,30
1649895642549,COGS 11,A01,083617,Boyle; Mary E. T.,36,0,40,4
1649895648584,COGS 13,A01,083071,Staff,1,0,40,39
1649895654609,COGS 14A,A01,092681,Staff,83,0,100,17
1649895660636,COGS 14B,A01,083073,Cheng; Tzu-Han,28,0,50,22
1649895666670,COGS 17,A01,092677,Staff,66,0,75,9
1649895672700,COGS 100,A01,083619,Staff,11,0,60,49
1649895678723,COGS 101A,A01,083621,Davis; Joshua Daniel,14,0,60,46
1649895684750,COGS 101B,A01,091572,Staff,36,0,60,24
1649895690778,COGS 101C,A01,083625,Delgado; Tania,25,0,30,5
1649895696802,COGS 107A,A01,083627,Boyle; Mary E. T.,16,0,60,44
1649895702916,COGS 118A,A01,083075,Staff,23,0,60,37
1649895708943,CSE 3,A50,083646,Miranda; Gregory Joseph,26,0,38,12
1649895708943,CSE 3,A51,083647,Miranda; Gregory Joseph,37,0,37,0
1649895714968,CSE 8A,A50,083650,Miranda; Gregory Joseph,12,0,40,28
1649895720992,CSE 11,A01,083080,Cao; Yingjun,0,20,40,40
1649895727020,CSE 12,A01,083652,Staff,65,0,100,35
1649895733043,CSE 15L,A01,083654,Staff,24,0,50,26
1649895733043,CSE 15L,A02,083655,Staff,48,0,50,2
1649895739066,CSE 20,A01,083657,Staff,71,0,80,9
1649895745090,CSE 30,A01,083084,Eldon; John,1,9,40,39
1649895751117,CSE 100,A01,083659,Cao; Yingjun,2,15,50,48
1649895757141,CSE 134B,A01,083661,Powell; Thomas Allan,2,23,65,63
1649895763164,CSE 140,A01,083663,Staff,31,0,75,44
1649895769191,CSE 140L,A01,083088,Eldon; John,25,0,75,50
1649895775214,CSE 175,A01,083665,Kumar; Rakesh,13,0,25,12
1649895781245,CSE 190,A00,092507,Dubnov; Shlomo,14,0,15,1
1649895787269,ECE 45,A01,083139,Staff,17,0,40,23
1649895793293,ECE 65,A50,083695,Staff,11,0,30,19
1649895799326,ECE 109,A01,091882,Touri; Behrouz,59,0,70,11
1649895805347,ECE 180,A00,083140,Abi Samra; Nicholas Camill,27,0,30,3
1649895805347,ECE 180,B00,083141,Abi Samra; Nicholas Camill,13,0,30,17
1649895811374,MATH 10A,A01,083735,Patchell; Gregory David,22,0,30,8
1649895811374,MATH 10A,A02,083736,Patchell; Gregory David,28,0,30,2
1649895811374,MATH 10A,A03,083737,Patchell; Gregory David,28,0,30,2
1649895817403,MATH 10B,A01,083207,Staff,13,0,30,17
1649895817403,MATH 10B,A02,083208,Staff,25,0,30,5
1649895817403,MATH 10B,B01,083739,Staff,25,0,30,5
1649895817403,MATH 10B,B02,083740,Staff,30,0,30,0
1649895823441,MATH 18,A01,083743,Staff,22,0,30,8
1649895823441,MATH 18,A02,083744,Staff,29,0,30,1
1649895823441,MATH 18,A03,083745,Staff,29,0,30,1
1649895823441,MATH 18,A04,083746,Staff,29,0,30,1
1649895823441,MATH 18,B01,083748,Staff,12,0,30,18
1649895823441,MATH 18,B02,083749,Staff,27,0,30,3
1649895823441,MATH 18,B03,083750,Staff,28,0,30,2
1649895823441,MATH 18,B04,083751,Staff,28,0,30,2
1649895829466,MATH 20A,A01,083754,Staff,38,0,40,2
1649895835495,MATH 20B,A01,083756,Staff,25,0,30,5
1649895835495,MATH 20B,A02,083757,Staff,30,0,30,0
1649895841528,MATH 20C,A01,083760,Staff,23,0,30,7
1649895841528,MATH 20C,A02,083761,Staff,24,0,30,6
1649895841528,MATH 20C,B01,083762,Staff,29,0,30,1
1649895841528,MATH 20C,B02,083763,Staff,30,0,30,0
1649895847555,MATH 20D,A01,083765,Staff,21,0,30,9
1649895847555,MATH 20D,A02,083766,Staff,30,0,30,0
1649895847555,MATH 20D,A03,083767,Staff,30,0,30,0
1649895853578,MATH 20E,A01,083771,Staff,17,0,30,13
1649895853578,MATH 20E,A02,083772,Staff,27,0,30,3
1649895853578,MATH 20E,B01,083773,Staff,24,0,30,6
1649895853578,MATH 20E,B02,083774,Staff,29,0,30,1
1649895859602,MATH 103A,A01,083777,Staff,0,0,30,30
1649895859602,MATH 103A,A02,083778,Staff,3,0,30,27
1649895859602,MATH 103A,B01,083779,Staff,6,0,30,24
1649895859602,MATH 103A,B02,083780,Staff,22,0,30,8
1649895865627,MATH 105,A01,085443,Staff,0,2,30,30
1649895871652,MATH 109,A01,083213,Anzaldo; Leesa B,20,0,30,10
1649895871652,MATH 109,A02,083214,Anzaldo; Leesa B,16,0,30,14
1649895871652,MATH 109,B01,083215,Anzaldo; Leesa B,25,0,30,5
1649895871652,MATH 109,B02,083216,Anzaldo; Leesa B,25,0,30,5
1649895877686,MATH 142A,A01,083219,Chow; Bennett,0,1,30,30
1649895877686,MATH 142A,A02,083220,Chow; Bennett,18,0,30,12
1649895877686,MATH 142A,B01,083221,Chow; Bennett,0,0,30,30
1649895877686,MATH 142A,B02,083222,Chow; Bennett,17,0,30,13
1649895883714,MATH 193A,A01,083224,Staff,0,2,30,30
1649895883714,MATH 193A,A02,083225,Staff,0,3,30,30
1649895883714,MATH 193A,A03,083781,Staff,13,0,30,17
1649895883714,MATH 193A,A04,083782,Staff,22,0,30,8
1649895889745,MATH 197,001,091859,McAuley; Julian John,9999,0,9999,0
1649895895810,COGS 9,A01,083615,Staff,28,0,60,32
1649895901842,COGS 11,A01,083617,Boyle; Mary E. T.,36,0,40,4
1649895907869,COGS 13,A01,083071,Staff,1,0,40,39
1649895913895,COGS 14A,A01,092681,Staff,82,0,100,18
1649895919919,COGS 14B,A01,083073,Cheng; Tzu-Han,28,0,50,22
1649895925945,COGS 17,A01,092677,Staff,66,0,75,9
1649895931972,COGS 100,A01,083619,Staff,11,0,60,49
1649895938000,COGS 101A,A01,083621,Davis; Joshua Daniel,14,0,60,46
1649895944024,COGS 101B,A01,091572,Staff,36,0,60,24
1649895950054,COGS 101C,A01,083625,Delgado; Tania,25,0,30,5
1649895956077,COGS 107A,A01,083627,Boyle; Mary E. T.,16,0,60,44
1649895962107,COGS 118A,A01,083075,Staff,23,0,60,37
1649895968139,CSE 3,A50,083646,Miranda; Gregory Joseph,26,0,38,12
1649895968139,CSE 3,A51,083647,Miranda; Gregory Joseph,37,0,37,0
1649895974171,CSE 8A,A50,083650,Miranda; Gregory Joseph,12,0,40,28
1649895980199,CSE 11,A01,083080,Cao; Yingjun,0,20,40,40
1649895986225,CSE 12,A01,083652,Staff,65,0,100,35
1649895992253,CSE 15L,A01,083654,Staff,24,0,50,26
1649895992253,CSE 15L,A02,083655,Staff,48,0,50,2
1649895998277,CSE 20,A01,083657,Staff,71,0,80,9
1649896004300,CSE 30,A01,083084,Eldon; John,1,9,40,39
1649896010322,CSE 100,A01,083659,Cao; Yingjun,2,15,50,48
1649896016347,CSE 134B,A01,083661,Powell; Thomas Allan,2,23,65,63
1649896022373,CSE 140,A01,083663,Staff,31,0,75,44
1649896028397,CSE 140L,A01,083088,Eldon; John,25,0,75,50
1649896034424,CSE 175,A01,083665,Kumar; Rakesh,13,0,25,12
1649896040448,CSE 190,A00,092507,Dubnov; Shlomo,14,0,15,1
1649896046472,ECE 45,A01,083139,Staff,17,0,40,23
1649896052499,ECE 65,A50,083695,Staff,11,0,30,19
1649896058523,ECE 109,A01,091882,Touri; Behrouz,59,0,70,11
1649896064545,ECE 180,A00,083140,Abi Samra; Nicholas Camill,27,0,30,3
1649896064545,ECE 180,B00,083141,Abi Samra; Nicholas Camill,13,0,30,17
1649896070572,MATH 10A,A01,083735,Patchell; Gregory David,22,0,30,8
1649896070572,MATH 10A,A02,083736,Patchell; Gregory David,28,0,30,2
1649896070572,MATH 10A,A03,083737,Patchell; Gregory David,28,0,30,2
1649896076595,MATH 10B,A01,083207,Staff,13,0,30,17
1649896076595,MATH 10B,A02,083208,Staff,25,0,30,5
1649896076595,MATH 10B,B01,083739,Staff,25,0,30,5
1649896076595,MATH 10B,B02,083740,Staff,30,0,30,0
1649896082625,MATH 18,A01,083743,Staff,22,0,30,8
1649896082625,MATH 18,A02,083744,Staff,29,0,30,1
1649896082625,MATH 18,A03,083745,Staff,29,0,30,1
1649896082625,MATH 18,A04,083746,Staff,29,0,30,1
1649896082625,MATH 18,B01,083748,Staff,12,0,30,18
1649896082625,MATH 18,B02,083749,Staff,27,0,30,3
1649896082625,MATH 18,B03,083750,Staff,28,0,30,2
1649896082625,MATH 18,B04,083751,Staff,28,0,30,2
1649896088649,MATH 20A,A01,083754,Staff,38,0,40,2
1649896094677,MATH 20B,A01,083756,Staff,25,0,30,5
1649896094677,MATH 20B,A02,083757,Staff,30,0,30,0
1649896100702,MATH 20C,A01,083760,Staff,23,0,30,7
1649896100702,MATH 20C,A02,083761,Staff,24,0,30,6
1649896100702,MATH 20C,B01,083762,Staff,29,0,30,1
1649896100702,MATH 20C,B02,083763,Staff,30,0,30,0
1649896106731,MATH 20D,A01,083765,Staff,21,0,30,9
1649896106731,MATH 20D,A02,083766,Staff,30,0,30,0
1649896106731,MATH 20D,A03,083767,Staff,30,0,30,0
1649896112758,MATH 20E,A01,083771,Staff,17,0,30,13
1649896112758,MATH 20E,A02,083772,Staff,27,0,30,3
1649896112758,MATH 20E,B01,083773,Staff,24,0,30,6
1649896112758,MATH 20E,B02,083774,Staff,29,0,30,1
1649896118785,MATH 103A,A01,083777,Staff,0,0,30,30
1649896118785,MATH 103A,A02,083778,Staff,3,0,30,27
1649896118785,MATH 103A,B01,083779,Staff,6,0,30,24
1649896118785,MATH 103A,B02,083780,Staff,22,0,30,8
1649896124809,MATH 105,A01,085443,Staff,0,2,30,30
1649896130834,MATH 109,A01,083213,Anzaldo; Leesa B,20,0,30,10
1649896130834,MATH 109,A02,083214,Anzaldo; Leesa B,16,0,30,14
1649896130834,MATH 109,B01,083215,Anzaldo; Leesa B,25,0,30,5
1649896130834,MATH 109,B02,083216,Anzaldo; Leesa B,25,0,30,5
1649896136863,MATH 142A,A01,083219,Chow; Bennett,0,1,30,30
1649896136863,MATH 142A,A02,083220,Chow; Bennett,18,0,30,12
1649896136863,MATH 142A,B01,083221,Chow; Bennett,0,0,30,30
1649896136863,MATH 142A,B02,083222,Chow; Bennett,17,0,30,13
1649896142889,MATH 193A,A01,083224,Staff,0,2,30,30
1649896142889,MATH 193A,A02,083225,Staff,0,3,30,30
1649896142889,MATH 193A,A03,083781,Staff,13,0,30,17
1649896142889,MATH 193A,A04,083782,Staff,22,0,30,8
1649896148912,MATH 197,001,091859,McAuley; Julian John,9999,0,9999,0
1649896154964,COGS 9,A01,083615,Staff,27,0,60,33
1649896160987,COGS 11,A01,083617,Boyle; Mary E. T.,36,0,40,4
1649896167010,COGS 13,A01,083071,Staff,1,0,40,39
1649896173041,COGS 14A,A01,092681,Staff,82,0,100,18
1649896179072,COGS 14B,A01,083073,Cheng; Tzu-Han,28,0,50,22
1649896185100,COGS 17,A01,092677,Staff,66,0,75,9
1649896191136,COGS 100,A01,083619,Staff,11,0,60,49
1649896197171,COGS 101A,A01,083621,Davis; Joshua Daniel,14,0,60,46
1649896203204,COGS 101B,A01,091572,Staff,36,0,60,24
1649896209227,COGS 101C,A01,083625,Delgado; Tania,25,0,30,5
1649896215252,COGS 107A,A01,083627,Boyle; Mary E. T.,16,0,60,44
1649896221288,COGS 118A,A01,083075,Staff,23,0,60,37
1649896227312,CSE 3,A50,083646,Miranda; Gregory Joseph,26,0,38,12
1649896227312,CSE 3,A51,083647,Miranda; Gregory Joseph,37,0,37,0
1649896233340,CSE 8A,A50,083650,Miranda; Gregory Joseph,12,0,40,28
1649896239364,CSE 11,A01,083080,Cao; Yingjun,0,20,40,40
1649896245389,CSE 12,A01,083652,Staff,65,0,100,35
1649896251416,CSE 15L,A01,083654,Staff,24,0,50,26
1649896251416,CSE 15L,A02,083655,Staff,48,0,50,2
1649896257438,CSE 20,A01,083657,Staff,71,0,80,9
1649896263467,CSE 30,A01,083084,Eldon; John,1,9,40,39
1649896269497,CSE 100,A01,083659,Cao; Yingjun,2,15,50,48
1649896275521,CSE 134B,A01,083661,Powell; Thomas Allan,2,23,65,63
1649896281551,CSE 140,A01,083663,Staff,31,0,75,44
1649896287572,CSE 140L,A01,083088,Eldon; John,24,0,75,51
1649896293595,CSE 175,A01,083665,Kumar; Rakesh,13,0,25,12
1649896299716,CSE 190,A00,092507,Dubnov; Shlomo,14,0,15,1
1649896305742,ECE 45,A01,083139,Staff,17,0,40,23
1649896321932,ECE 65,A50,083695,Staff,11,0,30,19
1649896327964,ECE 109,A01,091882,Touri; Behrouz,59,0,70,11
1649896333993,ECE 180,A00,083140,Abi Samra; Nicholas Camill,27,0,30,3
1649896333993,ECE 180,B00,083141,Abi Samra; Nicholas Camill,13,0,30,17
1649896340022,MATH 10A,A01,083735,Patchell; Gregory David,22,0,30,8
1649896340022,MATH 10A,A02,083736,Patchell; Gregory David,28,0,30,2
1649896340022,MATH 10A,A03,083737,Patchell; Gregory David,28,0,30,2
1649896346047,MATH 10B,A01,083207,Staff,13,0,30,17
1649896346047,MATH 10B,A02,083208,Staff,25,0,30,5
1649896346047,MATH 10B,B01,083739,Staff,25,0,30,5
1649896346047,MATH 10B,B02,083740,Staff,30,0,30,0
1649896352076,MATH 18,A01,083743,Staff,22,0,30,8
1649896352076,MATH 18,A02,083744,Staff,29,0,30,1
1649896352076,MATH 18,A03,083745,Staff,29,0,30,1
1649896352076,MATH 18,A04,083746,Staff,29,0,30,1
1649896352076,MATH 18,B01,083748,Staff,12,0,30,18
1649896352076,MATH 18,B02,083749,Staff,27,0,30,3
1649896352076,MATH 18,B03,083750,Staff,28,0,30,2
1649896352076,MATH 18,B04,083751,Staff,28,0,30,2
1649896358100,MATH 20A,A01,083754,Staff,38,0,40,2
1649896364123,MATH 20B,A01,083756,Staff,24,0,30,6
1649896364123,MATH 20B,A02,083757,Staff,30,0,30,0
1649896370146,MATH 20C,A01,083760,Staff,23,0,30,7
1649896370146,MATH 20C,A02,083761,Staff,24,0,30,6
1649896370146,MATH 20C,B01,083762,Staff,29,0,30,1
1649896370146,MATH 20C,B02,083763,Staff,30,0,30,0
1649896376169,MATH 20D,A01,083765,Staff,21,0,30,9
1649896376169,MATH 20D,A02,083766,Staff,30,0,30,0
1649896376169,MATH 20D,A03,083767,Staff,30,0,30,0
1649896382192,MATH 20E,A01,083771,Staff,17,0,30,13
1649896382192,MATH 20E,A02,083772,Staff,27,0,30,3
1649896382192,MATH 20E,B01,083773,Staff,24,0,30,6
1649896382192,MATH 20E,B02,083774,Staff,29,0,30,1
1649896388216,MATH 103A,A01,083777,Staff,0,0,30,30
1649896388216,MATH 103A,A02,083778,Staff,3,0,30,27
1649896388216,MATH 103A,B01,083779,Staff,6,0,30,24
1649896388216,MATH 103A,B02,083780,Staff,22,0,30,8
1649896394239,MATH 105,A01,085443,Staff,0,2,30,30
1649896400261,MATH 109,A01,083213,Anzaldo; Leesa B,20,0,30,10
1649896400261,MATH 109,A02,083214,Anzaldo; Leesa B,16,0,30,14
1649896400261,MATH 109,B01,083215,Anzaldo; Leesa B,25,0,30,5
1649896400261,MATH 109,B02,083216,Anzaldo; Leesa B,25,0,30,5
1649896406288,MATH 142A,A01,083219,Chow; Bennett,0,1,30,30
1649896406288,MATH 142A,A02,083220,Chow; Bennett,18,0,30,12
1649896406288,MATH 142A,B01,083221,Chow; Bennett,0,0,30,30
1649896406288,MATH 142A,B02,083222,Chow; Bennett,16,0,30,14
1649896412316,MATH 193A,A01,083224,Staff,0,2,30,30
1649896412316,MATH 193A,A02,083225,Staff,0,3,30,30
1649896412316,MATH 193A,A03,083781,Staff,13,0,30,17
1649896412316,MATH 193A,A04,083782,Staff,21,0,30,9
1649896418338,MATH 197,001,091859,McAuley; Julian John,9999,0,9999,0
1649896424397,COGS 9,A01,083615,Staff,27,0,60,33
1649896430419,COGS 11,A01,083617,Boyle; Mary E. T.,36,0,40,4
1649896436446,COGS 13,A01,083071,Staff,0,0,40,40
1649896442468,COGS 14A,A01,092681,Staff,80,0,100,20
1649896448490,COGS 14B,A01,083073,Cheng; Tzu-Han,28,0,50,22
1649896454518,COGS 17,A01,092677,Staff,66,0,75,9
1649896460543,COGS 100,A01,083619,Staff,10,0,60,50
1649896466566,COGS 101A,A01,083621,Davis; Joshua Daniel,13,0,60,47
1649896472588,COGS 101B,A01,091572,Staff,36,0,60,24
1649896478628,COGS 101C,A01,083625,Delgado; Tania,25,0,30,5
1649896484658,COGS 107A,A01,083627,Boyle; Mary E. T.,16,0,60,44
1649896490682,COGS 118A,A01,083075,Staff,23,0,60,37
1649896496715,CSE 3,A50,083646,Miranda; Gregory Joseph,26,0,38,12
1649896496715,CSE 3,A51,083647,Miranda; Gregory Joseph,37,0,37,0
1649896502742,CSE 8A,A50,083650,Miranda; Gregory Joseph,12,0,40,28
1649896508765,CSE 11,A01,083080,Cao; Yingjun,0,20,40,40
1649896514789,CSE 12,A01,083652,Staff,65,0,100,35
1649896520831,CSE 15L,A01,083654,Staff,24,0,50,26
1649896520831,CSE 15L,A02,083655,Staff,48,0,50,2
1649896526861,CSE 20,A01,083657,Staff,71,0,80,9
1649896532885,CSE 30,A01,083084,Eldon; John,1,9,40,39
1649896538909,CSE 100,A01,083659,Cao; Yingjun,2,16,50,48
1649896544935,CSE 134B,A01,083661,Powell; Thomas Allan,2,23,65,63
1649896550958,CSE 140,A01,083663,Staff,31,0,75,44
1649896556984,CSE 140L,A01,083088,Eldon; John,24,0,75,51
1649896563010,CSE 175,A01,083665,Kumar; Rakesh,13,0,25,12
1649896569035,CSE 190,A00,092507,Dubnov; Shlomo,14,0,15,1
1649896575079,ECE 45,A01,083139,Staff,17,0,40,23
1649896581110,ECE 65,A50,083695,Staff,11,0,30,19
1649896587133,ECE 109,A01,091882,Touri; Behrouz,59,0,70,11
1649896593157,ECE 180,A00,083140,Abi Samra; Nicholas Camill,27,0,30,3
1649896593157,ECE 180,B00,083141,Abi Samra; Nicholas Camill,13,0,30,17
1649896599181,MATH 10A,A01,083735,Patchell; Gregory David,22,0,30,8
1649896599181,MATH 10A,A02,083736,Patchell; Gregory David,28,0,30,2
1649896599181,MATH 10A,A03,083737,Patchell; Gregory David,28,0,30,2
1649896605207,MATH 10B,A01,083207,Staff,13,0,30,17
1649896605207,MATH 10B,A02,083208,Staff,25,0,30,5
1649896605207,MATH 10B,B01,083739,Staff,25,0,30,5
1649896605207,MATH 10B,B02,083740,Staff,30,0,30,0
1649896611233,MATH 18,A01,083743,Staff,22,0,30,8
1649896611233,MATH 18,A02,083744,Staff,29,0,30,1
1649896611233,MATH 18,A03,083745,Staff,29,0,30,1
1649896611233,MATH 18,A04,083746,Staff,29,0,30,1
1649896611233,MATH 18,B01,083748,Staff,12,0,30,18
1649896611233,MATH 18,B02,083749,Staff,27,0,30,3
1649896611233,MATH 18,B03,083750,Staff,28,0,30,2
1649896611233,MATH 18,B04,083751,Staff,28,0,30,2
1649896617255,MATH 20A,A01,083754,Staff,38,0,40,2
1649896623280,MATH 20B,A01,083756,Staff,24,0,30,6
1649896623280,MATH 20B,A02,083757,Staff,30,0,30,0
1649896629308,MATH 20C,A01,083760,Staff,23,0,30,7
1649896629308,MATH 20C,A02,083761,Staff,24,0,30,6
1649896629308,MATH 20C,B01,083762,Staff,29,0,30,1
1649896629308,MATH 20C,B02,083763,Staff,30,0,30,0
1649896635334,MATH 20D,A01,083765,Staff,21,0,30,9
1649896635334,MATH 20D,A02,083766,Staff,30,0,30,0
1649896635334,MATH 20D,A03,083767,Staff,30,0,30,0
1649896641357,MATH 20E,A01,083771,Staff,17,0,30,13
1649896641357,MATH 20E,A02,083772,Staff,27,0,30,3
1649896641357,MATH 20E,B01,083773,Staff,24,0,30,6
1649896641357,MATH 20E,B02,083774,Staff,29,0,30,1
1649896647384,MATH 103A,A01,083777,Staff,0,0,30,30
1649896647384,MATH 103A,A02,083778,Staff,3,0,30,27
1649896647384,MATH 103A,B01,083779,Staff,6,0,30,24
1649896647384,MATH 103A,B02,083780,Staff,22,0,30,8
1649896653408,MATH 105,A01,085443,Staff,0,2,30,30
1649896659434,MATH 109,A01,083213,Anzaldo; Leesa B,20,0,30,10
1649896659434,MATH 109,A02,083214,Anzaldo; Leesa B,16,0,30,14
1649896659434,MATH 109,B01,083215,Anzaldo; Leesa B,25,0,30,5
1649896659434,MATH 109,B02,083216,Anzaldo; Leesa B,25,0,30,5
1649896665459,MATH 142A,A01,083219,Chow; Bennett,0,1,30,30
1649896665459,MATH 142A,A02,083220,Chow; Bennett,18,0,30,12
1649896665459,MATH 142A,B01,083221,Chow; Bennett,0,0,30,30
1649896665459,MATH 142A,B02,083222,Chow; Bennett,16,0,30,14
1649896671491,MATH 193A,A01,083224,Staff,0,2,30,30
1649896671491,MATH 193A,A02,083225,Staff,0,3,30,30
1649896671491,MATH 193A,A03,083781,Staff,13,0,30,17
1649896671491,MATH 193A,A04,083782,Staff,21,0,30,9
1649896677521,MATH 197,001,091859,McAuley; Julian John,9999,0,9999,0
1649896683585,COGS 9,A01,083615,Staff,27,0,60,33
1649896689616,COGS 11,A01,083617,Boyle; Mary E. T.,36,0,40,4
1649896695640,COGS 13,A01,083071,Staff,0,1,40,40
1649896701667,COGS 14A,A01,092681,Staff,79,0,100,21
1649896707770,COGS 14B,A01,083073,Cheng; Tzu-Han,28,0,50,22
1649896713795,COGS 17,A01,092677,Staff,66,0,75,9
1649896719819,COGS 100,A01,083619,Staff,9,0,60,51
1649896725843,COGS 101A,A01,083621,Davis; Joshua Daniel,12,0,60,48
1649896731869,COGS 101B,A01,091572,Staff,36,0,60,24
1649896737907,COGS 101C,A01,083625,Delgado; Tania,25,0,30,5
1649896743934,COGS 107A,A01,083627,Boyle; Mary E. T.,16,0,60,44
1649896749975,COGS 118A,A01,083075,Staff,23,0,60,37
1649896756001,CSE 3,A50,083646,Miranda; Gregory Joseph,26,0,38,12
1649896756001,CSE 3,A51,083647,Miranda; Gregory Joseph,37,0,37,0
1649896762029,CSE 8A,A50,083650,Miranda; Gregory Joseph,11,0,40,29
1649896768053,CSE 11,A01,083080,Cao; Yingjun,0,20,40,40
1649896774077,CSE 12,A01,083652,Staff,64,0,100,36
1649896780103,CSE 15L,A01,083654,Staff,24,0,50,26
1649896780103,CSE 15L,A02,083655,Staff,47,0,50,3
1649896786125,CSE 20,A01,083657,Staff,71,0,80,9
1649896792162,CSE 30,A01,083084,Eldon; John,1,9,40,39
1649896798185,CSE 100,A01,083659,Cao; Yingjun,2,16,50,48
1649896804209,CSE 134B,A01,083661,Powell; Thomas Allan,2,23,65,63
1649896810236,CSE 140,A01,083663,Staff,31,0,75,44
1649896816262,CSE 140L,A01,083088,Eldon; John,24,0,75,51
1649896822290,CSE 175,A01,083665,Kumar; Rakesh,13,0,25,12
1649896828317,CSE 190,A00,092507,Dubnov; Shlomo,14,0,15,1
1649896834342,ECE 45,A01,083139,Staff,17,0,40,23
1649896840365,ECE 65,A50,083695,Staff,11,0,30,19
1649896846388,ECE 109,A01,091882,Touri; Behrouz,59,0,70,11
1649896852426,ECE 180,A00,083140,Abi Samra; Nicholas Camill,27,0,30,3
1649896852426,ECE 180,B00,083141,Abi Samra; Nicholas Camill,13,0,30,17
1649896858448,MATH 10A,A01,083735,Patchell; Gregory David,22,0,30,8
1649896858448,MATH 10A,A02,083736,Patchell; Gregory David,28,0,30,2
1649896858448,MATH 10A,A03,083737,Patchell; Gregory David,28,0,30,2
1649896864476,MATH 10B,A01,083207,Staff,13,0,30,17
1649896864476,MATH 10B,A02,083208,Staff,25,0,30,5
1649896864476,MATH 10B,B01,083739,Staff,25,0,30,5
1649896864476,MATH 10B,B02,083740,Staff,30,0,30,0
1649896870505,MATH 18,A01,083743,Staff,22,0,30,8
1649896870505,MATH 18,A02,083744,Staff,29,0,30,1
1649896870505,MATH 18,A03,083745,Staff,29,0,30,1
1649896870505,MATH 18,A04,083746,Staff,29,0,30,1
1649896870505,MATH 18,B01,083748,Staff,12,0,30,18
1649896870505,MATH 18,B02,083749,Staff,27,0,30,3
1649896870505,MATH 18,B03,083750,Staff,28,0,30,2
1649896870505,MATH 18,B04,083751,Staff,28,0,30,2
1649896876528,MATH 20A,A01,083754,Staff,38,0,40,2
1649896882558,MATH 20B,A01,083756,Staff,24,0,30,6
1649896882558,MATH 20B,A02,083757,Staff,30,0,30,0
1649896888585,MATH 20C,A01,083760,Staff,23,0,30,7
1649896888585,MATH 20C,A02,083761,Staff,24,0,30,6
1649896888585,MATH 20C,B01,083762,Staff,29,0,30,1
1649896888585,MATH 20C,B02,083763,Staff,30,0,30,0
1649896894609,MATH 20D,A01,083765,Staff,21,0,30,9
1649896894609,MATH 20D,A02,083766,Staff,30,0,30,0
1649896894609,MATH 20D,A03,083767,Staff,30,0,30,0
1649896900636,MATH 20E,A01,083771,Staff,17,0,30,13
1649896900636,MATH 20E,A02,083772,Staff,27,0,30,3
1649896900636,MATH 20E,B01,083773,Staff,24,0,30,6
1649896900636,MATH 20E,B02,083774,Staff,29,0,30,1
1649896906660,MATH 103A,A01,083777,Staff,0,0,30,30
1649896906660,MATH 103A,A02,083778,Staff,3,0,30,27
1649896906660,MATH 103A,B01,083779,Staff,6,0,30,24
1649896906660,MATH 103A,B02,083780,Staff,22,0,30,8
1649896912682,MATH 105,A01,085443,Staff,0,2,30,30
1649896918710,MATH 109,A01,083213,Anzaldo; Leesa B,20,0,30,10
1649896918710,MATH 109,A02,083214,Anzaldo; Leesa B,16,0,30,14
1649896918710,MATH 109,B01,083215,Anzaldo; Leesa B,25,0,30,5
1649896918710,MATH 109,B02,083216,Anzaldo; Leesa B,25,0,30,5
1649896924736,MATH 142A,A01,083219,Chow; Bennett,0,1,30,30
1649896924736,MATH 142A,A02,083220,Chow; Bennett,18,0,30,12
1649896924736,MATH 142A,B01,083221,Chow; Bennett,0,0,30,30
1649896924736,MATH 142A,B02,083222,Chow; Bennett,16,0,30,14
1649896930762,MATH 193A,A01,083224,Staff,0,2,30,30
1649896930762,MATH 193A,A02,083225,Staff,0,3,30,30
1649896930762,MATH 193A,A03,083781,Staff,13,0,30,17
1649896930762,MATH 193A,A04,083782,Staff,21,0,30,9
1649896936794,MATH 197,001,091859,McAuley; Julian John,9999,0,9999,0
1649896942851,COGS 9,A01,083615,Staff,26,0,60,34
1649896948877,COGS 11,A01,083617,Boyle; Mary E. T.,36,0,40,4
1649896954903,COGS 13,A01,083071,Staff,0,1,40,40
1649896960928,COGS 14A,A01,092681,Staff,79,0,100,21
1649896966962,COGS 14B,A01,083073,Cheng; Tzu-Han,28,0,50,22
1649896972990,COGS 17,A01,092677,Staff,66,0,75,9
1649896979021,COGS 100,A01,083619,Staff,8,0,60,52
1649896985050,COGS 101A,A01,083621,Davis; Joshua Daniel,11,0,60,49
1649896991077,COGS 101B,A01,091572,Staff,36,0,60,24
1649896997104,COGS 101C,A01,083625,Delgado; Tania,25,0,30,5
1649897003130,COGS 107A,A01,083627,Boyle; Mary E. T.,15,0,60,45
1649897009155,COGS 118A,A01,083075,Staff,23,0,60,37
1649897015181,CSE 3,A50,083646,Miranda; Gregory Joseph,26,0,38,12
1649897015181,CSE 3,A51,083647,Miranda; Gregory Joseph,37,0,37,0
1649897021204,CSE 8A,A50,083650,Miranda; Gregory Joseph,11,0,40,29
1649897027227,CSE 11,A01,083080,Cao; Yingjun,0,20,40,40
1649897033253,CSE 12,A01,083652,Staff,64,0,100,36
1649897039279,CSE 15L,A01,083654,Staff,24,0,50,26
1649897039279,CSE 15L,A02,083655,Staff,47,0,50,3
1649897045300,CSE 20,A01,083657,Staff,71,0,80,9
1649897051326,CSE 30,A01,083084,Eldon; John,1,9,40,39
1649897057348,CSE 100,A01,083659,Cao; Yingjun,2,16,50,48
1649897063376,CSE 134B,A01,083661,Powell; Thomas Allan,2,23,65,63
1649897069399,CSE 140,A01,083663,Staff,31,0,75,44
1649897075434,CSE 140L,A01,083088,Eldon; John,24,0,75,51
1649897081457,CSE 175,A01,083665,Kumar; Rakesh,13,0,25,12
1649897087479,CSE 190,A00,092507,Dubnov; Shlomo,14,0,15,1
1649897093507,ECE 45,A01,083139,Staff,17,0,40,23
1649897099532,ECE 65,A50,083695,Staff,11,0,30,19
1649897105554,ECE 109,A01,091882,Touri; Behrouz,59,0,70,11
1649897111578,ECE 180,A00,083140,Abi Samra; Nicholas Camill,27,0,30,3
1649897111578,ECE 180,B00,083141,Abi Samra; Nicholas Camill,13,0,30,17
1649897117604,MATH 10A,A01,083735,Patchell; Gregory David,22,0,30,8
1649897117604,MATH 10A,A02,083736,Patchell; Gregory David,28,0,30,2
1649897117604,MATH 10A,A03,083737,Patchell; Gregory David,28,0,30,2
1649897123635,MATH 10B,A01,083207,Staff,13,0,30,17
1649897123635,MATH 10B,A02,083208,Staff,25,0,30,5
1649897123635,MATH 10B,B01,083739,Staff,25,0,30,5
1649897123635,MATH 10B,B02,083740,Staff,30,0,30,0
1649897129665,MATH 18,A01,083743,Staff,22,0,30,8
1649897129665,MATH 18,A02,083744,Staff,29,0,30,1
1649897129665,MATH 18,A03,083745,Staff,29,0,30,1
1649897129665,MATH 18,A04,083746,Staff,29,0,30,1
1649897129665,MATH 18,B01,083748,Staff,12,0,30,18
1649897129665,MATH 18,B02,083749,Staff,27,0,30,3
1649897129665,MATH 18,B03,083750,Staff,28,0,30,2
1649897129665,MATH 18,B04,083751,Staff,28,0,30,2
1649897135688,MATH 20A,A01,083754,Staff,38,0,40,2
1649897141719,MATH 20B,A01,083756,Staff,24,0,30,6
1649897141719,MATH 20B,A02,083757,Staff,30,0,30,0
1649897147751,MATH 20C,A01,083760,Staff,23,0,30,7
1649897147751,MATH 20C,A02,083761,Staff,24,0,30,6
1649897147751,MATH 20C,B01,083762,Staff,29,0,30,1
1649897147751,MATH 20C,B02,083763,Staff,30,0,30,0
1649897153779,MATH 20D,A01,083765,Staff,21,0,30,9
1649897153779,MATH 20D,A02,083766,Staff,30,0,30,0
1649897153779,MATH 20D,A03,083767,Staff,30,0,30,0
1649897159802,MATH 20E,A01,083771,Staff,17,0,30,13
1649897159802,MATH 20E,A02,083772,Staff,27,0,30,3
1649897159802,MATH 20E,B01,083773,Staff,24,0,30,6
1649897159802,MATH 20E,B02,083774,Staff,29,0,30,1
1649897165826,MATH 103A,A01,083777,Staff,0,0,30,30
1649897165826,MATH 103A,A02,083778,Staff,3,0,30,27
1649897165826,MATH 103A,B01,083779,Staff,6,0,30,24
1649897165826,MATH 103A,B02,083780,Staff,22,0,30,8
1649897171853,MATH 105,A01,085443,Staff,0,2,30,30
1649897177882,MATH 109,A01,083213,Anzaldo; Leesa B,19,0,30,11
1649897177882,MATH 109,A02,083214,Anzaldo; Leesa B,16,0,30,14
1649897177882,MATH 109,B01,083215,Anzaldo; Leesa B,25,0,30,5
1649897177882,MATH 109,B02,083216,Anzaldo; Leesa B,25,0,30,5
1649897183911,MATH 142A,A01,083219,Chow; Bennett,0,1,30,30
1649897183911,MATH 142A,A02,083220,Chow; Bennett,18,0,30,12
1649897183911,MATH 142A,B01,083221,Chow; Bennett,0,0,30,30
1649897183911,MATH 142A,B02,083222,Chow; Bennett,16,0,30,14
1649897189938,MATH 193A,A01,083224,Staff,0,2,30,30
1649897189938,MATH 193A,A02,083225,Staff,0,3,30,30
1649897189938,MATH 193A,A03,083781,Staff,13,0,30,17
1649897189938,MATH 193A,A04,083782,Staff,21,0,30,9
1649897195964,MATH 197,001,091859,McAuley; Julian John,9999,0,9999,0
1649897202028,COGS 9,A01,083615,Staff,26,0,60,34
1649897208051,COGS 11,A01,083617,Boyle; Mary E. T.,36,0,40,4
1649897214078,COGS 13,A01,083071,Staff,0,2,40,40
1649897220104,COGS 14A,A01,092681,Staff,78,0,100,22
1649897226129,COGS 14B,A01,083073,Cheng; Tzu-Han,28,0,50,22
1649897232154,COGS 17,A01,092677,Staff,66,0,75,9
1649897238176,COGS 100,A01,083619,Staff,8,0,60,52
1649897244203,COGS 101A,A01,083621,Davis; Joshua Daniel,11,0,60,49
1649897250227,COGS 101B,A01,091572,Staff,36,0,60,24
1649897256257,COGS 101C,A01,083625,Delgado; Tania,25,0,30,5
1649897262282,COGS 107A,A01,083627,Boyle; Mary E. T.,15,0,60,45
1649897268305,COGS 118A,A01,083075,Staff,23,0,60,37
1649897274336,CSE 3,A50,083646,Miranda; Gregory Joseph,26,0,38,12
1649897274336,CSE 3,A51,083647,Miranda; Gregory Joseph,37,0,37,0
1649897280359,CSE 8A,A50,083650,Miranda; Gregory Joseph,11,0,40,29
1649897286386,CSE 11,A01,083080,Cao; Yingjun,0,20,40,40
1649897292410,CSE 12,A01,083652,Staff,64,0,100,36
1649897298434,CSE 15L,A01,083654,Staff,24,0,50,26
1649897298434,CSE 15L,A02,083655,Staff,47,0,50,3
1649897304555,CSE 20,A01,083657,Staff,71,0,80,9
1649897310587,CSE 30,A01,083084,Eldon; John,1,9,40,39
1649897316611,CSE 100,A01,083659,Cao; Yingjun,2,16,50,48
1649897322639,CSE 134B,A01,083661,Powell; Thomas Allan,2,23,65,63
1649897328665,CSE 140,A01,083663,Staff,30,0,75,45
1649897334689,CSE 140L,A01,083088,Eldon; John,23,0,75,52
1649897340714,CSE 175,A01,083665,Kumar; Rakesh,13,0,25,12
1649897346740,CSE 190,A00,092507,Dubnov; Shlomo,14,0,15,1
1649897352762,ECE 45,A01,083139,Staff,17,0,40,23
1649897358789,ECE 65,A50,083695,Staff,11,0,30,19
1649897364814,ECE 109,A01,091882,Touri; Behrouz,59,0,70,11
1649897370838,ECE 180,A00,083140,Abi Samra; Nicholas Camill,27,0,30,3
1649897370838,ECE 180,B00,083141,Abi Samra; Nicholas Camill,13,0,30,17
1649897376865,MATH 10A,A01,083735,Patchell; Gregory David,22,0,30,8
1649897376865,MATH 10A,A02,083736,Patchell; Gregory David,28,0,30,2
1649897376865,MATH 10A,A03,083737,Patchell; Gregory David,28,0,30,2
1649897382889,MATH 10B,A01,083207,Staff,13,0,30,17
1649897382889,MATH 10B,A02,083208,Staff,25,0,30,5
1649897382889,MATH 10B,B01,083739,Staff,25,0,30,5
1649897382889,MATH 10B,B02,083740,Staff,30,0,30,0
1649897388912,MATH 18,A01,083743,Staff,22,0,30,8
1649897388912,MATH 18,A02,083744,Staff,29,0,30,1
1649897388912,MATH 18,A03,083745,Staff,29,0,30,1
1649897388912,MATH 18,A04,083746,Staff,29,0,30,1
1649897388912,MATH 18,B01,083748,Staff,12,0,30,18
1649897388912,MATH 18,B02,083749,Staff,27,0,30,3
1649897388912,MATH 18,B03,083750,Staff,28,0,30,2
1649897388912,MATH 18,B04,083751,Staff,28,0,30,2
1649897394942,MATH 20A,A01,083754,Staff,38,0,40,2
1649897400966,MATH 20B,A01,083756,Staff,24,0,30,6
1649897400966,MATH 20B,A02,083757,Staff,30,0,30,0
1649897406998,MATH 20C,A01,083760,Staff,23,0,30,7
1649897406998,MATH 20C,A02,083761,Staff,24,0,30,6
1649897406998,MATH 20C,B01,083762,Staff,29,0,30,1
1649897406998,MATH 20C,B02,083763,Staff,30,0,30,0
1649897413025,MATH 20D,A01,083765,Staff,21,0,30,9
1649897413025,MATH 20D,A02,083766,Staff,30,0,30,0
1649897413025,MATH 20D,A03,083767,Staff,30,0,30,0
1649897419050,MATH 20E,A01,083771,Staff,17,0,30,13
1649897419050,MATH 20E,A02,083772,Staff,27,0,30,3
1649897419050,MATH 20E,B01,083773,Staff,24,0,30,6
1649897419050,MATH 20E,B02,083774,Staff,29,0,30,1
1649897425074,MATH 103A,A01,083777,Staff,0,0,30,30
1649897425074,MATH 103A,A02,083778,Staff,3,0,30,27
1649897425074,MATH 103A,B01,083779,Staff,6,0,30,24
1649897425074,MATH 103A,B02,083780,Staff,22,0,30,8
1649897431098,MATH 105,A01,085443,Staff,0,2,30,30
1649897437125,MATH 109,A01,083213,Anzaldo; Leesa B,19,0,30,11
1649897437125,MATH 109,A02,083214,Anzaldo; Leesa B,16,0,30,14
1649897437125,MATH 109,B01,083215,Anzaldo; Leesa B,25,0,30,5
1649897437125,MATH 109,B02,083216,Anzaldo; Leesa B,25,0,30,5
1649897443149,MATH 142A,A01,083219,Chow; Bennett,0,1,30,30
1649897443149,MATH 142A,A02,083220,Chow; Bennett,18,0,30,12
1649897443149,MATH 142A,B01,083221,Chow; Bennett,0,0,30,30
1649897443149,MATH 142A,B02,083222,Chow; Bennett,16,0,30,14
1649897449176,MATH 193A,A01,083224,Staff,0,2,30,30
1649897449176,MATH 193A,A02,083225,Staff,0,3,30,30
1649897449176,MATH 193A,A03,083781,Staff,13,0,30,17
1649897449176,MATH 193A,A04,083782,Staff,21,0,30,9
1649897455199,MATH 197,001,091859,McAuley; Julian John,9999,0,9999,0
1649897461262,COGS 9,A01,083615,Staff,26,0,60,34
1649897467288,COGS 11,A01,083617,Boyle; Mary E. T.,36,0,40,4
1649897473315,COGS 13,A01,083071,Staff,0,2,40,40
1649897479341,COGS 14A,A01,092681,Staff,78,0,100,22
1649897485363,COGS 14B,A01,083073,Cheng; Tzu-Han,28,0,50,22
1649897491394,COGS 17,A01,092677,Staff,66,0,75,9
1649897497418,COGS 100,A01,083619,Staff,8,0,60,52
1649897503443,COGS 101A,A01,083621,Davis; Joshua Daniel,11,0,60,49
1649897509467,COGS 101B,A01,091572,Staff,36,0,60,24
1649897515494,COGS 101C,A01,083625,Delgado; Tania,25,0,30,5
1649897521521,COGS 107A,A01,083627,Boyle; Mary E. T.,16,0,60,44
1649897527545,COGS 118A,A01,083075,Staff,23,0,60,37
1649897533572,CSE 3,A50,083646,Miranda; Gregory Joseph,26,0,38,12
1649897533572,CSE 3,A51,083647,Miranda; Gregory Joseph,37,0,37,0
1649897539596,CSE 8A,A50,083650,Miranda; Gregory Joseph,11,0,40,29
1649897545622,CSE 11,A01,083080,Cao; Yingjun,0,21,40,40
1649897551645,CSE 12,A01,083652,Staff,63,0,100,37
1649897557672,CSE 15L,A01,083654,Staff,23,0,50,27
1649897557672,CSE 15L,A02,083655,Staff,47,0,50,3
1649897563697,CSE 20,A01,083657,Staff,71,0,80,9
1649897569719,CSE 30,A01,083084,Eldon; John,1,9,40,39
1649897575745,CSE 100,A01,083659,Cao; Yingjun,2,16,50,48
1649897581769,CSE 134B,A01,083661,Powell; Thomas Allan,2,23,65,63
1649897587791,CSE 140,A01,083663,Staff,30,0,75,45
1649897593817,CSE 140L,A01,083088,Eldon; John,23,0,75,52
1649897599843,CSE 175,A01,083665,Kumar; Rakesh,13,0,25,12
1649897605868,CSE 190,A00,092507,Dubnov; Shlomo,14,0,15,1
1649897611894,ECE 45,A01,083139,Staff,16,0,40,24
1649897617923,ECE 65,A50,083695,Staff,11,0,30,19
1649897623946,ECE 109,A01,091882,Touri; Behrouz,59,0,70,11
1649897629970,ECE 180,A00,083140,Abi Samra; Nicholas Camill,27,0,30,3
1649897629970,ECE 180,B00,083141,Abi Samra; Nicholas Camill,13,0,30,17
1649897635998,MATH 10A,A01,083735,Patchell; Gregory David,22,0,30,8
1649897635998,MATH 10A,A02,083736,Patchell; Gregory David,28,0,30,2
1649897635998,MATH 10A,A03,083737,Patchell; Gregory David,28,0,30,2
1649897642023,MATH 10B,A01,083207,Staff,13,0,30,17
1649897642023,MATH 10B,A02,083208,Staff,25,0,30,5
1649897642023,MATH 10B,B01,083739,Staff,25,0,30,5
1649897642023,MATH 10B,B02,083740,Staff,30,0,30,0
1649897648061,MATH 18,A01,083743,Staff,22,0,30,8
1649897648061,MATH 18,A02,083744,Staff,29,0,30,1
1649897648061,MATH 18,A03,083745,Staff,29,0,30,1
1649897648061,MATH 18,A04,083746,Staff,29,0,30,1
1649897648061,MATH 18,B01,083748,Staff,12,0,30,18
1649897648061,MATH 18,B02,083749,Staff,26,0,30,4
1649897648061,MATH 18,B03,083750,Staff,28,0,30,2
1649897648061,MATH 18,B04,083751,Staff,28,0,30,2
1649897654082,MATH 20A,A01,083754,Staff,38,0,40,2
1649897660107,MATH 20B,A01,083756,Staff,23,0,30,7
1649897660107,MATH 20B,A02,083757,Staff,30,0,30,0
1649897666130,MATH 20C,A01,083760,Staff,23,0,30,7
1649897666130,MATH 20C,A02,083761,Staff,24,0,30,6
1649897666130,MATH 20C,B01,083762,Staff,29,0,30,1
1649897666130,MATH 20C,B02,083763,Staff,30,0,30,0
1649897672154,MATH 20D,A01,083765,Staff,21,0,30,9
1649897672154,MATH 20D,A02,083766,Staff,30,0,30,0
1649897672154,MATH 20D,A03,083767,Staff,30,0,30,0
1649897678180,MATH 20E,A01,083771,Staff,17,0,30,13
1649897678180,MATH 20E,A02,083772,Staff,27,0,30,3
1649897678180,MATH 20E,B01,083773,Staff,24,0,30,6
1649897678180,MATH 20E,B02,083774,Staff,29,0,30,1
1649897684210,MATH 103A,A01,083777,Staff,0,0,30,30
1649897684210,MATH 103A,A02,083778,Staff,2,0,30,28
1649897684210,MATH 103A,B01,083779,Staff,6,0,30,24
1649897684210,MATH 103A,B02,083780,Staff,22,0,30,8
1649897690235,MATH 105,A01,085443,Staff,0,2,30,30
1649897696258,MATH 109,A01,083213,Anzaldo; Leesa B,18,0,30,12
1649897696258,MATH 109,A02,083214,Anzaldo; Leesa B,16,0,30,14
1649897696258,MATH 109,B01,083215,Anzaldo; Leesa B,25,0,30,5
1649897696258,MATH 109,B02,083216,Anzaldo; Leesa B,25,0,30,5
1649897702282,MATH 142A,A01,083219,Chow; Bennett,0,1,30,30
1649897702282,MATH 142A,A02,083220,Chow; Bennett,18,0,30,12
1649897702282,MATH 142A,B01,083221,Chow; Bennett,0,0,30,30
1649897702282,MATH 142A,B02,083222,Chow; Bennett,16,0,30,14
1649897708304,MATH 193A,A01,083224,Staff,0,2,30,30
1649897708304,MATH 193A,A02,083225,Staff,0,3,30,30
1649897708304,MATH 193A,A03,083781,Staff,13,0,30,17
1649897708304,MATH 193A,A04,083782,Staff,21,0,30,9
1649897714334,MATH 197,001,091859,McAuley; Julian John,9999,0,9999,0
1649897720386,COGS 9,A01,083615,Staff,26,0,60,34
1649897726410,COGS 11,A01,083617,Boyle; Mary E. T.,36,0,40,4
1649897732433,COGS 13,A01,083071,Staff,0,2,40,40
1649897738456,COGS 14A,A01,092681,Staff,78,0,100,22
1649897744489,COGS 14B,A01,083073,Cheng; Tzu-Han,28,0,50,22
1649897750512,COGS 17,A01,092677,Staff,66,0,75,9
1649897756537,COGS 100,A01,083619,Staff,8,0,60,52
1649897762560,COGS 101A,A01,083621,Davis; Joshua Daniel,11,0,60,49
1649897768589,COGS 101B,A01,091572,Staff,35,0,60,25
1649897774622,COGS 101C,A01,083625,Delgado; Tania,25,0,30,5
1649897780655,COGS 107A,A01,083627,Boyle; Mary E. T.,16,0,60,44
1649897786677,COGS 118A,A01,083075,Staff,23,0,60,37
1649897792699,CSE 3,A50,083646,Miranda; Gregory Joseph,26,0,38,12
1649897792699,CSE 3,A51,083647,Miranda; Gregory Joseph,37,0,37,0
1649897798724,CSE 8A,A50,083650,Miranda; Gregory Joseph,11,0,40,29
1649897804750,CSE 11,A01,083080,Cao; Yingjun,0,21,40,40
1649897810775,CSE 12,A01,083652,Staff,63,0,100,37
1649897816798,CSE 15L,A01,083654,Staff,23,0,50,27
1649897816798,CSE 15L,A02,083655,Staff,47,0,50,3
1649897822827,CSE 20,A01,083657,Staff,71,0,80,9
1649897828850,CSE 30,A01,083084,Eldon; John,1,10,40,39
1649897834873,CSE 100,A01,083659,Cao; Yingjun,2,16,50,48
1649897840896,CSE 134B,A01,083661,Powell; Thomas Allan,2,23,65,63
1649897846919,CSE 140,A01,083663,Staff,30,0,75,45
1649897852944,CSE 140L,A01,083088,Eldon; John,23,0,75,52
1649897858968,CSE 175,A01,083665,Kumar; Rakesh,13,0,25,12
1649897864996,CSE 190,A00,092507,Dubnov; Shlomo,14,0,15,1
1649897871025,ECE 45,A01,083139,Staff,16,0,40,24
1649897877051,ECE 65,A50,083695,Staff,11,0,30,19
1649897883079,ECE 109,A01,091882,Touri; Behrouz,59,0,70,11
1649897889107,ECE 180,A00,083140,Abi Samra; Nicholas Camill,27,0,30,3
1649897889107,ECE 180,B00,083141,Abi Samra; Nicholas Camill,13,0,30,17
1649897895138,MATH 10A,A01,083735,Patchell; Gregory David,22,0,30,8
1649897895138,MATH 10A,A02,083736,Patchell; Gregory David,28,0,30,2
1649897895138,MATH 10A,A03,083737,Patchell; Gregory David,28,0,30,2
1649897901258,MATH 10B,A01,083207,Staff,13,0,30,17
1649897901258,MATH 10B,A02,083208,Staff,25,0,30,5
1649897901258,MATH 10B,B01,083739,Staff,25,0,30,5
1649897901258,MATH 10B,B02,083740,Staff,30,0,30,0
1649897907283,MATH 18,A01,083743,Staff,22,0,30,8
1649897907283,MATH 18,A02,083744,Staff,29,0,30,1
1649897907283,MATH 18,A03,083745,Staff,29,0,30,1
1649897907283,MATH 18,A04,083746,Staff,29,0,30,1
1649897907283,MATH 18,B01,083748,Staff,12,0,30,18
1649897907283,MATH 18,B02,083749,Staff,26,0,30,4
1649897907283,MATH 18,B03,083750,Staff,28,0,30,2
1649897907283,MATH 18,B04,083751,Staff,27,0,30,3
1649897913311,MATH 20A,A01,083754,Staff,38,0,40,2
1649897919334,MATH 20B,A01,083756,Staff,23,0,30,7
1649897919334,MATH 20B,A02,083757,Staff,30,0,30,0
1649897925358,MATH 20C,A01,083760,Staff,23,0,30,7
1649897925358,MATH 20C,A02,083761,Staff,24,0,30,6
1649897925358,MATH 20C,B01,083762,Staff,29,0,30,1
1649897925358,MATH 20C,B02,083763,Staff,30,0,30,0
1649897931384,MATH 20D,A01,083765,Staff,21,0,30,9
1649897931384,MATH 20D,A02,083766,Staff,30,0,30,0
1649897931384,MATH 20D,A03,083767,Staff,30,0,30,0
1649897937412,MATH 20E,A01,083771,Staff,17,0,30,13
1649897937412,MATH 20E,A02,083772,Staff,27,0,30,3
1649897937412,MATH 20E,B01,083773,Staff,24,0,30,6
1649897937412,MATH 20E,B02,083774,Staff,29,0,30,1
1649897943455,MATH 103A,A01,083777,Staff,0,0,30,30
1649897943455,MATH 103A,A02,083778,Staff,2,0,30,28
1649897943455,MATH 103A,B01,083779,Staff,6,0,30,24
1649897943455,MATH 103A,B02,083780,Staff,22,0,30,8
1649897949485,MATH 105,A01,085443,Staff,0,2,30,30
1649897955514,MATH 109,A01,083213,Anzaldo; Leesa B,18,0,30,12
1649897955514,MATH 109,A02,083214,Anzaldo; Leesa B,16,0,30,14
1649897955514,MATH 109,B01,083215,Anzaldo; Leesa B,25,0,30,5
1649897955514,MATH 109,B02,083216,Anzaldo; Leesa B,25,0,30,5
1649897961538,MATH 142A,A01,083219,Chow; Bennett,0,1,30,30
1649897961538,MATH 142A,A02,083220,Chow; Bennett,18,0,30,12
1649897961538,MATH 142A,B01,083221,Chow; Bennett,0,0,30,30
1649897961538,MATH 142A,B02,083222,Chow; Bennett,16,0,30,14
1649897967564,MATH 193A,A01,083224,Staff,0,2,30,30
1649897967564,MATH 193A,A02,083225,Staff,0,3,30,30
1649897967564,MATH 193A,A03,083781,Staff,13,0,30,17
1649897967564,MATH 193A,A04,083782,Staff,21,0,30,9
1649897973591,MATH 197,001,091859,McAuley; Julian John,9999,0,9999,0
1649897979643,COGS 9,A01,083615,Staff,26,0,60,34
1649897985670,COGS 11,A01,083617,Boyle; Mary E. T.,36,0,40,4
1649897991697,COGS 13,A01,083071,Staff,0,2,40,40
1649897997723,COGS 14A,A01,092681,Staff,78,0,100,22
1649898003750,COGS 14B,A01,083073,Cheng; Tzu-Han,28,0,50,22
1649898009774,COGS 17,A01,092677,Staff,66,0,75,9
1649898015800,COGS 100,A01,083619,Staff,8,0,60,52
1649898021828,COGS 101A,A01,083621,Davis; Joshua Daniel,11,0,60,49
1649898027856,COGS 101B,A01,091572,Staff,35,0,60,25
1649898033878,COGS 101C,A01,083625,Delgado; Tania,25,0,30,5
1649898039902,COGS 107A,A01,083627,Boyle; Mary E. T.,16,0,60,44
1649898045927,COGS 118A,A01,083075,Staff,23,0,60,37
1649898051953,CSE 3,A50,083646,Miranda; Gregory Joseph,26,0,38,12
1649898051953,CSE 3,A51,083647,Miranda; Gregory Joseph,37,0,37,0
1649898057976,CSE 8A,A50,083650,Miranda; Gregory Joseph,11,0,40,29
1649898064001,CSE 11,A01,083080,Cao; Yingjun,0,21,40,40
1649898070023,CSE 12,A01,083652,Staff,63,0,100,37
1649898076061,CSE 15L,A01,083654,Staff,23,0,50,27
1649898076061,CSE 15L,A02,083655,Staff,47,0,50,3
1649898082086,CSE 20,A01,083657,Staff,71,0,80,9
1649898088109,CSE 30,A01,083084,Eldon; John,1,11,40,39
1649898094133,CSE 100,A01,083659,Cao; Yingjun,2,16,50,48
1649898100170,CSE 134B,A01,083661,Powell; Thomas Allan,2,23,65,63
1649898106193,CSE 140,A01,083663,Staff,30,0,75,45
1649898112219,CSE 140L,A01,083088,Eldon; John,23,0,75,52
1649898118249,CSE 175,A01,083665,Kumar; Rakesh,13,0,25,12
1649898124276,CSE 190,A00,092507,Dubnov; Shlomo,14,0,15,1
1649898130303,ECE 45,A01,083139,Staff,16,0,40,24
1649898136329,ECE 65,A50,083695,Staff,11,0,30,19
1649898142363,ECE 109,A01,091882,Touri; Behrouz,59,0,70,11
1649898148385,ECE 180,A00,083140,Abi Samra; Nicholas Camill,27,0,30,3
1649898148385,ECE 180,B00,083141,Abi Samra; Nicholas Camill,13,0,30,17
1649898154427,MATH 10A,A01,083735,Patchell; Gregory David,22,0,30,8
1649898154427,MATH 10A,A02,083736,Patchell; Gregory David,28,0,30,2
1649898154427,MATH 10A,A03,083737,Patchell; Gregory David,28,0,30,2
1649898160450,MATH 10B,A01,083207,Staff,13,0,30,17
1649898160450,MATH 10B,A02,083208,Staff,25,0,30,5
1649898160450,MATH 10B,B01,083739,Staff,25,0,30,5
1649898160450,MATH 10B,B02,083740,Staff,30,0,30,0
1649898166475,MATH 18,A01,083743,Staff,22,0,30,8
1649898166475,MATH 18,A02,083744,Staff,29,0,30,1
1649898166475,MATH 18,A03,083745,Staff,29,0,30,1
1649898166475,MATH 18,A04,083746,Staff,29,0,30,1
1649898166475,MATH 18,B01,083748,Staff,12,0,30,18
1649898166475,MATH 18,B02,083749,Staff,26,0,30,4
1649898166475,MATH 18,B03,083750,Staff,28,0,30,2
1649898166475,MATH 18,B04,083751,Staff,27,0,30,3
1649898172502,MATH 20A,A01,083754,Staff,38,0,40,2
1649898178526,MATH 20B,A01,083756,Staff,22,0,30,8
1649898178526,MATH 20B,A02,083757,Staff,30,0,30,0
1649898184550,MATH 20C,A01,083760,Staff,23,0,30,7
1649898184550,MATH 20C,A02,083761,Staff,24,0,30,6
1649898184550,MATH 20C,B01,083762,Staff,29,0,30,1
1649898184550,MATH 20C,B02,083763,Staff,30,0,30,0
1649898190574,MATH 20D,A01,083765,Staff,21,0,30,9
1649898190574,MATH 20D,A02,083766,Staff,30,0,30,0
1649898190574,MATH 20D,A03,083767,Staff,30,0,30,0
1649898196598,MATH 20E,A01,083771,Staff,17,0,30,13
1649898196598,MATH 20E,A02,083772,Staff,27,0,30,3
1649898196598,MATH 20E,B01,083773,Staff,24,0,30,6
1649898196598,MATH 20E,B02,083774,Staff,29,0,30,1
1649898202623,MATH 103A,A01,083777,Staff,0,0,30,30
1649898202623,MATH 103A,A02,083778,Staff,2,0,30,28
1649898202623,MATH 103A,B01,083779,Staff,6,0,30,24
1649898202623,MATH 103A,B02,083780,Staff,22,0,30,8
1649898208647,MATH 105,A01,085443,Staff,0,2,30,30
1649898214672,MATH 109,A01,083213,Anzaldo; Leesa B,18,0,30,12
1649898214672,MATH 109,A02,083214,Anzaldo; Leesa B,16,0,30,14
1649898214672,MATH 109,B01,083215,Anzaldo; Leesa B,25,0,30,5
1649898214672,MATH 109,B02,083216,Anzaldo; Leesa B,25,0,30,5
1649898220696,MATH 142A,A01,083219,Chow; Bennett,0,1,30,30
1649898220696,MATH 142A,A02,083220,Chow; Bennett,18,0,30,12
1649898220696,MATH 142A,B01,083221,Chow; Bennett,0,0,30,30
1649898220696,MATH 142A,B02,083222,Chow; Bennett,16,0,30,14
1649898226725,MATH 193A,A01,083224,Staff,0,2,30,30
1649898226725,MATH 193A,A02,083225,Staff,0,3,30,30
1649898226725,MATH 193A,A03,083781,Staff,12,0,30,18
1649898226725,MATH 193A,A04,083782,Staff,21,0,30,9
1649898232750,MATH 197,001,091859,McAuley; Julian John,9999,0,9999,0
1649898238820,COGS 9,A01,083615,Staff,25,0,60,35
1649898244852,COGS 11,A01,083617,Boyle; Mary E. T.,35,0,40,5
1649898250876,COGS 13,A01,083071,Staff,0,2,40,40
1649898256909,COGS 14A,A01,092681,Staff,77,0,100,23
1649898262947,COGS 14B,A01,083073,Cheng; Tzu-Han,28,0,50,22
1649898268970,COGS 17,A01,092677,Staff,66,0,75,9
1649898275054,COGS 100,A01,083619,Staff,7,0,60,53
1649898281078,COGS 101A,A01,083621,Davis; Joshua Daniel,10,0,60,50
1649898287103,COGS 101B,A01,091572,Staff,35,0,60,25
1649898293141,COGS 101C,A01,083625,Delgado; Tania,24,0,30,6
1649898299163,COGS 107A,A01,083627,Boyle; Mary E. T.,16,0,60,44
1649898305186,COGS 118A,A01,083075,Staff,23,0,60,37
1649898311209,CSE 3,A50,083646,Miranda; Gregory Joseph,26,0,38,12
1649898311209,CSE 3,A51,083647,Miranda; Gregory Joseph,37,0,37,0
1649898317233,CSE 8A,A50,083650,Miranda; Gregory Joseph,11,0,40,29
1649898323265,CSE 11,A01,083080,Cao; Yingjun,0,21,40,40
1649898329289,CSE 12,A01,083652,Staff,63,0,100,37
1649898335315,CSE 15L,A01,083654,Staff,23,0,50,27
1649898335315,CSE 15L,A02,083655,Staff,47,0,50,3
1649898341348,CSE 20,A01,083657,Staff,71,0,80,9
1649898347372,CSE 30,A01,083084,Eldon; John,1,11,40,39
1649898353396,CSE 100,A01,083659,Cao; Yingjun,2,16,50,48
1649898359419,CSE 134B,A01,083661,Powell; Thomas Allan,2,23,65,63
1649898365449,CSE 140,A01,083663,Staff,30,0,75,45
1649898371472,CSE 140L,A01,083088,Eldon; John,23,0,75,52
1649898377497,CSE 175,A01,083665,Kumar; Rakesh,13,0,25,12
1649898383520,CSE 190,A00,092507,Dubnov; Shlomo,14,0,15,1
1649898389554,ECE 45,A01,083139,Staff,16,0,40,24
1649898395579,ECE 65,A50,083695,Staff,11,0,30,19
1649898401612,ECE 109,A01,091882,Touri; Behrouz,59,0,70,11
1649898407636,ECE 180,A00,083140,Abi Samra; Nicholas Camill,27,0,30,3
1649898407636,ECE 180,B00,083141,Abi Samra; Nicholas Camill,13,0,30,17
1649898413661,MATH 10A,A01,083735,Patchell; Gregory David,22,0,30,8
1649898413661,MATH 10A,A02,083736,Patchell; Gregory David,28,0,30,2
1649898413661,MATH 10A,A03,083737,Patchell; Gregory David,28,0,30,2
1649898419692,MATH 10B,A01,083207,Staff,13,0,30,17
1649898419692,MATH 10B,A02,083208,Staff,25,0,30,5
1649898419692,MATH 10B,B01,083739,Staff,25,0,30,5
1649898419692,MATH 10B,B02,083740,Staff,30,0,30,0
1649898425718,MATH 18,A01,083743,Staff,22,0,30,8
1649898425718,MATH 18,A02,083744,Staff,29,0,30,1
1649898425718,MATH 18,A03,083745,Staff,29,0,30,1
1649898425718,MATH 18,A04,083746,Staff,29,0,30,1
1649898425718,MATH 18,B01,083748,Staff,12,0,30,18
1649898425718,MATH 18,B02,083749,Staff,26,0,30,4
1649898425718,MATH 18,B03,083750,Staff,28,0,30,2
1649898425718,MATH 18,B04,083751,Staff,27,0,30,3
1649898431742,MATH 20A,A01,083754,Staff,38,0,40,2
1649898437774,MATH 20B,A01,083756,Staff,22,0,30,8
1649898437774,MATH 20B,A02,083757,Staff,30,0,30,0
1649898443869,MATH 20C,A01,083760,Staff,23,0,30,7
1649898443869,MATH 20C,A02,083761,Staff,24,0,30,6
1649898443869,MATH 20C,B01,083762,Staff,29,0,30,1
1649898443869,MATH 20C,B02,083763,Staff,30,0,30,0
1649898449892,MATH 20D,A01,083765,Staff,21,0,30,9
1649898449892,MATH 20D,A02,083766,Staff,30,0,30,0
1649898449892,MATH 20D,A03,083767,Staff,30,0,30,0
1649898455917,MATH 20E,A01,083771,Staff,17,0,30,13
1649898455917,MATH 20E,A02,083772,Staff,27,0,30,3
1649898455917,MATH 20E,B01,083773,Staff,24,0,30,6
1649898455917,MATH 20E,B02,083774,Staff,29,0,30,1
1649898461945,MATH 103A,A01,083777,Staff,0,0,30,30
1649898461945,MATH 103A,A02,083778,Staff,2,0,30,28
1649898461945,MATH 103A,B01,083779,Staff,6,0,30,24
1649898461945,MATH 103A,B02,083780,Staff,22,0,30,8
1649898467969,MATH 105,A01,085443,Staff,0,3,30,30
1649898473997,MATH 109,A01,083213,Anzaldo; Leesa B,18,0,30,12
1649898473997,MATH 109,A02,083214,Anzaldo; Leesa B,16,0,30,14
1649898473997,MATH 109,B01,083215,Anzaldo; Leesa B,25,0,30,5
1649898473997,MATH 109,B02,083216,Anzaldo; Leesa B,25,0,30,5
1649898480034,MATH 142A,A01,083219,Chow; Bennett,0,1,30,30
1649898480034,MATH 142A,A02,083220,Chow; Bennett,18,0,30,12
1649898480034,MATH 142A,B01,083221,Chow; Bennett,0,0,30,30
1649898480034,MATH 142A,B02,083222,Chow; Bennett,16,0,30,14
1649898486065,MATH 193A,A01,083224,Staff,0,2,30,30
1649898486065,MATH 193A,A02,083225,Staff,0,3,30,30
1649898486065,MATH 193A,A03,083781,Staff,12,0,30,18
1649898486065,MATH 193A,A04,083782,Staff,21,0,30,9
1649898492090,MATH 197,001,091859,McAuley; Julian John,9999,0,9999,0
1649898498225,COGS 9,A01,083615,Staff,25,0,60,35
1649898504248,COGS 11,A01,083617,Boyle; Mary E. T.,35,0,40,5
1649898510274,COGS 13,A01,083071,Staff,0,2,40,40
1649898516301,COGS 14A,A01,092681,Staff,77,0,100,23
1649898522325,COGS 14B,A01,083073,Cheng; Tzu-Han,28,0,50,22
1649898528352,COGS 17,A01,092677,Staff,66,0,75,9
1649898534378,COGS 100,A01,083619,Staff,7,0,60,53
1649898540406,COGS 101A,A01,083621,Davis; Joshua Daniel,10,0,60,50
1649898546430,COGS 101B,A01,091572,Staff,35,0,60,25
1649898552461,COGS 101C,A01,083625,Delgado; Tania,24,0,30,6
1649898558491,COGS 107A,A01,083627,Boyle; Mary E. T.,16,0,60,44
1649898564517,COGS 118A,A01,083075,Staff,23,0,60,37
1649898570540,CSE 3,A50,083646,Miranda; Gregory Joseph,26,0,38,12
1649898570540,CSE 3,A51,083647,Miranda; Gregory Joseph,37,0,37,0
1649898576569,CSE 8A,A50,083650,Miranda; Gregory Joseph,11,0,40,29
1649898582596,CSE 11,A01,083080,Cao; Yingjun,0,21,40,40
1649898588620,CSE 12,A01,083652,Staff,63,0,100,37
1649898594647,CSE 15L,A01,083654,Staff,23,0,50,27
1649898594647,CSE 15L,A02,083655,Staff,47,0,50,3
1649898600677,CSE 20,A01,083657,Staff,71,0,80,9
1649898606709,CSE 30,A01,083084,Eldon; John,1,11,40,39
1649898612732,CSE 100,A01,083659,Cao; Yingjun,2,17,50,48
1649898618759,CSE 134B,A01,083661,Powell; Thomas Allan,2,23,65,63
1649898624789,CSE 140,A01,083663,Staff,30,0,75,45
1649898630816,CSE 140L,A01,083088,Eldon; John,23,0,75,52
1649898636846,CSE 175,A01,083665,Kumar; Rakesh,13,0,25,12
1649898642870,CSE 190,A00,092507,Dubnov; Shlomo,14,0,15,1
1649898648899,ECE 45,A01,083139,Staff,16,0,40,24
1649898654923,ECE 65,A50,083695,Staff,11,0,30,19
1649898660957,ECE 109,A01,091882,Touri; Behrouz,59,0,70,11
1649898666997,ECE 180,A00,083140,Abi Samra; Nicholas Camill,27,0,30,3
1649898666997,ECE 180,B00,083141,Abi Samra; Nicholas Camill,13,0,30,17
1649898673024,MATH 10A,A01,083735,Patchell; Gregory David,22,0,30,8
1649898673024,MATH 10A,A02,083736,Patchell; Gregory David,28,0,30,2
1649898673024,MATH 10A,A03,083737,Patchell; Gregory David,28,0,30,2
1649898679047,MATH 10B,A01,083207,Staff,13,0,30,17
1649898679047,MATH 10B,A02,083208,Staff,25,0,30,5
1649898679047,MATH 10B,B01,083739,Staff,25,0,30,5
1649898679047,MATH 10B,B02,083740,Staff,30,0,30,0
1649898685070,MATH 18,A01,083743,Staff,22,0,30,8
1649898685070,MATH 18,A02,083744,Staff,29,0,30,1
1649898685070,MATH 18,A03,083745,Staff,29,0,30,1
1649898685070,MATH 18,A04,083746,Staff,29,0,30,1
1649898685070,MATH 18,B01,083748,Staff,12,0,30,18
1649898685070,MATH 18,B02,083749,Staff,26,0,30,4
1649898685070,MATH 18,B03,083750,Staff,28,0,30,2
1649898685070,MATH 18,B04,083751,Staff,27,0,30,3
1649898691097,MATH 20A,A01,083754,Staff,38,0,40,2
1649898697120,MATH 20B,A01,083756,Staff,22,0,30,8
1649898697120,MATH 20B,A02,083757,Staff,30,0,30,0
1649898703144,MATH 20C,A01,083760,Staff,23,0,30,7
1649898703144,MATH 20C,A02,083761,Staff,24,0,30,6
1649898703144,MATH 20C,B01,083762,Staff,29,0,30,1
1649898703144,MATH 20C,B02,083763,Staff,30,0,30,0
1649898709166,MATH 20D,A01,083765,Staff,21,0,30,9
1649898709166,MATH 20D,A02,083766,Staff,30,0,30,0
1649898709166,MATH 20D,A03,083767,Staff,30,0,30,0
1649898715190,MATH 20E,A01,083771,Staff,17,0,30,13
1649898715190,MATH 20E,A02,083772,Staff,27,0,30,3
1649898715190,MATH 20E,B01,083773,Staff,24,0,30,6
1649898715190,MATH 20E,B02,083774,Staff,29,0,30,1
1649898721217,MATH 103A,A01,083777,Staff,0,0,30,30
1649898721217,MATH 103A,A02,083778,Staff,2,0,30,28
1649898721217,MATH 103A,B01,083779,Staff,6,0,30,24
1649898721217,MATH 103A,B02,083780,Staff,22,0,30,8
1649898727240,MATH 105,A01,085443,Staff,0,3,30,30
1649898733265,MATH 109,A01,083213,Anzaldo; Leesa B,18,0,30,12
1649898733265,MATH 109,A02,083214,Anzaldo; Leesa B,16,0,30,14
1649898733265,MATH 109,B01,083215,Anzaldo; Leesa B,25,0,30,5
1649898733265,MATH 109,B02,083216,Anzaldo; Leesa B,24,0,30,6
1649898739299,MATH 142A,A01,083219,Chow; Bennett,0,1,30,30
1649898739299,MATH 142A,A02,083220,Chow; Bennett,18,0,30,12
1649898739299,MATH 142A,B01,083221,Chow; Bennett,0,0,30,30
1649898739299,MATH 142A,B02,083222,Chow; Bennett,16,0,30,14
1649898745326,MATH 193A,A01,083224,Staff,0,2,30,30
1649898745326,MATH 193A,A02,083225,Staff,0,3,30,30
1649898745326,MATH 193A,A03,083781,Staff,11,0,30,19
1649898745326,MATH 193A,A04,083782,Staff,21,0,30,9
1649898751350,MATH 197,001,091859,McAuley; Julian John,9999,0,9999,0
1649898757406,COGS 9,A01,083615,Staff,24,0,60,36
1649898763430,COGS 11,A01,083617,Boyle; Mary E. T.,35,0,40,5
1649898769453,COGS 13,A01,083071,Staff,0,4,40,40
1649898775476,COGS 14A,A01,092681,Staff,76,0,100,24
1649898781503,COGS 14B,A01,083073,Cheng; Tzu-Han,28,0,50,22
1649898787530,COGS 17,A01,092677,Staff,66,0,75,9
1649898793564,COGS 100,A01,083619,Staff,7,0,60,53
1649898799587,COGS 101A,A01,083621,Davis; Joshua Daniel,9,0,60,51
1649898805610,COGS 101B,A01,091572,Staff,35,0,60,25
1649898811636,COGS 101C,A01,083625,Delgado; Tania,24,0,30,6
1649898817662,COGS 107A,A01,083627,Boyle; Mary E. T.,16,0,60,44
1649898823686,COGS 118A,A01,083075,Staff,23,0,60,37
1649898829709,CSE 3,A50,083646,Miranda; Gregory Joseph,26,0,38,12
1649898829709,CSE 3,A51,083647,Miranda; Gregory Joseph,37,0,37,0
1649898835732,CSE 8A,A50,083650,Miranda; Gregory Joseph,10,0,40,30
1649898841760,CSE 11,A01,083080,Cao; Yingjun,0,21,40,40
1649898847793,CSE 12,A01,083652,Staff,63,0,100,37
1649898853820,CSE 15L,A01,083654,Staff,23,0,50,27
1649898853820,CSE 15L,A02,083655,Staff,47,0,50,3
1649898859847,CSE 20,A01,083657,Staff,71,0,80,9
1649898865882,CSE 30,A01,083084,Eldon; John,1,12,40,39
1649898871908,CSE 100,A01,083659,Cao; Yingjun,2,17,50,48
1649898877936,CSE 134B,A01,083661,Powell; Thomas Allan,2,23,65,63
1649898883964,CSE 140,A01,083663,Staff,30,0,75,45
1649898889987,CSE 140L,A01,083088,Eldon; John,23,0,75,52
1649898896028,CSE 175,A01,083665,Kumar; Rakesh,13,0,25,12
1649898902051,CSE 190,A00,092507,Dubnov; Shlomo,14,0,15,1
1649898908077,ECE 45,A01,083139,Staff,16,0,40,24
1649898914103,ECE 65,A50,083695,Staff,11,0,30,19
1649898920126,ECE 109,A01,091882,Touri; Behrouz,59,0,70,11
1649898926152,ECE 180,A00,083140,Abi Samra; Nicholas Camill,27,0,30,3
1649898926152,ECE 180,B00,083141,Abi Samra; Nicholas Camill,13,0,30,17
1649898932175,MATH 10A,A01,083735,Patchell; Gregory David,22,0,30,8
1649898932175,MATH 10A,A02,083736,Patchell; Gregory David,28,0,30,2
1649898932175,MATH 10A,A03,083737,Patchell; Gregory David,28,0,30,2
1649898938199,MATH 10B,A01,083207,Staff,13,0,30,17
1649898938199,MATH 10B,A02,083208,Staff,25,0,30,5
1649898938199,MATH 10B,B01,083739,Staff,25,0,30,5
1649898938199,MATH 10B,B02,083740,Staff,30,0,30,0
1649898944224,MATH 18,A01,083743,Staff,22,0,30,8
1649898944224,MATH 18,A02,083744,Staff,29,0,30,1
1649898944224,MATH 18,A03,083745,Staff,29,0,30,1
1649898944224,MATH 18,A04,083746,Staff,29,0,30,1
1649898944224,MATH 18,B01,083748,Staff,12,0,30,18
1649898944224,MATH 18,B02,083749,Staff,26,0,30,4
1649898944224,MATH 18,B03,083750,Staff,28,0,30,2
1649898944224,MATH 18,B04,083751,Staff,27,0,30,3
1649898950249,MATH 20A,A01,083754,Staff,38,0,40,2
1649898956279,MATH 20B,A01,083756,Staff,22,0,30,8
1649898956279,MATH 20B,A02,083757,Staff,30,0,30,0
1649898962311,MATH 20C,A01,083760,Staff,23,0,30,7
1649898962311,MATH 20C,A02,083761,Staff,24,0,30,6
1649898962311,MATH 20C,B01,083762,Staff,29,0,30,1
1649898962311,MATH 20C,B02,083763,Staff,30,0,30,0
1649898968340,MATH 20D,A01,083765,Staff,21,0,30,9
1649898968340,MATH 20D,A02,083766,Staff,30,0,30,0
1649898968340,MATH 20D,A03,083767,Staff,30,0,30,0
1649898974364,MATH 20E,A01,083771,Staff,16,0,30,14
1649898974364,MATH 20E,A02,083772,Staff,26,0,30,4
1649898974364,MATH 20E,B01,083773,Staff,24,0,30,6
1649898974364,MATH 20E,B02,083774,Staff,29,0,30,1
1649898980398,MATH 103A,A01,083777,Staff,0,0,30,30
1649898980398,MATH 103A,A02,083778,Staff,2,0,30,28
1649898980398,MATH 103A,B01,083779,Staff,6,0,30,24
1649898980398,MATH 103A,B02,083780,Staff,22,0,30,8
1649898986424,MATH 105,A01,085443,Staff,0,3,30,30
1649898992453,MATH 109,A01,083213,Anzaldo; Leesa B,18,0,30,12
1649898992453,MATH 109,A02,083214,Anzaldo; Leesa B,15,0,30,15
1649898992453,MATH 109,B01,083215,Anzaldo; Leesa B,25,0,30,5
1649898992453,MATH 109,B02,083216,Anzaldo; Leesa B,25,0,30,5
1649898998478,MATH 142A,A01,083219,Chow; Bennett,0,1,30,30
1649898998478,MATH 142A,A02,083220,Chow; Bennett,18,0,30,12
1649898998478,MATH 142A,B01,083221,Chow; Bennett,0,0,30,30
1649898998478,MATH 142A,B02,083222,Chow; Bennett,16,0,30,14
1649899004506,MATH 193A,A01,083224,Staff,0,2,30,30
1649899004506,MATH 193A,A02,083225,Staff,0,3,30,30
1649899004506,MATH 193A,A03,083781,Staff,11,0,30,19
1649899004506,MATH 193A,A04,083782,Staff,21,0,30,9
1649899010533,MATH 197,001,091859,McAuley; Julian John,9999,0,9999,0
1649899016597,COGS 9,A01,083615,Staff,24,0,60,36
1649899022622,COGS 11,A01,083617,Boyle; Mary E. T.,35,0,40,5
1649899028647,COGS 13,A01,083071,Staff,0,4,40,40
1649899034680,COGS 14A,A01,092681,Staff,76,0,100,24
1649899040706,COGS 14B,A01,083073,Cheng; Tzu-Han,28,0,50,22
1649899046732,COGS 17,A01,092677,Staff,66,0,75,9
1649899052759,COGS 100,A01,083619,Staff,7,0,60,53
1649899058791,COGS 101A,A01,083621,Davis; Joshua Daniel,9,0,60,51
1649899064816,COGS 101B,A01,091572,Staff,35,0,60,25
1649899070842,COGS 101C,A01,083625,Delgado; Tania,24,0,30,6
1649899076867,COGS 107A,A01,083627,Boyle; Mary E. T.,16,0,60,44
1649899082890,COGS 118A,A01,083075,Staff,22,0,60,38
1649899089017,CSE 3,A50,083646,Miranda; Gregory Joseph,26,0,38,12
1649899089017,CSE 3,A51,083647,Miranda; Gregory Joseph,37,0,37,0
1649899095045,CSE 8A,A50,083650,Miranda; Gregory Joseph,10,0,40,30
1649899101071,CSE 11,A01,083080,Cao; Yingjun,0,21,40,40
1649899107095,CSE 12,A01,083652,Staff,63,0,100,37
1649899113131,CSE 15L,A01,083654,Staff,23,0,50,27
1649899113131,CSE 15L,A02,083655,Staff,47,0,50,3
1649899119159,CSE 20,A01,083657,Staff,71,0,80,9
1649899125184,CSE 30,A01,083084,Eldon; John,1,12,40,39
1649899131209,CSE 100,A01,083659,Cao; Yingjun,2,17,50,48
1649899137241,CSE 134B,A01,083661,Powell; Thomas Allan,2,23,65,63
1649899143269,CSE 140,A01,083663,Staff,30,0,75,45
1649899149297,CSE 140L,A01,083088,Eldon; John,23,0,75,52
1649899155320,CSE 175,A01,083665,Kumar; Rakesh,13,0,25,12
1649899161347,CSE 190,A00,092507,Dubnov; Shlomo,14,0,15,1
1649899167379,ECE 45,A01,083139,Staff,16,0,40,24
1649899173403,ECE 65,A50,083695,Staff,11,0,30,19
1649899179439,ECE 109,A01,091882,Touri; Behrouz,59,0,70,11
1649899185465,ECE 180,A00,083140,Abi Samra; Nicholas Camill,27,0,30,3
1649899185465,ECE 180,B00,083141,Abi Samra; Nicholas Camill,13,0,30,17
1649899191489,MATH 10A,A01,083735,Patchell; Gregory David,22,0,30,8
1649899191489,MATH 10A,A02,083736,Patchell; Gregory David,28,0,30,2
1649899191489,MATH 10A,A03,083737,Patchell; Gregory David,28,0,30,2
1649899197519,MATH 10B,A01,083207,Staff,13,0,30,17
1649899197519,MATH 10B,A02,083208,Staff,25,0,30,5
1649899197519,MATH 10B,B01,083739,Staff,25,0,30,5
1649899197519,MATH 10B,B02,083740,Staff,30,0,30,0
1649899203543,MATH 18,A01,083743,Staff,22,0,30,8
1649899203543,MATH 18,A02,083744,Staff,29,0,30,1
1649899203543,MATH 18,A03,083745,Staff,29,0,30,1
1649899203543,MATH 18,A04,083746,Staff,29,0,30,1
1649899203543,MATH 18,B01,083748,Staff,12,0,30,18
1649899203543,MATH 18,B02,083749,Staff,26,0,30,4
1649899203543,MATH 18,B03,083750,Staff,28,0,30,2
1649899203543,MATH 18,B04,083751,Staff,27,0,30,3
1649899209566,MATH 20A,A01,083754,Staff,38,0,40,2
1649899215592,MATH 20B,A01,083756,Staff,22,0,30,8
1649899215592,MATH 20B,A02,083757,Staff,30,0,30,0
1649899221616,MATH 20C,A01,083760,Staff,23,0,30,7
1649899221616,MATH 20C,A02,083761,Staff,24,0,30,6
1649899221616,MATH 20C,B01,083762,Staff,29,0,30,1
1649899221616,MATH 20C,B02,083763,Staff,30,0,30,0
1649899227644,MATH 20D,A01,083765,Staff,21,0,30,9
1649899227644,MATH 20D,A02,083766,Staff,30,0,30,0
1649899227644,MATH 20D,A03,083767,Staff,30,0,30,0
1649899233672,MATH 20E,A01,083771,Staff,16,0,30,14
1649899233672,MATH 20E,A02,083772,Staff,26,0,30,4
1649899233672,MATH 20E,B01,083773,Staff,24,0,30,6
1649899233672,MATH 20E,B02,083774,Staff,29,0,30,1
1649899239695,MATH 103A,A01,083777,Staff,0,0,30,30
1649899239695,MATH 103A,A02,083778,Staff,2,0,30,28
1649899239695,MATH 103A,B01,083779,Staff,6,0,30,24
1649899239695,MATH 103A,B02,083780,Staff,22,0,30,8
1649899245726,MATH 105,A01,085443,Staff,0,3,30,30
1649899251754,MATH 109,A01,083213,Anzaldo; Leesa B,18,0,30,12
1649899251754,MATH 109,A02,083214,Anzaldo; Leesa B,15,0,30,15
1649899251754,MATH 109,B01,083215,Anzaldo; Leesa B,25,0,30,5
1649899251754,MATH 109,B02,083216,Anzaldo; Leesa B,25,0,30,5
1649899257781,MATH 142A,A01,083219,Chow; Bennett,0,1,30,30
1649899257781,MATH 142A,A02,083220,Chow; Bennett,18,0,30,12
1649899257781,MATH 142A,B01,083221,Chow; Bennett,0,0,30,30
1649899257781,MATH 142A,B02,083222,Chow; Bennett,16,0,30,14
1649899263805,MATH 193A,A01,083224,Staff,0,2,30,30
1649899263805,MATH 193A,A02,083225,Staff,0,3,30,30
1649899263805,MATH 193A,A03,083781,Staff,11,0,30,19
1649899263805,MATH 193A,A04,083782,Staff,21,0,30,9
1649899269828,MATH 197,001,091859,McAuley; Julian John,9999,0,9999,0
1649899275877,COGS 9,A01,083615,Staff,24,0,60,36
1649899281900,COGS 11,A01,083617,Boyle; Mary E. T.,35,0,40,5
1649899287923,COGS 13,A01,083071,Staff,0,4,40,40
1649899293945,COGS 14A,A01,092681,Staff,76,0,100,24
1649899299967,COGS 14B,A01,083073,Cheng; Tzu-Han,28,0,50,22
1649899306017,COGS 17,A01,092677,Staff,66,0,75,9
1649899312047,COGS 100,A01,083619,Staff,6,0,60,54
1649899318073,COGS 101A,A01,083621,Davis; Joshua Daniel,9,0,60,51
1649899324096,COGS 101B,A01,091572,Staff,35,0,60,25
1649899330123,COGS 101C,A01,083625,Delgado; Tania,24,0,30,6
1649899336146,COGS 107A,A01,083627,Boyle; Mary E. T.,16,0,60,44
1649899342176,COGS 118A,A01,083075,Staff,22,0,60,38
1649899348204,CSE 3,A50,083646,Miranda; Gregory Joseph,26,0,38,12
1649899348204,CSE 3,A51,083647,Miranda; Gregory Joseph,37,0,37,0
1649899354232,CSE 8A,A50,083650,Miranda; Gregory Joseph,10,0,40,30
1649899360263,CSE 11,A01,083080,Cao; Yingjun,0,22,40,40
1649899366297,CSE 12,A01,083652,Staff,63,0,100,37
1649899372334,CSE 15L,A01,083654,Staff,23,0,50,27
1649899372334,CSE 15L,A02,083655,Staff,47,0,50,3
1649899378359,CSE 20,A01,083657,Staff,70,0,80,10
1649899384398,CSE 30,A01,083084,Eldon; John,1,12,40,39
1649899390420,CSE 100,A01,083659,Cao; Yingjun,2,17,50,48
1649899396444,CSE 134B,A01,083661,Powell; Thomas Allan,2,23,65,63
1649899402469,CSE 140,A01,083663,Staff,30,0,75,45
1649899408563,CSE 140L,A01,083088,Eldon; John,23,0,75,52
1649899414589,CSE 175,A01,083665,Kumar; Rakesh,13,0,25,12
1649899420615,CSE 190,A00,092507,Dubnov; Shlomo,14,0,15,1
1649899426638,ECE 45,A01,083139,Staff,16,0,40,24
1649899432666,ECE 65,A50,083695,Staff,11,0,30,19
1649899438689,ECE 109,A01,091882,Touri; Behrouz,59,0,70,11
1649899444717,ECE 180,A00,083140,Abi Samra; Nicholas Camill,27,0,30,3
1649899444717,ECE 180,B00,083141,Abi Samra; Nicholas Camill,13,0,30,17
1649899450741,MATH 10A,A01,083735,Patchell; Gregory David,22,0,30,8
1649899450741,MATH 10A,A02,083736,Patchell; Gregory David,28,0,30,2
1649899450741,MATH 10A,A03,083737,Patchell; Gregory David,28,0,30,2
1649899456767,MATH 10B,A01,083207,Staff,13,0,30,17
1649899456767,MATH 10B,A02,083208,Staff,25,0,30,5
1649899456767,MATH 10B,B01,083739,Staff,25,0,30,5
1649899456767,MATH 10B,B02,083740,Staff,30,0,30,0
1649899462800,MATH 18,A01,083743,Staff,22,0,30,8
1649899462800,MATH 18,A02,083744,Staff,29,0,30,1
1649899462800,MATH 18,A03,083745,Staff,29,0,30,1
1649899462800,MATH 18,A04,083746,Staff,29,0,30,1
1649899462800,MATH 18,B01,083748,Staff,12,0,30,18
1649899462800,MATH 18,B02,083749,Staff,26,0,30,4
1649899462800,MATH 18,B03,083750,Staff,28,0,30,2
1649899462800,MATH 18,B04,083751,Staff,27,0,30,3
1649899468835,MATH 20A,A01,083754,Staff,38,0,40,2
1649899474858,MATH 20B,A01,083756,Staff,22,0,30,8
1649899474858,MATH 20B,A02,083757,Staff,30,0,30,0
1649899480886,MATH 20C,A01,083760,Staff,23,0,30,7
1649899480886,MATH 20C,A02,083761,Staff,24,0,30,6
1649899480886,MATH 20C,B01,083762,Staff,29,0,30,1
1649899480886,MATH 20C,B02,083763,Staff,30,0,30,0
1649899486911,MATH 20D,A01,083765,Staff,21,0,30,9
1649899486911,MATH 20D,A02,083766,Staff,30,0,30,0
1649899486911,MATH 20D,A03,083767,Staff,30,0,30,0
1649899492935,MATH 20E,A01,083771,Staff,16,0,30,14
1649899492935,MATH 20E,A02,083772,Staff,26,0,30,4
1649899492935,MATH 20E,B01,083773,Staff,24,0,30,6
1649899492935,MATH 20E,B02,083774,Staff,29,0,30,1
1649899498971,MATH 103A,A01,083777,Staff,0,0,30,30
1649899498971,MATH 103A,A02,083778,Staff,2,0,30,28
1649899498971,MATH 103A,B01,083779,Staff,6,0,30,24
1649899498971,MATH 103A,B02,083780,Staff,22,0,30,8
1649899505000,MATH 105,A01,085443,Staff,0,3,30,30
1649899511047,MATH 109,A01,083213,Anzaldo; Leesa B,18,0,30,12
1649899511047,MATH 109,A02,083214,Anzaldo; Leesa B,14,0,30,16
1649899511047,MATH 109,B01,083215,Anzaldo; Leesa B,25,0,30,5
1649899511047,MATH 109,B02,083216,Anzaldo; Leesa B,24,0,30,6
1649899517075,MATH 142A,A01,083219,Chow; Bennett,0,1,30,30
1649899517075,MATH 142A,A02,083220,Chow; Bennett,18,0,30,12
1649899517075,MATH 142A,B01,083221,Chow; Bennett,0,0,30,30
1649899517075,MATH 142A,B02,083222,Chow; Bennett,16,0,30,14
1649899523098,MATH 193A,A01,083224,Staff,0,3,30,30
1649899523098,MATH 193A,A02,083225,Staff,0,3,30,30
1649899523098,MATH 193A,A03,083781,Staff,11,0,30,19
1649899523098,MATH 193A,A04,083782,Staff,21,0,30,9
1649899529121,MATH 197,001,091859,McAuley; Julian John,9999,0,9999,0
1649899535178,COGS 9,A01,083615,Staff,24,0,60,36
1649899541202,COGS 11,A01,083617,Boyle; Mary E. T.,35,0,40,5
1649899547225,COGS 13,A01,083071,Staff,0,4,40,40
1649899553248,COGS 14A,A01,092681,Staff,76,0,100,24
1649899559273,COGS 14B,A01,083073,Cheng; Tzu-Han,28,0,50,22
1649899565295,COGS 17,A01,092677,Staff,66,0,75,9
1649899571319,COGS 100,A01,083619,Staff,6,0,60,54
1649899577345,COGS 101A,A01,083621,Davis; Joshua Daniel,9,0,60,51
1649899583371,COGS 101B,A01,091572,Staff,35,0,60,25
1649899589394,COGS 101C,A01,083625,Delgado; Tania,24,0,30,6
1649899595439,COGS 107A,A01,083627,Boyle; Mary E. T.,16,0,60,44
1649899601468,COGS 118A,A01,083075,Staff,22,0,60,38
1649899607498,CSE 3,A50,083646,Miranda; Gregory Joseph,26,0,38,12
1649899607498,CSE 3,A51,083647,Miranda; Gregory Joseph,37,0,37,0
1649899613522,CSE 8A,A50,083650,Miranda; Gregory Joseph,10,0,40,30
1649899619545,CSE 11,A01,083080,Cao; Yingjun,0,22,40,40
1649899625572,CSE 12,A01,083652,Staff,62,0,100,38
1649899631596,CSE 15L,A01,083654,Staff,22,0,50,28
1649899631596,CSE 15L,A02,083655,Staff,47,0,50,3
1649899637619,CSE 20,A01,083657,Staff,70,0,80,10
1649899643644,CSE 30,A01,083084,Eldon; John,1,12,40,39
1649899649670,CSE 100,A01,083659,Cao; Yingjun,2,18,50,48
1649899655693,CSE 134B,A01,083661,Powell; Thomas Allan,2,23,65,63
1649899661720,CSE 140,A01,083663,Staff,30,0,75,45
1649899667742,CSE 140L,A01,083088,Eldon; John,23,0,75,52
1649899673766,CSE 175,A01,083665,Kumar; Rakesh,13,0,25,12
1649899679794,CSE 190,A00,092507,Dubnov; Shlomo,14,0,15,1
1649899685824,ECE 45,A01,083139,Staff,16,0,40,24
1649899691846,ECE 65,A50,083695,Staff,11,0,30,19
1649899697873,ECE 109,A01,091882,Touri; Behrouz,59,0,70,11
1649899703897,ECE 180,A00,083140,Abi Samra; Nicholas Camill,27,0,30,3
1649899703897,ECE 180,B00,083141,Abi Samra; Nicholas Camill,13,0,30,17
1649899709929,MATH 10A,A01,083735,Patchell; Gregory David,22,0,30,8
1649899709929,MATH 10A,A02,083736,Patchell; Gregory David,28,0,30,2
1649899709929,MATH 10A,A03,083737,Patchell; Gregory David,28,0,30,2
1649899715954,MATH 10B,A01,083207,Staff,13,0,30,17
1649899715954,MATH 10B,A02,083208,Staff,25,0,30,5
1649899715954,MATH 10B,B01,083739,Staff,25,0,30,5
1649899715954,MATH 10B,B02,083740,Staff,30,0,30,0
1649899721980,MATH 18,A01,083743,Staff,22,0,30,8
1649899721980,MATH 18,A02,083744,Staff,29,0,30,1
1649899721980,MATH 18,A03,083745,Staff,29,0,30,1
1649899721980,MATH 18,A04,083746,Staff,29,0,30,1
1649899721980,MATH 18,B01,083748,Staff,12,0,30,18
1649899721980,MATH 18,B02,083749,Staff,26,0,30,4
1649899721980,MATH 18,B03,083750,Staff,28,0,30,2
1649899721980,MATH 18,B04,083751,Staff,27,0,30,3
1649899728003,MATH 20A,A01,083754,Staff,38,0,40,2
1649899734041,MATH 20B,A01,083756,Staff,22,0,30,8
1649899734041,MATH 20B,A02,083757,Staff,30,0,30,0
1649899740068,MATH 20C,A01,083760,Staff,23,0,30,7
1649899740068,MATH 20C,A02,083761,Staff,24,0,30,6
1649899740068,MATH 20C,B01,083762,Staff,29,0,30,1
1649899740068,MATH 20C,B02,083763,Staff,30,0,30,0
1649899746092,MATH 20D,A01,083765,Staff,21,0,30,9
1649899746092,MATH 20D,A02,083766,Staff,30,0,30,0
1649899746092,MATH 20D,A03,083767,Staff,30,0,30,0
1649899752116,MATH 20E,A01,083771,Staff,16,0,30,14
1649899752116,MATH 20E,A02,083772,Staff,26,0,30,4
1649899752116,MATH 20E,B01,083773,Staff,24,0,30,6
1649899752116,MATH 20E,B02,083774,Staff,29,0,30,1
1649899758144,MATH 103A,A01,083777,Staff,0,0,30,30
1649899758144,MATH 103A,A02,083778,Staff,2,0,30,28
1649899758144,MATH 103A,B01,083779,Staff,6,0,30,24
1649899758144,MATH 103A,B02,083780,Staff,22,0,30,8
1649899764166,MATH 105,A01,085443,Staff,0,3,30,30
1649899770193,MATH 109,A01,083213,Anzaldo; Leesa B,18,0,30,12
1649899770193,MATH 109,A02,083214,Anzaldo; Leesa B,14,0,30,16
1649899770193,MATH 109,B01,083215,Anzaldo; Leesa B,25,0,30,5
1649899770193,MATH 109,B02,083216,Anzaldo; Leesa B,24,0,30,6
1649899776225,MATH 142A,A01,083219,Chow; Bennett,0,2,30,30
1649899776225,MATH 142A,A02,083220,Chow; Bennett,18,0,30,12
1649899776225,MATH 142A,B01,083221,Chow; Bennett,0,0,30,30
1649899776225,MATH 142A,B02,083222,Chow; Bennett,15,0,30,15
1649899782254,MATH 193A,A01,083224,Staff,0,3,30,30
1649899782254,MATH 193A,A02,083225,Staff,0,3,30,30
1649899782254,MATH 193A,A03,083781,Staff,11,0,30,19
1649899782254,MATH 193A,A04,083782,Staff,21,0,30,9
1649899788276,MATH 197,001,091859,McAuley; Julian John,9999,0,9999,0
1649899794334,COGS 9,A01,083615,Staff,24,0,60,36
1649899800359,COGS 11,A01,083617,Boyle; Mary E. T.,35,0,40,5
1649899806382,COGS 13,A01,083071,Staff,0,4,40,40
1649899812409,COGS 14A,A01,092681,Staff,76,0,100,24
1649899818432,COGS 14B,A01,083073,Cheng; Tzu-Han,28,0,50,22
1649899824455,COGS 17,A01,092677,Staff,66,0,75,9
1649899830479,COGS 100,A01,083619,Staff,6,0,60,54
1649899836504,COGS 101A,A01,083621,Davis; Joshua Daniel,9,0,60,51
1649899842530,COGS 101B,A01,091572,Staff,35,0,60,25
1649899848551,COGS 101C,A01,083625,Delgado; Tania,24,0,30,6
1649899854581,COGS 107A,A01,083627,Boyle; Mary E. T.,16,0,60,44
1649899860617,COGS 118A,A01,083075,Staff,22,0,60,38
1649899866640,CSE 3,A50,083646,Miranda; Gregory Joseph,26,0,38,12
1649899866640,CSE 3,A51,083647,Miranda; Gregory Joseph,37,0,37,0
1649899872668,CSE 8A,A50,083650,Miranda; Gregory Joseph,9,0,40,31
1649899878692,CSE 11,A01,083080,Cao; Yingjun,0,22,40,40
1649899884716,CSE 12,A01,083652,Staff,62,0,100,38
1649899890739,CSE 15L,A01,083654,Staff,22,0,50,28
1649899890739,CSE 15L,A02,083655,Staff,47,0,50,3
1649899896768,CSE 20,A01,083657,Staff,70,0,80,10
1649899902791,CSE 30,A01,083084,Eldon; John,1,12,40,39
1649899908818,CSE 100,A01,083659,Cao; Yingjun,2,18,50,48
1649899914845,CSE 134B,A01,083661,Powell; Thomas Allan,2,23,65,63
1649899920870,CSE 140,A01,083663,Staff,30,0,75,45
1649899926896,CSE 140L,A01,083088,Eldon; John,23,0,75,52
1649899932920,CSE 175,A01,083665,Kumar; Rakesh,13,0,25,12
1649899938944,CSE 190,A00,092507,Dubnov; Shlomo,14,0,15,1
1649899944967,ECE 45,A01,083139,Staff,16,0,40,24
1649899950992,ECE 65,A50,083695,Staff,11,0,30,19
1649899957016,ECE 109,A01,091882,Touri; Behrouz,59,0,70,11
1649899963055,ECE 180,A00,083140,Abi Samra; Nicholas Camill,27,0,30,3
1649899963055,ECE 180,B00,083141,Abi Samra; Nicholas Camill,13,0,30,17
1649899969078,MATH 10A,A01,083735,Patchell; Gregory David,22,0,30,8
1649899969078,MATH 10A,A02,083736,Patchell; Gregory David,28,0,30,2
1649899969078,MATH 10A,A03,083737,Patchell; Gregory David,28,0,30,2
1649899975102,MATH 10B,A01,083207,Staff,13,0,30,17
1649899975102,MATH 10B,A02,083208,Staff,25,0,30,5
1649899975102,MATH 10B,B01,083739,Staff,25,0,30,5
1649899975102,MATH 10B,B02,083740,Staff,30,0,30,0
1649899981132,MATH 18,A01,083743,Staff,22,0,30,8
1649899981132,MATH 18,A02,083744,Staff,29,0,30,1
1649899981132,MATH 18,A03,083745,Staff,29,0,30,1
1649899981132,MATH 18,A04,083746,Staff,29,0,30,1
1649899981132,MATH 18,B01,083748,Staff,12,0,30,18
1649899981132,MATH 18,B02,083749,Staff,26,0,30,4
1649899981132,MATH 18,B03,083750,Staff,28,0,30,2
1649899981132,MATH 18,B04,083751,Staff,27,0,30,3
1649899987155,MATH 20A,A01,083754,Staff,38,0,40,2
1649899993178,MATH 20B,A01,083756,Staff,22,0,30,8
1649899993178,MATH 20B,A02,083757,Staff,30,0,30,0
1649899999213,MATH 20C,A01,083760,Staff,23,0,30,7
1649899999213,MATH 20C,A02,083761,Staff,24,0,30,6
1649899999213,MATH 20C,B01,083762,Staff,29,0,30,1
1649899999213,MATH 20C,B02,083763,Staff,30,0,30,0
1649900005320,MATH 20D,A01,083765,Staff,21,0,30,9
1649900005320,MATH 20D,A02,083766,Staff,30,0,30,0
1649900005320,MATH 20D,A03,083767,Staff,30,0,30,0
1649900011344,MATH 20E,A01,083771,Staff,16,0,30,14
1649900011344,MATH 20E,A02,083772,Staff,26,0,30,4
1649900011344,MATH 20E,B01,083773,Staff,24,0,30,6
1649900011344,MATH 20E,B02,083774,Staff,29,0,30,1
1649900017369,MATH 103A,A01,083777,Staff,0,0,30,30
1649900017369,MATH 103A,A02,083778,Staff,2,0,30,28
1649900017369,MATH 103A,B01,083779,Staff,6,0,30,24
1649900017369,MATH 103A,B02,083780,Staff,22,0,30,8
1649900023392,MATH 105,A01,085443,Staff,0,3,30,30
1649900029416,MATH 109,A01,083213,Anzaldo; Leesa B,18,0,30,12
1649900029416,MATH 109,A02,083214,Anzaldo; Leesa B,14,0,30,16
1649900029416,MATH 109,B01,083215,Anzaldo; Leesa B,25,0,30,5
1649900029416,MATH 109,B02,083216,Anzaldo; Leesa B,24,0,30,6
1649900035450,MATH 142A,A01,083219,Chow; Bennett,0,2,30,30
1649900035450,MATH 142A,A02,083220,Chow; Bennett,18,0,30,12
1649900035450,MATH 142A,B01,083221,Chow; Bennett,0,0,30,30
1649900035450,MATH 142A,B02,083222,Chow; Bennett,13,0,30,17
1649900041476,MATH 193A,A01,083224,Staff,0,3,30,30
1649900041476,MATH 193A,A02,083225,Staff,0,3,30,30
1649900041476,MATH 193A,A03,083781,Staff,11,0,30,19
1649900041476,MATH 193A,A04,083782,Staff,21,0,30,9
1649900047503,MATH 197,001,091859,McAuley; Julian John,9999,0,9999,0
1649900053561,COGS 9,A01,083615,Staff,24,0,60,36
1649900059587,COGS 11,A01,083617,Boyle; Mary E. T.,35,0,40,5
1649900065610,COGS 13,A01,083071,Staff,0,4,40,40
1649900071637,COGS 14A,A01,092681,Staff,75,0,100,25
1649900077660,COGS 14B,A01,083073,Cheng; Tzu-Han,27,0,50,23
1649900083695,COGS 17,A01,092677,Staff,66,0,75,9
1649900089722,COGS 100,A01,083619,Staff,6,0,60,54
1649900095748,COGS 101A,A01,083621,Davis; Joshua Daniel,9,0,60,51
1649900101773,COGS 101B,A01,091572,Staff,35,0,60,25
1649900107799,COGS 101C,A01,083625,Delgado; Tania,24,0,30,6
1649900113828,COGS 107A,A01,083627,Boyle; Mary E. T.,16,0,60,44
1649900119857,COGS 118A,A01,083075,Staff,22,0,60,38
1649900125896,CSE 3,A50,083646,Miranda; Gregory Joseph,26,0,38,12
1649900125896,CSE 3,A51,083647,Miranda; Gregory Joseph,37,0,37,0
1649900131923,CSE 8A,A50,083650,Miranda; Gregory Joseph,9,0,40,31
1649900137947,CSE 11,A01,083080,Cao; Yingjun,0,22,40,40
1649900143976,CSE 12,A01,083652,Staff,62,0,100,38
1649900150003,CSE 15L,A01,083654,Staff,22,0,50,28
1649900150003,CSE 15L,A02,083655,Staff,47,0,50,3
1649900156026,CSE 20,A01,083657,Staff,70,0,80,10
1649900162060,CSE 30,A01,083084,Eldon; John,1,13,40,39
1649900168084,CSE 100,A01,083659,Cao; Yingjun,2,18,50,48
1649900174113,CSE 134B,A01,083661,Powell; Thomas Allan,2,23,65,63
1649900180139,CSE 140,A01,083663,Staff,30,0,75,45
1649900186163,CSE 140L,A01,083088,Eldon; John,23,0,75,52
1649900192186,CSE 175,A01,083665,Kumar; Rakesh,13,0,25,12
1649900198219,CSE 190,A00,092507,Dubnov; Shlomo,14,0,15,1
1649900204249,ECE 45,A01,083139,Staff,16,0,40,24
1649900210271,ECE 65,A50,083695,Staff,11,0,30,19
1649900216293,ECE 109,A01,091882,Touri; Behrouz,59,0,70,11
1649900222317,ECE 180,A00,083140,Abi Samra; Nicholas Camill,27,0,30,3
1649900222317,ECE 180,B00,083141,Abi Samra; Nicholas Camill,13,0,30,17
1649900228347,MATH 10A,A01,083735,Patchell; Gregory David,22,0,30,8
1649900228347,MATH 10A,A02,083736,Patchell; Gregory David,28,0,30,2
1649900228347,MATH 10A,A03,083737,Patchell; Gregory David,28,0,30,2
1649900234374,MATH 10B,A01,083207,Staff,13,0,30,17
1649900234374,MATH 10B,A02,083208,Staff,25,0,30,5
1649900234374,MATH 10B,B01,083739,Staff,25,0,30,5
1649900234374,MATH 10B,B02,083740,Staff,30,0,30,0
1649900240403,MATH 18,A01,083743,Staff,22,0,30,8
1649900240403,MATH 18,A02,083744,Staff,29,0,30,1
1649900240403,MATH 18,A03,083745,Staff,29,0,30,1
1649900240403,MATH 18,A04,083746,Staff,29,0,30,1
1649900240403,MATH 18,B01,083748,Staff,12,0,30,18
1649900240403,MATH 18,B02,083749,Staff,26,0,30,4
1649900240403,MATH 18,B03,083750,Staff,28,0,30,2
1649900240403,MATH 18,B04,083751,Staff,27,0,30,3
1649900246430,MATH 20A,A01,083754,Staff,38,0,40,2
1649900252459,MATH 20B,A01,083756,Staff,22,0,30,8
1649900252459,MATH 20B,A02,083757,Staff,30,0,30,0
1649900258484,MATH 20C,A01,083760,Staff,23,0,30,7
1649900258484,MATH 20C,A02,083761,Staff,24,0,30,6
1649900258484,MATH 20C,B01,083762,Staff,29,0,30,1
1649900258484,MATH 20C,B02,083763,Staff,30,0,30,0
1649900264506,MATH 20D,A01,083765,Staff,21,0,30,9
1649900264506,MATH 20D,A02,083766,Staff,30,0,30,0
1649900264506,MATH 20D,A03,083767,Staff,30,0,30,0
1649900270535,MATH 20E,A01,083771,Staff,16,0,30,14
1649900270535,MATH 20E,A02,083772,Staff,26,0,30,4
1649900270535,MATH 20E,B01,083773,Staff,24,0,30,6
1649900270535,MATH 20E,B02,083774,Staff,29,0,30,1
1649900276562,MATH 103A,A01,083777,Staff,0,0,30,30
1649900276562,MATH 103A,A02,083778,Staff,2,0,30,28
1649900276562,MATH 103A,B01,083779,Staff,6,0,30,24
1649900276562,MATH 103A,B02,083780,Staff,22,0,30,8
1649900282590,MATH 105,A01,085443,Staff,0,3,30,30
1649900288615,MATH 109,A01,083213,Anzaldo; Leesa B,18,0,30,12
1649900288615,MATH 109,A02,083214,Anzaldo; Leesa B,14,0,30,16
1649900288615,MATH 109,B01,083215,Anzaldo; Leesa B,25,0,30,5
1649900288615,MATH 109,B02,083216,Anzaldo; Leesa B,24,0,30,6
1649900294638,MATH 142A,A01,083219,Chow; Bennett,0,2,30,30
1649900294638,MATH 142A,A02,083220,Chow; Bennett,18,0,30,12
1649900294638,MATH 142A,B01,083221,Chow; Bennett,0,0,30,30
1649900294638,MATH 142A,B02,083222,Chow; Bennett,14,0,30,16
1649900300660,MATH 193A,A01,083224,Staff,0,3,30,30
1649900300660,MATH 193A,A02,083225,Staff,0,3,30,30
1649900300660,MATH 193A,A03,083781,Staff,10,0,30,20
1649900300660,MATH 193A,A04,083782,Staff,21,0,30,9
1649900306682,MATH 197,001,091859,McAuley; Julian John,9999,0,9999,0
1649900312745,COGS 9,A01,083615,Staff,23,0,60,37
1649900318770,COGS 11,A01,083617,Boyle; Mary E. T.,35,0,40,5
1649900324793,COGS 13,A01,083071,Staff,0,4,40,40
1649900330816,COGS 14A,A01,092681,Staff,75,0,100,25
1649900336855,COGS 14B,A01,083073,Cheng; Tzu-Han,27,0,50,23
1649900342878,COGS 17,A01,092677,Staff,66,0,75,9
1649900348913,COGS 100,A01,083619,Staff,6,0,60,54
1649900354940,COGS 101A,A01,083621,Davis; Joshua Daniel,9,0,60,51
1649900360965,COGS 101B,A01,091572,Staff,35,0,60,25
1649900366993,COGS 101C,A01,083625,Delgado; Tania,24,0,30,6
1649900373019,COGS 107A,A01,083627,Boyle; Mary E. T.,16,0,60,44
1649900379046,COGS 118A,A01,083075,Staff,22,0,60,38
1649900385079,CSE 3,A50,083646,Miranda; Gregory Joseph,26,0,38,12
1649900385079,CSE 3,A51,083647,Miranda; Gregory Joseph,37,0,37,0
1649900391102,CSE 8A,A50,083650,Miranda; Gregory Joseph,8,0,40,32
1649900397135,CSE 11,A01,083080,Cao; Yingjun,0,22,40,40
1649900403164,CSE 12,A01,083652,Staff,62,0,100,38
1649900409189,CSE 15L,A01,083654,Staff,22,0,50,28
1649900409189,CSE 15L,A02,083655,Staff,47,0,50,3
1649900415213,CSE 20,A01,083657,Staff,70,0,80,10
1649900421236,CSE 30,A01,083084,Eldon; John,1,13,40,39
1649900427273,CSE 100,A01,083659,Cao; Yingjun,2,18,50,48
1649900433300,CSE 134B,A01,083661,Powell; Thomas Allan,2,23,65,63
1649900439322,CSE 140,A01,083663,Staff,30,0,75,45
1649900445345,CSE 140L,A01,083088,Eldon; John,23,0,75,52
1649900451381,CSE 175,A01,083665,Kumar; Rakesh,12,0,25,13
1649900457412,CSE 190,A00,092507,Dubnov; Shlomo,14,0,15,1
1649900463436,ECE 45,A01,083139,Staff,16,0,40,24
1649900469468,ECE 65,A50,083695,Staff,11,0,30,19
1649900475491,ECE 109,A01,091882,Touri; Behrouz,59,0,70,11
1649900481518,ECE 180,A00,083140,Abi Samra; Nicholas Camill,27,0,30,3
1649900481518,ECE 180,B00,083141,Abi Samra; Nicholas Camill,13,0,30,17
1649900487541,MATH 10A,A01,083735,Patchell; Gregory David,22,0,30,8
1649900487541,MATH 10A,A02,083736,Patchell; Gregory David,28,0,30,2
1649900487541,MATH 10A,A03,083737,Patchell; Gregory David,28,0,30,2
1649900493569,MATH 10B,A01,083207,Staff,13,0,30,17
1649900493569,MATH 10B,A02,083208,Staff,25,0,30,5
1649900493569,MATH 10B,B01,083739,Staff,25,0,30,5
1649900493569,MATH 10B,B02,083740,Staff,30,0,30,0
1649900499597,MATH 18,A01,083743,Staff,22,0,30,8
1649900499597,MATH 18,A02,083744,Staff,29,0,30,1
1649900499597,MATH 18,A03,083745,Staff,29,0,30,1
1649900499597,MATH 18,A04,083746,Staff,29,0,30,1
1649900499597,MATH 18,B01,083748,Staff,12,0,30,18
1649900499597,MATH 18,B02,083749,Staff,26,0,30,4
1649900499597,MATH 18,B03,083750,Staff,28,0,30,2
1649900499597,MATH 18,B04,083751,Staff,27,0,30,3
1649900505626,MATH 20A,A01,083754,Staff,38,0,40,2
1649900511653,MATH 20B,A01,083756,Staff,22,0,30,8
1649900511653,MATH 20B,A02,083757,Staff,30,0,30,0
1649900517676,MATH 20C,A01,083760,Staff,23,0,30,7
1649900517676,MATH 20C,A02,083761,Staff,24,0,30,6
1649900517676,MATH 20C,B01,083762,Staff,29,0,30,1
1649900517676,MATH 20C,B02,083763,Staff,30,0,30,0
1649900523699,MATH 20D,A01,083765,Staff,21,0,30,9
1649900523699,MATH 20D,A02,083766,Staff,30,0,30,0
1649900523699,MATH 20D,A03,083767,Staff,30,0,30,0
1649900529722,MATH 20E,A01,083771,Staff,16,0,30,14
1649900529722,MATH 20E,A02,083772,Staff,26,0,30,4
1649900529722,MATH 20E,B01,083773,Staff,24,0,30,6
1649900529722,MATH 20E,B02,083774,Staff,29,0,30,1
1649900535745,MATH 103A,A01,083777,Staff,0,0,30,30
1649900535745,MATH 103A,A02,083778,Staff,2,0,30,28
1649900535745,MATH 103A,B01,083779,Staff,6,0,30,24
1649900535745,MATH 103A,B02,083780,Staff,22,0,30,8
1649900541777,MATH 105,A01,085443,Staff,0,3,30,30
1649900547808,MATH 109,A01,083213,Anzaldo; Leesa B,18,0,30,12
1649900547808,MATH 109,A02,083214,Anzaldo; Leesa B,14,0,30,16
1649900547808,MATH 109,B01,083215,Anzaldo; Leesa B,25,0,30,5
1649900547808,MATH 109,B02,083216,Anzaldo; Leesa B,24,0,30,6
1649900553832,MATH 142A,A01,083219,Chow; Bennett,0,2,30,30
1649900553832,MATH 142A,A02,083220,Chow; Bennett,18,0,30,12
1649900553832,MATH 142A,B01,083221,Chow; Bennett,0,0,30,30
1649900553832,MATH 142A,B02,083222,Chow; Bennett,13,0,30,17
1649900559856,MATH 193A,A01,083224,Staff,0,3,30,30
1649900559856,MATH 193A,A02,083225,Staff,0,3,30,30
1649900559856,MATH 193A,A03,083781,Staff,10,0,30,20
1649900559856,MATH 193A,A04,083782,Staff,21,0,30,9
1649900565880,MATH 197,001,091859,McAuley; Julian John,9999,0,9999,0
1649900571939,COGS 9,A01,083615,Staff,23,0,60,37
1649900577965,COGS 11,A01,083617,Boyle; Mary E. T.,35,0,40,5
1649900583988,COGS 13,A01,083071,Staff,0,4,40,40
1649900590014,COGS 14A,A01,092681,Staff,74,0,100,26
1649900596107,COGS 14B,A01,083073,Cheng; Tzu-Han,27,0,50,23
1649900602133,COGS 17,A01,092677,Staff,66,0,75,9
1649900608168,COGS 100,A01,083619,Staff,6,0,60,54
1649900614195,COGS 101A,A01,083621,Davis; Joshua Daniel,7,0,60,53
1649900620218,COGS 101B,A01,091572,Staff,35,0,60,25
1649900626257,COGS 101C,A01,083625,Delgado; Tania,24,0,30,6
1649900632284,COGS 107A,A01,083627,Boyle; Mary E. T.,16,0,60,44
1649900638307,COGS 118A,A01,083075,Staff,22,0,60,38
1649900644336,CSE 3,A50,083646,Miranda; Gregory Joseph,26,0,38,12
1649900644336,CSE 3,A51,083647,Miranda; Gregory Joseph,37,0,37,0
1649900650363,CSE 8A,A50,083650,Miranda; Gregory Joseph,8,0,40,32
1649900656389,CSE 11,A01,083080,Cao; Yingjun,0,22,40,40
1649900662421,CSE 12,A01,083652,Staff,62,0,100,38
1649900668445,CSE 15L,A01,083654,Staff,22,0,50,28
1649900668445,CSE 15L,A02,083655,Staff,47,0,50,3
1649900674468,CSE 20,A01,083657,Staff,70,0,80,10
1649900680491,CSE 30,A01,083084,Eldon; John,1,13,40,39
1649900686518,CSE 100,A01,083659,Cao; Yingjun,2,18,50,48
1649900692541,CSE 134B,A01,083661,Powell; Thomas Allan,2,23,65,63
1649900698566,CSE 140,A01,083663,Staff,29,0,75,46
1649900714720,CSE 140L,A01,083088,Eldon; John,22,0,75,53
1649900720753,CSE 175,A01,083665,Kumar; Rakesh,12,0,25,13
1649900726776,CSE 190,A00,092507,Dubnov; Shlomo,14,0,15,1
1649900732803,ECE 45,A01,083139,Staff,15,0,40,25
1649900738827,ECE 65,A50,083695,Staff,11,0,30,19
1649900744851,ECE 109,A01,091882,Touri; Behrouz,59,0,70,11
1649900750877,ECE 180,A00,083140,Abi Samra; Nicholas Camill,27,0,30,3
1649900750877,ECE 180,B00,083141,Abi Samra; Nicholas Camill,13,0,30,17
1649900756901,MATH 10A,A01,083735,Patchell; Gregory David,22,0,30,8
1649900756901,MATH 10A,A02,083736,Patchell; Gregory David,28,0,30,2
1649900756901,MATH 10A,A03,083737,Patchell; Gregory David,28,0,30,2
1649900762992,MATH 10B,A01,083207,Staff,13,0,30,17
1649900762992,MATH 10B,A02,083208,Staff,25,0,30,5
1649900762992,MATH 10B,B01,083739,Staff,25,0,30,5
1649900762992,MATH 10B,B02,083740,Staff,30,0,30,0
1649900769021,MATH 18,A01,083743,Staff,22,0,30,8
1649900769021,MATH 18,A02,083744,Staff,29,0,30,1
1649900769021,MATH 18,A03,083745,Staff,29,0,30,1
1649900769021,MATH 18,A04,083746,Staff,29,0,30,1
1649900769021,MATH 18,B01,083748,Staff,12,0,30,18
1649900769021,MATH 18,B02,083749,Staff,26,0,30,4
1649900769021,MATH 18,B03,083750,Staff,28,0,30,2
1649900769021,MATH 18,B04,083751,Staff,27,0,30,3
1649900775046,MATH 20A,A01,083754,Staff,38,0,40,2
1649900781074,MATH 20B,A01,083756,Staff,22,0,30,8
1649900781074,MATH 20B,A02,083757,Staff,30,0,30,0
1649900787099,MATH 20C,A01,083760,Staff,23,0,30,7
1649900787099,MATH 20C,A02,083761,Staff,24,0,30,6
1649900787099,MATH 20C,B01,083762,Staff,29,0,30,1
1649900787099,MATH 20C,B02,083763,Staff,30,0,30,0
1649900793122,MATH 20D,A01,083765,Staff,21,0,30,9
1649900793122,MATH 20D,A02,083766,Staff,30,0,30,0
1649900793122,MATH 20D,A03,083767,Staff,30,0,30,0
1649900799146,MATH 20E,A01,083771,Staff,16,0,30,14
1649900799146,MATH 20E,A02,083772,Staff,26,0,30,4
1649900799146,MATH 20E,B01,083773,Staff,24,0,30,6
1649900799146,MATH 20E,B02,083774,Staff,29,0,30,1
1649900805181,MATH 103A,A01,083777,Staff,0,0,30,30
1649900805181,MATH 103A,A02,083778,Staff,2,0,30,28
1649900805181,MATH 103A,B01,083779,Staff,6,0,30,24
1649900805181,MATH 103A,B02,083780,Staff,22,0,30,8
1649900811205,MATH 105,A01,085443,Staff,0,4,30,30
1649900817228,MATH 109,A01,083213,Anzaldo; Leesa B,18,0,30,12
1649900817228,MATH 109,A02,083214,Anzaldo; Leesa B,14,0,30,16
1649900817228,MATH 109,B01,083215,Anzaldo; Leesa B,25,0,30,5
1649900817228,MATH 109,B02,083216,Anzaldo; Leesa B,24,0,30,6
1649900823256,MATH 142A,A01,083219,Chow; Bennett,0,2,30,30
1649900823256,MATH 142A,A02,083220,Chow; Bennett,18,0,30,12
1649900823256,MATH 142A,B01,083221,Chow; Bennett,0,0,30,30
1649900823256,MATH 142A,B02,083222,Chow; Bennett,13,0,30,17
1649900829280,MATH 193A,A01,083224,Staff,0,3,30,30
1649900829280,MATH 193A,A02,083225,Staff,0,3,30,30
1649900829280,MATH 193A,A03,083781,Staff,10,0,30,20
1649900829280,MATH 193A,A04,083782,Staff,20,0,30,10
1649900835306,MATH 197,001,091859,McAuley; Julian John,9999,0,9999,0
1649900841380,COGS 9,A01,083615,Staff,23,0,60,37
1649900847402,COGS 11,A01,083617,Boyle; Mary E. T.,35,0,40,5
1649900853429,COGS 13,A01,083071,Staff,0,4,40,40
1649900859458,COGS 14A,A01,092681,Staff,74,0,100,26
1649900865485,COGS 14B,A01,083073,Cheng; Tzu-Han,27,0,50,23
1649900871512,COGS 17,A01,092677,Staff,66,0,75,9
1649900877538,COGS 100,A01,083619,Staff,6,0,60,54
1649900883566,COGS 101A,A01,083621,Davis; Joshua Daniel,7,0,60,53
1649900889592,COGS 101B,A01,091572,Staff,35,0,60,25
1649900895617,COGS 101C,A01,083625,Delgado; Tania,24,0,30,6
1649900901651,COGS 107A,A01,083627,Boyle; Mary E. T.,16,0,60,44
1649900907684,COGS 118A,A01,083075,Staff,22,0,60,38
1649900913709,CSE 3,A50,083646,Miranda; Gregory Joseph,26,0,38,12
1649900913709,CSE 3,A51,083647,Miranda; Gregory Joseph,37,0,37,0
1649900919731,CSE 8A,A50,083650,Miranda; Gregory Joseph,8,0,40,32
1649900925755,CSE 11,A01,083080,Cao; Yingjun,0,22,40,40
1649900931783,CSE 12,A01,083652,Staff,62,0,100,38
1649900937810,CSE 15L,A01,083654,Staff,22,0,50,28
1649900937810,CSE 15L,A02,083655,Staff,47,0,50,3
1649900943836,CSE 20,A01,083657,Staff,70,0,80,10
1649900949860,CSE 30,A01,083084,Eldon; John,1,13,40,39
1649900955883,CSE 100,A01,083659,Cao; Yingjun,2,18,50,48
1649900961906,CSE 134B,A01,083661,Powell; Thomas Allan,2,23,65,63
1649900967931,CSE 140,A01,083663,Staff,29,0,75,46
1649900973952,CSE 140L,A01,083088,Eldon; John,22,0,75,53
1649900979974,CSE 175,A01,083665,Kumar; Rakesh,12,0,25,13
1649900985997,CSE 190,A00,092507,Dubnov; Shlomo,14,0,15,1
1649900992021,ECE 45,A01,083139,Staff,15,0,40,25
1649900998043,ECE 65,A50,083695,Staff,11,0,30,19
1649901004066,ECE 109,A01,091882,Touri; Behrouz,59,0,70,11
1649901010093,ECE 180,A00,083140,Abi Samra; Nicholas Camill,27,0,30,3
1649901010093,ECE 180,B00,083141,Abi Samra; Nicholas Camill,13,0,30,17
1649901016121,MATH 10A,A01,083735,Patchell; Gregory David,22,0,30,8
1649901016121,MATH 10A,A02,083736,Patchell; Gregory David,28,0,30,2
1649901016121,MATH 10A,A03,083737,Patchell; Gregory David,28,0,30,2
1649901022143,MATH 10B,A01,083207,Staff,13,0,30,17
1649901022143,MATH 10B,A02,083208,Staff,25,0,30,5
1649901022143,MATH 10B,B01,083739,Staff,25,0,30,5
1649901022143,MATH 10B,B02,083740,Staff,30,0,30,0
1649901028173,MATH 18,A01,083743,Staff,22,0,30,8
1649901028173,MATH 18,A02,083744,Staff,29,0,30,1
1649901028173,MATH 18,A03,083745,Staff,29,0,30,1
1649901028173,MATH 18,A04,083746,Staff,29,0,30,1
1649901028173,MATH 18,B01,083748,Staff,12,0,30,18
1649901028173,MATH 18,B02,083749,Staff,26,0,30,4
1649901028173,MATH 18,B03,083750,Staff,28,0,30,2
1649901028173,MATH 18,B04,083751,Staff,27,0,30,3
1649901034200,MATH 20A,A01,083754,Staff,38,0,40,2
1649901040222,MATH 20B,A01,083756,Staff,22,0,30,8
1649901040222,MATH 20B,A02,083757,Staff,30,0,30,0
1649901046250,MATH 20C,A01,083760,Staff,23,0,30,7
1649901046250,MATH 20C,A02,083761,Staff,24,0,30,6
1649901046250,MATH 20C,B01,083762,Staff,29,0,30,1
1649901046250,MATH 20C,B02,083763,Staff,30,0,30,0
1649901052278,MATH 20D,A01,083765,Staff,21,0,30,9
1649901052278,MATH 20D,A02,083766,Staff,30,0,30,0
1649901052278,MATH 20D,A03,083767,Staff,30,0,30,0
1649901058302,MATH 20E,A01,083771,Staff,15,0,30,15
1649901058302,MATH 20E,A02,083772,Staff,26,0,30,4
1649901058302,MATH 20E,B01,083773,Staff,24,0,30,6
1649901058302,MATH 20E,B02,083774,Staff,29,0,30,1
1649901064330,MATH 103A,A01,083777,Staff,0,0,30,30
1649901064330,MATH 103A,A02,083778,Staff,2,0,30,28
1649901064330,MATH 103A,B01,083779,Staff,6,0,30,24
1649901064330,MATH 103A,B02,083780,Staff,22,0,30,8
1649901070353,MATH 105,A01,085443,Staff,0,4,30,30
1649901076380,MATH 109,A01,083213,Anzaldo; Leesa B,18,0,30,12
1649901076380,MATH 109,A02,083214,Anzaldo; Leesa B,14,0,30,16
1649901076380,MATH 109,B01,083215,Anzaldo; Leesa B,25,0,30,5
1649901076380,MATH 109,B02,083216,Anzaldo; Leesa B,24,0,30,6
1649901082405,MATH 142A,A01,083219,Chow; Bennett,1,2,30,29
1649901082405,MATH 142A,A02,083220,Chow; Bennett,18,0,30,12
1649901082405,MATH 142A,B01,083221,Chow; Bennett,0,0,30,30
1649901082405,MATH 142A,B02,083222,Chow; Bennett,12,0,30,18
1649901088431,MATH 193A,A01,083224,Staff,0,3,30,30
1649901088431,MATH 193A,A02,083225,Staff,0,3,30,30
1649901088431,MATH 193A,A03,083781,Staff,10,0,30,20
1649901088431,MATH 193A,A04,083782,Staff,20,0,30,10
1649901094454,MATH 197,001,091859,McAuley; Julian John,9999,0,9999,0
1649901100509,COGS 9,A01,083615,Staff,22,0,60,38
1649901106532,COGS 11,A01,083617,Boyle; Mary E. T.,35,0,40,5
1649901112555,COGS 13,A01,083071,Staff,0,4,40,40
1649901118582,COGS 14A,A01,092681,Staff,74,0,100,26
1649901124606,COGS 14B,A01,083073,Cheng; Tzu-Han,26,0,50,24
1649901130629,COGS 17,A01,092677,Staff,66,0,75,9
1649901136654,COGS 100,A01,083619,Staff,5,0,60,55
1649901142676,COGS 101A,A01,083621,Davis; Joshua Daniel,6,0,60,54
1649901148706,COGS 101B,A01,091572,Staff,35,0,60,25
1649901154730,COGS 101C,A01,083625,Delgado; Tania,24,0,30,6
1649901160753,COGS 107A,A01,083627,Boyle; Mary E. T.,16,0,60,44
1649901166778,COGS 118A,A01,083075,Staff,22,0,60,38
1649901172806,CSE 3,A50,083646,Miranda; Gregory Joseph,26,0,38,12
1649901172806,CSE 3,A51,083647,Miranda; Gregory Joseph,37,0,37,0
1649901178830,CSE 8A,A50,083650,Miranda; Gregory Joseph,8,0,40,32
1649901184856,CSE 11,A01,083080,Cao; Yingjun,0,22,40,40
1649901190879,CSE 12,A01,083652,Staff,61,0,100,39
1649901196916,CSE 15L,A01,083654,Staff,22,0,50,28
1649901196916,CSE 15L,A02,083655,Staff,47,0,50,3
1649901203020,CSE 20,A01,083657,Staff,69,0,80,11
1649901209046,CSE 30,A01,083084,Eldon; John,1,13,40,39
1649901215073,CSE 100,A01,083659,Cao; Yingjun,2,18,50,48
1649901221097,CSE 134B,A01,083661,Powell; Thomas Allan,2,23,65,63
1649901227130,CSE 140,A01,083663,Staff,29,0,75,46
1649901233156,CSE 140L,A01,083088,Eldon; John,22,0,75,53
1649901239179,CSE 175,A01,083665,Kumar; Rakesh,12,0,25,13
1649901245206,CSE 190,A00,092507,Dubnov; Shlomo,14,0,15,1
1649901251229,ECE 45,A01,083139,Staff,15,0,40,25
1649901257267,ECE 65,A50,083695,Staff,10,0,30,20
1649901263289,ECE 109,A01,091882,Touri; Behrouz,59,0,70,11
1649901269311,ECE 180,A00,083140,Abi Samra; Nicholas Camill,27,0,30,3
1649901269311,ECE 180,B00,083141,Abi Samra; Nicholas Camill,13,0,30,17
1649901275333,MATH 10A,A01,083735,Patchell; Gregory David,22,0,30,8
1649901275333,MATH 10A,A02,083736,Patchell; Gregory David,28,0,30,2
1649901275333,MATH 10A,A03,083737,Patchell; Gregory David,28,0,30,2
1649901281357,MATH 10B,A01,083207,Staff,13,0,30,17
1649901281357,MATH 10B,A02,083208,Staff,25,0,30,5
1649901281357,MATH 10B,B01,083739,Staff,25,0,30,5
1649901281357,MATH 10B,B02,083740,Staff,30,0,30,0
1649901287387,MATH 18,A01,083743,Staff,22,0,30,8
1649901287387,MATH 18,A02,083744,Staff,29,0,30,1
1649901287387,MATH 18,A03,083745,Staff,29,0,30,1
1649901287387,MATH 18,A04,083746,Staff,29,0,30,1
1649901287387,MATH 18,B01,083748,Staff,12,0,30,18
1649901287387,MATH 18,B02,083749,Staff,26,0,30,4
1649901287387,MATH 18,B03,083750,Staff,28,0,30,2
1649901287387,MATH 18,B04,083751,Staff,27,0,30,3
1649901293418,MATH 20A,A01,083754,Staff,38,0,40,2
1649901299444,MATH 20B,A01,083756,Staff,22,0,30,8
1649901299444,MATH 20B,A02,083757,Staff,30,0,30,0
1649901305468,MATH 20C,A01,083760,Staff,23,0,30,7
1649901305468,MATH 20C,A02,083761,Staff,24,0,30,6
1649901305468,MATH 20C,B01,083762,Staff,29,0,30,1
1649901305468,MATH 20C,B02,083763,Staff,30,0,30,0
1649901311501,MATH 20D,A01,083765,Staff,21,0,30,9
1649901311501,MATH 20D,A02,083766,Staff,30,0,30,0
1649901311501,MATH 20D,A03,083767,Staff,30,0,30,0
1649901317525,MATH 20E,A01,083771,Staff,15,0,30,15
1649901317525,MATH 20E,A02,083772,Staff,26,0,30,4
1649901317525,MATH 20E,B01,083773,Staff,24,0,30,6
1649901317525,MATH 20E,B02,083774,Staff,29,0,30,1
1649901323553,MATH 103A,A01,083777,Staff,0,0,30,30
1649901323553,MATH 103A,A02,083778,Staff,2,0,30,28
1649901323553,MATH 103A,B01,083779,Staff,5,0,30,25
1649901323553,MATH 103A,B02,083780,Staff,21,0,30,9
1649901329585,MATH 105,A01,085443,Staff,0,4,30,30
1649901335609,MATH 109,A01,083213,Anzaldo; Leesa B,18,0,30,12
1649901335609,MATH 109,A02,083214,Anzaldo; Leesa B,14,0,30,16
1649901335609,MATH 109,B01,083215,Anzaldo; Leesa B,25,0,30,5
1649901335609,MATH 109,B02,083216,Anzaldo; Leesa B,24,0,30,6
1649901341649,MATH 142A,A01,083219,Chow; Bennett,1,2,30,29
1649901341649,MATH 142A,A02,083220,Chow; Bennett,18,0,30,12
1649901341649,MATH 142A,B01,083221,Chow; Bennett,0,0,30,30
1649901341649,MATH 142A,B02,083222,Chow; Bennett,12,0,30,18
1649901347672,MATH 193A,A01,083224,Staff,0,3,30,30
1649901347672,MATH 193A,A02,083225,Staff,0,3,30,30
1649901347672,MATH 193A,A03,083781,Staff,10,0,30,20
1649901347672,MATH 193A,A04,083782,Staff,20,0,30,10
1649901353696,MATH 197,001,091859,McAuley; Julian John,9999,0,9999,0
1649901359752,COGS 9,A01,083615,Staff,22,0,60,38
1649901365779,COGS 11,A01,083617,Boyle; Mary E. T.,35,0,40,5
1649901371807,COGS 13,A01,083071,Staff,0,4,40,40
1649901377839,COGS 14A,A01,092681,Staff,74,0,100,26
1649901383862,COGS 14B,A01,083073,Cheng; Tzu-Han,26,0,50,24
1649901389886,COGS 17,A01,092677,Staff,66,0,75,9
1649901395913,COGS 100,A01,083619,Staff,5,0,60,55
1649901401938,COGS 101A,A01,083621,Davis; Joshua Daniel,6,0,60,54
1649901407963,COGS 101B,A01,091572,Staff,35,0,60,25
1649901413994,COGS 101C,A01,083625,Delgado; Tania,24,0,30,6
1649901420021,COGS 107A,A01,083627,Boyle; Mary E. T.,16,0,60,44
1649901426057,COGS 118A,A01,083075,Staff,22,0,60,38
1649901432082,CSE 3,A50,083646,Miranda; Gregory Joseph,26,0,38,12
1649901432082,CSE 3,A51,083647,Miranda; Gregory Joseph,37,0,37,0
1649901438110,CSE 8A,A50,083650,Miranda; Gregory Joseph,8,0,40,32
1649901444138,CSE 11,A01,083080,Cao; Yingjun,0,22,40,40
1649901450161,CSE 12,A01,083652,Staff,61,0,100,39
1649901456187,CSE 15L,A01,083654,Staff,22,0,50,28
1649901456187,CSE 15L,A02,083655,Staff,47,0,50,3
1649901462210,CSE 20,A01,083657,Staff,69,0,80,11
1649901468232,CSE 30,A01,083084,Eldon; John,1,13,40,39
1649901474255,CSE 100,A01,083659,Cao; Yingjun,2,18,50,48
1649901480288,CSE 134B,A01,083661,Powell; Thomas Allan,2,23,65,63
1649901486312,CSE 140,A01,083663,Staff,29,0,75,46
1649901492339,CSE 140L,A01,083088,Eldon; John,22,0,75,53
1649901498362,CSE 175,A01,083665,Kumar; Rakesh,12,0,25,13
1649901504385,CSE 190,A00,092507,Dubnov; Shlomo,14,0,15,1
1649901510408,ECE 45,A01,083139,Staff,15,0,40,25
1649901516432,ECE 65,A50,083695,Staff,10,0,30,20
1649901522459,ECE 109,A01,091882,Touri; Behrouz,59,0,70,11
1649901528486,ECE 180,A00,083140,Abi Samra; Nicholas Camill,27,0,30,3
1649901528486,ECE 180,B00,083141,Abi Samra; Nicholas Camill,13,0,30,17
1649901534511,MATH 10A,A01,083735,Patchell; Gregory David,22,0,30,8
1649901534511,MATH 10A,A02,083736,Patchell; Gregory David,28,0,30,2
1649901534511,MATH 10A,A03,083737,Patchell; Gregory David,28,0,30,2
1649901540536,MATH 10B,A01,083207,Staff,13,0,30,17
1649901540536,MATH 10B,A02,083208,Staff,25,0,30,5
1649901540536,MATH 10B,B01,083739,Staff,25,0,30,5
1649901540536,MATH 10B,B02,083740,Staff,30,0,30,0
1649901546566,MATH 18,A01,083743,Staff,22,0,30,8
1649901546566,MATH 18,A02,083744,Staff,29,0,30,1
1649901546566,MATH 18,A03,083745,Staff,29,0,30,1
1649901546566,MATH 18,A04,083746,Staff,29,0,30,1
1649901546566,MATH 18,B01,083748,Staff,12,0,30,18
1649901546566,MATH 18,B02,083749,Staff,26,0,30,4
1649901546566,MATH 18,B03,083750,Staff,28,0,30,2
1649901546566,MATH 18,B04,083751,Staff,27,0,30,3
1649901552588,MATH 20A,A01,083754,Staff,38,0,40,2
1649901558617,MATH 20B,A01,083756,Staff,22,0,30,8
1649901558617,MATH 20B,A02,083757,Staff,30,0,30,0
1649901564640,MATH 20C,A01,083760,Staff,23,0,30,7
1649901564640,MATH 20C,A02,083761,Staff,24,0,30,6
1649901564640,MATH 20C,B01,083762,Staff,29,0,30,1
1649901564640,MATH 20C,B02,083763,Staff,30,0,30,0
1649901570668,MATH 20D,A01,083765,Staff,21,0,30,9
1649901570668,MATH 20D,A02,083766,Staff,30,0,30,0
1649901570668,MATH 20D,A03,083767,Staff,30,0,30,0
1649901576697,MATH 20E,A01,083771,Staff,15,0,30,15
1649901576697,MATH 20E,A02,083772,Staff,26,0,30,4
1649901576697,MATH 20E,B01,083773,Staff,24,0,30,6
1649901576697,MATH 20E,B02,083774,Staff,29,0,30,1
1649901582721,MATH 103A,A01,083777,Staff,0,0,30,30
1649901582721,MATH 103A,A02,083778,Staff,2,0,30,28
1649901582721,MATH 103A,B01,083779,Staff,5,0,30,25
1649901582721,MATH 103A,B02,083780,Staff,21,0,30,9
1649901588744,MATH 105,A01,085443,Staff,0,4,30,30
1649901594775,MATH 109,A01,083213,Anzaldo; Leesa B,18,0,30,12
1649901594775,MATH 109,A02,083214,Anzaldo; Leesa B,14,0,30,16
1649901594775,MATH 109,B01,083215,Anzaldo; Leesa B,25,0,30,5
1649901594775,MATH 109,B02,083216,Anzaldo; Leesa B,24,0,30,6
1649901600799,MATH 142A,A01,083219,Chow; Bennett,1,2,30,29
1649901600799,MATH 142A,A02,083220,Chow; Bennett,18,0,30,12
1649901600799,MATH 142A,B01,083221,Chow; Bennett,0,0,30,30
1649901600799,MATH 142A,B02,083222,Chow; Bennett,11,0,30,19
1649901606826,MATH 193A,A01,083224,Staff,0,3,30,30
1649901606826,MATH 193A,A02,083225,Staff,0,3,30,30
1649901606826,MATH 193A,A03,083781,Staff,9,0,30,21
1649901606826,MATH 193A,A04,083782,Staff,20,0,30,10
1649901612853,MATH 197,001,091859,McAuley; Julian John,9999,0,9999,0
1649901618913,COGS 9,A01,083615,Staff,21,0,60,39
1649901624941,COGS 11,A01,083617,Boyle; Mary E. T.,35,0,40,5
1649901630964,COGS 13,A01,083071,Staff,0,4,40,40
1649901636990,COGS 14A,A01,092681,Staff,74,0,100,26
1649901643013,COGS 14B,A01,083073,Cheng; Tzu-Han,26,0,50,24
1649901649038,COGS 17,A01,092677,Staff,67,0,75,8
1649901655073,COGS 100,A01,083619,Staff,5,0,60,55
1649901661104,COGS 101A,A01,083621,Davis; Joshua Daniel,6,0,60,54
1649901667130,COGS 101B,A01,091572,Staff,35,0,60,25
1649901673154,COGS 101C,A01,083625,Delgado; Tania,24,0,30,6
1649901679179,COGS 107A,A01,083627,Boyle; Mary E. T.,16,0,60,44
1649901685202,COGS 118A,A01,083075,Staff,22,0,60,38
1649901691224,CSE 3,A50,083646,Miranda; Gregory Joseph,26,0,38,12
1649901691224,CSE 3,A51,083647,Miranda; Gregory Joseph,37,0,37,0
1649901697263,CSE 8A,A50,083650,Miranda; Gregory Joseph,7,0,40,33
1649901703287,CSE 11,A01,083080,Cao; Yingjun,0,22,40,40
1649901709309,CSE 12,A01,083652,Staff,61,0,100,39
1649901715332,CSE 15L,A01,083654,Staff,22,0,50,28
1649901715332,CSE 15L,A02,083655,Staff,47,0,50,3
1649901721355,CSE 20,A01,083657,Staff,69,0,80,11
1649901727378,CSE 30,A01,083084,Eldon; John,1,13,40,39
1649901733408,CSE 100,A01,083659,Cao; Yingjun,2,18,50,48
1649901739440,CSE 134B,A01,083661,Powell; Thomas Allan,2,23,65,63
1649901745463,CSE 140,A01,083663,Staff,29,0,75,46
1649901751492,CSE 140L,A01,083088,Eldon; John,22,0,75,53
1649901757518,CSE 175,A01,083665,Kumar; Rakesh,12,0,25,13
1649901763543,CSE 190,A00,092507,Dubnov; Shlomo,14,0,15,1
1649901769566,ECE 45,A01,083139,Staff,15,0,40,25
1649901775592,ECE 65,A50,083695,Staff,10,0,30,20
1649901781618,ECE 109,A01,091882,Touri; Behrouz,59,0,70,11
1649901787646,ECE 180,A00,083140,Abi Samra; Nicholas Camill,27,0,30,3
1649901787646,ECE 180,B00,083141,Abi Samra; Nicholas Camill,13,0,30,17
1649901793669,MATH 10A,A01,083735,Patchell; Gregory David,22,0,30,8
1649901793669,MATH 10A,A02,083736,Patchell; Gregory David,28,0,30,2
1649901793669,MATH 10A,A03,083737,Patchell; Gregory David,28,0,30,2
1649901799781,MATH 10B,A01,083207,Staff,13,0,30,17
1649901799781,MATH 10B,A02,083208,Staff,25,0,30,5
1649901799781,MATH 10B,B01,083739,Staff,25,0,30,5
1649901799781,MATH 10B,B02,083740,Staff,30,0,30,0
1649901805807,MATH 18,A01,083743,Staff,22,0,30,8
1649901805807,MATH 18,A02,083744,Staff,29,0,30,1
1649901805807,MATH 18,A03,083745,Staff,29,0,30,1
1649901805807,MATH 18,A04,083746,Staff,29,0,30,1
1649901805807,MATH 18,B01,083748,Staff,12,0,30,18
1649901805807,MATH 18,B02,083749,Staff,26,0,30,4
1649901805807,MATH 18,B03,083750,Staff,28,0,30,2
1649901805807,MATH 18,B04,083751,Staff,27,0,30,3
1649901811831,MATH 20A,A01,083754,Staff,38,0,40,2
1649901817862,MATH 20B,A01,083756,Staff,21,0,30,9
1649901817862,MATH 20B,A02,083757,Staff,30,0,30,0
1649901823888,MATH 20C,A01,083760,Staff,23,0,30,7
1649901823888,MATH 20C,A02,083761,Staff,24,0,30,6
1649901823888,MATH 20C,B01,083762,Staff,29,0,30,1
1649901823888,MATH 20C,B02,083763,Staff,30,0,30,0
1649901829914,MATH 20D,A01,083765,Staff,21,0,30,9
1649901829914,MATH 20D,A02,083766,Staff,30,0,30,0
1649901829914,MATH 20D,A03,083767,Staff,30,0,30,0
1649901835951,MATH 20E,A01,083771,Staff,15,0,30,15
1649901835951,MATH 20E,A02,083772,Staff,26,0,30,4
1649901835951,MATH 20E,B01,083773,Staff,24,0,30,6
1649901835951,MATH 20E,B02,083774,Staff,29,0,30,1
1649901841979,MATH 103A,A01,083777,Staff,0,0,30,30
1649901841979,MATH 103A,A02,083778,Staff,2,0,30,28
1649901841979,MATH 103A,B01,083779,Staff,5,0,30,25
1649901841979,MATH 103A,B02,083780,Staff,21,0,30,9
1649901848006,MATH 105,A01,085443,Staff,0,4,30,30
1649901854034,MATH 109,A01,083213,Anzaldo; Leesa B,18,0,30,12
1649901854034,MATH 109,A02,083214,Anzaldo; Leesa B,14,0,30,16
1649901854034,MATH 109,B01,083215,Anzaldo; Leesa B,25,0,30,5
1649901854034,MATH 109,B02,083216,Anzaldo; Leesa B,24,0,30,6
1649901860067,MATH 142A,A01,083219,Chow; Bennett,1,1,30,29
1649901860067,MATH 142A,A02,083220,Chow; Bennett,18,0,30,12
1649901860067,MATH 142A,B01,083221,Chow; Bennett,0,0,30,30
1649901860067,MATH 142A,B02,083222,Chow; Bennett,11,0,30,19
1649901866094,MATH 193A,A01,083224,Staff,0,3,30,30
1649901866094,MATH 193A,A02,083225,Staff,0,3,30,30
1649901866094,MATH 193A,A03,083781,Staff,8,0,30,22
1649901866094,MATH 193A,A04,083782,Staff,20,0,30,10
1649901872121,MATH 197,001,091859,McAuley; Julian John,9999,0,9999,0
1649901878168,COGS 9,A01,083615,Staff,21,0,60,39
1649901884201,COGS 11,A01,083617,Boyle; Mary E. T.,35,0,40,5
1649901890231,COGS 13,A01,083071,Staff,0,4,40,40
1649901896257,COGS 14A,A01,092681,Staff,74,0,100,26
1649901902282,COGS 14B,A01,083073,Cheng; Tzu-Han,25,0,50,25
1649901908306,COGS 17,A01,092677,Staff,67,0,75,8
1649901914332,COGS 100,A01,083619,Staff,5,0,60,55
1649901920356,COGS 101A,A01,083621,Davis; Joshua Daniel,6,0,60,54
1649901926379,COGS 101B,A01,091572,Staff,35,0,60,25
1649901932402,COGS 101C,A01,083625,Delgado; Tania,24,0,30,6
1649901938430,COGS 107A,A01,083627,Boyle; Mary E. T.,16,0,60,44
1649901944459,COGS 118A,A01,083075,Staff,22,0,60,38
1649901950483,CSE 3,A50,083646,Miranda; Gregory Joseph,26,0,38,12
1649901950483,CSE 3,A51,083647,Miranda; Gregory Joseph,37,0,37,0
1649901956507,CSE 8A,A50,083650,Miranda; Gregory Joseph,7,0,40,33
1649901962538,CSE 11,A01,083080,Cao; Yingjun,0,23,40,40
1649901968579,CSE 12,A01,083652,Staff,61,0,100,39
1649901974603,CSE 15L,A01,083654,Staff,22,0,50,28
1649901974603,CSE 15L,A02,083655,Staff,47,0,50,3
1649901980628,CSE 20,A01,083657,Staff,69,0,80,11
1649901986656,CSE 30,A01,083084,Eldon; John,1,14,40,39
1649901992681,CSE 100,A01,083659,Cao; Yingjun,2,19,50,48
1649901998706,CSE 134B,A01,083661,Powell; Thomas Allan,2,23,65,63
1649902004728,CSE 140,A01,083663,Staff,29,0,75,46
1649902010757,CSE 140L,A01,083088,Eldon; John,22,0,75,53
1649902016782,CSE 175,A01,083665,Kumar; Rakesh,12,0,25,13
1649902022804,CSE 190,A00,092507,Dubnov; Shlomo,14,0,15,1
1649902028828,ECE 45,A01,083139,Staff,15,0,40,25
1649902034858,ECE 65,A50,083695,Staff,10,0,30,20
1649902040882,ECE 109,A01,091882,Touri; Behrouz,59,0,70,11
1649902046927,ECE 180,A00,083140,Abi Samra; Nicholas Camill,27,0,30,3
1649902046927,ECE 180,B00,083141,Abi Samra; Nicholas Camill,13,0,30,17
1649902052955,MATH 10A,A01,083735,Patchell; Gregory David,22,0,30,8
1649902052955,MATH 10A,A02,083736,Patchell; Gregory David,28,0,30,2
1649902052955,MATH 10A,A03,083737,Patchell; Gregory David,28,0,30,2
1649902058980,MATH 10B,A01,083207,Staff,13,0,30,17
1649902058980,MATH 10B,A02,083208,Staff,25,0,30,5
1649902058980,MATH 10B,B01,083739,Staff,25,0,30,5
1649902058980,MATH 10B,B02,083740,Staff,30,0,30,0
1649902065010,MATH 18,A01,083743,Staff,22,0,30,8
1649902065010,MATH 18,A02,083744,Staff,29,0,30,1
1649902065010,MATH 18,A03,083745,Staff,29,0,30,1
1649902065010,MATH 18,A04,083746,Staff,29,0,30,1
1649902065010,MATH 18,B01,083748,Staff,12,0,30,18
1649902065010,MATH 18,B02,083749,Staff,26,0,30,4
1649902065010,MATH 18,B03,083750,Staff,28,0,30,2
1649902065010,MATH 18,B04,083751,Staff,27,0,30,3
1649902071046,MATH 20A,A01,083754,Staff,38,0,40,2
1649902077072,MATH 20B,A01,083756,Staff,21,0,30,9
1649902077072,MATH 20B,A02,083757,Staff,30,0,30,0
1649902083096,MATH 20C,A01,083760,Staff,23,0,30,7
1649902083096,MATH 20C,A02,083761,Staff,24,0,30,6
1649902083096,MATH 20C,B01,083762,Staff,29,0,30,1
1649902083096,MATH 20C,B02,083763,Staff,30,0,30,0
1649902089122,MATH 20D,A01,083765,Staff,21,0,30,9
1649902089122,MATH 20D,A02,083766,Staff,30,0,30,0
1649902089122,MATH 20D,A03,083767,Staff,30,0,30,0
1649902095146,MATH 20E,A01,083771,Staff,15,0,30,15
1649902095146,MATH 20E,A02,083772,Staff,26,0,30,4
1649902095146,MATH 20E,B01,083773,Staff,24,0,30,6
1649902095146,MATH 20E,B02,083774,Staff,29,0,30,1
1649902101174,MATH 103A,A01,083777,Staff,0,0,30,30
1649902101174,MATH 103A,A02,083778,Staff,2,0,30,28
1649902101174,MATH 103A,B01,083779,Staff,4,0,30,26
1649902101174,MATH 103A,B02,083780,Staff,21,0,30,9
1649902107196,MATH 105,A01,085443,Staff,0,4,30,30
1649902113225,MATH 109,A01,083213,Anzaldo; Leesa B,18,0,30,12
1649902113225,MATH 109,A02,083214,Anzaldo; Leesa B,14,0,30,16
1649902113225,MATH 109,B01,083215,Anzaldo; Leesa B,25,0,30,5
1649902113225,MATH 109,B02,083216,Anzaldo; Leesa B,24,0,30,6
1649902119255,MATH 142A,A01,083219,Chow; Bennett,1,1,30,29
1649902119255,MATH 142A,A02,083220,Chow; Bennett,18,0,30,12
1649902119255,MATH 142A,B01,083221,Chow; Bennett,0,0,30,30
1649902119255,MATH 142A,B02,083222,Chow; Bennett,11,0,30,19
1649902125293,MATH 193A,A01,083224,Staff,0,3,30,30
1649902125293,MATH 193A,A02,083225,Staff,0,3,30,30
1649902125293,MATH 193A,A03,083781,Staff,8,0,30,22
1649902125293,MATH 193A,A04,083782,Staff,20,0,30,10
1649902131317,MATH 197,001,091859,McAuley; Julian John,9999,0,9999,0
1649902137377,COGS 9,A01,083615,Staff,21,0,60,39
1649902143400,COGS 11,A01,083617,Boyle; Mary E. T.,35,0,40,5
1649902149426,COGS 13,A01,083071,Staff,0,6,40,40
1649902155452,COGS 14A,A01,092681,Staff,74,0,100,26
1649902161477,COGS 14B,A01,083073,Cheng; Tzu-Han,25,0,50,25
1649902167499,COGS 17,A01,092677,Staff,67,0,75,8
1649902173523,COGS 100,A01,083619,Staff,5,0,60,55
1649902179554,COGS 101A,A01,083621,Davis; Joshua Daniel,6,0,60,54
1649902185592,COGS 101B,A01,091572,Staff,35,0,60,25
1649902191616,COGS 101C,A01,083625,Delgado; Tania,24,0,30,6
1649902197640,COGS 107A,A01,083627,Boyle; Mary E. T.,16,0,60,44
1649902203663,COGS 118A,A01,083075,Staff,22,0,60,38
1649902209689,CSE 3,A50,083646,Miranda; Gregory Joseph,26,0,38,12
1649902209689,CSE 3,A51,083647,Miranda; Gregory Joseph,37,0,37,0
1649902215715,CSE 8A,A50,083650,Miranda; Gregory Joseph,7,0,40,33
1649902221761,CSE 11,A01,083080,Cao; Yingjun,0,23,40,40
1649902227803,CSE 12,A01,083652,Staff,61,0,100,39
1649902233827,CSE 15L,A01,083654,Staff,22,0,50,28
1649902233827,CSE 15L,A02,083655,Staff,47,0,50,3
1649902239851,CSE 20,A01,083657,Staff,69,0,80,11
1649902245878,CSE 30,A01,083084,Eldon; John,1,14,40,39
1649902251905,CSE 100,A01,083659,Cao; Yingjun,2,19,50,48
1649902257928,CSE 134B,A01,083661,Powell; Thomas Allan,2,23,65,63
1649902263952,CSE 140,A01,083663,Staff,29,0,75,46
1649902269980,CSE 140L,A01,083088,Eldon; John,22,0,75,53
1649902276003,CSE 175,A01,083665,Kumar; Rakesh,12,0,25,13
1649902282028,CSE 190,A00,092507,Dubnov; Shlomo,14,0,15,1
1649902288059,ECE 45,A01,083139,Staff,15,0,40,25
1649902294093,ECE 65,A50,083695,Staff,10,0,30,20
1649902300117,ECE 109,A01,091882,Touri; Behrouz,58,0,70,12
1649902306142,ECE 180,A00,083140,Abi Samra; Nicholas Camill,27,0,30,3
1649902306142,ECE 180,B00,083141,Abi Samra; Nicholas Camill,13,0,30,17
1649902312171,MATH 10A,A01,083735,Patchell; Gregory David,22,0,30,8
1649902312171,MATH 10A,A02,083736,Patchell; Gregory David,28,0,30,2
1649902312171,MATH 10A,A03,083737,Patchell; Gregory David,28,0,30,2
1649902318199,MATH 10B,A01,083207,Staff,13,0,30,17
1649902318199,MATH 10B,A02,083208,Staff,25,0,30,5
1649902318199,MATH 10B,B01,083739,Staff,25,0,30,5
1649902318199,MATH 10B,B02,083740,Staff,30,0,30,0
1649902324225,MATH 18,A01,083743,Staff,22,0,30,8
1649902324225,MATH 18,A02,083744,Staff,29,0,30,1
1649902324225,MATH 18,A03,083745,Staff,29,0,30,1
1649902324225,MATH 18,A04,083746,Staff,29,0,30,1
1649902324225,MATH 18,B01,083748,Staff,12,0,30,18
1649902324225,MATH 18,B02,083749,Staff,26,0,30,4
1649902324225,MATH 18,B03,083750,Staff,28,0,30,2
1649902324225,MATH 18,B04,083751,Staff,27,0,30,3
1649902330251,MATH 20A,A01,083754,Staff,38,0,40,2
1649902336274,MATH 20B,A01,083756,Staff,21,0,30,9
1649902336274,MATH 20B,A02,083757,Staff,30,0,30,0
1649902342304,MATH 20C,A01,083760,Staff,23,0,30,7
1649902342304,MATH 20C,A02,083761,Staff,24,0,30,6
1649902342304,MATH 20C,B01,083762,Staff,29,0,30,1
1649902342304,MATH 20C,B02,083763,Staff,30,0,30,0
1649902348328,MATH 20D,A01,083765,Staff,21,0,30,9
1649902348328,MATH 20D,A02,083766,Staff,30,0,30,0
1649902348328,MATH 20D,A03,083767,Staff,30,0,30,0
1649902354352,MATH 20E,A01,083771,Staff,15,0,30,15
1649902354352,MATH 20E,A02,083772,Staff,25,0,30,5
1649902354352,MATH 20E,B01,083773,Staff,22,0,30,8
1649902354352,MATH 20E,B02,083774,Staff,29,0,30,1
1649902360376,MATH 103A,A01,083777,Staff,0,0,30,30
1649902360376,MATH 103A,A02,083778,Staff,2,0,30,28
1649902360376,MATH 103A,B01,083779,Staff,4,0,30,26
1649902360376,MATH 103A,B02,083780,Staff,21,0,30,9
1649902366409,MATH 105,A01,085443,Staff,0,4,30,30
1649902372437,MATH 109,A01,083213,Anzaldo; Leesa B,18,0,30,12
1649902372437,MATH 109,A02,083214,Anzaldo; Leesa B,13,0,30,17
1649902372437,MATH 109,B01,083215,Anzaldo; Leesa B,25,0,30,5
1649902372437,MATH 109,B02,083216,Anzaldo; Leesa B,24,0,30,6
1649902378461,MATH 142A,A01,083219,Chow; Bennett,1,1,30,29
1649902378461,MATH 142A,A02,083220,Chow; Bennett,17,0,30,13
1649902378461,MATH 142A,B01,083221,Chow; Bennett,0,0,30,30
1649902378461,MATH 142A,B02,083222,Chow; Bennett,11,0,30,19
1649902384485,MATH 193A,A01,083224,Staff,0,3,30,30
1649902384485,MATH 193A,A02,083225,Staff,0,3,30,30
1649902384485,MATH 193A,A03,083781,Staff,8,0,30,22
1649902384485,MATH 193A,A04,083782,Staff,20,0,30,10
1649902390508,MATH 197,001,091859,McAuley; Julian John,9999,0,9999,0
1649902396646,COGS 9,A01,083615,Staff,21,0,60,39
1649902402673,COGS 11,A01,083617,Boyle; Mary E. T.,35,0,40,5
1649902408697,COGS 13,A01,083071,Staff,0,6,40,40
1649902414732,COGS 14A,A01,092681,Staff,74,0,100,26
1649902420757,COGS 14B,A01,083073,Cheng; Tzu-Han,25,0,50,25
1649902426790,COGS 17,A01,092677,Staff,67,0,75,8
1649902432818,COGS 100,A01,083619,Staff,4,0,60,56
1649902438845,COGS 101A,A01,083621,Davis; Joshua Daniel,6,0,60,54
1649902444871,COGS 101B,A01,091572,Staff,35,0,60,25
1649902450901,COGS 101C,A01,083625,Delgado; Tania,24,0,30,6
1649902456923,COGS 107A,A01,083627,Boyle; Mary E. T.,15,0,60,45
1649902462957,COGS 118A,A01,083075,Staff,22,0,60,38
1649902468982,CSE 3,A50,083646,Miranda; Gregory Joseph,26,0,38,12
1649902468982,CSE 3,A51,083647,Miranda; Gregory Joseph,37,0,37,0
1649902475006,CSE 8A,A50,083650,Miranda; Gregory Joseph,7,0,40,33
1649902481029,CSE 11,A01,083080,Cao; Yingjun,0,23,40,40
1649902487053,CSE 12,A01,083652,Staff,61,0,100,39
1649902493075,CSE 15L,A01,083654,Staff,22,0,50,28
1649902493075,CSE 15L,A02,083655,Staff,47,0,50,3
1649902499099,CSE 20,A01,083657,Staff,68,0,80,12
1649902505120,CSE 30,A01,083084,Eldon; John,1,14,40,39
1649902511148,CSE 100,A01,083659,Cao; Yingjun,2,19,50,48
1649902517171,CSE 134B,A01,083661,Powell; Thomas Allan,2,23,65,63
1649902523207,CSE 140,A01,083663,Staff,29,0,75,46
1649902529229,CSE 140L,A01,083088,Eldon; John,22,0,75,53
1649902535255,CSE 175,A01,083665,Kumar; Rakesh,12,0,25,13
1649902541283,CSE 190,A00,092507,Dubnov; Shlomo,14,0,15,1
1649902547308,ECE 45,A01,083139,Staff,15,0,40,25
1649902553330,ECE 65,A50,083695,Staff,10,0,30,20
1649902559355,ECE 109,A01,091882,Touri; Behrouz,58,0,70,12
1649902565377,ECE 180,A00,083140,Abi Samra; Nicholas Camill,27,0,30,3
1649902565377,ECE 180,B00,083141,Abi Samra; Nicholas Camill,13,0,30,17
1649902571404,MATH 10A,A01,083735,Patchell; Gregory David,22,0,30,8
1649902571404,MATH 10A,A02,083736,Patchell; Gregory David,28,0,30,2
1649902571404,MATH 10A,A03,083737,Patchell; Gregory David,28,0,30,2
1649902577433,MATH 10B,A01,083207,Staff,13,0,30,17
1649902577433,MATH 10B,A02,083208,Staff,25,0,30,5
1649902577433,MATH 10B,B01,083739,Staff,25,0,30,5
1649902577433,MATH 10B,B02,083740,Staff,30,0,30,0
1649902583464,MATH 18,A01,083743,Staff,22,0,30,8
1649902583464,MATH 18,A02,083744,Staff,29,0,30,1
1649902583464,MATH 18,A03,083745,Staff,29,0,30,1
1649902583464,MATH 18,A04,083746,Staff,29,0,30,1
1649902583464,MATH 18,B01,083748,Staff,12,0,30,18
1649902583464,MATH 18,B02,083749,Staff,26,0,30,4
1649902583464,MATH 18,B03,083750,Staff,28,0,30,2
1649902583464,MATH 18,B04,083751,Staff,27,0,30,3
1649902589487,MATH 20A,A01,083754,Staff,38,0,40,2
1649902595513,MATH 20B,A01,083756,Staff,21,0,30,9
1649902595513,MATH 20B,A02,083757,Staff,30,0,30,0
1649902601538,MATH 20C,A01,083760,Staff,22,0,30,8
1649902601538,MATH 20C,A02,083761,Staff,24,0,30,6
1649902601538,MATH 20C,B01,083762,Staff,29,0,30,1
1649902601538,MATH 20C,B02,083763,Staff,30,0,30,0
1649902607568,MATH 20D,A01,083765,Staff,21,0,30,9
1649902607568,MATH 20D,A02,083766,Staff,30,0,30,0
1649902607568,MATH 20D,A03,083767,Staff,30,0,30,0
1649902613591,MATH 20E,A01,083771,Staff,15,0,30,15
1649902613591,MATH 20E,A02,083772,Staff,25,0,30,5
1649902613591,MATH 20E,B01,083773,Staff,22,0,30,8
1649902613591,MATH 20E,B02,083774,Staff,29,0,30,1
1649902619615,MATH 103A,A01,083777,Staff,0,0,30,30
1649902619615,MATH 103A,A02,083778,Staff,1,0,30,29
1649902619615,MATH 103A,B01,083779,Staff,4,0,30,26
1649902619615,MATH 103A,B02,083780,Staff,21,0,30,9
1649902625643,MATH 105,A01,085443,Staff,0,4,30,30
1649902631667,MATH 109,A01,083213,Anzaldo; Leesa B,18,0,30,12
1649902631667,MATH 109,A02,083214,Anzaldo; Leesa B,13,0,30,17
1649902631667,MATH 109,B01,083215,Anzaldo; Leesa B,26,0,30,4
1649902631667,MATH 109,B02,083216,Anzaldo; Leesa B,24,0,30,6
1649902637695,MATH 142A,A01,083219,Chow; Bennett,1,1,30,29
1649902637695,MATH 142A,A02,083220,Chow; Bennett,16,0,30,14
1649902637695,MATH 142A,B01,083221,Chow; Bennett,0,0,30,30
1649902637695,MATH 142A,B02,083222,Chow; Bennett,11,0,30,19
1649902643727,MATH 193A,A01,083224,Staff,0,3,30,30
1649902643727,MATH 193A,A02,083225,Staff,0,3,30,30
1649902643727,MATH 193A,A03,083781,Staff,8,0,30,22
1649902643727,MATH 193A,A04,083782,Staff,20,0,30,10
1649902649758,MATH 197,001,091859,McAuley; Julian John,9999,0,9999,0
1649902655820,COGS 9,A01,083615,Staff,21,0,60,39
1649902661845,COGS 11,A01,083617,Boyle; Mary E. T.,35,0,40,5
1649902667876,COGS 13,A01,083071,Staff,0,6,40,40
1649902673973,COGS 14A,A01,092681,Staff,74,0,100,26
1649902680004,COGS 14B,A01,083073,Cheng; Tzu-Han,25,0,50,25
1649902686032,COGS 17,A01,092677,Staff,67,0,75,8
1649902692054,COGS 100,A01,083619,Staff,3,0,60,57
1649902698082,COGS 101A,A01,083621,Davis; Joshua Daniel,6,0,60,54
1649902704110,COGS 101B,A01,091572,Staff,35,0,60,25
1649902710135,COGS 101C,A01,083625,Delgado; Tania,24,0,30,6
1649902716163,COGS 107A,A01,083627,Boyle; Mary E. T.,15,0,60,45
1649902722186,COGS 118A,A01,083075,Staff,22,0,60,38
1649902728215,CSE 3,A50,083646,Miranda; Gregory Joseph,26,0,38,12
1649902728215,CSE 3,A51,083647,Miranda; Gregory Joseph,37,0,37,0
1649902734240,CSE 8A,A50,083650,Miranda; Gregory Joseph,7,0,40,33
1649902740266,CSE 11,A01,083080,Cao; Yingjun,0,23,40,40
1649902746292,CSE 12,A01,083652,Staff,61,0,100,39
1649902752317,CSE 15L,A01,083654,Staff,22,0,50,28
1649902752317,CSE 15L,A02,083655,Staff,47,0,50,3
1649902758343,CSE 20,A01,083657,Staff,68,0,80,12
1649902764366,CSE 30,A01,083084,Eldon; John,1,14,40,39
1649902770403,CSE 100,A01,083659,Cao; Yingjun,2,20,50,48
1649902776439,CSE 134B,A01,083661,Powell; Thomas Allan,2,23,65,63
1649902782462,CSE 140,A01,083663,Staff,29,0,75,46
1649902788493,CSE 140L,A01,083088,Eldon; John,22,0,75,53
1649902794519,CSE 175,A01,083665,Kumar; Rakesh,12,0,25,13
1649902800543,CSE 190,A00,092507,Dubnov; Shlomo,14,0,15,1
1649902806569,ECE 45,A01,083139,Staff,15,0,40,25
1649902812593,ECE 65,A50,083695,Staff,10,0,30,20
1649902818629,ECE 109,A01,091882,Touri; Behrouz,59,0,70,11
1649902824654,ECE 180,A00,083140,Abi Samra; Nicholas Camill,27,0,30,3
1649902824654,ECE 180,B00,083141,Abi Samra; Nicholas Camill,13,0,30,17
1649902830678,MATH 10A,A01,083735,Patchell; Gregory David,22,0,30,8
1649902830678,MATH 10A,A02,083736,Patchell; Gregory David,28,0,30,2
1649902830678,MATH 10A,A03,083737,Patchell; Gregory David,28,0,30,2
1649902836702,MATH 10B,A01,083207,Staff,13,0,30,17
1649902836702,MATH 10B,A02,083208,Staff,25,0,30,5
1649902836702,MATH 10B,B01,083739,Staff,25,0,30,5
1649902836702,MATH 10B,B02,083740,Staff,30,0,30,0
1649902842741,MATH 18,A01,083743,Staff,22,0,30,8
1649902842741,MATH 18,A02,083744,Staff,29,0,30,1
1649902842741,MATH 18,A03,083745,Staff,29,0,30,1
1649902842741,MATH 18,A04,083746,Staff,29,0,30,1
1649902842741,MATH 18,B01,083748,Staff,12,0,30,18
1649902842741,MATH 18,B02,083749,Staff,26,0,30,4
1649902842741,MATH 18,B03,083750,Staff,28,0,30,2
1649902842741,MATH 18,B04,083751,Staff,27,0,30,3
1649902848777,MATH 20A,A01,083754,Staff,38,0,40,2
1649902854802,MATH 20B,A01,083756,Staff,21,0,30,9
1649902854802,MATH 20B,A02,083757,Staff,30,0,30,0
1649902860853,MATH 20C,A01,083760,Staff,22,0,30,8
1649902860853,MATH 20C,A02,083761,Staff,24,0,30,6
1649902860853,MATH 20C,B01,083762,Staff,29,0,30,1
1649902860853,MATH 20C,B02,083763,Staff,30,0,30,0
1649902866877,MATH 20D,A01,083765,Staff,21,0,30,9
1649902866877,MATH 20D,A02,083766,Staff,30,0,30,0
1649902866877,MATH 20D,A03,083767,Staff,30,0,30,0
1649902872901,MATH 20E,A01,083771,Staff,15,0,30,15
1649902872901,MATH 20E,A02,083772,Staff,25,0,30,5
1649902872901,MATH 20E,B01,083773,Staff,22,0,30,8
1649902872901,MATH 20E,B02,083774,Staff,29,0,30,1
1649902878930,MATH 103A,A01,083777,Staff,0,0,30,30
1649902878930,MATH 103A,A02,083778,Staff,1,0,30,29
1649902878930,MATH 103A,B01,083779,Staff,4,0,30,26
1649902878930,MATH 103A,B02,083780,Staff,21,0,30,9
1649902884954,MATH 105,A01,085443,Staff,0,4,30,30
1649902890976,MATH 109,A01,083213,Anzaldo; Leesa B,18,0,30,12
1649902890976,MATH 109,A02,083214,Anzaldo; Leesa B,13,0,30,17
1649902890976,MATH 109,B01,083215,Anzaldo; Leesa B,26,0,30,4
1649902890976,MATH 109,B02,083216,Anzaldo; Leesa B,24,0,30,6
1649902897012,MATH 142A,A01,083219,Chow; Bennett,1,1,30,29
1649902897012,MATH 142A,A02,083220,Chow; Bennett,16,0,30,14
1649902897012,MATH 142A,B01,083221,Chow; Bennett,0,0,30,30
1649902897012,MATH 142A,B02,083222,Chow; Bennett,11,0,30,19
1649902903037,MATH 193A,A01,083224,Staff,0,3,30,30
1649902903037,MATH 193A,A02,083225,Staff,0,3,30,30
1649902903037,MATH 193A,A03,083781,Staff,8,0,30,22
1649902903037,MATH 193A,A04,083782,Staff,20,0,30,10
1649902909060,MATH 197,001,091859,McAuley; Julian John,9999,0,9999,0
1649902915114,COGS 9,A01,083615,Staff,21,0,60,39
1649902921138,COGS 11,A01,083617,Boyle; Mary E. T.,35,0,40,5
1649902927161,COGS 13,A01,083071,Staff,0,6,40,40
1649902933196,COGS 14A,A01,092681,Staff,74,0,100,26
1649902939219,COGS 14B,A01,083073,Cheng; Tzu-Han,25,0,50,25
1649902945242,COGS 17,A01,092677,Staff,67,0,75,8
1649902951278,COGS 100,A01,083619,Staff,2,0,60,58
1649902957310,COGS 101A,A01,083621,Davis; Joshua Daniel,6,0,60,54
1649902963335,COGS 101B,A01,091572,Staff,34,0,60,26
1649902969362,COGS 101C,A01,083625,Delgado; Tania,24,0,30,6
1649902975384,COGS 107A,A01,083627,Boyle; Mary E. T.,15,0,60,45
1649902981411,COGS 118A,A01,083075,Staff,22,0,60,38
1649902987511,CSE 3,A50,083646,Miranda; Gregory Joseph,26,0,38,12
1649902987511,CSE 3,A51,083647,Miranda; Gregory Joseph,37,0,37,0
1649902993534,CSE 8A,A50,083650,Miranda; Gregory Joseph,7,0,40,33
1649902999559,CSE 11,A01,083080,Cao; Yingjun,0,23,40,40
1649903005582,CSE 12,A01,083652,Staff,61,0,100,39
1649903011606,CSE 15L,A01,083654,Staff,22,0,50,28
1649903011606,CSE 15L,A02,083655,Staff,47,0,50,3
1649903017628,CSE 20,A01,083657,Staff,68,0,80,12
1649903023653,CSE 30,A01,083084,Eldon; John,1,14,40,39
1649903029677,CSE 100,A01,083659,Cao; Yingjun,2,20,50,48
1649903035706,CSE 134B,A01,083661,Powell; Thomas Allan,2,23,65,63
1649903041729,CSE 140,A01,083663,Staff,29,0,75,46
1649903047752,CSE 140L,A01,083088,Eldon; John,22,0,75,53
1649903053775,CSE 175,A01,083665,Kumar; Rakesh,12,0,25,13
1649903059801,CSE 190,A00,092507,Dubnov; Shlomo,14,0,15,1
1649903065824,ECE 45,A01,083139,Staff,14,0,40,26
1649903071852,ECE 65,A50,083695,Staff,10,0,30,20
1649903077879,ECE 109,A01,091882,Touri; Behrouz,59,0,70,11
1649903083905,ECE 180,A00,083140,Abi Samra; Nicholas Camill,27,0,30,3
1649903083905,ECE 180,B00,083141,Abi Samra; Nicholas Camill,13,0,30,17
1649903089929,MATH 10A,A01,083735,Patchell; Gregory David,22,0,30,8
1649903089929,MATH 10A,A02,083736,Patchell; Gregory David,28,0,30,2
1649903089929,MATH 10A,A03,083737,Patchell; Gregory David,28,0,30,2
1649903095955,MATH 10B,A01,083207,Staff,13,0,30,17
1649903095955,MATH 10B,A02,083208,Staff,25,0,30,5
1649903095955,MATH 10B,B01,083739,Staff,25,0,30,5
1649903095955,MATH 10B,B02,083740,Staff,30,0,30,0
1649903101997,MATH 18,A01,083743,Staff,22,0,30,8
1649903101997,MATH 18,A02,083744,Staff,29,0,30,1
1649903101997,MATH 18,A03,083745,Staff,29,0,30,1
1649903101997,MATH 18,A04,083746,Staff,29,0,30,1
1649903101997,MATH 18,B01,083748,Staff,12,0,30,18
1649903101997,MATH 18,B02,083749,Staff,26,0,30,4
1649903101997,MATH 18,B03,083750,Staff,28,0,30,2
1649903101997,MATH 18,B04,083751,Staff,27,0,30,3
1649903108020,MATH 20A,A01,083754,Staff,38,0,40,2
1649903114045,MATH 20B,A01,083756,Staff,21,0,30,9
1649903114045,MATH 20B,A02,083757,Staff,30,0,30,0
1649903120072,MATH 20C,A01,083760,Staff,22,0,30,8
1649903120072,MATH 20C,A02,083761,Staff,24,0,30,6
1649903120072,MATH 20C,B01,083762,Staff,29,0,30,1
1649903120072,MATH 20C,B02,083763,Staff,30,0,30,0
1649903126095,MATH 20D,A01,083765,Staff,21,0,30,9
1649903126095,MATH 20D,A02,083766,Staff,30,0,30,0
1649903126095,MATH 20D,A03,083767,Staff,30,0,30,0
1649903132120,MATH 20E,A01,083771,Staff,15,0,30,15
1649903132120,MATH 20E,A02,083772,Staff,25,0,30,5
1649903132120,MATH 20E,B01,083773,Staff,22,0,30,8
1649903132120,MATH 20E,B02,083774,Staff,29,0,30,1
1649903138144,MATH 103A,A01,083777,Staff,0,0,30,30
1649903138144,MATH 103A,A02,083778,Staff,0,0,30,30
1649903138144,MATH 103A,B01,083779,Staff,4,0,30,26
1649903138144,MATH 103A,B02,083780,Staff,21,0,30,9
1649903144167,MATH 105,A01,085443,Staff,0,4,30,30
1649903150195,MATH 109,A01,083213,Anzaldo; Leesa B,17,0,30,13
1649903150195,MATH 109,A02,083214,Anzaldo; Leesa B,13,0,30,17
1649903150195,MATH 109,B01,083215,Anzaldo; Leesa B,26,0,30,4
1649903150195,MATH 109,B02,083216,Anzaldo; Leesa B,24,0,30,6
1649903156219,MATH 142A,A01,083219,Chow; Bennett,1,1,30,29
1649903156219,MATH 142A,A02,083220,Chow; Bennett,16,0,30,14
1649903156219,MATH 142A,B01,083221,Chow; Bennett,0,0,30,30
1649903156219,MATH 142A,B02,083222,Chow; Bennett,11,0,30,19
1649903162245,MATH 193A,A01,083224,Staff,0,3,30,30
1649903162245,MATH 193A,A02,083225,Staff,0,3,30,30
1649903162245,MATH 193A,A03,083781,Staff,8,0,30,22
1649903162245,MATH 193A,A04,083782,Staff,20,0,30,10
1649903168277,MATH 197,001,091859,McAuley; Julian John,9999,0,9999,0
1649903174325,COGS 9,A01,083615,Staff,21,0,60,39
1649903180351,COGS 11,A01,083617,Boyle; Mary E. T.,35,0,40,5
1649903186379,COGS 13,A01,083071,Staff,0,6,40,40
1649903192408,COGS 14A,A01,092681,Staff,73,0,100,27
1649903198434,COGS 14B,A01,083073,Cheng; Tzu-Han,25,0,50,25
1649903204460,COGS 17,A01,092677,Staff,67,0,75,8
1649903210485,COGS 100,A01,083619,Staff,3,0,60,57
1649903216507,COGS 101A,A01,083621,Davis; Joshua Daniel,4,0,60,56
1649903222537,COGS 101B,A01,091572,Staff,35,0,60,25
1649903228560,COGS 101C,A01,083625,Delgado; Tania,24,0,30,6
1649903234583,COGS 107A,A01,083627,Boyle; Mary E. T.,15,0,60,45
1649903240612,COGS 118A,A01,083075,Staff,22,0,60,38
1649903246636,CSE 3,A50,083646,Miranda; Gregory Joseph,26,0,38,12
1649903246636,CSE 3,A51,083647,Miranda; Gregory Joseph,37,0,37,0
1649903252659,CSE 8A,A50,083650,Miranda; Gregory Joseph,7,0,40,33
1649903258683,CSE 11,A01,083080,Cao; Yingjun,0,22,40,40
1649903264709,CSE 12,A01,083652,Staff,61,0,100,39
1649903270735,CSE 15L,A01,083654,Staff,22,0,50,28
1649903270735,CSE 15L,A02,083655,Staff,47,0,50,3
1649903276758,CSE 20,A01,083657,Staff,68,0,80,12
1649903282788,CSE 30,A01,083084,Eldon; John,1,14,40,39
1649903288810,CSE 100,A01,083659,Cao; Yingjun,2,20,50,48
1649903294837,CSE 134B,A01,083661,Powell; Thomas Allan,2,23,65,63
1649903300860,CSE 140,A01,083663,Staff,29,0,75,46
1649903306890,CSE 140L,A01,083088,Eldon; John,22,0,75,53
1649903312914,CSE 175,A01,083665,Kumar; Rakesh,12,0,25,13
1649903318942,CSE 190,A00,092507,Dubnov; Shlomo,14,0,15,1
1649903324970,ECE 45,A01,083139,Staff,14,0,40,26
1649903330995,ECE 65,A50,083695,Staff,10,0,30,20
1649903337022,ECE 109,A01,091882,Touri; Behrouz,59,0,70,11
1649903343045,ECE 180,A00,083140,Abi Samra; Nicholas Camill,27,0,30,3
1649903343045,ECE 180,B00,083141,Abi Samra; Nicholas Camill,13,0,30,17
1649903349072,MATH 10A,A01,083735,Patchell; Gregory David,22,0,30,8
1649903349072,MATH 10A,A02,083736,Patchell; Gregory David,28,0,30,2
1649903349072,MATH 10A,A03,083737,Patchell; Gregory David,28,0,30,2
1649903355096,MATH 10B,A01,083207,Staff,13,0,30,17
1649903355096,MATH 10B,A02,083208,Staff,25,0,30,5
1649903355096,MATH 10B,B01,083739,Staff,25,0,30,5
1649903355096,MATH 10B,B02,083740,Staff,30,0,30,0
1649903361126,MATH 18,A01,083743,Staff,22,0,30,8
1649903361126,MATH 18,A02,083744,Staff,29,0,30,1
1649903361126,MATH 18,A03,083745,Staff,29,0,30,1
1649903361126,MATH 18,A04,083746,Staff,28,0,30,2
1649903361126,MATH 18,B01,083748,Staff,12,0,30,18
1649903361126,MATH 18,B02,083749,Staff,26,0,30,4
1649903361126,MATH 18,B03,083750,Staff,28,0,30,2
1649903361126,MATH 18,B04,083751,Staff,27,0,30,3
1649903367160,MATH 20A,A01,083754,Staff,37,0,40,3
1649903373184,MATH 20B,A01,083756,Staff,21,0,30,9
1649903373184,MATH 20B,A02,083757,Staff,30,0,30,0
1649903379210,MATH 20C,A01,083760,Staff,22,0,30,8
1649903379210,MATH 20C,A02,083761,Staff,24,0,30,6
1649903379210,MATH 20C,B01,083762,Staff,29,0,30,1
1649903379210,MATH 20C,B02,083763,Staff,30,0,30,0
1649903385234,MATH 20D,A01,083765,Staff,21,0,30,9
1649903385234,MATH 20D,A02,083766,Staff,30,0,30,0
1649903385234,MATH 20D,A03,083767,Staff,30,0,30,0
1649903391255,MATH 20E,A01,083771,Staff,15,0,30,15
1649903391255,MATH 20E,A02,083772,Staff,25,0,30,5
1649903391255,MATH 20E,B01,083773,Staff,22,0,30,8
1649903391255,MATH 20E,B02,083774,Staff,29,0,30,1
1649903397283,MATH 103A,A01,083777,Staff,0,0,30,30
1649903397283,MATH 103A,A02,083778,Staff,0,0,30,30
1649903397283,MATH 103A,B01,083779,Staff,4,0,30,26
1649903397283,MATH 103A,B02,083780,Staff,21,0,30,9
1649903403306,MATH 105,A01,085443,Staff,0,4,30,30
1649903409334,MATH 109,A01,083213,Anzaldo; Leesa B,17,0,30,13
1649903409334,MATH 109,A02,083214,Anzaldo; Leesa B,13,0,30,17
1649903409334,MATH 109,B01,083215,Anzaldo; Leesa B,26,0,30,4
1649903409334,MATH 109,B02,083216,Anzaldo; Leesa B,24,0,30,6
1649903415360,MATH 142A,A01,083219,Chow; Bennett,1,1,30,29
1649903415360,MATH 142A,A02,083220,Chow; Bennett,16,0,30,14
1649903415360,MATH 142A,B01,083221,Chow; Bennett,0,0,30,30
1649903415360,MATH 142A,B02,083222,Chow; Bennett,11,0,30,19
1649903421391,MATH 193A,A01,083224,Staff,0,3,30,30
1649903421391,MATH 193A,A02,083225,Staff,0,3,30,30
1649903421391,MATH 193A,A03,083781,Staff,8,0,30,22
1649903421391,MATH 193A,A04,083782,Staff,20,0,30,10
1649903427414,MATH 197,001,091859,McAuley; Julian John,9999,0,9999,0
1649903433466,COGS 9,A01,083615,Staff,21,0,60,39
1649903439490,COGS 11,A01,083617,Boyle; Mary E. T.,35,0,40,5
1649903445516,COGS 13,A01,083071,Staff,0,6,40,40
1649903451542,COGS 14A,A01,092681,Staff,73,0,100,27
1649903457570,COGS 14B,A01,083073,Cheng; Tzu-Han,25,0,50,25
1649903463591,COGS 17,A01,092677,Staff,67,0,75,8
1649903469615,COGS 100,A01,083619,Staff,3,0,60,57
1649903475638,COGS 101A,A01,083621,Davis; Joshua Daniel,5,0,60,55
1649903481660,COGS 101B,A01,091572,Staff,35,0,60,25
1649903487684,COGS 101C,A01,083625,Delgado; Tania,24,0,30,6
1649903493707,COGS 107A,A01,083627,Boyle; Mary E. T.,15,0,60,45
1649903499740,COGS 118A,A01,083075,Staff,22,0,60,38
1649903505763,CSE 3,A50,083646,Miranda; Gregory Joseph,26,0,38,12
1649903505763,CSE 3,A51,083647,Miranda; Gregory Joseph,37,0,37,0
1649903511797,CSE 8A,A50,083650,Miranda; Gregory Joseph,7,0,40,33
1649903517820,CSE 11,A01,083080,Cao; Yingjun,0,22,40,40
1649903523843,CSE 12,A01,083652,Staff,61,0,100,39
1649903529864,CSE 15L,A01,083654,Staff,22,0,50,28
1649903529864,CSE 15L,A02,083655,Staff,47,0,50,3
1649903535887,CSE 20,A01,083657,Staff,68,0,80,12
1649903541917,CSE 30,A01,083084,Eldon; John,1,14,40,39
1649903547938,CSE 100,A01,083659,Cao; Yingjun,2,20,50,48
1649903553964,CSE 134B,A01,083661,Powell; Thomas Allan,2,23,65,63
1649903559987,CSE 140,A01,083663,Staff,29,0,75,46
1649903566014,CSE 140L,A01,083088,Eldon; John,22,0,75,53
1649903572040,CSE 175,A01,083665,Kumar; Rakesh,12,0,25,13
1649903578065,CSE 190,A00,092507,Dubnov; Shlomo,14,0,15,1
1649903584188,ECE 45,A01,083139,Staff,14,0,40,26
1649903590219,ECE 65,A50,083695,Staff,10,0,30,20
1649903596251,ECE 109,A01,091882,Touri; Behrouz,59,0,70,11
1649903602278,ECE 180,A00,083140,Abi Samra; Nicholas Camill,27,0,30,3
1649903602278,ECE 180,B00,083141,Abi Samra; Nicholas Camill,13,0,30,17
1649903608301,MATH 10A,A01,083735,Patchell; Gregory David,22,0,30,8
1649903608301,MATH 10A,A02,083736,Patchell; Gregory David,28,0,30,2
1649903608301,MATH 10A,A03,083737,Patchell; Gregory David,28,0,30,2
1649903614329,MATH 10B,A01,083207,Staff,13,0,30,17
1649903614329,MATH 10B,A02,083208,Staff,25,0,30,5
1649903614329,MATH 10B,B01,083739,Staff,25,0,30,5
1649903614329,MATH 10B,B02,083740,Staff,30,0,30,0
1649903620352,MATH 18,A01,083743,Staff,22,0,30,8
1649903620352,MATH 18,A02,083744,Staff,29,0,30,1
1649903620352,MATH 18,A03,083745,Staff,29,0,30,1
1649903620352,MATH 18,A04,083746,Staff,28,0,30,2
1649903620352,MATH 18,B01,083748,Staff,12,0,30,18
1649903620352,MATH 18,B02,083749,Staff,26,0,30,4
1649903620352,MATH 18,B03,083750,Staff,28,0,30,2
1649903620352,MATH 18,B04,083751,Staff,27,0,30,3
1649903626378,MATH 20A,A01,083754,Staff,37,0,40,3
1649903632414,MATH 20B,A01,083756,Staff,21,0,30,9
1649903632414,MATH 20B,A02,083757,Staff,30,0,30,0
1649903638437,MATH 20C,A01,083760,Staff,22,0,30,8
1649903638437,MATH 20C,A02,083761,Staff,24,0,30,6
1649903638437,MATH 20C,B01,083762,Staff,29,0,30,1
1649903638437,MATH 20C,B02,083763,Staff,30,0,30,0
1649903644461,MATH 20D,A01,083765,Staff,21,0,30,9
1649903644461,MATH 20D,A02,083766,Staff,30,0,30,0
1649903644461,MATH 20D,A03,083767,Staff,30,0,30,0
1649903650484,MATH 20E,A01,083771,Staff,14,0,30,16
1649903650484,MATH 20E,A02,083772,Staff,25,0,30,5
1649903650484,MATH 20E,B01,083773,Staff,22,0,30,8
1649903650484,MATH 20E,B02,083774,Staff,29,0,30,1
1649903656511,MATH 103A,A01,083777,Staff,0,0,30,30
1649903656511,MATH 103A,A02,083778,Staff,0,0,30,30
1649903656511,MATH 103A,B01,083779,Staff,4,0,30,26
1649903656511,MATH 103A,B02,083780,Staff,21,0,30,9
1649903662544,MATH 105,A01,085443,Staff,0,4,30,30
1649903668568,MATH 109,A01,083213,Anzaldo; Leesa B,17,0,30,13
1649903668568,MATH 109,A02,083214,Anzaldo; Leesa B,13,0,30,17
1649903668568,MATH 109,B01,083215,Anzaldo; Leesa B,26,0,30,4
1649903668568,MATH 109,B02,083216,Anzaldo; Leesa B,24,0,30,6
1649903674592,MATH 142A,A01,083219,Chow; Bennett,1,1,30,29
1649903674592,MATH 142A,A02,083220,Chow; Bennett,15,0,30,15
1649903674592,MATH 142A,B01,083221,Chow; Bennett,0,0,30,30
1649903674592,MATH 142A,B02,083222,Chow; Bennett,11,0,30,19
1649903680619,MATH 193A,A01,083224,Staff,0,3,30,30
1649903680619,MATH 193A,A02,083225,Staff,0,3,30,30
1649903680619,MATH 193A,A03,083781,Staff,8,0,30,22
1649903680619,MATH 193A,A04,083782,Staff,20,0,30,10
1649903686650,MATH 197,001,091859,McAuley; Julian John,9999,0,9999,0
1649903692712,COGS 9,A01,083615,Staff,21,0,60,39
1649903698735,COGS 11,A01,083617,Boyle; Mary E. T.,35,0,40,5
1649903704758,COGS 13,A01,083071,Staff,0,7,40,40
1649903710796,COGS 14A,A01,092681,Staff,72,0,100,28
1649903716820,COGS 14B,A01,083073,Cheng; Tzu-Han,25,0,50,25
1649903722842,COGS 17,A01,092677,Staff,66,0,75,9
1649903728866,COGS 100,A01,083619,Staff,3,0,60,57
1649903734890,COGS 101A,A01,083621,Davis; Joshua Daniel,4,0,60,56
1649903740917,COGS 101B,A01,091572,Staff,34,0,60,26
1649903746943,COGS 101C,A01,083625,Delgado; Tania,24,0,30,6
1649903752968,COGS 107A,A01,083627,Boyle; Mary E. T.,15,0,60,45
1649903759005,COGS 118A,A01,083075,Staff,22,0,60,38
1649903765034,CSE 3,A50,083646,Miranda; Gregory Joseph,26,0,38,12
1649903765034,CSE 3,A51,083647,Miranda; Gregory Joseph,37,0,37,0
1649903771061,CSE 8A,A50,083650,Miranda; Gregory Joseph,7,0,40,33
1649903777087,CSE 11,A01,083080,Cao; Yingjun,0,22,40,40
1649903783114,CSE 12,A01,083652,Staff,61,0,100,39
1649903789135,CSE 15L,A01,083654,Staff,22,0,50,28
1649903789135,CSE 15L,A02,083655,Staff,47,0,50,3
1649903795159,CSE 20,A01,083657,Staff,68,0,80,12
1649903801186,CSE 30,A01,083084,Eldon; John,1,15,40,39
1649903807210,CSE 100,A01,083659,Cao; Yingjun,2,22,50,48
1649903813232,CSE 134B,A01,083661,Powell; Thomas Allan,2,23,65,63
1649903819254,CSE 140,A01,083663,Staff,29,0,75,46
1649903825281,CSE 140L,A01,083088,Eldon; John,22,0,75,53
1649903831302,CSE 175,A01,083665,Kumar; Rakesh,12,0,25,13
1649903837328,CSE 190,A00,092507,Dubnov; Shlomo,14,0,15,1
1649903843350,ECE 45,A01,083139,Staff,14,0,40,26
1649903849374,ECE 65,A50,083695,Staff,10,0,30,20
1649903855400,ECE 109,A01,091882,Touri; Behrouz,58,0,70,12
1649903861424,ECE 180,A00,083140,Abi Samra; Nicholas Camill,27,0,30,3
1649903861424,ECE 180,B00,083141,Abi Samra; Nicholas Camill,13,0,30,17
1649903867447,MATH 10A,A01,083735,Patchell; Gregory David,22,0,30,8
1649903867447,MATH 10A,A02,083736,Patchell; Gregory David,28,0,30,2
1649903867447,MATH 10A,A03,083737,Patchell; Gregory David,28,0,30,2
1649903873469,MATH 10B,A01,083207,Staff,13,0,30,17
1649903873469,MATH 10B,A02,083208,Staff,25,0,30,5
1649903873469,MATH 10B,B01,083739,Staff,25,0,30,5
1649903873469,MATH 10B,B02,083740,Staff,30,0,30,0
1649903879492,MATH 18,A01,083743,Staff,22,0,30,8
1649903879492,MATH 18,A02,083744,Staff,29,0,30,1
1649903879492,MATH 18,A03,083745,Staff,29,0,30,1
1649903879492,MATH 18,A04,083746,Staff,28,0,30,2
1649903879492,MATH 18,B01,083748,Staff,12,0,30,18
1649903879492,MATH 18,B02,083749,Staff,26,0,30,4
1649903879492,MATH 18,B03,083750,Staff,28,0,30,2
1649903879492,MATH 18,B04,083751,Staff,27,0,30,3
1649903885515,MATH 20A,A01,083754,Staff,37,0,40,3
1649903891539,MATH 20B,A01,083756,Staff,21,0,30,9
1649903891539,MATH 20B,A02,083757,Staff,30,0,30,0
1649903897561,MATH 20C,A01,083760,Staff,22,0,30,8
1649903897561,MATH 20C,A02,083761,Staff,24,0,30,6
1649903897561,MATH 20C,B01,083762,Staff,29,0,30,1
1649903897561,MATH 20C,B02,083763,Staff,30,0,30,0
1649903903587,MATH 20D,A01,083765,Staff,22,0,30,8
1649903903587,MATH 20D,A02,083766,Staff,30,0,30,0
1649903903587,MATH 20D,A03,083767,Staff,30,0,30,0
1649903909615,MATH 20E,A01,083771,Staff,14,0,30,16
1649903909615,MATH 20E,A02,083772,Staff,25,0,30,5
1649903909615,MATH 20E,B01,083773,Staff,22,0,30,8
1649903909615,MATH 20E,B02,083774,Staff,29,0,30,1
1649903915648,MATH 103A,A01,083777,Staff,0,0,30,30
1649903915648,MATH 103A,A02,083778,Staff,0,0,30,30
1649903915648,MATH 103A,B01,083779,Staff,4,0,30,26
1649903915648,MATH 103A,B02,083780,Staff,21,0,30,9
1649903921671,MATH 105,A01,085443,Staff,0,4,30,30
1649903927699,MATH 109,A01,083213,Anzaldo; Leesa B,17,0,30,13
1649903927699,MATH 109,A02,083214,Anzaldo; Leesa B,13,0,30,17
1649903927699,MATH 109,B01,083215,Anzaldo; Leesa B,26,0,30,4
1649903927699,MATH 109,B02,083216,Anzaldo; Leesa B,24,0,30,6
1649903933724,MATH 142A,A01,083219,Chow; Bennett,1,1,30,29
1649903933724,MATH 142A,A02,083220,Chow; Bennett,15,0,30,15
1649903933724,MATH 142A,B01,083221,Chow; Bennett,0,0,30,30
1649903933724,MATH 142A,B02,083222,Chow; Bennett,11,0,30,19
1649903939747,MATH 193A,A01,083224,Staff,0,3,30,30
1649903939747,MATH 193A,A02,083225,Staff,0,3,30,30
1649903939747,MATH 193A,A03,083781,Staff,8,0,30,22
1649903939747,MATH 193A,A04,083782,Staff,20,0,30,10
1649903945773,MATH 197,001,091859,McAuley; Julian John,9999,0,9999,0
1649903951835,COGS 9,A01,083615,Staff,21,0,60,39
1649903957860,COGS 11,A01,083617,Boyle; Mary E. T.,35,0,40,5
1649903963883,COGS 13,A01,083071,Staff,0,7,40,40
1649903969911,COGS 14A,A01,092681,Staff,72,0,100,28
1649903975934,COGS 14B,A01,083073,Cheng; Tzu-Han,25,0,50,25
1649903981957,COGS 17,A01,092677,Staff,66,0,75,9
1649903987984,COGS 100,A01,083619,Staff,2,0,60,58
1649903994015,COGS 101A,A01,083621,Davis; Joshua Daniel,5,0,60,55
1649904000039,COGS 101B,A01,091572,Staff,34,0,60,26
1649904006066,COGS 101C,A01,083625,Delgado; Tania,24,0,30,6
1649904012092,COGS 107A,A01,083627,Boyle; Mary E. T.,15,0,60,45
1649904018116,COGS 118A,A01,083075,Staff,22,0,60,38
1649904024143,CSE 3,A50,083646,Miranda; Gregory Joseph,26,0,38,12
1649904024143,CSE 3,A51,083647,Miranda; Gregory Joseph,37,0,37,0
1649904030167,CSE 8A,A50,083650,Miranda; Gregory Joseph,7,0,40,33
1649904036189,CSE 11,A01,083080,Cao; Yingjun,0,22,40,40
1649904042217,CSE 12,A01,083652,Staff,61,0,100,39
1649904048243,CSE 15L,A01,083654,Staff,22,0,50,28
1649904048243,CSE 15L,A02,083655,Staff,47,0,50,3
1649904054267,CSE 20,A01,083657,Staff,68,0,80,12
1649904060295,CSE 30,A01,083084,Eldon; John,1,15,40,39
1649904066322,CSE 100,A01,083659,Cao; Yingjun,2,22,50,48
1649904072351,CSE 134B,A01,083661,Powell; Thomas Allan,2,23,65,63
1649904078375,CSE 140,A01,083663,Staff,28,0,75,47
1649904084399,CSE 140L,A01,083088,Eldon; John,21,0,75,54
1649904090424,CSE 175,A01,083665,Kumar; Rakesh,12,0,25,13
1649904096449,CSE 190,A00,092507,Dubnov; Shlomo,14,0,15,1
1649904102485,ECE 45,A01,083139,Staff,14,0,40,26
1649904108512,ECE 65,A50,083695,Staff,10,0,30,20
1649904114540,ECE 109,A01,091882,Touri; Behrouz,58,0,70,12
1649904120567,ECE 180,A00,083140,Abi Samra; Nicholas Camill,27,0,30,3
1649904120567,ECE 180,B00,083141,Abi Samra; Nicholas Camill,13,0,30,17
1649904126594,MATH 10A,A01,083735,Patchell; Gregory David,22,0,30,8
1649904126594,MATH 10A,A02,083736,Patchell; Gregory David,28,0,30,2
1649904126594,MATH 10A,A03,083737,Patchell; Gregory David,28,0,30,2
1649904132621,MATH 10B,A01,083207,Staff,13,0,30,17
1649904132621,MATH 10B,A02,083208,Staff,25,0,30,5
1649904132621,MATH 10B,B01,083739,Staff,25,0,30,5
1649904132621,MATH 10B,B02,083740,Staff,30,0,30,0
1649904138651,MATH 18,A01,083743,Staff,22,0,30,8
1649904138651,MATH 18,A02,083744,Staff,29,0,30,1
1649904138651,MATH 18,A03,083745,Staff,29,0,30,1
1649904138651,MATH 18,A04,083746,Staff,28,0,30,2
1649904138651,MATH 18,B01,083748,Staff,11,0,30,19
1649904138651,MATH 18,B02,083749,Staff,26,0,30,4
1649904138651,MATH 18,B03,083750,Staff,28,0,30,2
1649904138651,MATH 18,B04,083751,Staff,27,0,30,3
1649904144675,MATH 20A,A01,083754,Staff,37,0,40,3
1649904150701,MATH 20B,A01,083756,Staff,21,0,30,9
1649904150701,MATH 20B,A02,083757,Staff,30,0,30,0
1649904156727,MATH 20C,A01,083760,Staff,22,0,30,8
1649904156727,MATH 20C,A02,083761,Staff,24,0,30,6
1649904156727,MATH 20C,B01,083762,Staff,29,0,30,1
1649904156727,MATH 20C,B02,083763,Staff,30,0,30,0
1649904162754,MATH 20D,A01,083765,Staff,22,0,30,8
1649904162754,MATH 20D,A02,083766,Staff,30,0,30,0
1649904162754,MATH 20D,A03,083767,Staff,30,0,30,0
1649904168777,MATH 20E,A01,083771,Staff,14,0,30,16
1649904168777,MATH 20E,A02,083772,Staff,25,0,30,5
1649904168777,MATH 20E,B01,083773,Staff,22,0,30,8
1649904168777,MATH 20E,B02,083774,Staff,29,0,30,1
1649904174802,MATH 103A,A01,083777,Staff,0,0,30,30
1649904174802,MATH 103A,A02,083778,Staff,0,0,30,30
1649904174802,MATH 103A,B01,083779,Staff,4,0,30,26
1649904174802,MATH 103A,B02,083780,Staff,21,0,30,9
1649904180911,MATH 105,A01,085443,Staff,0,4,30,30
1649904186943,MATH 109,A01,083213,Anzaldo; Leesa B,17,0,30,13
1649904186943,MATH 109,A02,083214,Anzaldo; Leesa B,13,0,30,17
1649904186943,MATH 109,B01,083215,Anzaldo; Leesa B,26,0,30,4
1649904186943,MATH 109,B02,083216,Anzaldo; Leesa B,24,0,30,6
1649904192975,MATH 142A,A01,083219,Chow; Bennett,1,1,30,29
1649904192975,MATH 142A,A02,083220,Chow; Bennett,15,0,30,15
1649904192975,MATH 142A,B01,083221,Chow; Bennett,0,0,30,30
1649904192975,MATH 142A,B02,083222,Chow; Bennett,11,0,30,19
1649904199003,MATH 193A,A01,083224,Staff,0,3,30,30
1649904199003,MATH 193A,A02,083225,Staff,0,4,30,30
1649904199003,MATH 193A,A03,083781,Staff,8,0,30,22
1649904199003,MATH 193A,A04,083782,Staff,20,0,30,10
1649904205025,MATH 197,001,091859,McAuley; Julian John,9999,0,9999,0
1649904211079,COGS 9,A01,083615,Staff,21,0,60,39
1649904217105,COGS 11,A01,083617,Boyle; Mary E. T.,35,0,40,5
1649904223130,COGS 13,A01,083071,Staff,0,7,40,40
1649904229152,COGS 14A,A01,092681,Staff,72,0,100,28
1649904235185,COGS 14B,A01,083073,Cheng; Tzu-Han,25,0,50,25
1649904241213,COGS 17,A01,092677,Staff,66,0,75,9
1649904247241,COGS 100,A01,083619,Staff,1,0,60,59
1649904253273,COGS 101A,A01,083621,Davis; Joshua Daniel,4,0,60,56
1649904259298,COGS 101B,A01,091572,Staff,34,0,60,26
1649904265325,COGS 101C,A01,083625,Delgado; Tania,24,0,30,6
1649904271348,COGS 107A,A01,083627,Boyle; Mary E. T.,15,0,60,45
1649904277374,COGS 118A,A01,083075,Staff,22,0,60,38
1649904283402,CSE 3,A50,083646,Miranda; Gregory Joseph,26,0,38,12
1649904283402,CSE 3,A51,083647,Miranda; Gregory Joseph,37,0,37,0
1649904289430,CSE 8A,A50,083650,Miranda; Gregory Joseph,7,0,40,33
1649904295457,CSE 11,A01,083080,Cao; Yingjun,0,22,40,40
1649904301482,CSE 12,A01,083652,Staff,61,0,100,39
1649904307506,CSE 15L,A01,083654,Staff,22,0,50,28
1649904307506,CSE 15L,A02,083655,Staff,47,0,50,3
1649904313530,CSE 20,A01,083657,Staff,68,0,80,12
1649904319555,CSE 30,A01,083084,Eldon; John,1,16,40,39
1649904325584,CSE 100,A01,083659,Cao; Yingjun,2,22,50,48
1649904331607,CSE 134B,A01,083661,Powell; Thomas Allan,2,23,65,63
1649904337629,CSE 140,A01,083663,Staff,28,0,75,47
1649904343662,CSE 140L,A01,083088,Eldon; John,21,0,75,54
1649904349685,CSE 175,A01,083665,Kumar; Rakesh,12,0,25,13
1649904355709,CSE 190,A00,092507,Dubnov; Shlomo,14,0,15,1
1649904361733,ECE 45,A01,083139,Staff,14,0,40,26
1649904367760,ECE 65,A50,083695,Staff,10,0,30,20
1649904373784,ECE 109,A01,091882,Touri; Behrouz,58,0,70,12
1649904379817,ECE 180,A00,083140,Abi Samra; Nicholas Camill,27,0,30,3
1649904379817,ECE 180,B00,083141,Abi Samra; Nicholas Camill,13,0,30,17
1649904385841,MATH 10A,A01,083735,Patchell; Gregory David,22,0,30,8
1649904385841,MATH 10A,A02,083736,Patchell; Gregory David,28,0,30,2
1649904385841,MATH 10A,A03,083737,Patchell; Gregory David,28,0,30,2
1649904391874,MATH 10B,A01,083207,Staff,13,0,30,17
1649904391874,MATH 10B,A02,083208,Staff,25,0,30,5
1649904391874,MATH 10B,B01,083739,Staff,25,0,30,5
1649904391874,MATH 10B,B02,083740,Staff,30,0,30,0
1649904397901,MATH 18,A01,083743,Staff,22,0,30,8
1649904397901,MATH 18,A02,083744,Staff,29,0,30,1
1649904397901,MATH 18,A03,083745,Staff,29,0,30,1
1649904397901,MATH 18,A04,083746,Staff,28,0,30,2
1649904397901,MATH 18,B01,083748,Staff,11,0,30,19
1649904397901,MATH 18,B02,083749,Staff,26,0,30,4
1649904397901,MATH 18,B03,083750,Staff,28,0,30,2
1649904397901,MATH 18,B04,083751,Staff,27,0,30,3
1649904403927,MATH 20A,A01,083754,Staff,37,0,40,3
1649904409956,MATH 20B,A01,083756,Staff,21,0,30,9
1649904409956,MATH 20B,A02,083757,Staff,30,0,30,0
1649904415985,MATH 20C,A01,083760,Staff,22,0,30,8
1649904415985,MATH 20C,A02,083761,Staff,24,0,30,6
1649904415985,MATH 20C,B01,083762,Staff,29,0,30,1
1649904415985,MATH 20C,B02,083763,Staff,30,0,30,0
1649904422013,MATH 20D,A01,083765,Staff,22,0,30,8
1649904422013,MATH 20D,A02,083766,Staff,30,0,30,0
1649904422013,MATH 20D,A03,083767,Staff,30,0,30,0
1649904428040,MATH 20E,A01,083771,Staff,14,0,30,16
1649904428040,MATH 20E,A02,083772,Staff,25,0,30,5
1649904428040,MATH 20E,B01,083773,Staff,22,0,30,8
1649904428040,MATH 20E,B02,083774,Staff,29,0,30,1
1649904434063,MATH 103A,A01,083777,Staff,0,0,30,30
1649904434063,MATH 103A,A02,083778,Staff,0,0,30,30
1649904434063,MATH 103A,B01,083779,Staff,4,0,30,26
1649904434063,MATH 103A,B02,083780,Staff,21,0,30,9
1649904440088,MATH 105,A01,085443,Staff,0,4,30,30
1649904446111,MATH 109,A01,083213,Anzaldo; Leesa B,17,0,30,13
1649904446111,MATH 109,A02,083214,Anzaldo; Leesa B,13,0,30,17
1649904446111,MATH 109,B01,083215,Anzaldo; Leesa B,26,0,30,4
1649904446111,MATH 109,B02,083216,Anzaldo; Leesa B,24,0,30,6
1649904452134,MATH 142A,A01,083219,Chow; Bennett,1,1,30,29
1649904452134,MATH 142A,A02,083220,Chow; Bennett,15,0,30,15
1649904452134,MATH 142A,B01,083221,Chow; Bennett,0,0,30,30
1649904452134,MATH 142A,B02,083222,Chow; Bennett,11,0,30,19
1649904458160,MATH 193A,A01,083224,Staff,0,4,30,30
1649904458160,MATH 193A,A02,083225,Staff,0,3,30,30
1649904458160,MATH 193A,A03,083781,Staff,8,0,30,22
1649904458160,MATH 193A,A04,083782,Staff,20,0,30,10
1649904464183,MATH 197,001,091859,McAuley; Julian John,9999,0,9999,0
1649904470242,COGS 9,A01,083615,Staff,21,0,60,39
1649904476268,COGS 11,A01,083617,Boyle; Mary E. T.,35,0,40,5
1649904482290,COGS 13,A01,083071,Staff,0,7,40,40
1649904488314,COGS 14A,A01,092681,Staff,71,0,100,29
1649904494336,COGS 14B,A01,083073,Cheng; Tzu-Han,25,0,50,25
1649904500361,COGS 17,A01,092677,Staff,66,0,75,9
1649904506384,COGS 100,A01,083619,Staff,1,0,60,59
1649904512406,COGS 101A,A01,083621,Davis; Joshua Daniel,4,0,60,56
1649904518433,COGS 101B,A01,091572,Staff,34,0,60,26
1649904524454,COGS 101C,A01,083625,Delgado; Tania,24,0,30,6
1649904530478,COGS 107A,A01,083627,Boyle; Mary E. T.,15,0,60,45
1649904536517,COGS 118A,A01,083075,Staff,22,0,60,38
1649904542541,CSE 3,A50,083646,Miranda; Gregory Joseph,26,0,38,12
1649904542541,CSE 3,A51,083647,Miranda; Gregory Joseph,37,0,37,0
1649904548565,CSE 8A,A50,083650,Miranda; Gregory Joseph,7,0,40,33
1649904554589,CSE 11,A01,083080,Cao; Yingjun,0,22,40,40
1649904560613,CSE 12,A01,083652,Staff,61,0,100,39
1649904566656,CSE 15L,A01,083654,Staff,22,0,50,28
1649904566656,CSE 15L,A02,083655,Staff,47,0,50,3
1649904572681,CSE 20,A01,083657,Staff,68,0,80,12
1649904578718,CSE 30,A01,083084,Eldon; John,1,16,40,39
1649904584753,CSE 100,A01,083659,Cao; Yingjun,2,22,50,48
1649904590781,CSE 134B,A01,083661,Powell; Thomas Allan,2,23,65,63
1649904596805,CSE 140,A01,083663,Staff,27,0,75,48
1649904602838,CSE 140L,A01,083088,Eldon; John,21,0,75,54
1649904608870,CSE 175,A01,083665,Kumar; Rakesh,12,0,25,13
1649904614898,CSE 190,A00,092507,Dubnov; Shlomo,14,0,15,1
1649904620929,ECE 45,A01,083139,Staff,13,0,40,27
1649904626967,ECE 65,A50,083695,Staff,10,0,30,20
1649904632995,ECE 109,A01,091882,Touri; Behrouz,58,0,70,12
1649904639023,ECE 180,A00,083140,Abi Samra; Nicholas Camill,27,0,30,3
1649904639023,ECE 180,B00,083141,Abi Samra; Nicholas Camill,13,0,30,17
1649904645044,MATH 10A,A01,083735,Patchell; Gregory David,22,0,30,8
1649904645044,MATH 10A,A02,083736,Patchell; Gregory David,28,0,30,2
1649904645044,MATH 10A,A03,083737,Patchell; Gregory David,28,0,30,2
1649904651067,MATH 10B,A01,083207,Staff,13,0,30,17
1649904651067,MATH 10B,A02,083208,Staff,25,0,30,5
1649904651067,MATH 10B,B01,083739,Staff,25,0,30,5
1649904651067,MATH 10B,B02,083740,Staff,30,0,30,0
1649904657092,MATH 18,A01,083743,Staff,22,0,30,8
1649904657092,MATH 18,A02,083744,Staff,29,0,30,1
1649904657092,MATH 18,A03,083745,Staff,29,0,30,1
1649904657092,MATH 18,A04,083746,Staff,28,0,30,2
1649904657092,MATH 18,B01,083748,Staff,11,0,30,19
1649904657092,MATH 18,B02,083749,Staff,26,0,30,4
1649904657092,MATH 18,B03,083750,Staff,28,0,30,2
1649904657092,MATH 18,B04,083751,Staff,27,0,30,3
1649904663117,MATH 20A,A01,083754,Staff,37,0,40,3
1649904669140,MATH 20B,A01,083756,Staff,21,0,30,9
1649904669140,MATH 20B,A02,083757,Staff,30,0,30,0
1649904675166,MATH 20C,A01,083760,Staff,22,0,30,8
1649904675166,MATH 20C,A02,083761,Staff,24,0,30,6
1649904675166,MATH 20C,B01,083762,Staff,29,0,30,1
1649904675166,MATH 20C,B02,083763,Staff,30,0,30,0
1649904681191,MATH 20D,A01,083765,Staff,21,0,30,9
1649904681191,MATH 20D,A02,083766,Staff,30,0,30,0
1649904681191,MATH 20D,A03,083767,Staff,30,0,30,0
1649904687216,MATH 20E,A01,083771,Staff,14,0,30,16
1649904687216,MATH 20E,A02,083772,Staff,25,0,30,5
1649904687216,MATH 20E,B01,083773,Staff,22,0,30,8
1649904687216,MATH 20E,B02,083774,Staff,29,0,30,1
1649904693244,MATH 103A,A01,083777,Staff,0,0,30,30
1649904693244,MATH 103A,A02,083778,Staff,0,0,30,30
1649904693244,MATH 103A,B01,083779,Staff,3,0,30,27
1649904693244,MATH 103A,B02,083780,Staff,21,0,30,9
1649904699267,MATH 105,A01,085443,Staff,0,4,30,30
1649904705297,MATH 109,A01,083213,Anzaldo; Leesa B,17,0,30,13
1649904705297,MATH 109,A02,083214,Anzaldo; Leesa B,13,0,30,17
1649904705297,MATH 109,B01,083215,Anzaldo; Leesa B,26,0,30,4
1649904705297,MATH 109,B02,083216,Anzaldo; Leesa B,24,0,30,6
1649904711320,MATH 142A,A01,083219,Chow; Bennett,1,1,30,29
1649904711320,MATH 142A,A02,083220,Chow; Bennett,15,0,30,15
1649904711320,MATH 142A,B01,083221,Chow; Bennett,0,0,30,30
1649904711320,MATH 142A,B02,083222,Chow; Bennett,11,0,30,19
1649904717344,MATH 193A,A01,083224,Staff,0,3,30,30
1649904717344,MATH 193A,A02,083225,Staff,0,3,30,30
1649904717344,MATH 193A,A03,083781,Staff,7,0,30,23
1649904717344,MATH 193A,A04,083782,Staff,20,0,30,10
1649904723368,MATH 197,001,091859,McAuley; Julian John,9999,0,9999,0
1649904729428,COGS 9,A01,083615,Staff,21,0,60,39
1649904735452,COGS 11,A01,083617,Boyle; Mary E. T.,35,0,40,5
1649904741484,COGS 13,A01,083071,Staff,0,7,40,40
1649904747513,COGS 14A,A01,092681,Staff,70,0,100,30
1649904753544,COGS 14B,A01,083073,Cheng; Tzu-Han,25,0,50,25
1649904759567,COGS 17,A01,092677,Staff,66,0,75,9
1649904765599,COGS 100,A01,083619,Staff,1,0,60,59
1649904771696,COGS 101A,A01,083621,Davis; Joshua Daniel,4,0,60,56
1649904777719,COGS 101B,A01,091572,Staff,34,0,60,26
1649904783741,COGS 101C,A01,083625,Delgado; Tania,24,0,30,6
1649904789765,COGS 107A,A01,083627,Boyle; Mary E. T.,15,0,60,45
1649904795792,COGS 118A,A01,083075,Staff,22,0,60,38
1649904801818,CSE 3,A50,083646,Miranda; Gregory Joseph,26,0,38,12
1649904801818,CSE 3,A51,083647,Miranda; Gregory Joseph,37,0,37,0
1649904807841,CSE 8A,A50,083650,Miranda; Gregory Joseph,7,0,40,33
1649904813863,CSE 11,A01,083080,Cao; Yingjun,0,22,40,40
1649904819887,CSE 12,A01,083652,Staff,61,0,100,39
1649904825915,CSE 15L,A01,083654,Staff,22,0,50,28
1649904825915,CSE 15L,A02,083655,Staff,47,0,50,3
1649904831939,CSE 20,A01,083657,Staff,68,0,80,12
1649904837966,CSE 30,A01,083084,Eldon; John,1,16,40,39
1649904843989,CSE 100,A01,083659,Cao; Yingjun,2,22,50,48
1649904850012,CSE 134B,A01,083661,Powell; Thomas Allan,2,23,65,63
1649904856041,CSE 140,A01,083663,Staff,27,0,75,48
1649904862066,CSE 140L,A01,083088,Eldon; John,21,0,75,54
1649904868098,CSE 175,A01,083665,Kumar; Rakesh,12,0,25,13
1649904874123,CSE 190,A00,092507,Dubnov; Shlomo,14,0,15,1
1649904880151,ECE 45,A01,083139,Staff,12,0,40,28
1649904886183,ECE 65,A50,083695,Staff,9,0,30,21
1649904892217,ECE 109,A01,091882,Touri; Behrouz,58,0,70,12
1649904898244,ECE 180,A00,083140,Abi Samra; Nicholas Camill,26,0,30,4
1649904898244,ECE 180,B00,083141,Abi Samra; Nicholas Camill,13,0,30,17
1649904904279,MATH 10A,A01,083735,Patchell; Gregory David,22,0,30,8
1649904904279,MATH 10A,A02,083736,Patchell; Gregory David,28,0,30,2
1649904904279,MATH 10A,A03,083737,Patchell; Gregory David,28,0,30,2
1649904910301,MATH 10B,A01,083207,Staff,13,0,30,17
1649904910301,MATH 10B,A02,083208,Staff,25,0,30,5
1649904910301,MATH 10B,B01,083739,Staff,25,0,30,5
1649904910301,MATH 10B,B02,083740,Staff,30,0,30,0
1649904916326,MATH 18,A01,083743,Staff,22,0,30,8
1649904916326,MATH 18,A02,083744,Staff,29,0,30,1
1649904916326,MATH 18,A03,083745,Staff,29,0,30,1
1649904916326,MATH 18,A04,083746,Staff,28,0,30,2
1649904916326,MATH 18,B01,083748,Staff,11,0,30,19
1649904916326,MATH 18,B02,083749,Staff,26,0,30,4
1649904916326,MATH 18,B03,083750,Staff,28,0,30,2
1649904916326,MATH 18,B04,083751,Staff,27,0,30,3
1649904922350,MATH 20A,A01,083754,Staff,37,0,40,3
1649904928377,MATH 20B,A01,083756,Staff,21,0,30,9
1649904928377,MATH 20B,A02,083757,Staff,30,0,30,0
1649904934401,MATH 20C,A01,083760,Staff,22,0,30,8
1649904934401,MATH 20C,A02,083761,Staff,24,0,30,6
1649904934401,MATH 20C,B01,083762,Staff,29,0,30,1
1649904934401,MATH 20C,B02,083763,Staff,30,0,30,0
1649904940429,MATH 20D,A01,083765,Staff,21,0,30,9
1649904940429,MATH 20D,A02,083766,Staff,30,0,30,0
1649904940429,MATH 20D,A03,083767,Staff,30,0,30,0
1649904946457,MATH 20E,A01,083771,Staff,14,0,30,16
1649904946457,MATH 20E,A02,083772,Staff,25,0,30,5
1649904946457,MATH 20E,B01,083773,Staff,21,0,30,9
1649904946457,MATH 20E,B02,083774,Staff,29,0,30,1
1649904952482,MATH 103A,A01,083777,Staff,0,0,30,30
1649904952482,MATH 103A,A02,083778,Staff,0,0,30,30
1649904952482,MATH 103A,B01,083779,Staff,3,0,30,27
1649904952482,MATH 103A,B02,083780,Staff,21,0,30,9
1649904958506,MATH 105,A01,085443,Staff,0,4,30,30
1649904964534,MATH 109,A01,083213,Anzaldo; Leesa B,17,0,30,13
1649904964534,MATH 109,A02,083214,Anzaldo; Leesa B,13,0,30,17
1649904964534,MATH 109,B01,083215,Anzaldo; Leesa B,26,0,30,4
1649904964534,MATH 109,B02,083216,Anzaldo; Leesa B,24,0,30,6
1649904970559,MATH 142A,A01,083219,Chow; Bennett,1,1,30,29
1649904970559,MATH 142A,A02,083220,Chow; Bennett,15,0,30,15
1649904970559,MATH 142A,B01,083221,Chow; Bennett,0,0,30,30
1649904970559,MATH 142A,B02,083222,Chow; Bennett,11,0,30,19
1649904976584,MATH 193A,A01,083224,Staff,0,3,30,30
1649904976584,MATH 193A,A02,083225,Staff,0,3,30,30
1649904976584,MATH 193A,A03,083781,Staff,7,0,30,23
1649904976584,MATH 193A,A04,083782,Staff,20,0,30,10
1649904982612,MATH 197,001,091859,McAuley; Julian John,9999,0,9999,0
1649904988665,COGS 9,A01,083615,Staff,21,0,60,39
1649904994699,COGS 11,A01,083617,Boyle; Mary E. T.,35,0,40,5
1649905000722,COGS 13,A01,083071,Staff,0,7,40,40
1649905006761,COGS 14A,A01,092681,Staff,69,0,100,31
1649905012786,COGS 14B,A01,083073,Cheng; Tzu-Han,25,0,50,25
1649905018816,COGS 17,A01,092677,Staff,66,0,75,9
1649905024842,COGS 100,A01,083619,Staff,1,0,60,59
1649905030868,COGS 101A,A01,083621,Davis; Joshua Daniel,4,0,60,56
1649905036892,COGS 101B,A01,091572,Staff,34,0,60,26
1649905042924,COGS 101C,A01,083625,Delgado; Tania,24,0,30,6
1649905048949,COGS 107A,A01,083627,Boyle; Mary E. T.,15,0,60,45
1649905054975,COGS 118A,A01,083075,Staff,22,0,60,38
1649905061000,CSE 3,A50,083646,Miranda; Gregory Joseph,26,0,38,12
1649905061000,CSE 3,A51,083647,Miranda; Gregory Joseph,37,0,37,0
1649905067025,CSE 8A,A50,083650,Miranda; Gregory Joseph,7,0,40,33
1649905073052,CSE 11,A01,083080,Cao; Yingjun,0,22,40,40
1649905079076,CSE 12,A01,083652,Staff,61,0,100,39
1649905085099,CSE 15L,A01,083654,Staff,22,0,50,28
1649905085099,CSE 15L,A02,083655,Staff,47,0,50,3
1649905091131,CSE 20,A01,083657,Staff,68,0,80,12
1649905097153,CSE 30,A01,083084,Eldon; John,1,16,40,39
1649905103179,CSE 100,A01,083659,Cao; Yingjun,2,22,50,48
1649905109200,CSE 134B,A01,083661,Powell; Thomas Allan,2,23,65,63
1649905115225,CSE 140,A01,083663,Staff,27,0,75,48
1649905121250,CSE 140L,A01,083088,Eldon; John,21,0,75,54
1649905127283,CSE 175,A01,083665,Kumar; Rakesh,12,0,25,13
1649905133306,CSE 190,A00,092507,Dubnov; Shlomo,14,0,15,1
1649905139331,ECE 45,A01,083139,Staff,12,0,40,28
1649905145352,ECE 65,A50,083695,Staff,9,0,30,21
1649905151373,ECE 109,A01,091882,Touri; Behrouz,58,0,70,12
1649905157396,ECE 180,A00,083140,Abi Samra; Nicholas Camill,26,0,30,4
1649905157396,ECE 180,B00,083141,Abi Samra; Nicholas Camill,13,0,30,17
1649905163419,MATH 10A,A01,083735,Patchell; Gregory David,22,0,30,8
1649905163419,MATH 10A,A02,083736,Patchell; Gregory David,28,0,30,2
1649905163419,MATH 10A,A03,083737,Patchell; Gregory David,28,0,30,2
1649905169459,MATH 10B,A01,083207,Staff,13,0,30,17
1649905169459,MATH 10B,A02,083208,Staff,25,0,30,5
1649905169459,MATH 10B,B01,083739,Staff,25,0,30,5
1649905169459,MATH 10B,B02,083740,Staff,30,0,30,0
1649905175484,MATH 18,A01,083743,Staff,22,0,30,8
1649905175484,MATH 18,A02,083744,Staff,29,0,30,1
1649905175484,MATH 18,A03,083745,Staff,29,0,30,1
1649905175484,MATH 18,A04,083746,Staff,28,0,30,2
1649905175484,MATH 18,B01,083748,Staff,11,0,30,19
1649905175484,MATH 18,B02,083749,Staff,26,0,30,4
1649905175484,MATH 18,B03,083750,Staff,28,0,30,2
1649905175484,MATH 18,B04,083751,Staff,27,0,30,3
1649905181512,MATH 20A,A01,083754,Staff,37,0,40,3
1649905187537,MATH 20B,A01,083756,Staff,21,0,30,9
1649905187537,MATH 20B,A02,083757,Staff,30,0,30,0
1649905193562,MATH 20C,A01,083760,Staff,22,0,30,8
1649905193562,MATH 20C,A02,083761,Staff,24,0,30,6
1649905193562,MATH 20C,B01,083762,Staff,29,0,30,1
1649905193562,MATH 20C,B02,083763,Staff,30,0,30,0
1649905199588,MATH 20D,A01,083765,Staff,21,0,30,9
1649905199588,MATH 20D,A02,083766,Staff,30,0,30,0
1649905199588,MATH 20D,A03,083767,Staff,30,0,30,0
1649905205616,MATH 20E,A01,083771,Staff,14,0,30,16
1649905205616,MATH 20E,A02,083772,Staff,25,0,30,5
1649905205616,MATH 20E,B01,083773,Staff,21,0,30,9
1649905205616,MATH 20E,B02,083774,Staff,29,0,30,1
1649905211642,MATH 103A,A01,083777,Staff,0,0,30,30
1649905211642,MATH 103A,A02,083778,Staff,0,0,30,30
1649905211642,MATH 103A,B01,083779,Staff,3,0,30,27
1649905211642,MATH 103A,B02,083780,Staff,21,0,30,9
1649905217669,MATH 105,A01,085443,Staff,0,4,30,30
1649905223699,MATH 109,A01,083213,Anzaldo; Leesa B,17,0,30,13
1649905223699,MATH 109,A02,083214,Anzaldo; Leesa B,13,0,30,17
1649905223699,MATH 109,B01,083215,Anzaldo; Leesa B,26,0,30,4
1649905223699,MATH 109,B02,083216,Anzaldo; Leesa B,23,0,30,7
1649905229728,MATH 142A,A01,083219,Chow; Bennett,1,1,30,29
1649905229728,MATH 142A,A02,083220,Chow; Bennett,15,0,30,15
1649905229728,MATH 142A,B01,083221,Chow; Bennett,0,0,30,30
1649905229728,MATH 142A,B02,083222,Chow; Bennett,11,0,30,19
1649905235761,MATH 193A,A01,083224,Staff,0,3,30,30
1649905235761,MATH 193A,A02,083225,Staff,0,3,30,30
1649905235761,MATH 193A,A03,083781,Staff,7,0,30,23
1649905235761,MATH 193A,A04,083782,Staff,20,0,30,10
1649905241785,MATH 197,001,091859,McAuley; Julian John,9999,0,9999,0
1649905247832,COGS 9,A01,083615,Staff,21,0,60,39
1649905253855,COGS 11,A01,083617,Boyle; Mary E. T.,35,0,40,5
1649905259883,COGS 13,A01,083071,Staff,0,8,40,40
1649905265924,COGS 14A,A01,092681,Staff,69,0,100,31
1649905271948,COGS 14B,A01,083073,Cheng; Tzu-Han,25,0,50,25
1649905277972,COGS 17,A01,092677,Staff,66,0,75,9
1649905283999,COGS 100,A01,083619,Staff,0,0,60,60
1649905290022,COGS 101A,A01,083621,Davis; Joshua Daniel,4,0,60,56
1649905296050,COGS 101B,A01,091572,Staff,34,0,60,26
1649905302073,COGS 101C,A01,083625,Delgado; Tania,24,0,30,6
1649905308098,COGS 107A,A01,083627,Boyle; Mary E. T.,15,0,60,45
1649905314123,COGS 118A,A01,083075,Staff,22,0,60,38
1649905320146,CSE 3,A50,083646,Miranda; Gregory Joseph,26,0,38,12
1649905320146,CSE 3,A51,083647,Miranda; Gregory Joseph,37,0,37,0
1649905326186,CSE 8A,A50,083650,Miranda; Gregory Joseph,7,0,40,33
1649905332215,CSE 11,A01,083080,Cao; Yingjun,0,22,40,40
1649905338238,CSE 12,A01,083652,Staff,61,0,100,39
1649905344262,CSE 15L,A01,083654,Staff,22,0,50,28
1649905344262,CSE 15L,A02,083655,Staff,47,0,50,3
1649905350284,CSE 20,A01,083657,Staff,68,0,80,12
1649905356307,CSE 30,A01,083084,Eldon; John,1,16,40,39
1649905362335,CSE 100,A01,083659,Cao; Yingjun,2,24,50,48
1649905368430,CSE 134B,A01,083661,Powell; Thomas Allan,2,23,65,63
1649905374454,CSE 140,A01,083663,Staff,27,0,75,48
1649905380477,CSE 140L,A01,083088,Eldon; John,21,0,75,54
1649905386505,CSE 175,A01,083665,Kumar; Rakesh,12,0,25,13
1649905392527,CSE 190,A00,092507,Dubnov; Shlomo,14,0,15,1
1649905398555,ECE 45,A01,083139,Staff,12,0,40,28
1649905404580,ECE 65,A50,083695,Staff,9,0,30,21
1649905410605,ECE 109,A01,091882,Touri; Behrouz,58,0,70,12
1649905416632,ECE 180,A00,083140,Abi Samra; Nicholas Camill,26,0,30,4
1649905416632,ECE 180,B00,083141,Abi Samra; Nicholas Camill,13,0,30,17
1649905422655,MATH 10A,A01,083735,Patchell; Gregory David,22,0,30,8
1649905422655,MATH 10A,A02,083736,Patchell; Gregory David,28,0,30,2
1649905422655,MATH 10A,A03,083737,Patchell; Gregory David,28,0,30,2
1649905428680,MATH 10B,A01,083207,Staff,13,0,30,17
1649905428680,MATH 10B,A02,083208,Staff,25,0,30,5
1649905428680,MATH 10B,B01,083739,Staff,25,0,30,5
1649905428680,MATH 10B,B02,083740,Staff,30,0,30,0
1649905434703,MATH 18,A01,083743,Staff,22,0,30,8
1649905434703,MATH 18,A02,083744,Staff,29,0,30,1
1649905434703,MATH 18,A03,083745,Staff,29,0,30,1
1649905434703,MATH 18,A04,083746,Staff,28,0,30,2
1649905434703,MATH 18,B01,083748,Staff,10,0,30,20
1649905434703,MATH 18,B02,083749,Staff,26,0,30,4
1649905434703,MATH 18,B03,083750,Staff,28,0,30,2
1649905434703,MATH 18,B04,083751,Staff,27,0,30,3
1649905440732,MATH 20A,A01,083754,Staff,37,0,40,3
1649905446766,MATH 20B,A01,083756,Staff,21,0,30,9
1649905446766,MATH 20B,A02,083757,Staff,30,0,30,0
1649905452793,MATH 20C,A01,083760,Staff,22,0,30,8
1649905452793,MATH 20C,A02,083761,Staff,24,0,30,6
1649905452793,MATH 20C,B01,083762,Staff,28,0,30,2
1649905452793,MATH 20C,B02,083763,Staff,30,0,30,0
1649905458816,MATH 20D,A01,083765,Staff,21,0,30,9
1649905458816,MATH 20D,A02,083766,Staff,30,0,30,0
1649905458816,MATH 20D,A03,083767,Staff,30,0,30,0
1649905464844,MATH 20E,A01,083771,Staff,14,0,30,16
1649905464844,MATH 20E,A02,083772,Staff,25,0,30,5
1649905464844,MATH 20E,B01,083773,Staff,21,0,30,9
1649905464844,MATH 20E,B02,083774,Staff,29,0,30,1
1649905470871,MATH 103A,A01,083777,Staff,0,1,30,30
1649905470871,MATH 103A,A02,083778,Staff,0,0,30,30
1649905470871,MATH 103A,B01,083779,Staff,2,0,30,28
1649905470871,MATH 103A,B02,083780,Staff,21,0,30,9
1649905476896,MATH 105,A01,085443,Staff,0,4,30,30
1649905482924,MATH 109,A01,083213,Anzaldo; Leesa B,17,0,30,13
1649905482924,MATH 109,A02,083214,Anzaldo; Leesa B,13,0,30,17
1649905482924,MATH 109,B01,083215,Anzaldo; Leesa B,26,0,30,4
1649905482924,MATH 109,B02,083216,Anzaldo; Leesa B,22,0,30,8
1649905488959,MATH 142A,A01,083219,Chow; Bennett,1,1,30,29
1649905488959,MATH 142A,A02,083220,Chow; Bennett,15,0,30,15
1649905488959,MATH 142A,B01,083221,Chow; Bennett,0,0,30,30
1649905488959,MATH 142A,B02,083222,Chow; Bennett,11,0,30,19
1649905494987,MATH 193A,A01,083224,Staff,0,3,30,30
1649905494987,MATH 193A,A02,083225,Staff,0,3,30,30
1649905494987,MATH 193A,A03,083781,Staff,7,0,30,23
1649905494987,MATH 193A,A04,083782,Staff,20,0,30,10
1649905501010,MATH 197,001,091859,McAuley; Julian John,9999,0,9999,0
1649905507063,COGS 9,A01,083615,Staff,21,0,60,39
1649905513090,COGS 11,A01,083617,Boyle; Mary E. T.,35,0,40,5
1649905519116,COGS 13,A01,083071,Staff,0,8,40,40
1649905525139,COGS 14A,A01,092681,Staff,68,0,100,32
1649905531164,COGS 14B,A01,083073,Cheng; Tzu-Han,25,0,50,25
1649905537188,COGS 17,A01,092677,Staff,66,0,75,9
1649905543216,COGS 100,A01,083619,Staff,1,0,60,59
1649905549241,COGS 101A,A01,083621,Davis; Joshua Daniel,3,0,60,57
1649905555267,COGS 101B,A01,091572,Staff,35,0,60,25
1649905561292,COGS 101C,A01,083625,Delgado; Tania,24,0,30,6
1649905567320,COGS 107A,A01,083627,Boyle; Mary E. T.,15,0,60,45
1649905573347,COGS 118A,A01,083075,Staff,22,0,60,38
1649905579370,CSE 3,A50,083646,Miranda; Gregory Joseph,26,0,38,12
1649905579370,CSE 3,A51,083647,Miranda; Gregory Joseph,37,0,37,0
1649905585392,CSE 8A,A50,083650,Miranda; Gregory Joseph,7,0,40,33
1649905591427,CSE 11,A01,083080,Cao; Yingjun,0,22,40,40
1649905597453,CSE 12,A01,083652,Staff,61,0,100,39
1649905603486,CSE 15L,A01,083654,Staff,22,0,50,28
1649905603486,CSE 15L,A02,083655,Staff,47,0,50,3
1649905609509,CSE 20,A01,083657,Staff,68,0,80,12
1649905615532,CSE 30,A01,083084,Eldon; John,1,16,40,39
1649905621558,CSE 100,A01,083659,Cao; Yingjun,2,23,50,48
1649905627582,CSE 134B,A01,083661,Powell; Thomas Allan,2,23,65,63
1649905633608,CSE 140,A01,083663,Staff,26,0,75,49
1649905647664,CSE 140L,A01,083088,Eldon; John,20,0,75,55
1649905653689,CSE 175,A01,083665,Kumar; Rakesh,12,0,25,13
1649905659715,CSE 190,A00,092507,Dubnov; Shlomo,14,0,15,1
1649905665742,ECE 45,A01,083139,Staff,12,0,40,28
1649905671766,ECE 65,A50,083695,Staff,9,0,30,21
1649905677790,ECE 109,A01,091882,Touri; Behrouz,58,0,70,12
1649905683818,ECE 180,A00,083140,Abi Samra; Nicholas Camill,26,0,30,4
1649905683818,ECE 180,B00,083141,Abi Samra; Nicholas Camill,13,0,30,17
1649905689840,MATH 10A,A01,083735,Patchell; Gregory David,22,0,30,8
1649905689840,MATH 10A,A02,083736,Patchell; Gregory David,28,0,30,2
1649905689840,MATH 10A,A03,083737,Patchell; Gregory David,28,0,30,2
1649905695864,MATH 10B,A01,083207,Staff,13,0,30,17
1649905695864,MATH 10B,A02,083208,Staff,25,0,30,5
1649905695864,MATH 10B,B01,083739,Staff,25,0,30,5
1649905695864,MATH 10B,B02,083740,Staff,30,0,30,0
1649905701888,MATH 18,A01,083743,Staff,22,0,30,8
1649905701888,MATH 18,A02,083744,Staff,29,0,30,1
1649905701888,MATH 18,A03,083745,Staff,29,0,30,1
1649905701888,MATH 18,A04,083746,Staff,28,0,30,2
1649905701888,MATH 18,B01,083748,Staff,10,0,30,20
1649905701888,MATH 18,B02,083749,Staff,26,0,30,4
1649905701888,MATH 18,B03,083750,Staff,28,0,30,2
1649905701888,MATH 18,B04,083751,Staff,27,0,30,3
1649905707911,MATH 20A,A01,083754,Staff,37,0,40,3
1649905713938,MATH 20B,A01,083756,Staff,21,0,30,9
1649905713938,MATH 20B,A02,083757,Staff,30,0,30,0
1649905719969,MATH 20C,A01,083760,Staff,22,0,30,8
1649905719969,MATH 20C,A02,083761,Staff,24,0,30,6
1649905719969,MATH 20C,B01,083762,Staff,28,0,30,2
1649905719969,MATH 20C,B02,083763,Staff,30,0,30,0
1649905726005,MATH 20D,A01,083765,Staff,21,0,30,9
1649905726005,MATH 20D,A02,083766,Staff,30,0,30,0
1649905726005,MATH 20D,A03,083767,Staff,30,0,30,0
1649905732028,MATH 20E,A01,083771,Staff,14,0,30,16
1649905732028,MATH 20E,A02,083772,Staff,25,0,30,5
1649905732028,MATH 20E,B01,083773,Staff,20,0,30,10
1649905732028,MATH 20E,B02,083774,Staff,29,0,30,1
1649905738052,MATH 103A,A01,083777,Staff,0,1,30,30
1649905738052,MATH 103A,A02,083778,Staff,0,0,30,30
1649905738052,MATH 103A,B01,083779,Staff,2,0,30,28
1649905738052,MATH 103A,B02,083780,Staff,21,0,30,9
1649905744078,MATH 105,A01,085443,Staff,0,4,30,30
1649905750102,MATH 109,A01,083213,Anzaldo; Leesa B,17,0,30,13
1649905750102,MATH 109,A02,083214,Anzaldo; Leesa B,13,0,30,17
1649905750102,MATH 109,B01,083215,Anzaldo; Leesa B,26,0,30,4
1649905750102,MATH 109,B02,083216,Anzaldo; Leesa B,22,0,30,8
1649905756130,MATH 142A,A01,083219,Chow; Bennett,1,1,30,29
1649905756130,MATH 142A,A02,083220,Chow; Bennett,15,0,30,15
1649905756130,MATH 142A,B01,083221,Chow; Bennett,0,0,30,30
1649905756130,MATH 142A,B02,083222,Chow; Bennett,11,0,30,19
1649905762157,MATH 193A,A01,083224,Staff,0,3,30,30
1649905762157,MATH 193A,A02,083225,Staff,0,3,30,30
1649905762157,MATH 193A,A03,083781,Staff,7,0,30,23
1649905762157,MATH 193A,A04,083782,Staff,20,0,30,10
1649905768186,MATH 197,001,091859,McAuley; Julian John,9999,0,9999,0
1649905774241,COGS 9,A01,083615,Staff,21,0,60,39
1649905780269,COGS 11,A01,083617,Boyle; Mary E. T.,35,0,40,5
1649905786299,COGS 13,A01,083071,Staff,0,8,40,40
1649905792322,COGS 14A,A01,092681,Staff,69,0,100,31
1649905798350,COGS 14B,A01,083073,Cheng; Tzu-Han,25,0,50,25
1649905804373,COGS 17,A01,092677,Staff,66,0,75,9
1649905810400,COGS 100,A01,083619,Staff,1,0,60,59
1649905816424,COGS 101A,A01,083621,Davis; Joshua Daniel,1,0,60,59
1649905822451,COGS 101B,A01,091572,Staff,35,0,60,25
1649905828472,COGS 101C,A01,083625,Delgado; Tania,24,0,30,6
1649905834498,COGS 107A,A01,083627,Boyle; Mary E. T.,15,0,60,45
1649905840522,COGS 118A,A01,083075,Staff,22,0,60,38
1649905846547,CSE 3,A50,083646,Miranda; Gregory Joseph,26,0,38,12
1649905846547,CSE 3,A51,083647,Miranda; Gregory Joseph,37,0,37,0
1649905852574,CSE 8A,A50,083650,Miranda; Gregory Joseph,7,0,40,33
1649905858598,CSE 11,A01,083080,Cao; Yingjun,0,23,40,40
1649905864627,CSE 12,A01,083652,Staff,61,0,100,39
1649905870654,CSE 15L,A01,083654,Staff,22,0,50,28
1649905870654,CSE 15L,A02,083655,Staff,47,0,50,3
1649905876684,CSE 20,A01,083657,Staff,68,0,80,12
1649905882708,CSE 30,A01,083084,Eldon; John,1,16,40,39
1649905888730,CSE 100,A01,083659,Cao; Yingjun,2,23,50,48
1649905894754,CSE 134B,A01,083661,Powell; Thomas Allan,2,23,65,63
1649905900777,CSE 140,A01,083663,Staff,26,0,75,49
1649905906804,CSE 140L,A01,083088,Eldon; John,20,0,75,55
1649905912830,CSE 175,A01,083665,Kumar; Rakesh,12,0,25,13
1649905918854,CSE 190,A00,092507,Dubnov; Shlomo,14,0,15,1
1649905924891,ECE 45,A01,083139,Staff,12,0,40,28
1649905930916,ECE 65,A50,083695,Staff,9,0,30,21
1649905936938,ECE 109,A01,091882,Touri; Behrouz,58,0,70,12
1649905942964,ECE 180,A00,083140,Abi Samra; Nicholas Camill,26,0,30,4
1649905942964,ECE 180,B00,083141,Abi Samra; Nicholas Camill,13,0,30,17
1649905948991,MATH 10A,A01,083735,Patchell; Gregory David,22,0,30,8
1649905948991,MATH 10A,A02,083736,Patchell; Gregory David,28,0,30,2
1649905948991,MATH 10A,A03,083737,Patchell; Gregory David,28,0,30,2
1649905955017,MATH 10B,A01,083207,Staff,13,0,30,17
1649905955017,MATH 10B,A02,083208,Staff,25,0,30,5
1649905955017,MATH 10B,B01,083739,Staff,25,0,30,5
1649905955017,MATH 10B,B02,083740,Staff,30,0,30,0
1649905961041,MATH 18,A01,083743,Staff,22,0,30,8
1649905961041,MATH 18,A02,083744,Staff,29,0,30,1
1649905961041,MATH 18,A03,083745,Staff,29,0,30,1
1649905961041,MATH 18,A04,083746,Staff,28,0,30,2
1649905961041,MATH 18,B01,083748,Staff,10,0,30,20
1649905961041,MATH 18,B02,083749,Staff,26,0,30,4
1649905961041,MATH 18,B03,083750,Staff,28,0,30,2
1649905961041,MATH 18,B04,083751,Staff,27,0,30,3
1649905967065,MATH 20A,A01,083754,Staff,37,0,40,3
1649905973160,MATH 20B,A01,083756,Staff,21,0,30,9
1649905973160,MATH 20B,A02,083757,Staff,30,0,30,0
1649905979186,MATH 20C,A01,083760,Staff,22,0,30,8
1649905979186,MATH 20C,A02,083761,Staff,24,0,30,6
1649905979186,MATH 20C,B01,083762,Staff,28,0,30,2
1649905979186,MATH 20C,B02,083763,Staff,30,0,30,0
1649905985209,MATH 20D,A01,083765,Staff,21,0,30,9
1649905985209,MATH 20D,A02,083766,Staff,30,0,30,0
1649905985209,MATH 20D,A03,083767,Staff,30,0,30,0
1649905991232,MATH 20E,A01,083771,Staff,14,0,30,16
1649905991232,MATH 20E,A02,083772,Staff,25,0,30,5
1649905991232,MATH 20E,B01,083773,Staff,20,0,30,10
1649905991232,MATH 20E,B02,083774,Staff,29,0,30,1
1649905997255,MATH 103A,A01,083777,Staff,0,1,30,30
1649905997255,MATH 103A,A02,083778,Staff,0,0,30,30
1649905997255,MATH 103A,B01,083779,Staff,2,0,30,28
1649905997255,MATH 103A,B02,083780,Staff,21,0,30,9
1649906003281,MATH 105,A01,085443,Staff,0,4,30,30
1649906009303,MATH 109,A01,083213,Anzaldo; Leesa B,17,0,30,13
1649906009303,MATH 109,A02,083214,Anzaldo; Leesa B,13,0,30,17
1649906009303,MATH 109,B01,083215,Anzaldo; Leesa B,26,0,30,4
1649906009303,MATH 109,B02,083216,Anzaldo; Leesa B,22,0,30,8
1649906015325,MATH 142A,A01,083219,Chow; Bennett,1,1,30,29
1649906015325,MATH 142A,A02,083220,Chow; Bennett,15,0,30,15
1649906015325,MATH 142A,B01,083221,Chow; Bennett,0,0,30,30
1649906015325,MATH 142A,B02,083222,Chow; Bennett,10,0,30,20
1649906021349,MATH 193A,A01,083224,Staff,0,3,30,30
1649906021349,MATH 193A,A02,083225,Staff,0,3,30,30
1649906021349,MATH 193A,A03,083781,Staff,7,0,30,23
1649906021349,MATH 193A,A04,083782,Staff,19,0,30,11
1649906027375,MATH 197,001,091859,McAuley; Julian John,9999,0,9999,0
1649906033441,COGS 9,A01,083615,Staff,21,0,60,39
1649906039464,COGS 11,A01,083617,Boyle; Mary E. T.,35,0,40,5
1649906045489,COGS 13,A01,083071,Staff,0,8,40,40
1649906051515,COGS 14A,A01,092681,Staff,69,0,100,31
1649906057541,COGS 14B,A01,083073,Cheng; Tzu-Han,25,0,50,25
1649906063565,COGS 17,A01,092677,Staff,66,0,75,9
1649906069589,COGS 100,A01,083619,Staff,1,0,60,59
1649906075613,COGS 101A,A01,083621,Davis; Joshua Daniel,1,0,60,59
1649906081640,COGS 101B,A01,091572,Staff,35,0,60,25
1649906087669,COGS 101C,A01,083625,Delgado; Tania,24,0,30,6
1649906093691,COGS 107A,A01,083627,Boyle; Mary E. T.,15,0,60,45
1649906099715,COGS 118A,A01,083075,Staff,22,0,60,38
1649906105743,CSE 3,A50,083646,Miranda; Gregory Joseph,26,0,38,12
1649906105743,CSE 3,A51,083647,Miranda; Gregory Joseph,37,0,37,0
1649906111770,CSE 8A,A50,083650,Miranda; Gregory Joseph,7,0,40,33
1649906117814,CSE 11,A01,083080,Cao; Yingjun,0,23,40,40
1649906123837,CSE 12,A01,083652,Staff,60,0,100,40
1649906129877,CSE 15L,A01,083654,Staff,21,0,50,29
1649906129877,CSE 15L,A02,083655,Staff,47,0,50,3
1649906135916,CSE 20,A01,083657,Staff,68,0,80,12
1649906141939,CSE 30,A01,083084,Eldon; John,1,16,40,39
1649906147964,CSE 100,A01,083659,Cao; Yingjun,2,25,50,48
1649906153986,CSE 134B,A01,083661,Powell; Thomas Allan,2,23,65,63
1649906160008,CSE 140,A01,083663,Staff,26,0,75,49
1649906166034,CSE 140L,A01,083088,Eldon; John,20,0,75,55
1649906172061,CSE 175,A01,083665,Kumar; Rakesh,12,0,25,13
1649906178088,CSE 190,A00,092507,Dubnov; Shlomo,14,0,15,1
1649906184116,ECE 45,A01,083139,Staff,12,0,40,28
1649906190138,ECE 65,A50,083695,Staff,9,0,30,21
1649906196162,ECE 109,A01,091882,Touri; Behrouz,58,0,70,12
1649906202186,ECE 180,A00,083140,Abi Samra; Nicholas Camill,26,0,30,4
1649906202186,ECE 180,B00,083141,Abi Samra; Nicholas Camill,13,0,30,17
1649906208210,MATH 10A,A01,083735,Patchell; Gregory David,22,0,30,8
1649906208210,MATH 10A,A02,083736,Patchell; Gregory David,28,0,30,2
1649906208210,MATH 10A,A03,083737,Patchell; Gregory David,28,0,30,2
1649906214233,MATH 10B,A01,083207,Staff,13,0,30,17
1649906214233,MATH 10B,A02,083208,Staff,25,0,30,5
1649906214233,MATH 10B,B01,083739,Staff,25,0,30,5
1649906214233,MATH 10B,B02,083740,Staff,30,0,30,0
1649906220270,MATH 18,A01,083743,Staff,22,0,30,8
1649906220270,MATH 18,A02,083744,Staff,29,0,30,1
1649906220270,MATH 18,A03,083745,Staff,29,0,30,1
1649906220270,MATH 18,A04,083746,Staff,28,0,30,2
1649906220270,MATH 18,B01,083748,Staff,10,0,30,20
1649906220270,MATH 18,B02,083749,Staff,26,0,30,4
1649906220270,MATH 18,B03,083750,Staff,28,0,30,2
1649906220270,MATH 18,B04,083751,Staff,27,0,30,3
1649906226293,MATH 20A,A01,083754,Staff,37,0,40,3
1649906232323,MATH 20B,A01,083756,Staff,21,0,30,9
1649906232323,MATH 20B,A02,083757,Staff,30,0,30,0
1649906238349,MATH 20C,A01,083760,Staff,22,0,30,8
1649906238349,MATH 20C,A02,083761,Staff,24,0,30,6
1649906238349,MATH 20C,B01,083762,Staff,28,0,30,2
1649906238349,MATH 20C,B02,083763,Staff,30,0,30,0
1649906244373,MATH 20D,A01,083765,Staff,21,0,30,9
1649906244373,MATH 20D,A02,083766,Staff,30,0,30,0
1649906244373,MATH 20D,A03,083767,Staff,30,0,30,0
1649906250403,MATH 20E,A01,083771,Staff,14,0,30,16
1649906250403,MATH 20E,A02,083772,Staff,25,0,30,5
1649906250403,MATH 20E,B01,083773,Staff,20,0,30,10
1649906250403,MATH 20E,B02,083774,Staff,29,0,30,1
1649906256433,MATH 103A,A01,083777,Staff,0,1,30,30
1649906256433,MATH 103A,A02,083778,Staff,0,0,30,30
1649906256433,MATH 103A,B01,083779,Staff,1,0,30,29
1649906256433,MATH 103A,B02,083780,Staff,21,0,30,9
1649906262459,MATH 105,A01,085443,Staff,0,4,30,30
1649906268486,MATH 109,A01,083213,Anzaldo; Leesa B,17,0,30,13
1649906268486,MATH 109,A02,083214,Anzaldo; Leesa B,13,0,30,17
1649906268486,MATH 109,B01,083215,Anzaldo; Leesa B,26,0,30,4
1649906268486,MATH 109,B02,083216,Anzaldo; Leesa B,22,0,30,8
1649906274514,MATH 142A,A01,083219,Chow; Bennett,1,1,30,29
1649906274514,MATH 142A,A02,083220,Chow; Bennett,15,0,30,15
1649906274514,MATH 142A,B01,083221,Chow; Bennett,0,0,30,30
1649906274514,MATH 142A,B02,083222,Chow; Bennett,10,0,30,20
1649906280537,MATH 193A,A01,083224,Staff,0,3,30,30
1649906280537,MATH 193A,A02,083225,Staff,0,4,30,30
1649906280537,MATH 193A,A03,083781,Staff,6,0,30,24
1649906280537,MATH 193A,A04,083782,Staff,19,0,30,11
1649906286559,MATH 197,001,091859,McAuley; Julian John,9999,0,9999,0
1649906292624,COGS 9,A01,083615,Staff,20,0,60,40
1649906298647,COGS 11,A01,083617,Boyle; Mary E. T.,35,0,40,5
1649906304674,COGS 13,A01,083071,Staff,0,8,40,40
1649906310700,COGS 14A,A01,092681,Staff,69,0,100,31
1649906316723,COGS 14B,A01,083073,Cheng; Tzu-Han,25,0,50,25
1649906322748,COGS 17,A01,092677,Staff,66,0,75,9
1649906328772,COGS 100,A01,083619,Staff,1,0,60,59
1649906334794,COGS 101A,A01,083621,Davis; Joshua Daniel,0,0,60,60
1649906340819,COGS 101B,A01,091572,Staff,35,0,60,25
1649906346842,COGS 101C,A01,083625,Delgado; Tania,24,0,30,6
1649906352869,COGS 107A,A01,083627,Boyle; Mary E. T.,15,0,60,45
1649906358901,COGS 118A,A01,083075,Staff,22,0,60,38
1649906364925,CSE 3,A50,083646,Miranda; Gregory Joseph,26,0,38,12
1649906364925,CSE 3,A51,083647,Miranda; Gregory Joseph,37,0,37,0
1649906370948,CSE 8A,A50,083650,Miranda; Gregory Joseph,7,0,40,33
1649906376970,CSE 11,A01,083080,Cao; Yingjun,0,23,40,40
1649906383007,CSE 12,A01,083652,Staff,59,0,100,41
1649906389047,CSE 15L,A01,083654,Staff,20,0,50,30
1649906389047,CSE 15L,A02,083655,Staff,47,0,50,3
1649906395073,CSE 20,A01,083657,Staff,68,0,80,12
1649906401096,CSE 30,A01,083084,Eldon; John,1,16,40,39
1649906407123,CSE 100,A01,083659,Cao; Yingjun,2,25,50,48
1649906413149,CSE 134B,A01,083661,Powell; Thomas Allan,2,23,65,63
1649906419176,CSE 140,A01,083663,Staff,26,0,75,49
1649906425204,CSE 140L,A01,083088,Eldon; John,20,0,75,55
1649906431231,CSE 175,A01,083665,Kumar; Rakesh,12,0,25,13
1649906437268,CSE 190,A00,092507,Dubnov; Shlomo,14,0,15,1
1649906443292,ECE 45,A01,083139,Staff,12,0,40,28
1649906449319,ECE 65,A50,083695,Staff,9,0,30,21
1649906455342,ECE 109,A01,091882,Touri; Behrouz,58,0,70,12
1649906461363,ECE 180,A00,083140,Abi Samra; Nicholas Camill,26,0,30,4
1649906461363,ECE 180,B00,083141,Abi Samra; Nicholas Camill,13,0,30,17
1649906467386,MATH 10A,A01,083735,Patchell; Gregory David,22,0,30,8
1649906467386,MATH 10A,A02,083736,Patchell; Gregory David,28,0,30,2
1649906467386,MATH 10A,A03,083737,Patchell; Gregory David,28,0,30,2
1649906473411,MATH 10B,A01,083207,Staff,13,0,30,17
1649906473411,MATH 10B,A02,083208,Staff,25,0,30,5
1649906473411,MATH 10B,B01,083739,Staff,25,0,30,5
1649906473411,MATH 10B,B02,083740,Staff,30,0,30,0
1649906479442,MATH 18,A01,083743,Staff,22,0,30,8
1649906479442,MATH 18,A02,083744,Staff,29,0,30,1
1649906479442,MATH 18,A03,083745,Staff,29,0,30,1
1649906479442,MATH 18,A04,083746,Staff,28,0,30,2
1649906479442,MATH 18,B01,083748,Staff,9,0,30,21
1649906479442,MATH 18,B02,083749,Staff,26,0,30,4
1649906479442,MATH 18,B03,083750,Staff,28,0,30,2
1649906479442,MATH 18,B04,083751,Staff,27,0,30,3
1649906485474,MATH 20A,A01,083754,Staff,37,0,40,3
1649906491498,MATH 20B,A01,083756,Staff,21,0,30,9
1649906491498,MATH 20B,A02,083757,Staff,30,0,30,0
1649906497522,MATH 20C,A01,083760,Staff,22,0,30,8
1649906497522,MATH 20C,A02,083761,Staff,24,0,30,6
1649906497522,MATH 20C,B01,083762,Staff,28,0,30,2
1649906497522,MATH 20C,B02,083763,Staff,30,0,30,0
1649906503556,MATH 20D,A01,083765,Staff,21,0,30,9
1649906503556,MATH 20D,A02,083766,Staff,30,0,30,0
1649906503556,MATH 20D,A03,083767,Staff,30,0,30,0
1649906509580,MATH 20E,A01,083771,Staff,14,0,30,16
1649906509580,MATH 20E,A02,083772,Staff,25,0,30,5
1649906509580,MATH 20E,B01,083773,Staff,20,0,30,10
1649906509580,MATH 20E,B02,083774,Staff,29,0,30,1
1649906515603,MATH 103A,A01,083777,Staff,0,1,30,30
1649906515603,MATH 103A,A02,083778,Staff,0,2,30,30
1649906515603,MATH 103A,B01,083779,Staff,2,0,30,28
1649906515603,MATH 103A,B02,083780,Staff,21,0,30,9
1649906521627,MATH 105,A01,085443,Staff,0,4,30,30
1649906527651,MATH 109,A01,083213,Anzaldo; Leesa B,17,0,30,13
1649906527651,MATH 109,A02,083214,Anzaldo; Leesa B,13,0,30,17
1649906527651,MATH 109,B01,083215,Anzaldo; Leesa B,26,0,30,4
1649906527651,MATH 109,B02,083216,Anzaldo; Leesa B,22,0,30,8
1649906533676,MATH 142A,A01,083219,Chow; Bennett,1,1,30,29
1649906533676,MATH 142A,A02,083220,Chow; Bennett,15,0,30,15
1649906533676,MATH 142A,B01,083221,Chow; Bennett,0,1,30,30
1649906533676,MATH 142A,B02,083222,Chow; Bennett,9,0,30,21
1649906539703,MATH 193A,A01,083224,Staff,0,3,30,30
1649906539703,MATH 193A,A02,083225,Staff,0,4,30,30
1649906539703,MATH 193A,A03,083781,Staff,6,0,30,24
1649906539703,MATH 193A,A04,083782,Staff,19,0,30,11
1649906545727,MATH 197,001,091859,McAuley; Julian John,9999,0,9999,0
1649906551779,COGS 9,A01,083615,Staff,20,0,60,40
1649906557802,COGS 11,A01,083617,Boyle; Mary E. T.,35,0,40,5
1649906563899,COGS 13,A01,083071,Staff,0,8,40,40
1649906569921,COGS 14A,A01,092681,Staff,69,0,100,31
1649906575948,COGS 14B,A01,083073,Cheng; Tzu-Han,25,0,50,25
1649906581988,COGS 17,A01,092677,Staff,66,0,75,9
1649906588012,COGS 100,A01,083619,Staff,0,0,60,60
1649906594035,COGS 101A,A01,083621,Davis; Joshua Daniel,0,1,60,60
1649906600060,COGS 101B,A01,091572,Staff,35,0,60,25
1649906606082,COGS 101C,A01,083625,Delgado; Tania,24,0,30,6
1649906612109,COGS 107A,A01,083627,Boyle; Mary E. T.,15,0,60,45
1649906618145,COGS 118A,A01,083075,Staff,21,0,60,39
1649906624166,CSE 3,A50,083646,Miranda; Gregory Joseph,26,0,38,12
1649906624166,CSE 3,A51,083647,Miranda; Gregory Joseph,37,0,37,0
1649906630189,CSE 8A,A50,083650,Miranda; Gregory Joseph,7,0,40,33
1649906636218,CSE 11,A01,083080,Cao; Yingjun,0,23,40,40
1649906642242,CSE 12,A01,083652,Staff,58,0,100,42
1649906648268,CSE 15L,A01,083654,Staff,19,0,50,31
1649906648268,CSE 15L,A02,083655,Staff,47,0,50,3
1649906654290,CSE 20,A01,083657,Staff,68,0,80,12
1649906660314,CSE 30,A01,083084,Eldon; John,1,17,40,39
1649906666336,CSE 100,A01,083659,Cao; Yingjun,2,25,50,48
1649906672361,CSE 134B,A01,083661,Powell; Thomas Allan,2,23,65,63
1649906678385,CSE 140,A01,083663,Staff,26,0,75,49
1649906684408,CSE 140L,A01,083088,Eldon; John,20,0,75,55
1649906690445,CSE 175,A01,083665,Kumar; Rakesh,12,0,25,13
1649906696471,CSE 190,A00,092507,Dubnov; Shlomo,14,0,15,1
1649906702495,ECE 45,A01,083139,Staff,12,0,40,28
1649906708518,ECE 65,A50,083695,Staff,9,0,30,21
1649906714542,ECE 109,A01,091882,Touri; Behrouz,58,0,70,12
1649906720565,ECE 180,A00,083140,Abi Samra; Nicholas Camill,26,0,30,4
1649906720565,ECE 180,B00,083141,Abi Samra; Nicholas Camill,13,0,30,17
1649906726589,MATH 10A,A01,083735,Patchell; Gregory David,22,0,30,8
1649906726589,MATH 10A,A02,083736,Patchell; Gregory David,28,0,30,2
1649906726589,MATH 10A,A03,083737,Patchell; Gregory David,28,0,30,2
1649906732614,MATH 10B,A01,083207,Staff,13,0,30,17
1649906732614,MATH 10B,A02,083208,Staff,25,0,30,5
1649906732614,MATH 10B,B01,083739,Staff,25,0,30,5
1649906732614,MATH 10B,B02,083740,Staff,30,0,30,0
1649906738639,MATH 18,A01,083743,Staff,22,0,30,8
1649906738639,MATH 18,A02,083744,Staff,29,0,30,1
1649906738639,MATH 18,A03,083745,Staff,29,0,30,1
1649906738639,MATH 18,A04,083746,Staff,28,0,30,2
1649906738639,MATH 18,B01,083748,Staff,9,0,30,21
1649906738639,MATH 18,B02,083749,Staff,26,0,30,4
1649906738639,MATH 18,B03,083750,Staff,28,0,30,2
1649906738639,MATH 18,B04,083751,Staff,27,0,30,3
1649906744661,MATH 20A,A01,083754,Staff,37,0,40,3
1649906750685,MATH 20B,A01,083756,Staff,21,0,30,9
1649906750685,MATH 20B,A02,083757,Staff,30,0,30,0
1649906756709,MATH 20C,A01,083760,Staff,22,0,30,8
1649906756709,MATH 20C,A02,083761,Staff,24,0,30,6
1649906756709,MATH 20C,B01,083762,Staff,28,0,30,2
1649906756709,MATH 20C,B02,083763,Staff,30,0,30,0
1649906762735,MATH 20D,A01,083765,Staff,21,0,30,9
1649906762735,MATH 20D,A02,083766,Staff,30,0,30,0
1649906762735,MATH 20D,A03,083767,Staff,30,0,30,0
1649906768758,MATH 20E,A01,083771,Staff,14,0,30,16
1649906768758,MATH 20E,A02,083772,Staff,25,0,30,5
1649906768758,MATH 20E,B01,083773,Staff,19,0,30,11
1649906768758,MATH 20E,B02,083774,Staff,29,0,30,1
1649906774781,MATH 103A,A01,083777,Staff,0,1,30,30
1649906774781,MATH 103A,A02,083778,Staff,0,2,30,30
1649906774781,MATH 103A,B01,083779,Staff,2,0,30,28
1649906774781,MATH 103A,B02,083780,Staff,21,0,30,9
1649906780808,MATH 105,A01,085443,Staff,0,4,30,30
1649906786830,MATH 109,A01,083213,Anzaldo; Leesa B,17,0,30,13
1649906786830,MATH 109,A02,083214,Anzaldo; Leesa B,13,0,30,17
1649906786830,MATH 109,B01,083215,Anzaldo; Leesa B,26,0,30,4
1649906786830,MATH 109,B02,083216,Anzaldo; Leesa B,22,0,30,8
1649906792858,MATH 142A,A01,083219,Chow; Bennett,1,1,30,29
1649906792858,MATH 142A,A02,083220,Chow; Bennett,15,0,30,15
1649906792858,MATH 142A,B01,083221,Chow; Bennett,0,0,30,30
1649906792858,MATH 142A,B02,083222,Chow; Bennett,6,0,30,24
1649906798898,MATH 193A,A01,083224,Staff,0,3,30,30
1649906798898,MATH 193A,A02,083225,Staff,0,4,30,30
1649906798898,MATH 193A,A03,083781,Staff,6,0,30,24
1649906798898,MATH 193A,A04,083782,Staff,18,0,30,12
1649906804921,MATH 197,001,091859,McAuley; Julian John,9999,0,9999,0
1649906810974,COGS 9,A01,083615,Staff,20,0,60,40
1649906817001,COGS 11,A01,083617,Boyle; Mary E. T.,35,0,40,5
1649906823025,COGS 13,A01,083071,Staff,0,9,40,40
1649906829048,COGS 14A,A01,092681,Staff,68,0,100,32
1649906835070,COGS 14B,A01,083073,Cheng; Tzu-Han,25,0,50,25
1649906841095,COGS 17,A01,092677,Staff,66,0,75,9
1649906847121,COGS 100,A01,083619,Staff,0,1,60,60
1649906853143,COGS 101A,A01,083621,Davis; Joshua Daniel,0,2,60,60
1649906859168,COGS 101B,A01,091572,Staff,35,0,60,25
1649906865192,COGS 101C,A01,083625,Delgado; Tania,24,0,30,6
1649906871217,COGS 107A,A01,083627,Boyle; Mary E. T.,15,0,60,45
1649906877239,COGS 118A,A01,083075,Staff,21,0,60,39
1649906883262,CSE 3,A50,083646,Miranda; Gregory Joseph,26,0,38,12
1649906883262,CSE 3,A51,083647,Miranda; Gregory Joseph,37,0,37,0
1649906889286,CSE 8A,A50,083650,Miranda; Gregory Joseph,7,0,40,33
1649906895316,CSE 11,A01,083080,Cao; Yingjun,0,23,40,40
1649906901343,CSE 12,A01,083652,Staff,58,0,100,42
1649906907369,CSE 15L,A01,083654,Staff,19,0,50,31
1649906907369,CSE 15L,A02,083655,Staff,47,0,50,3
1649906913397,CSE 20,A01,083657,Staff,68,0,80,12
1649906919423,CSE 30,A01,083084,Eldon; John,1,17,40,39
1649906925449,CSE 100,A01,083659,Cao; Yingjun,2,26,50,48
1649906931475,CSE 134B,A01,083661,Powell; Thomas Allan,2,23,65,63
1649906937509,CSE 140,A01,083663,Staff,26,0,75,49
1649906943539,CSE 140L,A01,083088,Eldon; John,20,0,75,55
1649906949566,CSE 175,A01,083665,Kumar; Rakesh,12,0,25,13
1649906955594,CSE 190,A00,092507,Dubnov; Shlomo,14,0,15,1
1649906961637,ECE 45,A01,083139,Staff,12,0,40,28
1649906967659,ECE 65,A50,083695,Staff,9,0,30,21
1649906973685,ECE 109,A01,091882,Touri; Behrouz,58,0,70,12
1649906979711,ECE 180,A00,083140,Abi Samra; Nicholas Camill,26,0,30,4
1649906979711,ECE 180,B00,083141,Abi Samra; Nicholas Camill,13,0,30,17
1649906985737,MATH 10A,A01,083735,Patchell; Gregory David,22,0,30,8
1649906985737,MATH 10A,A02,083736,Patchell; Gregory David,28,0,30,2
1649906985737,MATH 10A,A03,083737,Patchell; Gregory David,28,0,30,2
1649906991764,MATH 10B,A01,083207,Staff,13,0,30,17
1649906991764,MATH 10B,A02,083208,Staff,25,0,30,5
1649906991764,MATH 10B,B01,083739,Staff,25,0,30,5
1649906991764,MATH 10B,B02,083740,Staff,30,0,30,0
1649906997793,MATH 18,A01,083743,Staff,22,0,30,8
1649906997793,MATH 18,A02,083744,Staff,29,0,30,1
1649906997793,MATH 18,A03,083745,Staff,29,0,30,1
1649906997793,MATH 18,A04,083746,Staff,28,0,30,2
1649906997793,MATH 18,B01,083748,Staff,9,0,30,21
1649906997793,MATH 18,B02,083749,Staff,26,0,30,4
1649906997793,MATH 18,B03,083750,Staff,28,0,30,2
1649906997793,MATH 18,B04,083751,Staff,27,0,30,3
1649907003822,MATH 20A,A01,083754,Staff,37,0,40,3
1649907009847,MATH 20B,A01,083756,Staff,21,0,30,9
1649907009847,MATH 20B,A02,083757,Staff,30,0,30,0
1649907015873,MATH 20C,A01,083760,Staff,22,0,30,8
1649907015873,MATH 20C,A02,083761,Staff,24,0,30,6
1649907015873,MATH 20C,B01,083762,Staff,28,0,30,2
1649907015873,MATH 20C,B02,083763,Staff,30,0,30,0
1649907021895,MATH 20D,A01,083765,Staff,21,0,30,9
1649907021895,MATH 20D,A02,083766,Staff,30,0,30,0
1649907021895,MATH 20D,A03,083767,Staff,30,0,30,0
1649907027920,MATH 20E,A01,083771,Staff,14,0,30,16
1649907027920,MATH 20E,A02,083772,Staff,25,0,30,5
1649907027920,MATH 20E,B01,083773,Staff,19,0,30,11
1649907027920,MATH 20E,B02,083774,Staff,29,0,30,1
1649907033948,MATH 103A,A01,083777,Staff,0,1,30,30
1649907033948,MATH 103A,A02,083778,Staff,0,2,30,30
1649907033948,MATH 103A,B01,083779,Staff,2,0,30,28
1649907033948,MATH 103A,B02,083780,Staff,21,0,30,9
1649907039976,MATH 105,A01,085443,Staff,0,5,30,30
1649907046012,MATH 109,A01,083213,Anzaldo; Leesa B,17,0,30,13
1649907046012,MATH 109,A02,083214,Anzaldo; Leesa B,13,0,30,17
1649907046012,MATH 109,B01,083215,Anzaldo; Leesa B,26,0,30,4
1649907046012,MATH 109,B02,083216,Anzaldo; Leesa B,22,0,30,8
1649907052036,MATH 142A,A01,083219,Chow; Bennett,1,1,30,29
1649907052036,MATH 142A,A02,083220,Chow; Bennett,15,0,30,15
1649907052036,MATH 142A,B01,083221,Chow; Bennett,0,0,30,30
1649907052036,MATH 142A,B02,083222,Chow; Bennett,6,0,30,24
1649907058061,MATH 193A,A01,083224,Staff,0,3,30,30
1649907058061,MATH 193A,A02,083225,Staff,0,4,30,30
1649907058061,MATH 193A,A03,083781,Staff,5,0,30,25
1649907058061,MATH 193A,A04,083782,Staff,18,0,30,12
1649907064088,MATH 197,001,091859,McAuley; Julian John,9999,0,9999,0
1649907070154,COGS 9,A01,083615,Staff,20,0,60,40
1649907076185,COGS 11,A01,083617,Boyle; Mary E. T.,35,0,40,5
1649907082214,COGS 13,A01,083071,Staff,0,9,40,40
1649907088237,COGS 14A,A01,092681,Staff,67,0,100,33
1649907094267,COGS 14B,A01,083073,Cheng; Tzu-Han,25,0,50,25
1649907100293,COGS 17,A01,092677,Staff,66,0,75,9
1649907106319,COGS 100,A01,083619,Staff,0,1,60,60
1649907112343,COGS 101A,A01,083621,Davis; Joshua Daniel,0,2,60,60
1649907118370,COGS 101B,A01,091572,Staff,35,0,60,25
1649907124396,COGS 101C,A01,083625,Delgado; Tania,24,0,30,6
1649907130419,COGS 107A,A01,083627,Boyle; Mary E. T.,15,0,60,45
1649907136444,COGS 118A,A01,083075,Staff,21,0,60,39
1649907142473,CSE 3,A50,083646,Miranda; Gregory Joseph,26,0,38,12
1649907142473,CSE 3,A51,083647,Miranda; Gregory Joseph,37,0,37,0
1649907148496,CSE 8A,A50,083650,Miranda; Gregory Joseph,7,0,40,33
1649907154520,CSE 11,A01,083080,Cao; Yingjun,0,23,40,40
1649907160636,CSE 12,A01,083652,Staff,58,0,100,42
1649907166660,CSE 15L,A01,083654,Staff,19,0,50,31
1649907166660,CSE 15L,A02,083655,Staff,47,0,50,3
1649907172686,CSE 20,A01,083657,Staff,68,0,80,12
1649907178713,CSE 30,A01,083084,Eldon; John,1,17,40,39
1649907184743,CSE 100,A01,083659,Cao; Yingjun,2,26,50,48
1649907190766,CSE 134B,A01,083661,Powell; Thomas Allan,2,23,65,63
1649907196788,CSE 140,A01,083663,Staff,26,0,75,49
1649907202818,CSE 140L,A01,083088,Eldon; John,20,0,75,55
1649907208839,CSE 175,A01,083665,Kumar; Rakesh,12,0,25,13
1649907214865,CSE 190,A00,092507,Dubnov; Shlomo,14,0,15,1
1649907220887,ECE 45,A01,083139,Staff,12,0,40,28
1649907226914,ECE 65,A50,083695,Staff,9,0,30,21
1649907232936,ECE 109,A01,091882,Touri; Behrouz,58,0,70,12
1649907238958,ECE 180,A00,083140,Abi Samra; Nicholas Camill,26,0,30,4
1649907238958,ECE 180,B00,083141,Abi Samra; Nicholas Camill,13,0,30,17
1649907244982,MATH 10A,A01,083735,Patchell; Gregory David,22,0,30,8
1649907244982,MATH 10A,A02,083736,Patchell; Gregory David,28,0,30,2
1649907244982,MATH 10A,A03,083737,Patchell; Gregory David,28,0,30,2
1649907251006,MATH 10B,A01,083207,Staff,13,0,30,17
1649907251006,MATH 10B,A02,083208,Staff,25,0,30,5
1649907251006,MATH 10B,B01,083739,Staff,25,0,30,5
1649907251006,MATH 10B,B02,083740,Staff,30,0,30,0
1649907257030,MATH 18,A01,083743,Staff,22,0,30,8
1649907257030,MATH 18,A02,083744,Staff,29,0,30,1
1649907257030,MATH 18,A03,083745,Staff,29,0,30,1
1649907257030,MATH 18,A04,083746,Staff,28,0,30,2
1649907257030,MATH 18,B01,083748,Staff,8,0,30,22
1649907257030,MATH 18,B02,083749,Staff,26,0,30,4
1649907257030,MATH 18,B03,083750,Staff,28,0,30,2
1649907257030,MATH 18,B04,083751,Staff,27,0,30,3
1649907263053,MATH 20A,A01,083754,Staff,37,0,40,3
1649907269077,MATH 20B,A01,083756,Staff,21,0,30,9
1649907269077,MATH 20B,A02,083757,Staff,30,0,30,0
1649907275104,MATH 20C,A01,083760,Staff,22,0,30,8
1649907275104,MATH 20C,A02,083761,Staff,24,0,30,6
1649907275104,MATH 20C,B01,083762,Staff,28,0,30,2
1649907275104,MATH 20C,B02,083763,Staff,30,0,30,0
1649907281130,MATH 20D,A01,083765,Staff,21,0,30,9
1649907281130,MATH 20D,A02,083766,Staff,30,0,30,0
1649907281130,MATH 20D,A03,083767,Staff,30,0,30,0
1649907287158,MATH 20E,A01,083771,Staff,14,0,30,16
1649907287158,MATH 20E,A02,083772,Staff,25,0,30,5
1649907287158,MATH 20E,B01,083773,Staff,19,0,30,11
1649907287158,MATH 20E,B02,083774,Staff,29,0,30,1
1649907293184,MATH 103A,A01,083777,Staff,0,1,30,30
1649907293184,MATH 103A,A02,083778,Staff,0,2,30,30
1649907293184,MATH 103A,B01,083779,Staff,2,0,30,28
1649907293184,MATH 103A,B02,083780,Staff,21,0,30,9
1649907299206,MATH 105,A01,085443,Staff,0,5,30,30
1649907305237,MATH 109,A01,083213,Anzaldo; Leesa B,17,0,30,13
1649907305237,MATH 109,A02,083214,Anzaldo; Leesa B,12,0,30,18
1649907305237,MATH 109,B01,083215,Anzaldo; Leesa B,26,0,30,4
1649907305237,MATH 109,B02,083216,Anzaldo; Leesa B,22,0,30,8
1649907311265,MATH 142A,A01,083219,Chow; Bennett,1,1,30,29
1649907311265,MATH 142A,A02,083220,Chow; Bennett,15,0,30,15
1649907311265,MATH 142A,B01,083221,Chow; Bennett,0,0,30,30
1649907311265,MATH 142A,B02,083222,Chow; Bennett,6,0,30,24
1649907317292,MATH 193A,A01,083224,Staff,0,3,30,30
1649907317292,MATH 193A,A02,083225,Staff,0,4,30,30
1649907317292,MATH 193A,A03,083781,Staff,5,0,30,25
1649907317292,MATH 193A,A04,083782,Staff,19,0,30,11
1649907323320,MATH 197,001,091859,McAuley; Julian John,9999,0,9999,0
1649907329378,COGS 9,A01,083615,Staff,20,0,60,40
1649907335401,COGS 11,A01,083617,Boyle; Mary E. T.,35,0,40,5
1649907341428,COGS 13,A01,083071,Staff,0,9,40,40
1649907347451,COGS 14A,A01,092681,Staff,67,0,100,33
1649907353486,COGS 14B,A01,083073,Cheng; Tzu-Han,25,0,50,25
1649907359511,COGS 17,A01,092677,Staff,65,0,75,10
1649907365536,COGS 100,A01,083619,Staff,0,1,60,60
1649907371560,COGS 101A,A01,083621,Davis; Joshua Daniel,0,2,60,60
1649907377583,COGS 101B,A01,091572,Staff,35,0,60,25
1649907383607,COGS 101C,A01,083625,Delgado; Tania,24,0,30,6
1649907389634,COGS 107A,A01,083627,Boyle; Mary E. T.,15,0,60,45
1649907395656,COGS 118A,A01,083075,Staff,21,0,60,39
1649907401680,CSE 3,A50,083646,Miranda; Gregory Joseph,26,0,38,12
1649907401680,CSE 3,A51,083647,Miranda; Gregory Joseph,37,0,37,0
1649907407705,CSE 8A,A50,083650,Miranda; Gregory Joseph,7,0,40,33
1649907413734,CSE 11,A01,083080,Cao; Yingjun,0,23,40,40
1649907419768,CSE 12,A01,083652,Staff,58,0,100,42
1649907425793,CSE 15L,A01,083654,Staff,19,0,50,31
1649907425793,CSE 15L,A02,083655,Staff,47,0,50,3
1649907431820,CSE 20,A01,083657,Staff,68,0,80,12
1649907437844,CSE 30,A01,083084,Eldon; John,1,17,40,39
1649907443881,CSE 100,A01,083659,Cao; Yingjun,2,26,50,48
1649907449909,CSE 134B,A01,083661,Powell; Thomas Allan,2,23,65,63
1649907455934,CSE 140,A01,083663,Staff,26,0,75,49
1649907461956,CSE 140L,A01,083088,Eldon; John,20,0,75,55
1649907467982,CSE 175,A01,083665,Kumar; Rakesh,12,0,25,13
1649907474008,CSE 190,A00,092507,Dubnov; Shlomo,14,0,15,1
1649907480032,ECE 45,A01,083139,Staff,12,0,40,28
1649907486060,ECE 65,A50,083695,Staff,9,0,30,21
1649907492099,ECE 109,A01,091882,Touri; Behrouz,58,0,70,12
1649907498122,ECE 180,A00,083140,Abi Samra; Nicholas Camill,26,0,30,4
1649907498122,ECE 180,B00,083141,Abi Samra; Nicholas Camill,13,0,30,17
1649907504147,MATH 10A,A01,083735,Patchell; Gregory David,22,0,30,8
1649907504147,MATH 10A,A02,083736,Patchell; Gregory David,28,0,30,2
1649907504147,MATH 10A,A03,083737,Patchell; Gregory David,28,0,30,2
1649907510175,MATH 10B,A01,083207,Staff,13,0,30,17
1649907510175,MATH 10B,A02,083208,Staff,25,0,30,5
1649907510175,MATH 10B,B01,083739,Staff,25,0,30,5
1649907510175,MATH 10B,B02,083740,Staff,30,0,30,0
1649907516209,MATH 18,A01,083743,Staff,22,0,30,8
1649907516209,MATH 18,A02,083744,Staff,29,0,30,1
1649907516209,MATH 18,A03,083745,Staff,29,0,30,1
1649907516209,MATH 18,A04,083746,Staff,28,0,30,2
1649907516209,MATH 18,B01,083748,Staff,8,0,30,22
1649907516209,MATH 18,B02,083749,Staff,26,0,30,4
1649907516209,MATH 18,B03,083750,Staff,28,0,30,2
1649907516209,MATH 18,B04,083751,Staff,27,0,30,3
1649907522231,MATH 20A,A01,083754,Staff,37,0,40,3
1649907528255,MATH 20B,A01,083756,Staff,21,0,30,9
1649907528255,MATH 20B,A02,083757,Staff,30,0,30,0
1649907534283,MATH 20C,A01,083760,Staff,22,0,30,8
1649907534283,MATH 20C,A02,083761,Staff,24,0,30,6
1649907534283,MATH 20C,B01,083762,Staff,28,0,30,2
1649907534283,MATH 20C,B02,083763,Staff,30,0,30,0
1649907540308,MATH 20D,A01,083765,Staff,21,0,30,9
1649907540308,MATH 20D,A02,083766,Staff,30,0,30,0
1649907540308,MATH 20D,A03,083767,Staff,30,0,30,0
1649907546333,MATH 20E,A01,083771,Staff,14,0,30,16
1649907546333,MATH 20E,A02,083772,Staff,25,0,30,5
1649907546333,MATH 20E,B01,083773,Staff,19,0,30,11
1649907546333,MATH 20E,B02,083774,Staff,29,0,30,1
1649907552365,MATH 103A,A01,083777,Staff,0,1,30,30
1649907552365,MATH 103A,A02,083778,Staff,0,2,30,30
1649907552365,MATH 103A,B01,083779,Staff,2,0,30,28
1649907552365,MATH 103A,B02,083780,Staff,21,0,30,9
1649907558389,MATH 105,A01,085443,Staff,0,5,30,30
1649907564416,MATH 109,A01,083213,Anzaldo; Leesa B,17,0,30,13
1649907564416,MATH 109,A02,083214,Anzaldo; Leesa B,12,0,30,18
1649907564416,MATH 109,B01,083215,Anzaldo; Leesa B,26,0,30,4
1649907564416,MATH 109,B02,083216,Anzaldo; Leesa B,22,0,30,8
1649907570440,MATH 142A,A01,083219,Chow; Bennett,1,1,30,29
1649907570440,MATH 142A,A02,083220,Chow; Bennett,15,0,30,15
1649907570440,MATH 142A,B01,083221,Chow; Bennett,0,0,30,30
1649907570440,MATH 142A,B02,083222,Chow; Bennett,6,0,30,24
1649907576468,MATH 193A,A01,083224,Staff,0,3,30,30
1649907576468,MATH 193A,A02,083225,Staff,0,4,30,30
1649907576468,MATH 193A,A03,083781,Staff,5,0,30,25
1649907576468,MATH 193A,A04,083782,Staff,18,0,30,12
1649907582490,MATH 197,001,091859,McAuley; Julian John,9999,0,9999,0
1649907588542,COGS 9,A01,083615,Staff,20,0,60,40
1649907594569,COGS 11,A01,083617,Boyle; Mary E. T.,35,0,40,5
1649907600604,COGS 13,A01,083071,Staff,0,9,40,40
1649907606628,COGS 14A,A01,092681,Staff,67,0,100,33
1649907612653,COGS 14B,A01,083073,Cheng; Tzu-Han,25,0,50,25
1649907618682,COGS 17,A01,092677,Staff,65,0,75,10
1649907624707,COGS 100,A01,083619,Staff,0,1,60,60
1649907630732,COGS 101A,A01,083621,Davis; Joshua Daniel,0,2,60,60
1649907636768,COGS 101B,A01,091572,Staff,35,0,60,25
1649907642791,COGS 101C,A01,083625,Delgado; Tania,24,0,30,6
1649907648818,COGS 107A,A01,083627,Boyle; Mary E. T.,15,0,60,45
1649907654841,COGS 118A,A01,083075,Staff,21,0,60,39
1649907660869,CSE 3,A50,083646,Miranda; Gregory Joseph,26,0,38,12
1649907660869,CSE 3,A51,083647,Miranda; Gregory Joseph,37,0,37,0
1649907666892,CSE 8A,A50,083650,Miranda; Gregory Joseph,7,0,40,33
1649907672917,CSE 11,A01,083080,Cao; Yingjun,0,23,40,40
1649907678945,CSE 12,A01,083652,Staff,58,0,100,42
1649907684972,CSE 15L,A01,083654,Staff,19,0,50,31
1649907684972,CSE 15L,A02,083655,Staff,47,0,50,3
1649907690997,CSE 20,A01,083657,Staff,68,0,80,12
1649907697019,CSE 30,A01,083084,Eldon; John,1,17,40,39
1649907703045,CSE 100,A01,083659,Cao; Yingjun,2,26,50,48
1649907709073,CSE 134B,A01,083661,Powell; Thomas Allan,2,23,65,63
1649907715096,CSE 140,A01,083663,Staff,26,0,75,49
1649907721122,CSE 140L,A01,083088,Eldon; John,20,0,75,55
1649907727145,CSE 175,A01,083665,Kumar; Rakesh,12,0,25,13
1649907733169,CSE 190,A00,092507,Dubnov; Shlomo,14,0,15,1
1649907739193,ECE 45,A01,083139,Staff,12,0,40,28
1649907745219,ECE 65,A50,083695,Staff,9,0,30,21
1649907751242,ECE 109,A01,091882,Touri; Behrouz,58,0,70,12
1649907757341,ECE 180,A00,083140,Abi Samra; Nicholas Camill,26,0,30,4
1649907757341,ECE 180,B00,083141,Abi Samra; Nicholas Camill,13,0,30,17
1649907763365,MATH 10A,A01,083735,Patchell; Gregory David,22,0,30,8
1649907763365,MATH 10A,A02,083736,Patchell; Gregory David,28,0,30,2
1649907763365,MATH 10A,A03,083737,Patchell; Gregory David,28,0,30,2
1649907769411,MATH 10B,A01,083207,Staff,13,0,30,17
1649907769411,MATH 10B,A02,083208,Staff,25,0,30,5
1649907769411,MATH 10B,B01,083739,Staff,25,0,30,5
1649907769411,MATH 10B,B02,083740,Staff,30,0,30,0
1649907775436,MATH 18,A01,083743,Staff,22,0,30,8
1649907775436,MATH 18,A02,083744,Staff,29,0,30,1
1649907775436,MATH 18,A03,083745,Staff,29,0,30,1
1649907775436,MATH 18,A04,083746,Staff,28,0,30,2
1649907775436,MATH 18,B01,083748,Staff,7,0,30,23
1649907775436,MATH 18,B02,083749,Staff,26,0,30,4
1649907775436,MATH 18,B03,083750,Staff,28,0,30,2
1649907775436,MATH 18,B04,083751,Staff,27,0,30,3
1649907781460,MATH 20A,A01,083754,Staff,37,0,40,3
1649907787483,MATH 20B,A01,083756,Staff,21,0,30,9
1649907787483,MATH 20B,A02,083757,Staff,30,0,30,0
1649907793506,MATH 20C,A01,083760,Staff,22,0,30,8
1649907793506,MATH 20C,A02,083761,Staff,24,0,30,6
1649907793506,MATH 20C,B01,083762,Staff,28,0,30,2
1649907793506,MATH 20C,B02,083763,Staff,30,0,30,0
1649907799531,MATH 20D,A01,083765,Staff,21,0,30,9
1649907799531,MATH 20D,A02,083766,Staff,30,0,30,0
1649907799531,MATH 20D,A03,083767,Staff,30,0,30,0
1649907805556,MATH 20E,A01,083771,Staff,14,0,30,16
1649907805556,MATH 20E,A02,083772,Staff,25,0,30,5
1649907805556,MATH 20E,B01,083773,Staff,19,0,30,11
1649907805556,MATH 20E,B02,083774,Staff,29,0,30,1
1649907811579,MATH 103A,A01,083777,Staff,0,1,30,30
1649907811579,MATH 103A,A02,083778,Staff,0,2,30,30
1649907811579,MATH 103A,B01,083779,Staff,1,0,30,29
1649907811579,MATH 103A,B02,083780,Staff,21,0,30,9
1649907817602,MATH 105,A01,085443,Staff,0,5,30,30
1649907823626,MATH 109,A01,083213,Anzaldo; Leesa B,17,0,30,13
1649907823626,MATH 109,A02,083214,Anzaldo; Leesa B,12,0,30,18
1649907823626,MATH 109,B01,083215,Anzaldo; Leesa B,26,0,30,4
1649907823626,MATH 109,B02,083216,Anzaldo; Leesa B,22,0,30,8
1649907829653,MATH 142A,A01,083219,Chow; Bennett,1,1,30,29
1649907829653,MATH 142A,A02,083220,Chow; Bennett,14,0,30,16
1649907829653,MATH 142A,B01,083221,Chow; Bennett,0,0,30,30
1649907829653,MATH 142A,B02,083222,Chow; Bennett,6,0,30,24
1649907835681,MATH 193A,A01,083224,Staff,0,3,30,30
1649907835681,MATH 193A,A02,083225,Staff,0,4,30,30
1649907835681,MATH 193A,A03,083781,Staff,5,0,30,25
1649907835681,MATH 193A,A04,083782,Staff,18,0,30,12
1649907841707,MATH 197,001,091859,McAuley; Julian John,9999,0,9999,0
1649907847780,COGS 9,A01,083615,Staff,20,0,60,40
1649907853803,COGS 11,A01,083617,Boyle; Mary E. T.,35,0,40,5
1649907859833,COGS 13,A01,083071,Staff,0,9,40,40
1649907865859,COGS 14A,A01,092681,Staff,67,0,100,33
1649907871881,COGS 14B,A01,083073,Cheng; Tzu-Han,25,0,50,25
1649907877906,COGS 17,A01,092677,Staff,63,0,75,12
1649907883930,COGS 100,A01,083619,Staff,0,1,60,60
1649907889954,COGS 101A,A01,083621,Davis; Joshua Daniel,0,4,60,60
1649907895977,COGS 101B,A01,091572,Staff,33,0,60,27
1649907902005,COGS 101C,A01,083625,Delgado; Tania,24,0,30,6
1649907908036,COGS 107A,A01,083627,Boyle; Mary E. T.,15,0,60,45
1649907914065,COGS 118A,A01,083075,Staff,21,0,60,39
1649907920090,CSE 3,A50,083646,Miranda; Gregory Joseph,26,0,38,12
1649907920090,CSE 3,A51,083647,Miranda; Gregory Joseph,37,0,37,0
1649907926117,CSE 8A,A50,083650,Miranda; Gregory Joseph,7,0,40,33
1649907932144,CSE 11,A01,083080,Cao; Yingjun,0,24,40,40
1649907938170,CSE 12,A01,083652,Staff,58,0,100,42
1649907944191,CSE 15L,A01,083654,Staff,19,0,50,31
1649907944191,CSE 15L,A02,083655,Staff,47,0,50,3
1649907950217,CSE 20,A01,083657,Staff,68,0,80,12
1649907956243,CSE 30,A01,083084,Eldon; John,1,18,40,39
1649907962266,CSE 100,A01,083659,Cao; Yingjun,2,26,50,48
1649907968294,CSE 134B,A01,083661,Powell; Thomas Allan,2,23,65,63
1649907974317,CSE 140,A01,083663,Staff,26,0,75,49
1649907980343,CSE 140L,A01,083088,Eldon; John,20,0,75,55
1649907986366,CSE 175,A01,083665,Kumar; Rakesh,12,0,25,13
1649907992393,CSE 190,A00,092507,Dubnov; Shlomo,14,0,15,1
1649907998423,ECE 45,A01,083139,Staff,11,0,40,29
1649908004454,ECE 65,A50,083695,Staff,9,0,30,21
1649908010480,ECE 109,A01,091882,Touri; Behrouz,58,0,70,12
1649908016502,ECE 180,A00,083140,Abi Samra; Nicholas Camill,26,0,30,4
1649908016502,ECE 180,B00,083141,Abi Samra; Nicholas Camill,13,0,30,17
1649908022526,MATH 10A,A01,083735,Patchell; Gregory David,22,0,30,8
1649908022526,MATH 10A,A02,083736,Patchell; Gregory David,28,0,30,2
1649908022526,MATH 10A,A03,083737,Patchell; Gregory David,28,0,30,2
1649908028551,MATH 10B,A01,083207,Staff,13,0,30,17
1649908028551,MATH 10B,A02,083208,Staff,25,0,30,5
1649908028551,MATH 10B,B01,083739,Staff,25,0,30,5
1649908028551,MATH 10B,B02,083740,Staff,30,0,30,0
1649908034580,MATH 18,A01,083743,Staff,22,0,30,8
1649908034580,MATH 18,A02,083744,Staff,29,0,30,1
1649908034580,MATH 18,A03,083745,Staff,29,0,30,1
1649908034580,MATH 18,A04,083746,Staff,28,0,30,2
1649908034580,MATH 18,B01,083748,Staff,7,0,30,23
1649908034580,MATH 18,B02,083749,Staff,26,0,30,4
1649908034580,MATH 18,B03,083750,Staff,28,0,30,2
1649908034580,MATH 18,B04,083751,Staff,27,0,30,3
1649908040604,MATH 20A,A01,083754,Staff,37,0,40,3
1649908046628,MATH 20B,A01,083756,Staff,21,0,30,9
1649908046628,MATH 20B,A02,083757,Staff,30,0,30,0
1649908052655,MATH 20C,A01,083760,Staff,22,0,30,8
1649908052655,MATH 20C,A02,083761,Staff,24,0,30,6
1649908052655,MATH 20C,B01,083762,Staff,28,0,30,2
1649908052655,MATH 20C,B02,083763,Staff,30,0,30,0
1649908058693,MATH 20D,A01,083765,Staff,21,0,30,9
1649908058693,MATH 20D,A02,083766,Staff,30,0,30,0
1649908058693,MATH 20D,A03,083767,Staff,30,0,30,0
1649908064720,MATH 20E,A01,083771,Staff,14,0,30,16
1649908064720,MATH 20E,A02,083772,Staff,25,0,30,5
1649908064720,MATH 20E,B01,083773,Staff,19,0,30,11
1649908064720,MATH 20E,B02,083774,Staff,29,0,30,1
1649908070749,MATH 103A,A01,083777,Staff,0,1,30,30
1649908070749,MATH 103A,A02,083778,Staff,0,2,30,30
1649908070749,MATH 103A,B01,083779,Staff,1,0,30,29
1649908070749,MATH 103A,B02,083780,Staff,21,0,30,9
1649908076771,MATH 105,A01,085443,Staff,0,5,30,30
1649908082794,MATH 109,A01,083213,Anzaldo; Leesa B,17,0,30,13
1649908082794,MATH 109,A02,083214,Anzaldo; Leesa B,12,0,30,18
1649908082794,MATH 109,B01,083215,Anzaldo; Leesa B,26,0,30,4
1649908082794,MATH 109,B02,083216,Anzaldo; Leesa B,22,0,30,8
1649908088818,MATH 142A,A01,083219,Chow; Bennett,1,1,30,29
1649908088818,MATH 142A,A02,083220,Chow; Bennett,14,0,30,16
1649908088818,MATH 142A,B01,083221,Chow; Bennett,0,0,30,30
1649908088818,MATH 142A,B02,083222,Chow; Bennett,6,0,30,24
1649908094842,MATH 193A,A01,083224,Staff,0,3,30,30
1649908094842,MATH 193A,A02,083225,Staff,0,4,30,30
1649908094842,MATH 193A,A03,083781,Staff,5,0,30,25
1649908094842,MATH 193A,A04,083782,Staff,18,0,30,12
1649908100864,MATH 197,001,091859,McAuley; Julian John,9999,0,9999,0
1649908106934,COGS 9,A01,083615,Staff,20,0,60,40
1649908112958,COGS 11,A01,083617,Boyle; Mary E. T.,35,0,40,5
1649908118984,COGS 13,A01,083071,Staff,0,9,40,40
1649908125009,COGS 14A,A01,092681,Staff,67,0,100,33
1649908131033,COGS 14B,A01,083073,Cheng; Tzu-Han,25,0,50,25
1649908137055,COGS 17,A01,092677,Staff,63,0,75,12
1649908143083,COGS 100,A01,083619,Staff,0,1,60,60
1649908149113,COGS 101A,A01,083621,Davis; Joshua Daniel,0,4,60,60
1649908155141,COGS 101B,A01,091572,Staff,33,0,60,27
1649908161164,COGS 101C,A01,083625,Delgado; Tania,24,0,30,6
1649908167191,COGS 107A,A01,083627,Boyle; Mary E. T.,15,0,60,45
1649908173216,COGS 118A,A01,083075,Staff,21,0,60,39
1649908179252,CSE 3,A50,083646,Miranda; Gregory Joseph,26,0,38,12
1649908179252,CSE 3,A51,083647,Miranda; Gregory Joseph,37,0,37,0
1649908185276,CSE 8A,A50,083650,Miranda; Gregory Joseph,7,0,40,33
1649908191300,CSE 11,A01,083080,Cao; Yingjun,0,25,40,40
1649908197327,CSE 12,A01,083652,Staff,58,0,100,42
1649908203350,CSE 15L,A01,083654,Staff,19,0,50,31
1649908203350,CSE 15L,A02,083655,Staff,47,0,50,3
1649908209376,CSE 20,A01,083657,Staff,68,0,80,12
1649908215399,CSE 30,A01,083084,Eldon; John,1,18,40,39
1649908221421,CSE 100,A01,083659,Cao; Yingjun,2,26,50,48
1649908227448,CSE 134B,A01,083661,Powell; Thomas Allan,2,23,65,63
1649908233470,CSE 140,A01,083663,Staff,25,0,75,50
1649908239492,CSE 140L,A01,083088,Eldon; John,19,0,75,56
1649908245518,CSE 175,A01,083665,Kumar; Rakesh,12,0,25,13
1649908251541,CSE 190,A00,092507,Dubnov; Shlomo,14,0,15,1
1649908257565,ECE 45,A01,083139,Staff,10,0,40,30
1649908263591,ECE 65,A50,083695,Staff,9,0,30,21
1649908269615,ECE 109,A01,091882,Touri; Behrouz,58,0,70,12
1649908275641,ECE 180,A00,083140,Abi Samra; Nicholas Camill,26,0,30,4
1649908275641,ECE 180,B00,083141,Abi Samra; Nicholas Camill,13,0,30,17
1649908281666,MATH 10A,A01,083735,Patchell; Gregory David,22,0,30,8
1649908281666,MATH 10A,A02,083736,Patchell; Gregory David,28,0,30,2
1649908281666,MATH 10A,A03,083737,Patchell; Gregory David,28,0,30,2
1649908287690,MATH 10B,A01,083207,Staff,13,0,30,17
1649908287690,MATH 10B,A02,083208,Staff,25,0,30,5
1649908287690,MATH 10B,B01,083739,Staff,25,0,30,5
1649908287690,MATH 10B,B02,083740,Staff,30,0,30,0
1649908293715,MATH 18,A01,083743,Staff,22,0,30,8
1649908293715,MATH 18,A02,083744,Staff,29,0,30,1
1649908293715,MATH 18,A03,083745,Staff,29,0,30,1
1649908293715,MATH 18,A04,083746,Staff,28,0,30,2
1649908293715,MATH 18,B01,083748,Staff,7,0,30,23
1649908293715,MATH 18,B02,083749,Staff,26,0,30,4
1649908293715,MATH 18,B03,083750,Staff,28,0,30,2
1649908293715,MATH 18,B04,083751,Staff,27,0,30,3
1649908299740,MATH 20A,A01,083754,Staff,37,0,40,3
1649908305776,MATH 20B,A01,083756,Staff,21,0,30,9
1649908305776,MATH 20B,A02,083757,Staff,30,0,30,0
1649908311800,MATH 20C,A01,083760,Staff,22,0,30,8
1649908311800,MATH 20C,A02,083761,Staff,24,0,30,6
1649908311800,MATH 20C,B01,083762,Staff,28,0,30,2
1649908311800,MATH 20C,B02,083763,Staff,30,0,30,0
1649908317827,MATH 20D,A01,083765,Staff,21,0,30,9
1649908317827,MATH 20D,A02,083766,Staff,30,0,30,0
1649908317827,MATH 20D,A03,083767,Staff,30,0,30,0
1649908323851,MATH 20E,A01,083771,Staff,14,0,30,16
1649908323851,MATH 20E,A02,083772,Staff,25,0,30,5
1649908323851,MATH 20E,B01,083773,Staff,19,0,30,11
1649908323851,MATH 20E,B02,083774,Staff,29,0,30,1
1649908329879,MATH 103A,A01,083777,Staff,0,1,30,30
1649908329879,MATH 103A,A02,083778,Staff,0,2,30,30
1649908329879,MATH 103A,B01,083779,Staff,1,0,30,29
1649908329879,MATH 103A,B02,083780,Staff,20,0,30,10
1649908335915,MATH 105,A01,085443,Staff,0,5,30,30
1649908341942,MATH 109,A01,083213,Anzaldo; Leesa B,17,0,30,13
1649908341942,MATH 109,A02,083214,Anzaldo; Leesa B,11,0,30,19
1649908341942,MATH 109,B01,083215,Anzaldo; Leesa B,26,0,30,4
1649908341942,MATH 109,B02,083216,Anzaldo; Leesa B,22,0,30,8
1649908347966,MATH 142A,A01,083219,Chow; Bennett,1,1,30,29
1649908347966,MATH 142A,A02,083220,Chow; Bennett,14,0,30,16
1649908347966,MATH 142A,B01,083221,Chow; Bennett,0,0,30,30
1649908347966,MATH 142A,B02,083222,Chow; Bennett,6,0,30,24
1649908354070,MATH 193A,A01,083224,Staff,0,3,30,30
1649908354070,MATH 193A,A02,083225,Staff,0,4,30,30
1649908354070,MATH 193A,A03,083781,Staff,5,0,30,25
1649908354070,MATH 193A,A04,083782,Staff,18,0,30,12
1649908360094,MATH 197,001,091859,McAuley; Julian John,9999,0,9999,0
1649908366158,COGS 9,A01,083615,Staff,19,0,60,41
1649908372196,COGS 11,A01,083617,Boyle; Mary E. T.,35,0,40,5
1649908378223,COGS 13,A01,083071,Staff,0,9,40,40
1649908384246,COGS 14A,A01,092681,Staff,67,0,100,33
1649908390270,COGS 14B,A01,083073,Cheng; Tzu-Han,25,0,50,25
1649908396294,COGS 17,A01,092677,Staff,63,0,75,12
1649908402320,COGS 100,A01,083619,Staff,0,1,60,60
1649908408364,COGS 101A,A01,083621,Davis; Joshua Daniel,0,5,60,60
1649908414394,COGS 101B,A01,091572,Staff,32,0,60,28
1649908420417,COGS 101C,A01,083625,Delgado; Tania,24,0,30,6
1649908426440,COGS 107A,A01,083627,Boyle; Mary E. T.,15,0,60,45
1649908432463,COGS 118A,A01,083075,Staff,21,0,60,39
1649908438491,CSE 3,A50,083646,Miranda; Gregory Joseph,26,0,38,12
1649908438491,CSE 3,A51,083647,Miranda; Gregory Joseph,37,0,37,0
1649908444518,CSE 8A,A50,083650,Miranda; Gregory Joseph,7,0,40,33
1649908450541,CSE 11,A01,083080,Cao; Yingjun,0,26,40,40
1649908456565,CSE 12,A01,083652,Staff,58,0,100,42
1649908462587,CSE 15L,A01,083654,Staff,19,0,50,31
1649908462587,CSE 15L,A02,083655,Staff,47,0,50,3
1649908468616,CSE 20,A01,083657,Staff,68,0,80,12
1649908474640,CSE 30,A01,083084,Eldon; John,1,19,40,39
1649908480666,CSE 100,A01,083659,Cao; Yingjun,2,26,50,48
1649908486691,CSE 134B,A01,083661,Powell; Thomas Allan,2,23,65,63
1649908492717,CSE 140,A01,083663,Staff,25,0,75,50
1649908498740,CSE 140L,A01,083088,Eldon; John,19,0,75,56
1649908504770,CSE 175,A01,083665,Kumar; Rakesh,12,0,25,13
1649908510793,CSE 190,A00,092507,Dubnov; Shlomo,14,0,15,1
1649908516817,ECE 45,A01,083139,Staff,10,0,40,30
1649908522848,ECE 65,A50,083695,Staff,9,0,30,21
1649908528870,ECE 109,A01,091882,Touri; Behrouz,58,0,70,12
1649908534895,ECE 180,A00,083140,Abi Samra; Nicholas Camill,26,0,30,4
1649908534895,ECE 180,B00,083141,Abi Samra; Nicholas Camill,13,0,30,17
1649908540919,MATH 10A,A01,083735,Patchell; Gregory David,22,0,30,8
1649908540919,MATH 10A,A02,083736,Patchell; Gregory David,28,0,30,2
1649908540919,MATH 10A,A03,083737,Patchell; Gregory David,28,0,30,2
1649908546943,MATH 10B,A01,083207,Staff,13,0,30,17
1649908546943,MATH 10B,A02,083208,Staff,25,0,30,5
1649908546943,MATH 10B,B01,083739,Staff,25,0,30,5
1649908546943,MATH 10B,B02,083740,Staff,30,0,30,0
1649908552967,MATH 18,A01,083743,Staff,22,0,30,8
1649908552967,MATH 18,A02,083744,Staff,29,0,30,1
1649908552967,MATH 18,A03,083745,Staff,29,0,30,1
1649908552967,MATH 18,A04,083746,Staff,28,0,30,2
1649908552967,MATH 18,B01,083748,Staff,7,0,30,23
1649908552967,MATH 18,B02,083749,Staff,26,0,30,4
1649908552967,MATH 18,B03,083750,Staff,28,0,30,2
1649908552967,MATH 18,B04,083751,Staff,27,0,30,3
1649908558998,MATH 20A,A01,083754,Staff,37,0,40,3
1649908565021,MATH 20B,A01,083756,Staff,21,0,30,9
1649908565021,MATH 20B,A02,083757,Staff,30,0,30,0
1649908571048,MATH 20C,A01,083760,Staff,22,0,30,8
1649908571048,MATH 20C,A02,083761,Staff,24,0,30,6
1649908571048,MATH 20C,B01,083762,Staff,28,0,30,2
1649908571048,MATH 20C,B02,083763,Staff,30,0,30,0
1649908577082,MATH 20D,A01,083765,Staff,21,0,30,9
1649908577082,MATH 20D,A02,083766,Staff,30,0,30,0
1649908577082,MATH 20D,A03,083767,Staff,30,0,30,0
1649908583109,MATH 20E,A01,083771,Staff,14,0,30,16
1649908583109,MATH 20E,A02,083772,Staff,25,0,30,5
1649908583109,MATH 20E,B01,083773,Staff,19,0,30,11
1649908583109,MATH 20E,B02,083774,Staff,29,0,30,1
1649908589132,MATH 103A,A01,083777,Staff,0,1,30,30
1649908589132,MATH 103A,A02,083778,Staff,0,2,30,30
1649908589132,MATH 103A,B01,083779,Staff,0,0,30,30
1649908589132,MATH 103A,B02,083780,Staff,20,0,30,10
1649908595155,MATH 105,A01,085443,Staff,0,5,30,30
1649908601181,MATH 109,A01,083213,Anzaldo; Leesa B,17,0,30,13
1649908601181,MATH 109,A02,083214,Anzaldo; Leesa B,11,0,30,19
1649908601181,MATH 109,B01,083215,Anzaldo; Leesa B,26,0,30,4
1649908601181,MATH 109,B02,083216,Anzaldo; Leesa B,22,0,30,8
1649908607204,MATH 142A,A01,083219,Chow; Bennett,1,1,30,29
1649908607204,MATH 142A,A02,083220,Chow; Bennett,13,0,30,17
1649908607204,MATH 142A,B01,083221,Chow; Bennett,0,0,30,30
1649908607204,MATH 142A,B02,083222,Chow; Bennett,6,0,30,24
1649908613226,MATH 193A,A01,083224,Staff,0,3,30,30
1649908613226,MATH 193A,A02,083225,Staff,0,4,30,30
1649908613226,MATH 193A,A03,083781,Staff,5,0,30,25
1649908613226,MATH 193A,A04,083782,Staff,18,0,30,12
1649908619252,MATH 197,001,091859,McAuley; Julian John,9999,0,9999,0
1649908625306,COGS 9,A01,083615,Staff,18,0,60,42
1649908631333,COGS 11,A01,083617,Boyle; Mary E. T.,35,0,40,5
1649908637355,COGS 13,A01,083071,Staff,0,9,40,40
1649908643380,COGS 14A,A01,092681,Staff,67,0,100,33
1649908649403,COGS 14B,A01,083073,Cheng; Tzu-Han,25,0,50,25
1649908655426,COGS 17,A01,092677,Staff,63,0,75,12
1649908661450,COGS 100,A01,083619,Staff,0,2,60,60
1649908667485,COGS 101A,A01,083621,Davis; Joshua Daniel,0,5,60,60
1649908673507,COGS 101B,A01,091572,Staff,32,0,60,28
1649908679533,COGS 101C,A01,083625,Delgado; Tania,24,0,30,6
1649908685557,COGS 107A,A01,083627,Boyle; Mary E. T.,15,0,60,45
1649908691590,COGS 118A,A01,083075,Staff,21,0,60,39
1649908697613,CSE 3,A50,083646,Miranda; Gregory Joseph,26,0,38,12
1649908697613,CSE 3,A51,083647,Miranda; Gregory Joseph,37,0,37,0
1649908703637,CSE 8A,A50,083650,Miranda; Gregory Joseph,7,0,40,33
1649908709661,CSE 11,A01,083080,Cao; Yingjun,0,26,40,40
1649908715688,CSE 12,A01,083652,Staff,58,0,100,42
1649908721712,CSE 15L,A01,083654,Staff,19,0,50,31
1649908721712,CSE 15L,A02,083655,Staff,47,0,50,3
1649908727735,CSE 20,A01,083657,Staff,68,0,80,12
1649908733759,CSE 30,A01,083084,Eldon; John,1,19,40,39
1649908739786,CSE 100,A01,083659,Cao; Yingjun,2,26,50,48
1649908745838,CSE 134B,A01,083661,Powell; Thomas Allan,2,23,65,63
1649908751863,CSE 140,A01,083663,Staff,25,0,75,50
1649908757892,CSE 140L,A01,083088,Eldon; John,19,0,75,56
1649908763916,CSE 175,A01,083665,Kumar; Rakesh,12,0,25,13
1649908769942,CSE 190,A00,092507,Dubnov; Shlomo,14,0,15,1
1649908775966,ECE 45,A01,083139,Staff,10,0,40,30
1649908781988,ECE 65,A50,083695,Staff,9,0,30,21
1649908788015,ECE 109,A01,091882,Touri; Behrouz,58,0,70,12
1649908794042,ECE 180,A00,083140,Abi Samra; Nicholas Camill,26,0,30,4
1649908794042,ECE 180,B00,083141,Abi Samra; Nicholas Camill,13,0,30,17
1649908800067,MATH 10A,A01,083735,Patchell; Gregory David,22,0,30,8
1649908800067,MATH 10A,A02,083736,Patchell; Gregory David,28,0,30,2
1649908800067,MATH 10A,A03,083737,Patchell; Gregory David,28,0,30,2
1649908806106,MATH 10B,A01,083207,Staff,13,0,30,17
1649908806106,MATH 10B,A02,083208,Staff,25,0,30,5
1649908806106,MATH 10B,B01,083739,Staff,25,0,30,5
1649908806106,MATH 10B,B02,083740,Staff,30,0,30,0
1649908812137,MATH 18,A01,083743,Staff,22,0,30,8
1649908812137,MATH 18,A02,083744,Staff,29,0,30,1
1649908812137,MATH 18,A03,083745,Staff,29,0,30,1
1649908812137,MATH 18,A04,083746,Staff,28,0,30,2
1649908812137,MATH 18,B01,083748,Staff,7,0,30,23
1649908812137,MATH 18,B02,083749,Staff,26,0,30,4
1649908812137,MATH 18,B03,083750,Staff,28,0,30,2
1649908812137,MATH 18,B04,083751,Staff,27,0,30,3
1649908818163,MATH 20A,A01,083754,Staff,37,0,40,3
1649908824194,MATH 20B,A01,083756,Staff,21,0,30,9
1649908824194,MATH 20B,A02,083757,Staff,30,0,30,0
1649908830225,MATH 20C,A01,083760,Staff,22,0,30,8
1649908830225,MATH 20C,A02,083761,Staff,24,0,30,6
1649908830225,MATH 20C,B01,083762,Staff,28,0,30,2
1649908830225,MATH 20C,B02,083763,Staff,30,0,30,0
1649908836250,MATH 20D,A01,083765,Staff,21,0,30,9
1649908836250,MATH 20D,A02,083766,Staff,30,0,30,0
1649908836250,MATH 20D,A03,083767,Staff,30,0,30,0
1649908842275,MATH 20E,A01,083771,Staff,14,0,30,16
1649908842275,MATH 20E,A02,083772,Staff,25,0,30,5
1649908842275,MATH 20E,B01,083773,Staff,19,0,30,11
1649908842275,MATH 20E,B02,083774,Staff,29,0,30,1
1649908848312,MATH 103A,A01,083777,Staff,0,1,30,30
1649908848312,MATH 103A,A02,083778,Staff,0,3,30,30
1649908848312,MATH 103A,B01,083779,Staff,0,0,30,30
1649908848312,MATH 103A,B02,083780,Staff,20,0,30,10
1649908854339,MATH 105,A01,085443,Staff,0,5,30,30
1649908860363,MATH 109,A01,083213,Anzaldo; Leesa B,17,0,30,13
1649908860363,MATH 109,A02,083214,Anzaldo; Leesa B,11,0,30,19
1649908860363,MATH 109,B01,083215,Anzaldo; Leesa B,26,0,30,4
1649908860363,MATH 109,B02,083216,Anzaldo; Leesa B,22,0,30,8
1649908866386,MATH 142A,A01,083219,Chow; Bennett,1,1,30,29
1649908866386,MATH 142A,A02,083220,Chow; Bennett,13,0,30,17
1649908866386,MATH 142A,B01,083221,Chow; Bennett,0,0,30,30
1649908866386,MATH 142A,B02,083222,Chow; Bennett,5,0,30,25
1649908872410,MATH 193A,A01,083224,Staff,0,3,30,30
1649908872410,MATH 193A,A02,083225,Staff,0,4,30,30
1649908872410,MATH 193A,A03,083781,Staff,5,0,30,25
1649908872410,MATH 193A,A04,083782,Staff,17,0,30,13
1649908878433,MATH 197,001,091859,McAuley; Julian John,9999,0,9999,0
1649908884494,COGS 9,A01,083615,Staff,18,0,60,42
1649908890521,COGS 11,A01,083617,Boyle; Mary E. T.,35,0,40,5
1649908896548,COGS 13,A01,083071,Staff,0,9,40,40
1649908902571,COGS 14A,A01,092681,Staff,67,0,100,33
1649908908595,COGS 14B,A01,083073,Cheng; Tzu-Han,25,0,50,25
1649908914619,COGS 17,A01,092677,Staff,63,0,75,12
1649908920645,COGS 100,A01,083619,Staff,0,1,60,60
1649908926673,COGS 101A,A01,083621,Davis; Joshua Daniel,0,5,60,60
1649908932694,COGS 101B,A01,091572,Staff,32,0,60,28
1649908938721,COGS 101C,A01,083625,Delgado; Tania,24,0,30,6
1649908944831,COGS 107A,A01,083627,Boyle; Mary E. T.,15,0,60,45
1649908950854,COGS 118A,A01,083075,Staff,21,0,60,39
1649908956881,CSE 3,A50,083646,Miranda; Gregory Joseph,26,0,38,12
1649908956881,CSE 3,A51,083647,Miranda; Gregory Joseph,37,0,37,0
1649908962905,CSE 8A,A50,083650,Miranda; Gregory Joseph,7,0,40,33
1649908968935,CSE 11,A01,083080,Cao; Yingjun,0,26,40,40
1649908974958,CSE 12,A01,083652,Staff,58,0,100,42
1649908981051,CSE 15L,A01,083654,Staff,19,0,50,31
1649908981051,CSE 15L,A02,083655,Staff,47,0,50,3
1649908987079,CSE 20,A01,083657,Staff,68,0,80,12
1649908993103,CSE 30,A01,083084,Eldon; John,1,19,40,39
1649908999126,CSE 100,A01,083659,Cao; Yingjun,2,26,50,48
1649909005149,CSE 134B,A01,083661,Powell; Thomas Allan,2,23,65,63
1649909011173,CSE 140,A01,083663,Staff,25,0,75,50
1649909017195,CSE 140L,A01,083088,Eldon; John,19,0,75,56
1649909023218,CSE 175,A01,083665,Kumar; Rakesh,12,0,25,13
1649909029244,CSE 190,A00,092507,Dubnov; Shlomo,14,0,15,1
1649909035266,ECE 45,A01,083139,Staff,10,0,40,30
1649909041289,ECE 65,A50,083695,Staff,9,0,30,21
1649909047310,ECE 109,A01,091882,Touri; Behrouz,58,0,70,12
1649909053342,ECE 180,A00,083140,Abi Samra; Nicholas Camill,26,0,30,4
1649909053342,ECE 180,B00,083141,Abi Samra; Nicholas Camill,13,0,30,17
1649909059375,MATH 10A,A01,083735,Patchell; Gregory David,22,0,30,8
1649909059375,MATH 10A,A02,083736,Patchell; Gregory David,28,0,30,2
1649909059375,MATH 10A,A03,083737,Patchell; Gregory David,28,0,30,2
1649909065397,MATH 10B,A01,083207,Staff,13,0,30,17
1649909065397,MATH 10B,A02,083208,Staff,25,0,30,5
1649909065397,MATH 10B,B01,083739,Staff,25,0,30,5
1649909065397,MATH 10B,B02,083740,Staff,30,0,30,0
1649909071422,MATH 18,A01,083743,Staff,22,0,30,8
1649909071422,MATH 18,A02,083744,Staff,29,0,30,1
1649909071422,MATH 18,A03,083745,Staff,29,0,30,1
1649909071422,MATH 18,A04,083746,Staff,28,0,30,2
1649909071422,MATH 18,B01,083748,Staff,7,0,30,23
1649909071422,MATH 18,B02,083749,Staff,26,0,30,4
1649909071422,MATH 18,B03,083750,Staff,28,0,30,2
1649909071422,MATH 18,B04,083751,Staff,27,0,30,3
1649909077446,MATH 20A,A01,083754,Staff,37,0,40,3
1649909083470,MATH 20B,A01,083756,Staff,21,0,30,9
1649909083470,MATH 20B,A02,083757,Staff,30,0,30,0
1649909089493,MATH 20C,A01,083760,Staff,22,0,30,8
1649909089493,MATH 20C,A02,083761,Staff,24,0,30,6
1649909089493,MATH 20C,B01,083762,Staff,28,0,30,2
1649909089493,MATH 20C,B02,083763,Staff,30,0,30,0
1649909095520,MATH 20D,A01,083765,Staff,21,0,30,9
1649909095520,MATH 20D,A02,083766,Staff,30,0,30,0
1649909095520,MATH 20D,A03,083767,Staff,30,0,30,0
1649909101556,MATH 20E,A01,083771,Staff,14,0,30,16
1649909101556,MATH 20E,A02,083772,Staff,25,0,30,5
1649909101556,MATH 20E,B01,083773,Staff,19,0,30,11
1649909101556,MATH 20E,B02,083774,Staff,29,0,30,1
1649909107580,MATH 103A,A01,083777,Staff,0,1,30,30
1649909107580,MATH 103A,A02,083778,Staff,0,3,30,30
1649909107580,MATH 103A,B01,083779,Staff,0,0,30,30
1649909107580,MATH 103A,B02,083780,Staff,20,0,30,10
1649909113609,MATH 105,A01,085443,Staff,0,5,30,30
1649909119635,MATH 109,A01,083213,Anzaldo; Leesa B,17,0,30,13
1649909119635,MATH 109,A02,083214,Anzaldo; Leesa B,11,0,30,19
1649909119635,MATH 109,B01,083215,Anzaldo; Leesa B,26,0,30,4
1649909119635,MATH 109,B02,083216,Anzaldo; Leesa B,22,0,30,8
1649909125662,MATH 142A,A01,083219,Chow; Bennett,1,1,30,29
1649909125662,MATH 142A,A02,083220,Chow; Bennett,13,0,30,17
1649909125662,MATH 142A,B01,083221,Chow; Bennett,0,0,30,30
1649909125662,MATH 142A,B02,083222,Chow; Bennett,5,0,30,25
1649909131686,MATH 193A,A01,083224,Staff,0,3,30,30
1649909131686,MATH 193A,A02,083225,Staff,0,4,30,30
1649909131686,MATH 193A,A03,083781,Staff,5,0,30,25
1649909131686,MATH 193A,A04,083782,Staff,17,0,30,13
1649909137709,MATH 197,001,091859,McAuley; Julian John,9999,0,9999,0
1649909143766,COGS 9,A01,083615,Staff,18,0,60,42
1649909149789,COGS 11,A01,083617,Boyle; Mary E. T.,35,0,40,5
1649909155812,COGS 13,A01,083071,Staff,0,9,40,40
1649909161834,COGS 14A,A01,092681,Staff,67,0,100,33
1649909167864,COGS 14B,A01,083073,Cheng; Tzu-Han,25,0,50,25
1649909173888,COGS 17,A01,092677,Staff,63,0,75,12
1649909179911,COGS 100,A01,083619,Staff,0,1,60,60
1649909185933,COGS 101A,A01,083621,Davis; Joshua Daniel,0,5,60,60
1649909191957,COGS 101B,A01,091572,Staff,32,0,60,28
1649909197981,COGS 101C,A01,083625,Delgado; Tania,24,0,30,6
1649909204003,COGS 107A,A01,083627,Boyle; Mary E. T.,15,0,60,45
1649909210026,COGS 118A,A01,083075,Staff,21,0,60,39
1649909216058,CSE 3,A50,083646,Miranda; Gregory Joseph,26,0,38,12
1649909216058,CSE 3,A51,083647,Miranda; Gregory Joseph,37,0,37,0
1649909222091,CSE 8A,A50,083650,Miranda; Gregory Joseph,7,0,40,33
1649909228115,CSE 11,A01,083080,Cao; Yingjun,0,26,40,40
1649909234140,CSE 12,A01,083652,Staff,58,0,100,42
1649909240162,CSE 15L,A01,083654,Staff,19,0,50,31
1649909240162,CSE 15L,A02,083655,Staff,47,0,50,3
1649909246196,CSE 20,A01,083657,Staff,68,0,80,12
1649909252223,CSE 30,A01,083084,Eldon; John,1,19,40,39
1649909258254,CSE 100,A01,083659,Cao; Yingjun,2,26,50,48
1649909264280,CSE 134B,A01,083661,Powell; Thomas Allan,2,23,65,63
1649909270308,CSE 140,A01,083663,Staff,25,0,75,50
1649909276339,CSE 140L,A01,083088,Eldon; John,19,0,75,56
1649909282366,CSE 175,A01,083665,Kumar; Rakesh,12,0,25,13
1649909288390,CSE 190,A00,092507,Dubnov; Shlomo,14,0,15,1
1649909294414,ECE 45,A01,083139,Staff,10,0,40,30
1649909300454,ECE 65,A50,083695,Staff,9,0,30,21
1649909306477,ECE 109,A01,091882,Touri; Behrouz,58,0,70,12
1649909312503,ECE 180,A00,083140,Abi Samra; Nicholas Camill,26,0,30,4
1649909312503,ECE 180,B00,083141,Abi Samra; Nicholas Camill,13,0,30,17
1649909318526,MATH 10A,A01,083735,Patchell; Gregory David,22,0,30,8
1649909318526,MATH 10A,A02,083736,Patchell; Gregory David,28,0,30,2
1649909318526,MATH 10A,A03,083737,Patchell; Gregory David,28,0,30,2
1649909324550,MATH 10B,A01,083207,Staff,13,0,30,17
1649909324550,MATH 10B,A02,083208,Staff,25,0,30,5
1649909324550,MATH 10B,B01,083739,Staff,25,0,30,5
1649909324550,MATH 10B,B02,083740,Staff,30,0,30,0
1649909330575,MATH 18,A01,083743,Staff,22,0,30,8
1649909330575,MATH 18,A02,083744,Staff,29,0,30,1
1649909330575,MATH 18,A03,083745,Staff,29,0,30,1
1649909330575,MATH 18,A04,083746,Staff,28,0,30,2
1649909330575,MATH 18,B01,083748,Staff,7,0,30,23
1649909330575,MATH 18,B02,083749,Staff,26,0,30,4
1649909330575,MATH 18,B03,083750,Staff,28,0,30,2
1649909330575,MATH 18,B04,083751,Staff,27,0,30,3
1649909336599,MATH 20A,A01,083754,Staff,37,0,40,3
1649909342621,MATH 20B,A01,083756,Staff,21,0,30,9
1649909342621,MATH 20B,A02,083757,Staff,30,0,30,0
1649909348659,MATH 20C,A01,083760,Staff,22,0,30,8
1649909348659,MATH 20C,A02,083761,Staff,24,0,30,6
1649909348659,MATH 20C,B01,083762,Staff,28,0,30,2
1649909348659,MATH 20C,B02,083763,Staff,30,0,30,0
1649909354684,MATH 20D,A01,083765,Staff,21,0,30,9
1649909354684,MATH 20D,A02,083766,Staff,30,0,30,0
1649909354684,MATH 20D,A03,083767,Staff,30,0,30,0
1649909360713,MATH 20E,A01,083771,Staff,14,0,30,16
1649909360713,MATH 20E,A02,083772,Staff,25,0,30,5
1649909360713,MATH 20E,B01,083773,Staff,19,0,30,11
1649909360713,MATH 20E,B02,083774,Staff,29,0,30,1
1649909366736,MATH 103A,A01,083777,Staff,0,1,30,30
1649909366736,MATH 103A,A02,083778,Staff,0,3,30,30
1649909366736,MATH 103A,B01,083779,Staff,0,0,30,30
1649909366736,MATH 103A,B02,083780,Staff,20,0,30,10
1649909372760,MATH 105,A01,085443,Staff,0,5,30,30
1649909378788,MATH 109,A01,083213,Anzaldo; Leesa B,17,0,30,13
1649909378788,MATH 109,A02,083214,Anzaldo; Leesa B,11,0,30,19
1649909378788,MATH 109,B01,083215,Anzaldo; Leesa B,26,0,30,4
1649909378788,MATH 109,B02,083216,Anzaldo; Leesa B,22,0,30,8
1649909384811,MATH 142A,A01,083219,Chow; Bennett,1,1,30,29
1649909384811,MATH 142A,A02,083220,Chow; Bennett,12,0,30,18
1649909384811,MATH 142A,B01,083221,Chow; Bennett,0,0,30,30
1649909384811,MATH 142A,B02,083222,Chow; Bennett,5,0,30,25
1649909390839,MATH 193A,A01,083224,Staff,0,3,30,30
1649909390839,MATH 193A,A02,083225,Staff,0,4,30,30
1649909390839,MATH 193A,A03,083781,Staff,5,0,30,25
1649909390839,MATH 193A,A04,083782,Staff,17,0,30,13
1649909396864,MATH 197,001,091859,McAuley; Julian John,9999,0,9999,0
1649909402919,COGS 9,A01,083615,Staff,18,0,60,42
1649909408945,COGS 11,A01,083617,Boyle; Mary E. T.,35,0,40,5
1649909414971,COGS 13,A01,083071,Staff,0,9,40,40
1649909420995,COGS 14A,A01,092681,Staff,67,0,100,33
1649909427019,COGS 14B,A01,083073,Cheng; Tzu-Han,25,0,50,25
1649909433041,COGS 17,A01,092677,Staff,63,0,75,12
1649909439067,COGS 100,A01,083619,Staff,0,1,60,60
1649909445095,COGS 101A,A01,083621,Davis; Joshua Daniel,0,5,60,60
1649909451120,COGS 101B,A01,091572,Staff,32,0,60,28
1649909457154,COGS 101C,A01,083625,Delgado; Tania,24,0,30,6
1649909463189,COGS 107A,A01,083627,Boyle; Mary E. T.,15,0,60,45
1649909469213,COGS 118A,A01,083075,Staff,21,0,60,39
1649909475242,CSE 3,A50,083646,Miranda; Gregory Joseph,26,0,38,12
1649909475242,CSE 3,A51,083647,Miranda; Gregory Joseph,37,0,37,0
1649909481268,CSE 8A,A50,083650,Miranda; Gregory Joseph,7,0,40,33
1649909487297,CSE 11,A01,083080,Cao; Yingjun,0,26,40,40
1649909493391,CSE 12,A01,083652,Staff,58,0,100,42
1649909499416,CSE 15L,A01,083654,Staff,19,0,50,31
1649909499416,CSE 15L,A02,083655,Staff,47,0,50,3
1649909505451,CSE 20,A01,083657,Staff,68,0,80,12
1649909511476,CSE 30,A01,083084,Eldon; John,1,19,40,39
1649909517500,CSE 100,A01,083659,Cao; Yingjun,2,26,50,48
1649909523526,CSE 134B,A01,083661,Powell; Thomas Allan,2,23,65,63
1649909529553,CSE 140,A01,083663,Staff,25,0,75,50
1649909535575,CSE 140L,A01,083088,Eldon; John,19,0,75,56
1649909541669,CSE 175,A01,083665,Kumar; Rakesh,12,0,25,13
1649909547696,CSE 190,A00,092507,Dubnov; Shlomo,14,0,15,1
1649909553724,ECE 45,A01,083139,Staff,10,0,40,30
1649909559747,ECE 65,A50,083695,Staff,9,0,30,21
1649909565774,ECE 109,A01,091882,Touri; Behrouz,58,0,70,12
1649909571801,ECE 180,A00,083140,Abi Samra; Nicholas Camill,26,0,30,4
1649909571801,ECE 180,B00,083141,Abi Samra; Nicholas Camill,13,0,30,17
1649909577825,MATH 10A,A01,083735,Patchell; Gregory David,22,0,30,8
1649909577825,MATH 10A,A02,083736,Patchell; Gregory David,28,0,30,2
1649909577825,MATH 10A,A03,083737,Patchell; Gregory David,28,0,30,2
1649909583849,MATH 10B,A01,083207,Staff,13,0,30,17
1649909583849,MATH 10B,A02,083208,Staff,25,0,30,5
1649909583849,MATH 10B,B01,083739,Staff,25,0,30,5
1649909583849,MATH 10B,B02,083740,Staff,30,0,30,0
1649909589877,MATH 18,A01,083743,Staff,22,0,30,8
1649909589877,MATH 18,A02,083744,Staff,29,0,30,1
1649909589877,MATH 18,A03,083745,Staff,29,0,30,1
1649909589877,MATH 18,A04,083746,Staff,28,0,30,2
1649909589877,MATH 18,B01,083748,Staff,7,0,30,23
1649909589877,MATH 18,B02,083749,Staff,26,0,30,4
1649909589877,MATH 18,B03,083750,Staff,28,0,30,2
1649909589877,MATH 18,B04,083751,Staff,27,0,30,3
1649909595900,MATH 20A,A01,083754,Staff,37,0,40,3
1649909601926,MATH 20B,A01,083756,Staff,21,0,30,9
1649909601926,MATH 20B,A02,083757,Staff,30,0,30,0
1649909607949,MATH 20C,A01,083760,Staff,22,0,30,8
1649909607949,MATH 20C,A02,083761,Staff,24,0,30,6
1649909607949,MATH 20C,B01,083762,Staff,28,0,30,2
1649909607949,MATH 20C,B02,083763,Staff,30,0,30,0
1649909613976,MATH 20D,A01,083765,Staff,21,0,30,9
1649909613976,MATH 20D,A02,083766,Staff,30,0,30,0
1649909613976,MATH 20D,A03,083767,Staff,30,0,30,0
1649909619999,MATH 20E,A01,083771,Staff,14,0,30,16
1649909619999,MATH 20E,A02,083772,Staff,25,0,30,5
1649909619999,MATH 20E,B01,083773,Staff,19,0,30,11
1649909619999,MATH 20E,B02,083774,Staff,29,0,30,1
1649909626036,MATH 103A,A01,083777,Staff,0,1,30,30
1649909626036,MATH 103A,A02,083778,Staff,0,3,30,30
1649909626036,MATH 103A,B01,083779,Staff,0,0,30,30
1649909626036,MATH 103A,B02,083780,Staff,20,0,30,10
1649909632060,MATH 105,A01,085443,Staff,0,5,30,30
1649909638087,MATH 109,A01,083213,Anzaldo; Leesa B,17,0,30,13
1649909638087,MATH 109,A02,083214,Anzaldo; Leesa B,11,0,30,19
1649909638087,MATH 109,B01,083215,Anzaldo; Leesa B,26,0,30,4
1649909638087,MATH 109,B02,083216,Anzaldo; Leesa B,22,0,30,8
1649909644110,MATH 142A,A01,083219,Chow; Bennett,1,1,30,29
1649909644110,MATH 142A,A02,083220,Chow; Bennett,12,0,30,18
1649909644110,MATH 142A,B01,083221,Chow; Bennett,0,0,30,30
1649909644110,MATH 142A,B02,083222,Chow; Bennett,5,0,30,25
1649909650135,MATH 193A,A01,083224,Staff,0,3,30,30
1649909650135,MATH 193A,A02,083225,Staff,0,4,30,30
1649909650135,MATH 193A,A03,083781,Staff,5,0,30,25
1649909650135,MATH 193A,A04,083782,Staff,17,0,30,13
1649909656161,MATH 197,001,091859,McAuley; Julian John,9999,0,9999,0
1649909662220,COGS 9,A01,083615,Staff,18,0,60,42
1649909668243,COGS 11,A01,083617,Boyle; Mary E. T.,35,0,40,5
1649909674279,COGS 13,A01,083071,Staff,0,9,40,40
1649909680302,COGS 14A,A01,092681,Staff,67,0,100,33
1649909686331,COGS 14B,A01,083073,Cheng; Tzu-Han,25,0,50,25
1649909692363,COGS 17,A01,092677,Staff,63,0,75,12
1649909698391,COGS 100,A01,083619,Staff,0,1,60,60
1649909704415,COGS 101A,A01,083621,Davis; Joshua Daniel,0,5,60,60
1649909710442,COGS 101B,A01,091572,Staff,32,0,60,28
1649909716468,COGS 101C,A01,083625,Delgado; Tania,24,0,30,6
1649909722494,COGS 107A,A01,083627,Boyle; Mary E. T.,15,0,60,45
1649909728542,COGS 118A,A01,083075,Staff,21,0,60,39
1649909734570,CSE 3,A50,083646,Miranda; Gregory Joseph,26,0,38,12
1649909734570,CSE 3,A51,083647,Miranda; Gregory Joseph,37,0,37,0
1649909740593,CSE 8A,A50,083650,Miranda; Gregory Joseph,7,0,40,33
1649909746620,CSE 11,A01,083080,Cao; Yingjun,0,26,40,40
1649909752646,CSE 12,A01,083652,Staff,58,0,100,42
1649909758673,CSE 15L,A01,083654,Staff,19,0,50,31
1649909758673,CSE 15L,A02,083655,Staff,47,0,50,3
1649909764696,CSE 20,A01,083657,Staff,68,0,80,12
1649909770721,CSE 30,A01,083084,Eldon; John,1,19,40,39
1649909776753,CSE 100,A01,083659,Cao; Yingjun,2,26,50,48
1649909782783,CSE 134B,A01,083661,Powell; Thomas Allan,2,23,65,63
1649909788808,CSE 140,A01,083663,Staff,25,0,75,50
1649909794839,CSE 140L,A01,083088,Eldon; John,19,0,75,56
1649909800863,CSE 175,A01,083665,Kumar; Rakesh,12,0,25,13
1649909806894,CSE 190,A00,092507,Dubnov; Shlomo,14,0,15,1
1649909812920,ECE 45,A01,083139,Staff,10,0,40,30
1649909818945,ECE 65,A50,083695,Staff,9,0,30,21
1649909824972,ECE 109,A01,091882,Touri; Behrouz,58,0,70,12
1649909831000,ECE 180,A00,083140,Abi Samra; Nicholas Camill,26,0,30,4
1649909831000,ECE 180,B00,083141,Abi Samra; Nicholas Camill,13,0,30,17
1649909837024,MATH 10A,A01,083735,Patchell; Gregory David,21,0,30,9
1649909837024,MATH 10A,A02,083736,Patchell; Gregory David,28,0,30,2
1649909837024,MATH 10A,A03,083737,Patchell; Gregory David,28,0,30,2
1649909843052,MATH 10B,A01,083207,Staff,13,0,30,17
1649909843052,MATH 10B,A02,083208,Staff,25,0,30,5
1649909843052,MATH 10B,B01,083739,Staff,25,0,30,5
1649909843052,MATH 10B,B02,083740,Staff,30,0,30,0
1649909849077,MATH 18,A01,083743,Staff,22,0,30,8
1649909849077,MATH 18,A02,083744,Staff,29,0,30,1
1649909849077,MATH 18,A03,083745,Staff,29,0,30,1
1649909849077,MATH 18,A04,083746,Staff,28,0,30,2
1649909849077,MATH 18,B01,083748,Staff,7,0,30,23
1649909849077,MATH 18,B02,083749,Staff,26,0,30,4
1649909849077,MATH 18,B03,083750,Staff,28,0,30,2
1649909849077,MATH 18,B04,083751,Staff,27,0,30,3
1649909855101,MATH 20A,A01,083754,Staff,37,0,40,3
1649909861126,MATH 20B,A01,083756,Staff,21,0,30,9
1649909861126,MATH 20B,A02,083757,Staff,30,0,30,0
1649909867149,MATH 20C,A01,083760,Staff,22,0,30,8
1649909867149,MATH 20C,A02,083761,Staff,24,0,30,6
1649909867149,MATH 20C,B01,083762,Staff,28,0,30,2
1649909867149,MATH 20C,B02,083763,Staff,30,0,30,0
1649909873177,MATH 20D,A01,083765,Staff,21,0,30,9
1649909873177,MATH 20D,A02,083766,Staff,30,0,30,0
1649909873177,MATH 20D,A03,083767,Staff,30,0,30,0
1649909879202,MATH 20E,A01,083771,Staff,14,0,30,16
1649909879202,MATH 20E,A02,083772,Staff,25,0,30,5
1649909879202,MATH 20E,B01,083773,Staff,19,0,30,11
1649909879202,MATH 20E,B02,083774,Staff,29,0,30,1
1649909885233,MATH 103A,A01,083777,Staff,0,1,30,30
1649909885233,MATH 103A,A02,083778,Staff,0,3,30,30
1649909885233,MATH 103A,B01,083779,Staff,0,0,30,30
1649909885233,MATH 103A,B02,083780,Staff,20,0,30,10
1649909891256,MATH 105,A01,085443,Staff,0,5,30,30
1649909897280,MATH 109,A01,083213,Anzaldo; Leesa B,17,0,30,13
1649909897280,MATH 109,A02,083214,Anzaldo; Leesa B,11,0,30,19
1649909897280,MATH 109,B01,083215,Anzaldo; Leesa B,26,0,30,4
1649909897280,MATH 109,B02,083216,Anzaldo; Leesa B,22,0,30,8
1649909903307,MATH 142A,A01,083219,Chow; Bennett,1,1,30,29
1649909903307,MATH 142A,A02,083220,Chow; Bennett,12,0,30,18
1649909903307,MATH 142A,B01,083221,Chow; Bennett,0,0,30,30
1649909903307,MATH 142A,B02,083222,Chow; Bennett,5,0,30,25
1649909909336,MATH 193A,A01,083224,Staff,0,3,30,30
1649909909336,MATH 193A,A02,083225,Staff,0,4,30,30
1649909909336,MATH 193A,A03,083781,Staff,5,0,30,25
1649909909336,MATH 193A,A04,083782,Staff,17,0,30,13
1649909915365,MATH 197,001,091859,McAuley; Julian John,9999,0,9999,0
1649909921422,COGS 9,A01,083615,Staff,18,0,60,42
1649909927445,COGS 11,A01,083617,Boyle; Mary E. T.,35,0,40,5
1649909933468,COGS 13,A01,083071,Staff,0,9,40,40
1649909939493,COGS 14A,A01,092681,Staff,67,0,100,33
1649909945516,COGS 14B,A01,083073,Cheng; Tzu-Han,25,0,50,25
1649909951542,COGS 17,A01,092677,Staff,63,0,75,12
1649909957568,COGS 100,A01,083619,Staff,0,1,60,60
1649909963591,COGS 101A,A01,083621,Davis; Joshua Daniel,0,5,60,60
1649909969615,COGS 101B,A01,091572,Staff,32,0,60,28
1649909975641,COGS 101C,A01,083625,Delgado; Tania,24,0,30,6
1649909981664,COGS 107A,A01,083627,Boyle; Mary E. T.,15,0,60,45
1649909987687,COGS 118A,A01,083075,Staff,21,0,60,39
1649909993715,CSE 3,A50,083646,Miranda; Gregory Joseph,26,0,38,12
1649909993715,CSE 3,A51,083647,Miranda; Gregory Joseph,37,0,37,0
1649909999745,CSE 8A,A50,083650,Miranda; Gregory Joseph,7,0,40,33
1649910005768,CSE 11,A01,083080,Cao; Yingjun,0,26,40,40
1649910011794,CSE 12,A01,083652,Staff,58,0,100,42
1649910017823,CSE 15L,A01,083654,Staff,19,0,50,31
1649910017823,CSE 15L,A02,083655,Staff,47,0,50,3
1649910023848,CSE 20,A01,083657,Staff,68,0,80,12
1649910029872,CSE 30,A01,083084,Eldon; John,1,19,40,39
1649910035897,CSE 100,A01,083659,Cao; Yingjun,2,26,50,48
1649910041924,CSE 134B,A01,083661,Powell; Thomas Allan,2,23,65,63
1649910047954,CSE 140,A01,083663,Staff,25,0,75,50
1649910053977,CSE 140L,A01,083088,Eldon; John,19,0,75,56
1649910060001,CSE 175,A01,083665,Kumar; Rakesh,12,0,25,13
1649910066025,CSE 190,A00,092507,Dubnov; Shlomo,14,0,15,1
1649910072052,ECE 45,A01,083139,Staff,10,0,40,30
1649910078079,ECE 65,A50,083695,Staff,9,0,30,21
1649910084110,ECE 109,A01,091882,Touri; Behrouz,57,0,70,13
1649910090137,ECE 180,A00,083140,Abi Samra; Nicholas Camill,26,0,30,4
1649910090137,ECE 180,B00,083141,Abi Samra; Nicholas Camill,13,0,30,17
1649910096162,MATH 10A,A01,083735,Patchell; Gregory David,21,0,30,9
1649910096162,MATH 10A,A02,083736,Patchell; Gregory David,28,0,30,2
1649910096162,MATH 10A,A03,083737,Patchell; Gregory David,28,0,30,2
1649910102185,MATH 10B,A01,083207,Staff,13,0,30,17
1649910102185,MATH 10B,A02,083208,Staff,25,0,30,5
1649910102185,MATH 10B,B01,083739,Staff,25,0,30,5
1649910102185,MATH 10B,B02,083740,Staff,30,0,30,0
1649910108215,MATH 18,A01,083743,Staff,22,0,30,8
1649910108215,MATH 18,A02,083744,Staff,29,0,30,1
1649910108215,MATH 18,A03,083745,Staff,29,0,30,1
1649910108215,MATH 18,A04,083746,Staff,28,0,30,2
1649910108215,MATH 18,B01,083748,Staff,7,0,30,23
1649910108215,MATH 18,B02,083749,Staff,26,0,30,4
1649910108215,MATH 18,B03,083750,Staff,28,0,30,2
1649910108215,MATH 18,B04,083751,Staff,27,0,30,3
1649910114240,MATH 20A,A01,083754,Staff,37,0,40,3
1649910120267,MATH 20B,A01,083756,Staff,21,0,30,9
1649910120267,MATH 20B,A02,083757,Staff,30,0,30,0
1649910126290,MATH 20C,A01,083760,Staff,22,0,30,8
1649910126290,MATH 20C,A02,083761,Staff,24,0,30,6
1649910126290,MATH 20C,B01,083762,Staff,28,0,30,2
1649910126290,MATH 20C,B02,083763,Staff,30,0,30,0
1649910132313,MATH 20D,A01,083765,Staff,21,0,30,9
1649910132313,MATH 20D,A02,083766,Staff,30,0,30,0
1649910132313,MATH 20D,A03,083767,Staff,30,0,30,0
1649910138417,MATH 20E,A01,083771,Staff,14,0,30,16
1649910138417,MATH 20E,A02,083772,Staff,25,0,30,5
1649910138417,MATH 20E,B01,083773,Staff,19,0,30,11
1649910138417,MATH 20E,B02,083774,Staff,29,0,30,1
1649910144444,MATH 103A,A01,083777,Staff,0,1,30,30
1649910144444,MATH 103A,A02,083778,Staff,0,3,30,30
1649910144444,MATH 103A,B01,083779,Staff,0,0,30,30
1649910144444,MATH 103A,B02,083780,Staff,19,0,30,11
1649910150472,MATH 105,A01,085443,Staff,0,5,30,30
1649910156499,MATH 109,A01,083213,Anzaldo; Leesa B,17,0,30,13
1649910156499,MATH 109,A02,083214,Anzaldo; Leesa B,11,0,30,19
1649910156499,MATH 109,B01,083215,Anzaldo; Leesa B,26,0,30,4
1649910156499,MATH 109,B02,083216,Anzaldo; Leesa B,22,0,30,8
1649910162527,MATH 142A,A01,083219,Chow; Bennett,1,1,30,29
1649910162527,MATH 142A,A02,083220,Chow; Bennett,12,0,30,18
1649910162527,MATH 142A,B01,083221,Chow; Bennett,0,0,30,30
1649910162527,MATH 142A,B02,083222,Chow; Bennett,5,0,30,25
1649910168551,MATH 193A,A01,083224,Staff,0,3,30,30
1649910168551,MATH 193A,A02,083225,Staff,0,4,30,30
1649910168551,MATH 193A,A03,083781,Staff,5,0,30,25
1649910168551,MATH 193A,A04,083782,Staff,17,0,30,13
1649910174577,MATH 197,001,091859,McAuley; Julian John,9999,0,9999,0
1649910180631,COGS 9,A01,083615,Staff,18,0,60,42
1649910186678,COGS 11,A01,083617,Boyle; Mary E. T.,35,0,40,5
1649910192704,COGS 13,A01,083071,Staff,0,9,40,40
1649910198726,COGS 14A,A01,092681,Staff,67,0,100,33
1649910204748,COGS 14B,A01,083073,Cheng; Tzu-Han,25,0,50,25
1649910210773,COGS 17,A01,092677,Staff,64,0,75,11
1649910216803,COGS 100,A01,083619,Staff,0,1,60,60
1649910222827,COGS 101A,A01,083621,Davis; Joshua Daniel,0,5,60,60
1649910228857,COGS 101B,A01,091572,Staff,32,0,60,28
1649910234884,COGS 101C,A01,083625,Delgado; Tania,24,0,30,6
1649910240908,COGS 107A,A01,083627,Boyle; Mary E. T.,15,0,60,45
1649910246932,COGS 118A,A01,083075,Staff,21,0,60,39
1649910252961,CSE 3,A50,083646,Miranda; Gregory Joseph,26,0,38,12
1649910252961,CSE 3,A51,083647,Miranda; Gregory Joseph,37,0,37,0
1649910258985,CSE 8A,A50,083650,Miranda; Gregory Joseph,7,0,40,33
1649910265012,CSE 11,A01,083080,Cao; Yingjun,0,26,40,40
1649910271035,CSE 12,A01,083652,Staff,58,0,100,42
1649910277063,CSE 15L,A01,083654,Staff,20,0,50,30
1649910277063,CSE 15L,A02,083655,Staff,47,0,50,3
1649910283085,CSE 20,A01,083657,Staff,68,0,80,12
1649910289115,CSE 30,A01,083084,Eldon; John,1,19,40,39
1649910295139,CSE 100,A01,083659,Cao; Yingjun,2,26,50,48
1649910301167,CSE 134B,A01,083661,Powell; Thomas Allan,2,23,65,63
1649910307190,CSE 140,A01,083663,Staff,25,0,75,50
1649910313212,CSE 140L,A01,083088,Eldon; John,19,0,75,56
1649910319234,CSE 175,A01,083665,Kumar; Rakesh,12,0,25,13
1649910325261,CSE 190,A00,092507,Dubnov; Shlomo,14,0,15,1
1649910331297,ECE 45,A01,083139,Staff,10,0,40,30
1649910337326,ECE 65,A50,083695,Staff,9,0,30,21
1649910343350,ECE 109,A01,091882,Touri; Behrouz,57,0,70,13
1649910349376,ECE 180,A00,083140,Abi Samra; Nicholas Camill,26,0,30,4
1649910349376,ECE 180,B00,083141,Abi Samra; Nicholas Camill,13,0,30,17
1649910355407,MATH 10A,A01,083735,Patchell; Gregory David,21,0,30,9
1649910355407,MATH 10A,A02,083736,Patchell; Gregory David,28,0,30,2
1649910355407,MATH 10A,A03,083737,Patchell; Gregory David,28,0,30,2
1649910361434,MATH 10B,A01,083207,Staff,13,0,30,17
1649910361434,MATH 10B,A02,083208,Staff,25,0,30,5
1649910361434,MATH 10B,B01,083739,Staff,25,0,30,5
1649910361434,MATH 10B,B02,083740,Staff,30,0,30,0
1649910367463,MATH 18,A01,083743,Staff,22,0,30,8
1649910367463,MATH 18,A02,083744,Staff,29,0,30,1
1649910367463,MATH 18,A03,083745,Staff,29,0,30,1
1649910367463,MATH 18,A04,083746,Staff,28,0,30,2
1649910367463,MATH 18,B01,083748,Staff,7,0,30,23
1649910367463,MATH 18,B02,083749,Staff,26,0,30,4
1649910367463,MATH 18,B03,083750,Staff,28,0,30,2
1649910367463,MATH 18,B04,083751,Staff,27,0,30,3
1649910373497,MATH 20A,A01,083754,Staff,37,0,40,3
1649910379525,MATH 20B,A01,083756,Staff,21,0,30,9
1649910379525,MATH 20B,A02,083757,Staff,30,0,30,0
1649910385549,MATH 20C,A01,083760,Staff,22,0,30,8
1649910385549,MATH 20C,A02,083761,Staff,24,0,30,6
1649910385549,MATH 20C,B01,083762,Staff,28,0,30,2
1649910385549,MATH 20C,B02,083763,Staff,30,0,30,0
1649910391572,MATH 20D,A01,083765,Staff,21,0,30,9
1649910391572,MATH 20D,A02,083766,Staff,30,0,30,0
1649910391572,MATH 20D,A03,083767,Staff,30,0,30,0
1649910397596,MATH 20E,A01,083771,Staff,14,0,30,16
1649910397596,MATH 20E,A02,083772,Staff,25,0,30,5
1649910397596,MATH 20E,B01,083773,Staff,19,0,30,11
1649910397596,MATH 20E,B02,083774,Staff,29,0,30,1
1649910403623,MATH 103A,A01,083777,Staff,0,1,30,30
1649910403623,MATH 103A,A02,083778,Staff,0,3,30,30
1649910403623,MATH 103A,B01,083779,Staff,0,0,30,30
1649910403623,MATH 103A,B02,083780,Staff,19,0,30,11
1649910409651,MATH 105,A01,085443,Staff,0,5,30,30
1649910415676,MATH 109,A01,083213,Anzaldo; Leesa B,17,0,30,13
1649910415676,MATH 109,A02,083214,Anzaldo; Leesa B,11,0,30,19
1649910415676,MATH 109,B01,083215,Anzaldo; Leesa B,26,0,30,4
1649910415676,MATH 109,B02,083216,Anzaldo; Leesa B,22,0,30,8
1649910421700,MATH 142A,A01,083219,Chow; Bennett,1,1,30,29
1649910421700,MATH 142A,A02,083220,Chow; Bennett,12,0,30,18
1649910421700,MATH 142A,B01,083221,Chow; Bennett,0,0,30,30
1649910421700,MATH 142A,B02,083222,Chow; Bennett,5,0,30,25
1649910427722,MATH 193A,A01,083224,Staff,0,3,30,30
1649910427722,MATH 193A,A02,083225,Staff,0,4,30,30
1649910427722,MATH 193A,A03,083781,Staff,5,0,30,25
1649910427722,MATH 193A,A04,083782,Staff,17,0,30,13
1649910433745,MATH 197,001,091859,McAuley; Julian John,9999,0,9999,0
1649910439811,COGS 9,A01,083615,Staff,18,0,60,42
1649910445835,COGS 11,A01,083617,Boyle; Mary E. T.,35,0,40,5
1649910451861,COGS 13,A01,083071,Staff,0,9,40,40
1649910457885,COGS 14A,A01,092681,Staff,67,0,100,33
1649910463912,COGS 14B,A01,083073,Cheng; Tzu-Han,25,0,50,25
1649910469938,COGS 17,A01,092677,Staff,64,0,75,11
1649910475963,COGS 100,A01,083619,Staff,0,1,60,60
1649910481990,COGS 101A,A01,083621,Davis; Joshua Daniel,0,5,60,60
1649910488015,COGS 101B,A01,091572,Staff,32,0,60,28
1649910494071,COGS 101C,A01,083625,Delgado; Tania,24,0,30,6
1649910500098,COGS 107A,A01,083627,Boyle; Mary E. T.,15,0,60,45
1649910506121,COGS 118A,A01,083075,Staff,21,0,60,39
1649910512150,CSE 3,A50,083646,Miranda; Gregory Joseph,26,0,38,12
1649910512150,CSE 3,A51,083647,Miranda; Gregory Joseph,37,0,37,0
1649910518180,CSE 8A,A50,083650,Miranda; Gregory Joseph,7,0,40,33
1649910524202,CSE 11,A01,083080,Cao; Yingjun,0,26,40,40
1649910530226,CSE 12,A01,083652,Staff,57,0,100,43
1649910536253,CSE 15L,A01,083654,Staff,19,0,50,31
1649910536253,CSE 15L,A02,083655,Staff,47,0,50,3
1649910542282,CSE 20,A01,083657,Staff,68,0,80,12
1649910548309,CSE 30,A01,083084,Eldon; John,1,19,40,39
1649910554343,CSE 100,A01,083659,Cao; Yingjun,2,26,50,48
1649910560372,CSE 134B,A01,083661,Powell; Thomas Allan,2,23,65,63
1649910566397,CSE 140,A01,083663,Staff,25,0,75,50
1649910572421,CSE 140L,A01,083088,Eldon; John,19,0,75,56
1649910578441,CSE 175,A01,083665,Kumar; Rakesh,12,0,25,13
1649910584480,CSE 190,A00,092507,Dubnov; Shlomo,14,0,15,1
1649910590511,ECE 45,A01,083139,Staff,10,0,40,30
1649910596551,ECE 65,A50,083695,Staff,9,0,30,21
1649910602580,ECE 109,A01,091882,Touri; Behrouz,57,0,70,13
1649910608602,ECE 180,A00,083140,Abi Samra; Nicholas Camill,26,0,30,4
1649910608602,ECE 180,B00,083141,Abi Samra; Nicholas Camill,13,0,30,17
1649910614630,MATH 10A,A01,083735,Patchell; Gregory David,21,0,30,9
1649910614630,MATH 10A,A02,083736,Patchell; Gregory David,28,0,30,2
1649910614630,MATH 10A,A03,083737,Patchell; Gregory David,28,0,30,2
1649910620657,MATH 10B,A01,083207,Staff,13,0,30,17
1649910620657,MATH 10B,A02,083208,Staff,25,0,30,5
1649910620657,MATH 10B,B01,083739,Staff,25,0,30,5
1649910620657,MATH 10B,B02,083740,Staff,30,0,30,0
1649910626689,MATH 18,A01,083743,Staff,22,0,30,8
1649910626689,MATH 18,A02,083744,Staff,29,0,30,1
1649910626689,MATH 18,A03,083745,Staff,29,0,30,1
1649910626689,MATH 18,A04,083746,Staff,28,0,30,2
1649910626689,MATH 18,B01,083748,Staff,7,0,30,23
1649910626689,MATH 18,B02,083749,Staff,26,0,30,4
1649910626689,MATH 18,B03,083750,Staff,28,0,30,2
1649910626689,MATH 18,B04,083751,Staff,27,0,30,3
1649910632711,MATH 20A,A01,083754,Staff,37,0,40,3
1649910638736,MATH 20B,A01,083756,Staff,21,0,30,9
1649910638736,MATH 20B,A02,083757,Staff,30,0,30,0
1649910644758,MATH 20C,A01,083760,Staff,22,0,30,8
1649910644758,MATH 20C,A02,083761,Staff,24,0,30,6
1649910644758,MATH 20C,B01,083762,Staff,28,0,30,2
1649910644758,MATH 20C,B02,083763,Staff,30,0,30,0
1649910650781,MATH 20D,A01,083765,Staff,21,0,30,9
1649910650781,MATH 20D,A02,083766,Staff,30,0,30,0
1649910650781,MATH 20D,A03,083767,Staff,30,0,30,0
1649910656808,MATH 20E,A01,083771,Staff,14,0,30,16
1649910656808,MATH 20E,A02,083772,Staff,25,0,30,5
1649910656808,MATH 20E,B01,083773,Staff,19,0,30,11
1649910656808,MATH 20E,B02,083774,Staff,29,0,30,1
1649910662839,MATH 103A,A01,083777,Staff,0,1,30,30
1649910662839,MATH 103A,A02,083778,Staff,0,3,30,30
1649910662839,MATH 103A,B01,083779,Staff,0,0,30,30
1649910662839,MATH 103A,B02,083780,Staff,19,0,30,11
1649910668862,MATH 105,A01,085443,Staff,0,5,30,30
1649910674890,MATH 109,A01,083213,Anzaldo; Leesa B,17,0,30,13
1649910674890,MATH 109,A02,083214,Anzaldo; Leesa B,11,0,30,19
1649910674890,MATH 109,B01,083215,Anzaldo; Leesa B,26,0,30,4
1649910674890,MATH 109,B02,083216,Anzaldo; Leesa B,22,0,30,8
1649910680919,MATH 142A,A01,083219,Chow; Bennett,1,1,30,29
1649910680919,MATH 142A,A02,083220,Chow; Bennett,12,0,30,18
1649910680919,MATH 142A,B01,083221,Chow; Bennett,0,0,30,30
1649910680919,MATH 142A,B02,083222,Chow; Bennett,5,0,30,25
1649910686948,MATH 193A,A01,083224,Staff,0,3,30,30
1649910686948,MATH 193A,A02,083225,Staff,0,4,30,30
1649910686948,MATH 193A,A03,083781,Staff,5,0,30,25
1649910686948,MATH 193A,A04,083782,Staff,17,0,30,13
1649910692973,MATH 197,001,091859,McAuley; Julian John,9999,0,9999,0
1649910699024,COGS 9,A01,083615,Staff,18,0,60,42
1649910705051,COGS 11,A01,083617,Boyle; Mary E. T.,35,0,40,5
1649910711076,COGS 13,A01,083071,Staff,0,9,40,40
1649910717100,COGS 14A,A01,092681,Staff,66,0,100,34
1649910723127,COGS 14B,A01,083073,Cheng; Tzu-Han,25,0,50,25
1649910729226,COGS 17,A01,092677,Staff,63,0,75,12
1649910735248,COGS 100,A01,083619,Staff,0,2,60,60
1649910741272,COGS 101A,A01,083621,Davis; Joshua Daniel,0,5,60,60
1649910747311,COGS 101B,A01,091572,Staff,32,0,60,28
1649910760491,COGS 101C,A01,083625,Delgado; Tania,24,0,30,6
1649910766518,COGS 107A,A01,083627,Boyle; Mary E. T.,15,0,60,45
1649910772541,COGS 118A,A01,083075,Staff,21,0,60,39
1649910778566,CSE 3,A50,083646,Miranda; Gregory Joseph,26,0,38,12
1649910778566,CSE 3,A51,083647,Miranda; Gregory Joseph,37,0,37,0
1649910784595,CSE 8A,A50,083650,Miranda; Gregory Joseph,7,0,40,33
1649910790625,CSE 11,A01,083080,Cao; Yingjun,0,26,40,40
1649910796650,CSE 12,A01,083652,Staff,57,0,100,43
1649910802673,CSE 15L,A01,083654,Staff,19,0,50,31
1649910802673,CSE 15L,A02,083655,Staff,47,0,50,3
1649910808695,CSE 20,A01,083657,Staff,68,0,80,12
1649910814724,CSE 30,A01,083084,Eldon; John,1,20,40,39
1649910820748,CSE 100,A01,083659,Cao; Yingjun,2,26,50,48
1649910826773,CSE 134B,A01,083661,Powell; Thomas Allan,2,23,65,63
1649910832798,CSE 140,A01,083663,Staff,25,0,75,50
1649910838822,CSE 140L,A01,083088,Eldon; John,19,0,75,56
1649910844848,CSE 175,A01,083665,Kumar; Rakesh,12,0,25,13
1649910850877,CSE 190,A00,092507,Dubnov; Shlomo,14,0,15,1
1649910856901,ECE 45,A01,083139,Staff,10,0,40,30
1649910862923,ECE 65,A50,083695,Staff,9,0,30,21
1649910868954,ECE 109,A01,091882,Touri; Behrouz,56,0,70,14
1649910874978,ECE 180,A00,083140,Abi Samra; Nicholas Camill,26,0,30,4
1649910874978,ECE 180,B00,083141,Abi Samra; Nicholas Camill,13,0,30,17
1649910881006,MATH 10A,A01,083735,Patchell; Gregory David,21,0,30,9
1649910881006,MATH 10A,A02,083736,Patchell; Gregory David,28,0,30,2
1649910881006,MATH 10A,A03,083737,Patchell; Gregory David,28,0,30,2
1649910887028,MATH 10B,A01,083207,Staff,13,0,30,17
1649910887028,MATH 10B,A02,083208,Staff,25,0,30,5
1649910887028,MATH 10B,B01,083739,Staff,25,0,30,5
1649910887028,MATH 10B,B02,083740,Staff,30,0,30,0
1649910893051,MATH 18,A01,083743,Staff,22,0,30,8
1649910893051,MATH 18,A02,083744,Staff,29,0,30,1
1649910893051,MATH 18,A03,083745,Staff,29,0,30,1
1649910893051,MATH 18,A04,083746,Staff,28,0,30,2
1649910893051,MATH 18,B01,083748,Staff,7,0,30,23
1649910893051,MATH 18,B02,083749,Staff,26,0,30,4
1649910893051,MATH 18,B03,083750,Staff,28,0,30,2
1649910893051,MATH 18,B04,083751,Staff,27,0,30,3
1649910899075,MATH 20A,A01,083754,Staff,37,0,40,3
1649910905099,MATH 20B,A01,083756,Staff,21,0,30,9
1649910905099,MATH 20B,A02,083757,Staff,30,0,30,0
1649910911121,MATH 20C,A01,083760,Staff,22,0,30,8
1649910911121,MATH 20C,A02,083761,Staff,24,0,30,6
1649910911121,MATH 20C,B01,083762,Staff,28,0,30,2
1649910911121,MATH 20C,B02,083763,Staff,30,0,30,0
1649910917144,MATH 20D,A01,083765,Staff,21,0,30,9
1649910917144,MATH 20D,A02,083766,Staff,30,0,30,0
1649910917144,MATH 20D,A03,083767,Staff,30,0,30,0
1649910923170,MATH 20E,A01,083771,Staff,14,0,30,16
1649910923170,MATH 20E,A02,083772,Staff,25,0,30,5
1649910923170,MATH 20E,B01,083773,Staff,19,0,30,11
1649910923170,MATH 20E,B02,083774,Staff,29,0,30,1
1649910929195,MATH 103A,A01,083777,Staff,0,1,30,30
1649910929195,MATH 103A,A02,083778,Staff,0,3,30,30
1649910929195,MATH 103A,B01,083779,Staff,0,0,30,30
1649910929195,MATH 103A,B02,083780,Staff,19,0,30,11
1649910935218,MATH 105,A01,085443,Staff,0,5,30,30
1649910941245,MATH 109,A01,083213,Anzaldo; Leesa B,17,0,30,13
1649910941245,MATH 109,A02,083214,Anzaldo; Leesa B,11,0,30,19
1649910941245,MATH 109,B01,083215,Anzaldo; Leesa B,26,0,30,4
1649910941245,MATH 109,B02,083216,Anzaldo; Leesa B,22,0,30,8
1649910947268,MATH 142A,A01,083219,Chow; Bennett,1,1,30,29
1649910947268,MATH 142A,A02,083220,Chow; Bennett,12,0,30,18
1649910947268,MATH 142A,B01,083221,Chow; Bennett,0,0,30,30
1649910947268,MATH 142A,B02,083222,Chow; Bennett,5,0,30,25
1649910953303,MATH 193A,A01,083224,Staff,0,3,30,30
1649910953303,MATH 193A,A02,083225,Staff,0,4,30,30
1649910953303,MATH 193A,A03,083781,Staff,5,0,30,25
1649910953303,MATH 193A,A04,083782,Staff,17,0,30,13
1649910959324,MATH 197,001,091859,McAuley; Julian John,9999,0,9999,0
1649910965375,COGS 9,A01,083615,Staff,18,0,60,42
1649910971402,COGS 11,A01,083617,Boyle; Mary E. T.,35,0,40,5
1649910977428,COGS 13,A01,083071,Staff,0,9,40,40
1649910983452,COGS 14A,A01,092681,Staff,66,0,100,34
1649910989480,COGS 14B,A01,083073,Cheng; Tzu-Han,25,0,50,25
1649910995504,COGS 17,A01,092677,Staff,63,0,75,12
1649911001530,COGS 100,A01,083619,Staff,0,2,60,60
1649911007553,COGS 101A,A01,083621,Davis; Joshua Daniel,0,5,60,60
1649911013576,COGS 101B,A01,091572,Staff,32,0,60,28
1649911019604,COGS 101C,A01,083625,Delgado; Tania,24,0,30,6
1649911025629,COGS 107A,A01,083627,Boyle; Mary E. T.,15,0,60,45
1649911031651,COGS 118A,A01,083075,Staff,21,0,60,39
1649911037676,CSE 3,A50,083646,Miranda; Gregory Joseph,26,0,38,12
1649911037676,CSE 3,A51,083647,Miranda; Gregory Joseph,37,0,37,0
1649911043701,CSE 8A,A50,083650,Miranda; Gregory Joseph,7,0,40,33
1649911049726,CSE 11,A01,083080,Cao; Yingjun,0,26,40,40
1649911055749,CSE 12,A01,083652,Staff,57,0,100,43
1649911061778,CSE 15L,A01,083654,Staff,19,0,50,31
1649911061778,CSE 15L,A02,083655,Staff,47,0,50,3
1649911067805,CSE 20,A01,083657,Staff,68,0,80,12
1649911073849,CSE 30,A01,083084,Eldon; John,1,20,40,39
1649911079876,CSE 100,A01,083659,Cao; Yingjun,2,26,50,48
1649911085899,CSE 134B,A01,083661,Powell; Thomas Allan,2,23,65,63
1649911091927,CSE 140,A01,083663,Staff,25,0,75,50
1649911097955,CSE 140L,A01,083088,Eldon; John,19,0,75,56
1649911103982,CSE 175,A01,083665,Kumar; Rakesh,12,0,25,13
1649911110008,CSE 190,A00,092507,Dubnov; Shlomo,14,0,15,1
1649911116033,ECE 45,A01,083139,Staff,10,0,40,30
1649911122057,ECE 65,A50,083695,Staff,8,0,30,22
1649911128080,ECE 109,A01,091882,Touri; Behrouz,56,0,70,14
1649911134104,ECE 180,A00,083140,Abi Samra; Nicholas Camill,26,0,30,4
1649911134104,ECE 180,B00,083141,Abi Samra; Nicholas Camill,13,0,30,17
1649911140132,MATH 10A,A01,083735,Patchell; Gregory David,21,0,30,9
1649911140132,MATH 10A,A02,083736,Patchell; Gregory David,28,0,30,2
1649911140132,MATH 10A,A03,083737,Patchell; Gregory David,28,0,30,2
1649911146159,MATH 10B,A01,083207,Staff,13,0,30,17
1649911146159,MATH 10B,A02,083208,Staff,25,0,30,5
1649911146159,MATH 10B,B01,083739,Staff,25,0,30,5
1649911146159,MATH 10B,B02,083740,Staff,30,0,30,0
1649911152184,MATH 18,A01,083743,Staff,22,0,30,8
1649911152184,MATH 18,A02,083744,Staff,29,0,30,1
1649911152184,MATH 18,A03,083745,Staff,29,0,30,1
1649911152184,MATH 18,A04,083746,Staff,28,0,30,2
1649911152184,MATH 18,B01,083748,Staff,7,0,30,23
1649911152184,MATH 18,B02,083749,Staff,26,0,30,4
1649911152184,MATH 18,B03,083750,Staff,28,0,30,2
1649911152184,MATH 18,B04,083751,Staff,27,0,30,3
1649911158218,MATH 20A,A01,083754,Staff,37,0,40,3
1649911164245,MATH 20B,A01,083756,Staff,20,0,30,10
1649911164245,MATH 20B,A02,083757,Staff,30,0,30,0
1649911170315,MATH 20C,A01,083760,Staff,22,0,30,8
1649911170315,MATH 20C,A02,083761,Staff,23,0,30,7
1649911170315,MATH 20C,B01,083762,Staff,28,0,30,2
1649911170315,MATH 20C,B02,083763,Staff,30,0,30,0
1649911176340,MATH 20D,A01,083765,Staff,21,0,30,9
1649911176340,MATH 20D,A02,083766,Staff,30,0,30,0
1649911176340,MATH 20D,A03,083767,Staff,30,0,30,0
1649911182372,MATH 20E,A01,083771,Staff,14,0,30,16
1649911182372,MATH 20E,A02,083772,Staff,25,0,30,5
1649911182372,MATH 20E,B01,083773,Staff,19,0,30,11
1649911182372,MATH 20E,B02,083774,Staff,29,0,30,1
1649911188397,MATH 103A,A01,083777,Staff,0,1,30,30
1649911188397,MATH 103A,A02,083778,Staff,0,3,30,30
1649911188397,MATH 103A,B01,083779,Staff,0,0,30,30
1649911188397,MATH 103A,B02,083780,Staff,19,0,30,11
1649911194424,MATH 105,A01,085443,Staff,0,5,30,30
1649911200453,MATH 109,A01,083213,Anzaldo; Leesa B,17,0,30,13
1649911200453,MATH 109,A02,083214,Anzaldo; Leesa B,11,0,30,19
1649911200453,MATH 109,B01,083215,Anzaldo; Leesa B,26,0,30,4
1649911200453,MATH 109,B02,083216,Anzaldo; Leesa B,22,0,30,8
1649911206477,MATH 142A,A01,083219,Chow; Bennett,1,1,30,29
1649911206477,MATH 142A,A02,083220,Chow; Bennett,12,0,30,18
1649911206477,MATH 142A,B01,083221,Chow; Bennett,0,0,30,30
1649911206477,MATH 142A,B02,083222,Chow; Bennett,5,0,30,25
1649911212513,MATH 193A,A01,083224,Staff,0,3,30,30
1649911212513,MATH 193A,A02,083225,Staff,0,4,30,30
1649911212513,MATH 193A,A03,083781,Staff,5,0,30,25
1649911212513,MATH 193A,A04,083782,Staff,17,0,30,13
1649911218540,MATH 197,001,091859,McAuley; Julian John,9999,0,9999,0
1649911224594,COGS 9,A01,083615,Staff,18,0,60,42
1649911230628,COGS 11,A01,083617,Boyle; Mary E. T.,35,0,40,5
1649911236651,COGS 13,A01,083071,Staff,0,9,40,40
1649911242675,COGS 14A,A01,092681,Staff,66,0,100,34
1649911248700,COGS 14B,A01,083073,Cheng; Tzu-Han,25,0,50,25
1649911254722,COGS 17,A01,092677,Staff,63,0,75,12
1649911260758,COGS 100,A01,083619,Staff,0,2,60,60
1649911266785,COGS 101A,A01,083621,Davis; Joshua Daniel,0,5,60,60
1649911272808,COGS 101B,A01,091572,Staff,32,0,60,28
1649911278835,COGS 101C,A01,083625,Delgado; Tania,24,0,30,6
1649911284860,COGS 107A,A01,083627,Boyle; Mary E. T.,15,0,60,45
1649911290882,COGS 118A,A01,083075,Staff,21,0,60,39
1649911296910,CSE 3,A50,083646,Miranda; Gregory Joseph,26,0,38,12
1649911296910,CSE 3,A51,083647,Miranda; Gregory Joseph,37,0,37,0
1649911302938,CSE 8A,A50,083650,Miranda; Gregory Joseph,7,0,40,33
1649911308963,CSE 11,A01,083080,Cao; Yingjun,0,26,40,40
1649911315005,CSE 12,A01,083652,Staff,57,0,100,43
1649911321032,CSE 15L,A01,083654,Staff,19,0,50,31
1649911321032,CSE 15L,A02,083655,Staff,47,0,50,3
1649911327058,CSE 20,A01,083657,Staff,68,0,80,12
1649911333162,CSE 30,A01,083084,Eldon; John,1,20,40,39
1649911339194,CSE 100,A01,083659,Cao; Yingjun,2,27,50,48
1649911345228,CSE 134B,A01,083661,Powell; Thomas Allan,2,23,65,63
1649911351251,CSE 140,A01,083663,Staff,25,0,75,50
1649911357281,CSE 140L,A01,083088,Eldon; John,19,0,75,56
1649911363305,CSE 175,A01,083665,Kumar; Rakesh,12,0,25,13
1649911369329,CSE 190,A00,092507,Dubnov; Shlomo,14,0,15,1
1649911375357,ECE 45,A01,083139,Staff,10,0,40,30
1649911381385,ECE 65,A50,083695,Staff,8,0,30,22
1649911387409,ECE 109,A01,091882,Touri; Behrouz,56,0,70,14
1649911393433,ECE 180,A00,083140,Abi Samra; Nicholas Camill,26,0,30,4
1649911393433,ECE 180,B00,083141,Abi Samra; Nicholas Camill,13,0,30,17
1649911399456,MATH 10A,A01,083735,Patchell; Gregory David,21,0,30,9
1649911399456,MATH 10A,A02,083736,Patchell; Gregory David,28,0,30,2
1649911399456,MATH 10A,A03,083737,Patchell; Gregory David,28,0,30,2
1649911405480,MATH 10B,A01,083207,Staff,13,0,30,17
1649911405480,MATH 10B,A02,083208,Staff,25,0,30,5
1649911405480,MATH 10B,B01,083739,Staff,25,0,30,5
1649911405480,MATH 10B,B02,083740,Staff,30,0,30,0
1649911411504,MATH 18,A01,083743,Staff,22,0,30,8
1649911411504,MATH 18,A02,083744,Staff,29,0,30,1
1649911411504,MATH 18,A03,083745,Staff,29,0,30,1
1649911411504,MATH 18,A04,083746,Staff,28,0,30,2
1649911411504,MATH 18,B01,083748,Staff,7,0,30,23
1649911411504,MATH 18,B02,083749,Staff,26,0,30,4
1649911411504,MATH 18,B03,083750,Staff,28,0,30,2
1649911411504,MATH 18,B04,083751,Staff,27,0,30,3
1649911417534,MATH 20A,A01,083754,Staff,37,0,40,3
1649911423561,MATH 20B,A01,083756,Staff,19,0,30,11
1649911423561,MATH 20B,A02,083757,Staff,30,0,30,0
1649911429589,MATH 20C,A01,083760,Staff,21,0,30,9
1649911429589,MATH 20C,A02,083761,Staff,23,0,30,7
1649911429589,MATH 20C,B01,083762,Staff,28,0,30,2
1649911429589,MATH 20C,B02,083763,Staff,30,0,30,0
1649911435616,MATH 20D,A01,083765,Staff,21,0,30,9
1649911435616,MATH 20D,A02,083766,Staff,30,0,30,0
1649911435616,MATH 20D,A03,083767,Staff,30,0,30,0
1649911441639,MATH 20E,A01,083771,Staff,14,0,30,16
1649911441639,MATH 20E,A02,083772,Staff,25,0,30,5
1649911441639,MATH 20E,B01,083773,Staff,19,0,30,11
1649911441639,MATH 20E,B02,083774,Staff,29,0,30,1
1649911447666,MATH 103A,A01,083777,Staff,0,1,30,30
1649911447666,MATH 103A,A02,083778,Staff,0,3,30,30
1649911447666,MATH 103A,B01,083779,Staff,0,0,30,30
1649911447666,MATH 103A,B02,083780,Staff,19,0,30,11
1649911453687,MATH 105,A01,085443,Staff,0,5,30,30
1649911459710,MATH 109,A01,083213,Anzaldo; Leesa B,17,0,30,13
1649911459710,MATH 109,A02,083214,Anzaldo; Leesa B,11,0,30,19
1649911459710,MATH 109,B01,083215,Anzaldo; Leesa B,26,0,30,4
1649911459710,MATH 109,B02,083216,Anzaldo; Leesa B,22,0,30,8
1649911465737,MATH 142A,A01,083219,Chow; Bennett,1,1,30,29
1649911465737,MATH 142A,A02,083220,Chow; Bennett,11,0,30,19
1649911465737,MATH 142A,B01,083221,Chow; Bennett,0,0,30,30
1649911465737,MATH 142A,B02,083222,Chow; Bennett,4,0,30,26
1649911471765,MATH 193A,A01,083224,Staff,0,3,30,30
1649911471765,MATH 193A,A02,083225,Staff,0,4,30,30
1649911471765,MATH 193A,A03,083781,Staff,5,0,30,25
1649911471765,MATH 193A,A04,083782,Staff,17,0,30,13
1649911477793,MATH 197,001,091859,McAuley; Julian John,9999,0,9999,0
1649911483845,COGS 9,A01,083615,Staff,17,0,60,43
1649911489872,COGS 11,A01,083617,Boyle; Mary E. T.,35,0,40,5
1649911495898,COGS 13,A01,083071,Staff,0,9,40,40
1649911501923,COGS 14A,A01,092681,Staff,66,0,100,34
1649911507946,COGS 14B,A01,083073,Cheng; Tzu-Han,25,0,50,25
1649911513971,COGS 17,A01,092677,Staff,63,0,75,12
1649911519997,COGS 100,A01,083619,Staff,0,2,60,60
1649911526033,COGS 101A,A01,083621,Davis; Joshua Daniel,0,5,60,60
1649911532058,COGS 101B,A01,091572,Staff,32,0,60,28
1649911538087,COGS 101C,A01,083625,Delgado; Tania,24,0,30,6
1649911544120,COGS 107A,A01,083627,Boyle; Mary E. T.,15,0,60,45
1649911550144,COGS 118A,A01,083075,Staff,21,0,60,39
1649911556166,CSE 3,A50,083646,Miranda; Gregory Joseph,26,0,38,12
1649911556166,CSE 3,A51,083647,Miranda; Gregory Joseph,37,0,37,0
1649911562190,CSE 8A,A50,083650,Miranda; Gregory Joseph,8,0,40,32
1649911568212,CSE 11,A01,083080,Cao; Yingjun,0,26,40,40
1649911574236,CSE 12,A01,083652,Staff,57,0,100,43
1649911580258,CSE 15L,A01,083654,Staff,19,0,50,31
1649911580258,CSE 15L,A02,083655,Staff,47,0,50,3
1649911586283,CSE 20,A01,083657,Staff,68,0,80,12
1649911592311,CSE 30,A01,083084,Eldon; John,1,20,40,39
1649911598338,CSE 100,A01,083659,Cao; Yingjun,2,27,50,48
1649911604368,CSE 134B,A01,083661,Powell; Thomas Allan,2,23,65,63
1649911610391,CSE 140,A01,083663,Staff,25,0,75,50
1649911616419,CSE 140L,A01,083088,Eldon; John,19,0,75,56
1649911622445,CSE 175,A01,083665,Kumar; Rakesh,12,0,25,13
1649911628488,CSE 190,A00,092507,Dubnov; Shlomo,14,0,15,1
1649911634511,ECE 45,A01,083139,Staff,10,0,40,30
1649911640538,ECE 65,A50,083695,Staff,8,0,30,22
1649911646561,ECE 109,A01,091882,Touri; Behrouz,56,0,70,14
1649911652584,ECE 180,A00,083140,Abi Samra; Nicholas Camill,26,0,30,4
1649911652584,ECE 180,B00,083141,Abi Samra; Nicholas Camill,13,0,30,17
1649911658608,MATH 10A,A01,083735,Patchell; Gregory David,21,0,30,9
1649911658608,MATH 10A,A02,083736,Patchell; Gregory David,28,0,30,2
1649911658608,MATH 10A,A03,083737,Patchell; Gregory David,28,0,30,2
1649911664632,MATH 10B,A01,083207,Staff,13,0,30,17
1649911664632,MATH 10B,A02,083208,Staff,25,0,30,5
1649911664632,MATH 10B,B01,083739,Staff,25,0,30,5
1649911664632,MATH 10B,B02,083740,Staff,30,0,30,0
1649911670658,MATH 18,A01,083743,Staff,22,0,30,8
1649911670658,MATH 18,A02,083744,Staff,29,0,30,1
1649911670658,MATH 18,A03,083745,Staff,29,0,30,1
1649911670658,MATH 18,A04,083746,Staff,28,0,30,2
1649911670658,MATH 18,B01,083748,Staff,6,0,30,24
1649911670658,MATH 18,B02,083749,Staff,26,0,30,4
1649911670658,MATH 18,B03,083750,Staff,28,0,30,2
1649911670658,MATH 18,B04,083751,Staff,27,0,30,3
1649911676682,MATH 20A,A01,083754,Staff,37,0,40,3
1649911682706,MATH 20B,A01,083756,Staff,19,0,30,11
1649911682706,MATH 20B,A02,083757,Staff,30,0,30,0
1649911688734,MATH 20C,A01,083760,Staff,21,0,30,9
1649911688734,MATH 20C,A02,083761,Staff,23,0,30,7
1649911688734,MATH 20C,B01,083762,Staff,28,0,30,2
1649911688734,MATH 20C,B02,083763,Staff,30,0,30,0
1649911694758,MATH 20D,A01,083765,Staff,21,0,30,9
1649911694758,MATH 20D,A02,083766,Staff,30,0,30,0
1649911694758,MATH 20D,A03,083767,Staff,30,0,30,0
1649911700782,MATH 20E,A01,083771,Staff,14,0,30,16
1649911700782,MATH 20E,A02,083772,Staff,25,0,30,5
1649911700782,MATH 20E,B01,083773,Staff,19,0,30,11
1649911700782,MATH 20E,B02,083774,Staff,29,0,30,1
1649911706806,MATH 103A,A01,083777,Staff,0,1,30,30
1649911706806,MATH 103A,A02,083778,Staff,0,3,30,30
1649911706806,MATH 103A,B01,083779,Staff,0,0,30,30
1649911706806,MATH 103A,B02,083780,Staff,19,0,30,11
1649911712838,MATH 105,A01,085443,Staff,0,5,30,30
1649911718872,MATH 109,A01,083213,Anzaldo; Leesa B,16,0,30,14
1649911718872,MATH 109,A02,083214,Anzaldo; Leesa B,11,0,30,19
1649911718872,MATH 109,B01,083215,Anzaldo; Leesa B,26,0,30,4
1649911718872,MATH 109,B02,083216,Anzaldo; Leesa B,22,0,30,8
1649911724895,MATH 142A,A01,083219,Chow; Bennett,1,1,30,29
1649911724895,MATH 142A,A02,083220,Chow; Bennett,11,0,30,19
1649911724895,MATH 142A,B01,083221,Chow; Bennett,0,0,30,30
1649911724895,MATH 142A,B02,083222,Chow; Bennett,4,0,30,26
1649911730930,MATH 193A,A01,083224,Staff,0,3,30,30
1649911730930,MATH 193A,A02,083225,Staff,0,4,30,30
1649911730930,MATH 193A,A03,083781,Staff,5,0,30,25
1649911730930,MATH 193A,A04,083782,Staff,17,0,30,13
1649911736951,MATH 197,001,091859,McAuley; Julian John,9999,0,9999,0
1649911743003,COGS 9,A01,083615,Staff,17,0,60,43
1649911749039,COGS 11,A01,083617,Boyle; Mary E. T.,35,0,40,5
1649911755071,COGS 13,A01,083071,Staff,0,9,40,40
1649911761104,COGS 14A,A01,092681,Staff,66,0,100,34
1649911767130,COGS 14B,A01,083073,Cheng; Tzu-Han,25,0,50,25
1649911773167,COGS 17,A01,092677,Staff,63,0,75,12
1649911779190,COGS 100,A01,083619,Staff,0,2,60,60
1649911785214,COGS 101A,A01,083621,Davis; Joshua Daniel,0,5,60,60
1649911791237,COGS 101B,A01,091572,Staff,32,0,60,28
1649911797260,COGS 101C,A01,083625,Delgado; Tania,24,0,30,6
1649911803298,COGS 107A,A01,083627,Boyle; Mary E. T.,15,0,60,45
1649911809321,COGS 118A,A01,083075,Staff,21,0,60,39
1649911815349,CSE 3,A50,083646,Miranda; Gregory Joseph,26,0,38,12
1649911815349,CSE 3,A51,083647,Miranda; Gregory Joseph,37,0,37,0
1649911821374,CSE 8A,A50,083650,Miranda; Gregory Joseph,8,0,40,32
1649911827399,CSE 11,A01,083080,Cao; Yingjun,0,26,40,40
1649911833422,CSE 12,A01,083652,Staff,57,0,100,43
1649911839444,CSE 15L,A01,083654,Staff,19,0,50,31
1649911839444,CSE 15L,A02,083655,Staff,47,0,50,3
1649911845467,CSE 20,A01,083657,Staff,68,0,80,12
1649911851489,CSE 30,A01,083084,Eldon; John,1,21,40,39
1649911857516,CSE 100,A01,083659,Cao; Yingjun,2,27,50,48
1649911863539,CSE 134B,A01,083661,Powell; Thomas Allan,2,23,65,63
1649911869563,CSE 140,A01,083663,Staff,25,0,75,50
1649911875587,CSE 140L,A01,083088,Eldon; John,19,0,75,56
1649911881611,CSE 175,A01,083665,Kumar; Rakesh,12,0,25,13
1649911887642,CSE 190,A00,092507,Dubnov; Shlomo,14,0,15,1
1649911893668,ECE 45,A01,083139,Staff,10,0,40,30
1649911899695,ECE 65,A50,083695,Staff,8,0,30,22
1649911905721,ECE 109,A01,091882,Touri; Behrouz,56,0,70,14
1649911911748,ECE 180,A00,083140,Abi Samra; Nicholas Camill,26,0,30,4
1649911911748,ECE 180,B00,083141,Abi Samra; Nicholas Camill,13,0,30,17
1649911917769,MATH 10A,A01,083735,Patchell; Gregory David,21,0,30,9
1649911917769,MATH 10A,A02,083736,Patchell; Gregory David,28,0,30,2
1649911917769,MATH 10A,A03,083737,Patchell; Gregory David,28,0,30,2
1649911923799,MATH 10B,A01,083207,Staff,12,0,30,18
1649911923799,MATH 10B,A02,083208,Staff,25,0,30,5
1649911923799,MATH 10B,B01,083739,Staff,25,0,30,5
1649911923799,MATH 10B,B02,083740,Staff,30,0,30,0
1649911929895,MATH 18,A01,083743,Staff,22,0,30,8
1649911929895,MATH 18,A02,083744,Staff,29,0,30,1
1649911929895,MATH 18,A03,083745,Staff,29,0,30,1
1649911929895,MATH 18,A04,083746,Staff,28,0,30,2
1649911929895,MATH 18,B01,083748,Staff,6,0,30,24
1649911929895,MATH 18,B02,083749,Staff,26,0,30,4
1649911929895,MATH 18,B03,083750,Staff,28,0,30,2
1649911929895,MATH 18,B04,083751,Staff,27,0,30,3
1649911935920,MATH 20A,A01,083754,Staff,37,0,40,3
1649911941946,MATH 20B,A01,083756,Staff,19,0,30,11
1649911941946,MATH 20B,A02,083757,Staff,30,0,30,0
1649911947973,MATH 20C,A01,083760,Staff,21,0,30,9
1649911947973,MATH 20C,A02,083761,Staff,23,0,30,7
1649911947973,MATH 20C,B01,083762,Staff,28,0,30,2
1649911947973,MATH 20C,B02,083763,Staff,30,0,30,0
1649911954002,MATH 20D,A01,083765,Staff,21,0,30,9
1649911954002,MATH 20D,A02,083766,Staff,30,0,30,0
1649911954002,MATH 20D,A03,083767,Staff,30,0,30,0
1649911960028,MATH 20E,A01,083771,Staff,14,0,30,16
1649911960028,MATH 20E,A02,083772,Staff,25,0,30,5
1649911960028,MATH 20E,B01,083773,Staff,18,0,30,12
1649911960028,MATH 20E,B02,083774,Staff,29,0,30,1
1649911966062,MATH 103A,A01,083777,Staff,0,1,30,30
1649911966062,MATH 103A,A02,083778,Staff,0,3,30,30
1649911966062,MATH 103A,B01,083779,Staff,0,0,30,30
1649911966062,MATH 103A,B02,083780,Staff,19,0,30,11
1649911972084,MATH 105,A01,085443,Staff,0,5,30,30
1649911978116,MATH 109,A01,083213,Anzaldo; Leesa B,16,0,30,14
1649911978116,MATH 109,A02,083214,Anzaldo; Leesa B,11,0,30,19
1649911978116,MATH 109,B01,083215,Anzaldo; Leesa B,26,0,30,4
1649911978116,MATH 109,B02,083216,Anzaldo; Leesa B,22,0,30,8
1649911984144,MATH 142A,A01,083219,Chow; Bennett,1,1,30,29
1649911984144,MATH 142A,A02,083220,Chow; Bennett,11,0,30,19
1649911984144,MATH 142A,B01,083221,Chow; Bennett,0,0,30,30
1649911984144,MATH 142A,B02,083222,Chow; Bennett,4,0,30,26
1649911990171,MATH 193A,A01,083224,Staff,0,3,30,30
1649911990171,MATH 193A,A02,083225,Staff,0,4,30,30
1649911990171,MATH 193A,A03,083781,Staff,5,0,30,25
1649911990171,MATH 193A,A04,083782,Staff,17,0,30,13
1649911996192,MATH 197,001,091859,McAuley; Julian John,9999,0,9999,0
1649912002244,COGS 9,A01,083615,Staff,17,0,60,43
1649912008267,COGS 11,A01,083617,Boyle; Mary E. T.,35,0,40,5
1649912014292,COGS 13,A01,083071,Staff,0,9,40,40
1649912020319,COGS 14A,A01,092681,Staff,66,0,100,34
1649912026341,COGS 14B,A01,083073,Cheng; Tzu-Han,25,0,50,25
1649912032367,COGS 17,A01,092677,Staff,63,0,75,12
1649912038394,COGS 100,A01,083619,Staff,0,2,60,60
1649912044421,COGS 101A,A01,083621,Davis; Joshua Daniel,0,5,60,60
1649912050449,COGS 101B,A01,091572,Staff,32,0,60,28
1649912056472,COGS 101C,A01,083625,Delgado; Tania,24,0,30,6
1649912062496,COGS 107A,A01,083627,Boyle; Mary E. T.,15,0,60,45
1649912068523,COGS 118A,A01,083075,Staff,21,0,60,39
1649912074551,CSE 3,A50,083646,Miranda; Gregory Joseph,26,0,38,12
1649912074551,CSE 3,A51,083647,Miranda; Gregory Joseph,37,0,37,0
1649912080580,CSE 8A,A50,083650,Miranda; Gregory Joseph,8,0,40,32
1649912086602,CSE 11,A01,083080,Cao; Yingjun,0,26,40,40
1649912092625,CSE 12,A01,083652,Staff,57,0,100,43
1649912098652,CSE 15L,A01,083654,Staff,19,0,50,31
1649912098652,CSE 15L,A02,083655,Staff,47,0,50,3
1649912104679,CSE 20,A01,083657,Staff,68,0,80,12
1649912110717,CSE 30,A01,083084,Eldon; John,1,21,40,39
1649912116752,CSE 100,A01,083659,Cao; Yingjun,2,27,50,48
1649912122773,CSE 134B,A01,083661,Powell; Thomas Allan,2,23,65,63
1649912128803,CSE 140,A01,083663,Staff,25,0,75,50
1649912134827,CSE 140L,A01,083088,Eldon; John,19,0,75,56
1649912140850,CSE 175,A01,083665,Kumar; Rakesh,12,0,25,13
1649912146873,CSE 190,A00,092507,Dubnov; Shlomo,14,0,15,1
1649912152900,ECE 45,A01,083139,Staff,10,0,40,30
1649912158929,ECE 65,A50,083695,Staff,8,0,30,22
1649912164952,ECE 109,A01,091882,Touri; Behrouz,56,0,70,14
1649912170995,ECE 180,A00,083140,Abi Samra; Nicholas Camill,26,0,30,4
1649912170995,ECE 180,B00,083141,Abi Samra; Nicholas Camill,13,0,30,17
1649912177022,MATH 10A,A01,083735,Patchell; Gregory David,21,0,30,9
1649912177022,MATH 10A,A02,083736,Patchell; Gregory David,28,0,30,2
1649912177022,MATH 10A,A03,083737,Patchell; Gregory David,28,0,30,2
1649912183047,MATH 10B,A01,083207,Staff,12,0,30,18
1649912183047,MATH 10B,A02,083208,Staff,25,0,30,5
1649912183047,MATH 10B,B01,083739,Staff,25,0,30,5
1649912183047,MATH 10B,B02,083740,Staff,30,0,30,0
1649912189072,MATH 18,A01,083743,Staff,22,0,30,8
1649912189072,MATH 18,A02,083744,Staff,29,0,30,1
1649912189072,MATH 18,A03,083745,Staff,29,0,30,1
1649912189072,MATH 18,A04,083746,Staff,28,0,30,2
1649912189072,MATH 18,B01,083748,Staff,6,0,30,24
1649912189072,MATH 18,B02,083749,Staff,26,0,30,4
1649912189072,MATH 18,B03,083750,Staff,28,0,30,2
1649912189072,MATH 18,B04,083751,Staff,27,0,30,3
1649912195096,MATH 20A,A01,083754,Staff,37,0,40,3
1649912201118,MATH 20B,A01,083756,Staff,19,0,30,11
1649912201118,MATH 20B,A02,083757,Staff,30,0,30,0
1649912207153,MATH 20C,A01,083760,Staff,21,0,30,9
1649912207153,MATH 20C,A02,083761,Staff,23,0,30,7
1649912207153,MATH 20C,B01,083762,Staff,28,0,30,2
1649912207153,MATH 20C,B02,083763,Staff,30,0,30,0
1649912213185,MATH 20D,A01,083765,Staff,21,0,30,9
1649912213185,MATH 20D,A02,083766,Staff,30,0,30,0
1649912213185,MATH 20D,A03,083767,Staff,30,0,30,0
1649912219209,MATH 20E,A01,083771,Staff,14,0,30,16
1649912219209,MATH 20E,A02,083772,Staff,25,0,30,5
1649912219209,MATH 20E,B01,083773,Staff,18,0,30,12
1649912219209,MATH 20E,B02,083774,Staff,29,0,30,1
1649912225235,MATH 103A,A01,083777,Staff,0,1,30,30
1649912225235,MATH 103A,A02,083778,Staff,0,3,30,30
1649912225235,MATH 103A,B01,083779,Staff,0,0,30,30
1649912225235,MATH 103A,B02,083780,Staff,19,0,30,11
1649912231261,MATH 105,A01,085443,Staff,0,5,30,30
1649912237288,MATH 109,A01,083213,Anzaldo; Leesa B,16,0,30,14
1649912237288,MATH 109,A02,083214,Anzaldo; Leesa B,11,0,30,19
1649912237288,MATH 109,B01,083215,Anzaldo; Leesa B,26,0,30,4
1649912237288,MATH 109,B02,083216,Anzaldo; Leesa B,22,0,30,8
1649912243313,MATH 142A,A01,083219,Chow; Bennett,1,1,30,29
1649912243313,MATH 142A,A02,083220,Chow; Bennett,11,0,30,19
1649912243313,MATH 142A,B01,083221,Chow; Bennett,0,0,30,30
1649912243313,MATH 142A,B02,083222,Chow; Bennett,4,0,30,26
1649912249337,MATH 193A,A01,083224,Staff,0,3,30,30
1649912249337,MATH 193A,A02,083225,Staff,0,4,30,30
1649912249337,MATH 193A,A03,083781,Staff,5,0,30,25
1649912249337,MATH 193A,A04,083782,Staff,17,0,30,13
1649912255358,MATH 197,001,091859,McAuley; Julian John,9999,0,9999,0
1649912261409,COGS 9,A01,083615,Staff,17,0,60,43
1649912267433,COGS 11,A01,083617,Boyle; Mary E. T.,35,0,40,5
1649912273474,COGS 13,A01,083071,Staff,0,9,40,40
1649912279499,COGS 14A,A01,092681,Staff,66,0,100,34
1649912285533,COGS 14B,A01,083073,Cheng; Tzu-Han,25,0,50,25
1649912291556,COGS 17,A01,092677,Staff,63,0,75,12
1649912297579,COGS 100,A01,083619,Staff,0,2,60,60
1649912303604,COGS 101A,A01,083621,Davis; Joshua Daniel,0,5,60,60
1649912309630,COGS 101B,A01,091572,Staff,32,0,60,28
1649912315664,COGS 101C,A01,083625,Delgado; Tania,24,0,30,6
1649912321703,COGS 107A,A01,083627,Boyle; Mary E. T.,15,0,60,45
1649912327741,COGS 118A,A01,083075,Staff,21,0,60,39
1649912333767,CSE 3,A50,083646,Miranda; Gregory Joseph,26,0,38,12
1649912333767,CSE 3,A51,083647,Miranda; Gregory Joseph,37,0,37,0
1649912339790,CSE 8A,A50,083650,Miranda; Gregory Joseph,8,0,40,32
1649912345813,CSE 11,A01,083080,Cao; Yingjun,0,26,40,40
1649912351840,CSE 12,A01,083652,Staff,57,0,100,43
1649912357864,CSE 15L,A01,083654,Staff,19,0,50,31
1649912357864,CSE 15L,A02,083655,Staff,47,0,50,3
1649912363897,CSE 20,A01,083657,Staff,68,0,80,12
1649912369924,CSE 30,A01,083084,Eldon; John,1,21,40,39
1649912375948,CSE 100,A01,083659,Cao; Yingjun,2,27,50,48
1649912381971,CSE 134B,A01,083661,Powell; Thomas Allan,2,23,65,63
1649912388006,CSE 140,A01,083663,Staff,25,0,75,50
1649912394030,CSE 140L,A01,083088,Eldon; John,19,0,75,56
1649912400052,CSE 175,A01,083665,Kumar; Rakesh,12,0,25,13
1649912406079,CSE 190,A00,092507,Dubnov; Shlomo,14,0,15,1
1649912412102,ECE 45,A01,083139,Staff,10,0,40,30
1649912418125,ECE 65,A50,083695,Staff,8,0,30,22
1649912424162,ECE 109,A01,091882,Touri; Behrouz,56,0,70,14
1649912430186,ECE 180,A00,083140,Abi Samra; Nicholas Camill,26,0,30,4
1649912430186,ECE 180,B00,083141,Abi Samra; Nicholas Camill,13,0,30,17
1649912436212,MATH 10A,A01,083735,Patchell; Gregory David,21,0,30,9
1649912436212,MATH 10A,A02,083736,Patchell; Gregory David,28,0,30,2
1649912436212,MATH 10A,A03,083737,Patchell; Gregory David,28,0,30,2
1649912442250,MATH 10B,A01,083207,Staff,12,0,30,18
1649912442250,MATH 10B,A02,083208,Staff,25,0,30,5
1649912442250,MATH 10B,B01,083739,Staff,25,0,30,5
1649912442250,MATH 10B,B02,083740,Staff,30,0,30,0
1649912448295,MATH 18,A01,083743,Staff,22,0,30,8
1649912448295,MATH 18,A02,083744,Staff,29,0,30,1
1649912448295,MATH 18,A03,083745,Staff,29,0,30,1
1649912448295,MATH 18,A04,083746,Staff,28,0,30,2
1649912448295,MATH 18,B01,083748,Staff,6,0,30,24
1649912448295,MATH 18,B02,083749,Staff,26,0,30,4
1649912448295,MATH 18,B03,083750,Staff,28,0,30,2
1649912448295,MATH 18,B04,083751,Staff,27,0,30,3
1649912454327,MATH 20A,A01,083754,Staff,37,0,40,3
1649912460349,MATH 20B,A01,083756,Staff,19,0,30,11
1649912460349,MATH 20B,A02,083757,Staff,30,0,30,0
1649912466385,MATH 20C,A01,083760,Staff,21,0,30,9
1649912466385,MATH 20C,A02,083761,Staff,23,0,30,7
1649912466385,MATH 20C,B01,083762,Staff,28,0,30,2
1649912466385,MATH 20C,B02,083763,Staff,30,0,30,0
1649912472412,MATH 20D,A01,083765,Staff,21,0,30,9
1649912472412,MATH 20D,A02,083766,Staff,30,0,30,0
1649912472412,MATH 20D,A03,083767,Staff,30,0,30,0
1649912478439,MATH 20E,A01,083771,Staff,14,0,30,16
1649912478439,MATH 20E,A02,083772,Staff,25,0,30,5
1649912478439,MATH 20E,B01,083773,Staff,18,0,30,12
1649912478439,MATH 20E,B02,083774,Staff,29,0,30,1
1649912484462,MATH 103A,A01,083777,Staff,0,1,30,30
1649912484462,MATH 103A,A02,083778,Staff,0,3,30,30
1649912484462,MATH 103A,B01,083779,Staff,0,0,30,30
1649912484462,MATH 103A,B02,083780,Staff,19,0,30,11
1649912490489,MATH 105,A01,085443,Staff,0,5,30,30
1649912496513,MATH 109,A01,083213,Anzaldo; Leesa B,16,0,30,14
1649912496513,MATH 109,A02,083214,Anzaldo; Leesa B,11,0,30,19
1649912496513,MATH 109,B01,083215,Anzaldo; Leesa B,26,0,30,4
1649912496513,MATH 109,B02,083216,Anzaldo; Leesa B,22,0,30,8
1649912502540,MATH 142A,A01,083219,Chow; Bennett,1,1,30,29
1649912502540,MATH 142A,A02,083220,Chow; Bennett,11,0,30,19
1649912502540,MATH 142A,B01,083221,Chow; Bennett,0,0,30,30
1649912502540,MATH 142A,B02,083222,Chow; Bennett,4,0,30,26
1649912508568,MATH 193A,A01,083224,Staff,0,3,30,30
1649912508568,MATH 193A,A02,083225,Staff,0,4,30,30
1649912508568,MATH 193A,A03,083781,Staff,5,0,30,25
1649912508568,MATH 193A,A04,083782,Staff,17,0,30,13
1649912514591,MATH 197,001,091859,McAuley; Julian John,9999,0,9999,0
1649912520727,COGS 9,A01,083615,Staff,17,0,60,43
1649912526755,COGS 11,A01,083617,Boyle; Mary E. T.,35,0,40,5
1649912532778,COGS 13,A01,083071,Staff,0,9,40,40
1649912538805,COGS 14A,A01,092681,Staff,66,0,100,34
1649912544832,COGS 14B,A01,083073,Cheng; Tzu-Han,25,0,50,25
1649912550856,COGS 17,A01,092677,Staff,63,0,75,12
1649912556879,COGS 100,A01,083619,Staff,0,2,60,60
1649912562902,COGS 101A,A01,083621,Davis; Joshua Daniel,0,5,60,60
1649912568929,COGS 101B,A01,091572,Staff,32,0,60,28
1649912574973,COGS 101C,A01,083625,Delgado; Tania,24,0,30,6
1649912580995,COGS 107A,A01,083627,Boyle; Mary E. T.,14,0,60,46
1649912587028,COGS 118A,A01,083075,Staff,21,0,60,39
1649912593052,CSE 3,A50,083646,Miranda; Gregory Joseph,26,0,38,12
1649912593052,CSE 3,A51,083647,Miranda; Gregory Joseph,37,0,37,0
1649912599077,CSE 8A,A50,083650,Miranda; Gregory Joseph,8,0,40,32
1649912605100,CSE 11,A01,083080,Cao; Yingjun,0,26,40,40
1649912611128,CSE 12,A01,083652,Staff,57,0,100,43
1649912617160,CSE 15L,A01,083654,Staff,19,0,50,31
1649912617160,CSE 15L,A02,083655,Staff,47,0,50,3
1649912623191,CSE 20,A01,083657,Staff,68,0,80,12
1649912629215,CSE 30,A01,083084,Eldon; John,1,21,40,39
1649912635240,CSE 100,A01,083659,Cao; Yingjun,2,27,50,48
1649912641264,CSE 134B,A01,083661,Powell; Thomas Allan,2,23,65,63
1649912647288,CSE 140,A01,083663,Staff,25,0,75,50
1649912653316,CSE 140L,A01,083088,Eldon; John,19,0,75,56
1649912659349,CSE 175,A01,083665,Kumar; Rakesh,12,0,25,13
1649912665372,CSE 190,A00,092507,Dubnov; Shlomo,14,0,15,1
1649912671399,ECE 45,A01,083139,Staff,10,0,40,30
1649912677426,ECE 65,A50,083695,Staff,8,0,30,22
1649912683450,ECE 109,A01,091882,Touri; Behrouz,56,0,70,14
1649912689476,ECE 180,A00,083140,Abi Samra; Nicholas Camill,26,0,30,4
1649912689476,ECE 180,B00,083141,Abi Samra; Nicholas Camill,13,0,30,17
1649912695503,MATH 10A,A01,083735,Patchell; Gregory David,21,0,30,9
1649912695503,MATH 10A,A02,083736,Patchell; Gregory David,28,0,30,2
1649912695503,MATH 10A,A03,083737,Patchell; Gregory David,28,0,30,2
1649912701534,MATH 10B,A01,083207,Staff,12,0,30,18
1649912701534,MATH 10B,A02,083208,Staff,25,0,30,5
1649912701534,MATH 10B,B01,083739,Staff,25,0,30,5
1649912701534,MATH 10B,B02,083740,Staff,30,0,30,0
1649912707568,MATH 18,A01,083743,Staff,22,0,30,8
1649912707568,MATH 18,A02,083744,Staff,29,0,30,1
1649912707568,MATH 18,A03,083745,Staff,29,0,30,1
1649912707568,MATH 18,A04,083746,Staff,28,0,30,2
1649912707568,MATH 18,B01,083748,Staff,6,0,30,24
1649912707568,MATH 18,B02,083749,Staff,26,0,30,4
1649912707568,MATH 18,B03,083750,Staff,28,0,30,2
1649912707568,MATH 18,B04,083751,Staff,27,0,30,3
1649912713608,MATH 20A,A01,083754,Staff,37,0,40,3
1649912719641,MATH 20B,A01,083756,Staff,19,0,30,11
1649912719641,MATH 20B,A02,083757,Staff,30,0,30,0
1649912725664,MATH 20C,A01,083760,Staff,21,0,30,9
1649912725664,MATH 20C,A02,083761,Staff,23,0,30,7
1649912725664,MATH 20C,B01,083762,Staff,28,0,30,2
1649912725664,MATH 20C,B02,083763,Staff,30,0,30,0
1649912731692,MATH 20D,A01,083765,Staff,21,0,30,9
1649912731692,MATH 20D,A02,083766,Staff,30,0,30,0
1649912731692,MATH 20D,A03,083767,Staff,30,0,30,0
1649912737720,MATH 20E,A01,083771,Staff,14,0,30,16
1649912737720,MATH 20E,A02,083772,Staff,25,0,30,5
1649912737720,MATH 20E,B01,083773,Staff,18,0,30,12
1649912737720,MATH 20E,B02,083774,Staff,29,0,30,1
1649912743744,MATH 103A,A01,083777,Staff,0,1,30,30
1649912743744,MATH 103A,A02,083778,Staff,0,3,30,30
1649912743744,MATH 103A,B01,083779,Staff,0,0,30,30
1649912743744,MATH 103A,B02,083780,Staff,19,0,30,11
1649912749771,MATH 105,A01,085443,Staff,0,5,30,30
1649912755796,MATH 109,A01,083213,Anzaldo; Leesa B,16,0,30,14
1649912755796,MATH 109,A02,083214,Anzaldo; Leesa B,11,0,30,19
1649912755796,MATH 109,B01,083215,Anzaldo; Leesa B,26,0,30,4
1649912755796,MATH 109,B02,083216,Anzaldo; Leesa B,22,0,30,8
1649912761823,MATH 142A,A01,083219,Chow; Bennett,1,1,30,29
1649912761823,MATH 142A,A02,083220,Chow; Bennett,11,0,30,19
1649912761823,MATH 142A,B01,083221,Chow; Bennett,0,0,30,30
1649912761823,MATH 142A,B02,083222,Chow; Bennett,4,0,30,26
1649912767847,MATH 193A,A01,083224,Staff,0,3,30,30
1649912767847,MATH 193A,A02,083225,Staff,0,4,30,30
1649912767847,MATH 193A,A03,083781,Staff,5,0,30,25
1649912767847,MATH 193A,A04,083782,Staff,17,0,30,13
1649912773871,MATH 197,001,091859,McAuley; Julian John,9999,0,9999,0
1649912779930,COGS 9,A01,083615,Staff,17,0,60,43
1649912785954,COGS 11,A01,083617,Boyle; Mary E. T.,35,0,40,5
1649912791979,COGS 13,A01,083071,Staff,0,9,40,40
1649912798003,COGS 14A,A01,092681,Staff,66,0,100,34
1649912804027,COGS 14B,A01,083073,Cheng; Tzu-Han,25,0,50,25
1649912810051,COGS 17,A01,092677,Staff,63,0,75,12
1649912816076,COGS 100,A01,083619,Staff,0,2,60,60
1649912822101,COGS 101A,A01,083621,Davis; Joshua Daniel,0,5,60,60
1649912828125,COGS 101B,A01,091572,Staff,32,0,60,28
1649912834148,COGS 101C,A01,083625,Delgado; Tania,24,0,30,6
1649912840172,COGS 107A,A01,083627,Boyle; Mary E. T.,14,0,60,46
1649912846195,COGS 118A,A01,083075,Staff,21,0,60,39
1649912852222,CSE 3,A50,083646,Miranda; Gregory Joseph,26,0,38,12
1649912852222,CSE 3,A51,083647,Miranda; Gregory Joseph,37,0,37,0
1649912858250,CSE 8A,A50,083650,Miranda; Gregory Joseph,8,0,40,32
1649912864274,CSE 11,A01,083080,Cao; Yingjun,0,26,40,40
1649912870298,CSE 12,A01,083652,Staff,57,0,100,43
1649912876323,CSE 15L,A01,083654,Staff,19,0,50,31
1649912876323,CSE 15L,A02,083655,Staff,47,0,50,3
1649912882350,CSE 20,A01,083657,Staff,68,0,80,12
1649912888381,CSE 30,A01,083084,Eldon; John,1,22,40,39
1649912894408,CSE 100,A01,083659,Cao; Yingjun,2,27,50,48
1649912900435,CSE 134B,A01,083661,Powell; Thomas Allan,2,23,65,63
1649912906463,CSE 140,A01,083663,Staff,25,0,75,50
1649912912493,CSE 140L,A01,083088,Eldon; John,19,0,75,56
1649912918519,CSE 175,A01,083665,Kumar; Rakesh,12,0,25,13
1649912924545,CSE 190,A00,092507,Dubnov; Shlomo,14,0,15,1
1649912930569,ECE 45,A01,083139,Staff,10,0,40,30
1649912936595,ECE 65,A50,083695,Staff,8,0,30,22
1649912942618,ECE 109,A01,091882,Touri; Behrouz,56,0,70,14
1649912948643,ECE 180,A00,083140,Abi Samra; Nicholas Camill,26,0,30,4
1649912948643,ECE 180,B00,083141,Abi Samra; Nicholas Camill,13,0,30,17
1649912954667,MATH 10A,A01,083735,Patchell; Gregory David,21,0,30,9
1649912954667,MATH 10A,A02,083736,Patchell; Gregory David,28,0,30,2
1649912954667,MATH 10A,A03,083737,Patchell; Gregory David,28,0,30,2
1649912960696,MATH 10B,A01,083207,Staff,12,0,30,18
1649912960696,MATH 10B,A02,083208,Staff,25,0,30,5
1649912960696,MATH 10B,B01,083739,Staff,25,0,30,5
1649912960696,MATH 10B,B02,083740,Staff,30,0,30,0
1649912966726,MATH 18,A01,083743,Staff,22,0,30,8
1649912966726,MATH 18,A02,083744,Staff,29,0,30,1
1649912966726,MATH 18,A03,083745,Staff,29,0,30,1
1649912966726,MATH 18,A04,083746,Staff,28,0,30,2
1649912966726,MATH 18,B01,083748,Staff,6,0,30,24
1649912966726,MATH 18,B02,083749,Staff,26,0,30,4
1649912966726,MATH 18,B03,083750,Staff,28,0,30,2
1649912966726,MATH 18,B04,083751,Staff,27,0,30,3
1649912972760,MATH 20A,A01,083754,Staff,37,0,40,3
1649912978783,MATH 20B,A01,083756,Staff,19,0,30,11
1649912978783,MATH 20B,A02,083757,Staff,30,0,30,0
1649912984817,MATH 20C,A01,083760,Staff,21,0,30,9
1649912984817,MATH 20C,A02,083761,Staff,23,0,30,7
1649912984817,MATH 20C,B01,083762,Staff,28,0,30,2
1649912984817,MATH 20C,B02,083763,Staff,30,0,30,0
1649912990845,MATH 20D,A01,083765,Staff,21,0,30,9
1649912990845,MATH 20D,A02,083766,Staff,30,0,30,0
1649912990845,MATH 20D,A03,083767,Staff,30,0,30,0
1649912996872,MATH 20E,A01,083771,Staff,14,0,30,16
1649912996872,MATH 20E,A02,083772,Staff,24,0,30,6
1649912996872,MATH 20E,B01,083773,Staff,18,0,30,12
1649912996872,MATH 20E,B02,083774,Staff,29,0,30,1
1649913002895,MATH 103A,A01,083777,Staff,0,1,30,30
1649913002895,MATH 103A,A02,083778,Staff,0,3,30,30
1649913002895,MATH 103A,B01,083779,Staff,0,0,30,30
1649913002895,MATH 103A,B02,083780,Staff,19,0,30,11
1649913008919,MATH 105,A01,085443,Staff,0,5,30,30
1649913014942,MATH 109,A01,083213,Anzaldo; Leesa B,16,0,30,14
1649913014942,MATH 109,A02,083214,Anzaldo; Leesa B,11,0,30,19
1649913014942,MATH 109,B01,083215,Anzaldo; Leesa B,26,0,30,4
1649913014942,MATH 109,B02,083216,Anzaldo; Leesa B,22,0,30,8
1649913020984,MATH 142A,A01,083219,Chow; Bennett,1,1,30,29
1649913020984,MATH 142A,A02,083220,Chow; Bennett,11,0,30,19
1649913020984,MATH 142A,B01,083221,Chow; Bennett,0,0,30,30
1649913020984,MATH 142A,B02,083222,Chow; Bennett,4,0,30,26
1649913027008,MATH 193A,A01,083224,Staff,0,3,30,30
1649913027008,MATH 193A,A02,083225,Staff,0,4,30,30
1649913027008,MATH 193A,A03,083781,Staff,5,0,30,25
1649913027008,MATH 193A,A04,083782,Staff,17,0,30,13
1649913033039,MATH 197,001,091859,McAuley; Julian John,9999,0,9999,0
1649913039095,COGS 9,A01,083615,Staff,17,0,60,43
1649913045118,COGS 11,A01,083617,Boyle; Mary E. T.,35,0,40,5
1649913051158,COGS 13,A01,083071,Staff,0,9,40,40
1649913057192,COGS 14A,A01,092681,Staff,66,0,100,34
1649913063215,COGS 14B,A01,083073,Cheng; Tzu-Han,25,0,50,25
1649913069239,COGS 17,A01,092677,Staff,63,0,75,12
1649913075262,COGS 100,A01,083619,Staff,0,2,60,60
1649913081284,COGS 101A,A01,083621,Davis; Joshua Daniel,0,5,60,60
1649913087310,COGS 101B,A01,091572,Staff,32,0,60,28
1649913093333,COGS 101C,A01,083625,Delgado; Tania,24,0,30,6
1649913099359,COGS 107A,A01,083627,Boyle; Mary E. T.,14,0,60,46
1649913105384,COGS 118A,A01,083075,Staff,21,0,60,39
1649913111412,CSE 3,A50,083646,Miranda; Gregory Joseph,26,0,38,12
1649913111412,CSE 3,A51,083647,Miranda; Gregory Joseph,37,0,37,0
1649913117510,CSE 8A,A50,083650,Miranda; Gregory Joseph,8,0,40,32
1649913123541,CSE 11,A01,083080,Cao; Yingjun,0,26,40,40
1649913129567,CSE 12,A01,083652,Staff,57,0,100,43
1649913135590,CSE 15L,A01,083654,Staff,19,0,50,31
1649913135590,CSE 15L,A02,083655,Staff,47,0,50,3
1649913141620,CSE 20,A01,083657,Staff,68,0,80,12
1649913147643,CSE 30,A01,083084,Eldon; John,1,22,40,39
1649913153669,CSE 100,A01,083659,Cao; Yingjun,2,27,50,48
1649913159693,CSE 134B,A01,083661,Powell; Thomas Allan,2,23,65,63
1649913165715,CSE 140,A01,083663,Staff,25,0,75,50
1649913171748,CSE 140L,A01,083088,Eldon; John,19,0,75,56
1649913177773,CSE 175,A01,083665,Kumar; Rakesh,12,0,25,13
1649913183802,CSE 190,A00,092507,Dubnov; Shlomo,14,0,15,1
1649913189825,ECE 45,A01,083139,Staff,9,0,40,31
1649913195851,ECE 65,A50,083695,Staff,8,0,30,22
1649913201881,ECE 109,A01,091882,Touri; Behrouz,56,0,70,14
1649913207904,ECE 180,A00,083140,Abi Samra; Nicholas Camill,26,0,30,4
1649913207904,ECE 180,B00,083141,Abi Samra; Nicholas Camill,13,0,30,17
1649913213931,MATH 10A,A01,083735,Patchell; Gregory David,20,0,30,10
1649913213931,MATH 10A,A02,083736,Patchell; Gregory David,28,0,30,2
1649913213931,MATH 10A,A03,083737,Patchell; Gregory David,28,0,30,2
1649913219955,MATH 10B,A01,083207,Staff,12,0,30,18
1649913219955,MATH 10B,A02,083208,Staff,25,0,30,5
1649913219955,MATH 10B,B01,083739,Staff,25,0,30,5
1649913219955,MATH 10B,B02,083740,Staff,30,0,30,0
1649913225979,MATH 18,A01,083743,Staff,22,0,30,8
1649913225979,MATH 18,A02,083744,Staff,29,0,30,1
1649913225979,MATH 18,A03,083745,Staff,29,0,30,1
1649913225979,MATH 18,A04,083746,Staff,28,0,30,2
1649913225979,MATH 18,B01,083748,Staff,6,0,30,24
1649913225979,MATH 18,B02,083749,Staff,26,0,30,4
1649913225979,MATH 18,B03,083750,Staff,28,0,30,2
1649913225979,MATH 18,B04,083751,Staff,27,0,30,3
1649913232002,MATH 20A,A01,083754,Staff,37,0,40,3
1649913238035,MATH 20B,A01,083756,Staff,19,0,30,11
1649913238035,MATH 20B,A02,083757,Staff,30,0,30,0
1649913244069,MATH 20C,A01,083760,Staff,21,0,30,9
1649913244069,MATH 20C,A02,083761,Staff,23,0,30,7
1649913244069,MATH 20C,B01,083762,Staff,28,0,30,2
1649913244069,MATH 20C,B02,083763,Staff,30,0,30,0
1649913250110,MATH 20D,A01,083765,Staff,21,0,30,9
1649913250110,MATH 20D,A02,083766,Staff,30,0,30,0
1649913250110,MATH 20D,A03,083767,Staff,30,0,30,0
1649913256156,MATH 20E,A01,083771,Staff,14,0,30,16
1649913256156,MATH 20E,A02,083772,Staff,24,0,30,6
1649913256156,MATH 20E,B01,083773,Staff,18,0,30,12
1649913256156,MATH 20E,B02,083774,Staff,29,0,30,1
1649913262183,MATH 103A,A01,083777,Staff,0,1,30,30
1649913262183,MATH 103A,A02,083778,Staff,0,3,30,30
1649913262183,MATH 103A,B01,083779,Staff,0,0,30,30
1649913262183,MATH 103A,B02,083780,Staff,18,0,30,12
1649913268218,MATH 105,A01,085443,Staff,0,5,30,30
1649913274257,MATH 109,A01,083213,Anzaldo; Leesa B,16,0,30,14
1649913274257,MATH 109,A02,083214,Anzaldo; Leesa B,11,0,30,19
1649913274257,MATH 109,B01,083215,Anzaldo; Leesa B,26,0,30,4
1649913274257,MATH 109,B02,083216,Anzaldo; Leesa B,22,0,30,8
1649913280286,MATH 142A,A01,083219,Chow; Bennett,1,1,30,29
1649913280286,MATH 142A,A02,083220,Chow; Bennett,11,0,30,19
1649913280286,MATH 142A,B01,083221,Chow; Bennett,0,0,30,30
1649913280286,MATH 142A,B02,083222,Chow; Bennett,4,0,30,26
1649913286317,MATH 193A,A01,083224,Staff,0,3,30,30
1649913286317,MATH 193A,A02,083225,Staff,0,4,30,30
1649913286317,MATH 193A,A03,083781,Staff,5,0,30,25
1649913286317,MATH 193A,A04,083782,Staff,17,0,30,13
1649913292344,MATH 197,001,091859,McAuley; Julian John,9999,0,9999,0
1649913298413,COGS 9,A01,083615,Staff,17,0,60,43
1649913304442,COGS 11,A01,083617,Boyle; Mary E. T.,35,0,40,5
1649913310474,COGS 13,A01,083071,Staff,0,9,40,40
1649913316508,COGS 14A,A01,092681,Staff,66,0,100,34
1649913322536,COGS 14B,A01,083073,Cheng; Tzu-Han,25,0,50,25
1649913328558,COGS 17,A01,092677,Staff,63,0,75,12
1649913334582,COGS 100,A01,083619,Staff,0,3,60,60
1649913340606,COGS 101A,A01,083621,Davis; Joshua Daniel,0,5,60,60
1649913346633,COGS 101B,A01,091572,Staff,32,0,60,28
1649913352658,COGS 101C,A01,083625,Delgado; Tania,24,0,30,6
1649913358693,COGS 107A,A01,083627,Boyle; Mary E. T.,14,0,60,46
1649913364723,COGS 118A,A01,083075,Staff,21,0,60,39
1649913370746,CSE 3,A50,083646,Miranda; Gregory Joseph,26,0,38,12
1649913370746,CSE 3,A51,083647,Miranda; Gregory Joseph,37,0,37,0
1649913376771,CSE 8A,A50,083650,Miranda; Gregory Joseph,8,0,40,32
1649913382794,CSE 11,A01,083080,Cao; Yingjun,0,26,40,40
1649913388821,CSE 12,A01,083652,Staff,57,0,100,43
1649913394845,CSE 15L,A01,083654,Staff,19,0,50,31
1649913394845,CSE 15L,A02,083655,Staff,47,0,50,3
1649913400869,CSE 20,A01,083657,Staff,68,0,80,12
1649913406892,CSE 30,A01,083084,Eldon; John,1,22,40,39
1649913412915,CSE 100,A01,083659,Cao; Yingjun,2,27,50,48
1649913418942,CSE 134B,A01,083661,Powell; Thomas Allan,2,23,65,63
1649913424967,CSE 140,A01,083663,Staff,25,0,75,50
1649913430990,CSE 140L,A01,083088,Eldon; John,19,0,75,56
1649913437016,CSE 175,A01,083665,Kumar; Rakesh,12,0,25,13
1649913443042,CSE 190,A00,092507,Dubnov; Shlomo,14,0,15,1
1649913449064,ECE 45,A01,083139,Staff,9,0,40,31
1649913455096,ECE 65,A50,083695,Staff,7,0,30,23
1649913461120,ECE 109,A01,091882,Touri; Behrouz,56,0,70,14
1649913467146,ECE 180,A00,083140,Abi Samra; Nicholas Camill,26,0,30,4
1649913467146,ECE 180,B00,083141,Abi Samra; Nicholas Camill,13,0,30,17
1649913473173,MATH 10A,A01,083735,Patchell; Gregory David,20,0,30,10
1649913473173,MATH 10A,A02,083736,Patchell; Gregory David,28,0,30,2
1649913473173,MATH 10A,A03,083737,Patchell; Gregory David,28,0,30,2
1649913479198,MATH 10B,A01,083207,Staff,12,0,30,18
1649913479198,MATH 10B,A02,083208,Staff,25,0,30,5
1649913479198,MATH 10B,B01,083739,Staff,25,0,30,5
1649913479198,MATH 10B,B02,083740,Staff,30,0,30,0
1649913485226,MATH 18,A01,083743,Staff,22,0,30,8
1649913485226,MATH 18,A02,083744,Staff,29,0,30,1
1649913485226,MATH 18,A03,083745,Staff,29,0,30,1
1649913485226,MATH 18,A04,083746,Staff,28,0,30,2
1649913485226,MATH 18,B01,083748,Staff,6,0,30,24
1649913485226,MATH 18,B02,083749,Staff,26,0,30,4
1649913485226,MATH 18,B03,083750,Staff,28,0,30,2
1649913485226,MATH 18,B04,083751,Staff,27,0,30,3
1649913491248,MATH 20A,A01,083754,Staff,37,0,40,3
1649913497271,MATH 20B,A01,083756,Staff,19,0,30,11
1649913497271,MATH 20B,A02,083757,Staff,30,0,30,0
1649913503304,MATH 20C,A01,083760,Staff,21,0,30,9
1649913503304,MATH 20C,A02,083761,Staff,23,0,30,7
1649913503304,MATH 20C,B01,083762,Staff,28,0,30,2
1649913503304,MATH 20C,B02,083763,Staff,30,0,30,0
1649913509330,MATH 20D,A01,083765,Staff,21,0,30,9
1649913509330,MATH 20D,A02,083766,Staff,30,0,30,0
1649913509330,MATH 20D,A03,083767,Staff,30,0,30,0
1649913515351,MATH 20E,A01,083771,Staff,13,0,30,17
1649913515351,MATH 20E,A02,083772,Staff,24,0,30,6
1649913515351,MATH 20E,B01,083773,Staff,18,0,30,12
1649913515351,MATH 20E,B02,083774,Staff,29,0,30,1
1649913521378,MATH 103A,A01,083777,Staff,0,2,30,30
1649913521378,MATH 103A,A02,083778,Staff,0,3,30,30
1649913521378,MATH 103A,B01,083779,Staff,1,0,30,29
1649913521378,MATH 103A,B02,083780,Staff,18,0,30,12
1649913527405,MATH 105,A01,085443,Staff,0,5,30,30
1649913533434,MATH 109,A01,083213,Anzaldo; Leesa B,16,0,30,14
1649913533434,MATH 109,A02,083214,Anzaldo; Leesa B,11,0,30,19
1649913533434,MATH 109,B01,083215,Anzaldo; Leesa B,26,0,30,4
1649913533434,MATH 109,B02,083216,Anzaldo; Leesa B,22,0,30,8
1649913539457,MATH 142A,A01,083219,Chow; Bennett,1,1,30,29
1649913539457,MATH 142A,A02,083220,Chow; Bennett,11,0,30,19
1649913539457,MATH 142A,B01,083221,Chow; Bennett,0,0,30,30
1649913539457,MATH 142A,B02,083222,Chow; Bennett,4,0,30,26
1649913545487,MATH 193A,A01,083224,Staff,0,3,30,30
1649913545487,MATH 193A,A02,083225,Staff,0,4,30,30
1649913545487,MATH 193A,A03,083781,Staff,5,0,30,25
1649913545487,MATH 193A,A04,083782,Staff,17,0,30,13
1649913551515,MATH 197,001,091859,McAuley; Julian John,9999,0,9999,0
1649913557568,COGS 9,A01,083615,Staff,17,0,60,43
1649913563595,COGS 11,A01,083617,Boyle; Mary E. T.,35,0,40,5
1649913569621,COGS 13,A01,083071,Staff,0,9,40,40
1649913575652,COGS 14A,A01,092681,Staff,66,0,100,34
1649913581676,COGS 14B,A01,083073,Cheng; Tzu-Han,25,0,50,25
1649913587702,COGS 17,A01,092677,Staff,63,0,75,12
1649913593726,COGS 100,A01,083619,Staff,0,3,60,60
1649913599752,COGS 101A,A01,083621,Davis; Joshua Daniel,0,5,60,60
1649913605776,COGS 101B,A01,091572,Staff,32,0,60,28
1649913611809,COGS 101C,A01,083625,Delgado; Tania,24,0,30,6
1649913617837,COGS 107A,A01,083627,Boyle; Mary E. T.,14,0,60,46
1649913623860,COGS 118A,A01,083075,Staff,21,0,60,39
1649913629885,CSE 3,A50,083646,Miranda; Gregory Joseph,26,0,38,12
1649913629885,CSE 3,A51,083647,Miranda; Gregory Joseph,37,0,37,0
1649913635913,CSE 8A,A50,083650,Miranda; Gregory Joseph,8,0,40,32
1649913641944,CSE 11,A01,083080,Cao; Yingjun,0,26,40,40
1649913647976,CSE 12,A01,083652,Staff,57,0,100,43
1649913654001,CSE 15L,A01,083654,Staff,19,0,50,31
1649913654001,CSE 15L,A02,083655,Staff,47,0,50,3
1649913660031,CSE 20,A01,083657,Staff,68,0,80,12
1649913666053,CSE 30,A01,083084,Eldon; John,1,23,40,39
1649913672077,CSE 100,A01,083659,Cao; Yingjun,2,27,50,48
1649913678106,CSE 134B,A01,083661,Powell; Thomas Allan,2,23,65,63
1649913684129,CSE 140,A01,083663,Staff,25,0,75,50
1649913690151,CSE 140L,A01,083088,Eldon; John,19,0,75,56
1649913696174,CSE 175,A01,083665,Kumar; Rakesh,12,0,25,13
1649913702200,CSE 190,A00,092507,Dubnov; Shlomo,14,0,15,1
1649913708227,ECE 45,A01,083139,Staff,9,0,40,31
1649913714323,ECE 65,A50,083695,Staff,7,0,30,23
1649913720367,ECE 109,A01,091882,Touri; Behrouz,56,0,70,14
1649913726391,ECE 180,A00,083140,Abi Samra; Nicholas Camill,26,0,30,4
1649913726391,ECE 180,B00,083141,Abi Samra; Nicholas Camill,13,0,30,17
1649913732415,MATH 10A,A01,083735,Patchell; Gregory David,20,0,30,10
1649913732415,MATH 10A,A02,083736,Patchell; Gregory David,28,0,30,2
1649913732415,MATH 10A,A03,083737,Patchell; Gregory David,28,0,30,2
1649913738438,MATH 10B,A01,083207,Staff,12,0,30,18
1649913738438,MATH 10B,A02,083208,Staff,25,0,30,5
1649913738438,MATH 10B,B01,083739,Staff,25,0,30,5
1649913738438,MATH 10B,B02,083740,Staff,30,0,30,0
1649913744467,MATH 18,A01,083743,Staff,22,0,30,8
1649913744467,MATH 18,A02,083744,Staff,29,0,30,1
1649913744467,MATH 18,A03,083745,Staff,29,0,30,1
1649913744467,MATH 18,A04,083746,Staff,28,0,30,2
1649913744467,MATH 18,B01,083748,Staff,6,0,30,24
1649913744467,MATH 18,B02,083749,Staff,26,0,30,4
1649913744467,MATH 18,B03,083750,Staff,28,0,30,2
1649913744467,MATH 18,B04,083751,Staff,27,0,30,3
1649913750496,MATH 20A,A01,083754,Staff,37,0,40,3
1649913756523,MATH 20B,A01,083756,Staff,19,0,30,11
1649913756523,MATH 20B,A02,083757,Staff,30,0,30,0
1649913762550,MATH 20C,A01,083760,Staff,21,0,30,9
1649913762550,MATH 20C,A02,083761,Staff,23,0,30,7
1649913762550,MATH 20C,B01,083762,Staff,28,0,30,2
1649913762550,MATH 20C,B02,083763,Staff,30,0,30,0
1649913768580,MATH 20D,A01,083765,Staff,21,0,30,9
1649913768580,MATH 20D,A02,083766,Staff,30,0,30,0
1649913768580,MATH 20D,A03,083767,Staff,30,0,30,0
1649913774612,MATH 20E,A01,083771,Staff,14,0,30,16
1649913774612,MATH 20E,A02,083772,Staff,24,0,30,6
1649913774612,MATH 20E,B01,083773,Staff,18,0,30,12
1649913774612,MATH 20E,B02,083774,Staff,29,0,30,1
1649913780641,MATH 103A,A01,083777,Staff,0,2,30,30
1649913780641,MATH 103A,A02,083778,Staff,0,3,30,30
1649913780641,MATH 103A,B01,083779,Staff,1,0,30,29
1649913780641,MATH 103A,B02,083780,Staff,18,0,30,12
1649913786663,MATH 105,A01,085443,Staff,0,5,30,30
1649913792692,MATH 109,A01,083213,Anzaldo; Leesa B,16,0,30,14
1649913792692,MATH 109,A02,083214,Anzaldo; Leesa B,11,0,30,19
1649913792692,MATH 109,B01,083215,Anzaldo; Leesa B,26,0,30,4
1649913792692,MATH 109,B02,083216,Anzaldo; Leesa B,22,0,30,8
1649913798719,MATH 142A,A01,083219,Chow; Bennett,1,1,30,29
1649913798719,MATH 142A,A02,083220,Chow; Bennett,10,0,30,20
1649913798719,MATH 142A,B01,083221,Chow; Bennett,0,0,30,30
1649913798719,MATH 142A,B02,083222,Chow; Bennett,4,0,30,26
1649913804748,MATH 193A,A01,083224,Staff,0,3,30,30
1649913804748,MATH 193A,A02,083225,Staff,0,4,30,30
1649913804748,MATH 193A,A03,083781,Staff,5,0,30,25
1649913804748,MATH 193A,A04,083782,Staff,17,0,30,13
1649913810772,MATH 197,001,091859,McAuley; Julian John,9999,0,9999,0
1649913816824,COGS 9,A01,083615,Staff,17,0,60,43
1649913822848,COGS 11,A01,083617,Boyle; Mary E. T.,35,0,40,5
1649913828870,COGS 13,A01,083071,Staff,0,9,40,40
1649913834893,COGS 14A,A01,092681,Staff,66,0,100,34
1649913840917,COGS 14B,A01,083073,Cheng; Tzu-Han,25,0,50,25
1649913846940,COGS 17,A01,092677,Staff,63,0,75,12
1649913852963,COGS 100,A01,083619,Staff,0,4,60,60
1649913858985,COGS 101A,A01,083621,Davis; Joshua Daniel,0,5,60,60
1649913865012,COGS 101B,A01,091572,Staff,32,0,60,28
1649913871039,COGS 101C,A01,083625,Delgado; Tania,24,0,30,6
1649913877064,COGS 107A,A01,083627,Boyle; Mary E. T.,14,0,60,46
1649913883100,COGS 118A,A01,083075,Staff,21,0,60,39
1649913889128,CSE 3,A50,083646,Miranda; Gregory Joseph,26,0,38,12
1649913889128,CSE 3,A51,083647,Miranda; Gregory Joseph,37,0,37,0
1649913895154,CSE 8A,A50,083650,Miranda; Gregory Joseph,8,0,40,32
1649913901178,CSE 11,A01,083080,Cao; Yingjun,0,26,40,40
1649913907205,CSE 12,A01,083652,Staff,56,0,100,44
1649913913228,CSE 15L,A01,083654,Staff,19,0,50,31
1649913913228,CSE 15L,A02,083655,Staff,47,0,50,3
1649913919253,CSE 20,A01,083657,Staff,68,0,80,12
1649913925274,CSE 30,A01,083084,Eldon; John,1,23,40,39
1649913931298,CSE 100,A01,083659,Cao; Yingjun,2,27,50,48
1649913937323,CSE 134B,A01,083661,Powell; Thomas Allan,2,23,65,63
1649913943347,CSE 140,A01,083663,Staff,25,0,75,50
1649913949377,CSE 140L,A01,083088,Eldon; John,19,0,75,56
1649913955400,CSE 175,A01,083665,Kumar; Rakesh,12,0,25,13
1649913961429,CSE 190,A00,092507,Dubnov; Shlomo,14,0,15,1
1649913967457,ECE 45,A01,083139,Staff,9,0,40,31
1649913973484,ECE 65,A50,083695,Staff,7,0,30,23
1649913979515,ECE 109,A01,091882,Touri; Behrouz,56,0,70,14
1649913985537,ECE 180,A00,083140,Abi Samra; Nicholas Camill,26,0,30,4
1649913985537,ECE 180,B00,083141,Abi Samra; Nicholas Camill,13,0,30,17
1649913991563,MATH 10A,A01,083735,Patchell; Gregory David,20,0,30,10
1649913991563,MATH 10A,A02,083736,Patchell; Gregory David,28,0,30,2
1649913991563,MATH 10A,A03,083737,Patchell; Gregory David,28,0,30,2
1649913997591,MATH 10B,A01,083207,Staff,12,0,30,18
1649913997591,MATH 10B,A02,083208,Staff,25,0,30,5
1649913997591,MATH 10B,B01,083739,Staff,25,0,30,5
1649913997591,MATH 10B,B02,083740,Staff,30,0,30,0
1649914003615,MATH 18,A01,083743,Staff,22,0,30,8
1649914003615,MATH 18,A02,083744,Staff,29,0,30,1
1649914003615,MATH 18,A03,083745,Staff,29,0,30,1
1649914003615,MATH 18,A04,083746,Staff,28,0,30,2
1649914003615,MATH 18,B01,083748,Staff,6,0,30,24
1649914003615,MATH 18,B02,083749,Staff,26,0,30,4
1649914003615,MATH 18,B03,083750,Staff,28,0,30,2
1649914003615,MATH 18,B04,083751,Staff,27,0,30,3
1649914009642,MATH 20A,A01,083754,Staff,37,0,40,3
1649914015664,MATH 20B,A01,083756,Staff,19,0,30,11
1649914015664,MATH 20B,A02,083757,Staff,30,0,30,0
1649914021700,MATH 20C,A01,083760,Staff,21,0,30,9
1649914021700,MATH 20C,A02,083761,Staff,23,0,30,7
1649914021700,MATH 20C,B01,083762,Staff,28,0,30,2
1649914021700,MATH 20C,B02,083763,Staff,30,0,30,0
1649914027726,MATH 20D,A01,083765,Staff,21,0,30,9
1649914027726,MATH 20D,A02,083766,Staff,30,0,30,0
1649914027726,MATH 20D,A03,083767,Staff,30,0,30,0
1649914033750,MATH 20E,A01,083771,Staff,14,0,30,16
1649914033750,MATH 20E,A02,083772,Staff,24,0,30,6
1649914033750,MATH 20E,B01,083773,Staff,18,0,30,12
1649914033750,MATH 20E,B02,083774,Staff,29,0,30,1
1649914039785,MATH 103A,A01,083777,Staff,0,3,30,30
1649914039785,MATH 103A,A02,083778,Staff,0,3,30,30
1649914039785,MATH 103A,B01,083779,Staff,1,0,30,29
1649914039785,MATH 103A,B02,083780,Staff,18,0,30,12
1649914045816,MATH 105,A01,085443,Staff,0,5,30,30
1649914051839,MATH 109,A01,083213,Anzaldo; Leesa B,16,0,30,14
1649914051839,MATH 109,A02,083214,Anzaldo; Leesa B,11,0,30,19
1649914051839,MATH 109,B01,083215,Anzaldo; Leesa B,26,0,30,4
1649914051839,MATH 109,B02,083216,Anzaldo; Leesa B,22,0,30,8
1649914057863,MATH 142A,A01,083219,Chow; Bennett,0,0,30,30
1649914057863,MATH 142A,A02,083220,Chow; Bennett,10,0,30,20
1649914057863,MATH 142A,B01,083221,Chow; Bennett,0,0,30,30
1649914057863,MATH 142A,B02,083222,Chow; Bennett,4,0,30,26
1649914063890,MATH 193A,A01,083224,Staff,0,3,30,30
1649914063890,MATH 193A,A02,083225,Staff,0,4,30,30
1649914063890,MATH 193A,A03,083781,Staff,5,0,30,25
1649914063890,MATH 193A,A04,083782,Staff,17,0,30,13
1649914069926,MATH 197,001,091859,McAuley; Julian John,9999,0,9999,0
1649914075977,COGS 9,A01,083615,Staff,17,0,60,43
1649914081999,COGS 11,A01,083617,Boyle; Mary E. T.,35,0,40,5
1649914088021,COGS 13,A01,083071,Staff,0,9,40,40
1649914094047,COGS 14A,A01,092681,Staff,66,0,100,34
1649914100072,COGS 14B,A01,083073,Cheng; Tzu-Han,25,0,50,25
1649914106094,COGS 17,A01,092677,Staff,63,0,75,12
1649914112116,COGS 100,A01,083619,Staff,0,4,60,60
1649914118138,COGS 101A,A01,083621,Davis; Joshua Daniel,0,5,60,60
1649914124161,COGS 101B,A01,091572,Staff,32,0,60,28
1649914130186,COGS 101C,A01,083625,Delgado; Tania,24,0,30,6
1649914136210,COGS 107A,A01,083627,Boyle; Mary E. T.,14,0,60,46
1649914142233,COGS 118A,A01,083075,Staff,21,0,60,39
1649914148265,CSE 3,A50,083646,Miranda; Gregory Joseph,26,0,38,12
1649914148265,CSE 3,A51,083647,Miranda; Gregory Joseph,37,0,37,0
1649914154287,CSE 8A,A50,083650,Miranda; Gregory Joseph,8,0,40,32
1649914160312,CSE 11,A01,083080,Cao; Yingjun,0,26,40,40
1649914166339,CSE 12,A01,083652,Staff,56,0,100,44
1649914172363,CSE 15L,A01,083654,Staff,19,0,50,31
1649914172363,CSE 15L,A02,083655,Staff,47,0,50,3
1649914178386,CSE 20,A01,083657,Staff,68,0,80,12
1649914184409,CSE 30,A01,083084,Eldon; John,0,22,40,40
1649914190434,CSE 100,A01,083659,Cao; Yingjun,1,25,50,49
1649914196460,CSE 134B,A01,083661,Powell; Thomas Allan,0,21,65,65
1649914202492,CSE 140,A01,083663,Staff,25,0,75,50
1649914208518,CSE 140L,A01,083088,Eldon; John,19,0,75,56
1649914214543,CSE 175,A01,083665,Kumar; Rakesh,12,0,25,13
1649914220569,CSE 190,A00,092507,Dubnov; Shlomo,14,0,15,1
1649914226592,ECE 45,A01,083139,Staff,9,0,40,31
1649914232617,ECE 65,A50,083695,Staff,7,0,30,23
1649914238649,ECE 109,A01,091882,Touri; Behrouz,56,0,70,14
1649914244683,ECE 180,A00,083140,Abi Samra; Nicholas Camill,26,0,30,4
1649914244683,ECE 180,B00,083141,Abi Samra; Nicholas Camill,13,0,30,17
1649914250713,MATH 10A,A01,083735,Patchell; Gregory David,20,0,30,10
1649914250713,MATH 10A,A02,083736,Patchell; Gregory David,28,0,30,2
1649914250713,MATH 10A,A03,083737,Patchell; Gregory David,28,0,30,2
1649914256738,MATH 10B,A01,083207,Staff,12,0,30,18
1649914256738,MATH 10B,A02,083208,Staff,25,0,30,5
1649914256738,MATH 10B,B01,083739,Staff,25,0,30,5
1649914256738,MATH 10B,B02,083740,Staff,30,0,30,0
1649914262768,MATH 18,A01,083743,Staff,22,0,30,8
1649914262768,MATH 18,A02,083744,Staff,29,0,30,1
1649914262768,MATH 18,A03,083745,Staff,29,0,30,1
1649914262768,MATH 18,A04,083746,Staff,28,0,30,2
1649914262768,MATH 18,B01,083748,Staff,6,0,30,24
1649914262768,MATH 18,B02,083749,Staff,26,0,30,4
1649914262768,MATH 18,B03,083750,Staff,28,0,30,2
1649914262768,MATH 18,B04,083751,Staff,27,0,30,3
1649914268794,MATH 20A,A01,083754,Staff,37,0,40,3
1649914274821,MATH 20B,A01,083756,Staff,19,0,30,11
1649914274821,MATH 20B,A02,083757,Staff,30,0,30,0
1649914280850,MATH 20C,A01,083760,Staff,21,0,30,9
1649914280850,MATH 20C,A02,083761,Staff,23,0,30,7
1649914280850,MATH 20C,B01,083762,Staff,28,0,30,2
1649914280850,MATH 20C,B02,083763,Staff,30,0,30,0
1649914286879,MATH 20D,A01,083765,Staff,21,0,30,9
1649914286879,MATH 20D,A02,083766,Staff,30,0,30,0
1649914286879,MATH 20D,A03,083767,Staff,30,0,30,0
1649914292903,MATH 20E,A01,083771,Staff,14,0,30,16
1649914292903,MATH 20E,A02,083772,Staff,24,0,30,6
1649914292903,MATH 20E,B01,083773,Staff,18,0,30,12
1649914292903,MATH 20E,B02,083774,Staff,29,0,30,1
1649914298925,MATH 103A,A01,083777,Staff,0,3,30,30
1649914298925,MATH 103A,A02,083778,Staff,0,3,30,30
1649914298925,MATH 103A,B01,083779,Staff,1,0,30,29
1649914298925,MATH 103A,B02,083780,Staff,18,0,30,12
1649914304957,MATH 105,A01,085443,Staff,0,5,30,30
1649914311054,MATH 109,A01,083213,Anzaldo; Leesa B,16,0,30,14
1649914311054,MATH 109,A02,083214,Anzaldo; Leesa B,11,0,30,19
1649914311054,MATH 109,B01,083215,Anzaldo; Leesa B,26,0,30,4
1649914311054,MATH 109,B02,083216,Anzaldo; Leesa B,22,0,30,8
1649914317083,MATH 142A,A01,083219,Chow; Bennett,0,1,30,30
1649914317083,MATH 142A,A02,083220,Chow; Bennett,9,0,30,21
1649914317083,MATH 142A,B01,083221,Chow; Bennett,0,0,30,30
1649914317083,MATH 142A,B02,083222,Chow; Bennett,3,0,30,27
1649914323112,MATH 193A,A01,083224,Staff,0,3,30,30
1649914323112,MATH 193A,A02,083225,Staff,0,4,30,30
1649914323112,MATH 193A,A03,083781,Staff,5,0,30,25
1649914323112,MATH 193A,A04,083782,Staff,17,0,30,13
1649914329134,MATH 197,001,091859,McAuley; Julian John,9999,0,9999,0
1649914335202,COGS 9,A01,083615,Staff,17,0,60,43
1649914341224,COGS 11,A01,083617,Boyle; Mary E. T.,35,0,40,5
1649914347251,COGS 13,A01,083071,Staff,0,9,40,40
1649914353286,COGS 14A,A01,092681,Staff,66,0,100,34
1649914359309,COGS 14B,A01,083073,Cheng; Tzu-Han,25,0,50,25
1649914365331,COGS 17,A01,092677,Staff,63,0,75,12
1649914371354,COGS 100,A01,083619,Staff,0,4,60,60
1649914377379,COGS 101A,A01,083621,Davis; Joshua Daniel,0,6,60,60
1649914383404,COGS 101B,A01,091572,Staff,32,0,60,28
1649914389428,COGS 101C,A01,083625,Delgado; Tania,24,0,30,6
1649914395450,COGS 107A,A01,083627,Boyle; Mary E. T.,14,0,60,46
1649914401475,COGS 118A,A01,083075,Staff,21,0,60,39
1649914407503,CSE 3,A50,083646,Miranda; Gregory Joseph,26,0,38,12
1649914407503,CSE 3,A51,083647,Miranda; Gregory Joseph,37,0,37,0
1649914413527,CSE 8A,A50,083650,Miranda; Gregory Joseph,8,0,40,32
1649914419550,CSE 11,A01,083080,Cao; Yingjun,0,26,40,40
1649914425576,CSE 12,A01,083652,Staff,56,0,100,44
1649914431608,CSE 15L,A01,083654,Staff,19,0,50,31
1649914431608,CSE 15L,A02,083655,Staff,47,0,50,3
1649914437635,CSE 20,A01,083657,Staff,68,0,80,12
1649914443658,CSE 30,A01,083084,Eldon; John,0,22,40,40
1649914449678,CSE 100,A01,083659,Cao; Yingjun,1,25,50,49
1649914455703,CSE 134B,A01,083661,Powell; Thomas Allan,0,21,65,65
1649914461726,CSE 140,A01,083663,Staff,25,0,75,50
1649914467751,CSE 140L,A01,083088,Eldon; John,19,0,75,56
1649914473778,CSE 175,A01,083665,Kumar; Rakesh,12,0,25,13
1649914479800,CSE 190,A00,092507,Dubnov; Shlomo,14,0,15,1
1649914485832,ECE 45,A01,083139,Staff,9,0,40,31
1649914491856,ECE 65,A50,083695,Staff,8,0,30,22
1649914497879,ECE 109,A01,091882,Touri; Behrouz,56,0,70,14
1649914503912,ECE 180,A00,083140,Abi Samra; Nicholas Camill,26,0,30,4
1649914503912,ECE 180,B00,083141,Abi Samra; Nicholas Camill,13,0,30,17
1649914509934,MATH 10A,A01,083735,Patchell; Gregory David,20,0,30,10
1649914509934,MATH 10A,A02,083736,Patchell; Gregory David,28,0,30,2
1649914509934,MATH 10A,A03,083737,Patchell; Gregory David,28,0,30,2
1649914515958,MATH 10B,A01,083207,Staff,12,0,30,18
1649914515958,MATH 10B,A02,083208,Staff,25,0,30,5
1649914515958,MATH 10B,B01,083739,Staff,25,0,30,5
1649914515958,MATH 10B,B02,083740,Staff,30,0,30,0
1649914521983,MATH 18,A01,083743,Staff,22,0,30,8
1649914521983,MATH 18,A02,083744,Staff,29,0,30,1
1649914521983,MATH 18,A03,083745,Staff,29,0,30,1
1649914521983,MATH 18,A04,083746,Staff,28,0,30,2
1649914521983,MATH 18,B01,083748,Staff,6,0,30,24
1649914521983,MATH 18,B02,083749,Staff,26,0,30,4
1649914521983,MATH 18,B03,083750,Staff,28,0,30,2
1649914521983,MATH 18,B04,083751,Staff,27,0,30,3
1649914528009,MATH 20A,A01,083754,Staff,37,0,40,3
1649914534044,MATH 20B,A01,083756,Staff,19,0,30,11
1649914534044,MATH 20B,A02,083757,Staff,30,0,30,0
1649914540069,MATH 20C,A01,083760,Staff,21,0,30,9
1649914540069,MATH 20C,A02,083761,Staff,23,0,30,7
1649914540069,MATH 20C,B01,083762,Staff,28,0,30,2
1649914540069,MATH 20C,B02,083763,Staff,30,0,30,0
1649914546097,MATH 20D,A01,083765,Staff,21,0,30,9
1649914546097,MATH 20D,A02,083766,Staff,30,0,30,0
1649914546097,MATH 20D,A03,083767,Staff,30,0,30,0
1649914552121,MATH 20E,A01,083771,Staff,14,0,30,16
1649914552121,MATH 20E,A02,083772,Staff,24,0,30,6
1649914552121,MATH 20E,B01,083773,Staff,18,0,30,12
1649914552121,MATH 20E,B02,083774,Staff,29,0,30,1
1649914558144,MATH 103A,A01,083777,Staff,0,3,30,30
1649914558144,MATH 103A,A02,083778,Staff,0,3,30,30
1649914558144,MATH 103A,B01,083779,Staff,0,0,30,30
1649914558144,MATH 103A,B02,083780,Staff,18,0,30,12
1649914564168,MATH 105,A01,085443,Staff,0,5,30,30
1649914570191,MATH 109,A01,083213,Anzaldo; Leesa B,16,0,30,14
1649914570191,MATH 109,A02,083214,Anzaldo; Leesa B,11,0,30,19
1649914570191,MATH 109,B01,083215,Anzaldo; Leesa B,26,0,30,4
1649914570191,MATH 109,B02,083216,Anzaldo; Leesa B,22,0,30,8
1649914576214,MATH 142A,A01,083219,Chow; Bennett,0,1,30,30
1649914576214,MATH 142A,A02,083220,Chow; Bennett,9,0,30,21
1649914576214,MATH 142A,B01,083221,Chow; Bennett,0,0,30,30
1649914576214,MATH 142A,B02,083222,Chow; Bennett,3,0,30,27
1649914582237,MATH 193A,A01,083224,Staff,0,3,30,30
1649914582237,MATH 193A,A02,083225,Staff,0,3,30,30
1649914582237,MATH 193A,A03,083781,Staff,4,0,30,26
1649914582237,MATH 193A,A04,083782,Staff,17,0,30,13
1649914588263,MATH 197,001,091859,McAuley; Julian John,9999,0,9999,0
1649914594324,COGS 9,A01,083615,Staff,17,0,60,43
1649914600351,COGS 11,A01,083617,Boyle; Mary E. T.,35,0,40,5
1649914606374,COGS 13,A01,083071,Staff,0,9,40,40
1649914612400,COGS 14A,A01,092681,Staff,66,0,100,34
1649914618426,COGS 14B,A01,083073,Cheng; Tzu-Han,25,0,50,25
1649914624453,COGS 17,A01,092677,Staff,63,0,75,12
1649914630485,COGS 100,A01,083619,Staff,0,4,60,60
1649914636512,COGS 101A,A01,083621,Davis; Joshua Daniel,0,6,60,60
1649914642543,COGS 101B,A01,091572,Staff,32,0,60,28
1649914648564,COGS 101C,A01,083625,Delgado; Tania,24,0,30,6
1649914654586,COGS 107A,A01,083627,Boyle; Mary E. T.,14,0,60,46
1649914660613,COGS 118A,A01,083075,Staff,21,0,60,39
1649914666650,CSE 3,A50,083646,Miranda; Gregory Joseph,26,0,38,12
1649914666650,CSE 3,A51,083647,Miranda; Gregory Joseph,37,0,37,0
1649914672677,CSE 8A,A50,083650,Miranda; Gregory Joseph,8,0,40,32
1649914678710,CSE 11,A01,083080,Cao; Yingjun,0,26,40,40
1649914684734,CSE 12,A01,083652,Staff,56,0,100,44
1649914690759,CSE 15L,A01,083654,Staff,19,0,50,31
1649914690759,CSE 15L,A02,083655,Staff,47,0,50,3
1649914696781,CSE 20,A01,083657,Staff,68,0,80,12
1649914702805,CSE 30,A01,083084,Eldon; John,0,23,40,40
1649914708831,CSE 100,A01,083659,Cao; Yingjun,1,25,50,49
1649914714858,CSE 134B,A01,083661,Powell; Thomas Allan,0,21,65,65
1649914720885,CSE 140,A01,083663,Staff,25,0,75,50
1649914726911,CSE 140L,A01,083088,Eldon; John,19,0,75,56
1649914732936,CSE 175,A01,083665,Kumar; Rakesh,12,0,25,13
1649914738958,CSE 190,A00,092507,Dubnov; Shlomo,14,0,15,1
1649914744984,ECE 45,A01,083139,Staff,9,0,40,31
1649914751009,ECE 65,A50,083695,Staff,8,0,30,22
1649914757031,ECE 109,A01,091882,Touri; Behrouz,56,0,70,14
1649914763055,ECE 180,A00,083140,Abi Samra; Nicholas Camill,26,0,30,4
1649914763055,ECE 180,B00,083141,Abi Samra; Nicholas Camill,13,0,30,17
1649914769079,MATH 10A,A01,083735,Patchell; Gregory David,20,0,30,10
1649914769079,MATH 10A,A02,083736,Patchell; Gregory David,28,0,30,2
1649914769079,MATH 10A,A03,083737,Patchell; Gregory David,28,0,30,2
1649914775111,MATH 10B,A01,083207,Staff,12,0,30,18
1649914775111,MATH 10B,A02,083208,Staff,25,0,30,5
1649914775111,MATH 10B,B01,083739,Staff,25,0,30,5
1649914775111,MATH 10B,B02,083740,Staff,30,0,30,0
1649914781151,MATH 18,A01,083743,Staff,22,0,30,8
1649914781151,MATH 18,A02,083744,Staff,29,0,30,1
1649914781151,MATH 18,A03,083745,Staff,29,0,30,1
1649914781151,MATH 18,A04,083746,Staff,28,0,30,2
1649914781151,MATH 18,B01,083748,Staff,6,0,30,24
1649914781151,MATH 18,B02,083749,Staff,26,0,30,4
1649914781151,MATH 18,B03,083750,Staff,28,0,30,2
1649914781151,MATH 18,B04,083751,Staff,27,0,30,3
1649914787173,MATH 20A,A01,083754,Staff,37,0,40,3
1649914793197,MATH 20B,A01,083756,Staff,19,0,30,11
1649914793197,MATH 20B,A02,083757,Staff,30,0,30,0
1649914799220,MATH 20C,A01,083760,Staff,21,0,30,9
1649914799220,MATH 20C,A02,083761,Staff,23,0,30,7
1649914799220,MATH 20C,B01,083762,Staff,28,0,30,2
1649914799220,MATH 20C,B02,083763,Staff,30,0,30,0
1649914805245,MATH 20D,A01,083765,Staff,21,0,30,9
1649914805245,MATH 20D,A02,083766,Staff,30,0,30,0
1649914805245,MATH 20D,A03,083767,Staff,30,0,30,0
1649914811271,MATH 20E,A01,083771,Staff,14,0,30,16
1649914811271,MATH 20E,A02,083772,Staff,24,0,30,6
1649914811271,MATH 20E,B01,083773,Staff,18,0,30,12
1649914811271,MATH 20E,B02,083774,Staff,29,0,30,1
1649914817297,MATH 103A,A01,083777,Staff,0,3,30,30
1649914817297,MATH 103A,A02,083778,Staff,0,3,30,30
1649914817297,MATH 103A,B01,083779,Staff,0,0,30,30
1649914817297,MATH 103A,B02,083780,Staff,18,0,30,12
1649914823321,MATH 105,A01,085443,Staff,0,5,30,30
1649914829348,MATH 109,A01,083213,Anzaldo; Leesa B,16,0,30,14
1649914829348,MATH 109,A02,083214,Anzaldo; Leesa B,11,0,30,19
1649914829348,MATH 109,B01,083215,Anzaldo; Leesa B,26,0,30,4
1649914829348,MATH 109,B02,083216,Anzaldo; Leesa B,22,0,30,8
1649914835376,MATH 142A,A01,083219,Chow; Bennett,0,1,30,30
1649914835376,MATH 142A,A02,083220,Chow; Bennett,10,0,30,20
1649914835376,MATH 142A,B01,083221,Chow; Bennett,0,0,30,30
1649914835376,MATH 142A,B02,083222,Chow; Bennett,2,0,30,28
1649914841402,MATH 193A,A01,083224,Staff,0,3,30,30
1649914841402,MATH 193A,A02,083225,Staff,0,3,30,30
1649914841402,MATH 193A,A03,083781,Staff,4,0,30,26
1649914841402,MATH 193A,A04,083782,Staff,17,0,30,13
1649914847427,MATH 197,001,091859,McAuley; Julian John,9999,0,9999,0
1649914853496,COGS 9,A01,083615,Staff,16,0,60,44
1649914859520,COGS 11,A01,083617,Boyle; Mary E. T.,35,0,40,5
1649914865543,COGS 13,A01,083071,Staff,0,9,40,40
1649914871571,COGS 14A,A01,092681,Staff,66,0,100,34
1649914877598,COGS 14B,A01,083073,Cheng; Tzu-Han,25,0,50,25
1649914883625,COGS 17,A01,092677,Staff,63,0,75,12
1649914889650,COGS 100,A01,083619,Staff,0,4,60,60
1649914895686,COGS 101A,A01,083621,Davis; Joshua Daniel,0,6,60,60
1649914901797,COGS 101B,A01,091572,Staff,32,0,60,28
1649914907830,COGS 101C,A01,083625,Delgado; Tania,24,0,30,6
1649914913855,COGS 107A,A01,083627,Boyle; Mary E. T.,14,0,60,46
1649914919879,COGS 118A,A01,083075,Staff,21,0,60,39
1649914925911,CSE 3,A50,083646,Miranda; Gregory Joseph,26,0,38,12
1649914925911,CSE 3,A51,083647,Miranda; Gregory Joseph,37,0,37,0
1649914931949,CSE 8A,A50,083650,Miranda; Gregory Joseph,8,0,40,32
1649914937972,CSE 11,A01,083080,Cao; Yingjun,0,26,40,40
1649914943996,CSE 12,A01,083652,Staff,56,0,100,44
1649914950022,CSE 15L,A01,083654,Staff,19,0,50,31
1649914950022,CSE 15L,A02,083655,Staff,47,0,50,3
1649914956052,CSE 20,A01,083657,Staff,68,0,80,12
1649914972223,CSE 30,A01,083084,Eldon; John,0,22,40,40
1649914978261,CSE 100,A01,083659,Cao; Yingjun,1,25,50,49
1649914984284,CSE 134B,A01,083661,Powell; Thomas Allan,0,21,65,65
1649914990307,CSE 140,A01,083663,Staff,24,0,75,51
1649914996351,CSE 140L,A01,083088,Eldon; John,18,0,75,57
1649915002377,CSE 175,A01,083665,Kumar; Rakesh,12,0,25,13
1649915008399,CSE 190,A00,092507,Dubnov; Shlomo,14,0,15,1
1649915014425,ECE 45,A01,083139,Staff,9,0,40,31
1649915020450,ECE 65,A50,083695,Staff,8,0,30,22
1649915026477,ECE 109,A01,091882,Touri; Behrouz,56,0,70,14
1649915032500,ECE 180,A00,083140,Abi Samra; Nicholas Camill,26,0,30,4
1649915032500,ECE 180,B00,083141,Abi Samra; Nicholas Camill,13,0,30,17
1649915038523,MATH 10A,A01,083735,Patchell; Gregory David,20,0,30,10
1649915038523,MATH 10A,A02,083736,Patchell; Gregory David,28,0,30,2
1649915038523,MATH 10A,A03,083737,Patchell; Gregory David,28,0,30,2
1649915044546,MATH 10B,A01,083207,Staff,12,0,30,18
1649915044546,MATH 10B,A02,083208,Staff,25,0,30,5
1649915044546,MATH 10B,B01,083739,Staff,25,0,30,5
1649915044546,MATH 10B,B02,083740,Staff,30,0,30,0
1649915050572,MATH 18,A01,083743,Staff,22,0,30,8
1649915050572,MATH 18,A02,083744,Staff,29,0,30,1
1649915050572,MATH 18,A03,083745,Staff,29,0,30,1
1649915050572,MATH 18,A04,083746,Staff,28,0,30,2
1649915050572,MATH 18,B01,083748,Staff,6,0,30,24
1649915050572,MATH 18,B02,083749,Staff,26,0,30,4
1649915050572,MATH 18,B03,083750,Staff,28,0,30,2
1649915050572,MATH 18,B04,083751,Staff,27,0,30,3
1649915056598,MATH 20A,A01,083754,Staff,37,0,40,3
1649915062620,MATH 20B,A01,083756,Staff,19,0,30,11
1649915062620,MATH 20B,A02,083757,Staff,30,0,30,0
1649915068647,MATH 20C,A01,083760,Staff,22,0,30,8
1649915068647,MATH 20C,A02,083761,Staff,23,0,30,7
1649915068647,MATH 20C,B01,083762,Staff,28,0,30,2
1649915068647,MATH 20C,B02,083763,Staff,30,0,30,0
1649915074674,MATH 20D,A01,083765,Staff,21,0,30,9
1649915074674,MATH 20D,A02,083766,Staff,30,0,30,0
1649915074674,MATH 20D,A03,083767,Staff,30,0,30,0
1649915080698,MATH 20E,A01,083771,Staff,14,0,30,16
1649915080698,MATH 20E,A02,083772,Staff,24,0,30,6
1649915080698,MATH 20E,B01,083773,Staff,18,0,30,12
1649915080698,MATH 20E,B02,083774,Staff,29,0,30,1
1649915086727,MATH 103A,A01,083777,Staff,0,3,30,30
1649915086727,MATH 103A,A02,083778,Staff,0,3,30,30
1649915086727,MATH 103A,B01,083779,Staff,0,0,30,30
1649915086727,MATH 103A,B02,083780,Staff,18,0,30,12
1649915092750,MATH 105,A01,085443,Staff,0,5,30,30
1649915098780,MATH 109,A01,083213,Anzaldo; Leesa B,16,0,30,14
1649915098780,MATH 109,A02,083214,Anzaldo; Leesa B,11,0,30,19
1649915098780,MATH 109,B01,083215,Anzaldo; Leesa B,26,0,30,4
1649915098780,MATH 109,B02,083216,Anzaldo; Leesa B,22,0,30,8
1649915104815,MATH 142A,A01,083219,Chow; Bennett,0,1,30,30
1649915104815,MATH 142A,A02,083220,Chow; Bennett,10,0,30,20
1649915104815,MATH 142A,B01,083221,Chow; Bennett,0,0,30,30
1649915104815,MATH 142A,B02,083222,Chow; Bennett,2,0,30,28
1649915110842,MATH 193A,A01,083224,Staff,0,3,30,30
1649915110842,MATH 193A,A02,083225,Staff,0,3,30,30
1649915110842,MATH 193A,A03,083781,Staff,4,0,30,26
1649915110842,MATH 193A,A04,083782,Staff,17,0,30,13
1649915116867,MATH 197,001,091859,McAuley; Julian John,9999,0,9999,0
1649915122919,COGS 9,A01,083615,Staff,16,0,60,44
1649915128945,COGS 11,A01,083617,Boyle; Mary E. T.,35,0,40,5
1649915134972,COGS 13,A01,083071,Staff,0,10,40,40
1649915140995,COGS 14A,A01,092681,Staff,66,0,100,34
1649915147018,COGS 14B,A01,083073,Cheng; Tzu-Han,24,0,50,26
1649915153042,COGS 17,A01,092677,Staff,63,0,75,12
1649915159069,COGS 100,A01,083619,Staff,0,4,60,60
1649915165096,COGS 101A,A01,083621,Davis; Joshua Daniel,0,6,60,60
1649915171129,COGS 101B,A01,091572,Staff,32,0,60,28
1649915177152,COGS 101C,A01,083625,Delgado; Tania,24,0,30,6
1649915183175,COGS 107A,A01,083627,Boyle; Mary E. T.,14,0,60,46
1649915189197,COGS 118A,A01,083075,Staff,21,0,60,39
1649915195231,CSE 3,A50,083646,Miranda; Gregory Joseph,26,0,38,12
1649915195231,CSE 3,A51,083647,Miranda; Gregory Joseph,37,0,37,0
1649915201264,CSE 8A,A50,083650,Miranda; Gregory Joseph,8,0,40,32
1649915207289,CSE 11,A01,083080,Cao; Yingjun,0,26,40,40
1649915213311,CSE 12,A01,083652,Staff,56,0,100,44
1649915219339,CSE 15L,A01,083654,Staff,19,0,50,31
1649915219339,CSE 15L,A02,083655,Staff,47,0,50,3
1649915225365,CSE 20,A01,083657,Staff,68,0,80,12
1649915231388,CSE 30,A01,083084,Eldon; John,0,22,40,40
1649915237412,CSE 100,A01,083659,Cao; Yingjun,1,25,50,49
1649915243435,CSE 134B,A01,083661,Powell; Thomas Allan,0,21,65,65
1649915249458,CSE 140,A01,083663,Staff,24,0,75,51
1649915255485,CSE 140L,A01,083088,Eldon; John,18,0,75,57
1649915261512,CSE 175,A01,083665,Kumar; Rakesh,12,0,25,13
1649915267538,CSE 190,A00,092507,Dubnov; Shlomo,14,0,15,1
1649915273560,ECE 45,A01,083139,Staff,8,0,40,32
1649915279584,ECE 65,A50,083695,Staff,8,0,30,22
1649915285607,ECE 109,A01,091882,Touri; Behrouz,55,0,70,15
1649915291631,ECE 180,A00,083140,Abi Samra; Nicholas Camill,26,0,30,4
1649915291631,ECE 180,B00,083141,Abi Samra; Nicholas Camill,13,0,30,17
1649915297657,MATH 10A,A01,083735,Patchell; Gregory David,20,0,30,10
1649915297657,MATH 10A,A02,083736,Patchell; Gregory David,28,0,30,2
1649915297657,MATH 10A,A03,083737,Patchell; Gregory David,28,0,30,2
1649915303687,MATH 10B,A01,083207,Staff,12,0,30,18
1649915303687,MATH 10B,A02,083208,Staff,25,0,30,5
1649915303687,MATH 10B,B01,083739,Staff,25,0,30,5
1649915303687,MATH 10B,B02,083740,Staff,30,0,30,0
1649915309717,MATH 18,A01,083743,Staff,22,0,30,8
1649915309717,MATH 18,A02,083744,Staff,29,0,30,1
1649915309717,MATH 18,A03,083745,Staff,29,0,30,1
1649915309717,MATH 18,A04,083746,Staff,28,0,30,2
1649915309717,MATH 18,B01,083748,Staff,6,0,30,24
1649915309717,MATH 18,B02,083749,Staff,26,0,30,4
1649915309717,MATH 18,B03,083750,Staff,28,0,30,2
1649915309717,MATH 18,B04,083751,Staff,27,0,30,3
1649915315743,MATH 20A,A01,083754,Staff,37,0,40,3
1649915321768,MATH 20B,A01,083756,Staff,19,0,30,11
1649915321768,MATH 20B,A02,083757,Staff,30,0,30,0
1649915327795,MATH 20C,A01,083760,Staff,22,0,30,8
1649915327795,MATH 20C,A02,083761,Staff,23,0,30,7
1649915327795,MATH 20C,B01,083762,Staff,28,0,30,2
1649915327795,MATH 20C,B02,083763,Staff,30,0,30,0
1649915333817,MATH 20D,A01,083765,Staff,21,0,30,9
1649915333817,MATH 20D,A02,083766,Staff,30,0,30,0
1649915333817,MATH 20D,A03,083767,Staff,30,0,30,0
1649915339841,MATH 20E,A01,083771,Staff,14,0,30,16
1649915339841,MATH 20E,A02,083772,Staff,24,0,30,6
1649915339841,MATH 20E,B01,083773,Staff,18,0,30,12
1649915339841,MATH 20E,B02,083774,Staff,29,0,30,1
1649915345869,MATH 103A,A01,083777,Staff,0,3,30,30
1649915345869,MATH 103A,A02,083778,Staff,0,3,30,30
1649915345869,MATH 103A,B01,083779,Staff,0,0,30,30
1649915345869,MATH 103A,B02,083780,Staff,18,0,30,12
1649915351892,MATH 105,A01,085443,Staff,0,5,30,30
1649915357920,MATH 109,A01,083213,Anzaldo; Leesa B,15,0,30,15
1649915357920,MATH 109,A02,083214,Anzaldo; Leesa B,11,0,30,19
1649915357920,MATH 109,B01,083215,Anzaldo; Leesa B,26,0,30,4
1649915357920,MATH 109,B02,083216,Anzaldo; Leesa B,22,0,30,8
1649915363945,MATH 142A,A01,083219,Chow; Bennett,0,1,30,30
1649915363945,MATH 142A,A02,083220,Chow; Bennett,10,0,30,20
1649915363945,MATH 142A,B01,083221,Chow; Bennett,0,0,30,30
1649915363945,MATH 142A,B02,083222,Chow; Bennett,2,0,30,28
1649915369972,MATH 193A,A01,083224,Staff,0,3,30,30
1649915369972,MATH 193A,A02,083225,Staff,0,3,30,30
1649915369972,MATH 193A,A03,083781,Staff,4,0,30,26
1649915369972,MATH 193A,A04,083782,Staff,17,0,30,13
1649915375997,MATH 197,001,091859,McAuley; Julian John,9999,0,9999,0
1649915382059,COGS 9,A01,083615,Staff,16,0,60,44
1649915388086,COGS 11,A01,083617,Boyle; Mary E. T.,35,0,40,5
1649915394109,COGS 13,A01,083071,Staff,0,10,40,40
1649915400133,COGS 14A,A01,092681,Staff,66,0,100,34
1649915406160,COGS 14B,A01,083073,Cheng; Tzu-Han,24,0,50,26
1649915412183,COGS 17,A01,092677,Staff,63,0,75,12
1649915418207,COGS 100,A01,083619,Staff,0,4,60,60
1649915424231,COGS 101A,A01,083621,Davis; Joshua Daniel,0,6,60,60
1649915430254,COGS 101B,A01,091572,Staff,32,0,60,28
1649915436281,COGS 101C,A01,083625,Delgado; Tania,24,0,30,6
1649915442304,COGS 107A,A01,083627,Boyle; Mary E. T.,14,0,60,46
1649915448327,COGS 118A,A01,083075,Staff,21,0,60,39
1649915454354,CSE 3,A50,083646,Miranda; Gregory Joseph,26,0,38,12
1649915454354,CSE 3,A51,083647,Miranda; Gregory Joseph,37,0,37,0
1649915460381,CSE 8A,A50,083650,Miranda; Gregory Joseph,8,0,40,32
1649915466406,CSE 11,A01,083080,Cao; Yingjun,0,26,40,40
1649915472431,CSE 12,A01,083652,Staff,56,0,100,44
1649915478454,CSE 15L,A01,083654,Staff,19,0,50,31
1649915478454,CSE 15L,A02,083655,Staff,47,0,50,3
1649915484479,CSE 20,A01,083657,Staff,68,0,80,12
1649915490502,CSE 30,A01,083084,Eldon; John,0,22,40,40
1649915496526,CSE 100,A01,083659,Cao; Yingjun,1,25,50,49
1649915502548,CSE 134B,A01,083661,Powell; Thomas Allan,0,21,65,65
1649915508645,CSE 140,A01,083663,Staff,24,0,75,51
1649915514670,CSE 140L,A01,083088,Eldon; John,18,0,75,57
1649915520696,CSE 175,A01,083665,Kumar; Rakesh,12,0,25,13
1649915526723,CSE 190,A00,092507,Dubnov; Shlomo,14,0,15,1
1649915532747,ECE 45,A01,083139,Staff,8,0,40,32
1649915538772,ECE 65,A50,083695,Staff,8,0,30,22
1649915544800,ECE 109,A01,091882,Touri; Behrouz,55,0,70,15
1649915550827,ECE 180,A00,083140,Abi Samra; Nicholas Camill,26,0,30,4
1649915550827,ECE 180,B00,083141,Abi Samra; Nicholas Camill,13,0,30,17
1649915556850,MATH 10A,A01,083735,Patchell; Gregory David,20,0,30,10
1649915556850,MATH 10A,A02,083736,Patchell; Gregory David,28,0,30,2
1649915556850,MATH 10A,A03,083737,Patchell; Gregory David,28,0,30,2
1649915562877,MATH 10B,A01,083207,Staff,12,0,30,18
1649915562877,MATH 10B,A02,083208,Staff,25,0,30,5
1649915562877,MATH 10B,B01,083739,Staff,25,0,30,5
1649915562877,MATH 10B,B02,083740,Staff,30,0,30,0
1649915568903,MATH 18,A01,083743,Staff,22,0,30,8
1649915568903,MATH 18,A02,083744,Staff,29,0,30,1
1649915568903,MATH 18,A03,083745,Staff,29,0,30,1
1649915568903,MATH 18,A04,083746,Staff,28,0,30,2
1649915568903,MATH 18,B01,083748,Staff,6,0,30,24
1649915568903,MATH 18,B02,083749,Staff,26,0,30,4
1649915568903,MATH 18,B03,083750,Staff,28,0,30,2
1649915568903,MATH 18,B04,083751,Staff,27,0,30,3
1649915574926,MATH 20A,A01,083754,Staff,37,0,40,3
1649915580952,MATH 20B,A01,083756,Staff,19,0,30,11
1649915580952,MATH 20B,A02,083757,Staff,30,0,30,0
1649915586976,MATH 20C,A01,083760,Staff,22,0,30,8
1649915586976,MATH 20C,A02,083761,Staff,23,0,30,7
1649915586976,MATH 20C,B01,083762,Staff,28,0,30,2
1649915586976,MATH 20C,B02,083763,Staff,30,0,30,0
1649915593000,MATH 20D,A01,083765,Staff,21,0,30,9
1649915593000,MATH 20D,A02,083766,Staff,30,0,30,0
1649915593000,MATH 20D,A03,083767,Staff,30,0,30,0
1649915599028,MATH 20E,A01,083771,Staff,14,0,30,16
1649915599028,MATH 20E,A02,083772,Staff,24,0,30,6
1649915599028,MATH 20E,B01,083773,Staff,18,0,30,12
1649915599028,MATH 20E,B02,083774,Staff,29,0,30,1
1649915605051,MATH 103A,A01,083777,Staff,0,3,30,30
1649915605051,MATH 103A,A02,083778,Staff,0,3,30,30
1649915605051,MATH 103A,B01,083779,Staff,0,0,30,30
1649915605051,MATH 103A,B02,083780,Staff,18,0,30,12
1649915611078,MATH 105,A01,085443,Staff,0,5,30,30
1649915617106,MATH 109,A01,083213,Anzaldo; Leesa B,15,0,30,15
1649915617106,MATH 109,A02,083214,Anzaldo; Leesa B,11,0,30,19
1649915617106,MATH 109,B01,083215,Anzaldo; Leesa B,26,0,30,4
1649915617106,MATH 109,B02,083216,Anzaldo; Leesa B,22,0,30,8
1649915623129,MATH 142A,A01,083219,Chow; Bennett,0,1,30,30
1649915623129,MATH 142A,A02,083220,Chow; Bennett,10,0,30,20
1649915623129,MATH 142A,B01,083221,Chow; Bennett,0,0,30,30
1649915623129,MATH 142A,B02,083222,Chow; Bennett,2,0,30,28
1649915629152,MATH 193A,A01,083224,Staff,0,3,30,30
1649915629152,MATH 193A,A02,083225,Staff,0,3,30,30
1649915629152,MATH 193A,A03,083781,Staff,4,0,30,26
1649915629152,MATH 193A,A04,083782,Staff,17,0,30,13
1649915635179,MATH 197,001,091859,McAuley; Julian John,9999,0,9999,0
1649915641230,COGS 9,A01,083615,Staff,16,0,60,44
1649915647252,COGS 11,A01,083617,Boyle; Mary E. T.,35,0,40,5
1649915653279,COGS 13,A01,083071,Staff,0,10,40,40
1649915659316,COGS 14A,A01,092681,Staff,66,0,100,34
1649915665343,COGS 14B,A01,083073,Cheng; Tzu-Han,24,0,50,26
1649915671365,COGS 17,A01,092677,Staff,63,0,75,12
1649915677388,COGS 100,A01,083619,Staff,0,4,60,60
1649915683416,COGS 101A,A01,083621,Davis; Joshua Daniel,0,6,60,60
1649915689441,COGS 101B,A01,091572,Staff,32,0,60,28
1649915695465,COGS 101C,A01,083625,Delgado; Tania,24,0,30,6
1649915701489,COGS 107A,A01,083627,Boyle; Mary E. T.,14,0,60,46
1649915707512,COGS 118A,A01,083075,Staff,21,0,60,39
1649915713536,CSE 3,A50,083646,Miranda; Gregory Joseph,26,0,38,12
1649915713536,CSE 3,A51,083647,Miranda; Gregory Joseph,37,0,37,0
1649915719563,CSE 8A,A50,083650,Miranda; Gregory Joseph,8,0,40,32
1649915725587,CSE 11,A01,083080,Cao; Yingjun,0,26,40,40
1649915731611,CSE 12,A01,083652,Staff,56,0,100,44
1649915737635,CSE 15L,A01,083654,Staff,19,0,50,31
1649915737635,CSE 15L,A02,083655,Staff,47,0,50,3
1649915743661,CSE 20,A01,083657,Staff,68,0,80,12
1649915749687,CSE 30,A01,083084,Eldon; John,0,23,40,40
1649915755710,CSE 100,A01,083659,Cao; Yingjun,1,25,50,49
1649915761737,CSE 134B,A01,083661,Powell; Thomas Allan,0,21,65,65
1649915767764,CSE 140,A01,083663,Staff,24,0,75,51
1649915773788,CSE 140L,A01,083088,Eldon; John,18,0,75,57
1649915779814,CSE 175,A01,083665,Kumar; Rakesh,12,0,25,13
1649915785838,CSE 190,A00,092507,Dubnov; Shlomo,14,0,15,1
1649915791862,ECE 45,A01,083139,Staff,8,0,40,32
1649915797891,ECE 65,A50,083695,Staff,8,0,30,22
1649915803916,ECE 109,A01,091882,Touri; Behrouz,55,0,70,15
1649915809938,ECE 180,A00,083140,Abi Samra; Nicholas Camill,26,0,30,4
1649915809938,ECE 180,B00,083141,Abi Samra; Nicholas Camill,13,0,30,17
1649915815973,MATH 10A,A01,083735,Patchell; Gregory David,20,0,30,10
1649915815973,MATH 10A,A02,083736,Patchell; Gregory David,28,0,30,2
1649915815973,MATH 10A,A03,083737,Patchell; Gregory David,28,0,30,2
1649915821995,MATH 10B,A01,083207,Staff,12,0,30,18
1649915821995,MATH 10B,A02,083208,Staff,25,0,30,5
1649915821995,MATH 10B,B01,083739,Staff,25,0,30,5
1649915821995,MATH 10B,B02,083740,Staff,30,0,30,0
1649915828020,MATH 18,A01,083743,Staff,22,0,30,8
1649915828020,MATH 18,A02,083744,Staff,29,0,30,1
1649915828020,MATH 18,A03,083745,Staff,29,0,30,1
1649915828020,MATH 18,A04,083746,Staff,28,0,30,2
1649915828020,MATH 18,B01,083748,Staff,6,0,30,24
1649915828020,MATH 18,B02,083749,Staff,26,0,30,4
1649915828020,MATH 18,B03,083750,Staff,28,0,30,2
1649915828020,MATH 18,B04,083751,Staff,27,0,30,3
1649915834043,MATH 20A,A01,083754,Staff,37,0,40,3
1649915840066,MATH 20B,A01,083756,Staff,19,0,30,11
1649915840066,MATH 20B,A02,083757,Staff,30,0,30,0
1649915846095,MATH 20C,A01,083760,Staff,22,0,30,8
1649915846095,MATH 20C,A02,083761,Staff,23,0,30,7
1649915846095,MATH 20C,B01,083762,Staff,28,0,30,2
1649915846095,MATH 20C,B02,083763,Staff,30,0,30,0
1649915852122,MATH 20D,A01,083765,Staff,21,0,30,9
1649915852122,MATH 20D,A02,083766,Staff,30,0,30,0
1649915852122,MATH 20D,A03,083767,Staff,30,0,30,0
1649915858148,MATH 20E,A01,083771,Staff,14,0,30,16
1649915858148,MATH 20E,A02,083772,Staff,24,0,30,6
1649915858148,MATH 20E,B01,083773,Staff,18,0,30,12
1649915858148,MATH 20E,B02,083774,Staff,29,0,30,1
1649915864175,MATH 103A,A01,083777,Staff,1,3,30,29
1649915864175,MATH 103A,A02,083778,Staff,0,3,30,30
1649915864175,MATH 103A,B01,083779,Staff,0,0,30,30
1649915864175,MATH 103A,B02,083780,Staff,18,0,30,12
1649915870199,MATH 105,A01,085443,Staff,0,5,30,30
1649915876222,MATH 109,A01,083213,Anzaldo; Leesa B,15,0,30,15
1649915876222,MATH 109,A02,083214,Anzaldo; Leesa B,11,0,30,19
1649915876222,MATH 109,B01,083215,Anzaldo; Leesa B,26,0,30,4
1649915876222,MATH 109,B02,083216,Anzaldo; Leesa B,22,0,30,8
1649915882246,MATH 142A,A01,083219,Chow; Bennett,0,1,30,30
1649915882246,MATH 142A,A02,083220,Chow; Bennett,10,0,30,20
1649915882246,MATH 142A,B01,083221,Chow; Bennett,0,0,30,30
1649915882246,MATH 142A,B02,083222,Chow; Bennett,2,0,30,28
1649915888273,MATH 193A,A01,083224,Staff,0,3,30,30
1649915888273,MATH 193A,A02,083225,Staff,0,3,30,30
1649915888273,MATH 193A,A03,083781,Staff,4,0,30,26
1649915888273,MATH 193A,A04,083782,Staff,16,0,30,14
1649915894297,MATH 197,001,091859,McAuley; Julian John,9999,0,9999,0
1649915900355,COGS 9,A01,083615,Staff,16,0,60,44
1649915906382,COGS 11,A01,083617,Boyle; Mary E. T.,35,0,40,5
1649915912405,COGS 13,A01,083071,Staff,0,10,40,40
1649915918429,COGS 14A,A01,092681,Staff,66,0,100,34
1649915924455,COGS 14B,A01,083073,Cheng; Tzu-Han,24,0,50,26
1649915930477,COGS 17,A01,092677,Staff,63,0,75,12
1649915936501,COGS 100,A01,083619,Staff,0,4,60,60
1649915942525,COGS 101A,A01,083621,Davis; Joshua Daniel,0,6,60,60
1649915948552,COGS 101B,A01,091572,Staff,32,0,60,28
1649915954578,COGS 101C,A01,083625,Delgado; Tania,24,0,30,6
1649915960601,COGS 107A,A01,083627,Boyle; Mary E. T.,14,0,60,46
1649915966628,COGS 118A,A01,083075,Staff,21,0,60,39
1649915972651,CSE 3,A50,083646,Miranda; Gregory Joseph,26,0,38,12
1649915972651,CSE 3,A51,083647,Miranda; Gregory Joseph,37,0,37,0
1649915978682,CSE 8A,A50,083650,Miranda; Gregory Joseph,8,0,40,32
1649915984714,CSE 11,A01,083080,Cao; Yingjun,0,26,40,40
1649915990753,CSE 12,A01,083652,Staff,56,0,100,44
1649915996777,CSE 15L,A01,083654,Staff,19,0,50,31
1649915996777,CSE 15L,A02,083655,Staff,47,0,50,3
1649916002800,CSE 20,A01,083657,Staff,68,0,80,12
1649916008829,CSE 30,A01,083084,Eldon; John,0,23,40,40
1649916014853,CSE 100,A01,083659,Cao; Yingjun,1,25,50,49
1649916020883,CSE 134B,A01,083661,Powell; Thomas Allan,0,21,65,65
1649916026904,CSE 140,A01,083663,Staff,24,0,75,51
1649916032930,CSE 140L,A01,083088,Eldon; John,18,0,75,57
1649916038957,CSE 175,A01,083665,Kumar; Rakesh,12,0,25,13
1649916044979,CSE 190,A00,092507,Dubnov; Shlomo,14,0,15,1
1649916051006,ECE 45,A01,083139,Staff,8,0,40,32
1649916057045,ECE 65,A50,083695,Staff,8,0,30,22
1649916063069,ECE 109,A01,091882,Touri; Behrouz,55,0,70,15
1649916069098,ECE 180,A00,083140,Abi Samra; Nicholas Camill,26,0,30,4
1649916069098,ECE 180,B00,083141,Abi Samra; Nicholas Camill,13,0,30,17
1649916075122,MATH 10A,A01,083735,Patchell; Gregory David,20,0,30,10
1649916075122,MATH 10A,A02,083736,Patchell; Gregory David,28,0,30,2
1649916075122,MATH 10A,A03,083737,Patchell; Gregory David,28,0,30,2
1649916081148,MATH 10B,A01,083207,Staff,12,0,30,18
1649916081148,MATH 10B,A02,083208,Staff,25,0,30,5
1649916081148,MATH 10B,B01,083739,Staff,25,0,30,5
1649916081148,MATH 10B,B02,083740,Staff,30,0,30,0
1649916087178,MATH 18,A01,083743,Staff,22,0,30,8
1649916087178,MATH 18,A02,083744,Staff,29,0,30,1
1649916087178,MATH 18,A03,083745,Staff,29,0,30,1
1649916087178,MATH 18,A04,083746,Staff,28,0,30,2
1649916087178,MATH 18,B01,083748,Staff,6,0,30,24
1649916087178,MATH 18,B02,083749,Staff,26,0,30,4
1649916087178,MATH 18,B03,083750,Staff,28,0,30,2
1649916087178,MATH 18,B04,083751,Staff,27,0,30,3
1649916093200,MATH 20A,A01,083754,Staff,37,0,40,3
1649916099232,MATH 20B,A01,083756,Staff,19,0,30,11
1649916099232,MATH 20B,A02,083757,Staff,30,0,30,0
1649916105333,MATH 20C,A01,083760,Staff,22,0,30,8
1649916105333,MATH 20C,A02,083761,Staff,23,0,30,7
1649916105333,MATH 20C,B01,083762,Staff,28,0,30,2
1649916105333,MATH 20C,B02,083763,Staff,30,0,30,0
1649916111357,MATH 20D,A01,083765,Staff,21,0,30,9
1649916111357,MATH 20D,A02,083766,Staff,30,0,30,0
1649916111357,MATH 20D,A03,083767,Staff,30,0,30,0
1649916117384,MATH 20E,A01,083771,Staff,14,0,30,16
1649916117384,MATH 20E,A02,083772,Staff,24,0,30,6
1649916117384,MATH 20E,B01,083773,Staff,18,0,30,12
1649916117384,MATH 20E,B02,083774,Staff,29,0,30,1
1649916123416,MATH 103A,A01,083777,Staff,1,3,30,29
1649916123416,MATH 103A,A02,083778,Staff,0,3,30,30
1649916123416,MATH 103A,B01,083779,Staff,0,0,30,30
1649916123416,MATH 103A,B02,083780,Staff,18,0,30,12
1649916129450,MATH 105,A01,085443,Staff,0,5,30,30
1649916135474,MATH 109,A01,083213,Anzaldo; Leesa B,15,0,30,15
1649916135474,MATH 109,A02,083214,Anzaldo; Leesa B,11,0,30,19
1649916135474,MATH 109,B01,083215,Anzaldo; Leesa B,26,0,30,4
1649916135474,MATH 109,B02,083216,Anzaldo; Leesa B,22,0,30,8
1649916141504,MATH 142A,A01,083219,Chow; Bennett,0,1,30,30
1649916141504,MATH 142A,A02,083220,Chow; Bennett,10,0,30,20
1649916141504,MATH 142A,B01,083221,Chow; Bennett,0,0,30,30
1649916141504,MATH 142A,B02,083222,Chow; Bennett,2,0,30,28
1649916147529,MATH 193A,A01,083224,Staff,0,3,30,30
1649916147529,MATH 193A,A02,083225,Staff,0,3,30,30
1649916147529,MATH 193A,A03,083781,Staff,4,0,30,26
1649916147529,MATH 193A,A04,083782,Staff,16,0,30,14
1649916153565,MATH 197,001,091859,McAuley; Julian John,9999,0,9999,0
1649916159622,COGS 9,A01,083615,Staff,16,0,60,44
1649916165645,COGS 11,A01,083617,Boyle; Mary E. T.,35,0,40,5
1649916171670,COGS 13,A01,083071,Staff,0,11,40,40
1649916177697,COGS 14A,A01,092681,Staff,66,0,100,34
1649916183729,COGS 14B,A01,083073,Cheng; Tzu-Han,24,0,50,26
1649916189755,COGS 17,A01,092677,Staff,63,0,75,12
1649916195784,COGS 100,A01,083619,Staff,0,5,60,60
1649916201809,COGS 101A,A01,083621,Davis; Joshua Daniel,0,6,60,60
1649916207835,COGS 101B,A01,091572,Staff,32,0,60,28
1649916213861,COGS 101C,A01,083625,Delgado; Tania,24,0,30,6
1649916219892,COGS 107A,A01,083627,Boyle; Mary E. T.,14,0,60,46
1649916225925,COGS 118A,A01,083075,Staff,21,0,60,39
1649916231954,CSE 3,A50,083646,Miranda; Gregory Joseph,26,0,38,12
1649916231954,CSE 3,A51,083647,Miranda; Gregory Joseph,37,0,37,0
1649916237988,CSE 8A,A50,083650,Miranda; Gregory Joseph,8,0,40,32
1649916244021,CSE 11,A01,083080,Cao; Yingjun,0,26,40,40
1649916250044,CSE 12,A01,083652,Staff,56,0,100,44
1649916256080,CSE 15L,A01,083654,Staff,19,0,50,31
1649916256080,CSE 15L,A02,083655,Staff,47,0,50,3
1649916262108,CSE 20,A01,083657,Staff,68,0,80,12
1649916268136,CSE 30,A01,083084,Eldon; John,0,23,40,40
1649916274159,CSE 100,A01,083659,Cao; Yingjun,1,25,50,49
1649916280183,CSE 134B,A01,083661,Powell; Thomas Allan,0,21,65,65
1649916286220,CSE 140,A01,083663,Staff,24,0,75,51
1649916292244,CSE 140L,A01,083088,Eldon; John,18,0,75,57
1649916298268,CSE 175,A01,083665,Kumar; Rakesh,12,0,25,13
1649916304290,CSE 190,A00,092507,Dubnov; Shlomo,14,0,15,1
1649916310323,ECE 45,A01,083139,Staff,8,0,40,32
1649916316346,ECE 65,A50,083695,Staff,8,0,30,22
1649916322374,ECE 109,A01,091882,Touri; Behrouz,55,0,70,15
1649916328398,ECE 180,A00,083140,Abi Samra; Nicholas Camill,26,0,30,4
1649916328398,ECE 180,B00,083141,Abi Samra; Nicholas Camill,13,0,30,17
1649916334421,MATH 10A,A01,083735,Patchell; Gregory David,20,0,30,10
1649916334421,MATH 10A,A02,083736,Patchell; Gregory David,28,0,30,2
1649916334421,MATH 10A,A03,083737,Patchell; Gregory David,28,0,30,2
1649916340449,MATH 10B,A01,083207,Staff,12,0,30,18
1649916340449,MATH 10B,A02,083208,Staff,25,0,30,5
1649916340449,MATH 10B,B01,083739,Staff,25,0,30,5
1649916340449,MATH 10B,B02,083740,Staff,30,0,30,0
1649916346477,MATH 18,A01,083743,Staff,22,0,30,8
1649916346477,MATH 18,A02,083744,Staff,29,0,30,1
1649916346477,MATH 18,A03,083745,Staff,29,0,30,1
1649916346477,MATH 18,A04,083746,Staff,28,0,30,2
1649916346477,MATH 18,B01,083748,Staff,6,0,30,24
1649916346477,MATH 18,B02,083749,Staff,26,0,30,4
1649916346477,MATH 18,B03,083750,Staff,28,0,30,2
1649916346477,MATH 18,B04,083751,Staff,27,0,30,3
1649916352499,MATH 20A,A01,083754,Staff,37,0,40,3
1649916358530,MATH 20B,A01,083756,Staff,19,0,30,11
1649916358530,MATH 20B,A02,083757,Staff,30,0,30,0
1649916364558,MATH 20C,A01,083760,Staff,22,0,30,8
1649916364558,MATH 20C,A02,083761,Staff,23,0,30,7
1649916364558,MATH 20C,B01,083762,Staff,28,0,30,2
1649916364558,MATH 20C,B02,083763,Staff,30,0,30,0
1649916370593,MATH 20D,A01,083765,Staff,21,0,30,9
1649916370593,MATH 20D,A02,083766,Staff,30,0,30,0
1649916370593,MATH 20D,A03,083767,Staff,30,0,30,0
1649916376619,MATH 20E,A01,083771,Staff,14,0,30,16
1649916376619,MATH 20E,A02,083772,Staff,24,0,30,6
1649916376619,MATH 20E,B01,083773,Staff,18,0,30,12
1649916376619,MATH 20E,B02,083774,Staff,29,0,30,1
1649916382647,MATH 103A,A01,083777,Staff,1,3,30,29
1649916382647,MATH 103A,A02,083778,Staff,0,3,30,30
1649916382647,MATH 103A,B01,083779,Staff,0,0,30,30
1649916382647,MATH 103A,B02,083780,Staff,18,0,30,12
1649916388671,MATH 105,A01,085443,Staff,0,5,30,30
1649916394700,MATH 109,A01,083213,Anzaldo; Leesa B,15,0,30,15
1649916394700,MATH 109,A02,083214,Anzaldo; Leesa B,11,0,30,19
1649916394700,MATH 109,B01,083215,Anzaldo; Leesa B,26,0,30,4
1649916394700,MATH 109,B02,083216,Anzaldo; Leesa B,22,0,30,8
1649916400736,MATH 142A,A01,083219,Chow; Bennett,0,1,30,30
1649916400736,MATH 142A,A02,083220,Chow; Bennett,9,0,30,21
1649916400736,MATH 142A,B01,083221,Chow; Bennett,0,0,30,30
1649916400736,MATH 142A,B02,083222,Chow; Bennett,2,0,30,28
1649916406761,MATH 193A,A01,083224,Staff,0,3,30,30
1649916406761,MATH 193A,A02,083225,Staff,0,3,30,30
1649916406761,MATH 193A,A03,083781,Staff,4,0,30,26
1649916406761,MATH 193A,A04,083782,Staff,16,0,30,14
1649916412784,MATH 197,001,091859,McAuley; Julian John,9999,0,9999,0
1649916418840,COGS 9,A01,083615,Staff,16,0,60,44
1649916424863,COGS 11,A01,083617,Boyle; Mary E. T.,35,0,40,5
1649916430886,COGS 13,A01,083071,Staff,0,11,40,40
1649916436912,COGS 14A,A01,092681,Staff,66,0,100,34
1649916442942,COGS 14B,A01,083073,Cheng; Tzu-Han,24,0,50,26
1649916448969,COGS 17,A01,092677,Staff,63,0,75,12
1649916454996,COGS 100,A01,083619,Staff,0,5,60,60
1649916461030,COGS 101A,A01,083621,Davis; Joshua Daniel,0,6,60,60
1649916467058,COGS 101B,A01,091572,Staff,32,0,60,28
1649916473110,COGS 101C,A01,083625,Delgado; Tania,24,0,30,6
1649916479134,COGS 107A,A01,083627,Boyle; Mary E. T.,14,0,60,46
1649916485163,COGS 118A,A01,083075,Staff,21,0,60,39
1649916491207,CSE 3,A50,083646,Miranda; Gregory Joseph,26,0,38,12
1649916491207,CSE 3,A51,083647,Miranda; Gregory Joseph,37,0,37,0
1649916497271,CSE 8A,A50,083650,Miranda; Gregory Joseph,8,0,40,32
1649916503295,CSE 11,A01,083080,Cao; Yingjun,0,26,40,40
1649916509318,CSE 12,A01,083652,Staff,56,0,100,44
1649916515342,CSE 15L,A01,083654,Staff,19,0,50,31
1649916515342,CSE 15L,A02,083655,Staff,47,0,50,3
1649916521368,CSE 20,A01,083657,Staff,68,0,80,12
1649916527403,CSE 30,A01,083084,Eldon; John,0,23,40,40
1649916533436,CSE 100,A01,083659,Cao; Yingjun,1,25,50,49
1649916539460,CSE 134B,A01,083661,Powell; Thomas Allan,0,21,65,65
1649916545485,CSE 140,A01,083663,Staff,24,0,75,51
1649916551512,CSE 140L,A01,083088,Eldon; John,18,0,75,57
1649916557545,CSE 175,A01,083665,Kumar; Rakesh,12,0,25,13
1649916563571,CSE 190,A00,092507,Dubnov; Shlomo,14,0,15,1
1649916569604,ECE 45,A01,083139,Staff,8,0,40,32
1649916575627,ECE 65,A50,083695,Staff,8,0,30,22
1649916581649,ECE 109,A01,091882,Touri; Behrouz,55,0,70,15
1649916587677,ECE 180,A00,083140,Abi Samra; Nicholas Camill,26,0,30,4
1649916587677,ECE 180,B00,083141,Abi Samra; Nicholas Camill,13,0,30,17
1649916593705,MATH 10A,A01,083735,Patchell; Gregory David,20,0,30,10
1649916593705,MATH 10A,A02,083736,Patchell; Gregory David,28,0,30,2
1649916593705,MATH 10A,A03,083737,Patchell; Gregory David,28,0,30,2
1649916599733,MATH 10B,A01,083207,Staff,12,0,30,18
1649916599733,MATH 10B,A02,083208,Staff,25,0,30,5
1649916599733,MATH 10B,B01,083739,Staff,25,0,30,5
1649916599733,MATH 10B,B02,083740,Staff,30,0,30,0
1649916605762,MATH 18,A01,083743,Staff,22,0,30,8
1649916605762,MATH 18,A02,083744,Staff,29,0,30,1
1649916605762,MATH 18,A03,083745,Staff,29,0,30,1
1649916605762,MATH 18,A04,083746,Staff,28,0,30,2
1649916605762,MATH 18,B01,083748,Staff,6,0,30,24
1649916605762,MATH 18,B02,083749,Staff,26,0,30,4
1649916605762,MATH 18,B03,083750,Staff,28,0,30,2
1649916605762,MATH 18,B04,083751,Staff,27,0,30,3
1649916611790,MATH 20A,A01,083754,Staff,37,0,40,3
1649916617819,MATH 20B,A01,083756,Staff,19,0,30,11
1649916617819,MATH 20B,A02,083757,Staff,30,0,30,0
1649916623842,MATH 20C,A01,083760,Staff,22,0,30,8
1649916623842,MATH 20C,A02,083761,Staff,23,0,30,7
1649916623842,MATH 20C,B01,083762,Staff,28,0,30,2
1649916623842,MATH 20C,B02,083763,Staff,30,0,30,0
1649916629865,MATH 20D,A01,083765,Staff,21,0,30,9
1649916629865,MATH 20D,A02,083766,Staff,30,0,30,0
1649916629865,MATH 20D,A03,083767,Staff,30,0,30,0
1649916635889,MATH 20E,A01,083771,Staff,14,0,30,16
1649916635889,MATH 20E,A02,083772,Staff,24,0,30,6
1649916635889,MATH 20E,B01,083773,Staff,18,0,30,12
1649916635889,MATH 20E,B02,083774,Staff,29,0,30,1
1649916641912,MATH 103A,A01,083777,Staff,1,3,30,29
1649916641912,MATH 103A,A02,083778,Staff,0,3,30,30
1649916641912,MATH 103A,B01,083779,Staff,0,0,30,30
1649916641912,MATH 103A,B02,083780,Staff,18,0,30,12
1649916647939,MATH 105,A01,085443,Staff,0,5,30,30
1649916653967,MATH 109,A01,083213,Anzaldo; Leesa B,15,0,30,15
1649916653967,MATH 109,A02,083214,Anzaldo; Leesa B,11,0,30,19
1649916653967,MATH 109,B01,083215,Anzaldo; Leesa B,26,0,30,4
1649916653967,MATH 109,B02,083216,Anzaldo; Leesa B,22,0,30,8
1649916659991,MATH 142A,A01,083219,Chow; Bennett,0,1,30,30
1649916659991,MATH 142A,A02,083220,Chow; Bennett,9,0,30,21
1649916659991,MATH 142A,B01,083221,Chow; Bennett,0,0,30,30
1649916659991,MATH 142A,B02,083222,Chow; Bennett,2,0,30,28
1649916666027,MATH 193A,A01,083224,Staff,0,3,30,30
1649916666027,MATH 193A,A02,083225,Staff,0,3,30,30
1649916666027,MATH 193A,A03,083781,Staff,4,0,30,26
1649916666027,MATH 193A,A04,083782,Staff,16,0,30,14
1649916672050,MATH 197,001,091859,McAuley; Julian John,9999,0,9999,0
1649916678112,COGS 9,A01,083615,Staff,16,0,60,44
1649916684140,COGS 11,A01,083617,Boyle; Mary E. T.,35,0,40,5
1649916690167,COGS 13,A01,083071,Staff,0,11,40,40
1649916696265,COGS 14A,A01,092681,Staff,66,0,100,34
1649916702287,COGS 14B,A01,083073,Cheng; Tzu-Han,24,0,50,26
1649916708312,COGS 17,A01,092677,Staff,63,0,75,12
1649916714334,COGS 100,A01,083619,Staff,0,5,60,60
1649916720365,COGS 101A,A01,083621,Davis; Joshua Daniel,0,6,60,60
1649916726391,COGS 101B,A01,091572,Staff,32,0,60,28
1649916732414,COGS 101C,A01,083625,Delgado; Tania,24,0,30,6
1649916738440,COGS 107A,A01,083627,Boyle; Mary E. T.,14,0,60,46
1649916744466,COGS 118A,A01,083075,Staff,21,0,60,39
1649916750491,CSE 3,A50,083646,Miranda; Gregory Joseph,26,0,38,12
1649916750491,CSE 3,A51,083647,Miranda; Gregory Joseph,37,0,37,0
1649916756515,CSE 8A,A50,083650,Miranda; Gregory Joseph,8,0,40,32
1649916762537,CSE 11,A01,083080,Cao; Yingjun,0,26,40,40
1649916768562,CSE 12,A01,083652,Staff,56,0,100,44
1649916774587,CSE 15L,A01,083654,Staff,19,0,50,31
1649916774587,CSE 15L,A02,083655,Staff,47,0,50,3
1649916780611,CSE 20,A01,083657,Staff,68,0,80,12
1649916786635,CSE 30,A01,083084,Eldon; John,0,23,40,40
1649916792659,CSE 100,A01,083659,Cao; Yingjun,1,25,50,49
1649916798683,CSE 134B,A01,083661,Powell; Thomas Allan,0,21,65,65
1649916804710,CSE 140,A01,083663,Staff,24,0,75,51
1649916810735,CSE 140L,A01,083088,Eldon; John,18,0,75,57
1649916816762,CSE 175,A01,083665,Kumar; Rakesh,12,0,25,13
1649916822788,CSE 190,A00,092507,Dubnov; Shlomo,14,0,15,1
1649916828812,ECE 45,A01,083139,Staff,8,0,40,32
1649916834833,ECE 65,A50,083695,Staff,8,0,30,22
1649916840867,ECE 109,A01,091882,Touri; Behrouz,55,0,70,15
1649916846895,ECE 180,A00,083140,Abi Samra; Nicholas Camill,26,0,30,4
1649916846895,ECE 180,B00,083141,Abi Samra; Nicholas Camill,13,0,30,17
1649916852924,MATH 10A,A01,083735,Patchell; Gregory David,20,0,30,10
1649916852924,MATH 10A,A02,083736,Patchell; Gregory David,28,0,30,2
1649916852924,MATH 10A,A03,083737,Patchell; Gregory David,28,0,30,2
1649916858948,MATH 10B,A01,083207,Staff,12,0,30,18
1649916858948,MATH 10B,A02,083208,Staff,25,0,30,5
1649916858948,MATH 10B,B01,083739,Staff,25,0,30,5
1649916858948,MATH 10B,B02,083740,Staff,30,0,30,0
1649916864976,MATH 18,A01,083743,Staff,22,0,30,8
1649916864976,MATH 18,A02,083744,Staff,29,0,30,1
1649916864976,MATH 18,A03,083745,Staff,29,0,30,1
1649916864976,MATH 18,A04,083746,Staff,28,0,30,2
1649916864976,MATH 18,B01,083748,Staff,6,0,30,24
1649916864976,MATH 18,B02,083749,Staff,26,0,30,4
1649916864976,MATH 18,B03,083750,Staff,28,0,30,2
1649916864976,MATH 18,B04,083751,Staff,27,0,30,3
1649916871005,MATH 20A,A01,083754,Staff,37,0,40,3
1649916877028,MATH 20B,A01,083756,Staff,19,0,30,11
1649916877028,MATH 20B,A02,083757,Staff,30,0,30,0
1649916883056,MATH 20C,A01,083760,Staff,22,0,30,8
1649916883056,MATH 20C,A02,083761,Staff,23,0,30,7
1649916883056,MATH 20C,B01,083762,Staff,28,0,30,2
1649916883056,MATH 20C,B02,083763,Staff,30,0,30,0
1649916889079,MATH 20D,A01,083765,Staff,20,0,30,10
1649916889079,MATH 20D,A02,083766,Staff,30,0,30,0
1649916889079,MATH 20D,A03,083767,Staff,30,0,30,0
1649916895106,MATH 20E,A01,083771,Staff,14,0,30,16
1649916895106,MATH 20E,A02,083772,Staff,24,0,30,6
1649916895106,MATH 20E,B01,083773,Staff,18,0,30,12
1649916895106,MATH 20E,B02,083774,Staff,29,0,30,1
1649916901135,MATH 103A,A01,083777,Staff,1,4,30,29
1649916901135,MATH 103A,A02,083778,Staff,0,3,30,30
1649916901135,MATH 103A,B01,083779,Staff,0,0,30,30
1649916901135,MATH 103A,B02,083780,Staff,18,0,30,12
1649916907164,MATH 105,A01,085443,Staff,0,5,30,30
1649916913192,MATH 109,A01,083213,Anzaldo; Leesa B,15,0,30,15
1649916913192,MATH 109,A02,083214,Anzaldo; Leesa B,10,0,30,20
1649916913192,MATH 109,B01,083215,Anzaldo; Leesa B,26,0,30,4
1649916913192,MATH 109,B02,083216,Anzaldo; Leesa B,22,0,30,8
1649916919216,MATH 142A,A01,083219,Chow; Bennett,0,1,30,30
1649916919216,MATH 142A,A02,083220,Chow; Bennett,9,0,30,21
1649916919216,MATH 142A,B01,083221,Chow; Bennett,0,0,30,30
1649916919216,MATH 142A,B02,083222,Chow; Bennett,2,0,30,28
1649916925239,MATH 193A,A01,083224,Staff,0,3,30,30
1649916925239,MATH 193A,A02,083225,Staff,0,3,30,30
1649916925239,MATH 193A,A03,083781,Staff,4,0,30,26
1649916925239,MATH 193A,A04,083782,Staff,16,0,30,14
1649916931264,MATH 197,001,091859,McAuley; Julian John,9999,0,9999,0
1649916937324,COGS 9,A01,083615,Staff,16,0,60,44
1649916943352,COGS 11,A01,083617,Boyle; Mary E. T.,35,0,40,5
1649916949374,COGS 13,A01,083071,Staff,0,11,40,40
1649916955401,COGS 14A,A01,092681,Staff,66,0,100,34
1649916961428,COGS 14B,A01,083073,Cheng; Tzu-Han,24,0,50,26
1649916967454,COGS 17,A01,092677,Staff,63,0,75,12
1649916973477,COGS 100,A01,083619,Staff,0,5,60,60
1649916979501,COGS 101A,A01,083621,Davis; Joshua Daniel,0,6,60,60
1649916985527,COGS 101B,A01,091572,Staff,32,0,60,28
1649916991548,COGS 101C,A01,083625,Delgado; Tania,24,0,30,6
1649916997575,COGS 107A,A01,083627,Boyle; Mary E. T.,14,0,60,46
1649917003599,COGS 118A,A01,083075,Staff,21,0,60,39
1649917009622,CSE 3,A50,083646,Miranda; Gregory Joseph,26,0,38,12
1649917009622,CSE 3,A51,083647,Miranda; Gregory Joseph,37,0,37,0
1649917015647,CSE 8A,A50,083650,Miranda; Gregory Joseph,8,0,40,32
1649917021672,CSE 11,A01,083080,Cao; Yingjun,0,26,40,40
1649917027698,CSE 12,A01,083652,Staff,56,0,100,44
1649917033722,CSE 15L,A01,083654,Staff,19,0,50,31
1649917033722,CSE 15L,A02,083655,Staff,47,0,50,3
1649917039756,CSE 20,A01,083657,Staff,68,0,80,12
1649917045784,CSE 30,A01,083084,Eldon; John,0,23,40,40
1649917051812,CSE 100,A01,083659,Cao; Yingjun,1,25,50,49
1649917057849,CSE 134B,A01,083661,Powell; Thomas Allan,0,21,65,65
1649917063878,CSE 140,A01,083663,Staff,24,0,75,51
1649917069917,CSE 140L,A01,083088,Eldon; John,18,0,75,57
1649917075940,CSE 175,A01,083665,Kumar; Rakesh,12,0,25,13
1649917081965,CSE 190,A00,092507,Dubnov; Shlomo,14,0,15,1
1649917088000,ECE 45,A01,083139,Staff,8,0,40,32
1649917094038,ECE 65,A50,083695,Staff,8,0,30,22
1649917100061,ECE 109,A01,091882,Touri; Behrouz,55,0,70,15
1649917106084,ECE 180,A00,083140,Abi Samra; Nicholas Camill,26,0,30,4
1649917106084,ECE 180,B00,083141,Abi Samra; Nicholas Camill,13,0,30,17
1649917112111,MATH 10A,A01,083735,Patchell; Gregory David,20,0,30,10
1649917112111,MATH 10A,A02,083736,Patchell; Gregory David,28,0,30,2
1649917112111,MATH 10A,A03,083737,Patchell; Gregory David,28,0,30,2
1649917118134,MATH 10B,A01,083207,Staff,12,0,30,18
1649917118134,MATH 10B,A02,083208,Staff,25,0,30,5
1649917118134,MATH 10B,B01,083739,Staff,25,0,30,5
1649917118134,MATH 10B,B02,083740,Staff,30,0,30,0
1649917124164,MATH 18,A01,083743,Staff,22,0,30,8
1649917124164,MATH 18,A02,083744,Staff,29,0,30,1
1649917124164,MATH 18,A03,083745,Staff,29,0,30,1
1649917124164,MATH 18,A04,083746,Staff,28,0,30,2
1649917124164,MATH 18,B01,083748,Staff,6,0,30,24
1649917124164,MATH 18,B02,083749,Staff,26,0,30,4
1649917124164,MATH 18,B03,083750,Staff,28,0,30,2
1649917124164,MATH 18,B04,083751,Staff,27,0,30,3
1649917130192,MATH 20A,A01,083754,Staff,37,0,40,3
1649917136218,MATH 20B,A01,083756,Staff,19,0,30,11
1649917136218,MATH 20B,A02,083757,Staff,30,0,30,0
1649917142241,MATH 20C,A01,083760,Staff,22,0,30,8
1649917142241,MATH 20C,A02,083761,Staff,23,0,30,7
1649917142241,MATH 20C,B01,083762,Staff,28,0,30,2
1649917142241,MATH 20C,B02,083763,Staff,30,0,30,0
1649917148264,MATH 20D,A01,083765,Staff,20,0,30,10
1649917148264,MATH 20D,A02,083766,Staff,30,0,30,0
1649917148264,MATH 20D,A03,083767,Staff,30,0,30,0
1649917154287,MATH 20E,A01,083771,Staff,14,0,30,16
1649917154287,MATH 20E,A02,083772,Staff,24,0,30,6
1649917154287,MATH 20E,B01,083773,Staff,18,0,30,12
1649917154287,MATH 20E,B02,083774,Staff,29,0,30,1
1649917160310,MATH 103A,A01,083777,Staff,1,4,30,29
1649917160310,MATH 103A,A02,083778,Staff,0,3,30,30
1649917160310,MATH 103A,B01,083779,Staff,0,0,30,30
1649917160310,MATH 103A,B02,083780,Staff,18,0,30,12
1649917166333,MATH 105,A01,085443,Staff,0,5,30,30
1649917172804,MATH 109,A01,083213,Anzaldo; Leesa B,15,0,30,15
1649917172804,MATH 109,A02,083214,Anzaldo; Leesa B,10,0,30,20
1649917172804,MATH 109,B01,083215,Anzaldo; Leesa B,26,0,30,4
1649917172804,MATH 109,B02,083216,Anzaldo; Leesa B,22,0,30,8
1649917178827,MATH 142A,A01,083219,Chow; Bennett,0,1,30,30
1649917178827,MATH 142A,A02,083220,Chow; Bennett,9,0,30,21
1649917178827,MATH 142A,B01,083221,Chow; Bennett,0,0,30,30
1649917178827,MATH 142A,B02,083222,Chow; Bennett,2,0,30,28
1649917184851,MATH 193A,A01,083224,Staff,0,3,30,30
1649917184851,MATH 193A,A02,083225,Staff,0,3,30,30
1649917184851,MATH 193A,A03,083781,Staff,4,0,30,26
1649917184851,MATH 193A,A04,083782,Staff,16,0,30,14
1649917190877,MATH 197,001,091859,McAuley; Julian John,9999,0,9999,0
1649917196938,COGS 9,A01,083615,Staff,16,0,60,44
1649917202961,COGS 11,A01,083617,Boyle; Mary E. T.,35,0,40,5
1649917209010,COGS 13,A01,083071,Staff,0,11,40,40
1649917215036,COGS 14A,A01,092681,Staff,66,0,100,34
1649917221061,COGS 14B,A01,083073,Cheng; Tzu-Han,24,0,50,26
1649917227086,COGS 17,A01,092677,Staff,63,0,75,12
1649917233115,COGS 100,A01,083619,Staff,0,5,60,60
1649917239143,COGS 101A,A01,083621,Davis; Joshua Daniel,0,6,60,60
1649917245174,COGS 101B,A01,091572,Staff,32,0,60,28
1649917251197,COGS 101C,A01,083625,Delgado; Tania,24,0,30,6
1649917257221,COGS 107A,A01,083627,Boyle; Mary E. T.,14,0,60,46
1649917263247,COGS 118A,A01,083075,Staff,21,0,60,39
1649917269274,CSE 3,A50,083646,Miranda; Gregory Joseph,26,0,38,12
1649917269274,CSE 3,A51,083647,Miranda; Gregory Joseph,37,0,37,0
1649917275305,CSE 8A,A50,083650,Miranda; Gregory Joseph,8,0,40,32
1649917281331,CSE 11,A01,083080,Cao; Yingjun,0,26,40,40
1649917287364,CSE 12,A01,083652,Staff,56,0,100,44
1649917293471,CSE 15L,A01,083654,Staff,19,0,50,31
1649917293471,CSE 15L,A02,083655,Staff,47,0,50,3
1649917299495,CSE 20,A01,083657,Staff,68,0,80,12
1649917305519,CSE 30,A01,083084,Eldon; John,0,23,40,40
1649917311544,CSE 100,A01,083659,Cao; Yingjun,1,25,50,49
1649917317569,CSE 134B,A01,083661,Powell; Thomas Allan,0,21,65,65
1649917323602,CSE 140,A01,083663,Staff,24,0,75,51
1649917329628,CSE 140L,A01,083088,Eldon; John,18,0,75,57
1649917335653,CSE 175,A01,083665,Kumar; Rakesh,12,0,25,13
1649917341684,CSE 190,A00,092507,Dubnov; Shlomo,14,0,15,1
1649917347708,ECE 45,A01,083139,Staff,8,0,40,32
1649917353735,ECE 65,A50,083695,Staff,8,0,30,22
1649917359759,ECE 109,A01,091882,Touri; Behrouz,55,0,70,15
1649917365783,ECE 180,A00,083140,Abi Samra; Nicholas Camill,26,0,30,4
1649917365783,ECE 180,B00,083141,Abi Samra; Nicholas Camill,13,0,30,17
1649917371807,MATH 10A,A01,083735,Patchell; Gregory David,20,0,30,10
1649917371807,MATH 10A,A02,083736,Patchell; Gregory David,28,0,30,2
1649917371807,MATH 10A,A03,083737,Patchell; Gregory David,28,0,30,2
1649917377832,MATH 10B,A01,083207,Staff,12,0,30,18
1649917377832,MATH 10B,A02,083208,Staff,25,0,30,5
1649917377832,MATH 10B,B01,083739,Staff,25,0,30,5
1649917377832,MATH 10B,B02,083740,Staff,30,0,30,0
1649917383857,MATH 18,A01,083743,Staff,22,0,30,8
1649917383857,MATH 18,A02,083744,Staff,29,0,30,1
1649917383857,MATH 18,A03,083745,Staff,29,0,30,1
1649917383857,MATH 18,A04,083746,Staff,28,0,30,2
1649917383857,MATH 18,B01,083748,Staff,6,0,30,24
1649917383857,MATH 18,B02,083749,Staff,26,0,30,4
1649917383857,MATH 18,B03,083750,Staff,28,0,30,2
1649917383857,MATH 18,B04,083751,Staff,27,0,30,3
1649917389880,MATH 20A,A01,083754,Staff,37,0,40,3
1649917395904,MATH 20B,A01,083756,Staff,19,0,30,11
1649917395904,MATH 20B,A02,083757,Staff,30,0,30,0
1649917401931,MATH 20C,A01,083760,Staff,22,0,30,8
1649917401931,MATH 20C,A02,083761,Staff,23,0,30,7
1649917401931,MATH 20C,B01,083762,Staff,28,0,30,2
1649917401931,MATH 20C,B02,083763,Staff,30,0,30,0
1649917407970,MATH 20D,A01,083765,Staff,20,0,30,10
1649917407970,MATH 20D,A02,083766,Staff,30,0,30,0
1649917407970,MATH 20D,A03,083767,Staff,30,0,30,0
1649917414004,MATH 20E,A01,083771,Staff,14,0,30,16
1649917414004,MATH 20E,A02,083772,Staff,24,0,30,6
1649917414004,MATH 20E,B01,083773,Staff,18,0,30,12
1649917414004,MATH 20E,B02,083774,Staff,29,0,30,1
1649917420031,MATH 103A,A01,083777,Staff,1,4,30,29
1649917420031,MATH 103A,A02,083778,Staff,0,3,30,30
1649917420031,MATH 103A,B01,083779,Staff,0,0,30,30
1649917420031,MATH 103A,B02,083780,Staff,18,0,30,12
1649917426057,MATH 105,A01,085443,Staff,0,5,30,30
1649917432087,MATH 109,A01,083213,Anzaldo; Leesa B,15,0,30,15
1649917432087,MATH 109,A02,083214,Anzaldo; Leesa B,10,0,30,20
1649917432087,MATH 109,B01,083215,Anzaldo; Leesa B,26,0,30,4
1649917432087,MATH 109,B02,083216,Anzaldo; Leesa B,22,0,30,8
1649917438115,MATH 142A,A01,083219,Chow; Bennett,0,1,30,30
1649917438115,MATH 142A,A02,083220,Chow; Bennett,9,0,30,21
1649917438115,MATH 142A,B01,083221,Chow; Bennett,0,1,30,30
1649917438115,MATH 142A,B02,083222,Chow; Bennett,2,0,30,28
1649917444139,MATH 193A,A01,083224,Staff,0,3,30,30
1649917444139,MATH 193A,A02,083225,Staff,0,3,30,30
1649917444139,MATH 193A,A03,083781,Staff,4,0,30,26
1649917444139,MATH 193A,A04,083782,Staff,16,0,30,14
1649917450167,MATH 197,001,091859,McAuley; Julian John,9999,0,9999,0
1649917456227,COGS 9,A01,083615,Staff,16,0,60,44
1649917462251,COGS 11,A01,083617,Boyle; Mary E. T.,35,0,40,5
1649917468275,COGS 13,A01,083071,Staff,0,11,40,40
1649917474301,COGS 14A,A01,092681,Staff,66,0,100,34
1649917480326,COGS 14B,A01,083073,Cheng; Tzu-Han,24,0,50,26
1649917486348,COGS 17,A01,092677,Staff,63,0,75,12
1649917492377,COGS 100,A01,083619,Staff,0,5,60,60
1649917498413,COGS 101A,A01,083621,Davis; Joshua Daniel,0,6,60,60
1649917504437,COGS 101B,A01,091572,Staff,32,0,60,28
1649917510465,COGS 101C,A01,083625,Delgado; Tania,24,0,30,6
1649917516489,COGS 107A,A01,083627,Boyle; Mary E. T.,14,0,60,46
1649917522517,COGS 118A,A01,083075,Staff,21,0,60,39
1649917528546,CSE 3,A50,083646,Miranda; Gregory Joseph,26,0,38,12
1649917528546,CSE 3,A51,083647,Miranda; Gregory Joseph,37,0,37,0
1649917534571,CSE 8A,A50,083650,Miranda; Gregory Joseph,8,0,40,32
1649917540593,CSE 11,A01,083080,Cao; Yingjun,0,26,40,40
1649917546623,CSE 12,A01,083652,Staff,56,0,100,44
1649917552650,CSE 15L,A01,083654,Staff,19,0,50,31
1649917552650,CSE 15L,A02,083655,Staff,47,0,50,3
1649917558679,CSE 20,A01,083657,Staff,68,0,80,12
1649917564701,CSE 30,A01,083084,Eldon; John,0,23,40,40
1649917570725,CSE 100,A01,083659,Cao; Yingjun,1,25,50,49
1649917576750,CSE 134B,A01,083661,Powell; Thomas Allan,0,21,65,65
1649917582774,CSE 140,A01,083663,Staff,24,0,75,51
1649917588799,CSE 140L,A01,083088,Eldon; John,18,0,75,57
1649917594825,CSE 175,A01,083665,Kumar; Rakesh,12,0,25,13
1649917600848,CSE 190,A00,092507,Dubnov; Shlomo,14,0,15,1
1649917606872,ECE 45,A01,083139,Staff,7,0,40,33
1649917612896,ECE 65,A50,083695,Staff,8,0,30,22
1649917618920,ECE 109,A01,091882,Touri; Behrouz,55,0,70,15
1649917624943,ECE 180,A00,083140,Abi Samra; Nicholas Camill,26,0,30,4
1649917624943,ECE 180,B00,083141,Abi Samra; Nicholas Camill,13,0,30,17
1649917630967,MATH 10A,A01,083735,Patchell; Gregory David,20,0,30,10
1649917630967,MATH 10A,A02,083736,Patchell; Gregory David,28,0,30,2
1649917630967,MATH 10A,A03,083737,Patchell; Gregory David,28,0,30,2
1649917636991,MATH 10B,A01,083207,Staff,12,0,30,18
1649917636991,MATH 10B,A02,083208,Staff,25,0,30,5
1649917636991,MATH 10B,B01,083739,Staff,25,0,30,5
1649917636991,MATH 10B,B02,083740,Staff,30,0,30,0
1649917643018,MATH 18,A01,083743,Staff,22,0,30,8
1649917643018,MATH 18,A02,083744,Staff,29,0,30,1
1649917643018,MATH 18,A03,083745,Staff,29,0,30,1
1649917643018,MATH 18,A04,083746,Staff,28,0,30,2
1649917643018,MATH 18,B01,083748,Staff,5,0,30,25
1649917643018,MATH 18,B02,083749,Staff,26,0,30,4
1649917643018,MATH 18,B03,083750,Staff,28,0,30,2
1649917643018,MATH 18,B04,083751,Staff,27,0,30,3
1649917649041,MATH 20A,A01,083754,Staff,37,0,40,3
1649917655065,MATH 20B,A01,083756,Staff,19,0,30,11
1649917655065,MATH 20B,A02,083757,Staff,30,0,30,0
1649917661091,MATH 20C,A01,083760,Staff,22,0,30,8
1649917661091,MATH 20C,A02,083761,Staff,23,0,30,7
1649917661091,MATH 20C,B01,083762,Staff,28,0,30,2
1649917661091,MATH 20C,B02,083763,Staff,30,0,30,0
1649917667114,MATH 20D,A01,083765,Staff,20,0,30,10
1649917667114,MATH 20D,A02,083766,Staff,30,0,30,0
1649917667114,MATH 20D,A03,083767,Staff,30,0,30,0
1649917673138,MATH 20E,A01,083771,Staff,14,0,30,16
1649917673138,MATH 20E,A02,083772,Staff,24,0,30,6
1649917673138,MATH 20E,B01,083773,Staff,18,0,30,12
1649917673138,MATH 20E,B02,083774,Staff,29,0,30,1
1649917679174,MATH 103A,A01,083777,Staff,1,4,30,29
1649917679174,MATH 103A,A02,083778,Staff,0,3,30,30
1649917679174,MATH 103A,B01,083779,Staff,0,0,30,30
1649917679174,MATH 103A,B02,083780,Staff,18,0,30,12
1649917685200,MATH 105,A01,085443,Staff,0,5,30,30
1649917691231,MATH 109,A01,083213,Anzaldo; Leesa B,15,0,30,15
1649917691231,MATH 109,A02,083214,Anzaldo; Leesa B,10,0,30,20
1649917691231,MATH 109,B01,083215,Anzaldo; Leesa B,26,0,30,4
1649917691231,MATH 109,B02,083216,Anzaldo; Leesa B,22,0,30,8
1649917697275,MATH 142A,A01,083219,Chow; Bennett,0,1,30,30
1649917697275,MATH 142A,A02,083220,Chow; Bennett,9,0,30,21
1649917697275,MATH 142A,B01,083221,Chow; Bennett,0,0,30,30
1649917697275,MATH 142A,B02,083222,Chow; Bennett,1,0,30,29
1649917703302,MATH 193A,A01,083224,Staff,0,3,30,30
1649917703302,MATH 193A,A02,083225,Staff,0,3,30,30
1649917703302,MATH 193A,A03,083781,Staff,4,0,30,26
1649917703302,MATH 193A,A04,083782,Staff,16,0,30,14
1649917709327,MATH 197,001,091859,McAuley; Julian John,9999,0,9999,0
1649917715381,COGS 9,A01,083615,Staff,16,0,60,44
1649917721419,COGS 11,A01,083617,Boyle; Mary E. T.,35,0,40,5
1649917727446,COGS 13,A01,083071,Staff,0,11,40,40
1649917733470,COGS 14A,A01,092681,Staff,66,0,100,34
1649917739506,COGS 14B,A01,083073,Cheng; Tzu-Han,24,0,50,26
1649917745533,COGS 17,A01,092677,Staff,63,0,75,12
1649917751557,COGS 100,A01,083619,Staff,0,5,60,60
1649917757581,COGS 101A,A01,083621,Davis; Joshua Daniel,0,6,60,60
1649917763605,COGS 101B,A01,091572,Staff,32,0,60,28
1649917769638,COGS 101C,A01,083625,Delgado; Tania,24,0,30,6
1649917775662,COGS 107A,A01,083627,Boyle; Mary E. T.,14,0,60,46
1649917781690,COGS 118A,A01,083075,Staff,21,0,60,39
1649917787713,CSE 3,A50,083646,Miranda; Gregory Joseph,26,0,38,12
1649917787713,CSE 3,A51,083647,Miranda; Gregory Joseph,37,0,37,0
1649917793742,CSE 8A,A50,083650,Miranda; Gregory Joseph,8,0,40,32
1649917799768,CSE 11,A01,083080,Cao; Yingjun,0,26,40,40
1649917805791,CSE 12,A01,083652,Staff,56,0,100,44
1649917811818,CSE 15L,A01,083654,Staff,19,0,50,31
1649917811818,CSE 15L,A02,083655,Staff,47,0,50,3
1649917817847,CSE 20,A01,083657,Staff,68,0,80,12
1649917823878,CSE 30,A01,083084,Eldon; John,0,23,40,40
1649917829901,CSE 100,A01,083659,Cao; Yingjun,1,25,50,49
1649917835929,CSE 134B,A01,083661,Powell; Thomas Allan,0,21,65,65
1649917841956,CSE 140,A01,083663,Staff,24,0,75,51
1649917847979,CSE 140L,A01,083088,Eldon; John,18,0,75,57
1649917854004,CSE 175,A01,083665,Kumar; Rakesh,12,0,25,13
1649917860029,CSE 190,A00,092507,Dubnov; Shlomo,14,0,15,1
1649917866058,ECE 45,A01,083139,Staff,8,0,40,32
1649917872087,ECE 65,A50,083695,Staff,7,0,30,23
1649917878120,ECE 109,A01,091882,Touri; Behrouz,55,0,70,15
1649917884144,ECE 180,A00,083140,Abi Samra; Nicholas Camill,26,0,30,4
1649917884144,ECE 180,B00,083141,Abi Samra; Nicholas Camill,13,0,30,17
1649917890242,MATH 10A,A01,083735,Patchell; Gregory David,20,0,30,10
1649917890242,MATH 10A,A02,083736,Patchell; Gregory David,28,0,30,2
1649917890242,MATH 10A,A03,083737,Patchell; Gregory David,28,0,30,2
1649917896269,MATH 10B,A01,083207,Staff,12,0,30,18
1649917896269,MATH 10B,A02,083208,Staff,25,0,30,5
1649917896269,MATH 10B,B01,083739,Staff,25,0,30,5
1649917896269,MATH 10B,B02,083740,Staff,30,0,30,0
1649917902295,MATH 18,A01,083743,Staff,22,0,30,8
1649917902295,MATH 18,A02,083744,Staff,29,0,30,1
1649917902295,MATH 18,A03,083745,Staff,29,0,30,1
1649917902295,MATH 18,A04,083746,Staff,28,0,30,2
1649917902295,MATH 18,B01,083748,Staff,5,0,30,25
1649917902295,MATH 18,B02,083749,Staff,26,0,30,4
1649917902295,MATH 18,B03,083750,Staff,28,0,30,2
1649917902295,MATH 18,B04,083751,Staff,27,0,30,3
1649917908320,MATH 20A,A01,083754,Staff,37,0,40,3
1649917914344,MATH 20B,A01,083756,Staff,19,0,30,11
1649917914344,MATH 20B,A02,083757,Staff,30,0,30,0
1649917920372,MATH 20C,A01,083760,Staff,22,0,30,8
1649917920372,MATH 20C,A02,083761,Staff,23,0,30,7
1649917920372,MATH 20C,B01,083762,Staff,28,0,30,2
1649917920372,MATH 20C,B02,083763,Staff,30,0,30,0
1649917926403,MATH 20D,A01,083765,Staff,20,0,30,10
1649917926403,MATH 20D,A02,083766,Staff,30,0,30,0
1649917926403,MATH 20D,A03,083767,Staff,30,0,30,0
1649917932429,MATH 20E,A01,083771,Staff,14,0,30,16
1649917932429,MATH 20E,A02,083772,Staff,24,0,30,6
1649917932429,MATH 20E,B01,083773,Staff,18,0,30,12
1649917932429,MATH 20E,B02,083774,Staff,29,0,30,1
1649917938454,MATH 103A,A01,083777,Staff,1,4,30,29
1649917938454,MATH 103A,A02,083778,Staff,0,3,30,30
1649917938454,MATH 103A,B01,083779,Staff,0,0,30,30
1649917938454,MATH 103A,B02,083780,Staff,18,0,30,12
1649917944480,MATH 105,A01,085443,Staff,0,5,30,30
1649917950505,MATH 109,A01,083213,Anzaldo; Leesa B,15,0,30,15
1649917950505,MATH 109,A02,083214,Anzaldo; Leesa B,10,0,30,20
1649917950505,MATH 109,B01,083215,Anzaldo; Leesa B,26,0,30,4
1649917950505,MATH 109,B02,083216,Anzaldo; Leesa B,22,0,30,8
1649917956529,MATH 142A,A01,083219,Chow; Bennett,0,1,30,30
1649917956529,MATH 142A,A02,083220,Chow; Bennett,9,0,30,21
1649917956529,MATH 142A,B01,083221,Chow; Bennett,0,0,30,30
1649917956529,MATH 142A,B02,083222,Chow; Bennett,0,0,30,30
1649917962556,MATH 193A,A01,083224,Staff,0,3,30,30
1649917962556,MATH 193A,A02,083225,Staff,0,3,30,30
1649917962556,MATH 193A,A03,083781,Staff,4,0,30,26
1649917962556,MATH 193A,A04,083782,Staff,16,0,30,14
1649917968578,MATH 197,001,091859,McAuley; Julian John,9999,0,9999,0
1649917974646,COGS 9,A01,083615,Staff,16,0,60,44
1649917980674,COGS 11,A01,083617,Boyle; Mary E. T.,35,0,40,5
1649917986701,COGS 13,A01,083071,Staff,0,11,40,40
1649917992729,COGS 14A,A01,092681,Staff,66,0,100,34
1649917998753,COGS 14B,A01,083073,Cheng; Tzu-Han,24,0,50,26
1649918004786,COGS 17,A01,092677,Staff,63,0,75,12
1649918010820,COGS 100,A01,083619,Staff,0,5,60,60
1649918016853,COGS 101A,A01,083621,Davis; Joshua Daniel,0,6,60,60
1649918022887,COGS 101B,A01,091572,Staff,32,0,60,28
1649918028917,COGS 101C,A01,083625,Delgado; Tania,24,0,30,6
1649918034941,COGS 107A,A01,083627,Boyle; Mary E. T.,14,0,60,46
1649918040966,COGS 118A,A01,083075,Staff,21,0,60,39
1649918046994,CSE 3,A50,083646,Miranda; Gregory Joseph,26,0,38,12
1649918046994,CSE 3,A51,083647,Miranda; Gregory Joseph,37,0,37,0
1649918053022,CSE 8A,A50,083650,Miranda; Gregory Joseph,8,0,40,32
1649918059048,CSE 11,A01,083080,Cao; Yingjun,0,26,40,40
1649918065071,CSE 12,A01,083652,Staff,56,0,100,44
1649918071103,CSE 15L,A01,083654,Staff,19,0,50,31
1649918071103,CSE 15L,A02,083655,Staff,47,0,50,3
1649918077129,CSE 20,A01,083657,Staff,68,0,80,12
1649918083155,CSE 30,A01,083084,Eldon; John,0,23,40,40
1649918089183,CSE 100,A01,083659,Cao; Yingjun,1,25,50,49
1649918095218,CSE 134B,A01,083661,Powell; Thomas Allan,0,21,65,65
1649918101245,CSE 140,A01,083663,Staff,24,0,75,51
1649918107287,CSE 140L,A01,083088,Eldon; John,18,0,75,57
1649918113313,CSE 175,A01,083665,Kumar; Rakesh,12,0,25,13
1649918119349,CSE 190,A00,092507,Dubnov; Shlomo,14,0,15,1
1649918125373,ECE 45,A01,083139,Staff,7,0,40,33
1649918131406,ECE 65,A50,083695,Staff,8,0,30,22
1649918137433,ECE 109,A01,091882,Touri; Behrouz,55,0,70,15
1649918143460,ECE 180,A00,083140,Abi Samra; Nicholas Camill,26,0,30,4
1649918143460,ECE 180,B00,083141,Abi Samra; Nicholas Camill,13,0,30,17
1649918149489,MATH 10A,A01,083735,Patchell; Gregory David,20,0,30,10
1649918149489,MATH 10A,A02,083736,Patchell; Gregory David,28,0,30,2
1649918149489,MATH 10A,A03,083737,Patchell; Gregory David,28,0,30,2
1649918155524,MATH 10B,A01,083207,Staff,11,0,30,19
1649918155524,MATH 10B,A02,083208,Staff,25,0,30,5
1649918155524,MATH 10B,B01,083739,Staff,25,0,30,5
1649918155524,MATH 10B,B02,083740,Staff,30,0,30,0
1649918161549,MATH 18,A01,083743,Staff,22,0,30,8
1649918161549,MATH 18,A02,083744,Staff,29,0,30,1
1649918161549,MATH 18,A03,083745,Staff,29,0,30,1
1649918161549,MATH 18,A04,083746,Staff,28,0,30,2
1649918161549,MATH 18,B01,083748,Staff,5,0,30,25
1649918161549,MATH 18,B02,083749,Staff,26,0,30,4
1649918161549,MATH 18,B03,083750,Staff,28,0,30,2
1649918161549,MATH 18,B04,083751,Staff,27,0,30,3
1649918167573,MATH 20A,A01,083754,Staff,37,0,40,3
1649918173610,MATH 20B,A01,083756,Staff,19,0,30,11
1649918173610,MATH 20B,A02,083757,Staff,30,0,30,0
1649918179633,MATH 20C,A01,083760,Staff,22,0,30,8
1649918179633,MATH 20C,A02,083761,Staff,23,0,30,7
1649918179633,MATH 20C,B01,083762,Staff,28,0,30,2
1649918179633,MATH 20C,B02,083763,Staff,30,0,30,0
1649918185657,MATH 20D,A01,083765,Staff,20,0,30,10
1649918185657,MATH 20D,A02,083766,Staff,30,0,30,0
1649918185657,MATH 20D,A03,083767,Staff,30,0,30,0
1649918191698,MATH 20E,A01,083771,Staff,13,0,30,17
1649918191698,MATH 20E,A02,083772,Staff,24,0,30,6
1649918191698,MATH 20E,B01,083773,Staff,18,0,30,12
1649918191698,MATH 20E,B02,083774,Staff,29,0,30,1
1649918197720,MATH 103A,A01,083777,Staff,1,4,30,29
1649918197720,MATH 103A,A02,083778,Staff,0,3,30,30
1649918197720,MATH 103A,B01,083779,Staff,0,0,30,30
1649918197720,MATH 103A,B02,083780,Staff,18,0,30,12
1649918203745,MATH 105,A01,085443,Staff,0,5,30,30
1649918209772,MATH 109,A01,083213,Anzaldo; Leesa B,15,0,30,15
1649918209772,MATH 109,A02,083214,Anzaldo; Leesa B,10,0,30,20
1649918209772,MATH 109,B01,083215,Anzaldo; Leesa B,26,0,30,4
1649918209772,MATH 109,B02,083216,Anzaldo; Leesa B,22,0,30,8
1649918215796,MATH 142A,A01,083219,Chow; Bennett,0,1,30,30
1649918215796,MATH 142A,A02,083220,Chow; Bennett,9,0,30,21
1649918215796,MATH 142A,B01,083221,Chow; Bennett,0,0,30,30
1649918215796,MATH 142A,B02,083222,Chow; Bennett,0,0,30,30
1649918221820,MATH 193A,A01,083224,Staff,0,3,30,30
1649918221820,MATH 193A,A02,083225,Staff,0,3,30,30
1649918221820,MATH 193A,A03,083781,Staff,4,0,30,26
1649918221820,MATH 193A,A04,083782,Staff,16,0,30,14
1649918227844,MATH 197,001,091859,McAuley; Julian John,9999,0,9999,0
1649918233902,COGS 9,A01,083615,Staff,16,0,60,44
1649918239925,COGS 11,A01,083617,Boyle; Mary E. T.,35,0,40,5
1649918245950,COGS 13,A01,083071,Staff,0,11,40,40
1649918251974,COGS 14A,A01,092681,Staff,66,0,100,34
1649918258000,COGS 14B,A01,083073,Cheng; Tzu-Han,24,0,50,26
1649918264024,COGS 17,A01,092677,Staff,63,0,75,12
1649918270050,COGS 100,A01,083619,Staff,0,5,60,60
1649918276074,COGS 101A,A01,083621,Davis; Joshua Daniel,0,6,60,60
1649918282105,COGS 101B,A01,091572,Staff,32,0,60,28
1649918288128,COGS 101C,A01,083625,Delgado; Tania,24,0,30,6
1649918294152,COGS 107A,A01,083627,Boyle; Mary E. T.,14,0,60,46
1649918300174,COGS 118A,A01,083075,Staff,21,0,60,39
1649918306199,CSE 3,A50,083646,Miranda; Gregory Joseph,26,0,38,12
1649918306199,CSE 3,A51,083647,Miranda; Gregory Joseph,37,0,37,0
1649918312236,CSE 8A,A50,083650,Miranda; Gregory Joseph,8,0,40,32
1649918318258,CSE 11,A01,083080,Cao; Yingjun,0,26,40,40
1649918324280,CSE 12,A01,083652,Staff,56,0,100,44
1649918330304,CSE 15L,A01,083654,Staff,19,0,50,31
1649918330304,CSE 15L,A02,083655,Staff,47,0,50,3
1649918336336,CSE 20,A01,083657,Staff,68,0,80,12
1649918342368,CSE 30,A01,083084,Eldon; John,0,23,40,40
1649918348392,CSE 100,A01,083659,Cao; Yingjun,1,26,50,49
1649918354417,CSE 134B,A01,083661,Powell; Thomas Allan,0,21,65,65
1649918360442,CSE 140,A01,083663,Staff,24,0,75,51
1649918366469,CSE 140L,A01,083088,Eldon; John,18,0,75,57
1649918372494,CSE 175,A01,083665,Kumar; Rakesh,12,0,25,13
1649918378518,CSE 190,A00,092507,Dubnov; Shlomo,14,0,15,1
1649918384542,ECE 45,A01,083139,Staff,7,0,40,33
1649918390567,ECE 65,A50,083695,Staff,8,0,30,22
1649918396591,ECE 109,A01,091882,Touri; Behrouz,55,0,70,15
1649918402619,ECE 180,A00,083140,Abi Samra; Nicholas Camill,26,0,30,4
1649918402619,ECE 180,B00,083141,Abi Samra; Nicholas Camill,13,0,30,17
1649918408643,MATH 10A,A01,083735,Patchell; Gregory David,20,0,30,10
1649918408643,MATH 10A,A02,083736,Patchell; Gregory David,28,0,30,2
1649918408643,MATH 10A,A03,083737,Patchell; Gregory David,28,0,30,2
1649918414677,MATH 10B,A01,083207,Staff,11,0,30,19
1649918414677,MATH 10B,A02,083208,Staff,25,0,30,5
1649918414677,MATH 10B,B01,083739,Staff,25,0,30,5
1649918414677,MATH 10B,B02,083740,Staff,30,0,30,0
1649918420704,MATH 18,A01,083743,Staff,22,0,30,8
1649918420704,MATH 18,A02,083744,Staff,29,0,30,1
1649918420704,MATH 18,A03,083745,Staff,29,0,30,1
1649918420704,MATH 18,A04,083746,Staff,28,0,30,2
1649918420704,MATH 18,B01,083748,Staff,5,0,30,25
1649918420704,MATH 18,B02,083749,Staff,26,0,30,4
1649918420704,MATH 18,B03,083750,Staff,28,0,30,2
1649918420704,MATH 18,B04,083751,Staff,27,0,30,3
1649918426730,MATH 20A,A01,083754,Staff,37,0,40,3
1649918432757,MATH 20B,A01,083756,Staff,19,0,30,11
1649918432757,MATH 20B,A02,083757,Staff,30,0,30,0
1649918438781,MATH 20C,A01,083760,Staff,22,0,30,8
1649918438781,MATH 20C,A02,083761,Staff,23,0,30,7
1649918438781,MATH 20C,B01,083762,Staff,28,0,30,2
1649918438781,MATH 20C,B02,083763,Staff,30,0,30,0
1649918444803,MATH 20D,A01,083765,Staff,20,0,30,10
1649918444803,MATH 20D,A02,083766,Staff,30,0,30,0
1649918444803,MATH 20D,A03,083767,Staff,30,0,30,0
1649918450845,MATH 20E,A01,083771,Staff,13,0,30,17
1649918450845,MATH 20E,A02,083772,Staff,24,0,30,6
1649918450845,MATH 20E,B01,083773,Staff,18,0,30,12
1649918450845,MATH 20E,B02,083774,Staff,29,0,30,1
1649918456873,MATH 103A,A01,083777,Staff,1,4,30,29
1649918456873,MATH 103A,A02,083778,Staff,0,3,30,30
1649918456873,MATH 103A,B01,083779,Staff,0,0,30,30
1649918456873,MATH 103A,B02,083780,Staff,17,0,30,13
1649918462896,MATH 105,A01,085443,Staff,0,5,30,30
1649918468925,MATH 109,A01,083213,Anzaldo; Leesa B,14,0,30,16
1649918468925,MATH 109,A02,083214,Anzaldo; Leesa B,10,0,30,20
1649918468925,MATH 109,B01,083215,Anzaldo; Leesa B,26,0,30,4
1649918468925,MATH 109,B02,083216,Anzaldo; Leesa B,22,0,30,8
1649918474953,MATH 142A,A01,083219,Chow; Bennett,0,1,30,30
1649918474953,MATH 142A,A02,083220,Chow; Bennett,9,0,30,21
1649918474953,MATH 142A,B01,083221,Chow; Bennett,0,0,30,30
1649918474953,MATH 142A,B02,083222,Chow; Bennett,0,0,30,30
1649918480983,MATH 193A,A01,083224,Staff,0,3,30,30
1649918480983,MATH 193A,A02,083225,Staff,0,3,30,30
1649918480983,MATH 193A,A03,083781,Staff,4,0,30,26
1649918480983,MATH 193A,A04,083782,Staff,16,0,30,14
1649918487081,MATH 197,001,091859,McAuley; Julian John,9999,0,9999,0
1649918493141,COGS 9,A01,083615,Staff,16,0,60,44
1649918499166,COGS 11,A01,083617,Boyle; Mary E. T.,35,0,40,5
1649918505200,COGS 13,A01,083071,Staff,0,11,40,40
1649918511222,COGS 14A,A01,092681,Staff,66,0,100,34
1649918517246,COGS 14B,A01,083073,Cheng; Tzu-Han,24,0,50,26
1649918523273,COGS 17,A01,092677,Staff,63,0,75,12
1649918529298,COGS 100,A01,083619,Staff,0,5,60,60
1649918535324,COGS 101A,A01,083621,Davis; Joshua Daniel,0,6,60,60
1649918541347,COGS 101B,A01,091572,Staff,32,0,60,28
1649918547370,COGS 101C,A01,083625,Delgado; Tania,24,0,30,6
1649918553409,COGS 107A,A01,083627,Boyle; Mary E. T.,14,0,60,46
1649918559431,COGS 118A,A01,083075,Staff,21,0,60,39
1649918565455,CSE 3,A50,083646,Miranda; Gregory Joseph,26,0,38,12
1649918565455,CSE 3,A51,083647,Miranda; Gregory Joseph,37,0,37,0
1649918571482,CSE 8A,A50,083650,Miranda; Gregory Joseph,8,0,40,32
1649918577506,CSE 11,A01,083080,Cao; Yingjun,0,26,40,40
1649918583528,CSE 12,A01,083652,Staff,56,0,100,44
1649918589555,CSE 15L,A01,083654,Staff,19,0,50,31
1649918589555,CSE 15L,A02,083655,Staff,47,0,50,3
1649918595582,CSE 20,A01,083657,Staff,68,0,80,12
1649918601609,CSE 30,A01,083084,Eldon; John,0,23,40,40
1649918607640,CSE 100,A01,083659,Cao; Yingjun,1,26,50,49
1649918613670,CSE 134B,A01,083661,Powell; Thomas Allan,0,21,65,65
1649918619693,CSE 140,A01,083663,Staff,24,0,75,51
1649918625715,CSE 140L,A01,083088,Eldon; John,18,0,75,57
1649918631744,CSE 175,A01,083665,Kumar; Rakesh,12,0,25,13
1649918637772,CSE 190,A00,092507,Dubnov; Shlomo,14,0,15,1
1649918643796,ECE 45,A01,083139,Staff,7,0,40,33
1649918649824,ECE 65,A50,083695,Staff,8,0,30,22
1649918655853,ECE 109,A01,091882,Touri; Behrouz,55,0,70,15
1649918661880,ECE 180,A00,083140,Abi Samra; Nicholas Camill,26,0,30,4
1649918661880,ECE 180,B00,083141,Abi Samra; Nicholas Camill,13,0,30,17
1649918667907,MATH 10A,A01,083735,Patchell; Gregory David,20,0,30,10
1649918667907,MATH 10A,A02,083736,Patchell; Gregory David,28,0,30,2
1649918667907,MATH 10A,A03,083737,Patchell; Gregory David,28,0,30,2
1649918673930,MATH 10B,A01,083207,Staff,11,0,30,19
1649918673930,MATH 10B,A02,083208,Staff,25,0,30,5
1649918673930,MATH 10B,B01,083739,Staff,25,0,30,5
1649918673930,MATH 10B,B02,083740,Staff,30,0,30,0
1649918679958,MATH 18,A01,083743,Staff,22,0,30,8
1649918679958,MATH 18,A02,083744,Staff,29,0,30,1
1649918679958,MATH 18,A03,083745,Staff,29,0,30,1
1649918679958,MATH 18,A04,083746,Staff,28,0,30,2
1649918679958,MATH 18,B01,083748,Staff,5,0,30,25
1649918679958,MATH 18,B02,083749,Staff,26,0,30,4
1649918679958,MATH 18,B03,083750,Staff,28,0,30,2
1649918679958,MATH 18,B04,083751,Staff,27,0,30,3
1649918685981,MATH 20A,A01,083754,Staff,37,0,40,3
1649918692004,MATH 20B,A01,083756,Staff,19,0,30,11
1649918692004,MATH 20B,A02,083757,Staff,30,0,30,0
1649918698031,MATH 20C,A01,083760,Staff,22,0,30,8
1649918698031,MATH 20C,A02,083761,Staff,23,0,30,7
1649918698031,MATH 20C,B01,083762,Staff,28,0,30,2
1649918698031,MATH 20C,B02,083763,Staff,30,0,30,0
1649918704053,MATH 20D,A01,083765,Staff,20,0,30,10
1649918704053,MATH 20D,A02,083766,Staff,30,0,30,0
1649918704053,MATH 20D,A03,083767,Staff,30,0,30,0
1649918710085,MATH 20E,A01,083771,Staff,12,0,30,18
1649918710085,MATH 20E,A02,083772,Staff,24,0,30,6
1649918710085,MATH 20E,B01,083773,Staff,18,0,30,12
1649918710085,MATH 20E,B02,083774,Staff,29,0,30,1
1649918716119,MATH 103A,A01,083777,Staff,1,4,30,29
1649918716119,MATH 103A,A02,083778,Staff,0,3,30,30
1649918716119,MATH 103A,B01,083779,Staff,0,0,30,30
1649918716119,MATH 103A,B02,083780,Staff,16,0,30,14
1649918722152,MATH 105,A01,085443,Staff,0,5,30,30
1649918728180,MATH 109,A01,083213,Anzaldo; Leesa B,14,0,30,16
1649918728180,MATH 109,A02,083214,Anzaldo; Leesa B,10,0,30,20
1649918728180,MATH 109,B01,083215,Anzaldo; Leesa B,26,0,30,4
1649918728180,MATH 109,B02,083216,Anzaldo; Leesa B,22,0,30,8
1649918734204,MATH 142A,A01,083219,Chow; Bennett,0,1,30,30
1649918734204,MATH 142A,A02,083220,Chow; Bennett,9,0,30,21
1649918734204,MATH 142A,B01,083221,Chow; Bennett,0,0,30,30
1649918734204,MATH 142A,B02,083222,Chow; Bennett,1,0,30,29
1649918740227,MATH 193A,A01,083224,Staff,0,3,30,30
1649918740227,MATH 193A,A02,083225,Staff,0,3,30,30
1649918740227,MATH 193A,A03,083781,Staff,4,0,30,26
1649918740227,MATH 193A,A04,083782,Staff,16,0,30,14
1649918746249,MATH 197,001,091859,McAuley; Julian John,9999,0,9999,0
1649918752301,COGS 9,A01,083615,Staff,16,0,60,44
1649918758328,COGS 11,A01,083617,Boyle; Mary E. T.,35,0,40,5
1649918764354,COGS 13,A01,083071,Staff,0,11,40,40
1649918770387,COGS 14A,A01,092681,Staff,66,0,100,34
1649918776414,COGS 14B,A01,083073,Cheng; Tzu-Han,24,0,50,26
1649918782437,COGS 17,A01,092677,Staff,63,0,75,12
1649918788463,COGS 100,A01,083619,Staff,0,5,60,60
1649918794490,COGS 101A,A01,083621,Davis; Joshua Daniel,0,6,60,60
1649918800517,COGS 101B,A01,091572,Staff,32,0,60,28
1649918806545,COGS 101C,A01,083625,Delgado; Tania,24,0,30,6
1649918812567,COGS 107A,A01,083627,Boyle; Mary E. T.,14,0,60,46
1649918818589,COGS 118A,A01,083075,Staff,21,0,60,39
1649918824618,CSE 3,A50,083646,Miranda; Gregory Joseph,26,0,38,12
1649918824618,CSE 3,A51,083647,Miranda; Gregory Joseph,37,0,37,0
1649918830646,CSE 8A,A50,083650,Miranda; Gregory Joseph,8,0,40,32
1649918836677,CSE 11,A01,083080,Cao; Yingjun,0,26,40,40
1649918842702,CSE 12,A01,083652,Staff,56,0,100,44
1649918848734,CSE 15L,A01,083654,Staff,19,0,50,31
1649918848734,CSE 15L,A02,083655,Staff,47,0,50,3
1649918854756,CSE 20,A01,083657,Staff,68,0,80,12
1649918860788,CSE 30,A01,083084,Eldon; John,0,23,40,40
1649918866815,CSE 100,A01,083659,Cao; Yingjun,1,26,50,49
1649918872847,CSE 134B,A01,083661,Powell; Thomas Allan,0,21,65,65
1649918878874,CSE 140,A01,083663,Staff,24,0,75,51
1649918884894,CSE 140L,A01,083088,Eldon; John,18,0,75,57
1649918890929,CSE 175,A01,083665,Kumar; Rakesh,12,0,25,13
1649918896955,CSE 190,A00,092507,Dubnov; Shlomo,14,0,15,1
1649918902978,ECE 45,A01,083139,Staff,7,0,40,33
1649918909001,ECE 65,A50,083695,Staff,8,0,30,22
1649918915023,ECE 109,A01,091882,Touri; Behrouz,55,0,70,15
1649918921059,ECE 180,A00,083140,Abi Samra; Nicholas Camill,26,0,30,4
1649918921059,ECE 180,B00,083141,Abi Samra; Nicholas Camill,13,0,30,17
1649918927087,MATH 10A,A01,083735,Patchell; Gregory David,20,0,30,10
1649918927087,MATH 10A,A02,083736,Patchell; Gregory David,28,0,30,2
1649918927087,MATH 10A,A03,083737,Patchell; Gregory David,28,0,30,2
1649918933111,MATH 10B,A01,083207,Staff,11,0,30,19
1649918933111,MATH 10B,A02,083208,Staff,25,0,30,5
1649918933111,MATH 10B,B01,083739,Staff,25,0,30,5
1649918933111,MATH 10B,B02,083740,Staff,30,0,30,0
1649918939140,MATH 18,A01,083743,Staff,22,0,30,8
1649918939140,MATH 18,A02,083744,Staff,29,0,30,1
1649918939140,MATH 18,A03,083745,Staff,29,0,30,1
1649918939140,MATH 18,A04,083746,Staff,28,0,30,2
1649918939140,MATH 18,B01,083748,Staff,5,0,30,25
1649918939140,MATH 18,B02,083749,Staff,26,0,30,4
1649918939140,MATH 18,B03,083750,Staff,28,0,30,2
1649918939140,MATH 18,B04,083751,Staff,27,0,30,3
1649918945161,MATH 20A,A01,083754,Staff,37,0,40,3
1649918951183,MATH 20B,A01,083756,Staff,19,0,30,11
1649918951183,MATH 20B,A02,083757,Staff,30,0,30,0
1649918957210,MATH 20C,A01,083760,Staff,22,0,30,8
1649918957210,MATH 20C,A02,083761,Staff,23,0,30,7
1649918957210,MATH 20C,B01,083762,Staff,28,0,30,2
1649918957210,MATH 20C,B02,083763,Staff,30,0,30,0
1649918963232,MATH 20D,A01,083765,Staff,20,0,30,10
1649918963232,MATH 20D,A02,083766,Staff,30,0,30,0
1649918963232,MATH 20D,A03,083767,Staff,30,0,30,0
1649918969256,MATH 20E,A01,083771,Staff,12,0,30,18
1649918969256,MATH 20E,A02,083772,Staff,24,0,30,6
1649918969256,MATH 20E,B01,083773,Staff,18,0,30,12
1649918969256,MATH 20E,B02,083774,Staff,29,0,30,1
1649918975290,MATH 103A,A01,083777,Staff,1,4,30,29
1649918975290,MATH 103A,A02,083778,Staff,0,3,30,30
1649918975290,MATH 103A,B01,083779,Staff,0,0,30,30
1649918975290,MATH 103A,B02,083780,Staff,16,0,30,14
1649918981315,MATH 105,A01,085443,Staff,0,5,30,30
1649918987341,MATH 109,A01,083213,Anzaldo; Leesa B,14,0,30,16
1649918987341,MATH 109,A02,083214,Anzaldo; Leesa B,10,0,30,20
1649918987341,MATH 109,B01,083215,Anzaldo; Leesa B,26,0,30,4
1649918987341,MATH 109,B02,083216,Anzaldo; Leesa B,22,0,30,8
1649918993364,MATH 142A,A01,083219,Chow; Bennett,0,1,30,30
1649918993364,MATH 142A,A02,083220,Chow; Bennett,9,0,30,21
1649918993364,MATH 142A,B01,083221,Chow; Bennett,0,0,30,30
1649918993364,MATH 142A,B02,083222,Chow; Bennett,1,0,30,29
1649918999387,MATH 193A,A01,083224,Staff,0,3,30,30
1649918999387,MATH 193A,A02,083225,Staff,0,3,30,30
1649918999387,MATH 193A,A03,083781,Staff,4,0,30,26
1649918999387,MATH 193A,A04,083782,Staff,16,0,30,14
1649919005410,MATH 197,001,091859,McAuley; Julian John,9999,0,9999,0
1649919011472,COGS 9,A01,083615,Staff,16,0,60,44
1649919017501,COGS 11,A01,083617,Boyle; Mary E. T.,35,0,40,5
1649919023540,COGS 13,A01,083071,Staff,0,11,40,40
1649919029567,COGS 14A,A01,092681,Staff,66,0,100,34
1649919035593,COGS 14B,A01,083073,Cheng; Tzu-Han,24,0,50,26
1649919041618,COGS 17,A01,092677,Staff,63,0,75,12
1649919047643,COGS 100,A01,083619,Staff,0,5,60,60
1649919053673,COGS 101A,A01,083621,Davis; Joshua Daniel,0,6,60,60
1649919059700,COGS 101B,A01,091572,Staff,32,0,60,28
1649919065727,COGS 101C,A01,083625,Delgado; Tania,24,0,30,6
1649919071750,COGS 107A,A01,083627,Boyle; Mary E. T.,14,0,60,46
1649919077874,COGS 118A,A01,083075,Staff,21,0,60,39
1649919083902,CSE 3,A50,083646,Miranda; Gregory Joseph,26,0,38,12
1649919083902,CSE 3,A51,083647,Miranda; Gregory Joseph,37,0,37,0
1649919089930,CSE 8A,A50,083650,Miranda; Gregory Joseph,8,0,40,32
1649919095953,CSE 11,A01,083080,Cao; Yingjun,0,26,40,40
1649919101977,CSE 12,A01,083652,Staff,56,0,100,44
1649919107999,CSE 15L,A01,083654,Staff,19,0,50,31
1649919107999,CSE 15L,A02,083655,Staff,47,0,50,3
1649919114022,CSE 20,A01,083657,Staff,68,0,80,12
1649919120052,CSE 30,A01,083084,Eldon; John,0,23,40,40
1649919126079,CSE 100,A01,083659,Cao; Yingjun,1,26,50,49
1649919132105,CSE 134B,A01,083661,Powell; Thomas Allan,0,21,65,65
1649919138132,CSE 140,A01,083663,Staff,24,0,75,51
1649919144159,CSE 140L,A01,083088,Eldon; John,18,0,75,57
1649919150181,CSE 175,A01,083665,Kumar; Rakesh,12,0,25,13
1649919156210,CSE 190,A00,092507,Dubnov; Shlomo,14,0,15,1
1649919162237,ECE 45,A01,083139,Staff,7,0,40,33
1649919168260,ECE 65,A50,083695,Staff,8,0,30,22
1649919174293,ECE 109,A01,091882,Touri; Behrouz,55,0,70,15
1649919180318,ECE 180,A00,083140,Abi Samra; Nicholas Camill,26,0,30,4
1649919180318,ECE 180,B00,083141,Abi Samra; Nicholas Camill,13,0,30,17
1649919186342,MATH 10A,A01,083735,Patchell; Gregory David,20,0,30,10
1649919186342,MATH 10A,A02,083736,Patchell; Gregory David,28,0,30,2
1649919186342,MATH 10A,A03,083737,Patchell; Gregory David,28,0,30,2
1649919192367,MATH 10B,A01,083207,Staff,11,0,30,19
1649919192367,MATH 10B,A02,083208,Staff,25,0,30,5
1649919192367,MATH 10B,B01,083739,Staff,25,0,30,5
1649919192367,MATH 10B,B02,083740,Staff,30,0,30,0
1649919198392,MATH 18,A01,083743,Staff,22,0,30,8
1649919198392,MATH 18,A02,083744,Staff,29,0,30,1
1649919198392,MATH 18,A03,083745,Staff,29,0,30,1
1649919198392,MATH 18,A04,083746,Staff,28,0,30,2
1649919198392,MATH 18,B01,083748,Staff,5,0,30,25
1649919198392,MATH 18,B02,083749,Staff,26,0,30,4
1649919198392,MATH 18,B03,083750,Staff,28,0,30,2
1649919198392,MATH 18,B04,083751,Staff,27,0,30,3
1649919204416,MATH 20A,A01,083754,Staff,37,0,40,3
1649919210444,MATH 20B,A01,083756,Staff,19,0,30,11
1649919210444,MATH 20B,A02,083757,Staff,30,0,30,0
1649919216469,MATH 20C,A01,083760,Staff,22,0,30,8
1649919216469,MATH 20C,A02,083761,Staff,23,0,30,7
1649919216469,MATH 20C,B01,083762,Staff,28,0,30,2
1649919216469,MATH 20C,B02,083763,Staff,30,0,30,0
1649919222491,MATH 20D,A01,083765,Staff,20,0,30,10
1649919222491,MATH 20D,A02,083766,Staff,30,0,30,0
1649919222491,MATH 20D,A03,083767,Staff,30,0,30,0
1649919228515,MATH 20E,A01,083771,Staff,12,0,30,18
1649919228515,MATH 20E,A02,083772,Staff,24,0,30,6
1649919228515,MATH 20E,B01,083773,Staff,18,0,30,12
1649919228515,MATH 20E,B02,083774,Staff,29,0,30,1
1649919234539,MATH 103A,A01,083777,Staff,1,4,30,29
1649919234539,MATH 103A,A02,083778,Staff,0,3,30,30
1649919234539,MATH 103A,B01,083779,Staff,0,0,30,30
1649919234539,MATH 103A,B02,083780,Staff,16,0,30,14
1649919240577,MATH 105,A01,085443,Staff,0,5,30,30
1649919246606,MATH 109,A01,083213,Anzaldo; Leesa B,14,0,30,16
1649919246606,MATH 109,A02,083214,Anzaldo; Leesa B,10,0,30,20
1649919246606,MATH 109,B01,083215,Anzaldo; Leesa B,26,0,30,4
1649919246606,MATH 109,B02,083216,Anzaldo; Leesa B,22,0,30,8
1649919252641,MATH 142A,A01,083219,Chow; Bennett,0,1,30,30
1649919252641,MATH 142A,A02,083220,Chow; Bennett,9,0,30,21
1649919252641,MATH 142A,B01,083221,Chow; Bennett,0,0,30,30
1649919252641,MATH 142A,B02,083222,Chow; Bennett,1,0,30,29
1649919258665,MATH 193A,A01,083224,Staff,0,3,30,30
1649919258665,MATH 193A,A02,083225,Staff,0,3,30,30
1649919258665,MATH 193A,A03,083781,Staff,4,0,30,26
1649919258665,MATH 193A,A04,083782,Staff,16,0,30,14
1649919264687,MATH 197,001,091859,McAuley; Julian John,9999,0,9999,0
1649919270747,COGS 9,A01,083615,Staff,16,0,60,44
1649919276773,COGS 11,A01,083617,Boyle; Mary E. T.,35,0,40,5
1649919282797,COGS 13,A01,083071,Staff,0,11,40,40
1649919288820,COGS 14A,A01,092681,Staff,66,0,100,34
1649919294846,COGS 14B,A01,083073,Cheng; Tzu-Han,24,0,50,26
1649919300880,COGS 17,A01,092677,Staff,63,0,75,12
1649919306902,COGS 100,A01,083619,Staff,0,5,60,60
1649919312925,COGS 101A,A01,083621,Davis; Joshua Daniel,0,6,60,60
1649919318948,COGS 101B,A01,091572,Staff,32,0,60,28
1649919324971,COGS 101C,A01,083625,Delgado; Tania,24,0,30,6
1649919330994,COGS 107A,A01,083627,Boyle; Mary E. T.,14,0,60,46
1649919337021,COGS 118A,A01,083075,Staff,21,0,60,39
1649919343044,CSE 3,A50,083646,Miranda; Gregory Joseph,26,0,38,12
1649919343044,CSE 3,A51,083647,Miranda; Gregory Joseph,37,0,37,0
1649919349068,CSE 8A,A50,083650,Miranda; Gregory Joseph,8,0,40,32
1649919355092,CSE 11,A01,083080,Cao; Yingjun,0,26,40,40
1649919361122,CSE 12,A01,083652,Staff,56,0,100,44
1649919367146,CSE 15L,A01,083654,Staff,19,0,50,31
1649919367146,CSE 15L,A02,083655,Staff,47,0,50,3
1649919373167,CSE 20,A01,083657,Staff,68,0,80,12
1649919379194,CSE 30,A01,083084,Eldon; John,0,23,40,40
1649919385221,CSE 100,A01,083659,Cao; Yingjun,1,26,50,49
1649919391244,CSE 134B,A01,083661,Powell; Thomas Allan,0,21,65,65
1649919397267,CSE 140,A01,083663,Staff,24,0,75,51
1649919403291,CSE 140L,A01,083088,Eldon; John,18,0,75,57
1649919409315,CSE 175,A01,083665,Kumar; Rakesh,12,0,25,13
1649919415339,CSE 190,A00,092507,Dubnov; Shlomo,14,0,15,1
1649919421361,ECE 45,A01,083139,Staff,7,0,40,33
1649919427386,ECE 65,A50,083695,Staff,8,0,30,22
1649919433422,ECE 109,A01,091882,Touri; Behrouz,55,0,70,15
1649919439458,ECE 180,A00,083140,Abi Samra; Nicholas Camill,26,0,30,4
1649919439458,ECE 180,B00,083141,Abi Samra; Nicholas Camill,13,0,30,17
1649919445488,MATH 10A,A01,083735,Patchell; Gregory David,20,0,30,10
1649919445488,MATH 10A,A02,083736,Patchell; Gregory David,28,0,30,2
1649919445488,MATH 10A,A03,083737,Patchell; Gregory David,28,0,30,2
1649919451513,MATH 10B,A01,083207,Staff,11,0,30,19
1649919451513,MATH 10B,A02,083208,Staff,25,0,30,5
1649919451513,MATH 10B,B01,083739,Staff,25,0,30,5
1649919451513,MATH 10B,B02,083740,Staff,30,0,30,0
1649919457538,MATH 18,A01,083743,Staff,22,0,30,8
1649919457538,MATH 18,A02,083744,Staff,29,0,30,1
1649919457538,MATH 18,A03,083745,Staff,29,0,30,1
1649919457538,MATH 18,A04,083746,Staff,28,0,30,2
1649919457538,MATH 18,B01,083748,Staff,5,0,30,25
1649919457538,MATH 18,B02,083749,Staff,26,0,30,4
1649919457538,MATH 18,B03,083750,Staff,28,0,30,2
1649919457538,MATH 18,B04,083751,Staff,27,0,30,3
1649919463562,MATH 20A,A01,083754,Staff,37,0,40,3
1649919469588,MATH 20B,A01,083756,Staff,19,0,30,11
1649919469588,MATH 20B,A02,083757,Staff,30,0,30,0
1649919475611,MATH 20C,A01,083760,Staff,22,0,30,8
1649919475611,MATH 20C,A02,083761,Staff,23,0,30,7
1649919475611,MATH 20C,B01,083762,Staff,28,0,30,2
1649919475611,MATH 20C,B02,083763,Staff,30,0,30,0
1649919481638,MATH 20D,A01,083765,Staff,20,0,30,10
1649919481638,MATH 20D,A02,083766,Staff,30,0,30,0
1649919481638,MATH 20D,A03,083767,Staff,30,0,30,0
1649919487663,MATH 20E,A01,083771,Staff,12,0,30,18
1649919487663,MATH 20E,A02,083772,Staff,24,0,30,6
1649919487663,MATH 20E,B01,083773,Staff,18,0,30,12
1649919487663,MATH 20E,B02,083774,Staff,29,0,30,1
1649919493687,MATH 103A,A01,083777,Staff,1,4,30,29
1649919493687,MATH 103A,A02,083778,Staff,0,3,30,30
1649919493687,MATH 103A,B01,083779,Staff,0,0,30,30
1649919493687,MATH 103A,B02,083780,Staff,16,0,30,14
1649919499715,MATH 105,A01,085443,Staff,0,5,30,30
1649919505743,MATH 109,A01,083213,Anzaldo; Leesa B,14,0,30,16
1649919505743,MATH 109,A02,083214,Anzaldo; Leesa B,10,0,30,20
1649919505743,MATH 109,B01,083215,Anzaldo; Leesa B,26,0,30,4
1649919505743,MATH 109,B02,083216,Anzaldo; Leesa B,22,0,30,8
1649919511771,MATH 142A,A01,083219,Chow; Bennett,0,1,30,30
1649919511771,MATH 142A,A02,083220,Chow; Bennett,9,0,30,21
1649919511771,MATH 142A,B01,083221,Chow; Bennett,0,0,30,30
1649919511771,MATH 142A,B02,083222,Chow; Bennett,1,0,30,29
1649919517795,MATH 193A,A01,083224,Staff,0,3,30,30
1649919517795,MATH 193A,A02,083225,Staff,0,3,30,30
1649919517795,MATH 193A,A03,083781,Staff,4,0,30,26
1649919517795,MATH 193A,A04,083782,Staff,16,0,30,14
1649919523819,MATH 197,001,091859,McAuley; Julian John,9999,0,9999,0
1649919529868,COGS 9,A01,083615,Staff,16,0,60,44
1649919535895,COGS 11,A01,083617,Boyle; Mary E. T.,35,0,40,5
1649919541919,COGS 13,A01,083071,Staff,0,11,40,40
1649919547949,COGS 14A,A01,092681,Staff,66,0,100,34
1649919553973,COGS 14B,A01,083073,Cheng; Tzu-Han,24,0,50,26
1649919559998,COGS 17,A01,092677,Staff,63,0,75,12
1649919566023,COGS 100,A01,083619,Staff,0,5,60,60
1649919572047,COGS 101A,A01,083621,Davis; Joshua Daniel,0,6,60,60
1649919578071,COGS 101B,A01,091572,Staff,32,0,60,28
1649919584093,COGS 101C,A01,083625,Delgado; Tania,24,0,30,6
1649919590121,COGS 107A,A01,083627,Boyle; Mary E. T.,14,0,60,46
1649919596147,COGS 118A,A01,083075,Staff,21,0,60,39
1649919602173,CSE 3,A50,083646,Miranda; Gregory Joseph,26,0,38,12
1649919602173,CSE 3,A51,083647,Miranda; Gregory Joseph,37,0,37,0
1649919608199,CSE 8A,A50,083650,Miranda; Gregory Joseph,8,0,40,32
1649919614248,CSE 11,A01,083080,Cao; Yingjun,0,26,40,40
1649919620271,CSE 12,A01,083652,Staff,56,0,100,44
1649919626294,CSE 15L,A01,083654,Staff,19,0,50,31
1649919626294,CSE 15L,A02,083655,Staff,47,0,50,3
1649919632316,CSE 20,A01,083657,Staff,68,0,80,12
1649919638339,CSE 30,A01,083084,Eldon; John,0,23,40,40
1649919644365,CSE 100,A01,083659,Cao; Yingjun,1,26,50,49
1649919650389,CSE 134B,A01,083661,Powell; Thomas Allan,0,21,65,65
1649919664144,CSE 140,A01,083663,Staff,24,0,75,51
1649919670169,CSE 140L,A01,083088,Eldon; John,18,0,75,57
1649919676191,CSE 175,A01,083665,Kumar; Rakesh,12,0,25,13
1649919682288,CSE 190,A00,092507,Dubnov; Shlomo,14,0,15,1
1649919688317,ECE 45,A01,083139,Staff,7,0,40,33
1649919694340,ECE 65,A50,083695,Staff,8,0,30,22
1649919700369,ECE 109,A01,091882,Touri; Behrouz,55,0,70,15
1649919706395,ECE 180,A00,083140,Abi Samra; Nicholas Camill,26,0,30,4
1649919706395,ECE 180,B00,083141,Abi Samra; Nicholas Camill,13,0,30,17
1649919712424,MATH 10A,A01,083735,Patchell; Gregory David,20,0,30,10
1649919712424,MATH 10A,A02,083736,Patchell; Gregory David,28,0,30,2
1649919712424,MATH 10A,A03,083737,Patchell; Gregory David,28,0,30,2
1649919718449,MATH 10B,A01,083207,Staff,11,0,30,19
1649919718449,MATH 10B,A02,083208,Staff,25,0,30,5
1649919718449,MATH 10B,B01,083739,Staff,25,0,30,5
1649919718449,MATH 10B,B02,083740,Staff,30,0,30,0
1649919724475,MATH 18,A01,083743,Staff,22,0,30,8
1649919724475,MATH 18,A02,083744,Staff,29,0,30,1
1649919724475,MATH 18,A03,083745,Staff,29,0,30,1
1649919724475,MATH 18,A04,083746,Staff,28,0,30,2
1649919724475,MATH 18,B01,083748,Staff,5,0,30,25
1649919724475,MATH 18,B02,083749,Staff,26,0,30,4
1649919724475,MATH 18,B03,083750,Staff,28,0,30,2
1649919724475,MATH 18,B04,083751,Staff,27,0,30,3
1649919730498,MATH 20A,A01,083754,Staff,37,0,40,3
1649919736526,MATH 20B,A01,083756,Staff,19,0,30,11
1649919736526,MATH 20B,A02,083757,Staff,30,0,30,0
1649919742574,MATH 20C,A01,083760,Staff,22,0,30,8
1649919742574,MATH 20C,A02,083761,Staff,23,0,30,7
1649919742574,MATH 20C,B01,083762,Staff,28,0,30,2
1649919742574,MATH 20C,B02,083763,Staff,30,0,30,0
1649919748600,MATH 20D,A01,083765,Staff,20,0,30,10
1649919748600,MATH 20D,A02,083766,Staff,30,0,30,0
1649919748600,MATH 20D,A03,083767,Staff,30,0,30,0
1649919754623,MATH 20E,A01,083771,Staff,12,0,30,18
1649919754623,MATH 20E,A02,083772,Staff,24,0,30,6
1649919754623,MATH 20E,B01,083773,Staff,18,0,30,12
1649919754623,MATH 20E,B02,083774,Staff,29,0,30,1
1649919760647,MATH 103A,A01,083777,Staff,1,4,30,29
1649919760647,MATH 103A,A02,083778,Staff,0,3,30,30
1649919760647,MATH 103A,B01,083779,Staff,0,0,30,30
1649919760647,MATH 103A,B02,083780,Staff,16,0,30,14
1649919766671,MATH 105,A01,085443,Staff,0,5,30,30
1649919772694,MATH 109,A01,083213,Anzaldo; Leesa B,14,0,30,16
1649919772694,MATH 109,A02,083214,Anzaldo; Leesa B,10,0,30,20
1649919772694,MATH 109,B01,083215,Anzaldo; Leesa B,26,0,30,4
1649919772694,MATH 109,B02,083216,Anzaldo; Leesa B,22,0,30,8
1649919778717,MATH 142A,A01,083219,Chow; Bennett,0,1,30,30
1649919778717,MATH 142A,A02,083220,Chow; Bennett,9,0,30,21
1649919778717,MATH 142A,B01,083221,Chow; Bennett,0,0,30,30
1649919778717,MATH 142A,B02,083222,Chow; Bennett,1,0,30,29
1649919784742,MATH 193A,A01,083224,Staff,0,3,30,30
1649919784742,MATH 193A,A02,083225,Staff,0,3,30,30
1649919784742,MATH 193A,A03,083781,Staff,4,0,30,26
1649919784742,MATH 193A,A04,083782,Staff,16,0,30,14
1649919790769,MATH 197,001,091859,McAuley; Julian John,9999,0,9999,0
1649919796829,COGS 9,A01,083615,Staff,16,0,60,44
1649919802857,COGS 11,A01,083617,Boyle; Mary E. T.,35,0,40,5
1649919808882,COGS 13,A01,083071,Staff,0,11,40,40
1649919814905,COGS 14A,A01,092681,Staff,66,0,100,34
1649919820929,COGS 14B,A01,083073,Cheng; Tzu-Han,24,0,50,26
1649919826952,COGS 17,A01,092677,Staff,63,0,75,12
1649919832979,COGS 100,A01,083619,Staff,0,5,60,60
1649919839002,COGS 101A,A01,083621,Davis; Joshua Daniel,0,6,60,60
1649919845033,COGS 101B,A01,091572,Staff,32,0,60,28
1649919851056,COGS 101C,A01,083625,Delgado; Tania,24,0,30,6
1649919857085,COGS 107A,A01,083627,Boyle; Mary E. T.,14,0,60,46
1649919863115,COGS 118A,A01,083075,Staff,21,0,60,39
1649919869140,CSE 3,A50,083646,Miranda; Gregory Joseph,26,0,38,12
1649919869140,CSE 3,A51,083647,Miranda; Gregory Joseph,37,0,37,0
1649919875184,CSE 8A,A50,083650,Miranda; Gregory Joseph,8,0,40,32
1649919881208,CSE 11,A01,083080,Cao; Yingjun,0,26,40,40
1649919887239,CSE 12,A01,083652,Staff,56,0,100,44
1649919893269,CSE 15L,A01,083654,Staff,19,0,50,31
1649919893269,CSE 15L,A02,083655,Staff,47,0,50,3
1649919899305,CSE 20,A01,083657,Staff,68,0,80,12
1649919905330,CSE 30,A01,083084,Eldon; John,0,23,40,40
1649919911358,CSE 100,A01,083659,Cao; Yingjun,1,26,50,49
1649919917387,CSE 134B,A01,083661,Powell; Thomas Allan,0,21,65,65
1649919923415,CSE 140,A01,083663,Staff,24,0,75,51
1649919929444,CSE 140L,A01,083088,Eldon; John,18,0,75,57
1649919935481,CSE 175,A01,083665,Kumar; Rakesh,12,0,25,13
1649919941506,CSE 190,A00,092507,Dubnov; Shlomo,14,0,15,1
1649919947529,ECE 45,A01,083139,Staff,7,0,40,33
1649919953556,ECE 65,A50,083695,Staff,8,0,30,22
1649919959586,ECE 109,A01,091882,Touri; Behrouz,55,0,70,15
1649919965616,ECE 180,A00,083140,Abi Samra; Nicholas Camill,26,0,30,4
1649919965616,ECE 180,B00,083141,Abi Samra; Nicholas Camill,13,0,30,17
1649919971643,MATH 10A,A01,083735,Patchell; Gregory David,20,0,30,10
1649919971643,MATH 10A,A02,083736,Patchell; Gregory David,28,0,30,2
1649919971643,MATH 10A,A03,083737,Patchell; Gregory David,28,0,30,2
1649919977667,MATH 10B,A01,083207,Staff,10,0,30,20
1649919977667,MATH 10B,A02,083208,Staff,25,0,30,5
1649919977667,MATH 10B,B01,083739,Staff,25,0,30,5
1649919977667,MATH 10B,B02,083740,Staff,30,0,30,0
1649919983693,MATH 18,A01,083743,Staff,22,0,30,8
1649919983693,MATH 18,A02,083744,Staff,29,0,30,1
1649919983693,MATH 18,A03,083745,Staff,29,0,30,1
1649919983693,MATH 18,A04,083746,Staff,28,0,30,2
1649919983693,MATH 18,B01,083748,Staff,5,0,30,25
1649919983693,MATH 18,B02,083749,Staff,26,0,30,4
1649919983693,MATH 18,B03,083750,Staff,28,0,30,2
1649919983693,MATH 18,B04,083751,Staff,27,0,30,3
1649919989717,MATH 20A,A01,083754,Staff,37,0,40,3
1649919995742,MATH 20B,A01,083756,Staff,19,0,30,11
1649919995742,MATH 20B,A02,083757,Staff,30,0,30,0
1649920001766,MATH 20C,A01,083760,Staff,22,0,30,8
1649920001766,MATH 20C,A02,083761,Staff,23,0,30,7
1649920001766,MATH 20C,B01,083762,Staff,28,0,30,2
1649920001766,MATH 20C,B02,083763,Staff,30,0,30,0
1649920007796,MATH 20D,A01,083765,Staff,20,0,30,10
1649920007796,MATH 20D,A02,083766,Staff,30,0,30,0
1649920007796,MATH 20D,A03,083767,Staff,30,0,30,0
1649920013832,MATH 20E,A01,083771,Staff,12,0,30,18
1649920013832,MATH 20E,A02,083772,Staff,24,0,30,6
1649920013832,MATH 20E,B01,083773,Staff,18,0,30,12
1649920013832,MATH 20E,B02,083774,Staff,29,0,30,1
1649920019856,MATH 103A,A01,083777,Staff,1,4,30,29
1649920019856,MATH 103A,A02,083778,Staff,0,3,30,30
1649920019856,MATH 103A,B01,083779,Staff,0,0,30,30
1649920019856,MATH 103A,B02,083780,Staff,16,0,30,14
1649920025880,MATH 105,A01,085443,Staff,0,5,30,30
1649920031906,MATH 109,A01,083213,Anzaldo; Leesa B,14,0,30,16
1649920031906,MATH 109,A02,083214,Anzaldo; Leesa B,10,0,30,20
1649920031906,MATH 109,B01,083215,Anzaldo; Leesa B,26,0,30,4
1649920031906,MATH 109,B02,083216,Anzaldo; Leesa B,22,0,30,8
1649920037941,MATH 142A,A01,083219,Chow; Bennett,0,1,30,30
1649920037941,MATH 142A,A02,083220,Chow; Bennett,9,0,30,21
1649920037941,MATH 142A,B01,083221,Chow; Bennett,0,0,30,30
1649920037941,MATH 142A,B02,083222,Chow; Bennett,1,0,30,29
1649920043963,MATH 193A,A01,083224,Staff,0,3,30,30
1649920043963,MATH 193A,A02,083225,Staff,0,3,30,30
1649920043963,MATH 193A,A03,083781,Staff,4,0,30,26
1649920043963,MATH 193A,A04,083782,Staff,16,0,30,14
1649920049984,MATH 197,001,091859,McAuley; Julian John,9999,0,9999,0
1649920056037,COGS 9,A01,083615,Staff,16,0,60,44
1649920062065,COGS 11,A01,083617,Boyle; Mary E. T.,35,0,40,5
1649920068092,COGS 13,A01,083071,Staff,0,11,40,40
1649920074114,COGS 14A,A01,092681,Staff,66,0,100,34
1649920080138,COGS 14B,A01,083073,Cheng; Tzu-Han,24,0,50,26
1649920086162,COGS 17,A01,092677,Staff,63,0,75,12
1649920092197,COGS 100,A01,083619,Staff,0,5,60,60
1649920098220,COGS 101A,A01,083621,Davis; Joshua Daniel,0,6,60,60
1649920104250,COGS 101B,A01,091572,Staff,32,0,60,28
1649920110274,COGS 101C,A01,083625,Delgado; Tania,24,0,30,6
1649920116312,COGS 107A,A01,083627,Boyle; Mary E. T.,14,0,60,46
1649920122342,COGS 118A,A01,083075,Staff,21,0,60,39
1649920128365,CSE 3,A50,083646,Miranda; Gregory Joseph,25,0,38,13
1649920128365,CSE 3,A51,083647,Miranda; Gregory Joseph,37,0,37,0
1649920134390,CSE 8A,A50,083650,Miranda; Gregory Joseph,8,0,40,32
1649920140412,CSE 11,A01,083080,Cao; Yingjun,0,26,40,40
1649920146436,CSE 12,A01,083652,Staff,56,0,100,44
1649920152460,CSE 15L,A01,083654,Staff,19,0,50,31
1649920152460,CSE 15L,A02,083655,Staff,47,0,50,3
1649920158484,CSE 20,A01,083657,Staff,68,0,80,12
1649920164507,CSE 30,A01,083084,Eldon; John,0,23,40,40
1649920170531,CSE 100,A01,083659,Cao; Yingjun,1,27,50,49
1649920176558,CSE 134B,A01,083661,Powell; Thomas Allan,0,21,65,65
1649920182585,CSE 140,A01,083663,Staff,24,0,75,51
1649920188610,CSE 140L,A01,083088,Eldon; John,18,0,75,57
1649920194636,CSE 175,A01,083665,Kumar; Rakesh,12,0,25,13
1649920200669,CSE 190,A00,092507,Dubnov; Shlomo,14,0,15,1
1649920206692,ECE 45,A01,083139,Staff,6,0,40,34
1649920212720,ECE 65,A50,083695,Staff,8,0,30,22
1649920218744,ECE 109,A01,091882,Touri; Behrouz,55,0,70,15
1649920224769,ECE 180,A00,083140,Abi Samra; Nicholas Camill,26,0,30,4
1649920224769,ECE 180,B00,083141,Abi Samra; Nicholas Camill,13,0,30,17
1649920230806,MATH 10A,A01,083735,Patchell; Gregory David,20,0,30,10
1649920230806,MATH 10A,A02,083736,Patchell; Gregory David,28,0,30,2
1649920230806,MATH 10A,A03,083737,Patchell; Gregory David,28,0,30,2
1649920236828,MATH 10B,A01,083207,Staff,10,0,30,20
1649920236828,MATH 10B,A02,083208,Staff,25,0,30,5
1649920236828,MATH 10B,B01,083739,Staff,25,0,30,5
1649920236828,MATH 10B,B02,083740,Staff,30,0,30,0
1649920242859,MATH 18,A01,083743,Staff,22,0,30,8
1649920242859,MATH 18,A02,083744,Staff,29,0,30,1
1649920242859,MATH 18,A03,083745,Staff,29,0,30,1
1649920242859,MATH 18,A04,083746,Staff,28,0,30,2
1649920242859,MATH 18,B01,083748,Staff,5,0,30,25
1649920242859,MATH 18,B02,083749,Staff,26,0,30,4
1649920242859,MATH 18,B03,083750,Staff,28,0,30,2
1649920242859,MATH 18,B04,083751,Staff,27,0,30,3
1649920248885,MATH 20A,A01,083754,Staff,37,0,40,3
1649920254912,MATH 20B,A01,083756,Staff,19,0,30,11
1649920254912,MATH 20B,A02,083757,Staff,30,0,30,0
1649920260936,MATH 20C,A01,083760,Staff,22,0,30,8
1649920260936,MATH 20C,A02,083761,Staff,23,0,30,7
1649920260936,MATH 20C,B01,083762,Staff,28,0,30,2
1649920260936,MATH 20C,B02,083763,Staff,30,0,30,0
1649920266965,MATH 20D,A01,083765,Staff,20,0,30,10
1649920266965,MATH 20D,A02,083766,Staff,30,0,30,0
1649920266965,MATH 20D,A03,083767,Staff,30,0,30,0
1649920272988,MATH 20E,A01,083771,Staff,12,0,30,18
1649920272988,MATH 20E,A02,083772,Staff,24,0,30,6
1649920272988,MATH 20E,B01,083773,Staff,18,0,30,12
1649920272988,MATH 20E,B02,083774,Staff,29,0,30,1
1649920279089,MATH 103A,A01,083777,Staff,1,4,30,29
1649920279089,MATH 103A,A02,083778,Staff,0,3,30,30
1649920279089,MATH 103A,B01,083779,Staff,0,0,30,30
1649920279089,MATH 103A,B02,083780,Staff,16,0,30,14
1649920285113,MATH 105,A01,085443,Staff,0,5,30,30
1649920291141,MATH 109,A01,083213,Anzaldo; Leesa B,14,0,30,16
1649920291141,MATH 109,A02,083214,Anzaldo; Leesa B,10,0,30,20
1649920291141,MATH 109,B01,083215,Anzaldo; Leesa B,26,0,30,4
1649920291141,MATH 109,B02,083216,Anzaldo; Leesa B,22,0,30,8
1649920297184,MATH 142A,A01,083219,Chow; Bennett,0,1,30,30
1649920297184,MATH 142A,A02,083220,Chow; Bennett,9,0,30,21
1649920297184,MATH 142A,B01,083221,Chow; Bennett,0,0,30,30
1649920297184,MATH 142A,B02,083222,Chow; Bennett,1,0,30,29
1649920303208,MATH 193A,A01,083224,Staff,0,3,30,30
1649920303208,MATH 193A,A02,083225,Staff,0,3,30,30
1649920303208,MATH 193A,A03,083781,Staff,4,0,30,26
1649920303208,MATH 193A,A04,083782,Staff,16,0,30,14
1649920309232,MATH 197,001,091859,McAuley; Julian John,9999,0,9999,0
1649920315321,COGS 9,A01,083615,Staff,16,0,60,44
1649920321356,COGS 11,A01,083617,Boyle; Mary E. T.,35,0,40,5
1649920327393,COGS 13,A01,083071,Staff,0,11,40,40
1649920333419,COGS 14A,A01,092681,Staff,66,0,100,34
1649920339450,COGS 14B,A01,083073,Cheng; Tzu-Han,24,0,50,26
1649920345484,COGS 17,A01,092677,Staff,63,0,75,12
1649920351520,COGS 100,A01,083619,Staff,0,5,60,60
1649920357561,COGS 101A,A01,083621,Davis; Joshua Daniel,0,6,60,60
1649920363592,COGS 101B,A01,091572,Staff,32,0,60,28
1649920369640,COGS 101C,A01,083625,Delgado; Tania,24,0,30,6
1649920375687,COGS 107A,A01,083627,Boyle; Mary E. T.,14,0,60,46
1649920381723,COGS 118A,A01,083075,Staff,21,0,60,39
1649920387747,CSE 3,A50,083646,Miranda; Gregory Joseph,25,0,38,13
1649920387747,CSE 3,A51,083647,Miranda; Gregory Joseph,37,0,37,0
1649920393776,CSE 8A,A50,083650,Miranda; Gregory Joseph,8,0,40,32
1649920399801,CSE 11,A01,083080,Cao; Yingjun,0,26,40,40
1649920405830,CSE 12,A01,083652,Staff,56,0,100,44
1649920411854,CSE 15L,A01,083654,Staff,19,0,50,31
1649920411854,CSE 15L,A02,083655,Staff,47,0,50,3
1649920417876,CSE 20,A01,083657,Staff,68,0,80,12
1649920423906,CSE 30,A01,083084,Eldon; John,0,23,40,40
1649920429940,CSE 100,A01,083659,Cao; Yingjun,1,27,50,49
1649920435969,CSE 134B,A01,083661,Powell; Thomas Allan,0,21,65,65
1649920441999,CSE 140,A01,083663,Staff,24,0,75,51
1649920448024,CSE 140L,A01,083088,Eldon; John,18,0,75,57
1649920454051,CSE 175,A01,083665,Kumar; Rakesh,12,0,25,13
1649920460080,CSE 190,A00,092507,Dubnov; Shlomo,14,0,15,1
1649920466102,ECE 45,A01,083139,Staff,6,0,40,34
1649920472133,ECE 65,A50,083695,Staff,8,0,30,22
1649920478164,ECE 109,A01,091882,Touri; Behrouz,55,0,70,15
1649920484198,ECE 180,A00,083140,Abi Samra; Nicholas Camill,26,0,30,4
1649920484198,ECE 180,B00,083141,Abi Samra; Nicholas Camill,13,0,30,17
1649920490224,MATH 10A,A01,083735,Patchell; Gregory David,20,0,30,10
1649920490224,MATH 10A,A02,083736,Patchell; Gregory David,28,0,30,2
1649920490224,MATH 10A,A03,083737,Patchell; Gregory David,28,0,30,2
1649920496254,MATH 10B,A01,083207,Staff,10,0,30,20
1649920496254,MATH 10B,A02,083208,Staff,25,0,30,5
1649920496254,MATH 10B,B01,083739,Staff,25,0,30,5
1649920496254,MATH 10B,B02,083740,Staff,30,0,30,0
1649920502279,MATH 18,A01,083743,Staff,22,0,30,8
1649920502279,MATH 18,A02,083744,Staff,29,0,30,1
1649920502279,MATH 18,A03,083745,Staff,29,0,30,1
1649920502279,MATH 18,A04,083746,Staff,28,0,30,2
1649920502279,MATH 18,B01,083748,Staff,5,0,30,25
1649920502279,MATH 18,B02,083749,Staff,26,0,30,4
1649920502279,MATH 18,B03,083750,Staff,28,0,30,2
1649920502279,MATH 18,B04,083751,Staff,27,0,30,3
1649920508306,MATH 20A,A01,083754,Staff,37,0,40,3
1649920514334,MATH 20B,A01,083756,Staff,19,0,30,11
1649920514334,MATH 20B,A02,083757,Staff,30,0,30,0
1649920520369,MATH 20C,A01,083760,Staff,22,0,30,8
1649920520369,MATH 20C,A02,083761,Staff,23,0,30,7
1649920520369,MATH 20C,B01,083762,Staff,28,0,30,2
1649920520369,MATH 20C,B02,083763,Staff,30,0,30,0
1649920526392,MATH 20D,A01,083765,Staff,20,0,30,10
1649920526392,MATH 20D,A02,083766,Staff,30,0,30,0
1649920526392,MATH 20D,A03,083767,Staff,30,0,30,0
1649920532418,MATH 20E,A01,083771,Staff,12,0,30,18
1649920532418,MATH 20E,A02,083772,Staff,24,0,30,6
1649920532418,MATH 20E,B01,083773,Staff,18,0,30,12
1649920532418,MATH 20E,B02,083774,Staff,29,0,30,1
1649920538446,MATH 103A,A01,083777,Staff,1,4,30,29
1649920538446,MATH 103A,A02,083778,Staff,0,3,30,30
1649920538446,MATH 103A,B01,083779,Staff,0,0,30,30
1649920538446,MATH 103A,B02,083780,Staff,16,0,30,14
1649920544474,MATH 105,A01,085443,Staff,0,5,30,30
1649920550498,MATH 109,A01,083213,Anzaldo; Leesa B,14,0,30,16
1649920550498,MATH 109,A02,083214,Anzaldo; Leesa B,10,0,30,20
1649920550498,MATH 109,B01,083215,Anzaldo; Leesa B,26,0,30,4
1649920550498,MATH 109,B02,083216,Anzaldo; Leesa B,22,0,30,8
1649920556532,MATH 142A,A01,083219,Chow; Bennett,0,1,30,30
1649920556532,MATH 142A,A02,083220,Chow; Bennett,9,0,30,21
1649920556532,MATH 142A,B01,083221,Chow; Bennett,0,0,30,30
1649920556532,MATH 142A,B02,083222,Chow; Bennett,1,0,30,29
1649920562556,MATH 193A,A01,083224,Staff,0,3,30,30
1649920562556,MATH 193A,A02,083225,Staff,0,3,30,30
1649920562556,MATH 193A,A03,083781,Staff,4,0,30,26
1649920562556,MATH 193A,A04,083782,Staff,16,0,30,14
1649920568578,MATH 197,001,091859,McAuley; Julian John,9999,0,9999,0
1649920574636,COGS 9,A01,083615,Staff,16,0,60,44
1649920580662,COGS 11,A01,083617,Boyle; Mary E. T.,35,0,40,5
1649920586690,COGS 13,A01,083071,Staff,0,11,40,40
1649920592714,COGS 14A,A01,092681,Staff,66,0,100,34
1649920598738,COGS 14B,A01,083073,Cheng; Tzu-Han,24,0,50,26
1649920604762,COGS 17,A01,092677,Staff,63,0,75,12
1649920610786,COGS 100,A01,083619,Staff,0,5,60,60
1649920616821,COGS 101A,A01,083621,Davis; Joshua Daniel,0,6,60,60
1649920622846,COGS 101B,A01,091572,Staff,32,0,60,28
1649920628873,COGS 101C,A01,083625,Delgado; Tania,24,0,30,6
1649920634897,COGS 107A,A01,083627,Boyle; Mary E. T.,14,0,60,46
1649920640925,COGS 118A,A01,083075,Staff,21,0,60,39
1649920646948,CSE 3,A50,083646,Miranda; Gregory Joseph,25,0,38,13
1649920646948,CSE 3,A51,083647,Miranda; Gregory Joseph,37,0,37,0
1649920652973,CSE 8A,A50,083650,Miranda; Gregory Joseph,8,0,40,32
1649920659010,CSE 11,A01,083080,Cao; Yingjun,0,26,40,40
1649920665038,CSE 12,A01,083652,Staff,56,0,100,44
1649920671067,CSE 15L,A01,083654,Staff,19,0,50,31
1649920671067,CSE 15L,A02,083655,Staff,47,0,50,3
1649920677096,CSE 20,A01,083657,Staff,68,0,80,12
1649920683124,CSE 30,A01,083084,Eldon; John,0,23,40,40
1649920689153,CSE 100,A01,083659,Cao; Yingjun,1,27,50,49
1649920695178,CSE 134B,A01,083661,Powell; Thomas Allan,0,21,65,65
1649920701202,CSE 140,A01,083663,Staff,24,0,75,51
1649920707230,CSE 140L,A01,083088,Eldon; John,18,0,75,57
1649920713258,CSE 175,A01,083665,Kumar; Rakesh,12,0,25,13
1649920719282,CSE 190,A00,092507,Dubnov; Shlomo,14,0,15,1
1649920725310,ECE 45,A01,083139,Staff,6,0,40,34
1649920731342,ECE 65,A50,083695,Staff,8,0,30,22
1649920737371,ECE 109,A01,091882,Touri; Behrouz,55,0,70,15
1649920743400,ECE 180,A00,083140,Abi Samra; Nicholas Camill,26,0,30,4
1649920743400,ECE 180,B00,083141,Abi Samra; Nicholas Camill,13,0,30,17
1649920749424,MATH 10A,A01,083735,Patchell; Gregory David,20,0,30,10
1649920749424,MATH 10A,A02,083736,Patchell; Gregory David,28,0,30,2
1649920749424,MATH 10A,A03,083737,Patchell; Gregory David,28,0,30,2
1649920755453,MATH 10B,A01,083207,Staff,10,0,30,20
1649920755453,MATH 10B,A02,083208,Staff,25,0,30,5
1649920755453,MATH 10B,B01,083739,Staff,25,0,30,5
1649920755453,MATH 10B,B02,083740,Staff,30,0,30,0
1649920761477,MATH 18,A01,083743,Staff,22,0,30,8
1649920761477,MATH 18,A02,083744,Staff,29,0,30,1
1649920761477,MATH 18,A03,083745,Staff,29,0,30,1
1649920761477,MATH 18,A04,083746,Staff,28,0,30,2
1649920761477,MATH 18,B01,083748,Staff,5,0,30,25
1649920761477,MATH 18,B02,083749,Staff,26,0,30,4
1649920761477,MATH 18,B03,083750,Staff,28,0,30,2
1649920761477,MATH 18,B04,083751,Staff,27,0,30,3
1649920767503,MATH 20A,A01,083754,Staff,37,0,40,3
1649920773531,MATH 20B,A01,083756,Staff,19,0,30,11
1649920773531,MATH 20B,A02,083757,Staff,30,0,30,0
1649920779560,MATH 20C,A01,083760,Staff,22,0,30,8
1649920779560,MATH 20C,A02,083761,Staff,23,0,30,7
1649920779560,MATH 20C,B01,083762,Staff,28,0,30,2
1649920779560,MATH 20C,B02,083763,Staff,30,0,30,0
1649920785587,MATH 20D,A01,083765,Staff,20,0,30,10
1649920785587,MATH 20D,A02,083766,Staff,30,0,30,0
1649920785587,MATH 20D,A03,083767,Staff,30,0,30,0
1649920791612,MATH 20E,A01,083771,Staff,12,0,30,18
1649920791612,MATH 20E,A02,083772,Staff,24,0,30,6
1649920791612,MATH 20E,B01,083773,Staff,18,0,30,12
1649920791612,MATH 20E,B02,083774,Staff,29,0,30,1
1649920797643,MATH 103A,A01,083777,Staff,1,4,30,29
1649920797643,MATH 103A,A02,083778,Staff,0,3,30,30
1649920797643,MATH 103A,B01,083779,Staff,0,0,30,30
1649920797643,MATH 103A,B02,083780,Staff,16,0,30,14
1649920803681,MATH 105,A01,085443,Staff,0,5,30,30
1649920809706,MATH 109,A01,083213,Anzaldo; Leesa B,14,0,30,16
1649920809706,MATH 109,A02,083214,Anzaldo; Leesa B,10,0,30,20
1649920809706,MATH 109,B01,083215,Anzaldo; Leesa B,26,0,30,4
1649920809706,MATH 109,B02,083216,Anzaldo; Leesa B,22,0,30,8
1649920815742,MATH 142A,A01,083219,Chow; Bennett,0,1,30,30
1649920815742,MATH 142A,A02,083220,Chow; Bennett,9,0,30,21
1649920815742,MATH 142A,B01,083221,Chow; Bennett,0,0,30,30
1649920815742,MATH 142A,B02,083222,Chow; Bennett,1,0,30,29
1649920821771,MATH 193A,A01,083224,Staff,0,3,30,30
1649920821771,MATH 193A,A02,083225,Staff,0,3,30,30
1649920821771,MATH 193A,A03,083781,Staff,4,0,30,26
1649920821771,MATH 193A,A04,083782,Staff,16,0,30,14
1649920827802,MATH 197,001,091859,McAuley; Julian John,9999,0,9999,0
1649920833860,COGS 9,A01,083615,Staff,16,0,60,44
1649920839887,COGS 11,A01,083617,Boyle; Mary E. T.,35,0,40,5
1649920845911,COGS 13,A01,083071,Staff,0,11,40,40
1649920851940,COGS 14A,A01,092681,Staff,66,0,100,34
1649920857964,COGS 14B,A01,083073,Cheng; Tzu-Han,24,0,50,26
1649920863991,COGS 17,A01,092677,Staff,63,0,75,12
1649920870097,COGS 100,A01,083619,Staff,0,5,60,60
1649920876122,COGS 101A,A01,083621,Davis; Joshua Daniel,0,6,60,60
1649920882146,COGS 101B,A01,091572,Staff,32,0,60,28
1649920888179,COGS 101C,A01,083625,Delgado; Tania,24,0,30,6
1649920894203,COGS 107A,A01,083627,Boyle; Mary E. T.,14,0,60,46
1649920900227,COGS 118A,A01,083075,Staff,21,0,60,39
1649920906258,CSE 3,A50,083646,Miranda; Gregory Joseph,25,0,38,13
1649920906258,CSE 3,A51,083647,Miranda; Gregory Joseph,37,0,37,0
1649920912282,CSE 8A,A50,083650,Miranda; Gregory Joseph,8,0,40,32
1649920918314,CSE 11,A01,083080,Cao; Yingjun,0,26,40,40
1649920924341,CSE 12,A01,083652,Staff,56,0,100,44
1649920930368,CSE 15L,A01,083654,Staff,19,0,50,31
1649920930368,CSE 15L,A02,083655,Staff,47,0,50,3
1649920936392,CSE 20,A01,083657,Staff,68,0,80,12
1649920942416,CSE 30,A01,083084,Eldon; John,0,23,40,40
1649920948442,CSE 100,A01,083659,Cao; Yingjun,1,27,50,49
1649920954482,CSE 134B,A01,083661,Powell; Thomas Allan,0,21,65,65
1649920960505,CSE 140,A01,083663,Staff,24,0,75,51
1649920966533,CSE 140L,A01,083088,Eldon; John,18,0,75,57
1649920972559,CSE 175,A01,083665,Kumar; Rakesh,12,0,25,13
1649920978589,CSE 190,A00,092507,Dubnov; Shlomo,14,0,15,1
1649920984618,ECE 45,A01,083139,Staff,6,0,40,34
1649920990641,ECE 65,A50,083695,Staff,8,0,30,22
1649920996670,ECE 109,A01,091882,Touri; Behrouz,55,0,70,15
1649921002694,ECE 180,A00,083140,Abi Samra; Nicholas Camill,26,0,30,4
1649921002694,ECE 180,B00,083141,Abi Samra; Nicholas Camill,13,0,30,17
1649921008720,MATH 10A,A01,083735,Patchell; Gregory David,20,0,30,10
1649921008720,MATH 10A,A02,083736,Patchell; Gregory David,28,0,30,2
1649921008720,MATH 10A,A03,083737,Patchell; Gregory David,28,0,30,2
1649921014747,MATH 10B,A01,083207,Staff,10,0,30,20
1649921014747,MATH 10B,A02,083208,Staff,25,0,30,5
1649921014747,MATH 10B,B01,083739,Staff,25,0,30,5
1649921014747,MATH 10B,B02,083740,Staff,30,0,30,0
1649921020781,MATH 18,A01,083743,Staff,22,0,30,8
1649921020781,MATH 18,A02,083744,Staff,29,0,30,1
1649921020781,MATH 18,A03,083745,Staff,29,0,30,1
1649921020781,MATH 18,A04,083746,Staff,28,0,30,2
1649921020781,MATH 18,B01,083748,Staff,5,0,30,25
1649921020781,MATH 18,B02,083749,Staff,26,0,30,4
1649921020781,MATH 18,B03,083750,Staff,28,0,30,2
1649921020781,MATH 18,B04,083751,Staff,27,0,30,3
1649921026806,MATH 20A,A01,083754,Staff,37,0,40,3
1649921032833,MATH 20B,A01,083756,Staff,19,0,30,11
1649921032833,MATH 20B,A02,083757,Staff,30,0,30,0
1649921038862,MATH 20C,A01,083760,Staff,22,0,30,8
1649921038862,MATH 20C,A02,083761,Staff,23,0,30,7
1649921038862,MATH 20C,B01,083762,Staff,28,0,30,2
1649921038862,MATH 20C,B02,083763,Staff,30,0,30,0
1649921044887,MATH 20D,A01,083765,Staff,20,0,30,10
1649921044887,MATH 20D,A02,083766,Staff,30,0,30,0
1649921044887,MATH 20D,A03,083767,Staff,30,0,30,0
1649921050913,MATH 20E,A01,083771,Staff,12,0,30,18
1649921050913,MATH 20E,A02,083772,Staff,24,0,30,6
1649921050913,MATH 20E,B01,083773,Staff,18,0,30,12
1649921050913,MATH 20E,B02,083774,Staff,29,0,30,1
1649921056949,MATH 103A,A01,083777,Staff,1,4,30,29
1649921056949,MATH 103A,A02,083778,Staff,0,3,30,30
1649921056949,MATH 103A,B01,083779,Staff,0,0,30,30
1649921056949,MATH 103A,B02,083780,Staff,16,0,30,14
1649921062973,MATH 105,A01,085443,Staff,0,5,30,30
1649921068998,MATH 109,A01,083213,Anzaldo; Leesa B,14,0,30,16
1649921068998,MATH 109,A02,083214,Anzaldo; Leesa B,10,0,30,20
1649921068998,MATH 109,B01,083215,Anzaldo; Leesa B,26,0,30,4
1649921068998,MATH 109,B02,083216,Anzaldo; Leesa B,22,0,30,8
1649921075023,MATH 142A,A01,083219,Chow; Bennett,0,1,30,30
1649921075023,MATH 142A,A02,083220,Chow; Bennett,9,0,30,21
1649921075023,MATH 142A,B01,083221,Chow; Bennett,0,0,30,30
1649921075023,MATH 142A,B02,083222,Chow; Bennett,1,0,30,29
1649921081051,MATH 193A,A01,083224,Staff,0,3,30,30
1649921081051,MATH 193A,A02,083225,Staff,0,3,30,30
1649921081051,MATH 193A,A03,083781,Staff,4,0,30,26
1649921081051,MATH 193A,A04,083782,Staff,16,0,30,14
1649921087078,MATH 197,001,091859,McAuley; Julian John,9999,0,9999,0
1649921093146,COGS 9,A01,083615,Staff,16,0,60,44
1649921099169,COGS 11,A01,083617,Boyle; Mary E. T.,35,0,40,5
1649921105193,COGS 13,A01,083071,Staff,0,11,40,40
1649921111215,COGS 14A,A01,092681,Staff,66,0,100,34
1649921117239,COGS 14B,A01,083073,Cheng; Tzu-Han,24,0,50,26
1649921123262,COGS 17,A01,092677,Staff,63,0,75,12
1649921129292,COGS 100,A01,083619,Staff,0,5,60,60
1649921135318,COGS 101A,A01,083621,Davis; Joshua Daniel,0,6,60,60
1649921141345,COGS 101B,A01,091572,Staff,32,0,60,28
1649921147373,COGS 101C,A01,083625,Delgado; Tania,24,0,30,6
1649921153400,COGS 107A,A01,083627,Boyle; Mary E. T.,14,0,60,46
1649921159432,COGS 118A,A01,083075,Staff,21,0,60,39
1649921165461,CSE 3,A50,083646,Miranda; Gregory Joseph,25,0,38,13
1649921165461,CSE 3,A51,083647,Miranda; Gregory Joseph,37,0,37,0
1649921171484,CSE 8A,A50,083650,Miranda; Gregory Joseph,8,0,40,32
1649921177508,CSE 11,A01,083080,Cao; Yingjun,0,26,40,40
1649921183534,CSE 12,A01,083652,Staff,56,0,100,44
1649921189558,CSE 15L,A01,083654,Staff,19,0,50,31
1649921189558,CSE 15L,A02,083655,Staff,47,0,50,3
1649921195585,CSE 20,A01,083657,Staff,68,0,80,12
1649921201622,CSE 30,A01,083084,Eldon; John,0,23,40,40
1649921207646,CSE 100,A01,083659,Cao; Yingjun,1,27,50,49
1649921213682,CSE 134B,A01,083661,Powell; Thomas Allan,0,21,65,65
1649921219704,CSE 140,A01,083663,Staff,24,0,75,51
1649921225728,CSE 140L,A01,083088,Eldon; John,18,0,75,57
1649921231752,CSE 175,A01,083665,Kumar; Rakesh,12,0,25,13
1649921237777,CSE 190,A00,092507,Dubnov; Shlomo,14,0,15,1
1649921243804,ECE 45,A01,083139,Staff,6,0,40,34
1649921249829,ECE 65,A50,083695,Staff,8,0,30,22
1649921255854,ECE 109,A01,091882,Touri; Behrouz,55,0,70,15
1649921261879,ECE 180,A00,083140,Abi Samra; Nicholas Camill,26,0,30,4
1649921261879,ECE 180,B00,083141,Abi Samra; Nicholas Camill,13,0,30,17
1649921267903,MATH 10A,A01,083735,Patchell; Gregory David,20,0,30,10
1649921267903,MATH 10A,A02,083736,Patchell; Gregory David,28,0,30,2
1649921267903,MATH 10A,A03,083737,Patchell; Gregory David,28,0,30,2
1649921273931,MATH 10B,A01,083207,Staff,10,0,30,20
1649921273931,MATH 10B,A02,083208,Staff,25,0,30,5
1649921273931,MATH 10B,B01,083739,Staff,25,0,30,5
1649921273931,MATH 10B,B02,083740,Staff,30,0,30,0
1649921279957,MATH 18,A01,083743,Staff,22,0,30,8
1649921279957,MATH 18,A02,083744,Staff,29,0,30,1
1649921279957,MATH 18,A03,083745,Staff,29,0,30,1
1649921279957,MATH 18,A04,083746,Staff,28,0,30,2
1649921279957,MATH 18,B01,083748,Staff,5,0,30,25
1649921279957,MATH 18,B02,083749,Staff,26,0,30,4
1649921279957,MATH 18,B03,083750,Staff,28,0,30,2
1649921279957,MATH 18,B04,083751,Staff,27,0,30,3
1649921285983,MATH 20A,A01,083754,Staff,37,0,40,3
1649921292010,MATH 20B,A01,083756,Staff,19,0,30,11
1649921292010,MATH 20B,A02,083757,Staff,30,0,30,0
1649921298039,MATH 20C,A01,083760,Staff,22,0,30,8
1649921298039,MATH 20C,A02,083761,Staff,23,0,30,7
1649921298039,MATH 20C,B01,083762,Staff,28,0,30,2
1649921298039,MATH 20C,B02,083763,Staff,30,0,30,0
1649921304063,MATH 20D,A01,083765,Staff,20,0,30,10
1649921304063,MATH 20D,A02,083766,Staff,30,0,30,0
1649921304063,MATH 20D,A03,083767,Staff,30,0,30,0
1649921310087,MATH 20E,A01,083771,Staff,12,0,30,18
1649921310087,MATH 20E,A02,083772,Staff,24,0,30,6
1649921310087,MATH 20E,B01,083773,Staff,18,0,30,12
1649921310087,MATH 20E,B02,083774,Staff,29,0,30,1
1649921316116,MATH 103A,A01,083777,Staff,1,4,30,29
1649921316116,MATH 103A,A02,083778,Staff,0,3,30,30
1649921316116,MATH 103A,B01,083779,Staff,0,0,30,30
1649921316116,MATH 103A,B02,083780,Staff,16,0,30,14
1649921322141,MATH 105,A01,085443,Staff,0,5,30,30
1649921328171,MATH 109,A01,083213,Anzaldo; Leesa B,14,0,30,16
1649921328171,MATH 109,A02,083214,Anzaldo; Leesa B,10,0,30,20
1649921328171,MATH 109,B01,083215,Anzaldo; Leesa B,26,0,30,4
1649921328171,MATH 109,B02,083216,Anzaldo; Leesa B,22,0,30,8
1649921334196,MATH 142A,A01,083219,Chow; Bennett,0,1,30,30
1649921334196,MATH 142A,A02,083220,Chow; Bennett,9,0,30,21
1649921334196,MATH 142A,B01,083221,Chow; Bennett,0,0,30,30
1649921334196,MATH 142A,B02,083222,Chow; Bennett,1,0,30,29
1649921340224,MATH 193A,A01,083224,Staff,0,3,30,30
1649921340224,MATH 193A,A02,083225,Staff,0,3,30,30
1649921340224,MATH 193A,A03,083781,Staff,4,0,30,26
1649921340224,MATH 193A,A04,083782,Staff,16,0,30,14
1649921346248,MATH 197,001,091859,McAuley; Julian John,9999,0,9999,0
1649921352302,COGS 9,A01,083615,Staff,16,0,60,44
1649921358324,COGS 11,A01,083617,Boyle; Mary E. T.,35,0,40,5
1649921364349,COGS 13,A01,083071,Staff,0,11,40,40
1649921370374,COGS 14A,A01,092681,Staff,66,0,100,34
1649921376397,COGS 14B,A01,083073,Cheng; Tzu-Han,24,0,50,26
1649921382421,COGS 17,A01,092677,Staff,63,0,75,12
1649921388444,COGS 100,A01,083619,Staff,0,5,60,60
1649921394472,COGS 101A,A01,083621,Davis; Joshua Daniel,0,6,60,60
1649921400502,COGS 101B,A01,091572,Staff,32,0,60,28
1649921406528,COGS 101C,A01,083625,Delgado; Tania,24,0,30,6
1649921412552,COGS 107A,A01,083627,Boyle; Mary E. T.,14,0,60,46
1649921418576,COGS 118A,A01,083075,Staff,21,0,60,39
1649921424601,CSE 3,A50,083646,Miranda; Gregory Joseph,25,0,38,13
1649921424601,CSE 3,A51,083647,Miranda; Gregory Joseph,37,0,37,0
1649921430625,CSE 8A,A50,083650,Miranda; Gregory Joseph,8,0,40,32
1649921436659,CSE 11,A01,083080,Cao; Yingjun,0,26,40,40
1649921442682,CSE 12,A01,083652,Staff,56,0,100,44
1649921448704,CSE 15L,A01,083654,Staff,19,0,50,31
1649921448704,CSE 15L,A02,083655,Staff,47,0,50,3
1649921454728,CSE 20,A01,083657,Staff,68,0,80,12
1649921460755,CSE 30,A01,083084,Eldon; John,0,23,40,40
1649921466857,CSE 100,A01,083659,Cao; Yingjun,1,27,50,49
1649921472881,CSE 134B,A01,083661,Powell; Thomas Allan,0,21,65,65
1649921478905,CSE 140,A01,083663,Staff,24,0,75,51
1649921484927,CSE 140L,A01,083088,Eldon; John,18,0,75,57
1649921490953,CSE 175,A01,083665,Kumar; Rakesh,12,0,25,13
1649921496984,CSE 190,A00,092507,Dubnov; Shlomo,14,0,15,1
1649921503011,ECE 45,A01,083139,Staff,6,0,40,34
1649921509038,ECE 65,A50,083695,Staff,8,0,30,22
1649921515066,ECE 109,A01,091882,Touri; Behrouz,55,0,70,15
1649921521091,ECE 180,A00,083140,Abi Samra; Nicholas Camill,26,0,30,4
1649921521091,ECE 180,B00,083141,Abi Samra; Nicholas Camill,13,0,30,17
1649921527113,MATH 10A,A01,083735,Patchell; Gregory David,20,0,30,10
1649921527113,MATH 10A,A02,083736,Patchell; Gregory David,28,0,30,2
1649921527113,MATH 10A,A03,083737,Patchell; Gregory David,28,0,30,2
1649921533139,MATH 10B,A01,083207,Staff,10,0,30,20
1649921533139,MATH 10B,A02,083208,Staff,25,0,30,5
1649921533139,MATH 10B,B01,083739,Staff,25,0,30,5
1649921533139,MATH 10B,B02,083740,Staff,30,0,30,0
1649921539165,MATH 18,A01,083743,Staff,22,0,30,8
1649921539165,MATH 18,A02,083744,Staff,29,0,30,1
1649921539165,MATH 18,A03,083745,Staff,29,0,30,1
1649921539165,MATH 18,A04,083746,Staff,28,0,30,2
1649921539165,MATH 18,B01,083748,Staff,5,0,30,25
1649921539165,MATH 18,B02,083749,Staff,26,0,30,4
1649921539165,MATH 18,B03,083750,Staff,28,0,30,2
1649921539165,MATH 18,B04,083751,Staff,27,0,30,3
1649921545188,MATH 20A,A01,083754,Staff,37,0,40,3
1649921551213,MATH 20B,A01,083756,Staff,19,0,30,11
1649921551213,MATH 20B,A02,083757,Staff,30,0,30,0
1649921557240,MATH 20C,A01,083760,Staff,22,0,30,8
1649921557240,MATH 20C,A02,083761,Staff,23,0,30,7
1649921557240,MATH 20C,B01,083762,Staff,28,0,30,2
1649921557240,MATH 20C,B02,083763,Staff,30,0,30,0
1649921563263,MATH 20D,A01,083765,Staff,20,0,30,10
1649921563263,MATH 20D,A02,083766,Staff,30,0,30,0
1649921563263,MATH 20D,A03,083767,Staff,30,0,30,0
1649921569292,MATH 20E,A01,083771,Staff,12,0,30,18
1649921569292,MATH 20E,A02,083772,Staff,24,0,30,6
1649921569292,MATH 20E,B01,083773,Staff,18,0,30,12
1649921569292,MATH 20E,B02,083774,Staff,29,0,30,1
1649921575318,MATH 103A,A01,083777,Staff,1,4,30,29
1649921575318,MATH 103A,A02,083778,Staff,0,3,30,30
1649921575318,MATH 103A,B01,083779,Staff,0,0,30,30
1649921575318,MATH 103A,B02,083780,Staff,16,0,30,14
1649921581352,MATH 105,A01,085443,Staff,0,5,30,30
1649921587375,MATH 109,A01,083213,Anzaldo; Leesa B,14,0,30,16
1649921587375,MATH 109,A02,083214,Anzaldo; Leesa B,10,0,30,20
1649921587375,MATH 109,B01,083215,Anzaldo; Leesa B,26,0,30,4
1649921587375,MATH 109,B02,083216,Anzaldo; Leesa B,22,0,30,8
1649921593400,MATH 142A,A01,083219,Chow; Bennett,0,1,30,30
1649921593400,MATH 142A,A02,083220,Chow; Bennett,9,0,30,21
1649921593400,MATH 142A,B01,083221,Chow; Bennett,0,0,30,30
1649921593400,MATH 142A,B02,083222,Chow; Bennett,1,0,30,29
1649921599434,MATH 193A,A01,083224,Staff,0,3,30,30
1649921599434,MATH 193A,A02,083225,Staff,0,3,30,30
1649921599434,MATH 193A,A03,083781,Staff,4,0,30,26
1649921599434,MATH 193A,A04,083782,Staff,16,0,30,14
1649921605462,MATH 197,001,091859,McAuley; Julian John,9999,0,9999,0
1649921611539,COGS 9,A01,083615,Staff,16,0,60,44
1649921617571,COGS 11,A01,083617,Boyle; Mary E. T.,35,0,40,5
1649921623595,COGS 13,A01,083071,Staff,0,11,40,40
1649921629621,COGS 14A,A01,092681,Staff,66,0,100,34
1649921635650,COGS 14B,A01,083073,Cheng; Tzu-Han,24,0,50,26
1649921641677,COGS 17,A01,092677,Staff,63,0,75,12
1649921647698,COGS 100,A01,083619,Staff,0,5,60,60
1649921653728,COGS 101A,A01,083621,Davis; Joshua Daniel,0,7,60,60
1649921659751,COGS 101B,A01,091572,Staff,32,0,60,28
1649921665778,COGS 101C,A01,083625,Delgado; Tania,24,0,30,6
1649921671802,COGS 107A,A01,083627,Boyle; Mary E. T.,14,0,60,46
1649921677837,COGS 118A,A01,083075,Staff,21,0,60,39
1649921683865,CSE 3,A50,083646,Miranda; Gregory Joseph,25,0,38,13
1649921683865,CSE 3,A51,083647,Miranda; Gregory Joseph,37,0,37,0
1649921689888,CSE 8A,A50,083650,Miranda; Gregory Joseph,8,0,40,32
1649921695911,CSE 11,A01,083080,Cao; Yingjun,0,26,40,40
1649921701937,CSE 12,A01,083652,Staff,56,0,100,44
1649921707964,CSE 15L,A01,083654,Staff,19,0,50,31
1649921707964,CSE 15L,A02,083655,Staff,47,0,50,3
1649921713993,CSE 20,A01,083657,Staff,68,0,80,12
1649921720026,CSE 30,A01,083084,Eldon; John,0,23,40,40
1649921726053,CSE 100,A01,083659,Cao; Yingjun,1,27,50,49
1649921732083,CSE 134B,A01,083661,Powell; Thomas Allan,0,21,65,65
1649921738106,CSE 140,A01,083663,Staff,24,0,75,51
1649921744129,CSE 140L,A01,083088,Eldon; John,18,0,75,57
1649921750157,CSE 175,A01,083665,Kumar; Rakesh,12,0,25,13
1649921756180,CSE 190,A00,092507,Dubnov; Shlomo,14,0,15,1
1649921762208,ECE 45,A01,083139,Staff,6,0,40,34
1649921768233,ECE 65,A50,083695,Staff,8,0,30,22
1649921774256,ECE 109,A01,091882,Touri; Behrouz,55,0,70,15
1649921780282,ECE 180,A00,083140,Abi Samra; Nicholas Camill,26,0,30,4
1649921780282,ECE 180,B00,083141,Abi Samra; Nicholas Camill,13,0,30,17
1649921786307,MATH 10A,A01,083735,Patchell; Gregory David,20,0,30,10
1649921786307,MATH 10A,A02,083736,Patchell; Gregory David,28,0,30,2
1649921786307,MATH 10A,A03,083737,Patchell; Gregory David,28,0,30,2
1649921792335,MATH 10B,A01,083207,Staff,10,0,30,20
1649921792335,MATH 10B,A02,083208,Staff,25,0,30,5
1649921792335,MATH 10B,B01,083739,Staff,25,0,30,5
1649921792335,MATH 10B,B02,083740,Staff,30,0,30,0
1649921798359,MATH 18,A01,083743,Staff,22,0,30,8
1649921798359,MATH 18,A02,083744,Staff,29,0,30,1
1649921798359,MATH 18,A03,083745,Staff,29,0,30,1
1649921798359,MATH 18,A04,083746,Staff,28,0,30,2
1649921798359,MATH 18,B01,083748,Staff,5,0,30,25
1649921798359,MATH 18,B02,083749,Staff,25,0,30,5
1649921798359,MATH 18,B03,083750,Staff,28,0,30,2
1649921798359,MATH 18,B04,083751,Staff,27,0,30,3
1649921804458,MATH 20A,A01,083754,Staff,37,0,40,3
1649921810482,MATH 20B,A01,083756,Staff,19,0,30,11
1649921810482,MATH 20B,A02,083757,Staff,30,0,30,0
1649921816507,MATH 20C,A01,083760,Staff,22,0,30,8
1649921816507,MATH 20C,A02,083761,Staff,23,0,30,7
1649921816507,MATH 20C,B01,083762,Staff,28,0,30,2
1649921816507,MATH 20C,B02,083763,Staff,30,0,30,0
1649921822530,MATH 20D,A01,083765,Staff,20,0,30,10
1649921822530,MATH 20D,A02,083766,Staff,30,0,30,0
1649921822530,MATH 20D,A03,083767,Staff,30,0,30,0
1649921828557,MATH 20E,A01,083771,Staff,12,0,30,18
1649921828557,MATH 20E,A02,083772,Staff,24,0,30,6
1649921828557,MATH 20E,B01,083773,Staff,18,0,30,12
1649921828557,MATH 20E,B02,083774,Staff,29,0,30,1
1649921834587,MATH 103A,A01,083777,Staff,1,4,30,29
1649921834587,MATH 103A,A02,083778,Staff,0,3,30,30
1649921834587,MATH 103A,B01,083779,Staff,0,0,30,30
1649921834587,MATH 103A,B02,083780,Staff,16,0,30,14
1649921840615,MATH 105,A01,085443,Staff,0,5,30,30
1649921846640,MATH 109,A01,083213,Anzaldo; Leesa B,14,0,30,16
1649921846640,MATH 109,A02,083214,Anzaldo; Leesa B,10,0,30,20
1649921846640,MATH 109,B01,083215,Anzaldo; Leesa B,26,0,30,4
1649921846640,MATH 109,B02,083216,Anzaldo; Leesa B,22,0,30,8
1649921852665,MATH 142A,A01,083219,Chow; Bennett,0,1,30,30
1649921852665,MATH 142A,A02,083220,Chow; Bennett,9,0,30,21
1649921852665,MATH 142A,B01,083221,Chow; Bennett,0,0,30,30
1649921852665,MATH 142A,B02,083222,Chow; Bennett,1,0,30,29
1649921858695,MATH 193A,A01,083224,Staff,0,3,30,30
1649921858695,MATH 193A,A02,083225,Staff,0,3,30,30
1649921858695,MATH 193A,A03,083781,Staff,4,0,30,26
1649921858695,MATH 193A,A04,083782,Staff,16,0,30,14
1649921864721,MATH 197,001,091859,McAuley; Julian John,9999,0,9999,0
1649921870778,COGS 9,A01,083615,Staff,16,0,60,44
1649921876806,COGS 11,A01,083617,Boyle; Mary E. T.,35,0,40,5
1649921882830,COGS 13,A01,083071,Staff,0,11,40,40
1649921888860,COGS 14A,A01,092681,Staff,66,0,100,34
1649921894882,COGS 14B,A01,083073,Cheng; Tzu-Han,24,0,50,26
1649921900906,COGS 17,A01,092677,Staff,63,0,75,12
1649921906930,COGS 100,A01,083619,Staff,0,5,60,60
1649921912957,COGS 101A,A01,083621,Davis; Joshua Daniel,0,7,60,60
1649921918995,COGS 101B,A01,091572,Staff,32,0,60,28
1649921925020,COGS 101C,A01,083625,Delgado; Tania,24,0,30,6
1649921931045,COGS 107A,A01,083627,Boyle; Mary E. T.,14,0,60,46
1649921937077,COGS 118A,A01,083075,Staff,21,0,60,39
1649921943104,CSE 3,A50,083646,Miranda; Gregory Joseph,25,0,38,13
1649921943104,CSE 3,A51,083647,Miranda; Gregory Joseph,37,0,37,0
1649921949128,CSE 8A,A50,083650,Miranda; Gregory Joseph,8,0,40,32
1649921955171,CSE 11,A01,083080,Cao; Yingjun,0,26,40,40
1649921961195,CSE 12,A01,083652,Staff,56,0,100,44
1649921967218,CSE 15L,A01,083654,Staff,19,0,50,31
1649921967218,CSE 15L,A02,083655,Staff,47,0,50,3
1649921973241,CSE 20,A01,083657,Staff,68,0,80,12
1649921979265,CSE 30,A01,083084,Eldon; John,0,23,40,40
1649921985294,CSE 100,A01,083659,Cao; Yingjun,1,27,50,49
1649921991331,CSE 134B,A01,083661,Powell; Thomas Allan,0,21,65,65
1649921997356,CSE 140,A01,083663,Staff,24,0,75,51
1649922003382,CSE 140L,A01,083088,Eldon; John,18,0,75,57
1649922009411,CSE 175,A01,083665,Kumar; Rakesh,12,0,25,13
1649922015436,CSE 190,A00,092507,Dubnov; Shlomo,14,0,15,1
1649922021466,ECE 45,A01,083139,Staff,6,0,40,34
1649922027526,ECE 65,A50,083695,Staff,8,0,30,22
1649922033552,ECE 109,A01,091882,Touri; Behrouz,55,0,70,15
1649922039580,ECE 180,A00,083140,Abi Samra; Nicholas Camill,26,0,30,4
1649922039580,ECE 180,B00,083141,Abi Samra; Nicholas Camill,13,0,30,17
1649922045612,MATH 10A,A01,083735,Patchell; Gregory David,20,0,30,10
1649922045612,MATH 10A,A02,083736,Patchell; Gregory David,28,0,30,2
1649922045612,MATH 10A,A03,083737,Patchell; Gregory David,28,0,30,2
1649922051638,MATH 10B,A01,083207,Staff,10,0,30,20
1649922051638,MATH 10B,A02,083208,Staff,25,0,30,5
1649922051638,MATH 10B,B01,083739,Staff,25,0,30,5
1649922051638,MATH 10B,B02,083740,Staff,30,0,30,0
1649922057671,MATH 18,A01,083743,Staff,22,0,30,8
1649922057671,MATH 18,A02,083744,Staff,29,0,30,1
1649922057671,MATH 18,A03,083745,Staff,29,0,30,1
1649922057671,MATH 18,A04,083746,Staff,28,0,30,2
1649922057671,MATH 18,B01,083748,Staff,5,0,30,25
1649922057671,MATH 18,B02,083749,Staff,26,0,30,4
1649922057671,MATH 18,B03,083750,Staff,28,0,30,2
1649922057671,MATH 18,B04,083751,Staff,26,0,30,4
1649922063772,MATH 20A,A01,083754,Staff,37,0,40,3
1649922069796,MATH 20B,A01,083756,Staff,19,0,30,11
1649922069796,MATH 20B,A02,083757,Staff,30,0,30,0
1649922075821,MATH 20C,A01,083760,Staff,22,0,30,8
1649922075821,MATH 20C,A02,083761,Staff,23,0,30,7
1649922075821,MATH 20C,B01,083762,Staff,28,0,30,2
1649922075821,MATH 20C,B02,083763,Staff,30,0,30,0
1649922081850,MATH 20D,A01,083765,Staff,20,0,30,10
1649922081850,MATH 20D,A02,083766,Staff,30,0,30,0
1649922081850,MATH 20D,A03,083767,Staff,30,0,30,0
1649922087877,MATH 20E,A01,083771,Staff,12,0,30,18
1649922087877,MATH 20E,A02,083772,Staff,24,0,30,6
1649922087877,MATH 20E,B01,083773,Staff,18,0,30,12
1649922087877,MATH 20E,B02,083774,Staff,29,0,30,1
1649922093907,MATH 103A,A01,083777,Staff,1,4,30,29
1649922093907,MATH 103A,A02,083778,Staff,0,3,30,30
1649922093907,MATH 103A,B01,083779,Staff,0,0,30,30
1649922093907,MATH 103A,B02,083780,Staff,16,0,30,14
1649922099932,MATH 105,A01,085443,Staff,0,5,30,30
1649922105961,MATH 109,A01,083213,Anzaldo; Leesa B,14,0,30,16
1649922105961,MATH 109,A02,083214,Anzaldo; Leesa B,10,0,30,20
1649922105961,MATH 109,B01,083215,Anzaldo; Leesa B,26,0,30,4
1649922105961,MATH 109,B02,083216,Anzaldo; Leesa B,22,0,30,8
1649922111989,MATH 142A,A01,083219,Chow; Bennett,0,1,30,30
1649922111989,MATH 142A,A02,083220,Chow; Bennett,9,0,30,21
1649922111989,MATH 142A,B01,083221,Chow; Bennett,0,0,30,30
1649922111989,MATH 142A,B02,083222,Chow; Bennett,1,0,30,29
1649922118013,MATH 193A,A01,083224,Staff,0,3,30,30
1649922118013,MATH 193A,A02,083225,Staff,0,3,30,30
1649922118013,MATH 193A,A03,083781,Staff,4,0,30,26
1649922118013,MATH 193A,A04,083782,Staff,16,0,30,14
1649922124036,MATH 197,001,091859,McAuley; Julian John,9999,0,9999,0
1649922130103,COGS 9,A01,083615,Staff,16,0,60,44
1649922136137,COGS 11,A01,083617,Boyle; Mary E. T.,35,0,40,5
1649922142172,COGS 13,A01,083071,Staff,0,11,40,40
1649922148196,COGS 14A,A01,092681,Staff,66,0,100,34
1649922154225,COGS 14B,A01,083073,Cheng; Tzu-Han,24,0,50,26
1649922160253,COGS 17,A01,092677,Staff,63,0,75,12
1649922166290,COGS 100,A01,083619,Staff,0,5,60,60
1649922172320,COGS 101A,A01,083621,Davis; Joshua Daniel,0,7,60,60
1649922178344,COGS 101B,A01,091572,Staff,32,0,60,28
1649922184375,COGS 101C,A01,083625,Delgado; Tania,24,0,30,6
1649922190410,COGS 107A,A01,083627,Boyle; Mary E. T.,14,0,60,46
1649922196438,COGS 118A,A01,083075,Staff,21,0,60,39
1649922202464,CSE 3,A50,083646,Miranda; Gregory Joseph,25,0,38,13
1649922202464,CSE 3,A51,083647,Miranda; Gregory Joseph,37,0,37,0
1649922208495,CSE 8A,A50,083650,Miranda; Gregory Joseph,8,0,40,32
1649922214525,CSE 11,A01,083080,Cao; Yingjun,0,26,40,40
1649922220553,CSE 12,A01,083652,Staff,56,0,100,44
1649922226578,CSE 15L,A01,083654,Staff,19,0,50,31
1649922226578,CSE 15L,A02,083655,Staff,47,0,50,3
1649922232619,CSE 20,A01,083657,Staff,68,0,80,12
1649922238643,CSE 30,A01,083084,Eldon; John,0,23,40,40
1649922244672,CSE 100,A01,083659,Cao; Yingjun,1,27,50,49
1649922250699,CSE 134B,A01,083661,Powell; Thomas Allan,0,21,65,65
1649922256723,CSE 140,A01,083663,Staff,24,0,75,51
1649922262751,CSE 140L,A01,083088,Eldon; John,18,0,75,57
1649922268776,CSE 175,A01,083665,Kumar; Rakesh,12,0,25,13
1649922274801,CSE 190,A00,092507,Dubnov; Shlomo,14,0,15,1
1649922280829,ECE 45,A01,083139,Staff,6,0,40,34
1649922286864,ECE 65,A50,083695,Staff,8,0,30,22
1649922292890,ECE 109,A01,091882,Touri; Behrouz,55,0,70,15
1649922298913,ECE 180,A00,083140,Abi Samra; Nicholas Camill,26,0,30,4
1649922298913,ECE 180,B00,083141,Abi Samra; Nicholas Camill,13,0,30,17
1649922304939,MATH 10A,A01,083735,Patchell; Gregory David,20,0,30,10
1649922304939,MATH 10A,A02,083736,Patchell; Gregory David,28,0,30,2
1649922304939,MATH 10A,A03,083737,Patchell; Gregory David,28,0,30,2
1649922310963,MATH 10B,A01,083207,Staff,10,0,30,20
1649922310963,MATH 10B,A02,083208,Staff,25,0,30,5
1649922310963,MATH 10B,B01,083739,Staff,25,0,30,5
1649922310963,MATH 10B,B02,083740,Staff,30,0,30,0
1649922317040,MATH 18,A01,083743,Staff,22,0,30,8
1649922317040,MATH 18,A02,083744,Staff,29,0,30,1
1649922317040,MATH 18,A03,083745,Staff,29,0,30,1
1649922317040,MATH 18,A04,083746,Staff,28,0,30,2
1649922317040,MATH 18,B01,083748,Staff,5,0,30,25
1649922317040,MATH 18,B02,083749,Staff,26,0,30,4
1649922317040,MATH 18,B03,083750,Staff,28,0,30,2
1649922317040,MATH 18,B04,083751,Staff,26,0,30,4
1649922323064,MATH 20A,A01,083754,Staff,37,0,40,3
1649922329095,MATH 20B,A01,083756,Staff,19,0,30,11
1649922329095,MATH 20B,A02,083757,Staff,30,0,30,0
1649922335123,MATH 20C,A01,083760,Staff,22,0,30,8
1649922335123,MATH 20C,A02,083761,Staff,23,0,30,7
1649922335123,MATH 20C,B01,083762,Staff,28,0,30,2
1649922335123,MATH 20C,B02,083763,Staff,30,0,30,0
1649922341153,MATH 20D,A01,083765,Staff,20,0,30,10
1649922341153,MATH 20D,A02,083766,Staff,30,0,30,0
1649922341153,MATH 20D,A03,083767,Staff,30,0,30,0
1649922347176,MATH 20E,A01,083771,Staff,12,0,30,18
1649922347176,MATH 20E,A02,083772,Staff,24,0,30,6
1649922347176,MATH 20E,B01,083773,Staff,18,0,30,12
1649922347176,MATH 20E,B02,083774,Staff,29,0,30,1
1649922353206,MATH 103A,A01,083777,Staff,1,4,30,29
1649922353206,MATH 103A,A02,083778,Staff,0,3,30,30
1649922353206,MATH 103A,B01,083779,Staff,0,0,30,30
1649922353206,MATH 103A,B02,083780,Staff,16,0,30,14
1649922359230,MATH 105,A01,085443,Staff,0,5,30,30
1649922365255,MATH 109,A01,083213,Anzaldo; Leesa B,14,0,30,16
1649922365255,MATH 109,A02,083214,Anzaldo; Leesa B,10,0,30,20
1649922365255,MATH 109,B01,083215,Anzaldo; Leesa B,26,0,30,4
1649922365255,MATH 109,B02,083216,Anzaldo; Leesa B,22,0,30,8
1649922371281,MATH 142A,A01,083219,Chow; Bennett,0,1,30,30
1649922371281,MATH 142A,A02,083220,Chow; Bennett,9,0,30,21
1649922371281,MATH 142A,B01,083221,Chow; Bennett,0,0,30,30
1649922371281,MATH 142A,B02,083222,Chow; Bennett,1,0,30,29
1649922377321,MATH 193A,A01,083224,Staff,0,3,30,30
1649922377321,MATH 193A,A02,083225,Staff,0,3,30,30
1649922377321,MATH 193A,A03,083781,Staff,4,0,30,26
1649922377321,MATH 193A,A04,083782,Staff,16,0,30,14
1649922383345,MATH 197,001,091859,McAuley; Julian John,9999,0,9999,0
1649922389419,COGS 9,A01,083615,Staff,16,0,60,44
1649922395445,COGS 11,A01,083617,Boyle; Mary E. T.,35,0,40,5
1649922401479,COGS 13,A01,083071,Staff,0,11,40,40
1649922407503,COGS 14A,A01,092681,Staff,66,0,100,34
1649922413529,COGS 14B,A01,083073,Cheng; Tzu-Han,24,0,50,26
1649922419554,COGS 17,A01,092677,Staff,63,0,75,12
1649922425584,COGS 100,A01,083619,Staff,0,5,60,60
1649922431608,COGS 101A,A01,083621,Davis; Joshua Daniel,0,7,60,60
1649922437638,COGS 101B,A01,091572,Staff,32,0,60,28
1649922443684,COGS 101C,A01,083625,Delgado; Tania,24,0,30,6
1649922449709,COGS 107A,A01,083627,Boyle; Mary E. T.,14,0,60,46
1649922455734,COGS 118A,A01,083075,Staff,21,0,60,39
1649922461761,CSE 3,A50,083646,Miranda; Gregory Joseph,25,0,38,13
1649922461761,CSE 3,A51,083647,Miranda; Gregory Joseph,37,0,37,0
1649922467792,CSE 8A,A50,083650,Miranda; Gregory Joseph,8,0,40,32
1649922473824,CSE 11,A01,083080,Cao; Yingjun,0,26,40,40
1649922479849,CSE 12,A01,083652,Staff,56,0,100,44
1649922485873,CSE 15L,A01,083654,Staff,19,0,50,31
1649922485873,CSE 15L,A02,083655,Staff,47,0,50,3
1649922491897,CSE 20,A01,083657,Staff,68,0,80,12
1649922497922,CSE 30,A01,083084,Eldon; John,0,24,40,40
1649922503949,CSE 100,A01,083659,Cao; Yingjun,1,27,50,49
1649922509978,CSE 134B,A01,083661,Powell; Thomas Allan,0,21,65,65
1649922516002,CSE 140,A01,083663,Staff,24,0,75,51
1649922522030,CSE 140L,A01,083088,Eldon; John,18,0,75,57
1649922528055,CSE 175,A01,083665,Kumar; Rakesh,12,0,25,13
1649922534090,CSE 190,A00,092507,Dubnov; Shlomo,14,0,15,1
1649922540116,ECE 45,A01,083139,Staff,6,0,40,34
1649922546148,ECE 65,A50,083695,Staff,8,0,30,22
1649922552187,ECE 109,A01,091882,Touri; Behrouz,55,0,70,15
1649922558213,ECE 180,A00,083140,Abi Samra; Nicholas Camill,26,0,30,4
1649922558213,ECE 180,B00,083141,Abi Samra; Nicholas Camill,13,0,30,17
1649922564238,MATH 10A,A01,083735,Patchell; Gregory David,20,0,30,10
1649922564238,MATH 10A,A02,083736,Patchell; Gregory David,28,0,30,2
1649922564238,MATH 10A,A03,083737,Patchell; Gregory David,28,0,30,2
1649922570263,MATH 10B,A01,083207,Staff,10,0,30,20
1649922570263,MATH 10B,A02,083208,Staff,25,0,30,5
1649922570263,MATH 10B,B01,083739,Staff,25,0,30,5
1649922570263,MATH 10B,B02,083740,Staff,30,0,30,0
1649922576298,MATH 18,A01,083743,Staff,22,0,30,8
1649922576298,MATH 18,A02,083744,Staff,29,0,30,1
1649922576298,MATH 18,A03,083745,Staff,29,0,30,1
1649922576298,MATH 18,A04,083746,Staff,28,0,30,2
1649922576298,MATH 18,B01,083748,Staff,5,0,30,25
1649922576298,MATH 18,B02,083749,Staff,26,0,30,4
1649922576298,MATH 18,B03,083750,Staff,28,0,30,2
1649922576298,MATH 18,B04,083751,Staff,26,0,30,4
1649922582323,MATH 20A,A01,083754,Staff,37,0,40,3
1649922588353,MATH 20B,A01,083756,Staff,19,0,30,11
1649922588353,MATH 20B,A02,083757,Staff,30,0,30,0
1649922594407,MATH 20C,A01,083760,Staff,22,0,30,8
1649922594407,MATH 20C,A02,083761,Staff,23,0,30,7
1649922594407,MATH 20C,B01,083762,Staff,28,0,30,2
1649922594407,MATH 20C,B02,083763,Staff,30,0,30,0
1649922600434,MATH 20D,A01,083765,Staff,20,0,30,10
1649922600434,MATH 20D,A02,083766,Staff,30,0,30,0
1649922600434,MATH 20D,A03,083767,Staff,30,0,30,0
1649922606459,MATH 20E,A01,083771,Staff,12,0,30,18
1649922606459,MATH 20E,A02,083772,Staff,24,0,30,6
1649922606459,MATH 20E,B01,083773,Staff,18,0,30,12
1649922606459,MATH 20E,B02,083774,Staff,29,0,30,1
1649922612485,MATH 103A,A01,083777,Staff,1,4,30,29
1649922612485,MATH 103A,A02,083778,Staff,0,3,30,30
1649922612485,MATH 103A,B01,083779,Staff,0,0,30,30
1649922612485,MATH 103A,B02,083780,Staff,16,0,30,14
1649922618514,MATH 105,A01,085443,Staff,0,5,30,30
1649922624539,MATH 109,A01,083213,Anzaldo; Leesa B,14,0,30,16
1649922624539,MATH 109,A02,083214,Anzaldo; Leesa B,10,0,30,20
1649922624539,MATH 109,B01,083215,Anzaldo; Leesa B,26,0,30,4
1649922624539,MATH 109,B02,083216,Anzaldo; Leesa B,22,0,30,8
1649922630565,MATH 142A,A01,083219,Chow; Bennett,0,1,30,30
1649922630565,MATH 142A,A02,083220,Chow; Bennett,9,0,30,21
1649922630565,MATH 142A,B01,083221,Chow; Bennett,0,0,30,30
1649922630565,MATH 142A,B02,083222,Chow; Bennett,1,0,30,29
1649922636590,MATH 193A,A01,083224,Staff,0,3,30,30
1649922636590,MATH 193A,A02,083225,Staff,0,3,30,30
1649922636590,MATH 193A,A03,083781,Staff,4,0,30,26
1649922636590,MATH 193A,A04,083782,Staff,16,0,30,14
1649922642614,MATH 197,001,091859,McAuley; Julian John,9999,0,9999,0
1649922648684,COGS 9,A01,083615,Staff,16,0,60,44
1649922654788,COGS 11,A01,083617,Boyle; Mary E. T.,35,0,40,5
1649922660817,COGS 13,A01,083071,Staff,0,11,40,40
1649922666845,COGS 14A,A01,092681,Staff,66,0,100,34
1649922672875,COGS 14B,A01,083073,Cheng; Tzu-Han,24,0,50,26
1649922678898,COGS 17,A01,092677,Staff,63,0,75,12
1649922684934,COGS 100,A01,083619,Staff,0,5,60,60
1649922690959,COGS 101A,A01,083621,Davis; Joshua Daniel,0,7,60,60
1649922696989,COGS 101B,A01,091572,Staff,32,0,60,28
1649922703023,COGS 101C,A01,083625,Delgado; Tania,24,0,30,6
1649922709054,COGS 107A,A01,083627,Boyle; Mary E. T.,14,0,60,46
1649922715082,COGS 118A,A01,083075,Staff,21,0,60,39
1649922721107,CSE 3,A50,083646,Miranda; Gregory Joseph,24,0,38,14
1649922721107,CSE 3,A51,083647,Miranda; Gregory Joseph,37,0,37,0
1649922727140,CSE 8A,A50,083650,Miranda; Gregory Joseph,8,0,40,32
1649922733168,CSE 11,A01,083080,Cao; Yingjun,0,26,40,40
1649922739191,CSE 12,A01,083652,Staff,56,0,100,44
1649922745216,CSE 15L,A01,083654,Staff,19,0,50,31
1649922745216,CSE 15L,A02,083655,Staff,47,0,50,3
1649922751245,CSE 20,A01,083657,Staff,68,0,80,12
1649922757269,CSE 30,A01,083084,Eldon; John,0,24,40,40
1649922763294,CSE 100,A01,083659,Cao; Yingjun,1,27,50,49
1649922769320,CSE 134B,A01,083661,Powell; Thomas Allan,0,21,65,65
1649922775345,CSE 140,A01,083663,Staff,24,0,75,51
1649922781376,CSE 140L,A01,083088,Eldon; John,18,0,75,57
1649922787401,CSE 175,A01,083665,Kumar; Rakesh,12,0,25,13
1649922793430,CSE 190,A00,092507,Dubnov; Shlomo,14,0,15,1
1649922799459,ECE 45,A01,083139,Staff,6,0,40,34
1649922805492,ECE 65,A50,083695,Staff,8,0,30,22
1649922811520,ECE 109,A01,091882,Touri; Behrouz,55,0,70,15
1649922817553,ECE 180,A00,083140,Abi Samra; Nicholas Camill,26,0,30,4
1649922817553,ECE 180,B00,083141,Abi Samra; Nicholas Camill,13,0,30,17
1649922823589,MATH 10A,A01,083735,Patchell; Gregory David,20,0,30,10
1649922823589,MATH 10A,A02,083736,Patchell; Gregory David,28,0,30,2
1649922823589,MATH 10A,A03,083737,Patchell; Gregory David,28,0,30,2
1649922829625,MATH 10B,A01,083207,Staff,10,0,30,20
1649922829625,MATH 10B,A02,083208,Staff,25,0,30,5
1649922829625,MATH 10B,B01,083739,Staff,25,0,30,5
1649922829625,MATH 10B,B02,083740,Staff,30,0,30,0
1649922835659,MATH 18,A01,083743,Staff,22,0,30,8
1649922835659,MATH 18,A02,083744,Staff,29,0,30,1
1649922835659,MATH 18,A03,083745,Staff,29,0,30,1
1649922835659,MATH 18,A04,083746,Staff,28,0,30,2
1649922835659,MATH 18,B01,083748,Staff,5,0,30,25
1649922835659,MATH 18,B02,083749,Staff,26,0,30,4
1649922835659,MATH 18,B03,083750,Staff,28,0,30,2
1649922835659,MATH 18,B04,083751,Staff,26,0,30,4
1649922841687,MATH 20A,A01,083754,Staff,37,0,40,3
1649922847713,MATH 20B,A01,083756,Staff,19,0,30,11
1649922847713,MATH 20B,A02,083757,Staff,30,0,30,0
1649922853738,MATH 20C,A01,083760,Staff,22,0,30,8
1649922853738,MATH 20C,A02,083761,Staff,23,0,30,7
1649922853738,MATH 20C,B01,083762,Staff,28,0,30,2
1649922853738,MATH 20C,B02,083763,Staff,30,0,30,0
1649922859766,MATH 20D,A01,083765,Staff,20,0,30,10
1649922859766,MATH 20D,A02,083766,Staff,30,0,30,0
1649922859766,MATH 20D,A03,083767,Staff,30,0,30,0
1649922865805,MATH 20E,A01,083771,Staff,12,0,30,18
1649922865805,MATH 20E,A02,083772,Staff,24,0,30,6
1649922865805,MATH 20E,B01,083773,Staff,18,0,30,12
1649922865805,MATH 20E,B02,083774,Staff,29,0,30,1
1649922871832,MATH 103A,A01,083777,Staff,1,4,30,29
1649922871832,MATH 103A,A02,083778,Staff,0,3,30,30
1649922871832,MATH 103A,B01,083779,Staff,0,0,30,30
1649922871832,MATH 103A,B02,083780,Staff,16,0,30,14
1649922877857,MATH 105,A01,085443,Staff,0,5,30,30
1649922883886,MATH 109,A01,083213,Anzaldo; Leesa B,14,0,30,16
1649922883886,MATH 109,A02,083214,Anzaldo; Leesa B,10,0,30,20
1649922883886,MATH 109,B01,083215,Anzaldo; Leesa B,26,0,30,4
1649922883886,MATH 109,B02,083216,Anzaldo; Leesa B,22,0,30,8
1649922889910,MATH 142A,A01,083219,Chow; Bennett,0,1,30,30
1649922889910,MATH 142A,A02,083220,Chow; Bennett,9,0,30,21
1649922889910,MATH 142A,B01,083221,Chow; Bennett,0,0,30,30
1649922889910,MATH 142A,B02,083222,Chow; Bennett,1,0,30,29
1649922895936,MATH 193A,A01,083224,Staff,0,3,30,30
1649922895936,MATH 193A,A02,083225,Staff,0,3,30,30
1649922895936,MATH 193A,A03,083781,Staff,4,0,30,26
1649922895936,MATH 193A,A04,083782,Staff,16,0,30,14
1649922901963,MATH 197,001,091859,McAuley; Julian John,9999,0,9999,0
1649922908045,COGS 9,A01,083615,Staff,16,0,60,44
1649922914075,COGS 11,A01,083617,Boyle; Mary E. T.,35,0,40,5
1649922920098,COGS 13,A01,083071,Staff,0,11,40,40
1649922926122,COGS 14A,A01,092681,Staff,66,0,100,34
1649922932145,COGS 14B,A01,083073,Cheng; Tzu-Han,24,0,50,26
1649922938171,COGS 17,A01,092677,Staff,63,0,75,12
1649922944194,COGS 100,A01,083619,Staff,0,5,60,60
1649922950221,COGS 101A,A01,083621,Davis; Joshua Daniel,0,7,60,60
1649922956246,COGS 101B,A01,091572,Staff,32,0,60,28
1649922962276,COGS 101C,A01,083625,Delgado; Tania,24,0,30,6
1649922968305,COGS 107A,A01,083627,Boyle; Mary E. T.,14,0,60,46
1649922974338,COGS 118A,A01,083075,Staff,21,0,60,39
1649922980372,CSE 3,A50,083646,Miranda; Gregory Joseph,24,0,38,14
1649922980372,CSE 3,A51,083647,Miranda; Gregory Joseph,37,0,37,0
1649922986401,CSE 8A,A50,083650,Miranda; Gregory Joseph,8,0,40,32
1649922992431,CSE 11,A01,083080,Cao; Yingjun,0,26,40,40
1649922998456,CSE 12,A01,083652,Staff,56,0,100,44
1649923004481,CSE 15L,A01,083654,Staff,19,0,50,31
1649923004481,CSE 15L,A02,083655,Staff,47,0,50,3
1649923010503,CSE 20,A01,083657,Staff,68,0,80,12
1649923016528,CSE 30,A01,083084,Eldon; John,0,24,40,40
1649923022568,CSE 100,A01,083659,Cao; Yingjun,1,27,50,49
1649923028598,CSE 134B,A01,083661,Powell; Thomas Allan,0,21,65,65
1649923034627,CSE 140,A01,083663,Staff,24,0,75,51
1649923040663,CSE 140L,A01,083088,Eldon; John,18,0,75,57
1649923046688,CSE 175,A01,083665,Kumar; Rakesh,12,0,25,13
1649923052714,CSE 190,A00,092507,Dubnov; Shlomo,14,0,15,1
1649923058740,ECE 45,A01,083139,Staff,6,0,40,34
1649923064770,ECE 65,A50,083695,Staff,8,0,30,22
1649923070796,ECE 109,A01,091882,Touri; Behrouz,55,0,70,15
1649923076838,ECE 180,A00,083140,Abi Samra; Nicholas Camill,26,0,30,4
1649923076838,ECE 180,B00,083141,Abi Samra; Nicholas Camill,13,0,30,17
1649923082864,MATH 10A,A01,083735,Patchell; Gregory David,20,0,30,10
1649923082864,MATH 10A,A02,083736,Patchell; Gregory David,28,0,30,2
1649923082864,MATH 10A,A03,083737,Patchell; Gregory David,28,0,30,2
1649923088890,MATH 10B,A01,083207,Staff,10,0,30,20
1649923088890,MATH 10B,A02,083208,Staff,25,0,30,5
1649923088890,MATH 10B,B01,083739,Staff,25,0,30,5
1649923088890,MATH 10B,B02,083740,Staff,30,0,30,0
1649923094927,MATH 18,A01,083743,Staff,22,0,30,8
1649923094927,MATH 18,A02,083744,Staff,29,0,30,1
1649923094927,MATH 18,A03,083745,Staff,29,0,30,1
1649923094927,MATH 18,A04,083746,Staff,28,0,30,2
1649923094927,MATH 18,B01,083748,Staff,5,0,30,25
1649923094927,MATH 18,B02,083749,Staff,26,0,30,4
1649923094927,MATH 18,B03,083750,Staff,28,0,30,2
1649923094927,MATH 18,B04,083751,Staff,26,0,30,4
1649923100956,MATH 20A,A01,083754,Staff,37,0,40,3
1649923106982,MATH 20B,A01,083756,Staff,19,0,30,11
1649923106982,MATH 20B,A02,083757,Staff,30,0,30,0
1649923113014,MATH 20C,A01,083760,Staff,22,0,30,8
1649923113014,MATH 20C,A02,083761,Staff,23,0,30,7
1649923113014,MATH 20C,B01,083762,Staff,28,0,30,2
1649923113014,MATH 20C,B02,083763,Staff,30,0,30,0
1649923119042,MATH 20D,A01,083765,Staff,20,0,30,10
1649923119042,MATH 20D,A02,083766,Staff,30,0,30,0
1649923119042,MATH 20D,A03,083767,Staff,30,0,30,0
1649923125067,MATH 20E,A01,083771,Staff,12,0,30,18
1649923125067,MATH 20E,A02,083772,Staff,24,0,30,6
1649923125067,MATH 20E,B01,083773,Staff,18,0,30,12
1649923125067,MATH 20E,B02,083774,Staff,29,0,30,1
1649923131098,MATH 103A,A01,083777,Staff,1,4,30,29
1649923131098,MATH 103A,A02,083778,Staff,0,3,30,30
1649923131098,MATH 103A,B01,083779,Staff,0,0,30,30
1649923131098,MATH 103A,B02,083780,Staff,16,0,30,14
1649923137126,MATH 105,A01,085443,Staff,0,5,30,30
1649923143151,MATH 109,A01,083213,Anzaldo; Leesa B,14,0,30,16
1649923143151,MATH 109,A02,083214,Anzaldo; Leesa B,10,0,30,20
1649923143151,MATH 109,B01,083215,Anzaldo; Leesa B,26,0,30,4
1649923143151,MATH 109,B02,083216,Anzaldo; Leesa B,22,0,30,8
1649923149176,MATH 142A,A01,083219,Chow; Bennett,0,1,30,30
1649923149176,MATH 142A,A02,083220,Chow; Bennett,9,0,30,21
1649923149176,MATH 142A,B01,083221,Chow; Bennett,0,0,30,30
1649923149176,MATH 142A,B02,083222,Chow; Bennett,1,0,30,29
1649923155202,MATH 193A,A01,083224,Staff,0,3,30,30
1649923155202,MATH 193A,A02,083225,Staff,0,3,30,30
1649923155202,MATH 193A,A03,083781,Staff,4,0,30,26
1649923155202,MATH 193A,A04,083782,Staff,16,0,30,14
1649923161228,MATH 197,001,091859,McAuley; Julian John,9999,0,9999,0
1649923167296,COGS 9,A01,083615,Staff,16,0,60,44
1649923173322,COGS 11,A01,083617,Boyle; Mary E. T.,35,0,40,5
1649923179345,COGS 13,A01,083071,Staff,0,11,40,40
1649923185370,COGS 14A,A01,092681,Staff,66,0,100,34
1649923191397,COGS 14B,A01,083073,Cheng; Tzu-Han,24,0,50,26
1649923197425,COGS 17,A01,092677,Staff,63,0,75,12
1649923203452,COGS 100,A01,083619,Staff,0,5,60,60
1649923209480,COGS 101A,A01,083621,Davis; Joshua Daniel,0,7,60,60
1649923215508,COGS 101B,A01,091572,Staff,32,0,60,28
1649923221534,COGS 101C,A01,083625,Delgado; Tania,24,0,30,6
1649923227563,COGS 107A,A01,083627,Boyle; Mary E. T.,14,0,60,46
1649923233590,COGS 118A,A01,083075,Staff,21,0,60,39
1649923239620,CSE 3,A50,083646,Miranda; Gregory Joseph,24,0,38,14
1649923239620,CSE 3,A51,083647,Miranda; Gregory Joseph,37,0,37,0
1649923245654,CSE 8A,A50,083650,Miranda; Gregory Joseph,8,0,40,32
1649923251768,CSE 11,A01,083080,Cao; Yingjun,0,26,40,40
1649923257806,CSE 12,A01,083652,Staff,56,0,100,44
1649923263834,CSE 15L,A01,083654,Staff,19,0,50,31
1649923263834,CSE 15L,A02,083655,Staff,47,0,50,3
1649923269858,CSE 20,A01,083657,Staff,68,0,80,12
1649923275888,CSE 30,A01,083084,Eldon; John,0,24,40,40
1649923281913,CSE 100,A01,083659,Cao; Yingjun,1,27,50,49
1649923287937,CSE 134B,A01,083661,Powell; Thomas Allan,0,21,65,65
1649923293961,CSE 140,A01,083663,Staff,24,0,75,51
1649923299983,CSE 140L,A01,083088,Eldon; John,18,0,75,57
1649923306014,CSE 175,A01,083665,Kumar; Rakesh,12,0,25,13
1649923312048,CSE 190,A00,092507,Dubnov; Shlomo,14,0,15,1
1649923318071,ECE 45,A01,083139,Staff,6,0,40,34
1649923324096,ECE 65,A50,083695,Staff,8,0,30,22
1649923330120,ECE 109,A01,091882,Touri; Behrouz,55,0,70,15
1649923336146,ECE 180,A00,083140,Abi Samra; Nicholas Camill,26,0,30,4
1649923336146,ECE 180,B00,083141,Abi Samra; Nicholas Camill,13,0,30,17
1649923342177,MATH 10A,A01,083735,Patchell; Gregory David,20,0,30,10
1649923342177,MATH 10A,A02,083736,Patchell; Gregory David,28,0,30,2
1649923342177,MATH 10A,A03,083737,Patchell; Gregory David,28,0,30,2
1649923348202,MATH 10B,A01,083207,Staff,10,0,30,20
1649923348202,MATH 10B,A02,083208,Staff,25,0,30,5
1649923348202,MATH 10B,B01,083739,Staff,25,0,30,5
1649923348202,MATH 10B,B02,083740,Staff,30,0,30,0
1649923354229,MATH 18,A01,083743,Staff,22,0,30,8
1649923354229,MATH 18,A02,083744,Staff,29,0,30,1
1649923354229,MATH 18,A03,083745,Staff,29,0,30,1
1649923354229,MATH 18,A04,083746,Staff,28,0,30,2
1649923354229,MATH 18,B01,083748,Staff,5,0,30,25
1649923354229,MATH 18,B02,083749,Staff,26,0,30,4
1649923354229,MATH 18,B03,083750,Staff,28,0,30,2
1649923354229,MATH 18,B04,083751,Staff,26,0,30,4
1649923360254,MATH 20A,A01,083754,Staff,37,0,40,3
1649923366282,MATH 20B,A01,083756,Staff,19,0,30,11
1649923366282,MATH 20B,A02,083757,Staff,30,0,30,0
1649923372307,MATH 20C,A01,083760,Staff,22,0,30,8
1649923372307,MATH 20C,A02,083761,Staff,23,0,30,7
1649923372307,MATH 20C,B01,083762,Staff,28,0,30,2
1649923372307,MATH 20C,B02,083763,Staff,30,0,30,0
1649923378329,MATH 20D,A01,083765,Staff,20,0,30,10
1649923378329,MATH 20D,A02,083766,Staff,30,0,30,0
1649923378329,MATH 20D,A03,083767,Staff,30,0,30,0
1649923384354,MATH 20E,A01,083771,Staff,12,0,30,18
1649923384354,MATH 20E,A02,083772,Staff,24,0,30,6
1649923384354,MATH 20E,B01,083773,Staff,18,0,30,12
1649923384354,MATH 20E,B02,083774,Staff,29,0,30,1
1649923390381,MATH 103A,A01,083777,Staff,1,4,30,29
1649923390381,MATH 103A,A02,083778,Staff,0,3,30,30
1649923390381,MATH 103A,B01,083779,Staff,0,0,30,30
1649923390381,MATH 103A,B02,083780,Staff,16,0,30,14
1649923396415,MATH 105,A01,085443,Staff,0,5,30,30
1649923402440,MATH 109,A01,083213,Anzaldo; Leesa B,14,0,30,16
1649923402440,MATH 109,A02,083214,Anzaldo; Leesa B,10,0,30,20
1649923402440,MATH 109,B01,083215,Anzaldo; Leesa B,26,0,30,4
1649923402440,MATH 109,B02,083216,Anzaldo; Leesa B,22,0,30,8
1649923408465,MATH 142A,A01,083219,Chow; Bennett,0,1,30,30
1649923408465,MATH 142A,A02,083220,Chow; Bennett,9,0,30,21
1649923408465,MATH 142A,B01,083221,Chow; Bennett,0,0,30,30
1649923408465,MATH 142A,B02,083222,Chow; Bennett,1,0,30,29
1649923414490,MATH 193A,A01,083224,Staff,0,3,30,30
1649923414490,MATH 193A,A02,083225,Staff,0,3,30,30
1649923414490,MATH 193A,A03,083781,Staff,4,0,30,26
1649923414490,MATH 193A,A04,083782,Staff,16,0,30,14
1649923420522,MATH 197,001,091859,McAuley; Julian John,9999,0,9999,0
1649923426587,COGS 9,A01,083615,Staff,16,0,60,44
1649923432615,COGS 11,A01,083617,Boyle; Mary E. T.,35,0,40,5
1649923438643,COGS 13,A01,083071,Staff,0,11,40,40
1649923444670,COGS 14A,A01,092681,Staff,65,0,100,35
1649923450704,COGS 14B,A01,083073,Cheng; Tzu-Han,24,0,50,26
1649923456735,COGS 17,A01,092677,Staff,63,0,75,12
1649923462775,COGS 100,A01,083619,Staff,0,5,60,60
1649923468804,COGS 101A,A01,083621,Davis; Joshua Daniel,0,7,60,60
1649923474828,COGS 101B,A01,091572,Staff,32,0,60,28
1649923480851,COGS 101C,A01,083625,Delgado; Tania,24,0,30,6
1649923486877,COGS 107A,A01,083627,Boyle; Mary E. T.,14,0,60,46
1649923492902,COGS 118A,A01,083075,Staff,21,0,60,39
1649923498951,CSE 3,A50,083646,Miranda; Gregory Joseph,24,0,38,14
1649923498951,CSE 3,A51,083647,Miranda; Gregory Joseph,37,0,37,0
1649923504976,CSE 8A,A50,083650,Miranda; Gregory Joseph,8,0,40,32
1649923511004,CSE 11,A01,083080,Cao; Yingjun,0,26,40,40
1649923517029,CSE 12,A01,083652,Staff,56,0,100,44
1649923523058,CSE 15L,A01,083654,Staff,19,0,50,31
1649923523058,CSE 15L,A02,083655,Staff,47,0,50,3
1649923529083,CSE 20,A01,083657,Staff,68,0,80,12
1649923535113,CSE 30,A01,083084,Eldon; John,0,24,40,40
1649923541141,CSE 100,A01,083659,Cao; Yingjun,1,27,50,49
1649923547165,CSE 134B,A01,083661,Powell; Thomas Allan,0,21,65,65
1649923553192,CSE 140,A01,083663,Staff,24,0,75,51
1649923559217,CSE 140L,A01,083088,Eldon; John,18,0,75,57
1649923565241,CSE 175,A01,083665,Kumar; Rakesh,12,0,25,13
1649923571265,CSE 190,A00,092507,Dubnov; Shlomo,14,0,15,1
1649923577290,ECE 45,A01,083139,Staff,6,0,40,34
1649923583316,ECE 65,A50,083695,Staff,8,0,30,22
1649923589341,ECE 109,A01,091882,Touri; Behrouz,55,0,70,15
1649923595375,ECE 180,A00,083140,Abi Samra; Nicholas Camill,26,0,30,4
1649923595375,ECE 180,B00,083141,Abi Samra; Nicholas Camill,13,0,30,17
1649923601400,MATH 10A,A01,083735,Patchell; Gregory David,20,0,30,10
1649923601400,MATH 10A,A02,083736,Patchell; Gregory David,28,0,30,2
1649923601400,MATH 10A,A03,083737,Patchell; Gregory David,28,0,30,2
1649923607428,MATH 10B,A01,083207,Staff,10,0,30,20
1649923607428,MATH 10B,A02,083208,Staff,25,0,30,5
1649923607428,MATH 10B,B01,083739,Staff,25,0,30,5
1649923607428,MATH 10B,B02,083740,Staff,30,0,30,0
1649923613460,MATH 18,A01,083743,Staff,22,0,30,8
1649923613460,MATH 18,A02,083744,Staff,29,0,30,1
1649923613460,MATH 18,A03,083745,Staff,29,0,30,1
1649923613460,MATH 18,A04,083746,Staff,28,0,30,2
1649923613460,MATH 18,B01,083748,Staff,5,0,30,25
1649923613460,MATH 18,B02,083749,Staff,26,0,30,4
1649923613460,MATH 18,B03,083750,Staff,28,0,30,2
1649923613460,MATH 18,B04,083751,Staff,26,0,30,4
1649923619483,MATH 20A,A01,083754,Staff,37,0,40,3
1649923625513,MATH 20B,A01,083756,Staff,19,0,30,11
1649923625513,MATH 20B,A02,083757,Staff,30,0,30,0
1649923631538,MATH 20C,A01,083760,Staff,22,0,30,8
1649923631538,MATH 20C,A02,083761,Staff,23,0,30,7
1649923631538,MATH 20C,B01,083762,Staff,28,0,30,2
1649923631538,MATH 20C,B02,083763,Staff,30,0,30,0
1649923637563,MATH 20D,A01,083765,Staff,20,0,30,10
1649923637563,MATH 20D,A02,083766,Staff,30,0,30,0
1649923637563,MATH 20D,A03,083767,Staff,30,0,30,0
1649923643586,MATH 20E,A01,083771,Staff,12,0,30,18
1649923643586,MATH 20E,A02,083772,Staff,24,0,30,6
1649923643586,MATH 20E,B01,083773,Staff,18,0,30,12
1649923643586,MATH 20E,B02,083774,Staff,29,0,30,1
1649923649617,MATH 103A,A01,083777,Staff,1,4,30,29
1649923649617,MATH 103A,A02,083778,Staff,0,3,30,30
1649923649617,MATH 103A,B01,083779,Staff,0,0,30,30
1649923649617,MATH 103A,B02,083780,Staff,16,0,30,14
1649923655644,MATH 105,A01,085443,Staff,0,5,30,30
1649923661670,MATH 109,A01,083213,Anzaldo; Leesa B,14,0,30,16
1649923661670,MATH 109,A02,083214,Anzaldo; Leesa B,10,0,30,20
1649923661670,MATH 109,B01,083215,Anzaldo; Leesa B,26,0,30,4
1649923661670,MATH 109,B02,083216,Anzaldo; Leesa B,22,0,30,8
1649923667700,MATH 142A,A01,083219,Chow; Bennett,0,1,30,30
1649923667700,MATH 142A,A02,083220,Chow; Bennett,9,0,30,21
1649923667700,MATH 142A,B01,083221,Chow; Bennett,0,0,30,30
1649923667700,MATH 142A,B02,083222,Chow; Bennett,1,0,30,29
1649923673724,MATH 193A,A01,083224,Staff,0,3,30,30
1649923673724,MATH 193A,A02,083225,Staff,0,3,30,30
1649923673724,MATH 193A,A03,083781,Staff,4,0,30,26
1649923673724,MATH 193A,A04,083782,Staff,16,0,30,14
1649923679761,MATH 197,001,091859,McAuley; Julian John,9999,0,9999,0
1649923685825,COGS 9,A01,083615,Staff,16,0,60,44
1649923691849,COGS 11,A01,083617,Boyle; Mary E. T.,35,0,40,5
1649923697871,COGS 13,A01,083071,Staff,0,11,40,40
1649923703895,COGS 14A,A01,092681,Staff,65,0,100,35
1649923709919,COGS 14B,A01,083073,Cheng; Tzu-Han,24,0,50,26
1649923715946,COGS 17,A01,092677,Staff,63,0,75,12
1649923721970,COGS 100,A01,083619,Staff,0,5,60,60
1649923728003,COGS 101A,A01,083621,Davis; Joshua Daniel,0,8,60,60
1649923734026,COGS 101B,A01,091572,Staff,32,0,60,28
1649923740052,COGS 101C,A01,083625,Delgado; Tania,24,0,30,6
1649923746076,COGS 107A,A01,083627,Boyle; Mary E. T.,14,0,60,46
1649923752104,COGS 118A,A01,083075,Staff,21,0,60,39
1649923758128,CSE 3,A50,083646,Miranda; Gregory Joseph,24,0,38,14
1649923758128,CSE 3,A51,083647,Miranda; Gregory Joseph,37,0,37,0
1649923764161,CSE 8A,A50,083650,Miranda; Gregory Joseph,8,0,40,32
1649923770187,CSE 11,A01,083080,Cao; Yingjun,0,26,40,40
1649923776211,CSE 12,A01,083652,Staff,56,0,100,44
1649923782239,CSE 15L,A01,083654,Staff,19,0,50,31
1649923782239,CSE 15L,A02,083655,Staff,47,0,50,3
1649923788265,CSE 20,A01,083657,Staff,68,0,80,12
1649923794293,CSE 30,A01,083084,Eldon; John,0,24,40,40
1649923800328,CSE 100,A01,083659,Cao; Yingjun,1,27,50,49
1649923806352,CSE 134B,A01,083661,Powell; Thomas Allan,0,21,65,65
1649923812377,CSE 140,A01,083663,Staff,24,0,75,51
1649923818407,CSE 140L,A01,083088,Eldon; John,18,0,75,57
1649923824439,CSE 175,A01,083665,Kumar; Rakesh,12,0,25,13
1649923830465,CSE 190,A00,092507,Dubnov; Shlomo,14,0,15,1
1649923836490,ECE 45,A01,083139,Staff,6,0,40,34
1649923842515,ECE 65,A50,083695,Staff,8,0,30,22
1649923848618,ECE 109,A01,091882,Touri; Behrouz,55,0,70,15
1649923854643,ECE 180,A00,083140,Abi Samra; Nicholas Camill,26,0,30,4
1649923854643,ECE 180,B00,083141,Abi Samra; Nicholas Camill,13,0,30,17
1649923860673,MATH 10A,A01,083735,Patchell; Gregory David,20,0,30,10
1649923860673,MATH 10A,A02,083736,Patchell; Gregory David,28,0,30,2
1649923860673,MATH 10A,A03,083737,Patchell; Gregory David,28,0,30,2
1649923866699,MATH 10B,A01,083207,Staff,10,0,30,20
1649923866699,MATH 10B,A02,083208,Staff,25,0,30,5
1649923866699,MATH 10B,B01,083739,Staff,25,0,30,5
1649923866699,MATH 10B,B02,083740,Staff,30,0,30,0
1649923872731,MATH 18,A01,083743,Staff,22,0,30,8
1649923872731,MATH 18,A02,083744,Staff,29,0,30,1
1649923872731,MATH 18,A03,083745,Staff,29,0,30,1
1649923872731,MATH 18,A04,083746,Staff,28,0,30,2
1649923872731,MATH 18,B01,083748,Staff,5,0,30,25
1649923872731,MATH 18,B02,083749,Staff,26,0,30,4
1649923872731,MATH 18,B03,083750,Staff,28,0,30,2
1649923872731,MATH 18,B04,083751,Staff,26,0,30,4
1649923878758,MATH 20A,A01,083754,Staff,37,0,40,3
1649923884792,MATH 20B,A01,083756,Staff,19,0,30,11
1649923884792,MATH 20B,A02,083757,Staff,30,0,30,0
1649923890816,MATH 20C,A01,083760,Staff,22,0,30,8
1649923890816,MATH 20C,A02,083761,Staff,23,0,30,7
1649923890816,MATH 20C,B01,083762,Staff,28,0,30,2
1649923890816,MATH 20C,B02,083763,Staff,30,0,30,0
1649923896840,MATH 20D,A01,083765,Staff,20,0,30,10
1649923896840,MATH 20D,A02,083766,Staff,30,0,30,0
1649923896840,MATH 20D,A03,083767,Staff,30,0,30,0
1649923902879,MATH 20E,A01,083771,Staff,12,0,30,18
1649923902879,MATH 20E,A02,083772,Staff,24,0,30,6
1649923902879,MATH 20E,B01,083773,Staff,18,0,30,12
1649923902879,MATH 20E,B02,083774,Staff,29,0,30,1
1649923908910,MATH 103A,A01,083777,Staff,1,4,30,29
1649923908910,MATH 103A,A02,083778,Staff,0,3,30,30
1649923908910,MATH 103A,B01,083779,Staff,0,0,30,30
1649923908910,MATH 103A,B02,083780,Staff,16,0,30,14
1649923914936,MATH 105,A01,085443,Staff,0,5,30,30
1649923920974,MATH 109,A01,083213,Anzaldo; Leesa B,14,0,30,16
1649923920974,MATH 109,A02,083214,Anzaldo; Leesa B,10,0,30,20
1649923920974,MATH 109,B01,083215,Anzaldo; Leesa B,26,0,30,4
1649923920974,MATH 109,B02,083216,Anzaldo; Leesa B,22,0,30,8
1649923927008,MATH 142A,A01,083219,Chow; Bennett,0,1,30,30
1649923927008,MATH 142A,A02,083220,Chow; Bennett,9,0,30,21
1649923927008,MATH 142A,B01,083221,Chow; Bennett,0,0,30,30
1649923927008,MATH 142A,B02,083222,Chow; Bennett,1,0,30,29
1649923933033,MATH 193A,A01,083224,Staff,0,3,30,30
1649923933033,MATH 193A,A02,083225,Staff,0,3,30,30
1649923933033,MATH 193A,A03,083781,Staff,4,0,30,26
1649923933033,MATH 193A,A04,083782,Staff,16,0,30,14
1649923939058,MATH 197,001,091859,McAuley; Julian John,9999,0,9999,0
1649923945148,COGS 9,A01,083615,Staff,16,0,60,44
1649923951179,COGS 11,A01,083617,Boyle; Mary E. T.,35,0,40,5
1649923957203,COGS 13,A01,083071,Staff,0,11,40,40
1649923963227,COGS 14A,A01,092681,Staff,65,0,100,35
1649923969252,COGS 14B,A01,083073,Cheng; Tzu-Han,24,0,50,26
1649923975279,COGS 17,A01,092677,Staff,63,0,75,12
1649923981311,COGS 100,A01,083619,Staff,0,5,60,60
1649923987351,COGS 101A,A01,083621,Davis; Joshua Daniel,0,8,60,60
1649923993375,COGS 101B,A01,091572,Staff,32,0,60,28
1649923999400,COGS 101C,A01,083625,Delgado; Tania,24,0,30,6
1649924005425,COGS 107A,A01,083627,Boyle; Mary E. T.,14,0,60,46
1649924011451,COGS 118A,A01,083075,Staff,21,0,60,39
1649924017477,CSE 3,A50,083646,Miranda; Gregory Joseph,24,0,38,14
1649924017477,CSE 3,A51,083647,Miranda; Gregory Joseph,37,0,37,0
1649924023512,CSE 8A,A50,083650,Miranda; Gregory Joseph,8,0,40,32
1649924029539,CSE 11,A01,083080,Cao; Yingjun,0,26,40,40
1649924035566,CSE 12,A01,083652,Staff,56,0,100,44
1649924041591,CSE 15L,A01,083654,Staff,19,0,50,31
1649924041591,CSE 15L,A02,083655,Staff,47,0,50,3
1649924047619,CSE 20,A01,083657,Staff,68,0,80,12
1649924053642,CSE 30,A01,083084,Eldon; John,0,24,40,40
1649924059673,CSE 100,A01,083659,Cao; Yingjun,1,27,50,49
1649924065700,CSE 134B,A01,083661,Powell; Thomas Allan,0,21,65,65
1649924071727,CSE 140,A01,083663,Staff,24,0,75,51
1649924077751,CSE 140L,A01,083088,Eldon; John,18,0,75,57
1649924083776,CSE 175,A01,083665,Kumar; Rakesh,12,0,25,13
1649924089808,CSE 190,A00,092507,Dubnov; Shlomo,14,0,15,1
1649924095837,ECE 45,A01,083139,Staff,6,0,40,34
1649924101863,ECE 65,A50,083695,Staff,8,0,30,22
1649924107889,ECE 109,A01,091882,Touri; Behrouz,55,0,70,15
1649924113917,ECE 180,A00,083140,Abi Samra; Nicholas Camill,26,0,30,4
1649924113917,ECE 180,B00,083141,Abi Samra; Nicholas Camill,13,0,30,17
1649924119942,MATH 10A,A01,083735,Patchell; Gregory David,20,0,30,10
1649924119942,MATH 10A,A02,083736,Patchell; Gregory David,28,0,30,2
1649924119942,MATH 10A,A03,083737,Patchell; Gregory David,28,0,30,2
1649924125967,MATH 10B,A01,083207,Staff,10,0,30,20
1649924125967,MATH 10B,A02,083208,Staff,25,0,30,5
1649924125967,MATH 10B,B01,083739,Staff,25,0,30,5
1649924125967,MATH 10B,B02,083740,Staff,30,0,30,0
1649924131994,MATH 18,A01,083743,Staff,22,0,30,8
1649924131994,MATH 18,A02,083744,Staff,29,0,30,1
1649924131994,MATH 18,A03,083745,Staff,29,0,30,1
1649924131994,MATH 18,A04,083746,Staff,28,0,30,2
1649924131994,MATH 18,B01,083748,Staff,5,0,30,25
1649924131994,MATH 18,B02,083749,Staff,26,0,30,4
1649924131994,MATH 18,B03,083750,Staff,28,0,30,2
1649924131994,MATH 18,B04,083751,Staff,26,0,30,4
1649924138018,MATH 20A,A01,083754,Staff,37,0,40,3
1649924144043,MATH 20B,A01,083756,Staff,19,0,30,11
1649924144043,MATH 20B,A02,083757,Staff,30,0,30,0
1649924150073,MATH 20C,A01,083760,Staff,22,0,30,8
1649924150073,MATH 20C,A02,083761,Staff,23,0,30,7
1649924150073,MATH 20C,B01,083762,Staff,28,0,30,2
1649924150073,MATH 20C,B02,083763,Staff,30,0,30,0
1649924156101,MATH 20D,A01,083765,Staff,20,0,30,10
1649924156101,MATH 20D,A02,083766,Staff,30,0,30,0
1649924156101,MATH 20D,A03,083767,Staff,30,0,30,0
1649924162130,MATH 20E,A01,083771,Staff,12,0,30,18
1649924162130,MATH 20E,A02,083772,Staff,24,0,30,6
1649924162130,MATH 20E,B01,083773,Staff,18,0,30,12
1649924162130,MATH 20E,B02,083774,Staff,29,0,30,1
1649924168161,MATH 103A,A01,083777,Staff,1,4,30,29
1649924168161,MATH 103A,A02,083778,Staff,0,3,30,30
1649924168161,MATH 103A,B01,083779,Staff,0,0,30,30
1649924168161,MATH 103A,B02,083780,Staff,16,0,30,14
1649924174184,MATH 105,A01,085443,Staff,0,5,30,30
1649924180210,MATH 109,A01,083213,Anzaldo; Leesa B,14,0,30,16
1649924180210,MATH 109,A02,083214,Anzaldo; Leesa B,9,0,30,21
1649924180210,MATH 109,B01,083215,Anzaldo; Leesa B,26,0,30,4
1649924180210,MATH 109,B02,083216,Anzaldo; Leesa B,22,0,30,8
1649924186238,MATH 142A,A01,083219,Chow; Bennett,0,1,30,30
1649924186238,MATH 142A,A02,083220,Chow; Bennett,9,0,30,21
1649924186238,MATH 142A,B01,083221,Chow; Bennett,0,0,30,30
1649924186238,MATH 142A,B02,083222,Chow; Bennett,1,0,30,29
1649924192261,MATH 193A,A01,083224,Staff,0,3,30,30
1649924192261,MATH 193A,A02,083225,Staff,0,3,30,30
1649924192261,MATH 193A,A03,083781,Staff,4,0,30,26
1649924192261,MATH 193A,A04,083782,Staff,16,0,30,14
1649924198283,MATH 197,001,091859,McAuley; Julian John,9999,0,9999,0
1649924204365,COGS 9,A01,083615,Staff,16,0,60,44
1649924210388,COGS 11,A01,083617,Boyle; Mary E. T.,35,0,40,5
1649924216414,COGS 13,A01,083071,Staff,0,11,40,40
1649924222441,COGS 14A,A01,092681,Staff,65,0,100,35
1649924228473,COGS 14B,A01,083073,Cheng; Tzu-Han,24,0,50,26
1649924234501,COGS 17,A01,092677,Staff,63,0,75,12
1649924240529,COGS 100,A01,083619,Staff,0,5,60,60
1649924246553,COGS 101A,A01,083621,Davis; Joshua Daniel,0,8,60,60
1649924252581,COGS 101B,A01,091572,Staff,32,0,60,28
1649924258611,COGS 101C,A01,083625,Delgado; Tania,24,0,30,6
1649924264637,COGS 107A,A01,083627,Boyle; Mary E. T.,14,0,60,46
1649924270662,COGS 118A,A01,083075,Staff,21,0,60,39
1649924276689,CSE 3,A50,083646,Miranda; Gregory Joseph,24,0,38,14
1649924276689,CSE 3,A51,083647,Miranda; Gregory Joseph,37,0,37,0
1649924282716,CSE 8A,A50,083650,Miranda; Gregory Joseph,8,0,40,32
1649924288744,CSE 11,A01,083080,Cao; Yingjun,0,26,40,40
1649924294772,CSE 12,A01,083652,Staff,56,0,100,44
1649924300798,CSE 15L,A01,083654,Staff,19,0,50,31
1649924300798,CSE 15L,A02,083655,Staff,47,0,50,3
1649924306821,CSE 20,A01,083657,Staff,68,0,80,12
1649924312849,CSE 30,A01,083084,Eldon; John,0,24,40,40
1649924318874,CSE 100,A01,083659,Cao; Yingjun,1,27,50,49
1649924324907,CSE 134B,A01,083661,Powell; Thomas Allan,0,21,65,65
1649924330931,CSE 140,A01,083663,Staff,24,0,75,51
1649924336958,CSE 140L,A01,083088,Eldon; John,18,0,75,57
1649924342982,CSE 175,A01,083665,Kumar; Rakesh,12,0,25,13
1649924349007,CSE 190,A00,092507,Dubnov; Shlomo,14,0,15,1
1649924355031,ECE 45,A01,083139,Staff,6,0,40,34
1649924361054,ECE 65,A50,083695,Staff,8,0,30,22
1649924367095,ECE 109,A01,091882,Touri; Behrouz,55,0,70,15
1649924373120,ECE 180,A00,083140,Abi Samra; Nicholas Camill,26,0,30,4
1649924373120,ECE 180,B00,083141,Abi Samra; Nicholas Camill,13,0,30,17
1649924379154,MATH 10A,A01,083735,Patchell; Gregory David,20,0,30,10
1649924379154,MATH 10A,A02,083736,Patchell; Gregory David,28,0,30,2
1649924379154,MATH 10A,A03,083737,Patchell; Gregory David,28,0,30,2
1649924385181,MATH 10B,A01,083207,Staff,10,0,30,20
1649924385181,MATH 10B,A02,083208,Staff,25,0,30,5
1649924385181,MATH 10B,B01,083739,Staff,25,0,30,5
1649924385181,MATH 10B,B02,083740,Staff,30,0,30,0
1649924391208,MATH 18,A01,083743,Staff,22,0,30,8
1649924391208,MATH 18,A02,083744,Staff,29,0,30,1
1649924391208,MATH 18,A03,083745,Staff,29,0,30,1
1649924391208,MATH 18,A04,083746,Staff,28,0,30,2
1649924391208,MATH 18,B01,083748,Staff,5,0,30,25
1649924391208,MATH 18,B02,083749,Staff,26,0,30,4
1649924391208,MATH 18,B03,083750,Staff,28,0,30,2
1649924391208,MATH 18,B04,083751,Staff,26,0,30,4
1649924397232,MATH 20A,A01,083754,Staff,37,0,40,3
1649924403259,MATH 20B,A01,083756,Staff,19,0,30,11
1649924403259,MATH 20B,A02,083757,Staff,30,0,30,0
1649924409288,MATH 20C,A01,083760,Staff,22,0,30,8
1649924409288,MATH 20C,A02,083761,Staff,23,0,30,7
1649924409288,MATH 20C,B01,083762,Staff,28,0,30,2
1649924409288,MATH 20C,B02,083763,Staff,30,0,30,0
1649924415313,MATH 20D,A01,083765,Staff,20,0,30,10
1649924415313,MATH 20D,A02,083766,Staff,30,0,30,0
1649924415313,MATH 20D,A03,083767,Staff,30,0,30,0
1649924421336,MATH 20E,A01,083771,Staff,12,0,30,18
1649924421336,MATH 20E,A02,083772,Staff,24,0,30,6
1649924421336,MATH 20E,B01,083773,Staff,18,0,30,12
1649924421336,MATH 20E,B02,083774,Staff,29,0,30,1
1649924427359,MATH 103A,A01,083777,Staff,1,4,30,29
1649924427359,MATH 103A,A02,083778,Staff,0,3,30,30
1649924427359,MATH 103A,B01,083779,Staff,0,0,30,30
1649924427359,MATH 103A,B02,083780,Staff,16,0,30,14
1649924433383,MATH 105,A01,085443,Staff,0,5,30,30
1649924439408,MATH 109,A01,083213,Anzaldo; Leesa B,14,0,30,16
1649924439408,MATH 109,A02,083214,Anzaldo; Leesa B,9,0,30,21
1649924439408,MATH 109,B01,083215,Anzaldo; Leesa B,26,0,30,4
1649924439408,MATH 109,B02,083216,Anzaldo; Leesa B,22,0,30,8
1649924445505,MATH 142A,A01,083219,Chow; Bennett,0,1,30,30
1649924445505,MATH 142A,A02,083220,Chow; Bennett,9,0,30,21
1649924445505,MATH 142A,B01,083221,Chow; Bennett,0,0,30,30
1649924445505,MATH 142A,B02,083222,Chow; Bennett,1,0,30,29
1649924451529,MATH 193A,A01,083224,Staff,0,3,30,30
1649924451529,MATH 193A,A02,083225,Staff,0,3,30,30
1649924451529,MATH 193A,A03,083781,Staff,4,0,30,26
1649924451529,MATH 193A,A04,083782,Staff,16,0,30,14
1649924457557,MATH 197,001,091859,McAuley; Julian John,9999,0,9999,0
1649924463614,COGS 9,A01,083615,Staff,16,0,60,44
1649924469642,COGS 11,A01,083617,Boyle; Mary E. T.,35,0,40,5
1649924475668,COGS 13,A01,083071,Staff,0,11,40,40
1649924481692,COGS 14A,A01,092681,Staff,65,0,100,35
1649924487716,COGS 14B,A01,083073,Cheng; Tzu-Han,24,0,50,26
1649924493741,COGS 17,A01,092677,Staff,63,0,75,12
1649924499765,COGS 100,A01,083619,Staff,0,5,60,60
1649924505789,COGS 101A,A01,083621,Davis; Joshua Daniel,0,8,60,60
1649924511817,COGS 101B,A01,091572,Staff,32,0,60,28
1649924517840,COGS 101C,A01,083625,Delgado; Tania,24,0,30,6
1649924523864,COGS 107A,A01,083627,Boyle; Mary E. T.,14,0,60,46
1649924529891,COGS 118A,A01,083075,Staff,21,0,60,39
1649924535918,CSE 3,A50,083646,Miranda; Gregory Joseph,24,0,38,14
1649924535918,CSE 3,A51,083647,Miranda; Gregory Joseph,37,0,37,0
1649924541945,CSE 8A,A50,083650,Miranda; Gregory Joseph,8,0,40,32
1649924547977,CSE 11,A01,083080,Cao; Yingjun,0,26,40,40
1649924554003,CSE 12,A01,083652,Staff,56,0,100,44
1649924560027,CSE 15L,A01,083654,Staff,19,0,50,31
1649924560027,CSE 15L,A02,083655,Staff,47,0,50,3
1649924566052,CSE 20,A01,083657,Staff,68,0,80,12
1649924572076,CSE 30,A01,083084,Eldon; John,0,24,40,40
1649924578101,CSE 100,A01,083659,Cao; Yingjun,1,27,50,49
1649924584125,CSE 134B,A01,083661,Powell; Thomas Allan,0,21,65,65
1649924590153,CSE 140,A01,083663,Staff,24,0,75,51
1649924596175,CSE 140L,A01,083088,Eldon; John,18,0,75,57
1649924602199,CSE 175,A01,083665,Kumar; Rakesh,12,0,25,13
1649924608225,CSE 190,A00,092507,Dubnov; Shlomo,14,0,15,1
1649924614253,ECE 45,A01,083139,Staff,6,0,40,34
1649924620276,ECE 65,A50,083695,Staff,8,0,30,22
1649924626301,ECE 109,A01,091882,Touri; Behrouz,55,0,70,15
1649924632325,ECE 180,A00,083140,Abi Samra; Nicholas Camill,26,0,30,4
1649924632325,ECE 180,B00,083141,Abi Samra; Nicholas Camill,13,0,30,17
1649924638356,MATH 10A,A01,083735,Patchell; Gregory David,20,0,30,10
1649924638356,MATH 10A,A02,083736,Patchell; Gregory David,28,0,30,2
1649924638356,MATH 10A,A03,083737,Patchell; Gregory David,28,0,30,2
1649924644384,MATH 10B,A01,083207,Staff,10,0,30,20
1649924644384,MATH 10B,A02,083208,Staff,25,0,30,5
1649924644384,MATH 10B,B01,083739,Staff,25,0,30,5
1649924644384,MATH 10B,B02,083740,Staff,30,0,30,0
1649924650416,MATH 18,A01,083743,Staff,22,0,30,8
1649924650416,MATH 18,A02,083744,Staff,29,0,30,1
1649924650416,MATH 18,A03,083745,Staff,29,0,30,1
1649924650416,MATH 18,A04,083746,Staff,28,0,30,2
1649924650416,MATH 18,B01,083748,Staff,5,0,30,25
1649924650416,MATH 18,B02,083749,Staff,26,0,30,4
1649924650416,MATH 18,B03,083750,Staff,28,0,30,2
1649924650416,MATH 18,B04,083751,Staff,26,0,30,4
1649924656441,MATH 20A,A01,083754,Staff,37,0,40,3
1649924662465,MATH 20B,A01,083756,Staff,19,0,30,11
1649924662465,MATH 20B,A02,083757,Staff,30,0,30,0
1649924668491,MATH 20C,A01,083760,Staff,22,0,30,8
1649924668491,MATH 20C,A02,083761,Staff,23,0,30,7
1649924668491,MATH 20C,B01,083762,Staff,28,0,30,2
1649924668491,MATH 20C,B02,083763,Staff,30,0,30,0
1649924674517,MATH 20D,A01,083765,Staff,20,0,30,10
1649924674517,MATH 20D,A02,083766,Staff,30,0,30,0
1649924674517,MATH 20D,A03,083767,Staff,30,0,30,0
1649924680549,MATH 20E,A01,083771,Staff,12,0,30,18
1649924680549,MATH 20E,A02,083772,Staff,24,0,30,6
1649924680549,MATH 20E,B01,083773,Staff,18,0,30,12
1649924680549,MATH 20E,B02,083774,Staff,29,0,30,1
1649924686574,MATH 103A,A01,083777,Staff,1,4,30,29
1649924686574,MATH 103A,A02,083778,Staff,0,3,30,30
1649924686574,MATH 103A,B01,083779,Staff,0,0,30,30
1649924686574,MATH 103A,B02,083780,Staff,16,0,30,14
1649924692601,MATH 105,A01,085443,Staff,0,5,30,30
1649924698626,MATH 109,A01,083213,Anzaldo; Leesa B,14,0,30,16
1649924698626,MATH 109,A02,083214,Anzaldo; Leesa B,9,0,30,21
1649924698626,MATH 109,B01,083215,Anzaldo; Leesa B,26,0,30,4
1649924698626,MATH 109,B02,083216,Anzaldo; Leesa B,22,0,30,8
1649924704651,MATH 142A,A01,083219,Chow; Bennett,0,1,30,30
1649924704651,MATH 142A,A02,083220,Chow; Bennett,9,0,30,21
1649924704651,MATH 142A,B01,083221,Chow; Bennett,0,0,30,30
1649924704651,MATH 142A,B02,083222,Chow; Bennett,1,0,30,29
1649924710679,MATH 193A,A01,083224,Staff,0,3,30,30
1649924710679,MATH 193A,A02,083225,Staff,0,3,30,30
1649924710679,MATH 193A,A03,083781,Staff,4,0,30,26
1649924710679,MATH 193A,A04,083782,Staff,16,0,30,14
1649924716707,MATH 197,001,091859,McAuley; Julian John,9999,0,9999,0
1649924722775,COGS 9,A01,083615,Staff,16,0,60,44
1649924728804,COGS 11,A01,083617,Boyle; Mary E. T.,35,0,40,5
1649924734831,COGS 13,A01,083071,Staff,0,11,40,40
1649924740853,COGS 14A,A01,092681,Staff,65,0,100,35
1649924746876,COGS 14B,A01,083073,Cheng; Tzu-Han,24,0,50,26
1649924752908,COGS 17,A01,092677,Staff,63,0,75,12
1649924758931,COGS 100,A01,083619,Staff,0,5,60,60
1649924764955,COGS 101A,A01,083621,Davis; Joshua Daniel,0,8,60,60
1649924770979,COGS 101B,A01,091572,Staff,32,0,60,28
1649924777002,COGS 101C,A01,083625,Delgado; Tania,24,0,30,6
1649924783026,COGS 107A,A01,083627,Boyle; Mary E. T.,14,0,60,46
1649924789056,COGS 118A,A01,083075,Staff,21,0,60,39
1649924795082,CSE 3,A50,083646,Miranda; Gregory Joseph,24,0,38,14
1649924795082,CSE 3,A51,083647,Miranda; Gregory Joseph,37,0,37,0
1649924801106,CSE 8A,A50,083650,Miranda; Gregory Joseph,8,0,40,32
1649924807134,CSE 11,A01,083080,Cao; Yingjun,0,26,40,40
1649924813161,CSE 12,A01,083652,Staff,56,0,100,44
1649924819188,CSE 15L,A01,083654,Staff,19,0,50,31
1649924819188,CSE 15L,A02,083655,Staff,47,0,50,3
1649924825216,CSE 20,A01,083657,Staff,68,0,80,12
1649924831240,CSE 30,A01,083084,Eldon; John,0,24,40,40
1649924837263,CSE 100,A01,083659,Cao; Yingjun,1,27,50,49
1649924843286,CSE 134B,A01,083661,Powell; Thomas Allan,0,21,65,65
1649924849310,CSE 140,A01,083663,Staff,24,0,75,51
1649924855340,CSE 140L,A01,083088,Eldon; John,18,0,75,57
1649924861366,CSE 175,A01,083665,Kumar; Rakesh,12,0,25,13
1649924867394,CSE 190,A00,092507,Dubnov; Shlomo,14,0,15,1
1649924873420,ECE 45,A01,083139,Staff,6,0,40,34
1649924879444,ECE 65,A50,083695,Staff,8,0,30,22
1649924885471,ECE 109,A01,091882,Touri; Behrouz,55,0,70,15
1649924891496,ECE 180,A00,083140,Abi Samra; Nicholas Camill,26,0,30,4
1649924891496,ECE 180,B00,083141,Abi Samra; Nicholas Camill,13,0,30,17
1649924897524,MATH 10A,A01,083735,Patchell; Gregory David,20,0,30,10
1649924897524,MATH 10A,A02,083736,Patchell; Gregory David,28,0,30,2
1649924897524,MATH 10A,A03,083737,Patchell; Gregory David,28,0,30,2
1649924903549,MATH 10B,A01,083207,Staff,10,0,30,20
1649924903549,MATH 10B,A02,083208,Staff,25,0,30,5
1649924903549,MATH 10B,B01,083739,Staff,25,0,30,5
1649924903549,MATH 10B,B02,083740,Staff,30,0,30,0
1649924909577,MATH 18,A01,083743,Staff,22,0,30,8
1649924909577,MATH 18,A02,083744,Staff,29,0,30,1
1649924909577,MATH 18,A03,083745,Staff,29,0,30,1
1649924909577,MATH 18,A04,083746,Staff,28,0,30,2
1649924909577,MATH 18,B01,083748,Staff,5,0,30,25
1649924909577,MATH 18,B02,083749,Staff,26,0,30,4
1649924909577,MATH 18,B03,083750,Staff,28,0,30,2
1649924909577,MATH 18,B04,083751,Staff,26,0,30,4
1649924915604,MATH 20A,A01,083754,Staff,37,0,40,3
1649924921632,MATH 20B,A01,083756,Staff,19,0,30,11
1649924921632,MATH 20B,A02,083757,Staff,30,0,30,0
1649924927660,MATH 20C,A01,083760,Staff,22,0,30,8
1649924927660,MATH 20C,A02,083761,Staff,23,0,30,7
1649924927660,MATH 20C,B01,083762,Staff,28,0,30,2
1649924927660,MATH 20C,B02,083763,Staff,30,0,30,0
1649924933686,MATH 20D,A01,083765,Staff,20,0,30,10
1649924933686,MATH 20D,A02,083766,Staff,30,0,30,0
1649924933686,MATH 20D,A03,083767,Staff,30,0,30,0
1649924939713,MATH 20E,A01,083771,Staff,12,0,30,18
1649924939713,MATH 20E,A02,083772,Staff,24,0,30,6
1649924939713,MATH 20E,B01,083773,Staff,18,0,30,12
1649924939713,MATH 20E,B02,083774,Staff,29,0,30,1
1649924956533,MATH 103A,A01,083777,Staff,1,4,30,29
1649924956533,MATH 103A,A02,083778,Staff,0,3,30,30
1649924956533,MATH 103A,B01,083779,Staff,0,0,30,30
1649924956533,MATH 103A,B02,083780,Staff,16,0,30,14
1649924962560,MATH 105,A01,085443,Staff,0,5,30,30
1649924968587,MATH 109,A01,083213,Anzaldo; Leesa B,14,0,30,16
1649924968587,MATH 109,A02,083214,Anzaldo; Leesa B,9,0,30,21
1649924968587,MATH 109,B01,083215,Anzaldo; Leesa B,26,0,30,4
1649924968587,MATH 109,B02,083216,Anzaldo; Leesa B,22,0,30,8
1649924974610,MATH 142A,A01,083219,Chow; Bennett,0,1,30,30
1649924974610,MATH 142A,A02,083220,Chow; Bennett,9,0,30,21
1649924974610,MATH 142A,B01,083221,Chow; Bennett,0,0,30,30
1649924974610,MATH 142A,B02,083222,Chow; Bennett,1,0,30,29
1649924980634,MATH 193A,A01,083224,Staff,0,3,30,30
1649924980634,MATH 193A,A02,083225,Staff,0,3,30,30
1649924980634,MATH 193A,A03,083781,Staff,4,0,30,26
1649924980634,MATH 193A,A04,083782,Staff,16,0,30,14
1649924986666,MATH 197,001,091859,McAuley; Julian John,9999,0,9999,0
1649924992728,COGS 9,A01,083615,Staff,16,0,60,44
1649924998757,COGS 11,A01,083617,Boyle; Mary E. T.,35,0,40,5
1649925004781,COGS 13,A01,083071,Staff,0,11,40,40
1649925010808,COGS 14A,A01,092681,Staff,65,0,100,35
1649925016837,COGS 14B,A01,083073,Cheng; Tzu-Han,24,0,50,26
1649925022860,COGS 17,A01,092677,Staff,63,0,75,12
1649925028885,COGS 100,A01,083619,Staff,0,5,60,60
1649925034913,COGS 101A,A01,083621,Davis; Joshua Daniel,0,8,60,60
1649925040949,COGS 101B,A01,091572,Staff,32,0,60,28
1649925047047,COGS 101C,A01,083625,Delgado; Tania,24,0,30,6
1649925053070,COGS 107A,A01,083627,Boyle; Mary E. T.,14,0,60,46
1649925059097,COGS 118A,A01,083075,Staff,21,0,60,39
1649925065120,CSE 3,A50,083646,Miranda; Gregory Joseph,24,0,38,14
1649925065120,CSE 3,A51,083647,Miranda; Gregory Joseph,37,0,37,0
1649925071145,CSE 8A,A50,083650,Miranda; Gregory Joseph,8,0,40,32
1649925077167,CSE 11,A01,083080,Cao; Yingjun,0,26,40,40
1649925083191,CSE 12,A01,083652,Staff,56,0,100,44
1649925089215,CSE 15L,A01,083654,Staff,19,0,50,31
1649925089215,CSE 15L,A02,083655,Staff,47,0,50,3
1649925095237,CSE 20,A01,083657,Staff,68,0,80,12
1649925101264,CSE 30,A01,083084,Eldon; John,0,24,40,40
1649925107287,CSE 100,A01,083659,Cao; Yingjun,1,27,50,49
1649925113314,CSE 134B,A01,083661,Powell; Thomas Allan,0,21,65,65
1649925119340,CSE 140,A01,083663,Staff,24,0,75,51
1649925125366,CSE 140L,A01,083088,Eldon; John,18,0,75,57
1649925131390,CSE 175,A01,083665,Kumar; Rakesh,12,0,25,13
1649925137414,CSE 190,A00,092507,Dubnov; Shlomo,14,0,15,1
1649925143441,ECE 45,A01,083139,Staff,6,0,40,34
1649925149467,ECE 65,A50,083695,Staff,8,0,30,22
1649925155491,ECE 109,A01,091882,Touri; Behrouz,55,0,70,15
1649925161517,ECE 180,A00,083140,Abi Samra; Nicholas Camill,26,0,30,4
1649925161517,ECE 180,B00,083141,Abi Samra; Nicholas Camill,13,0,30,17
1649925167541,MATH 10A,A01,083735,Patchell; Gregory David,20,0,30,10
1649925167541,MATH 10A,A02,083736,Patchell; Gregory David,28,0,30,2
1649925167541,MATH 10A,A03,083737,Patchell; Gregory David,28,0,30,2
1649925173564,MATH 10B,A01,083207,Staff,10,0,30,20
1649925173564,MATH 10B,A02,083208,Staff,25,0,30,5
1649925173564,MATH 10B,B01,083739,Staff,25,0,30,5
1649925173564,MATH 10B,B02,083740,Staff,30,0,30,0
1649925179591,MATH 18,A01,083743,Staff,22,0,30,8
1649925179591,MATH 18,A02,083744,Staff,29,0,30,1
1649925179591,MATH 18,A03,083745,Staff,29,0,30,1
1649925179591,MATH 18,A04,083746,Staff,28,0,30,2
1649925179591,MATH 18,B01,083748,Staff,5,0,30,25
1649925179591,MATH 18,B02,083749,Staff,26,0,30,4
1649925179591,MATH 18,B03,083750,Staff,28,0,30,2
1649925179591,MATH 18,B04,083751,Staff,26,0,30,4
1649925185618,MATH 20A,A01,083754,Staff,37,0,40,3
1649925191646,MATH 20B,A01,083756,Staff,19,0,30,11
1649925191646,MATH 20B,A02,083757,Staff,30,0,30,0
1649925197672,MATH 20C,A01,083760,Staff,22,0,30,8
1649925197672,MATH 20C,A02,083761,Staff,23,0,30,7
1649925197672,MATH 20C,B01,083762,Staff,28,0,30,2
1649925197672,MATH 20C,B02,083763,Staff,30,0,30,0
1649925203697,MATH 20D,A01,083765,Staff,20,0,30,10
1649925203697,MATH 20D,A02,083766,Staff,30,0,30,0
1649925203697,MATH 20D,A03,083767,Staff,30,0,30,0
1649925209725,MATH 20E,A01,083771,Staff,12,0,30,18
1649925209725,MATH 20E,A02,083772,Staff,24,0,30,6
1649925209725,MATH 20E,B01,083773,Staff,18,0,30,12
1649925209725,MATH 20E,B02,083774,Staff,29,0,30,1
1649925215753,MATH 103A,A01,083777,Staff,1,4,30,29
1649925215753,MATH 103A,A02,083778,Staff,0,3,30,30
1649925215753,MATH 103A,B01,083779,Staff,0,0,30,30
1649925215753,MATH 103A,B02,083780,Staff,16,0,30,14
1649925221776,MATH 105,A01,085443,Staff,0,5,30,30
1649925227801,MATH 109,A01,083213,Anzaldo; Leesa B,14,0,30,16
1649925227801,MATH 109,A02,083214,Anzaldo; Leesa B,9,0,30,21
1649925227801,MATH 109,B01,083215,Anzaldo; Leesa B,26,0,30,4
1649925227801,MATH 109,B02,083216,Anzaldo; Leesa B,22,0,30,8
1649925233826,MATH 142A,A01,083219,Chow; Bennett,0,1,30,30
1649925233826,MATH 142A,A02,083220,Chow; Bennett,9,0,30,21
1649925233826,MATH 142A,B01,083221,Chow; Bennett,0,0,30,30
1649925233826,MATH 142A,B02,083222,Chow; Bennett,1,0,30,29
1649925239851,MATH 193A,A01,083224,Staff,0,3,30,30
1649925239851,MATH 193A,A02,083225,Staff,0,3,30,30
1649925239851,MATH 193A,A03,083781,Staff,4,0,30,26
1649925239851,MATH 193A,A04,083782,Staff,16,0,30,14
1649925245879,MATH 197,001,091859,McAuley; Julian John,9999,0,9999,0
1649925251936,COGS 9,A01,083615,Staff,16,0,60,44
1649925257960,COGS 11,A01,083617,Boyle; Mary E. T.,35,0,40,5
1649925263984,COGS 13,A01,083071,Staff,0,11,40,40
1649925270011,COGS 14A,A01,092681,Staff,65,0,100,35
1649925276037,COGS 14B,A01,083073,Cheng; Tzu-Han,24,0,50,26
1649925282062,COGS 17,A01,092677,Staff,63,0,75,12
1649925288090,COGS 100,A01,083619,Staff,0,5,60,60
1649925294115,COGS 101A,A01,083621,Davis; Joshua Daniel,0,8,60,60
1649925300141,COGS 101B,A01,091572,Staff,32,0,60,28
1649925306166,COGS 101C,A01,083625,Delgado; Tania,24,0,30,6
1649925312195,COGS 107A,A01,083627,Boyle; Mary E. T.,14,0,60,46
1649925318223,COGS 118A,A01,083075,Staff,21,0,60,39
1649925324250,CSE 3,A50,083646,Miranda; Gregory Joseph,24,0,38,14
1649925324250,CSE 3,A51,083647,Miranda; Gregory Joseph,37,0,37,0
1649925330275,CSE 8A,A50,083650,Miranda; Gregory Joseph,8,0,40,32
1649925336300,CSE 11,A01,083080,Cao; Yingjun,0,26,40,40
1649925342323,CSE 12,A01,083652,Staff,56,0,100,44
1649925348348,CSE 15L,A01,083654,Staff,19,0,50,31
1649925348348,CSE 15L,A02,083655,Staff,47,0,50,3
1649925354377,CSE 20,A01,083657,Staff,68,0,80,12
1649925360403,CSE 30,A01,083084,Eldon; John,0,24,40,40
1649925366427,CSE 100,A01,083659,Cao; Yingjun,1,27,50,49
1649925372450,CSE 134B,A01,083661,Powell; Thomas Allan,0,21,65,65
1649925378473,CSE 140,A01,083663,Staff,24,0,75,51
1649925384497,CSE 140L,A01,083088,Eldon; John,18,0,75,57
1649925390525,CSE 175,A01,083665,Kumar; Rakesh,12,0,25,13
1649925396549,CSE 190,A00,092507,Dubnov; Shlomo,14,0,15,1
1649925402575,ECE 45,A01,083139,Staff,6,0,40,34
1649925408600,ECE 65,A50,083695,Staff,8,0,30,22
1649925414629,ECE 109,A01,091882,Touri; Behrouz,55,0,70,15
1649925420654,ECE 180,A00,083140,Abi Samra; Nicholas Camill,26,0,30,4
1649925420654,ECE 180,B00,083141,Abi Samra; Nicholas Camill,13,0,30,17
1649925426684,MATH 10A,A01,083735,Patchell; Gregory David,20,0,30,10
1649925426684,MATH 10A,A02,083736,Patchell; Gregory David,28,0,30,2
1649925426684,MATH 10A,A03,083737,Patchell; Gregory David,28,0,30,2
1649925432709,MATH 10B,A01,083207,Staff,10,0,30,20
1649925432709,MATH 10B,A02,083208,Staff,25,0,30,5
1649925432709,MATH 10B,B01,083739,Staff,25,0,30,5
1649925432709,MATH 10B,B02,083740,Staff,30,0,30,0
1649925438736,MATH 18,A01,083743,Staff,22,0,30,8
1649925438736,MATH 18,A02,083744,Staff,29,0,30,1
1649925438736,MATH 18,A03,083745,Staff,29,0,30,1
1649925438736,MATH 18,A04,083746,Staff,28,0,30,2
1649925438736,MATH 18,B01,083748,Staff,5,0,30,25
1649925438736,MATH 18,B02,083749,Staff,26,0,30,4
1649925438736,MATH 18,B03,083750,Staff,28,0,30,2
1649925438736,MATH 18,B04,083751,Staff,26,0,30,4
1649925444760,MATH 20A,A01,083754,Staff,37,0,40,3
1649925450784,MATH 20B,A01,083756,Staff,19,0,30,11
1649925450784,MATH 20B,A02,083757,Staff,30,0,30,0
1649925456811,MATH 20C,A01,083760,Staff,22,0,30,8
1649925456811,MATH 20C,A02,083761,Staff,23,0,30,7
1649925456811,MATH 20C,B01,083762,Staff,28,0,30,2
1649925456811,MATH 20C,B02,083763,Staff,30,0,30,0
1649925462837,MATH 20D,A01,083765,Staff,20,0,30,10
1649925462837,MATH 20D,A02,083766,Staff,30,0,30,0
1649925462837,MATH 20D,A03,083767,Staff,30,0,30,0
1649925468862,MATH 20E,A01,083771,Staff,12,0,30,18
1649925468862,MATH 20E,A02,083772,Staff,24,0,30,6
1649925468862,MATH 20E,B01,083773,Staff,18,0,30,12
1649925468862,MATH 20E,B02,083774,Staff,29,0,30,1
1649925474886,MATH 103A,A01,083777,Staff,1,4,30,29
1649925474886,MATH 103A,A02,083778,Staff,0,3,30,30
1649925474886,MATH 103A,B01,083779,Staff,0,0,30,30
1649925474886,MATH 103A,B02,083780,Staff,16,0,30,14
1649925480911,MATH 105,A01,085443,Staff,0,5,30,30
1649925486947,MATH 109,A01,083213,Anzaldo; Leesa B,14,0,30,16
1649925486947,MATH 109,A02,083214,Anzaldo; Leesa B,9,0,30,21
1649925486947,MATH 109,B01,083215,Anzaldo; Leesa B,26,0,30,4
1649925486947,MATH 109,B02,083216,Anzaldo; Leesa B,22,0,30,8
1649925492971,MATH 142A,A01,083219,Chow; Bennett,0,1,30,30
1649925492971,MATH 142A,A02,083220,Chow; Bennett,9,0,30,21
1649925492971,MATH 142A,B01,083221,Chow; Bennett,0,0,30,30
1649925492971,MATH 142A,B02,083222,Chow; Bennett,1,0,30,29
1649925498996,MATH 193A,A01,083224,Staff,0,3,30,30
1649925498996,MATH 193A,A02,083225,Staff,0,3,30,30
1649925498996,MATH 193A,A03,083781,Staff,4,0,30,26
1649925498996,MATH 193A,A04,083782,Staff,16,0,30,14
1649925505032,MATH 197,001,091859,McAuley; Julian John,9999,0,9999,0
1649925511086,COGS 9,A01,083615,Staff,16,0,60,44
1649925517112,COGS 11,A01,083617,Boyle; Mary E. T.,35,0,40,5
1649925523137,COGS 13,A01,083071,Staff,0,11,40,40
1649925529161,COGS 14A,A01,092681,Staff,65,0,100,35
1649925535189,COGS 14B,A01,083073,Cheng; Tzu-Han,24,0,50,26
1649925541216,COGS 17,A01,092677,Staff,63,0,75,12
1649925547241,COGS 100,A01,083619,Staff,0,5,60,60
1649925553270,COGS 101A,A01,083621,Davis; Joshua Daniel,0,8,60,60
1649925559299,COGS 101B,A01,091572,Staff,32,0,60,28
1649925565325,COGS 101C,A01,083625,Delgado; Tania,24,0,30,6
1649925571349,COGS 107A,A01,083627,Boyle; Mary E. T.,14,0,60,46
1649925577378,COGS 118A,A01,083075,Staff,21,0,60,39
1649925583407,CSE 3,A50,083646,Miranda; Gregory Joseph,24,0,38,14
1649925583407,CSE 3,A51,083647,Miranda; Gregory Joseph,37,0,37,0
1649925589437,CSE 8A,A50,083650,Miranda; Gregory Joseph,8,0,40,32
1649925595461,CSE 11,A01,083080,Cao; Yingjun,0,26,40,40
1649925601490,CSE 12,A01,083652,Staff,56,0,100,44
1649925607515,CSE 15L,A01,083654,Staff,19,0,50,31
1649925607515,CSE 15L,A02,083655,Staff,47,0,50,3
1649925613539,CSE 20,A01,083657,Staff,68,0,80,12
1649925619564,CSE 30,A01,083084,Eldon; John,0,24,40,40
1649925625592,CSE 100,A01,083659,Cao; Yingjun,1,27,50,49
1649925631622,CSE 134B,A01,083661,Powell; Thomas Allan,0,21,65,65
1649925637646,CSE 140,A01,083663,Staff,24,0,75,51
1649925643746,CSE 140L,A01,083088,Eldon; John,18,0,75,57
1649925649774,CSE 175,A01,083665,Kumar; Rakesh,12,0,25,13
1649925655799,CSE 190,A00,092507,Dubnov; Shlomo,14,0,15,1
1649925661827,ECE 45,A01,083139,Staff,6,0,40,34
1649925667865,ECE 65,A50,083695,Staff,8,0,30,22
1649925673889,ECE 109,A01,091882,Touri; Behrouz,55,0,70,15
1649925679917,ECE 180,A00,083140,Abi Samra; Nicholas Camill,26,0,30,4
1649925679917,ECE 180,B00,083141,Abi Samra; Nicholas Camill,13,0,30,17
1649925685945,MATH 10A,A01,083735,Patchell; Gregory David,20,0,30,10
1649925685945,MATH 10A,A02,083736,Patchell; Gregory David,28,0,30,2
1649925685945,MATH 10A,A03,083737,Patchell; Gregory David,28,0,30,2
1649925691973,MATH 10B,A01,083207,Staff,10,0,30,20
1649925691973,MATH 10B,A02,083208,Staff,25,0,30,5
1649925691973,MATH 10B,B01,083739,Staff,25,0,30,5
1649925691973,MATH 10B,B02,083740,Staff,30,0,30,0
1649925698001,MATH 18,A01,083743,Staff,22,0,30,8
1649925698001,MATH 18,A02,083744,Staff,29,0,30,1
1649925698001,MATH 18,A03,083745,Staff,29,0,30,1
1649925698001,MATH 18,A04,083746,Staff,28,0,30,2
1649925698001,MATH 18,B01,083748,Staff,5,0,30,25
1649925698001,MATH 18,B02,083749,Staff,26,0,30,4
1649925698001,MATH 18,B03,083750,Staff,28,0,30,2
1649925698001,MATH 18,B04,083751,Staff,26,0,30,4
1649925704029,MATH 20A,A01,083754,Staff,37,0,40,3
1649925710054,MATH 20B,A01,083756,Staff,19,0,30,11
1649925710054,MATH 20B,A02,083757,Staff,30,0,30,0
1649925716086,MATH 20C,A01,083760,Staff,22,0,30,8
1649925716086,MATH 20C,A02,083761,Staff,23,0,30,7
1649925716086,MATH 20C,B01,083762,Staff,28,0,30,2
1649925716086,MATH 20C,B02,083763,Staff,30,0,30,0
1649925722108,MATH 20D,A01,083765,Staff,20,0,30,10
1649925722108,MATH 20D,A02,083766,Staff,30,0,30,0
1649925722108,MATH 20D,A03,083767,Staff,30,0,30,0
1649925728139,MATH 20E,A01,083771,Staff,12,0,30,18
1649925728139,MATH 20E,A02,083772,Staff,24,0,30,6
1649925728139,MATH 20E,B01,083773,Staff,18,0,30,12
1649925728139,MATH 20E,B02,083774,Staff,29,0,30,1
1649925734163,MATH 103A,A01,083777,Staff,1,4,30,29
1649925734163,MATH 103A,A02,083778,Staff,0,3,30,30
1649925734163,MATH 103A,B01,083779,Staff,0,0,30,30
1649925734163,MATH 103A,B02,083780,Staff,16,0,30,14
1649925740190,MATH 105,A01,085443,Staff,0,5,30,30
1649925746222,MATH 109,A01,083213,Anzaldo; Leesa B,14,0,30,16
1649925746222,MATH 109,A02,083214,Anzaldo; Leesa B,9,0,30,21
1649925746222,MATH 109,B01,083215,Anzaldo; Leesa B,26,0,30,4
1649925746222,MATH 109,B02,083216,Anzaldo; Leesa B,22,0,30,8
1649925752246,MATH 142A,A01,083219,Chow; Bennett,0,1,30,30
1649925752246,MATH 142A,A02,083220,Chow; Bennett,9,0,30,21
1649925752246,MATH 142A,B01,083221,Chow; Bennett,0,0,30,30
1649925752246,MATH 142A,B02,083222,Chow; Bennett,1,0,30,29
1649925758271,MATH 193A,A01,083224,Staff,0,3,30,30
1649925758271,MATH 193A,A02,083225,Staff,0,3,30,30
1649925758271,MATH 193A,A03,083781,Staff,4,0,30,26
1649925758271,MATH 193A,A04,083782,Staff,16,0,30,14
1649925764294,MATH 197,001,091859,McAuley; Julian John,9999,0,9999,0
1649925770354,COGS 9,A01,083615,Staff,16,0,60,44
1649925776378,COGS 11,A01,083617,Boyle; Mary E. T.,35,0,40,5
1649925782402,COGS 13,A01,083071,Staff,0,11,40,40
1649925788430,COGS 14A,A01,092681,Staff,65,0,100,35
1649925794459,COGS 14B,A01,083073,Cheng; Tzu-Han,24,0,50,26
1649925800484,COGS 17,A01,092677,Staff,63,0,75,12
1649925806510,COGS 100,A01,083619,Staff,0,5,60,60
1649925812537,COGS 101A,A01,083621,Davis; Joshua Daniel,0,8,60,60
1649925818563,COGS 101B,A01,091572,Staff,32,0,60,28
1649925824593,COGS 101C,A01,083625,Delgado; Tania,24,0,30,6
1649925830620,COGS 107A,A01,083627,Boyle; Mary E. T.,14,0,60,46
1649925836645,COGS 118A,A01,083075,Staff,21,0,60,39
1649925842668,CSE 3,A50,083646,Miranda; Gregory Joseph,24,0,38,14
1649925842668,CSE 3,A51,083647,Miranda; Gregory Joseph,37,0,37,0
1649925848697,CSE 8A,A50,083650,Miranda; Gregory Joseph,8,0,40,32
1649925854722,CSE 11,A01,083080,Cao; Yingjun,0,26,40,40
1649925860751,CSE 12,A01,083652,Staff,56,0,100,44
1649925866774,CSE 15L,A01,083654,Staff,19,0,50,31
1649925866774,CSE 15L,A02,083655,Staff,47,0,50,3
1649925872797,CSE 20,A01,083657,Staff,68,0,80,12
1649925878821,CSE 30,A01,083084,Eldon; John,0,24,40,40
1649925884846,CSE 100,A01,083659,Cao; Yingjun,1,27,50,49
1649925890870,CSE 134B,A01,083661,Powell; Thomas Allan,0,21,65,65
1649925896897,CSE 140,A01,083663,Staff,24,0,75,51
1649925902919,CSE 140L,A01,083088,Eldon; John,18,0,75,57
1649925908944,CSE 175,A01,083665,Kumar; Rakesh,12,0,25,13
1649925914971,CSE 190,A00,092507,Dubnov; Shlomo,14,0,15,1
1649925921003,ECE 45,A01,083139,Staff,6,0,40,34
1649925927042,ECE 65,A50,083695,Staff,8,0,30,22
1649925933067,ECE 109,A01,091882,Touri; Behrouz,55,0,70,15
1649925939092,ECE 180,A00,083140,Abi Samra; Nicholas Camill,26,0,30,4
1649925939092,ECE 180,B00,083141,Abi Samra; Nicholas Camill,13,0,30,17
1649925945123,MATH 10A,A01,083735,Patchell; Gregory David,20,0,30,10
1649925945123,MATH 10A,A02,083736,Patchell; Gregory David,28,0,30,2
1649925945123,MATH 10A,A03,083737,Patchell; Gregory David,28,0,30,2
1649925951147,MATH 10B,A01,083207,Staff,10,0,30,20
1649925951147,MATH 10B,A02,083208,Staff,25,0,30,5
1649925951147,MATH 10B,B01,083739,Staff,25,0,30,5
1649925951147,MATH 10B,B02,083740,Staff,30,0,30,0
1649925957177,MATH 18,A01,083743,Staff,22,0,30,8
1649925957177,MATH 18,A02,083744,Staff,29,0,30,1
1649925957177,MATH 18,A03,083745,Staff,29,0,30,1
1649925957177,MATH 18,A04,083746,Staff,28,0,30,2
1649925957177,MATH 18,B01,083748,Staff,5,0,30,25
1649925957177,MATH 18,B02,083749,Staff,26,0,30,4
1649925957177,MATH 18,B03,083750,Staff,28,0,30,2
1649925957177,MATH 18,B04,083751,Staff,26,0,30,4
1649925963203,MATH 20A,A01,083754,Staff,37,0,40,3
1649925969230,MATH 20B,A01,083756,Staff,19,0,30,11
1649925969230,MATH 20B,A02,083757,Staff,30,0,30,0
1649925975259,MATH 20C,A01,083760,Staff,22,0,30,8
1649925975259,MATH 20C,A02,083761,Staff,23,0,30,7
1649925975259,MATH 20C,B01,083762,Staff,28,0,30,2
1649925975259,MATH 20C,B02,083763,Staff,30,0,30,0
1649925981286,MATH 20D,A01,083765,Staff,20,0,30,10
1649925981286,MATH 20D,A02,083766,Staff,30,0,30,0
1649925981286,MATH 20D,A03,083767,Staff,30,0,30,0
1649925987314,MATH 20E,A01,083771,Staff,12,0,30,18
1649925987314,MATH 20E,A02,083772,Staff,24,0,30,6
1649925987314,MATH 20E,B01,083773,Staff,17,0,30,13
1649925987314,MATH 20E,B02,083774,Staff,29,0,30,1
1649925993345,MATH 103A,A01,083777,Staff,1,4,30,29
1649925993345,MATH 103A,A02,083778,Staff,0,3,30,30
1649925993345,MATH 103A,B01,083779,Staff,0,0,30,30
1649925993345,MATH 103A,B02,083780,Staff,16,0,30,14
1649925999383,MATH 105,A01,085443,Staff,0,5,30,30
1649926005413,MATH 109,A01,083213,Anzaldo; Leesa B,14,0,30,16
1649926005413,MATH 109,A02,083214,Anzaldo; Leesa B,9,0,30,21
1649926005413,MATH 109,B01,083215,Anzaldo; Leesa B,26,0,30,4
1649926005413,MATH 109,B02,083216,Anzaldo; Leesa B,22,0,30,8
1649926011438,MATH 142A,A01,083219,Chow; Bennett,0,1,30,30
1649926011438,MATH 142A,A02,083220,Chow; Bennett,9,0,30,21
1649926011438,MATH 142A,B01,083221,Chow; Bennett,0,0,30,30
1649926011438,MATH 142A,B02,083222,Chow; Bennett,1,0,30,29
1649926017463,MATH 193A,A01,083224,Staff,0,3,30,30
1649926017463,MATH 193A,A02,083225,Staff,0,3,30,30
1649926017463,MATH 193A,A03,083781,Staff,4,0,30,26
1649926017463,MATH 193A,A04,083782,Staff,16,0,30,14
1649926023492,MATH 197,001,091859,McAuley; Julian John,9999,0,9999,0
1649926029549,COGS 9,A01,083615,Staff,16,0,60,44
1649926035585,COGS 11,A01,083617,Boyle; Mary E. T.,35,0,40,5
1649926041624,COGS 13,A01,083071,Staff,0,11,40,40
1649926047648,COGS 14A,A01,092681,Staff,65,0,100,35
1649926053676,COGS 14B,A01,083073,Cheng; Tzu-Han,24,0,50,26
1649926059716,COGS 17,A01,092677,Staff,63,0,75,12
1649926065746,COGS 100,A01,083619,Staff,0,5,60,60
1649926071770,COGS 101A,A01,083621,Davis; Joshua Daniel,0,8,60,60
1649926077794,COGS 101B,A01,091572,Staff,32,0,60,28
1649926083830,COGS 101C,A01,083625,Delgado; Tania,24,0,30,6
1649926089866,COGS 107A,A01,083627,Boyle; Mary E. T.,13,0,60,47
1649926095889,COGS 118A,A01,083075,Staff,21,0,60,39
1649926101918,CSE 3,A50,083646,Miranda; Gregory Joseph,24,0,38,14
1649926101918,CSE 3,A51,083647,Miranda; Gregory Joseph,37,0,37,0
1649926107944,CSE 8A,A50,083650,Miranda; Gregory Joseph,8,0,40,32
1649926113968,CSE 11,A01,083080,Cao; Yingjun,0,26,40,40
1649926120006,CSE 12,A01,083652,Staff,56,0,100,44
1649926126034,CSE 15L,A01,083654,Staff,19,0,50,31
1649926126034,CSE 15L,A02,083655,Staff,47,0,50,3
1649926132058,CSE 20,A01,083657,Staff,68,0,80,12
1649926138086,CSE 30,A01,083084,Eldon; John,0,24,40,40
1649926144114,CSE 100,A01,083659,Cao; Yingjun,1,27,50,49
1649926150146,CSE 134B,A01,083661,Powell; Thomas Allan,0,21,65,65
1649926156173,CSE 140,A01,083663,Staff,24,0,75,51
1649926162197,CSE 140L,A01,083088,Eldon; John,18,0,75,57
1649926168224,CSE 175,A01,083665,Kumar; Rakesh,12,0,25,13
1649926174249,CSE 190,A00,092507,Dubnov; Shlomo,14,0,15,1
1649926180275,ECE 45,A01,083139,Staff,6,0,40,34
1649926186299,ECE 65,A50,083695,Staff,7,0,30,23
1649926192324,ECE 109,A01,091882,Touri; Behrouz,55,0,70,15
1649926198347,ECE 180,A00,083140,Abi Samra; Nicholas Camill,26,0,30,4
1649926198347,ECE 180,B00,083141,Abi Samra; Nicholas Camill,13,0,30,17
1649926204390,MATH 10A,A01,083735,Patchell; Gregory David,20,0,30,10
1649926204390,MATH 10A,A02,083736,Patchell; Gregory David,28,0,30,2
1649926204390,MATH 10A,A03,083737,Patchell; Gregory David,28,0,30,2
1649926210414,MATH 10B,A01,083207,Staff,10,0,30,20
1649926210414,MATH 10B,A02,083208,Staff,25,0,30,5
1649926210414,MATH 10B,B01,083739,Staff,25,0,30,5
1649926210414,MATH 10B,B02,083740,Staff,30,0,30,0
1649926216444,MATH 18,A01,083743,Staff,22,0,30,8
1649926216444,MATH 18,A02,083744,Staff,29,0,30,1
1649926216444,MATH 18,A03,083745,Staff,29,0,30,1
1649926216444,MATH 18,A04,083746,Staff,28,0,30,2
1649926216444,MATH 18,B01,083748,Staff,5,0,30,25
1649926216444,MATH 18,B02,083749,Staff,26,0,30,4
1649926216444,MATH 18,B03,083750,Staff,28,0,30,2
1649926216444,MATH 18,B04,083751,Staff,26,0,30,4
1649926222475,MATH 20A,A01,083754,Staff,37,0,40,3
1649926228500,MATH 20B,A01,083756,Staff,19,0,30,11
1649926228500,MATH 20B,A02,083757,Staff,30,0,30,0
1649926234528,MATH 20C,A01,083760,Staff,22,0,30,8
1649926234528,MATH 20C,A02,083761,Staff,23,0,30,7
1649926234528,MATH 20C,B01,083762,Staff,28,0,30,2
1649926234528,MATH 20C,B02,083763,Staff,30,0,30,0
1649926240625,MATH 20D,A01,083765,Staff,20,0,30,10
1649926240625,MATH 20D,A02,083766,Staff,30,0,30,0
1649926240625,MATH 20D,A03,083767,Staff,30,0,30,0
1649926246649,MATH 20E,A01,083771,Staff,12,0,30,18
1649926246649,MATH 20E,A02,083772,Staff,24,0,30,6
1649926246649,MATH 20E,B01,083773,Staff,17,0,30,13
1649926246649,MATH 20E,B02,083774,Staff,29,0,30,1
1649926252678,MATH 103A,A01,083777,Staff,1,4,30,29
1649926252678,MATH 103A,A02,083778,Staff,0,3,30,30
1649926252678,MATH 103A,B01,083779,Staff,0,0,30,30
1649926252678,MATH 103A,B02,083780,Staff,16,0,30,14
1649926258705,MATH 105,A01,085443,Staff,0,5,30,30
1649926264732,MATH 109,A01,083213,Anzaldo; Leesa B,14,0,30,16
1649926264732,MATH 109,A02,083214,Anzaldo; Leesa B,9,0,30,21
1649926264732,MATH 109,B01,083215,Anzaldo; Leesa B,26,0,30,4
1649926264732,MATH 109,B02,083216,Anzaldo; Leesa B,22,0,30,8
1649926270759,MATH 142A,A01,083219,Chow; Bennett,0,1,30,30
1649926270759,MATH 142A,A02,083220,Chow; Bennett,9,0,30,21
1649926270759,MATH 142A,B01,083221,Chow; Bennett,0,0,30,30
1649926270759,MATH 142A,B02,083222,Chow; Bennett,1,0,30,29
1649926276788,MATH 193A,A01,083224,Staff,0,3,30,30
1649926276788,MATH 193A,A02,083225,Staff,0,3,30,30
1649926276788,MATH 193A,A03,083781,Staff,4,0,30,26
1649926276788,MATH 193A,A04,083782,Staff,16,0,30,14
1649926282823,MATH 197,001,091859,McAuley; Julian John,9999,0,9999,0
1649926288892,COGS 9,A01,083615,Staff,16,0,60,44
1649926294919,COGS 11,A01,083617,Boyle; Mary E. T.,35,0,40,5
1649926300946,COGS 13,A01,083071,Staff,0,11,40,40
1649926306974,COGS 14A,A01,092681,Staff,65,0,100,35
1649926313000,COGS 14B,A01,083073,Cheng; Tzu-Han,24,0,50,26
1649926319023,COGS 17,A01,092677,Staff,63,0,75,12
1649926325048,COGS 100,A01,083619,Staff,0,5,60,60
1649926331073,COGS 101A,A01,083621,Davis; Joshua Daniel,0,8,60,60
1649926337099,COGS 101B,A01,091572,Staff,32,0,60,28
1649926343124,COGS 101C,A01,083625,Delgado; Tania,24,0,30,6
1649926349152,COGS 107A,A01,083627,Boyle; Mary E. T.,13,0,60,47
1649926355178,COGS 118A,A01,083075,Staff,21,0,60,39
1649926361202,CSE 3,A50,083646,Miranda; Gregory Joseph,24,0,38,14
1649926361202,CSE 3,A51,083647,Miranda; Gregory Joseph,37,0,37,0
1649926367227,CSE 8A,A50,083650,Miranda; Gregory Joseph,8,0,40,32
1649926373251,CSE 11,A01,083080,Cao; Yingjun,0,26,40,40
1649926379274,CSE 12,A01,083652,Staff,56,0,100,44
1649926385299,CSE 15L,A01,083654,Staff,19,0,50,31
1649926385299,CSE 15L,A02,083655,Staff,47,0,50,3
1649926391322,CSE 20,A01,083657,Staff,68,0,80,12
1649926397347,CSE 30,A01,083084,Eldon; John,0,24,40,40
1649926403370,CSE 100,A01,083659,Cao; Yingjun,1,27,50,49
1649926409398,CSE 134B,A01,083661,Powell; Thomas Allan,0,21,65,65
1649926415425,CSE 140,A01,083663,Staff,24,0,75,51
1649926421461,CSE 140L,A01,083088,Eldon; John,18,0,75,57
1649926427485,CSE 175,A01,083665,Kumar; Rakesh,12,0,25,13
1649926433509,CSE 190,A00,092507,Dubnov; Shlomo,14,0,15,1
1649926439534,ECE 45,A01,083139,Staff,6,0,40,34
1649926445564,ECE 65,A50,083695,Staff,7,0,30,23
1649926451588,ECE 109,A01,091882,Touri; Behrouz,55,0,70,15
1649926457617,ECE 180,A00,083140,Abi Samra; Nicholas Camill,26,0,30,4
1649926457617,ECE 180,B00,083141,Abi Samra; Nicholas Camill,13,0,30,17
1649926463645,MATH 10A,A01,083735,Patchell; Gregory David,20,0,30,10
1649926463645,MATH 10A,A02,083736,Patchell; Gregory David,28,0,30,2
1649926463645,MATH 10A,A03,083737,Patchell; Gregory David,28,0,30,2
1649926469669,MATH 10B,A01,083207,Staff,10,0,30,20
1649926469669,MATH 10B,A02,083208,Staff,25,0,30,5
1649926469669,MATH 10B,B01,083739,Staff,25,0,30,5
1649926469669,MATH 10B,B02,083740,Staff,30,0,30,0
1649926475694,MATH 18,A01,083743,Staff,22,0,30,8
1649926475694,MATH 18,A02,083744,Staff,29,0,30,1
1649926475694,MATH 18,A03,083745,Staff,29,0,30,1
1649926475694,MATH 18,A04,083746,Staff,28,0,30,2
1649926475694,MATH 18,B01,083748,Staff,5,0,30,25
1649926475694,MATH 18,B02,083749,Staff,26,0,30,4
1649926475694,MATH 18,B03,083750,Staff,28,0,30,2
1649926475694,MATH 18,B04,083751,Staff,26,0,30,4
1649926481723,MATH 20A,A01,083754,Staff,37,0,40,3
1649926487748,MATH 20B,A01,083756,Staff,19,0,30,11
1649926487748,MATH 20B,A02,083757,Staff,30,0,30,0
1649926493773,MATH 20C,A01,083760,Staff,22,0,30,8
1649926493773,MATH 20C,A02,083761,Staff,23,0,30,7
1649926493773,MATH 20C,B01,083762,Staff,28,0,30,2
1649926493773,MATH 20C,B02,083763,Staff,30,0,30,0
1649926499798,MATH 20D,A01,083765,Staff,20,0,30,10
1649926499798,MATH 20D,A02,083766,Staff,30,0,30,0
1649926499798,MATH 20D,A03,083767,Staff,30,0,30,0
1649926505829,MATH 20E,A01,083771,Staff,12,0,30,18
1649926505829,MATH 20E,A02,083772,Staff,24,0,30,6
1649926505829,MATH 20E,B01,083773,Staff,17,0,30,13
1649926505829,MATH 20E,B02,083774,Staff,29,0,30,1
1649926511855,MATH 103A,A01,083777,Staff,1,4,30,29
1649926511855,MATH 103A,A02,083778,Staff,0,3,30,30
1649926511855,MATH 103A,B01,083779,Staff,0,0,30,30
1649926511855,MATH 103A,B02,083780,Staff,16,0,30,14
1649926517878,MATH 105,A01,085443,Staff,0,5,30,30
1649926523902,MATH 109,A01,083213,Anzaldo; Leesa B,14,0,30,16
1649926523902,MATH 109,A02,083214,Anzaldo; Leesa B,9,0,30,21
1649926523902,MATH 109,B01,083215,Anzaldo; Leesa B,26,0,30,4
1649926523902,MATH 109,B02,083216,Anzaldo; Leesa B,22,0,30,8
1649926529926,MATH 142A,A01,083219,Chow; Bennett,0,1,30,30
1649926529926,MATH 142A,A02,083220,Chow; Bennett,9,0,30,21
1649926529926,MATH 142A,B01,083221,Chow; Bennett,0,0,30,30
1649926529926,MATH 142A,B02,083222,Chow; Bennett,1,0,30,29
1649926535952,MATH 193A,A01,083224,Staff,0,3,30,30
1649926535952,MATH 193A,A02,083225,Staff,0,3,30,30
1649926535952,MATH 193A,A03,083781,Staff,4,0,30,26
1649926535952,MATH 193A,A04,083782,Staff,16,0,30,14
1649926541975,MATH 197,001,091859,McAuley; Julian John,9999,0,9999,0
1649926548028,COGS 9,A01,083615,Staff,16,0,60,44
1649926554053,COGS 11,A01,083617,Boyle; Mary E. T.,35,0,40,5
1649926560078,COGS 13,A01,083071,Staff,0,11,40,40
1649926566105,COGS 14A,A01,092681,Staff,65,0,100,35
1649926572127,COGS 14B,A01,083073,Cheng; Tzu-Han,24,0,50,26
1649926578161,COGS 17,A01,092677,Staff,63,0,75,12
1649926584185,COGS 100,A01,083619,Staff,0,5,60,60
1649926590214,COGS 101A,A01,083621,Davis; Joshua Daniel,0,8,60,60
1649926596245,COGS 101B,A01,091572,Staff,32,0,60,28
1649926602268,COGS 101C,A01,083625,Delgado; Tania,24,0,30,6
1649926608296,COGS 107A,A01,083627,Boyle; Mary E. T.,14,0,60,46
1649926614323,COGS 118A,A01,083075,Staff,21,0,60,39
1649926620353,CSE 3,A50,083646,Miranda; Gregory Joseph,24,0,38,14
1649926620353,CSE 3,A51,083647,Miranda; Gregory Joseph,37,0,37,0
1649926626377,CSE 8A,A50,083650,Miranda; Gregory Joseph,8,0,40,32
1649926632405,CSE 11,A01,083080,Cao; Yingjun,0,26,40,40
1649926638428,CSE 12,A01,083652,Staff,56,0,100,44
1649926644453,CSE 15L,A01,083654,Staff,19,0,50,31
1649926644453,CSE 15L,A02,083655,Staff,47,0,50,3
1649926650481,CSE 20,A01,083657,Staff,68,0,80,12
1649926656505,CSE 30,A01,083084,Eldon; John,0,24,40,40
1649926662534,CSE 100,A01,083659,Cao; Yingjun,1,27,50,49
1649926668562,CSE 134B,A01,083661,Powell; Thomas Allan,0,21,65,65
1649926674590,CSE 140,A01,083663,Staff,24,0,75,51
1649926680613,CSE 140L,A01,083088,Eldon; John,18,0,75,57
1649926686638,CSE 175,A01,083665,Kumar; Rakesh,12,0,25,13
1649926692662,CSE 190,A00,092507,Dubnov; Shlomo,14,0,15,1
1649926698692,ECE 45,A01,083139,Staff,6,0,40,34
1649926704717,ECE 65,A50,083695,Staff,7,0,30,23
1649926710747,ECE 109,A01,091882,Touri; Behrouz,55,0,70,15
1649926716774,ECE 180,A00,083140,Abi Samra; Nicholas Camill,26,0,30,4
1649926716774,ECE 180,B00,083141,Abi Samra; Nicholas Camill,13,0,30,17
1649926722799,MATH 10A,A01,083735,Patchell; Gregory David,20,0,30,10
1649926722799,MATH 10A,A02,083736,Patchell; Gregory David,28,0,30,2
1649926722799,MATH 10A,A03,083737,Patchell; Gregory David,28,0,30,2
1649926728824,MATH 10B,A01,083207,Staff,10,0,30,20
1649926728824,MATH 10B,A02,083208,Staff,25,0,30,5
1649926728824,MATH 10B,B01,083739,Staff,25,0,30,5
1649926728824,MATH 10B,B02,083740,Staff,30,0,30,0
1649926734849,MATH 18,A01,083743,Staff,22,0,30,8
1649926734849,MATH 18,A02,083744,Staff,29,0,30,1
1649926734849,MATH 18,A03,083745,Staff,29,0,30,1
1649926734849,MATH 18,A04,083746,Staff,28,0,30,2
1649926734849,MATH 18,B01,083748,Staff,5,0,30,25
1649926734849,MATH 18,B02,083749,Staff,26,0,30,4
1649926734849,MATH 18,B03,083750,Staff,28,0,30,2
1649926734849,MATH 18,B04,083751,Staff,26,0,30,4
1649926740874,MATH 20A,A01,083754,Staff,37,0,40,3
1649926746898,MATH 20B,A01,083756,Staff,19,0,30,11
1649926746898,MATH 20B,A02,083757,Staff,30,0,30,0
1649926752922,MATH 20C,A01,083760,Staff,22,0,30,8
1649926752922,MATH 20C,A02,083761,Staff,23,0,30,7
1649926752922,MATH 20C,B01,083762,Staff,28,0,30,2
1649926752922,MATH 20C,B02,083763,Staff,30,0,30,0
1649926758947,MATH 20D,A01,083765,Staff,20,0,30,10
1649926758947,MATH 20D,A02,083766,Staff,30,0,30,0
1649926758947,MATH 20D,A03,083767,Staff,30,0,30,0
1649926764971,MATH 20E,A01,083771,Staff,12,0,30,18
1649926764971,MATH 20E,A02,083772,Staff,24,0,30,6
1649926764971,MATH 20E,B01,083773,Staff,17,0,30,13
1649926764971,MATH 20E,B02,083774,Staff,29,0,30,1
1649926771000,MATH 103A,A01,083777,Staff,1,4,30,29
1649926771000,MATH 103A,A02,083778,Staff,0,3,30,30
1649926771000,MATH 103A,B01,083779,Staff,0,0,30,30
1649926771000,MATH 103A,B02,083780,Staff,16,0,30,14
1649926777023,MATH 105,A01,085443,Staff,0,5,30,30
1649926783048,MATH 109,A01,083213,Anzaldo; Leesa B,14,0,30,16
1649926783048,MATH 109,A02,083214,Anzaldo; Leesa B,9,0,30,21
1649926783048,MATH 109,B01,083215,Anzaldo; Leesa B,26,0,30,4
1649926783048,MATH 109,B02,083216,Anzaldo; Leesa B,22,0,30,8
1649926789076,MATH 142A,A01,083219,Chow; Bennett,0,1,30,30
1649926789076,MATH 142A,A02,083220,Chow; Bennett,9,0,30,21
1649926789076,MATH 142A,B01,083221,Chow; Bennett,0,0,30,30
1649926789076,MATH 142A,B02,083222,Chow; Bennett,1,0,30,29
1649926795101,MATH 193A,A01,083224,Staff,0,3,30,30
1649926795101,MATH 193A,A02,083225,Staff,0,3,30,30
1649926795101,MATH 193A,A03,083781,Staff,4,0,30,26
1649926795101,MATH 193A,A04,083782,Staff,16,0,30,14
1649926801128,MATH 197,001,091859,McAuley; Julian John,9999,0,9999,0
1649926807181,COGS 9,A01,083615,Staff,16,0,60,44
1649926813203,COGS 11,A01,083617,Boyle; Mary E. T.,35,0,40,5
1649926819239,COGS 13,A01,083071,Staff,0,11,40,40
1649926825261,COGS 14A,A01,092681,Staff,65,0,100,35
1649926831361,COGS 14B,A01,083073,Cheng; Tzu-Han,24,0,50,26
1649926837388,COGS 17,A01,092677,Staff,63,0,75,12
1649926843412,COGS 100,A01,083619,Staff,0,5,60,60
1649926849442,COGS 101A,A01,083621,Davis; Joshua Daniel,0,8,60,60
1649926855474,COGS 101B,A01,091572,Staff,32,0,60,28
1649926861497,COGS 101C,A01,083625,Delgado; Tania,24,0,30,6
1649926867523,COGS 107A,A01,083627,Boyle; Mary E. T.,14,0,60,46
1649926873551,COGS 118A,A01,083075,Staff,21,0,60,39
1649926879581,CSE 3,A50,083646,Miranda; Gregory Joseph,24,0,38,14
1649926879581,CSE 3,A51,083647,Miranda; Gregory Joseph,37,0,37,0
1649926885608,CSE 8A,A50,083650,Miranda; Gregory Joseph,8,0,40,32
1649926891633,CSE 11,A01,083080,Cao; Yingjun,0,26,40,40
1649926897655,CSE 12,A01,083652,Staff,56,0,100,44
1649926903684,CSE 15L,A01,083654,Staff,19,0,50,31
1649926903684,CSE 15L,A02,083655,Staff,47,0,50,3
1649926909719,CSE 20,A01,083657,Staff,68,0,80,12
1649926915748,CSE 30,A01,083084,Eldon; John,0,24,40,40
1649926921773,CSE 100,A01,083659,Cao; Yingjun,1,27,50,49
1649926927801,CSE 134B,A01,083661,Powell; Thomas Allan,0,21,65,65
1649926933825,CSE 140,A01,083663,Staff,24,0,75,51
1649926939854,CSE 140L,A01,083088,Eldon; John,18,0,75,57
1649926945891,CSE 175,A01,083665,Kumar; Rakesh,12,0,25,13
1649926951918,CSE 190,A00,092507,Dubnov; Shlomo,14,0,15,1
1649926957943,ECE 45,A01,083139,Staff,6,0,40,34
1649926963969,ECE 65,A50,083695,Staff,7,0,30,23
1649926969993,ECE 109,A01,091882,Touri; Behrouz,55,0,70,15
1649926976027,ECE 180,A00,083140,Abi Samra; Nicholas Camill,26,0,30,4
1649926976027,ECE 180,B00,083141,Abi Samra; Nicholas Camill,13,0,30,17
1649926982055,MATH 10A,A01,083735,Patchell; Gregory David,20,0,30,10
1649926982055,MATH 10A,A02,083736,Patchell; Gregory David,28,0,30,2
1649926982055,MATH 10A,A03,083737,Patchell; Gregory David,28,0,30,2
1649926988083,MATH 10B,A01,083207,Staff,10,0,30,20
1649926988083,MATH 10B,A02,083208,Staff,25,0,30,5
1649926988083,MATH 10B,B01,083739,Staff,25,0,30,5
1649926988083,MATH 10B,B02,083740,Staff,30,0,30,0
1649926994113,MATH 18,A01,083743,Staff,22,0,30,8
1649926994113,MATH 18,A02,083744,Staff,29,0,30,1
1649926994113,MATH 18,A03,083745,Staff,29,0,30,1
1649926994113,MATH 18,A04,083746,Staff,28,0,30,2
1649926994113,MATH 18,B01,083748,Staff,5,0,30,25
1649926994113,MATH 18,B02,083749,Staff,26,0,30,4
1649926994113,MATH 18,B03,083750,Staff,28,0,30,2
1649926994113,MATH 18,B04,083751,Staff,26,0,30,4
1649927000136,MATH 20A,A01,083754,Staff,37,0,40,3
1649927006162,MATH 20B,A01,083756,Staff,19,0,30,11
1649927006162,MATH 20B,A02,083757,Staff,30,0,30,0
1649927012190,MATH 20C,A01,083760,Staff,22,0,30,8
1649927012190,MATH 20C,A02,083761,Staff,23,0,30,7
1649927012190,MATH 20C,B01,083762,Staff,28,0,30,2
1649927012190,MATH 20C,B02,083763,Staff,30,0,30,0
1649927018217,MATH 20D,A01,083765,Staff,20,0,30,10
1649927018217,MATH 20D,A02,083766,Staff,30,0,30,0
1649927018217,MATH 20D,A03,083767,Staff,30,0,30,0
1649927024245,MATH 20E,A01,083771,Staff,12,0,30,18
1649927024245,MATH 20E,A02,083772,Staff,24,0,30,6
1649927024245,MATH 20E,B01,083773,Staff,17,0,30,13
1649927024245,MATH 20E,B02,083774,Staff,29,0,30,1
1649927030275,MATH 103A,A01,083777,Staff,1,4,30,29
1649927030275,MATH 103A,A02,083778,Staff,0,3,30,30
1649927030275,MATH 103A,B01,083779,Staff,0,0,30,30
1649927030275,MATH 103A,B02,083780,Staff,16,0,30,14
1649927036299,MATH 105,A01,085443,Staff,0,5,30,30
1649927042323,MATH 109,A01,083213,Anzaldo; Leesa B,14,0,30,16
1649927042323,MATH 109,A02,083214,Anzaldo; Leesa B,9,0,30,21
1649927042323,MATH 109,B01,083215,Anzaldo; Leesa B,26,0,30,4
1649927042323,MATH 109,B02,083216,Anzaldo; Leesa B,22,0,30,8
1649927048346,MATH 142A,A01,083219,Chow; Bennett,0,1,30,30
1649927048346,MATH 142A,A02,083220,Chow; Bennett,9,0,30,21
1649927048346,MATH 142A,B01,083221,Chow; Bennett,0,0,30,30
1649927048346,MATH 142A,B02,083222,Chow; Bennett,1,0,30,29
1649927054369,MATH 193A,A01,083224,Staff,0,3,30,30
1649927054369,MATH 193A,A02,083225,Staff,0,3,30,30
1649927054369,MATH 193A,A03,083781,Staff,4,0,30,26
1649927054369,MATH 193A,A04,083782,Staff,16,0,30,14
1649927060392,MATH 197,001,091859,McAuley; Julian John,9999,0,9999,0
1649927066466,COGS 9,A01,083615,Staff,16,0,60,44
1649927072492,COGS 11,A01,083617,Boyle; Mary E. T.,35,0,40,5
1649927078519,COGS 13,A01,083071,Staff,0,11,40,40
1649927084548,COGS 14A,A01,092681,Staff,65,0,100,35
1649927090574,COGS 14B,A01,083073,Cheng; Tzu-Han,24,0,50,26
1649927096602,COGS 17,A01,092677,Staff,63,0,75,12
1649927102630,COGS 100,A01,083619,Staff,0,5,60,60
1649927108658,COGS 101A,A01,083621,Davis; Joshua Daniel,0,8,60,60
1649927114686,COGS 101B,A01,091572,Staff,32,0,60,28
1649927120718,COGS 101C,A01,083625,Delgado; Tania,24,0,30,6
1649927126741,COGS 107A,A01,083627,Boyle; Mary E. T.,14,0,60,46
1649927132767,COGS 118A,A01,083075,Staff,21,0,60,39
1649927138790,CSE 3,A50,083646,Miranda; Gregory Joseph,24,0,38,14
1649927138790,CSE 3,A51,083647,Miranda; Gregory Joseph,37,0,37,0
1649927144826,CSE 8A,A50,083650,Miranda; Gregory Joseph,8,0,40,32
1649927150849,CSE 11,A01,083080,Cao; Yingjun,0,26,40,40
1649927156875,CSE 12,A01,083652,Staff,56,0,100,44
1649927162902,CSE 15L,A01,083654,Staff,19,0,50,31
1649927162902,CSE 15L,A02,083655,Staff,47,0,50,3
1649927168930,CSE 20,A01,083657,Staff,68,0,80,12
1649927174954,CSE 30,A01,083084,Eldon; John,0,24,40,40
1649927180977,CSE 100,A01,083659,Cao; Yingjun,1,27,50,49
1649927187003,CSE 134B,A01,083661,Powell; Thomas Allan,0,21,65,65
1649927193030,CSE 140,A01,083663,Staff,24,0,75,51
1649927199059,CSE 140L,A01,083088,Eldon; John,18,0,75,57
1649927205086,CSE 175,A01,083665,Kumar; Rakesh,12,0,25,13
1649927211113,CSE 190,A00,092507,Dubnov; Shlomo,14,0,15,1
1649927217136,ECE 45,A01,083139,Staff,6,0,40,34
1649927223163,ECE 65,A50,083695,Staff,7,0,30,23
1649927229194,ECE 109,A01,091882,Touri; Behrouz,55,0,70,15
1649927235216,ECE 180,A00,083140,Abi Samra; Nicholas Camill,26,0,30,4
1649927235216,ECE 180,B00,083141,Abi Samra; Nicholas Camill,13,0,30,17
1649927241247,MATH 10A,A01,083735,Patchell; Gregory David,20,0,30,10
1649927241247,MATH 10A,A02,083736,Patchell; Gregory David,28,0,30,2
1649927241247,MATH 10A,A03,083737,Patchell; Gregory David,28,0,30,2
1649927247272,MATH 10B,A01,083207,Staff,10,0,30,20
1649927247272,MATH 10B,A02,083208,Staff,25,0,30,5
1649927247272,MATH 10B,B01,083739,Staff,25,0,30,5
1649927247272,MATH 10B,B02,083740,Staff,30,0,30,0
1649927253296,MATH 18,A01,083743,Staff,22,0,30,8
1649927253296,MATH 18,A02,083744,Staff,29,0,30,1
1649927253296,MATH 18,A03,083745,Staff,29,0,30,1
1649927253296,MATH 18,A04,083746,Staff,28,0,30,2
1649927253296,MATH 18,B01,083748,Staff,5,0,30,25
1649927253296,MATH 18,B02,083749,Staff,26,0,30,4
1649927253296,MATH 18,B03,083750,Staff,28,0,30,2
1649927253296,MATH 18,B04,083751,Staff,26,0,30,4
1649927259319,MATH 20A,A01,083754,Staff,37,0,40,3
1649927265346,MATH 20B,A01,083756,Staff,19,0,30,11
1649927265346,MATH 20B,A02,083757,Staff,30,0,30,0
1649927271373,MATH 20C,A01,083760,Staff,22,0,30,8
1649927271373,MATH 20C,A02,083761,Staff,23,0,30,7
1649927271373,MATH 20C,B01,083762,Staff,28,0,30,2
1649927271373,MATH 20C,B02,083763,Staff,30,0,30,0
1649927277401,MATH 20D,A01,083765,Staff,20,0,30,10
1649927277401,MATH 20D,A02,083766,Staff,30,0,30,0
1649927277401,MATH 20D,A03,083767,Staff,30,0,30,0
1649927283424,MATH 20E,A01,083771,Staff,12,0,30,18
1649927283424,MATH 20E,A02,083772,Staff,24,0,30,6
1649927283424,MATH 20E,B01,083773,Staff,17,0,30,13
1649927283424,MATH 20E,B02,083774,Staff,29,0,30,1
1649927289451,MATH 103A,A01,083777,Staff,1,4,30,29
1649927289451,MATH 103A,A02,083778,Staff,0,3,30,30
1649927289451,MATH 103A,B01,083779,Staff,0,0,30,30
1649927289451,MATH 103A,B02,083780,Staff,16,0,30,14
1649927295477,MATH 105,A01,085443,Staff,0,5,30,30
1649927301505,MATH 109,A01,083213,Anzaldo; Leesa B,14,0,30,16
1649927301505,MATH 109,A02,083214,Anzaldo; Leesa B,9,0,30,21
1649927301505,MATH 109,B01,083215,Anzaldo; Leesa B,26,0,30,4
1649927301505,MATH 109,B02,083216,Anzaldo; Leesa B,22,0,30,8
1649927307530,MATH 142A,A01,083219,Chow; Bennett,0,1,30,30
1649927307530,MATH 142A,A02,083220,Chow; Bennett,9,0,30,21
1649927307530,MATH 142A,B01,083221,Chow; Bennett,0,0,30,30
1649927307530,MATH 142A,B02,083222,Chow; Bennett,1,0,30,29
1649927313555,MATH 193A,A01,083224,Staff,0,3,30,30
1649927313555,MATH 193A,A02,083225,Staff,0,3,30,30
1649927313555,MATH 193A,A03,083781,Staff,4,0,30,26
1649927313555,MATH 193A,A04,083782,Staff,16,0,30,14
1649927319577,MATH 197,001,091859,McAuley; Julian John,9999,0,9999,0
1649927325630,COGS 9,A01,083615,Staff,16,0,60,44
1649927331663,COGS 11,A01,083617,Boyle; Mary E. T.,35,0,40,5
1649927337690,COGS 13,A01,083071,Staff,0,11,40,40
1649927343716,COGS 14A,A01,092681,Staff,65,0,100,35
1649927349745,COGS 14B,A01,083073,Cheng; Tzu-Han,24,0,50,26
1649927355769,COGS 17,A01,092677,Staff,63,0,75,12
1649927361795,COGS 100,A01,083619,Staff,0,5,60,60
1649927367822,COGS 101A,A01,083621,Davis; Joshua Daniel,0,8,60,60
1649927373844,COGS 101B,A01,091572,Staff,32,0,60,28
1649927379869,COGS 101C,A01,083625,Delgado; Tania,24,0,30,6
1649927385897,COGS 107A,A01,083627,Boyle; Mary E. T.,14,0,60,46
1649927391921,COGS 118A,A01,083075,Staff,21,0,60,39
1649927397949,CSE 3,A50,083646,Miranda; Gregory Joseph,24,0,38,14
1649927397949,CSE 3,A51,083647,Miranda; Gregory Joseph,37,0,37,0
1649927403975,CSE 8A,A50,083650,Miranda; Gregory Joseph,8,0,40,32
1649927410004,CSE 11,A01,083080,Cao; Yingjun,0,26,40,40
1649927416027,CSE 12,A01,083652,Staff,56,0,100,44
1649927422049,CSE 15L,A01,083654,Staff,19,0,50,31
1649927422049,CSE 15L,A02,083655,Staff,47,0,50,3
1649927428146,CSE 20,A01,083657,Staff,68,0,80,12
1649927434179,CSE 30,A01,083084,Eldon; John,0,24,40,40
1649927440237,CSE 100,A01,083659,Cao; Yingjun,1,27,50,49
1649927446264,CSE 134B,A01,083661,Powell; Thomas Allan,0,21,65,65
1649927452290,CSE 140,A01,083663,Staff,24,0,75,51
1649927458316,CSE 140L,A01,083088,Eldon; John,18,0,75,57
1649927464341,CSE 175,A01,083665,Kumar; Rakesh,12,0,25,13
1649927470372,CSE 190,A00,092507,Dubnov; Shlomo,14,0,15,1
1649927476403,ECE 45,A01,083139,Staff,6,0,40,34
1649927482433,ECE 65,A50,083695,Staff,7,0,30,23
1649927488462,ECE 109,A01,091882,Touri; Behrouz,55,0,70,15
1649927494486,ECE 180,A00,083140,Abi Samra; Nicholas Camill,26,0,30,4
1649927494486,ECE 180,B00,083141,Abi Samra; Nicholas Camill,13,0,30,17
1649927500510,MATH 10A,A01,083735,Patchell; Gregory David,20,0,30,10
1649927500510,MATH 10A,A02,083736,Patchell; Gregory David,28,0,30,2
1649927500510,MATH 10A,A03,083737,Patchell; Gregory David,28,0,30,2
1649927506532,MATH 10B,A01,083207,Staff,10,0,30,20
1649927506532,MATH 10B,A02,083208,Staff,25,0,30,5
1649927506532,MATH 10B,B01,083739,Staff,25,0,30,5
1649927506532,MATH 10B,B02,083740,Staff,30,0,30,0
1649927512558,MATH 18,A01,083743,Staff,22,0,30,8
1649927512558,MATH 18,A02,083744,Staff,29,0,30,1
1649927512558,MATH 18,A03,083745,Staff,29,0,30,1
1649927512558,MATH 18,A04,083746,Staff,28,0,30,2
1649927512558,MATH 18,B01,083748,Staff,5,0,30,25
1649927512558,MATH 18,B02,083749,Staff,26,0,30,4
1649927512558,MATH 18,B03,083750,Staff,28,0,30,2
1649927512558,MATH 18,B04,083751,Staff,26,0,30,4
1649927518581,MATH 20A,A01,083754,Staff,37,0,40,3
1649927524608,MATH 20B,A01,083756,Staff,19,0,30,11
1649927524608,MATH 20B,A02,083757,Staff,30,0,30,0
1649927530632,MATH 20C,A01,083760,Staff,22,0,30,8
1649927530632,MATH 20C,A02,083761,Staff,23,0,30,7
1649927530632,MATH 20C,B01,083762,Staff,28,0,30,2
1649927530632,MATH 20C,B02,083763,Staff,30,0,30,0
1649927536660,MATH 20D,A01,083765,Staff,20,0,30,10
1649927536660,MATH 20D,A02,083766,Staff,30,0,30,0
1649927536660,MATH 20D,A03,083767,Staff,30,0,30,0
1649927542684,MATH 20E,A01,083771,Staff,12,0,30,18
1649927542684,MATH 20E,A02,083772,Staff,24,0,30,6
1649927542684,MATH 20E,B01,083773,Staff,17,0,30,13
1649927542684,MATH 20E,B02,083774,Staff,29,0,30,1
1649927548707,MATH 103A,A01,083777,Staff,1,4,30,29
1649927548707,MATH 103A,A02,083778,Staff,0,3,30,30
1649927548707,MATH 103A,B01,083779,Staff,0,0,30,30
1649927548707,MATH 103A,B02,083780,Staff,16,0,30,14
1649927554730,MATH 105,A01,085443,Staff,0,5,30,30
1649927560756,MATH 109,A01,083213,Anzaldo; Leesa B,14,0,30,16
1649927560756,MATH 109,A02,083214,Anzaldo; Leesa B,9,0,30,21
1649927560756,MATH 109,B01,083215,Anzaldo; Leesa B,26,0,30,4
1649927560756,MATH 109,B02,083216,Anzaldo; Leesa B,22,0,30,8
1649927566786,MATH 142A,A01,083219,Chow; Bennett,0,1,30,30
1649927566786,MATH 142A,A02,083220,Chow; Bennett,9,0,30,21
1649927566786,MATH 142A,B01,083221,Chow; Bennett,0,0,30,30
1649927566786,MATH 142A,B02,083222,Chow; Bennett,1,0,30,29
1649927572810,MATH 193A,A01,083224,Staff,0,3,30,30
1649927572810,MATH 193A,A02,083225,Staff,0,3,30,30
1649927572810,MATH 193A,A03,083781,Staff,4,0,30,26
1649927572810,MATH 193A,A04,083782,Staff,16,0,30,14
1649927578834,MATH 197,001,091859,McAuley; Julian John,9999,0,9999,0
1649927584888,COGS 9,A01,083615,Staff,16,0,60,44
1649927590913,COGS 11,A01,083617,Boyle; Mary E. T.,35,0,40,5
1649927596939,COGS 13,A01,083071,Staff,0,11,40,40
1649927602963,COGS 14A,A01,092681,Staff,65,0,100,35
1649927608987,COGS 14B,A01,083073,Cheng; Tzu-Han,24,0,50,26
1649927615011,COGS 17,A01,092677,Staff,63,0,75,12
1649927621036,COGS 100,A01,083619,Staff,0,5,60,60
1649927627059,COGS 101A,A01,083621,Davis; Joshua Daniel,0,8,60,60
1649927633084,COGS 101B,A01,091572,Staff,32,0,60,28
1649927639109,COGS 101C,A01,083625,Delgado; Tania,24,0,30,6
1649927645132,COGS 107A,A01,083627,Boyle; Mary E. T.,14,0,60,46
1649927651155,COGS 118A,A01,083075,Staff,21,0,60,39
1649927657179,CSE 3,A50,083646,Miranda; Gregory Joseph,24,0,38,14
1649927657179,CSE 3,A51,083647,Miranda; Gregory Joseph,37,0,37,0
1649927663206,CSE 8A,A50,083650,Miranda; Gregory Joseph,8,0,40,32
1649927669229,CSE 11,A01,083080,Cao; Yingjun,0,26,40,40
1649927675250,CSE 12,A01,083652,Staff,56,0,100,44
1649927681272,CSE 15L,A01,083654,Staff,19,0,50,31
1649927681272,CSE 15L,A02,083655,Staff,47,0,50,3
1649927687295,CSE 20,A01,083657,Staff,68,0,80,12
1649927693317,CSE 30,A01,083084,Eldon; John,0,24,40,40
1649927699340,CSE 100,A01,083659,Cao; Yingjun,1,27,50,49
1649927705363,CSE 134B,A01,083661,Powell; Thomas Allan,0,21,65,65
1649927711385,CSE 140,A01,083663,Staff,24,0,75,51
1649927717409,CSE 140L,A01,083088,Eldon; John,18,0,75,57
1649927723443,CSE 175,A01,083665,Kumar; Rakesh,12,0,25,13
1649927729470,CSE 190,A00,092507,Dubnov; Shlomo,14,0,15,1
1649927735496,ECE 45,A01,083139,Staff,6,0,40,34
1649927741523,ECE 65,A50,083695,Staff,7,0,30,23
1649927747547,ECE 109,A01,091882,Touri; Behrouz,55,0,70,15
1649927753572,ECE 180,A00,083140,Abi Samra; Nicholas Camill,26,0,30,4
1649927753572,ECE 180,B00,083141,Abi Samra; Nicholas Camill,13,0,30,17
1649927759600,MATH 10A,A01,083735,Patchell; Gregory David,20,0,30,10
1649927759600,MATH 10A,A02,083736,Patchell; Gregory David,28,0,30,2
1649927759600,MATH 10A,A03,083737,Patchell; Gregory David,28,0,30,2
1649927765624,MATH 10B,A01,083207,Staff,10,0,30,20
1649927765624,MATH 10B,A02,083208,Staff,25,0,30,5
1649927765624,MATH 10B,B01,083739,Staff,25,0,30,5
1649927765624,MATH 10B,B02,083740,Staff,30,0,30,0
1649927771649,MATH 18,A01,083743,Staff,22,0,30,8
1649927771649,MATH 18,A02,083744,Staff,29,0,30,1
1649927771649,MATH 18,A03,083745,Staff,29,0,30,1
1649927771649,MATH 18,A04,083746,Staff,28,0,30,2
1649927771649,MATH 18,B01,083748,Staff,5,0,30,25
1649927771649,MATH 18,B02,083749,Staff,26,0,30,4
1649927771649,MATH 18,B03,083750,Staff,28,0,30,2
1649927771649,MATH 18,B04,083751,Staff,26,0,30,4
1649927777675,MATH 20A,A01,083754,Staff,37,0,40,3
1649927783698,MATH 20B,A01,083756,Staff,19,0,30,11
1649927783698,MATH 20B,A02,083757,Staff,30,0,30,0
1649927789722,MATH 20C,A01,083760,Staff,22,0,30,8
1649927789722,MATH 20C,A02,083761,Staff,23,0,30,7
1649927789722,MATH 20C,B01,083762,Staff,28,0,30,2
1649927789722,MATH 20C,B02,083763,Staff,30,0,30,0
1649927795746,MATH 20D,A01,083765,Staff,20,0,30,10
1649927795746,MATH 20D,A02,083766,Staff,30,0,30,0
1649927795746,MATH 20D,A03,083767,Staff,30,0,30,0
1649927801773,MATH 20E,A01,083771,Staff,12,0,30,18
1649927801773,MATH 20E,A02,083772,Staff,24,0,30,6
1649927801773,MATH 20E,B01,083773,Staff,17,0,30,13
1649927801773,MATH 20E,B02,083774,Staff,29,0,30,1
1649927807798,MATH 103A,A01,083777,Staff,1,4,30,29
1649927807798,MATH 103A,A02,083778,Staff,0,3,30,30
1649927807798,MATH 103A,B01,083779,Staff,0,0,30,30
1649927807798,MATH 103A,B02,083780,Staff,16,0,30,14
1649927813823,MATH 105,A01,085443,Staff,0,5,30,30
1649927819850,MATH 109,A01,083213,Anzaldo; Leesa B,14,0,30,16
1649927819850,MATH 109,A02,083214,Anzaldo; Leesa B,9,0,30,21
1649927819850,MATH 109,B01,083215,Anzaldo; Leesa B,26,0,30,4
1649927819850,MATH 109,B02,083216,Anzaldo; Leesa B,22,0,30,8
1649927825882,MATH 142A,A01,083219,Chow; Bennett,0,1,30,30
1649927825882,MATH 142A,A02,083220,Chow; Bennett,9,0,30,21
1649927825882,MATH 142A,B01,083221,Chow; Bennett,0,0,30,30
1649927825882,MATH 142A,B02,083222,Chow; Bennett,1,0,30,29
1649927831905,MATH 193A,A01,083224,Staff,0,3,30,30
1649927831905,MATH 193A,A02,083225,Staff,0,3,30,30
1649927831905,MATH 193A,A03,083781,Staff,4,0,30,26
1649927831905,MATH 193A,A04,083782,Staff,16,0,30,14
1649927837931,MATH 197,001,091859,McAuley; Julian John,9999,0,9999,0
1649927843983,COGS 9,A01,083615,Staff,16,0,60,44
1649927850005,COGS 11,A01,083617,Boyle; Mary E. T.,35,0,40,5
1649927856028,COGS 13,A01,083071,Staff,0,11,40,40
1649927862052,COGS 14A,A01,092681,Staff,65,0,100,35
1649927868075,COGS 14B,A01,083073,Cheng; Tzu-Han,24,0,50,26
1649927874098,COGS 17,A01,092677,Staff,63,0,75,12
1649927880124,COGS 100,A01,083619,Staff,0,5,60,60
1649927886157,COGS 101A,A01,083621,Davis; Joshua Daniel,0,8,60,60
1649927892182,COGS 101B,A01,091572,Staff,32,0,60,28
1649927898208,COGS 101C,A01,083625,Delgado; Tania,24,0,30,6
1649927904236,COGS 107A,A01,083627,Boyle; Mary E. T.,14,0,60,46
1649927910259,COGS 118A,A01,083075,Staff,21,0,60,39
1649927916283,CSE 3,A50,083646,Miranda; Gregory Joseph,24,0,38,14
1649927916283,CSE 3,A51,083647,Miranda; Gregory Joseph,37,0,37,0
1649927922306,CSE 8A,A50,083650,Miranda; Gregory Joseph,8,0,40,32
1649927928337,CSE 11,A01,083080,Cao; Yingjun,0,26,40,40
1649927934360,CSE 12,A01,083652,Staff,56,0,100,44
1649927940383,CSE 15L,A01,083654,Staff,19,0,50,31
1649927940383,CSE 15L,A02,083655,Staff,47,0,50,3
1649927946406,CSE 20,A01,083657,Staff,68,0,80,12
1649927952433,CSE 30,A01,083084,Eldon; John,0,24,40,40
1649927958457,CSE 100,A01,083659,Cao; Yingjun,1,27,50,49
1649927964482,CSE 134B,A01,083661,Powell; Thomas Allan,0,21,65,65
1649927970507,CSE 140,A01,083663,Staff,24,0,75,51
1649927976536,CSE 140L,A01,083088,Eldon; John,18,0,75,57
1649927982566,CSE 175,A01,083665,Kumar; Rakesh,12,0,25,13
1649927988591,CSE 190,A00,092507,Dubnov; Shlomo,14,0,15,1
1649927994627,ECE 45,A01,083139,Staff,6,0,40,34
1649928000656,ECE 65,A50,083695,Staff,7,0,30,23
1649928006685,ECE 109,A01,091882,Touri; Behrouz,55,0,70,15
1649928012709,ECE 180,A00,083140,Abi Samra; Nicholas Camill,26,0,30,4
1649928012709,ECE 180,B00,083141,Abi Samra; Nicholas Camill,13,0,30,17
1649928018733,MATH 10A,A01,083735,Patchell; Gregory David,20,0,30,10
1649928018733,MATH 10A,A02,083736,Patchell; Gregory David,28,0,30,2
1649928018733,MATH 10A,A03,083737,Patchell; Gregory David,28,0,30,2
1649928024829,MATH 10B,A01,083207,Staff,10,0,30,20
1649928024829,MATH 10B,A02,083208,Staff,25,0,30,5
1649928024829,MATH 10B,B01,083739,Staff,25,0,30,5
1649928024829,MATH 10B,B02,083740,Staff,30,0,30,0
1649928030885,MATH 18,A01,083743,Staff,22,0,30,8
1649928030885,MATH 18,A02,083744,Staff,29,0,30,1
1649928030885,MATH 18,A03,083745,Staff,29,0,30,1
1649928030885,MATH 18,A04,083746,Staff,28,0,30,2
1649928030885,MATH 18,B01,083748,Staff,5,0,30,25
1649928030885,MATH 18,B02,083749,Staff,26,0,30,4
1649928030885,MATH 18,B03,083750,Staff,28,0,30,2
1649928030885,MATH 18,B04,083751,Staff,26,0,30,4
1649928036909,MATH 20A,A01,083754,Staff,37,0,40,3
1649928042932,MATH 20B,A01,083756,Staff,19,0,30,11
1649928042932,MATH 20B,A02,083757,Staff,30,0,30,0
1649928048960,MATH 20C,A01,083760,Staff,22,0,30,8
1649928048960,MATH 20C,A02,083761,Staff,23,0,30,7
1649928048960,MATH 20C,B01,083762,Staff,28,0,30,2
1649928048960,MATH 20C,B02,083763,Staff,30,0,30,0
1649928054984,MATH 20D,A01,083765,Staff,20,0,30,10
1649928054984,MATH 20D,A02,083766,Staff,30,0,30,0
1649928054984,MATH 20D,A03,083767,Staff,30,0,30,0
1649928061012,MATH 20E,A01,083771,Staff,12,0,30,18
1649928061012,MATH 20E,A02,083772,Staff,24,0,30,6
1649928061012,MATH 20E,B01,083773,Staff,17,0,30,13
1649928061012,MATH 20E,B02,083774,Staff,29,0,30,1
1649928067037,MATH 103A,A01,083777,Staff,1,4,30,29
1649928067037,MATH 103A,A02,083778,Staff,0,3,30,30
1649928067037,MATH 103A,B01,083779,Staff,0,0,30,30
1649928067037,MATH 103A,B02,083780,Staff,16,0,30,14
1649928073063,MATH 105,A01,085443,Staff,0,5,30,30
1649928079088,MATH 109,A01,083213,Anzaldo; Leesa B,14,0,30,16
1649928079088,MATH 109,A02,083214,Anzaldo; Leesa B,9,0,30,21
1649928079088,MATH 109,B01,083215,Anzaldo; Leesa B,26,0,30,4
1649928079088,MATH 109,B02,083216,Anzaldo; Leesa B,22,0,30,8
1649928085112,MATH 142A,A01,083219,Chow; Bennett,0,1,30,30
1649928085112,MATH 142A,A02,083220,Chow; Bennett,9,0,30,21
1649928085112,MATH 142A,B01,083221,Chow; Bennett,0,0,30,30
1649928085112,MATH 142A,B02,083222,Chow; Bennett,1,0,30,29
1649928091136,MATH 193A,A01,083224,Staff,0,3,30,30
1649928091136,MATH 193A,A02,083225,Staff,0,3,30,30
1649928091136,MATH 193A,A03,083781,Staff,4,0,30,26
1649928091136,MATH 193A,A04,083782,Staff,16,0,30,14
1649928097161,MATH 197,001,091859,McAuley; Julian John,9999,0,9999,0
1649928103214,COGS 9,A01,083615,Staff,16,0,60,44
1649928109238,COGS 11,A01,083617,Boyle; Mary E. T.,35,0,40,5
1649928115265,COGS 13,A01,083071,Staff,0,11,40,40
1649928121290,COGS 14A,A01,092681,Staff,65,0,100,35
1649928127318,COGS 14B,A01,083073,Cheng; Tzu-Han,24,0,50,26
1649928133342,COGS 17,A01,092677,Staff,63,0,75,12
1649928139364,COGS 100,A01,083619,Staff,0,5,60,60
1649928145387,COGS 101A,A01,083621,Davis; Joshua Daniel,0,8,60,60
1649928151417,COGS 101B,A01,091572,Staff,32,0,60,28
1649928157443,COGS 101C,A01,083625,Delgado; Tania,24,0,30,6
1649928163470,COGS 107A,A01,083627,Boyle; Mary E. T.,14,0,60,46
1649928169490,COGS 118A,A01,083075,Staff,21,0,60,39
1649928175514,CSE 3,A50,083646,Miranda; Gregory Joseph,24,0,38,14
1649928175514,CSE 3,A51,083647,Miranda; Gregory Joseph,37,0,37,0
1649928181543,CSE 8A,A50,083650,Miranda; Gregory Joseph,8,0,40,32
1649928187566,CSE 11,A01,083080,Cao; Yingjun,0,26,40,40
1649928193590,CSE 12,A01,083652,Staff,56,0,100,44
1649928199613,CSE 15L,A01,083654,Staff,19,0,50,31
1649928199613,CSE 15L,A02,083655,Staff,47,0,50,3
1649928205640,CSE 20,A01,083657,Staff,68,0,80,12
1649928211664,CSE 30,A01,083084,Eldon; John,0,24,40,40
1649928217687,CSE 100,A01,083659,Cao; Yingjun,1,27,50,49
1649928223711,CSE 134B,A01,083661,Powell; Thomas Allan,0,21,65,65
1649928229734,CSE 140,A01,083663,Staff,24,0,75,51
1649928235760,CSE 140L,A01,083088,Eldon; John,18,0,75,57
1649928241789,CSE 175,A01,083665,Kumar; Rakesh,12,0,25,13
1649928247813,CSE 190,A00,092507,Dubnov; Shlomo,14,0,15,1
1649928253841,ECE 45,A01,083139,Staff,6,0,40,34
1649928259866,ECE 65,A50,083695,Staff,7,0,30,23
1649928265891,ECE 109,A01,091882,Touri; Behrouz,55,0,70,15
1649928271914,ECE 180,A00,083140,Abi Samra; Nicholas Camill,26,0,30,4
1649928271914,ECE 180,B00,083141,Abi Samra; Nicholas Camill,13,0,30,17
1649928277938,MATH 10A,A01,083735,Patchell; Gregory David,20,0,30,10
1649928277938,MATH 10A,A02,083736,Patchell; Gregory David,28,0,30,2
1649928277938,MATH 10A,A03,083737,Patchell; Gregory David,28,0,30,2
1649928283965,MATH 10B,A01,083207,Staff,10,0,30,20
1649928283965,MATH 10B,A02,083208,Staff,25,0,30,5
1649928283965,MATH 10B,B01,083739,Staff,25,0,30,5
1649928283965,MATH 10B,B02,083740,Staff,30,0,30,0
1649928289996,MATH 18,A01,083743,Staff,22,0,30,8
1649928289996,MATH 18,A02,083744,Staff,29,0,30,1
1649928289996,MATH 18,A03,083745,Staff,29,0,30,1
1649928289996,MATH 18,A04,083746,Staff,28,0,30,2
1649928289996,MATH 18,B01,083748,Staff,5,0,30,25
1649928289996,MATH 18,B02,083749,Staff,26,0,30,4
1649928289996,MATH 18,B03,083750,Staff,28,0,30,2
1649928289996,MATH 18,B04,083751,Staff,26,0,30,4
1649928296020,MATH 20A,A01,083754,Staff,37,0,40,3
1649928302044,MATH 20B,A01,083756,Staff,19,0,30,11
1649928302044,MATH 20B,A02,083757,Staff,30,0,30,0
1649928308068,MATH 20C,A01,083760,Staff,22,0,30,8
1649928308068,MATH 20C,A02,083761,Staff,23,0,30,7
1649928308068,MATH 20C,B01,083762,Staff,28,0,30,2
1649928308068,MATH 20C,B02,083763,Staff,30,0,30,0
1649928314095,MATH 20D,A01,083765,Staff,20,0,30,10
1649928314095,MATH 20D,A02,083766,Staff,30,0,30,0
1649928314095,MATH 20D,A03,083767,Staff,30,0,30,0
1649928320119,MATH 20E,A01,083771,Staff,12,0,30,18
1649928320119,MATH 20E,A02,083772,Staff,24,0,30,6
1649928320119,MATH 20E,B01,083773,Staff,17,0,30,13
1649928320119,MATH 20E,B02,083774,Staff,29,0,30,1
1649928326141,MATH 103A,A01,083777,Staff,1,4,30,29
1649928326141,MATH 103A,A02,083778,Staff,0,3,30,30
1649928326141,MATH 103A,B01,083779,Staff,0,0,30,30
1649928326141,MATH 103A,B02,083780,Staff,16,0,30,14
1649928332167,MATH 105,A01,085443,Staff,0,5,30,30
1649928338191,MATH 109,A01,083213,Anzaldo; Leesa B,14,0,30,16
1649928338191,MATH 109,A02,083214,Anzaldo; Leesa B,9,0,30,21
1649928338191,MATH 109,B01,083215,Anzaldo; Leesa B,26,0,30,4
1649928338191,MATH 109,B02,083216,Anzaldo; Leesa B,22,0,30,8
1649928344216,MATH 142A,A01,083219,Chow; Bennett,0,1,30,30
1649928344216,MATH 142A,A02,083220,Chow; Bennett,9,0,30,21
1649928344216,MATH 142A,B01,083221,Chow; Bennett,0,0,30,30
1649928344216,MATH 142A,B02,083222,Chow; Bennett,1,0,30,29
1649928350244,MATH 193A,A01,083224,Staff,0,3,30,30
1649928350244,MATH 193A,A02,083225,Staff,0,3,30,30
1649928350244,MATH 193A,A03,083781,Staff,4,0,30,26
1649928350244,MATH 193A,A04,083782,Staff,16,0,30,14
1649928356265,MATH 197,001,091859,McAuley; Julian John,9999,0,9999,0
1649928362316,COGS 9,A01,083615,Staff,16,0,60,44
1649928368339,COGS 11,A01,083617,Boyle; Mary E. T.,35,0,40,5
1649928374366,COGS 13,A01,083071,Staff,0,11,40,40
1649928380389,COGS 14A,A01,092681,Staff,65,0,100,35
1649928386413,COGS 14B,A01,083073,Cheng; Tzu-Han,24,0,50,26
1649928392438,COGS 17,A01,092677,Staff,63,0,75,12
1649928398461,COGS 100,A01,083619,Staff,0,5,60,60
1649928404490,COGS 101A,A01,083621,Davis; Joshua Daniel,0,8,60,60
1649928410514,COGS 101B,A01,091572,Staff,32,0,60,28
1649928416539,COGS 101C,A01,083625,Delgado; Tania,24,0,30,6
1649928422563,COGS 107A,A01,083627,Boyle; Mary E. T.,14,0,60,46
1649928428589,COGS 118A,A01,083075,Staff,21,0,60,39
1649928434613,CSE 3,A50,083646,Miranda; Gregory Joseph,24,0,38,14
1649928434613,CSE 3,A51,083647,Miranda; Gregory Joseph,37,0,37,0
1649928440635,CSE 8A,A50,083650,Miranda; Gregory Joseph,8,0,40,32
1649928446663,CSE 11,A01,083080,Cao; Yingjun,0,26,40,40
1649928452686,CSE 12,A01,083652,Staff,56,0,100,44
1649928458714,CSE 15L,A01,083654,Staff,19,0,50,31
1649928458714,CSE 15L,A02,083655,Staff,47,0,50,3
1649928464740,CSE 20,A01,083657,Staff,68,0,80,12
1649928470765,CSE 30,A01,083084,Eldon; John,0,24,40,40
1649928476791,CSE 100,A01,083659,Cao; Yingjun,1,27,50,49
1649928482821,CSE 134B,A01,083661,Powell; Thomas Allan,0,21,65,65
1649928488847,CSE 140,A01,083663,Staff,24,0,75,51
1649928494876,CSE 140L,A01,083088,Eldon; John,18,0,75,57
1649928500903,CSE 175,A01,083665,Kumar; Rakesh,12,0,25,13
1649928506926,CSE 190,A00,092507,Dubnov; Shlomo,14,0,15,1
1649928512953,ECE 45,A01,083139,Staff,6,0,40,34
1649928518979,ECE 65,A50,083695,Staff,7,0,30,23
1649928525007,ECE 109,A01,091882,Touri; Behrouz,55,0,70,15
1649928531043,ECE 180,A00,083140,Abi Samra; Nicholas Camill,26,0,30,4
1649928531043,ECE 180,B00,083141,Abi Samra; Nicholas Camill,13,0,30,17
1649928537066,MATH 10A,A01,083735,Patchell; Gregory David,20,0,30,10
1649928537066,MATH 10A,A02,083736,Patchell; Gregory David,28,0,30,2
1649928537066,MATH 10A,A03,083737,Patchell; Gregory David,28,0,30,2
1649928543090,MATH 10B,A01,083207,Staff,10,0,30,20
1649928543090,MATH 10B,A02,083208,Staff,25,0,30,5
1649928543090,MATH 10B,B01,083739,Staff,25,0,30,5
1649928543090,MATH 10B,B02,083740,Staff,30,0,30,0
1649928549115,MATH 18,A01,083743,Staff,22,0,30,8
1649928549115,MATH 18,A02,083744,Staff,29,0,30,1
1649928549115,MATH 18,A03,083745,Staff,29,0,30,1
1649928549115,MATH 18,A04,083746,Staff,28,0,30,2
1649928549115,MATH 18,B01,083748,Staff,5,0,30,25
1649928549115,MATH 18,B02,083749,Staff,26,0,30,4
1649928549115,MATH 18,B03,083750,Staff,28,0,30,2
1649928549115,MATH 18,B04,083751,Staff,26,0,30,4
1649928555139,MATH 20A,A01,083754,Staff,37,0,40,3
1649928561164,MATH 20B,A01,083756,Staff,19,0,30,11
1649928561164,MATH 20B,A02,083757,Staff,30,0,30,0
1649928567186,MATH 20C,A01,083760,Staff,22,0,30,8
1649928567186,MATH 20C,A02,083761,Staff,23,0,30,7
1649928567186,MATH 20C,B01,083762,Staff,28,0,30,2
1649928567186,MATH 20C,B02,083763,Staff,30,0,30,0
1649928573212,MATH 20D,A01,083765,Staff,20,0,30,10
1649928573212,MATH 20D,A02,083766,Staff,30,0,30,0
1649928573212,MATH 20D,A03,083767,Staff,30,0,30,0
1649928579236,MATH 20E,A01,083771,Staff,12,0,30,18
1649928579236,MATH 20E,A02,083772,Staff,24,0,30,6
1649928579236,MATH 20E,B01,083773,Staff,17,0,30,13
1649928579236,MATH 20E,B02,083774,Staff,29,0,30,1
1649928585262,MATH 103A,A01,083777,Staff,1,4,30,29
1649928585262,MATH 103A,A02,083778,Staff,0,3,30,30
1649928585262,MATH 103A,B01,083779,Staff,0,0,30,30
1649928585262,MATH 103A,B02,083780,Staff,16,0,30,14
1649928591288,MATH 105,A01,085443,Staff,0,5,30,30
1649928597312,MATH 109,A01,083213,Anzaldo; Leesa B,14,0,30,16
1649928597312,MATH 109,A02,083214,Anzaldo; Leesa B,9,0,30,21
1649928597312,MATH 109,B01,083215,Anzaldo; Leesa B,26,0,30,4
1649928597312,MATH 109,B02,083216,Anzaldo; Leesa B,22,0,30,8
1649928603340,MATH 142A,A01,083219,Chow; Bennett,0,1,30,30
1649928603340,MATH 142A,A02,083220,Chow; Bennett,9,0,30,21
1649928603340,MATH 142A,B01,083221,Chow; Bennett,0,0,30,30
1649928603340,MATH 142A,B02,083222,Chow; Bennett,1,0,30,29
1649928609365,MATH 193A,A01,083224,Staff,0,3,30,30
1649928609365,MATH 193A,A02,083225,Staff,0,3,30,30
1649928609365,MATH 193A,A03,083781,Staff,4,0,30,26
1649928609365,MATH 193A,A04,083782,Staff,16,0,30,14
1649928615390,MATH 197,001,091859,McAuley; Julian John,9999,0,9999,0
1649928621524,COGS 9,A01,083615,Staff,16,0,60,44
1649928627545,COGS 11,A01,083617,Boyle; Mary E. T.,35,0,40,5
1649928633571,COGS 13,A01,083071,Staff,0,11,40,40
1649928639597,COGS 14A,A01,092681,Staff,65,0,100,35
1649928645620,COGS 14B,A01,083073,Cheng; Tzu-Han,24,0,50,26
1649928651643,COGS 17,A01,092677,Staff,63,0,75,12
1649928657665,COGS 100,A01,083619,Staff,0,5,60,60
1649928663689,COGS 101A,A01,083621,Davis; Joshua Daniel,0,8,60,60
1649928669713,COGS 101B,A01,091572,Staff,32,0,60,28
1649928675734,COGS 101C,A01,083625,Delgado; Tania,24,0,30,6
1649928681760,COGS 107A,A01,083627,Boyle; Mary E. T.,14,0,60,46
1649928687786,COGS 118A,A01,083075,Staff,21,0,60,39
1649928693808,CSE 3,A50,083646,Miranda; Gregory Joseph,24,0,38,14
1649928693808,CSE 3,A51,083647,Miranda; Gregory Joseph,37,0,37,0
1649928699834,CSE 8A,A50,083650,Miranda; Gregory Joseph,8,0,40,32
1649928705858,CSE 11,A01,083080,Cao; Yingjun,0,26,40,40
1649928711882,CSE 12,A01,083652,Staff,56,0,100,44
1649928717904,CSE 15L,A01,083654,Staff,19,0,50,31
1649928717904,CSE 15L,A02,083655,Staff,47,0,50,3
1649928723928,CSE 20,A01,083657,Staff,68,0,80,12
1649928729950,CSE 30,A01,083084,Eldon; John,0,24,40,40
1649928735974,CSE 100,A01,083659,Cao; Yingjun,1,27,50,49
1649928741997,CSE 134B,A01,083661,Powell; Thomas Allan,0,21,65,65
1649928748025,CSE 140,A01,083663,Staff,24,0,75,51
1649928754049,CSE 140L,A01,083088,Eldon; John,18,0,75,57
1649928760074,CSE 175,A01,083665,Kumar; Rakesh,12,0,25,13
1649928766101,CSE 190,A00,092507,Dubnov; Shlomo,14,0,15,1
1649928772127,ECE 45,A01,083139,Staff,6,0,40,34
1649928778152,ECE 65,A50,083695,Staff,7,0,30,23
1649928784184,ECE 109,A01,091882,Touri; Behrouz,55,0,70,15
1649928790207,ECE 180,A00,083140,Abi Samra; Nicholas Camill,26,0,30,4
1649928790207,ECE 180,B00,083141,Abi Samra; Nicholas Camill,13,0,30,17
1649928796235,MATH 10A,A01,083735,Patchell; Gregory David,20,0,30,10
1649928796235,MATH 10A,A02,083736,Patchell; Gregory David,28,0,30,2
1649928796235,MATH 10A,A03,083737,Patchell; Gregory David,28,0,30,2
1649928802262,MATH 10B,A01,083207,Staff,10,0,30,20
1649928802262,MATH 10B,A02,083208,Staff,25,0,30,5
1649928802262,MATH 10B,B01,083739,Staff,25,0,30,5
1649928802262,MATH 10B,B02,083740,Staff,30,0,30,0
1649928808287,MATH 18,A01,083743,Staff,22,0,30,8
1649928808287,MATH 18,A02,083744,Staff,29,0,30,1
1649928808287,MATH 18,A03,083745,Staff,29,0,30,1
1649928808287,MATH 18,A04,083746,Staff,28,0,30,2
1649928808287,MATH 18,B01,083748,Staff,5,0,30,25
1649928808287,MATH 18,B02,083749,Staff,26,0,30,4
1649928808287,MATH 18,B03,083750,Staff,28,0,30,2
1649928808287,MATH 18,B04,083751,Staff,26,0,30,4
1649928814310,MATH 20A,A01,083754,Staff,37,0,40,3
1649928820333,MATH 20B,A01,083756,Staff,19,0,30,11
1649928820333,MATH 20B,A02,083757,Staff,30,0,30,0
1649928826371,MATH 20C,A01,083760,Staff,22,0,30,8
1649928826371,MATH 20C,A02,083761,Staff,23,0,30,7
1649928826371,MATH 20C,B01,083762,Staff,28,0,30,2
1649928826371,MATH 20C,B02,083763,Staff,30,0,30,0
1649928832400,MATH 20D,A01,083765,Staff,20,0,30,10
1649928832400,MATH 20D,A02,083766,Staff,30,0,30,0
1649928832400,MATH 20D,A03,083767,Staff,30,0,30,0
1649928838427,MATH 20E,A01,083771,Staff,12,0,30,18
1649928838427,MATH 20E,A02,083772,Staff,24,0,30,6
1649928838427,MATH 20E,B01,083773,Staff,17,0,30,13
1649928838427,MATH 20E,B02,083774,Staff,29,0,30,1
1649928844449,MATH 103A,A01,083777,Staff,1,4,30,29
1649928844449,MATH 103A,A02,083778,Staff,0,3,30,30
1649928844449,MATH 103A,B01,083779,Staff,0,0,30,30
1649928844449,MATH 103A,B02,083780,Staff,16,0,30,14
1649928850481,MATH 105,A01,085443,Staff,0,5,30,30
1649928856505,MATH 109,A01,083213,Anzaldo; Leesa B,14,0,30,16
1649928856505,MATH 109,A02,083214,Anzaldo; Leesa B,9,0,30,21
1649928856505,MATH 109,B01,083215,Anzaldo; Leesa B,26,0,30,4
1649928856505,MATH 109,B02,083216,Anzaldo; Leesa B,22,0,30,8
1649928862530,MATH 142A,A01,083219,Chow; Bennett,0,1,30,30
1649928862530,MATH 142A,A02,083220,Chow; Bennett,9,0,30,21
1649928862530,MATH 142A,B01,083221,Chow; Bennett,0,0,30,30
1649928862530,MATH 142A,B02,083222,Chow; Bennett,1,0,30,29
1649928868552,MATH 193A,A01,083224,Staff,0,3,30,30
1649928868552,MATH 193A,A02,083225,Staff,0,3,30,30
1649928868552,MATH 193A,A03,083781,Staff,4,0,30,26
1649928868552,MATH 193A,A04,083782,Staff,16,0,30,14
1649928874576,MATH 197,001,091859,McAuley; Julian John,9999,0,9999,0
1649928880626,COGS 9,A01,083615,Staff,16,0,60,44
1649928886649,COGS 11,A01,083617,Boyle; Mary E. T.,35,0,40,5
1649928892671,COGS 13,A01,083071,Staff,0,11,40,40
1649928898696,COGS 14A,A01,092681,Staff,65,0,100,35
1649928904718,COGS 14B,A01,083073,Cheng; Tzu-Han,24,0,50,26
1649928910741,COGS 17,A01,092677,Staff,63,0,75,12
1649928916763,COGS 100,A01,083619,Staff,0,5,60,60
1649928922790,COGS 101A,A01,083621,Davis; Joshua Daniel,0,8,60,60
1649928928815,COGS 101B,A01,091572,Staff,32,0,60,28
1649928934841,COGS 101C,A01,083625,Delgado; Tania,24,0,30,6
1649928940864,COGS 107A,A01,083627,Boyle; Mary E. T.,14,0,60,46
1649928946887,COGS 118A,A01,083075,Staff,21,0,60,39
1649928952911,CSE 3,A50,083646,Miranda; Gregory Joseph,24,0,38,14
1649928952911,CSE 3,A51,083647,Miranda; Gregory Joseph,37,0,37,0
1649928958938,CSE 8A,A50,083650,Miranda; Gregory Joseph,8,0,40,32
1649928964960,CSE 11,A01,083080,Cao; Yingjun,0,26,40,40
1649928970984,CSE 12,A01,083652,Staff,56,0,100,44
1649928977010,CSE 15L,A01,083654,Staff,19,0,50,31
1649928977010,CSE 15L,A02,083655,Staff,47,0,50,3
1649928983033,CSE 20,A01,083657,Staff,68,0,80,12
1649928989059,CSE 30,A01,083084,Eldon; John,0,24,40,40
1649928995086,CSE 100,A01,083659,Cao; Yingjun,1,27,50,49
1649929001109,CSE 134B,A01,083661,Powell; Thomas Allan,0,21,65,65
1649929007133,CSE 140,A01,083663,Staff,24,0,75,51
1649929013156,CSE 140L,A01,083088,Eldon; John,18,0,75,57
1649929019182,CSE 175,A01,083665,Kumar; Rakesh,12,0,25,13
1649929025205,CSE 190,A00,092507,Dubnov; Shlomo,14,0,15,1
1649929031228,ECE 45,A01,083139,Staff,6,0,40,34
1649929037251,ECE 65,A50,083695,Staff,7,0,30,23
1649929043276,ECE 109,A01,091882,Touri; Behrouz,55,0,70,15
1649929049298,ECE 180,A00,083140,Abi Samra; Nicholas Camill,26,0,30,4
1649929049298,ECE 180,B00,083141,Abi Samra; Nicholas Camill,13,0,30,17
1649929055324,MATH 10A,A01,083735,Patchell; Gregory David,20,0,30,10
1649929055324,MATH 10A,A02,083736,Patchell; Gregory David,28,0,30,2
1649929055324,MATH 10A,A03,083737,Patchell; Gregory David,28,0,30,2
1649929061352,MATH 10B,A01,083207,Staff,10,0,30,20
1649929061352,MATH 10B,A02,083208,Staff,25,0,30,5
1649929061352,MATH 10B,B01,083739,Staff,25,0,30,5
1649929061352,MATH 10B,B02,083740,Staff,30,0,30,0
1649929067382,MATH 18,A01,083743,Staff,22,0,30,8
1649929067382,MATH 18,A02,083744,Staff,29,0,30,1
1649929067382,MATH 18,A03,083745,Staff,29,0,30,1
1649929067382,MATH 18,A04,083746,Staff,28,0,30,2
1649929067382,MATH 18,B01,083748,Staff,5,0,30,25
1649929067382,MATH 18,B02,083749,Staff,26,0,30,4
1649929067382,MATH 18,B03,083750,Staff,28,0,30,2
1649929067382,MATH 18,B04,083751,Staff,26,0,30,4
1649929073405,MATH 20A,A01,083754,Staff,37,0,40,3
1649929079429,MATH 20B,A01,083756,Staff,19,0,30,11
1649929079429,MATH 20B,A02,083757,Staff,30,0,30,0
1649929085453,MATH 20C,A01,083760,Staff,22,0,30,8
1649929085453,MATH 20C,A02,083761,Staff,23,0,30,7
1649929085453,MATH 20C,B01,083762,Staff,28,0,30,2
1649929085453,MATH 20C,B02,083763,Staff,30,0,30,0
1649929091477,MATH 20D,A01,083765,Staff,20,0,30,10
1649929091477,MATH 20D,A02,083766,Staff,30,0,30,0
1649929091477,MATH 20D,A03,083767,Staff,30,0,30,0
1649929097505,MATH 20E,A01,083771,Staff,12,0,30,18
1649929097505,MATH 20E,A02,083772,Staff,24,0,30,6
1649929097505,MATH 20E,B01,083773,Staff,17,0,30,13
1649929097505,MATH 20E,B02,083774,Staff,29,0,30,1
1649929103530,MATH 103A,A01,083777,Staff,1,4,30,29
1649929103530,MATH 103A,A02,083778,Staff,0,3,30,30
1649929103530,MATH 103A,B01,083779,Staff,0,0,30,30
1649929103530,MATH 103A,B02,083780,Staff,16,0,30,14
1649929109554,MATH 105,A01,085443,Staff,0,5,30,30
1649929115578,MATH 109,A01,083213,Anzaldo; Leesa B,14,0,30,16
1649929115578,MATH 109,A02,083214,Anzaldo; Leesa B,9,0,30,21
1649929115578,MATH 109,B01,083215,Anzaldo; Leesa B,26,0,30,4
1649929115578,MATH 109,B02,083216,Anzaldo; Leesa B,22,0,30,8
1649929121601,MATH 142A,A01,083219,Chow; Bennett,0,1,30,30
1649929121601,MATH 142A,A02,083220,Chow; Bennett,9,0,30,21
1649929121601,MATH 142A,B01,083221,Chow; Bennett,0,0,30,30
1649929121601,MATH 142A,B02,083222,Chow; Bennett,1,0,30,29
1649929127623,MATH 193A,A01,083224,Staff,0,3,30,30
1649929127623,MATH 193A,A02,083225,Staff,0,3,30,30
1649929127623,MATH 193A,A03,083781,Staff,4,0,30,26
1649929127623,MATH 193A,A04,083782,Staff,16,0,30,14
1649929133647,MATH 197,001,091859,McAuley; Julian John,9999,0,9999,0
1649929139703,COGS 9,A01,083615,Staff,16,0,60,44
1649929145729,COGS 11,A01,083617,Boyle; Mary E. T.,35,0,40,5
1649929151757,COGS 13,A01,083071,Staff,0,11,40,40
1649929157779,COGS 14A,A01,092681,Staff,65,0,100,35
1649929163803,COGS 14B,A01,083073,Cheng; Tzu-Han,24,0,50,26
1649929169829,COGS 17,A01,092677,Staff,63,0,75,12
1649929175853,COGS 100,A01,083619,Staff,0,5,60,60
1649929181879,COGS 101A,A01,083621,Davis; Joshua Daniel,0,8,60,60
1649929187903,COGS 101B,A01,091572,Staff,32,0,60,28
1649929193929,COGS 101C,A01,083625,Delgado; Tania,24,0,30,6
1649929199954,COGS 107A,A01,083627,Boyle; Mary E. T.,14,0,60,46
1649929205977,COGS 118A,A01,083075,Staff,21,0,60,39
1649929212075,CSE 3,A50,083646,Miranda; Gregory Joseph,24,0,38,14
1649929212075,CSE 3,A51,083647,Miranda; Gregory Joseph,37,0,37,0
1649929218101,CSE 8A,A50,083650,Miranda; Gregory Joseph,8,0,40,32
1649929224127,CSE 11,A01,083080,Cao; Yingjun,0,26,40,40
1649929230152,CSE 12,A01,083652,Staff,56,0,100,44
1649929236179,CSE 15L,A01,083654,Staff,19,0,50,31
1649929236179,CSE 15L,A02,083655,Staff,47,0,50,3
1649929242205,CSE 20,A01,083657,Staff,68,0,80,12
1649929248228,CSE 30,A01,083084,Eldon; John,0,24,40,40
1649929254251,CSE 100,A01,083659,Cao; Yingjun,1,27,50,49
1649929260276,CSE 134B,A01,083661,Powell; Thomas Allan,0,21,65,65
1649929266309,CSE 140,A01,083663,Staff,24,0,75,51
1649929272336,CSE 140L,A01,083088,Eldon; John,18,0,75,57
1649929278364,CSE 175,A01,083665,Kumar; Rakesh,12,0,25,13
1649929284387,CSE 190,A00,092507,Dubnov; Shlomo,14,0,15,1
1649929290417,ECE 45,A01,083139,Staff,6,0,40,34
1649929296441,ECE 65,A50,083695,Staff,7,0,30,23
1649929302464,ECE 109,A01,091882,Touri; Behrouz,55,0,70,15
1649929308488,ECE 180,A00,083140,Abi Samra; Nicholas Camill,26,0,30,4
1649929308488,ECE 180,B00,083141,Abi Samra; Nicholas Camill,13,0,30,17
1649929314511,MATH 10A,A01,083735,Patchell; Gregory David,20,0,30,10
1649929314511,MATH 10A,A02,083736,Patchell; Gregory David,28,0,30,2
1649929314511,MATH 10A,A03,083737,Patchell; Gregory David,28,0,30,2
1649929320551,MATH 10B,A01,083207,Staff,10,0,30,20
1649929320551,MATH 10B,A02,083208,Staff,25,0,30,5
1649929320551,MATH 10B,B01,083739,Staff,25,0,30,5
1649929320551,MATH 10B,B02,083740,Staff,30,0,30,0
1649929326587,MATH 18,A01,083743,Staff,22,0,30,8
1649929326587,MATH 18,A02,083744,Staff,29,0,30,1
1649929326587,MATH 18,A03,083745,Staff,29,0,30,1
1649929326587,MATH 18,A04,083746,Staff,28,0,30,2
1649929326587,MATH 18,B01,083748,Staff,5,0,30,25
1649929326587,MATH 18,B02,083749,Staff,26,0,30,4
1649929326587,MATH 18,B03,083750,Staff,28,0,30,2
1649929326587,MATH 18,B04,083751,Staff,26,0,30,4
1649929332612,MATH 20A,A01,083754,Staff,37,0,40,3
1649929338633,MATH 20B,A01,083756,Staff,19,0,30,11
1649929338633,MATH 20B,A02,083757,Staff,30,0,30,0
1649929344657,MATH 20C,A01,083760,Staff,22,0,30,8
1649929344657,MATH 20C,A02,083761,Staff,23,0,30,7
1649929344657,MATH 20C,B01,083762,Staff,28,0,30,2
1649929344657,MATH 20C,B02,083763,Staff,30,0,30,0
1649929350680,MATH 20D,A01,083765,Staff,20,0,30,10
1649929350680,MATH 20D,A02,083766,Staff,30,0,30,0
1649929350680,MATH 20D,A03,083767,Staff,30,0,30,0
1649929356704,MATH 20E,A01,083771,Staff,12,0,30,18
1649929356704,MATH 20E,A02,083772,Staff,24,0,30,6
1649929356704,MATH 20E,B01,083773,Staff,17,0,30,13
1649929356704,MATH 20E,B02,083774,Staff,29,0,30,1
1649929362727,MATH 103A,A01,083777,Staff,1,4,30,29
1649929362727,MATH 103A,A02,083778,Staff,0,3,30,30
1649929362727,MATH 103A,B01,083779,Staff,0,0,30,30
1649929362727,MATH 103A,B02,083780,Staff,16,0,30,14
1649929368751,MATH 105,A01,085443,Staff,0,5,30,30
1649929374776,MATH 109,A01,083213,Anzaldo; Leesa B,14,0,30,16
1649929374776,MATH 109,A02,083214,Anzaldo; Leesa B,9,0,30,21
1649929374776,MATH 109,B01,083215,Anzaldo; Leesa B,26,0,30,4
1649929374776,MATH 109,B02,083216,Anzaldo; Leesa B,22,0,30,8
1649929380801,MATH 142A,A01,083219,Chow; Bennett,0,1,30,30
1649929380801,MATH 142A,A02,083220,Chow; Bennett,9,0,30,21
1649929380801,MATH 142A,B01,083221,Chow; Bennett,0,0,30,30
1649929380801,MATH 142A,B02,083222,Chow; Bennett,1,0,30,29
1649929386829,MATH 193A,A01,083224,Staff,0,3,30,30
1649929386829,MATH 193A,A02,083225,Staff,0,3,30,30
1649929386829,MATH 193A,A03,083781,Staff,4,0,30,26
1649929386829,MATH 193A,A04,083782,Staff,16,0,30,14
1649929392862,MATH 197,001,091859,McAuley; Julian John,9999,0,9999,0
1649929398925,COGS 9,A01,083615,Staff,16,0,60,44
1649929404951,COGS 11,A01,083617,Boyle; Mary E. T.,35,0,40,5
1649929410974,COGS 13,A01,083071,Staff,0,11,40,40
1649929417001,COGS 14A,A01,092681,Staff,65,0,100,35
1649929423027,COGS 14B,A01,083073,Cheng; Tzu-Han,24,0,50,26
1649929429051,COGS 17,A01,092677,Staff,63,0,75,12
1649929435078,COGS 100,A01,083619,Staff,0,5,60,60
1649929441111,COGS 101A,A01,083621,Davis; Joshua Daniel,0,8,60,60
1649929447134,COGS 101B,A01,091572,Staff,32,0,60,28
1649929453162,COGS 101C,A01,083625,Delgado; Tania,24,0,30,6
1649929459188,COGS 107A,A01,083627,Boyle; Mary E. T.,14,0,60,46
1649929465213,COGS 118A,A01,083075,Staff,21,0,60,39
1649929471236,CSE 3,A50,083646,Miranda; Gregory Joseph,24,0,38,14
1649929471236,CSE 3,A51,083647,Miranda; Gregory Joseph,37,0,37,0
1649929477269,CSE 8A,A50,083650,Miranda; Gregory Joseph,8,0,40,32
1649929483296,CSE 11,A01,083080,Cao; Yingjun,0,26,40,40
1649929489323,CSE 12,A01,083652,Staff,56,0,100,44
1649929495346,CSE 15L,A01,083654,Staff,19,0,50,31
1649929495346,CSE 15L,A02,083655,Staff,47,0,50,3
1649929501371,CSE 20,A01,083657,Staff,68,0,80,12
1649929507394,CSE 30,A01,083084,Eldon; John,0,24,40,40
1649929513416,CSE 100,A01,083659,Cao; Yingjun,1,27,50,49
1649929519439,CSE 134B,A01,083661,Powell; Thomas Allan,0,21,65,65
1649929525465,CSE 140,A01,083663,Staff,24,0,75,51
1649929531486,CSE 140L,A01,083088,Eldon; John,18,0,75,57
1649929537509,CSE 175,A01,083665,Kumar; Rakesh,12,0,25,13
1649929543535,CSE 190,A00,092507,Dubnov; Shlomo,14,0,15,1
1649929549561,ECE 45,A01,083139,Staff,6,0,40,34
1649929555584,ECE 65,A50,083695,Staff,7,0,30,23
1649929561609,ECE 109,A01,091882,Touri; Behrouz,55,0,70,15
1649929567636,ECE 180,A00,083140,Abi Samra; Nicholas Camill,26,0,30,4
1649929567636,ECE 180,B00,083141,Abi Samra; Nicholas Camill,13,0,30,17
1649929573661,MATH 10A,A01,083735,Patchell; Gregory David,20,0,30,10
1649929573661,MATH 10A,A02,083736,Patchell; Gregory David,28,0,30,2
1649929573661,MATH 10A,A03,083737,Patchell; Gregory David,28,0,30,2
1649929579691,MATH 10B,A01,083207,Staff,10,0,30,20
1649929579691,MATH 10B,A02,083208,Staff,25,0,30,5
1649929579691,MATH 10B,B01,083739,Staff,25,0,30,5
1649929579691,MATH 10B,B02,083740,Staff,30,0,30,0
1649929585715,MATH 18,A01,083743,Staff,22,0,30,8
1649929585715,MATH 18,A02,083744,Staff,29,0,30,1
1649929585715,MATH 18,A03,083745,Staff,29,0,30,1
1649929585715,MATH 18,A04,083746,Staff,28,0,30,2
1649929585715,MATH 18,B01,083748,Staff,5,0,30,25
1649929585715,MATH 18,B02,083749,Staff,26,0,30,4
1649929585715,MATH 18,B03,083750,Staff,28,0,30,2
1649929585715,MATH 18,B04,083751,Staff,26,0,30,4
1649929591737,MATH 20A,A01,083754,Staff,37,0,40,3
1649929597761,MATH 20B,A01,083756,Staff,19,0,30,11
1649929597761,MATH 20B,A02,083757,Staff,30,0,30,0
1649929603785,MATH 20C,A01,083760,Staff,22,0,30,8
1649929603785,MATH 20C,A02,083761,Staff,23,0,30,7
1649929603785,MATH 20C,B01,083762,Staff,28,0,30,2
1649929603785,MATH 20C,B02,083763,Staff,30,0,30,0
1649929609806,MATH 20D,A01,083765,Staff,20,0,30,10
1649929609806,MATH 20D,A02,083766,Staff,30,0,30,0
1649929609806,MATH 20D,A03,083767,Staff,30,0,30,0
1649929615834,MATH 20E,A01,083771,Staff,12,0,30,18
1649929615834,MATH 20E,A02,083772,Staff,24,0,30,6
1649929615834,MATH 20E,B01,083773,Staff,17,0,30,13
1649929615834,MATH 20E,B02,083774,Staff,29,0,30,1
1649929621858,MATH 103A,A01,083777,Staff,1,4,30,29
1649929621858,MATH 103A,A02,083778,Staff,0,3,30,30
1649929621858,MATH 103A,B01,083779,Staff,0,0,30,30
1649929621858,MATH 103A,B02,083780,Staff,16,0,30,14
1649929627883,MATH 105,A01,085443,Staff,0,5,30,30
1649929633909,MATH 109,A01,083213,Anzaldo; Leesa B,14,0,30,16
1649929633909,MATH 109,A02,083214,Anzaldo; Leesa B,9,0,30,21
1649929633909,MATH 109,B01,083215,Anzaldo; Leesa B,26,0,30,4
1649929633909,MATH 109,B02,083216,Anzaldo; Leesa B,22,0,30,8
1649929639932,MATH 142A,A01,083219,Chow; Bennett,0,1,30,30
1649929639932,MATH 142A,A02,083220,Chow; Bennett,9,0,30,21
1649929639932,MATH 142A,B01,083221,Chow; Bennett,0,0,30,30
1649929639932,MATH 142A,B02,083222,Chow; Bennett,1,0,30,29
1649929645959,MATH 193A,A01,083224,Staff,0,3,30,30
1649929645959,MATH 193A,A02,083225,Staff,0,3,30,30
1649929645959,MATH 193A,A03,083781,Staff,4,0,30,26
1649929645959,MATH 193A,A04,083782,Staff,16,0,30,14
1649929651983,MATH 197,001,091859,McAuley; Julian John,9999,0,9999,0
1649929658036,COGS 9,A01,083615,Staff,16,0,60,44
1649929664060,COGS 11,A01,083617,Boyle; Mary E. T.,35,0,40,5
1649929670089,COGS 13,A01,083071,Staff,0,11,40,40
1649929676111,COGS 14A,A01,092681,Staff,65,0,100,35
1649929682137,COGS 14B,A01,083073,Cheng; Tzu-Han,24,0,50,26
1649929688164,COGS 17,A01,092677,Staff,63,0,75,12
1649929694193,COGS 100,A01,083619,Staff,0,5,60,60
1649929700219,COGS 101A,A01,083621,Davis; Joshua Daniel,0,8,60,60
1649929706241,COGS 101B,A01,091572,Staff,32,0,60,28
1649929712264,COGS 101C,A01,083625,Delgado; Tania,24,0,30,6
1649929718290,COGS 107A,A01,083627,Boyle; Mary E. T.,14,0,60,46
1649929724315,COGS 118A,A01,083075,Staff,21,0,60,39
1649929730341,CSE 3,A50,083646,Miranda; Gregory Joseph,24,0,38,14
1649929730341,CSE 3,A51,083647,Miranda; Gregory Joseph,37,0,37,0
1649929736373,CSE 8A,A50,083650,Miranda; Gregory Joseph,8,0,40,32
1649929742396,CSE 11,A01,083080,Cao; Yingjun,0,26,40,40
1649929748422,CSE 12,A01,083652,Staff,56,0,100,44
1649929754449,CSE 15L,A01,083654,Staff,19,0,50,31
1649929754449,CSE 15L,A02,083655,Staff,47,0,50,3
1649929760472,CSE 20,A01,083657,Staff,68,0,80,12
1649929766496,CSE 30,A01,083084,Eldon; John,0,24,40,40
1649929772523,CSE 100,A01,083659,Cao; Yingjun,1,27,50,49
1649929778547,CSE 134B,A01,083661,Powell; Thomas Allan,0,21,65,65
1649929784573,CSE 140,A01,083663,Staff,24,0,75,51
1649929790597,CSE 140L,A01,083088,Eldon; John,18,0,75,57
1649929796624,CSE 175,A01,083665,Kumar; Rakesh,12,0,25,13
1649929802651,CSE 190,A00,092507,Dubnov; Shlomo,14,0,15,1
1649929808756,ECE 45,A01,083139,Staff,6,0,40,34
1649929814784,ECE 65,A50,083695,Staff,7,0,30,23
1649929820808,ECE 109,A01,091882,Touri; Behrouz,55,0,70,15
1649929826833,ECE 180,A00,083140,Abi Samra; Nicholas Camill,26,0,30,4
1649929826833,ECE 180,B00,083141,Abi Samra; Nicholas Camill,13,0,30,17
1649929832860,MATH 10A,A01,083735,Patchell; Gregory David,20,0,30,10
1649929832860,MATH 10A,A02,083736,Patchell; Gregory David,28,0,30,2
1649929832860,MATH 10A,A03,083737,Patchell; Gregory David,28,0,30,2
1649929838887,MATH 10B,A01,083207,Staff,10,0,30,20
1649929838887,MATH 10B,A02,083208,Staff,25,0,30,5
1649929838887,MATH 10B,B01,083739,Staff,25,0,30,5
1649929838887,MATH 10B,B02,083740,Staff,30,0,30,0
1649929844917,MATH 18,A01,083743,Staff,22,0,30,8
1649929844917,MATH 18,A02,083744,Staff,29,0,30,1
1649929844917,MATH 18,A03,083745,Staff,29,0,30,1
1649929844917,MATH 18,A04,083746,Staff,28,0,30,2
1649929844917,MATH 18,B01,083748,Staff,5,0,30,25
1649929844917,MATH 18,B02,083749,Staff,26,0,30,4
1649929844917,MATH 18,B03,083750,Staff,28,0,30,2
1649929844917,MATH 18,B04,083751,Staff,26,0,30,4
1649929850940,MATH 20A,A01,083754,Staff,37,0,40,3
1649929856961,MATH 20B,A01,083756,Staff,19,0,30,11
1649929856961,MATH 20B,A02,083757,Staff,30,0,30,0
1649929862985,MATH 20C,A01,083760,Staff,22,0,30,8
1649929862985,MATH 20C,A02,083761,Staff,23,0,30,7
1649929862985,MATH 20C,B01,083762,Staff,28,0,30,2
1649929862985,MATH 20C,B02,083763,Staff,30,0,30,0
1649929869011,MATH 20D,A01,083765,Staff,20,0,30,10
1649929869011,MATH 20D,A02,083766,Staff,30,0,30,0
1649929869011,MATH 20D,A03,083767,Staff,30,0,30,0
1649929875039,MATH 20E,A01,083771,Staff,12,0,30,18
1649929875039,MATH 20E,A02,083772,Staff,24,0,30,6
1649929875039,MATH 20E,B01,083773,Staff,17,0,30,13
1649929875039,MATH 20E,B02,083774,Staff,29,0,30,1
1649929881075,MATH 103A,A01,083777,Staff,1,4,30,29
1649929881075,MATH 103A,A02,083778,Staff,0,3,30,30
1649929881075,MATH 103A,B01,083779,Staff,0,0,30,30
1649929881075,MATH 103A,B02,083780,Staff,16,0,30,14
1649929887110,MATH 105,A01,085443,Staff,0,5,30,30
1649929893137,MATH 109,A01,083213,Anzaldo; Leesa B,13,0,30,17
1649929893137,MATH 109,A02,083214,Anzaldo; Leesa B,9,0,30,21
1649929893137,MATH 109,B01,083215,Anzaldo; Leesa B,26,0,30,4
1649929893137,MATH 109,B02,083216,Anzaldo; Leesa B,22,0,30,8
1649929899162,MATH 142A,A01,083219,Chow; Bennett,0,1,30,30
1649929899162,MATH 142A,A02,083220,Chow; Bennett,9,0,30,21
1649929899162,MATH 142A,B01,083221,Chow; Bennett,0,0,30,30
1649929899162,MATH 142A,B02,083222,Chow; Bennett,1,0,30,29
1649929905189,MATH 193A,A01,083224,Staff,0,3,30,30
1649929905189,MATH 193A,A02,083225,Staff,0,3,30,30
1649929905189,MATH 193A,A03,083781,Staff,4,0,30,26
1649929905189,MATH 193A,A04,083782,Staff,16,0,30,14
1649929911214,MATH 197,001,091859,McAuley; Julian John,9999,0,9999,0
1649929917278,COGS 9,A01,083615,Staff,16,0,60,44
1649929923305,COGS 11,A01,083617,Boyle; Mary E. T.,35,0,40,5
1649929929332,COGS 13,A01,083071,Staff,0,11,40,40
1649929935354,COGS 14A,A01,092681,Staff,65,0,100,35
1649929941383,COGS 14B,A01,083073,Cheng; Tzu-Han,24,0,50,26
1649929947407,COGS 17,A01,092677,Staff,63,0,75,12
1649929953433,COGS 100,A01,083619,Staff,0,5,60,60
1649929959459,COGS 101A,A01,083621,Davis; Joshua Daniel,0,8,60,60
1649929965488,COGS 101B,A01,091572,Staff,32,0,60,28
1649929971512,COGS 101C,A01,083625,Delgado; Tania,24,0,30,6
1649929977537,COGS 107A,A01,083627,Boyle; Mary E. T.,14,0,60,46
1649929983566,COGS 118A,A01,083075,Staff,21,0,60,39
1649929989589,CSE 3,A50,083646,Miranda; Gregory Joseph,24,0,38,14
1649929989589,CSE 3,A51,083647,Miranda; Gregory Joseph,37,0,37,0
1649929995615,CSE 8A,A50,083650,Miranda; Gregory Joseph,8,0,40,32
1649930001637,CSE 11,A01,083080,Cao; Yingjun,0,26,40,40
1649930007661,CSE 12,A01,083652,Staff,56,0,100,44
1649930013684,CSE 15L,A01,083654,Staff,19,0,50,31
1649930013684,CSE 15L,A02,083655,Staff,47,0,50,3
1649930019707,CSE 20,A01,083657,Staff,68,0,80,12
1649930025734,CSE 30,A01,083084,Eldon; John,0,24,40,40
1649930031765,CSE 100,A01,083659,Cao; Yingjun,1,27,50,49
1649930037791,CSE 134B,A01,083661,Powell; Thomas Allan,0,21,65,65
1649930043817,CSE 140,A01,083663,Staff,24,0,75,51
1649930049841,CSE 140L,A01,083088,Eldon; John,18,0,75,57
1649930055866,CSE 175,A01,083665,Kumar; Rakesh,12,0,25,13
1649930061889,CSE 190,A00,092507,Dubnov; Shlomo,14,0,15,1
1649930067915,ECE 45,A01,083139,Staff,6,0,40,34
1649930073943,ECE 65,A50,083695,Staff,7,0,30,23
1649930079969,ECE 109,A01,091882,Touri; Behrouz,55,0,70,15
1649930085997,ECE 180,A00,083140,Abi Samra; Nicholas Camill,26,0,30,4
1649930085997,ECE 180,B00,083141,Abi Samra; Nicholas Camill,13,0,30,17
1649930092021,MATH 10A,A01,083735,Patchell; Gregory David,20,0,30,10
1649930092021,MATH 10A,A02,083736,Patchell; Gregory David,28,0,30,2
1649930092021,MATH 10A,A03,083737,Patchell; Gregory David,28,0,30,2
1649930098049,MATH 10B,A01,083207,Staff,10,0,30,20
1649930098049,MATH 10B,A02,083208,Staff,25,0,30,5
1649930098049,MATH 10B,B01,083739,Staff,25,0,30,5
1649930098049,MATH 10B,B02,083740,Staff,30,0,30,0
1649930104075,MATH 18,A01,083743,Staff,22,0,30,8
1649930104075,MATH 18,A02,083744,Staff,29,0,30,1
1649930104075,MATH 18,A03,083745,Staff,29,0,30,1
1649930104075,MATH 18,A04,083746,Staff,28,0,30,2
1649930104075,MATH 18,B01,083748,Staff,5,0,30,25
1649930104075,MATH 18,B02,083749,Staff,26,0,30,4
1649930104075,MATH 18,B03,083750,Staff,28,0,30,2
1649930104075,MATH 18,B04,083751,Staff,26,0,30,4
1649930110101,MATH 20A,A01,083754,Staff,37,0,40,3
1649930116124,MATH 20B,A01,083756,Staff,19,0,30,11
1649930116124,MATH 20B,A02,083757,Staff,30,0,30,0
1649930122152,MATH 20C,A01,083760,Staff,22,0,30,8
1649930122152,MATH 20C,A02,083761,Staff,23,0,30,7
1649930122152,MATH 20C,B01,083762,Staff,28,0,30,2
1649930122152,MATH 20C,B02,083763,Staff,30,0,30,0
1649930128176,MATH 20D,A01,083765,Staff,20,0,30,10
1649930128176,MATH 20D,A02,083766,Staff,30,0,30,0
1649930128176,MATH 20D,A03,083767,Staff,30,0,30,0
1649930134200,MATH 20E,A01,083771,Staff,12,0,30,18
1649930134200,MATH 20E,A02,083772,Staff,24,0,30,6
1649930134200,MATH 20E,B01,083773,Staff,17,0,30,13
1649930134200,MATH 20E,B02,083774,Staff,29,0,30,1
1649930140229,MATH 103A,A01,083777,Staff,1,4,30,29
1649930140229,MATH 103A,A02,083778,Staff,0,3,30,30
1649930140229,MATH 103A,B01,083779,Staff,0,0,30,30
1649930140229,MATH 103A,B02,083780,Staff,16,0,30,14
1649930146264,MATH 105,A01,085443,Staff,0,5,30,30
1649930152292,MATH 109,A01,083213,Anzaldo; Leesa B,13,0,30,17
1649930152292,MATH 109,A02,083214,Anzaldo; Leesa B,9,0,30,21
1649930152292,MATH 109,B01,083215,Anzaldo; Leesa B,26,0,30,4
1649930152292,MATH 109,B02,083216,Anzaldo; Leesa B,22,0,30,8
1649930158319,MATH 142A,A01,083219,Chow; Bennett,0,1,30,30
1649930158319,MATH 142A,A02,083220,Chow; Bennett,9,0,30,21
1649930158319,MATH 142A,B01,083221,Chow; Bennett,0,0,30,30
1649930158319,MATH 142A,B02,083222,Chow; Bennett,1,0,30,29
1649930164342,MATH 193A,A01,083224,Staff,0,3,30,30
1649930164342,MATH 193A,A02,083225,Staff,0,3,30,30
1649930164342,MATH 193A,A03,083781,Staff,4,0,30,26
1649930164342,MATH 193A,A04,083782,Staff,16,0,30,14
1649930170372,MATH 197,001,091859,McAuley; Julian John,9999,0,9999,0
1649930176420,COGS 9,A01,083615,Staff,16,0,60,44
1649930182443,COGS 11,A01,083617,Boyle; Mary E. T.,35,0,40,5
1649930188468,COGS 13,A01,083071,Staff,0,11,40,40
1649930194495,COGS 14A,A01,092681,Staff,65,0,100,35
1649930200526,COGS 14B,A01,083073,Cheng; Tzu-Han,24,0,50,26
1649930206550,COGS 17,A01,092677,Staff,63,0,75,12
1649930212577,COGS 100,A01,083619,Staff,0,5,60,60
1649930218603,COGS 101A,A01,083621,Davis; Joshua Daniel,0,8,60,60
1649930224626,COGS 101B,A01,091572,Staff,32,0,60,28
1649930230651,COGS 101C,A01,083625,Delgado; Tania,24,0,30,6
1649930236675,COGS 107A,A01,083627,Boyle; Mary E. T.,14,0,60,46
1649930242699,COGS 118A,A01,083075,Staff,21,0,60,39
1649930248723,CSE 3,A50,083646,Miranda; Gregory Joseph,24,0,38,14
1649930248723,CSE 3,A51,083647,Miranda; Gregory Joseph,37,0,37,0
1649930254746,CSE 8A,A50,083650,Miranda; Gregory Joseph,8,0,40,32
1649930260768,CSE 11,A01,083080,Cao; Yingjun,0,26,40,40
1649930266795,CSE 12,A01,083652,Staff,56,0,100,44
1649930272819,CSE 15L,A01,083654,Staff,19,0,50,31
1649930272819,CSE 15L,A02,083655,Staff,47,0,50,3
1649930278848,CSE 20,A01,083657,Staff,68,0,80,12
1649930284872,CSE 30,A01,083084,Eldon; John,0,24,40,40
1649930290899,CSE 100,A01,083659,Cao; Yingjun,1,27,50,49
1649930296922,CSE 134B,A01,083661,Powell; Thomas Allan,0,21,65,65
1649930302946,CSE 140,A01,083663,Staff,24,0,75,51
1649930308970,CSE 140L,A01,083088,Eldon; John,18,0,75,57
1649930314996,CSE 175,A01,083665,Kumar; Rakesh,12,0,25,13
1649930321024,CSE 190,A00,092507,Dubnov; Shlomo,14,0,15,1
1649930327051,ECE 45,A01,083139,Staff,6,0,40,34
1649930333074,ECE 65,A50,083695,Staff,7,0,30,23
1649930339101,ECE 109,A01,091882,Touri; Behrouz,55,0,70,15
1649930345125,ECE 180,A00,083140,Abi Samra; Nicholas Camill,26,0,30,4
1649930345125,ECE 180,B00,083141,Abi Samra; Nicholas Camill,13,0,30,17
1649930351155,MATH 10A,A01,083735,Patchell; Gregory David,20,0,30,10
1649930351155,MATH 10A,A02,083736,Patchell; Gregory David,28,0,30,2
1649930351155,MATH 10A,A03,083737,Patchell; Gregory David,28,0,30,2
1649930357177,MATH 10B,A01,083207,Staff,10,0,30,20
1649930357177,MATH 10B,A02,083208,Staff,25,0,30,5
1649930357177,MATH 10B,B01,083739,Staff,25,0,30,5
1649930357177,MATH 10B,B02,083740,Staff,30,0,30,0
1649930363204,MATH 18,A01,083743,Staff,22,0,30,8
1649930363204,MATH 18,A02,083744,Staff,29,0,30,1
1649930363204,MATH 18,A03,083745,Staff,29,0,30,1
1649930363204,MATH 18,A04,083746,Staff,28,0,30,2
1649930363204,MATH 18,B01,083748,Staff,5,0,30,25
1649930363204,MATH 18,B02,083749,Staff,26,0,30,4
1649930363204,MATH 18,B03,083750,Staff,28,0,30,2
1649930363204,MATH 18,B04,083751,Staff,26,0,30,4
1649930369240,MATH 20A,A01,083754,Staff,37,0,40,3
1649930375266,MATH 20B,A01,083756,Staff,19,0,30,11
1649930375266,MATH 20B,A02,083757,Staff,30,0,30,0
1649930381293,MATH 20C,A01,083760,Staff,22,0,30,8
1649930381293,MATH 20C,A02,083761,Staff,23,0,30,7
1649930381293,MATH 20C,B01,083762,Staff,28,0,30,2
1649930381293,MATH 20C,B02,083763,Staff,30,0,30,0
1649930387315,MATH 20D,A01,083765,Staff,20,0,30,10
1649930387315,MATH 20D,A02,083766,Staff,30,0,30,0
1649930387315,MATH 20D,A03,083767,Staff,30,0,30,0
1649930393343,MATH 20E,A01,083771,Staff,12,0,30,18
1649930393343,MATH 20E,A02,083772,Staff,24,0,30,6
1649930393343,MATH 20E,B01,083773,Staff,17,0,30,13
1649930393343,MATH 20E,B02,083774,Staff,29,0,30,1
1649930399365,MATH 103A,A01,083777,Staff,1,4,30,29
1649930399365,MATH 103A,A02,083778,Staff,0,3,30,30
1649930399365,MATH 103A,B01,083779,Staff,0,0,30,30
1649930399365,MATH 103A,B02,083780,Staff,16,0,30,14
1649930405470,MATH 105,A01,085443,Staff,0,5,30,30
1649930411496,MATH 109,A01,083213,Anzaldo; Leesa B,13,0,30,17
1649930411496,MATH 109,A02,083214,Anzaldo; Leesa B,9,0,30,21
1649930411496,MATH 109,B01,083215,Anzaldo; Leesa B,26,0,30,4
1649930411496,MATH 109,B02,083216,Anzaldo; Leesa B,22,0,30,8
1649930417523,MATH 142A,A01,083219,Chow; Bennett,0,1,30,30
1649930417523,MATH 142A,A02,083220,Chow; Bennett,9,0,30,21
1649930417523,MATH 142A,B01,083221,Chow; Bennett,0,0,30,30
1649930417523,MATH 142A,B02,083222,Chow; Bennett,1,0,30,29
1649930423565,MATH 193A,A01,083224,Staff,0,3,30,30
1649930423565,MATH 193A,A02,083225,Staff,0,3,30,30
1649930423565,MATH 193A,A03,083781,Staff,4,0,30,26
1649930423565,MATH 193A,A04,083782,Staff,16,0,30,14
1649930429588,MATH 197,001,091859,McAuley; Julian John,9999,0,9999,0
1649930435639,COGS 9,A01,083615,Staff,16,0,60,44
1649930441665,COGS 11,A01,083617,Boyle; Mary E. T.,35,0,40,5
1649930447687,COGS 13,A01,083071,Staff,0,11,40,40
1649930453711,COGS 14A,A01,092681,Staff,65,0,100,35
1649930459733,COGS 14B,A01,083073,Cheng; Tzu-Han,24,0,50,26
1649930465757,COGS 17,A01,092677,Staff,63,0,75,12
1649930471779,COGS 100,A01,083619,Staff,0,5,60,60
1649930477808,COGS 101A,A01,083621,Davis; Joshua Daniel,0,8,60,60
1649930483835,COGS 101B,A01,091572,Staff,32,0,60,28
1649930489857,COGS 101C,A01,083625,Delgado; Tania,24,0,30,6
1649930495885,COGS 107A,A01,083627,Boyle; Mary E. T.,14,0,60,46
1649930501910,COGS 118A,A01,083075,Staff,21,0,60,39
1649930507935,CSE 3,A50,083646,Miranda; Gregory Joseph,24,0,38,14
1649930507935,CSE 3,A51,083647,Miranda; Gregory Joseph,37,0,37,0
1649930513959,CSE 8A,A50,083650,Miranda; Gregory Joseph,8,0,40,32
1649930519982,CSE 11,A01,083080,Cao; Yingjun,0,26,40,40
1649930526006,CSE 12,A01,083652,Staff,56,0,100,44
1649930532033,CSE 15L,A01,083654,Staff,19,0,50,31
1649930532033,CSE 15L,A02,083655,Staff,47,0,50,3
1649930538059,CSE 20,A01,083657,Staff,68,0,80,12
1649930544082,CSE 30,A01,083084,Eldon; John,0,24,40,40
1649930550103,CSE 100,A01,083659,Cao; Yingjun,1,27,50,49
1649930556130,CSE 134B,A01,083661,Powell; Thomas Allan,0,21,65,65
1649930562153,CSE 140,A01,083663,Staff,24,0,75,51
1649930568177,CSE 140L,A01,083088,Eldon; John,18,0,75,57
1649930574203,CSE 175,A01,083665,Kumar; Rakesh,12,0,25,13
1649930580225,CSE 190,A00,092507,Dubnov; Shlomo,14,0,15,1
1649930586248,ECE 45,A01,083139,Staff,6,0,40,34
1649930592275,ECE 65,A50,083695,Staff,7,0,30,23
1649930598308,ECE 109,A01,091882,Touri; Behrouz,55,0,70,15
1649930604335,ECE 180,A00,083140,Abi Samra; Nicholas Camill,26,0,30,4
1649930604335,ECE 180,B00,083141,Abi Samra; Nicholas Camill,13,0,30,17
1649930610369,MATH 10A,A01,083735,Patchell; Gregory David,20,0,30,10
1649930610369,MATH 10A,A02,083736,Patchell; Gregory David,28,0,30,2
1649930610369,MATH 10A,A03,083737,Patchell; Gregory David,28,0,30,2
1649930616397,MATH 10B,A01,083207,Staff,10,0,30,20
1649930616397,MATH 10B,A02,083208,Staff,25,0,30,5
1649930616397,MATH 10B,B01,083739,Staff,25,0,30,5
1649930616397,MATH 10B,B02,083740,Staff,30,0,30,0
1649930622422,MATH 18,A01,083743,Staff,22,0,30,8
1649930622422,MATH 18,A02,083744,Staff,29,0,30,1
1649930622422,MATH 18,A03,083745,Staff,29,0,30,1
1649930622422,MATH 18,A04,083746,Staff,28,0,30,2
1649930622422,MATH 18,B01,083748,Staff,5,0,30,25
1649930622422,MATH 18,B02,083749,Staff,26,0,30,4
1649930622422,MATH 18,B03,083750,Staff,28,0,30,2
1649930622422,MATH 18,B04,083751,Staff,26,0,30,4
1649930628447,MATH 20A,A01,083754,Staff,37,0,40,3
1649930634472,MATH 20B,A01,083756,Staff,19,0,30,11
1649930634472,MATH 20B,A02,083757,Staff,30,0,30,0
1649930640496,MATH 20C,A01,083760,Staff,22,0,30,8
1649930640496,MATH 20C,A02,083761,Staff,23,0,30,7
1649930640496,MATH 20C,B01,083762,Staff,28,0,30,2
1649930640496,MATH 20C,B02,083763,Staff,30,0,30,0
1649930646519,MATH 20D,A01,083765,Staff,20,0,30,10
1649930646519,MATH 20D,A02,083766,Staff,30,0,30,0
1649930646519,MATH 20D,A03,083767,Staff,30,0,30,0
1649930652544,MATH 20E,A01,083771,Staff,12,0,30,18
1649930652544,MATH 20E,A02,083772,Staff,24,0,30,6
1649930652544,MATH 20E,B01,083773,Staff,17,0,30,13
1649930652544,MATH 20E,B02,083774,Staff,29,0,30,1
1649930658578,MATH 103A,A01,083777,Staff,1,4,30,29
1649930658578,MATH 103A,A02,083778,Staff,0,3,30,30
1649930658578,MATH 103A,B01,083779,Staff,0,0,30,30
1649930658578,MATH 103A,B02,083780,Staff,16,0,30,14
1649930664612,MATH 105,A01,085443,Staff,0,5,30,30
1649930670642,MATH 109,A01,083213,Anzaldo; Leesa B,13,0,30,17
1649930670642,MATH 109,A02,083214,Anzaldo; Leesa B,9,0,30,21
1649930670642,MATH 109,B01,083215,Anzaldo; Leesa B,26,0,30,4
1649930670642,MATH 109,B02,083216,Anzaldo; Leesa B,22,0,30,8
1649930676668,MATH 142A,A01,083219,Chow; Bennett,0,1,30,30
1649930676668,MATH 142A,A02,083220,Chow; Bennett,9,0,30,21
1649930676668,MATH 142A,B01,083221,Chow; Bennett,0,0,30,30
1649930676668,MATH 142A,B02,083222,Chow; Bennett,1,0,30,29
1649930682697,MATH 193A,A01,083224,Staff,0,3,30,30
1649930682697,MATH 193A,A02,083225,Staff,0,3,30,30
1649930682697,MATH 193A,A03,083781,Staff,4,0,30,26
1649930682697,MATH 193A,A04,083782,Staff,16,0,30,14
1649930688723,MATH 197,001,091859,McAuley; Julian John,9999,0,9999,0
1649930694774,COGS 9,A01,083615,Staff,16,0,60,44
1649930700798,COGS 11,A01,083617,Boyle; Mary E. T.,35,0,40,5
1649930706825,COGS 13,A01,083071,Staff,0,11,40,40
1649930712851,COGS 14A,A01,092681,Staff,65,0,100,35
1649930718875,COGS 14B,A01,083073,Cheng; Tzu-Han,24,0,50,26
1649930724899,COGS 17,A01,092677,Staff,63,0,75,12
1649930730926,COGS 100,A01,083619,Staff,0,5,60,60
1649930736950,COGS 101A,A01,083621,Davis; Joshua Daniel,0,8,60,60
1649930742974,COGS 101B,A01,091572,Staff,32,0,60,28
1649930749001,COGS 101C,A01,083625,Delgado; Tania,24,0,30,6
1649930755024,COGS 107A,A01,083627,Boyle; Mary E. T.,14,0,60,46
1649930761049,COGS 118A,A01,083075,Staff,21,0,60,39
1649930767079,CSE 3,A50,083646,Miranda; Gregory Joseph,24,0,38,14
1649930767079,CSE 3,A51,083647,Miranda; Gregory Joseph,37,0,37,0
1649930773104,CSE 8A,A50,083650,Miranda; Gregory Joseph,8,0,40,32
1649930779127,CSE 11,A01,083080,Cao; Yingjun,0,26,40,40
1649930785155,CSE 12,A01,083652,Staff,56,0,100,44
1649930791182,CSE 15L,A01,083654,Staff,19,0,50,31
1649930791182,CSE 15L,A02,083655,Staff,47,0,50,3
1649930797205,CSE 20,A01,083657,Staff,68,0,80,12
1649930803233,CSE 30,A01,083084,Eldon; John,0,24,40,40
1649930809258,CSE 100,A01,083659,Cao; Yingjun,1,27,50,49
1649930815281,CSE 134B,A01,083661,Powell; Thomas Allan,0,21,65,65
1649930821304,CSE 140,A01,083663,Staff,24,0,75,51
1649930827332,CSE 140L,A01,083088,Eldon; John,18,0,75,57
1649930833360,CSE 175,A01,083665,Kumar; Rakesh,12,0,25,13
1649930839387,CSE 190,A00,092507,Dubnov; Shlomo,14,0,15,1
1649930845413,ECE 45,A01,083139,Staff,6,0,40,34
1649930851436,ECE 65,A50,083695,Staff,7,0,30,23
1649930857459,ECE 109,A01,091882,Touri; Behrouz,55,0,70,15
1649930863486,ECE 180,A00,083140,Abi Samra; Nicholas Camill,26,0,30,4
1649930863486,ECE 180,B00,083141,Abi Samra; Nicholas Camill,13,0,30,17
1649930869509,MATH 10A,A01,083735,Patchell; Gregory David,20,0,30,10
1649930869509,MATH 10A,A02,083736,Patchell; Gregory David,28,0,30,2
1649930869509,MATH 10A,A03,083737,Patchell; Gregory David,28,0,30,2
1649930875537,MATH 10B,A01,083207,Staff,10,0,30,20
1649930875537,MATH 10B,A02,083208,Staff,25,0,30,5
1649930875537,MATH 10B,B01,083739,Staff,25,0,30,5
1649930875537,MATH 10B,B02,083740,Staff,30,0,30,0
1649930881568,MATH 18,A01,083743,Staff,22,0,30,8
1649930881568,MATH 18,A02,083744,Staff,29,0,30,1
1649930881568,MATH 18,A03,083745,Staff,29,0,30,1
1649930881568,MATH 18,A04,083746,Staff,28,0,30,2
1649930881568,MATH 18,B01,083748,Staff,5,0,30,25
1649930881568,MATH 18,B02,083749,Staff,26,0,30,4
1649930881568,MATH 18,B03,083750,Staff,28,0,30,2
1649930881568,MATH 18,B04,083751,Staff,26,0,30,4
1649930887593,MATH 20A,A01,083754,Staff,37,0,40,3
1649930893618,MATH 20B,A01,083756,Staff,19,0,30,11
1649930893618,MATH 20B,A02,083757,Staff,30,0,30,0
1649930899643,MATH 20C,A01,083760,Staff,22,0,30,8
1649930899643,MATH 20C,A02,083761,Staff,23,0,30,7
1649930899643,MATH 20C,B01,083762,Staff,28,0,30,2
1649930899643,MATH 20C,B02,083763,Staff,30,0,30,0
1649930905673,MATH 20D,A01,083765,Staff,20,0,30,10
1649930905673,MATH 20D,A02,083766,Staff,30,0,30,0
1649930905673,MATH 20D,A03,083767,Staff,30,0,30,0
1649930911698,MATH 20E,A01,083771,Staff,12,0,30,18
1649930911698,MATH 20E,A02,083772,Staff,24,0,30,6
1649930911698,MATH 20E,B01,083773,Staff,17,0,30,13
1649930911698,MATH 20E,B02,083774,Staff,29,0,30,1
1649930917727,MATH 103A,A01,083777,Staff,1,4,30,29
1649930917727,MATH 103A,A02,083778,Staff,0,3,30,30
1649930917727,MATH 103A,B01,083779,Staff,0,0,30,30
1649930917727,MATH 103A,B02,083780,Staff,16,0,30,14
1649930923766,MATH 105,A01,085443,Staff,0,5,30,30
1649930929791,MATH 109,A01,083213,Anzaldo; Leesa B,13,0,30,17
1649930929791,MATH 109,A02,083214,Anzaldo; Leesa B,9,0,30,21
1649930929791,MATH 109,B01,083215,Anzaldo; Leesa B,26,0,30,4
1649930929791,MATH 109,B02,083216,Anzaldo; Leesa B,22,0,30,8
1649930935821,MATH 142A,A01,083219,Chow; Bennett,0,1,30,30
1649930935821,MATH 142A,A02,083220,Chow; Bennett,9,0,30,21
1649930935821,MATH 142A,B01,083221,Chow; Bennett,0,0,30,30
1649930935821,MATH 142A,B02,083222,Chow; Bennett,1,0,30,29
1649930941851,MATH 193A,A01,083224,Staff,0,3,30,30
1649930941851,MATH 193A,A02,083225,Staff,0,3,30,30
1649930941851,MATH 193A,A03,083781,Staff,4,0,30,26
1649930941851,MATH 193A,A04,083782,Staff,16,0,30,14
1649930947874,MATH 197,001,091859,McAuley; Julian John,9999,0,9999,0
1649930953940,COGS 9,A01,083615,Staff,16,0,60,44
1649930959963,COGS 11,A01,083617,Boyle; Mary E. T.,35,0,40,5
1649930965988,COGS 13,A01,083071,Staff,0,11,40,40
1649930972012,COGS 14A,A01,092681,Staff,65,0,100,35
1649930978036,COGS 14B,A01,083073,Cheng; Tzu-Han,24,0,50,26
1649930984062,COGS 17,A01,092677,Staff,63,0,75,12
1649930990086,COGS 100,A01,083619,Staff,0,5,60,60
1649930996181,COGS 101A,A01,083621,Davis; Joshua Daniel,0,8,60,60
1649931002226,COGS 101B,A01,091572,Staff,32,0,60,28
1649931008249,COGS 101C,A01,083625,Delgado; Tania,24,0,30,6
1649931014272,COGS 107A,A01,083627,Boyle; Mary E. T.,14,0,60,46
1649931020295,COGS 118A,A01,083075,Staff,21,0,60,39
1649931026322,CSE 3,A50,083646,Miranda; Gregory Joseph,24,0,38,14
1649931026322,CSE 3,A51,083647,Miranda; Gregory Joseph,37,0,37,0
1649931032349,CSE 8A,A50,083650,Miranda; Gregory Joseph,8,0,40,32
1649931038374,CSE 11,A01,083080,Cao; Yingjun,0,26,40,40
1649931044395,CSE 12,A01,083652,Staff,56,0,100,44
1649931050419,CSE 15L,A01,083654,Staff,19,0,50,31
1649931050419,CSE 15L,A02,083655,Staff,47,0,50,3
1649931056447,CSE 20,A01,083657,Staff,68,0,80,12
1649931062472,CSE 30,A01,083084,Eldon; John,0,24,40,40
1649931068496,CSE 100,A01,083659,Cao; Yingjun,1,27,50,49
1649931074520,CSE 134B,A01,083661,Powell; Thomas Allan,0,21,65,65
1649931080543,CSE 140,A01,083663,Staff,24,0,75,51
1649931086567,CSE 140L,A01,083088,Eldon; John,18,0,75,57
1649931092591,CSE 175,A01,083665,Kumar; Rakesh,12,0,25,13
1649931098621,CSE 190,A00,092507,Dubnov; Shlomo,14,0,15,1
1649931104642,ECE 45,A01,083139,Staff,6,0,40,34
1649931110671,ECE 65,A50,083695,Staff,7,0,30,23
1649931116697,ECE 109,A01,091882,Touri; Behrouz,55,0,70,15
1649931122720,ECE 180,A00,083140,Abi Samra; Nicholas Camill,26,0,30,4
1649931122720,ECE 180,B00,083141,Abi Samra; Nicholas Camill,13,0,30,17
1649931128749,MATH 10A,A01,083735,Patchell; Gregory David,20,0,30,10
1649931128749,MATH 10A,A02,083736,Patchell; Gregory David,28,0,30,2
1649931128749,MATH 10A,A03,083737,Patchell; Gregory David,28,0,30,2
1649931134773,MATH 10B,A01,083207,Staff,10,0,30,20
1649931134773,MATH 10B,A02,083208,Staff,25,0,30,5
1649931134773,MATH 10B,B01,083739,Staff,25,0,30,5
1649931134773,MATH 10B,B02,083740,Staff,30,0,30,0
1649931140795,MATH 18,A01,083743,Staff,22,0,30,8
1649931140795,MATH 18,A02,083744,Staff,29,0,30,1
1649931140795,MATH 18,A03,083745,Staff,29,0,30,1
1649931140795,MATH 18,A04,083746,Staff,28,0,30,2
1649931140795,MATH 18,B01,083748,Staff,5,0,30,25
1649931140795,MATH 18,B02,083749,Staff,26,0,30,4
1649931140795,MATH 18,B03,083750,Staff,28,0,30,2
1649931140795,MATH 18,B04,083751,Staff,26,0,30,4
1649931146818,MATH 20A,A01,083754,Staff,37,0,40,3
1649931152844,MATH 20B,A01,083756,Staff,19,0,30,11
1649931152844,MATH 20B,A02,083757,Staff,30,0,30,0
1649931158868,MATH 20C,A01,083760,Staff,22,0,30,8
1649931158868,MATH 20C,A02,083761,Staff,23,0,30,7
1649931158868,MATH 20C,B01,083762,Staff,28,0,30,2
1649931158868,MATH 20C,B02,083763,Staff,30,0,30,0
1649931164894,MATH 20D,A01,083765,Staff,20,0,30,10
1649931164894,MATH 20D,A02,083766,Staff,30,0,30,0
1649931164894,MATH 20D,A03,083767,Staff,30,0,30,0
1649931170921,MATH 20E,A01,083771,Staff,12,0,30,18
1649931170921,MATH 20E,A02,083772,Staff,24,0,30,6
1649931170921,MATH 20E,B01,083773,Staff,17,0,30,13
1649931170921,MATH 20E,B02,083774,Staff,29,0,30,1
1649931176954,MATH 103A,A01,083777,Staff,1,4,30,29
1649931176954,MATH 103A,A02,083778,Staff,0,3,30,30
1649931176954,MATH 103A,B01,083779,Staff,0,0,30,30
1649931176954,MATH 103A,B02,083780,Staff,16,0,30,14
1649931182982,MATH 105,A01,085443,Staff,0,5,30,30
1649931189008,MATH 109,A01,083213,Anzaldo; Leesa B,13,0,30,17
1649931189008,MATH 109,A02,083214,Anzaldo; Leesa B,9,0,30,21
1649931189008,MATH 109,B01,083215,Anzaldo; Leesa B,26,0,30,4
1649931189008,MATH 109,B02,083216,Anzaldo; Leesa B,22,0,30,8
1649931195031,MATH 142A,A01,083219,Chow; Bennett,0,1,30,30
1649931195031,MATH 142A,A02,083220,Chow; Bennett,9,0,30,21
1649931195031,MATH 142A,B01,083221,Chow; Bennett,0,0,30,30
1649931195031,MATH 142A,B02,083222,Chow; Bennett,1,0,30,29
1649931201057,MATH 193A,A01,083224,Staff,0,3,30,30
1649931201057,MATH 193A,A02,083225,Staff,0,3,30,30
1649931201057,MATH 193A,A03,083781,Staff,4,0,30,26
1649931201057,MATH 193A,A04,083782,Staff,16,0,30,14
1649931207079,MATH 197,001,091859,McAuley; Julian John,9999,0,9999,0
1649931213143,COGS 9,A01,083615,Staff,16,0,60,44
1649931219168,COGS 11,A01,083617,Boyle; Mary E. T.,35,0,40,5
1649931225193,COGS 13,A01,083071,Staff,0,11,40,40
1649931231221,COGS 14A,A01,092681,Staff,65,0,100,35
1649931237245,COGS 14B,A01,083073,Cheng; Tzu-Han,24,0,50,26
1649931243269,COGS 17,A01,092677,Staff,63,0,75,12
1649931249293,COGS 100,A01,083619,Staff,0,5,60,60
1649931255318,COGS 101A,A01,083621,Davis; Joshua Daniel,0,8,60,60
1649931261344,COGS 101B,A01,091572,Staff,32,0,60,28
1649931267368,COGS 101C,A01,083625,Delgado; Tania,24,0,30,6
1649931273397,COGS 107A,A01,083627,Boyle; Mary E. T.,14,0,60,46
1649931279422,COGS 118A,A01,083075,Staff,21,0,60,39
1649931285450,CSE 3,A50,083646,Miranda; Gregory Joseph,24,0,38,14
1649931285450,CSE 3,A51,083647,Miranda; Gregory Joseph,37,0,37,0
1649931291487,CSE 8A,A50,083650,Miranda; Gregory Joseph,8,0,40,32
1649931297512,CSE 11,A01,083080,Cao; Yingjun,0,26,40,40
1649931303559,CSE 12,A01,083652,Staff,56,0,100,44
1649931309581,CSE 15L,A01,083654,Staff,19,0,50,31
1649931309581,CSE 15L,A02,083655,Staff,47,0,50,3
1649931315607,CSE 20,A01,083657,Staff,68,0,80,12
1649931321646,CSE 30,A01,083084,Eldon; John,0,24,40,40
1649931327672,CSE 100,A01,083659,Cao; Yingjun,1,27,50,49
1649931333704,CSE 134B,A01,083661,Powell; Thomas Allan,0,21,65,65
1649931339727,CSE 140,A01,083663,Staff,24,0,75,51
1649931345754,CSE 140L,A01,083088,Eldon; John,18,0,75,57
1649931351779,CSE 175,A01,083665,Kumar; Rakesh,12,0,25,13
1649931357811,CSE 190,A00,092507,Dubnov; Shlomo,14,0,15,1
1649931363839,ECE 45,A01,083139,Staff,6,0,40,34
1649931369864,ECE 65,A50,083695,Staff,7,0,30,23
1649931375895,ECE 109,A01,091882,Touri; Behrouz,55,0,70,15
1649931381920,ECE 180,A00,083140,Abi Samra; Nicholas Camill,26,0,30,4
1649931381920,ECE 180,B00,083141,Abi Samra; Nicholas Camill,13,0,30,17
1649931387954,MATH 10A,A01,083735,Patchell; Gregory David,20,0,30,10
1649931387954,MATH 10A,A02,083736,Patchell; Gregory David,28,0,30,2
1649931387954,MATH 10A,A03,083737,Patchell; Gregory David,28,0,30,2
1649931393986,MATH 10B,A01,083207,Staff,10,0,30,20
1649931393986,MATH 10B,A02,083208,Staff,25,0,30,5
1649931393986,MATH 10B,B01,083739,Staff,25,0,30,5
1649931393986,MATH 10B,B02,083740,Staff,30,0,30,0
1649931400015,MATH 18,A01,083743,Staff,22,0,30,8
1649931400015,MATH 18,A02,083744,Staff,29,0,30,1
1649931400015,MATH 18,A03,083745,Staff,29,0,30,1
1649931400015,MATH 18,A04,083746,Staff,28,0,30,2
1649931400015,MATH 18,B01,083748,Staff,5,0,30,25
1649931400015,MATH 18,B02,083749,Staff,26,0,30,4
1649931400015,MATH 18,B03,083750,Staff,28,0,30,2
1649931400015,MATH 18,B04,083751,Staff,26,0,30,4
1649931406040,MATH 20A,A01,083754,Staff,37,0,40,3
1649931412067,MATH 20B,A01,083756,Staff,19,0,30,11
1649931412067,MATH 20B,A02,083757,Staff,30,0,30,0
1649931418093,MATH 20C,A01,083760,Staff,22,0,30,8
1649931418093,MATH 20C,A02,083761,Staff,23,0,30,7
1649931418093,MATH 20C,B01,083762,Staff,28,0,30,2
1649931418093,MATH 20C,B02,083763,Staff,30,0,30,0
1649931424120,MATH 20D,A01,083765,Staff,20,0,30,10
1649931424120,MATH 20D,A02,083766,Staff,30,0,30,0
1649931424120,MATH 20D,A03,083767,Staff,30,0,30,0
1649931430152,MATH 20E,A01,083771,Staff,12,0,30,18
1649931430152,MATH 20E,A02,083772,Staff,24,0,30,6
1649931430152,MATH 20E,B01,083773,Staff,17,0,30,13
1649931430152,MATH 20E,B02,083774,Staff,29,0,30,1
1649931436179,MATH 103A,A01,083777,Staff,1,4,30,29
1649931436179,MATH 103A,A02,083778,Staff,0,3,30,30
1649931436179,MATH 103A,B01,083779,Staff,0,0,30,30
1649931436179,MATH 103A,B02,083780,Staff,16,0,30,14
1649931442208,MATH 105,A01,085443,Staff,0,5,30,30
1649931448235,MATH 109,A01,083213,Anzaldo; Leesa B,13,0,30,17
1649931448235,MATH 109,A02,083214,Anzaldo; Leesa B,9,0,30,21
1649931448235,MATH 109,B01,083215,Anzaldo; Leesa B,26,0,30,4
1649931448235,MATH 109,B02,083216,Anzaldo; Leesa B,22,0,30,8
1649931454262,MATH 142A,A01,083219,Chow; Bennett,0,1,30,30
1649931454262,MATH 142A,A02,083220,Chow; Bennett,9,0,30,21
1649931454262,MATH 142A,B01,083221,Chow; Bennett,0,0,30,30
1649931454262,MATH 142A,B02,083222,Chow; Bennett,1,0,30,29
1649931460289,MATH 193A,A01,083224,Staff,0,3,30,30
1649931460289,MATH 193A,A02,083225,Staff,0,3,30,30
1649931460289,MATH 193A,A03,083781,Staff,4,0,30,26
1649931460289,MATH 193A,A04,083782,Staff,16,0,30,14
1649931466314,MATH 197,001,091859,McAuley; Julian John,9999,0,9999,0
1649931472383,COGS 9,A01,083615,Staff,16,0,60,44
1649931478409,COGS 11,A01,083617,Boyle; Mary E. T.,35,0,40,5
1649931484438,COGS 13,A01,083071,Staff,0,11,40,40
1649931490464,COGS 14A,A01,092681,Staff,65,0,100,35
1649931496491,COGS 14B,A01,083073,Cheng; Tzu-Han,24,0,50,26
1649931502517,COGS 17,A01,092677,Staff,63,0,75,12
1649931508541,COGS 100,A01,083619,Staff,0,5,60,60
1649931514568,COGS 101A,A01,083621,Davis; Joshua Daniel,0,8,60,60
1649931520605,COGS 101B,A01,091572,Staff,32,0,60,28
1649931526631,COGS 101C,A01,083625,Delgado; Tania,24,0,30,6
1649931532660,COGS 107A,A01,083627,Boyle; Mary E. T.,14,0,60,46
1649931538689,COGS 118A,A01,083075,Staff,21,0,60,39
1649931544716,CSE 3,A50,083646,Miranda; Gregory Joseph,24,0,38,14
1649931544716,CSE 3,A51,083647,Miranda; Gregory Joseph,37,0,37,0
1649931550748,CSE 8A,A50,083650,Miranda; Gregory Joseph,8,0,40,32
1649931556773,CSE 11,A01,083080,Cao; Yingjun,0,26,40,40
1649931562797,CSE 12,A01,083652,Staff,56,0,100,44
1649931568822,CSE 15L,A01,083654,Staff,19,0,50,31
1649931568822,CSE 15L,A02,083655,Staff,47,0,50,3
1649931574851,CSE 20,A01,083657,Staff,68,0,80,12
1649931580880,CSE 30,A01,083084,Eldon; John,0,24,40,40
1649931586906,CSE 100,A01,083659,Cao; Yingjun,1,27,50,49
1649931593004,CSE 134B,A01,083661,Powell; Thomas Allan,0,21,65,65
1649931599034,CSE 140,A01,083663,Staff,24,0,75,51
1649931605071,CSE 140L,A01,083088,Eldon; John,18,0,75,57
1649931611103,CSE 175,A01,083665,Kumar; Rakesh,12,0,25,13
1649931617134,CSE 190,A00,092507,Dubnov; Shlomo,14,0,15,1
1649931623171,ECE 45,A01,083139,Staff,6,0,40,34
1649931629199,ECE 65,A50,083695,Staff,7,0,30,23
1649931635224,ECE 109,A01,091882,Touri; Behrouz,55,0,70,15
1649931641248,ECE 180,A00,083140,Abi Samra; Nicholas Camill,26,0,30,4
1649931641248,ECE 180,B00,083141,Abi Samra; Nicholas Camill,13,0,30,17
1649931647283,MATH 10A,A01,083735,Patchell; Gregory David,20,0,30,10
1649931647283,MATH 10A,A02,083736,Patchell; Gregory David,28,0,30,2
1649931647283,MATH 10A,A03,083737,Patchell; Gregory David,28,0,30,2
1649931653313,MATH 10B,A01,083207,Staff,10,0,30,20
1649931653313,MATH 10B,A02,083208,Staff,25,0,30,5
1649931653313,MATH 10B,B01,083739,Staff,25,0,30,5
1649931653313,MATH 10B,B02,083740,Staff,30,0,30,0
1649931659350,MATH 18,A01,083743,Staff,22,0,30,8
1649931659350,MATH 18,A02,083744,Staff,29,0,30,1
1649931659350,MATH 18,A03,083745,Staff,29,0,30,1
1649931659350,MATH 18,A04,083746,Staff,28,0,30,2
1649931659350,MATH 18,B01,083748,Staff,5,0,30,25
1649931659350,MATH 18,B02,083749,Staff,26,0,30,4
1649931659350,MATH 18,B03,083750,Staff,28,0,30,2
1649931659350,MATH 18,B04,083751,Staff,26,0,30,4
1649931665378,MATH 20A,A01,083754,Staff,37,0,40,3
1649931671415,MATH 20B,A01,083756,Staff,19,0,30,11
1649931671415,MATH 20B,A02,083757,Staff,30,0,30,0
1649931677442,MATH 20C,A01,083760,Staff,22,0,30,8
1649931677442,MATH 20C,A02,083761,Staff,23,0,30,7
1649931677442,MATH 20C,B01,083762,Staff,28,0,30,2
1649931677442,MATH 20C,B02,083763,Staff,30,0,30,0
1649931683472,MATH 20D,A01,083765,Staff,20,0,30,10
1649931683472,MATH 20D,A02,083766,Staff,30,0,30,0
1649931683472,MATH 20D,A03,083767,Staff,30,0,30,0
1649931689502,MATH 20E,A01,083771,Staff,12,0,30,18
1649931689502,MATH 20E,A02,083772,Staff,24,0,30,6
1649931689502,MATH 20E,B01,083773,Staff,17,0,30,13
1649931689502,MATH 20E,B02,083774,Staff,29,0,30,1
1649931695529,MATH 103A,A01,083777,Staff,1,4,30,29
1649931695529,MATH 103A,A02,083778,Staff,0,3,30,30
1649931695529,MATH 103A,B01,083779,Staff,0,0,30,30
1649931695529,MATH 103A,B02,083780,Staff,16,0,30,14
1649931701554,MATH 105,A01,085443,Staff,0,5,30,30
1649931707585,MATH 109,A01,083213,Anzaldo; Leesa B,13,0,30,17
1649931707585,MATH 109,A02,083214,Anzaldo; Leesa B,9,0,30,21
1649931707585,MATH 109,B01,083215,Anzaldo; Leesa B,26,0,30,4
1649931707585,MATH 109,B02,083216,Anzaldo; Leesa B,22,0,30,8
1649931713610,MATH 142A,A01,083219,Chow; Bennett,0,1,30,30
1649931713610,MATH 142A,A02,083220,Chow; Bennett,9,0,30,21
1649931713610,MATH 142A,B01,083221,Chow; Bennett,0,0,30,30
1649931713610,MATH 142A,B02,083222,Chow; Bennett,1,0,30,29
1649931719635,MATH 193A,A01,083224,Staff,0,3,30,30
1649931719635,MATH 193A,A02,083225,Staff,0,3,30,30
1649931719635,MATH 193A,A03,083781,Staff,4,0,30,26
1649931719635,MATH 193A,A04,083782,Staff,16,0,30,14
1649931725658,MATH 197,001,091859,McAuley; Julian John,9999,0,9999,0
1649931731741,COGS 9,A01,083615,Staff,16,0,60,44
1649931737765,COGS 11,A01,083617,Boyle; Mary E. T.,35,0,40,5
1649931743791,COGS 13,A01,083071,Staff,0,11,40,40
1649931749819,COGS 14A,A01,092681,Staff,65,0,100,35
1649931755843,COGS 14B,A01,083073,Cheng; Tzu-Han,24,0,50,26
1649931761869,COGS 17,A01,092677,Staff,63,0,75,12
1649931767895,COGS 100,A01,083619,Staff,0,5,60,60
1649931773929,COGS 101A,A01,083621,Davis; Joshua Daniel,0,8,60,60
1649931779974,COGS 101B,A01,091572,Staff,32,0,60,28
1649931786002,COGS 101C,A01,083625,Delgado; Tania,24,0,30,6
1649931792028,COGS 107A,A01,083627,Boyle; Mary E. T.,14,0,60,46
1649931798053,COGS 118A,A01,083075,Staff,21,0,60,39
1649931804081,CSE 3,A50,083646,Miranda; Gregory Joseph,24,0,38,14
1649931804081,CSE 3,A51,083647,Miranda; Gregory Joseph,37,0,37,0
1649931810116,CSE 8A,A50,083650,Miranda; Gregory Joseph,8,0,40,32
1649931816141,CSE 11,A01,083080,Cao; Yingjun,0,26,40,40
1649931822168,CSE 12,A01,083652,Staff,56,0,100,44
1649931828192,CSE 15L,A01,083654,Staff,19,0,50,31
1649931828192,CSE 15L,A02,083655,Staff,47,0,50,3
1649931834217,CSE 20,A01,083657,Staff,68,0,80,12
1649931840249,CSE 30,A01,083084,Eldon; John,0,24,40,40
1649931846273,CSE 100,A01,083659,Cao; Yingjun,1,27,50,49
1649931852302,CSE 134B,A01,083661,Powell; Thomas Allan,0,21,65,65
1649931858326,CSE 140,A01,083663,Staff,24,0,75,51
1649931864352,CSE 140L,A01,083088,Eldon; John,18,0,75,57
1649931870380,CSE 175,A01,083665,Kumar; Rakesh,12,0,25,13
1649931876409,CSE 190,A00,092507,Dubnov; Shlomo,14,0,15,1
1649931882439,ECE 45,A01,083139,Staff,6,0,40,34
1649931888467,ECE 65,A50,083695,Staff,7,0,30,23
1649931894496,ECE 109,A01,091882,Touri; Behrouz,55,0,70,15
1649931900525,ECE 180,A00,083140,Abi Samra; Nicholas Camill,26,0,30,4
1649931900525,ECE 180,B00,083141,Abi Samra; Nicholas Camill,13,0,30,17
1649931906550,MATH 10A,A01,083735,Patchell; Gregory David,20,0,30,10
1649931906550,MATH 10A,A02,083736,Patchell; Gregory David,28,0,30,2
1649931906550,MATH 10A,A03,083737,Patchell; Gregory David,28,0,30,2
1649931912575,MATH 10B,A01,083207,Staff,10,0,30,20
1649931912575,MATH 10B,A02,083208,Staff,25,0,30,5
1649931912575,MATH 10B,B01,083739,Staff,25,0,30,5
1649931912575,MATH 10B,B02,083740,Staff,30,0,30,0
1649931918602,MATH 18,A01,083743,Staff,22,0,30,8
1649931918602,MATH 18,A02,083744,Staff,29,0,30,1
1649931918602,MATH 18,A03,083745,Staff,29,0,30,1
1649931918602,MATH 18,A04,083746,Staff,28,0,30,2
1649931918602,MATH 18,B01,083748,Staff,5,0,30,25
1649931918602,MATH 18,B02,083749,Staff,26,0,30,4
1649931918602,MATH 18,B03,083750,Staff,28,0,30,2
1649931918602,MATH 18,B04,083751,Staff,26,0,30,4
1649931924627,MATH 20A,A01,083754,Staff,37,0,40,3
1649931930651,MATH 20B,A01,083756,Staff,19,0,30,11
1649931930651,MATH 20B,A02,083757,Staff,30,0,30,0
1649931936681,MATH 20C,A01,083760,Staff,22,0,30,8
1649931936681,MATH 20C,A02,083761,Staff,23,0,30,7
1649931936681,MATH 20C,B01,083762,Staff,28,0,30,2
1649931936681,MATH 20C,B02,083763,Staff,30,0,30,0
1649931942704,MATH 20D,A01,083765,Staff,20,0,30,10
1649931942704,MATH 20D,A02,083766,Staff,30,0,30,0
1649931942704,MATH 20D,A03,083767,Staff,30,0,30,0
1649931948734,MATH 20E,A01,083771,Staff,12,0,30,18
1649931948734,MATH 20E,A02,083772,Staff,24,0,30,6
1649931948734,MATH 20E,B01,083773,Staff,17,0,30,13
1649931948734,MATH 20E,B02,083774,Staff,29,0,30,1
1649931954760,MATH 103A,A01,083777,Staff,1,4,30,29
1649931954760,MATH 103A,A02,083778,Staff,0,3,30,30
1649931954760,MATH 103A,B01,083779,Staff,0,0,30,30
1649931954760,MATH 103A,B02,083780,Staff,16,0,30,14
1649931960789,MATH 105,A01,085443,Staff,0,5,30,30
1649931966814,MATH 109,A01,083213,Anzaldo; Leesa B,13,0,30,17
1649931966814,MATH 109,A02,083214,Anzaldo; Leesa B,9,0,30,21
1649931966814,MATH 109,B01,083215,Anzaldo; Leesa B,26,0,30,4
1649931966814,MATH 109,B02,083216,Anzaldo; Leesa B,22,0,30,8
1649931972847,MATH 142A,A01,083219,Chow; Bennett,0,1,30,30
1649931972847,MATH 142A,A02,083220,Chow; Bennett,9,0,30,21
1649931972847,MATH 142A,B01,083221,Chow; Bennett,0,0,30,30
1649931972847,MATH 142A,B02,083222,Chow; Bennett,1,0,30,29
1649931978872,MATH 193A,A01,083224,Staff,0,3,30,30
1649931978872,MATH 193A,A02,083225,Staff,0,3,30,30
1649931978872,MATH 193A,A03,083781,Staff,4,0,30,26
1649931978872,MATH 193A,A04,083782,Staff,16,0,30,14
1649931984901,MATH 197,001,091859,McAuley; Julian John,9999,0,9999,0
1649931990983,COGS 9,A01,083615,Staff,16,0,60,44
1649931997006,COGS 11,A01,083617,Boyle; Mary E. T.,35,0,40,5
1649932003036,COGS 13,A01,083071,Staff,0,11,40,40
1649932009061,COGS 14A,A01,092681,Staff,65,0,100,35
1649932015085,COGS 14B,A01,083073,Cheng; Tzu-Han,24,0,50,26
1649932021109,COGS 17,A01,092677,Staff,63,0,75,12
1649932027134,COGS 100,A01,083619,Staff,0,6,60,60
1649932033166,COGS 101A,A01,083621,Davis; Joshua Daniel,0,8,60,60
1649932039190,COGS 101B,A01,091572,Staff,31,0,60,29
1649932045216,COGS 101C,A01,083625,Delgado; Tania,24,0,30,6
1649932051252,COGS 107A,A01,083627,Boyle; Mary E. T.,14,0,60,46
1649932057277,COGS 118A,A01,083075,Staff,21,0,60,39
1649932063308,CSE 3,A50,083646,Miranda; Gregory Joseph,24,0,38,14
1649932063308,CSE 3,A51,083647,Miranda; Gregory Joseph,37,0,37,0
1649932069337,CSE 8A,A50,083650,Miranda; Gregory Joseph,8,0,40,32
1649932075369,CSE 11,A01,083080,Cao; Yingjun,0,26,40,40
1649932081399,CSE 12,A01,083652,Staff,56,0,100,44
1649932087427,CSE 15L,A01,083654,Staff,19,0,50,31
1649932087427,CSE 15L,A02,083655,Staff,47,0,50,3
1649932093455,CSE 20,A01,083657,Staff,68,0,80,12
1649932099479,CSE 30,A01,083084,Eldon; John,0,24,40,40
1649932105519,CSE 100,A01,083659,Cao; Yingjun,1,27,50,49
1649932111543,CSE 134B,A01,083661,Powell; Thomas Allan,0,21,65,65
1649932117571,CSE 140,A01,083663,Staff,24,0,75,51
1649932123594,CSE 140L,A01,083088,Eldon; John,18,0,75,57
1649932129623,CSE 175,A01,083665,Kumar; Rakesh,12,0,25,13
1649932135650,CSE 190,A00,092507,Dubnov; Shlomo,14,0,15,1
1649932141690,ECE 45,A01,083139,Staff,6,0,40,34
1649932147714,ECE 65,A50,083695,Staff,7,0,30,23
1649932153745,ECE 109,A01,091882,Touri; Behrouz,55,0,70,15
1649932159773,ECE 180,A00,083140,Abi Samra; Nicholas Camill,26,0,30,4
1649932159773,ECE 180,B00,083141,Abi Samra; Nicholas Camill,13,0,30,17
1649932165812,MATH 10A,A01,083735,Patchell; Gregory David,20,0,30,10
1649932165812,MATH 10A,A02,083736,Patchell; Gregory David,28,0,30,2
1649932165812,MATH 10A,A03,083737,Patchell; Gregory David,28,0,30,2
1649932171841,MATH 10B,A01,083207,Staff,10,0,30,20
1649932171841,MATH 10B,A02,083208,Staff,25,0,30,5
1649932171841,MATH 10B,B01,083739,Staff,25,0,30,5
1649932171841,MATH 10B,B02,083740,Staff,30,0,30,0
1649932177868,MATH 18,A01,083743,Staff,22,0,30,8
1649932177868,MATH 18,A02,083744,Staff,29,0,30,1
1649932177868,MATH 18,A03,083745,Staff,29,0,30,1
1649932177868,MATH 18,A04,083746,Staff,28,0,30,2
1649932177868,MATH 18,B01,083748,Staff,5,0,30,25
1649932177868,MATH 18,B02,083749,Staff,26,0,30,4
1649932177868,MATH 18,B03,083750,Staff,28,0,30,2
1649932177868,MATH 18,B04,083751,Staff,26,0,30,4
1649932183891,MATH 20A,A01,083754,Staff,37,0,40,3
1649932190001,MATH 20B,A01,083756,Staff,19,0,30,11
1649932190001,MATH 20B,A02,083757,Staff,30,0,30,0
1649932196028,MATH 20C,A01,083760,Staff,22,0,30,8
1649932196028,MATH 20C,A02,083761,Staff,23,0,30,7
1649932196028,MATH 20C,B01,083762,Staff,28,0,30,2
1649932196028,MATH 20C,B02,083763,Staff,30,0,30,0
1649932202053,MATH 20D,A01,083765,Staff,20,0,30,10
1649932202053,MATH 20D,A02,083766,Staff,30,0,30,0
1649932202053,MATH 20D,A03,083767,Staff,30,0,30,0
1649932208087,MATH 20E,A01,083771,Staff,12,0,30,18
1649932208087,MATH 20E,A02,083772,Staff,24,0,30,6
1649932208087,MATH 20E,B01,083773,Staff,17,0,30,13
1649932208087,MATH 20E,B02,083774,Staff,29,0,30,1
1649932214117,MATH 103A,A01,083777,Staff,1,4,30,29
1649932214117,MATH 103A,A02,083778,Staff,0,3,30,30
1649932214117,MATH 103A,B01,083779,Staff,0,0,30,30
1649932214117,MATH 103A,B02,083780,Staff,16,0,30,14
1649932220140,MATH 105,A01,085443,Staff,0,5,30,30
1649932226164,MATH 109,A01,083213,Anzaldo; Leesa B,13,0,30,17
1649932226164,MATH 109,A02,083214,Anzaldo; Leesa B,9,0,30,21
1649932226164,MATH 109,B01,083215,Anzaldo; Leesa B,26,0,30,4
1649932226164,MATH 109,B02,083216,Anzaldo; Leesa B,22,0,30,8
1649932232198,MATH 142A,A01,083219,Chow; Bennett,0,1,30,30
1649932232198,MATH 142A,A02,083220,Chow; Bennett,9,0,30,21
1649932232198,MATH 142A,B01,083221,Chow; Bennett,0,0,30,30
1649932232198,MATH 142A,B02,083222,Chow; Bennett,1,0,30,29
1649932238221,MATH 193A,A01,083224,Staff,0,3,30,30
1649932238221,MATH 193A,A02,083225,Staff,0,3,30,30
1649932238221,MATH 193A,A03,083781,Staff,4,0,30,26
1649932238221,MATH 193A,A04,083782,Staff,16,0,30,14
1649932244324,MATH 197,001,091859,McAuley; Julian John,9999,0,9999,0
1649932250381,COGS 9,A01,083615,Staff,16,0,60,44
1649932256409,COGS 11,A01,083617,Boyle; Mary E. T.,35,0,40,5
1649932262435,COGS 13,A01,083071,Staff,0,11,40,40
1649932268465,COGS 14A,A01,092681,Staff,65,0,100,35
1649932274497,COGS 14B,A01,083073,Cheng; Tzu-Han,24,0,50,26
1649932280525,COGS 17,A01,092677,Staff,63,0,75,12
1649932286548,COGS 100,A01,083619,Staff,0,6,60,60
1649932292580,COGS 101A,A01,083621,Davis; Joshua Daniel,0,8,60,60
1649932298608,COGS 101B,A01,091572,Staff,31,0,60,29
1649932304633,COGS 101C,A01,083625,Delgado; Tania,24,0,30,6
1649932310656,COGS 107A,A01,083627,Boyle; Mary E. T.,14,0,60,46
1649932316684,COGS 118A,A01,083075,Staff,21,0,60,39
1649932322710,CSE 3,A50,083646,Miranda; Gregory Joseph,24,0,38,14
1649932322710,CSE 3,A51,083647,Miranda; Gregory Joseph,37,0,37,0
1649932328734,CSE 8A,A50,083650,Miranda; Gregory Joseph,8,0,40,32
1649932334758,CSE 11,A01,083080,Cao; Yingjun,0,26,40,40
1649932340786,CSE 12,A01,083652,Staff,56,0,100,44
1649932346833,CSE 15L,A01,083654,Staff,19,0,50,31
1649932346833,CSE 15L,A02,083655,Staff,47,0,50,3
1649932352857,CSE 20,A01,083657,Staff,68,0,80,12
1649932358880,CSE 30,A01,083084,Eldon; John,0,24,40,40
1649932364903,CSE 100,A01,083659,Cao; Yingjun,1,27,50,49
1649932370933,CSE 134B,A01,083661,Powell; Thomas Allan,0,21,65,65
1649932376962,CSE 140,A01,083663,Staff,24,0,75,51
1649932382988,CSE 140L,A01,083088,Eldon; John,18,0,75,57
1649932389014,CSE 175,A01,083665,Kumar; Rakesh,12,0,25,13
1649932395048,CSE 190,A00,092507,Dubnov; Shlomo,14,0,15,1
1649932401072,ECE 45,A01,083139,Staff,6,0,40,34
1649932407103,ECE 65,A50,083695,Staff,7,0,30,23
1649932413128,ECE 109,A01,091882,Touri; Behrouz,55,0,70,15
1649932419154,ECE 180,A00,083140,Abi Samra; Nicholas Camill,26,0,30,4
1649932419154,ECE 180,B00,083141,Abi Samra; Nicholas Camill,13,0,30,17
1649932425183,MATH 10A,A01,083735,Patchell; Gregory David,20,0,30,10
1649932425183,MATH 10A,A02,083736,Patchell; Gregory David,28,0,30,2
1649932425183,MATH 10A,A03,083737,Patchell; Gregory David,28,0,30,2
1649932431207,MATH 10B,A01,083207,Staff,10,0,30,20
1649932431207,MATH 10B,A02,083208,Staff,25,0,30,5
1649932431207,MATH 10B,B01,083739,Staff,25,0,30,5
1649932431207,MATH 10B,B02,083740,Staff,30,0,30,0
1649932437234,MATH 18,A01,083743,Staff,22,0,30,8
1649932437234,MATH 18,A02,083744,Staff,29,0,30,1
1649932437234,MATH 18,A03,083745,Staff,29,0,30,1
1649932437234,MATH 18,A04,083746,Staff,28,0,30,2
1649932437234,MATH 18,B01,083748,Staff,5,0,30,25
1649932437234,MATH 18,B02,083749,Staff,26,0,30,4
1649932437234,MATH 18,B03,083750,Staff,28,0,30,2
1649932437234,MATH 18,B04,083751,Staff,26,0,30,4
1649932443261,MATH 20A,A01,083754,Staff,37,0,40,3
1649932449290,MATH 20B,A01,083756,Staff,19,0,30,11
1649932449290,MATH 20B,A02,083757,Staff,30,0,30,0
1649932455315,MATH 20C,A01,083760,Staff,22,0,30,8
1649932455315,MATH 20C,A02,083761,Staff,23,0,30,7
1649932455315,MATH 20C,B01,083762,Staff,28,0,30,2
1649932455315,MATH 20C,B02,083763,Staff,30,0,30,0
1649932461340,MATH 20D,A01,083765,Staff,20,0,30,10
1649932461340,MATH 20D,A02,083766,Staff,30,0,30,0
1649932461340,MATH 20D,A03,083767,Staff,30,0,30,0
1649932467365,MATH 20E,A01,083771,Staff,12,0,30,18
1649932467365,MATH 20E,A02,083772,Staff,24,0,30,6
1649932467365,MATH 20E,B01,083773,Staff,17,0,30,13
1649932467365,MATH 20E,B02,083774,Staff,29,0,30,1
1649932473410,MATH 103A,A01,083777,Staff,1,4,30,29
1649932473410,MATH 103A,A02,083778,Staff,0,3,30,30
1649932473410,MATH 103A,B01,083779,Staff,0,0,30,30
1649932473410,MATH 103A,B02,083780,Staff,16,0,30,14
1649932479435,MATH 105,A01,085443,Staff,0,5,30,30
1649932485466,MATH 109,A01,083213,Anzaldo; Leesa B,13,0,30,17
1649932485466,MATH 109,A02,083214,Anzaldo; Leesa B,9,0,30,21
1649932485466,MATH 109,B01,083215,Anzaldo; Leesa B,26,0,30,4
1649932485466,MATH 109,B02,083216,Anzaldo; Leesa B,22,0,30,8
1649932491509,MATH 142A,A01,083219,Chow; Bennett,0,1,30,30
1649932491509,MATH 142A,A02,083220,Chow; Bennett,9,0,30,21
1649932491509,MATH 142A,B01,083221,Chow; Bennett,0,0,30,30
1649932491509,MATH 142A,B02,083222,Chow; Bennett,1,0,30,29
1649932497538,MATH 193A,A01,083224,Staff,0,3,30,30
1649932497538,MATH 193A,A02,083225,Staff,0,3,30,30
1649932497538,MATH 193A,A03,083781,Staff,4,0,30,26
1649932497538,MATH 193A,A04,083782,Staff,16,0,30,14
1649932503563,MATH 197,001,091859,McAuley; Julian John,9999,0,9999,0
1649932509648,COGS 9,A01,083615,Staff,16,0,60,44
1649932515680,COGS 11,A01,083617,Boyle; Mary E. T.,35,0,40,5
1649932521705,COGS 13,A01,083071,Staff,0,11,40,40
1649932527734,COGS 14A,A01,092681,Staff,65,0,100,35
1649932533765,COGS 14B,A01,083073,Cheng; Tzu-Han,24,0,50,26
1649932539788,COGS 17,A01,092677,Staff,63,0,75,12
1649932545826,COGS 100,A01,083619,Staff,0,6,60,60
1649932551858,COGS 101A,A01,083621,Davis; Joshua Daniel,0,8,60,60
1649932557883,COGS 101B,A01,091572,Staff,31,0,60,29
1649932563907,COGS 101C,A01,083625,Delgado; Tania,24,0,30,6
1649932569936,COGS 107A,A01,083627,Boyle; Mary E. T.,14,0,60,46
1649932575972,COGS 118A,A01,083075,Staff,21,0,60,39
1649932581999,CSE 3,A50,083646,Miranda; Gregory Joseph,24,0,38,14
1649932581999,CSE 3,A51,083647,Miranda; Gregory Joseph,37,0,37,0
1649932588025,CSE 8A,A50,083650,Miranda; Gregory Joseph,8,0,40,32
1649932594055,CSE 11,A01,083080,Cao; Yingjun,0,26,40,40
1649932600094,CSE 12,A01,083652,Staff,56,0,100,44
1649932606124,CSE 15L,A01,083654,Staff,19,0,50,31
1649932606124,CSE 15L,A02,083655,Staff,47,0,50,3
1649932612155,CSE 20,A01,083657,Staff,68,0,80,12
1649932618202,CSE 30,A01,083084,Eldon; John,0,24,40,40
1649932624234,CSE 100,A01,083659,Cao; Yingjun,1,27,50,49
1649932630260,CSE 134B,A01,083661,Powell; Thomas Allan,0,21,65,65
1649932636284,CSE 140,A01,083663,Staff,24,0,75,51
1649932642315,CSE 140L,A01,083088,Eldon; John,18,0,75,57
1649932648341,CSE 175,A01,083665,Kumar; Rakesh,12,0,25,13
1649932654369,CSE 190,A00,092507,Dubnov; Shlomo,14,0,15,1
1649932660392,ECE 45,A01,083139,Staff,6,0,40,34
1649932666422,ECE 65,A50,083695,Staff,7,0,30,23
1649932672451,ECE 109,A01,091882,Touri; Behrouz,55,0,70,15
1649932678481,ECE 180,A00,083140,Abi Samra; Nicholas Camill,26,0,30,4
1649932678481,ECE 180,B00,083141,Abi Samra; Nicholas Camill,13,0,30,17
1649932684506,MATH 10A,A01,083735,Patchell; Gregory David,20,0,30,10
1649932684506,MATH 10A,A02,083736,Patchell; Gregory David,28,0,30,2
1649932684506,MATH 10A,A03,083737,Patchell; Gregory David,28,0,30,2
1649932690544,MATH 10B,A01,083207,Staff,10,0,30,20
1649932690544,MATH 10B,A02,083208,Staff,25,0,30,5
1649932690544,MATH 10B,B01,083739,Staff,25,0,30,5
1649932690544,MATH 10B,B02,083740,Staff,30,0,30,0
1649932696577,MATH 18,A01,083743,Staff,22,0,30,8
1649932696577,MATH 18,A02,083744,Staff,29,0,30,1
1649932696577,MATH 18,A03,083745,Staff,29,0,30,1
1649932696577,MATH 18,A04,083746,Staff,28,0,30,2
1649932696577,MATH 18,B01,083748,Staff,5,0,30,25
1649932696577,MATH 18,B02,083749,Staff,26,0,30,4
1649932696577,MATH 18,B03,083750,Staff,28,0,30,2
1649932696577,MATH 18,B04,083751,Staff,26,0,30,4
1649932702604,MATH 20A,A01,083754,Staff,37,0,40,3
1649932708629,MATH 20B,A01,083756,Staff,19,0,30,11
1649932708629,MATH 20B,A02,083757,Staff,30,0,30,0
1649932714655,MATH 20C,A01,083760,Staff,22,0,30,8
1649932714655,MATH 20C,A02,083761,Staff,23,0,30,7
1649932714655,MATH 20C,B01,083762,Staff,28,0,30,2
1649932714655,MATH 20C,B02,083763,Staff,30,0,30,0
1649932720691,MATH 20D,A01,083765,Staff,20,0,30,10
1649932720691,MATH 20D,A02,083766,Staff,30,0,30,0
1649932720691,MATH 20D,A03,083767,Staff,30,0,30,0
1649932726721,MATH 20E,A01,083771,Staff,12,0,30,18
1649932726721,MATH 20E,A02,083772,Staff,24,0,30,6
1649932726721,MATH 20E,B01,083773,Staff,17,0,30,13
1649932726721,MATH 20E,B02,083774,Staff,29,0,30,1
1649932732752,MATH 103A,A01,083777,Staff,1,4,30,29
1649932732752,MATH 103A,A02,083778,Staff,0,3,30,30
1649932732752,MATH 103A,B01,083779,Staff,0,0,30,30
1649932732752,MATH 103A,B02,083780,Staff,16,0,30,14
1649932738787,MATH 105,A01,085443,Staff,0,5,30,30
1649932744820,MATH 109,A01,083213,Anzaldo; Leesa B,13,0,30,17
1649932744820,MATH 109,A02,083214,Anzaldo; Leesa B,9,0,30,21
1649932744820,MATH 109,B01,083215,Anzaldo; Leesa B,26,0,30,4
1649932744820,MATH 109,B02,083216,Anzaldo; Leesa B,22,0,30,8
1649932750846,MATH 142A,A01,083219,Chow; Bennett,0,1,30,30
1649932750846,MATH 142A,A02,083220,Chow; Bennett,9,0,30,21
1649932750846,MATH 142A,B01,083221,Chow; Bennett,0,0,30,30
1649932750846,MATH 142A,B02,083222,Chow; Bennett,1,0,30,29
1649932756873,MATH 193A,A01,083224,Staff,0,3,30,30
1649932756873,MATH 193A,A02,083225,Staff,0,3,30,30
1649932756873,MATH 193A,A03,083781,Staff,4,0,30,26
1649932756873,MATH 193A,A04,083782,Staff,16,0,30,14
1649932762899,MATH 197,001,091859,McAuley; Julian John,9999,0,9999,0
1649932768967,COGS 9,A01,083615,Staff,16,0,60,44
1649932774997,COGS 11,A01,083617,Boyle; Mary E. T.,35,0,40,5
1649932781095,COGS 13,A01,083071,Staff,0,11,40,40
1649932787125,COGS 14A,A01,092681,Staff,65,0,100,35
1649932793150,COGS 14B,A01,083073,Cheng; Tzu-Han,24,0,50,26
1649932799173,COGS 17,A01,092677,Staff,63,0,75,12
1649932805205,COGS 100,A01,083619,Staff,0,6,60,60
1649932811238,COGS 101A,A01,083621,Davis; Joshua Daniel,0,8,60,60
1649932817263,COGS 101B,A01,091572,Staff,31,0,60,29
1649932823292,COGS 101C,A01,083625,Delgado; Tania,24,0,30,6
1649932829322,COGS 107A,A01,083627,Boyle; Mary E. T.,14,0,60,46
1649932835350,COGS 118A,A01,083075,Staff,21,0,60,39
1649932841386,CSE 3,A50,083646,Miranda; Gregory Joseph,24,0,38,14
1649932841386,CSE 3,A51,083647,Miranda; Gregory Joseph,37,0,37,0
1649932847410,CSE 8A,A50,083650,Miranda; Gregory Joseph,8,0,40,32
1649932853436,CSE 11,A01,083080,Cao; Yingjun,0,26,40,40
1649932859460,CSE 12,A01,083652,Staff,56,0,100,44
1649932865484,CSE 15L,A01,083654,Staff,19,0,50,31
1649932865484,CSE 15L,A02,083655,Staff,47,0,50,3
1649932871514,CSE 20,A01,083657,Staff,68,0,80,12
1649932877546,CSE 30,A01,083084,Eldon; John,0,24,40,40
1649932883572,CSE 100,A01,083659,Cao; Yingjun,1,27,50,49
1649932889599,CSE 134B,A01,083661,Powell; Thomas Allan,0,21,65,65
1649932895622,CSE 140,A01,083663,Staff,24,0,75,51
1649932901650,CSE 140L,A01,083088,Eldon; John,18,0,75,57
1649932907681,CSE 175,A01,083665,Kumar; Rakesh,12,0,25,13
1649932913705,CSE 190,A00,092507,Dubnov; Shlomo,14,0,15,1
1649932919731,ECE 45,A01,083139,Staff,6,0,40,34
1649932925757,ECE 65,A50,083695,Staff,7,0,30,23
1649932931787,ECE 109,A01,091882,Touri; Behrouz,55,0,70,15
1649932937814,ECE 180,A00,083140,Abi Samra; Nicholas Camill,26,0,30,4
1649932937814,ECE 180,B00,083141,Abi Samra; Nicholas Camill,13,0,30,17
1649932943849,MATH 10A,A01,083735,Patchell; Gregory David,20,0,30,10
1649932943849,MATH 10A,A02,083736,Patchell; Gregory David,28,0,30,2
1649932943849,MATH 10A,A03,083737,Patchell; Gregory David,28,0,30,2
1649932949878,MATH 10B,A01,083207,Staff,10,0,30,20
1649932949878,MATH 10B,A02,083208,Staff,25,0,30,5
1649932949878,MATH 10B,B01,083739,Staff,25,0,30,5
1649932949878,MATH 10B,B02,083740,Staff,30,0,30,0
1649932955908,MATH 18,A01,083743,Staff,22,0,30,8
1649932955908,MATH 18,A02,083744,Staff,29,0,30,1
1649932955908,MATH 18,A03,083745,Staff,29,0,30,1
1649932955908,MATH 18,A04,083746,Staff,28,0,30,2
1649932955908,MATH 18,B01,083748,Staff,5,0,30,25
1649932955908,MATH 18,B02,083749,Staff,26,0,30,4
1649932955908,MATH 18,B03,083750,Staff,28,0,30,2
1649932955908,MATH 18,B04,083751,Staff,26,0,30,4
1649932961934,MATH 20A,A01,083754,Staff,37,0,40,3
1649932967960,MATH 20B,A01,083756,Staff,19,0,30,11
1649932967960,MATH 20B,A02,083757,Staff,30,0,30,0
1649932973989,MATH 20C,A01,083760,Staff,22,0,30,8
1649932973989,MATH 20C,A02,083761,Staff,23,0,30,7
1649932973989,MATH 20C,B01,083762,Staff,28,0,30,2
1649932973989,MATH 20C,B02,083763,Staff,30,0,30,0
1649932980018,MATH 20D,A01,083765,Staff,20,0,30,10
1649932980018,MATH 20D,A02,083766,Staff,30,0,30,0
1649932980018,MATH 20D,A03,083767,Staff,30,0,30,0
1649932986049,MATH 20E,A01,083771,Staff,12,0,30,18
1649932986049,MATH 20E,A02,083772,Staff,24,0,30,6
1649932986049,MATH 20E,B01,083773,Staff,17,0,30,13
1649932986049,MATH 20E,B02,083774,Staff,29,0,30,1
1649932992074,MATH 103A,A01,083777,Staff,1,4,30,29
1649932992074,MATH 103A,A02,083778,Staff,0,3,30,30
1649932992074,MATH 103A,B01,083779,Staff,0,0,30,30
1649932992074,MATH 103A,B02,083780,Staff,16,0,30,14
1649932998103,MATH 105,A01,085443,Staff,0,5,30,30
1649933004133,MATH 109,A01,083213,Anzaldo; Leesa B,13,0,30,17
1649933004133,MATH 109,A02,083214,Anzaldo; Leesa B,9,0,30,21
1649933004133,MATH 109,B01,083215,Anzaldo; Leesa B,26,0,30,4
1649933004133,MATH 109,B02,083216,Anzaldo; Leesa B,22,0,30,8
1649933010158,MATH 142A,A01,083219,Chow; Bennett,0,1,30,30
1649933010158,MATH 142A,A02,083220,Chow; Bennett,9,0,30,21
1649933010158,MATH 142A,B01,083221,Chow; Bennett,0,0,30,30
1649933010158,MATH 142A,B02,083222,Chow; Bennett,1,0,30,29
1649933016182,MATH 193A,A01,083224,Staff,0,3,30,30
1649933016182,MATH 193A,A02,083225,Staff,0,3,30,30
1649933016182,MATH 193A,A03,083781,Staff,4,0,30,26
1649933016182,MATH 193A,A04,083782,Staff,16,0,30,14
1649933022207,MATH 197,001,091859,McAuley; Julian John,9999,0,9999,0
1649933028289,COGS 9,A01,083615,Staff,16,0,60,44
1649933034314,COGS 11,A01,083617,Boyle; Mary E. T.,35,0,40,5
1649933040347,COGS 13,A01,083071,Staff,0,11,40,40
1649933046371,COGS 14A,A01,092681,Staff,65,0,100,35
1649933052401,COGS 14B,A01,083073,Cheng; Tzu-Han,24,0,50,26
1649933058425,COGS 17,A01,092677,Staff,63,0,75,12
1649933064453,COGS 100,A01,083619,Staff,0,6,60,60
1649933070479,COGS 101A,A01,083621,Davis; Joshua Daniel,0,8,60,60
1649933076509,COGS 101B,A01,091572,Staff,31,0,60,29
1649933082538,COGS 101C,A01,083625,Delgado; Tania,24,0,30,6
1649933088572,COGS 107A,A01,083627,Boyle; Mary E. T.,14,0,60,46
1649933094599,COGS 118A,A01,083075,Staff,21,0,60,39
1649933100625,CSE 3,A50,083646,Miranda; Gregory Joseph,24,0,38,14
1649933100625,CSE 3,A51,083647,Miranda; Gregory Joseph,37,0,37,0
1649933106653,CSE 8A,A50,083650,Miranda; Gregory Joseph,8,0,40,32
1649933112687,CSE 11,A01,083080,Cao; Yingjun,0,26,40,40
1649933118710,CSE 12,A01,083652,Staff,56,0,100,44
1649933124734,CSE 15L,A01,083654,Staff,19,0,50,31
1649933124734,CSE 15L,A02,083655,Staff,47,0,50,3
1649933130764,CSE 20,A01,083657,Staff,68,0,80,12
1649933136791,CSE 30,A01,083084,Eldon; John,0,24,40,40
1649933142823,CSE 100,A01,083659,Cao; Yingjun,1,27,50,49
1649933148847,CSE 134B,A01,083661,Powell; Thomas Allan,0,21,65,65
1649933154870,CSE 140,A01,083663,Staff,24,0,75,51
1649933160897,CSE 140L,A01,083088,Eldon; John,18,0,75,57
1649933166921,CSE 175,A01,083665,Kumar; Rakesh,12,0,25,13
1649933172949,CSE 190,A00,092507,Dubnov; Shlomo,14,0,15,1
1649933178977,ECE 45,A01,083139,Staff,6,0,40,34
1649933185000,ECE 65,A50,083695,Staff,7,0,30,23
1649933191032,ECE 109,A01,091882,Touri; Behrouz,55,0,70,15
1649933197057,ECE 180,A00,083140,Abi Samra; Nicholas Camill,26,0,30,4
1649933197057,ECE 180,B00,083141,Abi Samra; Nicholas Camill,13,0,30,17
1649933203084,MATH 10A,A01,083735,Patchell; Gregory David,20,0,30,10
1649933203084,MATH 10A,A02,083736,Patchell; Gregory David,28,0,30,2
1649933203084,MATH 10A,A03,083737,Patchell; Gregory David,28,0,30,2
1649933209108,MATH 10B,A01,083207,Staff,10,0,30,20
1649933209108,MATH 10B,A02,083208,Staff,25,0,30,5
1649933209108,MATH 10B,B01,083739,Staff,25,0,30,5
1649933209108,MATH 10B,B02,083740,Staff,30,0,30,0
1649933215134,MATH 18,A01,083743,Staff,22,0,30,8
1649933215134,MATH 18,A02,083744,Staff,29,0,30,1
1649933215134,MATH 18,A03,083745,Staff,29,0,30,1
1649933215134,MATH 18,A04,083746,Staff,28,0,30,2
1649933215134,MATH 18,B01,083748,Staff,5,0,30,25
1649933215134,MATH 18,B02,083749,Staff,26,0,30,4
1649933215134,MATH 18,B03,083750,Staff,28,0,30,2
1649933215134,MATH 18,B04,083751,Staff,26,0,30,4
1649933221160,MATH 20A,A01,083754,Staff,37,0,40,3
1649933227188,MATH 20B,A01,083756,Staff,19,0,30,11
1649933227188,MATH 20B,A02,083757,Staff,30,0,30,0
1649933233212,MATH 20C,A01,083760,Staff,22,0,30,8
1649933233212,MATH 20C,A02,083761,Staff,23,0,30,7
1649933233212,MATH 20C,B01,083762,Staff,28,0,30,2
1649933233212,MATH 20C,B02,083763,Staff,30,0,30,0
1649933239236,MATH 20D,A01,083765,Staff,20,0,30,10
1649933239236,MATH 20D,A02,083766,Staff,30,0,30,0
1649933239236,MATH 20D,A03,083767,Staff,30,0,30,0
1649933245261,MATH 20E,A01,083771,Staff,12,0,30,18
1649933245261,MATH 20E,A02,083772,Staff,24,0,30,6
1649933245261,MATH 20E,B01,083773,Staff,17,0,30,13
1649933245261,MATH 20E,B02,083774,Staff,29,0,30,1
1649933251285,MATH 103A,A01,083777,Staff,1,4,30,29
1649933251285,MATH 103A,A02,083778,Staff,0,3,30,30
1649933251285,MATH 103A,B01,083779,Staff,0,0,30,30
1649933251285,MATH 103A,B02,083780,Staff,16,0,30,14
1649933257313,MATH 105,A01,085443,Staff,0,5,30,30
1649933263336,MATH 109,A01,083213,Anzaldo; Leesa B,13,0,30,17
1649933263336,MATH 109,A02,083214,Anzaldo; Leesa B,9,0,30,21
1649933263336,MATH 109,B01,083215,Anzaldo; Leesa B,26,0,30,4
1649933263336,MATH 109,B02,083216,Anzaldo; Leesa B,22,0,30,8
1649933269366,MATH 142A,A01,083219,Chow; Bennett,0,1,30,30
1649933269366,MATH 142A,A02,083220,Chow; Bennett,9,0,30,21
1649933269366,MATH 142A,B01,083221,Chow; Bennett,0,0,30,30
1649933269366,MATH 142A,B02,083222,Chow; Bennett,1,0,30,29
1649933275397,MATH 193A,A01,083224,Staff,0,3,30,30
1649933275397,MATH 193A,A02,083225,Staff,0,3,30,30
1649933275397,MATH 193A,A03,083781,Staff,4,0,30,26
1649933275397,MATH 193A,A04,083782,Staff,16,0,30,14
1649933281421,MATH 197,001,091859,McAuley; Julian John,9999,0,9999,0
1649933287483,COGS 9,A01,083615,Staff,16,0,60,44
1649933293507,COGS 11,A01,083617,Boyle; Mary E. T.,35,0,40,5
1649933299535,COGS 13,A01,083071,Staff,0,11,40,40
1649933305561,COGS 14A,A01,092681,Staff,65,0,100,35
1649933311589,COGS 14B,A01,083073,Cheng; Tzu-Han,24,0,50,26
1649933317612,COGS 17,A01,092677,Staff,63,0,75,12
1649933323636,COGS 100,A01,083619,Staff,0,6,60,60
1649933329664,COGS 101A,A01,083621,Davis; Joshua Daniel,0,8,60,60
1649933335694,COGS 101B,A01,091572,Staff,31,0,60,29
1649933341718,COGS 101C,A01,083625,Delgado; Tania,24,0,30,6
1649933347747,COGS 107A,A01,083627,Boyle; Mary E. T.,14,0,60,46
1649933353772,COGS 118A,A01,083075,Staff,21,0,60,39
1649933359806,CSE 3,A50,083646,Miranda; Gregory Joseph,24,0,38,14
1649933359806,CSE 3,A51,083647,Miranda; Gregory Joseph,37,0,37,0
1649933365831,CSE 8A,A50,083650,Miranda; Gregory Joseph,8,0,40,32
1649933371857,CSE 11,A01,083080,Cao; Yingjun,0,26,40,40
1649933377951,CSE 12,A01,083652,Staff,56,0,100,44
1649933383976,CSE 15L,A01,083654,Staff,19,0,50,31
1649933383976,CSE 15L,A02,083655,Staff,47,0,50,3
1649933390004,CSE 20,A01,083657,Staff,68,0,80,12
1649933396029,CSE 30,A01,083084,Eldon; John,0,24,40,40
1649933402061,CSE 100,A01,083659,Cao; Yingjun,1,27,50,49
1649933408089,CSE 134B,A01,083661,Powell; Thomas Allan,0,21,65,65
1649933414114,CSE 140,A01,083663,Staff,24,0,75,51
1649933420142,CSE 140L,A01,083088,Eldon; John,18,0,75,57
1649933426166,CSE 175,A01,083665,Kumar; Rakesh,12,0,25,13
1649933432192,CSE 190,A00,092507,Dubnov; Shlomo,14,0,15,1
1649933438222,ECE 45,A01,083139,Staff,6,0,40,34
1649933444250,ECE 65,A50,083695,Staff,7,0,30,23
1649933450276,ECE 109,A01,091882,Touri; Behrouz,55,0,70,15
1649933456299,ECE 180,A00,083140,Abi Samra; Nicholas Camill,26,0,30,4
1649933456299,ECE 180,B00,083141,Abi Samra; Nicholas Camill,13,0,30,17
1649933462349,MATH 10A,A01,083735,Patchell; Gregory David,20,0,30,10
1649933462349,MATH 10A,A02,083736,Patchell; Gregory David,28,0,30,2
1649933462349,MATH 10A,A03,083737,Patchell; Gregory David,28,0,30,2
1649933468377,MATH 10B,A01,083207,Staff,10,0,30,20
1649933468377,MATH 10B,A02,083208,Staff,25,0,30,5
1649933468377,MATH 10B,B01,083739,Staff,25,0,30,5
1649933468377,MATH 10B,B02,083740,Staff,30,0,30,0
1649933474402,MATH 18,A01,083743,Staff,22,0,30,8
1649933474402,MATH 18,A02,083744,Staff,29,0,30,1
1649933474402,MATH 18,A03,083745,Staff,29,0,30,1
1649933474402,MATH 18,A04,083746,Staff,28,0,30,2
1649933474402,MATH 18,B01,083748,Staff,5,0,30,25
1649933474402,MATH 18,B02,083749,Staff,26,0,30,4
1649933474402,MATH 18,B03,083750,Staff,28,0,30,2
1649933474402,MATH 18,B04,083751,Staff,26,0,30,4
1649933480430,MATH 20A,A01,083754,Staff,37,0,40,3
1649933486454,MATH 20B,A01,083756,Staff,19,0,30,11
1649933486454,MATH 20B,A02,083757,Staff,30,0,30,0
1649933492479,MATH 20C,A01,083760,Staff,22,0,30,8
1649933492479,MATH 20C,A02,083761,Staff,23,0,30,7
1649933492479,MATH 20C,B01,083762,Staff,28,0,30,2
1649933492479,MATH 20C,B02,083763,Staff,30,0,30,0
1649933498503,MATH 20D,A01,083765,Staff,20,0,30,10
1649933498503,MATH 20D,A02,083766,Staff,30,0,30,0
1649933498503,MATH 20D,A03,083767,Staff,30,0,30,0
1649933504533,MATH 20E,A01,083771,Staff,12,0,30,18
1649933504533,MATH 20E,A02,083772,Staff,24,0,30,6
1649933504533,MATH 20E,B01,083773,Staff,17,0,30,13
1649933504533,MATH 20E,B02,083774,Staff,29,0,30,1
1649933510558,MATH 103A,A01,083777,Staff,1,4,30,29
1649933510558,MATH 103A,A02,083778,Staff,0,3,30,30
1649933510558,MATH 103A,B01,083779,Staff,0,0,30,30
1649933510558,MATH 103A,B02,083780,Staff,16,0,30,14
1649933516582,MATH 105,A01,085443,Staff,0,5,30,30
1649933522607,MATH 109,A01,083213,Anzaldo; Leesa B,13,0,30,17
1649933522607,MATH 109,A02,083214,Anzaldo; Leesa B,9,0,30,21
1649933522607,MATH 109,B01,083215,Anzaldo; Leesa B,26,0,30,4
1649933522607,MATH 109,B02,083216,Anzaldo; Leesa B,22,0,30,8
1649933528631,MATH 142A,A01,083219,Chow; Bennett,0,1,30,30
1649933528631,MATH 142A,A02,083220,Chow; Bennett,9,0,30,21
1649933528631,MATH 142A,B01,083221,Chow; Bennett,0,0,30,30
1649933528631,MATH 142A,B02,083222,Chow; Bennett,1,0,30,29
1649933534654,MATH 193A,A01,083224,Staff,0,3,30,30
1649933534654,MATH 193A,A02,083225,Staff,0,3,30,30
1649933534654,MATH 193A,A03,083781,Staff,4,0,30,26
1649933534654,MATH 193A,A04,083782,Staff,16,0,30,14
1649933540686,MATH 197,001,091859,McAuley; Julian John,9999,0,9999,0
1649933546757,COGS 9,A01,083615,Staff,16,0,60,44
1649933552786,COGS 11,A01,083617,Boyle; Mary E. T.,35,0,40,5
1649933558810,COGS 13,A01,083071,Staff,0,11,40,40
1649933564840,COGS 14A,A01,092681,Staff,65,0,100,35
1649933570884,COGS 14B,A01,083073,Cheng; Tzu-Han,24,0,50,26
1649933576911,COGS 17,A01,092677,Staff,63,0,75,12
1649933582934,COGS 100,A01,083619,Staff,0,6,60,60
1649933588958,COGS 101A,A01,083621,Davis; Joshua Daniel,0,8,60,60
1649933594982,COGS 101B,A01,091572,Staff,31,0,60,29
1649933601008,COGS 101C,A01,083625,Delgado; Tania,24,0,30,6
1649933607031,COGS 107A,A01,083627,Boyle; Mary E. T.,14,0,60,46
1649933613054,COGS 118A,A01,083075,Staff,21,0,60,39
1649933619081,CSE 3,A50,083646,Miranda; Gregory Joseph,24,0,38,14
1649933619081,CSE 3,A51,083647,Miranda; Gregory Joseph,37,0,37,0
1649933625110,CSE 8A,A50,083650,Miranda; Gregory Joseph,8,0,40,32
1649933631136,CSE 11,A01,083080,Cao; Yingjun,0,26,40,40
1649933637161,CSE 12,A01,083652,Staff,56,0,100,44
1649933643186,CSE 15L,A01,083654,Staff,19,0,50,31
1649933643186,CSE 15L,A02,083655,Staff,47,0,50,3
1649933649210,CSE 20,A01,083657,Staff,68,0,80,12
1649933655235,CSE 30,A01,083084,Eldon; John,0,24,40,40
1649933661259,CSE 100,A01,083659,Cao; Yingjun,1,27,50,49
1649933667285,CSE 134B,A01,083661,Powell; Thomas Allan,0,21,65,65
1649933673308,CSE 140,A01,083663,Staff,24,0,75,51
1649933679338,CSE 140L,A01,083088,Eldon; John,18,0,75,57
1649933685367,CSE 175,A01,083665,Kumar; Rakesh,12,0,25,13
1649933691391,CSE 190,A00,092507,Dubnov; Shlomo,14,0,15,1
1649933697422,ECE 45,A01,083139,Staff,6,0,40,34
1649933703453,ECE 65,A50,083695,Staff,7,0,30,23
1649933709476,ECE 109,A01,091882,Touri; Behrouz,55,0,70,15
1649933715503,ECE 180,A00,083140,Abi Samra; Nicholas Camill,26,0,30,4
1649933715503,ECE 180,B00,083141,Abi Samra; Nicholas Camill,13,0,30,17
1649933721532,MATH 10A,A01,083735,Patchell; Gregory David,20,0,30,10
1649933721532,MATH 10A,A02,083736,Patchell; Gregory David,28,0,30,2
1649933721532,MATH 10A,A03,083737,Patchell; Gregory David,28,0,30,2
1649933727557,MATH 10B,A01,083207,Staff,10,0,30,20
1649933727557,MATH 10B,A02,083208,Staff,25,0,30,5
1649933727557,MATH 10B,B01,083739,Staff,25,0,30,5
1649933727557,MATH 10B,B02,083740,Staff,30,0,30,0
1649933733584,MATH 18,A01,083743,Staff,22,0,30,8
1649933733584,MATH 18,A02,083744,Staff,29,0,30,1
1649933733584,MATH 18,A03,083745,Staff,29,0,30,1
1649933733584,MATH 18,A04,083746,Staff,28,0,30,2
1649933733584,MATH 18,B01,083748,Staff,5,0,30,25
1649933733584,MATH 18,B02,083749,Staff,26,0,30,4
1649933733584,MATH 18,B03,083750,Staff,28,0,30,2
1649933733584,MATH 18,B04,083751,Staff,26,0,30,4
1649933739610,MATH 20A,A01,083754,Staff,37,0,40,3
1649933745632,MATH 20B,A01,083756,Staff,19,0,30,11
1649933745632,MATH 20B,A02,083757,Staff,30,0,30,0
1649933751661,MATH 20C,A01,083760,Staff,22,0,30,8
1649933751661,MATH 20C,A02,083761,Staff,23,0,30,7
1649933751661,MATH 20C,B01,083762,Staff,28,0,30,2
1649933751661,MATH 20C,B02,083763,Staff,30,0,30,0
1649933757701,MATH 20D,A01,083765,Staff,20,0,30,10
1649933757701,MATH 20D,A02,083766,Staff,30,0,30,0
1649933757701,MATH 20D,A03,083767,Staff,30,0,30,0
1649933763730,MATH 20E,A01,083771,Staff,12,0,30,18
1649933763730,MATH 20E,A02,083772,Staff,24,0,30,6
1649933763730,MATH 20E,B01,083773,Staff,17,0,30,13
1649933763730,MATH 20E,B02,083774,Staff,29,0,30,1
1649933769763,MATH 103A,A01,083777,Staff,1,4,30,29
1649933769763,MATH 103A,A02,083778,Staff,0,3,30,30
1649933769763,MATH 103A,B01,083779,Staff,0,0,30,30
1649933769763,MATH 103A,B02,083780,Staff,16,0,30,14
1649933775787,MATH 105,A01,085443,Staff,0,5,30,30
1649933781813,MATH 109,A01,083213,Anzaldo; Leesa B,13,0,30,17
1649933781813,MATH 109,A02,083214,Anzaldo; Leesa B,9,0,30,21
1649933781813,MATH 109,B01,083215,Anzaldo; Leesa B,26,0,30,4
1649933781813,MATH 109,B02,083216,Anzaldo; Leesa B,22,0,30,8
1649933787839,MATH 142A,A01,083219,Chow; Bennett,0,1,30,30
1649933787839,MATH 142A,A02,083220,Chow; Bennett,9,0,30,21
1649933787839,MATH 142A,B01,083221,Chow; Bennett,0,0,30,30
1649933787839,MATH 142A,B02,083222,Chow; Bennett,1,0,30,29
1649933793867,MATH 193A,A01,083224,Staff,0,3,30,30
1649933793867,MATH 193A,A02,083225,Staff,0,3,30,30
1649933793867,MATH 193A,A03,083781,Staff,4,0,30,26
1649933793867,MATH 193A,A04,083782,Staff,16,0,30,14
1649933799894,MATH 197,001,091859,McAuley; Julian John,9999,0,9999,0
1649933805971,COGS 9,A01,083615,Staff,16,0,60,44
1649933811995,COGS 11,A01,083617,Boyle; Mary E. T.,35,0,40,5
1649933818022,COGS 13,A01,083071,Staff,0,11,40,40
1649933824050,COGS 14A,A01,092681,Staff,65,0,100,35
1649933830074,COGS 14B,A01,083073,Cheng; Tzu-Han,24,0,50,26
1649933836107,COGS 17,A01,092677,Staff,63,0,75,12
1649933842137,COGS 100,A01,083619,Staff,0,6,60,60
1649933848175,COGS 101A,A01,083621,Davis; Joshua Daniel,0,8,60,60
1649933854204,COGS 101B,A01,091572,Staff,31,0,60,29
1649933860227,COGS 101C,A01,083625,Delgado; Tania,24,0,30,6
1649933866257,COGS 107A,A01,083627,Boyle; Mary E. T.,14,0,60,46
1649933872279,COGS 118A,A01,083075,Staff,21,0,60,39
1649933878305,CSE 3,A50,083646,Miranda; Gregory Joseph,24,0,38,14
1649933878305,CSE 3,A51,083647,Miranda; Gregory Joseph,37,0,37,0
1649933884329,CSE 8A,A50,083650,Miranda; Gregory Joseph,8,0,40,32
1649933890353,CSE 11,A01,083080,Cao; Yingjun,0,26,40,40
1649933896377,CSE 12,A01,083652,Staff,56,0,100,44
1649933902402,CSE 15L,A01,083654,Staff,19,0,50,31
1649933902402,CSE 15L,A02,083655,Staff,47,0,50,3
1649933908427,CSE 20,A01,083657,Staff,68,0,80,12
1649933914455,CSE 30,A01,083084,Eldon; John,0,24,40,40
1649933920478,CSE 100,A01,083659,Cao; Yingjun,1,27,50,49
1649933926502,CSE 134B,A01,083661,Powell; Thomas Allan,0,21,65,65
1649933932526,CSE 140,A01,083663,Staff,24,0,75,51
1649933938554,CSE 140L,A01,083088,Eldon; John,18,0,75,57
1649933944577,CSE 175,A01,083665,Kumar; Rakesh,12,0,25,13
1649933950605,CSE 190,A00,092507,Dubnov; Shlomo,14,0,15,1
1649933956684,ECE 45,A01,083139,Staff,6,0,40,34
1649933962713,ECE 65,A50,083695,Staff,7,0,30,23
1649933968742,ECE 109,A01,091882,Touri; Behrouz,55,0,70,15
1649933974844,ECE 180,A00,083140,Abi Samra; Nicholas Camill,26,0,30,4
1649933974844,ECE 180,B00,083141,Abi Samra; Nicholas Camill,13,0,30,17
1649933980878,MATH 10A,A01,083735,Patchell; Gregory David,20,0,30,10
1649933980878,MATH 10A,A02,083736,Patchell; Gregory David,28,0,30,2
1649933980878,MATH 10A,A03,083737,Patchell; Gregory David,28,0,30,2
1649933986907,MATH 10B,A01,083207,Staff,10,0,30,20
1649933986907,MATH 10B,A02,083208,Staff,25,0,30,5
1649933986907,MATH 10B,B01,083739,Staff,25,0,30,5
1649933986907,MATH 10B,B02,083740,Staff,30,0,30,0
1649933992935,MATH 18,A01,083743,Staff,22,0,30,8
1649933992935,MATH 18,A02,083744,Staff,29,0,30,1
1649933992935,MATH 18,A03,083745,Staff,29,0,30,1
1649933992935,MATH 18,A04,083746,Staff,28,0,30,2
1649933992935,MATH 18,B01,083748,Staff,5,0,30,25
1649933992935,MATH 18,B02,083749,Staff,26,0,30,4
1649933992935,MATH 18,B03,083750,Staff,28,0,30,2
1649933992935,MATH 18,B04,083751,Staff,26,0,30,4
1649933998962,MATH 20A,A01,083754,Staff,37,0,40,3
1649934004992,MATH 20B,A01,083756,Staff,19,0,30,11
1649934004992,MATH 20B,A02,083757,Staff,30,0,30,0
1649934011016,MATH 20C,A01,083760,Staff,22,0,30,8
1649934011016,MATH 20C,A02,083761,Staff,23,0,30,7
1649934011016,MATH 20C,B01,083762,Staff,28,0,30,2
1649934011016,MATH 20C,B02,083763,Staff,30,0,30,0
1649934017039,MATH 20D,A01,083765,Staff,20,0,30,10
1649934017039,MATH 20D,A02,083766,Staff,30,0,30,0
1649934017039,MATH 20D,A03,083767,Staff,30,0,30,0
1649934023068,MATH 20E,A01,083771,Staff,12,0,30,18
1649934023068,MATH 20E,A02,083772,Staff,24,0,30,6
1649934023068,MATH 20E,B01,083773,Staff,17,0,30,13
1649934023068,MATH 20E,B02,083774,Staff,29,0,30,1
1649934029101,MATH 103A,A01,083777,Staff,1,4,30,29
1649934029101,MATH 103A,A02,083778,Staff,0,3,30,30
1649934029101,MATH 103A,B01,083779,Staff,0,0,30,30
1649934029101,MATH 103A,B02,083780,Staff,16,0,30,14
1649934035123,MATH 105,A01,085443,Staff,0,5,30,30
1649934041151,MATH 109,A01,083213,Anzaldo; Leesa B,13,0,30,17
1649934041151,MATH 109,A02,083214,Anzaldo; Leesa B,9,0,30,21
1649934041151,MATH 109,B01,083215,Anzaldo; Leesa B,26,0,30,4
1649934041151,MATH 109,B02,083216,Anzaldo; Leesa B,22,0,30,8
1649934047184,MATH 142A,A01,083219,Chow; Bennett,0,1,30,30
1649934047184,MATH 142A,A02,083220,Chow; Bennett,9,0,30,21
1649934047184,MATH 142A,B01,083221,Chow; Bennett,0,0,30,30
1649934047184,MATH 142A,B02,083222,Chow; Bennett,1,0,30,29
1649934053207,MATH 193A,A01,083224,Staff,0,3,30,30
1649934053207,MATH 193A,A02,083225,Staff,0,3,30,30
1649934053207,MATH 193A,A03,083781,Staff,4,0,30,26
1649934053207,MATH 193A,A04,083782,Staff,16,0,30,14
1649934059229,MATH 197,001,091859,McAuley; Julian John,9999,0,9999,0
1649934065286,COGS 9,A01,083615,Staff,16,0,60,44
1649934071316,COGS 11,A01,083617,Boyle; Mary E. T.,35,0,40,5
1649934077339,COGS 13,A01,083071,Staff,0,11,40,40
1649934083362,COGS 14A,A01,092681,Staff,65,0,100,35
1649934089391,COGS 14B,A01,083073,Cheng; Tzu-Han,24,0,50,26
1649934095418,COGS 17,A01,092677,Staff,63,0,75,12
1649934101442,COGS 100,A01,083619,Staff,0,6,60,60
1649934107467,COGS 101A,A01,083621,Davis; Joshua Daniel,0,8,60,60
1649934113494,COGS 101B,A01,091572,Staff,31,0,60,29
1649934119517,COGS 101C,A01,083625,Delgado; Tania,24,0,30,6
1649934125547,COGS 107A,A01,083627,Boyle; Mary E. T.,14,0,60,46
1649934131574,COGS 118A,A01,083075,Staff,21,0,60,39
1649934137600,CSE 3,A50,083646,Miranda; Gregory Joseph,24,0,38,14
1649934137600,CSE 3,A51,083647,Miranda; Gregory Joseph,37,0,37,0
1649934143624,CSE 8A,A50,083650,Miranda; Gregory Joseph,8,0,40,32
1649934149648,CSE 11,A01,083080,Cao; Yingjun,0,26,40,40
1649934155674,CSE 12,A01,083652,Staff,56,0,100,44
1649934161697,CSE 15L,A01,083654,Staff,19,0,50,31
1649934161697,CSE 15L,A02,083655,Staff,47,0,50,3
1649934167726,CSE 20,A01,083657,Staff,68,0,80,12
1649934173748,CSE 30,A01,083084,Eldon; John,0,24,40,40
1649934179776,CSE 100,A01,083659,Cao; Yingjun,1,27,50,49
1649934185806,CSE 134B,A01,083661,Powell; Thomas Allan,0,21,65,65
1649934191831,CSE 140,A01,083663,Staff,24,0,75,51
1649934197859,CSE 140L,A01,083088,Eldon; John,18,0,75,57
1649934203885,CSE 175,A01,083665,Kumar; Rakesh,12,0,25,13
1649934209909,CSE 190,A00,092507,Dubnov; Shlomo,14,0,15,1
1649934215942,ECE 45,A01,083139,Staff,6,0,40,34
1649934221970,ECE 65,A50,083695,Staff,7,0,30,23
1649934227999,ECE 109,A01,091882,Touri; Behrouz,55,0,70,15
1649934234028,ECE 180,A00,083140,Abi Samra; Nicholas Camill,26,0,30,4
1649934234028,ECE 180,B00,083141,Abi Samra; Nicholas Camill,13,0,30,17
1649934240060,MATH 10A,A01,083735,Patchell; Gregory David,20,0,30,10
1649934240060,MATH 10A,A02,083736,Patchell; Gregory David,28,0,30,2
1649934240060,MATH 10A,A03,083737,Patchell; Gregory David,28,0,30,2
1649934246084,MATH 10B,A01,083207,Staff,10,0,30,20
1649934246084,MATH 10B,A02,083208,Staff,25,0,30,5
1649934246084,MATH 10B,B01,083739,Staff,25,0,30,5
1649934246084,MATH 10B,B02,083740,Staff,30,0,30,0
1649934252114,MATH 18,A01,083743,Staff,22,0,30,8
1649934252114,MATH 18,A02,083744,Staff,29,0,30,1
1649934252114,MATH 18,A03,083745,Staff,29,0,30,1
1649934252114,MATH 18,A04,083746,Staff,28,0,30,2
1649934252114,MATH 18,B01,083748,Staff,5,0,30,25
1649934252114,MATH 18,B02,083749,Staff,26,0,30,4
1649934252114,MATH 18,B03,083750,Staff,28,0,30,2
1649934252114,MATH 18,B04,083751,Staff,26,0,30,4
1649934258139,MATH 20A,A01,083754,Staff,37,0,40,3
1649934264170,MATH 20B,A01,083756,Staff,19,0,30,11
1649934264170,MATH 20B,A02,083757,Staff,30,0,30,0
1649934270198,MATH 20C,A01,083760,Staff,22,0,30,8
1649934270198,MATH 20C,A02,083761,Staff,23,0,30,7
1649934270198,MATH 20C,B01,083762,Staff,28,0,30,2
1649934270198,MATH 20C,B02,083763,Staff,30,0,30,0
1649934276222,MATH 20D,A01,083765,Staff,20,0,30,10
1649934276222,MATH 20D,A02,083766,Staff,30,0,30,0
1649934276222,MATH 20D,A03,083767,Staff,30,0,30,0
1649934282246,MATH 20E,A01,083771,Staff,12,0,30,18
1649934282246,MATH 20E,A02,083772,Staff,24,0,30,6
1649934282246,MATH 20E,B01,083773,Staff,17,0,30,13
1649934282246,MATH 20E,B02,083774,Staff,29,0,30,1
1649934288270,MATH 103A,A01,083777,Staff,1,4,30,29
1649934288270,MATH 103A,A02,083778,Staff,0,3,30,30
1649934288270,MATH 103A,B01,083779,Staff,0,0,30,30
1649934288270,MATH 103A,B02,083780,Staff,16,0,30,14
1649934294303,MATH 105,A01,085443,Staff,0,5,30,30
1649934300328,MATH 109,A01,083213,Anzaldo; Leesa B,13,0,30,17
1649934300328,MATH 109,A02,083214,Anzaldo; Leesa B,9,0,30,21
1649934300328,MATH 109,B01,083215,Anzaldo; Leesa B,26,0,30,4
1649934300328,MATH 109,B02,083216,Anzaldo; Leesa B,22,0,30,8
1649934306358,MATH 142A,A01,083219,Chow; Bennett,0,1,30,30
1649934306358,MATH 142A,A02,083220,Chow; Bennett,9,0,30,21
1649934306358,MATH 142A,B01,083221,Chow; Bennett,0,0,30,30
1649934306358,MATH 142A,B02,083222,Chow; Bennett,1,0,30,29
1649934312381,MATH 193A,A01,083224,Staff,0,3,30,30
1649934312381,MATH 193A,A02,083225,Staff,0,3,30,30
1649934312381,MATH 193A,A03,083781,Staff,4,0,30,26
1649934312381,MATH 193A,A04,083782,Staff,16,0,30,14
1649934318410,MATH 197,001,091859,McAuley; Julian John,9999,0,9999,0
1649934324550,COGS 9,A01,083615,Staff,16,0,60,44
1649934330581,COGS 11,A01,083617,Boyle; Mary E. T.,35,0,40,5
1649934336604,COGS 13,A01,083071,Staff,0,11,40,40
1649934342631,COGS 14A,A01,092681,Staff,65,0,100,35
1649934348658,COGS 14B,A01,083073,Cheng; Tzu-Han,24,0,50,26
1649934354689,COGS 17,A01,092677,Staff,63,0,75,12
1649934360713,COGS 100,A01,083619,Staff,0,6,60,60
1649934366737,COGS 101A,A01,083621,Davis; Joshua Daniel,0,8,60,60
1649934372764,COGS 101B,A01,091572,Staff,31,0,60,29
1649934378802,COGS 101C,A01,083625,Delgado; Tania,24,0,30,6
1649934384833,COGS 107A,A01,083627,Boyle; Mary E. T.,14,0,60,46
1649934390861,COGS 118A,A01,083075,Staff,21,0,60,39
1649934396888,CSE 3,A50,083646,Miranda; Gregory Joseph,24,0,38,14
1649934396888,CSE 3,A51,083647,Miranda; Gregory Joseph,37,0,37,0
1649934402919,CSE 8A,A50,083650,Miranda; Gregory Joseph,8,0,40,32
1649934408942,CSE 11,A01,083080,Cao; Yingjun,0,26,40,40
1649934414969,CSE 12,A01,083652,Staff,56,0,100,44
1649934420991,CSE 15L,A01,083654,Staff,19,0,50,31
1649934420991,CSE 15L,A02,083655,Staff,47,0,50,3
1649934427032,CSE 20,A01,083657,Staff,68,0,80,12
1649934433057,CSE 30,A01,083084,Eldon; John,0,24,40,40
1649934439086,CSE 100,A01,083659,Cao; Yingjun,1,27,50,49
1649934445114,CSE 134B,A01,083661,Powell; Thomas Allan,0,21,65,65
1649934451137,CSE 140,A01,083663,Staff,24,0,75,51
1649934457159,CSE 140L,A01,083088,Eldon; John,18,0,75,57
1649934463184,CSE 175,A01,083665,Kumar; Rakesh,12,0,25,13
1649934469213,CSE 190,A00,092507,Dubnov; Shlomo,14,0,15,1
1649934475237,ECE 45,A01,083139,Staff,6,0,40,34
1649934481268,ECE 65,A50,083695,Staff,7,0,30,23
1649934487292,ECE 109,A01,091882,Touri; Behrouz,55,0,70,15
1649934493318,ECE 180,A00,083140,Abi Samra; Nicholas Camill,26,0,30,4
1649934493318,ECE 180,B00,083141,Abi Samra; Nicholas Camill,13,0,30,17
1649934499344,MATH 10A,A01,083735,Patchell; Gregory David,20,0,30,10
1649934499344,MATH 10A,A02,083736,Patchell; Gregory David,28,0,30,2
1649934499344,MATH 10A,A03,083737,Patchell; Gregory David,28,0,30,2
1649934505374,MATH 10B,A01,083207,Staff,10,0,30,20
1649934505374,MATH 10B,A02,083208,Staff,25,0,30,5
1649934505374,MATH 10B,B01,083739,Staff,25,0,30,5
1649934505374,MATH 10B,B02,083740,Staff,30,0,30,0
1649934511409,MATH 18,A01,083743,Staff,22,0,30,8
1649934511409,MATH 18,A02,083744,Staff,29,0,30,1
1649934511409,MATH 18,A03,083745,Staff,29,0,30,1
1649934511409,MATH 18,A04,083746,Staff,28,0,30,2
1649934511409,MATH 18,B01,083748,Staff,5,0,30,25
1649934511409,MATH 18,B02,083749,Staff,26,0,30,4
1649934511409,MATH 18,B03,083750,Staff,28,0,30,2
1649934511409,MATH 18,B04,083751,Staff,26,0,30,4
1649934517437,MATH 20A,A01,083754,Staff,37,0,40,3
1649934523467,MATH 20B,A01,083756,Staff,19,0,30,11
1649934523467,MATH 20B,A02,083757,Staff,30,0,30,0
1649934529497,MATH 20C,A01,083760,Staff,22,0,30,8
1649934529497,MATH 20C,A02,083761,Staff,23,0,30,7
1649934529497,MATH 20C,B01,083762,Staff,28,0,30,2
1649934529497,MATH 20C,B02,083763,Staff,30,0,30,0
1649934535523,MATH 20D,A01,083765,Staff,20,0,30,10
1649934535523,MATH 20D,A02,083766,Staff,30,0,30,0
1649934535523,MATH 20D,A03,083767,Staff,30,0,30,0
1649934541569,MATH 20E,A01,083771,Staff,12,0,30,18
1649934541569,MATH 20E,A02,083772,Staff,24,0,30,6
1649934541569,MATH 20E,B01,083773,Staff,17,0,30,13
1649934541569,MATH 20E,B02,083774,Staff,29,0,30,1
1649934547595,MATH 103A,A01,083777,Staff,1,4,30,29
1649934547595,MATH 103A,A02,083778,Staff,0,3,30,30
1649934547595,MATH 103A,B01,083779,Staff,0,0,30,30
1649934547595,MATH 103A,B02,083780,Staff,16,0,30,14
1649934553624,MATH 105,A01,085443,Staff,0,5,30,30
1649934559656,MATH 109,A01,083213,Anzaldo; Leesa B,13,0,30,17
1649934559656,MATH 109,A02,083214,Anzaldo; Leesa B,9,0,30,21
1649934559656,MATH 109,B01,083215,Anzaldo; Leesa B,26,0,30,4
1649934559656,MATH 109,B02,083216,Anzaldo; Leesa B,22,0,30,8
1649934565688,MATH 142A,A01,083219,Chow; Bennett,0,1,30,30
1649934565688,MATH 142A,A02,083220,Chow; Bennett,9,0,30,21
1649934565688,MATH 142A,B01,083221,Chow; Bennett,0,0,30,30
1649934565688,MATH 142A,B02,083222,Chow; Bennett,1,0,30,29
1649934571716,MATH 193A,A01,083224,Staff,0,3,30,30
1649934571716,MATH 193A,A02,083225,Staff,0,3,30,30
1649934571716,MATH 193A,A03,083781,Staff,4,0,30,26
1649934571716,MATH 193A,A04,083782,Staff,16,0,30,14
1649934577741,MATH 197,001,091859,McAuley; Julian John,9999,0,9999,0
1649934583797,COGS 9,A01,083615,Staff,16,0,60,44
1649934589821,COGS 11,A01,083617,Boyle; Mary E. T.,35,0,40,5
1649934595844,COGS 13,A01,083071,Staff,0,11,40,40
1649934601873,COGS 14A,A01,092681,Staff,65,0,100,35
1649934607910,COGS 14B,A01,083073,Cheng; Tzu-Han,24,0,50,26
1649934613935,COGS 17,A01,092677,Staff,63,0,75,12
1649934619959,COGS 100,A01,083619,Staff,0,5,60,60
1649934625990,COGS 101A,A01,083621,Davis; Joshua Daniel,0,8,60,60
1649934632015,COGS 101B,A01,091572,Staff,31,0,60,29
1649934638040,COGS 101C,A01,083625,Delgado; Tania,24,0,30,6
1649934644066,COGS 107A,A01,083627,Boyle; Mary E. T.,14,0,60,46
1649934650174,COGS 118A,A01,083075,Staff,21,0,60,39
1649934656200,CSE 3,A50,083646,Miranda; Gregory Joseph,24,0,38,14
1649934656200,CSE 3,A51,083647,Miranda; Gregory Joseph,37,0,37,0
1649934662224,CSE 8A,A50,083650,Miranda; Gregory Joseph,8,0,40,32
1649934668250,CSE 11,A01,083080,Cao; Yingjun,0,26,40,40
1649934674283,CSE 12,A01,083652,Staff,56,0,100,44
1649934680305,CSE 15L,A01,083654,Staff,19,0,50,31
1649934680305,CSE 15L,A02,083655,Staff,47,0,50,3
1649934686329,CSE 20,A01,083657,Staff,68,0,80,12
1649934692352,CSE 30,A01,083084,Eldon; John,0,24,40,40
1649934698408,CSE 100,A01,083659,Cao; Yingjun,1,27,50,49
1649934704432,CSE 134B,A01,083661,Powell; Thomas Allan,0,21,65,65
1649934710456,CSE 140,A01,083663,Staff,24,0,75,51
1649934716479,CSE 140L,A01,083088,Eldon; John,18,0,75,57
1649934722504,CSE 175,A01,083665,Kumar; Rakesh,12,0,25,13
1649934728529,CSE 190,A00,092507,Dubnov; Shlomo,14,0,15,1
1649934734569,ECE 45,A01,083139,Staff,6,0,40,34
1649934740594,ECE 65,A50,083695,Staff,7,0,30,23
1649934746619,ECE 109,A01,091882,Touri; Behrouz,55,0,70,15
1649934752644,ECE 180,A00,083140,Abi Samra; Nicholas Camill,26,0,30,4
1649934752644,ECE 180,B00,083141,Abi Samra; Nicholas Camill,13,0,30,17
1649934758686,MATH 10A,A01,083735,Patchell; Gregory David,20,0,30,10
1649934758686,MATH 10A,A02,083736,Patchell; Gregory David,28,0,30,2
1649934758686,MATH 10A,A03,083737,Patchell; Gregory David,28,0,30,2
1649934764714,MATH 10B,A01,083207,Staff,10,0,30,20
1649934764714,MATH 10B,A02,083208,Staff,25,0,30,5
1649934764714,MATH 10B,B01,083739,Staff,25,0,30,5
1649934764714,MATH 10B,B02,083740,Staff,30,0,30,0
1649934770743,MATH 18,A01,083743,Staff,22,0,30,8
1649934770743,MATH 18,A02,083744,Staff,29,0,30,1
1649934770743,MATH 18,A03,083745,Staff,29,0,30,1
1649934770743,MATH 18,A04,083746,Staff,28,0,30,2
1649934770743,MATH 18,B01,083748,Staff,5,0,30,25
1649934770743,MATH 18,B02,083749,Staff,26,0,30,4
1649934770743,MATH 18,B03,083750,Staff,28,0,30,2
1649934770743,MATH 18,B04,083751,Staff,26,0,30,4
1649934776772,MATH 20A,A01,083754,Staff,37,0,40,3
1649934782798,MATH 20B,A01,083756,Staff,19,0,30,11
1649934782798,MATH 20B,A02,083757,Staff,30,0,30,0
1649934788824,MATH 20C,A01,083760,Staff,22,0,30,8
1649934788824,MATH 20C,A02,083761,Staff,23,0,30,7
1649934788824,MATH 20C,B01,083762,Staff,28,0,30,2
1649934788824,MATH 20C,B02,083763,Staff,30,0,30,0
1649934794849,MATH 20D,A01,083765,Staff,20,0,30,10
1649934794849,MATH 20D,A02,083766,Staff,30,0,30,0
1649934794849,MATH 20D,A03,083767,Staff,30,0,30,0
1649934800875,MATH 20E,A01,083771,Staff,12,0,30,18
1649934800875,MATH 20E,A02,083772,Staff,24,0,30,6
1649934800875,MATH 20E,B01,083773,Staff,17,0,30,13
1649934800875,MATH 20E,B02,083774,Staff,29,0,30,1
1649934806904,MATH 103A,A01,083777,Staff,1,4,30,29
1649934806904,MATH 103A,A02,083778,Staff,0,3,30,30
1649934806904,MATH 103A,B01,083779,Staff,0,0,30,30
1649934806904,MATH 103A,B02,083780,Staff,16,0,30,14
1649934812928,MATH 105,A01,085443,Staff,0,5,30,30
1649934818957,MATH 109,A01,083213,Anzaldo; Leesa B,13,0,30,17
1649934818957,MATH 109,A02,083214,Anzaldo; Leesa B,9,0,30,21
1649934818957,MATH 109,B01,083215,Anzaldo; Leesa B,26,0,30,4
1649934818957,MATH 109,B02,083216,Anzaldo; Leesa B,22,0,30,8
1649934824981,MATH 142A,A01,083219,Chow; Bennett,0,1,30,30
1649934824981,MATH 142A,A02,083220,Chow; Bennett,9,0,30,21
1649934824981,MATH 142A,B01,083221,Chow; Bennett,0,0,30,30
1649934824981,MATH 142A,B02,083222,Chow; Bennett,1,0,30,29
1649934831021,MATH 193A,A01,083224,Staff,0,3,30,30
1649934831021,MATH 193A,A02,083225,Staff,0,3,30,30
1649934831021,MATH 193A,A03,083781,Staff,4,0,30,26
1649934831021,MATH 193A,A04,083782,Staff,16,0,30,14
1649934837048,MATH 197,001,091859,McAuley; Julian John,9999,0,9999,0
1649934843142,COGS 9,A01,083615,Staff,16,0,60,44
1649934849179,COGS 11,A01,083617,Boyle; Mary E. T.,35,0,40,5
1649934855216,COGS 13,A01,083071,Staff,0,11,40,40
1649934861247,COGS 14A,A01,092681,Staff,65,0,100,35
1649934867272,COGS 14B,A01,083073,Cheng; Tzu-Han,24,0,50,26
1649934873302,COGS 17,A01,092677,Staff,63,0,75,12
1649934879330,COGS 100,A01,083619,Staff,0,5,60,60
1649934885353,COGS 101A,A01,083621,Davis; Joshua Daniel,0,8,60,60
1649934891381,COGS 101B,A01,091572,Staff,31,0,60,29
1649934897406,COGS 101C,A01,083625,Delgado; Tania,24,0,30,6
1649934903444,COGS 107A,A01,083627,Boyle; Mary E. T.,14,0,60,46
1649934909470,COGS 118A,A01,083075,Staff,21,0,60,39
1649934915575,CSE 3,A50,083646,Miranda; Gregory Joseph,24,0,38,14
1649934915575,CSE 3,A51,083647,Miranda; Gregory Joseph,37,0,37,0
1649934921608,CSE 8A,A50,083650,Miranda; Gregory Joseph,8,0,40,32
1649934927632,CSE 11,A01,083080,Cao; Yingjun,0,26,40,40
1649934933661,CSE 12,A01,083652,Staff,56,0,100,44
1649934939685,CSE 15L,A01,083654,Staff,19,0,50,31
1649934939685,CSE 15L,A02,083655,Staff,47,0,50,3
1649934945708,CSE 20,A01,083657,Staff,68,0,80,12
1649934951736,CSE 30,A01,083084,Eldon; John,0,24,40,40
1649934957765,CSE 100,A01,083659,Cao; Yingjun,1,27,50,49
1649934963790,CSE 134B,A01,083661,Powell; Thomas Allan,0,21,65,65
1649934969817,CSE 140,A01,083663,Staff,24,0,75,51
1649934975841,CSE 140L,A01,083088,Eldon; John,18,0,75,57
1649934981867,CSE 175,A01,083665,Kumar; Rakesh,12,0,25,13
1649934987894,CSE 190,A00,092507,Dubnov; Shlomo,14,0,15,1
1649934993926,ECE 45,A01,083139,Staff,6,0,40,34
1649934999953,ECE 65,A50,083695,Staff,7,0,30,23
1649935005982,ECE 109,A01,091882,Touri; Behrouz,55,0,70,15
1649935012007,ECE 180,A00,083140,Abi Samra; Nicholas Camill,26,0,30,4
1649935012007,ECE 180,B00,083141,Abi Samra; Nicholas Camill,13,0,30,17
1649935018041,MATH 10A,A01,083735,Patchell; Gregory David,20,0,30,10
1649935018041,MATH 10A,A02,083736,Patchell; Gregory David,28,0,30,2
1649935018041,MATH 10A,A03,083737,Patchell; Gregory David,28,0,30,2
1649935024066,MATH 10B,A01,083207,Staff,10,0,30,20
1649935024066,MATH 10B,A02,083208,Staff,25,0,30,5
1649935024066,MATH 10B,B01,083739,Staff,25,0,30,5
1649935024066,MATH 10B,B02,083740,Staff,30,0,30,0
1649935030093,MATH 18,A01,083743,Staff,22,0,30,8
1649935030093,MATH 18,A02,083744,Staff,29,0,30,1
1649935030093,MATH 18,A03,083745,Staff,29,0,30,1
1649935030093,MATH 18,A04,083746,Staff,28,0,30,2
1649935030093,MATH 18,B01,083748,Staff,5,0,30,25
1649935030093,MATH 18,B02,083749,Staff,26,0,30,4
1649935030093,MATH 18,B03,083750,Staff,28,0,30,2
1649935030093,MATH 18,B04,083751,Staff,26,0,30,4
1649935036126,MATH 20A,A01,083754,Staff,37,0,40,3
1649935042155,MATH 20B,A01,083756,Staff,19,0,30,11
1649935042155,MATH 20B,A02,083757,Staff,30,0,30,0
1649935048181,MATH 20C,A01,083760,Staff,22,0,30,8
1649935048181,MATH 20C,A02,083761,Staff,23,0,30,7
1649935048181,MATH 20C,B01,083762,Staff,28,0,30,2
1649935048181,MATH 20C,B02,083763,Staff,30,0,30,0
1649935054204,MATH 20D,A01,083765,Staff,20,0,30,10
1649935054204,MATH 20D,A02,083766,Staff,30,0,30,0
1649935054204,MATH 20D,A03,083767,Staff,30,0,30,0
1649935060235,MATH 20E,A01,083771,Staff,12,0,30,18
1649935060235,MATH 20E,A02,083772,Staff,24,0,30,6
1649935060235,MATH 20E,B01,083773,Staff,17,0,30,13
1649935060235,MATH 20E,B02,083774,Staff,29,0,30,1
1649935066264,MATH 103A,A01,083777,Staff,1,4,30,29
1649935066264,MATH 103A,A02,083778,Staff,0,3,30,30
1649935066264,MATH 103A,B01,083779,Staff,0,0,30,30
1649935066264,MATH 103A,B02,083780,Staff,16,0,30,14
1649935072289,MATH 105,A01,085443,Staff,0,5,30,30
1649935078315,MATH 109,A01,083213,Anzaldo; Leesa B,13,0,30,17
1649935078315,MATH 109,A02,083214,Anzaldo; Leesa B,9,0,30,21
1649935078315,MATH 109,B01,083215,Anzaldo; Leesa B,26,0,30,4
1649935078315,MATH 109,B02,083216,Anzaldo; Leesa B,22,0,30,8
1649935084340,MATH 142A,A01,083219,Chow; Bennett,0,1,30,30
1649935084340,MATH 142A,A02,083220,Chow; Bennett,9,0,30,21
1649935084340,MATH 142A,B01,083221,Chow; Bennett,0,0,30,30
1649935084340,MATH 142A,B02,083222,Chow; Bennett,1,0,30,29
1649935090365,MATH 193A,A01,083224,Staff,0,3,30,30
1649935090365,MATH 193A,A02,083225,Staff,0,3,30,30
1649935090365,MATH 193A,A03,083781,Staff,4,0,30,26
1649935090365,MATH 193A,A04,083782,Staff,16,0,30,14
1649935096388,MATH 197,001,091859,McAuley; Julian John,9999,0,9999,0
1649935102461,COGS 9,A01,083615,Staff,16,0,60,44
1649935108489,COGS 11,A01,083617,Boyle; Mary E. T.,35,0,40,5
1649935114514,COGS 13,A01,083071,Staff,0,11,40,40
