time,subj_course_id,sec_code,sec_id,prof,available,waitlist,total,enrolled_ct
1650021379698,COGS 9,A01,083615,Staff,1,15,60,59
1650021385741,COGS 11,A01,083617,Boyle; Mary E. T.,25,0,40,15
1650021391773,COGS 13,A01,083071,Staff,0,28,40,40
1650021397807,COGS 14A,A01,092681,Staff,0,6,100,100
1650021403843,COGS 14B,A01,083073,Cheng; Tzu-Han,0,2,50,50
1650021409873,COGS 17,A01,092677,Staff,35,0,75,40
1650021415901,COGS 100,A01,083619,Staff,0,18,60,60
1650021421933,COGS 101A,A01,083621,Davis; Joshua Daniel,0,16,60,60
1650021427963,COGS 101B,A01,091572,Staff,16,0,60,44
1650021433992,COGS 101C,A01,083625,Delgado; Tania,21,0,30,9
1650021440022,COGS 107A,A01,083627,Boyle; Mary E. T.,0,1,60,60
1650021446051,COGS 118A,A01,083075,Staff,19,0,60,41
1650021452098,CSE 3,A50,083646,Miranda; Gregory Joseph,22,0,38,16
1650021452098,CSE 3,A51,083647,Miranda; Gregory Joseph,37,0,37,0
1650021458143,CSE 8A,A50,083650,Miranda; Gregory Joseph,0,14,40,40
1650021464174,CSE 11,A01,083080,Cao; Yingjun,0,60,40,40
1650021470204,CSE 12,A01,083652,Staff,2,0,100,98
1650021476233,CSE 15L,A01,083654,Staff,0,0,50,50
1650021476233,CSE 15L,A02,083655,Staff,15,0,50,35
1650021482265,CSE 20,A01,083657,Staff,57,0,80,23
1650021488291,CSE 30,A01,083084,Eldon; John,0,62,40,40
1650021494323,CSE 100,A01,083659,Cao; Yingjun,0,57,50,50
1650021500353,CSE 134B,A01,083661,Powell; Thomas Allan,0,24,65,65
1650021506379,CSE 140,A01,083663,Staff,8,0,75,67
1650021512413,CSE 140L,A01,083088,Eldon; John,4,0,75,71
1650021518443,CSE 175,A01,083665,Kumar; Rakesh,10,0,25,15
1650021524478,CSE 190,A00,092507,Dubnov; Shlomo,17,0,20,3
1650021530510,ECE 45,A01,083139,Staff,0,10,40,40
1650021536543,ECE 65,A50,083695,Staff,0,1,30,30
1650021542571,ECE 109,A01,091882,Touri; Behrouz,48,0,70,22
1650021548599,ECE 180,A00,083140,Abi Samra; Nicholas Camill,26,0,30,4
1650021548599,ECE 180,B00,083141,Abi Samra; Nicholas Camill,10,0,30,20
1650021554634,MATH 10A,A01,083735,Patchell; Gregory David,14,0,30,16
1650021554634,MATH 10A,A02,083736,Patchell; Gregory David,28,0,30,2
1650021554634,MATH 10A,A03,083737,Patchell; Gregory David,27,0,30,3
1650021560669,MATH 10B,A01,083207,Staff,0,4,30,30
1650021560669,MATH 10B,A02,083208,Staff,0,0,30,30
1650021560669,MATH 10B,B01,083739,Staff,20,0,30,10
1650021560669,MATH 10B,B02,083740,Staff,30,0,30,0
1650021566709,MATH 18,A01,083743,Staff,10,0,30,20
1650021566709,MATH 18,A02,083744,Staff,28,0,30,2
1650021566709,MATH 18,A03,083745,Staff,23,0,30,7
1650021566709,MATH 18,A04,083746,Staff,27,0,30,3
1650021566709,MATH 18,B01,083748,Staff,0,8,30,30
1650021566709,MATH 18,B02,083749,Staff,0,6,30,30
1650021566709,MATH 18,B03,083750,Staff,0,6,30,30
1650021566709,MATH 18,B04,083751,Staff,1,7,30,29
1650021572737,MATH 20A,A01,083754,Staff,27,0,40,13
1650021578767,MATH 20B,A01,083756,Staff,0,4,30,30
1650021578767,MATH 20B,A02,083757,Staff,4,0,30,26
1650021584797,MATH 20C,A01,083760,Staff,0,9,30,30
1650021584797,MATH 20C,A02,083761,Staff,0,10,30,30
1650021584797,MATH 20C,B01,083762,Staff,17,0,30,13
1650021584797,MATH 20C,B02,083763,Staff,28,0,30,2
1650021590830,MATH 20D,A01,083765,Staff,0,2,30,30
1650021590830,MATH 20D,A02,083766,Staff,16,0,30,14
1650021590830,MATH 20D,A03,083767,Staff,28,0,30,2
1650021596861,MATH 20E,A01,083771,Staff,11,0,30,19
1650021596861,MATH 20E,A02,083772,Staff,20,0,30,10
1650021596861,MATH 20E,B01,083773,Staff,0,1,30,30
1650021596861,MATH 20E,B02,083774,Staff,20,0,30,10
1650021602891,MATH 103A,A01,083777,Staff,0,6,30,30
1650021602891,MATH 103A,A02,083778,Staff,0,7,30,30
1650021602891,MATH 103A,B01,083779,Staff,0,7,30,30
1650021602891,MATH 103A,B02,083780,Staff,0,6,30,30
1650021608920,MATH 105,A01,085443,Staff,0,11,30,30
1650021614947,MATH 109,A01,083213,Anzaldo; Leesa B,0,3,30,30
1650021614947,MATH 109,A02,083214,Anzaldo; Leesa B,0,4,30,30
1650021614947,MATH 109,B01,083215,Anzaldo; Leesa B,0,2,30,30
1650021614947,MATH 109,B02,083216,Anzaldo; Leesa B,0,2,30,30
1650021620977,MATH 142A,A01,083219,Chow; Bennett,0,7,30,30
1650021620977,MATH 142A,A02,083220,Chow; Bennett,0,7,30,30
1650021620977,MATH 142A,B01,083221,Chow; Bennett,0,8,30,30
1650021620977,MATH 142A,B02,083222,Chow; Bennett,0,7,30,30
1650021627004,MATH 193A,A01,083224,Staff,0,5,30,30
1650021627004,MATH 193A,A02,083225,Staff,0,4,30,30
1650021627004,MATH 193A,A03,083781,Staff,0,0,30,30
1650021627004,MATH 193A,A04,083782,Staff,9,0,30,21
1650021633034,MATH 197,001,091859,McAuley; Julian John,9999,0,9999,0
1650021639112,COGS 9,A01,083615,Staff,1,15,60,59
1650021645144,COGS 11,A01,083617,Boyle; Mary E. T.,25,0,40,15
1650021651177,COGS 13,A01,083071,Staff,0,28,40,40
1650021657207,COGS 14A,A01,092681,Staff,0,6,100,100
1650021663234,COGS 14B,A01,083073,Cheng; Tzu-Han,0,2,50,50
1650021669276,COGS 17,A01,092677,Staff,35,0,75,40
1650021675311,COGS 100,A01,083619,Staff,0,18,60,60
1650021681338,COGS 101A,A01,083621,Davis; Joshua Daniel,0,16,60,60
1650021687370,COGS 101B,A01,091572,Staff,16,0,60,44
1650021693403,COGS 101C,A01,083625,Delgado; Tania,21,0,30,9
1650021699432,COGS 107A,A01,083627,Boyle; Mary E. T.,0,1,60,60
1650021705463,COGS 118A,A01,083075,Staff,19,0,60,41
1650021711494,CSE 3,A50,083646,Miranda; Gregory Joseph,22,0,38,16
1650021711494,CSE 3,A51,083647,Miranda; Gregory Joseph,37,0,37,0
1650021717548,CSE 8A,A50,083650,Miranda; Gregory Joseph,0,14,40,40
1650021723577,CSE 11,A01,083080,Cao; Yingjun,0,60,40,40
1650021729611,CSE 12,A01,083652,Staff,2,0,100,98
1650021735638,CSE 15L,A01,083654,Staff,0,0,50,50
1650021735638,CSE 15L,A02,083655,Staff,15,0,50,35
1650021741690,CSE 20,A01,083657,Staff,57,0,80,23
1650021747719,CSE 30,A01,083084,Eldon; John,0,62,40,40
1650021753754,CSE 100,A01,083659,Cao; Yingjun,0,57,50,50
1650021759787,CSE 134B,A01,083661,Powell; Thomas Allan,0,24,65,65
1650021765814,CSE 140,A01,083663,Staff,8,0,75,67
1650021771842,CSE 140L,A01,083088,Eldon; John,4,0,75,71
1650021777876,CSE 175,A01,083665,Kumar; Rakesh,10,0,25,15
1650021783904,CSE 190,A00,092507,Dubnov; Shlomo,17,0,20,3
1650021789939,ECE 45,A01,083139,Staff,0,10,40,40
1650021795965,ECE 65,A50,083695,Staff,0,1,30,30
1650021801995,ECE 109,A01,091882,Touri; Behrouz,48,0,70,22
1650021808022,ECE 180,A00,083140,Abi Samra; Nicholas Camill,26,0,30,4
1650021808022,ECE 180,B00,083141,Abi Samra; Nicholas Camill,10,0,30,20
1650021814056,MATH 10A,A01,083735,Patchell; Gregory David,14,0,30,16
1650021814056,MATH 10A,A02,083736,Patchell; Gregory David,28,0,30,2
1650021814056,MATH 10A,A03,083737,Patchell; Gregory David,27,0,30,3
1650021820090,MATH 10B,A01,083207,Staff,0,4,30,30
1650021820090,MATH 10B,A02,083208,Staff,0,0,30,30
1650021820090,MATH 10B,B01,083739,Staff,20,0,30,10
1650021820090,MATH 10B,B02,083740,Staff,30,0,30,0
1650021826119,MATH 18,A01,083743,Staff,10,0,30,20
1650021826119,MATH 18,A02,083744,Staff,28,0,30,2
1650021826119,MATH 18,A03,083745,Staff,23,0,30,7
1650021826119,MATH 18,A04,083746,Staff,27,0,30,3
1650021826119,MATH 18,B01,083748,Staff,0,8,30,30
1650021826119,MATH 18,B02,083749,Staff,0,6,30,30
1650021826119,MATH 18,B03,083750,Staff,0,6,30,30
1650021826119,MATH 18,B04,083751,Staff,1,7,30,29
1650021832147,MATH 20A,A01,083754,Staff,27,0,40,13
1650021838183,MATH 20B,A01,083756,Staff,0,4,30,30
1650021838183,MATH 20B,A02,083757,Staff,4,0,30,26
1650021844216,MATH 20C,A01,083760,Staff,0,9,30,30
1650021844216,MATH 20C,A02,083761,Staff,0,10,30,30
1650021844216,MATH 20C,B01,083762,Staff,17,0,30,13
1650021844216,MATH 20C,B02,083763,Staff,28,0,30,2
1650021850243,MATH 20D,A01,083765,Staff,0,2,30,30
1650021850243,MATH 20D,A02,083766,Staff,16,0,30,14
1650021850243,MATH 20D,A03,083767,Staff,28,0,30,2
1650021856279,MATH 20E,A01,083771,Staff,11,0,30,19
1650021856279,MATH 20E,A02,083772,Staff,20,0,30,10
1650021856279,MATH 20E,B01,083773,Staff,0,1,30,30
1650021856279,MATH 20E,B02,083774,Staff,20,0,30,10
1650021862309,MATH 103A,A01,083777,Staff,0,6,30,30
1650021862309,MATH 103A,A02,083778,Staff,0,7,30,30
1650021862309,MATH 103A,B01,083779,Staff,0,7,30,30
1650021862309,MATH 103A,B02,083780,Staff,0,6,30,30
1650021868340,MATH 105,A01,085443,Staff,0,11,30,30
1650021874375,MATH 109,A01,083213,Anzaldo; Leesa B,0,3,30,30
1650021874375,MATH 109,A02,083214,Anzaldo; Leesa B,0,4,30,30
1650021874375,MATH 109,B01,083215,Anzaldo; Leesa B,0,2,30,30
1650021874375,MATH 109,B02,083216,Anzaldo; Leesa B,0,2,30,30
1650021880403,MATH 142A,A01,083219,Chow; Bennett,0,7,30,30
1650021880403,MATH 142A,A02,083220,Chow; Bennett,0,7,30,30
1650021880403,MATH 142A,B01,083221,Chow; Bennett,0,8,30,30
1650021880403,MATH 142A,B02,083222,Chow; Bennett,0,7,30,30
1650021886437,MATH 193A,A01,083224,Staff,0,5,30,30
1650021886437,MATH 193A,A02,083225,Staff,0,4,30,30
1650021886437,MATH 193A,A03,083781,Staff,0,0,30,30
1650021886437,MATH 193A,A04,083782,Staff,9,0,30,21
1650021892464,MATH 197,001,091859,McAuley; Julian John,9999,0,9999,0
1650021898544,COGS 9,A01,083615,Staff,1,15,60,59
1650021904575,COGS 11,A01,083617,Boyle; Mary E. T.,25,0,40,15
1650021910604,COGS 13,A01,083071,Staff,0,28,40,40
1650021916630,COGS 14A,A01,092681,Staff,0,6,100,100
1650021922661,COGS 14B,A01,083073,Cheng; Tzu-Han,0,2,50,50
1650021928685,COGS 17,A01,092677,Staff,35,0,75,40
1650021934713,COGS 100,A01,083619,Staff,0,18,60,60
1650021940752,COGS 101A,A01,083621,Davis; Joshua Daniel,0,16,60,60
1650021946785,COGS 101B,A01,091572,Staff,16,0,60,44
1650021952902,COGS 101C,A01,083625,Delgado; Tania,21,0,30,9
1650021958934,COGS 107A,A01,083627,Boyle; Mary E. T.,0,1,60,60
1650021964965,COGS 118A,A01,083075,Staff,19,0,60,41
1650021970996,CSE 3,A50,083646,Miranda; Gregory Joseph,22,0,38,16
1650021970996,CSE 3,A51,083647,Miranda; Gregory Joseph,37,0,37,0
1650021977024,CSE 8A,A50,083650,Miranda; Gregory Joseph,0,14,40,40
1650021983051,CSE 11,A01,083080,Cao; Yingjun,0,60,40,40
1650021989079,CSE 12,A01,083652,Staff,2,0,100,98
1650021995112,CSE 15L,A01,083654,Staff,0,0,50,50
1650021995112,CSE 15L,A02,083655,Staff,15,0,50,35
1650022001142,CSE 20,A01,083657,Staff,57,0,80,23
1650022007167,CSE 30,A01,083084,Eldon; John,0,62,40,40
1650022013195,CSE 100,A01,083659,Cao; Yingjun,0,57,50,50
1650022019224,CSE 134B,A01,083661,Powell; Thomas Allan,0,24,65,65
1650022025249,CSE 140,A01,083663,Staff,8,0,75,67
1650022031277,CSE 140L,A01,083088,Eldon; John,4,0,75,71
1650022037310,CSE 175,A01,083665,Kumar; Rakesh,10,0,25,15
1650022043337,CSE 190,A00,092507,Dubnov; Shlomo,17,0,20,3
1650022049366,ECE 45,A01,083139,Staff,0,10,40,40
1650022055393,ECE 65,A50,083695,Staff,0,1,30,30
1650022061425,ECE 109,A01,091882,Touri; Behrouz,48,0,70,22
1650022067455,ECE 180,A00,083140,Abi Samra; Nicholas Camill,26,0,30,4
1650022067455,ECE 180,B00,083141,Abi Samra; Nicholas Camill,10,0,30,20
1650022073488,MATH 10A,A01,083735,Patchell; Gregory David,14,0,30,16
1650022073488,MATH 10A,A02,083736,Patchell; Gregory David,28,0,30,2
1650022073488,MATH 10A,A03,083737,Patchell; Gregory David,27,0,30,3
1650022079520,MATH 10B,A01,083207,Staff,0,4,30,30
1650022079520,MATH 10B,A02,083208,Staff,0,0,30,30
1650022079520,MATH 10B,B01,083739,Staff,20,0,30,10
1650022079520,MATH 10B,B02,083740,Staff,30,0,30,0
1650022085549,MATH 18,A01,083743,Staff,10,0,30,20
1650022085549,MATH 18,A02,083744,Staff,28,0,30,2
1650022085549,MATH 18,A03,083745,Staff,23,0,30,7
1650022085549,MATH 18,A04,083746,Staff,27,0,30,3
1650022085549,MATH 18,B01,083748,Staff,0,8,30,30
1650022085549,MATH 18,B02,083749,Staff,0,6,30,30
1650022085549,MATH 18,B03,083750,Staff,0,6,30,30
1650022085549,MATH 18,B04,083751,Staff,1,7,30,29
1650022091577,MATH 20A,A01,083754,Staff,27,0,40,13
1650022097611,MATH 20B,A01,083756,Staff,0,4,30,30
1650022097611,MATH 20B,A02,083757,Staff,4,0,30,26
1650022103640,MATH 20C,A01,083760,Staff,0,9,30,30
1650022103640,MATH 20C,A02,083761,Staff,0,10,30,30
1650022103640,MATH 20C,B01,083762,Staff,17,0,30,13
1650022103640,MATH 20C,B02,083763,Staff,28,0,30,2
1650022109667,MATH 20D,A01,083765,Staff,0,2,30,30
1650022109667,MATH 20D,A02,083766,Staff,16,0,30,14
1650022109667,MATH 20D,A03,083767,Staff,28,0,30,2
1650022115697,MATH 20E,A01,083771,Staff,11,0,30,19
1650022115697,MATH 20E,A02,083772,Staff,20,0,30,10
1650022115697,MATH 20E,B01,083773,Staff,0,1,30,30
1650022115697,MATH 20E,B02,083774,Staff,20,0,30,10
1650022121730,MATH 103A,A01,083777,Staff,0,6,30,30
1650022121730,MATH 103A,A02,083778,Staff,0,7,30,30
1650022121730,MATH 103A,B01,083779,Staff,0,7,30,30
1650022121730,MATH 103A,B02,083780,Staff,0,6,30,30
1650022127760,MATH 105,A01,085443,Staff,0,11,30,30
1650022133798,MATH 109,A01,083213,Anzaldo; Leesa B,0,3,30,30
1650022133798,MATH 109,A02,083214,Anzaldo; Leesa B,0,4,30,30
1650022133798,MATH 109,B01,083215,Anzaldo; Leesa B,0,2,30,30
1650022133798,MATH 109,B02,083216,Anzaldo; Leesa B,0,2,30,30
1650022139827,MATH 142A,A01,083219,Chow; Bennett,0,7,30,30
1650022139827,MATH 142A,A02,083220,Chow; Bennett,0,7,30,30
1650022139827,MATH 142A,B01,083221,Chow; Bennett,0,8,30,30
1650022139827,MATH 142A,B02,083222,Chow; Bennett,0,7,30,30
1650022145857,MATH 193A,A01,083224,Staff,0,5,30,30
1650022145857,MATH 193A,A02,083225,Staff,0,4,30,30
1650022145857,MATH 193A,A03,083781,Staff,0,0,30,30
1650022145857,MATH 193A,A04,083782,Staff,9,0,30,21
1650022151881,MATH 197,001,091859,McAuley; Julian John,9999,0,9999,0
1650022157940,COGS 9,A01,083615,Staff,1,15,60,59
1650022163966,COGS 11,A01,083617,Boyle; Mary E. T.,25,0,40,15
1650022169996,COGS 13,A01,083071,Staff,0,28,40,40
1650022176023,COGS 14A,A01,092681,Staff,0,6,100,100
1650022182051,COGS 14B,A01,083073,Cheng; Tzu-Han,0,2,50,50
1650022188076,COGS 17,A01,092677,Staff,35,0,75,40
1650022194101,COGS 100,A01,083619,Staff,0,18,60,60
1650022200129,COGS 101A,A01,083621,Davis; Joshua Daniel,0,16,60,60
1650022206155,COGS 101B,A01,091572,Staff,16,0,60,44
1650022212181,COGS 101C,A01,083625,Delgado; Tania,21,0,30,9
1650022218205,COGS 107A,A01,083627,Boyle; Mary E. T.,0,1,60,60
1650022224228,COGS 118A,A01,083075,Staff,19,0,60,41
1650022230255,CSE 3,A50,083646,Miranda; Gregory Joseph,22,0,38,16
1650022230255,CSE 3,A51,083647,Miranda; Gregory Joseph,37,0,37,0
1650022236280,CSE 8A,A50,083650,Miranda; Gregory Joseph,0,14,40,40
1650022242306,CSE 11,A01,083080,Cao; Yingjun,0,60,40,40
1650022248335,CSE 12,A01,083652,Staff,2,0,100,98
1650022254358,CSE 15L,A01,083654,Staff,0,0,50,50
1650022254358,CSE 15L,A02,083655,Staff,15,0,50,35
1650022260387,CSE 20,A01,083657,Staff,57,0,80,23
1650022266412,CSE 30,A01,083084,Eldon; John,0,62,40,40
1650022272442,CSE 100,A01,083659,Cao; Yingjun,0,57,50,50
1650022278467,CSE 134B,A01,083661,Powell; Thomas Allan,0,24,65,65
1650022284494,CSE 140,A01,083663,Staff,8,0,75,67
1650022290517,CSE 140L,A01,083088,Eldon; John,4,0,75,71
1650022296543,CSE 175,A01,083665,Kumar; Rakesh,10,0,25,15
1650022302642,CSE 190,A00,092507,Dubnov; Shlomo,17,0,20,3
1650022308668,ECE 45,A01,083139,Staff,0,10,40,40
1650022314696,ECE 65,A50,083695,Staff,0,1,30,30
1650022320721,ECE 109,A01,091882,Touri; Behrouz,48,0,70,22
1650022326761,ECE 180,A00,083140,Abi Samra; Nicholas Camill,26,0,30,4
1650022326761,ECE 180,B00,083141,Abi Samra; Nicholas Camill,10,0,30,20
1650022332811,MATH 10A,A01,083735,Patchell; Gregory David,14,0,30,16
1650022332811,MATH 10A,A02,083736,Patchell; Gregory David,28,0,30,2
1650022332811,MATH 10A,A03,083737,Patchell; Gregory David,27,0,30,3
1650022338840,MATH 10B,A01,083207,Staff,0,4,30,30
1650022338840,MATH 10B,A02,083208,Staff,0,0,30,30
1650022338840,MATH 10B,B01,083739,Staff,20,0,30,10
1650022338840,MATH 10B,B02,083740,Staff,30,0,30,0
1650022344871,MATH 18,A01,083743,Staff,10,0,30,20
1650022344871,MATH 18,A02,083744,Staff,28,0,30,2
1650022344871,MATH 18,A03,083745,Staff,23,0,30,7
1650022344871,MATH 18,A04,083746,Staff,27,0,30,3
1650022344871,MATH 18,B01,083748,Staff,0,8,30,30
1650022344871,MATH 18,B02,083749,Staff,0,6,30,30
1650022344871,MATH 18,B03,083750,Staff,0,6,30,30
1650022344871,MATH 18,B04,083751,Staff,1,7,30,29
1650022350897,MATH 20A,A01,083754,Staff,27,0,40,13
1650022356920,MATH 20B,A01,083756,Staff,0,4,30,30
1650022356920,MATH 20B,A02,083757,Staff,4,0,30,26
1650022362945,MATH 20C,A01,083760,Staff,0,9,30,30
1650022362945,MATH 20C,A02,083761,Staff,0,10,30,30
1650022362945,MATH 20C,B01,083762,Staff,17,0,30,13
1650022362945,MATH 20C,B02,083763,Staff,28,0,30,2
1650022368971,MATH 20D,A01,083765,Staff,0,2,30,30
1650022368971,MATH 20D,A02,083766,Staff,16,0,30,14
1650022368971,MATH 20D,A03,083767,Staff,28,0,30,2
1650022375001,MATH 20E,A01,083771,Staff,11,0,30,19
1650022375001,MATH 20E,A02,083772,Staff,20,0,30,10
1650022375001,MATH 20E,B01,083773,Staff,0,1,30,30
1650022375001,MATH 20E,B02,083774,Staff,20,0,30,10
1650022381028,MATH 103A,A01,083777,Staff,0,6,30,30
1650022381028,MATH 103A,A02,083778,Staff,0,7,30,30
1650022381028,MATH 103A,B01,083779,Staff,0,7,30,30
1650022381028,MATH 103A,B02,083780,Staff,0,6,30,30
1650022387050,MATH 105,A01,085443,Staff,0,11,30,30
1650022393082,MATH 109,A01,083213,Anzaldo; Leesa B,0,3,30,30
1650022393082,MATH 109,A02,083214,Anzaldo; Leesa B,0,3,30,30
1650022393082,MATH 109,B01,083215,Anzaldo; Leesa B,0,2,30,30
1650022393082,MATH 109,B02,083216,Anzaldo; Leesa B,0,2,30,30
1650022399107,MATH 142A,A01,083219,Chow; Bennett,0,7,30,30
1650022399107,MATH 142A,A02,083220,Chow; Bennett,0,7,30,30
1650022399107,MATH 142A,B01,083221,Chow; Bennett,0,8,30,30
1650022399107,MATH 142A,B02,083222,Chow; Bennett,0,7,30,30
1650022405133,MATH 193A,A01,083224,Staff,0,5,30,30
1650022405133,MATH 193A,A02,083225,Staff,0,4,30,30
1650022405133,MATH 193A,A03,083781,Staff,0,0,30,30
1650022405133,MATH 193A,A04,083782,Staff,9,0,30,21
1650022411158,MATH 197,001,091859,McAuley; Julian John,9999,0,9999,0
1650022417231,COGS 9,A01,083615,Staff,1,15,60,59
1650022423266,COGS 11,A01,083617,Boyle; Mary E. T.,25,0,40,15
1650022429292,COGS 13,A01,083071,Staff,0,28,40,40
1650022435315,COGS 14A,A01,092681,Staff,0,6,100,100
1650022441345,COGS 14B,A01,083073,Cheng; Tzu-Han,0,2,50,50
1650022447368,COGS 17,A01,092677,Staff,35,0,75,40
1650022453393,COGS 100,A01,083619,Staff,0,18,60,60
1650022459421,COGS 101A,A01,083621,Davis; Joshua Daniel,0,16,60,60
1650022465450,COGS 101B,A01,091572,Staff,16,0,60,44
1650022471475,COGS 101C,A01,083625,Delgado; Tania,21,0,30,9
1650022477500,COGS 107A,A01,083627,Boyle; Mary E. T.,0,1,60,60
1650022483529,COGS 118A,A01,083075,Staff,19,0,60,41
1650022489553,CSE 3,A50,083646,Miranda; Gregory Joseph,22,0,38,16
1650022489553,CSE 3,A51,083647,Miranda; Gregory Joseph,37,0,37,0
1650022495578,CSE 8A,A50,083650,Miranda; Gregory Joseph,0,14,40,40
1650022501607,CSE 11,A01,083080,Cao; Yingjun,0,60,40,40
1650022507636,CSE 12,A01,083652,Staff,2,0,100,98
1650022513663,CSE 15L,A01,083654,Staff,0,0,50,50
1650022513663,CSE 15L,A02,083655,Staff,15,0,50,35
1650022519689,CSE 20,A01,083657,Staff,57,0,80,23
1650022525714,CSE 30,A01,083084,Eldon; John,0,62,40,40
1650022531740,CSE 100,A01,083659,Cao; Yingjun,0,57,50,50
1650022537772,CSE 134B,A01,083661,Powell; Thomas Allan,0,24,65,65
1650022543808,CSE 140,A01,083663,Staff,8,0,75,67
1650022549940,CSE 140L,A01,083088,Eldon; John,4,0,75,71
1650022555965,CSE 175,A01,083665,Kumar; Rakesh,10,0,25,15
1650022561991,CSE 190,A00,092507,Dubnov; Shlomo,17,0,20,3
1650022568090,ECE 45,A01,083139,Staff,0,10,40,40
1650022574118,ECE 65,A50,083695,Staff,0,1,30,30
1650022580147,ECE 109,A01,091882,Touri; Behrouz,48,0,70,22
1650022586171,ECE 180,A00,083140,Abi Samra; Nicholas Camill,26,0,30,4
1650022586171,ECE 180,B00,083141,Abi Samra; Nicholas Camill,10,0,30,20
1650022592198,MATH 10A,A01,083735,Patchell; Gregory David,14,0,30,16
1650022592198,MATH 10A,A02,083736,Patchell; Gregory David,28,0,30,2
1650022592198,MATH 10A,A03,083737,Patchell; Gregory David,27,0,30,3
1650022598224,MATH 10B,A01,083207,Staff,0,4,30,30
1650022598224,MATH 10B,A02,083208,Staff,0,0,30,30
1650022598224,MATH 10B,B01,083739,Staff,20,0,30,10
1650022598224,MATH 10B,B02,083740,Staff,30,0,30,0
1650022604261,MATH 18,A01,083743,Staff,10,0,30,20
1650022604261,MATH 18,A02,083744,Staff,28,0,30,2
1650022604261,MATH 18,A03,083745,Staff,23,0,30,7
1650022604261,MATH 18,A04,083746,Staff,27,0,30,3
1650022604261,MATH 18,B01,083748,Staff,0,8,30,30
1650022604261,MATH 18,B02,083749,Staff,0,6,30,30
1650022604261,MATH 18,B03,083750,Staff,0,6,30,30
1650022604261,MATH 18,B04,083751,Staff,1,7,30,29
1650022610287,MATH 20A,A01,083754,Staff,27,0,40,13
1650022616315,MATH 20B,A01,083756,Staff,0,4,30,30
1650022616315,MATH 20B,A02,083757,Staff,4,0,30,26
1650022622340,MATH 20C,A01,083760,Staff,0,9,30,30
1650022622340,MATH 20C,A02,083761,Staff,0,10,30,30
1650022622340,MATH 20C,B01,083762,Staff,17,0,30,13
1650022622340,MATH 20C,B02,083763,Staff,28,0,30,2
1650022628369,MATH 20D,A01,083765,Staff,0,2,30,30
1650022628369,MATH 20D,A02,083766,Staff,16,0,30,14
1650022628369,MATH 20D,A03,083767,Staff,28,0,30,2
1650022634395,MATH 20E,A01,083771,Staff,11,0,30,19
1650022634395,MATH 20E,A02,083772,Staff,20,0,30,10
1650022634395,MATH 20E,B01,083773,Staff,0,1,30,30
1650022634395,MATH 20E,B02,083774,Staff,20,0,30,10
1650022640423,MATH 103A,A01,083777,Staff,0,6,30,30
1650022640423,MATH 103A,A02,083778,Staff,0,7,30,30
1650022640423,MATH 103A,B01,083779,Staff,0,7,30,30
1650022640423,MATH 103A,B02,083780,Staff,0,6,30,30
1650022646456,MATH 105,A01,085443,Staff,0,11,30,30
1650022652485,MATH 109,A01,083213,Anzaldo; Leesa B,0,3,30,30
1650022652485,MATH 109,A02,083214,Anzaldo; Leesa B,0,3,30,30
1650022652485,MATH 109,B01,083215,Anzaldo; Leesa B,0,2,30,30
1650022652485,MATH 109,B02,083216,Anzaldo; Leesa B,0,2,30,30
1650022658517,MATH 142A,A01,083219,Chow; Bennett,0,7,30,30
1650022658517,MATH 142A,A02,083220,Chow; Bennett,0,7,30,30
1650022658517,MATH 142A,B01,083221,Chow; Bennett,0,8,30,30
1650022658517,MATH 142A,B02,083222,Chow; Bennett,0,7,30,30
1650022664543,MATH 193A,A01,083224,Staff,0,5,30,30
1650022664543,MATH 193A,A02,083225,Staff,0,4,30,30
1650022664543,MATH 193A,A03,083781,Staff,0,0,30,30
1650022664543,MATH 193A,A04,083782,Staff,9,0,30,21
1650022670569,MATH 197,001,091859,McAuley; Julian John,9999,0,9999,0
1650022676640,COGS 9,A01,083615,Staff,1,15,60,59
1650022682672,COGS 11,A01,083617,Boyle; Mary E. T.,25,0,40,15
1650022699147,COGS 13,A01,083071,Staff,0,28,40,40
1650022705183,COGS 14A,A01,092681,Staff,0,6,100,100
1650022721056,COGS 14B,A01,083073,Cheng; Tzu-Han,0,2,50,50
1650022727083,COGS 17,A01,092677,Staff,35,0,75,40
1650022743364,COGS 100,A01,083619,Staff,0,18,60,60
1650022749448,COGS 101A,A01,083621,Davis; Joshua Daniel,0,16,60,60
1650022765036,COGS 101B,A01,091572,Staff,16,0,60,44
1650022771065,COGS 101C,A01,083625,Delgado; Tania,21,0,30,9
1650022787350,COGS 107A,A01,083627,Boyle; Mary E. T.,0,1,60,60
1650022793378,COGS 118A,A01,083075,Staff,19,0,60,41
1650022809518,CSE 3,A50,083646,Miranda; Gregory Joseph,22,0,38,16
1650022809518,CSE 3,A51,083647,Miranda; Gregory Joseph,37,0,37,0
1650022815547,CSE 8A,A50,083650,Miranda; Gregory Joseph,0,14,40,40
1650022826544,CSE 11,A01,083080,Cao; Yingjun,0,60,40,40
1650022832572,CSE 12,A01,083652,Staff,2,0,100,98
1650022838602,CSE 15L,A01,083654,Staff,0,0,50,50
1650022838602,CSE 15L,A02,083655,Staff,15,0,50,35
1650022844629,CSE 20,A01,083657,Staff,57,0,80,23
1650022850662,CSE 30,A01,083084,Eldon; John,0,62,40,40
1650022856695,CSE 100,A01,083659,Cao; Yingjun,0,57,50,50
1650022862723,CSE 134B,A01,083661,Powell; Thomas Allan,0,24,65,65
1650022868753,CSE 140,A01,083663,Staff,8,0,75,67
1650022874780,CSE 140L,A01,083088,Eldon; John,4,0,75,71
1650022880811,CSE 175,A01,083665,Kumar; Rakesh,10,0,25,15
1650022886843,CSE 190,A00,092507,Dubnov; Shlomo,17,0,20,3
1650022892870,ECE 45,A01,083139,Staff,0,10,40,40
1650022898898,ECE 65,A50,083695,Staff,0,1,30,30
1650022904930,ECE 109,A01,091882,Touri; Behrouz,48,0,70,22
1650022910956,ECE 180,A00,083140,Abi Samra; Nicholas Camill,26,0,30,4
1650022910956,ECE 180,B00,083141,Abi Samra; Nicholas Camill,10,0,30,20
1650022916985,MATH 10A,A01,083735,Patchell; Gregory David,14,0,30,16
1650022916985,MATH 10A,A02,083736,Patchell; Gregory David,28,0,30,2
1650022916985,MATH 10A,A03,083737,Patchell; Gregory David,27,0,30,3
1650022923010,MATH 10B,A01,083207,Staff,0,4,30,30
1650022923010,MATH 10B,A02,083208,Staff,0,0,30,30
1650022923010,MATH 10B,B01,083739,Staff,20,0,30,10
1650022923010,MATH 10B,B02,083740,Staff,30,0,30,0
1650022929046,MATH 18,A01,083743,Staff,10,0,30,20
1650022929046,MATH 18,A02,083744,Staff,28,0,30,2
1650022929046,MATH 18,A03,083745,Staff,23,0,30,7
1650022929046,MATH 18,A04,083746,Staff,27,0,30,3
1650022929046,MATH 18,B01,083748,Staff,0,8,30,30
1650022929046,MATH 18,B02,083749,Staff,0,6,30,30
1650022929046,MATH 18,B03,083750,Staff,0,6,30,30
1650022929046,MATH 18,B04,083751,Staff,1,7,30,29
1650022935075,MATH 20A,A01,083754,Staff,27,0,40,13
1650022941107,MATH 20B,A01,083756,Staff,0,4,30,30
1650022941107,MATH 20B,A02,083757,Staff,4,0,30,26
1650022947140,MATH 20C,A01,083760,Staff,0,9,30,30
1650022947140,MATH 20C,A02,083761,Staff,0,10,30,30
1650022947140,MATH 20C,B01,083762,Staff,17,0,30,13
1650022947140,MATH 20C,B02,083763,Staff,28,0,30,2
1650022953171,MATH 20D,A01,083765,Staff,0,2,30,30
1650022953171,MATH 20D,A02,083766,Staff,16,0,30,14
1650022953171,MATH 20D,A03,083767,Staff,28,0,30,2
1650022959205,MATH 20E,A01,083771,Staff,11,0,30,19
1650022959205,MATH 20E,A02,083772,Staff,20,0,30,10
1650022959205,MATH 20E,B01,083773,Staff,0,1,30,30
1650022959205,MATH 20E,B02,083774,Staff,20,0,30,10
1650022965234,MATH 103A,A01,083777,Staff,0,6,30,30
1650022965234,MATH 103A,A02,083778,Staff,0,7,30,30
1650022965234,MATH 103A,B01,083779,Staff,0,7,30,30
1650022965234,MATH 103A,B02,083780,Staff,0,6,30,30
1650022971262,MATH 105,A01,085443,Staff,0,11,30,30
1650022977294,MATH 109,A01,083213,Anzaldo; Leesa B,0,3,30,30
1650022977294,MATH 109,A02,083214,Anzaldo; Leesa B,0,4,30,30
1650022977294,MATH 109,B01,083215,Anzaldo; Leesa B,0,2,30,30
1650022977294,MATH 109,B02,083216,Anzaldo; Leesa B,0,2,30,30
1650022983321,MATH 142A,A01,083219,Chow; Bennett,0,7,30,30
1650022983321,MATH 142A,A02,083220,Chow; Bennett,0,7,30,30
1650022983321,MATH 142A,B01,083221,Chow; Bennett,0,8,30,30
1650022983321,MATH 142A,B02,083222,Chow; Bennett,0,7,30,30
1650022989348,MATH 193A,A01,083224,Staff,0,5,30,30
1650022989348,MATH 193A,A02,083225,Staff,0,4,30,30
1650022989348,MATH 193A,A03,083781,Staff,0,0,30,30
1650022989348,MATH 193A,A04,083782,Staff,9,0,30,21
1650022995374,MATH 197,001,091859,McAuley; Julian John,9999,0,9999,0
1650023001461,COGS 9,A01,083615,Staff,1,15,60,59
1650023007493,COGS 11,A01,083617,Boyle; Mary E. T.,25,0,40,15
1650023013518,COGS 13,A01,083071,Staff,0,28,40,40
1650023019545,COGS 14A,A01,092681,Staff,0,6,100,100
1650023025571,COGS 14B,A01,083073,Cheng; Tzu-Han,0,2,50,50
1650023031603,COGS 17,A01,092677,Staff,35,0,75,40
1650023037642,COGS 100,A01,083619,Staff,0,18,60,60
1650023043669,COGS 101A,A01,083621,Davis; Joshua Daniel,0,16,60,60
1650023049700,COGS 101B,A01,091572,Staff,16,0,60,44
1650023055728,COGS 101C,A01,083625,Delgado; Tania,21,0,30,9
1650023061759,COGS 107A,A01,083627,Boyle; Mary E. T.,0,1,60,60
1650023067788,COGS 118A,A01,083075,Staff,19,0,60,41
1650023073821,CSE 3,A50,083646,Miranda; Gregory Joseph,22,0,38,16
1650023073821,CSE 3,A51,083647,Miranda; Gregory Joseph,37,0,37,0
1650023079852,CSE 8A,A50,083650,Miranda; Gregory Joseph,0,14,40,40
1650023085889,CSE 11,A01,083080,Cao; Yingjun,0,60,40,40
1650023091920,CSE 12,A01,083652,Staff,2,0,100,98
1650023097955,CSE 15L,A01,083654,Staff,0,0,50,50
1650023097955,CSE 15L,A02,083655,Staff,15,0,50,35
1650023103981,CSE 20,A01,083657,Staff,57,0,80,23
1650023110006,CSE 30,A01,083084,Eldon; John,0,62,40,40
1650023116038,CSE 100,A01,083659,Cao; Yingjun,0,57,50,50
1650023122067,CSE 134B,A01,083661,Powell; Thomas Allan,0,24,65,65
1650023128101,CSE 140,A01,083663,Staff,8,0,75,67
1650023134127,CSE 140L,A01,083088,Eldon; John,4,0,75,71
1650023140155,CSE 175,A01,083665,Kumar; Rakesh,10,0,25,15
1650023146188,CSE 190,A00,092507,Dubnov; Shlomo,17,0,20,3
1650023152218,ECE 45,A01,083139,Staff,0,10,40,40
1650023158246,ECE 65,A50,083695,Staff,0,1,30,30
1650023164277,ECE 109,A01,091882,Touri; Behrouz,48,0,70,22
1650023170309,ECE 180,A00,083140,Abi Samra; Nicholas Camill,26,0,30,4
1650023170309,ECE 180,B00,083141,Abi Samra; Nicholas Camill,10,0,30,20
1650023176348,MATH 10A,A01,083735,Patchell; Gregory David,14,0,30,16
1650023176348,MATH 10A,A02,083736,Patchell; Gregory David,28,0,30,2
1650023176348,MATH 10A,A03,083737,Patchell; Gregory David,27,0,30,3
1650023182375,MATH 10B,A01,083207,Staff,0,4,30,30
1650023182375,MATH 10B,A02,083208,Staff,0,0,30,30
1650023182375,MATH 10B,B01,083739,Staff,20,0,30,10
1650023182375,MATH 10B,B02,083740,Staff,30,0,30,0
1650023188406,MATH 18,A01,083743,Staff,10,0,30,20
1650023188406,MATH 18,A02,083744,Staff,28,0,30,2
1650023188406,MATH 18,A03,083745,Staff,23,0,30,7
1650023188406,MATH 18,A04,083746,Staff,27,0,30,3
1650023188406,MATH 18,B01,083748,Staff,0,8,30,30
1650023188406,MATH 18,B02,083749,Staff,0,6,30,30
1650023188406,MATH 18,B03,083750,Staff,0,6,30,30
1650023188406,MATH 18,B04,083751,Staff,1,7,30,29
1650023194430,MATH 20A,A01,083754,Staff,27,0,40,13
1650023200457,MATH 20B,A01,083756,Staff,0,4,30,30
1650023200457,MATH 20B,A02,083757,Staff,4,0,30,26
1650023206498,MATH 20C,A01,083760,Staff,0,9,30,30
1650023206498,MATH 20C,A02,083761,Staff,0,10,30,30
1650023206498,MATH 20C,B01,083762,Staff,17,0,30,13
1650023206498,MATH 20C,B02,083763,Staff,28,0,30,2
1650023212616,MATH 20D,A01,083765,Staff,0,2,30,30
1650023212616,MATH 20D,A02,083766,Staff,16,0,30,14
1650023212616,MATH 20D,A03,083767,Staff,28,0,30,2
1650023218650,MATH 20E,A01,083771,Staff,11,0,30,19
1650023218650,MATH 20E,A02,083772,Staff,20,0,30,10
1650023218650,MATH 20E,B01,083773,Staff,0,1,30,30
1650023218650,MATH 20E,B02,083774,Staff,20,0,30,10
1650023224677,MATH 103A,A01,083777,Staff,0,6,30,30
1650023224677,MATH 103A,A02,083778,Staff,0,7,30,30
1650023224677,MATH 103A,B01,083779,Staff,0,7,30,30
1650023224677,MATH 103A,B02,083780,Staff,0,6,30,30
1650023240258,MATH 105,A01,085443,Staff,0,11,30,30
1650023246284,MATH 109,A01,083213,Anzaldo; Leesa B,0,3,30,30
1650023246284,MATH 109,A02,083214,Anzaldo; Leesa B,0,4,30,30
1650023246284,MATH 109,B01,083215,Anzaldo; Leesa B,0,2,30,30
1650023246284,MATH 109,B02,083216,Anzaldo; Leesa B,0,2,30,30
1650023257146,MATH 142A,A01,083219,Chow; Bennett,0,7,30,30
1650023257146,MATH 142A,A02,083220,Chow; Bennett,0,7,30,30
1650023257146,MATH 142A,B01,083221,Chow; Bennett,0,8,30,30
1650023257146,MATH 142A,B02,083222,Chow; Bennett,0,7,30,30
1650023263193,MATH 193A,A01,083224,Staff,0,5,30,30
1650023263193,MATH 193A,A02,083225,Staff,0,4,30,30
1650023263193,MATH 193A,A03,083781,Staff,0,0,30,30
1650023263193,MATH 193A,A04,083782,Staff,9,0,30,21
1650023269217,MATH 197,001,091859,McAuley; Julian John,9999,0,9999,0
1650023275289,COGS 9,A01,083615,Staff,1,15,60,59
1650023281319,COGS 11,A01,083617,Boyle; Mary E. T.,25,0,40,15
1650023287347,COGS 13,A01,083071,Staff,0,28,40,40
1650023293372,COGS 14A,A01,092681,Staff,0,6,100,100
1650023299399,COGS 14B,A01,083073,Cheng; Tzu-Han,0,2,50,50
1650023305427,COGS 17,A01,092677,Staff,35,0,75,40
1650023311459,COGS 100,A01,083619,Staff,0,18,60,60
1650023317490,COGS 101A,A01,083621,Davis; Joshua Daniel,0,16,60,60
1650023323516,COGS 101B,A01,091572,Staff,16,0,60,44
1650023329542,COGS 101C,A01,083625,Delgado; Tania,21,0,30,9
1650023335567,COGS 107A,A01,083627,Boyle; Mary E. T.,0,1,60,60
1650023341596,COGS 118A,A01,083075,Staff,19,0,60,41
1650023347624,CSE 3,A50,083646,Miranda; Gregory Joseph,22,0,38,16
1650023347624,CSE 3,A51,083647,Miranda; Gregory Joseph,37,0,37,0
1650023353665,CSE 8A,A50,083650,Miranda; Gregory Joseph,0,14,40,40
1650023359690,CSE 11,A01,083080,Cao; Yingjun,0,60,40,40
1650023365716,CSE 12,A01,083652,Staff,2,0,100,98
1650023371745,CSE 15L,A01,083654,Staff,0,0,50,50
1650023371745,CSE 15L,A02,083655,Staff,15,0,50,35
1650023377770,CSE 20,A01,083657,Staff,57,0,80,23
1650023383798,CSE 30,A01,083084,Eldon; John,0,62,40,40
1650023389825,CSE 100,A01,083659,Cao; Yingjun,0,57,50,50
1650023395856,CSE 134B,A01,083661,Powell; Thomas Allan,0,24,65,65
1650023401884,CSE 140,A01,083663,Staff,8,0,75,67
1650023407913,CSE 140L,A01,083088,Eldon; John,4,0,75,71
1650023413945,CSE 175,A01,083665,Kumar; Rakesh,10,0,25,15
1650023419984,CSE 190,A00,092507,Dubnov; Shlomo,17,0,20,3
1650023426012,ECE 45,A01,083139,Staff,0,10,40,40
1650023432043,ECE 65,A50,083695,Staff,0,1,30,30
1650023438070,ECE 109,A01,091882,Touri; Behrouz,48,0,70,22
1650023444099,ECE 180,A00,083140,Abi Samra; Nicholas Camill,26,0,30,4
1650023444099,ECE 180,B00,083141,Abi Samra; Nicholas Camill,10,0,30,20
1650023450126,MATH 10A,A01,083735,Patchell; Gregory David,14,0,30,16
1650023450126,MATH 10A,A02,083736,Patchell; Gregory David,28,0,30,2
1650023450126,MATH 10A,A03,083737,Patchell; Gregory David,27,0,30,3
1650023456157,MATH 10B,A01,083207,Staff,0,4,30,30
1650023456157,MATH 10B,A02,083208,Staff,0,0,30,30
1650023456157,MATH 10B,B01,083739,Staff,20,0,30,10
1650023456157,MATH 10B,B02,083740,Staff,30,0,30,0
1650023462186,MATH 18,A01,083743,Staff,10,0,30,20
1650023462186,MATH 18,A02,083744,Staff,28,0,30,2
1650023462186,MATH 18,A03,083745,Staff,23,0,30,7
1650023462186,MATH 18,A04,083746,Staff,27,0,30,3
1650023462186,MATH 18,B01,083748,Staff,0,8,30,30
1650023462186,MATH 18,B02,083749,Staff,0,6,30,30
1650023462186,MATH 18,B03,083750,Staff,0,6,30,30
1650023462186,MATH 18,B04,083751,Staff,1,7,30,29
1650023468209,MATH 20A,A01,083754,Staff,27,0,40,13
1650023474240,MATH 20B,A01,083756,Staff,0,4,30,30
1650023474240,MATH 20B,A02,083757,Staff,4,0,30,26
1650023480267,MATH 20C,A01,083760,Staff,0,9,30,30
1650023480267,MATH 20C,A02,083761,Staff,0,10,30,30
1650023480267,MATH 20C,B01,083762,Staff,17,0,30,13
1650023480267,MATH 20C,B02,083763,Staff,28,0,30,2
1650023486294,MATH 20D,A01,083765,Staff,0,2,30,30
1650023486294,MATH 20D,A02,083766,Staff,16,0,30,14
1650023486294,MATH 20D,A03,083767,Staff,28,0,30,2
1650023492325,MATH 20E,A01,083771,Staff,11,0,30,19
1650023492325,MATH 20E,A02,083772,Staff,20,0,30,10
1650023492325,MATH 20E,B01,083773,Staff,0,1,30,30
1650023492325,MATH 20E,B02,083774,Staff,20,0,30,10
1650023498349,MATH 103A,A01,083777,Staff,0,6,30,30
1650023498349,MATH 103A,A02,083778,Staff,0,7,30,30
1650023498349,MATH 103A,B01,083779,Staff,0,7,30,30
1650023498349,MATH 103A,B02,083780,Staff,0,6,30,30
1650023504376,MATH 105,A01,085443,Staff,0,11,30,30
1650023510409,MATH 109,A01,083213,Anzaldo; Leesa B,0,3,30,30
1650023510409,MATH 109,A02,083214,Anzaldo; Leesa B,0,4,30,30
1650023510409,MATH 109,B01,083215,Anzaldo; Leesa B,0,2,30,30
1650023510409,MATH 109,B02,083216,Anzaldo; Leesa B,0,2,30,30
1650023516434,MATH 142A,A01,083219,Chow; Bennett,0,7,30,30
1650023516434,MATH 142A,A02,083220,Chow; Bennett,0,7,30,30
1650023516434,MATH 142A,B01,083221,Chow; Bennett,0,8,30,30
1650023516434,MATH 142A,B02,083222,Chow; Bennett,0,7,30,30
1650023522458,MATH 193A,A01,083224,Staff,0,5,30,30
1650023522458,MATH 193A,A02,083225,Staff,0,4,30,30
1650023522458,MATH 193A,A03,083781,Staff,0,0,30,30
1650023522458,MATH 193A,A04,083782,Staff,9,0,30,21
1650023528493,MATH 197,001,091859,McAuley; Julian John,9999,0,9999,0
1650023534561,COGS 9,A01,083615,Staff,1,15,60,59
1650023540591,COGS 11,A01,083617,Boyle; Mary E. T.,25,0,40,15
1650023546621,COGS 13,A01,083071,Staff,0,28,40,40
1650023552647,COGS 14A,A01,092681,Staff,0,6,100,100
1650023558672,COGS 14B,A01,083073,Cheng; Tzu-Han,0,2,50,50
1650023564701,COGS 17,A01,092677,Staff,35,0,75,40
1650023570727,COGS 100,A01,083619,Staff,0,18,60,60
1650023576756,COGS 101A,A01,083621,Davis; Joshua Daniel,0,16,60,60
1650023582781,COGS 101B,A01,091572,Staff,16,0,60,44
1650023588813,COGS 101C,A01,083625,Delgado; Tania,21,0,30,9
1650023594837,COGS 107A,A01,083627,Boyle; Mary E. T.,0,1,60,60
1650023600861,COGS 118A,A01,083075,Staff,19,0,60,41
1650023606888,CSE 3,A50,083646,Miranda; Gregory Joseph,22,0,38,16
1650023606888,CSE 3,A51,083647,Miranda; Gregory Joseph,37,0,37,0
1650023612915,CSE 8A,A50,083650,Miranda; Gregory Joseph,0,14,40,40
1650023618943,CSE 11,A01,083080,Cao; Yingjun,0,60,40,40
1650023624968,CSE 12,A01,083652,Staff,2,0,100,98
1650023630992,CSE 15L,A01,083654,Staff,0,0,50,50
1650023630992,CSE 15L,A02,083655,Staff,15,0,50,35
1650023637031,CSE 20,A01,083657,Staff,57,0,80,23
1650023643063,CSE 30,A01,083084,Eldon; John,0,62,40,40
1650023649088,CSE 100,A01,083659,Cao; Yingjun,0,57,50,50
1650023655114,CSE 134B,A01,083661,Powell; Thomas Allan,0,24,65,65
1650023661137,CSE 140,A01,083663,Staff,8,0,75,67
1650023667163,CSE 140L,A01,083088,Eldon; John,4,0,75,71
1650023673195,CSE 175,A01,083665,Kumar; Rakesh,10,0,25,15
1650023679227,CSE 190,A00,092507,Dubnov; Shlomo,17,0,20,3
1650023685258,ECE 45,A01,083139,Staff,0,10,40,40
1650023691285,ECE 65,A50,083695,Staff,0,1,30,30
1650023697311,ECE 109,A01,091882,Touri; Behrouz,48,0,70,22
1650023703340,ECE 180,A00,083140,Abi Samra; Nicholas Camill,26,0,30,4
1650023703340,ECE 180,B00,083141,Abi Samra; Nicholas Camill,10,0,30,20
1650023709367,MATH 10A,A01,083735,Patchell; Gregory David,14,0,30,16
1650023709367,MATH 10A,A02,083736,Patchell; Gregory David,28,0,30,2
1650023709367,MATH 10A,A03,083737,Patchell; Gregory David,27,0,30,3
1650023715402,MATH 10B,A01,083207,Staff,0,4,30,30
1650023715402,MATH 10B,A02,083208,Staff,0,0,30,30
1650023715402,MATH 10B,B01,083739,Staff,20,0,30,10
1650023715402,MATH 10B,B02,083740,Staff,30,0,30,0
1650023721443,MATH 18,A01,083743,Staff,10,0,30,20
1650023721443,MATH 18,A02,083744,Staff,28,0,30,2
1650023721443,MATH 18,A03,083745,Staff,23,0,30,7
1650023721443,MATH 18,A04,083746,Staff,27,0,30,3
1650023721443,MATH 18,B01,083748,Staff,0,8,30,30
1650023721443,MATH 18,B02,083749,Staff,0,6,30,30
1650023721443,MATH 18,B03,083750,Staff,0,6,30,30
1650023721443,MATH 18,B04,083751,Staff,1,7,30,29
1650023727467,MATH 20A,A01,083754,Staff,27,0,40,13
1650023733500,MATH 20B,A01,083756,Staff,0,4,30,30
1650023733500,MATH 20B,A02,083757,Staff,4,0,30,26
1650023739526,MATH 20C,A01,083760,Staff,0,9,30,30
1650023739526,MATH 20C,A02,083761,Staff,0,10,30,30
1650023739526,MATH 20C,B01,083762,Staff,17,0,30,13
1650023739526,MATH 20C,B02,083763,Staff,28,0,30,2
1650023745553,MATH 20D,A01,083765,Staff,0,2,30,30
1650023745553,MATH 20D,A02,083766,Staff,16,0,30,14
1650023745553,MATH 20D,A03,083767,Staff,28,0,30,2
1650023751580,MATH 20E,A01,083771,Staff,11,0,30,19
1650023751580,MATH 20E,A02,083772,Staff,20,0,30,10
1650023751580,MATH 20E,B01,083773,Staff,0,1,30,30
1650023751580,MATH 20E,B02,083774,Staff,20,0,30,10
1650023757606,MATH 103A,A01,083777,Staff,0,6,30,30
1650023757606,MATH 103A,A02,083778,Staff,0,7,30,30
1650023757606,MATH 103A,B01,083779,Staff,0,7,30,30
1650023757606,MATH 103A,B02,083780,Staff,0,6,30,30
1650023763632,MATH 105,A01,085443,Staff,0,11,30,30
1650023769656,MATH 109,A01,083213,Anzaldo; Leesa B,0,3,30,30
1650023769656,MATH 109,A02,083214,Anzaldo; Leesa B,0,4,30,30
1650023769656,MATH 109,B01,083215,Anzaldo; Leesa B,0,2,30,30
1650023769656,MATH 109,B02,083216,Anzaldo; Leesa B,0,2,30,30
1650023775682,MATH 142A,A01,083219,Chow; Bennett,0,7,30,30
1650023775682,MATH 142A,A02,083220,Chow; Bennett,0,7,30,30
1650023775682,MATH 142A,B01,083221,Chow; Bennett,0,8,30,30
1650023775682,MATH 142A,B02,083222,Chow; Bennett,0,7,30,30
1650023781707,MATH 193A,A01,083224,Staff,0,5,30,30
1650023781707,MATH 193A,A02,083225,Staff,0,4,30,30
1650023781707,MATH 193A,A03,083781,Staff,0,0,30,30
1650023781707,MATH 193A,A04,083782,Staff,9,0,30,21
1650023787735,MATH 197,001,091859,McAuley; Julian John,9999,0,9999,0
1650023793809,COGS 9,A01,083615,Staff,1,15,60,59
1650023799833,COGS 11,A01,083617,Boyle; Mary E. T.,25,0,40,15
1650023805863,COGS 13,A01,083071,Staff,0,28,40,40
1650023811894,COGS 14A,A01,092681,Staff,0,6,100,100
1650023818009,COGS 14B,A01,083073,Cheng; Tzu-Han,0,2,50,50
1650023824046,COGS 17,A01,092677,Staff,35,0,75,40
1650023830075,COGS 100,A01,083619,Staff,0,18,60,60
1650023836113,COGS 101A,A01,083621,Davis; Joshua Daniel,0,16,60,60
1650023842136,COGS 101B,A01,091572,Staff,16,0,60,44
1650023848164,COGS 101C,A01,083625,Delgado; Tania,21,0,30,9
1650023854188,COGS 107A,A01,083627,Boyle; Mary E. T.,0,1,60,60
1650023860215,COGS 118A,A01,083075,Staff,19,0,60,41
1650023866250,CSE 3,A50,083646,Miranda; Gregory Joseph,22,0,38,16
1650023866250,CSE 3,A51,083647,Miranda; Gregory Joseph,37,0,37,0
1650023872280,CSE 8A,A50,083650,Miranda; Gregory Joseph,0,14,40,40
1650023878320,CSE 11,A01,083080,Cao; Yingjun,0,60,40,40
1650023884345,CSE 12,A01,083652,Staff,2,0,100,98
1650023890372,CSE 15L,A01,083654,Staff,0,0,50,50
1650023890372,CSE 15L,A02,083655,Staff,15,0,50,35
1650023896399,CSE 20,A01,083657,Staff,57,0,80,23
1650023902425,CSE 30,A01,083084,Eldon; John,0,62,40,40
1650023908451,CSE 100,A01,083659,Cao; Yingjun,0,57,50,50
1650023914477,CSE 134B,A01,083661,Powell; Thomas Allan,0,25,65,65
1650023920505,CSE 140,A01,083663,Staff,8,0,75,67
1650023926536,CSE 140L,A01,083088,Eldon; John,4,0,75,71
1650023932564,CSE 175,A01,083665,Kumar; Rakesh,10,0,25,15
1650023938596,CSE 190,A00,092507,Dubnov; Shlomo,17,0,20,3
1650023944623,ECE 45,A01,083139,Staff,0,10,40,40
1650023950654,ECE 65,A50,083695,Staff,0,1,30,30
1650023956684,ECE 109,A01,091882,Touri; Behrouz,48,0,70,22
1650023962714,ECE 180,A00,083140,Abi Samra; Nicholas Camill,26,0,30,4
1650023962714,ECE 180,B00,083141,Abi Samra; Nicholas Camill,10,0,30,20
1650023968743,MATH 10A,A01,083735,Patchell; Gregory David,14,0,30,16
1650023968743,MATH 10A,A02,083736,Patchell; Gregory David,28,0,30,2
1650023968743,MATH 10A,A03,083737,Patchell; Gregory David,27,0,30,3
1650023974775,MATH 10B,A01,083207,Staff,0,4,30,30
1650023974775,MATH 10B,A02,083208,Staff,0,0,30,30
1650023974775,MATH 10B,B01,083739,Staff,20,0,30,10
1650023974775,MATH 10B,B02,083740,Staff,30,0,30,0
1650023980805,MATH 18,A01,083743,Staff,10,0,30,20
1650023980805,MATH 18,A02,083744,Staff,28,0,30,2
1650023980805,MATH 18,A03,083745,Staff,23,0,30,7
1650023980805,MATH 18,A04,083746,Staff,27,0,30,3
1650023980805,MATH 18,B01,083748,Staff,0,8,30,30
1650023980805,MATH 18,B02,083749,Staff,0,6,30,30
1650023980805,MATH 18,B03,083750,Staff,0,6,30,30
1650023980805,MATH 18,B04,083751,Staff,1,7,30,29
1650023986835,MATH 20A,A01,083754,Staff,27,0,40,13
1650023992862,MATH 20B,A01,083756,Staff,0,4,30,30
1650023992862,MATH 20B,A02,083757,Staff,4,0,30,26
1650023998890,MATH 20C,A01,083760,Staff,0,9,30,30
1650023998890,MATH 20C,A02,083761,Staff,0,10,30,30
1650023998890,MATH 20C,B01,083762,Staff,17,0,30,13
1650023998890,MATH 20C,B02,083763,Staff,28,0,30,2
1650024004917,MATH 20D,A01,083765,Staff,0,2,30,30
1650024004917,MATH 20D,A02,083766,Staff,16,0,30,14
1650024004917,MATH 20D,A03,083767,Staff,28,0,30,2
1650024010946,MATH 20E,A01,083771,Staff,11,0,30,19
1650024010946,MATH 20E,A02,083772,Staff,20,0,30,10
1650024010946,MATH 20E,B01,083773,Staff,0,1,30,30
1650024010946,MATH 20E,B02,083774,Staff,20,0,30,10
1650024016970,MATH 103A,A01,083777,Staff,0,6,30,30
1650024016970,MATH 103A,A02,083778,Staff,0,7,30,30
1650024016970,MATH 103A,B01,083779,Staff,0,7,30,30
1650024016970,MATH 103A,B02,083780,Staff,0,6,30,30
1650024023000,MATH 105,A01,085443,Staff,0,11,30,30
1650024029030,MATH 109,A01,083213,Anzaldo; Leesa B,0,3,30,30
1650024029030,MATH 109,A02,083214,Anzaldo; Leesa B,0,4,30,30
1650024029030,MATH 109,B01,083215,Anzaldo; Leesa B,0,2,30,30
1650024029030,MATH 109,B02,083216,Anzaldo; Leesa B,0,2,30,30
1650024035058,MATH 142A,A01,083219,Chow; Bennett,0,7,30,30
1650024035058,MATH 142A,A02,083220,Chow; Bennett,0,7,30,30
1650024035058,MATH 142A,B01,083221,Chow; Bennett,0,8,30,30
1650024035058,MATH 142A,B02,083222,Chow; Bennett,0,7,30,30
1650024041085,MATH 193A,A01,083224,Staff,0,5,30,30
1650024041085,MATH 193A,A02,083225,Staff,0,4,30,30
1650024041085,MATH 193A,A03,083781,Staff,0,0,30,30
1650024041085,MATH 193A,A04,083782,Staff,9,0,30,21
1650024047109,MATH 197,001,091859,McAuley; Julian John,9999,0,9999,0
1650024053179,COGS 9,A01,083615,Staff,1,15,60,59
1650024059208,COGS 11,A01,083617,Boyle; Mary E. T.,25,0,40,15
1650024065233,COGS 13,A01,083071,Staff,0,28,40,40
1650024071258,COGS 14A,A01,092681,Staff,0,6,100,100
1650024077284,COGS 14B,A01,083073,Cheng; Tzu-Han,0,2,50,50
1650024083310,COGS 17,A01,092677,Staff,35,0,75,40
1650024089333,COGS 100,A01,083619,Staff,0,18,60,60
1650024095355,COGS 101A,A01,083621,Davis; Joshua Daniel,0,16,60,60
1650024101379,COGS 101B,A01,091572,Staff,16,0,60,44
1650024107415,COGS 101C,A01,083625,Delgado; Tania,21,0,30,9
1650024113449,COGS 107A,A01,083627,Boyle; Mary E. T.,0,1,60,60
1650024119491,COGS 118A,A01,083075,Staff,19,0,60,41
1650024125515,CSE 3,A50,083646,Miranda; Gregory Joseph,22,0,38,16
1650024125515,CSE 3,A51,083647,Miranda; Gregory Joseph,37,0,37,0
1650024131540,CSE 8A,A50,083650,Miranda; Gregory Joseph,0,14,40,40
1650024137565,CSE 11,A01,083080,Cao; Yingjun,0,60,40,40
1650024143598,CSE 12,A01,083652,Staff,2,0,100,98
1650024149623,CSE 15L,A01,083654,Staff,0,0,50,50
1650024149623,CSE 15L,A02,083655,Staff,15,0,50,35
1650024155652,CSE 20,A01,083657,Staff,57,0,80,23
1650024161683,CSE 30,A01,083084,Eldon; John,0,62,40,40
1650024167709,CSE 100,A01,083659,Cao; Yingjun,0,57,50,50
1650024173734,CSE 134B,A01,083661,Powell; Thomas Allan,0,25,65,65
1650024179759,CSE 140,A01,083663,Staff,8,0,75,67
1650024185785,CSE 140L,A01,083088,Eldon; John,4,0,75,71
1650024191816,CSE 175,A01,083665,Kumar; Rakesh,10,0,25,15
1650024197840,CSE 190,A00,092507,Dubnov; Shlomo,17,0,20,3
1650024203866,ECE 45,A01,083139,Staff,0,10,40,40
1650024209895,ECE 65,A50,083695,Staff,0,1,30,30
1650024215921,ECE 109,A01,091882,Touri; Behrouz,48,0,70,22
1650024221945,ECE 180,A00,083140,Abi Samra; Nicholas Camill,26,0,30,4
1650024221945,ECE 180,B00,083141,Abi Samra; Nicholas Camill,10,0,30,20
1650024227977,MATH 10A,A01,083735,Patchell; Gregory David,14,0,30,16
1650024227977,MATH 10A,A02,083736,Patchell; Gregory David,28,0,30,2
1650024227977,MATH 10A,A03,083737,Patchell; Gregory David,27,0,30,3
1650024234002,MATH 10B,A01,083207,Staff,0,4,30,30
1650024234002,MATH 10B,A02,083208,Staff,0,0,30,30
1650024234002,MATH 10B,B01,083739,Staff,20,0,30,10
1650024234002,MATH 10B,B02,083740,Staff,30,0,30,0
1650024240037,MATH 18,A01,083743,Staff,10,0,30,20
1650024240037,MATH 18,A02,083744,Staff,28,0,30,2
1650024240037,MATH 18,A03,083745,Staff,23,0,30,7
1650024240037,MATH 18,A04,083746,Staff,27,0,30,3
1650024240037,MATH 18,B01,083748,Staff,0,8,30,30
1650024240037,MATH 18,B02,083749,Staff,0,6,30,30
1650024240037,MATH 18,B03,083750,Staff,0,6,30,30
1650024240037,MATH 18,B04,083751,Staff,1,7,30,29
1650024246079,MATH 20A,A01,083754,Staff,27,0,40,13
1650024252103,MATH 20B,A01,083756,Staff,0,4,30,30
1650024252103,MATH 20B,A02,083757,Staff,4,0,30,26
1650024258135,MATH 20C,A01,083760,Staff,0,9,30,30
1650024258135,MATH 20C,A02,083761,Staff,0,10,30,30
1650024258135,MATH 20C,B01,083762,Staff,17,0,30,13
1650024258135,MATH 20C,B02,083763,Staff,28,0,30,2
1650024264167,MATH 20D,A01,083765,Staff,0,2,30,30
1650024264167,MATH 20D,A02,083766,Staff,16,0,30,14
1650024264167,MATH 20D,A03,083767,Staff,28,0,30,2
1650024270194,MATH 20E,A01,083771,Staff,11,0,30,19
1650024270194,MATH 20E,A02,083772,Staff,20,0,30,10
1650024270194,MATH 20E,B01,083773,Staff,0,1,30,30
1650024270194,MATH 20E,B02,083774,Staff,20,0,30,10
1650024276237,MATH 103A,A01,083777,Staff,0,6,30,30
1650024276237,MATH 103A,A02,083778,Staff,0,7,30,30
1650024276237,MATH 103A,B01,083779,Staff,0,7,30,30
1650024276237,MATH 103A,B02,083780,Staff,0,6,30,30
1650024282266,MATH 105,A01,085443,Staff,0,11,30,30
1650024288301,MATH 109,A01,083213,Anzaldo; Leesa B,0,3,30,30
1650024288301,MATH 109,A02,083214,Anzaldo; Leesa B,0,4,30,30
1650024288301,MATH 109,B01,083215,Anzaldo; Leesa B,0,2,30,30
1650024288301,MATH 109,B02,083216,Anzaldo; Leesa B,0,2,30,30
1650024294335,MATH 142A,A01,083219,Chow; Bennett,0,7,30,30
1650024294335,MATH 142A,A02,083220,Chow; Bennett,0,7,30,30
1650024294335,MATH 142A,B01,083221,Chow; Bennett,0,8,30,30
1650024294335,MATH 142A,B02,083222,Chow; Bennett,0,7,30,30
1650024300364,MATH 193A,A01,083224,Staff,0,5,30,30
1650024300364,MATH 193A,A02,083225,Staff,0,4,30,30
1650024300364,MATH 193A,A03,083781,Staff,0,0,30,30
1650024300364,MATH 193A,A04,083782,Staff,9,0,30,21
1650024306389,MATH 197,001,091859,McAuley; Julian John,9999,0,9999,0
1650024312468,COGS 9,A01,083615,Staff,1,15,60,59
1650024318500,COGS 11,A01,083617,Boyle; Mary E. T.,25,0,40,15
1650024324527,COGS 13,A01,083071,Staff,0,28,40,40
1650024330551,COGS 14A,A01,092681,Staff,0,6,100,100
1650024336577,COGS 14B,A01,083073,Cheng; Tzu-Han,0,2,50,50
1650024342616,COGS 17,A01,092677,Staff,35,0,75,40
1650024348645,COGS 100,A01,083619,Staff,0,18,60,60
1650024354684,COGS 101A,A01,083621,Davis; Joshua Daniel,0,16,60,60
1650024360714,COGS 101B,A01,091572,Staff,16,0,60,44
1650024366752,COGS 101C,A01,083625,Delgado; Tania,21,0,30,9
1650024372780,COGS 107A,A01,083627,Boyle; Mary E. T.,0,1,60,60
1650024378804,COGS 118A,A01,083075,Staff,19,0,60,41
1650024384831,CSE 3,A50,083646,Miranda; Gregory Joseph,22,0,38,16
1650024384831,CSE 3,A51,083647,Miranda; Gregory Joseph,37,0,37,0
1650024390862,CSE 8A,A50,083650,Miranda; Gregory Joseph,0,14,40,40
1650024396889,CSE 11,A01,083080,Cao; Yingjun,0,60,40,40
1650024402913,CSE 12,A01,083652,Staff,2,0,100,98
1650024408952,CSE 15L,A01,083654,Staff,0,0,50,50
1650024408952,CSE 15L,A02,083655,Staff,15,0,50,35
1650024415076,CSE 20,A01,083657,Staff,57,0,80,23
1650024421102,CSE 30,A01,083084,Eldon; John,0,62,40,40
1650024427132,CSE 100,A01,083659,Cao; Yingjun,0,57,50,50
1650024433164,CSE 134B,A01,083661,Powell; Thomas Allan,0,25,65,65
1650024439189,CSE 140,A01,083663,Staff,8,0,75,67
1650024445219,CSE 140L,A01,083088,Eldon; John,4,0,75,71
1650024451245,CSE 175,A01,083665,Kumar; Rakesh,10,0,25,15
1650024457279,CSE 190,A00,092507,Dubnov; Shlomo,17,0,20,3
1650024463304,ECE 45,A01,083139,Staff,0,10,40,40
1650024469334,ECE 65,A50,083695,Staff,0,1,30,30
1650024475360,ECE 109,A01,091882,Touri; Behrouz,48,0,70,22
1650024481430,ECE 180,A00,083140,Abi Samra; Nicholas Camill,26,0,30,4
1650024481430,ECE 180,B00,083141,Abi Samra; Nicholas Camill,10,0,30,20
1650024487464,MATH 10A,A01,083735,Patchell; Gregory David,14,0,30,16
1650024487464,MATH 10A,A02,083736,Patchell; Gregory David,28,0,30,2
1650024487464,MATH 10A,A03,083737,Patchell; Gregory David,27,0,30,3
1650024493495,MATH 10B,A01,083207,Staff,0,4,30,30
1650024493495,MATH 10B,A02,083208,Staff,0,0,30,30
1650024493495,MATH 10B,B01,083739,Staff,20,0,30,10
1650024493495,MATH 10B,B02,083740,Staff,30,0,30,0
1650024499523,MATH 18,A01,083743,Staff,10,0,30,20
1650024499523,MATH 18,A02,083744,Staff,28,0,30,2
1650024499523,MATH 18,A03,083745,Staff,23,0,30,7
1650024499523,MATH 18,A04,083746,Staff,27,0,30,3
1650024499523,MATH 18,B01,083748,Staff,0,8,30,30
1650024499523,MATH 18,B02,083749,Staff,0,6,30,30
1650024499523,MATH 18,B03,083750,Staff,0,6,30,30
1650024499523,MATH 18,B04,083751,Staff,1,7,30,29
1650024505546,MATH 20A,A01,083754,Staff,27,0,40,13
1650024511577,MATH 20B,A01,083756,Staff,0,4,30,30
1650024511577,MATH 20B,A02,083757,Staff,4,0,30,26
1650024517617,MATH 20C,A01,083760,Staff,0,9,30,30
1650024517617,MATH 20C,A02,083761,Staff,0,10,30,30
1650024517617,MATH 20C,B01,083762,Staff,17,0,30,13
1650024517617,MATH 20C,B02,083763,Staff,28,0,30,2
1650024523647,MATH 20D,A01,083765,Staff,0,2,30,30
1650024523647,MATH 20D,A02,083766,Staff,16,0,30,14
1650024523647,MATH 20D,A03,083767,Staff,28,0,30,2
1650024529676,MATH 20E,A01,083771,Staff,11,0,30,19
1650024529676,MATH 20E,A02,083772,Staff,20,0,30,10
1650024529676,MATH 20E,B01,083773,Staff,0,1,30,30
1650024529676,MATH 20E,B02,083774,Staff,20,0,30,10
1650024535707,MATH 103A,A01,083777,Staff,0,6,30,30
1650024535707,MATH 103A,A02,083778,Staff,0,7,30,30
1650024535707,MATH 103A,B01,083779,Staff,0,7,30,30
1650024535707,MATH 103A,B02,083780,Staff,0,6,30,30
1650024541739,MATH 105,A01,085443,Staff,0,11,30,30
1650024547766,MATH 109,A01,083213,Anzaldo; Leesa B,0,3,30,30
1650024547766,MATH 109,A02,083214,Anzaldo; Leesa B,0,4,30,30
1650024547766,MATH 109,B01,083215,Anzaldo; Leesa B,0,2,30,30
1650024547766,MATH 109,B02,083216,Anzaldo; Leesa B,0,2,30,30
1650024553797,MATH 142A,A01,083219,Chow; Bennett,0,7,30,30
1650024553797,MATH 142A,A02,083220,Chow; Bennett,0,7,30,30
1650024553797,MATH 142A,B01,083221,Chow; Bennett,0,8,30,30
1650024553797,MATH 142A,B02,083222,Chow; Bennett,0,7,30,30
1650024559823,MATH 193A,A01,083224,Staff,0,5,30,30
1650024559823,MATH 193A,A02,083225,Staff,0,4,30,30
1650024559823,MATH 193A,A03,083781,Staff,0,0,30,30
1650024559823,MATH 193A,A04,083782,Staff,9,0,30,21
1650024565848,MATH 197,001,091859,McAuley; Julian John,9999,0,9999,0
1650024571903,COGS 9,A01,083615,Staff,1,15,60,59
1650024577928,COGS 11,A01,083617,Boyle; Mary E. T.,25,0,40,15
1650024583952,COGS 13,A01,083071,Staff,0,28,40,40
1650024589976,COGS 14A,A01,092681,Staff,0,6,100,100
1650024596005,COGS 14B,A01,083073,Cheng; Tzu-Han,0,2,50,50
1650024602029,COGS 17,A01,092677,Staff,35,0,75,40
1650024608063,COGS 100,A01,083619,Staff,0,18,60,60
1650024614092,COGS 101A,A01,083621,Davis; Joshua Daniel,0,16,60,60
1650024620120,COGS 101B,A01,091572,Staff,16,0,60,44
1650024626146,COGS 101C,A01,083625,Delgado; Tania,21,0,30,9
1650024632176,COGS 107A,A01,083627,Boyle; Mary E. T.,0,1,60,60
1650024638199,COGS 118A,A01,083075,Staff,19,0,60,41
1650024644224,CSE 3,A50,083646,Miranda; Gregory Joseph,22,0,38,16
1650024644224,CSE 3,A51,083647,Miranda; Gregory Joseph,37,0,37,0
1650024650268,CSE 8A,A50,083650,Miranda; Gregory Joseph,0,14,40,40
1650024656300,CSE 11,A01,083080,Cao; Yingjun,0,60,40,40
1650024662328,CSE 12,A01,083652,Staff,2,0,100,98
1650024668353,CSE 15L,A01,083654,Staff,0,0,50,50
1650024668353,CSE 15L,A02,083655,Staff,15,0,50,35
1650024674378,CSE 20,A01,083657,Staff,57,0,80,23
1650024680404,CSE 30,A01,083084,Eldon; John,0,62,40,40
1650024686430,CSE 100,A01,083659,Cao; Yingjun,0,57,50,50
1650024692455,CSE 134B,A01,083661,Powell; Thomas Allan,0,25,65,65
1650024698483,CSE 140,A01,083663,Staff,8,0,75,67
1650024704511,CSE 140L,A01,083088,Eldon; John,4,0,75,71
1650024710542,CSE 175,A01,083665,Kumar; Rakesh,10,0,25,15
1650024716569,CSE 190,A00,092507,Dubnov; Shlomo,17,0,20,3
1650024722599,ECE 45,A01,083139,Staff,0,10,40,40
1650024728624,ECE 65,A50,083695,Staff,0,1,30,30
1650024734653,ECE 109,A01,091882,Touri; Behrouz,48,0,70,22
1650024740685,ECE 180,A00,083140,Abi Samra; Nicholas Camill,26,0,30,4
1650024740685,ECE 180,B00,083141,Abi Samra; Nicholas Camill,10,0,30,20
1650024746717,MATH 10A,A01,083735,Patchell; Gregory David,14,0,30,16
1650024746717,MATH 10A,A02,083736,Patchell; Gregory David,28,0,30,2
1650024746717,MATH 10A,A03,083737,Patchell; Gregory David,27,0,30,3
1650024752742,MATH 10B,A01,083207,Staff,0,4,30,30
1650024752742,MATH 10B,A02,083208,Staff,0,0,30,30
1650024752742,MATH 10B,B01,083739,Staff,20,0,30,10
1650024752742,MATH 10B,B02,083740,Staff,30,0,30,0
1650024758779,MATH 18,A01,083743,Staff,10,0,30,20
1650024758779,MATH 18,A02,083744,Staff,28,0,30,2
1650024758779,MATH 18,A03,083745,Staff,23,0,30,7
1650024758779,MATH 18,A04,083746,Staff,27,0,30,3
1650024758779,MATH 18,B01,083748,Staff,0,8,30,30
1650024758779,MATH 18,B02,083749,Staff,0,6,30,30
1650024758779,MATH 18,B03,083750,Staff,0,6,30,30
1650024758779,MATH 18,B04,083751,Staff,1,7,30,29
1650024764803,MATH 20A,A01,083754,Staff,27,0,40,13
1650024770834,MATH 20B,A01,083756,Staff,0,4,30,30
1650024770834,MATH 20B,A02,083757,Staff,4,0,30,26
1650024776863,MATH 20C,A01,083760,Staff,0,9,30,30
1650024776863,MATH 20C,A02,083761,Staff,0,10,30,30
1650024776863,MATH 20C,B01,083762,Staff,17,0,30,13
1650024776863,MATH 20C,B02,083763,Staff,28,0,30,2
1650024782893,MATH 20D,A01,083765,Staff,0,2,30,30
1650024782893,MATH 20D,A02,083766,Staff,16,0,30,14
1650024782893,MATH 20D,A03,083767,Staff,28,0,30,2
1650024788921,MATH 20E,A01,083771,Staff,11,0,30,19
1650024788921,MATH 20E,A02,083772,Staff,20,0,30,10
1650024788921,MATH 20E,B01,083773,Staff,0,1,30,30
1650024788921,MATH 20E,B02,083774,Staff,20,0,30,10
1650024794952,MATH 103A,A01,083777,Staff,0,6,30,30
1650024794952,MATH 103A,A02,083778,Staff,0,7,30,30
1650024794952,MATH 103A,B01,083779,Staff,0,7,30,30
1650024794952,MATH 103A,B02,083780,Staff,0,6,30,30
1650024800977,MATH 105,A01,085443,Staff,0,11,30,30
1650024807007,MATH 109,A01,083213,Anzaldo; Leesa B,0,3,30,30
1650024807007,MATH 109,A02,083214,Anzaldo; Leesa B,0,4,30,30
1650024807007,MATH 109,B01,083215,Anzaldo; Leesa B,0,2,30,30
1650024807007,MATH 109,B02,083216,Anzaldo; Leesa B,0,2,30,30
1650024813036,MATH 142A,A01,083219,Chow; Bennett,0,7,30,30
1650024813036,MATH 142A,A02,083220,Chow; Bennett,0,7,30,30
1650024813036,MATH 142A,B01,083221,Chow; Bennett,0,8,30,30
1650024813036,MATH 142A,B02,083222,Chow; Bennett,0,7,30,30
1650024819067,MATH 193A,A01,083224,Staff,0,5,30,30
1650024819067,MATH 193A,A02,083225,Staff,0,4,30,30
1650024819067,MATH 193A,A03,083781,Staff,0,0,30,30
1650024819067,MATH 193A,A04,083782,Staff,9,0,30,21
1650024825095,MATH 197,001,091859,McAuley; Julian John,9999,0,9999,0
1650024831163,COGS 9,A01,083615,Staff,1,15,60,59
1650024837192,COGS 11,A01,083617,Boyle; Mary E. T.,25,0,40,15
1650024843219,COGS 13,A01,083071,Staff,0,28,40,40
1650024849253,COGS 14A,A01,092681,Staff,0,6,100,100
1650024855277,COGS 14B,A01,083073,Cheng; Tzu-Han,0,2,50,50
1650024861300,COGS 17,A01,092677,Staff,35,0,75,40
1650024867323,COGS 100,A01,083619,Staff,0,18,60,60
1650024873353,COGS 101A,A01,083621,Davis; Joshua Daniel,0,16,60,60
1650024879381,COGS 101B,A01,091572,Staff,16,0,60,44
1650024885407,COGS 101C,A01,083625,Delgado; Tania,21,0,30,9
1650024891432,COGS 107A,A01,083627,Boyle; Mary E. T.,0,1,60,60
1650024897459,COGS 118A,A01,083075,Staff,19,0,60,41
1650024903496,CSE 3,A50,083646,Miranda; Gregory Joseph,22,0,38,16
1650024903496,CSE 3,A51,083647,Miranda; Gregory Joseph,37,0,37,0
1650024909533,CSE 8A,A50,083650,Miranda; Gregory Joseph,0,14,40,40
1650024915562,CSE 11,A01,083080,Cao; Yingjun,0,60,40,40
1650024921597,CSE 12,A01,083652,Staff,2,0,100,98
1650024927625,CSE 15L,A01,083654,Staff,0,0,50,50
1650024927625,CSE 15L,A02,083655,Staff,15,0,50,35
1650024933649,CSE 20,A01,083657,Staff,57,0,80,23
1650024939686,CSE 30,A01,083084,Eldon; John,0,62,40,40
1650024945723,CSE 100,A01,083659,Cao; Yingjun,0,57,50,50
1650024951754,CSE 134B,A01,083661,Powell; Thomas Allan,0,25,65,65
1650024957780,CSE 140,A01,083663,Staff,8,0,75,67
1650024963812,CSE 140L,A01,083088,Eldon; John,4,0,75,71
1650024969839,CSE 175,A01,083665,Kumar; Rakesh,10,0,25,15
1650024975870,CSE 190,A00,092507,Dubnov; Shlomo,17,0,20,3
1650024981900,ECE 45,A01,083139,Staff,0,10,40,40
1650024987934,ECE 65,A50,083695,Staff,0,1,30,30
1650024993968,ECE 109,A01,091882,Touri; Behrouz,48,0,70,22
1650024999993,ECE 180,A00,083140,Abi Samra; Nicholas Camill,26,0,30,4
1650024999993,ECE 180,B00,083141,Abi Samra; Nicholas Camill,10,0,30,20
1650025006030,MATH 10A,A01,083735,Patchell; Gregory David,14,0,30,16
1650025006030,MATH 10A,A02,083736,Patchell; Gregory David,28,0,30,2
1650025006030,MATH 10A,A03,083737,Patchell; Gregory David,27,0,30,3
1650025012144,MATH 10B,A01,083207,Staff,0,4,30,30
1650025012144,MATH 10B,A02,083208,Staff,0,0,30,30
1650025012144,MATH 10B,B01,083739,Staff,20,0,30,10
1650025012144,MATH 10B,B02,083740,Staff,30,0,30,0
1650025018180,MATH 18,A01,083743,Staff,10,0,30,20
1650025018180,MATH 18,A02,083744,Staff,28,0,30,2
1650025018180,MATH 18,A03,083745,Staff,23,0,30,7
1650025018180,MATH 18,A04,083746,Staff,27,0,30,3
1650025018180,MATH 18,B01,083748,Staff,0,8,30,30
1650025018180,MATH 18,B02,083749,Staff,0,6,30,30
1650025018180,MATH 18,B03,083750,Staff,0,6,30,30
1650025018180,MATH 18,B04,083751,Staff,1,7,30,29
1650025024214,MATH 20A,A01,083754,Staff,27,0,40,13
1650025030245,MATH 20B,A01,083756,Staff,0,4,30,30
1650025030245,MATH 20B,A02,083757,Staff,4,0,30,26
1650025036271,MATH 20C,A01,083760,Staff,0,9,30,30
1650025036271,MATH 20C,A02,083761,Staff,0,10,30,30
1650025036271,MATH 20C,B01,083762,Staff,17,0,30,13
1650025036271,MATH 20C,B02,083763,Staff,28,0,30,2
1650025042299,MATH 20D,A01,083765,Staff,0,2,30,30
1650025042299,MATH 20D,A02,083766,Staff,16,0,30,14
1650025042299,MATH 20D,A03,083767,Staff,28,0,30,2
1650025048330,MATH 20E,A01,083771,Staff,11,0,30,19
1650025048330,MATH 20E,A02,083772,Staff,20,0,30,10
1650025048330,MATH 20E,B01,083773,Staff,0,1,30,30
1650025048330,MATH 20E,B02,083774,Staff,20,0,30,10
1650025054361,MATH 103A,A01,083777,Staff,0,6,30,30
1650025054361,MATH 103A,A02,083778,Staff,0,7,30,30
1650025054361,MATH 103A,B01,083779,Staff,0,7,30,30
1650025054361,MATH 103A,B02,083780,Staff,0,6,30,30
1650025060390,MATH 105,A01,085443,Staff,0,11,30,30
1650025066417,MATH 109,A01,083213,Anzaldo; Leesa B,0,3,30,30
1650025066417,MATH 109,A02,083214,Anzaldo; Leesa B,0,4,30,30
1650025066417,MATH 109,B01,083215,Anzaldo; Leesa B,0,2,30,30
1650025066417,MATH 109,B02,083216,Anzaldo; Leesa B,0,2,30,30
1650025072447,MATH 142A,A01,083219,Chow; Bennett,0,7,30,30
1650025072447,MATH 142A,A02,083220,Chow; Bennett,0,7,30,30
1650025072447,MATH 142A,B01,083221,Chow; Bennett,0,8,30,30
1650025072447,MATH 142A,B02,083222,Chow; Bennett,0,7,30,30
1650025078474,MATH 193A,A01,083224,Staff,0,5,30,30
1650025078474,MATH 193A,A02,083225,Staff,0,4,30,30
1650025078474,MATH 193A,A03,083781,Staff,0,0,30,30
1650025078474,MATH 193A,A04,083782,Staff,9,0,30,21
1650025084502,MATH 197,001,091859,McAuley; Julian John,9999,0,9999,0
1650025090563,COGS 9,A01,083615,Staff,1,15,60,59
1650025096592,COGS 11,A01,083617,Boyle; Mary E. T.,25,0,40,15
1650025102620,COGS 13,A01,083071,Staff,0,28,40,40
1650025108644,COGS 14A,A01,092681,Staff,0,6,100,100
1650025114675,COGS 14B,A01,083073,Cheng; Tzu-Han,0,2,50,50
1650025120720,COGS 17,A01,092677,Staff,35,0,75,40
1650025126748,COGS 100,A01,083619,Staff,0,18,60,60
1650025132774,COGS 101A,A01,083621,Davis; Joshua Daniel,0,16,60,60
1650025138803,COGS 101B,A01,091572,Staff,16,0,60,44
1650025144843,COGS 101C,A01,083625,Delgado; Tania,21,0,30,9
1650025150875,COGS 107A,A01,083627,Boyle; Mary E. T.,0,1,60,60
1650025156902,COGS 118A,A01,083075,Staff,19,0,60,41
1650025162930,CSE 3,A50,083646,Miranda; Gregory Joseph,22,0,38,16
1650025162930,CSE 3,A51,083647,Miranda; Gregory Joseph,37,0,37,0
1650025168954,CSE 8A,A50,083650,Miranda; Gregory Joseph,0,14,40,40
1650025174985,CSE 11,A01,083080,Cao; Yingjun,0,60,40,40
1650025181013,CSE 12,A01,083652,Staff,2,0,100,98
1650025187038,CSE 15L,A01,083654,Staff,0,0,50,50
1650025187038,CSE 15L,A02,083655,Staff,15,0,50,35
1650025193066,CSE 20,A01,083657,Staff,57,0,80,23
1650025199098,CSE 30,A01,083084,Eldon; John,0,62,40,40
1650025205125,CSE 100,A01,083659,Cao; Yingjun,0,57,50,50
1650025211152,CSE 134B,A01,083661,Powell; Thomas Allan,0,25,65,65
1650025217179,CSE 140,A01,083663,Staff,8,0,75,67
1650025223206,CSE 140L,A01,083088,Eldon; John,4,0,75,71
1650025229237,CSE 175,A01,083665,Kumar; Rakesh,10,0,25,15
1650025235268,CSE 190,A00,092507,Dubnov; Shlomo,17,0,20,3
1650025241302,ECE 45,A01,083139,Staff,0,10,40,40
1650025247334,ECE 65,A50,083695,Staff,0,1,30,30
1650025253361,ECE 109,A01,091882,Touri; Behrouz,48,0,70,22
1650025259407,ECE 180,A00,083140,Abi Samra; Nicholas Camill,26,0,30,4
1650025259407,ECE 180,B00,083141,Abi Samra; Nicholas Camill,10,0,30,20
1650025265432,MATH 10A,A01,083735,Patchell; Gregory David,14,0,30,16
1650025265432,MATH 10A,A02,083736,Patchell; Gregory David,28,0,30,2
1650025265432,MATH 10A,A03,083737,Patchell; Gregory David,27,0,30,3
1650025271460,MATH 10B,A01,083207,Staff,0,4,30,30
1650025271460,MATH 10B,A02,083208,Staff,0,0,30,30
1650025271460,MATH 10B,B01,083739,Staff,20,0,30,10
1650025271460,MATH 10B,B02,083740,Staff,30,0,30,0
1650025277501,MATH 18,A01,083743,Staff,10,0,30,20
1650025277501,MATH 18,A02,083744,Staff,28,0,30,2
1650025277501,MATH 18,A03,083745,Staff,23,0,30,7
1650025277501,MATH 18,A04,083746,Staff,27,0,30,3
1650025277501,MATH 18,B01,083748,Staff,0,8,30,30
1650025277501,MATH 18,B02,083749,Staff,0,6,30,30
1650025277501,MATH 18,B03,083750,Staff,0,6,30,30
1650025277501,MATH 18,B04,083751,Staff,1,7,30,29
1650025283526,MATH 20A,A01,083754,Staff,27,0,40,13
1650025289552,MATH 20B,A01,083756,Staff,0,4,30,30
1650025289552,MATH 20B,A02,083757,Staff,4,0,30,26
1650025295583,MATH 20C,A01,083760,Staff,0,9,30,30
1650025295583,MATH 20C,A02,083761,Staff,0,10,30,30
1650025295583,MATH 20C,B01,083762,Staff,17,0,30,13
1650025295583,MATH 20C,B02,083763,Staff,28,0,30,2
1650025301607,MATH 20D,A01,083765,Staff,0,2,30,30
1650025301607,MATH 20D,A02,083766,Staff,16,0,30,14
1650025301607,MATH 20D,A03,083767,Staff,28,0,30,2
1650025307634,MATH 20E,A01,083771,Staff,11,0,30,19
1650025307634,MATH 20E,A02,083772,Staff,20,0,30,10
1650025307634,MATH 20E,B01,083773,Staff,0,1,30,30
1650025307634,MATH 20E,B02,083774,Staff,20,0,30,10
1650025313660,MATH 103A,A01,083777,Staff,0,6,30,30
1650025313660,MATH 103A,A02,083778,Staff,0,7,30,30
1650025313660,MATH 103A,B01,083779,Staff,0,7,30,30
1650025313660,MATH 103A,B02,083780,Staff,0,6,30,30
1650025319686,MATH 105,A01,085443,Staff,0,11,30,30
1650025325722,MATH 109,A01,083213,Anzaldo; Leesa B,0,3,30,30
1650025325722,MATH 109,A02,083214,Anzaldo; Leesa B,0,4,30,30
1650025325722,MATH 109,B01,083215,Anzaldo; Leesa B,0,2,30,30
1650025325722,MATH 109,B02,083216,Anzaldo; Leesa B,0,2,30,30
1650025331748,MATH 142A,A01,083219,Chow; Bennett,0,7,30,30
1650025331748,MATH 142A,A02,083220,Chow; Bennett,0,7,30,30
1650025331748,MATH 142A,B01,083221,Chow; Bennett,0,8,30,30
1650025331748,MATH 142A,B02,083222,Chow; Bennett,0,7,30,30
1650025337778,MATH 193A,A01,083224,Staff,0,5,30,30
1650025337778,MATH 193A,A02,083225,Staff,0,4,30,30
1650025337778,MATH 193A,A03,083781,Staff,0,0,30,30
1650025337778,MATH 193A,A04,083782,Staff,9,0,30,21
1650025343803,MATH 197,001,091859,McAuley; Julian John,9999,0,9999,0
1650025349878,COGS 9,A01,083615,Staff,1,15,60,59
1650025355905,COGS 11,A01,083617,Boyle; Mary E. T.,25,0,40,15
1650025361936,COGS 13,A01,083071,Staff,0,28,40,40
1650025367969,COGS 14A,A01,092681,Staff,0,6,100,100
1650025373995,COGS 14B,A01,083073,Cheng; Tzu-Han,0,2,50,50
1650025380021,COGS 17,A01,092677,Staff,35,0,75,40
1650025386049,COGS 100,A01,083619,Staff,0,18,60,60
1650025392082,COGS 101A,A01,083621,Davis; Joshua Daniel,0,16,60,60
1650025398108,COGS 101B,A01,091572,Staff,16,0,60,44
1650025404136,COGS 101C,A01,083625,Delgado; Tania,21,0,30,9
1650025410161,COGS 107A,A01,083627,Boyle; Mary E. T.,0,1,60,60
1650025416188,COGS 118A,A01,083075,Staff,19,0,60,41
1650025422217,CSE 3,A50,083646,Miranda; Gregory Joseph,22,0,38,16
1650025422217,CSE 3,A51,083647,Miranda; Gregory Joseph,37,0,37,0
1650025428255,CSE 8A,A50,083650,Miranda; Gregory Joseph,0,14,40,40
1650025434282,CSE 11,A01,083080,Cao; Yingjun,0,60,40,40
1650025440319,CSE 12,A01,083652,Staff,2,0,100,98
1650025446344,CSE 15L,A01,083654,Staff,0,0,50,50
1650025446344,CSE 15L,A02,083655,Staff,15,0,50,35
1650025452370,CSE 20,A01,083657,Staff,57,0,80,23
1650025458397,CSE 30,A01,083084,Eldon; John,0,62,40,40
1650025464438,CSE 100,A01,083659,Cao; Yingjun,0,57,50,50
1650025470465,CSE 134B,A01,083661,Powell; Thomas Allan,0,25,65,65
1650025476499,CSE 140,A01,083663,Staff,8,0,75,67
1650025482525,CSE 140L,A01,083088,Eldon; John,4,0,75,71
1650025488552,CSE 175,A01,083665,Kumar; Rakesh,10,0,25,15
1650025494582,CSE 190,A00,092507,Dubnov; Shlomo,17,0,20,3
1650025500613,ECE 45,A01,083139,Staff,0,10,40,40
1650025506644,ECE 65,A50,083695,Staff,0,1,30,30
1650025512675,ECE 109,A01,091882,Touri; Behrouz,48,0,70,22
1650025518704,ECE 180,A00,083140,Abi Samra; Nicholas Camill,26,0,30,4
1650025518704,ECE 180,B00,083141,Abi Samra; Nicholas Camill,10,0,30,20
1650025524739,MATH 10A,A01,083735,Patchell; Gregory David,14,0,30,16
1650025524739,MATH 10A,A02,083736,Patchell; Gregory David,28,0,30,2
1650025524739,MATH 10A,A03,083737,Patchell; Gregory David,27,0,30,3
1650025530764,MATH 10B,A01,083207,Staff,0,4,30,30
1650025530764,MATH 10B,A02,083208,Staff,0,0,30,30
1650025530764,MATH 10B,B01,083739,Staff,20,0,30,10
1650025530764,MATH 10B,B02,083740,Staff,30,0,30,0
1650025536794,MATH 18,A01,083743,Staff,10,0,30,20
1650025536794,MATH 18,A02,083744,Staff,28,0,30,2
1650025536794,MATH 18,A03,083745,Staff,23,0,30,7
1650025536794,MATH 18,A04,083746,Staff,27,0,30,3
1650025536794,MATH 18,B01,083748,Staff,0,8,30,30
1650025536794,MATH 18,B02,083749,Staff,0,6,30,30
1650025536794,MATH 18,B03,083750,Staff,0,6,30,30
1650025536794,MATH 18,B04,083751,Staff,1,7,30,29
1650025542826,MATH 20A,A01,083754,Staff,27,0,40,13
1650025548858,MATH 20B,A01,083756,Staff,0,4,30,30
1650025548858,MATH 20B,A02,083757,Staff,4,0,30,26
1650025554890,MATH 20C,A01,083760,Staff,0,9,30,30
1650025554890,MATH 20C,A02,083761,Staff,0,10,30,30
1650025554890,MATH 20C,B01,083762,Staff,17,0,30,13
1650025554890,MATH 20C,B02,083763,Staff,28,0,30,2
1650025560921,MATH 20D,A01,083765,Staff,0,2,30,30
1650025560921,MATH 20D,A02,083766,Staff,16,0,30,14
1650025560921,MATH 20D,A03,083767,Staff,28,0,30,2
1650025566959,MATH 20E,A01,083771,Staff,11,0,30,19
1650025566959,MATH 20E,A02,083772,Staff,20,0,30,10
1650025566959,MATH 20E,B01,083773,Staff,0,1,30,30
1650025566959,MATH 20E,B02,083774,Staff,20,0,30,10
1650025572992,MATH 103A,A01,083777,Staff,0,6,30,30
1650025572992,MATH 103A,A02,083778,Staff,0,7,30,30
1650025572992,MATH 103A,B01,083779,Staff,0,7,30,30
1650025572992,MATH 103A,B02,083780,Staff,0,6,30,30
1650025579022,MATH 105,A01,085443,Staff,0,11,30,30
1650025585059,MATH 109,A01,083213,Anzaldo; Leesa B,0,3,30,30
1650025585059,MATH 109,A02,083214,Anzaldo; Leesa B,0,4,30,30
1650025585059,MATH 109,B01,083215,Anzaldo; Leesa B,0,2,30,30
1650025585059,MATH 109,B02,083216,Anzaldo; Leesa B,0,2,30,30
1650025591092,MATH 142A,A01,083219,Chow; Bennett,0,7,30,30
1650025591092,MATH 142A,A02,083220,Chow; Bennett,0,7,30,30
1650025591092,MATH 142A,B01,083221,Chow; Bennett,0,8,30,30
1650025591092,MATH 142A,B02,083222,Chow; Bennett,0,7,30,30
1650025597117,MATH 193A,A01,083224,Staff,0,5,30,30
1650025597117,MATH 193A,A02,083225,Staff,0,4,30,30
1650025597117,MATH 193A,A03,083781,Staff,0,0,30,30
1650025597117,MATH 193A,A04,083782,Staff,9,0,30,21
1650025603149,MATH 197,001,091859,McAuley; Julian John,9999,0,9999,0
1650025609327,COGS 9,A01,083615,Staff,1,15,60,59
1650025615352,COGS 11,A01,083617,Boyle; Mary E. T.,25,0,40,15
1650025621396,COGS 13,A01,083071,Staff,0,28,40,40
1650025627425,COGS 14A,A01,092681,Staff,0,6,100,100
1650025633457,COGS 14B,A01,083073,Cheng; Tzu-Han,0,2,50,50
1650025639486,COGS 17,A01,092677,Staff,35,0,75,40
1650025645511,COGS 100,A01,083619,Staff,0,18,60,60
1650025651537,COGS 101A,A01,083621,Davis; Joshua Daniel,0,16,60,60
1650025657563,COGS 101B,A01,091572,Staff,16,0,60,44
1650025663589,COGS 101C,A01,083625,Delgado; Tania,21,0,30,9
1650025669623,COGS 107A,A01,083627,Boyle; Mary E. T.,0,1,60,60
1650025675659,COGS 118A,A01,083075,Staff,19,0,60,41
1650025681686,CSE 3,A50,083646,Miranda; Gregory Joseph,22,0,38,16
1650025681686,CSE 3,A51,083647,Miranda; Gregory Joseph,37,0,37,0
1650025687722,CSE 8A,A50,083650,Miranda; Gregory Joseph,0,14,40,40
1650025693751,CSE 11,A01,083080,Cao; Yingjun,0,60,40,40
1650025699776,CSE 12,A01,083652,Staff,2,0,100,98
1650025705804,CSE 15L,A01,083654,Staff,0,0,50,50
1650025705804,CSE 15L,A02,083655,Staff,15,0,50,35
1650025711841,CSE 20,A01,083657,Staff,57,0,80,23
1650025717873,CSE 30,A01,083084,Eldon; John,0,62,40,40
1650025723899,CSE 100,A01,083659,Cao; Yingjun,0,57,50,50
1650025729926,CSE 134B,A01,083661,Powell; Thomas Allan,0,25,65,65
1650025735952,CSE 140,A01,083663,Staff,8,0,75,67
1650025741982,CSE 140L,A01,083088,Eldon; John,4,0,75,71
1650025748006,CSE 175,A01,083665,Kumar; Rakesh,10,0,25,15
1650025754035,CSE 190,A00,092507,Dubnov; Shlomo,17,0,20,3
1650025760072,ECE 45,A01,083139,Staff,0,10,40,40
1650025766095,ECE 65,A50,083695,Staff,0,1,30,30
1650025772118,ECE 109,A01,091882,Touri; Behrouz,48,0,70,22
1650025778145,ECE 180,A00,083140,Abi Samra; Nicholas Camill,26,0,30,4
1650025778145,ECE 180,B00,083141,Abi Samra; Nicholas Camill,10,0,30,20
1650025784171,MATH 10A,A01,083735,Patchell; Gregory David,14,0,30,16
1650025784171,MATH 10A,A02,083736,Patchell; Gregory David,28,0,30,2
1650025784171,MATH 10A,A03,083737,Patchell; Gregory David,27,0,30,3
1650025790200,MATH 10B,A01,083207,Staff,0,4,30,30
1650025790200,MATH 10B,A02,083208,Staff,0,0,30,30
1650025790200,MATH 10B,B01,083739,Staff,20,0,30,10
1650025790200,MATH 10B,B02,083740,Staff,30,0,30,0
1650025796253,MATH 18,A01,083743,Staff,10,0,30,20
1650025796253,MATH 18,A02,083744,Staff,28,0,30,2
1650025796253,MATH 18,A03,083745,Staff,23,0,30,7
1650025796253,MATH 18,A04,083746,Staff,27,0,30,3
1650025796253,MATH 18,B01,083748,Staff,0,8,30,30
1650025796253,MATH 18,B02,083749,Staff,0,6,30,30
1650025796253,MATH 18,B03,083750,Staff,0,6,30,30
1650025796253,MATH 18,B04,083751,Staff,1,7,30,29
1650025802283,MATH 20A,A01,083754,Staff,27,0,40,13
1650025808322,MATH 20B,A01,083756,Staff,0,4,30,30
1650025808322,MATH 20B,A02,083757,Staff,4,0,30,26
1650025814366,MATH 20C,A01,083760,Staff,0,9,30,30
1650025814366,MATH 20C,A02,083761,Staff,0,10,30,30
1650025814366,MATH 20C,B01,083762,Staff,17,0,30,13
1650025814366,MATH 20C,B02,083763,Staff,28,0,30,2
1650025820403,MATH 20D,A01,083765,Staff,0,2,30,30
1650025820403,MATH 20D,A02,083766,Staff,16,0,30,14
1650025820403,MATH 20D,A03,083767,Staff,28,0,30,2
1650025826438,MATH 20E,A01,083771,Staff,11,0,30,19
1650025826438,MATH 20E,A02,083772,Staff,20,0,30,10
1650025826438,MATH 20E,B01,083773,Staff,0,1,30,30
1650025826438,MATH 20E,B02,083774,Staff,20,0,30,10
1650025832469,MATH 103A,A01,083777,Staff,0,6,30,30
1650025832469,MATH 103A,A02,083778,Staff,0,7,30,30
1650025832469,MATH 103A,B01,083779,Staff,0,7,30,30
1650025832469,MATH 103A,B02,083780,Staff,0,6,30,30
1650025838497,MATH 105,A01,085443,Staff,0,11,30,30
1650025844528,MATH 109,A01,083213,Anzaldo; Leesa B,0,3,30,30
1650025844528,MATH 109,A02,083214,Anzaldo; Leesa B,0,4,30,30
1650025844528,MATH 109,B01,083215,Anzaldo; Leesa B,0,2,30,30
1650025844528,MATH 109,B02,083216,Anzaldo; Leesa B,0,2,30,30
1650025850552,MATH 142A,A01,083219,Chow; Bennett,0,7,30,30
1650025850552,MATH 142A,A02,083220,Chow; Bennett,0,7,30,30
1650025850552,MATH 142A,B01,083221,Chow; Bennett,0,8,30,30
1650025850552,MATH 142A,B02,083222,Chow; Bennett,0,7,30,30
1650025856577,MATH 193A,A01,083224,Staff,0,5,30,30
1650025856577,MATH 193A,A02,083225,Staff,0,4,30,30
1650025856577,MATH 193A,A03,083781,Staff,0,0,30,30
1650025856577,MATH 193A,A04,083782,Staff,9,0,30,21
1650025862604,MATH 197,001,091859,McAuley; Julian John,9999,0,9999,0
1650025868684,COGS 9,A01,083615,Staff,1,15,60,59
1650025874710,COGS 11,A01,083617,Boyle; Mary E. T.,25,0,40,15
1650025880739,COGS 13,A01,083071,Staff,0,28,40,40
1650025886780,COGS 14A,A01,092681,Staff,0,6,100,100
1650025892810,COGS 14B,A01,083073,Cheng; Tzu-Han,0,2,50,50
1650025898835,COGS 17,A01,092677,Staff,35,0,75,40
1650025904859,COGS 100,A01,083619,Staff,0,18,60,60
1650025910894,COGS 101A,A01,083621,Davis; Joshua Daniel,0,16,60,60
1650025916919,COGS 101B,A01,091572,Staff,16,0,60,44
1650025922949,COGS 101C,A01,083625,Delgado; Tania,21,0,30,9
1650025928979,COGS 107A,A01,083627,Boyle; Mary E. T.,0,1,60,60
1650025935013,COGS 118A,A01,083075,Staff,19,0,60,41
1650025941046,CSE 3,A50,083646,Miranda; Gregory Joseph,22,0,38,16
1650025941046,CSE 3,A51,083647,Miranda; Gregory Joseph,37,0,37,0
1650025947077,CSE 8A,A50,083650,Miranda; Gregory Joseph,0,14,40,40
1650025953107,CSE 11,A01,083080,Cao; Yingjun,0,60,40,40
1650025959133,CSE 12,A01,083652,Staff,2,0,100,98
1650025965163,CSE 15L,A01,083654,Staff,0,0,50,50
1650025965163,CSE 15L,A02,083655,Staff,15,0,50,35
1650025971192,CSE 20,A01,083657,Staff,57,0,80,23
1650025977216,CSE 30,A01,083084,Eldon; John,0,62,40,40
1650025983249,CSE 100,A01,083659,Cao; Yingjun,0,57,50,50
1650025989274,CSE 134B,A01,083661,Powell; Thomas Allan,0,25,65,65
1650025995301,CSE 140,A01,083663,Staff,8,0,75,67
1650026001331,CSE 140L,A01,083088,Eldon; John,4,0,75,71
1650026007365,CSE 175,A01,083665,Kumar; Rakesh,10,0,25,15
1650026013397,CSE 190,A00,092507,Dubnov; Shlomo,17,0,20,3
1650026019426,ECE 45,A01,083139,Staff,0,10,40,40
1650026025458,ECE 65,A50,083695,Staff,0,1,30,30
1650026031493,ECE 109,A01,091882,Touri; Behrouz,48,0,70,22
1650026037524,ECE 180,A00,083140,Abi Samra; Nicholas Camill,26,0,30,4
1650026037524,ECE 180,B00,083141,Abi Samra; Nicholas Camill,10,0,30,20
1650026043572,MATH 10A,A01,083735,Patchell; Gregory David,14,0,30,16
1650026043572,MATH 10A,A02,083736,Patchell; Gregory David,28,0,30,2
1650026043572,MATH 10A,A03,083737,Patchell; Gregory David,27,0,30,3
1650026049599,MATH 10B,A01,083207,Staff,0,4,30,30
1650026049599,MATH 10B,A02,083208,Staff,0,0,30,30
1650026049599,MATH 10B,B01,083739,Staff,20,0,30,10
1650026049599,MATH 10B,B02,083740,Staff,30,0,30,0
1650026055639,MATH 18,A01,083743,Staff,10,0,30,20
1650026055639,MATH 18,A02,083744,Staff,28,0,30,2
1650026055639,MATH 18,A03,083745,Staff,23,0,30,7
1650026055639,MATH 18,A04,083746,Staff,27,0,30,3
1650026055639,MATH 18,B01,083748,Staff,0,8,30,30
1650026055639,MATH 18,B02,083749,Staff,0,6,30,30
1650026055639,MATH 18,B03,083750,Staff,0,6,30,30
1650026055639,MATH 18,B04,083751,Staff,1,7,30,29
1650026061672,MATH 20A,A01,083754,Staff,27,0,40,13
1650026067703,MATH 20B,A01,083756,Staff,0,4,30,30
1650026067703,MATH 20B,A02,083757,Staff,4,0,30,26
1650026073729,MATH 20C,A01,083760,Staff,0,9,30,30
1650026073729,MATH 20C,A02,083761,Staff,0,10,30,30
1650026073729,MATH 20C,B01,083762,Staff,17,0,30,13
1650026073729,MATH 20C,B02,083763,Staff,28,0,30,2
1650026079758,MATH 20D,A01,083765,Staff,0,2,30,30
1650026079758,MATH 20D,A02,083766,Staff,16,0,30,14
1650026079758,MATH 20D,A03,083767,Staff,28,0,30,2
1650026085788,MATH 20E,A01,083771,Staff,11,0,30,19
1650026085788,MATH 20E,A02,083772,Staff,20,0,30,10
1650026085788,MATH 20E,B01,083773,Staff,0,1,30,30
1650026085788,MATH 20E,B02,083774,Staff,20,0,30,10
1650026091827,MATH 103A,A01,083777,Staff,0,6,30,30
1650026091827,MATH 103A,A02,083778,Staff,0,7,30,30
1650026091827,MATH 103A,B01,083779,Staff,0,7,30,30
1650026091827,MATH 103A,B02,083780,Staff,0,6,30,30
1650026097854,MATH 105,A01,085443,Staff,0,11,30,30
1650026103879,MATH 109,A01,083213,Anzaldo; Leesa B,0,3,30,30
1650026103879,MATH 109,A02,083214,Anzaldo; Leesa B,0,4,30,30
1650026103879,MATH 109,B01,083215,Anzaldo; Leesa B,0,2,30,30
1650026103879,MATH 109,B02,083216,Anzaldo; Leesa B,0,2,30,30
1650026109906,MATH 142A,A01,083219,Chow; Bennett,0,7,30,30
1650026109906,MATH 142A,A02,083220,Chow; Bennett,0,7,30,30
1650026109906,MATH 142A,B01,083221,Chow; Bennett,0,8,30,30
1650026109906,MATH 142A,B02,083222,Chow; Bennett,0,7,30,30
1650026115933,MATH 193A,A01,083224,Staff,0,5,30,30
1650026115933,MATH 193A,A02,083225,Staff,0,4,30,30
1650026115933,MATH 193A,A03,083781,Staff,0,0,30,30
1650026115933,MATH 193A,A04,083782,Staff,9,0,30,21
1650026121963,MATH 197,001,091859,McAuley; Julian John,9999,0,9999,0
1650026128020,COGS 9,A01,083615,Staff,1,15,60,59
1650026134049,COGS 11,A01,083617,Boyle; Mary E. T.,25,0,40,15
1650026140078,COGS 13,A01,083071,Staff,0,28,40,40
1650026146106,COGS 14A,A01,092681,Staff,0,6,100,100
1650026152140,COGS 14B,A01,083073,Cheng; Tzu-Han,0,2,50,50
1650026158165,COGS 17,A01,092677,Staff,35,0,75,40
1650026164190,COGS 100,A01,083619,Staff,0,18,60,60
1650026170218,COGS 101A,A01,083621,Davis; Joshua Daniel,0,16,60,60
1650026176243,COGS 101B,A01,091572,Staff,16,0,60,44
1650026182272,COGS 101C,A01,083625,Delgado; Tania,21,0,30,9
1650026188296,COGS 107A,A01,083627,Boyle; Mary E. T.,0,1,60,60
1650026194325,COGS 118A,A01,083075,Staff,19,0,60,41
1650026200435,CSE 3,A50,083646,Miranda; Gregory Joseph,22,0,38,16
1650026200435,CSE 3,A51,083647,Miranda; Gregory Joseph,37,0,37,0
1650026206464,CSE 8A,A50,083650,Miranda; Gregory Joseph,0,14,40,40
1650026212488,CSE 11,A01,083080,Cao; Yingjun,0,60,40,40
1650026218517,CSE 12,A01,083652,Staff,2,0,100,98
1650026224548,CSE 15L,A01,083654,Staff,0,0,50,50
1650026224548,CSE 15L,A02,083655,Staff,15,0,50,35
1650026230576,CSE 20,A01,083657,Staff,57,0,80,23
1650026236600,CSE 30,A01,083084,Eldon; John,0,62,40,40
1650026242630,CSE 100,A01,083659,Cao; Yingjun,0,57,50,50
1650026248652,CSE 134B,A01,083661,Powell; Thomas Allan,0,25,65,65
1650026254676,CSE 140,A01,083663,Staff,8,0,75,67
1650026260701,CSE 140L,A01,083088,Eldon; John,4,0,75,71
1650026266739,CSE 175,A01,083665,Kumar; Rakesh,10,0,25,15
1650026272768,CSE 190,A00,092507,Dubnov; Shlomo,17,0,20,3
1650026278793,ECE 45,A01,083139,Staff,0,10,40,40
1650026284818,ECE 65,A50,083695,Staff,0,1,30,30
1650026290846,ECE 109,A01,091882,Touri; Behrouz,48,0,70,22
1650026296873,ECE 180,A00,083140,Abi Samra; Nicholas Camill,26,0,30,4
1650026296873,ECE 180,B00,083141,Abi Samra; Nicholas Camill,10,0,30,20
1650026302899,MATH 10A,A01,083735,Patchell; Gregory David,14,0,30,16
1650026302899,MATH 10A,A02,083736,Patchell; Gregory David,28,0,30,2
1650026302899,MATH 10A,A03,083737,Patchell; Gregory David,27,0,30,3
1650026308930,MATH 10B,A01,083207,Staff,0,4,30,30
1650026308930,MATH 10B,A02,083208,Staff,0,0,30,30
1650026308930,MATH 10B,B01,083739,Staff,20,0,30,10
1650026308930,MATH 10B,B02,083740,Staff,30,0,30,0
1650026314969,MATH 18,A01,083743,Staff,10,0,30,20
1650026314969,MATH 18,A02,083744,Staff,28,0,30,2
1650026314969,MATH 18,A03,083745,Staff,23,0,30,7
1650026314969,MATH 18,A04,083746,Staff,27,0,30,3
1650026314969,MATH 18,B01,083748,Staff,0,8,30,30
1650026314969,MATH 18,B02,083749,Staff,0,6,30,30
1650026314969,MATH 18,B03,083750,Staff,0,6,30,30
1650026314969,MATH 18,B04,083751,Staff,1,7,30,29
1650026320993,MATH 20A,A01,083754,Staff,27,0,40,13
1650026327018,MATH 20B,A01,083756,Staff,0,4,30,30
1650026327018,MATH 20B,A02,083757,Staff,4,0,30,26
1650026333043,MATH 20C,A01,083760,Staff,0,9,30,30
1650026333043,MATH 20C,A02,083761,Staff,0,10,30,30
1650026333043,MATH 20C,B01,083762,Staff,17,0,30,13
1650026333043,MATH 20C,B02,083763,Staff,28,0,30,2
1650026339073,MATH 20D,A01,083765,Staff,0,2,30,30
1650026339073,MATH 20D,A02,083766,Staff,16,0,30,14
1650026339073,MATH 20D,A03,083767,Staff,28,0,30,2
1650026345099,MATH 20E,A01,083771,Staff,11,0,30,19
1650026345099,MATH 20E,A02,083772,Staff,20,0,30,10
1650026345099,MATH 20E,B01,083773,Staff,0,1,30,30
1650026345099,MATH 20E,B02,083774,Staff,20,0,30,10
1650026351130,MATH 103A,A01,083777,Staff,0,6,30,30
1650026351130,MATH 103A,A02,083778,Staff,0,7,30,30
1650026351130,MATH 103A,B01,083779,Staff,0,7,30,30
1650026351130,MATH 103A,B02,083780,Staff,0,6,30,30
1650026357157,MATH 105,A01,085443,Staff,0,11,30,30
1650026363186,MATH 109,A01,083213,Anzaldo; Leesa B,0,3,30,30
1650026363186,MATH 109,A02,083214,Anzaldo; Leesa B,0,4,30,30
1650026363186,MATH 109,B01,083215,Anzaldo; Leesa B,0,2,30,30
1650026363186,MATH 109,B02,083216,Anzaldo; Leesa B,0,2,30,30
1650026369212,MATH 142A,A01,083219,Chow; Bennett,0,7,30,30
1650026369212,MATH 142A,A02,083220,Chow; Bennett,0,7,30,30
1650026369212,MATH 142A,B01,083221,Chow; Bennett,0,8,30,30
1650026369212,MATH 142A,B02,083222,Chow; Bennett,0,7,30,30
1650026375239,MATH 193A,A01,083224,Staff,0,5,30,30
1650026375239,MATH 193A,A02,083225,Staff,0,4,30,30
1650026375239,MATH 193A,A03,083781,Staff,0,0,30,30
1650026375239,MATH 193A,A04,083782,Staff,9,0,30,21
1650026381263,MATH 197,001,091859,McAuley; Julian John,9999,0,9999,0
1650026387326,COGS 9,A01,083615,Staff,1,15,60,59
1650026393349,COGS 11,A01,083617,Boyle; Mary E. T.,25,0,40,15
1650026399377,COGS 13,A01,083071,Staff,0,28,40,40
1650026405405,COGS 14A,A01,092681,Staff,0,6,100,100
1650026411435,COGS 14B,A01,083073,Cheng; Tzu-Han,0,2,50,50
1650026417457,COGS 17,A01,092677,Staff,35,0,75,40
1650026423489,COGS 100,A01,083619,Staff,0,18,60,60
1650026429529,COGS 101A,A01,083621,Davis; Joshua Daniel,0,16,60,60
1650026435560,COGS 101B,A01,091572,Staff,16,0,60,44
1650026441585,COGS 101C,A01,083625,Delgado; Tania,21,0,30,9
1650026447614,COGS 107A,A01,083627,Boyle; Mary E. T.,0,1,60,60
1650026453638,COGS 118A,A01,083075,Staff,19,0,60,41
1650026459669,CSE 3,A50,083646,Miranda; Gregory Joseph,22,0,38,16
1650026459669,CSE 3,A51,083647,Miranda; Gregory Joseph,37,0,37,0
1650026465698,CSE 8A,A50,083650,Miranda; Gregory Joseph,0,14,40,40
1650026471725,CSE 11,A01,083080,Cao; Yingjun,0,60,40,40
1650026477748,CSE 12,A01,083652,Staff,2,0,100,98
1650026483777,CSE 15L,A01,083654,Staff,0,0,50,50
1650026483777,CSE 15L,A02,083655,Staff,15,0,50,35
1650026489801,CSE 20,A01,083657,Staff,57,0,80,23
1650026495835,CSE 30,A01,083084,Eldon; John,0,62,40,40
1650026501863,CSE 100,A01,083659,Cao; Yingjun,0,57,50,50
1650026507889,CSE 134B,A01,083661,Powell; Thomas Allan,0,25,65,65
1650026513911,CSE 140,A01,083663,Staff,8,0,75,67
1650026519936,CSE 140L,A01,083088,Eldon; John,4,0,75,71
1650026525961,CSE 175,A01,083665,Kumar; Rakesh,10,0,25,15
1650026531986,CSE 190,A00,092507,Dubnov; Shlomo,17,0,20,3
1650026538011,ECE 45,A01,083139,Staff,0,10,40,40
1650026544043,ECE 65,A50,083695,Staff,0,1,30,30
1650026550067,ECE 109,A01,091882,Touri; Behrouz,48,0,70,22
1650026556095,ECE 180,A00,083140,Abi Samra; Nicholas Camill,26,0,30,4
1650026556095,ECE 180,B00,083141,Abi Samra; Nicholas Camill,10,0,30,20
1650026562126,MATH 10A,A01,083735,Patchell; Gregory David,14,0,30,16
1650026562126,MATH 10A,A02,083736,Patchell; Gregory David,28,0,30,2
1650026562126,MATH 10A,A03,083737,Patchell; Gregory David,27,0,30,3
1650026568151,MATH 10B,A01,083207,Staff,0,4,30,30
1650026568151,MATH 10B,A02,083208,Staff,0,0,30,30
1650026568151,MATH 10B,B01,083739,Staff,20,0,30,10
1650026568151,MATH 10B,B02,083740,Staff,30,0,30,0
1650026574185,MATH 18,A01,083743,Staff,10,0,30,20
1650026574185,MATH 18,A02,083744,Staff,28,0,30,2
1650026574185,MATH 18,A03,083745,Staff,23,0,30,7
1650026574185,MATH 18,A04,083746,Staff,27,0,30,3
1650026574185,MATH 18,B01,083748,Staff,0,8,30,30
1650026574185,MATH 18,B02,083749,Staff,0,6,30,30
1650026574185,MATH 18,B03,083750,Staff,0,6,30,30
1650026574185,MATH 18,B04,083751,Staff,1,7,30,29
1650026580210,MATH 20A,A01,083754,Staff,27,0,40,13
1650026586235,MATH 20B,A01,083756,Staff,0,4,30,30
1650026586235,MATH 20B,A02,083757,Staff,4,0,30,26
1650026592260,MATH 20C,A01,083760,Staff,0,9,30,30
1650026592260,MATH 20C,A02,083761,Staff,0,10,30,30
1650026592260,MATH 20C,B01,083762,Staff,17,0,30,13
1650026592260,MATH 20C,B02,083763,Staff,28,0,30,2
1650026598287,MATH 20D,A01,083765,Staff,0,2,30,30
1650026598287,MATH 20D,A02,083766,Staff,16,0,30,14
1650026598287,MATH 20D,A03,083767,Staff,28,0,30,2
1650026604315,MATH 20E,A01,083771,Staff,11,0,30,19
1650026604315,MATH 20E,A02,083772,Staff,20,0,30,10
1650026604315,MATH 20E,B01,083773,Staff,0,1,30,30
1650026604315,MATH 20E,B02,083774,Staff,20,0,30,10
1650026610347,MATH 103A,A01,083777,Staff,0,6,30,30
1650026610347,MATH 103A,A02,083778,Staff,0,7,30,30
1650026610347,MATH 103A,B01,083779,Staff,0,7,30,30
1650026610347,MATH 103A,B02,083780,Staff,0,6,30,30
1650026616373,MATH 105,A01,085443,Staff,0,11,30,30
1650026622409,MATH 109,A01,083213,Anzaldo; Leesa B,0,3,30,30
1650026622409,MATH 109,A02,083214,Anzaldo; Leesa B,0,4,30,30
1650026622409,MATH 109,B01,083215,Anzaldo; Leesa B,0,2,30,30
1650026622409,MATH 109,B02,083216,Anzaldo; Leesa B,0,2,30,30
1650026628435,MATH 142A,A01,083219,Chow; Bennett,0,7,30,30
1650026628435,MATH 142A,A02,083220,Chow; Bennett,0,7,30,30
1650026628435,MATH 142A,B01,083221,Chow; Bennett,0,8,30,30
1650026628435,MATH 142A,B02,083222,Chow; Bennett,0,7,30,30
1650026634473,MATH 193A,A01,083224,Staff,0,5,30,30
1650026634473,MATH 193A,A02,083225,Staff,0,4,30,30
1650026634473,MATH 193A,A03,083781,Staff,0,0,30,30
1650026634473,MATH 193A,A04,083782,Staff,9,0,30,21
1650026640505,MATH 197,001,091859,McAuley; Julian John,9999,0,9999,0
1650026646565,COGS 9,A01,083615,Staff,1,15,60,59
1650026652589,COGS 11,A01,083617,Boyle; Mary E. T.,25,0,40,15
1650026658613,COGS 13,A01,083071,Staff,0,28,40,40
1650026664639,COGS 14A,A01,092681,Staff,0,6,100,100
1650026670674,COGS 14B,A01,083073,Cheng; Tzu-Han,0,2,50,50
1650026676709,COGS 17,A01,092677,Staff,35,0,75,40
1650026682741,COGS 100,A01,083619,Staff,0,18,60,60
1650026688774,COGS 101A,A01,083621,Davis; Joshua Daniel,0,16,60,60
1650026694807,COGS 101B,A01,091572,Staff,16,0,60,44
1650026700836,COGS 101C,A01,083625,Delgado; Tania,21,0,30,9
1650026706860,COGS 107A,A01,083627,Boyle; Mary E. T.,0,1,60,60
1650026712886,COGS 118A,A01,083075,Staff,19,0,60,41
1650026718910,CSE 3,A50,083646,Miranda; Gregory Joseph,22,0,38,16
1650026718910,CSE 3,A51,083647,Miranda; Gregory Joseph,37,0,37,0
1650026724945,CSE 8A,A50,083650,Miranda; Gregory Joseph,0,14,40,40
1650026730974,CSE 11,A01,083080,Cao; Yingjun,0,60,40,40
1650026737000,CSE 12,A01,083652,Staff,2,0,100,98
1650026743028,CSE 15L,A01,083654,Staff,0,0,50,50
1650026743028,CSE 15L,A02,083655,Staff,15,0,50,35
1650026749052,CSE 20,A01,083657,Staff,57,0,80,23
1650026755078,CSE 30,A01,083084,Eldon; John,0,62,40,40
1650026761111,CSE 100,A01,083659,Cao; Yingjun,0,57,50,50
1650026767136,CSE 134B,A01,083661,Powell; Thomas Allan,0,25,65,65
1650026773164,CSE 140,A01,083663,Staff,8,0,75,67
1650026779189,CSE 140L,A01,083088,Eldon; John,4,0,75,71
1650026785219,CSE 175,A01,083665,Kumar; Rakesh,10,0,25,15
1650026791252,CSE 190,A00,092507,Dubnov; Shlomo,17,0,20,3
1650026797371,ECE 45,A01,083139,Staff,0,10,40,40
1650026803407,ECE 65,A50,083695,Staff,0,1,30,30
1650026809437,ECE 109,A01,091882,Touri; Behrouz,48,0,70,22
1650026815463,ECE 180,A00,083140,Abi Samra; Nicholas Camill,26,0,30,4
1650026815463,ECE 180,B00,083141,Abi Samra; Nicholas Camill,10,0,30,20
1650026821491,MATH 10A,A01,083735,Patchell; Gregory David,14,0,30,16
1650026821491,MATH 10A,A02,083736,Patchell; Gregory David,28,0,30,2
1650026821491,MATH 10A,A03,083737,Patchell; Gregory David,27,0,30,3
1650026827518,MATH 10B,A01,083207,Staff,0,4,30,30
1650026827518,MATH 10B,A02,083208,Staff,0,0,30,30
1650026827518,MATH 10B,B01,083739,Staff,20,0,30,10
1650026827518,MATH 10B,B02,083740,Staff,30,0,30,0
1650026833546,MATH 18,A01,083743,Staff,10,0,30,20
1650026833546,MATH 18,A02,083744,Staff,28,0,30,2
1650026833546,MATH 18,A03,083745,Staff,23,0,30,7
1650026833546,MATH 18,A04,083746,Staff,27,0,30,3
1650026833546,MATH 18,B01,083748,Staff,0,8,30,30
1650026833546,MATH 18,B02,083749,Staff,0,6,30,30
1650026833546,MATH 18,B03,083750,Staff,0,6,30,30
1650026833546,MATH 18,B04,083751,Staff,1,7,30,29
1650026839571,MATH 20A,A01,083754,Staff,27,0,40,13
1650026845611,MATH 20B,A01,083756,Staff,0,4,30,30
1650026845611,MATH 20B,A02,083757,Staff,4,0,30,26
1650026851641,MATH 20C,A01,083760,Staff,0,9,30,30
1650026851641,MATH 20C,A02,083761,Staff,0,10,30,30
1650026851641,MATH 20C,B01,083762,Staff,17,0,30,13
1650026851641,MATH 20C,B02,083763,Staff,28,0,30,2
1650026857668,MATH 20D,A01,083765,Staff,0,2,30,30
1650026857668,MATH 20D,A02,083766,Staff,16,0,30,14
1650026857668,MATH 20D,A03,083767,Staff,28,0,30,2
1650026863694,MATH 20E,A01,083771,Staff,11,0,30,19
1650026863694,MATH 20E,A02,083772,Staff,20,0,30,10
1650026863694,MATH 20E,B01,083773,Staff,0,1,30,30
1650026863694,MATH 20E,B02,083774,Staff,20,0,30,10
1650026869729,MATH 103A,A01,083777,Staff,0,6,30,30
1650026869729,MATH 103A,A02,083778,Staff,0,7,30,30
1650026869729,MATH 103A,B01,083779,Staff,0,7,30,30
1650026869729,MATH 103A,B02,083780,Staff,0,6,30,30
1650026875757,MATH 105,A01,085443,Staff,0,11,30,30
1650026881797,MATH 109,A01,083213,Anzaldo; Leesa B,0,3,30,30
1650026881797,MATH 109,A02,083214,Anzaldo; Leesa B,0,4,30,30
1650026881797,MATH 109,B01,083215,Anzaldo; Leesa B,0,2,30,30
1650026881797,MATH 109,B02,083216,Anzaldo; Leesa B,0,2,30,30
1650026887826,MATH 142A,A01,083219,Chow; Bennett,0,7,30,30
1650026887826,MATH 142A,A02,083220,Chow; Bennett,0,7,30,30
1650026887826,MATH 142A,B01,083221,Chow; Bennett,0,8,30,30
1650026887826,MATH 142A,B02,083222,Chow; Bennett,0,7,30,30
1650026893860,MATH 193A,A01,083224,Staff,0,5,30,30
1650026893860,MATH 193A,A02,083225,Staff,0,4,30,30
1650026893860,MATH 193A,A03,083781,Staff,0,0,30,30
1650026893860,MATH 193A,A04,083782,Staff,9,0,30,21
1650026899887,MATH 197,001,091859,McAuley; Julian John,9999,0,9999,0
1650026905967,COGS 9,A01,083615,Staff,1,15,60,59
1650026911993,COGS 11,A01,083617,Boyle; Mary E. T.,25,0,40,15
1650026918030,COGS 13,A01,083071,Staff,0,28,40,40
1650026924055,COGS 14A,A01,092681,Staff,0,6,100,100
1650026930084,COGS 14B,A01,083073,Cheng; Tzu-Han,0,2,50,50
1650026936112,COGS 17,A01,092677,Staff,35,0,75,40
1650026942141,COGS 100,A01,083619,Staff,0,18,60,60
1650026948170,COGS 101A,A01,083621,Davis; Joshua Daniel,0,16,60,60
1650026954196,COGS 101B,A01,091572,Staff,16,0,60,44
1650026960229,COGS 101C,A01,083625,Delgado; Tania,21,0,30,9
1650026966255,COGS 107A,A01,083627,Boyle; Mary E. T.,0,1,60,60
1650026972282,COGS 118A,A01,083075,Staff,19,0,60,41
1650026978311,CSE 3,A50,083646,Miranda; Gregory Joseph,22,0,38,16
1650026978311,CSE 3,A51,083647,Miranda; Gregory Joseph,37,0,37,0
1650026984344,CSE 8A,A50,083650,Miranda; Gregory Joseph,0,14,40,40
1650026990374,CSE 11,A01,083080,Cao; Yingjun,0,60,40,40
1650026996402,CSE 12,A01,083652,Staff,2,0,100,98
1650027002427,CSE 15L,A01,083654,Staff,0,0,50,50
1650027002427,CSE 15L,A02,083655,Staff,15,0,50,35
1650027008457,CSE 20,A01,083657,Staff,57,0,80,23
1650027014483,CSE 30,A01,083084,Eldon; John,0,62,40,40
1650027020515,CSE 100,A01,083659,Cao; Yingjun,0,57,50,50
1650027026564,CSE 134B,A01,083661,Powell; Thomas Allan,0,25,65,65
1650027032590,CSE 140,A01,083663,Staff,8,0,75,67
1650027038616,CSE 140L,A01,083088,Eldon; John,4,0,75,71
1650027044641,CSE 175,A01,083665,Kumar; Rakesh,10,0,25,15
1650027050665,CSE 190,A00,092507,Dubnov; Shlomo,17,0,20,3
1650027056705,ECE 45,A01,083139,Staff,0,10,40,40
1650027062732,ECE 65,A50,083695,Staff,0,1,30,30
1650027068766,ECE 109,A01,091882,Touri; Behrouz,48,0,70,22
1650027074794,ECE 180,A00,083140,Abi Samra; Nicholas Camill,26,0,30,4
1650027074794,ECE 180,B00,083141,Abi Samra; Nicholas Camill,10,0,30,20
1650027080824,MATH 10A,A01,083735,Patchell; Gregory David,14,0,30,16
1650027080824,MATH 10A,A02,083736,Patchell; Gregory David,28,0,30,2
1650027080824,MATH 10A,A03,083737,Patchell; Gregory David,27,0,30,3
1650027086847,MATH 10B,A01,083207,Staff,0,4,30,30
1650027086847,MATH 10B,A02,083208,Staff,0,0,30,30
1650027086847,MATH 10B,B01,083739,Staff,20,0,30,10
1650027086847,MATH 10B,B02,083740,Staff,30,0,30,0
1650027092880,MATH 18,A01,083743,Staff,10,0,30,20
1650027092880,MATH 18,A02,083744,Staff,28,0,30,2
1650027092880,MATH 18,A03,083745,Staff,23,0,30,7
1650027092880,MATH 18,A04,083746,Staff,27,0,30,3
1650027092880,MATH 18,B01,083748,Staff,0,8,30,30
1650027092880,MATH 18,B02,083749,Staff,0,6,30,30
1650027092880,MATH 18,B03,083750,Staff,0,6,30,30
1650027092880,MATH 18,B04,083751,Staff,1,7,30,29
1650027098912,MATH 20A,A01,083754,Staff,27,0,40,13
1650027104938,MATH 20B,A01,083756,Staff,0,4,30,30
1650027104938,MATH 20B,A02,083757,Staff,4,0,30,26
1650027110964,MATH 20C,A01,083760,Staff,0,9,30,30
1650027110964,MATH 20C,A02,083761,Staff,0,10,30,30
1650027110964,MATH 20C,B01,083762,Staff,17,0,30,13
1650027110964,MATH 20C,B02,083763,Staff,28,0,30,2
1650027116998,MATH 20D,A01,083765,Staff,0,2,30,30
1650027116998,MATH 20D,A02,083766,Staff,16,0,30,14
1650027116998,MATH 20D,A03,083767,Staff,28,0,30,2
1650027123035,MATH 20E,A01,083771,Staff,11,0,30,19
1650027123035,MATH 20E,A02,083772,Staff,20,0,30,10
1650027123035,MATH 20E,B01,083773,Staff,0,1,30,30
1650027123035,MATH 20E,B02,083774,Staff,20,0,30,10
1650027129062,MATH 103A,A01,083777,Staff,0,6,30,30
1650027129062,MATH 103A,A02,083778,Staff,0,7,30,30
1650027129062,MATH 103A,B01,083779,Staff,0,7,30,30
1650027129062,MATH 103A,B02,083780,Staff,0,6,30,30
1650027135092,MATH 105,A01,085443,Staff,0,11,30,30
1650027141121,MATH 109,A01,083213,Anzaldo; Leesa B,0,3,30,30
1650027141121,MATH 109,A02,083214,Anzaldo; Leesa B,0,4,30,30
1650027141121,MATH 109,B01,083215,Anzaldo; Leesa B,0,2,30,30
1650027141121,MATH 109,B02,083216,Anzaldo; Leesa B,0,2,30,30
1650027147145,MATH 142A,A01,083219,Chow; Bennett,0,7,30,30
1650027147145,MATH 142A,A02,083220,Chow; Bennett,0,7,30,30
1650027147145,MATH 142A,B01,083221,Chow; Bennett,0,8,30,30
1650027147145,MATH 142A,B02,083222,Chow; Bennett,0,7,30,30
1650027153171,MATH 193A,A01,083224,Staff,0,5,30,30
1650027153171,MATH 193A,A02,083225,Staff,0,4,30,30
1650027153171,MATH 193A,A03,083781,Staff,0,0,30,30
1650027153171,MATH 193A,A04,083782,Staff,9,0,30,21
1650027159196,MATH 197,001,091859,McAuley; Julian John,9999,0,9999,0
1650027165270,COGS 9,A01,083615,Staff,1,15,60,59
1650027171296,COGS 11,A01,083617,Boyle; Mary E. T.,25,0,40,15
1650027177321,COGS 13,A01,083071,Staff,0,28,40,40
1650027183346,COGS 14A,A01,092681,Staff,0,6,100,100
1650027189371,COGS 14B,A01,083073,Cheng; Tzu-Han,0,2,50,50
1650027195398,COGS 17,A01,092677,Staff,35,0,75,40
1650027201422,COGS 100,A01,083619,Staff,0,18,60,60
1650027207451,COGS 101A,A01,083621,Davis; Joshua Daniel,0,16,60,60
1650027213478,COGS 101B,A01,091572,Staff,16,0,60,44
1650027219508,COGS 101C,A01,083625,Delgado; Tania,21,0,30,9
1650027225534,COGS 107A,A01,083627,Boyle; Mary E. T.,0,1,60,60
1650027231560,COGS 118A,A01,083075,Staff,19,0,60,41
1650027237592,CSE 3,A50,083646,Miranda; Gregory Joseph,22,0,38,16
1650027237592,CSE 3,A51,083647,Miranda; Gregory Joseph,37,0,37,0
1650027243617,CSE 8A,A50,083650,Miranda; Gregory Joseph,0,14,40,40
1650027249647,CSE 11,A01,083080,Cao; Yingjun,0,60,40,40
1650027255673,CSE 12,A01,083652,Staff,2,0,100,98
1650027261698,CSE 15L,A01,083654,Staff,0,0,50,50
1650027261698,CSE 15L,A02,083655,Staff,15,0,50,35
1650027267723,CSE 20,A01,083657,Staff,57,0,80,23
1650027273761,CSE 30,A01,083084,Eldon; John,0,62,40,40
1650027279789,CSE 100,A01,083659,Cao; Yingjun,0,57,50,50
1650027285818,CSE 134B,A01,083661,Powell; Thomas Allan,0,25,65,65
1650027291843,CSE 140,A01,083663,Staff,8,0,75,67
1650027297869,CSE 140L,A01,083088,Eldon; John,4,0,75,71
1650027303902,CSE 175,A01,083665,Kumar; Rakesh,10,0,25,15
1650027309931,CSE 190,A00,092507,Dubnov; Shlomo,17,0,20,3
1650027315957,ECE 45,A01,083139,Staff,0,10,40,40
1650027321986,ECE 65,A50,083695,Staff,0,1,30,30
1650027328018,ECE 109,A01,091882,Touri; Behrouz,48,0,70,22
1650027334043,ECE 180,A00,083140,Abi Samra; Nicholas Camill,26,0,30,4
1650027334043,ECE 180,B00,083141,Abi Samra; Nicholas Camill,10,0,30,20
1650027340076,MATH 10A,A01,083735,Patchell; Gregory David,14,0,30,16
1650027340076,MATH 10A,A02,083736,Patchell; Gregory David,28,0,30,2
1650027340076,MATH 10A,A03,083737,Patchell; Gregory David,27,0,30,3
1650027346107,MATH 10B,A01,083207,Staff,0,4,30,30
1650027346107,MATH 10B,A02,083208,Staff,0,0,30,30
1650027346107,MATH 10B,B01,083739,Staff,20,0,30,10
1650027346107,MATH 10B,B02,083740,Staff,30,0,30,0
1650027352135,MATH 18,A01,083743,Staff,10,0,30,20
1650027352135,MATH 18,A02,083744,Staff,28,0,30,2
1650027352135,MATH 18,A03,083745,Staff,23,0,30,7
1650027352135,MATH 18,A04,083746,Staff,27,0,30,3
1650027352135,MATH 18,B01,083748,Staff,0,8,30,30
1650027352135,MATH 18,B02,083749,Staff,0,6,30,30
1650027352135,MATH 18,B03,083750,Staff,0,6,30,30
1650027352135,MATH 18,B04,083751,Staff,1,7,30,29
1650027358165,MATH 20A,A01,083754,Staff,27,0,40,13
1650027364196,MATH 20B,A01,083756,Staff,0,4,30,30
1650027364196,MATH 20B,A02,083757,Staff,4,0,30,26
1650027370222,MATH 20C,A01,083760,Staff,0,9,30,30
1650027370222,MATH 20C,A02,083761,Staff,0,10,30,30
1650027370222,MATH 20C,B01,083762,Staff,17,0,30,13
1650027370222,MATH 20C,B02,083763,Staff,28,0,30,2
1650027376250,MATH 20D,A01,083765,Staff,0,2,30,30
1650027376250,MATH 20D,A02,083766,Staff,16,0,30,14
1650027376250,MATH 20D,A03,083767,Staff,28,0,30,2
1650027382280,MATH 20E,A01,083771,Staff,11,0,30,19
1650027382280,MATH 20E,A02,083772,Staff,20,0,30,10
1650027382280,MATH 20E,B01,083773,Staff,0,1,30,30
1650027382280,MATH 20E,B02,083774,Staff,20,0,30,10
1650027388311,MATH 103A,A01,083777,Staff,0,6,30,30
1650027388311,MATH 103A,A02,083778,Staff,0,7,30,30
1650027388311,MATH 103A,B01,083779,Staff,0,7,30,30
1650027388311,MATH 103A,B02,083780,Staff,0,6,30,30
1650027394436,MATH 105,A01,085443,Staff,0,11,30,30
1650027400462,MATH 109,A01,083213,Anzaldo; Leesa B,0,3,30,30
1650027400462,MATH 109,A02,083214,Anzaldo; Leesa B,0,4,30,30
1650027400462,MATH 109,B01,083215,Anzaldo; Leesa B,0,2,30,30
1650027400462,MATH 109,B02,083216,Anzaldo; Leesa B,0,2,30,30
1650027406492,MATH 142A,A01,083219,Chow; Bennett,0,7,30,30
1650027406492,MATH 142A,A02,083220,Chow; Bennett,0,7,30,30
1650027406492,MATH 142A,B01,083221,Chow; Bennett,0,8,30,30
1650027406492,MATH 142A,B02,083222,Chow; Bennett,0,7,30,30
1650027412527,MATH 193A,A01,083224,Staff,0,5,30,30
1650027412527,MATH 193A,A02,083225,Staff,0,4,30,30
1650027412527,MATH 193A,A03,083781,Staff,0,0,30,30
1650027412527,MATH 193A,A04,083782,Staff,9,0,30,21
1650027418554,MATH 197,001,091859,McAuley; Julian John,9999,0,9999,0
1650027424612,COGS 9,A01,083615,Staff,1,15,60,59
1650027430640,COGS 11,A01,083617,Boyle; Mary E. T.,25,0,40,15
1650027436666,COGS 13,A01,083071,Staff,0,28,40,40
1650027442692,COGS 14A,A01,092681,Staff,0,6,100,100
1650027448722,COGS 14B,A01,083073,Cheng; Tzu-Han,0,2,50,50
1650027454746,COGS 17,A01,092677,Staff,35,0,75,40
1650027460768,COGS 100,A01,083619,Staff,0,18,60,60
1650027466809,COGS 101A,A01,083621,Davis; Joshua Daniel,0,16,60,60
1650027472844,COGS 101B,A01,091572,Staff,16,0,60,44
1650027478873,COGS 101C,A01,083625,Delgado; Tania,21,0,30,9
1650027484897,COGS 107A,A01,083627,Boyle; Mary E. T.,0,1,60,60
1650027490924,COGS 118A,A01,083075,Staff,19,0,60,41
1650027496967,CSE 3,A50,083646,Miranda; Gregory Joseph,22,0,38,16
1650027496967,CSE 3,A51,083647,Miranda; Gregory Joseph,37,0,37,0
1650027503006,CSE 8A,A50,083650,Miranda; Gregory Joseph,0,14,40,40
1650027509037,CSE 11,A01,083080,Cao; Yingjun,0,60,40,40
1650027515063,CSE 12,A01,083652,Staff,2,0,100,98
1650027521091,CSE 15L,A01,083654,Staff,0,0,50,50
1650027521091,CSE 15L,A02,083655,Staff,15,0,50,35
1650027527117,CSE 20,A01,083657,Staff,57,0,80,23
1650027533142,CSE 30,A01,083084,Eldon; John,0,62,40,40
1650027539173,CSE 100,A01,083659,Cao; Yingjun,0,57,50,50
1650027545205,CSE 134B,A01,083661,Powell; Thomas Allan,0,25,65,65
1650027551228,CSE 140,A01,083663,Staff,8,0,75,67
1650027557251,CSE 140L,A01,083088,Eldon; John,4,0,75,71
1650027563279,CSE 175,A01,083665,Kumar; Rakesh,10,0,25,15
1650027569303,CSE 190,A00,092507,Dubnov; Shlomo,17,0,20,3
1650027575330,ECE 45,A01,083139,Staff,0,10,40,40
1650027581355,ECE 65,A50,083695,Staff,0,1,30,30
1650027587383,ECE 109,A01,091882,Touri; Behrouz,48,0,70,22
1650027593409,ECE 180,A00,083140,Abi Samra; Nicholas Camill,26,0,30,4
1650027593409,ECE 180,B00,083141,Abi Samra; Nicholas Camill,10,0,30,20
1650027599435,MATH 10A,A01,083735,Patchell; Gregory David,14,0,30,16
1650027599435,MATH 10A,A02,083736,Patchell; Gregory David,28,0,30,2
1650027599435,MATH 10A,A03,083737,Patchell; Gregory David,27,0,30,3
1650027605466,MATH 10B,A01,083207,Staff,0,4,30,30
1650027605466,MATH 10B,A02,083208,Staff,0,0,30,30
1650027605466,MATH 10B,B01,083739,Staff,20,0,30,10
1650027605466,MATH 10B,B02,083740,Staff,30,0,30,0
1650027611506,MATH 18,A01,083743,Staff,10,0,30,20
1650027611506,MATH 18,A02,083744,Staff,28,0,30,2
1650027611506,MATH 18,A03,083745,Staff,23,0,30,7
1650027611506,MATH 18,A04,083746,Staff,27,0,30,3
1650027611506,MATH 18,B01,083748,Staff,0,8,30,30
1650027611506,MATH 18,B02,083749,Staff,0,6,30,30
1650027611506,MATH 18,B03,083750,Staff,0,6,30,30
1650027611506,MATH 18,B04,083751,Staff,1,7,30,29
1650027617533,MATH 20A,A01,083754,Staff,27,0,40,13
1650027623560,MATH 20B,A01,083756,Staff,0,4,30,30
1650027623560,MATH 20B,A02,083757,Staff,4,0,30,26
1650027629593,MATH 20C,A01,083760,Staff,0,9,30,30
1650027629593,MATH 20C,A02,083761,Staff,0,10,30,30
1650027629593,MATH 20C,B01,083762,Staff,17,0,30,13
1650027629593,MATH 20C,B02,083763,Staff,28,0,30,2
1650027635621,MATH 20D,A01,083765,Staff,0,2,30,30
1650027635621,MATH 20D,A02,083766,Staff,16,0,30,14
1650027635621,MATH 20D,A03,083767,Staff,28,0,30,2
1650027641654,MATH 20E,A01,083771,Staff,11,0,30,19
1650027641654,MATH 20E,A02,083772,Staff,20,0,30,10
1650027641654,MATH 20E,B01,083773,Staff,0,1,30,30
1650027641654,MATH 20E,B02,083774,Staff,20,0,30,10
1650027647683,MATH 103A,A01,083777,Staff,0,6,30,30
1650027647683,MATH 103A,A02,083778,Staff,0,7,30,30
1650027647683,MATH 103A,B01,083779,Staff,0,7,30,30
1650027647683,MATH 103A,B02,083780,Staff,0,6,30,30
1650027653709,MATH 105,A01,085443,Staff,0,11,30,30
1650027659734,MATH 109,A01,083213,Anzaldo; Leesa B,0,3,30,30
1650027659734,MATH 109,A02,083214,Anzaldo; Leesa B,0,4,30,30
1650027659734,MATH 109,B01,083215,Anzaldo; Leesa B,0,2,30,30
1650027659734,MATH 109,B02,083216,Anzaldo; Leesa B,0,2,30,30
1650027665761,MATH 142A,A01,083219,Chow; Bennett,0,7,30,30
1650027665761,MATH 142A,A02,083220,Chow; Bennett,0,7,30,30
1650027665761,MATH 142A,B01,083221,Chow; Bennett,0,8,30,30
1650027665761,MATH 142A,B02,083222,Chow; Bennett,0,7,30,30
1650027671786,MATH 193A,A01,083224,Staff,0,5,30,30
1650027671786,MATH 193A,A02,083225,Staff,0,4,30,30
1650027671786,MATH 193A,A03,083781,Staff,0,0,30,30
1650027671786,MATH 193A,A04,083782,Staff,9,0,30,21
1650027677815,MATH 197,001,091859,McAuley; Julian John,9999,0,9999,0
1650027683900,COGS 9,A01,083615,Staff,1,15,60,59
1650027689937,COGS 11,A01,083617,Boyle; Mary E. T.,25,0,40,15
1650027695974,COGS 13,A01,083071,Staff,0,28,40,40
1650027702000,COGS 14A,A01,092681,Staff,0,6,100,100
1650027708033,COGS 14B,A01,083073,Cheng; Tzu-Han,0,2,50,50
1650027714057,COGS 17,A01,092677,Staff,35,0,75,40
1650027720089,COGS 100,A01,083619,Staff,0,18,60,60
1650027726126,COGS 101A,A01,083621,Davis; Joshua Daniel,0,16,60,60
1650027732167,COGS 101B,A01,091572,Staff,16,0,60,44
1650027738193,COGS 101C,A01,083625,Delgado; Tania,21,0,30,9
1650027744221,COGS 107A,A01,083627,Boyle; Mary E. T.,0,1,60,60
1650027750247,COGS 118A,A01,083075,Staff,19,0,60,41
1650027756280,CSE 3,A50,083646,Miranda; Gregory Joseph,22,0,38,16
1650027756280,CSE 3,A51,083647,Miranda; Gregory Joseph,37,0,37,0
1650027762317,CSE 8A,A50,083650,Miranda; Gregory Joseph,0,14,40,40
1650027768352,CSE 11,A01,083080,Cao; Yingjun,0,60,40,40
1650027774377,CSE 12,A01,083652,Staff,2,0,100,98
1650027780406,CSE 15L,A01,083654,Staff,0,0,50,50
1650027780406,CSE 15L,A02,083655,Staff,15,0,50,35
1650027786432,CSE 20,A01,083657,Staff,57,0,80,23
1650027792457,CSE 30,A01,083084,Eldon; John,0,62,40,40
1650027798484,CSE 100,A01,083659,Cao; Yingjun,0,57,50,50
1650027804513,CSE 134B,A01,083661,Powell; Thomas Allan,0,25,65,65
1650027810538,CSE 140,A01,083663,Staff,8,0,75,67
1650027816577,CSE 140L,A01,083088,Eldon; John,4,0,75,71
1650027822605,CSE 175,A01,083665,Kumar; Rakesh,10,0,25,15
1650027828630,CSE 190,A00,092507,Dubnov; Shlomo,17,0,20,3
1650027834658,ECE 45,A01,083139,Staff,0,10,40,40
1650027840685,ECE 65,A50,083695,Staff,0,1,30,30
1650027846718,ECE 109,A01,091882,Touri; Behrouz,48,0,70,22
1650027852748,ECE 180,A00,083140,Abi Samra; Nicholas Camill,26,0,30,4
1650027852748,ECE 180,B00,083141,Abi Samra; Nicholas Camill,10,0,30,20
1650027858774,MATH 10A,A01,083735,Patchell; Gregory David,14,0,30,16
1650027858774,MATH 10A,A02,083736,Patchell; Gregory David,28,0,30,2
1650027858774,MATH 10A,A03,083737,Patchell; Gregory David,27,0,30,3
1650027864800,MATH 10B,A01,083207,Staff,0,4,30,30
1650027864800,MATH 10B,A02,083208,Staff,0,0,30,30
1650027864800,MATH 10B,B01,083739,Staff,20,0,30,10
1650027864800,MATH 10B,B02,083740,Staff,30,0,30,0
1650027870827,MATH 18,A01,083743,Staff,10,0,30,20
1650027870827,MATH 18,A02,083744,Staff,28,0,30,2
1650027870827,MATH 18,A03,083745,Staff,23,0,30,7
1650027870827,MATH 18,A04,083746,Staff,27,0,30,3
1650027870827,MATH 18,B01,083748,Staff,0,8,30,30
1650027870827,MATH 18,B02,083749,Staff,0,6,30,30
1650027870827,MATH 18,B03,083750,Staff,0,6,30,30
1650027870827,MATH 18,B04,083751,Staff,1,7,30,29
1650027876855,MATH 20A,A01,083754,Staff,27,0,40,13
1650027882881,MATH 20B,A01,083756,Staff,0,4,30,30
1650027882881,MATH 20B,A02,083757,Staff,4,0,30,26
1650027888906,MATH 20C,A01,083760,Staff,0,9,30,30
1650027888906,MATH 20C,A02,083761,Staff,0,10,30,30
1650027888906,MATH 20C,B01,083762,Staff,17,0,30,13
1650027888906,MATH 20C,B02,083763,Staff,28,0,30,2
1650027894931,MATH 20D,A01,083765,Staff,0,2,30,30
1650027894931,MATH 20D,A02,083766,Staff,16,0,30,14
1650027894931,MATH 20D,A03,083767,Staff,28,0,30,2
1650027900967,MATH 20E,A01,083771,Staff,11,0,30,19
1650027900967,MATH 20E,A02,083772,Staff,20,0,30,10
1650027900967,MATH 20E,B01,083773,Staff,0,1,30,30
1650027900967,MATH 20E,B02,083774,Staff,20,0,30,10
1650027906993,MATH 103A,A01,083777,Staff,0,6,30,30
1650027906993,MATH 103A,A02,083778,Staff,0,7,30,30
1650027906993,MATH 103A,B01,083779,Staff,0,7,30,30
1650027906993,MATH 103A,B02,083780,Staff,0,6,30,30
1650027913017,MATH 105,A01,085443,Staff,0,11,30,30
1650027919043,MATH 109,A01,083213,Anzaldo; Leesa B,0,3,30,30
1650027919043,MATH 109,A02,083214,Anzaldo; Leesa B,0,4,30,30
1650027919043,MATH 109,B01,083215,Anzaldo; Leesa B,0,2,30,30
1650027919043,MATH 109,B02,083216,Anzaldo; Leesa B,0,2,30,30
1650027925077,MATH 142A,A01,083219,Chow; Bennett,0,7,30,30
1650027925077,MATH 142A,A02,083220,Chow; Bennett,0,7,30,30
1650027925077,MATH 142A,B01,083221,Chow; Bennett,0,8,30,30
1650027925077,MATH 142A,B02,083222,Chow; Bennett,0,7,30,30
1650027931107,MATH 193A,A01,083224,Staff,0,5,30,30
1650027931107,MATH 193A,A02,083225,Staff,0,4,30,30
1650027931107,MATH 193A,A03,083781,Staff,0,0,30,30
1650027931107,MATH 193A,A04,083782,Staff,9,0,30,21
1650027937134,MATH 197,001,091859,McAuley; Julian John,9999,0,9999,0
1650027943190,COGS 9,A01,083615,Staff,1,15,60,59
1650027949216,COGS 11,A01,083617,Boyle; Mary E. T.,25,0,40,15
1650027955240,COGS 13,A01,083071,Staff,0,28,40,40
1650027961265,COGS 14A,A01,092681,Staff,0,6,100,100
1650027967295,COGS 14B,A01,083073,Cheng; Tzu-Han,0,2,50,50
1650027973324,COGS 17,A01,092677,Staff,35,0,75,40
1650027979350,COGS 100,A01,083619,Staff,0,18,60,60
1650027985480,COGS 101A,A01,083621,Davis; Joshua Daniel,0,16,60,60
1650027991509,COGS 101B,A01,091572,Staff,16,0,60,44
1650027997536,COGS 101C,A01,083625,Delgado; Tania,21,0,30,9
1650028003568,COGS 107A,A01,083627,Boyle; Mary E. T.,0,1,60,60
1650028009596,COGS 118A,A01,083075,Staff,19,0,60,41
1650028015627,CSE 3,A50,083646,Miranda; Gregory Joseph,22,0,38,16
1650028015627,CSE 3,A51,083647,Miranda; Gregory Joseph,37,0,37,0
1650028021651,CSE 8A,A50,083650,Miranda; Gregory Joseph,0,14,40,40
1650028027676,CSE 11,A01,083080,Cao; Yingjun,0,60,40,40
1650028033700,CSE 12,A01,083652,Staff,2,0,100,98
1650028039724,CSE 15L,A01,083654,Staff,0,0,50,50
1650028039724,CSE 15L,A02,083655,Staff,15,0,50,35
1650028045749,CSE 20,A01,083657,Staff,57,0,80,23
1650028051774,CSE 30,A01,083084,Eldon; John,0,62,40,40
1650028057800,CSE 100,A01,083659,Cao; Yingjun,0,57,50,50
1650028063832,CSE 134B,A01,083661,Powell; Thomas Allan,0,25,65,65
1650028069869,CSE 140,A01,083663,Staff,8,0,75,67
1650028075911,CSE 140L,A01,083088,Eldon; John,4,0,75,71
1650028081938,CSE 175,A01,083665,Kumar; Rakesh,10,0,25,15
1650028087963,CSE 190,A00,092507,Dubnov; Shlomo,17,0,20,3
1650028093994,ECE 45,A01,083139,Staff,0,10,40,40
1650028100028,ECE 65,A50,083695,Staff,0,1,30,30
1650028106056,ECE 109,A01,091882,Touri; Behrouz,48,0,70,22
1650028112094,ECE 180,A00,083140,Abi Samra; Nicholas Camill,26,0,30,4
1650028112094,ECE 180,B00,083141,Abi Samra; Nicholas Camill,10,0,30,20
1650028118121,MATH 10A,A01,083735,Patchell; Gregory David,14,0,30,16
1650028118121,MATH 10A,A02,083736,Patchell; Gregory David,28,0,30,2
1650028118121,MATH 10A,A03,083737,Patchell; Gregory David,27,0,30,3
1650028124152,MATH 10B,A01,083207,Staff,0,4,30,30
1650028124152,MATH 10B,A02,083208,Staff,0,0,30,30
1650028124152,MATH 10B,B01,083739,Staff,20,0,30,10
1650028124152,MATH 10B,B02,083740,Staff,30,0,30,0
1650028130178,MATH 18,A01,083743,Staff,10,0,30,20
1650028130178,MATH 18,A02,083744,Staff,28,0,30,2
1650028130178,MATH 18,A03,083745,Staff,23,0,30,7
1650028130178,MATH 18,A04,083746,Staff,27,0,30,3
1650028130178,MATH 18,B01,083748,Staff,0,8,30,30
1650028130178,MATH 18,B02,083749,Staff,0,6,30,30
1650028130178,MATH 18,B03,083750,Staff,0,6,30,30
1650028130178,MATH 18,B04,083751,Staff,1,7,30,29
1650028136211,MATH 20A,A01,083754,Staff,27,0,40,13
1650028142238,MATH 20B,A01,083756,Staff,0,4,30,30
1650028142238,MATH 20B,A02,083757,Staff,4,0,30,26
1650028148274,MATH 20C,A01,083760,Staff,0,9,30,30
1650028148274,MATH 20C,A02,083761,Staff,0,10,30,30
1650028148274,MATH 20C,B01,083762,Staff,17,0,30,13
1650028148274,MATH 20C,B02,083763,Staff,28,0,30,2
1650028154301,MATH 20D,A01,083765,Staff,0,2,30,30
1650028154301,MATH 20D,A02,083766,Staff,16,0,30,14
1650028154301,MATH 20D,A03,083767,Staff,28,0,30,2
1650028160331,MATH 20E,A01,083771,Staff,11,0,30,19
1650028160331,MATH 20E,A02,083772,Staff,20,0,30,10
1650028160331,MATH 20E,B01,083773,Staff,0,1,30,30
1650028160331,MATH 20E,B02,083774,Staff,20,0,30,10
1650028166357,MATH 103A,A01,083777,Staff,0,6,30,30
1650028166357,MATH 103A,A02,083778,Staff,0,7,30,30
1650028166357,MATH 103A,B01,083779,Staff,0,7,30,30
1650028166357,MATH 103A,B02,083780,Staff,0,6,30,30
1650028172386,MATH 105,A01,085443,Staff,0,11,30,30
1650028178432,MATH 109,A01,083213,Anzaldo; Leesa B,0,3,30,30
1650028178432,MATH 109,A02,083214,Anzaldo; Leesa B,0,4,30,30
1650028178432,MATH 109,B01,083215,Anzaldo; Leesa B,0,2,30,30
1650028178432,MATH 109,B02,083216,Anzaldo; Leesa B,0,2,30,30
1650028184463,MATH 142A,A01,083219,Chow; Bennett,0,7,30,30
1650028184463,MATH 142A,A02,083220,Chow; Bennett,0,7,30,30
1650028184463,MATH 142A,B01,083221,Chow; Bennett,0,8,30,30
1650028184463,MATH 142A,B02,083222,Chow; Bennett,0,7,30,30
1650028190497,MATH 193A,A01,083224,Staff,0,5,30,30
1650028190497,MATH 193A,A02,083225,Staff,0,4,30,30
1650028190497,MATH 193A,A03,083781,Staff,0,0,30,30
1650028190497,MATH 193A,A04,083782,Staff,9,0,30,21
1650028196533,MATH 197,001,091859,McAuley; Julian John,9999,0,9999,0
1650028202614,COGS 9,A01,083615,Staff,1,15,60,59
1650028208639,COGS 11,A01,083617,Boyle; Mary E. T.,25,0,40,15
1650028214683,COGS 13,A01,083071,Staff,0,28,40,40
1650028220708,COGS 14A,A01,092681,Staff,0,6,100,100
1650028226738,COGS 14B,A01,083073,Cheng; Tzu-Han,0,2,50,50
1650028232771,COGS 17,A01,092677,Staff,35,0,75,40
1650028238806,COGS 100,A01,083619,Staff,0,18,60,60
1650028244828,COGS 101A,A01,083621,Davis; Joshua Daniel,0,16,60,60
1650028250865,COGS 101B,A01,091572,Staff,16,0,60,44
1650028256893,COGS 101C,A01,083625,Delgado; Tania,21,0,30,9
1650028262919,COGS 107A,A01,083627,Boyle; Mary E. T.,0,1,60,60
1650028268947,COGS 118A,A01,083075,Staff,19,0,60,41
1650028274977,CSE 3,A50,083646,Miranda; Gregory Joseph,22,0,38,16
1650028274977,CSE 3,A51,083647,Miranda; Gregory Joseph,37,0,37,0
1650028281006,CSE 8A,A50,083650,Miranda; Gregory Joseph,0,14,40,40
1650028287031,CSE 11,A01,083080,Cao; Yingjun,0,60,40,40
1650028293059,CSE 12,A01,083652,Staff,2,0,100,98
1650028299088,CSE 15L,A01,083654,Staff,0,0,50,50
1650028299088,CSE 15L,A02,083655,Staff,15,0,50,35
1650028305113,CSE 20,A01,083657,Staff,57,0,80,23
1650028311137,CSE 30,A01,083084,Eldon; John,0,62,40,40
1650028317163,CSE 100,A01,083659,Cao; Yingjun,0,57,50,50
1650028323190,CSE 134B,A01,083661,Powell; Thomas Allan,0,25,65,65
1650028329215,CSE 140,A01,083663,Staff,8,0,75,67
1650028335240,CSE 140L,A01,083088,Eldon; John,4,0,75,71
1650028341269,CSE 175,A01,083665,Kumar; Rakesh,10,0,25,15
1650028347317,CSE 190,A00,092507,Dubnov; Shlomo,17,0,20,3
1650028353351,ECE 45,A01,083139,Staff,0,10,40,40
1650028359382,ECE 65,A50,083695,Staff,0,1,30,30
1650028365410,ECE 109,A01,091882,Touri; Behrouz,48,0,70,22
1650028371441,ECE 180,A00,083140,Abi Samra; Nicholas Camill,26,0,30,4
1650028371441,ECE 180,B00,083141,Abi Samra; Nicholas Camill,10,0,30,20
1650028377475,MATH 10A,A01,083735,Patchell; Gregory David,14,0,30,16
1650028377475,MATH 10A,A02,083736,Patchell; Gregory David,28,0,30,2
1650028377475,MATH 10A,A03,083737,Patchell; Gregory David,27,0,30,3
1650028383501,MATH 10B,A01,083207,Staff,0,4,30,30
1650028383501,MATH 10B,A02,083208,Staff,0,0,30,30
1650028383501,MATH 10B,B01,083739,Staff,20,0,30,10
1650028383501,MATH 10B,B02,083740,Staff,30,0,30,0
1650028389532,MATH 18,A01,083743,Staff,10,0,30,20
1650028389532,MATH 18,A02,083744,Staff,28,0,30,2
1650028389532,MATH 18,A03,083745,Staff,23,0,30,7
1650028389532,MATH 18,A04,083746,Staff,27,0,30,3
1650028389532,MATH 18,B01,083748,Staff,0,8,30,30
1650028389532,MATH 18,B02,083749,Staff,0,6,30,30
1650028389532,MATH 18,B03,083750,Staff,0,6,30,30
1650028389532,MATH 18,B04,083751,Staff,1,7,30,29
1650028395559,MATH 20A,A01,083754,Staff,27,0,40,13
1650028401582,MATH 20B,A01,083756,Staff,0,4,30,30
1650028401582,MATH 20B,A02,083757,Staff,4,0,30,26
1650028407618,MATH 20C,A01,083760,Staff,0,9,30,30
1650028407618,MATH 20C,A02,083761,Staff,0,10,30,30
1650028407618,MATH 20C,B01,083762,Staff,17,0,30,13
1650028407618,MATH 20C,B02,083763,Staff,28,0,30,2
1650028413652,MATH 20D,A01,083765,Staff,0,2,30,30
1650028413652,MATH 20D,A02,083766,Staff,16,0,30,14
1650028413652,MATH 20D,A03,083767,Staff,28,0,30,2
1650028419676,MATH 20E,A01,083771,Staff,11,0,30,19
1650028419676,MATH 20E,A02,083772,Staff,20,0,30,10
1650028419676,MATH 20E,B01,083773,Staff,0,1,30,30
1650028419676,MATH 20E,B02,083774,Staff,20,0,30,10
1650028425702,MATH 103A,A01,083777,Staff,0,6,30,30
1650028425702,MATH 103A,A02,083778,Staff,0,7,30,30
1650028425702,MATH 103A,B01,083779,Staff,0,7,30,30
1650028425702,MATH 103A,B02,083780,Staff,0,6,30,30
1650028431732,MATH 105,A01,085443,Staff,0,11,30,30
1650028437758,MATH 109,A01,083213,Anzaldo; Leesa B,0,3,30,30
1650028437758,MATH 109,A02,083214,Anzaldo; Leesa B,0,4,30,30
1650028437758,MATH 109,B01,083215,Anzaldo; Leesa B,0,2,30,30
1650028437758,MATH 109,B02,083216,Anzaldo; Leesa B,0,2,30,30
1650028443789,MATH 142A,A01,083219,Chow; Bennett,0,7,30,30
1650028443789,MATH 142A,A02,083220,Chow; Bennett,0,7,30,30
1650028443789,MATH 142A,B01,083221,Chow; Bennett,0,8,30,30
1650028443789,MATH 142A,B02,083222,Chow; Bennett,0,7,30,30
1650028449817,MATH 193A,A01,083224,Staff,0,5,30,30
1650028449817,MATH 193A,A02,083225,Staff,0,4,30,30
1650028449817,MATH 193A,A03,083781,Staff,0,0,30,30
1650028449817,MATH 193A,A04,083782,Staff,9,0,30,21
1650028455844,MATH 197,001,091859,McAuley; Julian John,9999,0,9999,0
1650028461907,COGS 9,A01,083615,Staff,1,15,60,59
1650028467931,COGS 11,A01,083617,Boyle; Mary E. T.,25,0,40,15
1650028473958,COGS 13,A01,083071,Staff,0,28,40,40
1650028479986,COGS 14A,A01,092681,Staff,0,6,100,100
1650028486016,COGS 14B,A01,083073,Cheng; Tzu-Han,0,2,50,50
1650028492039,COGS 17,A01,092677,Staff,35,0,75,40
1650028498063,COGS 100,A01,083619,Staff,0,18,60,60
1650028504088,COGS 101A,A01,083621,Davis; Joshua Daniel,0,16,60,60
1650028510115,COGS 101B,A01,091572,Staff,16,0,60,44
1650028516153,COGS 101C,A01,083625,Delgado; Tania,21,0,30,9
1650028522178,COGS 107A,A01,083627,Boyle; Mary E. T.,0,1,60,60
1650028528204,COGS 118A,A01,083075,Staff,19,0,60,41
1650028534229,CSE 3,A50,083646,Miranda; Gregory Joseph,22,0,38,16
1650028534229,CSE 3,A51,083647,Miranda; Gregory Joseph,37,0,37,0
1650028540252,CSE 8A,A50,083650,Miranda; Gregory Joseph,0,14,40,40
1650028546280,CSE 11,A01,083080,Cao; Yingjun,0,60,40,40
1650028552319,CSE 12,A01,083652,Staff,2,0,100,98
1650028558342,CSE 15L,A01,083654,Staff,0,0,50,50
1650028558342,CSE 15L,A02,083655,Staff,15,0,50,35
1650028564369,CSE 20,A01,083657,Staff,57,0,80,23
1650028570416,CSE 30,A01,083084,Eldon; John,0,62,40,40
1650028576439,CSE 100,A01,083659,Cao; Yingjun,0,57,50,50
1650028582536,CSE 134B,A01,083661,Powell; Thomas Allan,0,25,65,65
1650028588560,CSE 140,A01,083663,Staff,8,0,75,67
1650028594595,CSE 140L,A01,083088,Eldon; John,4,0,75,71
1650028600627,CSE 175,A01,083665,Kumar; Rakesh,10,0,25,15
1650028606652,CSE 190,A00,092507,Dubnov; Shlomo,17,0,20,3
1650028612680,ECE 45,A01,083139,Staff,0,10,40,40
1650028618706,ECE 65,A50,083695,Staff,0,1,30,30
1650028624730,ECE 109,A01,091882,Touri; Behrouz,48,0,70,22
1650028630754,ECE 180,A00,083140,Abi Samra; Nicholas Camill,26,0,30,4
1650028630754,ECE 180,B00,083141,Abi Samra; Nicholas Camill,10,0,30,20
1650028636791,MATH 10A,A01,083735,Patchell; Gregory David,14,0,30,16
1650028636791,MATH 10A,A02,083736,Patchell; Gregory David,28,0,30,2
1650028636791,MATH 10A,A03,083737,Patchell; Gregory David,27,0,30,3
1650028642816,MATH 10B,A01,083207,Staff,0,4,30,30
1650028642816,MATH 10B,A02,083208,Staff,0,0,30,30
1650028642816,MATH 10B,B01,083739,Staff,20,0,30,10
1650028642816,MATH 10B,B02,083740,Staff,30,0,30,0
1650028648849,MATH 18,A01,083743,Staff,10,0,30,20
1650028648849,MATH 18,A02,083744,Staff,28,0,30,2
1650028648849,MATH 18,A03,083745,Staff,23,0,30,7
1650028648849,MATH 18,A04,083746,Staff,27,0,30,3
1650028648849,MATH 18,B01,083748,Staff,0,8,30,30
1650028648849,MATH 18,B02,083749,Staff,0,6,30,30
1650028648849,MATH 18,B03,083750,Staff,0,6,30,30
1650028648849,MATH 18,B04,083751,Staff,1,7,30,29
1650028654874,MATH 20A,A01,083754,Staff,27,0,40,13
1650028660904,MATH 20B,A01,083756,Staff,0,4,30,30
1650028660904,MATH 20B,A02,083757,Staff,4,0,30,26
1650028666931,MATH 20C,A01,083760,Staff,0,9,30,30
1650028666931,MATH 20C,A02,083761,Staff,0,10,30,30
1650028666931,MATH 20C,B01,083762,Staff,17,0,30,13
1650028666931,MATH 20C,B02,083763,Staff,28,0,30,2
1650028672958,MATH 20D,A01,083765,Staff,0,2,30,30
1650028672958,MATH 20D,A02,083766,Staff,16,0,30,14
1650028672958,MATH 20D,A03,083767,Staff,28,0,30,2
1650028678989,MATH 20E,A01,083771,Staff,11,0,30,19
1650028678989,MATH 20E,A02,083772,Staff,20,0,30,10
1650028678989,MATH 20E,B01,083773,Staff,0,1,30,30
1650028678989,MATH 20E,B02,083774,Staff,19,0,30,11
1650028685017,MATH 103A,A01,083777,Staff,0,6,30,30
1650028685017,MATH 103A,A02,083778,Staff,0,7,30,30
1650028685017,MATH 103A,B01,083779,Staff,0,7,30,30
1650028685017,MATH 103A,B02,083780,Staff,0,6,30,30
1650028691045,MATH 105,A01,085443,Staff,0,11,30,30
1650028697082,MATH 109,A01,083213,Anzaldo; Leesa B,0,3,30,30
1650028697082,MATH 109,A02,083214,Anzaldo; Leesa B,0,4,30,30
1650028697082,MATH 109,B01,083215,Anzaldo; Leesa B,0,2,30,30
1650028697082,MATH 109,B02,083216,Anzaldo; Leesa B,0,2,30,30
1650028703112,MATH 142A,A01,083219,Chow; Bennett,0,7,30,30
1650028703112,MATH 142A,A02,083220,Chow; Bennett,0,7,30,30
1650028703112,MATH 142A,B01,083221,Chow; Bennett,0,8,30,30
1650028703112,MATH 142A,B02,083222,Chow; Bennett,0,7,30,30
1650028709139,MATH 193A,A01,083224,Staff,0,5,30,30
1650028709139,MATH 193A,A02,083225,Staff,0,4,30,30
1650028709139,MATH 193A,A03,083781,Staff,0,0,30,30
1650028709139,MATH 193A,A04,083782,Staff,9,0,30,21
1650028715162,MATH 197,001,091859,McAuley; Julian John,9999,0,9999,0
1650028721238,COGS 9,A01,083615,Staff,1,15,60,59
1650028727266,COGS 11,A01,083617,Boyle; Mary E. T.,25,0,40,15
1650028733289,COGS 13,A01,083071,Staff,0,28,40,40
1650028739313,COGS 14A,A01,092681,Staff,0,6,100,100
1650028745335,COGS 14B,A01,083073,Cheng; Tzu-Han,0,2,50,50
1650028751371,COGS 17,A01,092677,Staff,35,0,75,40
1650028757395,COGS 100,A01,083619,Staff,0,18,60,60
1650028763424,COGS 101A,A01,083621,Davis; Joshua Daniel,0,16,60,60
1650028769452,COGS 101B,A01,091572,Staff,16,0,60,44
1650028775482,COGS 101C,A01,083625,Delgado; Tania,21,0,30,9
1650028781507,COGS 107A,A01,083627,Boyle; Mary E. T.,0,1,60,60
1650028787531,COGS 118A,A01,083075,Staff,19,0,60,41
1650028793558,CSE 3,A50,083646,Miranda; Gregory Joseph,22,0,38,16
1650028793558,CSE 3,A51,083647,Miranda; Gregory Joseph,37,0,37,0
1650028799586,CSE 8A,A50,083650,Miranda; Gregory Joseph,0,14,40,40
1650028805619,CSE 11,A01,083080,Cao; Yingjun,0,60,40,40
1650028811647,CSE 12,A01,083652,Staff,2,0,100,98
1650028817674,CSE 15L,A01,083654,Staff,0,0,50,50
1650028817674,CSE 15L,A02,083655,Staff,15,0,50,35
1650028823704,CSE 20,A01,083657,Staff,57,0,80,23
1650028829729,CSE 30,A01,083084,Eldon; John,0,62,40,40
1650028835754,CSE 100,A01,083659,Cao; Yingjun,0,57,50,50
1650028841783,CSE 134B,A01,083661,Powell; Thomas Allan,0,25,65,65
1650028847810,CSE 140,A01,083663,Staff,8,0,75,67
1650028853845,CSE 140L,A01,083088,Eldon; John,4,0,75,71
1650028859869,CSE 175,A01,083665,Kumar; Rakesh,10,0,25,15
1650028865894,CSE 190,A00,092507,Dubnov; Shlomo,17,0,20,3
1650028871920,ECE 45,A01,083139,Staff,0,10,40,40
1650028877952,ECE 65,A50,083695,Staff,0,1,30,30
1650028883976,ECE 109,A01,091882,Touri; Behrouz,48,0,70,22
1650028890002,ECE 180,A00,083140,Abi Samra; Nicholas Camill,26,0,30,4
1650028890002,ECE 180,B00,083141,Abi Samra; Nicholas Camill,10,0,30,20
1650028896031,MATH 10A,A01,083735,Patchell; Gregory David,14,0,30,16
1650028896031,MATH 10A,A02,083736,Patchell; Gregory David,28,0,30,2
1650028896031,MATH 10A,A03,083737,Patchell; Gregory David,27,0,30,3
1650028902056,MATH 10B,A01,083207,Staff,0,4,30,30
1650028902056,MATH 10B,A02,083208,Staff,0,0,30,30
1650028902056,MATH 10B,B01,083739,Staff,20,0,30,10
1650028902056,MATH 10B,B02,083740,Staff,30,0,30,0
1650028908084,MATH 18,A01,083743,Staff,10,0,30,20
1650028908084,MATH 18,A02,083744,Staff,28,0,30,2
1650028908084,MATH 18,A03,083745,Staff,23,0,30,7
1650028908084,MATH 18,A04,083746,Staff,27,0,30,3
1650028908084,MATH 18,B01,083748,Staff,0,8,30,30
1650028908084,MATH 18,B02,083749,Staff,0,6,30,30
1650028908084,MATH 18,B03,083750,Staff,0,6,30,30
1650028908084,MATH 18,B04,083751,Staff,1,7,30,29
1650028914109,MATH 20A,A01,083754,Staff,27,0,40,13
1650028920135,MATH 20B,A01,083756,Staff,0,4,30,30
1650028920135,MATH 20B,A02,083757,Staff,4,0,30,26
1650028926166,MATH 20C,A01,083760,Staff,0,9,30,30
1650028926166,MATH 20C,A02,083761,Staff,0,10,30,30
1650028926166,MATH 20C,B01,083762,Staff,17,0,30,13
1650028926166,MATH 20C,B02,083763,Staff,28,0,30,2
1650028932195,MATH 20D,A01,083765,Staff,0,2,30,30
1650028932195,MATH 20D,A02,083766,Staff,16,0,30,14
1650028932195,MATH 20D,A03,083767,Staff,28,0,30,2
1650028938223,MATH 20E,A01,083771,Staff,11,0,30,19
1650028938223,MATH 20E,A02,083772,Staff,20,0,30,10
1650028938223,MATH 20E,B01,083773,Staff,0,1,30,30
1650028938223,MATH 20E,B02,083774,Staff,19,0,30,11
1650028944248,MATH 103A,A01,083777,Staff,0,6,30,30
1650028944248,MATH 103A,A02,083778,Staff,0,7,30,30
1650028944248,MATH 103A,B01,083779,Staff,0,7,30,30
1650028944248,MATH 103A,B02,083780,Staff,0,6,30,30
1650028950281,MATH 105,A01,085443,Staff,0,11,30,30
1650028956307,MATH 109,A01,083213,Anzaldo; Leesa B,0,3,30,30
1650028956307,MATH 109,A02,083214,Anzaldo; Leesa B,0,4,30,30
1650028956307,MATH 109,B01,083215,Anzaldo; Leesa B,0,2,30,30
1650028956307,MATH 109,B02,083216,Anzaldo; Leesa B,0,2,30,30
1650028962339,MATH 142A,A01,083219,Chow; Bennett,0,7,30,30
1650028962339,MATH 142A,A02,083220,Chow; Bennett,0,7,30,30
1650028962339,MATH 142A,B01,083221,Chow; Bennett,0,8,30,30
1650028962339,MATH 142A,B02,083222,Chow; Bennett,0,7,30,30
1650028968363,MATH 193A,A01,083224,Staff,0,5,30,30
1650028968363,MATH 193A,A02,083225,Staff,0,4,30,30
1650028968363,MATH 193A,A03,083781,Staff,0,0,30,30
1650028968363,MATH 193A,A04,083782,Staff,9,0,30,21
1650028974390,MATH 197,001,091859,McAuley; Julian John,9999,0,9999,0
1650028980459,COGS 9,A01,083615,Staff,1,15,60,59
1650028986484,COGS 11,A01,083617,Boyle; Mary E. T.,25,0,40,15
1650028992508,COGS 13,A01,083071,Staff,0,28,40,40
1650028998533,COGS 14A,A01,092681,Staff,0,6,100,100
1650029004556,COGS 14B,A01,083073,Cheng; Tzu-Han,0,2,50,50
1650029010581,COGS 17,A01,092677,Staff,35,0,75,40
1650029016605,COGS 100,A01,083619,Staff,0,18,60,60
1650029022630,COGS 101A,A01,083621,Davis; Joshua Daniel,0,16,60,60
1650029028657,COGS 101B,A01,091572,Staff,16,0,60,44
1650029034702,COGS 101C,A01,083625,Delgado; Tania,21,0,30,9
1650029040726,COGS 107A,A01,083627,Boyle; Mary E. T.,0,1,60,60
1650029046753,COGS 118A,A01,083075,Staff,19,0,60,41
1650029052777,CSE 3,A50,083646,Miranda; Gregory Joseph,22,0,38,16
1650029052777,CSE 3,A51,083647,Miranda; Gregory Joseph,37,0,37,0
1650029058801,CSE 8A,A50,083650,Miranda; Gregory Joseph,0,14,40,40
1650029064825,CSE 11,A01,083080,Cao; Yingjun,0,60,40,40
1650029070852,CSE 12,A01,083652,Staff,2,0,100,98
1650029076875,CSE 15L,A01,083654,Staff,0,0,50,50
1650029076875,CSE 15L,A02,083655,Staff,15,0,50,35
1650029082899,CSE 20,A01,083657,Staff,57,0,80,23
1650029088923,CSE 30,A01,083084,Eldon; John,0,62,40,40
1650029094949,CSE 100,A01,083659,Cao; Yingjun,0,57,50,50
1650029100973,CSE 134B,A01,083661,Powell; Thomas Allan,0,25,65,65
1650029106996,CSE 140,A01,083663,Staff,8,0,75,67
1650029113023,CSE 140L,A01,083088,Eldon; John,4,0,75,71
1650029119050,CSE 175,A01,083665,Kumar; Rakesh,10,0,25,15
1650029125080,CSE 190,A00,092507,Dubnov; Shlomo,17,0,20,3
1650029131108,ECE 45,A01,083139,Staff,0,10,40,40
1650029137132,ECE 65,A50,083695,Staff,0,1,30,30
1650029143169,ECE 109,A01,091882,Touri; Behrouz,48,0,70,22
1650029149193,ECE 180,A00,083140,Abi Samra; Nicholas Camill,26,0,30,4
1650029149193,ECE 180,B00,083141,Abi Samra; Nicholas Camill,10,0,30,20
1650029155223,MATH 10A,A01,083735,Patchell; Gregory David,14,0,30,16
1650029155223,MATH 10A,A02,083736,Patchell; Gregory David,28,0,30,2
1650029155223,MATH 10A,A03,083737,Patchell; Gregory David,27,0,30,3
1650029161253,MATH 10B,A01,083207,Staff,0,4,30,30
1650029161253,MATH 10B,A02,083208,Staff,0,0,30,30
1650029161253,MATH 10B,B01,083739,Staff,20,0,30,10
1650029161253,MATH 10B,B02,083740,Staff,30,0,30,0
1650029167279,MATH 18,A01,083743,Staff,10,0,30,20
1650029167279,MATH 18,A02,083744,Staff,28,0,30,2
1650029167279,MATH 18,A03,083745,Staff,23,0,30,7
1650029167279,MATH 18,A04,083746,Staff,27,0,30,3
1650029167279,MATH 18,B01,083748,Staff,0,8,30,30
1650029167279,MATH 18,B02,083749,Staff,0,6,30,30
1650029167279,MATH 18,B03,083750,Staff,0,6,30,30
1650029167279,MATH 18,B04,083751,Staff,1,7,30,29
1650029173312,MATH 20A,A01,083754,Staff,27,0,40,13
1650029179426,MATH 20B,A01,083756,Staff,0,4,30,30
1650029179426,MATH 20B,A02,083757,Staff,4,0,30,26
1650029185449,MATH 20C,A01,083760,Staff,0,9,30,30
1650029185449,MATH 20C,A02,083761,Staff,0,10,30,30
1650029185449,MATH 20C,B01,083762,Staff,17,0,30,13
1650029185449,MATH 20C,B02,083763,Staff,28,0,30,2
1650029191488,MATH 20D,A01,083765,Staff,0,2,30,30
1650029191488,MATH 20D,A02,083766,Staff,16,0,30,14
1650029191488,MATH 20D,A03,083767,Staff,28,0,30,2
1650029197519,MATH 20E,A01,083771,Staff,11,0,30,19
1650029197519,MATH 20E,A02,083772,Staff,20,0,30,10
1650029197519,MATH 20E,B01,083773,Staff,0,1,30,30
1650029197519,MATH 20E,B02,083774,Staff,19,0,30,11
1650029203550,MATH 103A,A01,083777,Staff,0,6,30,30
1650029203550,MATH 103A,A02,083778,Staff,0,7,30,30
1650029203550,MATH 103A,B01,083779,Staff,0,7,30,30
1650029203550,MATH 103A,B02,083780,Staff,0,6,30,30
1650029209574,MATH 105,A01,085443,Staff,0,11,30,30
1650029215599,MATH 109,A01,083213,Anzaldo; Leesa B,0,3,30,30
1650029215599,MATH 109,A02,083214,Anzaldo; Leesa B,0,4,30,30
1650029215599,MATH 109,B01,083215,Anzaldo; Leesa B,0,2,30,30
1650029215599,MATH 109,B02,083216,Anzaldo; Leesa B,0,2,30,30
1650029221623,MATH 142A,A01,083219,Chow; Bennett,0,7,30,30
1650029221623,MATH 142A,A02,083220,Chow; Bennett,0,7,30,30
1650029221623,MATH 142A,B01,083221,Chow; Bennett,0,8,30,30
1650029221623,MATH 142A,B02,083222,Chow; Bennett,0,7,30,30
1650029227650,MATH 193A,A01,083224,Staff,0,5,30,30
1650029227650,MATH 193A,A02,083225,Staff,0,4,30,30
1650029227650,MATH 193A,A03,083781,Staff,0,0,30,30
1650029227650,MATH 193A,A04,083782,Staff,9,0,30,21
1650029233678,MATH 197,001,091859,McAuley; Julian John,9999,0,9999,0
1650029239732,COGS 9,A01,083615,Staff,1,15,60,59
1650029245769,COGS 11,A01,083617,Boyle; Mary E. T.,25,0,40,15
1650029251793,COGS 13,A01,083071,Staff,0,28,40,40
1650029257818,COGS 14A,A01,092681,Staff,0,6,100,100
1650029263846,COGS 14B,A01,083073,Cheng; Tzu-Han,0,2,50,50
1650029269874,COGS 17,A01,092677,Staff,35,0,75,40
1650029275899,COGS 100,A01,083619,Staff,0,18,60,60
1650029281941,COGS 101A,A01,083621,Davis; Joshua Daniel,0,16,60,60
1650029287972,COGS 101B,A01,091572,Staff,16,0,60,44
1650029293996,COGS 101C,A01,083625,Delgado; Tania,21,0,30,9
1650029300024,COGS 107A,A01,083627,Boyle; Mary E. T.,0,1,60,60
1650029306050,COGS 118A,A01,083075,Staff,19,0,60,41
1650029312076,CSE 3,A50,083646,Miranda; Gregory Joseph,22,0,38,16
1650029312076,CSE 3,A51,083647,Miranda; Gregory Joseph,37,0,37,0
1650029318105,CSE 8A,A50,083650,Miranda; Gregory Joseph,0,14,40,40
1650029324131,CSE 11,A01,083080,Cao; Yingjun,0,60,40,40
1650029330153,CSE 12,A01,083652,Staff,2,0,100,98
1650029336178,CSE 15L,A01,083654,Staff,0,0,50,50
1650029336178,CSE 15L,A02,083655,Staff,15,0,50,35
1650029342204,CSE 20,A01,083657,Staff,57,0,80,23
1650029348233,CSE 30,A01,083084,Eldon; John,0,62,40,40
1650029354257,CSE 100,A01,083659,Cao; Yingjun,0,57,50,50
1650029360280,CSE 134B,A01,083661,Powell; Thomas Allan,0,25,65,65
1650029366302,CSE 140,A01,083663,Staff,8,0,75,67
1650029372324,CSE 140L,A01,083088,Eldon; John,4,0,75,71
1650029378350,CSE 175,A01,083665,Kumar; Rakesh,10,0,25,15
1650029384374,CSE 190,A00,092507,Dubnov; Shlomo,17,0,20,3
1650029390399,ECE 45,A01,083139,Staff,0,10,40,40
1650029396428,ECE 65,A50,083695,Staff,0,1,30,30
1650029402455,ECE 109,A01,091882,Touri; Behrouz,48,0,70,22
1650029408480,ECE 180,A00,083140,Abi Samra; Nicholas Camill,26,0,30,4
1650029408480,ECE 180,B00,083141,Abi Samra; Nicholas Camill,10,0,30,20
1650029414505,MATH 10A,A01,083735,Patchell; Gregory David,14,0,30,16
1650029414505,MATH 10A,A02,083736,Patchell; Gregory David,28,0,30,2
1650029414505,MATH 10A,A03,083737,Patchell; Gregory David,27,0,30,3
1650029420542,MATH 10B,A01,083207,Staff,0,4,30,30
1650029420542,MATH 10B,A02,083208,Staff,0,0,30,30
1650029420542,MATH 10B,B01,083739,Staff,20,0,30,10
1650029420542,MATH 10B,B02,083740,Staff,30,0,30,0
1650029426568,MATH 18,A01,083743,Staff,10,0,30,20
1650029426568,MATH 18,A02,083744,Staff,28,0,30,2
1650029426568,MATH 18,A03,083745,Staff,23,0,30,7
1650029426568,MATH 18,A04,083746,Staff,27,0,30,3
1650029426568,MATH 18,B01,083748,Staff,0,8,30,30
1650029426568,MATH 18,B02,083749,Staff,0,6,30,30
1650029426568,MATH 18,B03,083750,Staff,0,6,30,30
1650029426568,MATH 18,B04,083751,Staff,1,7,30,29
1650029432596,MATH 20A,A01,083754,Staff,27,0,40,13
1650029438624,MATH 20B,A01,083756,Staff,0,4,30,30
1650029438624,MATH 20B,A02,083757,Staff,4,0,30,26
1650029444655,MATH 20C,A01,083760,Staff,0,9,30,30
1650029444655,MATH 20C,A02,083761,Staff,0,10,30,30
1650029444655,MATH 20C,B01,083762,Staff,17,0,30,13
1650029444655,MATH 20C,B02,083763,Staff,28,0,30,2
1650029450707,MATH 20D,A01,083765,Staff,0,2,30,30
1650029450707,MATH 20D,A02,083766,Staff,16,0,30,14
1650029450707,MATH 20D,A03,083767,Staff,28,0,30,2
1650029456732,MATH 20E,A01,083771,Staff,11,0,30,19
1650029456732,MATH 20E,A02,083772,Staff,20,0,30,10
1650029456732,MATH 20E,B01,083773,Staff,0,1,30,30
1650029456732,MATH 20E,B02,083774,Staff,19,0,30,11
1650029462756,MATH 103A,A01,083777,Staff,0,6,30,30
1650029462756,MATH 103A,A02,083778,Staff,0,7,30,30
1650029462756,MATH 103A,B01,083779,Staff,0,7,30,30
1650029462756,MATH 103A,B02,083780,Staff,0,6,30,30
1650029468780,MATH 105,A01,085443,Staff,0,11,30,30
1650029474819,MATH 109,A01,083213,Anzaldo; Leesa B,0,3,30,30
1650029474819,MATH 109,A02,083214,Anzaldo; Leesa B,0,4,30,30
1650029474819,MATH 109,B01,083215,Anzaldo; Leesa B,0,2,30,30
1650029474819,MATH 109,B02,083216,Anzaldo; Leesa B,0,2,30,30
1650029480918,MATH 142A,A01,083219,Chow; Bennett,0,7,30,30
1650029480918,MATH 142A,A02,083220,Chow; Bennett,0,7,30,30
1650029480918,MATH 142A,B01,083221,Chow; Bennett,0,8,30,30
1650029480918,MATH 142A,B02,083222,Chow; Bennett,0,7,30,30
1650029486942,MATH 193A,A01,083224,Staff,0,5,30,30
1650029486942,MATH 193A,A02,083225,Staff,0,4,30,30
1650029486942,MATH 193A,A03,083781,Staff,0,0,30,30
1650029486942,MATH 193A,A04,083782,Staff,9,0,30,21
1650029492973,MATH 197,001,091859,McAuley; Julian John,9999,0,9999,0
1650029499040,COGS 9,A01,083615,Staff,1,15,60,59
1650029505065,COGS 11,A01,083617,Boyle; Mary E. T.,25,0,40,15
1650029511093,COGS 13,A01,083071,Staff,0,28,40,40
1650029517118,COGS 14A,A01,092681,Staff,0,6,100,100
1650029523150,COGS 14B,A01,083073,Cheng; Tzu-Han,0,2,50,50
1650029529175,COGS 17,A01,092677,Staff,35,0,75,40
1650029535201,COGS 100,A01,083619,Staff,0,18,60,60
1650029541228,COGS 101A,A01,083621,Davis; Joshua Daniel,0,16,60,60
1650029547254,COGS 101B,A01,091572,Staff,16,0,60,44
1650029553281,COGS 101C,A01,083625,Delgado; Tania,21,0,30,9
1650029559318,COGS 107A,A01,083627,Boyle; Mary E. T.,0,1,60,60
1650029565342,COGS 118A,A01,083075,Staff,19,0,60,41
1650029571377,CSE 3,A50,083646,Miranda; Gregory Joseph,22,0,38,16
1650029571377,CSE 3,A51,083647,Miranda; Gregory Joseph,37,0,37,0
1650029577401,CSE 8A,A50,083650,Miranda; Gregory Joseph,0,14,40,40
1650029583425,CSE 11,A01,083080,Cao; Yingjun,0,60,40,40
1650029589454,CSE 12,A01,083652,Staff,2,0,100,98
1650029595478,CSE 15L,A01,083654,Staff,0,0,50,50
1650029595478,CSE 15L,A02,083655,Staff,15,0,50,35
1650029601504,CSE 20,A01,083657,Staff,57,0,80,23
1650029607531,CSE 30,A01,083084,Eldon; John,0,62,40,40
1650029613555,CSE 100,A01,083659,Cao; Yingjun,0,57,50,50
1650029619579,CSE 134B,A01,083661,Powell; Thomas Allan,0,25,65,65
1650029625603,CSE 140,A01,083663,Staff,8,0,75,67
1650029631636,CSE 140L,A01,083088,Eldon; John,4,0,75,71
1650029637663,CSE 175,A01,083665,Kumar; Rakesh,10,0,25,15
1650029643687,CSE 190,A00,092507,Dubnov; Shlomo,17,0,20,3
1650029649716,ECE 45,A01,083139,Staff,0,10,40,40
1650029655745,ECE 65,A50,083695,Staff,0,1,30,30
1650029661773,ECE 109,A01,091882,Touri; Behrouz,48,0,70,22
1650029667798,ECE 180,A00,083140,Abi Samra; Nicholas Camill,26,0,30,4
1650029667798,ECE 180,B00,083141,Abi Samra; Nicholas Camill,10,0,30,20
1650029673822,MATH 10A,A01,083735,Patchell; Gregory David,14,0,30,16
1650029673822,MATH 10A,A02,083736,Patchell; Gregory David,28,0,30,2
1650029673822,MATH 10A,A03,083737,Patchell; Gregory David,27,0,30,3
1650029679850,MATH 10B,A01,083207,Staff,0,4,30,30
1650029679850,MATH 10B,A02,083208,Staff,0,0,30,30
1650029679850,MATH 10B,B01,083739,Staff,20,0,30,10
1650029679850,MATH 10B,B02,083740,Staff,30,0,30,0
1650029685876,MATH 18,A01,083743,Staff,10,0,30,20
1650029685876,MATH 18,A02,083744,Staff,28,0,30,2
1650029685876,MATH 18,A03,083745,Staff,23,0,30,7
1650029685876,MATH 18,A04,083746,Staff,27,0,30,3
1650029685876,MATH 18,B01,083748,Staff,0,8,30,30
1650029685876,MATH 18,B02,083749,Staff,0,6,30,30
1650029685876,MATH 18,B03,083750,Staff,0,6,30,30
1650029685876,MATH 18,B04,083751,Staff,1,7,30,29
1650029691900,MATH 20A,A01,083754,Staff,27,0,40,13
1650029697928,MATH 20B,A01,083756,Staff,0,4,30,30
1650029697928,MATH 20B,A02,083757,Staff,4,0,30,26
1650029703957,MATH 20C,A01,083760,Staff,0,9,30,30
1650029703957,MATH 20C,A02,083761,Staff,0,10,30,30
1650029703957,MATH 20C,B01,083762,Staff,17,0,30,13
1650029703957,MATH 20C,B02,083763,Staff,28,0,30,2
1650029709983,MATH 20D,A01,083765,Staff,0,2,30,30
1650029709983,MATH 20D,A02,083766,Staff,16,0,30,14
1650029709983,MATH 20D,A03,083767,Staff,28,0,30,2
1650029716009,MATH 20E,A01,083771,Staff,11,0,30,19
1650029716009,MATH 20E,A02,083772,Staff,20,0,30,10
1650029716009,MATH 20E,B01,083773,Staff,0,1,30,30
1650029716009,MATH 20E,B02,083774,Staff,19,0,30,11
1650029722035,MATH 103A,A01,083777,Staff,0,6,30,30
1650029722035,MATH 103A,A02,083778,Staff,0,7,30,30
1650029722035,MATH 103A,B01,083779,Staff,0,7,30,30
1650029722035,MATH 103A,B02,083780,Staff,0,6,30,30
1650029728063,MATH 105,A01,085443,Staff,0,11,30,30
1650029734092,MATH 109,A01,083213,Anzaldo; Leesa B,0,3,30,30
1650029734092,MATH 109,A02,083214,Anzaldo; Leesa B,0,4,30,30
1650029734092,MATH 109,B01,083215,Anzaldo; Leesa B,0,2,30,30
1650029734092,MATH 109,B02,083216,Anzaldo; Leesa B,0,2,30,30
1650029740117,MATH 142A,A01,083219,Chow; Bennett,0,7,30,30
1650029740117,MATH 142A,A02,083220,Chow; Bennett,0,7,30,30
1650029740117,MATH 142A,B01,083221,Chow; Bennett,0,8,30,30
1650029740117,MATH 142A,B02,083222,Chow; Bennett,0,7,30,30
1650029746141,MATH 193A,A01,083224,Staff,0,5,30,30
1650029746141,MATH 193A,A02,083225,Staff,0,4,30,30
1650029746141,MATH 193A,A03,083781,Staff,0,0,30,30
1650029746141,MATH 193A,A04,083782,Staff,9,0,30,21
1650029752167,MATH 197,001,091859,McAuley; Julian John,9999,0,9999,0
1650029758220,COGS 9,A01,083615,Staff,1,15,60,59
1650029764245,COGS 11,A01,083617,Boyle; Mary E. T.,25,0,40,15
1650029770346,COGS 13,A01,083071,Staff,0,28,40,40
1650029776372,COGS 14A,A01,092681,Staff,0,6,100,100
1650029782401,COGS 14B,A01,083073,Cheng; Tzu-Han,0,2,50,50
1650029788433,COGS 17,A01,092677,Staff,35,0,75,40
1650029794460,COGS 100,A01,083619,Staff,0,18,60,60
1650029800511,COGS 101A,A01,083621,Davis; Joshua Daniel,0,16,60,60
1650029806535,COGS 101B,A01,091572,Staff,16,0,60,44
1650029812579,COGS 101C,A01,083625,Delgado; Tania,21,0,30,9
1650029818606,COGS 107A,A01,083627,Boyle; Mary E. T.,0,1,60,60
1650029824630,COGS 118A,A01,083075,Staff,19,0,60,41
1650029830655,CSE 3,A50,083646,Miranda; Gregory Joseph,22,0,38,16
1650029830655,CSE 3,A51,083647,Miranda; Gregory Joseph,37,0,37,0
1650029836684,CSE 8A,A50,083650,Miranda; Gregory Joseph,0,14,40,40
1650029842711,CSE 11,A01,083080,Cao; Yingjun,0,60,40,40
1650029848735,CSE 12,A01,083652,Staff,2,0,100,98
1650029854763,CSE 15L,A01,083654,Staff,0,0,50,50
1650029854763,CSE 15L,A02,083655,Staff,15,0,50,35
1650029860790,CSE 20,A01,083657,Staff,57,0,80,23
1650029866814,CSE 30,A01,083084,Eldon; John,0,62,40,40
1650029872838,CSE 100,A01,083659,Cao; Yingjun,0,57,50,50
1650029878862,CSE 134B,A01,083661,Powell; Thomas Allan,0,25,65,65
1650029884886,CSE 140,A01,083663,Staff,8,0,75,67
1650029890914,CSE 140L,A01,083088,Eldon; John,4,0,75,71
1650029896938,CSE 175,A01,083665,Kumar; Rakesh,10,0,25,15
1650029902965,CSE 190,A00,092507,Dubnov; Shlomo,17,0,20,3
1650029909000,ECE 45,A01,083139,Staff,0,10,40,40
1650029915023,ECE 65,A50,083695,Staff,0,1,30,30
1650029921047,ECE 109,A01,091882,Touri; Behrouz,48,0,70,22
1650029927078,ECE 180,A00,083140,Abi Samra; Nicholas Camill,26,0,30,4
1650029927078,ECE 180,B00,083141,Abi Samra; Nicholas Camill,10,0,30,20
1650029933103,MATH 10A,A01,083735,Patchell; Gregory David,14,0,30,16
1650029933103,MATH 10A,A02,083736,Patchell; Gregory David,28,0,30,2
1650029933103,MATH 10A,A03,083737,Patchell; Gregory David,27,0,30,3
1650029939126,MATH 10B,A01,083207,Staff,0,4,30,30
1650029939126,MATH 10B,A02,083208,Staff,0,0,30,30
1650029939126,MATH 10B,B01,083739,Staff,20,0,30,10
1650029939126,MATH 10B,B02,083740,Staff,30,0,30,0
1650029945155,MATH 18,A01,083743,Staff,10,0,30,20
1650029945155,MATH 18,A02,083744,Staff,28,0,30,2
1650029945155,MATH 18,A03,083745,Staff,23,0,30,7
1650029945155,MATH 18,A04,083746,Staff,27,0,30,3
1650029945155,MATH 18,B01,083748,Staff,0,8,30,30
1650029945155,MATH 18,B02,083749,Staff,0,6,30,30
1650029945155,MATH 18,B03,083750,Staff,0,6,30,30
1650029945155,MATH 18,B04,083751,Staff,1,7,30,29
1650029951188,MATH 20A,A01,083754,Staff,27,0,40,13
1650029957224,MATH 20B,A01,083756,Staff,0,4,30,30
1650029957224,MATH 20B,A02,083757,Staff,4,0,30,26
1650029963254,MATH 20C,A01,083760,Staff,0,9,30,30
1650029963254,MATH 20C,A02,083761,Staff,0,10,30,30
1650029963254,MATH 20C,B01,083762,Staff,17,0,30,13
1650029963254,MATH 20C,B02,083763,Staff,28,0,30,2
1650029969277,MATH 20D,A01,083765,Staff,0,2,30,30
1650029969277,MATH 20D,A02,083766,Staff,16,0,30,14
1650029969277,MATH 20D,A03,083767,Staff,28,0,30,2
1650029975320,MATH 20E,A01,083771,Staff,11,0,30,19
1650029975320,MATH 20E,A02,083772,Staff,20,0,30,10
1650029975320,MATH 20E,B01,083773,Staff,0,1,30,30
1650029975320,MATH 20E,B02,083774,Staff,19,0,30,11
1650029981346,MATH 103A,A01,083777,Staff,0,6,30,30
1650029981346,MATH 103A,A02,083778,Staff,0,7,30,30
1650029981346,MATH 103A,B01,083779,Staff,0,7,30,30
1650029981346,MATH 103A,B02,083780,Staff,0,6,30,30
1650029987370,MATH 105,A01,085443,Staff,0,11,30,30
1650029993412,MATH 109,A01,083213,Anzaldo; Leesa B,0,3,30,30
1650029993412,MATH 109,A02,083214,Anzaldo; Leesa B,0,4,30,30
1650029993412,MATH 109,B01,083215,Anzaldo; Leesa B,0,2,30,30
1650029993412,MATH 109,B02,083216,Anzaldo; Leesa B,0,2,30,30
1650029999442,MATH 142A,A01,083219,Chow; Bennett,0,7,30,30
1650029999442,MATH 142A,A02,083220,Chow; Bennett,0,7,30,30
1650029999442,MATH 142A,B01,083221,Chow; Bennett,0,8,30,30
1650029999442,MATH 142A,B02,083222,Chow; Bennett,0,7,30,30
1650030005474,MATH 193A,A01,083224,Staff,0,5,30,30
1650030005474,MATH 193A,A02,083225,Staff,0,4,30,30
1650030005474,MATH 193A,A03,083781,Staff,0,0,30,30
1650030005474,MATH 193A,A04,083782,Staff,9,0,30,21
1650030011498,MATH 197,001,091859,McAuley; Julian John,9999,0,9999,0
1650030017552,COGS 9,A01,083615,Staff,1,15,60,59
1650030023576,COGS 11,A01,083617,Boyle; Mary E. T.,25,0,40,15
1650030029600,COGS 13,A01,083071,Staff,0,28,40,40
1650030035642,COGS 14A,A01,092681,Staff,0,6,100,100
1650030041665,COGS 14B,A01,083073,Cheng; Tzu-Han,0,2,50,50
1650030047689,COGS 17,A01,092677,Staff,35,0,75,40
1650030053715,COGS 100,A01,083619,Staff,0,18,60,60
1650030059739,COGS 101A,A01,083621,Davis; Joshua Daniel,0,16,60,60
1650030065764,COGS 101B,A01,091572,Staff,16,0,60,44
1650030071792,COGS 101C,A01,083625,Delgado; Tania,21,0,30,9
1650030077814,COGS 107A,A01,083627,Boyle; Mary E. T.,0,1,60,60
1650030083842,COGS 118A,A01,083075,Staff,19,0,60,41
1650030089867,CSE 3,A50,083646,Miranda; Gregory Joseph,22,0,38,16
1650030089867,CSE 3,A51,083647,Miranda; Gregory Joseph,37,0,37,0
1650030095893,CSE 8A,A50,083650,Miranda; Gregory Joseph,0,14,40,40
1650030101918,CSE 11,A01,083080,Cao; Yingjun,0,60,40,40
1650030107945,CSE 12,A01,083652,Staff,2,0,100,98
1650030113969,CSE 15L,A01,083654,Staff,0,0,50,50
1650030113969,CSE 15L,A02,083655,Staff,15,0,50,35
1650030119999,CSE 20,A01,083657,Staff,57,0,80,23
1650030126027,CSE 30,A01,083084,Eldon; John,0,62,40,40
1650030132051,CSE 100,A01,083659,Cao; Yingjun,0,57,50,50
1650030138102,CSE 134B,A01,083661,Powell; Thomas Allan,0,25,65,65
1650030144125,CSE 140,A01,083663,Staff,8,0,75,67
1650030150159,CSE 140L,A01,083088,Eldon; John,4,0,75,71
1650030156186,CSE 175,A01,083665,Kumar; Rakesh,10,0,25,15
1650030162214,CSE 190,A00,092507,Dubnov; Shlomo,17,0,20,3
1650030168236,ECE 45,A01,083139,Staff,0,10,40,40
1650030174260,ECE 65,A50,083695,Staff,0,1,30,30
1650030180286,ECE 109,A01,091882,Touri; Behrouz,48,0,70,22
1650030186313,ECE 180,A00,083140,Abi Samra; Nicholas Camill,26,0,30,4
1650030186313,ECE 180,B00,083141,Abi Samra; Nicholas Camill,10,0,30,20
1650030192337,MATH 10A,A01,083735,Patchell; Gregory David,14,0,30,16
1650030192337,MATH 10A,A02,083736,Patchell; Gregory David,28,0,30,2
1650030192337,MATH 10A,A03,083737,Patchell; Gregory David,27,0,30,3
1650030198370,MATH 10B,A01,083207,Staff,0,4,30,30
1650030198370,MATH 10B,A02,083208,Staff,0,0,30,30
1650030198370,MATH 10B,B01,083739,Staff,20,0,30,10
1650030198370,MATH 10B,B02,083740,Staff,30,0,30,0
1650030204400,MATH 18,A01,083743,Staff,10,0,30,20
1650030204400,MATH 18,A02,083744,Staff,28,0,30,2
1650030204400,MATH 18,A03,083745,Staff,23,0,30,7
1650030204400,MATH 18,A04,083746,Staff,27,0,30,3
1650030204400,MATH 18,B01,083748,Staff,0,8,30,30
1650030204400,MATH 18,B02,083749,Staff,0,6,30,30
1650030204400,MATH 18,B03,083750,Staff,0,6,30,30
1650030204400,MATH 18,B04,083751,Staff,1,7,30,29
1650030210434,MATH 20A,A01,083754,Staff,27,0,40,13
1650030216460,MATH 20B,A01,083756,Staff,0,4,30,30
1650030216460,MATH 20B,A02,083757,Staff,4,0,30,26
1650030222484,MATH 20C,A01,083760,Staff,0,9,30,30
1650030222484,MATH 20C,A02,083761,Staff,0,10,30,30
1650030222484,MATH 20C,B01,083762,Staff,17,0,30,13
1650030222484,MATH 20C,B02,083763,Staff,28,0,30,2
1650030228510,MATH 20D,A01,083765,Staff,0,2,30,30
1650030228510,MATH 20D,A02,083766,Staff,16,0,30,14
1650030228510,MATH 20D,A03,083767,Staff,28,0,30,2
1650030234536,MATH 20E,A01,083771,Staff,11,0,30,19
1650030234536,MATH 20E,A02,083772,Staff,20,0,30,10
1650030234536,MATH 20E,B01,083773,Staff,0,1,30,30
1650030234536,MATH 20E,B02,083774,Staff,19,0,30,11
1650030240564,MATH 103A,A01,083777,Staff,0,6,30,30
1650030240564,MATH 103A,A02,083778,Staff,0,7,30,30
1650030240564,MATH 103A,B01,083779,Staff,0,7,30,30
1650030240564,MATH 103A,B02,083780,Staff,0,6,30,30
1650030246592,MATH 105,A01,085443,Staff,0,11,30,30
1650030252623,MATH 109,A01,083213,Anzaldo; Leesa B,0,3,30,30
1650030252623,MATH 109,A02,083214,Anzaldo; Leesa B,0,4,30,30
1650030252623,MATH 109,B01,083215,Anzaldo; Leesa B,0,2,30,30
1650030252623,MATH 109,B02,083216,Anzaldo; Leesa B,0,2,30,30
1650030258647,MATH 142A,A01,083219,Chow; Bennett,0,7,30,30
1650030258647,MATH 142A,A02,083220,Chow; Bennett,0,7,30,30
1650030258647,MATH 142A,B01,083221,Chow; Bennett,0,8,30,30
1650030258647,MATH 142A,B02,083222,Chow; Bennett,0,7,30,30
1650030264676,MATH 193A,A01,083224,Staff,0,5,30,30
1650030264676,MATH 193A,A02,083225,Staff,0,4,30,30
1650030264676,MATH 193A,A03,083781,Staff,0,0,30,30
1650030264676,MATH 193A,A04,083782,Staff,9,0,30,21
1650030270701,MATH 197,001,091859,McAuley; Julian John,9999,0,9999,0
1650030276763,COGS 9,A01,083615,Staff,1,15,60,59
1650030282793,COGS 11,A01,083617,Boyle; Mary E. T.,25,0,40,15
1650030288818,COGS 13,A01,083071,Staff,0,28,40,40
1650030294843,COGS 14A,A01,092681,Staff,0,6,100,100
1650030300869,COGS 14B,A01,083073,Cheng; Tzu-Han,0,2,50,50
1650030306893,COGS 17,A01,092677,Staff,35,0,75,40
1650030312931,COGS 100,A01,083619,Staff,0,18,60,60
1650030318955,COGS 101A,A01,083621,Davis; Joshua Daniel,0,16,60,60
1650030324982,COGS 101B,A01,091572,Staff,16,0,60,44
1650030331010,COGS 101C,A01,083625,Delgado; Tania,21,0,30,9
1650030337034,COGS 107A,A01,083627,Boyle; Mary E. T.,0,1,60,60
1650030343061,COGS 118A,A01,083075,Staff,19,0,60,41
1650030349104,CSE 3,A50,083646,Miranda; Gregory Joseph,22,0,38,16
1650030349104,CSE 3,A51,083647,Miranda; Gregory Joseph,37,0,37,0
1650030355128,CSE 8A,A50,083650,Miranda; Gregory Joseph,0,14,40,40
1650030361199,CSE 11,A01,083080,Cao; Yingjun,0,60,40,40
1650030367301,CSE 12,A01,083652,Staff,2,0,100,98
1650030373330,CSE 15L,A01,083654,Staff,0,0,50,50
1650030373330,CSE 15L,A02,083655,Staff,15,0,50,35
1650030379355,CSE 20,A01,083657,Staff,57,0,80,23
1650030385379,CSE 30,A01,083084,Eldon; John,0,62,40,40
1650030391410,CSE 100,A01,083659,Cao; Yingjun,0,57,50,50
1650030397436,CSE 134B,A01,083661,Powell; Thomas Allan,0,25,65,65
1650030403460,CSE 140,A01,083663,Staff,8,0,75,67
1650030409485,CSE 140L,A01,083088,Eldon; John,4,0,75,71
1650030415523,CSE 175,A01,083665,Kumar; Rakesh,10,0,25,15
1650030421552,CSE 190,A00,092507,Dubnov; Shlomo,17,0,20,3
1650030427577,ECE 45,A01,083139,Staff,0,10,40,40
1650030433604,ECE 65,A50,083695,Staff,0,1,30,30
1650030439633,ECE 109,A01,091882,Touri; Behrouz,48,0,70,22
1650030445657,ECE 180,A00,083140,Abi Samra; Nicholas Camill,26,0,30,4
1650030445657,ECE 180,B00,083141,Abi Samra; Nicholas Camill,10,0,30,20
1650030451685,MATH 10A,A01,083735,Patchell; Gregory David,14,0,30,16
1650030451685,MATH 10A,A02,083736,Patchell; Gregory David,28,0,30,2
1650030451685,MATH 10A,A03,083737,Patchell; Gregory David,27,0,30,3
1650030457712,MATH 10B,A01,083207,Staff,0,4,30,30
1650030457712,MATH 10B,A02,083208,Staff,0,0,30,30
1650030457712,MATH 10B,B01,083739,Staff,20,0,30,10
1650030457712,MATH 10B,B02,083740,Staff,30,0,30,0
1650030463743,MATH 18,A01,083743,Staff,10,0,30,20
1650030463743,MATH 18,A02,083744,Staff,28,0,30,2
1650030463743,MATH 18,A03,083745,Staff,23,0,30,7
1650030463743,MATH 18,A04,083746,Staff,27,0,30,3
1650030463743,MATH 18,B01,083748,Staff,0,8,30,30
1650030463743,MATH 18,B02,083749,Staff,0,6,30,30
1650030463743,MATH 18,B03,083750,Staff,0,6,30,30
1650030463743,MATH 18,B04,083751,Staff,1,7,30,29
1650030469767,MATH 20A,A01,083754,Staff,27,0,40,13
1650030475795,MATH 20B,A01,083756,Staff,0,4,30,30
1650030475795,MATH 20B,A02,083757,Staff,4,0,30,26
1650030481831,MATH 20C,A01,083760,Staff,0,9,30,30
1650030481831,MATH 20C,A02,083761,Staff,0,10,30,30
1650030481831,MATH 20C,B01,083762,Staff,17,0,30,13
1650030481831,MATH 20C,B02,083763,Staff,28,0,30,2
1650030487856,MATH 20D,A01,083765,Staff,0,2,30,30
1650030487856,MATH 20D,A02,083766,Staff,16,0,30,14
1650030487856,MATH 20D,A03,083767,Staff,28,0,30,2
1650030493883,MATH 20E,A01,083771,Staff,11,0,30,19
1650030493883,MATH 20E,A02,083772,Staff,20,0,30,10
1650030493883,MATH 20E,B01,083773,Staff,0,1,30,30
1650030493883,MATH 20E,B02,083774,Staff,19,0,30,11
1650030499910,MATH 103A,A01,083777,Staff,0,6,30,30
1650030499910,MATH 103A,A02,083778,Staff,0,7,30,30
1650030499910,MATH 103A,B01,083779,Staff,0,7,30,30
1650030499910,MATH 103A,B02,083780,Staff,0,6,30,30
1650030505944,MATH 105,A01,085443,Staff,0,11,30,30
1650030511968,MATH 109,A01,083213,Anzaldo; Leesa B,0,3,30,30
1650030511968,MATH 109,A02,083214,Anzaldo; Leesa B,0,4,30,30
1650030511968,MATH 109,B01,083215,Anzaldo; Leesa B,0,2,30,30
1650030511968,MATH 109,B02,083216,Anzaldo; Leesa B,0,2,30,30
1650030517994,MATH 142A,A01,083219,Chow; Bennett,0,7,30,30
1650030517994,MATH 142A,A02,083220,Chow; Bennett,0,7,30,30
1650030517994,MATH 142A,B01,083221,Chow; Bennett,0,8,30,30
1650030517994,MATH 142A,B02,083222,Chow; Bennett,0,7,30,30
1650030524022,MATH 193A,A01,083224,Staff,0,5,30,30
1650030524022,MATH 193A,A02,083225,Staff,0,4,30,30
1650030524022,MATH 193A,A03,083781,Staff,0,0,30,30
1650030524022,MATH 193A,A04,083782,Staff,9,0,30,21
1650030530046,MATH 197,001,091859,McAuley; Julian John,9999,0,9999,0
1650030536101,COGS 9,A01,083615,Staff,1,15,60,59
1650030542125,COGS 11,A01,083617,Boyle; Mary E. T.,25,0,40,15
1650030548148,COGS 13,A01,083071,Staff,0,28,40,40
1650030554180,COGS 14A,A01,092681,Staff,0,6,100,100
1650030560205,COGS 14B,A01,083073,Cheng; Tzu-Han,0,2,50,50
1650030566231,COGS 17,A01,092677,Staff,35,0,75,40
1650030572257,COGS 100,A01,083619,Staff,0,18,60,60
1650030578285,COGS 101A,A01,083621,Davis; Joshua Daniel,0,16,60,60
1650030584313,COGS 101B,A01,091572,Staff,16,0,60,44
1650030590336,COGS 101C,A01,083625,Delgado; Tania,21,0,30,9
1650030596361,COGS 107A,A01,083627,Boyle; Mary E. T.,0,1,60,60
1650030602391,COGS 118A,A01,083075,Staff,19,0,60,41
1650030608418,CSE 3,A50,083646,Miranda; Gregory Joseph,22,0,38,16
1650030608418,CSE 3,A51,083647,Miranda; Gregory Joseph,37,0,37,0
1650030614447,CSE 8A,A50,083650,Miranda; Gregory Joseph,0,14,40,40
1650030620475,CSE 11,A01,083080,Cao; Yingjun,0,60,40,40
1650030626500,CSE 12,A01,083652,Staff,2,0,100,98
1650030632524,CSE 15L,A01,083654,Staff,0,0,50,50
1650030632524,CSE 15L,A02,083655,Staff,15,0,50,35
1650030638550,CSE 20,A01,083657,Staff,57,0,80,23
1650030644593,CSE 30,A01,083084,Eldon; John,0,62,40,40
1650030650618,CSE 100,A01,083659,Cao; Yingjun,0,57,50,50
1650030656645,CSE 134B,A01,083661,Powell; Thomas Allan,0,25,65,65
1650030662673,CSE 140,A01,083663,Staff,8,0,75,67
1650030668701,CSE 140L,A01,083088,Eldon; John,4,0,75,71
1650030674737,CSE 175,A01,083665,Kumar; Rakesh,10,0,25,15
1650030680760,CSE 190,A00,092507,Dubnov; Shlomo,17,0,20,3
1650030686785,ECE 45,A01,083139,Staff,0,10,40,40
1650030692813,ECE 65,A50,083695,Staff,0,1,30,30
1650030698839,ECE 109,A01,091882,Touri; Behrouz,48,0,70,22
1650030704863,ECE 180,A00,083140,Abi Samra; Nicholas Camill,26,0,30,4
1650030704863,ECE 180,B00,083141,Abi Samra; Nicholas Camill,10,0,30,20
1650030710895,MATH 10A,A01,083735,Patchell; Gregory David,14,0,30,16
1650030710895,MATH 10A,A02,083736,Patchell; Gregory David,28,0,30,2
1650030710895,MATH 10A,A03,083737,Patchell; Gregory David,27,0,30,3
1650030716927,MATH 10B,A01,083207,Staff,0,4,30,30
1650030716927,MATH 10B,A02,083208,Staff,0,0,30,30
1650030716927,MATH 10B,B01,083739,Staff,20,0,30,10
1650030716927,MATH 10B,B02,083740,Staff,30,0,30,0
1650030722964,MATH 18,A01,083743,Staff,10,0,30,20
1650030722964,MATH 18,A02,083744,Staff,28,0,30,2
1650030722964,MATH 18,A03,083745,Staff,23,0,30,7
1650030722964,MATH 18,A04,083746,Staff,27,0,30,3
1650030722964,MATH 18,B01,083748,Staff,0,8,30,30
1650030722964,MATH 18,B02,083749,Staff,0,6,30,30
1650030722964,MATH 18,B03,083750,Staff,0,6,30,30
1650030722964,MATH 18,B04,083751,Staff,1,7,30,29
1650030728990,MATH 20A,A01,083754,Staff,27,0,40,13
1650030735028,MATH 20B,A01,083756,Staff,0,4,30,30
1650030735028,MATH 20B,A02,083757,Staff,4,0,30,26
1650030741066,MATH 20C,A01,083760,Staff,0,9,30,30
1650030741066,MATH 20C,A02,083761,Staff,0,10,30,30
1650030741066,MATH 20C,B01,083762,Staff,17,0,30,13
1650030741066,MATH 20C,B02,083763,Staff,28,0,30,2
1650030747093,MATH 20D,A01,083765,Staff,0,2,30,30
1650030747093,MATH 20D,A02,083766,Staff,16,0,30,14
1650030747093,MATH 20D,A03,083767,Staff,28,0,30,2
1650030753126,MATH 20E,A01,083771,Staff,11,0,30,19
1650030753126,MATH 20E,A02,083772,Staff,20,0,30,10
1650030753126,MATH 20E,B01,083773,Staff,0,1,30,30
1650030753126,MATH 20E,B02,083774,Staff,19,0,30,11
1650030759155,MATH 103A,A01,083777,Staff,0,6,30,30
1650030759155,MATH 103A,A02,083778,Staff,0,7,30,30
1650030759155,MATH 103A,B01,083779,Staff,0,7,30,30
1650030759155,MATH 103A,B02,083780,Staff,0,6,30,30
1650030765180,MATH 105,A01,085443,Staff,0,11,30,30
1650030771203,MATH 109,A01,083213,Anzaldo; Leesa B,0,3,30,30
1650030771203,MATH 109,A02,083214,Anzaldo; Leesa B,0,4,30,30
1650030771203,MATH 109,B01,083215,Anzaldo; Leesa B,0,2,30,30
1650030771203,MATH 109,B02,083216,Anzaldo; Leesa B,0,2,30,30
1650030777232,MATH 142A,A01,083219,Chow; Bennett,0,7,30,30
1650030777232,MATH 142A,A02,083220,Chow; Bennett,0,7,30,30
1650030777232,MATH 142A,B01,083221,Chow; Bennett,0,8,30,30
1650030777232,MATH 142A,B02,083222,Chow; Bennett,0,7,30,30
1650030783267,MATH 193A,A01,083224,Staff,0,5,30,30
1650030783267,MATH 193A,A02,083225,Staff,0,4,30,30
1650030783267,MATH 193A,A03,083781,Staff,0,0,30,30
1650030783267,MATH 193A,A04,083782,Staff,9,0,30,21
1650030789291,MATH 197,001,091859,McAuley; Julian John,9999,0,9999,0
1650030795355,COGS 9,A01,083615,Staff,1,15,60,59
1650030801379,COGS 11,A01,083617,Boyle; Mary E. T.,25,0,40,15
1650030807407,COGS 13,A01,083071,Staff,0,28,40,40
1650030813430,COGS 14A,A01,092681,Staff,0,6,100,100
1650030819457,COGS 14B,A01,083073,Cheng; Tzu-Han,0,2,50,50
1650030825484,COGS 17,A01,092677,Staff,35,0,75,40
1650030831509,COGS 100,A01,083619,Staff,0,18,60,60
1650030837537,COGS 101A,A01,083621,Davis; Joshua Daniel,0,16,60,60
1650030843571,COGS 101B,A01,091572,Staff,16,0,60,44
1650030849611,COGS 101C,A01,083625,Delgado; Tania,21,0,30,9
1650030855639,COGS 107A,A01,083627,Boyle; Mary E. T.,0,1,60,60
1650030861664,COGS 118A,A01,083075,Staff,19,0,60,41
1650030867699,CSE 3,A50,083646,Miranda; Gregory Joseph,22,0,38,16
1650030867699,CSE 3,A51,083647,Miranda; Gregory Joseph,37,0,37,0
1650030873738,CSE 8A,A50,083650,Miranda; Gregory Joseph,0,14,40,40
1650030879762,CSE 11,A01,083080,Cao; Yingjun,0,60,40,40
1650030885787,CSE 12,A01,083652,Staff,2,0,100,98
1650030891824,CSE 15L,A01,083654,Staff,0,0,50,50
1650030891824,CSE 15L,A02,083655,Staff,15,0,50,35
1650030897848,CSE 20,A01,083657,Staff,57,0,80,23
1650030903871,CSE 30,A01,083084,Eldon; John,0,62,40,40
1650030909903,CSE 100,A01,083659,Cao; Yingjun,0,57,50,50
1650030915927,CSE 134B,A01,083661,Powell; Thomas Allan,0,25,65,65
1650030921953,CSE 140,A01,083663,Staff,8,0,75,67
1650030927980,CSE 140L,A01,083088,Eldon; John,4,0,75,71
1650030934005,CSE 175,A01,083665,Kumar; Rakesh,10,0,25,15
1650030940029,CSE 190,A00,092507,Dubnov; Shlomo,17,0,20,3
1650030946058,ECE 45,A01,083139,Staff,0,10,40,40
1650030952092,ECE 65,A50,083695,Staff,0,1,30,30
1650030958116,ECE 109,A01,091882,Touri; Behrouz,48,0,70,22
1650030964230,ECE 180,A00,083140,Abi Samra; Nicholas Camill,26,0,30,4
1650030964230,ECE 180,B00,083141,Abi Samra; Nicholas Camill,10,0,30,20
1650030970257,MATH 10A,A01,083735,Patchell; Gregory David,14,0,30,16
1650030970257,MATH 10A,A02,083736,Patchell; Gregory David,28,0,30,2
1650030970257,MATH 10A,A03,083737,Patchell; Gregory David,27,0,30,3
1650030976286,MATH 10B,A01,083207,Staff,0,4,30,30
1650030976286,MATH 10B,A02,083208,Staff,0,0,30,30
1650030976286,MATH 10B,B01,083739,Staff,20,0,30,10
1650030976286,MATH 10B,B02,083740,Staff,30,0,30,0
1650030982319,MATH 18,A01,083743,Staff,10,0,30,20
1650030982319,MATH 18,A02,083744,Staff,28,0,30,2
1650030982319,MATH 18,A03,083745,Staff,23,0,30,7
1650030982319,MATH 18,A04,083746,Staff,27,0,30,3
1650030982319,MATH 18,B01,083748,Staff,0,8,30,30
1650030982319,MATH 18,B02,083749,Staff,0,6,30,30
1650030982319,MATH 18,B03,083750,Staff,0,6,30,30
1650030982319,MATH 18,B04,083751,Staff,1,7,30,29
1650030988348,MATH 20A,A01,083754,Staff,27,0,40,13
1650030994372,MATH 20B,A01,083756,Staff,0,4,30,30
1650030994372,MATH 20B,A02,083757,Staff,4,0,30,26
1650031000403,MATH 20C,A01,083760,Staff,0,9,30,30
1650031000403,MATH 20C,A02,083761,Staff,0,10,30,30
1650031000403,MATH 20C,B01,083762,Staff,17,0,30,13
1650031000403,MATH 20C,B02,083763,Staff,28,0,30,2
1650031006432,MATH 20D,A01,083765,Staff,0,2,30,30
1650031006432,MATH 20D,A02,083766,Staff,16,0,30,14
1650031006432,MATH 20D,A03,083767,Staff,28,0,30,2
1650031012471,MATH 20E,A01,083771,Staff,11,0,30,19
1650031012471,MATH 20E,A02,083772,Staff,20,0,30,10
1650031012471,MATH 20E,B01,083773,Staff,0,1,30,30
1650031012471,MATH 20E,B02,083774,Staff,19,0,30,11
1650031018506,MATH 103A,A01,083777,Staff,0,6,30,30
1650031018506,MATH 103A,A02,083778,Staff,0,7,30,30
1650031018506,MATH 103A,B01,083779,Staff,0,7,30,30
1650031018506,MATH 103A,B02,083780,Staff,0,6,30,30
1650031024541,MATH 105,A01,085443,Staff,0,11,30,30
1650031030569,MATH 109,A01,083213,Anzaldo; Leesa B,0,3,30,30
1650031030569,MATH 109,A02,083214,Anzaldo; Leesa B,0,4,30,30
1650031030569,MATH 109,B01,083215,Anzaldo; Leesa B,0,2,30,30
1650031030569,MATH 109,B02,083216,Anzaldo; Leesa B,0,2,30,30
1650031036605,MATH 142A,A01,083219,Chow; Bennett,0,7,30,30
1650031036605,MATH 142A,A02,083220,Chow; Bennett,0,7,30,30
1650031036605,MATH 142A,B01,083221,Chow; Bennett,0,8,30,30
1650031036605,MATH 142A,B02,083222,Chow; Bennett,0,7,30,30
1650031042630,MATH 193A,A01,083224,Staff,0,5,30,30
1650031042630,MATH 193A,A02,083225,Staff,0,4,30,30
1650031042630,MATH 193A,A03,083781,Staff,0,0,30,30
1650031042630,MATH 193A,A04,083782,Staff,9,0,30,21
1650031048655,MATH 197,001,091859,McAuley; Julian John,9999,0,9999,0
1650031054706,COGS 9,A01,083615,Staff,1,15,60,59
1650031060737,COGS 11,A01,083617,Boyle; Mary E. T.,25,0,40,15
1650031066763,COGS 13,A01,083071,Staff,0,28,40,40
1650031072793,COGS 14A,A01,092681,Staff,0,6,100,100
1650031078816,COGS 14B,A01,083073,Cheng; Tzu-Han,0,2,50,50
1650031084840,COGS 17,A01,092677,Staff,35,0,75,40
1650031090863,COGS 100,A01,083619,Staff,0,18,60,60
1650031096887,COGS 101A,A01,083621,Davis; Joshua Daniel,0,16,60,60
1650031102910,COGS 101B,A01,091572,Staff,16,0,60,44
1650031108939,COGS 101C,A01,083625,Delgado; Tania,21,0,30,9
1650031114966,COGS 107A,A01,083627,Boyle; Mary E. T.,0,1,60,60
1650031121005,COGS 118A,A01,083075,Staff,19,0,60,41
1650031127028,CSE 3,A50,083646,Miranda; Gregory Joseph,22,0,38,16
1650031127028,CSE 3,A51,083647,Miranda; Gregory Joseph,37,0,37,0
1650031133052,CSE 8A,A50,083650,Miranda; Gregory Joseph,0,14,40,40
1650031139075,CSE 11,A01,083080,Cao; Yingjun,0,60,40,40
1650031145098,CSE 12,A01,083652,Staff,2,0,100,98
1650031151123,CSE 15L,A01,083654,Staff,0,0,50,50
1650031151123,CSE 15L,A02,083655,Staff,15,0,50,35
1650031157162,CSE 20,A01,083657,Staff,57,0,80,23
1650031163185,CSE 30,A01,083084,Eldon; John,0,62,40,40
1650031169209,CSE 100,A01,083659,Cao; Yingjun,0,57,50,50
1650031175239,CSE 134B,A01,083661,Powell; Thomas Allan,0,25,65,65
1650031181263,CSE 140,A01,083663,Staff,8,0,75,67
1650031187288,CSE 140L,A01,083088,Eldon; John,4,0,75,71
1650031193312,CSE 175,A01,083665,Kumar; Rakesh,10,0,25,15
1650031199339,CSE 190,A00,092507,Dubnov; Shlomo,17,0,20,3
1650031205365,ECE 45,A01,083139,Staff,0,10,40,40
1650031211408,ECE 65,A50,083695,Staff,0,1,30,30
1650031217442,ECE 109,A01,091882,Touri; Behrouz,48,0,70,22
1650031223470,ECE 180,A00,083140,Abi Samra; Nicholas Camill,26,0,30,4
1650031223470,ECE 180,B00,083141,Abi Samra; Nicholas Camill,10,0,30,20
1650031229497,MATH 10A,A01,083735,Patchell; Gregory David,14,0,30,16
1650031229497,MATH 10A,A02,083736,Patchell; Gregory David,28,0,30,2
1650031229497,MATH 10A,A03,083737,Patchell; Gregory David,27,0,30,3
1650031235527,MATH 10B,A01,083207,Staff,0,4,30,30
1650031235527,MATH 10B,A02,083208,Staff,0,0,30,30
1650031235527,MATH 10B,B01,083739,Staff,20,0,30,10
1650031235527,MATH 10B,B02,083740,Staff,30,0,30,0
1650031241560,MATH 18,A01,083743,Staff,10,0,30,20
1650031241560,MATH 18,A02,083744,Staff,28,0,30,2
1650031241560,MATH 18,A03,083745,Staff,23,0,30,7
1650031241560,MATH 18,A04,083746,Staff,27,0,30,3
1650031241560,MATH 18,B01,083748,Staff,0,8,30,30
1650031241560,MATH 18,B02,083749,Staff,0,6,30,30
1650031241560,MATH 18,B03,083750,Staff,0,6,30,30
1650031241560,MATH 18,B04,083751,Staff,1,7,30,29
1650031247584,MATH 20A,A01,083754,Staff,27,0,40,13
1650031253609,MATH 20B,A01,083756,Staff,0,4,30,30
1650031253609,MATH 20B,A02,083757,Staff,4,0,30,26
1650031259636,MATH 20C,A01,083760,Staff,0,9,30,30
1650031259636,MATH 20C,A02,083761,Staff,0,10,30,30
1650031259636,MATH 20C,B01,083762,Staff,17,0,30,13
1650031259636,MATH 20C,B02,083763,Staff,28,0,30,2
1650031265666,MATH 20D,A01,083765,Staff,0,2,30,30
1650031265666,MATH 20D,A02,083766,Staff,16,0,30,14
1650031265666,MATH 20D,A03,083767,Staff,28,0,30,2
1650031271695,MATH 20E,A01,083771,Staff,11,0,30,19
1650031271695,MATH 20E,A02,083772,Staff,20,0,30,10
1650031271695,MATH 20E,B01,083773,Staff,0,1,30,30
1650031271695,MATH 20E,B02,083774,Staff,19,0,30,11
1650031277723,MATH 103A,A01,083777,Staff,0,6,30,30
1650031277723,MATH 103A,A02,083778,Staff,0,7,30,30
1650031277723,MATH 103A,B01,083779,Staff,0,7,30,30
1650031277723,MATH 103A,B02,083780,Staff,0,6,30,30
1650031283765,MATH 105,A01,085443,Staff,0,11,30,30
1650031289798,MATH 109,A01,083213,Anzaldo; Leesa B,0,3,30,30
1650031289798,MATH 109,A02,083214,Anzaldo; Leesa B,0,4,30,30
1650031289798,MATH 109,B01,083215,Anzaldo; Leesa B,0,2,30,30
1650031289798,MATH 109,B02,083216,Anzaldo; Leesa B,0,2,30,30
1650031295824,MATH 142A,A01,083219,Chow; Bennett,0,7,30,30
1650031295824,MATH 142A,A02,083220,Chow; Bennett,0,7,30,30
1650031295824,MATH 142A,B01,083221,Chow; Bennett,0,8,30,30
1650031295824,MATH 142A,B02,083222,Chow; Bennett,0,7,30,30
1650031301851,MATH 193A,A01,083224,Staff,0,5,30,30
1650031301851,MATH 193A,A02,083225,Staff,0,4,30,30
1650031301851,MATH 193A,A03,083781,Staff,0,0,30,30
1650031301851,MATH 193A,A04,083782,Staff,9,0,30,21
1650031307882,MATH 197,001,091859,McAuley; Julian John,9999,0,9999,0
1650031313935,COGS 9,A01,083615,Staff,1,15,60,59
1650031319963,COGS 11,A01,083617,Boyle; Mary E. T.,25,0,40,15
1650031325992,COGS 13,A01,083071,Staff,0,28,40,40
1650031332016,COGS 14A,A01,092681,Staff,0,6,100,100
1650031338042,COGS 14B,A01,083073,Cheng; Tzu-Han,0,2,50,50
1650031344077,COGS 17,A01,092677,Staff,35,0,75,40
1650031350101,COGS 100,A01,083619,Staff,0,18,60,60
1650031356125,COGS 101A,A01,083621,Davis; Joshua Daniel,0,16,60,60
1650031362152,COGS 101B,A01,091572,Staff,16,0,60,44
1650031368181,COGS 101C,A01,083625,Delgado; Tania,21,0,30,9
1650031374205,COGS 107A,A01,083627,Boyle; Mary E. T.,0,1,60,60
1650031380229,COGS 118A,A01,083075,Staff,19,0,60,41
1650031386260,CSE 3,A50,083646,Miranda; Gregory Joseph,22,0,38,16
1650031386260,CSE 3,A51,083647,Miranda; Gregory Joseph,37,0,37,0
1650031392283,CSE 8A,A50,083650,Miranda; Gregory Joseph,0,14,40,40
1650031398310,CSE 11,A01,083080,Cao; Yingjun,0,60,40,40
1650031404343,CSE 12,A01,083652,Staff,2,0,100,98
1650031410371,CSE 15L,A01,083654,Staff,0,0,50,50
1650031410371,CSE 15L,A02,083655,Staff,15,0,50,35
1650031416397,CSE 20,A01,083657,Staff,57,0,80,23
1650031422425,CSE 30,A01,083084,Eldon; John,0,62,40,40
1650031428448,CSE 100,A01,083659,Cao; Yingjun,0,57,50,50
1650031434480,CSE 134B,A01,083661,Powell; Thomas Allan,0,25,65,65
1650031440508,CSE 140,A01,083663,Staff,8,0,75,67
1650031446531,CSE 140L,A01,083088,Eldon; John,4,0,75,71
1650031452560,CSE 175,A01,083665,Kumar; Rakesh,10,0,25,15
1650031458583,CSE 190,A00,092507,Dubnov; Shlomo,17,0,20,3
1650031464611,ECE 45,A01,083139,Staff,0,10,40,40
1650031470638,ECE 65,A50,083695,Staff,0,1,30,30
1650031476664,ECE 109,A01,091882,Touri; Behrouz,48,0,70,22
1650031482687,ECE 180,A00,083140,Abi Samra; Nicholas Camill,26,0,30,4
1650031482687,ECE 180,B00,083141,Abi Samra; Nicholas Camill,10,0,30,20
1650031488717,MATH 10A,A01,083735,Patchell; Gregory David,14,0,30,16
1650031488717,MATH 10A,A02,083736,Patchell; Gregory David,28,0,30,2
1650031488717,MATH 10A,A03,083737,Patchell; Gregory David,27,0,30,3
1650031494753,MATH 10B,A01,083207,Staff,0,4,30,30
1650031494753,MATH 10B,A02,083208,Staff,0,0,30,30
1650031494753,MATH 10B,B01,083739,Staff,20,0,30,10
1650031494753,MATH 10B,B02,083740,Staff,30,0,30,0
1650031500783,MATH 18,A01,083743,Staff,10,0,30,20
1650031500783,MATH 18,A02,083744,Staff,28,0,30,2
1650031500783,MATH 18,A03,083745,Staff,23,0,30,7
1650031500783,MATH 18,A04,083746,Staff,27,0,30,3
1650031500783,MATH 18,B01,083748,Staff,0,8,30,30
1650031500783,MATH 18,B02,083749,Staff,0,6,30,30
1650031500783,MATH 18,B03,083750,Staff,0,6,30,30
1650031500783,MATH 18,B04,083751,Staff,1,7,30,29
1650031506808,MATH 20A,A01,083754,Staff,27,0,40,13
1650031512831,MATH 20B,A01,083756,Staff,0,4,30,30
1650031512831,MATH 20B,A02,083757,Staff,4,0,30,26
1650031518853,MATH 20C,A01,083760,Staff,0,9,30,30
1650031518853,MATH 20C,A02,083761,Staff,0,11,30,30
1650031518853,MATH 20C,B01,083762,Staff,17,0,30,13
1650031518853,MATH 20C,B02,083763,Staff,28,0,30,2
1650031524880,MATH 20D,A01,083765,Staff,0,2,30,30
1650031524880,MATH 20D,A02,083766,Staff,16,0,30,14
1650031524880,MATH 20D,A03,083767,Staff,28,0,30,2
1650031530905,MATH 20E,A01,083771,Staff,11,0,30,19
1650031530905,MATH 20E,A02,083772,Staff,20,0,30,10
1650031530905,MATH 20E,B01,083773,Staff,0,1,30,30
1650031530905,MATH 20E,B02,083774,Staff,19,0,30,11
1650031536933,MATH 103A,A01,083777,Staff,0,6,30,30
1650031536933,MATH 103A,A02,083778,Staff,0,7,30,30
1650031536933,MATH 103A,B01,083779,Staff,0,7,30,30
1650031536933,MATH 103A,B02,083780,Staff,0,6,30,30
1650031542961,MATH 105,A01,085443,Staff,0,11,30,30
1650031548989,MATH 109,A01,083213,Anzaldo; Leesa B,0,3,30,30
1650031548989,MATH 109,A02,083214,Anzaldo; Leesa B,0,4,30,30
1650031548989,MATH 109,B01,083215,Anzaldo; Leesa B,0,2,30,30
1650031548989,MATH 109,B02,083216,Anzaldo; Leesa B,0,2,30,30
1650031555014,MATH 142A,A01,083219,Chow; Bennett,0,7,30,30
1650031555014,MATH 142A,A02,083220,Chow; Bennett,0,7,30,30
1650031555014,MATH 142A,B01,083221,Chow; Bennett,0,8,30,30
1650031555014,MATH 142A,B02,083222,Chow; Bennett,0,7,30,30
1650031561116,MATH 193A,A01,083224,Staff,0,5,30,30
1650031561116,MATH 193A,A02,083225,Staff,0,4,30,30
1650031561116,MATH 193A,A03,083781,Staff,0,0,30,30
1650031561116,MATH 193A,A04,083782,Staff,9,0,30,21
1650031567142,MATH 197,001,091859,McAuley; Julian John,9999,0,9999,0
1650031573195,COGS 9,A01,083615,Staff,1,15,60,59
1650031579220,COGS 11,A01,083617,Boyle; Mary E. T.,25,0,40,15
1650031585244,COGS 13,A01,083071,Staff,0,28,40,40
1650031591271,COGS 14A,A01,092681,Staff,0,6,100,100
1650031597294,COGS 14B,A01,083073,Cheng; Tzu-Han,0,2,50,50
1650031603321,COGS 17,A01,092677,Staff,35,0,75,40
1650031609358,COGS 100,A01,083619,Staff,0,18,60,60
1650031615386,COGS 101A,A01,083621,Davis; Joshua Daniel,0,16,60,60
1650031621412,COGS 101B,A01,091572,Staff,16,0,60,44
1650031627450,COGS 101C,A01,083625,Delgado; Tania,21,0,30,9
1650031633474,COGS 107A,A01,083627,Boyle; Mary E. T.,0,1,60,60
1650031639505,COGS 118A,A01,083075,Staff,19,0,60,41
1650031645533,CSE 3,A50,083646,Miranda; Gregory Joseph,22,0,38,16
1650031645533,CSE 3,A51,083647,Miranda; Gregory Joseph,37,0,37,0
1650031651559,CSE 8A,A50,083650,Miranda; Gregory Joseph,0,14,40,40
1650031657582,CSE 11,A01,083080,Cao; Yingjun,0,60,40,40
1650031663606,CSE 12,A01,083652,Staff,2,0,100,98
1650031669631,CSE 15L,A01,083654,Staff,0,0,50,50
1650031669631,CSE 15L,A02,083655,Staff,15,0,50,35
1650031675654,CSE 20,A01,083657,Staff,57,0,80,23
1650031681685,CSE 30,A01,083084,Eldon; John,0,62,40,40
1650031687712,CSE 100,A01,083659,Cao; Yingjun,0,57,50,50
1650031693738,CSE 134B,A01,083661,Powell; Thomas Allan,0,25,65,65
1650031699764,CSE 140,A01,083663,Staff,8,0,75,67
1650031705785,CSE 140L,A01,083088,Eldon; John,4,0,75,71
1650031711810,CSE 175,A01,083665,Kumar; Rakesh,10,0,25,15
1650031717837,CSE 190,A00,092507,Dubnov; Shlomo,17,0,20,3
1650031723863,ECE 45,A01,083139,Staff,0,10,40,40
1650031729886,ECE 65,A50,083695,Staff,0,1,30,30
1650031735909,ECE 109,A01,091882,Touri; Behrouz,48,0,70,22
1650031741937,ECE 180,A00,083140,Abi Samra; Nicholas Camill,26,0,30,4
1650031741937,ECE 180,B00,083141,Abi Samra; Nicholas Camill,10,0,30,20
1650031747965,MATH 10A,A01,083735,Patchell; Gregory David,14,0,30,16
1650031747965,MATH 10A,A02,083736,Patchell; Gregory David,28,0,30,2
1650031747965,MATH 10A,A03,083737,Patchell; Gregory David,27,0,30,3
1650031753989,MATH 10B,A01,083207,Staff,0,4,30,30
1650031753989,MATH 10B,A02,083208,Staff,0,0,30,30
1650031753989,MATH 10B,B01,083739,Staff,20,0,30,10
1650031753989,MATH 10B,B02,083740,Staff,30,0,30,0
1650031760016,MATH 18,A01,083743,Staff,10,0,30,20
1650031760016,MATH 18,A02,083744,Staff,28,0,30,2
1650031760016,MATH 18,A03,083745,Staff,23,0,30,7
1650031760016,MATH 18,A04,083746,Staff,27,0,30,3
1650031760016,MATH 18,B01,083748,Staff,0,8,30,30
1650031760016,MATH 18,B02,083749,Staff,0,6,30,30
1650031760016,MATH 18,B03,083750,Staff,0,6,30,30
1650031760016,MATH 18,B04,083751,Staff,1,7,30,29
1650031766042,MATH 20A,A01,083754,Staff,27,0,40,13
1650031772070,MATH 20B,A01,083756,Staff,0,4,30,30
1650031772070,MATH 20B,A02,083757,Staff,4,0,30,26
1650031778100,MATH 20C,A01,083760,Staff,0,9,30,30
1650031778100,MATH 20C,A02,083761,Staff,0,11,30,30
1650031778100,MATH 20C,B01,083762,Staff,17,0,30,13
1650031778100,MATH 20C,B02,083763,Staff,28,0,30,2
1650031784123,MATH 20D,A01,083765,Staff,0,2,30,30
1650031784123,MATH 20D,A02,083766,Staff,16,0,30,14
1650031784123,MATH 20D,A03,083767,Staff,28,0,30,2
1650031790146,MATH 20E,A01,083771,Staff,11,0,30,19
1650031790146,MATH 20E,A02,083772,Staff,20,0,30,10
1650031790146,MATH 20E,B01,083773,Staff,0,1,30,30
1650031790146,MATH 20E,B02,083774,Staff,19,0,30,11
1650031796171,MATH 103A,A01,083777,Staff,0,6,30,30
1650031796171,MATH 103A,A02,083778,Staff,0,7,30,30
1650031796171,MATH 103A,B01,083779,Staff,0,7,30,30
1650031796171,MATH 103A,B02,083780,Staff,0,6,30,30
1650031802196,MATH 105,A01,085443,Staff,0,11,30,30
1650031808220,MATH 109,A01,083213,Anzaldo; Leesa B,0,3,30,30
1650031808220,MATH 109,A02,083214,Anzaldo; Leesa B,0,4,30,30
1650031808220,MATH 109,B01,083215,Anzaldo; Leesa B,0,2,30,30
1650031808220,MATH 109,B02,083216,Anzaldo; Leesa B,0,2,30,30
1650031814249,MATH 142A,A01,083219,Chow; Bennett,0,7,30,30
1650031814249,MATH 142A,A02,083220,Chow; Bennett,0,7,30,30
1650031814249,MATH 142A,B01,083221,Chow; Bennett,0,8,30,30
1650031814249,MATH 142A,B02,083222,Chow; Bennett,0,7,30,30
1650031820270,MATH 193A,A01,083224,Staff,0,5,30,30
1650031820270,MATH 193A,A02,083225,Staff,0,4,30,30
1650031820270,MATH 193A,A03,083781,Staff,0,0,30,30
1650031820270,MATH 193A,A04,083782,Staff,9,0,30,21
1650031826293,MATH 197,001,091859,McAuley; Julian John,9999,0,9999,0
1650031832363,COGS 9,A01,083615,Staff,1,15,60,59
1650031838386,COGS 11,A01,083617,Boyle; Mary E. T.,25,0,40,15
1650031844416,COGS 13,A01,083071,Staff,0,28,40,40
1650031850440,COGS 14A,A01,092681,Staff,0,6,100,100
1650031856464,COGS 14B,A01,083073,Cheng; Tzu-Han,0,2,50,50
1650031862487,COGS 17,A01,092677,Staff,35,0,75,40
1650031868512,COGS 100,A01,083619,Staff,0,18,60,60
1650031874540,COGS 101A,A01,083621,Davis; Joshua Daniel,0,16,60,60
1650031880567,COGS 101B,A01,091572,Staff,16,0,60,44
1650031886594,COGS 101C,A01,083625,Delgado; Tania,21,0,30,9
1650031892620,COGS 107A,A01,083627,Boyle; Mary E. T.,0,1,60,60
1650031898643,COGS 118A,A01,083075,Staff,19,0,60,41
1650031904667,CSE 3,A50,083646,Miranda; Gregory Joseph,22,0,38,16
1650031904667,CSE 3,A51,083647,Miranda; Gregory Joseph,37,0,37,0
1650031910692,CSE 8A,A50,083650,Miranda; Gregory Joseph,0,14,40,40
1650031916717,CSE 11,A01,083080,Cao; Yingjun,0,60,40,40
1650031922741,CSE 12,A01,083652,Staff,2,0,100,98
1650031928771,CSE 15L,A01,083654,Staff,0,0,50,50
1650031928771,CSE 15L,A02,083655,Staff,15,0,50,35
1650031934796,CSE 20,A01,083657,Staff,57,0,80,23
1650031940824,CSE 30,A01,083084,Eldon; John,0,62,40,40
1650031946847,CSE 100,A01,083659,Cao; Yingjun,0,57,50,50
1650031952871,CSE 134B,A01,083661,Powell; Thomas Allan,0,25,65,65
1650031958897,CSE 140,A01,083663,Staff,8,0,75,67
1650031964925,CSE 140L,A01,083088,Eldon; John,4,0,75,71
1650031970953,CSE 175,A01,083665,Kumar; Rakesh,10,0,25,15
1650031976977,CSE 190,A00,092507,Dubnov; Shlomo,17,0,20,3
1650031983003,ECE 45,A01,083139,Staff,0,10,40,40
1650031989027,ECE 65,A50,083695,Staff,0,1,30,30
1650031995051,ECE 109,A01,091882,Touri; Behrouz,48,0,70,22
1650032001080,ECE 180,A00,083140,Abi Samra; Nicholas Camill,26,0,30,4
1650032001080,ECE 180,B00,083141,Abi Samra; Nicholas Camill,10,0,30,20
1650032007108,MATH 10A,A01,083735,Patchell; Gregory David,14,0,30,16
1650032007108,MATH 10A,A02,083736,Patchell; Gregory David,28,0,30,2
1650032007108,MATH 10A,A03,083737,Patchell; Gregory David,27,0,30,3
1650032013137,MATH 10B,A01,083207,Staff,0,4,30,30
1650032013137,MATH 10B,A02,083208,Staff,0,0,30,30
1650032013137,MATH 10B,B01,083739,Staff,20,0,30,10
1650032013137,MATH 10B,B02,083740,Staff,30,0,30,0
1650032019162,MATH 18,A01,083743,Staff,10,0,30,20
1650032019162,MATH 18,A02,083744,Staff,28,0,30,2
1650032019162,MATH 18,A03,083745,Staff,23,0,30,7
1650032019162,MATH 18,A04,083746,Staff,27,0,30,3
1650032019162,MATH 18,B01,083748,Staff,0,8,30,30
1650032019162,MATH 18,B02,083749,Staff,0,6,30,30
1650032019162,MATH 18,B03,083750,Staff,0,6,30,30
1650032019162,MATH 18,B04,083751,Staff,1,7,30,29
1650032025186,MATH 20A,A01,083754,Staff,27,0,40,13
1650032031219,MATH 20B,A01,083756,Staff,0,4,30,30
1650032031219,MATH 20B,A02,083757,Staff,4,0,30,26
1650032037247,MATH 20C,A01,083760,Staff,0,9,30,30
1650032037247,MATH 20C,A02,083761,Staff,0,11,30,30
1650032037247,MATH 20C,B01,083762,Staff,17,0,30,13
1650032037247,MATH 20C,B02,083763,Staff,28,0,30,2
1650032043275,MATH 20D,A01,083765,Staff,0,2,30,30
1650032043275,MATH 20D,A02,083766,Staff,16,0,30,14
1650032043275,MATH 20D,A03,083767,Staff,28,0,30,2
1650032049302,MATH 20E,A01,083771,Staff,11,0,30,19
1650032049302,MATH 20E,A02,083772,Staff,20,0,30,10
1650032049302,MATH 20E,B01,083773,Staff,0,1,30,30
1650032049302,MATH 20E,B02,083774,Staff,19,0,30,11
1650032055327,MATH 103A,A01,083777,Staff,0,6,30,30
1650032055327,MATH 103A,A02,083778,Staff,0,7,30,30
1650032055327,MATH 103A,B01,083779,Staff,0,7,30,30
1650032055327,MATH 103A,B02,083780,Staff,0,6,30,30
1650032061350,MATH 105,A01,085443,Staff,0,11,30,30
1650032067386,MATH 109,A01,083213,Anzaldo; Leesa B,0,3,30,30
1650032067386,MATH 109,A02,083214,Anzaldo; Leesa B,0,4,30,30
1650032067386,MATH 109,B01,083215,Anzaldo; Leesa B,0,2,30,30
1650032067386,MATH 109,B02,083216,Anzaldo; Leesa B,0,2,30,30
1650032073411,MATH 142A,A01,083219,Chow; Bennett,0,7,30,30
1650032073411,MATH 142A,A02,083220,Chow; Bennett,0,7,30,30
1650032073411,MATH 142A,B01,083221,Chow; Bennett,0,8,30,30
1650032073411,MATH 142A,B02,083222,Chow; Bennett,0,7,30,30
1650032079446,MATH 193A,A01,083224,Staff,0,5,30,30
1650032079446,MATH 193A,A02,083225,Staff,0,4,30,30
1650032079446,MATH 193A,A03,083781,Staff,0,0,30,30
1650032079446,MATH 193A,A04,083782,Staff,9,0,30,21
1650032085471,MATH 197,001,091859,McAuley; Julian John,9999,0,9999,0
1650032091538,COGS 9,A01,083615,Staff,1,15,60,59
1650032097562,COGS 11,A01,083617,Boyle; Mary E. T.,25,0,40,15
1650032103594,COGS 13,A01,083071,Staff,0,28,40,40
1650032109620,COGS 14A,A01,092681,Staff,0,6,100,100
1650032115651,COGS 14B,A01,083073,Cheng; Tzu-Han,0,2,50,50
1650032121677,COGS 17,A01,092677,Staff,35,0,75,40
1650032135907,COGS 100,A01,083619,Staff,0,18,60,60
1650032141946,COGS 101A,A01,083621,Davis; Joshua Daniel,0,16,60,60
1650032147970,COGS 101B,A01,091572,Staff,16,0,60,44
1650032153994,COGS 101C,A01,083625,Delgado; Tania,21,0,30,9
1650032160088,COGS 107A,A01,083627,Boyle; Mary E. T.,0,1,60,60
1650032166118,COGS 118A,A01,083075,Staff,19,0,60,41
1650032172141,CSE 3,A50,083646,Miranda; Gregory Joseph,22,0,38,16
1650032172141,CSE 3,A51,083647,Miranda; Gregory Joseph,37,0,37,0
1650032178177,CSE 8A,A50,083650,Miranda; Gregory Joseph,0,14,40,40
1650032184208,CSE 11,A01,083080,Cao; Yingjun,0,60,40,40
1650032190237,CSE 12,A01,083652,Staff,2,0,100,98
1650032196264,CSE 15L,A01,083654,Staff,0,0,50,50
1650032196264,CSE 15L,A02,083655,Staff,15,0,50,35
1650032202293,CSE 20,A01,083657,Staff,57,0,80,23
1650032208323,CSE 30,A01,083084,Eldon; John,0,62,40,40
1650032214346,CSE 100,A01,083659,Cao; Yingjun,0,57,50,50
1650032220375,CSE 134B,A01,083661,Powell; Thomas Allan,0,25,65,65
1650032226399,CSE 140,A01,083663,Staff,8,0,75,67
1650032232422,CSE 140L,A01,083088,Eldon; John,4,0,75,71
1650032238446,CSE 175,A01,083665,Kumar; Rakesh,10,0,25,15
1650032244473,CSE 190,A00,092507,Dubnov; Shlomo,17,0,20,3
1650032250500,ECE 45,A01,083139,Staff,0,10,40,40
1650032256538,ECE 65,A50,083695,Staff,0,1,30,30
1650032262567,ECE 109,A01,091882,Touri; Behrouz,48,0,70,22
1650032268594,ECE 180,A00,083140,Abi Samra; Nicholas Camill,26,0,30,4
1650032268594,ECE 180,B00,083141,Abi Samra; Nicholas Camill,10,0,30,20
1650032274623,MATH 10A,A01,083735,Patchell; Gregory David,14,0,30,16
1650032274623,MATH 10A,A02,083736,Patchell; Gregory David,28,0,30,2
1650032274623,MATH 10A,A03,083737,Patchell; Gregory David,27,0,30,3
1650032280648,MATH 10B,A01,083207,Staff,0,4,30,30
1650032280648,MATH 10B,A02,083208,Staff,0,0,30,30
1650032280648,MATH 10B,B01,083739,Staff,20,0,30,10
1650032280648,MATH 10B,B02,083740,Staff,30,0,30,0
1650032286680,MATH 18,A01,083743,Staff,10,0,30,20
1650032286680,MATH 18,A02,083744,Staff,28,0,30,2
1650032286680,MATH 18,A03,083745,Staff,23,0,30,7
1650032286680,MATH 18,A04,083746,Staff,27,0,30,3
1650032286680,MATH 18,B01,083748,Staff,0,8,30,30
1650032286680,MATH 18,B02,083749,Staff,0,6,30,30
1650032286680,MATH 18,B03,083750,Staff,0,6,30,30
1650032286680,MATH 18,B04,083751,Staff,1,7,30,29
1650032292707,MATH 20A,A01,083754,Staff,27,0,40,13
1650032298729,MATH 20B,A01,083756,Staff,0,4,30,30
1650032298729,MATH 20B,A02,083757,Staff,4,0,30,26
1650032304757,MATH 20C,A01,083760,Staff,0,9,30,30
1650032304757,MATH 20C,A02,083761,Staff,0,11,30,30
1650032304757,MATH 20C,B01,083762,Staff,17,0,30,13
1650032304757,MATH 20C,B02,083763,Staff,28,0,30,2
1650032310780,MATH 20D,A01,083765,Staff,0,2,30,30
1650032310780,MATH 20D,A02,083766,Staff,16,0,30,14
1650032310780,MATH 20D,A03,083767,Staff,28,0,30,2
1650032316809,MATH 20E,A01,083771,Staff,11,0,30,19
1650032316809,MATH 20E,A02,083772,Staff,20,0,30,10
1650032316809,MATH 20E,B01,083773,Staff,0,1,30,30
1650032316809,MATH 20E,B02,083774,Staff,19,0,30,11
1650032322839,MATH 103A,A01,083777,Staff,0,6,30,30
1650032322839,MATH 103A,A02,083778,Staff,0,7,30,30
1650032322839,MATH 103A,B01,083779,Staff,0,7,30,30
1650032322839,MATH 103A,B02,083780,Staff,0,6,30,30
1650032328866,MATH 105,A01,085443,Staff,0,11,30,30
1650032334891,MATH 109,A01,083213,Anzaldo; Leesa B,0,3,30,30
1650032334891,MATH 109,A02,083214,Anzaldo; Leesa B,0,4,30,30
1650032334891,MATH 109,B01,083215,Anzaldo; Leesa B,0,2,30,30
1650032334891,MATH 109,B02,083216,Anzaldo; Leesa B,0,2,30,30
1650032340932,MATH 142A,A01,083219,Chow; Bennett,0,7,30,30
1650032340932,MATH 142A,A02,083220,Chow; Bennett,0,7,30,30
1650032340932,MATH 142A,B01,083221,Chow; Bennett,0,8,30,30
1650032340932,MATH 142A,B02,083222,Chow; Bennett,0,7,30,30
1650032346957,MATH 193A,A01,083224,Staff,0,5,30,30
1650032346957,MATH 193A,A02,083225,Staff,0,4,30,30
1650032346957,MATH 193A,A03,083781,Staff,0,0,30,30
1650032346957,MATH 193A,A04,083782,Staff,9,0,30,21
1650032352981,MATH 197,001,091859,McAuley; Julian John,9999,0,9999,0
1650032359056,COGS 9,A01,083615,Staff,1,15,60,59
1650032365083,COGS 11,A01,083617,Boyle; Mary E. T.,25,0,40,15
1650032371108,COGS 13,A01,083071,Staff,0,28,40,40
1650032377136,COGS 14A,A01,092681,Staff,0,6,100,100
1650032383162,COGS 14B,A01,083073,Cheng; Tzu-Han,0,2,50,50
1650032389186,COGS 17,A01,092677,Staff,35,0,75,40
1650032395210,COGS 100,A01,083619,Staff,0,18,60,60
1650032401244,COGS 101A,A01,083621,Davis; Joshua Daniel,0,16,60,60
1650032407270,COGS 101B,A01,091572,Staff,16,0,60,44
1650032413295,COGS 101C,A01,083625,Delgado; Tania,21,0,30,9
1650032419321,COGS 107A,A01,083627,Boyle; Mary E. T.,0,1,60,60
1650032425356,COGS 118A,A01,083075,Staff,19,0,60,41
1650032431383,CSE 3,A50,083646,Miranda; Gregory Joseph,22,0,38,16
1650032431383,CSE 3,A51,083647,Miranda; Gregory Joseph,37,0,37,0
1650032437419,CSE 8A,A50,083650,Miranda; Gregory Joseph,0,14,40,40
1650032443446,CSE 11,A01,083080,Cao; Yingjun,0,60,40,40
1650032449473,CSE 12,A01,083652,Staff,2,0,100,98
1650032455499,CSE 15L,A01,083654,Staff,0,0,50,50
1650032455499,CSE 15L,A02,083655,Staff,15,0,50,35
1650032461525,CSE 20,A01,083657,Staff,57,0,80,23
1650032467554,CSE 30,A01,083084,Eldon; John,0,62,40,40
1650032473578,CSE 100,A01,083659,Cao; Yingjun,0,57,50,50
1650032479602,CSE 134B,A01,083661,Powell; Thomas Allan,0,25,65,65
1650032485633,CSE 140,A01,083663,Staff,8,0,75,67
1650032491656,CSE 140L,A01,083088,Eldon; John,4,0,75,71
1650032497680,CSE 175,A01,083665,Kumar; Rakesh,10,0,25,15
1650032503703,CSE 190,A00,092507,Dubnov; Shlomo,17,0,20,3
1650032509726,ECE 45,A01,083139,Staff,0,10,40,40
1650032515754,ECE 65,A50,083695,Staff,0,1,30,30
1650032521781,ECE 109,A01,091882,Touri; Behrouz,48,0,70,22
1650032527805,ECE 180,A00,083140,Abi Samra; Nicholas Camill,26,0,30,4
1650032527805,ECE 180,B00,083141,Abi Samra; Nicholas Camill,10,0,30,20
1650032533829,MATH 10A,A01,083735,Patchell; Gregory David,14,0,30,16
1650032533829,MATH 10A,A02,083736,Patchell; Gregory David,28,0,30,2
1650032533829,MATH 10A,A03,083737,Patchell; Gregory David,27,0,30,3
1650032539859,MATH 10B,A01,083207,Staff,0,4,30,30
1650032539859,MATH 10B,A02,083208,Staff,0,0,30,30
1650032539859,MATH 10B,B01,083739,Staff,20,0,30,10
1650032539859,MATH 10B,B02,083740,Staff,30,0,30,0
1650032545889,MATH 18,A01,083743,Staff,10,0,30,20
1650032545889,MATH 18,A02,083744,Staff,28,0,30,2
1650032545889,MATH 18,A03,083745,Staff,23,0,30,7
1650032545889,MATH 18,A04,083746,Staff,27,0,30,3
1650032545889,MATH 18,B01,083748,Staff,0,8,30,30
1650032545889,MATH 18,B02,083749,Staff,0,6,30,30
1650032545889,MATH 18,B03,083750,Staff,0,6,30,30
1650032545889,MATH 18,B04,083751,Staff,1,7,30,29
1650032551920,MATH 20A,A01,083754,Staff,27,0,40,13
1650032557944,MATH 20B,A01,083756,Staff,0,4,30,30
1650032557944,MATH 20B,A02,083757,Staff,3,0,30,27
1650032563973,MATH 20C,A01,083760,Staff,0,9,30,30
1650032563973,MATH 20C,A02,083761,Staff,0,11,30,30
1650032563973,MATH 20C,B01,083762,Staff,17,0,30,13
1650032563973,MATH 20C,B02,083763,Staff,28,0,30,2
1650032569995,MATH 20D,A01,083765,Staff,0,2,30,30
1650032569995,MATH 20D,A02,083766,Staff,16,0,30,14
1650032569995,MATH 20D,A03,083767,Staff,28,0,30,2
1650032576020,MATH 20E,A01,083771,Staff,11,0,30,19
1650032576020,MATH 20E,A02,083772,Staff,20,0,30,10
1650032576020,MATH 20E,B01,083773,Staff,0,1,30,30
1650032576020,MATH 20E,B02,083774,Staff,19,0,30,11
1650032582044,MATH 103A,A01,083777,Staff,0,6,30,30
1650032582044,MATH 103A,A02,083778,Staff,0,7,30,30
1650032582044,MATH 103A,B01,083779,Staff,0,7,30,30
1650032582044,MATH 103A,B02,083780,Staff,0,6,30,30
1650032588071,MATH 105,A01,085443,Staff,0,11,30,30
1650032594102,MATH 109,A01,083213,Anzaldo; Leesa B,0,3,30,30
1650032594102,MATH 109,A02,083214,Anzaldo; Leesa B,0,4,30,30
1650032594102,MATH 109,B01,083215,Anzaldo; Leesa B,0,2,30,30
1650032594102,MATH 109,B02,083216,Anzaldo; Leesa B,0,2,30,30
1650032600126,MATH 142A,A01,083219,Chow; Bennett,0,7,30,30
1650032600126,MATH 142A,A02,083220,Chow; Bennett,0,7,30,30
1650032600126,MATH 142A,B01,083221,Chow; Bennett,0,8,30,30
1650032600126,MATH 142A,B02,083222,Chow; Bennett,0,7,30,30
1650032606149,MATH 193A,A01,083224,Staff,0,5,30,30
1650032606149,MATH 193A,A02,083225,Staff,0,4,30,30
1650032606149,MATH 193A,A03,083781,Staff,0,0,30,30
1650032606149,MATH 193A,A04,083782,Staff,9,0,30,21
1650032612171,MATH 197,001,091859,McAuley; Julian John,9999,0,9999,0
1650032618221,COGS 9,A01,083615,Staff,1,15,60,59
1650032624244,COGS 11,A01,083617,Boyle; Mary E. T.,25,0,40,15
1650032630268,COGS 13,A01,083071,Staff,0,28,40,40
1650032636293,COGS 14A,A01,092681,Staff,0,6,100,100
1650032642317,COGS 14B,A01,083073,Cheng; Tzu-Han,0,2,50,50
1650032648340,COGS 17,A01,092677,Staff,35,0,75,40
1650032654375,COGS 100,A01,083619,Staff,0,18,60,60
1650032660397,COGS 101A,A01,083621,Davis; Joshua Daniel,0,16,60,60
1650032666421,COGS 101B,A01,091572,Staff,16,0,60,44
1650032672445,COGS 101C,A01,083625,Delgado; Tania,21,0,30,9
1650032678472,COGS 107A,A01,083627,Boyle; Mary E. T.,0,1,60,60
1650032684498,COGS 118A,A01,083075,Staff,19,0,60,41
1650032690523,CSE 3,A50,083646,Miranda; Gregory Joseph,22,0,38,16
1650032690523,CSE 3,A51,083647,Miranda; Gregory Joseph,37,0,37,0
1650032696551,CSE 8A,A50,083650,Miranda; Gregory Joseph,0,14,40,40
1650032702580,CSE 11,A01,083080,Cao; Yingjun,0,60,40,40
1650032708607,CSE 12,A01,083652,Staff,2,0,100,98
1650032714631,CSE 15L,A01,083654,Staff,0,0,50,50
1650032714631,CSE 15L,A02,083655,Staff,15,0,50,35
1650032720654,CSE 20,A01,083657,Staff,57,0,80,23
1650032726682,CSE 30,A01,083084,Eldon; John,0,62,40,40
1650032732709,CSE 100,A01,083659,Cao; Yingjun,0,57,50,50
1650032738736,CSE 134B,A01,083661,Powell; Thomas Allan,0,25,65,65
1650032744763,CSE 140,A01,083663,Staff,8,0,75,67
1650032750790,CSE 140L,A01,083088,Eldon; John,4,0,75,71
1650032756917,CSE 175,A01,083665,Kumar; Rakesh,10,0,25,15
1650032762946,CSE 190,A00,092507,Dubnov; Shlomo,17,0,20,3
1650032768972,ECE 45,A01,083139,Staff,0,10,40,40
1650032774997,ECE 65,A50,083695,Staff,0,1,30,30
1650032781021,ECE 109,A01,091882,Touri; Behrouz,48,0,70,22
1650032787047,ECE 180,A00,083140,Abi Samra; Nicholas Camill,26,0,30,4
1650032787047,ECE 180,B00,083141,Abi Samra; Nicholas Camill,10,0,30,20
1650032793070,MATH 10A,A01,083735,Patchell; Gregory David,14,0,30,16
1650032793070,MATH 10A,A02,083736,Patchell; Gregory David,28,0,30,2
1650032793070,MATH 10A,A03,083737,Patchell; Gregory David,27,0,30,3
1650032799097,MATH 10B,A01,083207,Staff,0,4,30,30
1650032799097,MATH 10B,A02,083208,Staff,0,0,30,30
1650032799097,MATH 10B,B01,083739,Staff,20,0,30,10
1650032799097,MATH 10B,B02,083740,Staff,30,0,30,0
1650032805123,MATH 18,A01,083743,Staff,10,0,30,20
1650032805123,MATH 18,A02,083744,Staff,28,0,30,2
1650032805123,MATH 18,A03,083745,Staff,23,0,30,7
1650032805123,MATH 18,A04,083746,Staff,27,0,30,3
1650032805123,MATH 18,B01,083748,Staff,0,8,30,30
1650032805123,MATH 18,B02,083749,Staff,0,6,30,30
1650032805123,MATH 18,B03,083750,Staff,0,6,30,30
1650032805123,MATH 18,B04,083751,Staff,1,7,30,29
1650032811150,MATH 20A,A01,083754,Staff,27,0,40,13
1650032817175,MATH 20B,A01,083756,Staff,0,4,30,30
1650032817175,MATH 20B,A02,083757,Staff,3,0,30,27
1650032823202,MATH 20C,A01,083760,Staff,0,9,30,30
1650032823202,MATH 20C,A02,083761,Staff,0,11,30,30
1650032823202,MATH 20C,B01,083762,Staff,17,0,30,13
1650032823202,MATH 20C,B02,083763,Staff,28,0,30,2
1650032829227,MATH 20D,A01,083765,Staff,0,2,30,30
1650032829227,MATH 20D,A02,083766,Staff,16,0,30,14
1650032829227,MATH 20D,A03,083767,Staff,28,0,30,2
1650032835251,MATH 20E,A01,083771,Staff,11,0,30,19
1650032835251,MATH 20E,A02,083772,Staff,20,0,30,10
1650032835251,MATH 20E,B01,083773,Staff,0,1,30,30
1650032835251,MATH 20E,B02,083774,Staff,19,0,30,11
1650032841274,MATH 103A,A01,083777,Staff,0,6,30,30
1650032841274,MATH 103A,A02,083778,Staff,0,7,30,30
1650032841274,MATH 103A,B01,083779,Staff,0,7,30,30
1650032841274,MATH 103A,B02,083780,Staff,0,6,30,30
1650032847301,MATH 105,A01,085443,Staff,0,11,30,30
1650032853332,MATH 109,A01,083213,Anzaldo; Leesa B,0,3,30,30
1650032853332,MATH 109,A02,083214,Anzaldo; Leesa B,0,4,30,30
1650032853332,MATH 109,B01,083215,Anzaldo; Leesa B,0,2,30,30
1650032853332,MATH 109,B02,083216,Anzaldo; Leesa B,0,2,30,30
1650032859355,MATH 142A,A01,083219,Chow; Bennett,0,7,30,30
1650032859355,MATH 142A,A02,083220,Chow; Bennett,0,7,30,30
1650032859355,MATH 142A,B01,083221,Chow; Bennett,0,8,30,30
1650032859355,MATH 142A,B02,083222,Chow; Bennett,0,7,30,30
1650032865378,MATH 193A,A01,083224,Staff,0,5,30,30
1650032865378,MATH 193A,A02,083225,Staff,0,4,30,30
1650032865378,MATH 193A,A03,083781,Staff,0,0,30,30
1650032865378,MATH 193A,A04,083782,Staff,9,0,30,21
1650032871405,MATH 197,001,091859,McAuley; Julian John,9999,0,9999,0
1650032877473,COGS 9,A01,083615,Staff,1,15,60,59
1650032883497,COGS 11,A01,083617,Boyle; Mary E. T.,25,0,40,15
1650032889526,COGS 13,A01,083071,Staff,0,28,40,40
1650032895562,COGS 14A,A01,092681,Staff,0,6,100,100
1650032901586,COGS 14B,A01,083073,Cheng; Tzu-Han,0,2,50,50
1650032907613,COGS 17,A01,092677,Staff,35,0,75,40
1650032913645,COGS 100,A01,083619,Staff,0,18,60,60
1650032919667,COGS 101A,A01,083621,Davis; Joshua Daniel,0,16,60,60
1650032925694,COGS 101B,A01,091572,Staff,16,0,60,44
1650032931717,COGS 101C,A01,083625,Delgado; Tania,21,0,30,9
1650032937739,COGS 107A,A01,083627,Boyle; Mary E. T.,0,1,60,60
1650032943763,COGS 118A,A01,083075,Staff,19,0,60,41
1650032949792,CSE 3,A50,083646,Miranda; Gregory Joseph,22,0,38,16
1650032949792,CSE 3,A51,083647,Miranda; Gregory Joseph,37,0,37,0
1650032955820,CSE 8A,A50,083650,Miranda; Gregory Joseph,0,14,40,40
1650032961843,CSE 11,A01,083080,Cao; Yingjun,0,60,40,40
1650032967867,CSE 12,A01,083652,Staff,2,0,100,98
1650032973891,CSE 15L,A01,083654,Staff,0,0,50,50
1650032973891,CSE 15L,A02,083655,Staff,15,0,50,35
1650032979923,CSE 20,A01,083657,Staff,57,0,80,23
1650032985945,CSE 30,A01,083084,Eldon; John,0,62,40,40
1650032991968,CSE 100,A01,083659,Cao; Yingjun,0,57,50,50
1650032997996,CSE 134B,A01,083661,Powell; Thomas Allan,0,25,65,65
1650033004026,CSE 140,A01,083663,Staff,8,0,75,67
1650033010051,CSE 140L,A01,083088,Eldon; John,4,0,75,71
1650033016083,CSE 175,A01,083665,Kumar; Rakesh,10,0,25,15
1650033022107,CSE 190,A00,092507,Dubnov; Shlomo,17,0,20,3
1650033028136,ECE 45,A01,083139,Staff,0,10,40,40
1650033034158,ECE 65,A50,083695,Staff,0,1,30,30
1650033040182,ECE 109,A01,091882,Touri; Behrouz,48,0,70,22
1650033046206,ECE 180,A00,083140,Abi Samra; Nicholas Camill,26,0,30,4
1650033046206,ECE 180,B00,083141,Abi Samra; Nicholas Camill,10,0,30,20
1650033052233,MATH 10A,A01,083735,Patchell; Gregory David,14,0,30,16
1650033052233,MATH 10A,A02,083736,Patchell; Gregory David,28,0,30,2
1650033052233,MATH 10A,A03,083737,Patchell; Gregory David,27,0,30,3
1650033058263,MATH 10B,A01,083207,Staff,0,4,30,30
1650033058263,MATH 10B,A02,083208,Staff,0,0,30,30
1650033058263,MATH 10B,B01,083739,Staff,20,0,30,10
1650033058263,MATH 10B,B02,083740,Staff,30,0,30,0
1650033064292,MATH 18,A01,083743,Staff,10,0,30,20
1650033064292,MATH 18,A02,083744,Staff,28,0,30,2
1650033064292,MATH 18,A03,083745,Staff,23,0,30,7
1650033064292,MATH 18,A04,083746,Staff,27,0,30,3
1650033064292,MATH 18,B01,083748,Staff,0,8,30,30
1650033064292,MATH 18,B02,083749,Staff,0,6,30,30
1650033064292,MATH 18,B03,083750,Staff,0,6,30,30
1650033064292,MATH 18,B04,083751,Staff,1,7,30,29
1650033070326,MATH 20A,A01,083754,Staff,27,0,40,13
1650033076352,MATH 20B,A01,083756,Staff,0,4,30,30
1650033076352,MATH 20B,A02,083757,Staff,3,0,30,27
1650033082379,MATH 20C,A01,083760,Staff,0,9,30,30
1650033082379,MATH 20C,A02,083761,Staff,0,11,30,30
1650033082379,MATH 20C,B01,083762,Staff,17,0,30,13
1650033082379,MATH 20C,B02,083763,Staff,28,0,30,2
1650033088410,MATH 20D,A01,083765,Staff,0,2,30,30
1650033088410,MATH 20D,A02,083766,Staff,16,0,30,14
1650033088410,MATH 20D,A03,083767,Staff,28,0,30,2
1650033094434,MATH 20E,A01,083771,Staff,11,0,30,19
1650033094434,MATH 20E,A02,083772,Staff,20,0,30,10
1650033094434,MATH 20E,B01,083773,Staff,0,1,30,30
1650033094434,MATH 20E,B02,083774,Staff,19,0,30,11
1650033100469,MATH 103A,A01,083777,Staff,0,6,30,30
1650033100469,MATH 103A,A02,083778,Staff,0,7,30,30
1650033100469,MATH 103A,B01,083779,Staff,0,7,30,30
1650033100469,MATH 103A,B02,083780,Staff,0,6,30,30
1650033106490,MATH 105,A01,085443,Staff,0,11,30,30
1650033112515,MATH 109,A01,083213,Anzaldo; Leesa B,0,3,30,30
1650033112515,MATH 109,A02,083214,Anzaldo; Leesa B,0,4,30,30
1650033112515,MATH 109,B01,083215,Anzaldo; Leesa B,0,2,30,30
1650033112515,MATH 109,B02,083216,Anzaldo; Leesa B,0,2,30,30
1650033118540,MATH 142A,A01,083219,Chow; Bennett,0,7,30,30
1650033118540,MATH 142A,A02,083220,Chow; Bennett,0,7,30,30
1650033118540,MATH 142A,B01,083221,Chow; Bennett,0,8,30,30
1650033118540,MATH 142A,B02,083222,Chow; Bennett,0,7,30,30
1650033124570,MATH 193A,A01,083224,Staff,0,5,30,30
1650033124570,MATH 193A,A02,083225,Staff,0,4,30,30
1650033124570,MATH 193A,A03,083781,Staff,0,0,30,30
1650033124570,MATH 193A,A04,083782,Staff,9,0,30,21
1650033130602,MATH 197,001,091859,McAuley; Julian John,9999,0,9999,0
1650033136661,COGS 9,A01,083615,Staff,1,15,60,59
1650033142684,COGS 11,A01,083617,Boyle; Mary E. T.,25,0,40,15
1650033148730,COGS 13,A01,083071,Staff,0,28,40,40
1650033154753,COGS 14A,A01,092681,Staff,0,6,100,100
1650033160795,COGS 14B,A01,083073,Cheng; Tzu-Han,0,2,50,50
1650033166822,COGS 17,A01,092677,Staff,35,0,75,40
1650033172847,COGS 100,A01,083619,Staff,0,18,60,60
1650033178874,COGS 101A,A01,083621,Davis; Joshua Daniel,0,16,60,60
1650033184897,COGS 101B,A01,091572,Staff,16,0,60,44
1650033190926,COGS 101C,A01,083625,Delgado; Tania,21,0,30,9
1650033196952,COGS 107A,A01,083627,Boyle; Mary E. T.,0,1,60,60
1650033202980,COGS 118A,A01,083075,Staff,19,0,60,41
1650033209004,CSE 3,A50,083646,Miranda; Gregory Joseph,22,0,38,16
1650033209004,CSE 3,A51,083647,Miranda; Gregory Joseph,37,0,37,0
1650033215031,CSE 8A,A50,083650,Miranda; Gregory Joseph,0,14,40,40
1650033221060,CSE 11,A01,083080,Cao; Yingjun,0,60,40,40
1650033227124,CSE 12,A01,083652,Staff,2,0,100,98
1650033233152,CSE 15L,A01,083654,Staff,0,0,50,50
1650033233152,CSE 15L,A02,083655,Staff,15,0,50,35
1650033239177,CSE 20,A01,083657,Staff,57,0,80,23
1650033245206,CSE 30,A01,083084,Eldon; John,0,62,40,40
1650033251233,CSE 100,A01,083659,Cao; Yingjun,0,57,50,50
1650033257258,CSE 134B,A01,083661,Powell; Thomas Allan,0,25,65,65
1650033263284,CSE 140,A01,083663,Staff,8,0,75,67
1650033269322,CSE 140L,A01,083088,Eldon; John,4,0,75,71
1650033275344,CSE 175,A01,083665,Kumar; Rakesh,10,0,25,15
1650033281369,CSE 190,A00,092507,Dubnov; Shlomo,17,0,20,3
1650033287391,ECE 45,A01,083139,Staff,0,10,40,40
1650033293423,ECE 65,A50,083695,Staff,0,1,30,30
1650033299450,ECE 109,A01,091882,Touri; Behrouz,48,0,70,22
1650033305475,ECE 180,A00,083140,Abi Samra; Nicholas Camill,26,0,30,4
1650033305475,ECE 180,B00,083141,Abi Samra; Nicholas Camill,9,0,30,21
1650033311502,MATH 10A,A01,083735,Patchell; Gregory David,14,0,30,16
1650033311502,MATH 10A,A02,083736,Patchell; Gregory David,28,0,30,2
1650033311502,MATH 10A,A03,083737,Patchell; Gregory David,27,0,30,3
1650033317524,MATH 10B,A01,083207,Staff,0,4,30,30
1650033317524,MATH 10B,A02,083208,Staff,0,0,30,30
1650033317524,MATH 10B,B01,083739,Staff,20,0,30,10
1650033317524,MATH 10B,B02,083740,Staff,30,0,30,0
1650033323550,MATH 18,A01,083743,Staff,10,0,30,20
1650033323550,MATH 18,A02,083744,Staff,28,0,30,2
1650033323550,MATH 18,A03,083745,Staff,23,0,30,7
1650033323550,MATH 18,A04,083746,Staff,27,0,30,3
1650033323550,MATH 18,B01,083748,Staff,0,8,30,30
1650033323550,MATH 18,B02,083749,Staff,0,6,30,30
1650033323550,MATH 18,B03,083750,Staff,0,6,30,30
1650033323550,MATH 18,B04,083751,Staff,1,7,30,29
1650033329583,MATH 20A,A01,083754,Staff,27,0,40,13
1650033335612,MATH 20B,A01,083756,Staff,0,4,30,30
1650033335612,MATH 20B,A02,083757,Staff,3,0,30,27
1650033341634,MATH 20C,A01,083760,Staff,0,9,30,30
1650033341634,MATH 20C,A02,083761,Staff,0,11,30,30
1650033341634,MATH 20C,B01,083762,Staff,17,0,30,13
1650033341634,MATH 20C,B02,083763,Staff,28,0,30,2
1650033347658,MATH 20D,A01,083765,Staff,0,2,30,30
1650033347658,MATH 20D,A02,083766,Staff,16,0,30,14
1650033347658,MATH 20D,A03,083767,Staff,28,0,30,2
1650033353785,MATH 20E,A01,083771,Staff,11,0,30,19
1650033353785,MATH 20E,A02,083772,Staff,20,0,30,10
1650033353785,MATH 20E,B01,083773,Staff,0,1,30,30
1650033353785,MATH 20E,B02,083774,Staff,19,0,30,11
1650033359814,MATH 103A,A01,083777,Staff,0,6,30,30
1650033359814,MATH 103A,A02,083778,Staff,0,7,30,30
1650033359814,MATH 103A,B01,083779,Staff,0,7,30,30
1650033359814,MATH 103A,B02,083780,Staff,0,6,30,30
1650033365840,MATH 105,A01,085443,Staff,0,11,30,30
1650033371869,MATH 109,A01,083213,Anzaldo; Leesa B,0,3,30,30
1650033371869,MATH 109,A02,083214,Anzaldo; Leesa B,0,4,30,30
1650033371869,MATH 109,B01,083215,Anzaldo; Leesa B,0,2,30,30
1650033371869,MATH 109,B02,083216,Anzaldo; Leesa B,0,2,30,30
1650033377897,MATH 142A,A01,083219,Chow; Bennett,0,7,30,30
1650033377897,MATH 142A,A02,083220,Chow; Bennett,0,7,30,30
1650033377897,MATH 142A,B01,083221,Chow; Bennett,0,8,30,30
1650033377897,MATH 142A,B02,083222,Chow; Bennett,0,7,30,30
1650033383923,MATH 193A,A01,083224,Staff,0,5,30,30
1650033383923,MATH 193A,A02,083225,Staff,0,4,30,30
1650033383923,MATH 193A,A03,083781,Staff,0,0,30,30
1650033383923,MATH 193A,A04,083782,Staff,9,0,30,21
1650033389946,MATH 197,001,091859,McAuley; Julian John,9999,0,9999,0
1650033396003,COGS 9,A01,083615,Staff,1,15,60,59
1650033402026,COGS 11,A01,083617,Boyle; Mary E. T.,25,0,40,15
1650033408052,COGS 13,A01,083071,Staff,0,28,40,40
1650033414075,COGS 14A,A01,092681,Staff,0,6,100,100
1650033420100,COGS 14B,A01,083073,Cheng; Tzu-Han,0,2,50,50
1650033426123,COGS 17,A01,092677,Staff,35,0,75,40
1650033432149,COGS 100,A01,083619,Staff,0,18,60,60
1650033438176,COGS 101A,A01,083621,Davis; Joshua Daniel,0,16,60,60
1650033444199,COGS 101B,A01,091572,Staff,16,0,60,44
1650033450231,COGS 101C,A01,083625,Delgado; Tania,21,0,30,9
1650033456257,COGS 107A,A01,083627,Boyle; Mary E. T.,0,1,60,60
1650033462281,COGS 118A,A01,083075,Staff,19,0,60,41
1650033468312,CSE 3,A50,083646,Miranda; Gregory Joseph,22,0,38,16
1650033468312,CSE 3,A51,083647,Miranda; Gregory Joseph,37,0,37,0
1650033474347,CSE 8A,A50,083650,Miranda; Gregory Joseph,0,14,40,40
1650033480369,CSE 11,A01,083080,Cao; Yingjun,0,60,40,40
1650033486391,CSE 12,A01,083652,Staff,2,0,100,98
1650033492420,CSE 15L,A01,083654,Staff,0,0,50,50
1650033492420,CSE 15L,A02,083655,Staff,15,0,50,35
1650033498452,CSE 20,A01,083657,Staff,57,0,80,23
1650033504473,CSE 30,A01,083084,Eldon; John,0,62,40,40
1650033510495,CSE 100,A01,083659,Cao; Yingjun,0,57,50,50
1650033516520,CSE 134B,A01,083661,Powell; Thomas Allan,0,25,65,65
1650033522543,CSE 140,A01,083663,Staff,8,0,75,67
1650033528566,CSE 140L,A01,083088,Eldon; John,4,0,75,71
1650033534588,CSE 175,A01,083665,Kumar; Rakesh,10,0,25,15
1650033540614,CSE 190,A00,092507,Dubnov; Shlomo,17,0,20,3
1650033546636,ECE 45,A01,083139,Staff,0,10,40,40
1650033552660,ECE 65,A50,083695,Staff,0,1,30,30
1650033558682,ECE 109,A01,091882,Touri; Behrouz,48,0,70,22
1650033564705,ECE 180,A00,083140,Abi Samra; Nicholas Camill,26,0,30,4
1650033564705,ECE 180,B00,083141,Abi Samra; Nicholas Camill,9,0,30,21
1650033570728,MATH 10A,A01,083735,Patchell; Gregory David,14,0,30,16
1650033570728,MATH 10A,A02,083736,Patchell; Gregory David,28,0,30,2
1650033570728,MATH 10A,A03,083737,Patchell; Gregory David,27,0,30,3
1650033576762,MATH 10B,A01,083207,Staff,0,4,30,30
1650033576762,MATH 10B,A02,083208,Staff,0,0,30,30
1650033576762,MATH 10B,B01,083739,Staff,20,0,30,10
1650033576762,MATH 10B,B02,083740,Staff,30,0,30,0
1650033582794,MATH 18,A01,083743,Staff,10,0,30,20
1650033582794,MATH 18,A02,083744,Staff,28,0,30,2
1650033582794,MATH 18,A03,083745,Staff,23,0,30,7
1650033582794,MATH 18,A04,083746,Staff,27,0,30,3
1650033582794,MATH 18,B01,083748,Staff,0,8,30,30
1650033582794,MATH 18,B02,083749,Staff,0,6,30,30
1650033582794,MATH 18,B03,083750,Staff,0,6,30,30
1650033582794,MATH 18,B04,083751,Staff,1,7,30,29
1650033588827,MATH 20A,A01,083754,Staff,27,0,40,13
1650033594852,MATH 20B,A01,083756,Staff,0,4,30,30
1650033594852,MATH 20B,A02,083757,Staff,3,0,30,27
1650033600888,MATH 20C,A01,083760,Staff,0,9,30,30
1650033600888,MATH 20C,A02,083761,Staff,0,11,30,30
1650033600888,MATH 20C,B01,083762,Staff,17,0,30,13
1650033600888,MATH 20C,B02,083763,Staff,28,0,30,2
1650033606925,MATH 20D,A01,083765,Staff,0,2,30,30
1650033606925,MATH 20D,A02,083766,Staff,16,0,30,14
1650033606925,MATH 20D,A03,083767,Staff,28,0,30,2
1650033612948,MATH 20E,A01,083771,Staff,11,0,30,19
1650033612948,MATH 20E,A02,083772,Staff,20,0,30,10
1650033612948,MATH 20E,B01,083773,Staff,0,1,30,30
1650033612948,MATH 20E,B02,083774,Staff,19,0,30,11
1650033618978,MATH 103A,A01,083777,Staff,0,6,30,30
1650033618978,MATH 103A,A02,083778,Staff,0,7,30,30
1650033618978,MATH 103A,B01,083779,Staff,0,7,30,30
1650033618978,MATH 103A,B02,083780,Staff,0,6,30,30
1650033625003,MATH 105,A01,085443,Staff,0,11,30,30
1650033631034,MATH 109,A01,083213,Anzaldo; Leesa B,0,3,30,30
1650033631034,MATH 109,A02,083214,Anzaldo; Leesa B,0,4,30,30
1650033631034,MATH 109,B01,083215,Anzaldo; Leesa B,0,2,30,30
1650033631034,MATH 109,B02,083216,Anzaldo; Leesa B,0,2,30,30
1650033637067,MATH 142A,A01,083219,Chow; Bennett,0,7,30,30
1650033637067,MATH 142A,A02,083220,Chow; Bennett,0,7,30,30
1650033637067,MATH 142A,B01,083221,Chow; Bennett,0,8,30,30
1650033637067,MATH 142A,B02,083222,Chow; Bennett,0,7,30,30
1650033643093,MATH 193A,A01,083224,Staff,0,5,30,30
1650033643093,MATH 193A,A02,083225,Staff,0,4,30,30
1650033643093,MATH 193A,A03,083781,Staff,0,0,30,30
1650033643093,MATH 193A,A04,083782,Staff,9,0,30,21
1650033649118,MATH 197,001,091859,McAuley; Julian John,9999,0,9999,0
1650033655184,COGS 9,A01,083615,Staff,1,15,60,59
1650033661208,COGS 11,A01,083617,Boyle; Mary E. T.,25,0,40,15
1650033667246,COGS 13,A01,083071,Staff,0,28,40,40
1650033673280,COGS 14A,A01,092681,Staff,0,6,100,100
1650033679310,COGS 14B,A01,083073,Cheng; Tzu-Han,0,2,50,50
1650033685332,COGS 17,A01,092677,Staff,35,0,75,40
1650033691355,COGS 100,A01,083619,Staff,0,18,60,60
1650033697387,COGS 101A,A01,083621,Davis; Joshua Daniel,0,16,60,60
1650033703408,COGS 101B,A01,091572,Staff,16,0,60,44
1650033709435,COGS 101C,A01,083625,Delgado; Tania,21,0,30,9
1650033715458,COGS 107A,A01,083627,Boyle; Mary E. T.,0,1,60,60
1650033721481,COGS 118A,A01,083075,Staff,19,0,60,41
1650033727510,CSE 3,A50,083646,Miranda; Gregory Joseph,22,0,38,16
1650033727510,CSE 3,A51,083647,Miranda; Gregory Joseph,37,0,37,0
1650033733537,CSE 8A,A50,083650,Miranda; Gregory Joseph,0,14,40,40
1650033739564,CSE 11,A01,083080,Cao; Yingjun,0,60,40,40
1650033745587,CSE 12,A01,083652,Staff,2,0,100,98
1650033751623,CSE 15L,A01,083654,Staff,0,0,50,50
1650033751623,CSE 15L,A02,083655,Staff,15,0,50,35
1650033757646,CSE 20,A01,083657,Staff,57,0,80,23
1650033763669,CSE 30,A01,083084,Eldon; John,0,62,40,40
1650033769693,CSE 100,A01,083659,Cao; Yingjun,0,57,50,50
1650033775715,CSE 134B,A01,083661,Powell; Thomas Allan,0,25,65,65
1650033781740,CSE 140,A01,083663,Staff,8,0,75,67
1650033787762,CSE 140L,A01,083088,Eldon; John,4,0,75,71
1650033793787,CSE 175,A01,083665,Kumar; Rakesh,10,0,25,15
1650033799812,CSE 190,A00,092507,Dubnov; Shlomo,17,0,20,3
1650033805839,ECE 45,A01,083139,Staff,0,10,40,40
1650033811864,ECE 65,A50,083695,Staff,0,1,30,30
1650033817889,ECE 109,A01,091882,Touri; Behrouz,48,0,70,22
1650033823912,ECE 180,A00,083140,Abi Samra; Nicholas Camill,26,0,30,4
1650033823912,ECE 180,B00,083141,Abi Samra; Nicholas Camill,9,0,30,21
1650033829939,MATH 10A,A01,083735,Patchell; Gregory David,14,0,30,16
1650033829939,MATH 10A,A02,083736,Patchell; Gregory David,28,0,30,2
1650033829939,MATH 10A,A03,083737,Patchell; Gregory David,27,0,30,3
1650033835974,MATH 10B,A01,083207,Staff,0,4,30,30
1650033835974,MATH 10B,A02,083208,Staff,0,0,30,30
1650033835974,MATH 10B,B01,083739,Staff,20,0,30,10
1650033835974,MATH 10B,B02,083740,Staff,30,0,30,0
1650033842002,MATH 18,A01,083743,Staff,10,0,30,20
1650033842002,MATH 18,A02,083744,Staff,28,0,30,2
1650033842002,MATH 18,A03,083745,Staff,23,0,30,7
1650033842002,MATH 18,A04,083746,Staff,27,0,30,3
1650033842002,MATH 18,B01,083748,Staff,0,8,30,30
1650033842002,MATH 18,B02,083749,Staff,0,6,30,30
1650033842002,MATH 18,B03,083750,Staff,0,6,30,30
1650033842002,MATH 18,B04,083751,Staff,1,7,30,29
1650033848044,MATH 20A,A01,083754,Staff,27,0,40,13
1650033854068,MATH 20B,A01,083756,Staff,0,4,30,30
1650033854068,MATH 20B,A02,083757,Staff,3,0,30,27
1650033860091,MATH 20C,A01,083760,Staff,0,9,30,30
1650033860091,MATH 20C,A02,083761,Staff,0,11,30,30
1650033860091,MATH 20C,B01,083762,Staff,17,0,30,13
1650033860091,MATH 20C,B02,083763,Staff,28,0,30,2
1650033866113,MATH 20D,A01,083765,Staff,0,2,30,30
1650033866113,MATH 20D,A02,083766,Staff,16,0,30,14
1650033866113,MATH 20D,A03,083767,Staff,28,0,30,2
1650033872135,MATH 20E,A01,083771,Staff,11,0,30,19
1650033872135,MATH 20E,A02,083772,Staff,20,0,30,10
1650033872135,MATH 20E,B01,083773,Staff,0,1,30,30
1650033872135,MATH 20E,B02,083774,Staff,19,0,30,11
1650033878158,MATH 103A,A01,083777,Staff,0,6,30,30
1650033878158,MATH 103A,A02,083778,Staff,0,7,30,30
1650033878158,MATH 103A,B01,083779,Staff,0,7,30,30
1650033878158,MATH 103A,B02,083780,Staff,0,6,30,30
1650033884189,MATH 105,A01,085443,Staff,0,11,30,30
1650033890219,MATH 109,A01,083213,Anzaldo; Leesa B,0,3,30,30
1650033890219,MATH 109,A02,083214,Anzaldo; Leesa B,0,4,30,30
1650033890219,MATH 109,B01,083215,Anzaldo; Leesa B,0,2,30,30
1650033890219,MATH 109,B02,083216,Anzaldo; Leesa B,0,2,30,30
1650033896242,MATH 142A,A01,083219,Chow; Bennett,0,7,30,30
1650033896242,MATH 142A,A02,083220,Chow; Bennett,0,7,30,30
1650033896242,MATH 142A,B01,083221,Chow; Bennett,0,8,30,30
1650033896242,MATH 142A,B02,083222,Chow; Bennett,0,7,30,30
1650033902281,MATH 193A,A01,083224,Staff,0,5,30,30
1650033902281,MATH 193A,A02,083225,Staff,0,4,30,30
1650033902281,MATH 193A,A03,083781,Staff,0,0,30,30
1650033902281,MATH 193A,A04,083782,Staff,9,0,30,21
1650033908307,MATH 197,001,091859,McAuley; Julian John,9999,0,9999,0
1650033914356,COGS 9,A01,083615,Staff,1,15,60,59
1650033920380,COGS 11,A01,083617,Boyle; Mary E. T.,25,0,40,15
1650033926401,COGS 13,A01,083071,Staff,0,28,40,40
1650033932424,COGS 14A,A01,092681,Staff,0,6,100,100
1650033938451,COGS 14B,A01,083073,Cheng; Tzu-Han,0,2,50,50
1650033944570,COGS 17,A01,092677,Staff,35,0,75,40
1650033950592,COGS 100,A01,083619,Staff,0,18,60,60
1650033956614,COGS 101A,A01,083621,Davis; Joshua Daniel,0,16,60,60
1650033962637,COGS 101B,A01,091572,Staff,16,0,60,44
1650033968661,COGS 101C,A01,083625,Delgado; Tania,21,0,30,9
1650033974685,COGS 107A,A01,083627,Boyle; Mary E. T.,0,1,60,60
1650033980711,COGS 118A,A01,083075,Staff,19,0,60,41
1650033986741,CSE 3,A50,083646,Miranda; Gregory Joseph,22,0,38,16
1650033986741,CSE 3,A51,083647,Miranda; Gregory Joseph,37,0,37,0
1650033992764,CSE 8A,A50,083650,Miranda; Gregory Joseph,0,14,40,40
1650033998784,CSE 11,A01,083080,Cao; Yingjun,0,60,40,40
1650034004810,CSE 12,A01,083652,Staff,2,0,100,98
1650034010882,CSE 15L,A01,083654,Staff,0,0,50,50
1650034010882,CSE 15L,A02,083655,Staff,15,0,50,35
1650034016905,CSE 20,A01,083657,Staff,57,0,80,23
1650034022927,CSE 30,A01,083084,Eldon; John,0,62,40,40
1650034028953,CSE 100,A01,083659,Cao; Yingjun,0,57,50,50
1650034034977,CSE 134B,A01,083661,Powell; Thomas Allan,0,25,65,65
1650034041001,CSE 140,A01,083663,Staff,8,0,75,67
1650034047028,CSE 140L,A01,083088,Eldon; John,4,0,75,71
1650034053051,CSE 175,A01,083665,Kumar; Rakesh,10,0,25,15
1650034059079,CSE 190,A00,092507,Dubnov; Shlomo,17,0,20,3
1650034065102,ECE 45,A01,083139,Staff,0,10,40,40
1650034071126,ECE 65,A50,083695,Staff,0,1,30,30
1650034077150,ECE 109,A01,091882,Touri; Behrouz,48,0,70,22
1650034083172,ECE 180,A00,083140,Abi Samra; Nicholas Camill,26,0,30,4
1650034083172,ECE 180,B00,083141,Abi Samra; Nicholas Camill,9,0,30,21
1650034089196,MATH 10A,A01,083735,Patchell; Gregory David,14,0,30,16
1650034089196,MATH 10A,A02,083736,Patchell; Gregory David,28,0,30,2
1650034089196,MATH 10A,A03,083737,Patchell; Gregory David,27,0,30,3
1650034095221,MATH 10B,A01,083207,Staff,0,4,30,30
1650034095221,MATH 10B,A02,083208,Staff,0,0,30,30
1650034095221,MATH 10B,B01,083739,Staff,20,0,30,10
1650034095221,MATH 10B,B02,083740,Staff,30,0,30,0
1650034101256,MATH 18,A01,083743,Staff,10,0,30,20
1650034101256,MATH 18,A02,083744,Staff,28,0,30,2
1650034101256,MATH 18,A03,083745,Staff,23,0,30,7
1650034101256,MATH 18,A04,083746,Staff,27,0,30,3
1650034101256,MATH 18,B01,083748,Staff,0,8,30,30
1650034101256,MATH 18,B02,083749,Staff,0,6,30,30
1650034101256,MATH 18,B03,083750,Staff,0,6,30,30
1650034101256,MATH 18,B04,083751,Staff,1,7,30,29
1650034107280,MATH 20A,A01,083754,Staff,27,0,40,13
1650034113303,MATH 20B,A01,083756,Staff,0,4,30,30
1650034113303,MATH 20B,A02,083757,Staff,2,0,30,28
1650034119327,MATH 20C,A01,083760,Staff,0,9,30,30
1650034119327,MATH 20C,A02,083761,Staff,0,11,30,30
1650034119327,MATH 20C,B01,083762,Staff,17,0,30,13
1650034119327,MATH 20C,B02,083763,Staff,28,0,30,2
1650034125363,MATH 20D,A01,083765,Staff,0,2,30,30
1650034125363,MATH 20D,A02,083766,Staff,16,0,30,14
1650034125363,MATH 20D,A03,083767,Staff,28,0,30,2
1650034131389,MATH 20E,A01,083771,Staff,11,0,30,19
1650034131389,MATH 20E,A02,083772,Staff,20,0,30,10
1650034131389,MATH 20E,B01,083773,Staff,0,1,30,30
1650034131389,MATH 20E,B02,083774,Staff,19,0,30,11
1650034137415,MATH 103A,A01,083777,Staff,0,6,30,30
1650034137415,MATH 103A,A02,083778,Staff,0,7,30,30
1650034137415,MATH 103A,B01,083779,Staff,0,7,30,30
1650034137415,MATH 103A,B02,083780,Staff,0,6,30,30
1650034143442,MATH 105,A01,085443,Staff,0,11,30,30
1650034149470,MATH 109,A01,083213,Anzaldo; Leesa B,0,3,30,30
1650034149470,MATH 109,A02,083214,Anzaldo; Leesa B,0,4,30,30
1650034149470,MATH 109,B01,083215,Anzaldo; Leesa B,0,2,30,30
1650034149470,MATH 109,B02,083216,Anzaldo; Leesa B,0,2,30,30
1650034155499,MATH 142A,A01,083219,Chow; Bennett,0,7,30,30
1650034155499,MATH 142A,A02,083220,Chow; Bennett,0,7,30,30
1650034155499,MATH 142A,B01,083221,Chow; Bennett,0,8,30,30
1650034155499,MATH 142A,B02,083222,Chow; Bennett,0,7,30,30
1650034161522,MATH 193A,A01,083224,Staff,0,5,30,30
1650034161522,MATH 193A,A02,083225,Staff,0,4,30,30
1650034161522,MATH 193A,A03,083781,Staff,0,0,30,30
1650034161522,MATH 193A,A04,083782,Staff,9,0,30,21
1650034167547,MATH 197,001,091859,McAuley; Julian John,9999,0,9999,0
1650034173606,COGS 9,A01,083615,Staff,1,15,60,59
1650034179631,COGS 11,A01,083617,Boyle; Mary E. T.,25,0,40,15
1650034185666,COGS 13,A01,083071,Staff,0,28,40,40
1650034191689,COGS 14A,A01,092681,Staff,0,6,100,100
1650034197713,COGS 14B,A01,083073,Cheng; Tzu-Han,0,2,50,50
1650034203735,COGS 17,A01,092677,Staff,35,0,75,40
1650034209765,COGS 100,A01,083619,Staff,0,18,60,60
1650034215792,COGS 101A,A01,083621,Davis; Joshua Daniel,0,16,60,60
1650034221820,COGS 101B,A01,091572,Staff,16,0,60,44
1650034227851,COGS 101C,A01,083625,Delgado; Tania,21,0,30,9
1650034233881,COGS 107A,A01,083627,Boyle; Mary E. T.,0,1,60,60
1650034239906,COGS 118A,A01,083075,Staff,19,0,60,41
1650034245935,CSE 3,A50,083646,Miranda; Gregory Joseph,22,0,38,16
1650034245935,CSE 3,A51,083647,Miranda; Gregory Joseph,37,0,37,0
1650034251958,CSE 8A,A50,083650,Miranda; Gregory Joseph,0,14,40,40
1650034257980,CSE 11,A01,083080,Cao; Yingjun,0,60,40,40
1650034264011,CSE 12,A01,083652,Staff,2,0,100,98
1650034270035,CSE 15L,A01,083654,Staff,0,0,50,50
1650034270035,CSE 15L,A02,083655,Staff,15,0,50,35
1650034276058,CSE 20,A01,083657,Staff,57,0,80,23
1650034282085,CSE 30,A01,083084,Eldon; John,0,62,40,40
1650034288114,CSE 100,A01,083659,Cao; Yingjun,0,57,50,50
1650034294147,CSE 134B,A01,083661,Powell; Thomas Allan,0,25,65,65
1650034300170,CSE 140,A01,083663,Staff,8,0,75,67
1650034306202,CSE 140L,A01,083088,Eldon; John,4,0,75,71
1650034312228,CSE 175,A01,083665,Kumar; Rakesh,10,0,25,15
1650034318253,CSE 190,A00,092507,Dubnov; Shlomo,17,0,20,3
1650034324277,ECE 45,A01,083139,Staff,0,10,40,40
1650034330306,ECE 65,A50,083695,Staff,0,1,30,30
1650034336330,ECE 109,A01,091882,Touri; Behrouz,48,0,70,22
1650034342354,ECE 180,A00,083140,Abi Samra; Nicholas Camill,26,0,30,4
1650034342354,ECE 180,B00,083141,Abi Samra; Nicholas Camill,9,0,30,21
1650034348379,MATH 10A,A01,083735,Patchell; Gregory David,14,0,30,16
1650034348379,MATH 10A,A02,083736,Patchell; Gregory David,28,0,30,2
1650034348379,MATH 10A,A03,083737,Patchell; Gregory David,27,0,30,3
1650034354402,MATH 10B,A01,083207,Staff,0,4,30,30
1650034354402,MATH 10B,A02,083208,Staff,0,0,30,30
1650034354402,MATH 10B,B01,083739,Staff,20,0,30,10
1650034354402,MATH 10B,B02,083740,Staff,30,0,30,0
1650034360429,MATH 18,A01,083743,Staff,10,0,30,20
1650034360429,MATH 18,A02,083744,Staff,28,0,30,2
1650034360429,MATH 18,A03,083745,Staff,23,0,30,7
1650034360429,MATH 18,A04,083746,Staff,27,0,30,3
1650034360429,MATH 18,B01,083748,Staff,0,8,30,30
1650034360429,MATH 18,B02,083749,Staff,0,6,30,30
1650034360429,MATH 18,B03,083750,Staff,0,6,30,30
1650034360429,MATH 18,B04,083751,Staff,1,7,30,29
1650034366455,MATH 20A,A01,083754,Staff,27,0,40,13
1650034372481,MATH 20B,A01,083756,Staff,0,4,30,30
1650034372481,MATH 20B,A02,083757,Staff,2,0,30,28
1650034378510,MATH 20C,A01,083760,Staff,0,9,30,30
1650034378510,MATH 20C,A02,083761,Staff,0,11,30,30
1650034378510,MATH 20C,B01,083762,Staff,17,0,30,13
1650034378510,MATH 20C,B02,083763,Staff,28,0,30,2
1650034384544,MATH 20D,A01,083765,Staff,0,2,30,30
1650034384544,MATH 20D,A02,083766,Staff,16,0,30,14
1650034384544,MATH 20D,A03,083767,Staff,28,0,30,2
1650034390570,MATH 20E,A01,083771,Staff,11,0,30,19
1650034390570,MATH 20E,A02,083772,Staff,20,0,30,10
1650034390570,MATH 20E,B01,083773,Staff,0,1,30,30
1650034390570,MATH 20E,B02,083774,Staff,19,0,30,11
1650034396599,MATH 103A,A01,083777,Staff,0,6,30,30
1650034396599,MATH 103A,A02,083778,Staff,0,7,30,30
1650034396599,MATH 103A,B01,083779,Staff,0,7,30,30
1650034396599,MATH 103A,B02,083780,Staff,0,6,30,30
1650034402625,MATH 105,A01,085443,Staff,0,11,30,30
1650034408649,MATH 109,A01,083213,Anzaldo; Leesa B,0,3,30,30
1650034408649,MATH 109,A02,083214,Anzaldo; Leesa B,0,4,30,30
1650034408649,MATH 109,B01,083215,Anzaldo; Leesa B,0,2,30,30
1650034408649,MATH 109,B02,083216,Anzaldo; Leesa B,0,2,30,30
1650034414677,MATH 142A,A01,083219,Chow; Bennett,0,7,30,30
1650034414677,MATH 142A,A02,083220,Chow; Bennett,0,7,30,30
1650034414677,MATH 142A,B01,083221,Chow; Bennett,0,8,30,30
1650034414677,MATH 142A,B02,083222,Chow; Bennett,0,7,30,30
1650034420708,MATH 193A,A01,083224,Staff,0,5,30,30
1650034420708,MATH 193A,A02,083225,Staff,0,4,30,30
1650034420708,MATH 193A,A03,083781,Staff,0,0,30,30
1650034420708,MATH 193A,A04,083782,Staff,9,0,30,21
1650034426735,MATH 197,001,091859,McAuley; Julian John,9999,0,9999,0
1650034432811,COGS 9,A01,083615,Staff,1,15,60,59
1650034438840,COGS 11,A01,083617,Boyle; Mary E. T.,25,0,40,15
1650034444863,COGS 13,A01,083071,Staff,0,28,40,40
1650034450889,COGS 14A,A01,092681,Staff,0,6,100,100
1650034456913,COGS 14B,A01,083073,Cheng; Tzu-Han,0,2,50,50
1650034462935,COGS 17,A01,092677,Staff,35,0,75,40
1650034468962,COGS 100,A01,083619,Staff,0,18,60,60
1650034474986,COGS 101A,A01,083621,Davis; Joshua Daniel,0,16,60,60
1650034481007,COGS 101B,A01,091572,Staff,16,0,60,44
1650034487040,COGS 101C,A01,083625,Delgado; Tania,21,0,30,9
1650034493067,COGS 107A,A01,083627,Boyle; Mary E. T.,0,1,60,60
1650034499091,COGS 118A,A01,083075,Staff,19,0,60,41
1650034505134,CSE 3,A50,083646,Miranda; Gregory Joseph,22,0,38,16
1650034505134,CSE 3,A51,083647,Miranda; Gregory Joseph,37,0,37,0
1650034511160,CSE 8A,A50,083650,Miranda; Gregory Joseph,0,14,40,40
1650034517191,CSE 11,A01,083080,Cao; Yingjun,0,60,40,40
1650034523221,CSE 12,A01,083652,Staff,2,0,100,98
1650034529244,CSE 15L,A01,083654,Staff,0,0,50,50
1650034529244,CSE 15L,A02,083655,Staff,15,0,50,35
1650034535268,CSE 20,A01,083657,Staff,57,0,80,23
1650034541388,CSE 30,A01,083084,Eldon; John,0,62,40,40
1650034547413,CSE 100,A01,083659,Cao; Yingjun,0,57,50,50
1650034553436,CSE 134B,A01,083661,Powell; Thomas Allan,0,25,65,65
1650034559468,CSE 140,A01,083663,Staff,8,0,75,67
1650034565496,CSE 140L,A01,083088,Eldon; John,4,0,75,71
1650034571533,CSE 175,A01,083665,Kumar; Rakesh,10,0,25,15
1650034577561,CSE 190,A00,092507,Dubnov; Shlomo,17,0,20,3
1650034583585,ECE 45,A01,083139,Staff,0,10,40,40
1650034589615,ECE 65,A50,083695,Staff,0,1,30,30
1650034595639,ECE 109,A01,091882,Touri; Behrouz,48,0,70,22
1650034601662,ECE 180,A00,083140,Abi Samra; Nicholas Camill,26,0,30,4
1650034601662,ECE 180,B00,083141,Abi Samra; Nicholas Camill,9,0,30,21
1650034607687,MATH 10A,A01,083735,Patchell; Gregory David,14,0,30,16
1650034607687,MATH 10A,A02,083736,Patchell; Gregory David,28,0,30,2
1650034607687,MATH 10A,A03,083737,Patchell; Gregory David,27,0,30,3
1650034613732,MATH 10B,A01,083207,Staff,0,4,30,30
1650034613732,MATH 10B,A02,083208,Staff,0,0,30,30
1650034613732,MATH 10B,B01,083739,Staff,20,0,30,10
1650034613732,MATH 10B,B02,083740,Staff,30,0,30,0
1650034619771,MATH 18,A01,083743,Staff,10,0,30,20
1650034619771,MATH 18,A02,083744,Staff,28,0,30,2
1650034619771,MATH 18,A03,083745,Staff,23,0,30,7
1650034619771,MATH 18,A04,083746,Staff,27,0,30,3
1650034619771,MATH 18,B01,083748,Staff,0,8,30,30
1650034619771,MATH 18,B02,083749,Staff,0,6,30,30
1650034619771,MATH 18,B03,083750,Staff,0,6,30,30
1650034619771,MATH 18,B04,083751,Staff,1,7,30,29
1650034625795,MATH 20A,A01,083754,Staff,27,0,40,13
1650034631825,MATH 20B,A01,083756,Staff,0,4,30,30
1650034631825,MATH 20B,A02,083757,Staff,2,0,30,28
1650034637858,MATH 20C,A01,083760,Staff,0,9,30,30
1650034637858,MATH 20C,A02,083761,Staff,0,11,30,30
1650034637858,MATH 20C,B01,083762,Staff,17,0,30,13
1650034637858,MATH 20C,B02,083763,Staff,28,0,30,2
1650034643882,MATH 20D,A01,083765,Staff,0,2,30,30
1650034643882,MATH 20D,A02,083766,Staff,16,0,30,14
1650034643882,MATH 20D,A03,083767,Staff,28,0,30,2
1650034649910,MATH 20E,A01,083771,Staff,11,0,30,19
1650034649910,MATH 20E,A02,083772,Staff,20,0,30,10
1650034649910,MATH 20E,B01,083773,Staff,0,1,30,30
1650034649910,MATH 20E,B02,083774,Staff,19,0,30,11
1650034655935,MATH 103A,A01,083777,Staff,0,6,30,30
1650034655935,MATH 103A,A02,083778,Staff,0,7,30,30
1650034655935,MATH 103A,B01,083779,Staff,0,7,30,30
1650034655935,MATH 103A,B02,083780,Staff,0,6,30,30
1650034661961,MATH 105,A01,085443,Staff,0,11,30,30
1650034667986,MATH 109,A01,083213,Anzaldo; Leesa B,0,3,30,30
1650034667986,MATH 109,A02,083214,Anzaldo; Leesa B,0,4,30,30
1650034667986,MATH 109,B01,083215,Anzaldo; Leesa B,0,2,30,30
1650034667986,MATH 109,B02,083216,Anzaldo; Leesa B,0,2,30,30
1650034674014,MATH 142A,A01,083219,Chow; Bennett,0,7,30,30
1650034674014,MATH 142A,A02,083220,Chow; Bennett,0,7,30,30
1650034674014,MATH 142A,B01,083221,Chow; Bennett,0,8,30,30
1650034674014,MATH 142A,B02,083222,Chow; Bennett,0,7,30,30
1650034680037,MATH 193A,A01,083224,Staff,0,5,30,30
1650034680037,MATH 193A,A02,083225,Staff,0,4,30,30
1650034680037,MATH 193A,A03,083781,Staff,0,0,30,30
1650034680037,MATH 193A,A04,083782,Staff,9,0,30,21
1650034686058,MATH 197,001,091859,McAuley; Julian John,9999,0,9999,0
1650034692108,COGS 9,A01,083615,Staff,1,15,60,59
1650034698139,COGS 11,A01,083617,Boyle; Mary E. T.,25,0,40,15
1650034704162,COGS 13,A01,083071,Staff,0,28,40,40
1650034710184,COGS 14A,A01,092681,Staff,0,6,100,100
1650034716208,COGS 14B,A01,083073,Cheng; Tzu-Han,0,2,50,50
1650034725633,COGS 17,A01,092677,Staff,35,0,75,40
1650034731657,COGS 100,A01,083619,Staff,0,18,60,60
1650034737680,COGS 101A,A01,083621,Davis; Joshua Daniel,0,16,60,60
1650034743704,COGS 101B,A01,091572,Staff,16,0,60,44
1650034749729,COGS 101C,A01,083625,Delgado; Tania,21,0,30,9
1650034755767,COGS 107A,A01,083627,Boyle; Mary E. T.,0,1,60,60
1650034761799,COGS 118A,A01,083075,Staff,19,0,60,41
1650034767830,CSE 3,A50,083646,Miranda; Gregory Joseph,22,0,38,16
1650034767830,CSE 3,A51,083647,Miranda; Gregory Joseph,37,0,37,0
1650034773853,CSE 8A,A50,083650,Miranda; Gregory Joseph,0,14,40,40
1650034779894,CSE 11,A01,083080,Cao; Yingjun,0,60,40,40
1650034785918,CSE 12,A01,083652,Staff,2,0,100,98
1650034791945,CSE 15L,A01,083654,Staff,0,0,50,50
1650034791945,CSE 15L,A02,083655,Staff,15,0,50,35
1650034797985,CSE 20,A01,083657,Staff,57,0,80,23
1650034804012,CSE 30,A01,083084,Eldon; John,0,62,40,40
1650034810038,CSE 100,A01,083659,Cao; Yingjun,0,57,50,50
1650034816062,CSE 134B,A01,083661,Powell; Thomas Allan,0,25,65,65
1650034822085,CSE 140,A01,083663,Staff,8,0,75,67
1650034828115,CSE 140L,A01,083088,Eldon; John,4,0,75,71
1650034834138,CSE 175,A01,083665,Kumar; Rakesh,10,0,25,15
1650034840161,CSE 190,A00,092507,Dubnov; Shlomo,17,0,20,3
1650034846195,ECE 45,A01,083139,Staff,0,10,40,40
1650034852222,ECE 65,A50,083695,Staff,0,1,30,30
1650034858246,ECE 109,A01,091882,Touri; Behrouz,48,0,70,22
1650034864268,ECE 180,A00,083140,Abi Samra; Nicholas Camill,26,0,30,4
1650034864268,ECE 180,B00,083141,Abi Samra; Nicholas Camill,9,0,30,21
1650034870299,MATH 10A,A01,083735,Patchell; Gregory David,14,0,30,16
1650034870299,MATH 10A,A02,083736,Patchell; Gregory David,28,0,30,2
1650034870299,MATH 10A,A03,083737,Patchell; Gregory David,27,0,30,3
1650034876328,MATH 10B,A01,083207,Staff,0,4,30,30
1650034876328,MATH 10B,A02,083208,Staff,0,0,30,30
1650034876328,MATH 10B,B01,083739,Staff,20,0,30,10
1650034876328,MATH 10B,B02,083740,Staff,30,0,30,0
1650034882358,MATH 18,A01,083743,Staff,10,0,30,20
1650034882358,MATH 18,A02,083744,Staff,28,0,30,2
1650034882358,MATH 18,A03,083745,Staff,23,0,30,7
1650034882358,MATH 18,A04,083746,Staff,27,0,30,3
1650034882358,MATH 18,B01,083748,Staff,0,8,30,30
1650034882358,MATH 18,B02,083749,Staff,0,6,30,30
1650034882358,MATH 18,B03,083750,Staff,0,6,30,30
1650034882358,MATH 18,B04,083751,Staff,1,7,30,29
1650034888382,MATH 20A,A01,083754,Staff,27,0,40,13
1650034894405,MATH 20B,A01,083756,Staff,0,4,30,30
1650034894405,MATH 20B,A02,083757,Staff,2,0,30,28
1650034900428,MATH 20C,A01,083760,Staff,0,9,30,30
1650034900428,MATH 20C,A02,083761,Staff,0,11,30,30
1650034900428,MATH 20C,B01,083762,Staff,17,0,30,13
1650034900428,MATH 20C,B02,083763,Staff,28,0,30,2
1650034906452,MATH 20D,A01,083765,Staff,0,2,30,30
1650034906452,MATH 20D,A02,083766,Staff,16,0,30,14
1650034906452,MATH 20D,A03,083767,Staff,28,0,30,2
1650034912479,MATH 20E,A01,083771,Staff,11,0,30,19
1650034912479,MATH 20E,A02,083772,Staff,20,0,30,10
1650034912479,MATH 20E,B01,083773,Staff,0,1,30,30
1650034912479,MATH 20E,B02,083774,Staff,19,0,30,11
1650034918508,MATH 103A,A01,083777,Staff,0,6,30,30
1650034918508,MATH 103A,A02,083778,Staff,0,7,30,30
1650034918508,MATH 103A,B01,083779,Staff,0,7,30,30
1650034918508,MATH 103A,B02,083780,Staff,0,6,30,30
1650034924533,MATH 105,A01,085443,Staff,0,11,30,30
1650034930557,MATH 109,A01,083213,Anzaldo; Leesa B,0,3,30,30
1650034930557,MATH 109,A02,083214,Anzaldo; Leesa B,0,4,30,30
1650034930557,MATH 109,B01,083215,Anzaldo; Leesa B,0,2,30,30
1650034930557,MATH 109,B02,083216,Anzaldo; Leesa B,0,2,30,30
1650034936585,MATH 142A,A01,083219,Chow; Bennett,0,7,30,30
1650034936585,MATH 142A,A02,083220,Chow; Bennett,0,7,30,30
1650034936585,MATH 142A,B01,083221,Chow; Bennett,0,8,30,30
1650034936585,MATH 142A,B02,083222,Chow; Bennett,0,7,30,30
1650034942608,MATH 193A,A01,083224,Staff,0,5,30,30
1650034942608,MATH 193A,A02,083225,Staff,0,4,30,30
1650034942608,MATH 193A,A03,083781,Staff,0,0,30,30
1650034942608,MATH 193A,A04,083782,Staff,9,0,30,21
1650034948633,MATH 197,001,091859,McAuley; Julian John,9999,0,9999,0
1650034954693,COGS 9,A01,083615,Staff,1,15,60,59
1650034960720,COGS 11,A01,083617,Boyle; Mary E. T.,25,0,40,15
1650034966746,COGS 13,A01,083071,Staff,0,28,40,40
1650034972769,COGS 14A,A01,092681,Staff,0,6,100,100
1650034978792,COGS 14B,A01,083073,Cheng; Tzu-Han,0,2,50,50
1650034984817,COGS 17,A01,092677,Staff,35,0,75,40
1650034990843,COGS 100,A01,083619,Staff,0,18,60,60
1650034996885,COGS 101A,A01,083621,Davis; Joshua Daniel,0,16,60,60
1650035002911,COGS 101B,A01,091572,Staff,16,0,60,44
1650035008937,COGS 101C,A01,083625,Delgado; Tania,21,0,30,9
1650035014969,COGS 107A,A01,083627,Boyle; Mary E. T.,0,1,60,60
1650035020996,COGS 118A,A01,083075,Staff,19,0,60,41
1650035027025,CSE 3,A50,083646,Miranda; Gregory Joseph,22,0,38,16
1650035027025,CSE 3,A51,083647,Miranda; Gregory Joseph,37,0,37,0
1650035033048,CSE 8A,A50,083650,Miranda; Gregory Joseph,0,14,40,40
1650035039070,CSE 11,A01,083080,Cao; Yingjun,0,60,40,40
1650035045095,CSE 12,A01,083652,Staff,2,0,100,98
1650035051129,CSE 15L,A01,083654,Staff,0,0,50,50
1650035051129,CSE 15L,A02,083655,Staff,15,0,50,35
1650035057157,CSE 20,A01,083657,Staff,57,0,80,23
1650035063179,CSE 30,A01,083084,Eldon; John,0,62,40,40
1650035069202,CSE 100,A01,083659,Cao; Yingjun,0,57,50,50
1650035075236,CSE 134B,A01,083661,Powell; Thomas Allan,0,25,65,65
1650035081266,CSE 140,A01,083663,Staff,8,0,75,67
1650035087287,CSE 140L,A01,083088,Eldon; John,4,0,75,71
1650035093315,CSE 175,A01,083665,Kumar; Rakesh,10,0,25,15
1650035099338,CSE 190,A00,092507,Dubnov; Shlomo,17,0,20,3
1650035105361,ECE 45,A01,083139,Staff,0,10,40,40
1650035111386,ECE 65,A50,083695,Staff,0,1,30,30
1650035117408,ECE 109,A01,091882,Touri; Behrouz,48,0,70,22
1650035123433,ECE 180,A00,083140,Abi Samra; Nicholas Camill,26,0,30,4
1650035123433,ECE 180,B00,083141,Abi Samra; Nicholas Camill,9,0,30,21
1650035129458,MATH 10A,A01,083735,Patchell; Gregory David,14,0,30,16
1650035129458,MATH 10A,A02,083736,Patchell; Gregory David,28,0,30,2
1650035129458,MATH 10A,A03,083737,Patchell; Gregory David,27,0,30,3
1650035135492,MATH 10B,A01,083207,Staff,0,4,30,30
1650035135492,MATH 10B,A02,083208,Staff,0,0,30,30
1650035135492,MATH 10B,B01,083739,Staff,20,0,30,10
1650035135492,MATH 10B,B02,083740,Staff,30,0,30,0
1650035141603,MATH 18,A01,083743,Staff,10,0,30,20
1650035141603,MATH 18,A02,083744,Staff,28,0,30,2
1650035141603,MATH 18,A03,083745,Staff,23,0,30,7
1650035141603,MATH 18,A04,083746,Staff,27,0,30,3
1650035141603,MATH 18,B01,083748,Staff,0,8,30,30
1650035141603,MATH 18,B02,083749,Staff,0,6,30,30
1650035141603,MATH 18,B03,083750,Staff,0,6,30,30
1650035141603,MATH 18,B04,083751,Staff,1,7,30,29
1650035147625,MATH 20A,A01,083754,Staff,27,0,40,13
1650035153651,MATH 20B,A01,083756,Staff,0,4,30,30
1650035153651,MATH 20B,A02,083757,Staff,2,0,30,28
1650035159687,MATH 20C,A01,083760,Staff,0,9,30,30
1650035159687,MATH 20C,A02,083761,Staff,0,11,30,30
1650035159687,MATH 20C,B01,083762,Staff,17,0,30,13
1650035159687,MATH 20C,B02,083763,Staff,28,0,30,2
1650035165710,MATH 20D,A01,083765,Staff,0,2,30,30
1650035165710,MATH 20D,A02,083766,Staff,16,0,30,14
1650035165710,MATH 20D,A03,083767,Staff,28,0,30,2
1650035171735,MATH 20E,A01,083771,Staff,11,0,30,19
1650035171735,MATH 20E,A02,083772,Staff,20,0,30,10
1650035171735,MATH 20E,B01,083773,Staff,0,1,30,30
1650035171735,MATH 20E,B02,083774,Staff,19,0,30,11
1650035177764,MATH 103A,A01,083777,Staff,0,6,30,30
1650035177764,MATH 103A,A02,083778,Staff,0,7,30,30
1650035177764,MATH 103A,B01,083779,Staff,0,7,30,30
1650035177764,MATH 103A,B02,083780,Staff,0,6,30,30
1650035183800,MATH 105,A01,085443,Staff,0,11,30,30
1650035189823,MATH 109,A01,083213,Anzaldo; Leesa B,0,3,30,30
1650035189823,MATH 109,A02,083214,Anzaldo; Leesa B,0,4,30,30
1650035189823,MATH 109,B01,083215,Anzaldo; Leesa B,0,2,30,30
1650035189823,MATH 109,B02,083216,Anzaldo; Leesa B,0,2,30,30
1650035195846,MATH 142A,A01,083219,Chow; Bennett,0,7,30,30
1650035195846,MATH 142A,A02,083220,Chow; Bennett,0,7,30,30
1650035195846,MATH 142A,B01,083221,Chow; Bennett,0,8,30,30
1650035195846,MATH 142A,B02,083222,Chow; Bennett,0,7,30,30
1650035201875,MATH 193A,A01,083224,Staff,0,5,30,30
1650035201875,MATH 193A,A02,083225,Staff,0,4,30,30
1650035201875,MATH 193A,A03,083781,Staff,0,0,30,30
1650035201875,MATH 193A,A04,083782,Staff,9,0,30,21
1650035207909,MATH 197,001,091859,McAuley; Julian John,9999,0,9999,0
1650035213960,COGS 9,A01,083615,Staff,1,15,60,59
1650035219995,COGS 11,A01,083617,Boyle; Mary E. T.,25,0,40,15
1650035226031,COGS 13,A01,083071,Staff,0,28,40,40
1650035232057,COGS 14A,A01,092681,Staff,0,6,100,100
1650035238081,COGS 14B,A01,083073,Cheng; Tzu-Han,0,2,50,50
1650035244104,COGS 17,A01,092677,Staff,35,0,75,40
1650035250128,COGS 100,A01,083619,Staff,0,18,60,60
1650035256153,COGS 101A,A01,083621,Davis; Joshua Daniel,0,16,60,60
1650035262178,COGS 101B,A01,091572,Staff,16,0,60,44
1650035268214,COGS 101C,A01,083625,Delgado; Tania,21,0,30,9
1650035274242,COGS 107A,A01,083627,Boyle; Mary E. T.,0,1,60,60
1650035280267,COGS 118A,A01,083075,Staff,19,0,60,41
1650035286304,CSE 3,A50,083646,Miranda; Gregory Joseph,22,0,38,16
1650035286304,CSE 3,A51,083647,Miranda; Gregory Joseph,37,0,37,0
1650035292327,CSE 8A,A50,083650,Miranda; Gregory Joseph,0,14,40,40
1650035298350,CSE 11,A01,083080,Cao; Yingjun,0,60,40,40
1650035304377,CSE 12,A01,083652,Staff,2,0,100,98
1650035310402,CSE 15L,A01,083654,Staff,0,0,50,50
1650035310402,CSE 15L,A02,083655,Staff,15,0,50,35
1650035316429,CSE 20,A01,083657,Staff,57,0,80,23
1650035322458,CSE 30,A01,083084,Eldon; John,0,62,40,40
1650035328492,CSE 100,A01,083659,Cao; Yingjun,0,57,50,50
1650035334515,CSE 134B,A01,083661,Powell; Thomas Allan,0,25,65,65
1650035340542,CSE 140,A01,083663,Staff,8,0,75,67
1650035346565,CSE 140L,A01,083088,Eldon; John,4,0,75,71
1650035352594,CSE 175,A01,083665,Kumar; Rakesh,10,0,25,15
1650035358618,CSE 190,A00,092507,Dubnov; Shlomo,17,0,20,3
1650035364642,ECE 45,A01,083139,Staff,0,10,40,40
1650035370665,ECE 65,A50,083695,Staff,0,1,30,30
1650035376693,ECE 109,A01,091882,Touri; Behrouz,48,0,70,22
1650035382723,ECE 180,A00,083140,Abi Samra; Nicholas Camill,26,0,30,4
1650035382723,ECE 180,B00,083141,Abi Samra; Nicholas Camill,9,0,30,21
1650035388746,MATH 10A,A01,083735,Patchell; Gregory David,14,0,30,16
1650035388746,MATH 10A,A02,083736,Patchell; Gregory David,28,0,30,2
1650035388746,MATH 10A,A03,083737,Patchell; Gregory David,27,0,30,3
1650035394771,MATH 10B,A01,083207,Staff,0,4,30,30
1650035394771,MATH 10B,A02,083208,Staff,0,0,30,30
1650035394771,MATH 10B,B01,083739,Staff,20,0,30,10
1650035394771,MATH 10B,B02,083740,Staff,30,0,30,0
1650035400818,MATH 18,A01,083743,Staff,10,0,30,20
1650035400818,MATH 18,A02,083744,Staff,28,0,30,2
1650035400818,MATH 18,A03,083745,Staff,23,0,30,7
1650035400818,MATH 18,A04,083746,Staff,27,0,30,3
1650035400818,MATH 18,B01,083748,Staff,0,8,30,30
1650035400818,MATH 18,B02,083749,Staff,0,6,30,30
1650035400818,MATH 18,B03,083750,Staff,0,6,30,30
1650035400818,MATH 18,B04,083751,Staff,1,7,30,29
1650035406841,MATH 20A,A01,083754,Staff,27,0,40,13
1650035412870,MATH 20B,A01,083756,Staff,0,4,30,30
1650035412870,MATH 20B,A02,083757,Staff,2,0,30,28
1650035418893,MATH 20C,A01,083760,Staff,0,9,30,30
1650035418893,MATH 20C,A02,083761,Staff,0,11,30,30
1650035418893,MATH 20C,B01,083762,Staff,17,0,30,13
1650035418893,MATH 20C,B02,083763,Staff,28,0,30,2
1650035424920,MATH 20D,A01,083765,Staff,0,2,30,30
1650035424920,MATH 20D,A02,083766,Staff,16,0,30,14
1650035424920,MATH 20D,A03,083767,Staff,28,0,30,2
1650035430956,MATH 20E,A01,083771,Staff,11,0,30,19
1650035430956,MATH 20E,A02,083772,Staff,20,0,30,10
1650035430956,MATH 20E,B01,083773,Staff,0,1,30,30
1650035430956,MATH 20E,B02,083774,Staff,19,0,30,11
1650035436980,MATH 103A,A01,083777,Staff,0,6,30,30
1650035436980,MATH 103A,A02,083778,Staff,0,7,30,30
1650035436980,MATH 103A,B01,083779,Staff,0,7,30,30
1650035436980,MATH 103A,B02,083780,Staff,0,6,30,30
1650035443003,MATH 105,A01,085443,Staff,0,11,30,30
1650035449029,MATH 109,A01,083213,Anzaldo; Leesa B,0,3,30,30
1650035449029,MATH 109,A02,083214,Anzaldo; Leesa B,0,4,30,30
1650035449029,MATH 109,B01,083215,Anzaldo; Leesa B,0,2,30,30
1650035449029,MATH 109,B02,083216,Anzaldo; Leesa B,0,2,30,30
1650035455052,MATH 142A,A01,083219,Chow; Bennett,0,7,30,30
1650035455052,MATH 142A,A02,083220,Chow; Bennett,0,7,30,30
1650035455052,MATH 142A,B01,083221,Chow; Bennett,0,8,30,30
1650035455052,MATH 142A,B02,083222,Chow; Bennett,0,7,30,30
1650035461078,MATH 193A,A01,083224,Staff,0,5,30,30
1650035461078,MATH 193A,A02,083225,Staff,0,4,30,30
1650035461078,MATH 193A,A03,083781,Staff,0,0,30,30
1650035461078,MATH 193A,A04,083782,Staff,9,0,30,21
1650035467112,MATH 197,001,091859,McAuley; Julian John,9999,0,9999,0
1650035473164,COGS 9,A01,083615,Staff,1,15,60,59
1650035479196,COGS 11,A01,083617,Boyle; Mary E. T.,25,0,40,15
1650035485219,COGS 13,A01,083071,Staff,0,28,40,40
1650035491245,COGS 14A,A01,092681,Staff,0,6,100,100
1650035497278,COGS 14B,A01,083073,Cheng; Tzu-Han,0,2,50,50
1650035503305,COGS 17,A01,092677,Staff,35,0,75,40
1650035509330,COGS 100,A01,083619,Staff,0,18,60,60
1650035515354,COGS 101A,A01,083621,Davis; Joshua Daniel,0,16,60,60
1650035521380,COGS 101B,A01,091572,Staff,16,0,60,44
1650035527403,COGS 101C,A01,083625,Delgado; Tania,21,0,30,9
1650035533430,COGS 107A,A01,083627,Boyle; Mary E. T.,0,1,60,60
1650035539461,COGS 118A,A01,083075,Staff,19,0,60,41
1650035545501,CSE 3,A50,083646,Miranda; Gregory Joseph,22,0,38,16
1650035545501,CSE 3,A51,083647,Miranda; Gregory Joseph,37,0,37,0
1650035551528,CSE 8A,A50,083650,Miranda; Gregory Joseph,0,14,40,40
1650035557552,CSE 11,A01,083080,Cao; Yingjun,0,60,40,40
1650035563577,CSE 12,A01,083652,Staff,2,0,100,98
1650035569601,CSE 15L,A01,083654,Staff,0,0,50,50
1650035569601,CSE 15L,A02,083655,Staff,15,0,50,35
1650035575645,CSE 20,A01,083657,Staff,57,0,80,23
1650035581669,CSE 30,A01,083084,Eldon; John,0,62,40,40
1650035587703,CSE 100,A01,083659,Cao; Yingjun,0,57,50,50
1650035593738,CSE 134B,A01,083661,Powell; Thomas Allan,0,25,65,65
1650035599763,CSE 140,A01,083663,Staff,8,0,75,67
1650035605786,CSE 140L,A01,083088,Eldon; John,4,0,75,71
1650035611812,CSE 175,A01,083665,Kumar; Rakesh,10,0,25,15
1650035617852,CSE 190,A00,092507,Dubnov; Shlomo,17,0,20,3
1650035623874,ECE 45,A01,083139,Staff,0,10,40,40
1650035629897,ECE 65,A50,083695,Staff,0,1,30,30
1650035635931,ECE 109,A01,091882,Touri; Behrouz,48,0,70,22
1650035641958,ECE 180,A00,083140,Abi Samra; Nicholas Camill,26,0,30,4
1650035641958,ECE 180,B00,083141,Abi Samra; Nicholas Camill,9,0,30,21
1650035647985,MATH 10A,A01,083735,Patchell; Gregory David,14,0,30,16
1650035647985,MATH 10A,A02,083736,Patchell; Gregory David,28,0,30,2
1650035647985,MATH 10A,A03,083737,Patchell; Gregory David,27,0,30,3
1650035654009,MATH 10B,A01,083207,Staff,0,4,30,30
1650035654009,MATH 10B,A02,083208,Staff,0,0,30,30
1650035654009,MATH 10B,B01,083739,Staff,20,0,30,10
1650035654009,MATH 10B,B02,083740,Staff,30,0,30,0
1650035660034,MATH 18,A01,083743,Staff,10,0,30,20
1650035660034,MATH 18,A02,083744,Staff,28,0,30,2
1650035660034,MATH 18,A03,083745,Staff,23,0,30,7
1650035660034,MATH 18,A04,083746,Staff,27,0,30,3
1650035660034,MATH 18,B01,083748,Staff,0,8,30,30
1650035660034,MATH 18,B02,083749,Staff,0,6,30,30
1650035660034,MATH 18,B03,083750,Staff,0,6,30,30
1650035660034,MATH 18,B04,083751,Staff,1,7,30,29
1650035666058,MATH 20A,A01,083754,Staff,27,0,40,13
1650035672086,MATH 20B,A01,083756,Staff,0,4,30,30
1650035672086,MATH 20B,A02,083757,Staff,2,0,30,28
1650035678112,MATH 20C,A01,083760,Staff,0,9,30,30
1650035678112,MATH 20C,A02,083761,Staff,0,11,30,30
1650035678112,MATH 20C,B01,083762,Staff,17,0,30,13
1650035678112,MATH 20C,B02,083763,Staff,28,0,30,2
1650035684141,MATH 20D,A01,083765,Staff,0,2,30,30
1650035684141,MATH 20D,A02,083766,Staff,16,0,30,14
1650035684141,MATH 20D,A03,083767,Staff,28,0,30,2
1650035690167,MATH 20E,A01,083771,Staff,11,0,30,19
1650035690167,MATH 20E,A02,083772,Staff,20,0,30,10
1650035690167,MATH 20E,B01,083773,Staff,0,1,30,30
1650035690167,MATH 20E,B02,083774,Staff,19,0,30,11
1650035696190,MATH 103A,A01,083777,Staff,0,6,30,30
1650035696190,MATH 103A,A02,083778,Staff,0,7,30,30
1650035696190,MATH 103A,B01,083779,Staff,0,7,30,30
1650035696190,MATH 103A,B02,083780,Staff,0,6,30,30
1650035702213,MATH 105,A01,085443,Staff,0,11,30,30
1650035708243,MATH 109,A01,083213,Anzaldo; Leesa B,0,3,30,30
1650035708243,MATH 109,A02,083214,Anzaldo; Leesa B,0,4,30,30
1650035708243,MATH 109,B01,083215,Anzaldo; Leesa B,0,2,30,30
1650035708243,MATH 109,B02,083216,Anzaldo; Leesa B,0,2,30,30
1650035714266,MATH 142A,A01,083219,Chow; Bennett,0,7,30,30
1650035714266,MATH 142A,A02,083220,Chow; Bennett,0,7,30,30
1650035714266,MATH 142A,B01,083221,Chow; Bennett,0,8,30,30
1650035714266,MATH 142A,B02,083222,Chow; Bennett,0,7,30,30
1650035720289,MATH 193A,A01,083224,Staff,0,5,30,30
1650035720289,MATH 193A,A02,083225,Staff,0,4,30,30
1650035720289,MATH 193A,A03,083781,Staff,0,0,30,30
1650035720289,MATH 193A,A04,083782,Staff,9,0,30,21
1650035726310,MATH 197,001,091859,McAuley; Julian John,9999,0,9999,0
1650035732452,COGS 9,A01,083615,Staff,2,15,60,58
1650035738485,COGS 11,A01,083617,Boyle; Mary E. T.,25,0,40,15
1650035744519,COGS 13,A01,083071,Staff,0,28,40,40
1650035750542,COGS 14A,A01,092681,Staff,0,6,100,100
1650035756566,COGS 14B,A01,083073,Cheng; Tzu-Han,0,2,50,50
1650035762593,COGS 17,A01,092677,Staff,35,0,75,40
1650035768618,COGS 100,A01,083619,Staff,0,18,60,60
1650035774645,COGS 101A,A01,083621,Davis; Joshua Daniel,0,16,60,60
1650035780668,COGS 101B,A01,091572,Staff,16,0,60,44
1650035786703,COGS 101C,A01,083625,Delgado; Tania,21,0,30,9
1650035792726,COGS 107A,A01,083627,Boyle; Mary E. T.,0,1,60,60
1650035798757,COGS 118A,A01,083075,Staff,19,0,60,41
1650035804789,CSE 3,A50,083646,Miranda; Gregory Joseph,22,0,38,16
1650035804789,CSE 3,A51,083647,Miranda; Gregory Joseph,37,0,37,0
1650035810812,CSE 8A,A50,083650,Miranda; Gregory Joseph,0,14,40,40
1650035816839,CSE 11,A01,083080,Cao; Yingjun,0,60,40,40
1650035822863,CSE 12,A01,083652,Staff,2,0,100,98
1650035828896,CSE 15L,A01,083654,Staff,0,0,50,50
1650035828896,CSE 15L,A02,083655,Staff,15,0,50,35
1650035834942,CSE 20,A01,083657,Staff,57,0,80,23
1650035840966,CSE 30,A01,083084,Eldon; John,0,62,40,40
1650035846997,CSE 100,A01,083659,Cao; Yingjun,0,57,50,50
1650035853019,CSE 134B,A01,083661,Powell; Thomas Allan,0,25,65,65
1650035859142,CSE 140,A01,083663,Staff,8,0,75,67
1650035865171,CSE 140L,A01,083088,Eldon; John,4,0,75,71
1650035871207,CSE 175,A01,083665,Kumar; Rakesh,10,0,25,15
1650035877231,CSE 190,A00,092507,Dubnov; Shlomo,17,0,20,3
1650035883253,ECE 45,A01,083139,Staff,0,10,40,40
1650035889280,ECE 65,A50,083695,Staff,0,1,30,30
1650035895304,ECE 109,A01,091882,Touri; Behrouz,48,0,70,22
1650035901327,ECE 180,A00,083140,Abi Samra; Nicholas Camill,26,0,30,4
1650035901327,ECE 180,B00,083141,Abi Samra; Nicholas Camill,9,0,30,21
1650035907353,MATH 10A,A01,083735,Patchell; Gregory David,14,0,30,16
1650035907353,MATH 10A,A02,083736,Patchell; Gregory David,28,0,30,2
1650035907353,MATH 10A,A03,083737,Patchell; Gregory David,27,0,30,3
1650035913377,MATH 10B,A01,083207,Staff,0,4,30,30
1650035913377,MATH 10B,A02,083208,Staff,0,0,30,30
1650035913377,MATH 10B,B01,083739,Staff,20,0,30,10
1650035913377,MATH 10B,B02,083740,Staff,30,0,30,0
1650035919402,MATH 18,A01,083743,Staff,10,0,30,20
1650035919402,MATH 18,A02,083744,Staff,28,0,30,2
1650035919402,MATH 18,A03,083745,Staff,23,0,30,7
1650035919402,MATH 18,A04,083746,Staff,27,0,30,3
1650035919402,MATH 18,B01,083748,Staff,0,8,30,30
1650035919402,MATH 18,B02,083749,Staff,0,6,30,30
1650035919402,MATH 18,B03,083750,Staff,0,6,30,30
1650035919402,MATH 18,B04,083751,Staff,1,7,30,29
1650035925426,MATH 20A,A01,083754,Staff,27,0,40,13
1650035931448,MATH 20B,A01,083756,Staff,0,4,30,30
1650035931448,MATH 20B,A02,083757,Staff,2,0,30,28
1650035937476,MATH 20C,A01,083760,Staff,0,9,30,30
1650035937476,MATH 20C,A02,083761,Staff,0,11,30,30
1650035937476,MATH 20C,B01,083762,Staff,17,0,30,13
1650035937476,MATH 20C,B02,083763,Staff,28,0,30,2
1650035943500,MATH 20D,A01,083765,Staff,0,2,30,30
1650035943500,MATH 20D,A02,083766,Staff,16,0,30,14
1650035943500,MATH 20D,A03,083767,Staff,28,0,30,2
1650035949525,MATH 20E,A01,083771,Staff,11,0,30,19
1650035949525,MATH 20E,A02,083772,Staff,20,0,30,10
1650035949525,MATH 20E,B01,083773,Staff,0,1,30,30
1650035949525,MATH 20E,B02,083774,Staff,19,0,30,11
1650035955550,MATH 103A,A01,083777,Staff,0,6,30,30
1650035955550,MATH 103A,A02,083778,Staff,0,7,30,30
1650035955550,MATH 103A,B01,083779,Staff,0,7,30,30
1650035955550,MATH 103A,B02,083780,Staff,0,6,30,30
1650035961575,MATH 105,A01,085443,Staff,0,11,30,30
1650035967601,MATH 109,A01,083213,Anzaldo; Leesa B,0,3,30,30
1650035967601,MATH 109,A02,083214,Anzaldo; Leesa B,0,4,30,30
1650035967601,MATH 109,B01,083215,Anzaldo; Leesa B,0,2,30,30
1650035967601,MATH 109,B02,083216,Anzaldo; Leesa B,0,2,30,30
1650035973629,MATH 142A,A01,083219,Chow; Bennett,0,7,30,30
1650035973629,MATH 142A,A02,083220,Chow; Bennett,0,7,30,30
1650035973629,MATH 142A,B01,083221,Chow; Bennett,0,8,30,30
1650035973629,MATH 142A,B02,083222,Chow; Bennett,0,7,30,30
1650035979656,MATH 193A,A01,083224,Staff,0,5,30,30
1650035979656,MATH 193A,A02,083225,Staff,0,4,30,30
1650035979656,MATH 193A,A03,083781,Staff,0,0,30,30
1650035979656,MATH 193A,A04,083782,Staff,9,0,30,21
1650035985680,MATH 197,001,091859,McAuley; Julian John,9999,0,9999,0
1650035991747,COGS 9,A01,083615,Staff,2,15,60,58
1650035997774,COGS 11,A01,083617,Boyle; Mary E. T.,25,0,40,15
1650036003803,COGS 13,A01,083071,Staff,0,28,40,40
1650036009834,COGS 14A,A01,092681,Staff,0,6,100,100
1650036015871,COGS 14B,A01,083073,Cheng; Tzu-Han,0,2,50,50
1650036021900,COGS 17,A01,092677,Staff,35,0,75,40
1650036027923,COGS 100,A01,083619,Staff,0,18,60,60
1650036033946,COGS 101A,A01,083621,Davis; Joshua Daniel,0,16,60,60
1650036039978,COGS 101B,A01,091572,Staff,16,0,60,44
1650036046002,COGS 101C,A01,083625,Delgado; Tania,21,0,30,9
1650036052026,COGS 107A,A01,083627,Boyle; Mary E. T.,0,1,60,60
1650036058050,COGS 118A,A01,083075,Staff,19,0,60,41
1650036064077,CSE 3,A50,083646,Miranda; Gregory Joseph,22,0,38,16
1650036064077,CSE 3,A51,083647,Miranda; Gregory Joseph,37,0,37,0
1650036070100,CSE 8A,A50,083650,Miranda; Gregory Joseph,0,14,40,40
1650036076124,CSE 11,A01,083080,Cao; Yingjun,0,60,40,40
1650036082153,CSE 12,A01,083652,Staff,2,0,100,98
1650036088184,CSE 15L,A01,083654,Staff,0,0,50,50
1650036088184,CSE 15L,A02,083655,Staff,15,0,50,35
1650036094219,CSE 20,A01,083657,Staff,57,0,80,23
1650036100253,CSE 30,A01,083084,Eldon; John,0,62,40,40
1650036106285,CSE 100,A01,083659,Cao; Yingjun,0,57,50,50
1650036112310,CSE 134B,A01,083661,Powell; Thomas Allan,0,25,65,65
1650036118336,CSE 140,A01,083663,Staff,8,0,75,67
1650036124359,CSE 140L,A01,083088,Eldon; John,4,0,75,71
1650036130388,CSE 175,A01,083665,Kumar; Rakesh,10,0,25,15
1650036136414,CSE 190,A00,092507,Dubnov; Shlomo,17,0,20,3
1650036142440,ECE 45,A01,083139,Staff,0,10,40,40
1650036148469,ECE 65,A50,083695,Staff,0,1,30,30
1650036154493,ECE 109,A01,091882,Touri; Behrouz,48,0,70,22
1650036160517,ECE 180,A00,083140,Abi Samra; Nicholas Camill,26,0,30,4
1650036160517,ECE 180,B00,083141,Abi Samra; Nicholas Camill,9,0,30,21
1650036166541,MATH 10A,A01,083735,Patchell; Gregory David,14,0,30,16
1650036166541,MATH 10A,A02,083736,Patchell; Gregory David,28,0,30,2
1650036166541,MATH 10A,A03,083737,Patchell; Gregory David,27,0,30,3
1650036172565,MATH 10B,A01,083207,Staff,0,4,30,30
1650036172565,MATH 10B,A02,083208,Staff,0,0,30,30
1650036172565,MATH 10B,B01,083739,Staff,20,0,30,10
1650036172565,MATH 10B,B02,083740,Staff,30,0,30,0
1650036178597,MATH 18,A01,083743,Staff,10,0,30,20
1650036178597,MATH 18,A02,083744,Staff,28,0,30,2
1650036178597,MATH 18,A03,083745,Staff,23,0,30,7
1650036178597,MATH 18,A04,083746,Staff,27,0,30,3
1650036178597,MATH 18,B01,083748,Staff,0,8,30,30
1650036178597,MATH 18,B02,083749,Staff,0,6,30,30
1650036178597,MATH 18,B03,083750,Staff,0,6,30,30
1650036178597,MATH 18,B04,083751,Staff,1,7,30,29
1650036184620,MATH 20A,A01,083754,Staff,27,0,40,13
1650036190649,MATH 20B,A01,083756,Staff,0,4,30,30
1650036190649,MATH 20B,A02,083757,Staff,2,0,30,28
1650036196677,MATH 20C,A01,083760,Staff,0,9,30,30
1650036196677,MATH 20C,A02,083761,Staff,0,11,30,30
1650036196677,MATH 20C,B01,083762,Staff,17,0,30,13
1650036196677,MATH 20C,B02,083763,Staff,28,0,30,2
1650036202701,MATH 20D,A01,083765,Staff,0,2,30,30
1650036202701,MATH 20D,A02,083766,Staff,16,0,30,14
1650036202701,MATH 20D,A03,083767,Staff,28,0,30,2
1650036208732,MATH 20E,A01,083771,Staff,11,0,30,19
1650036208732,MATH 20E,A02,083772,Staff,20,0,30,10
1650036208732,MATH 20E,B01,083773,Staff,0,1,30,30
1650036208732,MATH 20E,B02,083774,Staff,19,0,30,11
1650036214760,MATH 103A,A01,083777,Staff,0,6,30,30
1650036214760,MATH 103A,A02,083778,Staff,0,7,30,30
1650036214760,MATH 103A,B01,083779,Staff,0,7,30,30
1650036214760,MATH 103A,B02,083780,Staff,0,6,30,30
1650036220784,MATH 105,A01,085443,Staff,0,11,30,30
1650036226807,MATH 109,A01,083213,Anzaldo; Leesa B,0,3,30,30
1650036226807,MATH 109,A02,083214,Anzaldo; Leesa B,0,4,30,30
1650036226807,MATH 109,B01,083215,Anzaldo; Leesa B,0,2,30,30
1650036226807,MATH 109,B02,083216,Anzaldo; Leesa B,0,2,30,30
1650036232833,MATH 142A,A01,083219,Chow; Bennett,0,7,30,30
1650036232833,MATH 142A,A02,083220,Chow; Bennett,0,7,30,30
1650036232833,MATH 142A,B01,083221,Chow; Bennett,0,8,30,30
1650036232833,MATH 142A,B02,083222,Chow; Bennett,0,7,30,30
1650036238859,MATH 193A,A01,083224,Staff,0,5,30,30
1650036238859,MATH 193A,A02,083225,Staff,0,4,30,30
1650036238859,MATH 193A,A03,083781,Staff,0,0,30,30
1650036238859,MATH 193A,A04,083782,Staff,9,0,30,21
1650036244884,MATH 197,001,091859,McAuley; Julian John,9999,0,9999,0
1650036250951,COGS 9,A01,083615,Staff,2,15,60,58
1650036256978,COGS 11,A01,083617,Boyle; Mary E. T.,25,0,40,15
1650036263004,COGS 13,A01,083071,Staff,0,28,40,40
1650036269026,COGS 14A,A01,092681,Staff,0,6,100,100
1650036275056,COGS 14B,A01,083073,Cheng; Tzu-Han,0,2,50,50
1650036281077,COGS 17,A01,092677,Staff,35,0,75,40
1650036287102,COGS 100,A01,083619,Staff,0,18,60,60
1650036293129,COGS 101A,A01,083621,Davis; Joshua Daniel,0,16,60,60
1650036299154,COGS 101B,A01,091572,Staff,16,0,60,44
1650036305184,COGS 101C,A01,083625,Delgado; Tania,21,0,30,9
1650036311216,COGS 107A,A01,083627,Boyle; Mary E. T.,0,1,60,60
1650036317239,COGS 118A,A01,083075,Staff,19,0,60,41
1650036323263,CSE 3,A50,083646,Miranda; Gregory Joseph,22,0,38,16
1650036323263,CSE 3,A51,083647,Miranda; Gregory Joseph,37,0,37,0
1650036329385,CSE 8A,A50,083650,Miranda; Gregory Joseph,0,14,40,40
1650036335413,CSE 11,A01,083080,Cao; Yingjun,0,60,40,40
1650036341440,CSE 12,A01,083652,Staff,2,0,100,98
1650036347461,CSE 15L,A01,083654,Staff,0,0,50,50
1650036347461,CSE 15L,A02,083655,Staff,15,0,50,35
1650036353487,CSE 20,A01,083657,Staff,57,0,80,23
1650036359513,CSE 30,A01,083084,Eldon; John,0,62,40,40
1650036365536,CSE 100,A01,083659,Cao; Yingjun,0,57,50,50
1650036371560,CSE 134B,A01,083661,Powell; Thomas Allan,0,25,65,65
1650036377587,CSE 140,A01,083663,Staff,8,0,75,67
1650036383614,CSE 140L,A01,083088,Eldon; John,4,0,75,71
1650036389637,CSE 175,A01,083665,Kumar; Rakesh,10,0,25,15
1650036395662,CSE 190,A00,092507,Dubnov; Shlomo,17,0,20,3
1650036401690,ECE 45,A01,083139,Staff,0,10,40,40
1650036407723,ECE 65,A50,083695,Staff,0,1,30,30
1650036413748,ECE 109,A01,091882,Touri; Behrouz,48,0,70,22
1650036419775,ECE 180,A00,083140,Abi Samra; Nicholas Camill,26,0,30,4
1650036419775,ECE 180,B00,083141,Abi Samra; Nicholas Camill,9,0,30,21
1650036425804,MATH 10A,A01,083735,Patchell; Gregory David,14,0,30,16
1650036425804,MATH 10A,A02,083736,Patchell; Gregory David,28,0,30,2
1650036425804,MATH 10A,A03,083737,Patchell; Gregory David,27,0,30,3
1650036431830,MATH 10B,A01,083207,Staff,0,4,30,30
1650036431830,MATH 10B,A02,083208,Staff,0,0,30,30
1650036431830,MATH 10B,B01,083739,Staff,20,0,30,10
1650036431830,MATH 10B,B02,083740,Staff,30,0,30,0
1650036437856,MATH 18,A01,083743,Staff,10,0,30,20
1650036437856,MATH 18,A02,083744,Staff,28,0,30,2
1650036437856,MATH 18,A03,083745,Staff,23,0,30,7
1650036437856,MATH 18,A04,083746,Staff,27,0,30,3
1650036437856,MATH 18,B01,083748,Staff,0,8,30,30
1650036437856,MATH 18,B02,083749,Staff,0,6,30,30
1650036437856,MATH 18,B03,083750,Staff,0,6,30,30
1650036437856,MATH 18,B04,083751,Staff,1,7,30,29
1650036443885,MATH 20A,A01,083754,Staff,27,0,40,13
1650036449912,MATH 20B,A01,083756,Staff,0,4,30,30
1650036449912,MATH 20B,A02,083757,Staff,2,0,30,28
1650036455936,MATH 20C,A01,083760,Staff,0,9,30,30
1650036455936,MATH 20C,A02,083761,Staff,0,11,30,30
1650036455936,MATH 20C,B01,083762,Staff,17,0,30,13
1650036455936,MATH 20C,B02,083763,Staff,28,0,30,2
1650036461959,MATH 20D,A01,083765,Staff,0,2,30,30
1650036461959,MATH 20D,A02,083766,Staff,16,0,30,14
1650036461959,MATH 20D,A03,083767,Staff,28,0,30,2
1650036467986,MATH 20E,A01,083771,Staff,11,0,30,19
1650036467986,MATH 20E,A02,083772,Staff,20,0,30,10
1650036467986,MATH 20E,B01,083773,Staff,0,1,30,30
1650036467986,MATH 20E,B02,083774,Staff,19,0,30,11
1650036474023,MATH 103A,A01,083777,Staff,0,6,30,30
1650036474023,MATH 103A,A02,083778,Staff,0,7,30,30
1650036474023,MATH 103A,B01,083779,Staff,0,7,30,30
1650036474023,MATH 103A,B02,083780,Staff,0,6,30,30
1650036480051,MATH 105,A01,085443,Staff,0,11,30,30
1650036486075,MATH 109,A01,083213,Anzaldo; Leesa B,0,3,30,30
1650036486075,MATH 109,A02,083214,Anzaldo; Leesa B,0,4,30,30
1650036486075,MATH 109,B01,083215,Anzaldo; Leesa B,0,2,30,30
1650036486075,MATH 109,B02,083216,Anzaldo; Leesa B,0,2,30,30
1650036492104,MATH 142A,A01,083219,Chow; Bennett,0,7,30,30
1650036492104,MATH 142A,A02,083220,Chow; Bennett,0,7,30,30
1650036492104,MATH 142A,B01,083221,Chow; Bennett,0,8,30,30
1650036492104,MATH 142A,B02,083222,Chow; Bennett,0,7,30,30
1650036498128,MATH 193A,A01,083224,Staff,0,5,30,30
1650036498128,MATH 193A,A02,083225,Staff,0,4,30,30
1650036498128,MATH 193A,A03,083781,Staff,0,0,30,30
1650036498128,MATH 193A,A04,083782,Staff,9,0,30,21
1650036504155,MATH 197,001,091859,McAuley; Julian John,9999,0,9999,0
1650036510214,COGS 9,A01,083615,Staff,2,15,60,58
1650036516248,COGS 11,A01,083617,Boyle; Mary E. T.,25,0,40,15
1650036522276,COGS 13,A01,083071,Staff,0,28,40,40
1650036528304,COGS 14A,A01,092681,Staff,0,6,100,100
1650036534338,COGS 14B,A01,083073,Cheng; Tzu-Han,0,2,50,50
1650036540370,COGS 17,A01,092677,Staff,35,0,75,40
1650036546392,COGS 100,A01,083619,Staff,0,18,60,60
1650036552420,COGS 101A,A01,083621,Davis; Joshua Daniel,0,16,60,60
1650036558445,COGS 101B,A01,091572,Staff,16,0,60,44
1650036564481,COGS 101C,A01,083625,Delgado; Tania,21,0,30,9
1650036570504,COGS 107A,A01,083627,Boyle; Mary E. T.,0,1,60,60
1650036576530,COGS 118A,A01,083075,Staff,19,0,60,41
1650036582557,CSE 3,A50,083646,Miranda; Gregory Joseph,22,0,38,16
1650036582557,CSE 3,A51,083647,Miranda; Gregory Joseph,37,0,37,0
1650036588582,CSE 8A,A50,083650,Miranda; Gregory Joseph,0,14,40,40
1650036594609,CSE 11,A01,083080,Cao; Yingjun,0,60,40,40
1650036600634,CSE 12,A01,083652,Staff,2,0,100,98
1650036606657,CSE 15L,A01,083654,Staff,0,0,50,50
1650036606657,CSE 15L,A02,083655,Staff,15,0,50,35
1650036612678,CSE 20,A01,083657,Staff,57,0,80,23
1650036618713,CSE 30,A01,083084,Eldon; John,0,62,40,40
1650036624739,CSE 100,A01,083659,Cao; Yingjun,0,57,50,50
1650036630767,CSE 134B,A01,083661,Powell; Thomas Allan,0,25,65,65
1650036636793,CSE 140,A01,083663,Staff,8,0,75,67
1650036642816,CSE 140L,A01,083088,Eldon; John,4,0,75,71
1650036648842,CSE 175,A01,083665,Kumar; Rakesh,10,0,25,15
1650036654865,CSE 190,A00,092507,Dubnov; Shlomo,17,0,20,3
1650036660902,ECE 45,A01,083139,Staff,0,10,40,40
1650036666927,ECE 65,A50,083695,Staff,0,1,30,30
1650036672954,ECE 109,A01,091882,Touri; Behrouz,48,0,70,22
1650036678981,ECE 180,A00,083140,Abi Samra; Nicholas Camill,26,0,30,4
1650036678981,ECE 180,B00,083141,Abi Samra; Nicholas Camill,9,0,30,21
1650036685010,MATH 10A,A01,083735,Patchell; Gregory David,14,0,30,16
1650036685010,MATH 10A,A02,083736,Patchell; Gregory David,28,0,30,2
1650036685010,MATH 10A,A03,083737,Patchell; Gregory David,27,0,30,3
1650036691038,MATH 10B,A01,083207,Staff,0,4,30,30
1650036691038,MATH 10B,A02,083208,Staff,0,0,30,30
1650036691038,MATH 10B,B01,083739,Staff,20,0,30,10
1650036691038,MATH 10B,B02,083740,Staff,30,0,30,0
1650036697071,MATH 18,A01,083743,Staff,10,0,30,20
1650036697071,MATH 18,A02,083744,Staff,28,0,30,2
1650036697071,MATH 18,A03,083745,Staff,23,0,30,7
1650036697071,MATH 18,A04,083746,Staff,27,0,30,3
1650036697071,MATH 18,B01,083748,Staff,0,8,30,30
1650036697071,MATH 18,B02,083749,Staff,0,6,30,30
1650036697071,MATH 18,B03,083750,Staff,0,6,30,30
1650036697071,MATH 18,B04,083751,Staff,1,7,30,29
1650036703101,MATH 20A,A01,083754,Staff,27,0,40,13
1650036709134,MATH 20B,A01,083756,Staff,0,4,30,30
1650036709134,MATH 20B,A02,083757,Staff,2,0,30,28
1650036715166,MATH 20C,A01,083760,Staff,0,9,30,30
1650036715166,MATH 20C,A02,083761,Staff,0,11,30,30
1650036715166,MATH 20C,B01,083762,Staff,17,0,30,13
1650036715166,MATH 20C,B02,083763,Staff,28,0,30,2
1650036721196,MATH 20D,A01,083765,Staff,0,2,30,30
1650036721196,MATH 20D,A02,083766,Staff,16,0,30,14
1650036721196,MATH 20D,A03,083767,Staff,28,0,30,2
1650036727221,MATH 20E,A01,083771,Staff,11,0,30,19
1650036727221,MATH 20E,A02,083772,Staff,20,0,30,10
1650036727221,MATH 20E,B01,083773,Staff,0,1,30,30
1650036727221,MATH 20E,B02,083774,Staff,19,0,30,11
1650036733247,MATH 103A,A01,083777,Staff,0,6,30,30
1650036733247,MATH 103A,A02,083778,Staff,0,7,30,30
1650036733247,MATH 103A,B01,083779,Staff,0,7,30,30
1650036733247,MATH 103A,B02,083780,Staff,0,6,30,30
1650036739271,MATH 105,A01,085443,Staff,0,11,30,30
1650036745293,MATH 109,A01,083213,Anzaldo; Leesa B,0,3,30,30
1650036745293,MATH 109,A02,083214,Anzaldo; Leesa B,0,4,30,30
1650036745293,MATH 109,B01,083215,Anzaldo; Leesa B,0,2,30,30
1650036745293,MATH 109,B02,083216,Anzaldo; Leesa B,0,2,30,30
1650036751319,MATH 142A,A01,083219,Chow; Bennett,0,7,30,30
1650036751319,MATH 142A,A02,083220,Chow; Bennett,0,7,30,30
1650036751319,MATH 142A,B01,083221,Chow; Bennett,0,8,30,30
1650036751319,MATH 142A,B02,083222,Chow; Bennett,0,7,30,30
1650036757349,MATH 193A,A01,083224,Staff,0,5,30,30
1650036757349,MATH 193A,A02,083225,Staff,0,4,30,30
1650036757349,MATH 193A,A03,083781,Staff,0,0,30,30
1650036757349,MATH 193A,A04,083782,Staff,9,0,30,21
1650036763377,MATH 197,001,091859,McAuley; Julian John,9999,0,9999,0
1650036769438,COGS 9,A01,083615,Staff,2,15,60,58
1650036775469,COGS 11,A01,083617,Boyle; Mary E. T.,25,0,40,15
1650036781496,COGS 13,A01,083071,Staff,0,28,40,40
1650036787519,COGS 14A,A01,092681,Staff,0,6,100,100
1650036793554,COGS 14B,A01,083073,Cheng; Tzu-Han,0,2,50,50
1650036799575,COGS 17,A01,092677,Staff,35,0,75,40
1650036805610,COGS 100,A01,083619,Staff,0,18,60,60
1650036811632,COGS 101A,A01,083621,Davis; Joshua Daniel,0,16,60,60
1650036817658,COGS 101B,A01,091572,Staff,16,0,60,44
1650036823692,COGS 101C,A01,083625,Delgado; Tania,21,0,30,9
1650036829716,COGS 107A,A01,083627,Boyle; Mary E. T.,0,1,60,60
1650036835748,COGS 118A,A01,083075,Staff,19,0,60,41
1650036841774,CSE 3,A50,083646,Miranda; Gregory Joseph,22,0,38,16
1650036841774,CSE 3,A51,083647,Miranda; Gregory Joseph,37,0,37,0
1650036847802,CSE 8A,A50,083650,Miranda; Gregory Joseph,0,14,40,40
1650036853825,CSE 11,A01,083080,Cao; Yingjun,0,60,40,40
1650036859851,CSE 12,A01,083652,Staff,2,0,100,98
1650036865886,CSE 15L,A01,083654,Staff,0,0,50,50
1650036865886,CSE 15L,A02,083655,Staff,15,0,50,35
1650036871915,CSE 20,A01,083657,Staff,57,0,80,23
1650036877944,CSE 30,A01,083084,Eldon; John,0,62,40,40
1650036883978,CSE 100,A01,083659,Cao; Yingjun,0,57,50,50
1650036890002,CSE 134B,A01,083661,Powell; Thomas Allan,0,25,65,65
1650036896047,CSE 140,A01,083663,Staff,8,0,75,67
1650036902074,CSE 140L,A01,083088,Eldon; John,4,0,75,71
1650036908111,CSE 175,A01,083665,Kumar; Rakesh,10,0,25,15
1650036914138,CSE 190,A00,092507,Dubnov; Shlomo,17,0,20,3
1650036920168,ECE 45,A01,083139,Staff,0,10,40,40
1650036926260,ECE 65,A50,083695,Staff,0,1,30,30
1650036932286,ECE 109,A01,091882,Touri; Behrouz,48,0,70,22
1650036938309,ECE 180,A00,083140,Abi Samra; Nicholas Camill,26,0,30,4
1650036938309,ECE 180,B00,083141,Abi Samra; Nicholas Camill,9,0,30,21
1650036944342,MATH 10A,A01,083735,Patchell; Gregory David,14,0,30,16
1650036944342,MATH 10A,A02,083736,Patchell; Gregory David,28,0,30,2
1650036944342,MATH 10A,A03,083737,Patchell; Gregory David,27,0,30,3
1650036950373,MATH 10B,A01,083207,Staff,0,4,30,30
1650036950373,MATH 10B,A02,083208,Staff,0,0,30,30
1650036950373,MATH 10B,B01,083739,Staff,20,0,30,10
1650036950373,MATH 10B,B02,083740,Staff,30,0,30,0
1650036956403,MATH 18,A01,083743,Staff,10,0,30,20
1650036956403,MATH 18,A02,083744,Staff,28,0,30,2
1650036956403,MATH 18,A03,083745,Staff,23,0,30,7
1650036956403,MATH 18,A04,083746,Staff,27,0,30,3
1650036956403,MATH 18,B01,083748,Staff,0,8,30,30
1650036956403,MATH 18,B02,083749,Staff,0,6,30,30
1650036956403,MATH 18,B03,083750,Staff,0,6,30,30
1650036956403,MATH 18,B04,083751,Staff,1,7,30,29
1650036962429,MATH 20A,A01,083754,Staff,27,0,40,13
1650036968466,MATH 20B,A01,083756,Staff,0,4,30,30
1650036968466,MATH 20B,A02,083757,Staff,2,0,30,28
1650036974492,MATH 20C,A01,083760,Staff,0,9,30,30
1650036974492,MATH 20C,A02,083761,Staff,0,11,30,30
1650036974492,MATH 20C,B01,083762,Staff,17,0,30,13
1650036974492,MATH 20C,B02,083763,Staff,28,0,30,2
1650036980515,MATH 20D,A01,083765,Staff,0,2,30,30
1650036980515,MATH 20D,A02,083766,Staff,16,0,30,14
1650036980515,MATH 20D,A03,083767,Staff,28,0,30,2
1650036986538,MATH 20E,A01,083771,Staff,11,0,30,19
1650036986538,MATH 20E,A02,083772,Staff,20,0,30,10
1650036986538,MATH 20E,B01,083773,Staff,0,1,30,30
1650036986538,MATH 20E,B02,083774,Staff,19,0,30,11
1650036992565,MATH 103A,A01,083777,Staff,0,6,30,30
1650036992565,MATH 103A,A02,083778,Staff,0,7,30,30
1650036992565,MATH 103A,B01,083779,Staff,0,7,30,30
1650036992565,MATH 103A,B02,083780,Staff,0,6,30,30
1650036998590,MATH 105,A01,085443,Staff,0,11,30,30
1650037004611,MATH 109,A01,083213,Anzaldo; Leesa B,0,3,30,30
1650037004611,MATH 109,A02,083214,Anzaldo; Leesa B,0,4,30,30
1650037004611,MATH 109,B01,083215,Anzaldo; Leesa B,0,2,30,30
1650037004611,MATH 109,B02,083216,Anzaldo; Leesa B,0,2,30,30
1650037010640,MATH 142A,A01,083219,Chow; Bennett,0,7,30,30
1650037010640,MATH 142A,A02,083220,Chow; Bennett,0,7,30,30
1650037010640,MATH 142A,B01,083221,Chow; Bennett,0,8,30,30
1650037010640,MATH 142A,B02,083222,Chow; Bennett,0,7,30,30
1650037016673,MATH 193A,A01,083224,Staff,0,5,30,30
1650037016673,MATH 193A,A02,083225,Staff,0,4,30,30
1650037016673,MATH 193A,A03,083781,Staff,0,0,30,30
1650037016673,MATH 193A,A04,083782,Staff,9,0,30,21
1650037022696,MATH 197,001,091859,McAuley; Julian John,9999,0,9999,0
1650037028756,COGS 9,A01,083615,Staff,2,15,60,58
1650037034787,COGS 11,A01,083617,Boyle; Mary E. T.,25,0,40,15
1650037040811,COGS 13,A01,083071,Staff,0,28,40,40
1650037046835,COGS 14A,A01,092681,Staff,0,6,100,100
1650037052858,COGS 14B,A01,083073,Cheng; Tzu-Han,0,2,50,50
1650037058880,COGS 17,A01,092677,Staff,35,0,75,40
1650037064904,COGS 100,A01,083619,Staff,0,18,60,60
1650037070928,COGS 101A,A01,083621,Davis; Joshua Daniel,0,16,60,60
1650037076952,COGS 101B,A01,091572,Staff,16,0,60,44
1650037082978,COGS 101C,A01,083625,Delgado; Tania,21,0,30,9
1650037089005,COGS 107A,A01,083627,Boyle; Mary E. T.,0,1,60,60
1650037095030,COGS 118A,A01,083075,Staff,19,0,60,41
1650037101053,CSE 3,A50,083646,Miranda; Gregory Joseph,22,0,38,16
1650037101053,CSE 3,A51,083647,Miranda; Gregory Joseph,37,0,37,0
1650037107084,CSE 8A,A50,083650,Miranda; Gregory Joseph,0,14,40,40
1650037113108,CSE 11,A01,083080,Cao; Yingjun,0,60,40,40
1650037119147,CSE 12,A01,083652,Staff,2,0,100,98
1650037125172,CSE 15L,A01,083654,Staff,0,0,50,50
1650037125172,CSE 15L,A02,083655,Staff,15,0,50,35
1650037131196,CSE 20,A01,083657,Staff,57,0,80,23
1650037137222,CSE 30,A01,083084,Eldon; John,0,62,40,40
1650037143251,CSE 100,A01,083659,Cao; Yingjun,0,57,50,50
1650037149279,CSE 134B,A01,083661,Powell; Thomas Allan,0,25,65,65
1650037155312,CSE 140,A01,083663,Staff,8,0,75,67
1650037161336,CSE 140L,A01,083088,Eldon; John,4,0,75,71
1650037167362,CSE 175,A01,083665,Kumar; Rakesh,10,0,25,15
1650037173397,CSE 190,A00,092507,Dubnov; Shlomo,17,0,20,3
1650037179423,ECE 45,A01,083139,Staff,0,10,40,40
1650037185452,ECE 65,A50,083695,Staff,0,1,30,30
1650037191479,ECE 109,A01,091882,Touri; Behrouz,48,0,70,22
1650037197505,ECE 180,A00,083140,Abi Samra; Nicholas Camill,26,0,30,4
1650037197505,ECE 180,B00,083141,Abi Samra; Nicholas Camill,9,0,30,21
1650037203532,MATH 10A,A01,083735,Patchell; Gregory David,14,0,30,16
1650037203532,MATH 10A,A02,083736,Patchell; Gregory David,28,0,30,2
1650037203532,MATH 10A,A03,083737,Patchell; Gregory David,27,0,30,3
1650037209561,MATH 10B,A01,083207,Staff,0,4,30,30
1650037209561,MATH 10B,A02,083208,Staff,0,0,30,30
1650037209561,MATH 10B,B01,083739,Staff,20,0,30,10
1650037209561,MATH 10B,B02,083740,Staff,30,0,30,0
1650037215599,MATH 18,A01,083743,Staff,10,0,30,20
1650037215599,MATH 18,A02,083744,Staff,28,0,30,2
1650037215599,MATH 18,A03,083745,Staff,23,0,30,7
1650037215599,MATH 18,A04,083746,Staff,27,0,30,3
1650037215599,MATH 18,B01,083748,Staff,0,8,30,30
1650037215599,MATH 18,B02,083749,Staff,0,6,30,30
1650037215599,MATH 18,B03,083750,Staff,0,6,30,30
1650037215599,MATH 18,B04,083751,Staff,1,7,30,29
1650037221623,MATH 20A,A01,083754,Staff,27,0,40,13
1650037227650,MATH 20B,A01,083756,Staff,0,4,30,30
1650037227650,MATH 20B,A02,083757,Staff,2,0,30,28
1650037233675,MATH 20C,A01,083760,Staff,0,9,30,30
1650037233675,MATH 20C,A02,083761,Staff,0,11,30,30
1650037233675,MATH 20C,B01,083762,Staff,17,0,30,13
1650037233675,MATH 20C,B02,083763,Staff,28,0,30,2
1650037239699,MATH 20D,A01,083765,Staff,0,2,30,30
1650037239699,MATH 20D,A02,083766,Staff,16,0,30,14
1650037239699,MATH 20D,A03,083767,Staff,28,0,30,2
1650037245726,MATH 20E,A01,083771,Staff,11,0,30,19
1650037245726,MATH 20E,A02,083772,Staff,20,0,30,10
1650037245726,MATH 20E,B01,083773,Staff,0,1,30,30
1650037245726,MATH 20E,B02,083774,Staff,19,0,30,11
1650037251758,MATH 103A,A01,083777,Staff,0,6,30,30
1650037251758,MATH 103A,A02,083778,Staff,0,7,30,30
1650037251758,MATH 103A,B01,083779,Staff,0,7,30,30
1650037251758,MATH 103A,B02,083780,Staff,0,6,30,30
1650037257782,MATH 105,A01,085443,Staff,0,11,30,30
1650037263813,MATH 109,A01,083213,Anzaldo; Leesa B,0,3,30,30
1650037263813,MATH 109,A02,083214,Anzaldo; Leesa B,0,4,30,30
1650037263813,MATH 109,B01,083215,Anzaldo; Leesa B,0,2,30,30
1650037263813,MATH 109,B02,083216,Anzaldo; Leesa B,0,2,30,30
1650037269837,MATH 142A,A01,083219,Chow; Bennett,0,7,30,30
1650037269837,MATH 142A,A02,083220,Chow; Bennett,0,7,30,30
1650037269837,MATH 142A,B01,083221,Chow; Bennett,0,8,30,30
1650037269837,MATH 142A,B02,083222,Chow; Bennett,0,7,30,30
1650037275863,MATH 193A,A01,083224,Staff,0,5,30,30
1650037275863,MATH 193A,A02,083225,Staff,0,4,30,30
1650037275863,MATH 193A,A03,083781,Staff,0,0,30,30
1650037275863,MATH 193A,A04,083782,Staff,9,0,30,21
1650037281886,MATH 197,001,091859,McAuley; Julian John,9999,0,9999,0
1650037287940,COGS 9,A01,083615,Staff,2,15,60,58
1650037293964,COGS 11,A01,083617,Boyle; Mary E. T.,25,0,40,15
1650037299986,COGS 13,A01,083071,Staff,0,28,40,40
1650037306013,COGS 14A,A01,092681,Staff,0,6,100,100
1650037312041,COGS 14B,A01,083073,Cheng; Tzu-Han,0,2,50,50
1650037318064,COGS 17,A01,092677,Staff,35,0,75,40
1650037324098,COGS 100,A01,083619,Staff,0,18,60,60
1650037330126,COGS 101A,A01,083621,Davis; Joshua Daniel,0,16,60,60
1650037336149,COGS 101B,A01,091572,Staff,16,0,60,44
1650037342173,COGS 101C,A01,083625,Delgado; Tania,21,0,30,9
1650037348202,COGS 107A,A01,083627,Boyle; Mary E. T.,0,1,60,60
1650037354224,COGS 118A,A01,083075,Staff,19,0,60,41
1650037360248,CSE 3,A50,083646,Miranda; Gregory Joseph,22,0,38,16
1650037360248,CSE 3,A51,083647,Miranda; Gregory Joseph,37,0,37,0
1650037366280,CSE 8A,A50,083650,Miranda; Gregory Joseph,0,14,40,40
1650037372305,CSE 11,A01,083080,Cao; Yingjun,0,60,40,40
1650037378332,CSE 12,A01,083652,Staff,2,0,100,98
1650037384358,CSE 15L,A01,083654,Staff,0,0,50,50
1650037384358,CSE 15L,A02,083655,Staff,15,0,50,35
1650037390383,CSE 20,A01,083657,Staff,57,0,80,23
1650037396410,CSE 30,A01,083084,Eldon; John,0,62,40,40
1650037402433,CSE 100,A01,083659,Cao; Yingjun,0,57,50,50
1650037408472,CSE 134B,A01,083661,Powell; Thomas Allan,0,25,65,65
1650037414496,CSE 140,A01,083663,Staff,8,0,75,67
1650037420521,CSE 140L,A01,083088,Eldon; John,4,0,75,71
1650037426544,CSE 175,A01,083665,Kumar; Rakesh,10,0,25,15
1650037432569,CSE 190,A00,092507,Dubnov; Shlomo,17,0,20,3
1650037438595,ECE 45,A01,083139,Staff,0,10,40,40
1650037444618,ECE 65,A50,083695,Staff,0,1,30,30
1650037450645,ECE 109,A01,091882,Touri; Behrouz,48,0,70,22
1650037456672,ECE 180,A00,083140,Abi Samra; Nicholas Camill,26,0,30,4
1650037456672,ECE 180,B00,083141,Abi Samra; Nicholas Camill,9,0,30,21
1650037462697,MATH 10A,A01,083735,Patchell; Gregory David,14,0,30,16
1650037462697,MATH 10A,A02,083736,Patchell; Gregory David,28,0,30,2
1650037462697,MATH 10A,A03,083737,Patchell; Gregory David,27,0,30,3
1650037468724,MATH 10B,A01,083207,Staff,0,4,30,30
1650037468724,MATH 10B,A02,083208,Staff,0,0,30,30
1650037468724,MATH 10B,B01,083739,Staff,20,0,30,10
1650037468724,MATH 10B,B02,083740,Staff,30,0,30,0
1650037474749,MATH 18,A01,083743,Staff,10,0,30,20
1650037474749,MATH 18,A02,083744,Staff,28,0,30,2
1650037474749,MATH 18,A03,083745,Staff,23,0,30,7
1650037474749,MATH 18,A04,083746,Staff,27,0,30,3
1650037474749,MATH 18,B01,083748,Staff,0,8,30,30
1650037474749,MATH 18,B02,083749,Staff,0,6,30,30
1650037474749,MATH 18,B03,083750,Staff,0,6,30,30
1650037474749,MATH 18,B04,083751,Staff,1,7,30,29
1650037480775,MATH 20A,A01,083754,Staff,27,0,40,13
1650037486808,MATH 20B,A01,083756,Staff,0,4,30,30
1650037486808,MATH 20B,A02,083757,Staff,2,0,30,28
1650037492848,MATH 20C,A01,083760,Staff,0,9,30,30
1650037492848,MATH 20C,A02,083761,Staff,0,11,30,30
1650037492848,MATH 20C,B01,083762,Staff,17,0,30,13
1650037492848,MATH 20C,B02,083763,Staff,28,0,30,2
1650037498874,MATH 20D,A01,083765,Staff,0,2,30,30
1650037498874,MATH 20D,A02,083766,Staff,16,0,30,14
1650037498874,MATH 20D,A03,083767,Staff,28,0,30,2
1650037504902,MATH 20E,A01,083771,Staff,11,0,30,19
1650037504902,MATH 20E,A02,083772,Staff,20,0,30,10
1650037504902,MATH 20E,B01,083773,Staff,0,1,30,30
1650037504902,MATH 20E,B02,083774,Staff,19,0,30,11
1650037510927,MATH 103A,A01,083777,Staff,0,6,30,30
1650037510927,MATH 103A,A02,083778,Staff,0,7,30,30
1650037510927,MATH 103A,B01,083779,Staff,0,7,30,30
1650037510927,MATH 103A,B02,083780,Staff,0,6,30,30
1650037516951,MATH 105,A01,085443,Staff,0,11,30,30
1650037523077,MATH 109,A01,083213,Anzaldo; Leesa B,0,3,30,30
1650037523077,MATH 109,A02,083214,Anzaldo; Leesa B,0,4,30,30
1650037523077,MATH 109,B01,083215,Anzaldo; Leesa B,0,2,30,30
1650037523077,MATH 109,B02,083216,Anzaldo; Leesa B,0,2,30,30
1650037529100,MATH 142A,A01,083219,Chow; Bennett,0,7,30,30
1650037529100,MATH 142A,A02,083220,Chow; Bennett,0,7,30,30
1650037529100,MATH 142A,B01,083221,Chow; Bennett,0,8,30,30
1650037529100,MATH 142A,B02,083222,Chow; Bennett,0,7,30,30
1650037535129,MATH 193A,A01,083224,Staff,0,5,30,30
1650037535129,MATH 193A,A02,083225,Staff,0,4,30,30
1650037535129,MATH 193A,A03,083781,Staff,0,0,30,30
1650037535129,MATH 193A,A04,083782,Staff,9,0,30,21
1650037541155,MATH 197,001,091859,McAuley; Julian John,9999,0,9999,0
1650037547217,COGS 9,A01,083615,Staff,2,15,60,58
1650037553239,COGS 11,A01,083617,Boyle; Mary E. T.,25,0,40,15
1650037559262,COGS 13,A01,083071,Staff,0,28,40,40
1650037565290,COGS 14A,A01,092681,Staff,0,6,100,100
1650037571313,COGS 14B,A01,083073,Cheng; Tzu-Han,0,2,50,50
1650037577335,COGS 17,A01,092677,Staff,35,0,75,40
1650037583359,COGS 100,A01,083619,Staff,0,18,60,60
1650037589382,COGS 101A,A01,083621,Davis; Joshua Daniel,0,16,60,60
1650037595407,COGS 101B,A01,091572,Staff,16,0,60,44
1650037601434,COGS 101C,A01,083625,Delgado; Tania,21,0,30,9
1650037607458,COGS 107A,A01,083627,Boyle; Mary E. T.,0,1,60,60
1650037613483,COGS 118A,A01,083075,Staff,19,0,60,41
1650037619524,CSE 3,A50,083646,Miranda; Gregory Joseph,22,0,38,16
1650037619524,CSE 3,A51,083647,Miranda; Gregory Joseph,37,0,37,0
1650037625553,CSE 8A,A50,083650,Miranda; Gregory Joseph,0,14,40,40
1650037631580,CSE 11,A01,083080,Cao; Yingjun,0,60,40,40
1650037637608,CSE 12,A01,083652,Staff,2,0,100,98
1650037643631,CSE 15L,A01,083654,Staff,0,0,50,50
1650037643631,CSE 15L,A02,083655,Staff,15,0,50,35
1650037649654,CSE 20,A01,083657,Staff,57,0,80,23
1650037655681,CSE 30,A01,083084,Eldon; John,0,62,40,40
1650037661705,CSE 100,A01,083659,Cao; Yingjun,0,57,50,50
1650037667733,CSE 134B,A01,083661,Powell; Thomas Allan,0,25,65,65
1650037673761,CSE 140,A01,083663,Staff,8,0,75,67
1650037679789,CSE 140L,A01,083088,Eldon; John,4,0,75,71
1650037685813,CSE 175,A01,083665,Kumar; Rakesh,10,0,25,15
1650037691843,CSE 190,A00,092507,Dubnov; Shlomo,17,0,20,3
1650037697867,ECE 45,A01,083139,Staff,0,10,40,40
1650037703890,ECE 65,A50,083695,Staff,0,1,30,30
1650037709914,ECE 109,A01,091882,Touri; Behrouz,48,0,70,22
1650037715942,ECE 180,A00,083140,Abi Samra; Nicholas Camill,26,0,30,4
1650037715942,ECE 180,B00,083141,Abi Samra; Nicholas Camill,9,0,30,21
1650037721970,MATH 10A,A01,083735,Patchell; Gregory David,14,0,30,16
1650037721970,MATH 10A,A02,083736,Patchell; Gregory David,28,0,30,2
1650037721970,MATH 10A,A03,083737,Patchell; Gregory David,27,0,30,3
1650037727997,MATH 10B,A01,083207,Staff,0,4,30,30
1650037727997,MATH 10B,A02,083208,Staff,0,0,30,30
1650037727997,MATH 10B,B01,083739,Staff,20,0,30,10
1650037727997,MATH 10B,B02,083740,Staff,30,0,30,0
1650037734027,MATH 18,A01,083743,Staff,10,0,30,20
1650037734027,MATH 18,A02,083744,Staff,28,0,30,2
1650037734027,MATH 18,A03,083745,Staff,23,0,30,7
1650037734027,MATH 18,A04,083746,Staff,27,0,30,3
1650037734027,MATH 18,B01,083748,Staff,0,8,30,30
1650037734027,MATH 18,B02,083749,Staff,0,6,30,30
1650037734027,MATH 18,B03,083750,Staff,0,6,30,30
1650037734027,MATH 18,B04,083751,Staff,1,7,30,29
1650037740051,MATH 20A,A01,083754,Staff,27,0,40,13
1650037746075,MATH 20B,A01,083756,Staff,0,4,30,30
1650037746075,MATH 20B,A02,083757,Staff,2,0,30,28
1650037752097,MATH 20C,A01,083760,Staff,0,9,30,30
1650037752097,MATH 20C,A02,083761,Staff,0,11,30,30
1650037752097,MATH 20C,B01,083762,Staff,17,0,30,13
1650037752097,MATH 20C,B02,083763,Staff,28,0,30,2
1650037758125,MATH 20D,A01,083765,Staff,0,2,30,30
1650037758125,MATH 20D,A02,083766,Staff,16,0,30,14
1650037758125,MATH 20D,A03,083767,Staff,28,0,30,2
1650037764148,MATH 20E,A01,083771,Staff,11,0,30,19
1650037764148,MATH 20E,A02,083772,Staff,20,0,30,10
1650037764148,MATH 20E,B01,083773,Staff,0,1,30,30
1650037764148,MATH 20E,B02,083774,Staff,19,0,30,11
1650037770181,MATH 103A,A01,083777,Staff,0,6,30,30
1650037770181,MATH 103A,A02,083778,Staff,0,7,30,30
1650037770181,MATH 103A,B01,083779,Staff,0,7,30,30
1650037770181,MATH 103A,B02,083780,Staff,0,6,30,30
1650037776204,MATH 105,A01,085443,Staff,0,11,30,30
1650037782229,MATH 109,A01,083213,Anzaldo; Leesa B,0,3,30,30
1650037782229,MATH 109,A02,083214,Anzaldo; Leesa B,0,4,30,30
1650037782229,MATH 109,B01,083215,Anzaldo; Leesa B,0,2,30,30
1650037782229,MATH 109,B02,083216,Anzaldo; Leesa B,0,2,30,30
1650037788253,MATH 142A,A01,083219,Chow; Bennett,0,7,30,30
1650037788253,MATH 142A,A02,083220,Chow; Bennett,0,7,30,30
1650037788253,MATH 142A,B01,083221,Chow; Bennett,0,8,30,30
1650037788253,MATH 142A,B02,083222,Chow; Bennett,0,7,30,30
1650037794277,MATH 193A,A01,083224,Staff,0,5,30,30
1650037794277,MATH 193A,A02,083225,Staff,0,4,30,30
1650037794277,MATH 193A,A03,083781,Staff,0,0,30,30
1650037794277,MATH 193A,A04,083782,Staff,9,0,30,21
1650037800314,MATH 197,001,091859,McAuley; Julian John,9999,0,9999,0
1650037806378,COGS 9,A01,083615,Staff,2,15,60,58
1650037812401,COGS 11,A01,083617,Boyle; Mary E. T.,25,0,40,15
1650037818424,COGS 13,A01,083071,Staff,0,28,40,40
1650037824449,COGS 14A,A01,092681,Staff,0,6,100,100
1650037830477,COGS 14B,A01,083073,Cheng; Tzu-Han,0,2,50,50
1650037836502,COGS 17,A01,092677,Staff,35,0,75,40
1650037842527,COGS 100,A01,083619,Staff,0,18,60,60
1650037848552,COGS 101A,A01,083621,Davis; Joshua Daniel,0,16,60,60
1650037854575,COGS 101B,A01,091572,Staff,16,0,60,44
1650037860599,COGS 101C,A01,083625,Delgado; Tania,21,0,30,9
1650037866634,COGS 107A,A01,083627,Boyle; Mary E. T.,0,1,60,60
1650037872657,COGS 118A,A01,083075,Staff,19,0,60,41
1650037878687,CSE 3,A50,083646,Miranda; Gregory Joseph,22,0,38,16
1650037878687,CSE 3,A51,083647,Miranda; Gregory Joseph,37,0,37,0
1650037884715,CSE 8A,A50,083650,Miranda; Gregory Joseph,0,14,40,40
1650037890743,CSE 11,A01,083080,Cao; Yingjun,0,60,40,40
1650037896775,CSE 12,A01,083652,Staff,2,0,100,98
1650037902818,CSE 15L,A01,083654,Staff,0,0,50,50
1650037902818,CSE 15L,A02,083655,Staff,15,0,50,35
1650037908845,CSE 20,A01,083657,Staff,57,0,80,23
1650037914873,CSE 30,A01,083084,Eldon; John,0,62,40,40
1650037920901,CSE 100,A01,083659,Cao; Yingjun,0,57,50,50
1650037926929,CSE 134B,A01,083661,Powell; Thomas Allan,0,25,65,65
1650037932955,CSE 140,A01,083663,Staff,8,0,75,67
1650037938978,CSE 140L,A01,083088,Eldon; John,4,0,75,71
1650037945000,CSE 175,A01,083665,Kumar; Rakesh,10,0,25,15
1650037951026,CSE 190,A00,092507,Dubnov; Shlomo,17,0,20,3
1650037957055,ECE 45,A01,083139,Staff,0,10,40,40
1650037963081,ECE 65,A50,083695,Staff,0,1,30,30
1650037969109,ECE 109,A01,091882,Touri; Behrouz,48,0,70,22
1650037975141,ECE 180,A00,083140,Abi Samra; Nicholas Camill,26,0,30,4
1650037975141,ECE 180,B00,083141,Abi Samra; Nicholas Camill,9,0,30,21
1650037981163,MATH 10A,A01,083735,Patchell; Gregory David,14,0,30,16
1650037981163,MATH 10A,A02,083736,Patchell; Gregory David,28,0,30,2
1650037981163,MATH 10A,A03,083737,Patchell; Gregory David,27,0,30,3
1650037987192,MATH 10B,A01,083207,Staff,0,4,30,30
1650037987192,MATH 10B,A02,083208,Staff,0,0,30,30
1650037987192,MATH 10B,B01,083739,Staff,20,0,30,10
1650037987192,MATH 10B,B02,083740,Staff,30,0,30,0
1650037993221,MATH 18,A01,083743,Staff,10,0,30,20
1650037993221,MATH 18,A02,083744,Staff,28,0,30,2
1650037993221,MATH 18,A03,083745,Staff,23,0,30,7
1650037993221,MATH 18,A04,083746,Staff,27,0,30,3
1650037993221,MATH 18,B01,083748,Staff,0,8,30,30
1650037993221,MATH 18,B02,083749,Staff,0,6,30,30
1650037993221,MATH 18,B03,083750,Staff,0,6,30,30
1650037993221,MATH 18,B04,083751,Staff,1,7,30,29
1650037999248,MATH 20A,A01,083754,Staff,27,0,40,13
1650038005272,MATH 20B,A01,083756,Staff,0,4,30,30
1650038005272,MATH 20B,A02,083757,Staff,2,0,30,28
1650038011301,MATH 20C,A01,083760,Staff,0,9,30,30
1650038011301,MATH 20C,A02,083761,Staff,0,11,30,30
1650038011301,MATH 20C,B01,083762,Staff,17,0,30,13
1650038011301,MATH 20C,B02,083763,Staff,28,0,30,2
1650038017325,MATH 20D,A01,083765,Staff,0,2,30,30
1650038017325,MATH 20D,A02,083766,Staff,16,0,30,14
1650038017325,MATH 20D,A03,083767,Staff,28,0,30,2
1650038023349,MATH 20E,A01,083771,Staff,11,0,30,19
1650038023349,MATH 20E,A02,083772,Staff,20,0,30,10
1650038023349,MATH 20E,B01,083773,Staff,0,1,30,30
1650038023349,MATH 20E,B02,083774,Staff,19,0,30,11
1650038029377,MATH 103A,A01,083777,Staff,0,6,30,30
1650038029377,MATH 103A,A02,083778,Staff,0,7,30,30
1650038029377,MATH 103A,B01,083779,Staff,0,7,30,30
1650038029377,MATH 103A,B02,083780,Staff,0,6,30,30
1650038035404,MATH 105,A01,085443,Staff,0,11,30,30
1650038041427,MATH 109,A01,083213,Anzaldo; Leesa B,0,3,30,30
1650038041427,MATH 109,A02,083214,Anzaldo; Leesa B,0,4,30,30
1650038041427,MATH 109,B01,083215,Anzaldo; Leesa B,0,2,30,30
1650038041427,MATH 109,B02,083216,Anzaldo; Leesa B,0,2,30,30
1650038047460,MATH 142A,A01,083219,Chow; Bennett,0,7,30,30
1650038047460,MATH 142A,A02,083220,Chow; Bennett,0,7,30,30
1650038047460,MATH 142A,B01,083221,Chow; Bennett,0,8,30,30
1650038047460,MATH 142A,B02,083222,Chow; Bennett,0,7,30,30
1650038053491,MATH 193A,A01,083224,Staff,0,5,30,30
1650038053491,MATH 193A,A02,083225,Staff,0,4,30,30
1650038053491,MATH 193A,A03,083781,Staff,0,0,30,30
1650038053491,MATH 193A,A04,083782,Staff,9,0,30,21
1650038059516,MATH 197,001,091859,McAuley; Julian John,9999,0,9999,0
1650038065573,COGS 9,A01,083615,Staff,2,15,60,58
1650038071600,COGS 11,A01,083617,Boyle; Mary E. T.,25,0,40,15
1650038077627,COGS 13,A01,083071,Staff,0,28,40,40
1650038083648,COGS 14A,A01,092681,Staff,0,6,100,100
1650038089684,COGS 14B,A01,083073,Cheng; Tzu-Han,0,2,50,50
1650038095707,COGS 17,A01,092677,Staff,35,0,75,40
1650038101735,COGS 100,A01,083619,Staff,0,18,60,60
1650038107758,COGS 101A,A01,083621,Davis; Joshua Daniel,0,16,60,60
1650038113879,COGS 101B,A01,091572,Staff,16,0,60,44
1650038119902,COGS 101C,A01,083625,Delgado; Tania,21,0,30,9
1650038125929,COGS 107A,A01,083627,Boyle; Mary E. T.,0,1,60,60
1650038131954,COGS 118A,A01,083075,Staff,19,0,60,41
1650038137985,CSE 3,A50,083646,Miranda; Gregory Joseph,22,0,38,16
1650038137985,CSE 3,A51,083647,Miranda; Gregory Joseph,37,0,37,0
1650038144009,CSE 8A,A50,083650,Miranda; Gregory Joseph,0,14,40,40
1650038150033,CSE 11,A01,083080,Cao; Yingjun,0,60,40,40
1650038156057,CSE 12,A01,083652,Staff,2,0,100,98
1650038162079,CSE 15L,A01,083654,Staff,0,0,50,50
1650038162079,CSE 15L,A02,083655,Staff,15,0,50,35
1650038168102,CSE 20,A01,083657,Staff,57,0,80,23
1650038174125,CSE 30,A01,083084,Eldon; John,0,62,40,40
1650038180147,CSE 100,A01,083659,Cao; Yingjun,0,57,50,50
1650038186171,CSE 134B,A01,083661,Powell; Thomas Allan,0,25,65,65
1650038192195,CSE 140,A01,083663,Staff,8,0,75,67
1650038198220,CSE 140L,A01,083088,Eldon; John,4,0,75,71
1650038204244,CSE 175,A01,083665,Kumar; Rakesh,10,0,25,15
1650038210269,CSE 190,A00,092507,Dubnov; Shlomo,17,0,20,3
1650038216294,ECE 45,A01,083139,Staff,0,10,40,40
1650038222320,ECE 65,A50,083695,Staff,0,1,30,30
1650038228352,ECE 109,A01,091882,Touri; Behrouz,48,0,70,22
1650038234376,ECE 180,A00,083140,Abi Samra; Nicholas Camill,26,0,30,4
1650038234376,ECE 180,B00,083141,Abi Samra; Nicholas Camill,9,0,30,21
1650038240406,MATH 10A,A01,083735,Patchell; Gregory David,14,0,30,16
1650038240406,MATH 10A,A02,083736,Patchell; Gregory David,28,0,30,2
1650038240406,MATH 10A,A03,083737,Patchell; Gregory David,27,0,30,3
1650038246430,MATH 10B,A01,083207,Staff,0,4,30,30
1650038246430,MATH 10B,A02,083208,Staff,0,0,30,30
1650038246430,MATH 10B,B01,083739,Staff,20,0,30,10
1650038246430,MATH 10B,B02,083740,Staff,30,0,30,0
1650038252458,MATH 18,A01,083743,Staff,10,0,30,20
1650038252458,MATH 18,A02,083744,Staff,28,0,30,2
1650038252458,MATH 18,A03,083745,Staff,23,0,30,7
1650038252458,MATH 18,A04,083746,Staff,27,0,30,3
1650038252458,MATH 18,B01,083748,Staff,0,8,30,30
1650038252458,MATH 18,B02,083749,Staff,0,6,30,30
1650038252458,MATH 18,B03,083750,Staff,0,6,30,30
1650038252458,MATH 18,B04,083751,Staff,1,7,30,29
1650038258482,MATH 20A,A01,083754,Staff,27,0,40,13
1650038264505,MATH 20B,A01,083756,Staff,0,4,30,30
1650038264505,MATH 20B,A02,083757,Staff,2,0,30,28
1650038270532,MATH 20C,A01,083760,Staff,0,9,30,30
1650038270532,MATH 20C,A02,083761,Staff,0,11,30,30
1650038270532,MATH 20C,B01,083762,Staff,17,0,30,13
1650038270532,MATH 20C,B02,083763,Staff,28,0,30,2
1650038276564,MATH 20D,A01,083765,Staff,0,2,30,30
1650038276564,MATH 20D,A02,083766,Staff,16,0,30,14
1650038276564,MATH 20D,A03,083767,Staff,28,0,30,2
1650038282595,MATH 20E,A01,083771,Staff,11,0,30,19
1650038282595,MATH 20E,A02,083772,Staff,20,0,30,10
1650038282595,MATH 20E,B01,083773,Staff,0,1,30,30
1650038282595,MATH 20E,B02,083774,Staff,19,0,30,11
1650038288619,MATH 103A,A01,083777,Staff,0,6,30,30
1650038288619,MATH 103A,A02,083778,Staff,0,7,30,30
1650038288619,MATH 103A,B01,083779,Staff,0,7,30,30
1650038288619,MATH 103A,B02,083780,Staff,0,6,30,30
1650038294656,MATH 105,A01,085443,Staff,0,11,30,30
1650038300680,MATH 109,A01,083213,Anzaldo; Leesa B,0,3,30,30
1650038300680,MATH 109,A02,083214,Anzaldo; Leesa B,0,4,30,30
1650038300680,MATH 109,B01,083215,Anzaldo; Leesa B,0,2,30,30
1650038300680,MATH 109,B02,083216,Anzaldo; Leesa B,0,2,30,30
1650038306709,MATH 142A,A01,083219,Chow; Bennett,0,7,30,30
1650038306709,MATH 142A,A02,083220,Chow; Bennett,0,7,30,30
1650038306709,MATH 142A,B01,083221,Chow; Bennett,0,8,30,30
1650038306709,MATH 142A,B02,083222,Chow; Bennett,0,7,30,30
1650038312738,MATH 193A,A01,083224,Staff,0,5,30,30
1650038312738,MATH 193A,A02,083225,Staff,0,4,30,30
1650038312738,MATH 193A,A03,083781,Staff,0,0,30,30
1650038312738,MATH 193A,A04,083782,Staff,9,0,30,21
1650038318762,MATH 197,001,091859,McAuley; Julian John,9999,0,9999,0
1650038324818,COGS 9,A01,083615,Staff,2,15,60,58
1650038330844,COGS 11,A01,083617,Boyle; Mary E. T.,25,0,40,15
1650038336869,COGS 13,A01,083071,Staff,0,28,40,40
1650038342893,COGS 14A,A01,092681,Staff,0,6,100,100
1650038348919,COGS 14B,A01,083073,Cheng; Tzu-Han,0,2,50,50
1650038354943,COGS 17,A01,092677,Staff,35,0,75,40
1650038360969,COGS 100,A01,083619,Staff,0,18,60,60
1650038366997,COGS 101A,A01,083621,Davis; Joshua Daniel,0,16,60,60
1650038373040,COGS 101B,A01,091572,Staff,16,0,60,44
1650038379064,COGS 101C,A01,083625,Delgado; Tania,21,0,30,9
1650038385088,COGS 107A,A01,083627,Boyle; Mary E. T.,0,1,60,60
1650038391112,COGS 118A,A01,083075,Staff,19,0,60,41
1650038397139,CSE 3,A50,083646,Miranda; Gregory Joseph,22,0,38,16
1650038397139,CSE 3,A51,083647,Miranda; Gregory Joseph,37,0,37,0
1650038403168,CSE 8A,A50,083650,Miranda; Gregory Joseph,0,14,40,40
1650038409193,CSE 11,A01,083080,Cao; Yingjun,0,60,40,40
1650038415217,CSE 12,A01,083652,Staff,2,0,100,98
1650038421250,CSE 15L,A01,083654,Staff,0,0,50,50
1650038421250,CSE 15L,A02,083655,Staff,15,0,50,35
1650038427274,CSE 20,A01,083657,Staff,57,0,80,23
1650038433297,CSE 30,A01,083084,Eldon; John,0,62,40,40
1650038439326,CSE 100,A01,083659,Cao; Yingjun,0,57,50,50
1650038445355,CSE 134B,A01,083661,Powell; Thomas Allan,0,25,65,65
1650038451378,CSE 140,A01,083663,Staff,8,0,75,67
1650038457405,CSE 140L,A01,083088,Eldon; John,4,0,75,71
1650038463430,CSE 175,A01,083665,Kumar; Rakesh,10,0,25,15
1650038469456,CSE 190,A00,092507,Dubnov; Shlomo,17,0,20,3
1650038475480,ECE 45,A01,083139,Staff,0,10,40,40
1650038481504,ECE 65,A50,083695,Staff,0,1,30,30
1650038487530,ECE 109,A01,091882,Touri; Behrouz,48,0,70,22
1650038493553,ECE 180,A00,083140,Abi Samra; Nicholas Camill,26,0,30,4
1650038493553,ECE 180,B00,083141,Abi Samra; Nicholas Camill,9,0,30,21
1650038499595,MATH 10A,A01,083735,Patchell; Gregory David,14,0,30,16
1650038499595,MATH 10A,A02,083736,Patchell; Gregory David,28,0,30,2
1650038499595,MATH 10A,A03,083737,Patchell; Gregory David,27,0,30,3
1650038505628,MATH 10B,A01,083207,Staff,0,4,30,30
1650038505628,MATH 10B,A02,083208,Staff,0,0,30,30
1650038505628,MATH 10B,B01,083739,Staff,20,0,30,10
1650038505628,MATH 10B,B02,083740,Staff,30,0,30,0
1650038511659,MATH 18,A01,083743,Staff,10,0,30,20
1650038511659,MATH 18,A02,083744,Staff,28,0,30,2
1650038511659,MATH 18,A03,083745,Staff,23,0,30,7
1650038511659,MATH 18,A04,083746,Staff,27,0,30,3
1650038511659,MATH 18,B01,083748,Staff,0,8,30,30
1650038511659,MATH 18,B02,083749,Staff,0,6,30,30
1650038511659,MATH 18,B03,083750,Staff,0,6,30,30
1650038511659,MATH 18,B04,083751,Staff,1,7,30,29
1650038517686,MATH 20A,A01,083754,Staff,27,0,40,13
1650038523718,MATH 20B,A01,083756,Staff,0,4,30,30
1650038523718,MATH 20B,A02,083757,Staff,2,0,30,28
1650038529742,MATH 20C,A01,083760,Staff,0,9,30,30
1650038529742,MATH 20C,A02,083761,Staff,0,11,30,30
1650038529742,MATH 20C,B01,083762,Staff,17,0,30,13
1650038529742,MATH 20C,B02,083763,Staff,28,0,30,2
1650038535771,MATH 20D,A01,083765,Staff,0,2,30,30
1650038535771,MATH 20D,A02,083766,Staff,16,0,30,14
1650038535771,MATH 20D,A03,083767,Staff,28,0,30,2
1650038541802,MATH 20E,A01,083771,Staff,11,0,30,19
1650038541802,MATH 20E,A02,083772,Staff,20,0,30,10
1650038541802,MATH 20E,B01,083773,Staff,0,1,30,30
1650038541802,MATH 20E,B02,083774,Staff,19,0,30,11
1650038547826,MATH 103A,A01,083777,Staff,0,6,30,30
1650038547826,MATH 103A,A02,083778,Staff,0,7,30,30
1650038547826,MATH 103A,B01,083779,Staff,0,7,30,30
1650038547826,MATH 103A,B02,083780,Staff,0,6,30,30
1650038553848,MATH 105,A01,085443,Staff,0,11,30,30
1650038559874,MATH 109,A01,083213,Anzaldo; Leesa B,0,3,30,30
1650038559874,MATH 109,A02,083214,Anzaldo; Leesa B,0,4,30,30
1650038559874,MATH 109,B01,083215,Anzaldo; Leesa B,0,2,30,30
1650038559874,MATH 109,B02,083216,Anzaldo; Leesa B,0,2,30,30
1650038565903,MATH 142A,A01,083219,Chow; Bennett,0,7,30,30
1650038565903,MATH 142A,A02,083220,Chow; Bennett,0,7,30,30
1650038565903,MATH 142A,B01,083221,Chow; Bennett,0,8,30,30
1650038565903,MATH 142A,B02,083222,Chow; Bennett,0,7,30,30
1650038572142,MATH 193A,A01,083224,Staff,0,5,30,30
1650038572142,MATH 193A,A02,083225,Staff,0,4,30,30
1650038572142,MATH 193A,A03,083781,Staff,0,0,30,30
1650038572142,MATH 193A,A04,083782,Staff,9,0,30,21
1650038578164,MATH 197,001,091859,McAuley; Julian John,9999,0,9999,0
1650038584234,COGS 9,A01,083615,Staff,2,15,60,58
1650038590270,COGS 11,A01,083617,Boyle; Mary E. T.,25,0,40,15
1650038596299,COGS 13,A01,083071,Staff,0,28,40,40
1650038602322,COGS 14A,A01,092681,Staff,0,6,100,100
1650038608345,COGS 14B,A01,083073,Cheng; Tzu-Han,0,2,50,50
1650038614371,COGS 17,A01,092677,Staff,35,0,75,40
1650038620398,COGS 100,A01,083619,Staff,0,18,60,60
1650038626423,COGS 101A,A01,083621,Davis; Joshua Daniel,0,16,60,60
1650038632459,COGS 101B,A01,091572,Staff,16,0,60,44
1650038638482,COGS 101C,A01,083625,Delgado; Tania,21,0,30,9
1650038644506,COGS 107A,A01,083627,Boyle; Mary E. T.,0,1,60,60
1650038650531,COGS 118A,A01,083075,Staff,19,0,60,41
1650038656561,CSE 3,A50,083646,Miranda; Gregory Joseph,22,0,38,16
1650038656561,CSE 3,A51,083647,Miranda; Gregory Joseph,37,0,37,0
1650038662595,CSE 8A,A50,083650,Miranda; Gregory Joseph,0,14,40,40
1650038668619,CSE 11,A01,083080,Cao; Yingjun,0,60,40,40
1650038674656,CSE 12,A01,083652,Staff,2,0,100,98
1650038680685,CSE 15L,A01,083654,Staff,0,0,50,50
1650038680685,CSE 15L,A02,083655,Staff,15,0,50,35
1650038686709,CSE 20,A01,083657,Staff,57,0,80,23
1650038692738,CSE 30,A01,083084,Eldon; John,0,62,40,40
1650038698760,CSE 100,A01,083659,Cao; Yingjun,0,57,50,50
1650038704787,CSE 134B,A01,083661,Powell; Thomas Allan,0,25,65,65
1650038710899,CSE 140,A01,083663,Staff,8,0,75,67
1650038716925,CSE 140L,A01,083088,Eldon; John,4,0,75,71
1650038722949,CSE 175,A01,083665,Kumar; Rakesh,10,0,25,15
1650038728971,CSE 190,A00,092507,Dubnov; Shlomo,17,0,20,3
1650038734994,ECE 45,A01,083139,Staff,0,10,40,40
1650038741021,ECE 65,A50,083695,Staff,0,1,30,30
1650038747048,ECE 109,A01,091882,Touri; Behrouz,48,0,70,22
1650038753079,ECE 180,A00,083140,Abi Samra; Nicholas Camill,26,0,30,4
1650038753079,ECE 180,B00,083141,Abi Samra; Nicholas Camill,9,0,30,21
1650038759101,MATH 10A,A01,083735,Patchell; Gregory David,14,0,30,16
1650038759101,MATH 10A,A02,083736,Patchell; Gregory David,28,0,30,2
1650038759101,MATH 10A,A03,083737,Patchell; Gregory David,27,0,30,3
1650038765123,MATH 10B,A01,083207,Staff,0,4,30,30
1650038765123,MATH 10B,A02,083208,Staff,0,0,30,30
1650038765123,MATH 10B,B01,083739,Staff,20,0,30,10
1650038765123,MATH 10B,B02,083740,Staff,30,0,30,0
1650038771151,MATH 18,A01,083743,Staff,10,0,30,20
1650038771151,MATH 18,A02,083744,Staff,28,0,30,2
1650038771151,MATH 18,A03,083745,Staff,23,0,30,7
1650038771151,MATH 18,A04,083746,Staff,27,0,30,3
1650038771151,MATH 18,B01,083748,Staff,0,8,30,30
1650038771151,MATH 18,B02,083749,Staff,0,6,30,30
1650038771151,MATH 18,B03,083750,Staff,0,6,30,30
1650038771151,MATH 18,B04,083751,Staff,1,7,30,29
1650038777174,MATH 20A,A01,083754,Staff,27,0,40,13
1650038783203,MATH 20B,A01,083756,Staff,0,4,30,30
1650038783203,MATH 20B,A02,083757,Staff,2,0,30,28
1650038789233,MATH 20C,A01,083760,Staff,0,9,30,30
1650038789233,MATH 20C,A02,083761,Staff,0,11,30,30
1650038789233,MATH 20C,B01,083762,Staff,17,0,30,13
1650038789233,MATH 20C,B02,083763,Staff,28,0,30,2
1650038795255,MATH 20D,A01,083765,Staff,0,2,30,30
1650038795255,MATH 20D,A02,083766,Staff,16,0,30,14
1650038795255,MATH 20D,A03,083767,Staff,28,0,30,2
1650038801285,MATH 20E,A01,083771,Staff,11,0,30,19
1650038801285,MATH 20E,A02,083772,Staff,20,0,30,10
1650038801285,MATH 20E,B01,083773,Staff,0,1,30,30
1650038801285,MATH 20E,B02,083774,Staff,19,0,30,11
1650038807311,MATH 103A,A01,083777,Staff,0,6,30,30
1650038807311,MATH 103A,A02,083778,Staff,0,7,30,30
1650038807311,MATH 103A,B01,083779,Staff,0,7,30,30
1650038807311,MATH 103A,B02,083780,Staff,0,6,30,30
1650038813333,MATH 105,A01,085443,Staff,0,11,30,30
1650038819361,MATH 109,A01,083213,Anzaldo; Leesa B,0,3,30,30
1650038819361,MATH 109,A02,083214,Anzaldo; Leesa B,0,4,30,30
1650038819361,MATH 109,B01,083215,Anzaldo; Leesa B,0,2,30,30
1650038819361,MATH 109,B02,083216,Anzaldo; Leesa B,0,2,30,30
1650038825389,MATH 142A,A01,083219,Chow; Bennett,0,7,30,30
1650038825389,MATH 142A,A02,083220,Chow; Bennett,0,7,30,30
1650038825389,MATH 142A,B01,083221,Chow; Bennett,0,8,30,30
1650038825389,MATH 142A,B02,083222,Chow; Bennett,0,7,30,30
1650038831421,MATH 193A,A01,083224,Staff,0,5,30,30
1650038831421,MATH 193A,A02,083225,Staff,0,4,30,30
1650038831421,MATH 193A,A03,083781,Staff,0,0,30,30
1650038831421,MATH 193A,A04,083782,Staff,9,0,30,21
1650038837448,MATH 197,001,091859,McAuley; Julian John,9999,0,9999,0
1650038843497,COGS 9,A01,083615,Staff,2,15,60,58
1650038849521,COGS 11,A01,083617,Boyle; Mary E. T.,25,0,40,15
1650038855547,COGS 13,A01,083071,Staff,0,28,40,40
1650038861581,COGS 14A,A01,092681,Staff,0,6,100,100
1650038867608,COGS 14B,A01,083073,Cheng; Tzu-Han,0,2,50,50
1650038873635,COGS 17,A01,092677,Staff,35,0,75,40
1650038879667,COGS 100,A01,083619,Staff,0,18,60,60
1650038885691,COGS 101A,A01,083621,Davis; Joshua Daniel,0,16,60,60
1650038891716,COGS 101B,A01,091572,Staff,16,0,60,44
1650038897738,COGS 101C,A01,083625,Delgado; Tania,21,0,30,9
1650038903761,COGS 107A,A01,083627,Boyle; Mary E. T.,0,1,60,60
1650038909788,COGS 118A,A01,083075,Staff,19,0,60,41
1650038915821,CSE 3,A50,083646,Miranda; Gregory Joseph,22,0,38,16
1650038915821,CSE 3,A51,083647,Miranda; Gregory Joseph,37,0,37,0
1650038921855,CSE 8A,A50,083650,Miranda; Gregory Joseph,0,14,40,40
1650038927877,CSE 11,A01,083080,Cao; Yingjun,0,60,40,40
1650038933904,CSE 12,A01,083652,Staff,2,0,100,98
1650038939930,CSE 15L,A01,083654,Staff,0,0,50,50
1650038939930,CSE 15L,A02,083655,Staff,15,0,50,35
1650038945953,CSE 20,A01,083657,Staff,57,0,80,23
1650038951993,CSE 30,A01,083084,Eldon; John,0,62,40,40
1650038958017,CSE 100,A01,083659,Cao; Yingjun,0,57,50,50
1650038964041,CSE 134B,A01,083661,Powell; Thomas Allan,0,25,65,65
1650038970067,CSE 140,A01,083663,Staff,8,0,75,67
1650038976092,CSE 140L,A01,083088,Eldon; John,4,0,75,71
1650038982115,CSE 175,A01,083665,Kumar; Rakesh,10,0,25,15
1650038988143,CSE 190,A00,092507,Dubnov; Shlomo,17,0,20,3
1650038994171,ECE 45,A01,083139,Staff,0,10,40,40
1650039000206,ECE 65,A50,083695,Staff,0,1,30,30
1650039006230,ECE 109,A01,091882,Touri; Behrouz,48,0,70,22
1650039012254,ECE 180,A00,083140,Abi Samra; Nicholas Camill,26,0,30,4
1650039012254,ECE 180,B00,083141,Abi Samra; Nicholas Camill,9,0,30,21
1650039018279,MATH 10A,A01,083735,Patchell; Gregory David,14,0,30,16
1650039018279,MATH 10A,A02,083736,Patchell; Gregory David,28,0,30,2
1650039018279,MATH 10A,A03,083737,Patchell; Gregory David,27,0,30,3
1650039024307,MATH 10B,A01,083207,Staff,0,5,30,30
1650039024307,MATH 10B,A02,083208,Staff,0,0,30,30
1650039024307,MATH 10B,B01,083739,Staff,20,0,30,10
1650039024307,MATH 10B,B02,083740,Staff,30,0,30,0
1650039030341,MATH 18,A01,083743,Staff,10,0,30,20
1650039030341,MATH 18,A02,083744,Staff,28,0,30,2
1650039030341,MATH 18,A03,083745,Staff,23,0,30,7
1650039030341,MATH 18,A04,083746,Staff,27,0,30,3
1650039030341,MATH 18,B01,083748,Staff,0,8,30,30
1650039030341,MATH 18,B02,083749,Staff,0,6,30,30
1650039030341,MATH 18,B03,083750,Staff,0,6,30,30
1650039030341,MATH 18,B04,083751,Staff,1,7,30,29
1650039036366,MATH 20A,A01,083754,Staff,27,0,40,13
1650039042391,MATH 20B,A01,083756,Staff,0,4,30,30
1650039042391,MATH 20B,A02,083757,Staff,2,0,30,28
1650039048416,MATH 20C,A01,083760,Staff,0,9,30,30
1650039048416,MATH 20C,A02,083761,Staff,0,11,30,30
1650039048416,MATH 20C,B01,083762,Staff,17,0,30,13
1650039048416,MATH 20C,B02,083763,Staff,28,0,30,2
1650039054450,MATH 20D,A01,083765,Staff,0,2,30,30
1650039054450,MATH 20D,A02,083766,Staff,16,0,30,14
1650039054450,MATH 20D,A03,083767,Staff,28,0,30,2
1650039060490,MATH 20E,A01,083771,Staff,11,0,30,19
1650039060490,MATH 20E,A02,083772,Staff,20,0,30,10
1650039060490,MATH 20E,B01,083773,Staff,0,1,30,30
1650039060490,MATH 20E,B02,083774,Staff,19,0,30,11
1650039066519,MATH 103A,A01,083777,Staff,0,6,30,30
1650039066519,MATH 103A,A02,083778,Staff,0,7,30,30
1650039066519,MATH 103A,B01,083779,Staff,0,7,30,30
1650039066519,MATH 103A,B02,083780,Staff,0,6,30,30
1650039072542,MATH 105,A01,085443,Staff,0,11,30,30
1650039078567,MATH 109,A01,083213,Anzaldo; Leesa B,0,3,30,30
1650039078567,MATH 109,A02,083214,Anzaldo; Leesa B,0,4,30,30
1650039078567,MATH 109,B01,083215,Anzaldo; Leesa B,0,2,30,30
1650039078567,MATH 109,B02,083216,Anzaldo; Leesa B,0,2,30,30
1650039084592,MATH 142A,A01,083219,Chow; Bennett,0,7,30,30
1650039084592,MATH 142A,A02,083220,Chow; Bennett,0,7,30,30
1650039084592,MATH 142A,B01,083221,Chow; Bennett,0,8,30,30
1650039084592,MATH 142A,B02,083222,Chow; Bennett,0,7,30,30
1650039090614,MATH 193A,A01,083224,Staff,0,5,30,30
1650039090614,MATH 193A,A02,083225,Staff,0,4,30,30
1650039090614,MATH 193A,A03,083781,Staff,0,0,30,30
1650039090614,MATH 193A,A04,083782,Staff,9,0,30,21
1650039096640,MATH 197,001,091859,McAuley; Julian John,9999,0,9999,0
1650039102705,COGS 9,A01,083615,Staff,2,15,60,58
1650039108731,COGS 11,A01,083617,Boyle; Mary E. T.,25,0,40,15
1650039114752,COGS 13,A01,083071,Staff,0,28,40,40
1650039120776,COGS 14A,A01,092681,Staff,0,6,100,100
1650039126802,COGS 14B,A01,083073,Cheng; Tzu-Han,0,2,50,50
1650039132830,COGS 17,A01,092677,Staff,35,0,75,40
1650039138862,COGS 100,A01,083619,Staff,0,18,60,60
1650039144887,COGS 101A,A01,083621,Davis; Joshua Daniel,0,16,60,60
1650039150910,COGS 101B,A01,091572,Staff,16,0,60,44
1650039156936,COGS 101C,A01,083625,Delgado; Tania,21,0,30,9
1650039162974,COGS 107A,A01,083627,Boyle; Mary E. T.,0,1,60,60
1650039169000,COGS 118A,A01,083075,Staff,19,0,60,41
1650039175023,CSE 3,A50,083646,Miranda; Gregory Joseph,22,0,38,16
1650039175023,CSE 3,A51,083647,Miranda; Gregory Joseph,37,0,37,0
1650039181056,CSE 8A,A50,083650,Miranda; Gregory Joseph,0,14,40,40
1650039187080,CSE 11,A01,083080,Cao; Yingjun,0,60,40,40
1650039193103,CSE 12,A01,083652,Staff,2,0,100,98
1650039199127,CSE 15L,A01,083654,Staff,0,0,50,50
1650039199127,CSE 15L,A02,083655,Staff,15,0,50,35
1650039205151,CSE 20,A01,083657,Staff,57,0,80,23
1650039211175,CSE 30,A01,083084,Eldon; John,0,62,40,40
1650039217201,CSE 100,A01,083659,Cao; Yingjun,0,57,50,50
1650039223224,CSE 134B,A01,083661,Powell; Thomas Allan,0,25,65,65
1650039229253,CSE 140,A01,083663,Staff,8,0,75,67
1650039235278,CSE 140L,A01,083088,Eldon; John,4,0,75,71
1650039241301,CSE 175,A01,083665,Kumar; Rakesh,10,0,25,15
1650039247328,CSE 190,A00,092507,Dubnov; Shlomo,17,0,20,3
1650039253354,ECE 45,A01,083139,Staff,0,10,40,40
1650039259378,ECE 65,A50,083695,Staff,0,1,30,30
1650039265408,ECE 109,A01,091882,Touri; Behrouz,48,0,70,22
1650039271445,ECE 180,A00,083140,Abi Samra; Nicholas Camill,26,0,30,4
1650039271445,ECE 180,B00,083141,Abi Samra; Nicholas Camill,9,0,30,21
1650039277468,MATH 10A,A01,083735,Patchell; Gregory David,14,0,30,16
1650039277468,MATH 10A,A02,083736,Patchell; Gregory David,28,0,30,2
1650039277468,MATH 10A,A03,083737,Patchell; Gregory David,27,0,30,3
1650039283494,MATH 10B,A01,083207,Staff,0,5,30,30
1650039283494,MATH 10B,A02,083208,Staff,0,0,30,30
1650039283494,MATH 10B,B01,083739,Staff,20,0,30,10
1650039283494,MATH 10B,B02,083740,Staff,30,0,30,0
1650039289525,MATH 18,A01,083743,Staff,10,0,30,20
1650039289525,MATH 18,A02,083744,Staff,28,0,30,2
1650039289525,MATH 18,A03,083745,Staff,23,0,30,7
1650039289525,MATH 18,A04,083746,Staff,27,0,30,3
1650039289525,MATH 18,B01,083748,Staff,0,8,30,30
1650039289525,MATH 18,B02,083749,Staff,0,6,30,30
1650039289525,MATH 18,B03,083750,Staff,0,6,30,30
1650039289525,MATH 18,B04,083751,Staff,1,7,30,29
1650039295549,MATH 20A,A01,083754,Staff,27,0,40,13
1650039301572,MATH 20B,A01,083756,Staff,0,5,30,30
1650039301572,MATH 20B,A02,083757,Staff,2,0,30,28
1650039307696,MATH 20C,A01,083760,Staff,0,9,30,30
1650039307696,MATH 20C,A02,083761,Staff,0,11,30,30
1650039307696,MATH 20C,B01,083762,Staff,17,0,30,13
1650039307696,MATH 20C,B02,083763,Staff,28,0,30,2
1650039313722,MATH 20D,A01,083765,Staff,0,2,30,30
1650039313722,MATH 20D,A02,083766,Staff,16,0,30,14
1650039313722,MATH 20D,A03,083767,Staff,28,0,30,2
1650039319744,MATH 20E,A01,083771,Staff,11,0,30,19
1650039319744,MATH 20E,A02,083772,Staff,20,0,30,10
1650039319744,MATH 20E,B01,083773,Staff,0,1,30,30
1650039319744,MATH 20E,B02,083774,Staff,19,0,30,11
1650039325767,MATH 103A,A01,083777,Staff,0,6,30,30
1650039325767,MATH 103A,A02,083778,Staff,0,7,30,30
1650039325767,MATH 103A,B01,083779,Staff,0,7,30,30
1650039325767,MATH 103A,B02,083780,Staff,0,6,30,30
1650039331796,MATH 105,A01,085443,Staff,0,11,30,30
1650039337825,MATH 109,A01,083213,Anzaldo; Leesa B,0,3,30,30
1650039337825,MATH 109,A02,083214,Anzaldo; Leesa B,0,4,30,30
1650039337825,MATH 109,B01,083215,Anzaldo; Leesa B,0,2,30,30
1650039337825,MATH 109,B02,083216,Anzaldo; Leesa B,0,2,30,30
1650039343853,MATH 142A,A01,083219,Chow; Bennett,0,7,30,30
1650039343853,MATH 142A,A02,083220,Chow; Bennett,0,7,30,30
1650039343853,MATH 142A,B01,083221,Chow; Bennett,0,8,30,30
1650039343853,MATH 142A,B02,083222,Chow; Bennett,0,7,30,30
1650039349879,MATH 193A,A01,083224,Staff,0,5,30,30
1650039349879,MATH 193A,A02,083225,Staff,0,4,30,30
1650039349879,MATH 193A,A03,083781,Staff,0,0,30,30
1650039349879,MATH 193A,A04,083782,Staff,9,0,30,21
1650039355905,MATH 197,001,091859,McAuley; Julian John,9999,0,9999,0
1650039361966,COGS 9,A01,083615,Staff,2,15,60,58
1650039367993,COGS 11,A01,083617,Boyle; Mary E. T.,25,0,40,15
1650039374016,COGS 13,A01,083071,Staff,0,28,40,40
1650039380039,COGS 14A,A01,092681,Staff,0,6,100,100
1650039386066,COGS 14B,A01,083073,Cheng; Tzu-Han,0,2,50,50
1650039392097,COGS 17,A01,092677,Staff,35,0,75,40
1650039398119,COGS 100,A01,083619,Staff,0,18,60,60
1650039404142,COGS 101A,A01,083621,Davis; Joshua Daniel,0,16,60,60
1650039410166,COGS 101B,A01,091572,Staff,16,0,60,44
1650039416188,COGS 101C,A01,083625,Delgado; Tania,21,0,30,9
1650039422220,COGS 107A,A01,083627,Boyle; Mary E. T.,0,1,60,60
1650039428243,COGS 118A,A01,083075,Staff,19,0,60,41
1650039434267,CSE 3,A50,083646,Miranda; Gregory Joseph,22,0,38,16
1650039434267,CSE 3,A51,083647,Miranda; Gregory Joseph,37,0,37,0
1650039440296,CSE 8A,A50,083650,Miranda; Gregory Joseph,0,14,40,40
1650039446326,CSE 11,A01,083080,Cao; Yingjun,0,60,40,40
1650039452356,CSE 12,A01,083652,Staff,2,0,100,98
1650039458383,CSE 15L,A01,083654,Staff,0,0,50,50
1650039458383,CSE 15L,A02,083655,Staff,15,0,50,35
1650039464408,CSE 20,A01,083657,Staff,57,0,80,23
1650039470441,CSE 30,A01,083084,Eldon; John,0,62,40,40
1650039476465,CSE 100,A01,083659,Cao; Yingjun,0,57,50,50
1650039482489,CSE 134B,A01,083661,Powell; Thomas Allan,0,25,65,65
1650039488522,CSE 140,A01,083663,Staff,8,0,75,67
1650039494553,CSE 140L,A01,083088,Eldon; John,4,0,75,71
1650039500580,CSE 175,A01,083665,Kumar; Rakesh,10,0,25,15
1650039506607,CSE 190,A00,092507,Dubnov; Shlomo,17,0,20,3
1650039512630,ECE 45,A01,083139,Staff,0,10,40,40
1650039518656,ECE 65,A50,083695,Staff,0,1,30,30
1650039524682,ECE 109,A01,091882,Touri; Behrouz,48,0,70,22
1650039530709,ECE 180,A00,083140,Abi Samra; Nicholas Camill,26,0,30,4
1650039530709,ECE 180,B00,083141,Abi Samra; Nicholas Camill,9,0,30,21
1650039536780,MATH 10A,A01,083735,Patchell; Gregory David,14,0,30,16
1650039536780,MATH 10A,A02,083736,Patchell; Gregory David,28,0,30,2
1650039536780,MATH 10A,A03,083737,Patchell; Gregory David,27,0,30,3
1650039542804,MATH 10B,A01,083207,Staff,0,5,30,30
1650039542804,MATH 10B,A02,083208,Staff,0,0,30,30
1650039542804,MATH 10B,B01,083739,Staff,20,0,30,10
1650039542804,MATH 10B,B02,083740,Staff,30,0,30,0
1650039548827,MATH 18,A01,083743,Staff,10,0,30,20
1650039548827,MATH 18,A02,083744,Staff,28,0,30,2
1650039548827,MATH 18,A03,083745,Staff,23,0,30,7
1650039548827,MATH 18,A04,083746,Staff,27,0,30,3
1650039548827,MATH 18,B01,083748,Staff,0,8,30,30
1650039548827,MATH 18,B02,083749,Staff,0,6,30,30
1650039548827,MATH 18,B03,083750,Staff,0,6,30,30
1650039548827,MATH 18,B04,083751,Staff,1,7,30,29
1650039554852,MATH 20A,A01,083754,Staff,27,0,40,13
1650039560886,MATH 20B,A01,083756,Staff,0,5,30,30
1650039560886,MATH 20B,A02,083757,Staff,2,0,30,28
1650039566910,MATH 20C,A01,083760,Staff,0,9,30,30
1650039566910,MATH 20C,A02,083761,Staff,0,11,30,30
1650039566910,MATH 20C,B01,083762,Staff,17,0,30,13
1650039566910,MATH 20C,B02,083763,Staff,28,0,30,2
1650039572940,MATH 20D,A01,083765,Staff,0,2,30,30
1650039572940,MATH 20D,A02,083766,Staff,16,0,30,14
1650039572940,MATH 20D,A03,083767,Staff,28,0,30,2
1650039578971,MATH 20E,A01,083771,Staff,11,0,30,19
1650039578971,MATH 20E,A02,083772,Staff,20,0,30,10
1650039578971,MATH 20E,B01,083773,Staff,0,1,30,30
1650039578971,MATH 20E,B02,083774,Staff,19,0,30,11
1650039584995,MATH 103A,A01,083777,Staff,0,6,30,30
1650039584995,MATH 103A,A02,083778,Staff,0,7,30,30
1650039584995,MATH 103A,B01,083779,Staff,0,7,30,30
1650039584995,MATH 103A,B02,083780,Staff,0,6,30,30
1650039591023,MATH 105,A01,085443,Staff,0,11,30,30
1650039597048,MATH 109,A01,083213,Anzaldo; Leesa B,0,3,30,30
1650039597048,MATH 109,A02,083214,Anzaldo; Leesa B,0,4,30,30
1650039597048,MATH 109,B01,083215,Anzaldo; Leesa B,0,2,30,30
1650039597048,MATH 109,B02,083216,Anzaldo; Leesa B,0,2,30,30
1650039603073,MATH 142A,A01,083219,Chow; Bennett,0,7,30,30
1650039603073,MATH 142A,A02,083220,Chow; Bennett,0,7,30,30
1650039603073,MATH 142A,B01,083221,Chow; Bennett,0,8,30,30
1650039603073,MATH 142A,B02,083222,Chow; Bennett,0,7,30,30
1650039609110,MATH 193A,A01,083224,Staff,0,5,30,30
1650039609110,MATH 193A,A02,083225,Staff,0,4,30,30
1650039609110,MATH 193A,A03,083781,Staff,0,0,30,30
1650039609110,MATH 193A,A04,083782,Staff,9,0,30,21
1650039615134,MATH 197,001,091859,McAuley; Julian John,9999,0,9999,0
1650039621200,COGS 9,A01,083615,Staff,2,15,60,58
1650039627224,COGS 11,A01,083617,Boyle; Mary E. T.,25,0,40,15
1650039633249,COGS 13,A01,083071,Staff,0,28,40,40
1650039639274,COGS 14A,A01,092681,Staff,0,6,100,100
1650039645299,COGS 14B,A01,083073,Cheng; Tzu-Han,0,2,50,50
1650039651325,COGS 17,A01,092677,Staff,35,0,75,40
1650039657351,COGS 100,A01,083619,Staff,0,18,60,60
1650039663379,COGS 101A,A01,083621,Davis; Joshua Daniel,0,16,60,60
1650039669407,COGS 101B,A01,091572,Staff,16,0,60,44
1650039675433,COGS 101C,A01,083625,Delgado; Tania,21,0,30,9
1650039681466,COGS 107A,A01,083627,Boyle; Mary E. T.,0,1,60,60
1650039687492,COGS 118A,A01,083075,Staff,19,0,60,41
1650039693523,CSE 3,A50,083646,Miranda; Gregory Joseph,22,0,38,16
1650039693523,CSE 3,A51,083647,Miranda; Gregory Joseph,37,0,37,0
1650039699551,CSE 8A,A50,083650,Miranda; Gregory Joseph,0,14,40,40
1650039705578,CSE 11,A01,083080,Cao; Yingjun,0,60,40,40
1650039711608,CSE 12,A01,083652,Staff,2,0,100,98
1650039717642,CSE 15L,A01,083654,Staff,0,0,50,50
1650039717642,CSE 15L,A02,083655,Staff,15,0,50,35
1650039723665,CSE 20,A01,083657,Staff,57,0,80,23
1650039729687,CSE 30,A01,083084,Eldon; John,0,63,40,40
1650039735709,CSE 100,A01,083659,Cao; Yingjun,0,57,50,50
1650039741732,CSE 134B,A01,083661,Powell; Thomas Allan,0,25,65,65
1650039747758,CSE 140,A01,083663,Staff,8,0,75,67
1650039753784,CSE 140L,A01,083088,Eldon; John,4,0,75,71
1650039759811,CSE 175,A01,083665,Kumar; Rakesh,10,0,25,15
1650039765833,CSE 190,A00,092507,Dubnov; Shlomo,17,0,20,3
1650039771859,ECE 45,A01,083139,Staff,0,10,40,40
1650039777892,ECE 65,A50,083695,Staff,0,1,30,30
1650039783918,ECE 109,A01,091882,Touri; Behrouz,48,0,70,22
1650039789950,ECE 180,A00,083140,Abi Samra; Nicholas Camill,26,0,30,4
1650039789950,ECE 180,B00,083141,Abi Samra; Nicholas Camill,9,0,30,21
1650039795987,MATH 10A,A01,083735,Patchell; Gregory David,14,0,30,16
1650039795987,MATH 10A,A02,083736,Patchell; Gregory David,28,0,30,2
1650039795987,MATH 10A,A03,083737,Patchell; Gregory David,27,0,30,3
1650039802020,MATH 10B,A01,083207,Staff,0,5,30,30
1650039802020,MATH 10B,A02,083208,Staff,0,0,30,30
1650039802020,MATH 10B,B01,083739,Staff,20,0,30,10
1650039802020,MATH 10B,B02,083740,Staff,30,0,30,0
1650039808042,MATH 18,A01,083743,Staff,10,0,30,20
1650039808042,MATH 18,A02,083744,Staff,28,0,30,2
1650039808042,MATH 18,A03,083745,Staff,23,0,30,7
1650039808042,MATH 18,A04,083746,Staff,27,0,30,3
1650039808042,MATH 18,B01,083748,Staff,0,8,30,30
1650039808042,MATH 18,B02,083749,Staff,0,6,30,30
1650039808042,MATH 18,B03,083750,Staff,0,6,30,30
1650039808042,MATH 18,B04,083751,Staff,1,7,30,29
1650039814068,MATH 20A,A01,083754,Staff,27,0,40,13
1650039820093,MATH 20B,A01,083756,Staff,0,5,30,30
1650039820093,MATH 20B,A02,083757,Staff,1,0,30,29
1650039826127,MATH 20C,A01,083760,Staff,0,9,30,30
1650039826127,MATH 20C,A02,083761,Staff,0,11,30,30
1650039826127,MATH 20C,B01,083762,Staff,17,0,30,13
1650039826127,MATH 20C,B02,083763,Staff,28,0,30,2
1650039832149,MATH 20D,A01,083765,Staff,0,2,30,30
1650039832149,MATH 20D,A02,083766,Staff,16,0,30,14
1650039832149,MATH 20D,A03,083767,Staff,28,0,30,2
1650039838182,MATH 20E,A01,083771,Staff,11,0,30,19
1650039838182,MATH 20E,A02,083772,Staff,20,0,30,10
1650039838182,MATH 20E,B01,083773,Staff,0,1,30,30
1650039838182,MATH 20E,B02,083774,Staff,19,0,30,11
1650039844211,MATH 103A,A01,083777,Staff,0,6,30,30
1650039844211,MATH 103A,A02,083778,Staff,0,7,30,30
1650039844211,MATH 103A,B01,083779,Staff,0,7,30,30
1650039844211,MATH 103A,B02,083780,Staff,0,6,30,30
1650039850234,MATH 105,A01,085443,Staff,0,11,30,30
1650039856262,MATH 109,A01,083213,Anzaldo; Leesa B,0,3,30,30
1650039856262,MATH 109,A02,083214,Anzaldo; Leesa B,0,4,30,30
1650039856262,MATH 109,B01,083215,Anzaldo; Leesa B,0,2,30,30
1650039856262,MATH 109,B02,083216,Anzaldo; Leesa B,0,2,30,30
1650039862286,MATH 142A,A01,083219,Chow; Bennett,0,7,30,30
1650039862286,MATH 142A,A02,083220,Chow; Bennett,0,7,30,30
1650039862286,MATH 142A,B01,083221,Chow; Bennett,0,8,30,30
1650039862286,MATH 142A,B02,083222,Chow; Bennett,0,7,30,30
1650039868316,MATH 193A,A01,083224,Staff,0,5,30,30
1650039868316,MATH 193A,A02,083225,Staff,0,4,30,30
1650039868316,MATH 193A,A03,083781,Staff,0,0,30,30
1650039868316,MATH 193A,A04,083782,Staff,9,0,30,21
1650039874338,MATH 197,001,091859,McAuley; Julian John,9999,0,9999,0
1650039880402,COGS 9,A01,083615,Staff,2,15,60,58
1650039886435,COGS 11,A01,083617,Boyle; Mary E. T.,25,0,40,15
1650039892460,COGS 13,A01,083071,Staff,0,28,40,40
1650039898575,COGS 14A,A01,092681,Staff,0,6,100,100
1650039904600,COGS 14B,A01,083073,Cheng; Tzu-Han,0,2,50,50
1650039910623,COGS 17,A01,092677,Staff,35,0,75,40
1650039916652,COGS 100,A01,083619,Staff,0,18,60,60
1650039922675,COGS 101A,A01,083621,Davis; Joshua Daniel,0,16,60,60
1650039928696,COGS 101B,A01,091572,Staff,16,0,60,44
1650039934720,COGS 101C,A01,083625,Delgado; Tania,21,0,30,9
1650039940743,COGS 107A,A01,083627,Boyle; Mary E. T.,0,1,60,60
1650039946765,COGS 118A,A01,083075,Staff,19,0,60,41
1650039952806,CSE 3,A50,083646,Miranda; Gregory Joseph,22,0,38,16
1650039952806,CSE 3,A51,083647,Miranda; Gregory Joseph,37,0,37,0
1650039958838,CSE 8A,A50,083650,Miranda; Gregory Joseph,0,14,40,40
1650039964883,CSE 11,A01,083080,Cao; Yingjun,0,60,40,40
1650039970957,CSE 12,A01,083652,Staff,2,0,100,98
1650039976980,CSE 15L,A01,083654,Staff,0,0,50,50
1650039976980,CSE 15L,A02,083655,Staff,15,0,50,35
1650039983008,CSE 20,A01,083657,Staff,57,0,80,23
1650039989030,CSE 30,A01,083084,Eldon; John,0,63,40,40
1650039995061,CSE 100,A01,083659,Cao; Yingjun,0,57,50,50
1650040001088,CSE 134B,A01,083661,Powell; Thomas Allan,0,25,65,65
1650040007126,CSE 140,A01,083663,Staff,8,0,75,67
1650040013151,CSE 140L,A01,083088,Eldon; John,4,0,75,71
1650040019183,CSE 175,A01,083665,Kumar; Rakesh,10,0,25,15
1650040025210,CSE 190,A00,092507,Dubnov; Shlomo,17,0,20,3
1650040031233,ECE 45,A01,083139,Staff,0,10,40,40
1650040037267,ECE 65,A50,083695,Staff,0,1,30,30
1650040043293,ECE 109,A01,091882,Touri; Behrouz,48,0,70,22
1650040049328,ECE 180,A00,083140,Abi Samra; Nicholas Camill,26,0,30,4
1650040049328,ECE 180,B00,083141,Abi Samra; Nicholas Camill,9,0,30,21
1650040055353,MATH 10A,A01,083735,Patchell; Gregory David,14,0,30,16
1650040055353,MATH 10A,A02,083736,Patchell; Gregory David,28,0,30,2
1650040055353,MATH 10A,A03,083737,Patchell; Gregory David,27,0,30,3
1650040061375,MATH 10B,A01,083207,Staff,0,5,30,30
1650040061375,MATH 10B,A02,083208,Staff,0,0,30,30
1650040061375,MATH 10B,B01,083739,Staff,20,0,30,10
1650040061375,MATH 10B,B02,083740,Staff,30,0,30,0
1650040067409,MATH 18,A01,083743,Staff,10,0,30,20
1650040067409,MATH 18,A02,083744,Staff,28,0,30,2
1650040067409,MATH 18,A03,083745,Staff,23,0,30,7
1650040067409,MATH 18,A04,083746,Staff,27,0,30,3
1650040067409,MATH 18,B01,083748,Staff,0,8,30,30
1650040067409,MATH 18,B02,083749,Staff,0,6,30,30
1650040067409,MATH 18,B03,083750,Staff,0,6,30,30
1650040067409,MATH 18,B04,083751,Staff,1,7,30,29
1650040073432,MATH 20A,A01,083754,Staff,27,0,40,13
1650040079455,MATH 20B,A01,083756,Staff,0,5,30,30
1650040079455,MATH 20B,A02,083757,Staff,2,0,30,28
1650040085479,MATH 20C,A01,083760,Staff,0,9,30,30
1650040085479,MATH 20C,A02,083761,Staff,0,11,30,30
1650040085479,MATH 20C,B01,083762,Staff,17,0,30,13
1650040085479,MATH 20C,B02,083763,Staff,28,0,30,2
1650040091510,MATH 20D,A01,083765,Staff,0,2,30,30
1650040091510,MATH 20D,A02,083766,Staff,16,0,30,14
1650040091510,MATH 20D,A03,083767,Staff,28,0,30,2
1650040097539,MATH 20E,A01,083771,Staff,11,0,30,19
1650040097539,MATH 20E,A02,083772,Staff,20,0,30,10
1650040097539,MATH 20E,B01,083773,Staff,0,1,30,30
1650040097539,MATH 20E,B02,083774,Staff,19,0,30,11
1650040103569,MATH 103A,A01,083777,Staff,0,6,30,30
1650040103569,MATH 103A,A02,083778,Staff,0,7,30,30
1650040103569,MATH 103A,B01,083779,Staff,0,7,30,30
1650040103569,MATH 103A,B02,083780,Staff,0,6,30,30
1650040109593,MATH 105,A01,085443,Staff,0,11,30,30
1650040115620,MATH 109,A01,083213,Anzaldo; Leesa B,0,3,30,30
1650040115620,MATH 109,A02,083214,Anzaldo; Leesa B,0,4,30,30
1650040115620,MATH 109,B01,083215,Anzaldo; Leesa B,0,2,30,30
1650040115620,MATH 109,B02,083216,Anzaldo; Leesa B,0,2,30,30
1650040121644,MATH 142A,A01,083219,Chow; Bennett,0,7,30,30
1650040121644,MATH 142A,A02,083220,Chow; Bennett,0,7,30,30
1650040121644,MATH 142A,B01,083221,Chow; Bennett,0,8,30,30
1650040121644,MATH 142A,B02,083222,Chow; Bennett,0,7,30,30
1650040127671,MATH 193A,A01,083224,Staff,0,5,30,30
1650040127671,MATH 193A,A02,083225,Staff,0,4,30,30
1650040127671,MATH 193A,A03,083781,Staff,0,0,30,30
1650040127671,MATH 193A,A04,083782,Staff,9,0,30,21
1650040133695,MATH 197,001,091859,McAuley; Julian John,9999,0,9999,0
1650040139763,COGS 9,A01,083615,Staff,2,15,60,58
1650040145788,COGS 11,A01,083617,Boyle; Mary E. T.,25,0,40,15
1650040151811,COGS 13,A01,083071,Staff,0,28,40,40
1650040157837,COGS 14A,A01,092681,Staff,0,6,100,100
1650040163860,COGS 14B,A01,083073,Cheng; Tzu-Han,0,2,50,50
1650040169883,COGS 17,A01,092677,Staff,35,0,75,40
1650040175910,COGS 100,A01,083619,Staff,0,18,60,60
1650040181934,COGS 101A,A01,083621,Davis; Joshua Daniel,0,16,60,60
1650040187955,COGS 101B,A01,091572,Staff,16,0,60,44
1650040193995,COGS 101C,A01,083625,Delgado; Tania,21,0,30,9
1650040200019,COGS 107A,A01,083627,Boyle; Mary E. T.,0,1,60,60
1650040206041,COGS 118A,A01,083075,Staff,19,0,60,41
1650040212069,CSE 3,A50,083646,Miranda; Gregory Joseph,22,0,38,16
1650040212069,CSE 3,A51,083647,Miranda; Gregory Joseph,37,0,37,0
1650040218094,CSE 8A,A50,083650,Miranda; Gregory Joseph,0,14,40,40
1650040224118,CSE 11,A01,083080,Cao; Yingjun,0,60,40,40
1650040230144,CSE 12,A01,083652,Staff,2,0,100,98
1650040236166,CSE 15L,A01,083654,Staff,0,0,50,50
1650040236166,CSE 15L,A02,083655,Staff,15,0,50,35
1650040242191,CSE 20,A01,083657,Staff,57,0,80,23
1650040248223,CSE 30,A01,083084,Eldon; John,0,63,40,40
1650040254249,CSE 100,A01,083659,Cao; Yingjun,0,57,50,50
1650040260276,CSE 134B,A01,083661,Powell; Thomas Allan,0,25,65,65
1650040266298,CSE 140,A01,083663,Staff,8,0,75,67
1650040272322,CSE 140L,A01,083088,Eldon; John,4,0,75,71
1650040278349,CSE 175,A01,083665,Kumar; Rakesh,10,0,25,15
1650040284375,CSE 190,A00,092507,Dubnov; Shlomo,17,0,20,3
1650040290399,ECE 45,A01,083139,Staff,0,10,40,40
1650040296425,ECE 65,A50,083695,Staff,0,1,30,30
1650040302447,ECE 109,A01,091882,Touri; Behrouz,48,0,70,22
1650040308480,ECE 180,A00,083140,Abi Samra; Nicholas Camill,26,0,30,4
1650040308480,ECE 180,B00,083141,Abi Samra; Nicholas Camill,9,0,30,21
1650040314507,MATH 10A,A01,083735,Patchell; Gregory David,14,0,30,16
1650040314507,MATH 10A,A02,083736,Patchell; Gregory David,28,0,30,2
1650040314507,MATH 10A,A03,083737,Patchell; Gregory David,27,0,30,3
1650040320537,MATH 10B,A01,083207,Staff,0,5,30,30
1650040320537,MATH 10B,A02,083208,Staff,0,0,30,30
1650040320537,MATH 10B,B01,083739,Staff,20,0,30,10
1650040320537,MATH 10B,B02,083740,Staff,30,0,30,0
1650040326566,MATH 18,A01,083743,Staff,10,0,30,20
1650040326566,MATH 18,A02,083744,Staff,28,0,30,2
1650040326566,MATH 18,A03,083745,Staff,23,0,30,7
1650040326566,MATH 18,A04,083746,Staff,27,0,30,3
1650040326566,MATH 18,B01,083748,Staff,0,8,30,30
1650040326566,MATH 18,B02,083749,Staff,0,6,30,30
1650040326566,MATH 18,B03,083750,Staff,0,6,30,30
1650040326566,MATH 18,B04,083751,Staff,1,7,30,29
1650040332593,MATH 20A,A01,083754,Staff,27,0,40,13
1650040338619,MATH 20B,A01,083756,Staff,0,5,30,30
1650040338619,MATH 20B,A02,083757,Staff,2,0,30,28
1650040344653,MATH 20C,A01,083760,Staff,0,9,30,30
1650040344653,MATH 20C,A02,083761,Staff,0,11,30,30
1650040344653,MATH 20C,B01,083762,Staff,17,0,30,13
1650040344653,MATH 20C,B02,083763,Staff,28,0,30,2
1650040350693,MATH 20D,A01,083765,Staff,0,2,30,30
1650040350693,MATH 20D,A02,083766,Staff,16,0,30,14
1650040350693,MATH 20D,A03,083767,Staff,28,0,30,2
1650040356716,MATH 20E,A01,083771,Staff,11,0,30,19
1650040356716,MATH 20E,A02,083772,Staff,20,0,30,10
1650040356716,MATH 20E,B01,083773,Staff,0,1,30,30
1650040356716,MATH 20E,B02,083774,Staff,19,0,30,11
1650040362742,MATH 103A,A01,083777,Staff,0,6,30,30
1650040362742,MATH 103A,A02,083778,Staff,0,7,30,30
1650040362742,MATH 103A,B01,083779,Staff,0,7,30,30
1650040362742,MATH 103A,B02,083780,Staff,0,6,30,30
1650040368768,MATH 105,A01,085443,Staff,0,11,30,30
1650040374793,MATH 109,A01,083213,Anzaldo; Leesa B,0,3,30,30
1650040374793,MATH 109,A02,083214,Anzaldo; Leesa B,0,4,30,30
1650040374793,MATH 109,B01,083215,Anzaldo; Leesa B,0,2,30,30
1650040374793,MATH 109,B02,083216,Anzaldo; Leesa B,0,2,30,30
1650040380817,MATH 142A,A01,083219,Chow; Bennett,0,7,30,30
1650040380817,MATH 142A,A02,083220,Chow; Bennett,0,7,30,30
1650040380817,MATH 142A,B01,083221,Chow; Bennett,0,8,30,30
1650040380817,MATH 142A,B02,083222,Chow; Bennett,0,7,30,30
1650040386839,MATH 193A,A01,083224,Staff,0,5,30,30
1650040386839,MATH 193A,A02,083225,Staff,0,4,30,30
1650040386839,MATH 193A,A03,083781,Staff,0,0,30,30
1650040386839,MATH 193A,A04,083782,Staff,9,0,30,21
1650040392862,MATH 197,001,091859,McAuley; Julian John,9999,0,9999,0
1650040398911,COGS 9,A01,083615,Staff,2,15,60,58
1650040404936,COGS 11,A01,083617,Boyle; Mary E. T.,25,0,40,15
1650040410971,COGS 13,A01,083071,Staff,0,28,40,40
1650040416996,COGS 14A,A01,092681,Staff,0,6,100,100
1650040423028,COGS 14B,A01,083073,Cheng; Tzu-Han,0,2,50,50
1650040429051,COGS 17,A01,092677,Staff,35,0,75,40
1650040435074,COGS 100,A01,083619,Staff,0,18,60,60
1650040441098,COGS 101A,A01,083621,Davis; Joshua Daniel,0,16,60,60
1650040447124,COGS 101B,A01,091572,Staff,16,0,60,44
1650040453146,COGS 101C,A01,083625,Delgado; Tania,21,0,30,9
1650040459173,COGS 107A,A01,083627,Boyle; Mary E. T.,0,1,60,60
1650040465197,COGS 118A,A01,083075,Staff,19,0,60,41
1650040471219,CSE 3,A50,083646,Miranda; Gregory Joseph,22,0,38,16
1650040471219,CSE 3,A51,083647,Miranda; Gregory Joseph,37,0,37,0
1650040477249,CSE 8A,A50,083650,Miranda; Gregory Joseph,0,14,40,40
1650040483277,CSE 11,A01,083080,Cao; Yingjun,0,60,40,40
1650040489301,CSE 12,A01,083652,Staff,2,0,100,98
1650040495438,CSE 15L,A01,083654,Staff,0,0,50,50
1650040495438,CSE 15L,A02,083655,Staff,15,0,50,35
1650040501464,CSE 20,A01,083657,Staff,57,0,80,23
1650040507489,CSE 30,A01,083084,Eldon; John,0,63,40,40
1650040513518,CSE 100,A01,083659,Cao; Yingjun,0,57,50,50
1650040519551,CSE 134B,A01,083661,Powell; Thomas Allan,0,25,65,65
1650040525574,CSE 140,A01,083663,Staff,8,0,75,67
1650040531600,CSE 140L,A01,083088,Eldon; John,4,0,75,71
1650040537623,CSE 175,A01,083665,Kumar; Rakesh,10,0,25,15
1650040543645,CSE 190,A00,092507,Dubnov; Shlomo,17,0,20,3
1650040549671,ECE 45,A01,083139,Staff,0,10,40,40
1650040555700,ECE 65,A50,083695,Staff,0,1,30,30
1650040561739,ECE 109,A01,091882,Touri; Behrouz,48,0,70,22
1650040567772,ECE 180,A00,083140,Abi Samra; Nicholas Camill,25,0,30,5
1650040567772,ECE 180,B00,083141,Abi Samra; Nicholas Camill,9,0,30,21
1650040573802,MATH 10A,A01,083735,Patchell; Gregory David,14,0,30,16
1650040573802,MATH 10A,A02,083736,Patchell; Gregory David,28,0,30,2
1650040573802,MATH 10A,A03,083737,Patchell; Gregory David,27,0,30,3
1650040579832,MATH 10B,A01,083207,Staff,0,5,30,30
1650040579832,MATH 10B,A02,083208,Staff,0,0,30,30
1650040579832,MATH 10B,B01,083739,Staff,20,0,30,10
1650040579832,MATH 10B,B02,083740,Staff,30,0,30,0
1650040585858,MATH 18,A01,083743,Staff,10,0,30,20
1650040585858,MATH 18,A02,083744,Staff,28,0,30,2
1650040585858,MATH 18,A03,083745,Staff,23,0,30,7
1650040585858,MATH 18,A04,083746,Staff,27,0,30,3
1650040585858,MATH 18,B01,083748,Staff,0,8,30,30
1650040585858,MATH 18,B02,083749,Staff,0,6,30,30
1650040585858,MATH 18,B03,083750,Staff,0,6,30,30
1650040585858,MATH 18,B04,083751,Staff,1,7,30,29
1650040591880,MATH 20A,A01,083754,Staff,27,0,40,13
1650040597906,MATH 20B,A01,083756,Staff,0,5,30,30
1650040597906,MATH 20B,A02,083757,Staff,2,0,30,28
1650040603929,MATH 20C,A01,083760,Staff,0,9,30,30
1650040603929,MATH 20C,A02,083761,Staff,0,11,30,30
1650040603929,MATH 20C,B01,083762,Staff,17,0,30,13
1650040603929,MATH 20C,B02,083763,Staff,28,0,30,2
1650040609961,MATH 20D,A01,083765,Staff,0,2,30,30
1650040609961,MATH 20D,A02,083766,Staff,16,0,30,14
1650040609961,MATH 20D,A03,083767,Staff,28,0,30,2
1650040615985,MATH 20E,A01,083771,Staff,11,0,30,19
1650040615985,MATH 20E,A02,083772,Staff,20,0,30,10
1650040615985,MATH 20E,B01,083773,Staff,0,1,30,30
1650040615985,MATH 20E,B02,083774,Staff,19,0,30,11
1650040622013,MATH 103A,A01,083777,Staff,0,6,30,30
1650040622013,MATH 103A,A02,083778,Staff,0,7,30,30
1650040622013,MATH 103A,B01,083779,Staff,0,7,30,30
1650040622013,MATH 103A,B02,083780,Staff,0,6,30,30
1650040628040,MATH 105,A01,085443,Staff,0,11,30,30
1650040634065,MATH 109,A01,083213,Anzaldo; Leesa B,0,3,30,30
1650040634065,MATH 109,A02,083214,Anzaldo; Leesa B,0,4,30,30
1650040634065,MATH 109,B01,083215,Anzaldo; Leesa B,0,2,30,30
1650040634065,MATH 109,B02,083216,Anzaldo; Leesa B,0,2,30,30
1650040640088,MATH 142A,A01,083219,Chow; Bennett,0,7,30,30
1650040640088,MATH 142A,A02,083220,Chow; Bennett,0,7,30,30
1650040640088,MATH 142A,B01,083221,Chow; Bennett,0,8,30,30
1650040640088,MATH 142A,B02,083222,Chow; Bennett,0,7,30,30
1650040646110,MATH 193A,A01,083224,Staff,0,5,30,30
1650040646110,MATH 193A,A02,083225,Staff,0,4,30,30
1650040646110,MATH 193A,A03,083781,Staff,0,0,30,30
1650040646110,MATH 193A,A04,083782,Staff,9,0,30,21
1650040652135,MATH 197,001,091859,McAuley; Julian John,9999,0,9999,0
1650040658195,COGS 9,A01,083615,Staff,2,15,60,58
1650040664232,COGS 11,A01,083617,Boyle; Mary E. T.,25,0,40,15
1650040670256,COGS 13,A01,083071,Staff,0,28,40,40
1650040676278,COGS 14A,A01,092681,Staff,0,6,100,100
1650040682300,COGS 14B,A01,083073,Cheng; Tzu-Han,0,2,50,50
1650040688326,COGS 17,A01,092677,Staff,35,0,75,40
1650040694357,COGS 100,A01,083619,Staff,0,18,60,60
1650040700382,COGS 101A,A01,083621,Davis; Joshua Daniel,0,16,60,60
1650040706412,COGS 101B,A01,091572,Staff,16,0,60,44
1650040712436,COGS 101C,A01,083625,Delgado; Tania,21,0,30,9
1650040718460,COGS 107A,A01,083627,Boyle; Mary E. T.,0,1,60,60
1650040724485,COGS 118A,A01,083075,Staff,19,0,60,41
1650040730528,CSE 3,A50,083646,Miranda; Gregory Joseph,22,0,38,16
1650040730528,CSE 3,A51,083647,Miranda; Gregory Joseph,37,0,37,0
1650040736555,CSE 8A,A50,083650,Miranda; Gregory Joseph,0,14,40,40
1650040742585,CSE 11,A01,083080,Cao; Yingjun,0,60,40,40
1650040748616,CSE 12,A01,083652,Staff,2,0,100,98
1650040754647,CSE 15L,A01,083654,Staff,0,0,50,50
1650040754647,CSE 15L,A02,083655,Staff,15,0,50,35
1650040760675,CSE 20,A01,083657,Staff,57,0,80,23
1650040766698,CSE 30,A01,083084,Eldon; John,0,63,40,40
1650040772722,CSE 100,A01,083659,Cao; Yingjun,0,57,50,50
1650040778753,CSE 134B,A01,083661,Powell; Thomas Allan,0,25,65,65
1650040784776,CSE 140,A01,083663,Staff,8,0,75,67
1650040790814,CSE 140L,A01,083088,Eldon; John,4,0,75,71
1650040796857,CSE 175,A01,083665,Kumar; Rakesh,10,0,25,15
1650040802887,CSE 190,A00,092507,Dubnov; Shlomo,17,0,20,3
1650040808910,ECE 45,A01,083139,Staff,0,10,40,40
1650040814946,ECE 65,A50,083695,Staff,0,1,30,30
1650040820969,ECE 109,A01,091882,Touri; Behrouz,48,0,70,22
1650040826996,ECE 180,A00,083140,Abi Samra; Nicholas Camill,25,0,30,5
1650040826996,ECE 180,B00,083141,Abi Samra; Nicholas Camill,9,0,30,21
1650040833021,MATH 10A,A01,083735,Patchell; Gregory David,14,0,30,16
1650040833021,MATH 10A,A02,083736,Patchell; Gregory David,28,0,30,2
1650040833021,MATH 10A,A03,083737,Patchell; Gregory David,27,0,30,3
1650040839047,MATH 10B,A01,083207,Staff,0,5,30,30
1650040839047,MATH 10B,A02,083208,Staff,0,0,30,30
1650040839047,MATH 10B,B01,083739,Staff,20,0,30,10
1650040839047,MATH 10B,B02,083740,Staff,30,0,30,0
1650040845073,MATH 18,A01,083743,Staff,10,0,30,20
1650040845073,MATH 18,A02,083744,Staff,28,0,30,2
1650040845073,MATH 18,A03,083745,Staff,23,0,30,7
1650040845073,MATH 18,A04,083746,Staff,27,0,30,3
1650040845073,MATH 18,B01,083748,Staff,0,8,30,30
1650040845073,MATH 18,B02,083749,Staff,0,6,30,30
1650040845073,MATH 18,B03,083750,Staff,0,6,30,30
1650040845073,MATH 18,B04,083751,Staff,1,7,30,29
1650040851102,MATH 20A,A01,083754,Staff,27,0,40,13
1650040857133,MATH 20B,A01,083756,Staff,0,6,30,30
1650040857133,MATH 20B,A02,083757,Staff,2,0,30,28
1650040863160,MATH 20C,A01,083760,Staff,0,9,30,30
1650040863160,MATH 20C,A02,083761,Staff,0,11,30,30
1650040863160,MATH 20C,B01,083762,Staff,17,0,30,13
1650040863160,MATH 20C,B02,083763,Staff,28,0,30,2
1650040869183,MATH 20D,A01,083765,Staff,0,2,30,30
1650040869183,MATH 20D,A02,083766,Staff,16,0,30,14
1650040869183,MATH 20D,A03,083767,Staff,28,0,30,2
1650040875210,MATH 20E,A01,083771,Staff,11,0,30,19
1650040875210,MATH 20E,A02,083772,Staff,20,0,30,10
1650040875210,MATH 20E,B01,083773,Staff,0,1,30,30
1650040875210,MATH 20E,B02,083774,Staff,19,0,30,11
1650040881256,MATH 103A,A01,083777,Staff,0,6,30,30
1650040881256,MATH 103A,A02,083778,Staff,0,7,30,30
1650040881256,MATH 103A,B01,083779,Staff,0,7,30,30
1650040881256,MATH 103A,B02,083780,Staff,0,6,30,30
1650040887280,MATH 105,A01,085443,Staff,0,11,30,30
1650040893313,MATH 109,A01,083213,Anzaldo; Leesa B,0,3,30,30
1650040893313,MATH 109,A02,083214,Anzaldo; Leesa B,0,4,30,30
1650040893313,MATH 109,B01,083215,Anzaldo; Leesa B,0,2,30,30
1650040893313,MATH 109,B02,083216,Anzaldo; Leesa B,0,2,30,30
1650040899341,MATH 142A,A01,083219,Chow; Bennett,0,7,30,30
1650040899341,MATH 142A,A02,083220,Chow; Bennett,0,7,30,30
1650040899341,MATH 142A,B01,083221,Chow; Bennett,0,8,30,30
1650040899341,MATH 142A,B02,083222,Chow; Bennett,0,7,30,30
1650040905364,MATH 193A,A01,083224,Staff,0,5,30,30
1650040905364,MATH 193A,A02,083225,Staff,0,4,30,30
1650040905364,MATH 193A,A03,083781,Staff,0,0,30,30
1650040905364,MATH 193A,A04,083782,Staff,9,0,30,21
1650040911395,MATH 197,001,091859,McAuley; Julian John,9999,0,9999,0
1650040917478,COGS 9,A01,083615,Staff,2,15,60,58
1650040923500,COGS 11,A01,083617,Boyle; Mary E. T.,25,0,40,15
1650040929523,COGS 13,A01,083071,Staff,0,28,40,40
1650040935546,COGS 14A,A01,092681,Staff,0,6,100,100
1650040941576,COGS 14B,A01,083073,Cheng; Tzu-Han,0,2,50,50
1650040947606,COGS 17,A01,092677,Staff,35,0,75,40
1650040953632,COGS 100,A01,083619,Staff,0,18,60,60
1650040959675,COGS 101A,A01,083621,Davis; Joshua Daniel,0,16,60,60
1650040965705,COGS 101B,A01,091572,Staff,16,0,60,44
1650040971732,COGS 101C,A01,083625,Delgado; Tania,21,0,30,9
1650040977765,COGS 107A,A01,083627,Boyle; Mary E. T.,0,1,60,60
1650040983795,COGS 118A,A01,083075,Staff,19,0,60,41
1650040989818,CSE 3,A50,083646,Miranda; Gregory Joseph,22,0,38,16
1650040989818,CSE 3,A51,083647,Miranda; Gregory Joseph,37,0,37,0
1650040995846,CSE 8A,A50,083650,Miranda; Gregory Joseph,0,14,40,40
1650041001872,CSE 11,A01,083080,Cao; Yingjun,0,60,40,40
1650041007893,CSE 12,A01,083652,Staff,2,0,100,98
1650041013923,CSE 15L,A01,083654,Staff,0,0,50,50
1650041013923,CSE 15L,A02,083655,Staff,15,0,50,35
1650041019953,CSE 20,A01,083657,Staff,57,0,80,23
1650041025980,CSE 30,A01,083084,Eldon; John,0,63,40,40
1650041032003,CSE 100,A01,083659,Cao; Yingjun,0,57,50,50
1650041038026,CSE 134B,A01,083661,Powell; Thomas Allan,0,25,65,65
1650041044055,CSE 140,A01,083663,Staff,8,0,75,67
1650041050081,CSE 140L,A01,083088,Eldon; John,4,0,75,71
1650041056102,CSE 175,A01,083665,Kumar; Rakesh,10,0,25,15
1650041062144,CSE 190,A00,092507,Dubnov; Shlomo,17,0,20,3
1650041068166,ECE 45,A01,083139,Staff,0,10,40,40
1650041074192,ECE 65,A50,083695,Staff,0,1,30,30
1650041080218,ECE 109,A01,091882,Touri; Behrouz,48,0,70,22
1650041086246,ECE 180,A00,083140,Abi Samra; Nicholas Camill,25,0,30,5
1650041086246,ECE 180,B00,083141,Abi Samra; Nicholas Camill,9,0,30,21
1650041092367,MATH 10A,A01,083735,Patchell; Gregory David,14,0,30,16
1650041092367,MATH 10A,A02,083736,Patchell; Gregory David,28,0,30,2
1650041092367,MATH 10A,A03,083737,Patchell; Gregory David,27,0,30,3
1650041098391,MATH 10B,A01,083207,Staff,0,5,30,30
1650041098391,MATH 10B,A02,083208,Staff,0,0,30,30
1650041098391,MATH 10B,B01,083739,Staff,20,0,30,10
1650041098391,MATH 10B,B02,083740,Staff,30,0,30,0
1650041104417,MATH 18,A01,083743,Staff,10,0,30,20
1650041104417,MATH 18,A02,083744,Staff,28,0,30,2
1650041104417,MATH 18,A03,083745,Staff,23,0,30,7
1650041104417,MATH 18,A04,083746,Staff,27,0,30,3
1650041104417,MATH 18,B01,083748,Staff,0,8,30,30
1650041104417,MATH 18,B02,083749,Staff,0,6,30,30
1650041104417,MATH 18,B03,083750,Staff,0,6,30,30
1650041104417,MATH 18,B04,083751,Staff,1,7,30,29
1650041110441,MATH 20A,A01,083754,Staff,27,0,40,13
1650041116467,MATH 20B,A01,083756,Staff,0,6,30,30
1650041116467,MATH 20B,A02,083757,Staff,1,0,30,29
1650041122492,MATH 20C,A01,083760,Staff,0,9,30,30
1650041122492,MATH 20C,A02,083761,Staff,0,11,30,30
1650041122492,MATH 20C,B01,083762,Staff,17,0,30,13
1650041122492,MATH 20C,B02,083763,Staff,28,0,30,2
1650041128520,MATH 20D,A01,083765,Staff,0,2,30,30
1650041128520,MATH 20D,A02,083766,Staff,16,0,30,14
1650041128520,MATH 20D,A03,083767,Staff,28,0,30,2
1650041134561,MATH 20E,A01,083771,Staff,11,0,30,19
1650041134561,MATH 20E,A02,083772,Staff,20,0,30,10
1650041134561,MATH 20E,B01,083773,Staff,0,1,30,30
1650041134561,MATH 20E,B02,083774,Staff,19,0,30,11
1650041140600,MATH 103A,A01,083777,Staff,0,6,30,30
1650041140600,MATH 103A,A02,083778,Staff,0,7,30,30
1650041140600,MATH 103A,B01,083779,Staff,0,7,30,30
1650041140600,MATH 103A,B02,083780,Staff,0,6,30,30
1650041146626,MATH 105,A01,085443,Staff,0,11,30,30
1650041152649,MATH 109,A01,083213,Anzaldo; Leesa B,0,3,30,30
1650041152649,MATH 109,A02,083214,Anzaldo; Leesa B,0,4,30,30
1650041152649,MATH 109,B01,083215,Anzaldo; Leesa B,0,2,30,30
1650041152649,MATH 109,B02,083216,Anzaldo; Leesa B,0,2,30,30
1650041158672,MATH 142A,A01,083219,Chow; Bennett,0,7,30,30
1650041158672,MATH 142A,A02,083220,Chow; Bennett,0,7,30,30
1650041158672,MATH 142A,B01,083221,Chow; Bennett,0,8,30,30
1650041158672,MATH 142A,B02,083222,Chow; Bennett,0,7,30,30
1650041164699,MATH 193A,A01,083224,Staff,0,5,30,30
1650041164699,MATH 193A,A02,083225,Staff,0,4,30,30
1650041164699,MATH 193A,A03,083781,Staff,0,0,30,30
1650041164699,MATH 193A,A04,083782,Staff,9,0,30,21
1650041170742,MATH 197,001,091859,McAuley; Julian John,9999,0,9999,0
1650041176802,COGS 9,A01,083615,Staff,2,15,60,58
1650041182828,COGS 11,A01,083617,Boyle; Mary E. T.,25,0,40,15
1650041188859,COGS 13,A01,083071,Staff,0,28,40,40
1650041194895,COGS 14A,A01,092681,Staff,0,6,100,100
1650041200916,COGS 14B,A01,083073,Cheng; Tzu-Han,0,2,50,50
1650041206940,COGS 17,A01,092677,Staff,35,0,75,40
1650041212975,COGS 100,A01,083619,Staff,0,18,60,60
1650041218997,COGS 101A,A01,083621,Davis; Joshua Daniel,0,16,60,60
1650041225020,COGS 101B,A01,091572,Staff,16,0,60,44
1650041231048,COGS 101C,A01,083625,Delgado; Tania,21,0,30,9
1650041237080,COGS 107A,A01,083627,Boyle; Mary E. T.,0,1,60,60
1650041243107,COGS 118A,A01,083075,Staff,19,0,60,41
1650041249134,CSE 3,A50,083646,Miranda; Gregory Joseph,22,0,38,16
1650041249134,CSE 3,A51,083647,Miranda; Gregory Joseph,37,0,37,0
1650041255157,CSE 8A,A50,083650,Miranda; Gregory Joseph,0,14,40,40
1650041261185,CSE 11,A01,083080,Cao; Yingjun,0,60,40,40
1650041267217,CSE 12,A01,083652,Staff,2,0,100,98
1650041273247,CSE 15L,A01,083654,Staff,0,0,50,50
1650041273247,CSE 15L,A02,083655,Staff,15,0,50,35
1650041279271,CSE 20,A01,083657,Staff,57,0,80,23
1650041285297,CSE 30,A01,083084,Eldon; John,0,62,40,40
1650041291324,CSE 100,A01,083659,Cao; Yingjun,0,57,50,50
1650041297351,CSE 134B,A01,083661,Powell; Thomas Allan,0,25,65,65
1650041303378,CSE 140,A01,083663,Staff,8,0,75,67
1650041309409,CSE 140L,A01,083088,Eldon; John,4,0,75,71
1650041315435,CSE 175,A01,083665,Kumar; Rakesh,10,0,25,15
1650041321470,CSE 190,A00,092507,Dubnov; Shlomo,17,0,20,3
1650041327493,ECE 45,A01,083139,Staff,0,10,40,40
1650041333518,ECE 65,A50,083695,Staff,0,1,30,30
1650041339545,ECE 109,A01,091882,Touri; Behrouz,48,0,70,22
1650041345584,ECE 180,A00,083140,Abi Samra; Nicholas Camill,25,0,30,5
1650041345584,ECE 180,B00,083141,Abi Samra; Nicholas Camill,9,0,30,21
1650041351611,MATH 10A,A01,083735,Patchell; Gregory David,14,0,30,16
1650041351611,MATH 10A,A02,083736,Patchell; Gregory David,28,0,30,2
1650041351611,MATH 10A,A03,083737,Patchell; Gregory David,27,0,30,3
1650041357639,MATH 10B,A01,083207,Staff,0,5,30,30
1650041357639,MATH 10B,A02,083208,Staff,0,0,30,30
1650041357639,MATH 10B,B01,083739,Staff,20,0,30,10
1650041357639,MATH 10B,B02,083740,Staff,30,0,30,0
1650041363664,MATH 18,A01,083743,Staff,10,0,30,20
1650041363664,MATH 18,A02,083744,Staff,28,0,30,2
1650041363664,MATH 18,A03,083745,Staff,23,0,30,7
1650041363664,MATH 18,A04,083746,Staff,27,0,30,3
1650041363664,MATH 18,B01,083748,Staff,0,8,30,30
1650041363664,MATH 18,B02,083749,Staff,0,6,30,30
1650041363664,MATH 18,B03,083750,Staff,0,6,30,30
1650041363664,MATH 18,B04,083751,Staff,1,7,30,29
1650041369688,MATH 20A,A01,083754,Staff,27,0,40,13
1650041375716,MATH 20B,A01,083756,Staff,0,6,30,30
1650041375716,MATH 20B,A02,083757,Staff,1,0,30,29
1650041381744,MATH 20C,A01,083760,Staff,0,9,30,30
1650041381744,MATH 20C,A02,083761,Staff,0,11,30,30
1650041381744,MATH 20C,B01,083762,Staff,17,0,30,13
1650041381744,MATH 20C,B02,083763,Staff,28,0,30,2
1650041387784,MATH 20D,A01,083765,Staff,0,2,30,30
1650041387784,MATH 20D,A02,083766,Staff,16,0,30,14
1650041387784,MATH 20D,A03,083767,Staff,28,0,30,2
1650041393811,MATH 20E,A01,083771,Staff,11,0,30,19
1650041393811,MATH 20E,A02,083772,Staff,20,0,30,10
1650041393811,MATH 20E,B01,083773,Staff,0,1,30,30
1650041393811,MATH 20E,B02,083774,Staff,19,0,30,11
1650041399865,MATH 103A,A01,083777,Staff,0,6,30,30
1650041399865,MATH 103A,A02,083778,Staff,0,7,30,30
1650041399865,MATH 103A,B01,083779,Staff,0,7,30,30
1650041399865,MATH 103A,B02,083780,Staff,0,6,30,30
1650041405891,MATH 105,A01,085443,Staff,0,11,30,30
1650041411920,MATH 109,A01,083213,Anzaldo; Leesa B,0,3,30,30
1650041411920,MATH 109,A02,083214,Anzaldo; Leesa B,0,4,30,30
1650041411920,MATH 109,B01,083215,Anzaldo; Leesa B,0,2,30,30
1650041411920,MATH 109,B02,083216,Anzaldo; Leesa B,0,2,30,30
1650041417942,MATH 142A,A01,083219,Chow; Bennett,0,7,30,30
1650041417942,MATH 142A,A02,083220,Chow; Bennett,0,7,30,30
1650041417942,MATH 142A,B01,083221,Chow; Bennett,0,8,30,30
1650041417942,MATH 142A,B02,083222,Chow; Bennett,0,7,30,30
1650041423965,MATH 193A,A01,083224,Staff,0,5,30,30
1650041423965,MATH 193A,A02,083225,Staff,0,4,30,30
1650041423965,MATH 193A,A03,083781,Staff,0,0,30,30
1650041423965,MATH 193A,A04,083782,Staff,9,0,30,21
1650041429992,MATH 197,001,091859,McAuley; Julian John,9999,0,9999,0
1650041436059,COGS 9,A01,083615,Staff,2,15,60,58
1650041442086,COGS 11,A01,083617,Boyle; Mary E. T.,25,0,40,15
1650041448120,COGS 13,A01,083071,Staff,0,28,40,40
1650041454144,COGS 14A,A01,092681,Staff,0,6,100,100
1650041460166,COGS 14B,A01,083073,Cheng; Tzu-Han,0,2,50,50
1650041466199,COGS 17,A01,092677,Staff,35,0,75,40
1650041472242,COGS 100,A01,083619,Staff,0,18,60,60
1650041478270,COGS 101A,A01,083621,Davis; Joshua Daniel,0,16,60,60
1650041484299,COGS 101B,A01,091572,Staff,16,0,60,44
1650041490322,COGS 101C,A01,083625,Delgado; Tania,21,0,30,9
1650041496349,COGS 107A,A01,083627,Boyle; Mary E. T.,0,1,60,60
1650041502376,COGS 118A,A01,083075,Staff,19,0,60,41
1650041508403,CSE 3,A50,083646,Miranda; Gregory Joseph,22,0,38,16
1650041508403,CSE 3,A51,083647,Miranda; Gregory Joseph,37,0,37,0
1650041514439,CSE 8A,A50,083650,Miranda; Gregory Joseph,0,14,40,40
1650041520461,CSE 11,A01,083080,Cao; Yingjun,0,60,40,40
1650041526487,CSE 12,A01,083652,Staff,2,0,100,98
1650041532510,CSE 15L,A01,083654,Staff,0,0,50,50
1650041532510,CSE 15L,A02,083655,Staff,15,0,50,35
1650041538540,CSE 20,A01,083657,Staff,57,0,80,23
1650041544563,CSE 30,A01,083084,Eldon; John,0,63,40,40
1650041550586,CSE 100,A01,083659,Cao; Yingjun,0,57,50,50
1650041556608,CSE 134B,A01,083661,Powell; Thomas Allan,0,25,65,65
1650041562632,CSE 140,A01,083663,Staff,8,0,75,67
1650041568675,CSE 140L,A01,083088,Eldon; John,4,0,75,71
1650041574698,CSE 175,A01,083665,Kumar; Rakesh,10,0,25,15
1650041580729,CSE 190,A00,092507,Dubnov; Shlomo,17,0,20,3
1650041586754,ECE 45,A01,083139,Staff,0,10,40,40
1650041592794,ECE 65,A50,083695,Staff,0,1,30,30
1650041598820,ECE 109,A01,091882,Touri; Behrouz,48,0,70,22
1650041604843,ECE 180,A00,083140,Abi Samra; Nicholas Camill,25,0,30,5
1650041604843,ECE 180,B00,083141,Abi Samra; Nicholas Camill,9,0,30,21
1650041610870,MATH 10A,A01,083735,Patchell; Gregory David,14,0,30,16
1650041610870,MATH 10A,A02,083736,Patchell; Gregory David,28,0,30,2
1650041610870,MATH 10A,A03,083737,Patchell; Gregory David,27,0,30,3
1650041616893,MATH 10B,A01,083207,Staff,0,5,30,30
1650041616893,MATH 10B,A02,083208,Staff,0,0,30,30
1650041616893,MATH 10B,B01,083739,Staff,20,0,30,10
1650041616893,MATH 10B,B02,083740,Staff,30,0,30,0
1650041622918,MATH 18,A01,083743,Staff,10,0,30,20
1650041622918,MATH 18,A02,083744,Staff,28,0,30,2
1650041622918,MATH 18,A03,083745,Staff,23,0,30,7
1650041622918,MATH 18,A04,083746,Staff,27,0,30,3
1650041622918,MATH 18,B01,083748,Staff,0,8,30,30
1650041622918,MATH 18,B02,083749,Staff,0,6,30,30
1650041622918,MATH 18,B03,083750,Staff,0,6,30,30
1650041622918,MATH 18,B04,083751,Staff,1,7,30,29
1650041628941,MATH 20A,A01,083754,Staff,27,0,40,13
1650041634969,MATH 20B,A01,083756,Staff,0,6,30,30
1650041634969,MATH 20B,A02,083757,Staff,1,0,30,29
1650041640990,MATH 20C,A01,083760,Staff,0,9,30,30
1650041640990,MATH 20C,A02,083761,Staff,0,11,30,30
1650041640990,MATH 20C,B01,083762,Staff,17,0,30,13
1650041640990,MATH 20C,B02,083763,Staff,28,0,30,2
1650041647045,MATH 20D,A01,083765,Staff,0,2,30,30
1650041647045,MATH 20D,A02,083766,Staff,16,0,30,14
1650041647045,MATH 20D,A03,083767,Staff,28,0,30,2
1650041653081,MATH 20E,A01,083771,Staff,11,0,30,19
1650041653081,MATH 20E,A02,083772,Staff,20,0,30,10
1650041653081,MATH 20E,B01,083773,Staff,0,1,30,30
1650041653081,MATH 20E,B02,083774,Staff,19,0,30,11
1650041659104,MATH 103A,A01,083777,Staff,0,6,30,30
1650041659104,MATH 103A,A02,083778,Staff,0,7,30,30
1650041659104,MATH 103A,B01,083779,Staff,0,7,30,30
1650041659104,MATH 103A,B02,083780,Staff,0,6,30,30
1650041665132,MATH 105,A01,085443,Staff,0,11,30,30
1650041671156,MATH 109,A01,083213,Anzaldo; Leesa B,0,3,30,30
1650041671156,MATH 109,A02,083214,Anzaldo; Leesa B,0,4,30,30
1650041671156,MATH 109,B01,083215,Anzaldo; Leesa B,0,2,30,30
1650041671156,MATH 109,B02,083216,Anzaldo; Leesa B,0,2,30,30
1650041677196,MATH 142A,A01,083219,Chow; Bennett,0,7,30,30
1650041677196,MATH 142A,A02,083220,Chow; Bennett,0,7,30,30
1650041677196,MATH 142A,B01,083221,Chow; Bennett,0,8,30,30
1650041677196,MATH 142A,B02,083222,Chow; Bennett,0,7,30,30
1650041683226,MATH 193A,A01,083224,Staff,0,5,30,30
1650041683226,MATH 193A,A02,083225,Staff,0,4,30,30
1650041683226,MATH 193A,A03,083781,Staff,0,0,30,30
1650041683226,MATH 193A,A04,083782,Staff,9,0,30,21
1650041689337,MATH 197,001,091859,McAuley; Julian John,9999,0,9999,0
1650041695387,COGS 9,A01,083615,Staff,2,15,60,58
1650041701417,COGS 11,A01,083617,Boyle; Mary E. T.,25,0,40,15
1650041707441,COGS 13,A01,083071,Staff,0,28,40,40
1650041713464,COGS 14A,A01,092681,Staff,0,6,100,100
1650041719487,COGS 14B,A01,083073,Cheng; Tzu-Han,0,2,50,50
1650041725510,COGS 17,A01,092677,Staff,35,0,75,40
1650041731536,COGS 100,A01,083619,Staff,0,18,60,60
1650041737559,COGS 101A,A01,083621,Davis; Joshua Daniel,0,16,60,60
1650041743582,COGS 101B,A01,091572,Staff,16,0,60,44
1650041749611,COGS 101C,A01,083625,Delgado; Tania,21,0,30,9
1650041755635,COGS 107A,A01,083627,Boyle; Mary E. T.,0,1,60,60
1650041761663,COGS 118A,A01,083075,Staff,19,0,60,41
1650041767690,CSE 3,A50,083646,Miranda; Gregory Joseph,22,0,38,16
1650041767690,CSE 3,A51,083647,Miranda; Gregory Joseph,37,0,37,0
1650041773715,CSE 8A,A50,083650,Miranda; Gregory Joseph,0,14,40,40
1650041779741,CSE 11,A01,083080,Cao; Yingjun,0,60,40,40
1650041785764,CSE 12,A01,083652,Staff,2,0,100,98
1650041791791,CSE 15L,A01,083654,Staff,0,0,50,50
1650041791791,CSE 15L,A02,083655,Staff,14,0,50,36
1650041797820,CSE 20,A01,083657,Staff,57,0,80,23
1650041803842,CSE 30,A01,083084,Eldon; John,0,63,40,40
1650041809865,CSE 100,A01,083659,Cao; Yingjun,0,57,50,50
1650041815890,CSE 134B,A01,083661,Powell; Thomas Allan,0,25,65,65
1650041821913,CSE 140,A01,083663,Staff,8,0,75,67
1650041827946,CSE 140L,A01,083088,Eldon; John,4,0,75,71
1650041833974,CSE 175,A01,083665,Kumar; Rakesh,10,0,25,15
1650041840005,CSE 190,A00,092507,Dubnov; Shlomo,17,0,20,3
1650041846032,ECE 45,A01,083139,Staff,0,10,40,40
1650041852059,ECE 65,A50,083695,Staff,0,1,30,30
1650041858086,ECE 109,A01,091882,Touri; Behrouz,48,0,70,22
1650041864118,ECE 180,A00,083140,Abi Samra; Nicholas Camill,25,0,30,5
1650041864118,ECE 180,B00,083141,Abi Samra; Nicholas Camill,9,0,30,21
1650041870148,MATH 10A,A01,083735,Patchell; Gregory David,14,0,30,16
1650041870148,MATH 10A,A02,083736,Patchell; Gregory David,28,0,30,2
1650041870148,MATH 10A,A03,083737,Patchell; Gregory David,27,0,30,3
1650041876177,MATH 10B,A01,083207,Staff,0,5,30,30
1650041876177,MATH 10B,A02,083208,Staff,0,0,30,30
1650041876177,MATH 10B,B01,083739,Staff,20,0,30,10
1650041876177,MATH 10B,B02,083740,Staff,30,0,30,0
1650041882216,MATH 18,A01,083743,Staff,10,0,30,20
1650041882216,MATH 18,A02,083744,Staff,28,0,30,2
1650041882216,MATH 18,A03,083745,Staff,23,0,30,7
1650041882216,MATH 18,A04,083746,Staff,27,0,30,3
1650041882216,MATH 18,B01,083748,Staff,0,8,30,30
1650041882216,MATH 18,B02,083749,Staff,0,6,30,30
1650041882216,MATH 18,B03,083750,Staff,0,6,30,30
1650041882216,MATH 18,B04,083751,Staff,1,7,30,29
1650041888239,MATH 20A,A01,083754,Staff,27,0,40,13
1650041894282,MATH 20B,A01,083756,Staff,0,6,30,30
1650041894282,MATH 20B,A02,083757,Staff,1,0,30,29
1650041900309,MATH 20C,A01,083760,Staff,0,9,30,30
1650041900309,MATH 20C,A02,083761,Staff,0,11,30,30
1650041900309,MATH 20C,B01,083762,Staff,17,0,30,13
1650041900309,MATH 20C,B02,083763,Staff,28,0,30,2
1650041906341,MATH 20D,A01,083765,Staff,0,2,30,30
1650041906341,MATH 20D,A02,083766,Staff,16,0,30,14
1650041906341,MATH 20D,A03,083767,Staff,28,0,30,2
1650041912364,MATH 20E,A01,083771,Staff,11,0,30,19
1650041912364,MATH 20E,A02,083772,Staff,20,0,30,10
1650041912364,MATH 20E,B01,083773,Staff,0,1,30,30
1650041912364,MATH 20E,B02,083774,Staff,19,0,30,11
1650041918394,MATH 103A,A01,083777,Staff,0,6,30,30
1650041918394,MATH 103A,A02,083778,Staff,0,7,30,30
1650041918394,MATH 103A,B01,083779,Staff,0,8,30,30
1650041918394,MATH 103A,B02,083780,Staff,0,6,30,30
1650041924419,MATH 105,A01,085443,Staff,0,11,30,30
1650041930449,MATH 109,A01,083213,Anzaldo; Leesa B,0,3,30,30
1650041930449,MATH 109,A02,083214,Anzaldo; Leesa B,0,4,30,30
1650041930449,MATH 109,B01,083215,Anzaldo; Leesa B,0,2,30,30
1650041930449,MATH 109,B02,083216,Anzaldo; Leesa B,0,2,30,30
1650041936478,MATH 142A,A01,083219,Chow; Bennett,0,7,30,30
1650041936478,MATH 142A,A02,083220,Chow; Bennett,0,7,30,30
1650041936478,MATH 142A,B01,083221,Chow; Bennett,0,9,30,30
1650041936478,MATH 142A,B02,083222,Chow; Bennett,0,7,30,30
1650041942513,MATH 193A,A01,083224,Staff,0,5,30,30
1650041942513,MATH 193A,A02,083225,Staff,0,4,30,30
1650041942513,MATH 193A,A03,083781,Staff,0,0,30,30
1650041942513,MATH 193A,A04,083782,Staff,9,0,30,21
1650041948544,MATH 197,001,091859,McAuley; Julian John,9999,0,9999,0
1650041954607,COGS 9,A01,083615,Staff,2,15,60,58
1650041960632,COGS 11,A01,083617,Boyle; Mary E. T.,25,0,40,15
1650041966657,COGS 13,A01,083071,Staff,0,28,40,40
1650041972680,COGS 14A,A01,092681,Staff,0,6,100,100
1650041978702,COGS 14B,A01,083073,Cheng; Tzu-Han,0,2,50,50
1650041984728,COGS 17,A01,092677,Staff,35,0,75,40
1650041990761,COGS 100,A01,083619,Staff,0,18,60,60
1650041996786,COGS 101A,A01,083621,Davis; Joshua Daniel,0,16,60,60
1650042002823,COGS 101B,A01,091572,Staff,16,0,60,44
1650042008846,COGS 101C,A01,083625,Delgado; Tania,21,0,30,9
1650042014870,COGS 107A,A01,083627,Boyle; Mary E. T.,0,1,60,60
1650042020898,COGS 118A,A01,083075,Staff,19,0,60,41
1650042026924,CSE 3,A50,083646,Miranda; Gregory Joseph,22,0,38,16
1650042026924,CSE 3,A51,083647,Miranda; Gregory Joseph,37,0,37,0
1650042032948,CSE 8A,A50,083650,Miranda; Gregory Joseph,0,14,40,40
1650042038978,CSE 11,A01,083080,Cao; Yingjun,0,60,40,40
1650042045000,CSE 12,A01,083652,Staff,2,0,100,98
1650042051026,CSE 15L,A01,083654,Staff,0,0,50,50
1650042051026,CSE 15L,A02,083655,Staff,14,0,50,36
1650042057052,CSE 20,A01,083657,Staff,57,0,80,23
1650042063091,CSE 30,A01,083084,Eldon; John,0,63,40,40
1650042069125,CSE 100,A01,083659,Cao; Yingjun,0,57,50,50
1650042075149,CSE 134B,A01,083661,Powell; Thomas Allan,0,25,65,65
1650042081175,CSE 140,A01,083663,Staff,8,0,75,67
1650042087199,CSE 140L,A01,083088,Eldon; John,4,0,75,71
1650042093229,CSE 175,A01,083665,Kumar; Rakesh,10,0,25,15
1650042099252,CSE 190,A00,092507,Dubnov; Shlomo,17,0,20,3
1650042105276,ECE 45,A01,083139,Staff,0,10,40,40
1650042111300,ECE 65,A50,083695,Staff,0,1,30,30
1650042117337,ECE 109,A01,091882,Touri; Behrouz,48,0,70,22
1650042123362,ECE 180,A00,083140,Abi Samra; Nicholas Camill,25,0,30,5
1650042123362,ECE 180,B00,083141,Abi Samra; Nicholas Camill,9,0,30,21
1650042129386,MATH 10A,A01,083735,Patchell; Gregory David,14,0,30,16
1650042129386,MATH 10A,A02,083736,Patchell; Gregory David,28,0,30,2
1650042129386,MATH 10A,A03,083737,Patchell; Gregory David,27,0,30,3
1650042135416,MATH 10B,A01,083207,Staff,0,5,30,30
1650042135416,MATH 10B,A02,083208,Staff,0,0,30,30
1650042135416,MATH 10B,B01,083739,Staff,20,0,30,10
1650042135416,MATH 10B,B02,083740,Staff,30,0,30,0
1650042141458,MATH 18,A01,083743,Staff,10,0,30,20
1650042141458,MATH 18,A02,083744,Staff,28,0,30,2
1650042141458,MATH 18,A03,083745,Staff,23,0,30,7
1650042141458,MATH 18,A04,083746,Staff,27,0,30,3
1650042141458,MATH 18,B01,083748,Staff,0,8,30,30
1650042141458,MATH 18,B02,083749,Staff,0,6,30,30
1650042141458,MATH 18,B03,083750,Staff,0,6,30,30
1650042141458,MATH 18,B04,083751,Staff,1,7,30,29
1650042147481,MATH 20A,A01,083754,Staff,27,0,40,13
1650042153506,MATH 20B,A01,083756,Staff,0,6,30,30
1650042153506,MATH 20B,A02,083757,Staff,1,0,30,29
1650042159541,MATH 20C,A01,083760,Staff,0,9,30,30
1650042159541,MATH 20C,A02,083761,Staff,0,11,30,30
1650042159541,MATH 20C,B01,083762,Staff,17,0,30,13
1650042159541,MATH 20C,B02,083763,Staff,28,0,30,2
1650042165564,MATH 20D,A01,083765,Staff,0,2,30,30
1650042165564,MATH 20D,A02,083766,Staff,16,0,30,14
1650042165564,MATH 20D,A03,083767,Staff,28,0,30,2
1650042178982,MATH 20E,A01,083771,Staff,11,0,30,19
1650042178982,MATH 20E,A02,083772,Staff,20,0,30,10
1650042178982,MATH 20E,B01,083773,Staff,0,1,30,30
1650042178982,MATH 20E,B02,083774,Staff,19,0,30,11
1650042185008,MATH 103A,A01,083777,Staff,0,6,30,30
1650042185008,MATH 103A,A02,083778,Staff,0,7,30,30
1650042185008,MATH 103A,B01,083779,Staff,0,8,30,30
1650042185008,MATH 103A,B02,083780,Staff,0,6,30,30
1650042191033,MATH 105,A01,085443,Staff,0,11,30,30
1650042197055,MATH 109,A01,083213,Anzaldo; Leesa B,0,3,30,30
1650042197055,MATH 109,A02,083214,Anzaldo; Leesa B,0,4,30,30
1650042197055,MATH 109,B01,083215,Anzaldo; Leesa B,0,2,30,30
1650042197055,MATH 109,B02,083216,Anzaldo; Leesa B,0,2,30,30
1650042203081,MATH 142A,A01,083219,Chow; Bennett,0,7,30,30
1650042203081,MATH 142A,A02,083220,Chow; Bennett,0,7,30,30
1650042203081,MATH 142A,B01,083221,Chow; Bennett,0,9,30,30
1650042203081,MATH 142A,B02,083222,Chow; Bennett,0,7,30,30
1650042209105,MATH 193A,A01,083224,Staff,0,5,30,30
1650042209105,MATH 193A,A02,083225,Staff,0,4,30,30
1650042209105,MATH 193A,A03,083781,Staff,0,0,30,30
1650042209105,MATH 193A,A04,083782,Staff,9,0,30,21
1650042215128,MATH 197,001,091859,McAuley; Julian John,9999,0,9999,0
1650042221194,COGS 9,A01,083615,Staff,2,15,60,58
1650042227222,COGS 11,A01,083617,Boyle; Mary E. T.,25,0,40,15
1650042233249,COGS 13,A01,083071,Staff,0,28,40,40
1650042239272,COGS 14A,A01,092681,Staff,0,6,100,100
1650042245304,COGS 14B,A01,083073,Cheng; Tzu-Han,0,2,50,50
1650042251325,COGS 17,A01,092677,Staff,35,0,75,40
1650042257350,COGS 100,A01,083619,Staff,0,18,60,60
1650042263384,COGS 101A,A01,083621,Davis; Joshua Daniel,0,16,60,60
1650042269408,COGS 101B,A01,091572,Staff,16,0,60,44
1650042275436,COGS 101C,A01,083625,Delgado; Tania,21,0,30,9
1650042281464,COGS 107A,A01,083627,Boyle; Mary E. T.,0,1,60,60
1650042287568,COGS 118A,A01,083075,Staff,19,0,60,41
1650042293601,CSE 3,A50,083646,Miranda; Gregory Joseph,22,0,38,16
1650042293601,CSE 3,A51,083647,Miranda; Gregory Joseph,37,0,37,0
1650042299630,CSE 8A,A50,083650,Miranda; Gregory Joseph,0,14,40,40
1650042305653,CSE 11,A01,083080,Cao; Yingjun,0,60,40,40
1650042311677,CSE 12,A01,083652,Staff,2,0,100,98
1650042317702,CSE 15L,A01,083654,Staff,0,0,50,50
1650042317702,CSE 15L,A02,083655,Staff,14,0,50,36
1650042323725,CSE 20,A01,083657,Staff,57,0,80,23
1650042329749,CSE 30,A01,083084,Eldon; John,0,63,40,40
1650042335776,CSE 100,A01,083659,Cao; Yingjun,0,57,50,50
1650042341816,CSE 134B,A01,083661,Powell; Thomas Allan,0,25,65,65
1650042347846,CSE 140,A01,083663,Staff,8,0,75,67
1650042353872,CSE 140L,A01,083088,Eldon; John,4,0,75,71
1650042359900,CSE 175,A01,083665,Kumar; Rakesh,10,0,25,15
1650042365927,CSE 190,A00,092507,Dubnov; Shlomo,17,0,20,3
1650042371949,ECE 45,A01,083139,Staff,0,10,40,40
1650042377975,ECE 65,A50,083695,Staff,0,1,30,30
1650042383998,ECE 109,A01,091882,Touri; Behrouz,48,0,70,22
1650042390023,ECE 180,A00,083140,Abi Samra; Nicholas Camill,25,0,30,5
1650042390023,ECE 180,B00,083141,Abi Samra; Nicholas Camill,9,0,30,21
1650042396049,MATH 10A,A01,083735,Patchell; Gregory David,14,0,30,16
1650042396049,MATH 10A,A02,083736,Patchell; Gregory David,28,0,30,2
1650042396049,MATH 10A,A03,083737,Patchell; Gregory David,27,0,30,3
1650042402074,MATH 10B,A01,083207,Staff,0,5,30,30
1650042402074,MATH 10B,A02,083208,Staff,0,0,30,30
1650042402074,MATH 10B,B01,083739,Staff,20,0,30,10
1650042402074,MATH 10B,B02,083740,Staff,30,0,30,0
1650042408103,MATH 18,A01,083743,Staff,10,0,30,20
1650042408103,MATH 18,A02,083744,Staff,28,0,30,2
1650042408103,MATH 18,A03,083745,Staff,23,0,30,7
1650042408103,MATH 18,A04,083746,Staff,27,0,30,3
1650042408103,MATH 18,B01,083748,Staff,0,8,30,30
1650042408103,MATH 18,B02,083749,Staff,0,6,30,30
1650042408103,MATH 18,B03,083750,Staff,0,6,30,30
1650042408103,MATH 18,B04,083751,Staff,1,7,30,29
1650042414127,MATH 20A,A01,083754,Staff,27,0,40,13
1650042420150,MATH 20B,A01,083756,Staff,0,6,30,30
1650042420150,MATH 20B,A02,083757,Staff,1,0,30,29
1650042426184,MATH 20C,A01,083760,Staff,0,9,30,30
1650042426184,MATH 20C,A02,083761,Staff,0,11,30,30
1650042426184,MATH 20C,B01,083762,Staff,17,0,30,13
1650042426184,MATH 20C,B02,083763,Staff,28,0,30,2
1650042432208,MATH 20D,A01,083765,Staff,0,2,30,30
1650042432208,MATH 20D,A02,083766,Staff,16,0,30,14
1650042432208,MATH 20D,A03,083767,Staff,28,0,30,2
1650042438231,MATH 20E,A01,083771,Staff,11,0,30,19
1650042438231,MATH 20E,A02,083772,Staff,20,0,30,10
1650042438231,MATH 20E,B01,083773,Staff,0,1,30,30
1650042438231,MATH 20E,B02,083774,Staff,19,0,30,11
1650042444263,MATH 103A,A01,083777,Staff,0,6,30,30
1650042444263,MATH 103A,A02,083778,Staff,0,7,30,30
1650042444263,MATH 103A,B01,083779,Staff,0,8,30,30
1650042444263,MATH 103A,B02,083780,Staff,0,6,30,30
1650042450286,MATH 105,A01,085443,Staff,0,11,30,30
1650042456336,MATH 109,A01,083213,Anzaldo; Leesa B,0,3,30,30
1650042456336,MATH 109,A02,083214,Anzaldo; Leesa B,0,4,30,30
1650042456336,MATH 109,B01,083215,Anzaldo; Leesa B,0,2,30,30
1650042456336,MATH 109,B02,083216,Anzaldo; Leesa B,0,2,30,30
1650042462364,MATH 142A,A01,083219,Chow; Bennett,0,7,30,30
1650042462364,MATH 142A,A02,083220,Chow; Bennett,0,7,30,30
1650042462364,MATH 142A,B01,083221,Chow; Bennett,0,9,30,30
1650042462364,MATH 142A,B02,083222,Chow; Bennett,0,7,30,30
1650042468392,MATH 193A,A01,083224,Staff,0,5,30,30
1650042468392,MATH 193A,A02,083225,Staff,0,4,30,30
1650042468392,MATH 193A,A03,083781,Staff,0,0,30,30
1650042468392,MATH 193A,A04,083782,Staff,9,0,30,21
1650042474418,MATH 197,001,091859,McAuley; Julian John,9999,0,9999,0
1650042480485,COGS 9,A01,083615,Staff,2,15,60,58
1650042486510,COGS 11,A01,083617,Boyle; Mary E. T.,25,0,40,15
1650042492537,COGS 13,A01,083071,Staff,0,28,40,40
1650042498574,COGS 14A,A01,092681,Staff,0,6,100,100
1650042504608,COGS 14B,A01,083073,Cheng; Tzu-Han,0,3,50,50
1650042510635,COGS 17,A01,092677,Staff,35,0,75,40
1650042516665,COGS 100,A01,083619,Staff,0,17,60,60
1650042522690,COGS 101A,A01,083621,Davis; Joshua Daniel,0,16,60,60
1650042528716,COGS 101B,A01,091572,Staff,16,0,60,44
1650042534748,COGS 101C,A01,083625,Delgado; Tania,21,0,30,9
1650042540773,COGS 107A,A01,083627,Boyle; Mary E. T.,0,1,60,60
1650042546800,COGS 118A,A01,083075,Staff,19,0,60,41
1650042552822,CSE 3,A50,083646,Miranda; Gregory Joseph,22,0,38,16
1650042552822,CSE 3,A51,083647,Miranda; Gregory Joseph,37,0,37,0
1650042558850,CSE 8A,A50,083650,Miranda; Gregory Joseph,0,14,40,40
1650042564883,CSE 11,A01,083080,Cao; Yingjun,0,60,40,40
1650042570911,CSE 12,A01,083652,Staff,2,0,100,98
1650042576944,CSE 15L,A01,083654,Staff,0,0,50,50
1650042576944,CSE 15L,A02,083655,Staff,14,0,50,36
1650042582971,CSE 20,A01,083657,Staff,57,0,80,23
1650042588993,CSE 30,A01,083084,Eldon; John,0,63,40,40
1650042595029,CSE 100,A01,083659,Cao; Yingjun,0,57,50,50
1650042601055,CSE 134B,A01,083661,Powell; Thomas Allan,0,25,65,65
1650042607081,CSE 140,A01,083663,Staff,8,0,75,67
1650042613103,CSE 140L,A01,083088,Eldon; John,4,0,75,71
1650042619126,CSE 175,A01,083665,Kumar; Rakesh,10,0,25,15
1650042625158,CSE 190,A00,092507,Dubnov; Shlomo,17,0,20,3
1650042631182,ECE 45,A01,083139,Staff,0,10,40,40
1650042637206,ECE 65,A50,083695,Staff,0,1,30,30
1650042643240,ECE 109,A01,091882,Touri; Behrouz,48,0,70,22
1650042649265,ECE 180,A00,083140,Abi Samra; Nicholas Camill,25,0,30,5
1650042649265,ECE 180,B00,083141,Abi Samra; Nicholas Camill,9,0,30,21
1650042655298,MATH 10A,A01,083735,Patchell; Gregory David,14,0,30,16
1650042655298,MATH 10A,A02,083736,Patchell; Gregory David,28,0,30,2
1650042655298,MATH 10A,A03,083737,Patchell; Gregory David,27,0,30,3
1650042661325,MATH 10B,A01,083207,Staff,0,5,30,30
1650042661325,MATH 10B,A02,083208,Staff,0,0,30,30
1650042661325,MATH 10B,B01,083739,Staff,20,0,30,10
1650042661325,MATH 10B,B02,083740,Staff,30,0,30,0
1650042667350,MATH 18,A01,083743,Staff,10,0,30,20
1650042667350,MATH 18,A02,083744,Staff,28,0,30,2
1650042667350,MATH 18,A03,083745,Staff,23,0,30,7
1650042667350,MATH 18,A04,083746,Staff,27,0,30,3
1650042667350,MATH 18,B01,083748,Staff,0,8,30,30
1650042667350,MATH 18,B02,083749,Staff,0,6,30,30
1650042667350,MATH 18,B03,083750,Staff,0,6,30,30
1650042667350,MATH 18,B04,083751,Staff,1,7,30,29
1650042673374,MATH 20A,A01,083754,Staff,27,0,40,13
1650042679396,MATH 20B,A01,083756,Staff,0,6,30,30
1650042679396,MATH 20B,A02,083757,Staff,1,0,30,29
1650042685422,MATH 20C,A01,083760,Staff,0,9,30,30
1650042685422,MATH 20C,A02,083761,Staff,0,11,30,30
1650042685422,MATH 20C,B01,083762,Staff,17,0,30,13
1650042685422,MATH 20C,B02,083763,Staff,28,0,30,2
1650042691448,MATH 20D,A01,083765,Staff,0,2,30,30
1650042691448,MATH 20D,A02,083766,Staff,16,0,30,14
1650042691448,MATH 20D,A03,083767,Staff,28,0,30,2
1650042697479,MATH 20E,A01,083771,Staff,11,0,30,19
1650042697479,MATH 20E,A02,083772,Staff,20,0,30,10
1650042697479,MATH 20E,B01,083773,Staff,0,1,30,30
1650042697479,MATH 20E,B02,083774,Staff,19,0,30,11
1650042703504,MATH 103A,A01,083777,Staff,0,6,30,30
1650042703504,MATH 103A,A02,083778,Staff,0,7,30,30
1650042703504,MATH 103A,B01,083779,Staff,0,8,30,30
1650042703504,MATH 103A,B02,083780,Staff,0,6,30,30
1650042709531,MATH 105,A01,085443,Staff,0,11,30,30
1650042715555,MATH 109,A01,083213,Anzaldo; Leesa B,0,3,30,30
1650042715555,MATH 109,A02,083214,Anzaldo; Leesa B,0,4,30,30
1650042715555,MATH 109,B01,083215,Anzaldo; Leesa B,0,2,30,30
1650042715555,MATH 109,B02,083216,Anzaldo; Leesa B,0,2,30,30
1650042721577,MATH 142A,A01,083219,Chow; Bennett,0,7,30,30
1650042721577,MATH 142A,A02,083220,Chow; Bennett,0,7,30,30
1650042721577,MATH 142A,B01,083221,Chow; Bennett,0,9,30,30
1650042721577,MATH 142A,B02,083222,Chow; Bennett,0,7,30,30
1650042727601,MATH 193A,A01,083224,Staff,0,5,30,30
1650042727601,MATH 193A,A02,083225,Staff,0,4,30,30
1650042727601,MATH 193A,A03,083781,Staff,0,0,30,30
1650042727601,MATH 193A,A04,083782,Staff,9,0,30,21
1650042733629,MATH 197,001,091859,McAuley; Julian John,9999,0,9999,0
1650042739690,COGS 9,A01,083615,Staff,2,15,60,58
1650042745713,COGS 11,A01,083617,Boyle; Mary E. T.,25,0,40,15
1650042751736,COGS 13,A01,083071,Staff,0,28,40,40
1650042757761,COGS 14A,A01,092681,Staff,0,6,100,100
1650042763786,COGS 14B,A01,083073,Cheng; Tzu-Han,0,3,50,50
1650042769818,COGS 17,A01,092677,Staff,35,0,75,40
1650042775847,COGS 100,A01,083619,Staff,0,17,60,60
1650042781876,COGS 101A,A01,083621,Davis; Joshua Daniel,0,16,60,60
1650042787902,COGS 101B,A01,091572,Staff,16,0,60,44
1650042793927,COGS 101C,A01,083625,Delgado; Tania,21,0,30,9
1650042799949,COGS 107A,A01,083627,Boyle; Mary E. T.,0,1,60,60
1650042805982,COGS 118A,A01,083075,Staff,19,0,60,41
1650042812012,CSE 3,A50,083646,Miranda; Gregory Joseph,22,0,38,16
1650042812012,CSE 3,A51,083647,Miranda; Gregory Joseph,37,0,37,0
1650042818038,CSE 8A,A50,083650,Miranda; Gregory Joseph,0,15,40,40
1650042824062,CSE 11,A01,083080,Cao; Yingjun,0,60,40,40
1650042830090,CSE 12,A01,083652,Staff,2,0,100,98
1650042836116,CSE 15L,A01,083654,Staff,0,0,50,50
1650042836116,CSE 15L,A02,083655,Staff,14,0,50,36
1650042842138,CSE 20,A01,083657,Staff,57,0,80,23
1650042848162,CSE 30,A01,083084,Eldon; John,0,63,40,40
1650042854182,CSE 100,A01,083659,Cao; Yingjun,0,57,50,50
1650042860208,CSE 134B,A01,083661,Powell; Thomas Allan,0,25,65,65
1650042866230,CSE 140,A01,083663,Staff,8,0,75,67
1650042872253,CSE 140L,A01,083088,Eldon; John,4,0,75,71
1650042878277,CSE 175,A01,083665,Kumar; Rakesh,9,0,25,16
1650042884391,CSE 190,A00,092507,Dubnov; Shlomo,17,0,20,3
1650042890414,ECE 45,A01,083139,Staff,0,10,40,40
1650042896440,ECE 65,A50,083695,Staff,0,1,30,30
1650042902469,ECE 109,A01,091882,Touri; Behrouz,48,0,70,22
1650042908493,ECE 180,A00,083140,Abi Samra; Nicholas Camill,25,0,30,5
1650042908493,ECE 180,B00,083141,Abi Samra; Nicholas Camill,9,0,30,21
1650042914515,MATH 10A,A01,083735,Patchell; Gregory David,14,0,30,16
1650042914515,MATH 10A,A02,083736,Patchell; Gregory David,28,0,30,2
1650042914515,MATH 10A,A03,083737,Patchell; Gregory David,27,0,30,3
1650042920554,MATH 10B,A01,083207,Staff,0,5,30,30
1650042920554,MATH 10B,A02,083208,Staff,0,0,30,30
1650042920554,MATH 10B,B01,083739,Staff,20,0,30,10
1650042920554,MATH 10B,B02,083740,Staff,30,0,30,0
1650042926577,MATH 18,A01,083743,Staff,10,0,30,20
1650042926577,MATH 18,A02,083744,Staff,28,0,30,2
1650042926577,MATH 18,A03,083745,Staff,23,0,30,7
1650042926577,MATH 18,A04,083746,Staff,27,0,30,3
1650042926577,MATH 18,B01,083748,Staff,0,8,30,30
1650042926577,MATH 18,B02,083749,Staff,0,6,30,30
1650042926577,MATH 18,B03,083750,Staff,0,6,30,30
1650042926577,MATH 18,B04,083751,Staff,1,7,30,29
1650042932604,MATH 20A,A01,083754,Staff,27,0,40,13
1650042938636,MATH 20B,A01,083756,Staff,0,6,30,30
1650042938636,MATH 20B,A02,083757,Staff,1,0,30,29
1650042944667,MATH 20C,A01,083760,Staff,0,9,30,30
1650042944667,MATH 20C,A02,083761,Staff,0,11,30,30
1650042944667,MATH 20C,B01,083762,Staff,17,0,30,13
1650042944667,MATH 20C,B02,083763,Staff,28,0,30,2
1650042950702,MATH 20D,A01,083765,Staff,0,2,30,30
1650042950702,MATH 20D,A02,083766,Staff,16,0,30,14
1650042950702,MATH 20D,A03,083767,Staff,28,0,30,2
1650042956733,MATH 20E,A01,083771,Staff,11,0,30,19
1650042956733,MATH 20E,A02,083772,Staff,20,0,30,10
1650042956733,MATH 20E,B01,083773,Staff,0,1,30,30
1650042956733,MATH 20E,B02,083774,Staff,19,0,30,11
1650042962757,MATH 103A,A01,083777,Staff,0,6,30,30
1650042962757,MATH 103A,A02,083778,Staff,0,7,30,30
1650042962757,MATH 103A,B01,083779,Staff,0,8,30,30
1650042962757,MATH 103A,B02,083780,Staff,0,6,30,30
1650042968787,MATH 105,A01,085443,Staff,0,11,30,30
1650042974813,MATH 109,A01,083213,Anzaldo; Leesa B,0,3,30,30
1650042974813,MATH 109,A02,083214,Anzaldo; Leesa B,0,4,30,30
1650042974813,MATH 109,B01,083215,Anzaldo; Leesa B,0,2,30,30
1650042974813,MATH 109,B02,083216,Anzaldo; Leesa B,0,2,30,30
1650042980837,MATH 142A,A01,083219,Chow; Bennett,0,7,30,30
1650042980837,MATH 142A,A02,083220,Chow; Bennett,0,7,30,30
1650042980837,MATH 142A,B01,083221,Chow; Bennett,0,9,30,30
1650042980837,MATH 142A,B02,083222,Chow; Bennett,0,7,30,30
1650042986875,MATH 193A,A01,083224,Staff,0,5,30,30
1650042986875,MATH 193A,A02,083225,Staff,0,4,30,30
1650042986875,MATH 193A,A03,083781,Staff,0,0,30,30
1650042986875,MATH 193A,A04,083782,Staff,9,0,30,21
1650042992897,MATH 197,001,091859,McAuley; Julian John,9999,0,9999,0
1650042998964,COGS 9,A01,083615,Staff,2,15,60,58
1650043004999,COGS 11,A01,083617,Boyle; Mary E. T.,25,0,40,15
1650043011027,COGS 13,A01,083071,Staff,0,28,40,40
1650043017133,COGS 14A,A01,092681,Staff,0,6,100,100
1650043023171,COGS 14B,A01,083073,Cheng; Tzu-Han,0,3,50,50
1650043029199,COGS 17,A01,092677,Staff,35,0,75,40
1650043035223,COGS 100,A01,083619,Staff,0,17,60,60
1650043041247,COGS 101A,A01,083621,Davis; Joshua Daniel,0,16,60,60
1650043047275,COGS 101B,A01,091572,Staff,16,0,60,44
1650043053307,COGS 101C,A01,083625,Delgado; Tania,21,0,30,9
1650043059348,COGS 107A,A01,083627,Boyle; Mary E. T.,0,1,60,60
1650043065380,COGS 118A,A01,083075,Staff,19,0,60,41
1650043071412,CSE 3,A50,083646,Miranda; Gregory Joseph,21,0,38,17
1650043071412,CSE 3,A51,083647,Miranda; Gregory Joseph,37,0,37,0
1650043077435,CSE 8A,A50,083650,Miranda; Gregory Joseph,0,15,40,40
1650043083470,CSE 11,A01,083080,Cao; Yingjun,0,60,40,40
1650043089509,CSE 12,A01,083652,Staff,2,0,100,98
1650043095538,CSE 15L,A01,083654,Staff,0,0,50,50
1650043095538,CSE 15L,A02,083655,Staff,14,0,50,36
1650043101561,CSE 20,A01,083657,Staff,57,0,80,23
1650043107587,CSE 30,A01,083084,Eldon; John,0,63,40,40
1650043113611,CSE 100,A01,083659,Cao; Yingjun,0,57,50,50
1650043119634,CSE 134B,A01,083661,Powell; Thomas Allan,0,25,65,65
1650043125658,CSE 140,A01,083663,Staff,8,0,75,67
1650043131680,CSE 140L,A01,083088,Eldon; John,4,0,75,71
1650043137703,CSE 175,A01,083665,Kumar; Rakesh,9,0,25,16
1650043143731,CSE 190,A00,092507,Dubnov; Shlomo,17,0,20,3
1650043149758,ECE 45,A01,083139,Staff,0,10,40,40
1650043155781,ECE 65,A50,083695,Staff,0,1,30,30
1650043161808,ECE 109,A01,091882,Touri; Behrouz,48,0,70,22
1650043167833,ECE 180,A00,083140,Abi Samra; Nicholas Camill,25,0,30,5
1650043167833,ECE 180,B00,083141,Abi Samra; Nicholas Camill,9,0,30,21
1650043173866,MATH 10A,A01,083735,Patchell; Gregory David,14,0,30,16
1650043173866,MATH 10A,A02,083736,Patchell; Gregory David,28,0,30,2
1650043173866,MATH 10A,A03,083737,Patchell; Gregory David,27,0,30,3
1650043179895,MATH 10B,A01,083207,Staff,0,5,30,30
1650043179895,MATH 10B,A02,083208,Staff,0,0,30,30
1650043179895,MATH 10B,B01,083739,Staff,20,0,30,10
1650043179895,MATH 10B,B02,083740,Staff,30,0,30,0
1650043185926,MATH 18,A01,083743,Staff,10,0,30,20
1650043185926,MATH 18,A02,083744,Staff,28,0,30,2
1650043185926,MATH 18,A03,083745,Staff,23,0,30,7
1650043185926,MATH 18,A04,083746,Staff,27,0,30,3
1650043185926,MATH 18,B01,083748,Staff,0,8,30,30
1650043185926,MATH 18,B02,083749,Staff,0,6,30,30
1650043185926,MATH 18,B03,083750,Staff,0,6,30,30
1650043185926,MATH 18,B04,083751,Staff,1,7,30,29
1650043191948,MATH 20A,A01,083754,Staff,27,0,40,13
1650043197972,MATH 20B,A01,083756,Staff,0,6,30,30
1650043197972,MATH 20B,A02,083757,Staff,1,0,30,29
1650043203995,MATH 20C,A01,083760,Staff,0,9,30,30
1650043203995,MATH 20C,A02,083761,Staff,0,11,30,30
1650043203995,MATH 20C,B01,083762,Staff,17,0,30,13
1650043203995,MATH 20C,B02,083763,Staff,28,0,30,2
1650043210020,MATH 20D,A01,083765,Staff,0,2,30,30
1650043210020,MATH 20D,A02,083766,Staff,16,0,30,14
1650043210020,MATH 20D,A03,083767,Staff,28,0,30,2
1650043216043,MATH 20E,A01,083771,Staff,11,0,30,19
1650043216043,MATH 20E,A02,083772,Staff,20,0,30,10
1650043216043,MATH 20E,B01,083773,Staff,0,1,30,30
1650043216043,MATH 20E,B02,083774,Staff,19,0,30,11
1650043222101,MATH 103A,A01,083777,Staff,0,6,30,30
1650043222101,MATH 103A,A02,083778,Staff,0,7,30,30
1650043222101,MATH 103A,B01,083779,Staff,0,8,30,30
1650043222101,MATH 103A,B02,083780,Staff,0,6,30,30
1650043228130,MATH 105,A01,085443,Staff,0,11,30,30
1650043234158,MATH 109,A01,083213,Anzaldo; Leesa B,0,3,30,30
1650043234158,MATH 109,A02,083214,Anzaldo; Leesa B,0,4,30,30
1650043234158,MATH 109,B01,083215,Anzaldo; Leesa B,0,2,30,30
1650043234158,MATH 109,B02,083216,Anzaldo; Leesa B,0,2,30,30
1650043240182,MATH 142A,A01,083219,Chow; Bennett,0,7,30,30
1650043240182,MATH 142A,A02,083220,Chow; Bennett,0,7,30,30
1650043240182,MATH 142A,B01,083221,Chow; Bennett,0,9,30,30
1650043240182,MATH 142A,B02,083222,Chow; Bennett,0,7,30,30
1650043246206,MATH 193A,A01,083224,Staff,0,5,30,30
1650043246206,MATH 193A,A02,083225,Staff,0,4,30,30
1650043246206,MATH 193A,A03,083781,Staff,0,0,30,30
1650043246206,MATH 193A,A04,083782,Staff,9,0,30,21
1650043252232,MATH 197,001,091859,McAuley; Julian John,9999,0,9999,0
1650043258289,COGS 9,A01,083615,Staff,2,15,60,58
1650043264315,COGS 11,A01,083617,Boyle; Mary E. T.,25,0,40,15
1650043270342,COGS 13,A01,083071,Staff,0,28,40,40
1650043276365,COGS 14A,A01,092681,Staff,0,6,100,100
1650043282387,COGS 14B,A01,083073,Cheng; Tzu-Han,0,3,50,50
1650043288412,COGS 17,A01,092677,Staff,35,0,75,40
1650043294446,COGS 100,A01,083619,Staff,0,17,60,60
1650043300469,COGS 101A,A01,083621,Davis; Joshua Daniel,0,16,60,60
1650043306497,COGS 101B,A01,091572,Staff,16,0,60,44
1650043312521,COGS 101C,A01,083625,Delgado; Tania,21,0,30,9
1650043318552,COGS 107A,A01,083627,Boyle; Mary E. T.,0,1,60,60
1650043324578,COGS 118A,A01,083075,Staff,19,0,60,41
1650043330600,CSE 3,A50,083646,Miranda; Gregory Joseph,21,0,38,17
1650043330600,CSE 3,A51,083647,Miranda; Gregory Joseph,37,0,37,0
1650043336623,CSE 8A,A50,083650,Miranda; Gregory Joseph,0,15,40,40
1650043342647,CSE 11,A01,083080,Cao; Yingjun,0,60,40,40
1650043348673,CSE 12,A01,083652,Staff,2,0,100,98
1650043354697,CSE 15L,A01,083654,Staff,0,0,50,50
1650043354697,CSE 15L,A02,083655,Staff,14,0,50,36
1650043360719,CSE 20,A01,083657,Staff,57,0,80,23
1650043366745,CSE 30,A01,083084,Eldon; John,0,63,40,40
1650043372772,CSE 100,A01,083659,Cao; Yingjun,0,57,50,50
1650043378795,CSE 134B,A01,083661,Powell; Thomas Allan,0,25,65,65
1650043384819,CSE 140,A01,083663,Staff,8,0,75,67
1650043390842,CSE 140L,A01,083088,Eldon; John,3,0,75,72
1650043396866,CSE 175,A01,083665,Kumar; Rakesh,9,0,25,16
1650043402889,CSE 190,A00,092507,Dubnov; Shlomo,17,0,20,3
1650043408917,ECE 45,A01,083139,Staff,0,10,40,40
1650043414940,ECE 65,A50,083695,Staff,0,1,30,30
1650043420964,ECE 109,A01,091882,Touri; Behrouz,48,0,70,22
1650043426991,ECE 180,A00,083140,Abi Samra; Nicholas Camill,25,0,30,5
1650043426991,ECE 180,B00,083141,Abi Samra; Nicholas Camill,9,0,30,21
1650043433015,MATH 10A,A01,083735,Patchell; Gregory David,13,0,30,17
1650043433015,MATH 10A,A02,083736,Patchell; Gregory David,28,0,30,2
1650043433015,MATH 10A,A03,083737,Patchell; Gregory David,27,0,30,3
1650043439041,MATH 10B,A01,083207,Staff,0,5,30,30
1650043439041,MATH 10B,A02,083208,Staff,0,0,30,30
1650043439041,MATH 10B,B01,083739,Staff,20,0,30,10
1650043439041,MATH 10B,B02,083740,Staff,30,0,30,0
1650043445070,MATH 18,A01,083743,Staff,10,0,30,20
1650043445070,MATH 18,A02,083744,Staff,28,0,30,2
1650043445070,MATH 18,A03,083745,Staff,23,0,30,7
1650043445070,MATH 18,A04,083746,Staff,27,0,30,3
1650043445070,MATH 18,B01,083748,Staff,0,8,30,30
1650043445070,MATH 18,B02,083749,Staff,0,6,30,30
1650043445070,MATH 18,B03,083750,Staff,0,6,30,30
1650043445070,MATH 18,B04,083751,Staff,1,7,30,29
1650043451099,MATH 20A,A01,083754,Staff,27,0,40,13
1650043457122,MATH 20B,A01,083756,Staff,0,6,30,30
1650043457122,MATH 20B,A02,083757,Staff,1,0,30,29
1650043463144,MATH 20C,A01,083760,Staff,0,9,30,30
1650043463144,MATH 20C,A02,083761,Staff,0,12,30,30
1650043463144,MATH 20C,B01,083762,Staff,17,0,30,13
1650043463144,MATH 20C,B02,083763,Staff,28,0,30,2
1650043469165,MATH 20D,A01,083765,Staff,0,2,30,30
1650043469165,MATH 20D,A02,083766,Staff,16,0,30,14
1650043469165,MATH 20D,A03,083767,Staff,28,0,30,2
1650043475191,MATH 20E,A01,083771,Staff,11,0,30,19
1650043475191,MATH 20E,A02,083772,Staff,20,0,30,10
1650043475191,MATH 20E,B01,083773,Staff,0,1,30,30
1650043475191,MATH 20E,B02,083774,Staff,18,0,30,12
1650043481310,MATH 103A,A01,083777,Staff,0,6,30,30
1650043481310,MATH 103A,A02,083778,Staff,0,7,30,30
1650043481310,MATH 103A,B01,083779,Staff,0,8,30,30
1650043481310,MATH 103A,B02,083780,Staff,0,6,30,30
1650043487331,MATH 105,A01,085443,Staff,0,11,30,30
1650043493355,MATH 109,A01,083213,Anzaldo; Leesa B,0,3,30,30
1650043493355,MATH 109,A02,083214,Anzaldo; Leesa B,0,4,30,30
1650043493355,MATH 109,B01,083215,Anzaldo; Leesa B,0,2,30,30
1650043493355,MATH 109,B02,083216,Anzaldo; Leesa B,0,2,30,30
1650043499383,MATH 142A,A01,083219,Chow; Bennett,0,7,30,30
1650043499383,MATH 142A,A02,083220,Chow; Bennett,0,7,30,30
1650043499383,MATH 142A,B01,083221,Chow; Bennett,0,9,30,30
1650043499383,MATH 142A,B02,083222,Chow; Bennett,0,7,30,30
1650043505406,MATH 193A,A01,083224,Staff,0,5,30,30
1650043505406,MATH 193A,A02,083225,Staff,0,4,30,30
1650043505406,MATH 193A,A03,083781,Staff,0,0,30,30
1650043505406,MATH 193A,A04,083782,Staff,9,0,30,21
1650043511431,MATH 197,001,091859,McAuley; Julian John,9999,0,9999,0
1650043517478,COGS 9,A01,083615,Staff,2,15,60,58
1650043523516,COGS 11,A01,083617,Boyle; Mary E. T.,25,0,40,15
1650043529547,COGS 13,A01,083071,Staff,0,28,40,40
1650043535570,COGS 14A,A01,092681,Staff,0,7,100,100
1650043541598,COGS 14B,A01,083073,Cheng; Tzu-Han,0,3,50,50
1650043547624,COGS 17,A01,092677,Staff,35,0,75,40
1650043553652,COGS 100,A01,083619,Staff,0,17,60,60
1650043559684,COGS 101A,A01,083621,Davis; Joshua Daniel,0,16,60,60
1650043565713,COGS 101B,A01,091572,Staff,16,0,60,44
1650043571738,COGS 101C,A01,083625,Delgado; Tania,21,0,30,9
1650043577769,COGS 107A,A01,083627,Boyle; Mary E. T.,0,1,60,60
1650043583803,COGS 118A,A01,083075,Staff,19,0,60,41
1650043589827,CSE 3,A50,083646,Miranda; Gregory Joseph,21,0,38,17
1650043589827,CSE 3,A51,083647,Miranda; Gregory Joseph,37,0,37,0
1650043595857,CSE 8A,A50,083650,Miranda; Gregory Joseph,0,15,40,40
1650043601884,CSE 11,A01,083080,Cao; Yingjun,0,60,40,40
1650043607907,CSE 12,A01,083652,Staff,2,0,100,98
1650043613937,CSE 15L,A01,083654,Staff,0,0,50,50
1650043613937,CSE 15L,A02,083655,Staff,14,0,50,36
1650043619962,CSE 20,A01,083657,Staff,57,0,80,23
1650043625989,CSE 30,A01,083084,Eldon; John,0,63,40,40
1650043632014,CSE 100,A01,083659,Cao; Yingjun,0,57,50,50
1650043638036,CSE 134B,A01,083661,Powell; Thomas Allan,0,25,65,65
1650043644067,CSE 140,A01,083663,Staff,8,0,75,67
1650043650097,CSE 140L,A01,083088,Eldon; John,3,0,75,72
1650043656125,CSE 175,A01,083665,Kumar; Rakesh,9,0,25,16
1650043662149,CSE 190,A00,092507,Dubnov; Shlomo,17,0,20,3
1650043668174,ECE 45,A01,083139,Staff,0,10,40,40
1650043674199,ECE 65,A50,083695,Staff,0,1,30,30
1650043680224,ECE 109,A01,091882,Touri; Behrouz,48,0,70,22
1650043686248,ECE 180,A00,083140,Abi Samra; Nicholas Camill,25,0,30,5
1650043686248,ECE 180,B00,083141,Abi Samra; Nicholas Camill,9,0,30,21
1650043692285,MATH 10A,A01,083735,Patchell; Gregory David,13,0,30,17
1650043692285,MATH 10A,A02,083736,Patchell; Gregory David,28,0,30,2
1650043692285,MATH 10A,A03,083737,Patchell; Gregory David,27,0,30,3
1650043698311,MATH 10B,A01,083207,Staff,0,5,30,30
1650043698311,MATH 10B,A02,083208,Staff,0,0,30,30
1650043698311,MATH 10B,B01,083739,Staff,20,0,30,10
1650043698311,MATH 10B,B02,083740,Staff,30,0,30,0
1650043704336,MATH 18,A01,083743,Staff,10,0,30,20
1650043704336,MATH 18,A02,083744,Staff,28,0,30,2
1650043704336,MATH 18,A03,083745,Staff,23,0,30,7
1650043704336,MATH 18,A04,083746,Staff,27,0,30,3
1650043704336,MATH 18,B01,083748,Staff,0,8,30,30
1650043704336,MATH 18,B02,083749,Staff,0,6,30,30
1650043704336,MATH 18,B03,083750,Staff,0,6,30,30
1650043704336,MATH 18,B04,083751,Staff,1,7,30,29
1650043710362,MATH 20A,A01,083754,Staff,27,0,40,13
1650043716389,MATH 20B,A01,083756,Staff,0,6,30,30
1650043716389,MATH 20B,A02,083757,Staff,1,0,30,29
1650043722416,MATH 20C,A01,083760,Staff,0,9,30,30
1650043722416,MATH 20C,A02,083761,Staff,0,12,30,30
1650043722416,MATH 20C,B01,083762,Staff,17,0,30,13
1650043722416,MATH 20C,B02,083763,Staff,28,0,30,2
1650043728443,MATH 20D,A01,083765,Staff,0,2,30,30
1650043728443,MATH 20D,A02,083766,Staff,16,0,30,14
1650043728443,MATH 20D,A03,083767,Staff,28,0,30,2
1650043734466,MATH 20E,A01,083771,Staff,10,0,30,20
1650043734466,MATH 20E,A02,083772,Staff,20,0,30,10
1650043734466,MATH 20E,B01,083773,Staff,0,1,30,30
1650043734466,MATH 20E,B02,083774,Staff,18,0,30,12
1650043740493,MATH 103A,A01,083777,Staff,0,6,30,30
1650043740493,MATH 103A,A02,083778,Staff,0,7,30,30
1650043740493,MATH 103A,B01,083779,Staff,0,8,30,30
1650043740493,MATH 103A,B02,083780,Staff,0,6,30,30
1650043746516,MATH 105,A01,085443,Staff,0,11,30,30
1650043752539,MATH 109,A01,083213,Anzaldo; Leesa B,0,3,30,30
1650043752539,MATH 109,A02,083214,Anzaldo; Leesa B,0,4,30,30
1650043752539,MATH 109,B01,083215,Anzaldo; Leesa B,0,2,30,30
1650043752539,MATH 109,B02,083216,Anzaldo; Leesa B,0,2,30,30
1650043758570,MATH 142A,A01,083219,Chow; Bennett,0,7,30,30
1650043758570,MATH 142A,A02,083220,Chow; Bennett,0,7,30,30
1650043758570,MATH 142A,B01,083221,Chow; Bennett,0,9,30,30
1650043758570,MATH 142A,B02,083222,Chow; Bennett,0,7,30,30
1650043764603,MATH 193A,A01,083224,Staff,0,5,30,30
1650043764603,MATH 193A,A02,083225,Staff,0,4,30,30
1650043764603,MATH 193A,A03,083781,Staff,0,0,30,30
1650043764603,MATH 193A,A04,083782,Staff,9,0,30,21
1650043770628,MATH 197,001,091859,McAuley; Julian John,9999,0,9999,0
1650043776682,COGS 9,A01,083615,Staff,2,15,60,58
1650043782706,COGS 11,A01,083617,Boyle; Mary E. T.,25,0,40,15
1650043788729,COGS 13,A01,083071,Staff,0,28,40,40
1650043794752,COGS 14A,A01,092681,Staff,0,7,100,100
1650043800777,COGS 14B,A01,083073,Cheng; Tzu-Han,0,3,50,50
1650043806804,COGS 17,A01,092677,Staff,35,0,75,40
1650043812836,COGS 100,A01,083619,Staff,0,17,60,60
1650043818860,COGS 101A,A01,083621,Davis; Joshua Daniel,0,16,60,60
1650043824887,COGS 101B,A01,091572,Staff,16,0,60,44
1650043830910,COGS 101C,A01,083625,Delgado; Tania,21,0,30,9
1650043836934,COGS 107A,A01,083627,Boyle; Mary E. T.,0,1,60,60
1650043842959,COGS 118A,A01,083075,Staff,19,0,60,41
1650043848983,CSE 3,A50,083646,Miranda; Gregory Joseph,21,0,38,17
1650043848983,CSE 3,A51,083647,Miranda; Gregory Joseph,37,0,37,0
1650043855022,CSE 8A,A50,083650,Miranda; Gregory Joseph,0,15,40,40
1650043861044,CSE 11,A01,083080,Cao; Yingjun,0,60,40,40
1650043867068,CSE 12,A01,083652,Staff,1,0,100,99
1650043873095,CSE 15L,A01,083654,Staff,0,0,50,50
1650043873095,CSE 15L,A02,083655,Staff,13,0,50,37
1650043879145,CSE 20,A01,083657,Staff,58,0,80,22
1650043885168,CSE 30,A01,083084,Eldon; John,0,63,40,40
1650043891193,CSE 100,A01,083659,Cao; Yingjun,0,57,50,50
1650043897224,CSE 134B,A01,083661,Powell; Thomas Allan,0,25,65,65
1650043903254,CSE 140,A01,083663,Staff,8,0,75,67
1650043909283,CSE 140L,A01,083088,Eldon; John,3,0,75,72
1650043915308,CSE 175,A01,083665,Kumar; Rakesh,9,0,25,16
1650043921331,CSE 190,A00,092507,Dubnov; Shlomo,17,0,20,3
1650043927354,ECE 45,A01,083139,Staff,0,10,40,40
1650043933377,ECE 65,A50,083695,Staff,0,1,30,30
1650043939404,ECE 109,A01,091882,Touri; Behrouz,48,0,70,22
1650043945437,ECE 180,A00,083140,Abi Samra; Nicholas Camill,25,0,30,5
1650043945437,ECE 180,B00,083141,Abi Samra; Nicholas Camill,9,0,30,21
1650043951465,MATH 10A,A01,083735,Patchell; Gregory David,13,0,30,17
1650043951465,MATH 10A,A02,083736,Patchell; Gregory David,28,0,30,2
1650043951465,MATH 10A,A03,083737,Patchell; Gregory David,27,0,30,3
1650043957488,MATH 10B,A01,083207,Staff,0,5,30,30
1650043957488,MATH 10B,A02,083208,Staff,0,1,30,30
1650043957488,MATH 10B,B01,083739,Staff,20,0,30,10
1650043957488,MATH 10B,B02,083740,Staff,30,0,30,0
1650043963512,MATH 18,A01,083743,Staff,10,0,30,20
1650043963512,MATH 18,A02,083744,Staff,28,0,30,2
1650043963512,MATH 18,A03,083745,Staff,23,0,30,7
1650043963512,MATH 18,A04,083746,Staff,27,0,30,3
1650043963512,MATH 18,B01,083748,Staff,0,8,30,30
1650043963512,MATH 18,B02,083749,Staff,0,6,30,30
1650043963512,MATH 18,B03,083750,Staff,0,6,30,30
1650043963512,MATH 18,B04,083751,Staff,1,7,30,29
1650043969538,MATH 20A,A01,083754,Staff,27,0,40,13
1650043975571,MATH 20B,A01,083756,Staff,0,6,30,30
1650043975571,MATH 20B,A02,083757,Staff,1,0,30,29
1650043981595,MATH 20C,A01,083760,Staff,0,9,30,30
1650043981595,MATH 20C,A02,083761,Staff,0,12,30,30
1650043981595,MATH 20C,B01,083762,Staff,17,0,30,13
1650043981595,MATH 20C,B02,083763,Staff,28,0,30,2
1650043987621,MATH 20D,A01,083765,Staff,0,2,30,30
1650043987621,MATH 20D,A02,083766,Staff,16,0,30,14
1650043987621,MATH 20D,A03,083767,Staff,28,0,30,2
1650043993644,MATH 20E,A01,083771,Staff,10,0,30,20
1650043993644,MATH 20E,A02,083772,Staff,20,0,30,10
1650043993644,MATH 20E,B01,083773,Staff,0,1,30,30
1650043993644,MATH 20E,B02,083774,Staff,18,0,30,12
1650043999676,MATH 103A,A01,083777,Staff,0,6,30,30
1650043999676,MATH 103A,A02,083778,Staff,0,7,30,30
1650043999676,MATH 103A,B01,083779,Staff,0,8,30,30
1650043999676,MATH 103A,B02,083780,Staff,0,6,30,30
1650044005705,MATH 105,A01,085443,Staff,0,11,30,30
1650044011736,MATH 109,A01,083213,Anzaldo; Leesa B,0,3,30,30
1650044011736,MATH 109,A02,083214,Anzaldo; Leesa B,0,4,30,30
1650044011736,MATH 109,B01,083215,Anzaldo; Leesa B,0,2,30,30
1650044011736,MATH 109,B02,083216,Anzaldo; Leesa B,0,2,30,30
1650044017767,MATH 142A,A01,083219,Chow; Bennett,0,7,30,30
1650044017767,MATH 142A,A02,083220,Chow; Bennett,0,7,30,30
1650044017767,MATH 142A,B01,083221,Chow; Bennett,0,9,30,30
1650044017767,MATH 142A,B02,083222,Chow; Bennett,0,7,30,30
1650044023799,MATH 193A,A01,083224,Staff,0,5,30,30
1650044023799,MATH 193A,A02,083225,Staff,0,4,30,30
1650044023799,MATH 193A,A03,083781,Staff,0,0,30,30
1650044023799,MATH 193A,A04,083782,Staff,9,0,30,21
1650044029825,MATH 197,001,091859,McAuley; Julian John,9999,0,9999,0
1650044035875,COGS 9,A01,083615,Staff,2,15,60,58
1650044041906,COGS 11,A01,083617,Boyle; Mary E. T.,25,0,40,15
1650044047929,COGS 13,A01,083071,Staff,0,28,40,40
1650044053953,COGS 14A,A01,092681,Staff,0,7,100,100
1650044059975,COGS 14B,A01,083073,Cheng; Tzu-Han,0,3,50,50
1650044066000,COGS 17,A01,092677,Staff,35,0,75,40
1650044072115,COGS 100,A01,083619,Staff,0,17,60,60
1650044078136,COGS 101A,A01,083621,Davis; Joshua Daniel,0,16,60,60
1650044084170,COGS 101B,A01,091572,Staff,16,0,60,44
1650044090193,COGS 101C,A01,083625,Delgado; Tania,21,0,30,9
1650044096225,COGS 107A,A01,083627,Boyle; Mary E. T.,1,1,60,59
1650044102256,COGS 118A,A01,083075,Staff,19,0,60,41
1650044108282,CSE 3,A50,083646,Miranda; Gregory Joseph,21,0,38,17
1650044108282,CSE 3,A51,083647,Miranda; Gregory Joseph,37,0,37,0
1650044114305,CSE 8A,A50,083650,Miranda; Gregory Joseph,0,15,40,40
1650044120327,CSE 11,A01,083080,Cao; Yingjun,0,60,40,40
1650044126364,CSE 12,A01,083652,Staff,1,0,100,99
1650044132391,CSE 15L,A01,083654,Staff,0,0,50,50
1650044132391,CSE 15L,A02,083655,Staff,13,0,50,37
1650044138418,CSE 20,A01,083657,Staff,58,0,80,22
1650044144449,CSE 30,A01,083084,Eldon; John,0,63,40,40
1650044150475,CSE 100,A01,083659,Cao; Yingjun,0,57,50,50
1650044156499,CSE 134B,A01,083661,Powell; Thomas Allan,0,25,65,65
1650044162520,CSE 140,A01,083663,Staff,8,0,75,67
1650044168548,CSE 140L,A01,083088,Eldon; John,3,0,75,72
1650044174584,CSE 175,A01,083665,Kumar; Rakesh,9,0,25,16
1650044180608,CSE 190,A00,092507,Dubnov; Shlomo,16,0,20,4
1650044186631,ECE 45,A01,083139,Staff,0,10,40,40
1650044192658,ECE 65,A50,083695,Staff,0,1,30,30
1650044198680,ECE 109,A01,091882,Touri; Behrouz,48,0,70,22
1650044204711,ECE 180,A00,083140,Abi Samra; Nicholas Camill,25,0,30,5
1650044204711,ECE 180,B00,083141,Abi Samra; Nicholas Camill,9,0,30,21
1650044210739,MATH 10A,A01,083735,Patchell; Gregory David,13,0,30,17
1650044210739,MATH 10A,A02,083736,Patchell; Gregory David,28,0,30,2
1650044210739,MATH 10A,A03,083737,Patchell; Gregory David,27,0,30,3
1650044216773,MATH 10B,A01,083207,Staff,0,5,30,30
1650044216773,MATH 10B,A02,083208,Staff,0,1,30,30
1650044216773,MATH 10B,B01,083739,Staff,20,0,30,10
1650044216773,MATH 10B,B02,083740,Staff,30,0,30,0
1650044222812,MATH 18,A01,083743,Staff,10,0,30,20
1650044222812,MATH 18,A02,083744,Staff,28,0,30,2
1650044222812,MATH 18,A03,083745,Staff,23,0,30,7
1650044222812,MATH 18,A04,083746,Staff,27,0,30,3
1650044222812,MATH 18,B01,083748,Staff,0,8,30,30
1650044222812,MATH 18,B02,083749,Staff,0,6,30,30
1650044222812,MATH 18,B03,083750,Staff,0,6,30,30
1650044222812,MATH 18,B04,083751,Staff,1,7,30,29
1650044228842,MATH 20A,A01,083754,Staff,27,0,40,13
1650044234868,MATH 20B,A01,083756,Staff,0,6,30,30
1650044234868,MATH 20B,A02,083757,Staff,1,0,30,29
1650044240894,MATH 20C,A01,083760,Staff,0,9,30,30
1650044240894,MATH 20C,A02,083761,Staff,0,12,30,30
1650044240894,MATH 20C,B01,083762,Staff,17,0,30,13
1650044240894,MATH 20C,B02,083763,Staff,28,0,30,2
1650044246921,MATH 20D,A01,083765,Staff,0,2,30,30
1650044246921,MATH 20D,A02,083766,Staff,15,0,30,15
1650044246921,MATH 20D,A03,083767,Staff,28,0,30,2
1650044252949,MATH 20E,A01,083771,Staff,10,0,30,20
1650044252949,MATH 20E,A02,083772,Staff,20,0,30,10
1650044252949,MATH 20E,B01,083773,Staff,0,1,30,30
1650044252949,MATH 20E,B02,083774,Staff,18,0,30,12
1650044258972,MATH 103A,A01,083777,Staff,0,6,30,30
1650044258972,MATH 103A,A02,083778,Staff,0,7,30,30
1650044258972,MATH 103A,B01,083779,Staff,0,8,30,30
1650044258972,MATH 103A,B02,083780,Staff,0,6,30,30
1650044264995,MATH 105,A01,085443,Staff,0,11,30,30
1650044271020,MATH 109,A01,083213,Anzaldo; Leesa B,0,3,30,30
1650044271020,MATH 109,A02,083214,Anzaldo; Leesa B,0,4,30,30
1650044271020,MATH 109,B01,083215,Anzaldo; Leesa B,0,2,30,30
1650044271020,MATH 109,B02,083216,Anzaldo; Leesa B,0,2,30,30
1650044277045,MATH 142A,A01,083219,Chow; Bennett,0,7,30,30
1650044277045,MATH 142A,A02,083220,Chow; Bennett,0,7,30,30
1650044277045,MATH 142A,B01,083221,Chow; Bennett,0,9,30,30
1650044277045,MATH 142A,B02,083222,Chow; Bennett,0,7,30,30
1650044283077,MATH 193A,A01,083224,Staff,0,5,30,30
1650044283077,MATH 193A,A02,083225,Staff,0,4,30,30
1650044283077,MATH 193A,A03,083781,Staff,0,0,30,30
1650044283077,MATH 193A,A04,083782,Staff,9,0,30,21
1650044289101,MATH 197,001,091859,McAuley; Julian John,9999,0,9999,0
1650044295185,COGS 9,A01,083615,Staff,2,15,60,58
1650044301209,COGS 11,A01,083617,Boyle; Mary E. T.,25,0,40,15
1650044307231,COGS 13,A01,083071,Staff,0,28,40,40
1650044313264,COGS 14A,A01,092681,Staff,0,7,100,100
1650044319292,COGS 14B,A01,083073,Cheng; Tzu-Han,0,3,50,50
1650044325317,COGS 17,A01,092677,Staff,35,0,75,40
1650044331345,COGS 100,A01,083619,Staff,0,17,60,60
1650044337380,COGS 101A,A01,083621,Davis; Joshua Daniel,0,16,60,60
1650044343401,COGS 101B,A01,091572,Staff,16,0,60,44
1650044349428,COGS 101C,A01,083625,Delgado; Tania,21,0,30,9
1650044355455,COGS 107A,A01,083627,Boyle; Mary E. T.,1,1,60,59
1650044361478,COGS 118A,A01,083075,Staff,19,0,60,41
1650044367506,CSE 3,A50,083646,Miranda; Gregory Joseph,21,0,38,17
1650044367506,CSE 3,A51,083647,Miranda; Gregory Joseph,37,0,37,0
1650044373529,CSE 8A,A50,083650,Miranda; Gregory Joseph,0,15,40,40
1650044379556,CSE 11,A01,083080,Cao; Yingjun,0,60,40,40
1650044385579,CSE 12,A01,083652,Staff,1,0,100,99
1650044391607,CSE 15L,A01,083654,Staff,0,0,50,50
1650044391607,CSE 15L,A02,083655,Staff,13,0,50,37
1650044397632,CSE 20,A01,083657,Staff,58,0,80,22
1650044403669,CSE 30,A01,083084,Eldon; John,0,63,40,40
1650044409691,CSE 100,A01,083659,Cao; Yingjun,0,57,50,50
1650044415719,CSE 134B,A01,083661,Powell; Thomas Allan,0,25,65,65
1650044421745,CSE 140,A01,083663,Staff,8,0,75,67
1650044427776,CSE 140L,A01,083088,Eldon; John,3,0,75,72
1650044433801,CSE 175,A01,083665,Kumar; Rakesh,9,0,25,16
1650044439825,CSE 190,A00,092507,Dubnov; Shlomo,16,0,20,4
1650044445851,ECE 45,A01,083139,Staff,0,10,40,40
1650044451876,ECE 65,A50,083695,Staff,0,1,30,30
1650044457901,ECE 109,A01,091882,Touri; Behrouz,48,0,70,22
1650044463926,ECE 180,A00,083140,Abi Samra; Nicholas Camill,25,0,30,5
1650044463926,ECE 180,B00,083141,Abi Samra; Nicholas Camill,9,0,30,21
1650044469950,MATH 10A,A01,083735,Patchell; Gregory David,13,0,30,17
1650044469950,MATH 10A,A02,083736,Patchell; Gregory David,28,0,30,2
1650044469950,MATH 10A,A03,083737,Patchell; Gregory David,27,0,30,3
1650044475987,MATH 10B,A01,083207,Staff,0,5,30,30
1650044475987,MATH 10B,A02,083208,Staff,0,1,30,30
1650044475987,MATH 10B,B01,083739,Staff,20,0,30,10
1650044475987,MATH 10B,B02,083740,Staff,30,0,30,0
1650044482010,MATH 18,A01,083743,Staff,10,0,30,20
1650044482010,MATH 18,A02,083744,Staff,28,0,30,2
1650044482010,MATH 18,A03,083745,Staff,23,0,30,7
1650044482010,MATH 18,A04,083746,Staff,27,0,30,3
1650044482010,MATH 18,B01,083748,Staff,0,8,30,30
1650044482010,MATH 18,B02,083749,Staff,0,6,30,30
1650044482010,MATH 18,B03,083750,Staff,0,6,30,30
1650044482010,MATH 18,B04,083751,Staff,1,7,30,29
1650044488046,MATH 20A,A01,083754,Staff,27,0,40,13
1650044494074,MATH 20B,A01,083756,Staff,0,6,30,30
1650044494074,MATH 20B,A02,083757,Staff,1,0,30,29
1650044500100,MATH 20C,A01,083760,Staff,0,9,30,30
1650044500100,MATH 20C,A02,083761,Staff,0,12,30,30
1650044500100,MATH 20C,B01,083762,Staff,17,0,30,13
1650044500100,MATH 20C,B02,083763,Staff,28,0,30,2
1650044506124,MATH 20D,A01,083765,Staff,0,2,30,30
1650044506124,MATH 20D,A02,083766,Staff,15,0,30,15
1650044506124,MATH 20D,A03,083767,Staff,28,0,30,2
1650044512155,MATH 20E,A01,083771,Staff,10,0,30,20
1650044512155,MATH 20E,A02,083772,Staff,20,0,30,10
1650044512155,MATH 20E,B01,083773,Staff,0,1,30,30
1650044512155,MATH 20E,B02,083774,Staff,18,0,30,12
1650044518183,MATH 103A,A01,083777,Staff,0,6,30,30
1650044518183,MATH 103A,A02,083778,Staff,0,7,30,30
1650044518183,MATH 103A,B01,083779,Staff,0,8,30,30
1650044518183,MATH 103A,B02,083780,Staff,0,6,30,30
1650044524218,MATH 105,A01,085443,Staff,0,11,30,30
1650044530241,MATH 109,A01,083213,Anzaldo; Leesa B,0,3,30,30
1650044530241,MATH 109,A02,083214,Anzaldo; Leesa B,0,4,30,30
1650044530241,MATH 109,B01,083215,Anzaldo; Leesa B,0,2,30,30
1650044530241,MATH 109,B02,083216,Anzaldo; Leesa B,0,2,30,30
1650044536265,MATH 142A,A01,083219,Chow; Bennett,0,7,30,30
1650044536265,MATH 142A,A02,083220,Chow; Bennett,0,7,30,30
1650044536265,MATH 142A,B01,083221,Chow; Bennett,0,9,30,30
1650044536265,MATH 142A,B02,083222,Chow; Bennett,0,7,30,30
1650044542291,MATH 193A,A01,083224,Staff,0,5,30,30
1650044542291,MATH 193A,A02,083225,Staff,0,4,30,30
1650044542291,MATH 193A,A03,083781,Staff,0,0,30,30
1650044542291,MATH 193A,A04,083782,Staff,9,0,30,21
1650044548319,MATH 197,001,091859,McAuley; Julian John,9999,0,9999,0
1650044554372,COGS 9,A01,083615,Staff,2,15,60,58
1650044560394,COGS 11,A01,083617,Boyle; Mary E. T.,25,0,40,15
1650044566420,COGS 13,A01,083071,Staff,0,28,40,40
1650044572445,COGS 14A,A01,092681,Staff,0,7,100,100
1650044578471,COGS 14B,A01,083073,Cheng; Tzu-Han,0,3,50,50
1650044584501,COGS 17,A01,092677,Staff,35,0,75,40
1650044590528,COGS 100,A01,083619,Staff,0,17,60,60
1650044596551,COGS 101A,A01,083621,Davis; Joshua Daniel,0,16,60,60
1650044602587,COGS 101B,A01,091572,Staff,16,0,60,44
1650044608615,COGS 101C,A01,083625,Delgado; Tania,21,0,30,9
1650044614641,COGS 107A,A01,083627,Boyle; Mary E. T.,1,1,60,59
1650044620671,COGS 118A,A01,083075,Staff,19,0,60,41
1650044626702,CSE 3,A50,083646,Miranda; Gregory Joseph,21,0,38,17
1650044626702,CSE 3,A51,083647,Miranda; Gregory Joseph,37,0,37,0
1650044632729,CSE 8A,A50,083650,Miranda; Gregory Joseph,0,15,40,40
1650044638754,CSE 11,A01,083080,Cao; Yingjun,0,60,40,40
1650044644788,CSE 12,A01,083652,Staff,1,0,100,99
1650044650812,CSE 15L,A01,083654,Staff,0,0,50,50
1650044650812,CSE 15L,A02,083655,Staff,13,0,50,37
1650044656842,CSE 20,A01,083657,Staff,58,0,80,22
1650044662871,CSE 30,A01,083084,Eldon; John,0,63,40,40
1650044668987,CSE 100,A01,083659,Cao; Yingjun,0,57,50,50
1650044675010,CSE 134B,A01,083661,Powell; Thomas Allan,0,25,65,65
1650044681041,CSE 140,A01,083663,Staff,8,0,75,67
1650044687069,CSE 140L,A01,083088,Eldon; John,3,0,75,72
1650044693093,CSE 175,A01,083665,Kumar; Rakesh,9,0,25,16
1650044699118,CSE 190,A00,092507,Dubnov; Shlomo,15,0,20,5
1650044705142,ECE 45,A01,083139,Staff,0,10,40,40
1650044711175,ECE 65,A50,083695,Staff,0,1,30,30
1650044717210,ECE 109,A01,091882,Touri; Behrouz,48,0,70,22
1650044723233,ECE 180,A00,083140,Abi Samra; Nicholas Camill,25,0,30,5
1650044723233,ECE 180,B00,083141,Abi Samra; Nicholas Camill,9,0,30,21
1650044729260,MATH 10A,A01,083735,Patchell; Gregory David,13,0,30,17
1650044729260,MATH 10A,A02,083736,Patchell; Gregory David,28,0,30,2
1650044729260,MATH 10A,A03,083737,Patchell; Gregory David,27,0,30,3
1650044735292,MATH 10B,A01,083207,Staff,0,5,30,30
1650044735292,MATH 10B,A02,083208,Staff,0,1,30,30
1650044735292,MATH 10B,B01,083739,Staff,20,0,30,10
1650044735292,MATH 10B,B02,083740,Staff,30,0,30,0
1650044741316,MATH 18,A01,083743,Staff,10,0,30,20
1650044741316,MATH 18,A02,083744,Staff,28,0,30,2
1650044741316,MATH 18,A03,083745,Staff,23,0,30,7
1650044741316,MATH 18,A04,083746,Staff,27,0,30,3
1650044741316,MATH 18,B01,083748,Staff,0,8,30,30
1650044741316,MATH 18,B02,083749,Staff,0,6,30,30
1650044741316,MATH 18,B03,083750,Staff,0,6,30,30
1650044741316,MATH 18,B04,083751,Staff,1,7,30,29
1650044747338,MATH 20A,A01,083754,Staff,27,0,40,13
1650044753363,MATH 20B,A01,083756,Staff,0,6,30,30
1650044753363,MATH 20B,A02,083757,Staff,1,0,30,29
1650044759386,MATH 20C,A01,083760,Staff,0,9,30,30
1650044759386,MATH 20C,A02,083761,Staff,0,12,30,30
1650044759386,MATH 20C,B01,083762,Staff,17,0,30,13
1650044759386,MATH 20C,B02,083763,Staff,28,0,30,2
1650044765428,MATH 20D,A01,083765,Staff,0,2,30,30
1650044765428,MATH 20D,A02,083766,Staff,15,0,30,15
1650044765428,MATH 20D,A03,083767,Staff,28,0,30,2
1650044771455,MATH 20E,A01,083771,Staff,10,0,30,20
1650044771455,MATH 20E,A02,083772,Staff,20,0,30,10
1650044771455,MATH 20E,B01,083773,Staff,0,1,30,30
1650044771455,MATH 20E,B02,083774,Staff,17,0,30,13
1650044777481,MATH 103A,A01,083777,Staff,0,6,30,30
1650044777481,MATH 103A,A02,083778,Staff,0,7,30,30
1650044777481,MATH 103A,B01,083779,Staff,0,8,30,30
1650044777481,MATH 103A,B02,083780,Staff,0,6,30,30
1650044783511,MATH 105,A01,085443,Staff,0,11,30,30
1650044789535,MATH 109,A01,083213,Anzaldo; Leesa B,0,3,30,30
1650044789535,MATH 109,A02,083214,Anzaldo; Leesa B,0,4,30,30
1650044789535,MATH 109,B01,083215,Anzaldo; Leesa B,0,2,30,30
1650044789535,MATH 109,B02,083216,Anzaldo; Leesa B,0,2,30,30
1650044795577,MATH 142A,A01,083219,Chow; Bennett,0,7,30,30
1650044795577,MATH 142A,A02,083220,Chow; Bennett,0,7,30,30
1650044795577,MATH 142A,B01,083221,Chow; Bennett,0,9,30,30
1650044795577,MATH 142A,B02,083222,Chow; Bennett,0,7,30,30
1650044801601,MATH 193A,A01,083224,Staff,0,5,30,30
1650044801601,MATH 193A,A02,083225,Staff,0,4,30,30
1650044801601,MATH 193A,A03,083781,Staff,0,0,30,30
1650044801601,MATH 193A,A04,083782,Staff,9,0,30,21
1650044807669,MATH 197,001,091859,McAuley; Julian John,9999,0,9999,0
1650044813728,COGS 9,A01,083615,Staff,2,15,60,58
1650044819754,COGS 11,A01,083617,Boyle; Mary E. T.,25,0,40,15
1650044825778,COGS 13,A01,083071,Staff,0,28,40,40
1650044831814,COGS 14A,A01,092681,Staff,0,7,100,100
1650044837836,COGS 14B,A01,083073,Cheng; Tzu-Han,0,3,50,50
1650044843864,COGS 17,A01,092677,Staff,35,0,75,40
1650044849896,COGS 100,A01,083619,Staff,0,17,60,60
1650044855920,COGS 101A,A01,083621,Davis; Joshua Daniel,0,16,60,60
1650044861949,COGS 101B,A01,091572,Staff,16,0,60,44
1650044867973,COGS 101C,A01,083625,Delgado; Tania,21,0,30,9
1650044874000,COGS 107A,A01,083627,Boyle; Mary E. T.,1,2,60,59
1650044880025,COGS 118A,A01,083075,Staff,19,0,60,41
1650044886073,CSE 3,A50,083646,Miranda; Gregory Joseph,21,0,38,17
1650044886073,CSE 3,A51,083647,Miranda; Gregory Joseph,37,0,37,0
1650044892102,CSE 8A,A50,083650,Miranda; Gregory Joseph,0,15,40,40
1650044898126,CSE 11,A01,083080,Cao; Yingjun,0,60,40,40
1650044904149,CSE 12,A01,083652,Staff,1,0,100,99
1650044910173,CSE 15L,A01,083654,Staff,0,0,50,50
1650044910173,CSE 15L,A02,083655,Staff,13,0,50,37
1650044916196,CSE 20,A01,083657,Staff,58,0,80,22
1650044922224,CSE 30,A01,083084,Eldon; John,0,63,40,40
1650044928253,CSE 100,A01,083659,Cao; Yingjun,0,57,50,50
1650044934281,CSE 134B,A01,083661,Powell; Thomas Allan,0,25,65,65
1650044940310,CSE 140,A01,083663,Staff,8,0,75,67
1650044946338,CSE 140L,A01,083088,Eldon; John,3,0,75,72
1650044952370,CSE 175,A01,083665,Kumar; Rakesh,9,0,25,16
1650044958395,CSE 190,A00,092507,Dubnov; Shlomo,15,0,20,5
1650044964421,ECE 45,A01,083139,Staff,0,10,40,40
1650044970445,ECE 65,A50,083695,Staff,0,1,30,30
1650044976469,ECE 109,A01,091882,Touri; Behrouz,48,0,70,22
1650044982492,ECE 180,A00,083140,Abi Samra; Nicholas Camill,25,0,30,5
1650044982492,ECE 180,B00,083141,Abi Samra; Nicholas Camill,9,0,30,21
1650044988522,MATH 10A,A01,083735,Patchell; Gregory David,13,0,30,17
1650044988522,MATH 10A,A02,083736,Patchell; Gregory David,28,0,30,2
1650044988522,MATH 10A,A03,083737,Patchell; Gregory David,27,0,30,3
1650044994546,MATH 10B,A01,083207,Staff,0,5,30,30
1650044994546,MATH 10B,A02,083208,Staff,0,1,30,30
1650044994546,MATH 10B,B01,083739,Staff,20,0,30,10
1650044994546,MATH 10B,B02,083740,Staff,30,0,30,0
1650045000571,MATH 18,A01,083743,Staff,10,0,30,20
1650045000571,MATH 18,A02,083744,Staff,28,0,30,2
1650045000571,MATH 18,A03,083745,Staff,23,0,30,7
1650045000571,MATH 18,A04,083746,Staff,27,0,30,3
1650045000571,MATH 18,B01,083748,Staff,0,8,30,30
1650045000571,MATH 18,B02,083749,Staff,0,6,30,30
1650045000571,MATH 18,B03,083750,Staff,0,6,30,30
1650045000571,MATH 18,B04,083751,Staff,1,7,30,29
1650045006596,MATH 20A,A01,083754,Staff,27,0,40,13
1650045012619,MATH 20B,A01,083756,Staff,0,6,30,30
1650045012619,MATH 20B,A02,083757,Staff,1,0,30,29
1650045018646,MATH 20C,A01,083760,Staff,0,9,30,30
1650045018646,MATH 20C,A02,083761,Staff,0,12,30,30
1650045018646,MATH 20C,B01,083762,Staff,17,0,30,13
1650045018646,MATH 20C,B02,083763,Staff,28,0,30,2
1650045024668,MATH 20D,A01,083765,Staff,0,2,30,30
1650045024668,MATH 20D,A02,083766,Staff,15,0,30,15
1650045024668,MATH 20D,A03,083767,Staff,28,0,30,2
1650045030692,MATH 20E,A01,083771,Staff,10,0,30,20
1650045030692,MATH 20E,A02,083772,Staff,20,0,30,10
1650045030692,MATH 20E,B01,083773,Staff,0,1,30,30
1650045030692,MATH 20E,B02,083774,Staff,17,0,30,13
1650045036715,MATH 103A,A01,083777,Staff,0,6,30,30
1650045036715,MATH 103A,A02,083778,Staff,0,7,30,30
1650045036715,MATH 103A,B01,083779,Staff,0,8,30,30
1650045036715,MATH 103A,B02,083780,Staff,0,6,30,30
1650045042738,MATH 105,A01,085443,Staff,0,11,30,30
1650045048768,MATH 109,A01,083213,Anzaldo; Leesa B,0,3,30,30
1650045048768,MATH 109,A02,083214,Anzaldo; Leesa B,0,4,30,30
1650045048768,MATH 109,B01,083215,Anzaldo; Leesa B,0,2,30,30
1650045048768,MATH 109,B02,083216,Anzaldo; Leesa B,0,2,30,30
1650045054824,MATH 142A,A01,083219,Chow; Bennett,0,7,30,30
1650045054824,MATH 142A,A02,083220,Chow; Bennett,0,7,30,30
1650045054824,MATH 142A,B01,083221,Chow; Bennett,0,9,30,30
1650045054824,MATH 142A,B02,083222,Chow; Bennett,0,7,30,30
1650045060847,MATH 193A,A01,083224,Staff,0,5,30,30
1650045060847,MATH 193A,A02,083225,Staff,0,4,30,30
1650045060847,MATH 193A,A03,083781,Staff,0,0,30,30
1650045060847,MATH 193A,A04,083782,Staff,9,0,30,21
1650045066869,MATH 197,001,091859,McAuley; Julian John,9999,0,9999,0
1650045072917,COGS 9,A01,083615,Staff,2,15,60,58
1650045078950,COGS 11,A01,083617,Boyle; Mary E. T.,25,0,40,15
1650045084974,COGS 13,A01,083071,Staff,0,28,40,40
1650045091003,COGS 14A,A01,092681,Staff,0,7,100,100
1650045097033,COGS 14B,A01,083073,Cheng; Tzu-Han,0,3,50,50
1650045103061,COGS 17,A01,092677,Staff,35,0,75,40
1650045109084,COGS 100,A01,083619,Staff,0,17,60,60
1650045115106,COGS 101A,A01,083621,Davis; Joshua Daniel,0,16,60,60
1650045121150,COGS 101B,A01,091572,Staff,16,0,60,44
1650045127181,COGS 101C,A01,083625,Delgado; Tania,21,0,30,9
1650045133234,COGS 107A,A01,083627,Boyle; Mary E. T.,1,2,60,59
1650045139261,COGS 118A,A01,083075,Staff,19,0,60,41
1650045145284,CSE 3,A50,083646,Miranda; Gregory Joseph,21,0,38,17
1650045145284,CSE 3,A51,083647,Miranda; Gregory Joseph,37,0,37,0
1650045151310,CSE 8A,A50,083650,Miranda; Gregory Joseph,0,15,40,40
1650045157346,CSE 11,A01,083080,Cao; Yingjun,0,60,40,40
1650045163377,CSE 12,A01,083652,Staff,1,0,100,99
1650045169399,CSE 15L,A01,083654,Staff,0,0,50,50
1650045169399,CSE 15L,A02,083655,Staff,13,0,50,37
1650045175429,CSE 20,A01,083657,Staff,58,0,80,22
1650045181464,CSE 30,A01,083084,Eldon; John,0,63,40,40
1650045187493,CSE 100,A01,083659,Cao; Yingjun,0,57,50,50
1650045193515,CSE 134B,A01,083661,Powell; Thomas Allan,0,25,65,65
1650045199540,CSE 140,A01,083663,Staff,8,0,75,67
1650045205567,CSE 140L,A01,083088,Eldon; John,3,0,75,72
1650045211600,CSE 175,A01,083665,Kumar; Rakesh,9,0,25,16
1650045217630,CSE 190,A00,092507,Dubnov; Shlomo,15,0,20,5
1650045223662,ECE 45,A01,083139,Staff,0,10,40,40
1650045229687,ECE 65,A50,083695,Staff,0,1,30,30
1650045235717,ECE 109,A01,091882,Touri; Behrouz,48,0,70,22
1650045241738,ECE 180,A00,083140,Abi Samra; Nicholas Camill,25,0,30,5
1650045241738,ECE 180,B00,083141,Abi Samra; Nicholas Camill,9,0,30,21
1650045247767,MATH 10A,A01,083735,Patchell; Gregory David,13,0,30,17
1650045247767,MATH 10A,A02,083736,Patchell; Gregory David,28,0,30,2
1650045247767,MATH 10A,A03,083737,Patchell; Gregory David,27,0,30,3
1650045253794,MATH 10B,A01,083207,Staff,0,5,30,30
1650045253794,MATH 10B,A02,083208,Staff,0,1,30,30
1650045253794,MATH 10B,B01,083739,Staff,20,0,30,10
1650045253794,MATH 10B,B02,083740,Staff,30,0,30,0
1650045259819,MATH 18,A01,083743,Staff,10,0,30,20
1650045259819,MATH 18,A02,083744,Staff,28,0,30,2
1650045259819,MATH 18,A03,083745,Staff,23,0,30,7
1650045259819,MATH 18,A04,083746,Staff,27,0,30,3
1650045259819,MATH 18,B01,083748,Staff,0,8,30,30
1650045259819,MATH 18,B02,083749,Staff,0,6,30,30
1650045259819,MATH 18,B03,083750,Staff,0,6,30,30
1650045259819,MATH 18,B04,083751,Staff,1,7,30,29
1650045265954,MATH 20A,A01,083754,Staff,27,0,40,13
1650045271982,MATH 20B,A01,083756,Staff,0,6,30,30
1650045271982,MATH 20B,A02,083757,Staff,1,0,30,29
1650045278018,MATH 20C,A01,083760,Staff,0,9,30,30
1650045278018,MATH 20C,A02,083761,Staff,0,12,30,30
1650045278018,MATH 20C,B01,083762,Staff,16,0,30,14
1650045278018,MATH 20C,B02,083763,Staff,28,0,30,2
1650045284042,MATH 20D,A01,083765,Staff,0,2,30,30
1650045284042,MATH 20D,A02,083766,Staff,15,0,30,15
1650045284042,MATH 20D,A03,083767,Staff,28,0,30,2
1650045290069,MATH 20E,A01,083771,Staff,10,0,30,20
1650045290069,MATH 20E,A02,083772,Staff,20,0,30,10
1650045290069,MATH 20E,B01,083773,Staff,1,1,30,29
1650045290069,MATH 20E,B02,083774,Staff,17,0,30,13
1650045296097,MATH 103A,A01,083777,Staff,0,6,30,30
1650045296097,MATH 103A,A02,083778,Staff,0,7,30,30
1650045296097,MATH 103A,B01,083779,Staff,0,8,30,30
1650045296097,MATH 103A,B02,083780,Staff,0,6,30,30
1650045302126,MATH 105,A01,085443,Staff,0,11,30,30
1650045308149,MATH 109,A01,083213,Anzaldo; Leesa B,0,3,30,30
1650045308149,MATH 109,A02,083214,Anzaldo; Leesa B,0,4,30,30
1650045308149,MATH 109,B01,083215,Anzaldo; Leesa B,0,2,30,30
1650045308149,MATH 109,B02,083216,Anzaldo; Leesa B,0,2,30,30
1650045314174,MATH 142A,A01,083219,Chow; Bennett,0,7,30,30
1650045314174,MATH 142A,A02,083220,Chow; Bennett,0,7,30,30
1650045314174,MATH 142A,B01,083221,Chow; Bennett,0,9,30,30
1650045314174,MATH 142A,B02,083222,Chow; Bennett,0,7,30,30
1650045320201,MATH 193A,A01,083224,Staff,0,5,30,30
1650045320201,MATH 193A,A02,083225,Staff,0,4,30,30
1650045320201,MATH 193A,A03,083781,Staff,0,0,30,30
1650045320201,MATH 193A,A04,083782,Staff,9,0,30,21
1650045326227,MATH 197,001,091859,McAuley; Julian John,9999,0,9999,0
1650045332285,COGS 9,A01,083615,Staff,2,15,60,58
1650045338311,COGS 11,A01,083617,Boyle; Mary E. T.,25,0,40,15
1650045344347,COGS 13,A01,083071,Staff,0,28,40,40
1650045350374,COGS 14A,A01,092681,Staff,0,7,100,100
1650045356401,COGS 14B,A01,083073,Cheng; Tzu-Han,0,3,50,50
1650045362426,COGS 17,A01,092677,Staff,35,0,75,40
1650045368453,COGS 100,A01,083619,Staff,0,17,60,60
1650045374475,COGS 101A,A01,083621,Davis; Joshua Daniel,0,16,60,60
1650045380504,COGS 101B,A01,091572,Staff,16,0,60,44
1650045386527,COGS 101C,A01,083625,Delgado; Tania,21,0,30,9
1650045392561,COGS 107A,A01,083627,Boyle; Mary E. T.,1,2,60,59
1650045398588,COGS 118A,A01,083075,Staff,19,0,60,41
1650045404611,CSE 3,A50,083646,Miranda; Gregory Joseph,21,0,38,17
1650045404611,CSE 3,A51,083647,Miranda; Gregory Joseph,37,0,37,0
1650045410638,CSE 8A,A50,083650,Miranda; Gregory Joseph,0,15,40,40
1650045416664,CSE 11,A01,083080,Cao; Yingjun,0,60,40,40
1650045422690,CSE 12,A01,083652,Staff,1,0,100,99
1650045428713,CSE 15L,A01,083654,Staff,0,0,50,50
1650045428713,CSE 15L,A02,083655,Staff,13,0,50,37
1650045434736,CSE 20,A01,083657,Staff,58,0,80,22
1650045440763,CSE 30,A01,083084,Eldon; John,0,63,40,40
1650045446789,CSE 100,A01,083659,Cao; Yingjun,0,57,50,50
1650045452812,CSE 134B,A01,083661,Powell; Thomas Allan,0,25,65,65
1650045458845,CSE 140,A01,083663,Staff,8,0,75,67
1650045464869,CSE 140L,A01,083088,Eldon; John,3,0,75,72
1650045470911,CSE 175,A01,083665,Kumar; Rakesh,9,0,25,16
1650045476934,CSE 190,A00,092507,Dubnov; Shlomo,15,0,20,5
1650045482967,ECE 45,A01,083139,Staff,0,10,40,40
1650045489001,ECE 65,A50,083695,Staff,0,1,30,30
1650045495036,ECE 109,A01,091882,Touri; Behrouz,48,0,70,22
1650045501071,ECE 180,A00,083140,Abi Samra; Nicholas Camill,25,0,30,5
1650045501071,ECE 180,B00,083141,Abi Samra; Nicholas Camill,9,0,30,21
1650045507109,MATH 10A,A01,083735,Patchell; Gregory David,13,0,30,17
1650045507109,MATH 10A,A02,083736,Patchell; Gregory David,28,0,30,2
1650045507109,MATH 10A,A03,083737,Patchell; Gregory David,27,0,30,3
1650045513133,MATH 10B,A01,083207,Staff,0,5,30,30
1650045513133,MATH 10B,A02,083208,Staff,0,1,30,30
1650045513133,MATH 10B,B01,083739,Staff,20,0,30,10
1650045513133,MATH 10B,B02,083740,Staff,30,0,30,0
1650045519166,MATH 18,A01,083743,Staff,10,0,30,20
1650045519166,MATH 18,A02,083744,Staff,28,0,30,2
1650045519166,MATH 18,A03,083745,Staff,23,0,30,7
1650045519166,MATH 18,A04,083746,Staff,27,0,30,3
1650045519166,MATH 18,B01,083748,Staff,0,8,30,30
1650045519166,MATH 18,B02,083749,Staff,0,6,30,30
1650045519166,MATH 18,B03,083750,Staff,0,6,30,30
1650045519166,MATH 18,B04,083751,Staff,1,7,30,29
1650045525190,MATH 20A,A01,083754,Staff,27,0,40,13
1650045531213,MATH 20B,A01,083756,Staff,0,6,30,30
1650045531213,MATH 20B,A02,083757,Staff,1,0,30,29
1650045537240,MATH 20C,A01,083760,Staff,0,9,30,30
1650045537240,MATH 20C,A02,083761,Staff,0,12,30,30
1650045537240,MATH 20C,B01,083762,Staff,16,0,30,14
1650045537240,MATH 20C,B02,083763,Staff,28,0,30,2
1650045543264,MATH 20D,A01,083765,Staff,0,2,30,30
1650045543264,MATH 20D,A02,083766,Staff,15,0,30,15
1650045543264,MATH 20D,A03,083767,Staff,28,0,30,2
1650045549291,MATH 20E,A01,083771,Staff,10,0,30,20
1650045549291,MATH 20E,A02,083772,Staff,20,0,30,10
1650045549291,MATH 20E,B01,083773,Staff,1,1,30,29
1650045549291,MATH 20E,B02,083774,Staff,17,0,30,13
1650045555317,MATH 103A,A01,083777,Staff,0,6,30,30
1650045555317,MATH 103A,A02,083778,Staff,0,7,30,30
1650045555317,MATH 103A,B01,083779,Staff,0,8,30,30
1650045555317,MATH 103A,B02,083780,Staff,0,6,30,30
1650045561351,MATH 105,A01,085443,Staff,0,11,30,30
1650045567383,MATH 109,A01,083213,Anzaldo; Leesa B,0,3,30,30
1650045567383,MATH 109,A02,083214,Anzaldo; Leesa B,0,4,30,30
1650045567383,MATH 109,B01,083215,Anzaldo; Leesa B,0,2,30,30
1650045567383,MATH 109,B02,083216,Anzaldo; Leesa B,0,2,30,30
1650045573410,MATH 142A,A01,083219,Chow; Bennett,0,7,30,30
1650045573410,MATH 142A,A02,083220,Chow; Bennett,0,7,30,30
1650045573410,MATH 142A,B01,083221,Chow; Bennett,0,9,30,30
1650045573410,MATH 142A,B02,083222,Chow; Bennett,0,7,30,30
1650045579434,MATH 193A,A01,083224,Staff,0,5,30,30
1650045579434,MATH 193A,A02,083225,Staff,0,4,30,30
1650045579434,MATH 193A,A03,083781,Staff,0,0,30,30
1650045579434,MATH 193A,A04,083782,Staff,9,0,30,21
1650045585457,MATH 197,001,091859,McAuley; Julian John,9999,0,9999,0
1650045591520,COGS 9,A01,083615,Staff,2,15,60,58
1650045597544,COGS 11,A01,083617,Boyle; Mary E. T.,25,0,40,15
1650045603570,COGS 13,A01,083071,Staff,0,28,40,40
1650045609606,COGS 14A,A01,092681,Staff,0,7,100,100
1650045615630,COGS 14B,A01,083073,Cheng; Tzu-Han,0,3,50,50
1650045621657,COGS 17,A01,092677,Staff,35,0,75,40
1650045627683,COGS 100,A01,083619,Staff,0,17,60,60
1650045633718,COGS 101A,A01,083621,Davis; Joshua Daniel,0,16,60,60
1650045639746,COGS 101B,A01,091572,Staff,16,0,60,44
1650045645778,COGS 101C,A01,083625,Delgado; Tania,21,0,30,9
1650045651806,COGS 107A,A01,083627,Boyle; Mary E. T.,1,2,60,59
1650045657846,COGS 118A,A01,083075,Staff,19,0,60,41
1650045663869,CSE 3,A50,083646,Miranda; Gregory Joseph,21,0,38,17
1650045663869,CSE 3,A51,083647,Miranda; Gregory Joseph,37,0,37,0
1650045669912,CSE 8A,A50,083650,Miranda; Gregory Joseph,0,15,40,40
1650045675938,CSE 11,A01,083080,Cao; Yingjun,0,60,40,40
1650045681970,CSE 12,A01,083652,Staff,1,0,100,99
1650045688003,CSE 15L,A01,083654,Staff,0,0,50,50
1650045688003,CSE 15L,A02,083655,Staff,13,0,50,37
1650045694032,CSE 20,A01,083657,Staff,58,0,80,22
1650045700073,CSE 30,A01,083084,Eldon; John,0,63,40,40
1650045706103,CSE 100,A01,083659,Cao; Yingjun,0,57,50,50
1650045712125,CSE 134B,A01,083661,Powell; Thomas Allan,1,25,65,64
1650045718158,CSE 140,A01,083663,Staff,8,0,75,67
1650045724182,CSE 140L,A01,083088,Eldon; John,3,0,75,72
1650045730205,CSE 175,A01,083665,Kumar; Rakesh,9,0,25,16
1650045736228,CSE 190,A00,092507,Dubnov; Shlomo,14,0,20,6
1650045742279,ECE 45,A01,083139,Staff,0,10,40,40
1650045748300,ECE 65,A50,083695,Staff,0,1,30,30
1650045754324,ECE 109,A01,091882,Touri; Behrouz,48,0,70,22
1650045760347,ECE 180,A00,083140,Abi Samra; Nicholas Camill,25,0,30,5
1650045760347,ECE 180,B00,083141,Abi Samra; Nicholas Camill,9,0,30,21
1650045766377,MATH 10A,A01,083735,Patchell; Gregory David,13,0,30,17
1650045766377,MATH 10A,A02,083736,Patchell; Gregory David,28,0,30,2
1650045766377,MATH 10A,A03,083737,Patchell; Gregory David,27,0,30,3
1650045772415,MATH 10B,A01,083207,Staff,0,5,30,30
1650045772415,MATH 10B,A02,083208,Staff,0,1,30,30
1650045772415,MATH 10B,B01,083739,Staff,20,0,30,10
1650045772415,MATH 10B,B02,083740,Staff,30,0,30,0
1650045778446,MATH 18,A01,083743,Staff,10,0,30,20
1650045778446,MATH 18,A02,083744,Staff,28,0,30,2
1650045778446,MATH 18,A03,083745,Staff,23,0,30,7
1650045778446,MATH 18,A04,083746,Staff,27,0,30,3
1650045778446,MATH 18,B01,083748,Staff,0,8,30,30
1650045778446,MATH 18,B02,083749,Staff,0,6,30,30
1650045778446,MATH 18,B03,083750,Staff,0,6,30,30
1650045778446,MATH 18,B04,083751,Staff,1,7,30,29
1650045784469,MATH 20A,A01,083754,Staff,26,0,40,14
1650045790506,MATH 20B,A01,083756,Staff,0,6,30,30
1650045790506,MATH 20B,A02,083757,Staff,1,0,30,29
1650045796532,MATH 20C,A01,083760,Staff,0,9,30,30
1650045796532,MATH 20C,A02,083761,Staff,0,12,30,30
1650045796532,MATH 20C,B01,083762,Staff,16,0,30,14
1650045796532,MATH 20C,B02,083763,Staff,28,0,30,2
1650045802559,MATH 20D,A01,083765,Staff,0,2,30,30
1650045802559,MATH 20D,A02,083766,Staff,15,0,30,15
1650045802559,MATH 20D,A03,083767,Staff,28,0,30,2
1650045808583,MATH 20E,A01,083771,Staff,10,0,30,20
1650045808583,MATH 20E,A02,083772,Staff,20,0,30,10
1650045808583,MATH 20E,B01,083773,Staff,1,1,30,29
1650045808583,MATH 20E,B02,083774,Staff,17,0,30,13
1650045814616,MATH 103A,A01,083777,Staff,0,6,30,30
1650045814616,MATH 103A,A02,083778,Staff,0,7,30,30
1650045814616,MATH 103A,B01,083779,Staff,0,8,30,30
1650045814616,MATH 103A,B02,083780,Staff,0,6,30,30
1650045820660,MATH 105,A01,085443,Staff,0,11,30,30
1650045826682,MATH 109,A01,083213,Anzaldo; Leesa B,0,3,30,30
1650045826682,MATH 109,A02,083214,Anzaldo; Leesa B,0,4,30,30
1650045826682,MATH 109,B01,083215,Anzaldo; Leesa B,0,2,30,30
1650045826682,MATH 109,B02,083216,Anzaldo; Leesa B,1,2,30,29
1650045832712,MATH 142A,A01,083219,Chow; Bennett,0,7,30,30
1650045832712,MATH 142A,A02,083220,Chow; Bennett,0,7,30,30
1650045832712,MATH 142A,B01,083221,Chow; Bennett,0,9,30,30
1650045832712,MATH 142A,B02,083222,Chow; Bennett,0,7,30,30
1650045838735,MATH 193A,A01,083224,Staff,0,5,30,30
1650045838735,MATH 193A,A02,083225,Staff,0,4,30,30
1650045838735,MATH 193A,A03,083781,Staff,0,0,30,30
1650045838735,MATH 193A,A04,083782,Staff,9,0,30,21
1650045844757,MATH 197,001,091859,McAuley; Julian John,9999,0,9999,0
1650045850806,COGS 9,A01,083615,Staff,2,15,60,58
1650045856919,COGS 11,A01,083617,Boyle; Mary E. T.,25,0,40,15
1650045862945,COGS 13,A01,083071,Staff,0,28,40,40
1650045868977,COGS 14A,A01,092681,Staff,0,7,100,100
1650045875014,COGS 14B,A01,083073,Cheng; Tzu-Han,0,3,50,50
1650045881043,COGS 17,A01,092677,Staff,35,0,75,40
1650045887065,COGS 100,A01,083619,Staff,0,17,60,60
1650045893088,COGS 101A,A01,083621,Davis; Joshua Daniel,0,16,60,60
1650045899121,COGS 101B,A01,091572,Staff,16,0,60,44
1650045905152,COGS 101C,A01,083625,Delgado; Tania,21,0,30,9
1650045911184,COGS 107A,A01,083627,Boyle; Mary E. T.,1,2,60,59
1650045917208,COGS 118A,A01,083075,Staff,19,0,60,41
1650045923231,CSE 3,A50,083646,Miranda; Gregory Joseph,21,0,38,17
1650045923231,CSE 3,A51,083647,Miranda; Gregory Joseph,37,0,37,0
1650045929254,CSE 8A,A50,083650,Miranda; Gregory Joseph,0,15,40,40
1650045935274,CSE 11,A01,083080,Cao; Yingjun,0,60,40,40
1650045941307,CSE 12,A01,083652,Staff,1,0,100,99
1650045947328,CSE 15L,A01,083654,Staff,0,0,50,50
1650045947328,CSE 15L,A02,083655,Staff,13,0,50,37
1650045953350,CSE 20,A01,083657,Staff,58,0,80,22
1650045959373,CSE 30,A01,083084,Eldon; John,0,63,40,40
1650045965407,CSE 100,A01,083659,Cao; Yingjun,0,57,50,50
1650045971435,CSE 134B,A01,083661,Powell; Thomas Allan,1,26,65,64
1650045977459,CSE 140,A01,083663,Staff,8,0,75,67
1650045983485,CSE 140L,A01,083088,Eldon; John,3,0,75,72
1650045989510,CSE 175,A01,083665,Kumar; Rakesh,9,0,25,16
1650045995533,CSE 190,A00,092507,Dubnov; Shlomo,14,0,20,6
1650046001564,ECE 45,A01,083139,Staff,0,11,40,40
1650046007597,ECE 65,A50,083695,Staff,0,2,30,30
1650046013630,ECE 109,A01,091882,Touri; Behrouz,48,0,70,22
1650046019653,ECE 180,A00,083140,Abi Samra; Nicholas Camill,25,0,30,5
1650046019653,ECE 180,B00,083141,Abi Samra; Nicholas Camill,9,0,30,21
1650046025689,MATH 10A,A01,083735,Patchell; Gregory David,13,0,30,17
1650046025689,MATH 10A,A02,083736,Patchell; Gregory David,28,0,30,2
1650046025689,MATH 10A,A03,083737,Patchell; Gregory David,27,0,30,3
1650046031713,MATH 10B,A01,083207,Staff,0,5,30,30
1650046031713,MATH 10B,A02,083208,Staff,0,1,30,30
1650046031713,MATH 10B,B01,083739,Staff,20,0,30,10
1650046031713,MATH 10B,B02,083740,Staff,30,0,30,0
1650046037739,MATH 18,A01,083743,Staff,10,0,30,20
1650046037739,MATH 18,A02,083744,Staff,28,0,30,2
1650046037739,MATH 18,A03,083745,Staff,23,0,30,7
1650046037739,MATH 18,A04,083746,Staff,27,0,30,3
1650046037739,MATH 18,B01,083748,Staff,0,8,30,30
1650046037739,MATH 18,B02,083749,Staff,0,6,30,30
1650046037739,MATH 18,B03,083750,Staff,0,6,30,30
1650046037739,MATH 18,B04,083751,Staff,1,7,30,29
1650046043778,MATH 20A,A01,083754,Staff,26,0,40,14
1650046049804,MATH 20B,A01,083756,Staff,0,6,30,30
1650046049804,MATH 20B,A02,083757,Staff,1,0,30,29
1650046055831,MATH 20C,A01,083760,Staff,0,9,30,30
1650046055831,MATH 20C,A02,083761,Staff,0,12,30,30
1650046055831,MATH 20C,B01,083762,Staff,16,0,30,14
1650046055831,MATH 20C,B02,083763,Staff,28,0,30,2
1650046061855,MATH 20D,A01,083765,Staff,0,2,30,30
1650046061855,MATH 20D,A02,083766,Staff,15,0,30,15
1650046061855,MATH 20D,A03,083767,Staff,28,0,30,2
1650046067885,MATH 20E,A01,083771,Staff,10,0,30,20
1650046067885,MATH 20E,A02,083772,Staff,20,0,30,10
1650046067885,MATH 20E,B01,083773,Staff,1,1,30,29
1650046067885,MATH 20E,B02,083774,Staff,17,0,30,13
1650046073919,MATH 103A,A01,083777,Staff,0,6,30,30
1650046073919,MATH 103A,A02,083778,Staff,0,7,30,30
1650046073919,MATH 103A,B01,083779,Staff,0,8,30,30
1650046073919,MATH 103A,B02,083780,Staff,0,6,30,30
1650046079942,MATH 105,A01,085443,Staff,0,11,30,30
1650046085968,MATH 109,A01,083213,Anzaldo; Leesa B,0,3,30,30
1650046085968,MATH 109,A02,083214,Anzaldo; Leesa B,0,4,30,30
1650046085968,MATH 109,B01,083215,Anzaldo; Leesa B,0,2,30,30
1650046085968,MATH 109,B02,083216,Anzaldo; Leesa B,1,2,30,29
1650046091990,MATH 142A,A01,083219,Chow; Bennett,0,7,30,30
1650046091990,MATH 142A,A02,083220,Chow; Bennett,0,7,30,30
1650046091990,MATH 142A,B01,083221,Chow; Bennett,0,9,30,30
1650046091990,MATH 142A,B02,083222,Chow; Bennett,0,7,30,30
1650046098012,MATH 193A,A01,083224,Staff,0,5,30,30
1650046098012,MATH 193A,A02,083225,Staff,0,4,30,30
1650046098012,MATH 193A,A03,083781,Staff,0,0,30,30
1650046098012,MATH 193A,A04,083782,Staff,9,0,30,21
1650046104046,MATH 197,001,091859,McAuley; Julian John,9999,0,9999,0
1650046110094,COGS 9,A01,083615,Staff,2,15,60,58
1650046116132,COGS 11,A01,083617,Boyle; Mary E. T.,25,0,40,15
1650046122157,COGS 13,A01,083071,Staff,0,28,40,40
1650046128179,COGS 14A,A01,092681,Staff,0,7,100,100
1650046134214,COGS 14B,A01,083073,Cheng; Tzu-Han,0,3,50,50
1650046140236,COGS 17,A01,092677,Staff,35,0,75,40
1650046146260,COGS 100,A01,083619,Staff,0,17,60,60
1650046152282,COGS 101A,A01,083621,Davis; Joshua Daniel,0,16,60,60
1650046158307,COGS 101B,A01,091572,Staff,16,0,60,44
1650046164344,COGS 101C,A01,083625,Delgado; Tania,21,0,30,9
1650046170374,COGS 107A,A01,083627,Boyle; Mary E. T.,1,2,60,59
1650046176407,COGS 118A,A01,083075,Staff,19,0,60,41
1650046182436,CSE 3,A50,083646,Miranda; Gregory Joseph,21,0,38,17
1650046182436,CSE 3,A51,083647,Miranda; Gregory Joseph,37,0,37,0
1650046188460,CSE 8A,A50,083650,Miranda; Gregory Joseph,0,15,40,40
1650046194483,CSE 11,A01,083080,Cao; Yingjun,0,60,40,40
1650046200526,CSE 12,A01,083652,Staff,1,0,100,99
1650046206549,CSE 15L,A01,083654,Staff,0,0,50,50
1650046206549,CSE 15L,A02,083655,Staff,12,0,50,38
1650046212573,CSE 20,A01,083657,Staff,58,0,80,22
1650046218609,CSE 30,A01,083084,Eldon; John,0,63,40,40
1650046224630,CSE 100,A01,083659,Cao; Yingjun,0,57,50,50
1650046230657,CSE 134B,A01,083661,Powell; Thomas Allan,1,26,65,64
1650046236684,CSE 140,A01,083663,Staff,8,0,75,67
1650046242717,CSE 140L,A01,083088,Eldon; John,3,0,75,72
1650046248739,CSE 175,A01,083665,Kumar; Rakesh,9,0,25,16
1650046254764,CSE 190,A00,092507,Dubnov; Shlomo,14,0,20,6
1650046260787,ECE 45,A01,083139,Staff,0,11,40,40
1650046266811,ECE 65,A50,083695,Staff,0,2,30,30
1650046272844,ECE 109,A01,091882,Touri; Behrouz,48,0,70,22
1650046278867,ECE 180,A00,083140,Abi Samra; Nicholas Camill,25,0,30,5
1650046278867,ECE 180,B00,083141,Abi Samra; Nicholas Camill,9,0,30,21
1650046284891,MATH 10A,A01,083735,Patchell; Gregory David,13,0,30,17
1650046284891,MATH 10A,A02,083736,Patchell; Gregory David,28,0,30,2
1650046284891,MATH 10A,A03,083737,Patchell; Gregory David,27,0,30,3
1650046290922,MATH 10B,A01,083207,Staff,0,5,30,30
1650046290922,MATH 10B,A02,083208,Staff,0,1,30,30
1650046290922,MATH 10B,B01,083739,Staff,20,0,30,10
1650046290922,MATH 10B,B02,083740,Staff,30,0,30,0
1650046296947,MATH 18,A01,083743,Staff,10,0,30,20
1650046296947,MATH 18,A02,083744,Staff,28,0,30,2
1650046296947,MATH 18,A03,083745,Staff,23,0,30,7
1650046296947,MATH 18,A04,083746,Staff,27,0,30,3
1650046296947,MATH 18,B01,083748,Staff,0,8,30,30
1650046296947,MATH 18,B02,083749,Staff,0,6,30,30
1650046296947,MATH 18,B03,083750,Staff,0,6,30,30
1650046296947,MATH 18,B04,083751,Staff,1,7,30,29
1650046302973,MATH 20A,A01,083754,Staff,26,0,40,14
1650046308996,MATH 20B,A01,083756,Staff,0,6,30,30
1650046308996,MATH 20B,A02,083757,Staff,1,0,30,29
1650046315026,MATH 20C,A01,083760,Staff,0,9,30,30
1650046315026,MATH 20C,A02,083761,Staff,0,12,30,30
1650046315026,MATH 20C,B01,083762,Staff,16,0,30,14
1650046315026,MATH 20C,B02,083763,Staff,28,0,30,2
1650046321064,MATH 20D,A01,083765,Staff,0,2,30,30
1650046321064,MATH 20D,A02,083766,Staff,15,0,30,15
1650046321064,MATH 20D,A03,083767,Staff,28,0,30,2
1650046327089,MATH 20E,A01,083771,Staff,10,0,30,20
1650046327089,MATH 20E,A02,083772,Staff,20,0,30,10
1650046327089,MATH 20E,B01,083773,Staff,1,1,30,29
1650046327089,MATH 20E,B02,083774,Staff,17,0,30,13
1650046333114,MATH 103A,A01,083777,Staff,0,6,30,30
1650046333114,MATH 103A,A02,083778,Staff,0,7,30,30
1650046333114,MATH 103A,B01,083779,Staff,0,8,30,30
1650046333114,MATH 103A,B02,083780,Staff,0,6,30,30
1650046339136,MATH 105,A01,085443,Staff,0,11,30,30
1650046345158,MATH 109,A01,083213,Anzaldo; Leesa B,0,3,30,30
1650046345158,MATH 109,A02,083214,Anzaldo; Leesa B,0,4,30,30
1650046345158,MATH 109,B01,083215,Anzaldo; Leesa B,0,2,30,30
1650046345158,MATH 109,B02,083216,Anzaldo; Leesa B,1,2,30,29
1650046351199,MATH 142A,A01,083219,Chow; Bennett,0,7,30,30
1650046351199,MATH 142A,A02,083220,Chow; Bennett,0,7,30,30
1650046351199,MATH 142A,B01,083221,Chow; Bennett,0,9,30,30
1650046351199,MATH 142A,B02,083222,Chow; Bennett,0,7,30,30
1650046357224,MATH 193A,A01,083224,Staff,0,5,30,30
1650046357224,MATH 193A,A02,083225,Staff,0,4,30,30
1650046357224,MATH 193A,A03,083781,Staff,0,0,30,30
1650046357224,MATH 193A,A04,083782,Staff,9,0,30,21
1650046363251,MATH 197,001,091859,McAuley; Julian John,9999,0,9999,0
1650046369300,COGS 9,A01,083615,Staff,2,16,60,58
1650046375329,COGS 11,A01,083617,Boyle; Mary E. T.,25,0,40,15
1650046381354,COGS 13,A01,083071,Staff,0,28,40,40
1650046387383,COGS 14A,A01,092681,Staff,0,7,100,100
1650046393406,COGS 14B,A01,083073,Cheng; Tzu-Han,0,3,50,50
1650046399435,COGS 17,A01,092677,Staff,35,0,75,40
1650046405458,COGS 100,A01,083619,Staff,0,17,60,60
1650046411487,COGS 101A,A01,083621,Davis; Joshua Daniel,0,16,60,60
1650046417514,COGS 101B,A01,091572,Staff,16,0,60,44
1650046423538,COGS 101C,A01,083625,Delgado; Tania,21,0,30,9
1650046429574,COGS 107A,A01,083627,Boyle; Mary E. T.,1,2,60,59
1650046435604,COGS 118A,A01,083075,Staff,19,0,60,41
1650046441636,CSE 3,A50,083646,Miranda; Gregory Joseph,22,0,38,16
1650046441636,CSE 3,A51,083647,Miranda; Gregory Joseph,37,0,37,0
1650046447677,CSE 8A,A50,083650,Miranda; Gregory Joseph,0,15,40,40
1650046453796,CSE 11,A01,083080,Cao; Yingjun,0,60,40,40
1650046459820,CSE 12,A01,083652,Staff,1,0,100,99
1650046465846,CSE 15L,A01,083654,Staff,0,0,50,50
1650046465846,CSE 15L,A02,083655,Staff,12,0,50,38
1650046471870,CSE 20,A01,083657,Staff,58,0,80,22
1650046477895,CSE 30,A01,083084,Eldon; John,0,63,40,40
1650046483917,CSE 100,A01,083659,Cao; Yingjun,0,57,50,50
1650046489941,CSE 134B,A01,083661,Powell; Thomas Allan,1,26,65,64
1650046495970,CSE 140,A01,083663,Staff,8,0,75,67
1650046501993,CSE 140L,A01,083088,Eldon; John,3,0,75,72
1650046508023,CSE 175,A01,083665,Kumar; Rakesh,9,0,25,16
1650046514048,CSE 190,A00,092507,Dubnov; Shlomo,14,0,20,6
1650046520075,ECE 45,A01,083139,Staff,0,11,40,40
1650046526105,ECE 65,A50,083695,Staff,0,2,30,30
1650046532129,ECE 109,A01,091882,Touri; Behrouz,48,0,70,22
1650046538151,ECE 180,A00,083140,Abi Samra; Nicholas Camill,25,0,30,5
1650046538151,ECE 180,B00,083141,Abi Samra; Nicholas Camill,9,0,30,21
1650046544182,MATH 10A,A01,083735,Patchell; Gregory David,13,0,30,17
1650046544182,MATH 10A,A02,083736,Patchell; Gregory David,28,0,30,2
1650046544182,MATH 10A,A03,083737,Patchell; Gregory David,27,0,30,3
1650046550203,MATH 10B,A01,083207,Staff,0,5,30,30
1650046550203,MATH 10B,A02,083208,Staff,0,1,30,30
1650046550203,MATH 10B,B01,083739,Staff,20,0,30,10
1650046550203,MATH 10B,B02,083740,Staff,30,0,30,0
1650046556241,MATH 18,A01,083743,Staff,10,0,30,20
1650046556241,MATH 18,A02,083744,Staff,28,0,30,2
1650046556241,MATH 18,A03,083745,Staff,23,0,30,7
1650046556241,MATH 18,A04,083746,Staff,27,0,30,3
1650046556241,MATH 18,B01,083748,Staff,0,8,30,30
1650046556241,MATH 18,B02,083749,Staff,0,6,30,30
1650046556241,MATH 18,B03,083750,Staff,0,6,30,30
1650046556241,MATH 18,B04,083751,Staff,1,7,30,29
1650046562264,MATH 20A,A01,083754,Staff,26,0,40,14
1650046568287,MATH 20B,A01,083756,Staff,0,6,30,30
1650046568287,MATH 20B,A02,083757,Staff,1,0,30,29
1650046574312,MATH 20C,A01,083760,Staff,0,9,30,30
1650046574312,MATH 20C,A02,083761,Staff,0,12,30,30
1650046574312,MATH 20C,B01,083762,Staff,16,0,30,14
1650046574312,MATH 20C,B02,083763,Staff,28,0,30,2
1650046580337,MATH 20D,A01,083765,Staff,0,2,30,30
1650046580337,MATH 20D,A02,083766,Staff,15,0,30,15
1650046580337,MATH 20D,A03,083767,Staff,28,0,30,2
1650046586374,MATH 20E,A01,083771,Staff,10,0,30,20
1650046586374,MATH 20E,A02,083772,Staff,20,0,30,10
1650046586374,MATH 20E,B01,083773,Staff,1,1,30,29
1650046586374,MATH 20E,B02,083774,Staff,17,0,30,13
1650046592397,MATH 103A,A01,083777,Staff,0,6,30,30
1650046592397,MATH 103A,A02,083778,Staff,0,7,30,30
1650046592397,MATH 103A,B01,083779,Staff,0,8,30,30
1650046592397,MATH 103A,B02,083780,Staff,0,6,30,30
1650046598423,MATH 105,A01,085443,Staff,0,11,30,30
1650046604447,MATH 109,A01,083213,Anzaldo; Leesa B,0,3,30,30
1650046604447,MATH 109,A02,083214,Anzaldo; Leesa B,0,4,30,30
1650046604447,MATH 109,B01,083215,Anzaldo; Leesa B,0,2,30,30
1650046604447,MATH 109,B02,083216,Anzaldo; Leesa B,1,2,30,29
1650046610475,MATH 142A,A01,083219,Chow; Bennett,0,7,30,30
1650046610475,MATH 142A,A02,083220,Chow; Bennett,0,7,30,30
1650046610475,MATH 142A,B01,083221,Chow; Bennett,0,9,30,30
1650046610475,MATH 142A,B02,083222,Chow; Bennett,0,7,30,30
1650046616506,MATH 193A,A01,083224,Staff,0,5,30,30
1650046616506,MATH 193A,A02,083225,Staff,0,4,30,30
1650046616506,MATH 193A,A03,083781,Staff,0,0,30,30
1650046616506,MATH 193A,A04,083782,Staff,9,0,30,21
1650046622535,MATH 197,001,091859,McAuley; Julian John,9999,0,9999,0
1650046628600,COGS 9,A01,083615,Staff,2,16,60,58
1650046634624,COGS 11,A01,083617,Boyle; Mary E. T.,25,0,40,15
1650046640646,COGS 13,A01,083071,Staff,0,28,40,40
1650046646672,COGS 14A,A01,092681,Staff,0,6,100,100
1650046652701,COGS 14B,A01,083073,Cheng; Tzu-Han,0,3,50,50
1650046658726,COGS 17,A01,092677,Staff,36,0,75,39
1650046664757,COGS 100,A01,083619,Staff,0,17,60,60
1650046670783,COGS 101A,A01,083621,Davis; Joshua Daniel,0,16,60,60
1650046676810,COGS 101B,A01,091572,Staff,15,0,60,45
1650046682832,COGS 101C,A01,083625,Delgado; Tania,21,0,30,9
1650046688857,COGS 107A,A01,083627,Boyle; Mary E. T.,1,2,60,59
1650046694883,COGS 118A,A01,083075,Staff,19,0,60,41
1650046700911,CSE 3,A50,083646,Miranda; Gregory Joseph,22,0,38,16
1650046700911,CSE 3,A51,083647,Miranda; Gregory Joseph,37,0,37,0
1650046706947,CSE 8A,A50,083650,Miranda; Gregory Joseph,0,15,40,40
1650046712987,CSE 11,A01,083080,Cao; Yingjun,0,60,40,40
1650046719010,CSE 12,A01,083652,Staff,1,0,100,99
1650046725035,CSE 15L,A01,083654,Staff,0,0,50,50
1650046725035,CSE 15L,A02,083655,Staff,12,0,50,38
1650046731062,CSE 20,A01,083657,Staff,58,0,80,22
1650046737084,CSE 30,A01,083084,Eldon; John,0,63,40,40
1650046743110,CSE 100,A01,083659,Cao; Yingjun,0,57,50,50
1650046749143,CSE 134B,A01,083661,Powell; Thomas Allan,1,26,65,64
1650046755170,CSE 140,A01,083663,Staff,8,0,75,67
1650046761208,CSE 140L,A01,083088,Eldon; John,3,0,75,72
1650046767231,CSE 175,A01,083665,Kumar; Rakesh,9,0,25,16
1650046773253,CSE 190,A00,092507,Dubnov; Shlomo,14,0,20,6
1650046779287,ECE 45,A01,083139,Staff,0,11,40,40
1650046785310,ECE 65,A50,083695,Staff,0,3,30,30
1650046791336,ECE 109,A01,091882,Touri; Behrouz,48,0,70,22
1650046797360,ECE 180,A00,083140,Abi Samra; Nicholas Camill,25,0,30,5
1650046797360,ECE 180,B00,083141,Abi Samra; Nicholas Camill,9,0,30,21
1650046803395,MATH 10A,A01,083735,Patchell; Gregory David,13,0,30,17
1650046803395,MATH 10A,A02,083736,Patchell; Gregory David,28,0,30,2
1650046803395,MATH 10A,A03,083737,Patchell; Gregory David,27,0,30,3
1650046809424,MATH 10B,A01,083207,Staff,0,5,30,30
1650046809424,MATH 10B,A02,083208,Staff,0,1,30,30
1650046809424,MATH 10B,B01,083739,Staff,20,0,30,10
1650046809424,MATH 10B,B02,083740,Staff,30,0,30,0
1650046815450,MATH 18,A01,083743,Staff,10,0,30,20
1650046815450,MATH 18,A02,083744,Staff,28,0,30,2
1650046815450,MATH 18,A03,083745,Staff,23,0,30,7
1650046815450,MATH 18,A04,083746,Staff,27,0,30,3
1650046815450,MATH 18,B01,083748,Staff,0,8,30,30
1650046815450,MATH 18,B02,083749,Staff,0,6,30,30
1650046815450,MATH 18,B03,083750,Staff,0,6,30,30
1650046815450,MATH 18,B04,083751,Staff,1,7,30,29
1650046821485,MATH 20A,A01,083754,Staff,26,0,40,14
1650046827507,MATH 20B,A01,083756,Staff,0,6,30,30
1650046827507,MATH 20B,A02,083757,Staff,1,0,30,29
1650046833529,MATH 20C,A01,083760,Staff,0,9,30,30
1650046833529,MATH 20C,A02,083761,Staff,0,12,30,30
1650046833529,MATH 20C,B01,083762,Staff,16,0,30,14
1650046833529,MATH 20C,B02,083763,Staff,28,0,30,2
1650046839563,MATH 20D,A01,083765,Staff,0,2,30,30
1650046839563,MATH 20D,A02,083766,Staff,15,0,30,15
1650046839563,MATH 20D,A03,083767,Staff,28,0,30,2
1650046845590,MATH 20E,A01,083771,Staff,10,0,30,20
1650046845590,MATH 20E,A02,083772,Staff,20,0,30,10
1650046845590,MATH 20E,B01,083773,Staff,1,1,30,29
1650046845590,MATH 20E,B02,083774,Staff,17,0,30,13
1650046851613,MATH 103A,A01,083777,Staff,0,6,30,30
1650046851613,MATH 103A,A02,083778,Staff,0,7,30,30
1650046851613,MATH 103A,B01,083779,Staff,0,8,30,30
1650046851613,MATH 103A,B02,083780,Staff,0,6,30,30
1650046857642,MATH 105,A01,085443,Staff,0,11,30,30
1650046863666,MATH 109,A01,083213,Anzaldo; Leesa B,0,3,30,30
1650046863666,MATH 109,A02,083214,Anzaldo; Leesa B,0,4,30,30
1650046863666,MATH 109,B01,083215,Anzaldo; Leesa B,0,2,30,30
1650046863666,MATH 109,B02,083216,Anzaldo; Leesa B,1,2,30,29
1650046869691,MATH 142A,A01,083219,Chow; Bennett,0,7,30,30
1650046869691,MATH 142A,A02,083220,Chow; Bennett,0,7,30,30
1650046869691,MATH 142A,B01,083221,Chow; Bennett,0,9,30,30
1650046869691,MATH 142A,B02,083222,Chow; Bennett,0,7,30,30
1650046875721,MATH 193A,A01,083224,Staff,0,5,30,30
1650046875721,MATH 193A,A02,083225,Staff,0,4,30,30
1650046875721,MATH 193A,A03,083781,Staff,0,0,30,30
1650046875721,MATH 193A,A04,083782,Staff,9,0,30,21
1650046881748,MATH 197,001,091859,McAuley; Julian John,9999,0,9999,0
1650046887803,COGS 9,A01,083615,Staff,2,16,60,58
1650046893826,COGS 11,A01,083617,Boyle; Mary E. T.,25,0,40,15
1650046899857,COGS 13,A01,083071,Staff,0,28,40,40
1650046905881,COGS 14A,A01,092681,Staff,0,6,100,100
1650046911904,COGS 14B,A01,083073,Cheng; Tzu-Han,0,3,50,50
1650046917925,COGS 17,A01,092677,Staff,36,0,75,39
1650046923952,COGS 100,A01,083619,Staff,0,17,60,60
1650046929975,COGS 101A,A01,083621,Davis; Joshua Daniel,0,16,60,60
1650046936016,COGS 101B,A01,091572,Staff,15,0,60,45
1650046942041,COGS 101C,A01,083625,Delgado; Tania,21,0,30,9
1650046948065,COGS 107A,A01,083627,Boyle; Mary E. T.,1,2,60,59
1650046954091,COGS 118A,A01,083075,Staff,19,0,60,41
1650046960125,CSE 3,A50,083646,Miranda; Gregory Joseph,22,0,38,16
1650046960125,CSE 3,A51,083647,Miranda; Gregory Joseph,37,0,37,0
1650046966156,CSE 8A,A50,083650,Miranda; Gregory Joseph,0,15,40,40
1650046972191,CSE 11,A01,083080,Cao; Yingjun,0,61,40,40
1650046978214,CSE 12,A01,083652,Staff,0,0,100,100
1650046984241,CSE 15L,A01,083654,Staff,0,0,50,50
1650046984241,CSE 15L,A02,083655,Staff,11,0,50,39
1650046990267,CSE 20,A01,083657,Staff,58,0,80,22
1650046996290,CSE 30,A01,083084,Eldon; John,0,63,40,40
1650047002317,CSE 100,A01,083659,Cao; Yingjun,0,57,50,50
1650047008343,CSE 134B,A01,083661,Powell; Thomas Allan,1,26,65,64
1650047014365,CSE 140,A01,083663,Staff,8,0,75,67
1650047020393,CSE 140L,A01,083088,Eldon; John,3,0,75,72
1650047026424,CSE 175,A01,083665,Kumar; Rakesh,9,0,25,16
1650047032454,CSE 190,A00,092507,Dubnov; Shlomo,14,0,20,6
1650047038488,ECE 45,A01,083139,Staff,0,11,40,40
1650047044526,ECE 65,A50,083695,Staff,0,3,30,30
1650047050642,ECE 109,A01,091882,Touri; Behrouz,48,0,70,22
1650047056669,ECE 180,A00,083140,Abi Samra; Nicholas Camill,25,0,30,5
1650047056669,ECE 180,B00,083141,Abi Samra; Nicholas Camill,9,0,30,21
1650047062707,MATH 10A,A01,083735,Patchell; Gregory David,13,0,30,17
1650047062707,MATH 10A,A02,083736,Patchell; Gregory David,28,0,30,2
1650047062707,MATH 10A,A03,083737,Patchell; Gregory David,27,0,30,3
1650047068731,MATH 10B,A01,083207,Staff,0,5,30,30
1650047068731,MATH 10B,A02,083208,Staff,0,1,30,30
1650047068731,MATH 10B,B01,083739,Staff,20,0,30,10
1650047068731,MATH 10B,B02,083740,Staff,30,0,30,0
1650047074757,MATH 18,A01,083743,Staff,10,0,30,20
1650047074757,MATH 18,A02,083744,Staff,28,0,30,2
1650047074757,MATH 18,A03,083745,Staff,23,0,30,7
1650047074757,MATH 18,A04,083746,Staff,27,0,30,3
1650047074757,MATH 18,B01,083748,Staff,0,8,30,30
1650047074757,MATH 18,B02,083749,Staff,0,6,30,30
1650047074757,MATH 18,B03,083750,Staff,0,6,30,30
1650047074757,MATH 18,B04,083751,Staff,1,7,30,29
1650047080781,MATH 20A,A01,083754,Staff,26,0,40,14
1650047086804,MATH 20B,A01,083756,Staff,0,6,30,30
1650047086804,MATH 20B,A02,083757,Staff,1,0,30,29
1650047092828,MATH 20C,A01,083760,Staff,0,9,30,30
1650047092828,MATH 20C,A02,083761,Staff,0,12,30,30
1650047092828,MATH 20C,B01,083762,Staff,16,0,30,14
1650047092828,MATH 20C,B02,083763,Staff,28,0,30,2
1650047098856,MATH 20D,A01,083765,Staff,0,2,30,30
1650047098856,MATH 20D,A02,083766,Staff,15,0,30,15
1650047098856,MATH 20D,A03,083767,Staff,28,0,30,2
1650047104879,MATH 20E,A01,083771,Staff,10,0,30,20
1650047104879,MATH 20E,A02,083772,Staff,20,0,30,10
1650047104879,MATH 20E,B01,083773,Staff,1,1,30,29
1650047104879,MATH 20E,B02,083774,Staff,17,0,30,13
1650047110906,MATH 103A,A01,083777,Staff,0,6,30,30
1650047110906,MATH 103A,A02,083778,Staff,0,7,30,30
1650047110906,MATH 103A,B01,083779,Staff,0,8,30,30
1650047110906,MATH 103A,B02,083780,Staff,0,6,30,30
1650047116938,MATH 105,A01,085443,Staff,0,11,30,30
1650047122966,MATH 109,A01,083213,Anzaldo; Leesa B,0,3,30,30
1650047122966,MATH 109,A02,083214,Anzaldo; Leesa B,0,4,30,30
1650047122966,MATH 109,B01,083215,Anzaldo; Leesa B,0,2,30,30
1650047122966,MATH 109,B02,083216,Anzaldo; Leesa B,1,2,30,29
1650047128995,MATH 142A,A01,083219,Chow; Bennett,0,7,30,30
1650047128995,MATH 142A,A02,083220,Chow; Bennett,0,7,30,30
1650047128995,MATH 142A,B01,083221,Chow; Bennett,0,9,30,30
1650047128995,MATH 142A,B02,083222,Chow; Bennett,0,7,30,30
1650047135017,MATH 193A,A01,083224,Staff,0,5,30,30
1650047135017,MATH 193A,A02,083225,Staff,0,4,30,30
1650047135017,MATH 193A,A03,083781,Staff,0,0,30,30
1650047135017,MATH 193A,A04,083782,Staff,9,0,30,21
1650047141042,MATH 197,001,091859,McAuley; Julian John,9999,0,9999,0
1650047147107,COGS 9,A01,083615,Staff,2,16,60,58
1650047153134,COGS 11,A01,083617,Boyle; Mary E. T.,25,0,40,15
1650047159171,COGS 13,A01,083071,Staff,0,28,40,40
1650047165197,COGS 14A,A01,092681,Staff,0,6,100,100
1650047171219,COGS 14B,A01,083073,Cheng; Tzu-Han,0,3,50,50
1650047177242,COGS 17,A01,092677,Staff,35,0,75,40
1650047183263,COGS 100,A01,083619,Staff,0,17,60,60
1650047189286,COGS 101A,A01,083621,Davis; Joshua Daniel,0,16,60,60
1650047195309,COGS 101B,A01,091572,Staff,15,0,60,45
1650047201337,COGS 101C,A01,083625,Delgado; Tania,21,0,30,9
1650047207368,COGS 107A,A01,083627,Boyle; Mary E. T.,1,2,60,59
1650047213392,COGS 118A,A01,083075,Staff,19,0,60,41
1650047219424,CSE 3,A50,083646,Miranda; Gregory Joseph,22,0,38,16
1650047219424,CSE 3,A51,083647,Miranda; Gregory Joseph,37,0,37,0
1650047225455,CSE 8A,A50,083650,Miranda; Gregory Joseph,0,15,40,40
1650047231476,CSE 11,A01,083080,Cao; Yingjun,0,61,40,40
1650047237503,CSE 12,A01,083652,Staff,0,0,100,100
1650047243535,CSE 15L,A01,083654,Staff,0,0,50,50
1650047243535,CSE 15L,A02,083655,Staff,11,0,50,39
1650047249563,CSE 20,A01,083657,Staff,58,0,80,22
1650047255591,CSE 30,A01,083084,Eldon; John,0,63,40,40
1650047261612,CSE 100,A01,083659,Cao; Yingjun,0,57,50,50
1650047267635,CSE 134B,A01,083661,Powell; Thomas Allan,1,26,65,64
1650047273658,CSE 140,A01,083663,Staff,8,0,75,67
1650047279684,CSE 140L,A01,083088,Eldon; John,3,0,75,72
1650047285707,CSE 175,A01,083665,Kumar; Rakesh,9,0,25,16
1650047291729,CSE 190,A00,092507,Dubnov; Shlomo,14,0,20,6
1650047297758,ECE 45,A01,083139,Staff,0,11,40,40
1650047303784,ECE 65,A50,083695,Staff,0,2,30,30
1650047309808,ECE 109,A01,091882,Touri; Behrouz,48,0,70,22
1650047315832,ECE 180,A00,083140,Abi Samra; Nicholas Camill,25,0,30,5
1650047315832,ECE 180,B00,083141,Abi Samra; Nicholas Camill,9,0,30,21
1650047321861,MATH 10A,A01,083735,Patchell; Gregory David,12,0,30,18
1650047321861,MATH 10A,A02,083736,Patchell; Gregory David,28,0,30,2
1650047321861,MATH 10A,A03,083737,Patchell; Gregory David,27,0,30,3
1650047327894,MATH 10B,A01,083207,Staff,0,5,30,30
1650047327894,MATH 10B,A02,083208,Staff,0,1,30,30
1650047327894,MATH 10B,B01,083739,Staff,20,0,30,10
1650047327894,MATH 10B,B02,083740,Staff,30,0,30,0
1650047333933,MATH 18,A01,083743,Staff,10,0,30,20
1650047333933,MATH 18,A02,083744,Staff,28,0,30,2
1650047333933,MATH 18,A03,083745,Staff,23,0,30,7
1650047333933,MATH 18,A04,083746,Staff,27,0,30,3
1650047333933,MATH 18,B01,083748,Staff,0,8,30,30
1650047333933,MATH 18,B02,083749,Staff,0,6,30,30
1650047333933,MATH 18,B03,083750,Staff,0,6,30,30
1650047333933,MATH 18,B04,083751,Staff,1,7,30,29
1650047339957,MATH 20A,A01,083754,Staff,26,0,40,14
1650047345984,MATH 20B,A01,083756,Staff,0,6,30,30
1650047345984,MATH 20B,A02,083757,Staff,1,0,30,29
1650047352007,MATH 20C,A01,083760,Staff,0,9,30,30
1650047352007,MATH 20C,A02,083761,Staff,0,12,30,30
1650047352007,MATH 20C,B01,083762,Staff,16,0,30,14
1650047352007,MATH 20C,B02,083763,Staff,28,0,30,2
1650047358033,MATH 20D,A01,083765,Staff,0,2,30,30
1650047358033,MATH 20D,A02,083766,Staff,15,0,30,15
1650047358033,MATH 20D,A03,083767,Staff,28,0,30,2
1650047364071,MATH 20E,A01,083771,Staff,10,0,30,20
1650047364071,MATH 20E,A02,083772,Staff,20,0,30,10
1650047364071,MATH 20E,B01,083773,Staff,1,1,30,29
1650047364071,MATH 20E,B02,083774,Staff,17,0,30,13
1650047370098,MATH 103A,A01,083777,Staff,0,6,30,30
1650047370098,MATH 103A,A02,083778,Staff,0,7,30,30
1650047370098,MATH 103A,B01,083779,Staff,0,8,30,30
1650047370098,MATH 103A,B02,083780,Staff,0,6,30,30
1650047376124,MATH 105,A01,085443,Staff,0,11,30,30
1650047382152,MATH 109,A01,083213,Anzaldo; Leesa B,0,3,30,30
1650047382152,MATH 109,A02,083214,Anzaldo; Leesa B,0,4,30,30
1650047382152,MATH 109,B01,083215,Anzaldo; Leesa B,0,2,30,30
1650047382152,MATH 109,B02,083216,Anzaldo; Leesa B,1,2,30,29
1650047388175,MATH 142A,A01,083219,Chow; Bennett,0,7,30,30
1650047388175,MATH 142A,A02,083220,Chow; Bennett,0,7,30,30
1650047388175,MATH 142A,B01,083221,Chow; Bennett,0,9,30,30
1650047388175,MATH 142A,B02,083222,Chow; Bennett,0,7,30,30
1650047394200,MATH 193A,A01,083224,Staff,0,5,30,30
1650047394200,MATH 193A,A02,083225,Staff,0,4,30,30
1650047394200,MATH 193A,A03,083781,Staff,0,0,30,30
1650047394200,MATH 193A,A04,083782,Staff,9,0,30,21
1650047400226,MATH 197,001,091859,McAuley; Julian John,9999,0,9999,0
1650047406281,COGS 9,A01,083615,Staff,2,17,60,58
1650047412318,COGS 11,A01,083617,Boyle; Mary E. T.,25,0,40,15
1650047418357,COGS 13,A01,083071,Staff,0,28,40,40
1650047424383,COGS 14A,A01,092681,Staff,0,6,100,100
1650047430410,COGS 14B,A01,083073,Cheng; Tzu-Han,0,3,50,50
1650047436441,COGS 17,A01,092677,Staff,35,0,75,40
1650047442462,COGS 100,A01,083619,Staff,0,17,60,60
1650047448581,COGS 101A,A01,083621,Davis; Joshua Daniel,0,16,60,60
1650047454618,COGS 101B,A01,091572,Staff,15,0,60,45
1650047460646,COGS 101C,A01,083625,Delgado; Tania,21,0,30,9
1650047466684,COGS 107A,A01,083627,Boyle; Mary E. T.,1,2,60,59
1650047472711,COGS 118A,A01,083075,Staff,19,0,60,41
1650047478734,CSE 3,A50,083646,Miranda; Gregory Joseph,22,0,38,16
1650047478734,CSE 3,A51,083647,Miranda; Gregory Joseph,37,0,37,0
1650047484763,CSE 8A,A50,083650,Miranda; Gregory Joseph,0,15,40,40
1650047490793,CSE 11,A01,083080,Cao; Yingjun,0,62,40,40
1650047496816,CSE 12,A01,083652,Staff,0,0,100,100
1650047502839,CSE 15L,A01,083654,Staff,0,0,50,50
1650047502839,CSE 15L,A02,083655,Staff,11,0,50,39
1650047508861,CSE 20,A01,083657,Staff,58,0,80,22
1650047514903,CSE 30,A01,083084,Eldon; John,0,63,40,40
1650047520926,CSE 100,A01,083659,Cao; Yingjun,0,57,50,50
1650047526954,CSE 134B,A01,083661,Powell; Thomas Allan,1,26,65,64
1650047532977,CSE 140,A01,083663,Staff,8,0,75,67
1650047539008,CSE 140L,A01,083088,Eldon; John,3,0,75,72
1650047545040,CSE 175,A01,083665,Kumar; Rakesh,9,0,25,16
1650047551063,CSE 190,A00,092507,Dubnov; Shlomo,14,0,20,6
1650047557090,ECE 45,A01,083139,Staff,0,11,40,40
1650047563126,ECE 65,A50,083695,Staff,0,3,30,30
1650047569151,ECE 109,A01,091882,Touri; Behrouz,48,0,70,22
1650047575176,ECE 180,A00,083140,Abi Samra; Nicholas Camill,25,0,30,5
1650047575176,ECE 180,B00,083141,Abi Samra; Nicholas Camill,9,0,30,21
1650047581204,MATH 10A,A01,083735,Patchell; Gregory David,12,0,30,18
1650047581204,MATH 10A,A02,083736,Patchell; Gregory David,28,0,30,2
1650047581204,MATH 10A,A03,083737,Patchell; Gregory David,27,0,30,3
1650047587233,MATH 10B,A01,083207,Staff,0,5,30,30
1650047587233,MATH 10B,A02,083208,Staff,0,1,30,30
1650047587233,MATH 10B,B01,083739,Staff,20,0,30,10
1650047587233,MATH 10B,B02,083740,Staff,30,0,30,0
1650047593256,MATH 18,A01,083743,Staff,10,0,30,20
1650047593256,MATH 18,A02,083744,Staff,28,0,30,2
1650047593256,MATH 18,A03,083745,Staff,23,0,30,7
1650047593256,MATH 18,A04,083746,Staff,27,0,30,3
1650047593256,MATH 18,B01,083748,Staff,0,8,30,30
1650047593256,MATH 18,B02,083749,Staff,0,6,30,30
1650047593256,MATH 18,B03,083750,Staff,0,6,30,30
1650047593256,MATH 18,B04,083751,Staff,1,7,30,29
1650047599282,MATH 20A,A01,083754,Staff,26,0,40,14
1650047605309,MATH 20B,A01,083756,Staff,0,6,30,30
1650047605309,MATH 20B,A02,083757,Staff,1,0,30,29
1650047611330,MATH 20C,A01,083760,Staff,0,9,30,30
1650047611330,MATH 20C,A02,083761,Staff,0,12,30,30
1650047611330,MATH 20C,B01,083762,Staff,16,0,30,14
1650047611330,MATH 20C,B02,083763,Staff,28,0,30,2
1650047617354,MATH 20D,A01,083765,Staff,0,2,30,30
1650047617354,MATH 20D,A02,083766,Staff,15,0,30,15
1650047617354,MATH 20D,A03,083767,Staff,28,0,30,2
1650047623381,MATH 20E,A01,083771,Staff,10,0,30,20
1650047623381,MATH 20E,A02,083772,Staff,20,0,30,10
1650047623381,MATH 20E,B01,083773,Staff,1,1,30,29
1650047623381,MATH 20E,B02,083774,Staff,17,0,30,13
1650047629413,MATH 103A,A01,083777,Staff,0,6,30,30
1650047629413,MATH 103A,A02,083778,Staff,0,7,30,30
1650047629413,MATH 103A,B01,083779,Staff,0,8,30,30
1650047629413,MATH 103A,B02,083780,Staff,0,6,30,30
1650047635450,MATH 105,A01,085443,Staff,0,11,30,30
1650047641476,MATH 109,A01,083213,Anzaldo; Leesa B,0,3,30,30
1650047641476,MATH 109,A02,083214,Anzaldo; Leesa B,0,4,30,30
1650047641476,MATH 109,B01,083215,Anzaldo; Leesa B,0,2,30,30
1650047641476,MATH 109,B02,083216,Anzaldo; Leesa B,1,2,30,29
1650047647584,MATH 142A,A01,083219,Chow; Bennett,0,7,30,30
1650047647584,MATH 142A,A02,083220,Chow; Bennett,0,7,30,30
1650047647584,MATH 142A,B01,083221,Chow; Bennett,0,9,30,30
1650047647584,MATH 142A,B02,083222,Chow; Bennett,0,7,30,30
1650047653608,MATH 193A,A01,083224,Staff,0,5,30,30
1650047653608,MATH 193A,A02,083225,Staff,0,4,30,30
1650047653608,MATH 193A,A03,083781,Staff,0,0,30,30
1650047653608,MATH 193A,A04,083782,Staff,9,0,30,21
1650047659637,MATH 197,001,091859,McAuley; Julian John,9999,0,9999,0
1650047665701,COGS 9,A01,083615,Staff,2,17,60,58
1650047671728,COGS 11,A01,083617,Boyle; Mary E. T.,25,0,40,15
1650047677759,COGS 13,A01,083071,Staff,0,28,40,40
1650047683788,COGS 14A,A01,092681,Staff,0,6,100,100
1650047689811,COGS 14B,A01,083073,Cheng; Tzu-Han,0,3,50,50
1650047695832,COGS 17,A01,092677,Staff,35,0,75,40
1650047701858,COGS 100,A01,083619,Staff,0,17,60,60
1650047707885,COGS 101A,A01,083621,Davis; Joshua Daniel,0,16,60,60
1650047713922,COGS 101B,A01,091572,Staff,15,0,60,45
1650047719947,COGS 101C,A01,083625,Delgado; Tania,21,0,30,9
1650047725978,COGS 107A,A01,083627,Boyle; Mary E. T.,1,2,60,59
1650047731999,COGS 118A,A01,083075,Staff,19,0,60,41
1650047738032,CSE 3,A50,083646,Miranda; Gregory Joseph,22,0,38,16
1650047738032,CSE 3,A51,083647,Miranda; Gregory Joseph,37,0,37,0
1650047744054,CSE 8A,A50,083650,Miranda; Gregory Joseph,0,15,40,40
1650047750094,CSE 11,A01,083080,Cao; Yingjun,0,62,40,40
1650047756119,CSE 12,A01,083652,Staff,0,0,100,100
1650047762144,CSE 15L,A01,083654,Staff,0,0,50,50
1650047762144,CSE 15L,A02,083655,Staff,11,0,50,39
1650047768171,CSE 20,A01,083657,Staff,58,0,80,22
1650047774193,CSE 30,A01,083084,Eldon; John,0,63,40,40
1650047780217,CSE 100,A01,083659,Cao; Yingjun,0,57,50,50
1650047786257,CSE 134B,A01,083661,Powell; Thomas Allan,1,26,65,64
1650047792278,CSE 140,A01,083663,Staff,8,0,75,67
1650047798313,CSE 140L,A01,083088,Eldon; John,3,0,75,72
1650047804335,CSE 175,A01,083665,Kumar; Rakesh,9,0,25,16
1650047810361,CSE 190,A00,092507,Dubnov; Shlomo,14,0,20,6
1650047816382,ECE 45,A01,083139,Staff,0,12,40,40
1650047822409,ECE 65,A50,083695,Staff,0,3,30,30
1650047828431,ECE 109,A01,091882,Touri; Behrouz,48,0,70,22
1650047834455,ECE 180,A00,083140,Abi Samra; Nicholas Camill,25,0,30,5
1650047834455,ECE 180,B00,083141,Abi Samra; Nicholas Camill,9,0,30,21
1650047840479,MATH 10A,A01,083735,Patchell; Gregory David,12,0,30,18
1650047840479,MATH 10A,A02,083736,Patchell; Gregory David,28,0,30,2
1650047840479,MATH 10A,A03,083737,Patchell; Gregory David,27,0,30,3
1650047846509,MATH 10B,A01,083207,Staff,0,5,30,30
1650047846509,MATH 10B,A02,083208,Staff,0,1,30,30
1650047846509,MATH 10B,B01,083739,Staff,20,0,30,10
1650047846509,MATH 10B,B02,083740,Staff,30,0,30,0
1650047852536,MATH 18,A01,083743,Staff,10,0,30,20
1650047852536,MATH 18,A02,083744,Staff,28,0,30,2
1650047852536,MATH 18,A03,083745,Staff,23,0,30,7
1650047852536,MATH 18,A04,083746,Staff,27,0,30,3
1650047852536,MATH 18,B01,083748,Staff,0,8,30,30
1650047852536,MATH 18,B02,083749,Staff,0,6,30,30
1650047852536,MATH 18,B03,083750,Staff,0,6,30,30
1650047852536,MATH 18,B04,083751,Staff,1,7,30,29
1650047858572,MATH 20A,A01,083754,Staff,26,0,40,14
1650047864598,MATH 20B,A01,083756,Staff,0,6,30,30
1650047864598,MATH 20B,A02,083757,Staff,1,0,30,29
1650047870620,MATH 20C,A01,083760,Staff,0,9,30,30
1650047870620,MATH 20C,A02,083761,Staff,0,12,30,30
1650047870620,MATH 20C,B01,083762,Staff,16,0,30,14
1650047870620,MATH 20C,B02,083763,Staff,28,0,30,2
1650047876644,MATH 20D,A01,083765,Staff,0,2,30,30
1650047876644,MATH 20D,A02,083766,Staff,15,0,30,15
1650047876644,MATH 20D,A03,083767,Staff,28,0,30,2
1650047882672,MATH 20E,A01,083771,Staff,10,0,30,20
1650047882672,MATH 20E,A02,083772,Staff,20,0,30,10
1650047882672,MATH 20E,B01,083773,Staff,1,1,30,29
1650047882672,MATH 20E,B02,083774,Staff,17,0,30,13
1650047888711,MATH 103A,A01,083777,Staff,0,6,30,30
1650047888711,MATH 103A,A02,083778,Staff,0,7,30,30
1650047888711,MATH 103A,B01,083779,Staff,0,8,30,30
1650047888711,MATH 103A,B02,083780,Staff,0,6,30,30
1650047894742,MATH 105,A01,085443,Staff,0,11,30,30
1650047900772,MATH 109,A01,083213,Anzaldo; Leesa B,0,3,30,30
1650047900772,MATH 109,A02,083214,Anzaldo; Leesa B,0,4,30,30
1650047900772,MATH 109,B01,083215,Anzaldo; Leesa B,0,2,30,30
1650047900772,MATH 109,B02,083216,Anzaldo; Leesa B,1,2,30,29
1650047906797,MATH 142A,A01,083219,Chow; Bennett,0,7,30,30
1650047906797,MATH 142A,A02,083220,Chow; Bennett,0,7,30,30
1650047906797,MATH 142A,B01,083221,Chow; Bennett,0,9,30,30
1650047906797,MATH 142A,B02,083222,Chow; Bennett,0,7,30,30
1650047912820,MATH 193A,A01,083224,Staff,0,5,30,30
1650047912820,MATH 193A,A02,083225,Staff,0,4,30,30
1650047912820,MATH 193A,A03,083781,Staff,0,0,30,30
1650047912820,MATH 193A,A04,083782,Staff,9,0,30,21
1650047918849,MATH 197,001,091859,McAuley; Julian John,9999,0,9999,0
1650047924903,COGS 9,A01,083615,Staff,2,17,60,58
1650047930924,COGS 11,A01,083617,Boyle; Mary E. T.,25,0,40,15
1650047936956,COGS 13,A01,083071,Staff,0,28,40,40
1650047942983,COGS 14A,A01,092681,Staff,0,6,100,100
1650047949007,COGS 14B,A01,083073,Cheng; Tzu-Han,0,3,50,50
1650047955031,COGS 17,A01,092677,Staff,35,0,75,40
1650047961057,COGS 100,A01,083619,Staff,0,17,60,60
1650047967080,COGS 101A,A01,083621,Davis; Joshua Daniel,0,16,60,60
1650047973101,COGS 101B,A01,091572,Staff,15,0,60,45
1650047979128,COGS 101C,A01,083625,Delgado; Tania,21,0,30,9
1650047985160,COGS 107A,A01,083627,Boyle; Mary E. T.,1,2,60,59
1650047991188,COGS 118A,A01,083075,Staff,19,0,60,41
1650047997215,CSE 3,A50,083646,Miranda; Gregory Joseph,22,0,38,16
1650047997215,CSE 3,A51,083647,Miranda; Gregory Joseph,37,0,37,0
1650048003239,CSE 8A,A50,083650,Miranda; Gregory Joseph,0,15,40,40
1650048009267,CSE 11,A01,083080,Cao; Yingjun,0,62,40,40
1650048015296,CSE 12,A01,083652,Staff,0,0,100,100
1650048021318,CSE 15L,A01,083654,Staff,0,0,50,50
1650048021318,CSE 15L,A02,083655,Staff,11,0,50,39
1650048027346,CSE 20,A01,083657,Staff,58,0,80,22
1650048033378,CSE 30,A01,083084,Eldon; John,0,63,40,40
1650048039402,CSE 100,A01,083659,Cao; Yingjun,0,57,50,50
1650048045442,CSE 134B,A01,083661,Powell; Thomas Allan,1,26,65,64
1650048051465,CSE 140,A01,083663,Staff,8,0,75,67
1650048057489,CSE 140L,A01,083088,Eldon; John,3,0,75,72
1650048063516,CSE 175,A01,083665,Kumar; Rakesh,9,0,25,16
1650048069539,CSE 190,A00,092507,Dubnov; Shlomo,14,0,20,6
1650048075564,ECE 45,A01,083139,Staff,0,12,40,40
1650048081592,ECE 65,A50,083695,Staff,0,3,30,30
1650048087615,ECE 109,A01,091882,Touri; Behrouz,48,0,70,22
1650048093639,ECE 180,A00,083140,Abi Samra; Nicholas Camill,25,0,30,5
1650048093639,ECE 180,B00,083141,Abi Samra; Nicholas Camill,9,0,30,21
1650048099667,MATH 10A,A01,083735,Patchell; Gregory David,12,0,30,18
1650048099667,MATH 10A,A02,083736,Patchell; Gregory David,28,0,30,2
1650048099667,MATH 10A,A03,083737,Patchell; Gregory David,27,0,30,3
1650048105689,MATH 10B,A01,083207,Staff,0,5,30,30
1650048105689,MATH 10B,A02,083208,Staff,0,1,30,30
1650048105689,MATH 10B,B01,083739,Staff,20,0,30,10
1650048105689,MATH 10B,B02,083740,Staff,30,0,30,0
1650048111718,MATH 18,A01,083743,Staff,10,0,30,20
1650048111718,MATH 18,A02,083744,Staff,28,0,30,2
1650048111718,MATH 18,A03,083745,Staff,23,0,30,7
1650048111718,MATH 18,A04,083746,Staff,27,0,30,3
1650048111718,MATH 18,B01,083748,Staff,0,8,30,30
1650048111718,MATH 18,B02,083749,Staff,0,6,30,30
1650048111718,MATH 18,B03,083750,Staff,0,6,30,30
1650048111718,MATH 18,B04,083751,Staff,1,7,30,29
1650048117744,MATH 20A,A01,083754,Staff,26,0,40,14
1650048123778,MATH 20B,A01,083756,Staff,0,6,30,30
1650048123778,MATH 20B,A02,083757,Staff,1,0,30,29
1650048129805,MATH 20C,A01,083760,Staff,0,9,30,30
1650048129805,MATH 20C,A02,083761,Staff,0,12,30,30
1650048129805,MATH 20C,B01,083762,Staff,16,0,30,14
1650048129805,MATH 20C,B02,083763,Staff,28,0,30,2
1650048135829,MATH 20D,A01,083765,Staff,0,2,30,30
1650048135829,MATH 20D,A02,083766,Staff,15,0,30,15
1650048135829,MATH 20D,A03,083767,Staff,28,0,30,2
1650048141855,MATH 20E,A01,083771,Staff,10,0,30,20
1650048141855,MATH 20E,A02,083772,Staff,20,0,30,10
1650048141855,MATH 20E,B01,083773,Staff,1,1,30,29
1650048141855,MATH 20E,B02,083774,Staff,17,0,30,13
1650048147878,MATH 103A,A01,083777,Staff,0,6,30,30
1650048147878,MATH 103A,A02,083778,Staff,0,7,30,30
1650048147878,MATH 103A,B01,083779,Staff,0,8,30,30
1650048147878,MATH 103A,B02,083780,Staff,0,6,30,30
1650048153905,MATH 105,A01,085443,Staff,0,11,30,30
1650048159932,MATH 109,A01,083213,Anzaldo; Leesa B,0,3,30,30
1650048159932,MATH 109,A02,083214,Anzaldo; Leesa B,0,4,30,30
1650048159932,MATH 109,B01,083215,Anzaldo; Leesa B,0,2,30,30
1650048159932,MATH 109,B02,083216,Anzaldo; Leesa B,1,2,30,29
1650048165958,MATH 142A,A01,083219,Chow; Bennett,0,7,30,30
1650048165958,MATH 142A,A02,083220,Chow; Bennett,0,7,30,30
1650048165958,MATH 142A,B01,083221,Chow; Bennett,0,9,30,30
1650048165958,MATH 142A,B02,083222,Chow; Bennett,0,7,30,30
1650048171985,MATH 193A,A01,083224,Staff,0,5,30,30
1650048171985,MATH 193A,A02,083225,Staff,0,4,30,30
1650048171985,MATH 193A,A03,083781,Staff,0,0,30,30
1650048171985,MATH 193A,A04,083782,Staff,9,0,30,21
1650048178008,MATH 197,001,091859,McAuley; Julian John,9999,0,9999,0
1650048184068,COGS 9,A01,083615,Staff,2,17,60,58
1650048190098,COGS 11,A01,083617,Boyle; Mary E. T.,25,0,40,15
1650048196120,COGS 13,A01,083071,Staff,0,28,40,40
1650048202145,COGS 14A,A01,092681,Staff,0,6,100,100
1650048208170,COGS 14B,A01,083073,Cheng; Tzu-Han,0,3,50,50
1650048214205,COGS 17,A01,092677,Staff,35,0,75,40
1650048220227,COGS 100,A01,083619,Staff,0,17,60,60
1650048226252,COGS 101A,A01,083621,Davis; Joshua Daniel,0,16,60,60
1650048232285,COGS 101B,A01,091572,Staff,15,0,60,45
1650048238408,COGS 101C,A01,083625,Delgado; Tania,21,0,30,9
1650048244434,COGS 107A,A01,083627,Boyle; Mary E. T.,1,2,60,59
1650048250460,COGS 118A,A01,083075,Staff,19,0,60,41
1650048256502,CSE 3,A50,083646,Miranda; Gregory Joseph,22,0,38,16
1650048256502,CSE 3,A51,083647,Miranda; Gregory Joseph,37,0,37,0
1650048262525,CSE 8A,A50,083650,Miranda; Gregory Joseph,0,15,40,40
1650048268556,CSE 11,A01,083080,Cao; Yingjun,0,62,40,40
1650048274581,CSE 12,A01,083652,Staff,0,0,100,100
1650048280609,CSE 15L,A01,083654,Staff,0,0,50,50
1650048280609,CSE 15L,A02,083655,Staff,11,0,50,39
1650048286633,CSE 20,A01,083657,Staff,58,0,80,22
1650048292658,CSE 30,A01,083084,Eldon; John,0,63,40,40
1650048298685,CSE 100,A01,083659,Cao; Yingjun,0,57,50,50
1650048304706,CSE 134B,A01,083661,Powell; Thomas Allan,1,26,65,64
1650048310735,CSE 140,A01,083663,Staff,8,0,75,67
1650048316768,CSE 140L,A01,083088,Eldon; John,3,0,75,72
1650048322793,CSE 175,A01,083665,Kumar; Rakesh,9,0,25,16
1650048328819,CSE 190,A00,092507,Dubnov; Shlomo,14,0,20,6
1650048334845,ECE 45,A01,083139,Staff,0,12,40,40
1650048340870,ECE 65,A50,083695,Staff,0,3,30,30
1650048346898,ECE 109,A01,091882,Touri; Behrouz,48,0,70,22
1650048352924,ECE 180,A00,083140,Abi Samra; Nicholas Camill,25,0,30,5
1650048352924,ECE 180,B00,083141,Abi Samra; Nicholas Camill,9,0,30,21
1650048358948,MATH 10A,A01,083735,Patchell; Gregory David,12,0,30,18
1650048358948,MATH 10A,A02,083736,Patchell; Gregory David,28,0,30,2
1650048358948,MATH 10A,A03,083737,Patchell; Gregory David,27,0,30,3
1650048364983,MATH 10B,A01,083207,Staff,0,5,30,30
1650048364983,MATH 10B,A02,083208,Staff,0,1,30,30
1650048364983,MATH 10B,B01,083739,Staff,20,0,30,10
1650048364983,MATH 10B,B02,083740,Staff,30,0,30,0
1650048371007,MATH 18,A01,083743,Staff,10,0,30,20
1650048371007,MATH 18,A02,083744,Staff,28,0,30,2
1650048371007,MATH 18,A03,083745,Staff,23,0,30,7
1650048371007,MATH 18,A04,083746,Staff,27,0,30,3
1650048371007,MATH 18,B01,083748,Staff,0,8,30,30
1650048371007,MATH 18,B02,083749,Staff,0,6,30,30
1650048371007,MATH 18,B03,083750,Staff,0,6,30,30
1650048371007,MATH 18,B04,083751,Staff,1,7,30,29
1650048377032,MATH 20A,A01,083754,Staff,26,0,40,14
1650048383057,MATH 20B,A01,083756,Staff,0,6,30,30
1650048383057,MATH 20B,A02,083757,Staff,1,0,30,29
1650048389088,MATH 20C,A01,083760,Staff,0,9,30,30
1650048389088,MATH 20C,A02,083761,Staff,0,12,30,30
1650048389088,MATH 20C,B01,083762,Staff,16,0,30,14
1650048389088,MATH 20C,B02,083763,Staff,28,0,30,2
1650048395117,MATH 20D,A01,083765,Staff,0,2,30,30
1650048395117,MATH 20D,A02,083766,Staff,15,0,30,15
1650048395117,MATH 20D,A03,083767,Staff,28,0,30,2
1650048401140,MATH 20E,A01,083771,Staff,10,0,30,20
1650048401140,MATH 20E,A02,083772,Staff,20,0,30,10
1650048401140,MATH 20E,B01,083773,Staff,1,1,30,29
1650048401140,MATH 20E,B02,083774,Staff,17,0,30,13
1650048407172,MATH 103A,A01,083777,Staff,0,6,30,30
1650048407172,MATH 103A,A02,083778,Staff,0,7,30,30
1650048407172,MATH 103A,B01,083779,Staff,0,8,30,30
1650048407172,MATH 103A,B02,083780,Staff,0,6,30,30
1650048413195,MATH 105,A01,085443,Staff,0,11,30,30
1650048419221,MATH 109,A01,083213,Anzaldo; Leesa B,0,3,30,30
1650048419221,MATH 109,A02,083214,Anzaldo; Leesa B,0,4,30,30
1650048419221,MATH 109,B01,083215,Anzaldo; Leesa B,0,2,30,30
1650048419221,MATH 109,B02,083216,Anzaldo; Leesa B,1,2,30,29
1650048425243,MATH 142A,A01,083219,Chow; Bennett,0,7,30,30
1650048425243,MATH 142A,A02,083220,Chow; Bennett,0,7,30,30
1650048425243,MATH 142A,B01,083221,Chow; Bennett,0,9,30,30
1650048425243,MATH 142A,B02,083222,Chow; Bennett,0,7,30,30
1650048431275,MATH 193A,A01,083224,Staff,0,5,30,30
1650048431275,MATH 193A,A02,083225,Staff,0,4,30,30
1650048431275,MATH 193A,A03,083781,Staff,0,0,30,30
1650048431275,MATH 193A,A04,083782,Staff,9,0,30,21
1650048437306,MATH 197,001,091859,McAuley; Julian John,9999,0,9999,0
1650048443355,COGS 9,A01,083615,Staff,2,17,60,58
1650048449382,COGS 11,A01,083617,Boyle; Mary E. T.,25,0,40,15
1650048455406,COGS 13,A01,083071,Staff,0,28,40,40
1650048461434,COGS 14A,A01,092681,Staff,0,6,100,100
1650048467464,COGS 14B,A01,083073,Cheng; Tzu-Han,0,3,50,50
1650048473492,COGS 17,A01,092677,Staff,35,0,75,40
1650048479529,COGS 100,A01,083619,Staff,0,17,60,60
1650048485552,COGS 101A,A01,083621,Davis; Joshua Daniel,0,16,60,60
1650048491580,COGS 101B,A01,091572,Staff,15,0,60,45
1650048497604,COGS 101C,A01,083625,Delgado; Tania,21,0,30,9
1650048503632,COGS 107A,A01,083627,Boyle; Mary E. T.,1,2,60,59
1650048509658,COGS 118A,A01,083075,Staff,19,0,60,41
1650048515686,CSE 3,A50,083646,Miranda; Gregory Joseph,22,0,38,16
1650048515686,CSE 3,A51,083647,Miranda; Gregory Joseph,37,0,37,0
1650048521709,CSE 8A,A50,083650,Miranda; Gregory Joseph,0,15,40,40
1650048527736,CSE 11,A01,083080,Cao; Yingjun,0,62,40,40
1650048533776,CSE 12,A01,083652,Staff,0,0,100,100
1650048539799,CSE 15L,A01,083654,Staff,0,0,50,50
1650048539799,CSE 15L,A02,083655,Staff,11,0,50,39
1650048545827,CSE 20,A01,083657,Staff,58,0,80,22
1650048551854,CSE 30,A01,083084,Eldon; John,0,63,40,40
1650048557882,CSE 100,A01,083659,Cao; Yingjun,0,57,50,50
1650048563914,CSE 134B,A01,083661,Powell; Thomas Allan,1,26,65,64
1650048569938,CSE 140,A01,083663,Staff,8,0,75,67
1650048575962,CSE 140L,A01,083088,Eldon; John,3,0,75,72
1650048581985,CSE 175,A01,083665,Kumar; Rakesh,9,0,25,16
1650048588011,CSE 190,A00,092507,Dubnov; Shlomo,14,0,20,6
1650048594034,ECE 45,A01,083139,Staff,0,12,40,40
1650048600070,ECE 65,A50,083695,Staff,0,3,30,30
1650048606096,ECE 109,A01,091882,Touri; Behrouz,48,0,70,22
1650048612131,ECE 180,A00,083140,Abi Samra; Nicholas Camill,25,0,30,5
1650048612131,ECE 180,B00,083141,Abi Samra; Nicholas Camill,9,0,30,21
1650048618168,MATH 10A,A01,083735,Patchell; Gregory David,12,0,30,18
1650048618168,MATH 10A,A02,083736,Patchell; Gregory David,28,0,30,2
1650048618168,MATH 10A,A03,083737,Patchell; Gregory David,27,0,30,3
1650048624198,MATH 10B,A01,083207,Staff,0,5,30,30
1650048624198,MATH 10B,A02,083208,Staff,0,1,30,30
1650048624198,MATH 10B,B01,083739,Staff,20,0,30,10
1650048624198,MATH 10B,B02,083740,Staff,30,0,30,0
1650048630222,MATH 18,A01,083743,Staff,10,0,30,20
1650048630222,MATH 18,A02,083744,Staff,28,0,30,2
1650048630222,MATH 18,A03,083745,Staff,23,0,30,7
1650048630222,MATH 18,A04,083746,Staff,27,0,30,3
1650048630222,MATH 18,B01,083748,Staff,0,8,30,30
1650048630222,MATH 18,B02,083749,Staff,0,6,30,30
1650048630222,MATH 18,B03,083750,Staff,0,6,30,30
1650048630222,MATH 18,B04,083751,Staff,1,7,30,29
1650048636252,MATH 20A,A01,083754,Staff,26,0,40,14
1650048642286,MATH 20B,A01,083756,Staff,0,6,30,30
1650048642286,MATH 20B,A02,083757,Staff,1,0,30,29
1650048648310,MATH 20C,A01,083760,Staff,0,9,30,30
1650048648310,MATH 20C,A02,083761,Staff,0,12,30,30
1650048648310,MATH 20C,B01,083762,Staff,16,0,30,14
1650048648310,MATH 20C,B02,083763,Staff,28,0,30,2
1650048654333,MATH 20D,A01,083765,Staff,0,2,30,30
1650048654333,MATH 20D,A02,083766,Staff,15,0,30,15
1650048654333,MATH 20D,A03,083767,Staff,28,0,30,2
1650048660363,MATH 20E,A01,083771,Staff,10,0,30,20
1650048660363,MATH 20E,A02,083772,Staff,20,0,30,10
1650048660363,MATH 20E,B01,083773,Staff,1,1,30,29
1650048660363,MATH 20E,B02,083774,Staff,17,0,30,13
1650048671669,MATH 103A,A01,083777,Staff,0,6,30,30
1650048671669,MATH 103A,A02,083778,Staff,0,7,30,30
1650048671669,MATH 103A,B01,083779,Staff,0,8,30,30
1650048671669,MATH 103A,B02,083780,Staff,0,6,30,30
1650048677693,MATH 105,A01,085443,Staff,0,11,30,30
1650048683725,MATH 109,A01,083213,Anzaldo; Leesa B,0,3,30,30
1650048683725,MATH 109,A02,083214,Anzaldo; Leesa B,0,4,30,30
1650048683725,MATH 109,B01,083215,Anzaldo; Leesa B,0,2,30,30
1650048683725,MATH 109,B02,083216,Anzaldo; Leesa B,1,2,30,29
1650048689750,MATH 142A,A01,083219,Chow; Bennett,0,7,30,30
1650048689750,MATH 142A,A02,083220,Chow; Bennett,0,7,30,30
1650048689750,MATH 142A,B01,083221,Chow; Bennett,0,9,30,30
1650048689750,MATH 142A,B02,083222,Chow; Bennett,0,8,30,30
1650048695775,MATH 193A,A01,083224,Staff,0,5,30,30
1650048695775,MATH 193A,A02,083225,Staff,0,4,30,30
1650048695775,MATH 193A,A03,083781,Staff,0,0,30,30
1650048695775,MATH 193A,A04,083782,Staff,9,0,30,21
1650048701798,MATH 197,001,091859,McAuley; Julian John,9999,0,9999,0
1650048707849,COGS 9,A01,083615,Staff,2,17,60,58
1650048713871,COGS 11,A01,083617,Boyle; Mary E. T.,25,0,40,15
1650048719897,COGS 13,A01,083071,Staff,0,28,40,40
1650048725929,COGS 14A,A01,092681,Staff,0,7,100,100
1650048731953,COGS 14B,A01,083073,Cheng; Tzu-Han,0,3,50,50
1650048737981,COGS 17,A01,092677,Staff,34,0,75,41
1650048744007,COGS 100,A01,083619,Staff,0,17,60,60
1650048750031,COGS 101A,A01,083621,Davis; Joshua Daniel,0,16,60,60
1650048756053,COGS 101B,A01,091572,Staff,15,0,60,45
1650048762086,COGS 101C,A01,083625,Delgado; Tania,21,0,30,9
1650048768117,COGS 107A,A01,083627,Boyle; Mary E. T.,1,2,60,59
1650048774150,COGS 118A,A01,083075,Staff,19,0,60,41
1650048780177,CSE 3,A50,083646,Miranda; Gregory Joseph,22,0,38,16
1650048780177,CSE 3,A51,083647,Miranda; Gregory Joseph,37,0,37,0
1650048786201,CSE 8A,A50,083650,Miranda; Gregory Joseph,0,15,40,40
1650048792227,CSE 11,A01,083080,Cao; Yingjun,0,62,40,40
1650048798249,CSE 12,A01,083652,Staff,0,0,100,100
1650048804275,CSE 15L,A01,083654,Staff,0,0,50,50
1650048804275,CSE 15L,A02,083655,Staff,11,0,50,39
1650048810305,CSE 20,A01,083657,Staff,58,0,80,22
1650048816326,CSE 30,A01,083084,Eldon; John,0,63,40,40
1650048822355,CSE 100,A01,083659,Cao; Yingjun,0,57,50,50
1650048828382,CSE 134B,A01,083661,Powell; Thomas Allan,1,26,65,64
1650048834411,CSE 140,A01,083663,Staff,8,0,75,67
1650048840556,CSE 140L,A01,083088,Eldon; John,3,0,75,72
1650048846588,CSE 175,A01,083665,Kumar; Rakesh,9,0,25,16
1650048852614,CSE 190,A00,092507,Dubnov; Shlomo,14,0,20,6
1650048858648,ECE 45,A01,083139,Staff,0,12,40,40
1650048864685,ECE 65,A50,083695,Staff,0,3,30,30
1650048870715,ECE 109,A01,091882,Touri; Behrouz,48,0,70,22
1650048876742,ECE 180,A00,083140,Abi Samra; Nicholas Camill,25,0,30,5
1650048876742,ECE 180,B00,083141,Abi Samra; Nicholas Camill,9,0,30,21
1650048882780,MATH 10A,A01,083735,Patchell; Gregory David,12,0,30,18
1650048882780,MATH 10A,A02,083736,Patchell; Gregory David,28,0,30,2
1650048882780,MATH 10A,A03,083737,Patchell; Gregory David,27,0,30,3
1650048888809,MATH 10B,A01,083207,Staff,0,5,30,30
1650048888809,MATH 10B,A02,083208,Staff,0,1,30,30
1650048888809,MATH 10B,B01,083739,Staff,20,0,30,10
1650048888809,MATH 10B,B02,083740,Staff,30,0,30,0
1650048894844,MATH 18,A01,083743,Staff,10,0,30,20
1650048894844,MATH 18,A02,083744,Staff,28,0,30,2
1650048894844,MATH 18,A03,083745,Staff,23,0,30,7
1650048894844,MATH 18,A04,083746,Staff,27,0,30,3
1650048894844,MATH 18,B01,083748,Staff,0,8,30,30
1650048894844,MATH 18,B02,083749,Staff,0,6,30,30
1650048894844,MATH 18,B03,083750,Staff,0,6,30,30
1650048894844,MATH 18,B04,083751,Staff,1,7,30,29
1650048900867,MATH 20A,A01,083754,Staff,26,0,40,14
1650048906893,MATH 20B,A01,083756,Staff,0,6,30,30
1650048906893,MATH 20B,A02,083757,Staff,1,0,30,29
1650048912925,MATH 20C,A01,083760,Staff,0,9,30,30
1650048912925,MATH 20C,A02,083761,Staff,0,12,30,30
1650048912925,MATH 20C,B01,083762,Staff,16,0,30,14
1650048912925,MATH 20C,B02,083763,Staff,28,0,30,2
1650048918946,MATH 20D,A01,083765,Staff,0,2,30,30
1650048918946,MATH 20D,A02,083766,Staff,15,0,30,15
1650048918946,MATH 20D,A03,083767,Staff,28,0,30,2
1650048924972,MATH 20E,A01,083771,Staff,10,0,30,20
1650048924972,MATH 20E,A02,083772,Staff,20,0,30,10
1650048924972,MATH 20E,B01,083773,Staff,1,1,30,29
1650048924972,MATH 20E,B02,083774,Staff,17,0,30,13
1650048931003,MATH 103A,A01,083777,Staff,0,6,30,30
1650048931003,MATH 103A,A02,083778,Staff,0,7,30,30
1650048931003,MATH 103A,B01,083779,Staff,0,8,30,30
1650048931003,MATH 103A,B02,083780,Staff,0,6,30,30
1650048937029,MATH 105,A01,085443,Staff,0,11,30,30
1650048943054,MATH 109,A01,083213,Anzaldo; Leesa B,0,3,30,30
1650048943054,MATH 109,A02,083214,Anzaldo; Leesa B,0,4,30,30
1650048943054,MATH 109,B01,083215,Anzaldo; Leesa B,0,2,30,30
1650048943054,MATH 109,B02,083216,Anzaldo; Leesa B,1,2,30,29
1650048949076,MATH 142A,A01,083219,Chow; Bennett,0,7,30,30
1650048949076,MATH 142A,A02,083220,Chow; Bennett,0,7,30,30
1650048949076,MATH 142A,B01,083221,Chow; Bennett,0,9,30,30
1650048949076,MATH 142A,B02,083222,Chow; Bennett,0,8,30,30
1650048955107,MATH 193A,A01,083224,Staff,0,5,30,30
1650048955107,MATH 193A,A02,083225,Staff,0,4,30,30
1650048955107,MATH 193A,A03,083781,Staff,0,0,30,30
1650048955107,MATH 193A,A04,083782,Staff,9,0,30,21
1650048961129,MATH 197,001,091859,McAuley; Julian John,9998,0,9999,1
1650048967194,COGS 9,A01,083615,Staff,2,17,60,58
1650048973219,COGS 11,A01,083617,Boyle; Mary E. T.,25,0,40,15
1650048979244,COGS 13,A01,083071,Staff,0,28,40,40
1650048985267,COGS 14A,A01,092681,Staff,0,7,100,100
1650048991302,COGS 14B,A01,083073,Cheng; Tzu-Han,0,3,50,50
1650048997324,COGS 17,A01,092677,Staff,34,0,75,41
1650049003347,COGS 100,A01,083619,Staff,0,17,60,60
1650049009370,COGS 101A,A01,083621,Davis; Joshua Daniel,0,16,60,60
1650049015395,COGS 101B,A01,091572,Staff,15,0,60,45
1650049021419,COGS 101C,A01,083625,Delgado; Tania,21,0,30,9
1650049027442,COGS 107A,A01,083627,Boyle; Mary E. T.,1,2,60,59
1650049033473,COGS 118A,A01,083075,Staff,19,0,60,41
1650049039500,CSE 3,A50,083646,Miranda; Gregory Joseph,22,0,38,16
1650049039500,CSE 3,A51,083647,Miranda; Gregory Joseph,37,0,37,0
1650049045541,CSE 8A,A50,083650,Miranda; Gregory Joseph,0,15,40,40
1650049051573,CSE 11,A01,083080,Cao; Yingjun,0,62,40,40
1650049057597,CSE 12,A01,083652,Staff,0,0,100,100
1650049063623,CSE 15L,A01,083654,Staff,0,0,50,50
1650049063623,CSE 15L,A02,083655,Staff,11,0,50,39
1650049069649,CSE 20,A01,083657,Staff,58,0,80,22
1650049075674,CSE 30,A01,083084,Eldon; John,0,63,40,40
1650049081700,CSE 100,A01,083659,Cao; Yingjun,0,57,50,50
1650049087728,CSE 134B,A01,083661,Powell; Thomas Allan,1,26,65,64
1650049093757,CSE 140,A01,083663,Staff,8,0,75,67
1650049099780,CSE 140L,A01,083088,Eldon; John,3,0,75,72
1650049105802,CSE 175,A01,083665,Kumar; Rakesh,9,0,25,16
1650049111826,CSE 190,A00,092507,Dubnov; Shlomo,14,0,20,6
1650049117849,ECE 45,A01,083139,Staff,0,12,40,40
1650049123870,ECE 65,A50,083695,Staff,0,3,30,30
1650049129898,ECE 109,A01,091882,Touri; Behrouz,48,0,70,22
1650049135923,ECE 180,A00,083140,Abi Samra; Nicholas Camill,25,0,30,5
1650049135923,ECE 180,B00,083141,Abi Samra; Nicholas Camill,9,0,30,21
1650049141947,MATH 10A,A01,083735,Patchell; Gregory David,12,0,30,18
1650049141947,MATH 10A,A02,083736,Patchell; Gregory David,28,0,30,2
1650049141947,MATH 10A,A03,083737,Patchell; Gregory David,27,0,30,3
1650049147973,MATH 10B,A01,083207,Staff,0,5,30,30
1650049147973,MATH 10B,A02,083208,Staff,0,1,30,30
1650049147973,MATH 10B,B01,083739,Staff,20,0,30,10
1650049147973,MATH 10B,B02,083740,Staff,30,0,30,0
1650049154002,MATH 18,A01,083743,Staff,10,0,30,20
1650049154002,MATH 18,A02,083744,Staff,28,0,30,2
1650049154002,MATH 18,A03,083745,Staff,23,0,30,7
1650049154002,MATH 18,A04,083746,Staff,27,0,30,3
1650049154002,MATH 18,B01,083748,Staff,0,8,30,30
1650049154002,MATH 18,B02,083749,Staff,0,6,30,30
1650049154002,MATH 18,B03,083750,Staff,0,6,30,30
1650049154002,MATH 18,B04,083751,Staff,1,7,30,29
1650049160031,MATH 20A,A01,083754,Staff,26,0,40,14
1650049166053,MATH 20B,A01,083756,Staff,0,6,30,30
1650049166053,MATH 20B,A02,083757,Staff,1,0,30,29
1650049172081,MATH 20C,A01,083760,Staff,0,9,30,30
1650049172081,MATH 20C,A02,083761,Staff,0,12,30,30
1650049172081,MATH 20C,B01,083762,Staff,16,0,30,14
1650049172081,MATH 20C,B02,083763,Staff,28,0,30,2
1650049178104,MATH 20D,A01,083765,Staff,0,2,30,30
1650049178104,MATH 20D,A02,083766,Staff,15,0,30,15
1650049178104,MATH 20D,A03,083767,Staff,28,0,30,2
1650049184131,MATH 20E,A01,083771,Staff,10,0,30,20
1650049184131,MATH 20E,A02,083772,Staff,20,0,30,10
1650049184131,MATH 20E,B01,083773,Staff,1,1,30,29
1650049184131,MATH 20E,B02,083774,Staff,17,0,30,13
1650049190165,MATH 103A,A01,083777,Staff,0,6,30,30
1650049190165,MATH 103A,A02,083778,Staff,0,7,30,30
1650049190165,MATH 103A,B01,083779,Staff,0,8,30,30
1650049190165,MATH 103A,B02,083780,Staff,0,6,30,30
1650049196188,MATH 105,A01,085443,Staff,0,11,30,30
1650049202211,MATH 109,A01,083213,Anzaldo; Leesa B,0,3,30,30
1650049202211,MATH 109,A02,083214,Anzaldo; Leesa B,0,4,30,30
1650049202211,MATH 109,B01,083215,Anzaldo; Leesa B,0,2,30,30
1650049202211,MATH 109,B02,083216,Anzaldo; Leesa B,1,3,30,29
1650049208239,MATH 142A,A01,083219,Chow; Bennett,0,7,30,30
1650049208239,MATH 142A,A02,083220,Chow; Bennett,0,7,30,30
1650049208239,MATH 142A,B01,083221,Chow; Bennett,0,9,30,30
1650049208239,MATH 142A,B02,083222,Chow; Bennett,0,8,30,30
1650049214267,MATH 193A,A01,083224,Staff,0,5,30,30
1650049214267,MATH 193A,A02,083225,Staff,0,4,30,30
1650049214267,MATH 193A,A03,083781,Staff,0,0,30,30
1650049214267,MATH 193A,A04,083782,Staff,9,0,30,21
1650049220289,MATH 197,001,091859,McAuley; Julian John,9998,0,9999,1
1650049226364,COGS 9,A01,083615,Staff,2,17,60,58
1650049232388,COGS 11,A01,083617,Boyle; Mary E. T.,25,0,40,15
1650049238417,COGS 13,A01,083071,Staff,0,28,40,40
1650049244440,COGS 14A,A01,092681,Staff,0,7,100,100
1650049250467,COGS 14B,A01,083073,Cheng; Tzu-Han,0,3,50,50
1650049256513,COGS 17,A01,092677,Staff,34,0,75,41
1650049262549,COGS 100,A01,083619,Staff,0,17,60,60
1650049268580,COGS 101A,A01,083621,Davis; Joshua Daniel,0,16,60,60
1650049274603,COGS 101B,A01,091572,Staff,15,0,60,45
1650049280629,COGS 101C,A01,083625,Delgado; Tania,21,0,30,9
1650049286652,COGS 107A,A01,083627,Boyle; Mary E. T.,1,2,60,59
1650049292678,COGS 118A,A01,083075,Staff,19,0,60,41
1650049298705,CSE 3,A50,083646,Miranda; Gregory Joseph,22,0,38,16
1650049298705,CSE 3,A51,083647,Miranda; Gregory Joseph,37,0,37,0
1650049304729,CSE 8A,A50,083650,Miranda; Gregory Joseph,0,15,40,40
1650049310752,CSE 11,A01,083080,Cao; Yingjun,0,62,40,40
1650049316790,CSE 12,A01,083652,Staff,0,0,100,100
1650049322816,CSE 15L,A01,083654,Staff,0,0,50,50
1650049322816,CSE 15L,A02,083655,Staff,11,0,50,39
1650049328857,CSE 20,A01,083657,Staff,58,0,80,22
1650049334883,CSE 30,A01,083084,Eldon; John,0,63,40,40
1650049340909,CSE 100,A01,083659,Cao; Yingjun,0,57,50,50
1650049346932,CSE 134B,A01,083661,Powell; Thomas Allan,1,26,65,64
1650049352958,CSE 140,A01,083663,Staff,8,0,75,67
1650049358981,CSE 140L,A01,083088,Eldon; John,3,0,75,72
1650049365011,CSE 175,A01,083665,Kumar; Rakesh,9,0,25,16
1650049371047,CSE 190,A00,092507,Dubnov; Shlomo,14,0,20,6
1650049377073,ECE 45,A01,083139,Staff,0,12,40,40
1650049383115,ECE 65,A50,083695,Staff,0,3,30,30
1650049389149,ECE 109,A01,091882,Touri; Behrouz,48,0,70,22
1650049395173,ECE 180,A00,083140,Abi Samra; Nicholas Camill,25,0,30,5
1650049395173,ECE 180,B00,083141,Abi Samra; Nicholas Camill,9,0,30,21
1650049401200,MATH 10A,A01,083735,Patchell; Gregory David,12,0,30,18
1650049401200,MATH 10A,A02,083736,Patchell; Gregory David,28,0,30,2
1650049401200,MATH 10A,A03,083737,Patchell; Gregory David,27,0,30,3
1650049407224,MATH 10B,A01,083207,Staff,0,5,30,30
1650049407224,MATH 10B,A02,083208,Staff,0,1,30,30
1650049407224,MATH 10B,B01,083739,Staff,20,0,30,10
1650049407224,MATH 10B,B02,083740,Staff,30,0,30,0
1650049413255,MATH 18,A01,083743,Staff,10,0,30,20
1650049413255,MATH 18,A02,083744,Staff,28,0,30,2
1650049413255,MATH 18,A03,083745,Staff,23,0,30,7
1650049413255,MATH 18,A04,083746,Staff,27,0,30,3
1650049413255,MATH 18,B01,083748,Staff,0,8,30,30
1650049413255,MATH 18,B02,083749,Staff,0,6,30,30
1650049413255,MATH 18,B03,083750,Staff,0,6,30,30
1650049413255,MATH 18,B04,083751,Staff,1,7,30,29
1650049419278,MATH 20A,A01,083754,Staff,26,0,40,14
1650049425308,MATH 20B,A01,083756,Staff,0,6,30,30
1650049425308,MATH 20B,A02,083757,Staff,1,0,30,29
1650049431335,MATH 20C,A01,083760,Staff,0,9,30,30
1650049431335,MATH 20C,A02,083761,Staff,0,12,30,30
1650049431335,MATH 20C,B01,083762,Staff,16,0,30,14
1650049431335,MATH 20C,B02,083763,Staff,28,0,30,2
1650049437450,MATH 20D,A01,083765,Staff,0,2,30,30
1650049437450,MATH 20D,A02,083766,Staff,15,0,30,15
1650049437450,MATH 20D,A03,083767,Staff,28,0,30,2
1650049443484,MATH 20E,A01,083771,Staff,10,0,30,20
1650049443484,MATH 20E,A02,083772,Staff,20,0,30,10
1650049443484,MATH 20E,B01,083773,Staff,1,1,30,29
1650049443484,MATH 20E,B02,083774,Staff,17,0,30,13
1650049449508,MATH 103A,A01,083777,Staff,0,6,30,30
1650049449508,MATH 103A,A02,083778,Staff,0,7,30,30
1650049449508,MATH 103A,B01,083779,Staff,0,8,30,30
1650049449508,MATH 103A,B02,083780,Staff,0,6,30,30
1650049455530,MATH 105,A01,085443,Staff,0,11,30,30
1650049461559,MATH 109,A01,083213,Anzaldo; Leesa B,0,3,30,30
1650049461559,MATH 109,A02,083214,Anzaldo; Leesa B,0,4,30,30
1650049461559,MATH 109,B01,083215,Anzaldo; Leesa B,0,2,30,30
1650049461559,MATH 109,B02,083216,Anzaldo; Leesa B,1,3,30,29
1650049467608,MATH 142A,A01,083219,Chow; Bennett,0,7,30,30
1650049467608,MATH 142A,A02,083220,Chow; Bennett,0,7,30,30
1650049467608,MATH 142A,B01,083221,Chow; Bennett,0,9,30,30
1650049467608,MATH 142A,B02,083222,Chow; Bennett,0,8,30,30
1650049473635,MATH 193A,A01,083224,Staff,0,5,30,30
1650049473635,MATH 193A,A02,083225,Staff,0,4,30,30
1650049473635,MATH 193A,A03,083781,Staff,0,0,30,30
1650049473635,MATH 193A,A04,083782,Staff,9,0,30,21
1650049479662,MATH 197,001,091859,McAuley; Julian John,9998,0,9999,1
1650049485723,COGS 9,A01,083615,Staff,2,17,60,58
1650049491750,COGS 11,A01,083617,Boyle; Mary E. T.,25,0,40,15
1650049497778,COGS 13,A01,083071,Staff,0,28,40,40
1650049503808,COGS 14A,A01,092681,Staff,0,7,100,100
1650049509841,COGS 14B,A01,083073,Cheng; Tzu-Han,0,3,50,50
1650049515871,COGS 17,A01,092677,Staff,34,0,75,41
1650049521896,COGS 100,A01,083619,Staff,0,17,60,60
1650049527920,COGS 101A,A01,083621,Davis; Joshua Daniel,0,16,60,60
1650049533944,COGS 101B,A01,091572,Staff,15,0,60,45
1650049539978,COGS 101C,A01,083625,Delgado; Tania,21,0,30,9
1650049546005,COGS 107A,A01,083627,Boyle; Mary E. T.,1,2,60,59
1650049552028,COGS 118A,A01,083075,Staff,19,0,60,41
1650049558062,CSE 3,A50,083646,Miranda; Gregory Joseph,22,0,38,16
1650049558062,CSE 3,A51,083647,Miranda; Gregory Joseph,37,0,37,0
1650049564102,CSE 8A,A50,083650,Miranda; Gregory Joseph,0,15,40,40
1650049570129,CSE 11,A01,083080,Cao; Yingjun,0,62,40,40
1650049576159,CSE 12,A01,083652,Staff,0,0,100,100
1650049582189,CSE 15L,A01,083654,Staff,0,0,50,50
1650049582189,CSE 15L,A02,083655,Staff,11,0,50,39
1650049588212,CSE 20,A01,083657,Staff,58,0,80,22
1650049594238,CSE 30,A01,083084,Eldon; John,0,63,40,40
1650049600264,CSE 100,A01,083659,Cao; Yingjun,0,57,50,50
1650049606287,CSE 134B,A01,083661,Powell; Thomas Allan,1,26,65,64
1650049612309,CSE 140,A01,083663,Staff,8,0,75,67
1650049618339,CSE 140L,A01,083088,Eldon; John,3,0,75,72
1650049624363,CSE 175,A01,083665,Kumar; Rakesh,9,0,25,16
1650049630387,CSE 190,A00,092507,Dubnov; Shlomo,14,0,20,6
1650049636411,ECE 45,A01,083139,Staff,0,12,40,40
1650049642437,ECE 65,A50,083695,Staff,0,3,30,30
1650049648475,ECE 109,A01,091882,Touri; Behrouz,48,0,70,22
1650049654502,ECE 180,A00,083140,Abi Samra; Nicholas Camill,25,0,30,5
1650049654502,ECE 180,B00,083141,Abi Samra; Nicholas Camill,9,0,30,21
1650049660534,MATH 10A,A01,083735,Patchell; Gregory David,12,0,30,18
1650049660534,MATH 10A,A02,083736,Patchell; Gregory David,28,0,30,2
1650049660534,MATH 10A,A03,083737,Patchell; Gregory David,27,0,30,3
1650049666563,MATH 10B,A01,083207,Staff,0,5,30,30
1650049666563,MATH 10B,A02,083208,Staff,0,1,30,30
1650049666563,MATH 10B,B01,083739,Staff,20,0,30,10
1650049666563,MATH 10B,B02,083740,Staff,30,0,30,0
1650049672595,MATH 18,A01,083743,Staff,10,0,30,20
1650049672595,MATH 18,A02,083744,Staff,28,0,30,2
1650049672595,MATH 18,A03,083745,Staff,23,0,30,7
1650049672595,MATH 18,A04,083746,Staff,27,0,30,3
1650049672595,MATH 18,B01,083748,Staff,0,8,30,30
1650049672595,MATH 18,B02,083749,Staff,0,6,30,30
1650049672595,MATH 18,B03,083750,Staff,0,6,30,30
1650049672595,MATH 18,B04,083751,Staff,1,7,30,29
1650049678620,MATH 20A,A01,083754,Staff,26,0,40,14
1650049684647,MATH 20B,A01,083756,Staff,0,6,30,30
1650049684647,MATH 20B,A02,083757,Staff,1,0,30,29
1650049690671,MATH 20C,A01,083760,Staff,0,9,30,30
1650049690671,MATH 20C,A02,083761,Staff,0,12,30,30
1650049690671,MATH 20C,B01,083762,Staff,16,0,30,14
1650049690671,MATH 20C,B02,083763,Staff,28,0,30,2
1650049696694,MATH 20D,A01,083765,Staff,0,2,30,30
1650049696694,MATH 20D,A02,083766,Staff,15,0,30,15
1650049696694,MATH 20D,A03,083767,Staff,28,0,30,2
1650049702727,MATH 20E,A01,083771,Staff,10,0,30,20
1650049702727,MATH 20E,A02,083772,Staff,20,0,30,10
1650049702727,MATH 20E,B01,083773,Staff,1,1,30,29
1650049702727,MATH 20E,B02,083774,Staff,17,0,30,13
1650049708751,MATH 103A,A01,083777,Staff,0,6,30,30
1650049708751,MATH 103A,A02,083778,Staff,0,7,30,30
1650049708751,MATH 103A,B01,083779,Staff,0,8,30,30
1650049708751,MATH 103A,B02,083780,Staff,0,6,30,30
1650049714773,MATH 105,A01,085443,Staff,0,11,30,30
1650049720797,MATH 109,A01,083213,Anzaldo; Leesa B,0,3,30,30
1650049720797,MATH 109,A02,083214,Anzaldo; Leesa B,0,4,30,30
1650049720797,MATH 109,B01,083215,Anzaldo; Leesa B,0,2,30,30
1650049720797,MATH 109,B02,083216,Anzaldo; Leesa B,1,3,30,29
1650049726826,MATH 142A,A01,083219,Chow; Bennett,0,8,30,30
1650049726826,MATH 142A,A02,083220,Chow; Bennett,0,7,30,30
1650049726826,MATH 142A,B01,083221,Chow; Bennett,0,9,30,30
1650049726826,MATH 142A,B02,083222,Chow; Bennett,0,9,30,30
1650049732853,MATH 193A,A01,083224,Staff,0,5,30,30
1650049732853,MATH 193A,A02,083225,Staff,0,4,30,30
1650049732853,MATH 193A,A03,083781,Staff,0,0,30,30
1650049732853,MATH 193A,A04,083782,Staff,9,0,30,21
1650049738876,MATH 197,001,091859,McAuley; Julian John,9998,0,9999,1
1650049744937,COGS 9,A01,083615,Staff,2,17,60,58
1650049750960,COGS 11,A01,083617,Boyle; Mary E. T.,25,0,40,15
1650049756987,COGS 13,A01,083071,Staff,0,28,40,40
1650049763020,COGS 14A,A01,092681,Staff,0,7,100,100
1650049769042,COGS 14B,A01,083073,Cheng; Tzu-Han,0,3,50,50
1650049775065,COGS 17,A01,092677,Staff,34,0,75,41
1650049781090,COGS 100,A01,083619,Staff,0,17,60,60
1650049787118,COGS 101A,A01,083621,Davis; Joshua Daniel,0,16,60,60
1650049793139,COGS 101B,A01,091572,Staff,14,0,60,46
1650049799169,COGS 101C,A01,083625,Delgado; Tania,21,0,30,9
1650049805192,COGS 107A,A01,083627,Boyle; Mary E. T.,1,2,60,59
1650049811219,COGS 118A,A01,083075,Staff,19,0,60,41
1650049817244,CSE 3,A50,083646,Miranda; Gregory Joseph,22,0,38,16
1650049817244,CSE 3,A51,083647,Miranda; Gregory Joseph,37,0,37,0
1650049823286,CSE 8A,A50,083650,Miranda; Gregory Joseph,0,15,40,40
1650049829310,CSE 11,A01,083080,Cao; Yingjun,0,62,40,40
1650049835336,CSE 12,A01,083652,Staff,0,0,100,100
1650049841372,CSE 15L,A01,083654,Staff,0,0,50,50
1650049841372,CSE 15L,A02,083655,Staff,11,0,50,39
1650049847395,CSE 20,A01,083657,Staff,58,0,80,22
1650049853418,CSE 30,A01,083084,Eldon; John,0,63,40,40
1650049859441,CSE 100,A01,083659,Cao; Yingjun,0,57,50,50
1650049865471,CSE 134B,A01,083661,Powell; Thomas Allan,1,26,65,64
1650049871500,CSE 140,A01,083663,Staff,8,0,75,67
1650049877525,CSE 140L,A01,083088,Eldon; John,3,0,75,72
1650049883547,CSE 175,A01,083665,Kumar; Rakesh,9,0,25,16
1650049889569,CSE 190,A00,092507,Dubnov; Shlomo,14,0,20,6
1650049895592,ECE 45,A01,083139,Staff,0,12,40,40
1650049901622,ECE 65,A50,083695,Staff,0,3,30,30
1650049907649,ECE 109,A01,091882,Touri; Behrouz,48,0,70,22
1650049913674,ECE 180,A00,083140,Abi Samra; Nicholas Camill,25,0,30,5
1650049913674,ECE 180,B00,083141,Abi Samra; Nicholas Camill,8,0,30,22
1650049919706,MATH 10A,A01,083735,Patchell; Gregory David,12,0,30,18
1650049919706,MATH 10A,A02,083736,Patchell; Gregory David,28,0,30,2
1650049919706,MATH 10A,A03,083737,Patchell; Gregory David,27,0,30,3
1650049925728,MATH 10B,A01,083207,Staff,0,5,30,30
1650049925728,MATH 10B,A02,083208,Staff,0,1,30,30
1650049925728,MATH 10B,B01,083739,Staff,20,0,30,10
1650049925728,MATH 10B,B02,083740,Staff,30,0,30,0
1650049931774,MATH 18,A01,083743,Staff,10,0,30,20
1650049931774,MATH 18,A02,083744,Staff,28,0,30,2
1650049931774,MATH 18,A03,083745,Staff,23,0,30,7
1650049931774,MATH 18,A04,083746,Staff,27,0,30,3
1650049931774,MATH 18,B01,083748,Staff,0,8,30,30
1650049931774,MATH 18,B02,083749,Staff,0,6,30,30
1650049931774,MATH 18,B03,083750,Staff,0,6,30,30
1650049931774,MATH 18,B04,083751,Staff,1,7,30,29
1650049937798,MATH 20A,A01,083754,Staff,26,0,40,14
1650049943822,MATH 20B,A01,083756,Staff,0,6,30,30
1650049943822,MATH 20B,A02,083757,Staff,1,0,30,29
1650049949849,MATH 20C,A01,083760,Staff,0,9,30,30
1650049949849,MATH 20C,A02,083761,Staff,0,12,30,30
1650049949849,MATH 20C,B01,083762,Staff,16,0,30,14
1650049949849,MATH 20C,B02,083763,Staff,28,0,30,2
1650049955882,MATH 20D,A01,083765,Staff,0,2,30,30
1650049955882,MATH 20D,A02,083766,Staff,15,0,30,15
1650049955882,MATH 20D,A03,083767,Staff,28,0,30,2
1650049961909,MATH 20E,A01,083771,Staff,10,0,30,20
1650049961909,MATH 20E,A02,083772,Staff,20,0,30,10
1650049961909,MATH 20E,B01,083773,Staff,1,1,30,29
1650049961909,MATH 20E,B02,083774,Staff,17,0,30,13
1650049967932,MATH 103A,A01,083777,Staff,0,6,30,30
1650049967932,MATH 103A,A02,083778,Staff,0,7,30,30
1650049967932,MATH 103A,B01,083779,Staff,0,8,30,30
1650049967932,MATH 103A,B02,083780,Staff,0,6,30,30
1650049973962,MATH 105,A01,085443,Staff,0,11,30,30
1650049979994,MATH 109,A01,083213,Anzaldo; Leesa B,0,3,30,30
1650049979994,MATH 109,A02,083214,Anzaldo; Leesa B,0,4,30,30
1650049979994,MATH 109,B01,083215,Anzaldo; Leesa B,0,2,30,30
1650049979994,MATH 109,B02,083216,Anzaldo; Leesa B,1,3,30,29
1650049986021,MATH 142A,A01,083219,Chow; Bennett,0,8,30,30
1650049986021,MATH 142A,A02,083220,Chow; Bennett,0,7,30,30
1650049986021,MATH 142A,B01,083221,Chow; Bennett,0,9,30,30
1650049986021,MATH 142A,B02,083222,Chow; Bennett,0,9,30,30
1650049992044,MATH 193A,A01,083224,Staff,0,5,30,30
1650049992044,MATH 193A,A02,083225,Staff,0,4,30,30
1650049992044,MATH 193A,A03,083781,Staff,0,0,30,30
1650049992044,MATH 193A,A04,083782,Staff,9,0,30,21
1650049998066,MATH 197,001,091859,McAuley; Julian John,9998,0,9999,1
1650050004133,COGS 9,A01,083615,Staff,2,17,60,58
1650050010155,COGS 11,A01,083617,Boyle; Mary E. T.,25,0,40,15
1650050016180,COGS 13,A01,083071,Staff,0,28,40,40
1650050022204,COGS 14A,A01,092681,Staff,0,7,100,100
1650050028332,COGS 14B,A01,083073,Cheng; Tzu-Han,0,3,50,50
1650050034357,COGS 17,A01,092677,Staff,35,0,75,40
1650050040381,COGS 100,A01,083619,Staff,0,17,60,60
1650050046416,COGS 101A,A01,083621,Davis; Joshua Daniel,0,16,60,60
1650050052442,COGS 101B,A01,091572,Staff,14,0,60,46
1650050058468,COGS 101C,A01,083625,Delgado; Tania,21,0,30,9
1650050064495,COGS 107A,A01,083627,Boyle; Mary E. T.,1,2,60,59
1650050070521,COGS 118A,A01,083075,Staff,19,0,60,41
1650050076549,CSE 3,A50,083646,Miranda; Gregory Joseph,22,0,38,16
1650050076549,CSE 3,A51,083647,Miranda; Gregory Joseph,37,0,37,0
1650050082579,CSE 8A,A50,083650,Miranda; Gregory Joseph,0,15,40,40
1650050088600,CSE 11,A01,083080,Cao; Yingjun,0,62,40,40
1650050094629,CSE 12,A01,083652,Staff,0,0,100,100
1650050100652,CSE 15L,A01,083654,Staff,0,0,50,50
1650050100652,CSE 15L,A02,083655,Staff,11,0,50,39
1650050106675,CSE 20,A01,083657,Staff,58,0,80,22
1650050112702,CSE 30,A01,083084,Eldon; John,0,63,40,40
1650050118725,CSE 100,A01,083659,Cao; Yingjun,0,57,50,50
1650050124751,CSE 134B,A01,083661,Powell; Thomas Allan,1,26,65,64
1650050130775,CSE 140,A01,083663,Staff,8,0,75,67
1650050136797,CSE 140L,A01,083088,Eldon; John,3,0,75,72
1650050142823,CSE 175,A01,083665,Kumar; Rakesh,9,0,25,16
1650050148848,CSE 190,A00,092507,Dubnov; Shlomo,14,0,20,6
1650050154874,ECE 45,A01,083139,Staff,0,12,40,40
1650050160901,ECE 65,A50,083695,Staff,0,3,30,30
1650050166923,ECE 109,A01,091882,Touri; Behrouz,48,0,70,22
1650050172960,ECE 180,A00,083140,Abi Samra; Nicholas Camill,25,0,30,5
1650050172960,ECE 180,B00,083141,Abi Samra; Nicholas Camill,8,0,30,22
1650050178985,MATH 10A,A01,083735,Patchell; Gregory David,12,0,30,18
1650050178985,MATH 10A,A02,083736,Patchell; Gregory David,28,0,30,2
1650050178985,MATH 10A,A03,083737,Patchell; Gregory David,27,0,30,3
1650050185008,MATH 10B,A01,083207,Staff,0,5,30,30
1650050185008,MATH 10B,A02,083208,Staff,0,1,30,30
1650050185008,MATH 10B,B01,083739,Staff,20,0,30,10
1650050185008,MATH 10B,B02,083740,Staff,30,0,30,0
1650050191031,MATH 18,A01,083743,Staff,10,0,30,20
1650050191031,MATH 18,A02,083744,Staff,28,0,30,2
1650050191031,MATH 18,A03,083745,Staff,23,0,30,7
1650050191031,MATH 18,A04,083746,Staff,27,0,30,3
1650050191031,MATH 18,B01,083748,Staff,0,8,30,30
1650050191031,MATH 18,B02,083749,Staff,0,6,30,30
1650050191031,MATH 18,B03,083750,Staff,0,6,30,30
1650050191031,MATH 18,B04,083751,Staff,1,7,30,29
1650050197060,MATH 20A,A01,083754,Staff,26,0,40,14
1650050203085,MATH 20B,A01,083756,Staff,0,6,30,30
1650050203085,MATH 20B,A02,083757,Staff,1,0,30,29
1650050209125,MATH 20C,A01,083760,Staff,0,9,30,30
1650050209125,MATH 20C,A02,083761,Staff,0,12,30,30
1650050209125,MATH 20C,B01,083762,Staff,16,0,30,14
1650050209125,MATH 20C,B02,083763,Staff,28,0,30,2
1650050215152,MATH 20D,A01,083765,Staff,0,2,30,30
1650050215152,MATH 20D,A02,083766,Staff,15,0,30,15
1650050215152,MATH 20D,A03,083767,Staff,28,0,30,2
1650050221174,MATH 20E,A01,083771,Staff,10,0,30,20
1650050221174,MATH 20E,A02,083772,Staff,20,0,30,10
1650050221174,MATH 20E,B01,083773,Staff,1,1,30,29
1650050221174,MATH 20E,B02,083774,Staff,17,0,30,13
1650050227198,MATH 103A,A01,083777,Staff,0,6,30,30
1650050227198,MATH 103A,A02,083778,Staff,0,7,30,30
1650050227198,MATH 103A,B01,083779,Staff,0,8,30,30
1650050227198,MATH 103A,B02,083780,Staff,0,6,30,30
1650050233219,MATH 105,A01,085443,Staff,0,11,30,30
1650050239243,MATH 109,A01,083213,Anzaldo; Leesa B,0,3,30,30
1650050239243,MATH 109,A02,083214,Anzaldo; Leesa B,0,4,30,30
1650050239243,MATH 109,B01,083215,Anzaldo; Leesa B,0,2,30,30
1650050239243,MATH 109,B02,083216,Anzaldo; Leesa B,1,3,30,29
1650050245266,MATH 142A,A01,083219,Chow; Bennett,0,8,30,30
1650050245266,MATH 142A,A02,083220,Chow; Bennett,0,7,30,30
1650050245266,MATH 142A,B01,083221,Chow; Bennett,0,9,30,30
1650050245266,MATH 142A,B02,083222,Chow; Bennett,0,9,30,30
1650050251292,MATH 193A,A01,083224,Staff,0,5,30,30
1650050251292,MATH 193A,A02,083225,Staff,0,4,30,30
1650050251292,MATH 193A,A03,083781,Staff,0,0,30,30
1650050251292,MATH 193A,A04,083782,Staff,9,0,30,21
1650050257315,MATH 197,001,091859,McAuley; Julian John,9998,0,9999,1
1650050263374,COGS 9,A01,083615,Staff,2,17,60,58
1650050269396,COGS 11,A01,083617,Boyle; Mary E. T.,25,0,40,15
1650050275429,COGS 13,A01,083071,Staff,0,28,40,40
1650050281462,COGS 14A,A01,092681,Staff,0,7,100,100
1650050287490,COGS 14B,A01,083073,Cheng; Tzu-Han,0,3,50,50
1650050293529,COGS 17,A01,092677,Staff,35,0,75,40
1650050299564,COGS 100,A01,083619,Staff,0,17,60,60
1650050305588,COGS 101A,A01,083621,Davis; Joshua Daniel,0,16,60,60
1650050311611,COGS 101B,A01,091572,Staff,14,0,60,46
1650050317634,COGS 101C,A01,083625,Delgado; Tania,21,0,30,9
1650050323657,COGS 107A,A01,083627,Boyle; Mary E. T.,1,2,60,59
1650050329701,COGS 118A,A01,083075,Staff,19,0,60,41
1650050335723,CSE 3,A50,083646,Miranda; Gregory Joseph,22,0,38,16
1650050335723,CSE 3,A51,083647,Miranda; Gregory Joseph,37,0,37,0
1650050341752,CSE 8A,A50,083650,Miranda; Gregory Joseph,0,15,40,40
1650050347774,CSE 11,A01,083080,Cao; Yingjun,0,62,40,40
1650050353804,CSE 12,A01,083652,Staff,0,0,100,100
1650050359841,CSE 15L,A01,083654,Staff,0,0,50,50
1650050359841,CSE 15L,A02,083655,Staff,11,0,50,39
1650050365871,CSE 20,A01,083657,Staff,58,0,80,22
1650050371893,CSE 30,A01,083084,Eldon; John,0,63,40,40
1650050377920,CSE 100,A01,083659,Cao; Yingjun,0,57,50,50
1650050383947,CSE 134B,A01,083661,Powell; Thomas Allan,1,26,65,64
1650050389970,CSE 140,A01,083663,Staff,8,0,75,67
1650050395997,CSE 140L,A01,083088,Eldon; John,3,0,75,72
1650050402021,CSE 175,A01,083665,Kumar; Rakesh,9,0,25,16
1650050408045,CSE 190,A00,092507,Dubnov; Shlomo,14,0,20,6
1650050414071,ECE 45,A01,083139,Staff,0,12,40,40
1650050420098,ECE 65,A50,083695,Staff,0,3,30,30
1650050426119,ECE 109,A01,091882,Touri; Behrouz,48,0,70,22
1650050432142,ECE 180,A00,083140,Abi Samra; Nicholas Camill,25,0,30,5
1650050432142,ECE 180,B00,083141,Abi Samra; Nicholas Camill,8,0,30,22
1650050438164,MATH 10A,A01,083735,Patchell; Gregory David,12,0,30,18
1650050438164,MATH 10A,A02,083736,Patchell; Gregory David,28,0,30,2
1650050438164,MATH 10A,A03,083737,Patchell; Gregory David,27,0,30,3
1650050444188,MATH 10B,A01,083207,Staff,0,5,30,30
1650050444188,MATH 10B,A02,083208,Staff,0,1,30,30
1650050444188,MATH 10B,B01,083739,Staff,20,0,30,10
1650050444188,MATH 10B,B02,083740,Staff,30,0,30,0
1650050450226,MATH 18,A01,083743,Staff,10,0,30,20
1650050450226,MATH 18,A02,083744,Staff,28,0,30,2
1650050450226,MATH 18,A03,083745,Staff,23,0,30,7
1650050450226,MATH 18,A04,083746,Staff,27,0,30,3
1650050450226,MATH 18,B01,083748,Staff,0,8,30,30
1650050450226,MATH 18,B02,083749,Staff,0,6,30,30
1650050450226,MATH 18,B03,083750,Staff,0,6,30,30
1650050450226,MATH 18,B04,083751,Staff,1,7,30,29
1650050456248,MATH 20A,A01,083754,Staff,26,0,40,14
1650050462271,MATH 20B,A01,083756,Staff,0,6,30,30
1650050462271,MATH 20B,A02,083757,Staff,1,0,30,29
1650050468302,MATH 20C,A01,083760,Staff,0,9,30,30
1650050468302,MATH 20C,A02,083761,Staff,0,12,30,30
1650050468302,MATH 20C,B01,083762,Staff,16,0,30,14
1650050468302,MATH 20C,B02,083763,Staff,28,0,30,2
1650050474327,MATH 20D,A01,083765,Staff,0,2,30,30
1650050474327,MATH 20D,A02,083766,Staff,15,0,30,15
1650050474327,MATH 20D,A03,083767,Staff,28,0,30,2
1650050480354,MATH 20E,A01,083771,Staff,10,0,30,20
1650050480354,MATH 20E,A02,083772,Staff,20,0,30,10
1650050480354,MATH 20E,B01,083773,Staff,1,1,30,29
1650050480354,MATH 20E,B02,083774,Staff,17,0,30,13
1650050486377,MATH 103A,A01,083777,Staff,0,6,30,30
1650050486377,MATH 103A,A02,083778,Staff,0,7,30,30
1650050486377,MATH 103A,B01,083779,Staff,0,8,30,30
1650050486377,MATH 103A,B02,083780,Staff,0,6,30,30
1650050492402,MATH 105,A01,085443,Staff,0,11,30,30
1650050498463,MATH 109,A01,083213,Anzaldo; Leesa B,0,3,30,30
1650050498463,MATH 109,A02,083214,Anzaldo; Leesa B,0,4,30,30
1650050498463,MATH 109,B01,083215,Anzaldo; Leesa B,0,2,30,30
1650050498463,MATH 109,B02,083216,Anzaldo; Leesa B,1,3,30,29
1650050504497,MATH 142A,A01,083219,Chow; Bennett,0,8,30,30
1650050504497,MATH 142A,A02,083220,Chow; Bennett,0,7,30,30
1650050504497,MATH 142A,B01,083221,Chow; Bennett,0,9,30,30
1650050504497,MATH 142A,B02,083222,Chow; Bennett,0,9,30,30
1650050510523,MATH 193A,A01,083224,Staff,0,5,30,30
1650050510523,MATH 193A,A02,083225,Staff,0,4,30,30
1650050510523,MATH 193A,A03,083781,Staff,0,0,30,30
1650050510523,MATH 193A,A04,083782,Staff,9,0,30,21
1650050516559,MATH 197,001,091859,McAuley; Julian John,9998,0,9999,1
1650050522620,COGS 9,A01,083615,Staff,2,17,60,58
1650050528643,COGS 11,A01,083617,Boyle; Mary E. T.,25,0,40,15
1650050534665,COGS 13,A01,083071,Staff,0,28,40,40
1650050540692,COGS 14A,A01,092681,Staff,0,7,100,100
1650050546718,COGS 14B,A01,083073,Cheng; Tzu-Han,0,3,50,50
1650050552762,COGS 17,A01,092677,Staff,35,0,75,40
1650050558823,COGS 100,A01,083619,Staff,0,17,60,60
1650050564855,COGS 101A,A01,083621,Davis; Joshua Daniel,0,16,60,60
1650050570878,COGS 101B,A01,091572,Staff,14,0,60,46
1650050576901,COGS 101C,A01,083625,Delgado; Tania,21,0,30,9
1650050582927,COGS 107A,A01,083627,Boyle; Mary E. T.,1,2,60,59
1650050588955,COGS 118A,A01,083075,Staff,19,0,60,41
1650050594982,CSE 3,A50,083646,Miranda; Gregory Joseph,22,0,38,16
1650050594982,CSE 3,A51,083647,Miranda; Gregory Joseph,37,0,37,0
1650050601009,CSE 8A,A50,083650,Miranda; Gregory Joseph,0,15,40,40
1650050607031,CSE 11,A01,083080,Cao; Yingjun,0,62,40,40
1650050613057,CSE 12,A01,083652,Staff,0,0,100,100
1650050619085,CSE 15L,A01,083654,Staff,0,0,50,50
1650050619085,CSE 15L,A02,083655,Staff,11,0,50,39
1650050625189,CSE 20,A01,083657,Staff,58,0,80,22
1650050631212,CSE 30,A01,083084,Eldon; John,0,63,40,40
1650050637235,CSE 100,A01,083659,Cao; Yingjun,0,57,50,50
1650050643266,CSE 134B,A01,083661,Powell; Thomas Allan,1,26,65,64
1650050649289,CSE 140,A01,083663,Staff,8,0,75,67
1650050655312,CSE 140L,A01,083088,Eldon; John,3,0,75,72
1650050661337,CSE 175,A01,083665,Kumar; Rakesh,9,0,25,16
1650050667362,CSE 190,A00,092507,Dubnov; Shlomo,14,0,20,6
1650050673401,ECE 45,A01,083139,Staff,0,12,40,40
1650050679424,ECE 65,A50,083695,Staff,0,3,30,30
1650050685450,ECE 109,A01,091882,Touri; Behrouz,48,0,70,22
1650050691473,ECE 180,A00,083140,Abi Samra; Nicholas Camill,25,0,30,5
1650050691473,ECE 180,B00,083141,Abi Samra; Nicholas Camill,8,0,30,22
1650050697495,MATH 10A,A01,083735,Patchell; Gregory David,12,0,30,18
1650050697495,MATH 10A,A02,083736,Patchell; Gregory David,28,0,30,2
1650050697495,MATH 10A,A03,083737,Patchell; Gregory David,27,0,30,3
1650050703519,MATH 10B,A01,083207,Staff,0,5,30,30
1650050703519,MATH 10B,A02,083208,Staff,0,1,30,30
1650050703519,MATH 10B,B01,083739,Staff,20,0,30,10
1650050703519,MATH 10B,B02,083740,Staff,30,0,30,0
1650050709542,MATH 18,A01,083743,Staff,10,0,30,20
1650050709542,MATH 18,A02,083744,Staff,28,0,30,2
1650050709542,MATH 18,A03,083745,Staff,23,0,30,7
1650050709542,MATH 18,A04,083746,Staff,27,0,30,3
1650050709542,MATH 18,B01,083748,Staff,0,8,30,30
1650050709542,MATH 18,B02,083749,Staff,1,6,30,29
1650050709542,MATH 18,B03,083750,Staff,0,6,30,30
1650050709542,MATH 18,B04,083751,Staff,1,7,30,29
1650050715567,MATH 20A,A01,083754,Staff,26,0,40,14
1650050721595,MATH 20B,A01,083756,Staff,0,6,30,30
1650050721595,MATH 20B,A02,083757,Staff,1,0,30,29
1650050727625,MATH 20C,A01,083760,Staff,0,9,30,30
1650050727625,MATH 20C,A02,083761,Staff,0,12,30,30
1650050727625,MATH 20C,B01,083762,Staff,16,0,30,14
1650050727625,MATH 20C,B02,083763,Staff,28,0,30,2
1650050733649,MATH 20D,A01,083765,Staff,0,2,30,30
1650050733649,MATH 20D,A02,083766,Staff,15,0,30,15
1650050733649,MATH 20D,A03,083767,Staff,28,0,30,2
1650050739676,MATH 20E,A01,083771,Staff,10,0,30,20
1650050739676,MATH 20E,A02,083772,Staff,20,0,30,10
1650050739676,MATH 20E,B01,083773,Staff,1,1,30,29
1650050739676,MATH 20E,B02,083774,Staff,17,0,30,13
1650050745702,MATH 103A,A01,083777,Staff,0,6,30,30
1650050745702,MATH 103A,A02,083778,Staff,0,7,30,30
1650050745702,MATH 103A,B01,083779,Staff,0,8,30,30
1650050745702,MATH 103A,B02,083780,Staff,0,6,30,30
1650050751724,MATH 105,A01,085443,Staff,0,11,30,30
1650050757746,MATH 109,A01,083213,Anzaldo; Leesa B,0,3,30,30
1650050757746,MATH 109,A02,083214,Anzaldo; Leesa B,0,4,30,30
1650050757746,MATH 109,B01,083215,Anzaldo; Leesa B,0,2,30,30
1650050757746,MATH 109,B02,083216,Anzaldo; Leesa B,1,3,30,29
1650050763769,MATH 142A,A01,083219,Chow; Bennett,0,8,30,30
1650050763769,MATH 142A,A02,083220,Chow; Bennett,0,7,30,30
1650050763769,MATH 142A,B01,083221,Chow; Bennett,0,9,30,30
1650050763769,MATH 142A,B02,083222,Chow; Bennett,0,9,30,30
1650050769799,MATH 193A,A01,083224,Staff,0,5,30,30
1650050769799,MATH 193A,A02,083225,Staff,0,4,30,30
1650050769799,MATH 193A,A03,083781,Staff,0,0,30,30
1650050769799,MATH 193A,A04,083782,Staff,9,0,30,21
1650050775833,MATH 197,001,091859,McAuley; Julian John,9998,0,9999,1
1650050781920,COGS 9,A01,083615,Staff,2,17,60,58
1650050787949,COGS 11,A01,083617,Boyle; Mary E. T.,25,0,40,15
1650050793972,COGS 13,A01,083071,Staff,0,28,40,40
1650050799998,COGS 14A,A01,092681,Staff,0,7,100,100
1650050806021,COGS 14B,A01,083073,Cheng; Tzu-Han,0,3,50,50
1650050812047,COGS 17,A01,092677,Staff,35,0,75,40
1650050818073,COGS 100,A01,083619,Staff,0,17,60,60
1650050824094,COGS 101A,A01,083621,Davis; Joshua Daniel,0,16,60,60
1650050830129,COGS 101B,A01,091572,Staff,14,0,60,46
1650050836152,COGS 101C,A01,083625,Delgado; Tania,21,0,30,9
1650050842176,COGS 107A,A01,083627,Boyle; Mary E. T.,1,2,60,59
1650050848203,COGS 118A,A01,083075,Staff,19,0,60,41
1650050854232,CSE 3,A50,083646,Miranda; Gregory Joseph,22,0,38,16
1650050854232,CSE 3,A51,083647,Miranda; Gregory Joseph,37,0,37,0
1650050860262,CSE 8A,A50,083650,Miranda; Gregory Joseph,0,15,40,40
1650050866295,CSE 11,A01,083080,Cao; Yingjun,0,62,40,40
1650050872318,CSE 12,A01,083652,Staff,0,0,100,100
1650050878344,CSE 15L,A01,083654,Staff,0,0,50,50
1650050878344,CSE 15L,A02,083655,Staff,11,0,50,39
1650050884370,CSE 20,A01,083657,Staff,58,0,80,22
1650050890399,CSE 30,A01,083084,Eldon; John,0,63,40,40
1650050896430,CSE 100,A01,083659,Cao; Yingjun,0,57,50,50
1650050902460,CSE 134B,A01,083661,Powell; Thomas Allan,1,26,65,64
1650050908484,CSE 140,A01,083663,Staff,8,0,75,67
1650050914515,CSE 140L,A01,083088,Eldon; John,3,0,75,72
1650050920540,CSE 175,A01,083665,Kumar; Rakesh,9,0,25,16
1650050926563,CSE 190,A00,092507,Dubnov; Shlomo,14,0,20,6
1650050932590,ECE 45,A01,083139,Staff,0,12,40,40
1650050938617,ECE 65,A50,083695,Staff,0,3,30,30
1650050944642,ECE 109,A01,091882,Touri; Behrouz,48,0,70,22
1650050950790,ECE 180,A00,083140,Abi Samra; Nicholas Camill,25,0,30,5
1650050950790,ECE 180,B00,083141,Abi Samra; Nicholas Camill,8,0,30,22
1650050956824,MATH 10A,A01,083735,Patchell; Gregory David,12,0,30,18
1650050956824,MATH 10A,A02,083736,Patchell; Gregory David,28,0,30,2
1650050956824,MATH 10A,A03,083737,Patchell; Gregory David,27,0,30,3
1650050962853,MATH 10B,A01,083207,Staff,0,5,30,30
1650050962853,MATH 10B,A02,083208,Staff,0,1,30,30
1650050962853,MATH 10B,B01,083739,Staff,20,0,30,10
1650050962853,MATH 10B,B02,083740,Staff,30,0,30,0
1650050968884,MATH 18,A01,083743,Staff,10,0,30,20
1650050968884,MATH 18,A02,083744,Staff,28,0,30,2
1650050968884,MATH 18,A03,083745,Staff,23,0,30,7
1650050968884,MATH 18,A04,083746,Staff,27,0,30,3
1650050968884,MATH 18,B01,083748,Staff,0,8,30,30
1650050968884,MATH 18,B02,083749,Staff,1,6,30,29
1650050968884,MATH 18,B03,083750,Staff,0,6,30,30
1650050968884,MATH 18,B04,083751,Staff,1,7,30,29
1650050974909,MATH 20A,A01,083754,Staff,26,0,40,14
1650050980932,MATH 20B,A01,083756,Staff,0,6,30,30
1650050980932,MATH 20B,A02,083757,Staff,1,0,30,29
1650050986963,MATH 20C,A01,083760,Staff,0,9,30,30
1650050986963,MATH 20C,A02,083761,Staff,0,12,30,30
1650050986963,MATH 20C,B01,083762,Staff,16,0,30,14
1650050986963,MATH 20C,B02,083763,Staff,28,0,30,2
1650050992993,MATH 20D,A01,083765,Staff,0,2,30,30
1650050992993,MATH 20D,A02,083766,Staff,15,0,30,15
1650050992993,MATH 20D,A03,083767,Staff,28,0,30,2
1650050999017,MATH 20E,A01,083771,Staff,10,0,30,20
1650050999017,MATH 20E,A02,083772,Staff,20,0,30,10
1650050999017,MATH 20E,B01,083773,Staff,1,1,30,29
1650050999017,MATH 20E,B02,083774,Staff,17,0,30,13
1650051005044,MATH 103A,A01,083777,Staff,0,6,30,30
1650051005044,MATH 103A,A02,083778,Staff,0,7,30,30
1650051005044,MATH 103A,B01,083779,Staff,0,8,30,30
1650051005044,MATH 103A,B02,083780,Staff,0,6,30,30
1650051011069,MATH 105,A01,085443,Staff,0,11,30,30
1650051017091,MATH 109,A01,083213,Anzaldo; Leesa B,0,3,30,30
1650051017091,MATH 109,A02,083214,Anzaldo; Leesa B,0,4,30,30
1650051017091,MATH 109,B01,083215,Anzaldo; Leesa B,0,2,30,30
1650051017091,MATH 109,B02,083216,Anzaldo; Leesa B,1,3,30,29
1650051023121,MATH 142A,A01,083219,Chow; Bennett,0,8,30,30
1650051023121,MATH 142A,A02,083220,Chow; Bennett,0,7,30,30
1650051023121,MATH 142A,B01,083221,Chow; Bennett,0,9,30,30
1650051023121,MATH 142A,B02,083222,Chow; Bennett,0,9,30,30
1650051029147,MATH 193A,A01,083224,Staff,0,5,30,30
1650051029147,MATH 193A,A02,083225,Staff,0,4,30,30
1650051029147,MATH 193A,A03,083781,Staff,0,0,30,30
1650051029147,MATH 193A,A04,083782,Staff,9,0,30,21
1650051035169,MATH 197,001,091859,McAuley; Julian John,9998,0,9999,1
1650051041219,COGS 9,A01,083615,Staff,2,17,60,58
1650051047250,COGS 11,A01,083617,Boyle; Mary E. T.,25,0,40,15
1650051053275,COGS 13,A01,083071,Staff,0,28,40,40
1650051059300,COGS 14A,A01,092681,Staff,0,8,100,100
1650051065334,COGS 14B,A01,083073,Cheng; Tzu-Han,0,3,50,50
1650051071358,COGS 17,A01,092677,Staff,35,0,75,40
1650051077384,COGS 100,A01,083619,Staff,0,17,60,60
1650051083408,COGS 101A,A01,083621,Davis; Joshua Daniel,0,16,60,60
1650051089439,COGS 101B,A01,091572,Staff,14,0,60,46
1650051095476,COGS 101C,A01,083625,Delgado; Tania,21,0,30,9
1650051101500,COGS 107A,A01,083627,Boyle; Mary E. T.,1,2,60,59
1650051107526,COGS 118A,A01,083075,Staff,19,0,60,41
1650051113554,CSE 3,A50,083646,Miranda; Gregory Joseph,22,0,38,16
1650051113554,CSE 3,A51,083647,Miranda; Gregory Joseph,37,0,37,0
1650051119584,CSE 8A,A50,083650,Miranda; Gregory Joseph,0,15,40,40
1650051125611,CSE 11,A01,083080,Cao; Yingjun,0,62,40,40
1650051131632,CSE 12,A01,083652,Staff,0,0,100,100
1650051137655,CSE 15L,A01,083654,Staff,0,0,50,50
1650051137655,CSE 15L,A02,083655,Staff,11,0,50,39
1650051143686,CSE 20,A01,083657,Staff,58,0,80,22
1650051149713,CSE 30,A01,083084,Eldon; John,0,63,40,40
1650051155734,CSE 100,A01,083659,Cao; Yingjun,0,57,50,50
1650051161768,CSE 134B,A01,083661,Powell; Thomas Allan,1,26,65,64
1650051167794,CSE 140,A01,083663,Staff,8,0,75,67
1650051173821,CSE 140L,A01,083088,Eldon; John,3,0,75,72
1650051179844,CSE 175,A01,083665,Kumar; Rakesh,9,0,25,16
1650051185868,CSE 190,A00,092507,Dubnov; Shlomo,14,0,20,6
1650051191892,ECE 45,A01,083139,Staff,0,12,40,40
1650051197931,ECE 65,A50,083695,Staff,0,3,30,30
1650051203960,ECE 109,A01,091882,Touri; Behrouz,48,0,70,22
1650051209985,ECE 180,A00,083140,Abi Samra; Nicholas Camill,25,0,30,5
1650051209985,ECE 180,B00,083141,Abi Samra; Nicholas Camill,8,0,30,22
1650051216012,MATH 10A,A01,083735,Patchell; Gregory David,12,0,30,18
1650051216012,MATH 10A,A02,083736,Patchell; Gregory David,28,0,30,2
1650051216012,MATH 10A,A03,083737,Patchell; Gregory David,27,0,30,3
1650051222127,MATH 10B,A01,083207,Staff,0,5,30,30
1650051222127,MATH 10B,A02,083208,Staff,0,1,30,30
1650051222127,MATH 10B,B01,083739,Staff,20,0,30,10
1650051222127,MATH 10B,B02,083740,Staff,30,0,30,0
1650051228159,MATH 18,A01,083743,Staff,10,0,30,20
1650051228159,MATH 18,A02,083744,Staff,28,0,30,2
1650051228159,MATH 18,A03,083745,Staff,23,0,30,7
1650051228159,MATH 18,A04,083746,Staff,27,0,30,3
1650051228159,MATH 18,B01,083748,Staff,0,8,30,30
1650051228159,MATH 18,B02,083749,Staff,1,6,30,29
1650051228159,MATH 18,B03,083750,Staff,0,6,30,30
1650051228159,MATH 18,B04,083751,Staff,1,7,30,29
1650051234182,MATH 20A,A01,083754,Staff,26,0,40,14
1650051240205,MATH 20B,A01,083756,Staff,0,6,30,30
1650051240205,MATH 20B,A02,083757,Staff,1,0,30,29
1650051246233,MATH 20C,A01,083760,Staff,0,9,30,30
1650051246233,MATH 20C,A02,083761,Staff,0,12,30,30
1650051246233,MATH 20C,B01,083762,Staff,16,0,30,14
1650051246233,MATH 20C,B02,083763,Staff,28,0,30,2
1650051252259,MATH 20D,A01,083765,Staff,0,2,30,30
1650051252259,MATH 20D,A02,083766,Staff,15,0,30,15
1650051252259,MATH 20D,A03,083767,Staff,28,0,30,2
1650051258285,MATH 20E,A01,083771,Staff,10,0,30,20
1650051258285,MATH 20E,A02,083772,Staff,20,0,30,10
1650051258285,MATH 20E,B01,083773,Staff,1,1,30,29
1650051258285,MATH 20E,B02,083774,Staff,17,0,30,13
1650051264310,MATH 103A,A01,083777,Staff,0,6,30,30
1650051264310,MATH 103A,A02,083778,Staff,0,7,30,30
1650051264310,MATH 103A,B01,083779,Staff,0,8,30,30
1650051264310,MATH 103A,B02,083780,Staff,0,6,30,30
1650051270333,MATH 105,A01,085443,Staff,0,11,30,30
1650051276359,MATH 109,A01,083213,Anzaldo; Leesa B,0,3,30,30
1650051276359,MATH 109,A02,083214,Anzaldo; Leesa B,0,4,30,30
1650051276359,MATH 109,B01,083215,Anzaldo; Leesa B,0,2,30,30
1650051276359,MATH 109,B02,083216,Anzaldo; Leesa B,1,3,30,29
1650051282388,MATH 142A,A01,083219,Chow; Bennett,0,8,30,30
1650051282388,MATH 142A,A02,083220,Chow; Bennett,0,7,30,30
1650051282388,MATH 142A,B01,083221,Chow; Bennett,0,9,30,30
1650051282388,MATH 142A,B02,083222,Chow; Bennett,0,9,30,30
1650051288415,MATH 193A,A01,083224,Staff,0,5,30,30
1650051288415,MATH 193A,A02,083225,Staff,0,4,30,30
1650051288415,MATH 193A,A03,083781,Staff,0,0,30,30
1650051288415,MATH 193A,A04,083782,Staff,9,0,30,21
1650051294453,MATH 197,001,091859,McAuley; Julian John,9998,0,9999,1
1650051300505,COGS 9,A01,083615,Staff,2,17,60,58
1650051306528,COGS 11,A01,083617,Boyle; Mary E. T.,25,0,40,15
1650051312551,COGS 13,A01,083071,Staff,0,28,40,40
1650051318593,COGS 14A,A01,092681,Staff,0,8,100,100
1650051324614,COGS 14B,A01,083073,Cheng; Tzu-Han,0,3,50,50
1650051330640,COGS 17,A01,092677,Staff,35,0,75,40
1650051336665,COGS 100,A01,083619,Staff,0,17,60,60
1650051342695,COGS 101A,A01,083621,Davis; Joshua Daniel,0,16,60,60
1650051348726,COGS 101B,A01,091572,Staff,14,0,60,46
1650051354756,COGS 101C,A01,083625,Delgado; Tania,21,0,30,9
1650051360781,COGS 107A,A01,083627,Boyle; Mary E. T.,1,2,60,59
1650051366805,COGS 118A,A01,083075,Staff,19,0,60,41
1650051372829,CSE 3,A50,083646,Miranda; Gregory Joseph,22,0,38,16
1650051372829,CSE 3,A51,083647,Miranda; Gregory Joseph,37,0,37,0
1650051378859,CSE 8A,A50,083650,Miranda; Gregory Joseph,0,15,40,40
1650051384894,CSE 11,A01,083080,Cao; Yingjun,0,62,40,40
1650051390924,CSE 12,A01,083652,Staff,0,0,100,100
1650051396948,CSE 15L,A01,083654,Staff,0,0,50,50
1650051396948,CSE 15L,A02,083655,Staff,11,0,50,39
1650051402974,CSE 20,A01,083657,Staff,58,0,80,22
1650051409020,CSE 30,A01,083084,Eldon; John,0,63,40,40
1650051415047,CSE 100,A01,083659,Cao; Yingjun,0,57,50,50
1650051421073,CSE 134B,A01,083661,Powell; Thomas Allan,1,27,65,64
1650051427097,CSE 140,A01,083663,Staff,8,0,75,67
1650051433119,CSE 140L,A01,083088,Eldon; John,3,0,75,72
1650051439150,CSE 175,A01,083665,Kumar; Rakesh,9,0,25,16
1650051445172,CSE 190,A00,092507,Dubnov; Shlomo,14,0,20,6
1650051451199,ECE 45,A01,083139,Staff,0,12,40,40
1650051457224,ECE 65,A50,083695,Staff,0,3,30,30
1650051463263,ECE 109,A01,091882,Touri; Behrouz,48,0,70,22
1650051469285,ECE 180,A00,083140,Abi Samra; Nicholas Camill,25,0,30,5
1650051469285,ECE 180,B00,083141,Abi Samra; Nicholas Camill,8,0,30,22
1650051475310,MATH 10A,A01,083735,Patchell; Gregory David,12,0,30,18
1650051475310,MATH 10A,A02,083736,Patchell; Gregory David,28,0,30,2
1650051475310,MATH 10A,A03,083737,Patchell; Gregory David,27,0,30,3
1650051481334,MATH 10B,A01,083207,Staff,0,5,30,30
1650051481334,MATH 10B,A02,083208,Staff,0,1,30,30
1650051481334,MATH 10B,B01,083739,Staff,20,0,30,10
1650051481334,MATH 10B,B02,083740,Staff,30,0,30,0
1650051487357,MATH 18,A01,083743,Staff,10,0,30,20
1650051487357,MATH 18,A02,083744,Staff,28,0,30,2
1650051487357,MATH 18,A03,083745,Staff,23,0,30,7
1650051487357,MATH 18,A04,083746,Staff,27,0,30,3
1650051487357,MATH 18,B01,083748,Staff,0,8,30,30
1650051487357,MATH 18,B02,083749,Staff,1,6,30,29
1650051487357,MATH 18,B03,083750,Staff,0,6,30,30
1650051487357,MATH 18,B04,083751,Staff,1,7,30,29
1650051493385,MATH 20A,A01,083754,Staff,26,0,40,14
1650051499409,MATH 20B,A01,083756,Staff,0,6,30,30
1650051499409,MATH 20B,A02,083757,Staff,1,0,30,29
1650051505433,MATH 20C,A01,083760,Staff,0,9,30,30
1650051505433,MATH 20C,A02,083761,Staff,0,12,30,30
1650051505433,MATH 20C,B01,083762,Staff,16,0,30,14
1650051505433,MATH 20C,B02,083763,Staff,28,0,30,2
1650051511457,MATH 20D,A01,083765,Staff,0,2,30,30
1650051511457,MATH 20D,A02,083766,Staff,15,0,30,15
1650051511457,MATH 20D,A03,083767,Staff,28,0,30,2
1650051517487,MATH 20E,A01,083771,Staff,10,0,30,20
1650051517487,MATH 20E,A02,083772,Staff,20,0,30,10
1650051517487,MATH 20E,B01,083773,Staff,1,1,30,29
1650051517487,MATH 20E,B02,083774,Staff,17,0,30,13
1650051523510,MATH 103A,A01,083777,Staff,0,6,30,30
1650051523510,MATH 103A,A02,083778,Staff,0,7,30,30
1650051523510,MATH 103A,B01,083779,Staff,0,8,30,30
1650051523510,MATH 103A,B02,083780,Staff,0,6,30,30
1650051529536,MATH 105,A01,085443,Staff,0,11,30,30
1650051535559,MATH 109,A01,083213,Anzaldo; Leesa B,0,3,30,30
1650051535559,MATH 109,A02,083214,Anzaldo; Leesa B,0,4,30,30
1650051535559,MATH 109,B01,083215,Anzaldo; Leesa B,0,2,30,30
1650051535559,MATH 109,B02,083216,Anzaldo; Leesa B,1,3,30,29
1650051541584,MATH 142A,A01,083219,Chow; Bennett,0,8,30,30
1650051541584,MATH 142A,A02,083220,Chow; Bennett,0,7,30,30
1650051541584,MATH 142A,B01,083221,Chow; Bennett,0,9,30,30
1650051541584,MATH 142A,B02,083222,Chow; Bennett,0,9,30,30
1650051547606,MATH 193A,A01,083224,Staff,0,5,30,30
1650051547606,MATH 193A,A02,083225,Staff,0,4,30,30
1650051547606,MATH 193A,A03,083781,Staff,0,0,30,30
1650051547606,MATH 193A,A04,083782,Staff,9,0,30,21
1650051553628,MATH 197,001,091859,McAuley; Julian John,9998,0,9999,1
1650051559680,COGS 9,A01,083615,Staff,2,17,60,58
1650051565703,COGS 11,A01,083617,Boyle; Mary E. T.,25,0,40,15
1650051571733,COGS 13,A01,083071,Staff,0,28,40,40
1650051577755,COGS 14A,A01,092681,Staff,0,8,100,100
1650051583779,COGS 14B,A01,083073,Cheng; Tzu-Han,0,3,50,50
1650051589809,COGS 17,A01,092677,Staff,35,0,75,40
1650051595833,COGS 100,A01,083619,Staff,0,17,60,60
1650051601861,COGS 101A,A01,083621,Davis; Joshua Daniel,0,16,60,60
1650051607888,COGS 101B,A01,091572,Staff,14,0,60,46
1650051613919,COGS 101C,A01,083625,Delgado; Tania,21,0,30,9
1650051619942,COGS 107A,A01,083627,Boyle; Mary E. T.,1,2,60,59
1650051625964,COGS 118A,A01,083075,Staff,19,0,60,41
1650051631987,CSE 3,A50,083646,Miranda; Gregory Joseph,22,0,38,16
1650051631987,CSE 3,A51,083647,Miranda; Gregory Joseph,37,0,37,0
1650051638010,CSE 8A,A50,083650,Miranda; Gregory Joseph,0,15,40,40
1650051644044,CSE 11,A01,083080,Cao; Yingjun,0,62,40,40
1650051650072,CSE 12,A01,083652,Staff,0,0,100,100
1650051656095,CSE 15L,A01,083654,Staff,0,0,50,50
1650051656095,CSE 15L,A02,083655,Staff,11,0,50,39
1650051662133,CSE 20,A01,083657,Staff,58,0,80,22
1650051668248,CSE 30,A01,083084,Eldon; John,0,63,40,40
1650051674279,CSE 100,A01,083659,Cao; Yingjun,0,57,50,50
1650051680301,CSE 134B,A01,083661,Powell; Thomas Allan,1,27,65,64
1650051686327,CSE 140,A01,083663,Staff,8,0,75,67
1650051692351,CSE 140L,A01,083088,Eldon; John,3,0,75,72
1650051698379,CSE 175,A01,083665,Kumar; Rakesh,9,0,25,16
1650051704402,CSE 190,A00,092507,Dubnov; Shlomo,14,0,20,6
1650051710428,ECE 45,A01,083139,Staff,0,12,40,40
1650051716457,ECE 65,A50,083695,Staff,0,3,30,30
1650051722483,ECE 109,A01,091882,Touri; Behrouz,48,0,70,22
1650051728511,ECE 180,A00,083140,Abi Samra; Nicholas Camill,25,0,30,5
1650051728511,ECE 180,B00,083141,Abi Samra; Nicholas Camill,8,0,30,22
1650051734533,MATH 10A,A01,083735,Patchell; Gregory David,12,0,30,18
1650051734533,MATH 10A,A02,083736,Patchell; Gregory David,28,0,30,2
1650051734533,MATH 10A,A03,083737,Patchell; Gregory David,27,0,30,3
1650051740556,MATH 10B,A01,083207,Staff,0,5,30,30
1650051740556,MATH 10B,A02,083208,Staff,0,1,30,30
1650051740556,MATH 10B,B01,083739,Staff,20,0,30,10
1650051740556,MATH 10B,B02,083740,Staff,30,0,30,0
1650051746577,MATH 18,A01,083743,Staff,10,0,30,20
1650051746577,MATH 18,A02,083744,Staff,28,0,30,2
1650051746577,MATH 18,A03,083745,Staff,23,0,30,7
1650051746577,MATH 18,A04,083746,Staff,27,0,30,3
1650051746577,MATH 18,B01,083748,Staff,0,8,30,30
1650051746577,MATH 18,B02,083749,Staff,1,6,30,29
1650051746577,MATH 18,B03,083750,Staff,0,6,30,30
1650051746577,MATH 18,B04,083751,Staff,1,7,30,29
1650051752607,MATH 20A,A01,083754,Staff,26,0,40,14
1650051758637,MATH 20B,A01,083756,Staff,0,6,30,30
1650051758637,MATH 20B,A02,083757,Staff,1,0,30,29
1650051764659,MATH 20C,A01,083760,Staff,0,9,30,30
1650051764659,MATH 20C,A02,083761,Staff,0,12,30,30
1650051764659,MATH 20C,B01,083762,Staff,16,0,30,14
1650051764659,MATH 20C,B02,083763,Staff,28,0,30,2
1650051770682,MATH 20D,A01,083765,Staff,0,2,30,30
1650051770682,MATH 20D,A02,083766,Staff,15,0,30,15
1650051770682,MATH 20D,A03,083767,Staff,28,0,30,2
1650051776706,MATH 20E,A01,083771,Staff,10,0,30,20
1650051776706,MATH 20E,A02,083772,Staff,20,0,30,10
1650051776706,MATH 20E,B01,083773,Staff,1,1,30,29
1650051776706,MATH 20E,B02,083774,Staff,17,0,30,13
1650051782736,MATH 103A,A01,083777,Staff,0,6,30,30
1650051782736,MATH 103A,A02,083778,Staff,0,7,30,30
1650051782736,MATH 103A,B01,083779,Staff,0,8,30,30
1650051782736,MATH 103A,B02,083780,Staff,0,6,30,30
1650051788758,MATH 105,A01,085443,Staff,0,11,30,30
1650051794794,MATH 109,A01,083213,Anzaldo; Leesa B,0,4,30,30
1650051794794,MATH 109,A02,083214,Anzaldo; Leesa B,0,4,30,30
1650051794794,MATH 109,B01,083215,Anzaldo; Leesa B,0,2,30,30
1650051794794,MATH 109,B02,083216,Anzaldo; Leesa B,1,3,30,29
1650051800816,MATH 142A,A01,083219,Chow; Bennett,0,8,30,30
1650051800816,MATH 142A,A02,083220,Chow; Bennett,0,8,30,30
1650051800816,MATH 142A,B01,083221,Chow; Bennett,0,9,30,30
1650051800816,MATH 142A,B02,083222,Chow; Bennett,0,9,30,30
1650051806840,MATH 193A,A01,083224,Staff,0,5,30,30
1650051806840,MATH 193A,A02,083225,Staff,0,4,30,30
1650051806840,MATH 193A,A03,083781,Staff,0,0,30,30
1650051806840,MATH 193A,A04,083782,Staff,9,0,30,21
1650051812863,MATH 197,001,091859,McAuley; Julian John,9998,0,9999,1
1650051819009,COGS 9,A01,083615,Staff,3,17,60,57
1650051825032,COGS 11,A01,083617,Boyle; Mary E. T.,25,0,40,15
1650051831062,COGS 13,A01,083071,Staff,0,28,40,40
1650051837086,COGS 14A,A01,092681,Staff,0,8,100,100
1650051843111,COGS 14B,A01,083073,Cheng; Tzu-Han,0,3,50,50
1650051849211,COGS 17,A01,092677,Staff,35,0,75,40
1650051855237,COGS 100,A01,083619,Staff,0,17,60,60
1650051861266,COGS 101A,A01,083621,Davis; Joshua Daniel,0,16,60,60
1650051867290,COGS 101B,A01,091572,Staff,14,0,60,46
1650051873312,COGS 101C,A01,083625,Delgado; Tania,21,0,30,9
1650051879334,COGS 107A,A01,083627,Boyle; Mary E. T.,1,2,60,59
1650051885356,COGS 118A,A01,083075,Staff,19,0,60,41
1650051891388,CSE 3,A50,083646,Miranda; Gregory Joseph,22,0,38,16
1650051891388,CSE 3,A51,083647,Miranda; Gregory Joseph,37,0,37,0
1650051897410,CSE 8A,A50,083650,Miranda; Gregory Joseph,0,15,40,40
1650051903440,CSE 11,A01,083080,Cao; Yingjun,0,62,40,40
1650051909463,CSE 12,A01,083652,Staff,0,0,100,100
1650051915489,CSE 15L,A01,083654,Staff,0,0,50,50
1650051915489,CSE 15L,A02,083655,Staff,11,0,50,39
1650051921510,CSE 20,A01,083657,Staff,58,0,80,22
1650051927538,CSE 30,A01,083084,Eldon; John,0,63,40,40
1650051933560,CSE 100,A01,083659,Cao; Yingjun,0,57,50,50
1650051939582,CSE 134B,A01,083661,Powell; Thomas Allan,1,27,65,64
1650051945603,CSE 140,A01,083663,Staff,8,0,75,67
1650051951634,CSE 140L,A01,083088,Eldon; John,3,0,75,72
1650051957658,CSE 175,A01,083665,Kumar; Rakesh,9,0,25,16
1650051963688,CSE 190,A00,092507,Dubnov; Shlomo,14,0,20,6
1650051969714,ECE 45,A01,083139,Staff,0,12,40,40
1650051975738,ECE 65,A50,083695,Staff,0,3,30,30
1650051981761,ECE 109,A01,091882,Touri; Behrouz,48,0,70,22
1650051987791,ECE 180,A00,083140,Abi Samra; Nicholas Camill,25,0,30,5
1650051987791,ECE 180,B00,083141,Abi Samra; Nicholas Camill,8,0,30,22
1650051993818,MATH 10A,A01,083735,Patchell; Gregory David,12,0,30,18
1650051993818,MATH 10A,A02,083736,Patchell; Gregory David,28,0,30,2
1650051993818,MATH 10A,A03,083737,Patchell; Gregory David,27,0,30,3
1650051999842,MATH 10B,A01,083207,Staff,0,5,30,30
1650051999842,MATH 10B,A02,083208,Staff,0,1,30,30
1650051999842,MATH 10B,B01,083739,Staff,19,0,30,11
1650051999842,MATH 10B,B02,083740,Staff,30,0,30,0
1650052005865,MATH 18,A01,083743,Staff,10,0,30,20
1650052005865,MATH 18,A02,083744,Staff,28,0,30,2
1650052005865,MATH 18,A03,083745,Staff,23,0,30,7
1650052005865,MATH 18,A04,083746,Staff,27,0,30,3
1650052005865,MATH 18,B01,083748,Staff,0,8,30,30
1650052005865,MATH 18,B02,083749,Staff,1,6,30,29
1650052005865,MATH 18,B03,083750,Staff,0,6,30,30
1650052005865,MATH 18,B04,083751,Staff,1,7,30,29
1650052011898,MATH 20A,A01,083754,Staff,26,0,40,14
1650052017930,MATH 20B,A01,083756,Staff,0,6,30,30
1650052017930,MATH 20B,A02,083757,Staff,1,0,30,29
1650052023952,MATH 20C,A01,083760,Staff,0,9,30,30
1650052023952,MATH 20C,A02,083761,Staff,0,12,30,30
1650052023952,MATH 20C,B01,083762,Staff,16,0,30,14
1650052023952,MATH 20C,B02,083763,Staff,28,0,30,2
1650052029976,MATH 20D,A01,083765,Staff,0,2,30,30
1650052029976,MATH 20D,A02,083766,Staff,15,0,30,15
1650052029976,MATH 20D,A03,083767,Staff,28,0,30,2
1650052035998,MATH 20E,A01,083771,Staff,10,0,30,20
1650052035998,MATH 20E,A02,083772,Staff,20,0,30,10
1650052035998,MATH 20E,B01,083773,Staff,1,1,30,29
1650052035998,MATH 20E,B02,083774,Staff,17,0,30,13
1650052042021,MATH 103A,A01,083777,Staff,0,6,30,30
1650052042021,MATH 103A,A02,083778,Staff,0,7,30,30
1650052042021,MATH 103A,B01,083779,Staff,0,8,30,30
1650052042021,MATH 103A,B02,083780,Staff,0,6,30,30
1650052048047,MATH 105,A01,085443,Staff,0,11,30,30
1650052054072,MATH 109,A01,083213,Anzaldo; Leesa B,0,4,30,30
1650052054072,MATH 109,A02,083214,Anzaldo; Leesa B,0,4,30,30
1650052054072,MATH 109,B01,083215,Anzaldo; Leesa B,0,2,30,30
1650052054072,MATH 109,B02,083216,Anzaldo; Leesa B,1,3,30,29
1650052060101,MATH 142A,A01,083219,Chow; Bennett,0,8,30,30
1650052060101,MATH 142A,A02,083220,Chow; Bennett,0,8,30,30
1650052060101,MATH 142A,B01,083221,Chow; Bennett,0,9,30,30
1650052060101,MATH 142A,B02,083222,Chow; Bennett,0,9,30,30
1650052066132,MATH 193A,A01,083224,Staff,0,5,30,30
1650052066132,MATH 193A,A02,083225,Staff,0,4,30,30
1650052066132,MATH 193A,A03,083781,Staff,0,0,30,30
1650052066132,MATH 193A,A04,083782,Staff,9,0,30,21
1650052072158,MATH 197,001,091859,McAuley; Julian John,9998,0,9999,1
1650052078213,COGS 9,A01,083615,Staff,3,17,60,57
1650052084239,COGS 11,A01,083617,Boyle; Mary E. T.,25,0,40,15
1650052090263,COGS 13,A01,083071,Staff,0,28,40,40
1650052096286,COGS 14A,A01,092681,Staff,0,8,100,100
1650052102310,COGS 14B,A01,083073,Cheng; Tzu-Han,0,3,50,50
1650052108336,COGS 17,A01,092677,Staff,35,0,75,40
1650052114358,COGS 100,A01,083619,Staff,0,17,60,60
1650052120381,COGS 101A,A01,083621,Davis; Joshua Daniel,0,16,60,60
1650052126408,COGS 101B,A01,091572,Staff,14,0,60,46
1650052132438,COGS 101C,A01,083625,Delgado; Tania,21,0,30,9
1650052138461,COGS 107A,A01,083627,Boyle; Mary E. T.,1,2,60,59
1650052144487,COGS 118A,A01,083075,Staff,19,0,60,41
1650052150513,CSE 3,A50,083646,Miranda; Gregory Joseph,22,0,38,16
1650052150513,CSE 3,A51,083647,Miranda; Gregory Joseph,37,0,37,0
1650052156536,CSE 8A,A50,083650,Miranda; Gregory Joseph,0,15,40,40
1650052162563,CSE 11,A01,083080,Cao; Yingjun,0,62,40,40
1650052168585,CSE 12,A01,083652,Staff,0,0,100,100
1650052174609,CSE 15L,A01,083654,Staff,0,0,50,50
1650052174609,CSE 15L,A02,083655,Staff,11,0,50,39
1650052180634,CSE 20,A01,083657,Staff,58,0,80,22
1650052186667,CSE 30,A01,083084,Eldon; John,0,63,40,40
1650052192692,CSE 100,A01,083659,Cao; Yingjun,0,58,50,50
1650052198719,CSE 134B,A01,083661,Powell; Thomas Allan,1,27,65,64
1650052204742,CSE 140,A01,083663,Staff,8,0,75,67
1650052210767,CSE 140L,A01,083088,Eldon; John,3,0,75,72
1650052216792,CSE 175,A01,083665,Kumar; Rakesh,9,0,25,16
1650052222815,CSE 190,A00,092507,Dubnov; Shlomo,14,0,20,6
1650052228842,ECE 45,A01,083139,Staff,0,12,40,40
1650052234869,ECE 65,A50,083695,Staff,0,3,30,30
1650052240893,ECE 109,A01,091882,Touri; Behrouz,48,0,70,22
1650052246916,ECE 180,A00,083140,Abi Samra; Nicholas Camill,25,0,30,5
1650052246916,ECE 180,B00,083141,Abi Samra; Nicholas Camill,8,0,30,22
1650052252938,MATH 10A,A01,083735,Patchell; Gregory David,12,0,30,18
1650052252938,MATH 10A,A02,083736,Patchell; Gregory David,28,0,30,2
1650052252938,MATH 10A,A03,083737,Patchell; Gregory David,27,0,30,3
1650052258962,MATH 10B,A01,083207,Staff,0,5,30,30
1650052258962,MATH 10B,A02,083208,Staff,0,1,30,30
1650052258962,MATH 10B,B01,083739,Staff,19,0,30,11
1650052258962,MATH 10B,B02,083740,Staff,30,0,30,0
1650052264988,MATH 18,A01,083743,Staff,10,0,30,20
1650052264988,MATH 18,A02,083744,Staff,28,0,30,2
1650052264988,MATH 18,A03,083745,Staff,23,0,30,7
1650052264988,MATH 18,A04,083746,Staff,27,0,30,3
1650052264988,MATH 18,B01,083748,Staff,0,8,30,30
1650052264988,MATH 18,B02,083749,Staff,1,6,30,29
1650052264988,MATH 18,B03,083750,Staff,0,6,30,30
1650052264988,MATH 18,B04,083751,Staff,1,7,30,29
1650052271014,MATH 20A,A01,083754,Staff,26,0,40,14
1650052277040,MATH 20B,A01,083756,Staff,0,6,30,30
1650052277040,MATH 20B,A02,083757,Staff,1,0,30,29
1650052283064,MATH 20C,A01,083760,Staff,0,9,30,30
1650052283064,MATH 20C,A02,083761,Staff,0,12,30,30
1650052283064,MATH 20C,B01,083762,Staff,16,0,30,14
1650052283064,MATH 20C,B02,083763,Staff,28,0,30,2
1650052289095,MATH 20D,A01,083765,Staff,0,2,30,30
1650052289095,MATH 20D,A02,083766,Staff,15,0,30,15
1650052289095,MATH 20D,A03,083767,Staff,28,0,30,2
1650052295122,MATH 20E,A01,083771,Staff,10,0,30,20
1650052295122,MATH 20E,A02,083772,Staff,20,0,30,10
1650052295122,MATH 20E,B01,083773,Staff,1,1,30,29
1650052295122,MATH 20E,B02,083774,Staff,17,0,30,13
1650052301159,MATH 103A,A01,083777,Staff,0,6,30,30
1650052301159,MATH 103A,A02,083778,Staff,0,7,30,30
1650052301159,MATH 103A,B01,083779,Staff,0,8,30,30
1650052301159,MATH 103A,B02,083780,Staff,0,6,30,30
1650052307206,MATH 105,A01,085443,Staff,0,11,30,30
1650052313233,MATH 109,A01,083213,Anzaldo; Leesa B,0,4,30,30
1650052313233,MATH 109,A02,083214,Anzaldo; Leesa B,0,4,30,30
1650052313233,MATH 109,B01,083215,Anzaldo; Leesa B,0,2,30,30
1650052313233,MATH 109,B02,083216,Anzaldo; Leesa B,1,3,30,29
1650052319261,MATH 142A,A01,083219,Chow; Bennett,0,8,30,30
1650052319261,MATH 142A,A02,083220,Chow; Bennett,0,8,30,30
1650052319261,MATH 142A,B01,083221,Chow; Bennett,0,9,30,30
1650052319261,MATH 142A,B02,083222,Chow; Bennett,0,9,30,30
1650052325286,MATH 193A,A01,083224,Staff,0,5,30,30
1650052325286,MATH 193A,A02,083225,Staff,0,4,30,30
1650052325286,MATH 193A,A03,083781,Staff,0,0,30,30
1650052325286,MATH 193A,A04,083782,Staff,9,0,30,21
1650052331309,MATH 197,001,091859,McAuley; Julian John,9998,0,9999,1
1650052337371,COGS 9,A01,083615,Staff,3,17,60,57
1650052343405,COGS 11,A01,083617,Boyle; Mary E. T.,25,0,40,15
1650052349431,COGS 13,A01,083071,Staff,0,28,40,40
1650052355454,COGS 14A,A01,092681,Staff,0,8,100,100
1650052361477,COGS 14B,A01,083073,Cheng; Tzu-Han,0,3,50,50
1650052367499,COGS 17,A01,092677,Staff,35,0,75,40
1650052373522,COGS 100,A01,083619,Staff,0,17,60,60
1650052379549,COGS 101A,A01,083621,Davis; Joshua Daniel,0,16,60,60
1650052385576,COGS 101B,A01,091572,Staff,14,0,60,46
1650052391602,COGS 101C,A01,083625,Delgado; Tania,21,0,30,9
1650052397639,COGS 107A,A01,083627,Boyle; Mary E. T.,1,2,60,59
1650052403661,COGS 118A,A01,083075,Staff,19,0,60,41
1650052409783,CSE 3,A50,083646,Miranda; Gregory Joseph,22,0,38,16
1650052409783,CSE 3,A51,083647,Miranda; Gregory Joseph,37,0,37,0
1650052415814,CSE 8A,A50,083650,Miranda; Gregory Joseph,0,15,40,40
1650052421839,CSE 11,A01,083080,Cao; Yingjun,0,62,40,40
1650052427865,CSE 12,A01,083652,Staff,0,0,100,100
1650052433889,CSE 15L,A01,083654,Staff,0,0,50,50
1650052433889,CSE 15L,A02,083655,Staff,11,0,50,39
1650052439912,CSE 20,A01,083657,Staff,58,0,80,22
1650052445939,CSE 30,A01,083084,Eldon; John,0,63,40,40
1650052451961,CSE 100,A01,083659,Cao; Yingjun,0,58,50,50
1650052457987,CSE 134B,A01,083661,Powell; Thomas Allan,1,27,65,64
1650052464012,CSE 140,A01,083663,Staff,8,0,75,67
1650052470034,CSE 140L,A01,083088,Eldon; John,3,0,75,72
1650052476057,CSE 175,A01,083665,Kumar; Rakesh,9,0,25,16
1650052482081,CSE 190,A00,092507,Dubnov; Shlomo,14,0,20,6
1650052488107,ECE 45,A01,083139,Staff,0,12,40,40
1650052494133,ECE 65,A50,083695,Staff,0,3,30,30
1650052500170,ECE 109,A01,091882,Touri; Behrouz,48,0,70,22
1650052506193,ECE 180,A00,083140,Abi Samra; Nicholas Camill,25,0,30,5
1650052506193,ECE 180,B00,083141,Abi Samra; Nicholas Camill,8,0,30,22
1650052512216,MATH 10A,A01,083735,Patchell; Gregory David,12,0,30,18
1650052512216,MATH 10A,A02,083736,Patchell; Gregory David,28,0,30,2
1650052512216,MATH 10A,A03,083737,Patchell; Gregory David,27,0,30,3
1650052518245,MATH 10B,A01,083207,Staff,0,5,30,30
1650052518245,MATH 10B,A02,083208,Staff,0,1,30,30
1650052518245,MATH 10B,B01,083739,Staff,19,0,30,11
1650052518245,MATH 10B,B02,083740,Staff,30,0,30,0
1650052524269,MATH 18,A01,083743,Staff,10,0,30,20
1650052524269,MATH 18,A02,083744,Staff,28,0,30,2
1650052524269,MATH 18,A03,083745,Staff,23,0,30,7
1650052524269,MATH 18,A04,083746,Staff,27,0,30,3
1650052524269,MATH 18,B01,083748,Staff,0,8,30,30
1650052524269,MATH 18,B02,083749,Staff,1,6,30,29
1650052524269,MATH 18,B03,083750,Staff,0,6,30,30
1650052524269,MATH 18,B04,083751,Staff,1,7,30,29
1650052530295,MATH 20A,A01,083754,Staff,26,0,40,14
1650052536320,MATH 20B,A01,083756,Staff,0,6,30,30
1650052536320,MATH 20B,A02,083757,Staff,1,0,30,29
1650052542354,MATH 20C,A01,083760,Staff,0,9,30,30
1650052542354,MATH 20C,A02,083761,Staff,0,12,30,30
1650052542354,MATH 20C,B01,083762,Staff,16,0,30,14
1650052542354,MATH 20C,B02,083763,Staff,28,0,30,2
1650052548377,MATH 20D,A01,083765,Staff,0,2,30,30
1650052548377,MATH 20D,A02,083766,Staff,15,0,30,15
1650052548377,MATH 20D,A03,083767,Staff,28,0,30,2
1650052554402,MATH 20E,A01,083771,Staff,10,0,30,20
1650052554402,MATH 20E,A02,083772,Staff,20,0,30,10
1650052554402,MATH 20E,B01,083773,Staff,1,1,30,29
1650052554402,MATH 20E,B02,083774,Staff,17,0,30,13
1650052560431,MATH 103A,A01,083777,Staff,0,6,30,30
1650052560431,MATH 103A,A02,083778,Staff,0,7,30,30
1650052560431,MATH 103A,B01,083779,Staff,0,8,30,30
1650052560431,MATH 103A,B02,083780,Staff,0,6,30,30
1650052566457,MATH 105,A01,085443,Staff,0,11,30,30
1650052572486,MATH 109,A01,083213,Anzaldo; Leesa B,0,4,30,30
1650052572486,MATH 109,A02,083214,Anzaldo; Leesa B,0,4,30,30
1650052572486,MATH 109,B01,083215,Anzaldo; Leesa B,0,2,30,30
1650052572486,MATH 109,B02,083216,Anzaldo; Leesa B,1,3,30,29
1650052578514,MATH 142A,A01,083219,Chow; Bennett,0,8,30,30
1650052578514,MATH 142A,A02,083220,Chow; Bennett,0,8,30,30
1650052578514,MATH 142A,B01,083221,Chow; Bennett,0,9,30,30
1650052578514,MATH 142A,B02,083222,Chow; Bennett,0,9,30,30
1650052584538,MATH 193A,A01,083224,Staff,0,5,30,30
1650052584538,MATH 193A,A02,083225,Staff,0,4,30,30
1650052584538,MATH 193A,A03,083781,Staff,0,0,30,30
1650052584538,MATH 193A,A04,083782,Staff,9,0,30,21
1650052590563,MATH 197,001,091859,McAuley; Julian John,9998,0,9999,1
1650052596622,COGS 9,A01,083615,Staff,3,17,60,57
1650052602647,COGS 11,A01,083617,Boyle; Mary E. T.,25,0,40,15
1650052608673,COGS 13,A01,083071,Staff,0,28,40,40
1650052614698,COGS 14A,A01,092681,Staff,0,8,100,100
1650052620722,COGS 14B,A01,083073,Cheng; Tzu-Han,0,3,50,50
1650052626754,COGS 17,A01,092677,Staff,35,0,75,40
1650052632778,COGS 100,A01,083619,Staff,0,17,60,60
1650052638804,COGS 101A,A01,083621,Davis; Joshua Daniel,0,16,60,60
1650052644826,COGS 101B,A01,091572,Staff,14,0,60,46
1650052650865,COGS 101C,A01,083625,Delgado; Tania,21,0,30,9
1650052656893,COGS 107A,A01,083627,Boyle; Mary E. T.,1,2,60,59
1650052662921,COGS 118A,A01,083075,Staff,19,0,60,41
1650052668943,CSE 3,A50,083646,Miranda; Gregory Joseph,22,0,38,16
1650052668943,CSE 3,A51,083647,Miranda; Gregory Joseph,37,0,37,0
1650052674970,CSE 8A,A50,083650,Miranda; Gregory Joseph,0,15,40,40
1650052680996,CSE 11,A01,083080,Cao; Yingjun,0,62,40,40
1650052687024,CSE 12,A01,083652,Staff,0,0,100,100
1650052693061,CSE 15L,A01,083654,Staff,0,0,50,50
1650052693061,CSE 15L,A02,083655,Staff,11,0,50,39
1650052699085,CSE 20,A01,083657,Staff,58,0,80,22
1650052705124,CSE 30,A01,083084,Eldon; John,0,63,40,40
1650052711150,CSE 100,A01,083659,Cao; Yingjun,0,58,50,50
1650052717181,CSE 134B,A01,083661,Powell; Thomas Allan,1,27,65,64
1650052723207,CSE 140,A01,083663,Staff,8,0,75,67
1650052729229,CSE 140L,A01,083088,Eldon; John,3,0,75,72
1650052735251,CSE 175,A01,083665,Kumar; Rakesh,9,0,25,16
1650052741278,CSE 190,A00,092507,Dubnov; Shlomo,14,0,20,6
1650052747303,ECE 45,A01,083139,Staff,0,12,40,40
1650052753326,ECE 65,A50,083695,Staff,0,3,30,30
1650052759361,ECE 109,A01,091882,Touri; Behrouz,48,0,70,22
1650052765385,ECE 180,A00,083140,Abi Samra; Nicholas Camill,25,0,30,5
1650052765385,ECE 180,B00,083141,Abi Samra; Nicholas Camill,8,0,30,22
1650052771424,MATH 10A,A01,083735,Patchell; Gregory David,12,0,30,18
1650052771424,MATH 10A,A02,083736,Patchell; Gregory David,28,0,30,2
1650052771424,MATH 10A,A03,083737,Patchell; Gregory David,27,0,30,3
1650052777456,MATH 10B,A01,083207,Staff,0,5,30,30
1650052777456,MATH 10B,A02,083208,Staff,0,1,30,30
1650052777456,MATH 10B,B01,083739,Staff,19,0,30,11
1650052777456,MATH 10B,B02,083740,Staff,30,0,30,0
1650052783483,MATH 18,A01,083743,Staff,10,0,30,20
1650052783483,MATH 18,A02,083744,Staff,28,0,30,2
1650052783483,MATH 18,A03,083745,Staff,23,0,30,7
1650052783483,MATH 18,A04,083746,Staff,27,0,30,3
1650052783483,MATH 18,B01,083748,Staff,0,8,30,30
1650052783483,MATH 18,B02,083749,Staff,1,6,30,29
1650052783483,MATH 18,B03,083750,Staff,0,6,30,30
1650052783483,MATH 18,B04,083751,Staff,1,7,30,29
1650052789509,MATH 20A,A01,083754,Staff,26,0,40,14
1650052795530,MATH 20B,A01,083756,Staff,0,5,30,30
1650052795530,MATH 20B,A02,083757,Staff,0,0,30,30
1650052801554,MATH 20C,A01,083760,Staff,0,9,30,30
1650052801554,MATH 20C,A02,083761,Staff,0,12,30,30
1650052801554,MATH 20C,B01,083762,Staff,16,0,30,14
1650052801554,MATH 20C,B02,083763,Staff,28,0,30,2
1650052807579,MATH 20D,A01,083765,Staff,0,2,30,30
1650052807579,MATH 20D,A02,083766,Staff,15,0,30,15
1650052807579,MATH 20D,A03,083767,Staff,28,0,30,2
1650052813607,MATH 20E,A01,083771,Staff,10,0,30,20
1650052813607,MATH 20E,A02,083772,Staff,20,0,30,10
1650052813607,MATH 20E,B01,083773,Staff,1,1,30,29
1650052813607,MATH 20E,B02,083774,Staff,17,0,30,13
1650052819640,MATH 103A,A01,083777,Staff,0,6,30,30
1650052819640,MATH 103A,A02,083778,Staff,0,7,30,30
1650052819640,MATH 103A,B01,083779,Staff,0,8,30,30
1650052819640,MATH 103A,B02,083780,Staff,0,6,30,30
1650052825667,MATH 105,A01,085443,Staff,0,11,30,30
1650052831695,MATH 109,A01,083213,Anzaldo; Leesa B,0,4,30,30
1650052831695,MATH 109,A02,083214,Anzaldo; Leesa B,0,4,30,30
1650052831695,MATH 109,B01,083215,Anzaldo; Leesa B,0,2,30,30
1650052831695,MATH 109,B02,083216,Anzaldo; Leesa B,1,3,30,29
1650052837725,MATH 142A,A01,083219,Chow; Bennett,0,8,30,30
1650052837725,MATH 142A,A02,083220,Chow; Bennett,0,8,30,30
1650052837725,MATH 142A,B01,083221,Chow; Bennett,0,9,30,30
1650052837725,MATH 142A,B02,083222,Chow; Bennett,0,9,30,30
1650052843752,MATH 193A,A01,083224,Staff,0,5,30,30
1650052843752,MATH 193A,A02,083225,Staff,0,4,30,30
1650052843752,MATH 193A,A03,083781,Staff,0,0,30,30
1650052843752,MATH 193A,A04,083782,Staff,9,0,30,21
1650052849778,MATH 197,001,091859,McAuley; Julian John,9998,0,9999,1
1650052855840,COGS 9,A01,083615,Staff,3,17,60,57
1650052861870,COGS 11,A01,083617,Boyle; Mary E. T.,25,0,40,15
1650052867904,COGS 13,A01,083071,Staff,0,28,40,40
1650052873929,COGS 14A,A01,092681,Staff,0,8,100,100
1650052879963,COGS 14B,A01,083073,Cheng; Tzu-Han,0,3,50,50
1650052885985,COGS 17,A01,092677,Staff,35,0,75,40
1650052892011,COGS 100,A01,083619,Staff,0,17,60,60
1650052898042,COGS 101A,A01,083621,Davis; Joshua Daniel,0,16,60,60
1650052904077,COGS 101B,A01,091572,Staff,14,0,60,46
1650052910101,COGS 101C,A01,083625,Delgado; Tania,21,0,30,9
1650052916122,COGS 107A,A01,083627,Boyle; Mary E. T.,1,2,60,59
1650052922152,COGS 118A,A01,083075,Staff,19,0,60,41
1650052928181,CSE 3,A50,083646,Miranda; Gregory Joseph,22,0,38,16
1650052928181,CSE 3,A51,083647,Miranda; Gregory Joseph,37,0,37,0
1650052934204,CSE 8A,A50,083650,Miranda; Gregory Joseph,0,15,40,40
1650052940232,CSE 11,A01,083080,Cao; Yingjun,0,62,40,40
1650052946261,CSE 12,A01,083652,Staff,0,1,100,100
1650052952285,CSE 15L,A01,083654,Staff,0,0,50,50
1650052952285,CSE 15L,A02,083655,Staff,11,0,50,39
1650052958313,CSE 20,A01,083657,Staff,58,0,80,22
1650052964348,CSE 30,A01,083084,Eldon; John,0,63,40,40
1650052970384,CSE 100,A01,083659,Cao; Yingjun,0,58,50,50
1650052976408,CSE 134B,A01,083661,Powell; Thomas Allan,1,27,65,64
1650052982429,CSE 140,A01,083663,Staff,8,0,75,67
1650052988453,CSE 140L,A01,083088,Eldon; John,3,0,75,72
1650052994473,CSE 175,A01,083665,Kumar; Rakesh,9,0,25,16
1650053000508,CSE 190,A00,092507,Dubnov; Shlomo,14,0,20,6
1650053006648,ECE 45,A01,083139,Staff,0,12,40,40
1650053012674,ECE 65,A50,083695,Staff,0,3,30,30
1650053018700,ECE 109,A01,091882,Touri; Behrouz,48,0,70,22
1650053024723,ECE 180,A00,083140,Abi Samra; Nicholas Camill,25,0,30,5
1650053024723,ECE 180,B00,083141,Abi Samra; Nicholas Camill,8,0,30,22
1650053030745,MATH 10A,A01,083735,Patchell; Gregory David,12,0,30,18
1650053030745,MATH 10A,A02,083736,Patchell; Gregory David,28,0,30,2
1650053030745,MATH 10A,A03,083737,Patchell; Gregory David,27,0,30,3
1650053036774,MATH 10B,A01,083207,Staff,0,5,30,30
1650053036774,MATH 10B,A02,083208,Staff,0,1,30,30
1650053036774,MATH 10B,B01,083739,Staff,19,0,30,11
1650053036774,MATH 10B,B02,083740,Staff,30,0,30,0
1650053042809,MATH 18,A01,083743,Staff,10,0,30,20
1650053042809,MATH 18,A02,083744,Staff,28,0,30,2
1650053042809,MATH 18,A03,083745,Staff,23,0,30,7
1650053042809,MATH 18,A04,083746,Staff,27,0,30,3
1650053042809,MATH 18,B01,083748,Staff,0,8,30,30
1650053042809,MATH 18,B02,083749,Staff,1,6,30,29
1650053042809,MATH 18,B03,083750,Staff,0,6,30,30
1650053042809,MATH 18,B04,083751,Staff,1,7,30,29
1650053048833,MATH 20A,A01,083754,Staff,26,0,40,14
1650053054861,MATH 20B,A01,083756,Staff,0,5,30,30
1650053054861,MATH 20B,A02,083757,Staff,0,0,30,30
1650053060888,MATH 20C,A01,083760,Staff,0,9,30,30
1650053060888,MATH 20C,A02,083761,Staff,0,12,30,30
1650053060888,MATH 20C,B01,083762,Staff,16,0,30,14
1650053060888,MATH 20C,B02,083763,Staff,28,0,30,2
1650053066914,MATH 20D,A01,083765,Staff,0,2,30,30
1650053066914,MATH 20D,A02,083766,Staff,15,0,30,15
1650053066914,MATH 20D,A03,083767,Staff,28,0,30,2
1650053072945,MATH 20E,A01,083771,Staff,10,0,30,20
1650053072945,MATH 20E,A02,083772,Staff,20,0,30,10
1650053072945,MATH 20E,B01,083773,Staff,1,1,30,29
1650053072945,MATH 20E,B02,083774,Staff,17,0,30,13
1650053078970,MATH 103A,A01,083777,Staff,0,6,30,30
1650053078970,MATH 103A,A02,083778,Staff,0,7,30,30
1650053078970,MATH 103A,B01,083779,Staff,0,8,30,30
1650053078970,MATH 103A,B02,083780,Staff,0,6,30,30
1650053085013,MATH 105,A01,085443,Staff,0,11,30,30
1650053091043,MATH 109,A01,083213,Anzaldo; Leesa B,0,4,30,30
1650053091043,MATH 109,A02,083214,Anzaldo; Leesa B,0,4,30,30
1650053091043,MATH 109,B01,083215,Anzaldo; Leesa B,0,2,30,30
1650053091043,MATH 109,B02,083216,Anzaldo; Leesa B,1,3,30,29
1650053097079,MATH 142A,A01,083219,Chow; Bennett,0,8,30,30
1650053097079,MATH 142A,A02,083220,Chow; Bennett,0,8,30,30
1650053097079,MATH 142A,B01,083221,Chow; Bennett,0,9,30,30
1650053097079,MATH 142A,B02,083222,Chow; Bennett,0,9,30,30
1650053103112,MATH 193A,A01,083224,Staff,0,4,30,30
1650053103112,MATH 193A,A02,083225,Staff,0,4,30,30
1650053103112,MATH 193A,A03,083781,Staff,0,0,30,30
1650053103112,MATH 193A,A04,083782,Staff,8,0,30,22
1650053109134,MATH 197,001,091859,McAuley; Julian John,9998,0,9999,1
1650053115193,COGS 9,A01,083615,Staff,3,17,60,57
1650053121234,COGS 11,A01,083617,Boyle; Mary E. T.,25,0,40,15
1650053127260,COGS 13,A01,083071,Staff,0,28,40,40
1650053133293,COGS 14A,A01,092681,Staff,0,8,100,100
1650053139316,COGS 14B,A01,083073,Cheng; Tzu-Han,0,3,50,50
1650053145343,COGS 17,A01,092677,Staff,35,0,75,40
1650053151376,COGS 100,A01,083619,Staff,0,17,60,60
1650053157400,COGS 101A,A01,083621,Davis; Joshua Daniel,0,16,60,60
1650053163423,COGS 101B,A01,091572,Staff,14,0,60,46
1650053169455,COGS 101C,A01,083625,Delgado; Tania,21,0,30,9
1650053175483,COGS 107A,A01,083627,Boyle; Mary E. T.,1,2,60,59
1650053181513,COGS 118A,A01,083075,Staff,19,0,60,41
1650053187546,CSE 3,A50,083646,Miranda; Gregory Joseph,22,0,38,16
1650053187546,CSE 3,A51,083647,Miranda; Gregory Joseph,37,0,37,0
1650053193572,CSE 8A,A50,083650,Miranda; Gregory Joseph,0,15,40,40
1650053199594,CSE 11,A01,083080,Cao; Yingjun,0,62,40,40
1650053205618,CSE 12,A01,083652,Staff,0,1,100,100
1650053211641,CSE 15L,A01,083654,Staff,0,0,50,50
1650053211641,CSE 15L,A02,083655,Staff,11,0,50,39
1650053217679,CSE 20,A01,083657,Staff,58,0,80,22
1650053223702,CSE 30,A01,083084,Eldon; John,0,63,40,40
1650053229730,CSE 100,A01,083659,Cao; Yingjun,0,58,50,50
1650053235753,CSE 134B,A01,083661,Powell; Thomas Allan,1,27,65,64
1650053241776,CSE 140,A01,083663,Staff,7,0,75,68
1650053247801,CSE 140L,A01,083088,Eldon; John,2,0,75,73
1650053253835,CSE 175,A01,083665,Kumar; Rakesh,9,0,25,16
1650053259859,CSE 190,A00,092507,Dubnov; Shlomo,14,0,20,6
1650053265887,ECE 45,A01,083139,Staff,0,12,40,40
1650053271915,ECE 65,A50,083695,Staff,0,3,30,30
1650053277941,ECE 109,A01,091882,Touri; Behrouz,48,0,70,22
1650053283968,ECE 180,A00,083140,Abi Samra; Nicholas Camill,25,0,30,5
1650053283968,ECE 180,B00,083141,Abi Samra; Nicholas Camill,8,0,30,22
1650053290002,MATH 10A,A01,083735,Patchell; Gregory David,12,0,30,18
1650053290002,MATH 10A,A02,083736,Patchell; Gregory David,28,0,30,2
1650053290002,MATH 10A,A03,083737,Patchell; Gregory David,27,0,30,3
1650053296028,MATH 10B,A01,083207,Staff,0,5,30,30
1650053296028,MATH 10B,A02,083208,Staff,0,1,30,30
1650053296028,MATH 10B,B01,083739,Staff,19,0,30,11
1650053296028,MATH 10B,B02,083740,Staff,30,0,30,0
1650053302055,MATH 18,A01,083743,Staff,10,0,30,20
1650053302055,MATH 18,A02,083744,Staff,28,0,30,2
1650053302055,MATH 18,A03,083745,Staff,23,0,30,7
1650053302055,MATH 18,A04,083746,Staff,27,0,30,3
1650053302055,MATH 18,B01,083748,Staff,0,8,30,30
1650053302055,MATH 18,B02,083749,Staff,1,6,30,29
1650053302055,MATH 18,B03,083750,Staff,0,6,30,30
1650053302055,MATH 18,B04,083751,Staff,1,7,30,29
1650053308081,MATH 20A,A01,083754,Staff,26,0,40,14
1650053314105,MATH 20B,A01,083756,Staff,0,5,30,30
1650053314105,MATH 20B,A02,083757,Staff,0,0,30,30
1650053320129,MATH 20C,A01,083760,Staff,0,9,30,30
1650053320129,MATH 20C,A02,083761,Staff,0,12,30,30
1650053320129,MATH 20C,B01,083762,Staff,16,0,30,14
1650053320129,MATH 20C,B02,083763,Staff,28,0,30,2
1650053326152,MATH 20D,A01,083765,Staff,0,2,30,30
1650053326152,MATH 20D,A02,083766,Staff,15,0,30,15
1650053326152,MATH 20D,A03,083767,Staff,28,0,30,2
1650053332175,MATH 20E,A01,083771,Staff,10,0,30,20
1650053332175,MATH 20E,A02,083772,Staff,20,0,30,10
1650053332175,MATH 20E,B01,083773,Staff,1,1,30,29
1650053332175,MATH 20E,B02,083774,Staff,17,0,30,13
1650053338216,MATH 103A,A01,083777,Staff,0,6,30,30
1650053338216,MATH 103A,A02,083778,Staff,0,7,30,30
1650053338216,MATH 103A,B01,083779,Staff,0,8,30,30
1650053338216,MATH 103A,B02,083780,Staff,0,6,30,30
1650053344256,MATH 105,A01,085443,Staff,0,11,30,30
1650053350286,MATH 109,A01,083213,Anzaldo; Leesa B,0,4,30,30
1650053350286,MATH 109,A02,083214,Anzaldo; Leesa B,0,4,30,30
1650053350286,MATH 109,B01,083215,Anzaldo; Leesa B,0,2,30,30
1650053350286,MATH 109,B02,083216,Anzaldo; Leesa B,1,3,30,29
1650053356326,MATH 142A,A01,083219,Chow; Bennett,0,8,30,30
1650053356326,MATH 142A,A02,083220,Chow; Bennett,0,8,30,30
1650053356326,MATH 142A,B01,083221,Chow; Bennett,0,9,30,30
1650053356326,MATH 142A,B02,083222,Chow; Bennett,0,9,30,30
1650053362352,MATH 193A,A01,083224,Staff,0,4,30,30
1650053362352,MATH 193A,A02,083225,Staff,0,4,30,30
1650053362352,MATH 193A,A03,083781,Staff,0,0,30,30
1650053362352,MATH 193A,A04,083782,Staff,8,0,30,22
1650053368374,MATH 197,001,091859,McAuley; Julian John,9998,0,9999,1
1650053374423,COGS 9,A01,083615,Staff,3,17,60,57
1650053380447,COGS 11,A01,083617,Boyle; Mary E. T.,25,0,40,15
1650053386469,COGS 13,A01,083071,Staff,0,28,40,40
1650053392497,COGS 14A,A01,092681,Staff,0,8,100,100
1650053398521,COGS 14B,A01,083073,Cheng; Tzu-Han,0,3,50,50
1650053404545,COGS 17,A01,092677,Staff,35,0,75,40
1650053410566,COGS 100,A01,083619,Staff,0,17,60,60
1650053416598,COGS 101A,A01,083621,Davis; Joshua Daniel,0,16,60,60
1650053422627,COGS 101B,A01,091572,Staff,14,0,60,46
1650053428660,COGS 101C,A01,083625,Delgado; Tania,21,0,30,9
1650053434683,COGS 107A,A01,083627,Boyle; Mary E. T.,1,2,60,59
1650053440712,COGS 118A,A01,083075,Staff,19,0,60,41
1650053446740,CSE 3,A50,083646,Miranda; Gregory Joseph,22,0,38,16
1650053446740,CSE 3,A51,083647,Miranda; Gregory Joseph,37,0,37,0
1650053452764,CSE 8A,A50,083650,Miranda; Gregory Joseph,0,15,40,40
1650053458792,CSE 11,A01,083080,Cao; Yingjun,0,62,40,40
1650053464816,CSE 12,A01,083652,Staff,0,1,100,100
1650053470842,CSE 15L,A01,083654,Staff,0,0,50,50
1650053470842,CSE 15L,A02,083655,Staff,11,0,50,39
1650053476865,CSE 20,A01,083657,Staff,58,0,80,22
1650053482889,CSE 30,A01,083084,Eldon; John,0,63,40,40
1650053488923,CSE 100,A01,083659,Cao; Yingjun,0,58,50,50
1650053494944,CSE 134B,A01,083661,Powell; Thomas Allan,1,27,65,64
1650053500978,CSE 140,A01,083663,Staff,7,0,75,68
1650053507007,CSE 140L,A01,083088,Eldon; John,2,0,75,73
1650053513034,CSE 175,A01,083665,Kumar; Rakesh,9,0,25,16
1650053519056,CSE 190,A00,092507,Dubnov; Shlomo,14,0,20,6
1650053525079,ECE 45,A01,083139,Staff,0,12,40,40
1650053531109,ECE 65,A50,083695,Staff,0,3,30,30
1650053537134,ECE 109,A01,091882,Touri; Behrouz,48,0,70,22
1650053543166,ECE 180,A00,083140,Abi Samra; Nicholas Camill,25,0,30,5
1650053543166,ECE 180,B00,083141,Abi Samra; Nicholas Camill,8,0,30,22
1650053549190,MATH 10A,A01,083735,Patchell; Gregory David,12,0,30,18
1650053549190,MATH 10A,A02,083736,Patchell; Gregory David,28,0,30,2
1650053549190,MATH 10A,A03,083737,Patchell; Gregory David,27,0,30,3
1650053555216,MATH 10B,A01,083207,Staff,0,5,30,30
1650053555216,MATH 10B,A02,083208,Staff,0,1,30,30
1650053555216,MATH 10B,B01,083739,Staff,19,0,30,11
1650053555216,MATH 10B,B02,083740,Staff,30,0,30,0
1650053561239,MATH 18,A01,083743,Staff,10,0,30,20
1650053561239,MATH 18,A02,083744,Staff,28,0,30,2
1650053561239,MATH 18,A03,083745,Staff,23,0,30,7
1650053561239,MATH 18,A04,083746,Staff,27,0,30,3
1650053561239,MATH 18,B01,083748,Staff,0,8,30,30
1650053561239,MATH 18,B02,083749,Staff,1,6,30,29
1650053561239,MATH 18,B03,083750,Staff,0,6,30,30
1650053561239,MATH 18,B04,083751,Staff,1,7,30,29
1650053567261,MATH 20A,A01,083754,Staff,26,0,40,14
1650053573284,MATH 20B,A01,083756,Staff,0,5,30,30
1650053573284,MATH 20B,A02,083757,Staff,0,0,30,30
1650053579314,MATH 20C,A01,083760,Staff,0,9,30,30
1650053579314,MATH 20C,A02,083761,Staff,0,12,30,30
1650053579314,MATH 20C,B01,083762,Staff,16,0,30,14
1650053579314,MATH 20C,B02,083763,Staff,28,0,30,2
1650053585342,MATH 20D,A01,083765,Staff,0,2,30,30
1650053585342,MATH 20D,A02,083766,Staff,15,0,30,15
1650053585342,MATH 20D,A03,083767,Staff,28,0,30,2
1650053591364,MATH 20E,A01,083771,Staff,10,0,30,20
1650053591364,MATH 20E,A02,083772,Staff,20,0,30,10
1650053591364,MATH 20E,B01,083773,Staff,1,1,30,29
1650053591364,MATH 20E,B02,083774,Staff,17,0,30,13
1650053597389,MATH 103A,A01,083777,Staff,0,6,30,30
1650053597389,MATH 103A,A02,083778,Staff,0,7,30,30
1650053597389,MATH 103A,B01,083779,Staff,0,8,30,30
1650053597389,MATH 103A,B02,083780,Staff,0,6,30,30
1650053603499,MATH 105,A01,085443,Staff,0,11,30,30
1650053609523,MATH 109,A01,083213,Anzaldo; Leesa B,0,4,30,30
1650053609523,MATH 109,A02,083214,Anzaldo; Leesa B,0,4,30,30
1650053609523,MATH 109,B01,083215,Anzaldo; Leesa B,0,2,30,30
1650053609523,MATH 109,B02,083216,Anzaldo; Leesa B,1,3,30,29
1650053615547,MATH 142A,A01,083219,Chow; Bennett,0,8,30,30
1650053615547,MATH 142A,A02,083220,Chow; Bennett,0,8,30,30
1650053615547,MATH 142A,B01,083221,Chow; Bennett,0,9,30,30
1650053615547,MATH 142A,B02,083222,Chow; Bennett,0,9,30,30
1650053621575,MATH 193A,A01,083224,Staff,0,4,30,30
1650053621575,MATH 193A,A02,083225,Staff,0,4,30,30
1650053621575,MATH 193A,A03,083781,Staff,0,0,30,30
1650053621575,MATH 193A,A04,083782,Staff,8,0,30,22
1650053627599,MATH 197,001,091859,McAuley; Julian John,9998,0,9999,1
1650053633678,COGS 9,A01,083615,Staff,3,17,60,57
1650053639715,COGS 11,A01,083617,Boyle; Mary E. T.,25,0,40,15
1650053645739,COGS 13,A01,083071,Staff,0,28,40,40
1650053651783,COGS 14A,A01,092681,Staff,0,8,100,100
1650053657811,COGS 14B,A01,083073,Cheng; Tzu-Han,0,3,50,50
1650053663844,COGS 17,A01,092677,Staff,35,0,75,40
1650053669868,COGS 100,A01,083619,Staff,0,17,60,60
1650053675897,COGS 101A,A01,083621,Davis; Joshua Daniel,0,16,60,60
1650053681920,COGS 101B,A01,091572,Staff,14,0,60,46
1650053687943,COGS 101C,A01,083625,Delgado; Tania,21,0,30,9
1650053693976,COGS 107A,A01,083627,Boyle; Mary E. T.,1,2,60,59
1650053700000,COGS 118A,A01,083075,Staff,19,0,60,41
1650053706031,CSE 3,A50,083646,Miranda; Gregory Joseph,22,0,38,16
1650053706031,CSE 3,A51,083647,Miranda; Gregory Joseph,37,0,37,0
1650053712055,CSE 8A,A50,083650,Miranda; Gregory Joseph,0,15,40,40
1650053718079,CSE 11,A01,083080,Cao; Yingjun,0,62,40,40
1650053724111,CSE 12,A01,083652,Staff,0,1,100,100
1650053730146,CSE 15L,A01,083654,Staff,0,0,50,50
1650053730146,CSE 15L,A02,083655,Staff,11,0,50,39
1650053736182,CSE 20,A01,083657,Staff,58,0,80,22
1650053742231,CSE 30,A01,083084,Eldon; John,0,63,40,40
1650053748261,CSE 100,A01,083659,Cao; Yingjun,0,57,50,50
1650053754297,CSE 134B,A01,083661,Powell; Thomas Allan,1,27,65,64
1650053760334,CSE 140,A01,083663,Staff,7,0,75,68
1650053766356,CSE 140L,A01,083088,Eldon; John,2,0,75,73
1650053772379,CSE 175,A01,083665,Kumar; Rakesh,9,0,25,16
1650053778418,CSE 190,A00,092507,Dubnov; Shlomo,14,0,20,6
1650053784443,ECE 45,A01,083139,Staff,0,12,40,40
1650053790468,ECE 65,A50,083695,Staff,0,3,30,30
1650053796510,ECE 109,A01,091882,Touri; Behrouz,48,0,70,22
1650053802532,ECE 180,A00,083140,Abi Samra; Nicholas Camill,25,0,30,5
1650053802532,ECE 180,B00,083141,Abi Samra; Nicholas Camill,8,0,30,22
1650053808561,MATH 10A,A01,083735,Patchell; Gregory David,12,0,30,18
1650053808561,MATH 10A,A02,083736,Patchell; Gregory David,28,0,30,2
1650053808561,MATH 10A,A03,083737,Patchell; Gregory David,27,0,30,3
1650053814584,MATH 10B,A01,083207,Staff,0,5,30,30
1650053814584,MATH 10B,A02,083208,Staff,0,1,30,30
1650053814584,MATH 10B,B01,083739,Staff,19,0,30,11
1650053814584,MATH 10B,B02,083740,Staff,30,0,30,0
1650053820615,MATH 18,A01,083743,Staff,10,0,30,20
1650053820615,MATH 18,A02,083744,Staff,28,0,30,2
1650053820615,MATH 18,A03,083745,Staff,23,0,30,7
1650053820615,MATH 18,A04,083746,Staff,27,0,30,3
1650053820615,MATH 18,B01,083748,Staff,0,8,30,30
1650053820615,MATH 18,B02,083749,Staff,1,6,30,29
1650053820615,MATH 18,B03,083750,Staff,0,6,30,30
1650053820615,MATH 18,B04,083751,Staff,1,7,30,29
1650053826638,MATH 20A,A01,083754,Staff,26,0,40,14
1650053832660,MATH 20B,A01,083756,Staff,0,5,30,30
1650053832660,MATH 20B,A02,083757,Staff,0,0,30,30
1650053838687,MATH 20C,A01,083760,Staff,0,9,30,30
1650053838687,MATH 20C,A02,083761,Staff,0,12,30,30
1650053838687,MATH 20C,B01,083762,Staff,16,0,30,14
1650053838687,MATH 20C,B02,083763,Staff,28,0,30,2
1650053844719,MATH 20D,A01,083765,Staff,0,2,30,30
1650053844719,MATH 20D,A02,083766,Staff,15,0,30,15
1650053844719,MATH 20D,A03,083767,Staff,28,0,30,2
1650053850747,MATH 20E,A01,083771,Staff,10,0,30,20
1650053850747,MATH 20E,A02,083772,Staff,20,0,30,10
1650053850747,MATH 20E,B01,083773,Staff,1,1,30,29
1650053850747,MATH 20E,B02,083774,Staff,17,0,30,13
1650053856771,MATH 103A,A01,083777,Staff,0,6,30,30
1650053856771,MATH 103A,A02,083778,Staff,0,7,30,30
1650053856771,MATH 103A,B01,083779,Staff,0,8,30,30
1650053856771,MATH 103A,B02,083780,Staff,0,6,30,30
1650053862796,MATH 105,A01,085443,Staff,0,11,30,30
1650053868825,MATH 109,A01,083213,Anzaldo; Leesa B,0,4,30,30
1650053868825,MATH 109,A02,083214,Anzaldo; Leesa B,0,4,30,30
1650053868825,MATH 109,B01,083215,Anzaldo; Leesa B,0,2,30,30
1650053868825,MATH 109,B02,083216,Anzaldo; Leesa B,1,3,30,29
1650053874863,MATH 142A,A01,083219,Chow; Bennett,0,8,30,30
1650053874863,MATH 142A,A02,083220,Chow; Bennett,0,8,30,30
1650053874863,MATH 142A,B01,083221,Chow; Bennett,0,9,30,30
1650053874863,MATH 142A,B02,083222,Chow; Bennett,0,9,30,30
1650053880893,MATH 193A,A01,083224,Staff,0,4,30,30
1650053880893,MATH 193A,A02,083225,Staff,0,4,30,30
1650053880893,MATH 193A,A03,083781,Staff,0,0,30,30
1650053880893,MATH 193A,A04,083782,Staff,8,0,30,22
1650053886924,MATH 197,001,091859,McAuley; Julian John,9998,0,9999,1
1650053892984,COGS 9,A01,083615,Staff,3,17,60,57
1650053899008,COGS 11,A01,083617,Boyle; Mary E. T.,25,0,40,15
1650053905035,COGS 13,A01,083071,Staff,0,28,40,40
1650053911061,COGS 14A,A01,092681,Staff,0,8,100,100
1650053917087,COGS 14B,A01,083073,Cheng; Tzu-Han,0,3,50,50
1650053923110,COGS 17,A01,092677,Staff,35,0,75,40
1650053929139,COGS 100,A01,083619,Staff,0,17,60,60
1650053935163,COGS 101A,A01,083621,Davis; Joshua Daniel,0,16,60,60
1650053941185,COGS 101B,A01,091572,Staff,14,0,60,46
1650053947222,COGS 101C,A01,083625,Delgado; Tania,21,0,30,9
1650053953250,COGS 107A,A01,083627,Boyle; Mary E. T.,1,2,60,59
1650053959304,COGS 118A,A01,083075,Staff,19,0,60,41
1650053965327,CSE 3,A50,083646,Miranda; Gregory Joseph,22,0,38,16
1650053965327,CSE 3,A51,083647,Miranda; Gregory Joseph,37,0,37,0
1650053971352,CSE 8A,A50,083650,Miranda; Gregory Joseph,0,15,40,40
1650053977379,CSE 11,A01,083080,Cao; Yingjun,0,62,40,40
1650053983409,CSE 12,A01,083652,Staff,0,1,100,100
1650053989431,CSE 15L,A01,083654,Staff,0,0,50,50
1650053989431,CSE 15L,A02,083655,Staff,11,0,50,39
1650053995462,CSE 20,A01,083657,Staff,58,0,80,22
1650054001500,CSE 30,A01,083084,Eldon; John,0,63,40,40
1650054007532,CSE 100,A01,083659,Cao; Yingjun,0,57,50,50
1650054013568,CSE 134B,A01,083661,Powell; Thomas Allan,1,27,65,64
1650054019592,CSE 140,A01,083663,Staff,7,0,75,68
1650054025621,CSE 140L,A01,083088,Eldon; John,2,0,75,73
1650054031647,CSE 175,A01,083665,Kumar; Rakesh,9,0,25,16
1650054037673,CSE 190,A00,092507,Dubnov; Shlomo,14,0,20,6
1650054043697,ECE 45,A01,083139,Staff,0,12,40,40
1650054049727,ECE 65,A50,083695,Staff,0,3,30,30
1650054055750,ECE 109,A01,091882,Touri; Behrouz,48,0,70,22
1650054061778,ECE 180,A00,083140,Abi Samra; Nicholas Camill,25,0,30,5
1650054061778,ECE 180,B00,083141,Abi Samra; Nicholas Camill,8,0,30,22
1650054067806,MATH 10A,A01,083735,Patchell; Gregory David,12,0,30,18
1650054067806,MATH 10A,A02,083736,Patchell; Gregory David,28,0,30,2
1650054067806,MATH 10A,A03,083737,Patchell; Gregory David,27,0,30,3
1650054073831,MATH 10B,A01,083207,Staff,0,5,30,30
1650054073831,MATH 10B,A02,083208,Staff,0,1,30,30
1650054073831,MATH 10B,B01,083739,Staff,19,0,30,11
1650054073831,MATH 10B,B02,083740,Staff,30,0,30,0
1650054079862,MATH 18,A01,083743,Staff,10,0,30,20
1650054079862,MATH 18,A02,083744,Staff,28,0,30,2
1650054079862,MATH 18,A03,083745,Staff,23,0,30,7
1650054079862,MATH 18,A04,083746,Staff,27,0,30,3
1650054079862,MATH 18,B01,083748,Staff,0,8,30,30
1650054079862,MATH 18,B02,083749,Staff,1,6,30,29
1650054079862,MATH 18,B03,083750,Staff,0,6,30,30
1650054079862,MATH 18,B04,083751,Staff,1,7,30,29
1650054085889,MATH 20A,A01,083754,Staff,26,0,40,14
1650054091917,MATH 20B,A01,083756,Staff,0,5,30,30
1650054091917,MATH 20B,A02,083757,Staff,0,1,30,30
1650054097944,MATH 20C,A01,083760,Staff,0,9,30,30
1650054097944,MATH 20C,A02,083761,Staff,0,12,30,30
1650054097944,MATH 20C,B01,083762,Staff,16,0,30,14
1650054097944,MATH 20C,B02,083763,Staff,28,0,30,2
1650054103974,MATH 20D,A01,083765,Staff,0,2,30,30
1650054103974,MATH 20D,A02,083766,Staff,15,0,30,15
1650054103974,MATH 20D,A03,083767,Staff,28,0,30,2
1650054110016,MATH 20E,A01,083771,Staff,10,0,30,20
1650054110016,MATH 20E,A02,083772,Staff,20,0,30,10
1650054110016,MATH 20E,B01,083773,Staff,1,1,30,29
1650054110016,MATH 20E,B02,083774,Staff,17,0,30,13
1650054116040,MATH 103A,A01,083777,Staff,0,6,30,30
1650054116040,MATH 103A,A02,083778,Staff,0,7,30,30
1650054116040,MATH 103A,B01,083779,Staff,0,8,30,30
1650054116040,MATH 103A,B02,083780,Staff,0,6,30,30
1650054122080,MATH 105,A01,085443,Staff,0,11,30,30
1650054128109,MATH 109,A01,083213,Anzaldo; Leesa B,0,4,30,30
1650054128109,MATH 109,A02,083214,Anzaldo; Leesa B,0,4,30,30
1650054128109,MATH 109,B01,083215,Anzaldo; Leesa B,0,2,30,30
1650054128109,MATH 109,B02,083216,Anzaldo; Leesa B,1,3,30,29
1650054134142,MATH 142A,A01,083219,Chow; Bennett,0,8,30,30
1650054134142,MATH 142A,A02,083220,Chow; Bennett,0,8,30,30
1650054134142,MATH 142A,B01,083221,Chow; Bennett,0,9,30,30
1650054134142,MATH 142A,B02,083222,Chow; Bennett,0,9,30,30
1650054140170,MATH 193A,A01,083224,Staff,0,4,30,30
1650054140170,MATH 193A,A02,083225,Staff,0,4,30,30
1650054140170,MATH 193A,A03,083781,Staff,0,0,30,30
1650054140170,MATH 193A,A04,083782,Staff,8,0,30,22
1650054146204,MATH 197,001,091859,McAuley; Julian John,9998,0,9999,1
1650054152265,COGS 9,A01,083615,Staff,3,17,60,57
1650054158291,COGS 11,A01,083617,Boyle; Mary E. T.,25,0,40,15
1650054164313,COGS 13,A01,083071,Staff,0,28,40,40
1650054170334,COGS 14A,A01,092681,Staff,0,8,100,100
1650054176358,COGS 14B,A01,083073,Cheng; Tzu-Han,0,3,50,50
1650054182381,COGS 17,A01,092677,Staff,35,0,75,40
1650054188410,COGS 100,A01,083619,Staff,0,17,60,60
1650054194522,COGS 101A,A01,083621,Davis; Joshua Daniel,0,16,60,60
1650054200547,COGS 101B,A01,091572,Staff,14,0,60,46
1650054206570,COGS 101C,A01,083625,Delgado; Tania,21,0,30,9
1650054212597,COGS 107A,A01,083627,Boyle; Mary E. T.,1,2,60,59
1650054218626,COGS 118A,A01,083075,Staff,19,0,60,41
1650054224650,CSE 3,A50,083646,Miranda; Gregory Joseph,22,0,38,16
1650054224650,CSE 3,A51,083647,Miranda; Gregory Joseph,37,0,37,0
1650054230678,CSE 8A,A50,083650,Miranda; Gregory Joseph,0,16,40,40
1650054236703,CSE 11,A01,083080,Cao; Yingjun,0,62,40,40
1650054242728,CSE 12,A01,083652,Staff,0,1,100,100
1650054248753,CSE 15L,A01,083654,Staff,0,0,50,50
1650054248753,CSE 15L,A02,083655,Staff,11,0,50,39
1650054254775,CSE 20,A01,083657,Staff,58,0,80,22
1650054260801,CSE 30,A01,083084,Eldon; John,0,63,40,40
1650054266839,CSE 100,A01,083659,Cao; Yingjun,0,57,50,50
1650054272868,CSE 134B,A01,083661,Powell; Thomas Allan,1,27,65,64
1650054278900,CSE 140,A01,083663,Staff,7,0,75,68
1650054284924,CSE 140L,A01,083088,Eldon; John,2,0,75,73
1650054290953,CSE 175,A01,083665,Kumar; Rakesh,9,0,25,16
1650054296978,CSE 190,A00,092507,Dubnov; Shlomo,14,0,20,6
1650054303007,ECE 45,A01,083139,Staff,0,12,40,40
1650054309032,ECE 65,A50,083695,Staff,0,3,30,30
1650054325034,ECE 109,A01,091882,Touri; Behrouz,48,0,70,22
1650054331061,ECE 180,A00,083140,Abi Samra; Nicholas Camill,25,0,30,5
1650054331061,ECE 180,B00,083141,Abi Samra; Nicholas Camill,8,0,30,22
1650054337092,MATH 10A,A01,083735,Patchell; Gregory David,12,0,30,18
1650054337092,MATH 10A,A02,083736,Patchell; Gregory David,28,0,30,2
1650054337092,MATH 10A,A03,083737,Patchell; Gregory David,27,0,30,3
1650054343117,MATH 10B,A01,083207,Staff,0,5,30,30
1650054343117,MATH 10B,A02,083208,Staff,0,1,30,30
1650054343117,MATH 10B,B01,083739,Staff,19,0,30,11
1650054343117,MATH 10B,B02,083740,Staff,30,0,30,0
1650054349149,MATH 18,A01,083743,Staff,10,0,30,20
1650054349149,MATH 18,A02,083744,Staff,28,0,30,2
1650054349149,MATH 18,A03,083745,Staff,23,0,30,7
1650054349149,MATH 18,A04,083746,Staff,27,0,30,3
1650054349149,MATH 18,B01,083748,Staff,0,8,30,30
1650054349149,MATH 18,B02,083749,Staff,1,6,30,29
1650054349149,MATH 18,B03,083750,Staff,0,6,30,30
1650054349149,MATH 18,B04,083751,Staff,1,7,30,29
1650054355173,MATH 20A,A01,083754,Staff,26,0,40,14
1650054361196,MATH 20B,A01,083756,Staff,0,5,30,30
1650054361196,MATH 20B,A02,083757,Staff,0,1,30,30
1650054367231,MATH 20C,A01,083760,Staff,0,9,30,30
1650054367231,MATH 20C,A02,083761,Staff,0,12,30,30
1650054367231,MATH 20C,B01,083762,Staff,16,0,30,14
1650054367231,MATH 20C,B02,083763,Staff,28,0,30,2
1650054373253,MATH 20D,A01,083765,Staff,0,2,30,30
1650054373253,MATH 20D,A02,083766,Staff,15,0,30,15
1650054373253,MATH 20D,A03,083767,Staff,28,0,30,2
1650054379278,MATH 20E,A01,083771,Staff,10,0,30,20
1650054379278,MATH 20E,A02,083772,Staff,20,0,30,10
1650054379278,MATH 20E,B01,083773,Staff,1,1,30,29
1650054379278,MATH 20E,B02,083774,Staff,17,0,30,13
1650054385302,MATH 103A,A01,083777,Staff,0,6,30,30
1650054385302,MATH 103A,A02,083778,Staff,0,7,30,30
1650054385302,MATH 103A,B01,083779,Staff,0,8,30,30
1650054385302,MATH 103A,B02,083780,Staff,0,6,30,30
1650054391330,MATH 105,A01,085443,Staff,0,11,30,30
1650054397353,MATH 109,A01,083213,Anzaldo; Leesa B,0,4,30,30
1650054397353,MATH 109,A02,083214,Anzaldo; Leesa B,0,4,30,30
1650054397353,MATH 109,B01,083215,Anzaldo; Leesa B,0,2,30,30
1650054397353,MATH 109,B02,083216,Anzaldo; Leesa B,1,3,30,29
1650054403382,MATH 142A,A01,083219,Chow; Bennett,0,8,30,30
1650054403382,MATH 142A,A02,083220,Chow; Bennett,0,8,30,30
1650054403382,MATH 142A,B01,083221,Chow; Bennett,0,9,30,30
1650054403382,MATH 142A,B02,083222,Chow; Bennett,0,9,30,30
1650054409409,MATH 193A,A01,083224,Staff,0,4,30,30
1650054409409,MATH 193A,A02,083225,Staff,0,4,30,30
1650054409409,MATH 193A,A03,083781,Staff,0,0,30,30
1650054409409,MATH 193A,A04,083782,Staff,8,0,30,22
1650054415450,MATH 197,001,091859,McAuley; Julian John,9998,0,9999,1
1650054421504,COGS 9,A01,083615,Staff,3,17,60,57
1650054427533,COGS 11,A01,083617,Boyle; Mary E. T.,25,0,40,15
1650054433555,COGS 13,A01,083071,Staff,0,28,40,40
1650054439622,COGS 14A,A01,092681,Staff,0,8,100,100
1650054445651,COGS 14B,A01,083073,Cheng; Tzu-Han,0,3,50,50
1650054451681,COGS 17,A01,092677,Staff,35,0,75,40
1650054457705,COGS 100,A01,083619,Staff,0,17,60,60
1650054463733,COGS 101A,A01,083621,Davis; Joshua Daniel,0,16,60,60
1650054469758,COGS 101B,A01,091572,Staff,14,0,60,46
1650054475791,COGS 101C,A01,083625,Delgado; Tania,21,0,30,9
1650054481815,COGS 107A,A01,083627,Boyle; Mary E. T.,1,2,60,59
1650054487839,COGS 118A,A01,083075,Staff,19,0,60,41
1650054493868,CSE 3,A50,083646,Miranda; Gregory Joseph,22,0,38,16
1650054493868,CSE 3,A51,083647,Miranda; Gregory Joseph,37,0,37,0
1650054499892,CSE 8A,A50,083650,Miranda; Gregory Joseph,0,16,40,40
1650054505916,CSE 11,A01,083080,Cao; Yingjun,0,62,40,40
1650054511939,CSE 12,A01,083652,Staff,0,1,100,100
1650054517965,CSE 15L,A01,083654,Staff,0,0,50,50
1650054517965,CSE 15L,A02,083655,Staff,11,0,50,39
1650054523989,CSE 20,A01,083657,Staff,58,0,80,22
1650054530016,CSE 30,A01,083084,Eldon; John,0,63,40,40
1650054536042,CSE 100,A01,083659,Cao; Yingjun,0,57,50,50
1650054542072,CSE 134B,A01,083661,Powell; Thomas Allan,1,27,65,64
1650054548096,CSE 140,A01,083663,Staff,7,0,75,68
1650054554121,CSE 140L,A01,083088,Eldon; John,2,0,75,73
1650054560145,CSE 175,A01,083665,Kumar; Rakesh,9,0,25,16
1650054566168,CSE 190,A00,092507,Dubnov; Shlomo,14,0,20,6
1650054572195,ECE 45,A01,083139,Staff,0,12,40,40
1650054578221,ECE 65,A50,083695,Staff,0,3,30,30
1650054584243,ECE 109,A01,091882,Touri; Behrouz,48,0,70,22
1650054590270,ECE 180,A00,083140,Abi Samra; Nicholas Camill,25,0,30,5
1650054590270,ECE 180,B00,083141,Abi Samra; Nicholas Camill,8,0,30,22
1650054596295,MATH 10A,A01,083735,Patchell; Gregory David,12,0,30,18
1650054596295,MATH 10A,A02,083736,Patchell; Gregory David,28,0,30,2
1650054596295,MATH 10A,A03,083737,Patchell; Gregory David,27,0,30,3
1650054602322,MATH 10B,A01,083207,Staff,0,5,30,30
1650054602322,MATH 10B,A02,083208,Staff,0,1,30,30
1650054602322,MATH 10B,B01,083739,Staff,19,0,30,11
1650054602322,MATH 10B,B02,083740,Staff,30,0,30,0
1650054608349,MATH 18,A01,083743,Staff,10,0,30,20
1650054608349,MATH 18,A02,083744,Staff,28,0,30,2
1650054608349,MATH 18,A03,083745,Staff,23,0,30,7
1650054608349,MATH 18,A04,083746,Staff,27,0,30,3
1650054608349,MATH 18,B01,083748,Staff,0,8,30,30
1650054608349,MATH 18,B02,083749,Staff,1,6,30,29
1650054608349,MATH 18,B03,083750,Staff,0,6,30,30
1650054608349,MATH 18,B04,083751,Staff,1,7,30,29
1650054614384,MATH 20A,A01,083754,Staff,26,0,40,14
1650054620411,MATH 20B,A01,083756,Staff,0,5,30,30
1650054620411,MATH 20B,A02,083757,Staff,0,1,30,30
1650054626441,MATH 20C,A01,083760,Staff,0,9,30,30
1650054626441,MATH 20C,A02,083761,Staff,0,12,30,30
1650054626441,MATH 20C,B01,083762,Staff,16,0,30,14
1650054626441,MATH 20C,B02,083763,Staff,28,0,30,2
1650054632465,MATH 20D,A01,083765,Staff,0,2,30,30
1650054632465,MATH 20D,A02,083766,Staff,15,0,30,15
1650054632465,MATH 20D,A03,083767,Staff,28,0,30,2
1650054638497,MATH 20E,A01,083771,Staff,10,0,30,20
1650054638497,MATH 20E,A02,083772,Staff,20,0,30,10
1650054638497,MATH 20E,B01,083773,Staff,1,1,30,29
1650054638497,MATH 20E,B02,083774,Staff,17,0,30,13
1650054644521,MATH 103A,A01,083777,Staff,0,6,30,30
1650054644521,MATH 103A,A02,083778,Staff,0,7,30,30
1650054644521,MATH 103A,B01,083779,Staff,0,8,30,30
1650054644521,MATH 103A,B02,083780,Staff,0,6,30,30
1650054650548,MATH 105,A01,085443,Staff,0,11,30,30
1650054656572,MATH 109,A01,083213,Anzaldo; Leesa B,0,4,30,30
1650054656572,MATH 109,A02,083214,Anzaldo; Leesa B,0,4,30,30
1650054656572,MATH 109,B01,083215,Anzaldo; Leesa B,0,2,30,30
1650054656572,MATH 109,B02,083216,Anzaldo; Leesa B,1,3,30,29
1650054662608,MATH 142A,A01,083219,Chow; Bennett,0,8,30,30
1650054662608,MATH 142A,A02,083220,Chow; Bennett,0,8,30,30
1650054662608,MATH 142A,B01,083221,Chow; Bennett,0,9,30,30
1650054662608,MATH 142A,B02,083222,Chow; Bennett,0,9,30,30
1650054668637,MATH 193A,A01,083224,Staff,0,4,30,30
1650054668637,MATH 193A,A02,083225,Staff,0,4,30,30
1650054668637,MATH 193A,A03,083781,Staff,0,0,30,30
1650054668637,MATH 193A,A04,083782,Staff,8,0,30,22
1650054674661,MATH 197,001,091859,McAuley; Julian John,9998,0,9999,1
1650054680742,COGS 9,A01,083615,Staff,3,17,60,57
1650054686768,COGS 11,A01,083617,Boyle; Mary E. T.,25,0,40,15
1650054692800,COGS 13,A01,083071,Staff,0,28,40,40
1650054698834,COGS 14A,A01,092681,Staff,0,8,100,100
1650054704867,COGS 14B,A01,083073,Cheng; Tzu-Han,0,3,50,50
1650054710890,COGS 17,A01,092677,Staff,35,0,75,40
1650054716919,COGS 100,A01,083619,Staff,0,17,60,60
1650054722952,COGS 101A,A01,083621,Davis; Joshua Daniel,0,16,60,60
1650054728982,COGS 101B,A01,091572,Staff,14,0,60,46
1650054735005,COGS 101C,A01,083625,Delgado; Tania,21,0,30,9
1650054741035,COGS 107A,A01,083627,Boyle; Mary E. T.,1,2,60,59
1650054747060,COGS 118A,A01,083075,Staff,19,0,60,41
1650054753098,CSE 3,A50,083646,Miranda; Gregory Joseph,22,0,38,16
1650054753098,CSE 3,A51,083647,Miranda; Gregory Joseph,37,0,37,0
1650054759125,CSE 8A,A50,083650,Miranda; Gregory Joseph,0,16,40,40
1650054765149,CSE 11,A01,083080,Cao; Yingjun,0,62,40,40
1650054771176,CSE 12,A01,083652,Staff,0,1,100,100
1650054777208,CSE 15L,A01,083654,Staff,0,0,50,50
1650054777208,CSE 15L,A02,083655,Staff,11,0,50,39
1650054783238,CSE 20,A01,083657,Staff,58,0,80,22
1650054789265,CSE 30,A01,083084,Eldon; John,0,63,40,40
1650054795293,CSE 100,A01,083659,Cao; Yingjun,0,57,50,50
1650054801427,CSE 134B,A01,083661,Powell; Thomas Allan,1,27,65,64
1650054807450,CSE 140,A01,083663,Staff,7,0,75,68
1650054813475,CSE 140L,A01,083088,Eldon; John,2,0,75,73
1650054819503,CSE 175,A01,083665,Kumar; Rakesh,9,0,25,16
1650054825529,CSE 190,A00,092507,Dubnov; Shlomo,14,0,20,6
1650054831555,ECE 45,A01,083139,Staff,0,12,40,40
1650054837579,ECE 65,A50,083695,Staff,0,3,30,30
1650054843602,ECE 109,A01,091882,Touri; Behrouz,48,0,70,22
1650054849630,ECE 180,A00,083140,Abi Samra; Nicholas Camill,24,0,30,6
1650054849630,ECE 180,B00,083141,Abi Samra; Nicholas Camill,8,0,30,22
1650054855659,MATH 10A,A01,083735,Patchell; Gregory David,12,0,30,18
1650054855659,MATH 10A,A02,083736,Patchell; Gregory David,28,0,30,2
1650054855659,MATH 10A,A03,083737,Patchell; Gregory David,27,0,30,3
1650054861684,MATH 10B,A01,083207,Staff,0,5,30,30
1650054861684,MATH 10B,A02,083208,Staff,0,1,30,30
1650054861684,MATH 10B,B01,083739,Staff,19,0,30,11
1650054861684,MATH 10B,B02,083740,Staff,30,0,30,0
1650054867707,MATH 18,A01,083743,Staff,10,0,30,20
1650054867707,MATH 18,A02,083744,Staff,28,0,30,2
1650054867707,MATH 18,A03,083745,Staff,23,0,30,7
1650054867707,MATH 18,A04,083746,Staff,27,0,30,3
1650054867707,MATH 18,B01,083748,Staff,0,8,30,30
1650054867707,MATH 18,B02,083749,Staff,1,6,30,29
1650054867707,MATH 18,B03,083750,Staff,0,6,30,30
1650054867707,MATH 18,B04,083751,Staff,1,7,30,29
1650054873734,MATH 20A,A01,083754,Staff,26,0,40,14
1650054879759,MATH 20B,A01,083756,Staff,0,5,30,30
1650054879759,MATH 20B,A02,083757,Staff,0,1,30,30
1650054885788,MATH 20C,A01,083760,Staff,0,9,30,30
1650054885788,MATH 20C,A02,083761,Staff,0,12,30,30
1650054885788,MATH 20C,B01,083762,Staff,16,0,30,14
1650054885788,MATH 20C,B02,083763,Staff,28,0,30,2
1650054891816,MATH 20D,A01,083765,Staff,0,2,30,30
1650054891816,MATH 20D,A02,083766,Staff,15,0,30,15
1650054891816,MATH 20D,A03,083767,Staff,28,0,30,2
1650054897841,MATH 20E,A01,083771,Staff,10,0,30,20
1650054897841,MATH 20E,A02,083772,Staff,20,0,30,10
1650054897841,MATH 20E,B01,083773,Staff,1,1,30,29
1650054897841,MATH 20E,B02,083774,Staff,17,0,30,13
1650054903870,MATH 103A,A01,083777,Staff,0,6,30,30
1650054903870,MATH 103A,A02,083778,Staff,0,7,30,30
1650054903870,MATH 103A,B01,083779,Staff,0,8,30,30
1650054903870,MATH 103A,B02,083780,Staff,0,6,30,30
1650054909901,MATH 105,A01,085443,Staff,0,11,30,30
1650054915927,MATH 109,A01,083213,Anzaldo; Leesa B,0,4,30,30
1650054915927,MATH 109,A02,083214,Anzaldo; Leesa B,0,4,30,30
1650054915927,MATH 109,B01,083215,Anzaldo; Leesa B,0,2,30,30
1650054915927,MATH 109,B02,083216,Anzaldo; Leesa B,1,3,30,29
1650054921954,MATH 142A,A01,083219,Chow; Bennett,0,8,30,30
1650054921954,MATH 142A,A02,083220,Chow; Bennett,0,8,30,30
1650054921954,MATH 142A,B01,083221,Chow; Bennett,0,9,30,30
1650054921954,MATH 142A,B02,083222,Chow; Bennett,0,9,30,30
1650054927980,MATH 193A,A01,083224,Staff,0,4,30,30
1650054927980,MATH 193A,A02,083225,Staff,0,4,30,30
1650054927980,MATH 193A,A03,083781,Staff,0,0,30,30
1650054927980,MATH 193A,A04,083782,Staff,8,0,30,22
1650054934004,MATH 197,001,091859,McAuley; Julian John,9998,0,9999,1
1650054940056,COGS 9,A01,083615,Staff,3,17,60,57
1650054946083,COGS 11,A01,083617,Boyle; Mary E. T.,25,0,40,15
1650054952119,COGS 13,A01,083071,Staff,0,28,40,40
1650054958146,COGS 14A,A01,092681,Staff,0,8,100,100
1650054964170,COGS 14B,A01,083073,Cheng; Tzu-Han,0,3,50,50
1650054970196,COGS 17,A01,092677,Staff,35,0,75,40
1650054976232,COGS 100,A01,083619,Staff,0,17,60,60
1650054982255,COGS 101A,A01,083621,Davis; Joshua Daniel,0,16,60,60
1650054988284,COGS 101B,A01,091572,Staff,14,0,60,46
1650054994318,COGS 101C,A01,083625,Delgado; Tania,21,0,30,9
1650055000344,COGS 107A,A01,083627,Boyle; Mary E. T.,1,2,60,59
1650055006367,COGS 118A,A01,083075,Staff,19,0,60,41
1650055012392,CSE 3,A50,083646,Miranda; Gregory Joseph,22,0,38,16
1650055012392,CSE 3,A51,083647,Miranda; Gregory Joseph,37,0,37,0
1650055018428,CSE 8A,A50,083650,Miranda; Gregory Joseph,0,16,40,40
1650055024452,CSE 11,A01,083080,Cao; Yingjun,0,62,40,40
1650055030484,CSE 12,A01,083652,Staff,0,1,100,100
1650055036513,CSE 15L,A01,083654,Staff,0,0,50,50
1650055036513,CSE 15L,A02,083655,Staff,11,0,50,39
1650055042554,CSE 20,A01,083657,Staff,58,0,80,22
1650055048577,CSE 30,A01,083084,Eldon; John,0,63,40,40
1650055054601,CSE 100,A01,083659,Cao; Yingjun,0,57,50,50
1650055060624,CSE 134B,A01,083661,Powell; Thomas Allan,1,27,65,64
1650055066648,CSE 140,A01,083663,Staff,7,0,75,68
1650055072671,CSE 140L,A01,083088,Eldon; John,2,0,75,73
1650055078699,CSE 175,A01,083665,Kumar; Rakesh,9,0,25,16
1650055084726,CSE 190,A00,092507,Dubnov; Shlomo,14,0,20,6
1650055090752,ECE 45,A01,083139,Staff,0,12,40,40
1650055096778,ECE 65,A50,083695,Staff,0,3,30,30
1650055102812,ECE 109,A01,091882,Touri; Behrouz,48,0,70,22
1650055108836,ECE 180,A00,083140,Abi Samra; Nicholas Camill,24,0,30,6
1650055108836,ECE 180,B00,083141,Abi Samra; Nicholas Camill,8,0,30,22
1650055114860,MATH 10A,A01,083735,Patchell; Gregory David,12,0,30,18
1650055114860,MATH 10A,A02,083736,Patchell; Gregory David,28,0,30,2
1650055114860,MATH 10A,A03,083737,Patchell; Gregory David,27,0,30,3
1650055120888,MATH 10B,A01,083207,Staff,0,5,30,30
1650055120888,MATH 10B,A02,083208,Staff,0,1,30,30
1650055120888,MATH 10B,B01,083739,Staff,19,0,30,11
1650055120888,MATH 10B,B02,083740,Staff,30,0,30,0
1650055126934,MATH 18,A01,083743,Staff,10,0,30,20
1650055126934,MATH 18,A02,083744,Staff,28,0,30,2
1650055126934,MATH 18,A03,083745,Staff,23,0,30,7
1650055126934,MATH 18,A04,083746,Staff,27,0,30,3
1650055126934,MATH 18,B01,083748,Staff,0,9,30,30
1650055126934,MATH 18,B02,083749,Staff,1,6,30,29
1650055126934,MATH 18,B03,083750,Staff,0,6,30,30
1650055126934,MATH 18,B04,083751,Staff,1,7,30,29
1650055132957,MATH 20A,A01,083754,Staff,26,0,40,14
1650055138984,MATH 20B,A01,083756,Staff,0,5,30,30
1650055138984,MATH 20B,A02,083757,Staff,0,1,30,30
1650055145008,MATH 20C,A01,083760,Staff,0,9,30,30
1650055145008,MATH 20C,A02,083761,Staff,0,12,30,30
1650055145008,MATH 20C,B01,083762,Staff,16,0,30,14
1650055145008,MATH 20C,B02,083763,Staff,28,0,30,2
1650055151032,MATH 20D,A01,083765,Staff,0,2,30,30
1650055151032,MATH 20D,A02,083766,Staff,15,0,30,15
1650055151032,MATH 20D,A03,083767,Staff,28,0,30,2
1650055157057,MATH 20E,A01,083771,Staff,10,0,30,20
1650055157057,MATH 20E,A02,083772,Staff,20,0,30,10
1650055157057,MATH 20E,B01,083773,Staff,1,1,30,29
1650055157057,MATH 20E,B02,083774,Staff,17,0,30,13
1650055163079,MATH 103A,A01,083777,Staff,0,6,30,30
1650055163079,MATH 103A,A02,083778,Staff,0,7,30,30
1650055163079,MATH 103A,B01,083779,Staff,0,8,30,30
1650055163079,MATH 103A,B02,083780,Staff,0,6,30,30
1650055169101,MATH 105,A01,085443,Staff,0,11,30,30
1650055175123,MATH 109,A01,083213,Anzaldo; Leesa B,0,4,30,30
1650055175123,MATH 109,A02,083214,Anzaldo; Leesa B,0,4,30,30
1650055175123,MATH 109,B01,083215,Anzaldo; Leesa B,0,2,30,30
1650055175123,MATH 109,B02,083216,Anzaldo; Leesa B,1,3,30,29
1650055181148,MATH 142A,A01,083219,Chow; Bennett,0,8,30,30
1650055181148,MATH 142A,A02,083220,Chow; Bennett,0,8,30,30
1650055181148,MATH 142A,B01,083221,Chow; Bennett,0,9,30,30
1650055181148,MATH 142A,B02,083222,Chow; Bennett,0,9,30,30
1650055187171,MATH 193A,A01,083224,Staff,0,4,30,30
1650055187171,MATH 193A,A02,083225,Staff,0,4,30,30
1650055187171,MATH 193A,A03,083781,Staff,0,0,30,30
1650055187171,MATH 193A,A04,083782,Staff,8,0,30,22
1650055193195,MATH 197,001,091859,McAuley; Julian John,9998,0,9999,1
1650055199247,COGS 9,A01,083615,Staff,3,17,60,57
1650055205275,COGS 11,A01,083617,Boyle; Mary E. T.,25,0,40,15
1650055211297,COGS 13,A01,083071,Staff,0,28,40,40
1650055217320,COGS 14A,A01,092681,Staff,0,8,100,100
1650055223348,COGS 14B,A01,083073,Cheng; Tzu-Han,0,3,50,50
1650055229370,COGS 17,A01,092677,Staff,35,0,75,40
1650055235396,COGS 100,A01,083619,Staff,0,17,60,60
1650055241425,COGS 101A,A01,083621,Davis; Joshua Daniel,0,16,60,60
1650055247453,COGS 101B,A01,091572,Staff,14,0,60,46
1650055253477,COGS 101C,A01,083625,Delgado; Tania,21,0,30,9
1650055259500,COGS 107A,A01,083627,Boyle; Mary E. T.,1,2,60,59
1650055265529,COGS 118A,A01,083075,Staff,19,0,60,41
1650055271557,CSE 3,A50,083646,Miranda; Gregory Joseph,22,0,38,16
1650055271557,CSE 3,A51,083647,Miranda; Gregory Joseph,37,0,37,0
1650055277584,CSE 8A,A50,083650,Miranda; Gregory Joseph,0,16,40,40
1650055283607,CSE 11,A01,083080,Cao; Yingjun,0,62,40,40
1650055289631,CSE 12,A01,083652,Staff,0,1,100,100
1650055295653,CSE 15L,A01,083654,Staff,0,0,50,50
1650055295653,CSE 15L,A02,083655,Staff,11,0,50,39
1650055301680,CSE 20,A01,083657,Staff,58,0,80,22
1650055307703,CSE 30,A01,083084,Eldon; John,0,63,40,40
1650055313746,CSE 100,A01,083659,Cao; Yingjun,0,57,50,50
1650055319768,CSE 134B,A01,083661,Powell; Thomas Allan,1,27,65,64
1650055325799,CSE 140,A01,083663,Staff,7,0,75,68
1650055331835,CSE 140L,A01,083088,Eldon; John,2,0,75,73
1650055337861,CSE 175,A01,083665,Kumar; Rakesh,9,0,25,16
1650055343888,CSE 190,A00,092507,Dubnov; Shlomo,14,0,20,6
1650055349917,ECE 45,A01,083139,Staff,0,12,40,40
1650055355940,ECE 65,A50,083695,Staff,0,3,30,30
1650055361964,ECE 109,A01,091882,Touri; Behrouz,48,0,70,22
1650055367988,ECE 180,A00,083140,Abi Samra; Nicholas Camill,24,0,30,6
1650055367988,ECE 180,B00,083141,Abi Samra; Nicholas Camill,8,0,30,22
1650055374011,MATH 10A,A01,083735,Patchell; Gregory David,12,0,30,18
1650055374011,MATH 10A,A02,083736,Patchell; Gregory David,28,0,30,2
1650055374011,MATH 10A,A03,083737,Patchell; Gregory David,27,0,30,3
1650055380043,MATH 10B,A01,083207,Staff,0,5,30,30
1650055380043,MATH 10B,A02,083208,Staff,0,1,30,30
1650055380043,MATH 10B,B01,083739,Staff,19,0,30,11
1650055380043,MATH 10B,B02,083740,Staff,30,0,30,0
1650055386068,MATH 18,A01,083743,Staff,10,0,30,20
1650055386068,MATH 18,A02,083744,Staff,28,0,30,2
1650055386068,MATH 18,A03,083745,Staff,23,0,30,7
1650055386068,MATH 18,A04,083746,Staff,27,0,30,3
1650055386068,MATH 18,B01,083748,Staff,0,9,30,30
1650055386068,MATH 18,B02,083749,Staff,1,6,30,29
1650055386068,MATH 18,B03,083750,Staff,0,6,30,30
1650055386068,MATH 18,B04,083751,Staff,1,7,30,29
1650055392095,MATH 20A,A01,083754,Staff,26,0,40,14
1650055398238,MATH 20B,A01,083756,Staff,0,5,30,30
1650055398238,MATH 20B,A02,083757,Staff,0,1,30,30
1650055404266,MATH 20C,A01,083760,Staff,0,9,30,30
1650055404266,MATH 20C,A02,083761,Staff,0,12,30,30
1650055404266,MATH 20C,B01,083762,Staff,16,0,30,14
1650055404266,MATH 20C,B02,083763,Staff,28,0,30,2
1650055410292,MATH 20D,A01,083765,Staff,0,2,30,30
1650055410292,MATH 20D,A02,083766,Staff,15,0,30,15
1650055410292,MATH 20D,A03,083767,Staff,28,0,30,2
1650055416329,MATH 20E,A01,083771,Staff,10,0,30,20
1650055416329,MATH 20E,A02,083772,Staff,20,0,30,10
1650055416329,MATH 20E,B01,083773,Staff,1,1,30,29
1650055416329,MATH 20E,B02,083774,Staff,17,0,30,13
1650055422353,MATH 103A,A01,083777,Staff,0,6,30,30
1650055422353,MATH 103A,A02,083778,Staff,0,7,30,30
1650055422353,MATH 103A,B01,083779,Staff,0,8,30,30
1650055422353,MATH 103A,B02,083780,Staff,0,6,30,30
1650055428383,MATH 105,A01,085443,Staff,0,11,30,30
1650055434414,MATH 109,A01,083213,Anzaldo; Leesa B,0,4,30,30
1650055434414,MATH 109,A02,083214,Anzaldo; Leesa B,0,4,30,30
1650055434414,MATH 109,B01,083215,Anzaldo; Leesa B,0,2,30,30
1650055434414,MATH 109,B02,083216,Anzaldo; Leesa B,1,3,30,29
1650055440448,MATH 142A,A01,083219,Chow; Bennett,0,8,30,30
1650055440448,MATH 142A,A02,083220,Chow; Bennett,0,8,30,30
1650055440448,MATH 142A,B01,083221,Chow; Bennett,0,9,30,30
1650055440448,MATH 142A,B02,083222,Chow; Bennett,0,9,30,30
1650055446472,MATH 193A,A01,083224,Staff,0,4,30,30
1650055446472,MATH 193A,A02,083225,Staff,0,4,30,30
1650055446472,MATH 193A,A03,083781,Staff,0,0,30,30
1650055446472,MATH 193A,A04,083782,Staff,8,0,30,22
1650055452513,MATH 197,001,091859,McAuley; Julian John,9998,0,9999,1
1650055458569,COGS 9,A01,083615,Staff,3,17,60,57
1650055464605,COGS 11,A01,083617,Boyle; Mary E. T.,25,0,40,15
1650055470634,COGS 13,A01,083071,Staff,0,28,40,40
1650055476660,COGS 14A,A01,092681,Staff,0,8,100,100
1650055482683,COGS 14B,A01,083073,Cheng; Tzu-Han,0,3,50,50
1650055488710,COGS 17,A01,092677,Staff,35,0,75,40
1650055494737,COGS 100,A01,083619,Staff,0,17,60,60
1650055500763,COGS 101A,A01,083621,Davis; Joshua Daniel,0,16,60,60
1650055506796,COGS 101B,A01,091572,Staff,14,0,60,46
1650055512833,COGS 101C,A01,083625,Delgado; Tania,21,0,30,9
1650055518860,COGS 107A,A01,083627,Boyle; Mary E. T.,1,2,60,59
1650055524883,COGS 118A,A01,083075,Staff,19,0,60,41
1650055530906,CSE 3,A50,083646,Miranda; Gregory Joseph,22,0,38,16
1650055530906,CSE 3,A51,083647,Miranda; Gregory Joseph,37,0,37,0
1650055536936,CSE 8A,A50,083650,Miranda; Gregory Joseph,0,16,40,40
1650055542963,CSE 11,A01,083080,Cao; Yingjun,0,63,40,40
1650055548985,CSE 12,A01,083652,Staff,0,1,100,100
1650055555007,CSE 15L,A01,083654,Staff,0,0,50,50
1650055555007,CSE 15L,A02,083655,Staff,11,0,50,39
1650055561028,CSE 20,A01,083657,Staff,58,0,80,22
1650055567075,CSE 30,A01,083084,Eldon; John,0,63,40,40
1650055573101,CSE 100,A01,083659,Cao; Yingjun,0,57,50,50
1650055579128,CSE 134B,A01,083661,Powell; Thomas Allan,1,27,65,64
1650055585155,CSE 140,A01,083663,Staff,7,0,75,68
1650055591178,CSE 140L,A01,083088,Eldon; John,2,0,75,73
1650055597201,CSE 175,A01,083665,Kumar; Rakesh,9,0,25,16
1650055603437,CSE 190,A00,092507,Dubnov; Shlomo,14,0,20,6
1650055609471,ECE 45,A01,083139,Staff,0,12,40,40
1650055615499,ECE 65,A50,083695,Staff,0,3,30,30
1650055621537,ECE 109,A01,091882,Touri; Behrouz,48,0,70,22
1650055627560,ECE 180,A00,083140,Abi Samra; Nicholas Camill,24,0,30,6
1650055627560,ECE 180,B00,083141,Abi Samra; Nicholas Camill,8,0,30,22
1650055633584,MATH 10A,A01,083735,Patchell; Gregory David,12,0,30,18
1650055633584,MATH 10A,A02,083736,Patchell; Gregory David,28,0,30,2
1650055633584,MATH 10A,A03,083737,Patchell; Gregory David,27,0,30,3
1650055639623,MATH 10B,A01,083207,Staff,0,5,30,30
1650055639623,MATH 10B,A02,083208,Staff,0,1,30,30
1650055639623,MATH 10B,B01,083739,Staff,19,0,30,11
1650055639623,MATH 10B,B02,083740,Staff,30,0,30,0
1650055645660,MATH 18,A01,083743,Staff,10,0,30,20
1650055645660,MATH 18,A02,083744,Staff,28,0,30,2
1650055645660,MATH 18,A03,083745,Staff,23,0,30,7
1650055645660,MATH 18,A04,083746,Staff,27,0,30,3
1650055645660,MATH 18,B01,083748,Staff,0,9,30,30
1650055645660,MATH 18,B02,083749,Staff,1,6,30,29
1650055645660,MATH 18,B03,083750,Staff,0,6,30,30
1650055645660,MATH 18,B04,083751,Staff,1,7,30,29
1650055651684,MATH 20A,A01,083754,Staff,26,0,40,14
1650055657708,MATH 20B,A01,083756,Staff,0,5,30,30
1650055657708,MATH 20B,A02,083757,Staff,0,1,30,30
1650055663732,MATH 20C,A01,083760,Staff,0,9,30,30
1650055663732,MATH 20C,A02,083761,Staff,0,12,30,30
1650055663732,MATH 20C,B01,083762,Staff,16,0,30,14
1650055663732,MATH 20C,B02,083763,Staff,28,0,30,2
1650055669771,MATH 20D,A01,083765,Staff,0,2,30,30
1650055669771,MATH 20D,A02,083766,Staff,15,0,30,15
1650055669771,MATH 20D,A03,083767,Staff,28,0,30,2
1650055675794,MATH 20E,A01,083771,Staff,10,0,30,20
1650055675794,MATH 20E,A02,083772,Staff,20,0,30,10
1650055675794,MATH 20E,B01,083773,Staff,1,1,30,29
1650055675794,MATH 20E,B02,083774,Staff,17,0,30,13
1650055681833,MATH 103A,A01,083777,Staff,0,6,30,30
1650055681833,MATH 103A,A02,083778,Staff,0,7,30,30
1650055681833,MATH 103A,B01,083779,Staff,0,8,30,30
1650055681833,MATH 103A,B02,083780,Staff,0,6,30,30
1650055687858,MATH 105,A01,085443,Staff,0,11,30,30
1650055693891,MATH 109,A01,083213,Anzaldo; Leesa B,0,4,30,30
1650055693891,MATH 109,A02,083214,Anzaldo; Leesa B,0,4,30,30
1650055693891,MATH 109,B01,083215,Anzaldo; Leesa B,0,2,30,30
1650055693891,MATH 109,B02,083216,Anzaldo; Leesa B,1,3,30,29
1650055699920,MATH 142A,A01,083219,Chow; Bennett,0,8,30,30
1650055699920,MATH 142A,A02,083220,Chow; Bennett,0,8,30,30
1650055699920,MATH 142A,B01,083221,Chow; Bennett,0,9,30,30
1650055699920,MATH 142A,B02,083222,Chow; Bennett,0,9,30,30
1650055705950,MATH 193A,A01,083224,Staff,0,4,30,30
1650055705950,MATH 193A,A02,083225,Staff,0,4,30,30
1650055705950,MATH 193A,A03,083781,Staff,0,0,30,30
1650055705950,MATH 193A,A04,083782,Staff,8,0,30,22
1650055711976,MATH 197,001,091859,McAuley; Julian John,9998,0,9999,1
1650055718038,COGS 9,A01,083615,Staff,3,17,60,57
1650055724062,COGS 11,A01,083617,Boyle; Mary E. T.,25,0,40,15
1650055730089,COGS 13,A01,083071,Staff,0,28,40,40
1650055736110,COGS 14A,A01,092681,Staff,0,8,100,100
1650055742133,COGS 14B,A01,083073,Cheng; Tzu-Han,0,3,50,50
1650055748156,COGS 17,A01,092677,Staff,35,0,75,40
1650055754186,COGS 100,A01,083619,Staff,0,17,60,60
1650055760213,COGS 101A,A01,083621,Davis; Joshua Daniel,0,16,60,60
1650055766236,COGS 101B,A01,091572,Staff,14,0,60,46
1650055772264,COGS 101C,A01,083625,Delgado; Tania,21,0,30,9
1650055778302,COGS 107A,A01,083627,Boyle; Mary E. T.,1,2,60,59
1650055784325,COGS 118A,A01,083075,Staff,19,0,60,41
1650055790347,CSE 3,A50,083646,Miranda; Gregory Joseph,22,0,38,16
1650055790347,CSE 3,A51,083647,Miranda; Gregory Joseph,37,0,37,0
1650055796374,CSE 8A,A50,083650,Miranda; Gregory Joseph,0,16,40,40
1650055802413,CSE 11,A01,083080,Cao; Yingjun,0,63,40,40
1650055808437,CSE 12,A01,083652,Staff,0,1,100,100
1650055814461,CSE 15L,A01,083654,Staff,0,0,50,50
1650055814461,CSE 15L,A02,083655,Staff,11,0,50,39
1650055820485,CSE 20,A01,083657,Staff,58,0,80,22
1650055826511,CSE 30,A01,083084,Eldon; John,0,63,40,40
1650055832533,CSE 100,A01,083659,Cao; Yingjun,0,57,50,50
1650055838560,CSE 134B,A01,083661,Powell; Thomas Allan,1,27,65,64
1650055844585,CSE 140,A01,083663,Staff,7,0,75,68
1650055850621,CSE 140L,A01,083088,Eldon; John,2,0,75,73
1650055856645,CSE 175,A01,083665,Kumar; Rakesh,9,0,25,16
1650055862670,CSE 190,A00,092507,Dubnov; Shlomo,14,0,20,6
1650055868695,ECE 45,A01,083139,Staff,0,12,40,40
1650055874719,ECE 65,A50,083695,Staff,0,3,30,30
1650055880749,ECE 109,A01,091882,Touri; Behrouz,48,0,70,22
1650055886777,ECE 180,A00,083140,Abi Samra; Nicholas Camill,24,0,30,6
1650055886777,ECE 180,B00,083141,Abi Samra; Nicholas Camill,8,0,30,22
1650055892802,MATH 10A,A01,083735,Patchell; Gregory David,12,0,30,18
1650055892802,MATH 10A,A02,083736,Patchell; Gregory David,28,0,30,2
1650055892802,MATH 10A,A03,083737,Patchell; Gregory David,27,0,30,3
1650055898828,MATH 10B,A01,083207,Staff,0,5,30,30
1650055898828,MATH 10B,A02,083208,Staff,0,2,30,30
1650055898828,MATH 10B,B01,083739,Staff,19,0,30,11
1650055898828,MATH 10B,B02,083740,Staff,30,0,30,0
1650055904854,MATH 18,A01,083743,Staff,10,0,30,20
1650055904854,MATH 18,A02,083744,Staff,28,0,30,2
1650055904854,MATH 18,A03,083745,Staff,23,0,30,7
1650055904854,MATH 18,A04,083746,Staff,27,0,30,3
1650055904854,MATH 18,B01,083748,Staff,0,9,30,30
1650055904854,MATH 18,B02,083749,Staff,1,6,30,29
1650055904854,MATH 18,B03,083750,Staff,0,6,30,30
1650055904854,MATH 18,B04,083751,Staff,1,7,30,29
1650055910878,MATH 20A,A01,083754,Staff,26,0,40,14
1650055916913,MATH 20B,A01,083756,Staff,0,5,30,30
1650055916913,MATH 20B,A02,083757,Staff,0,1,30,30
1650055922938,MATH 20C,A01,083760,Staff,0,9,30,30
1650055922938,MATH 20C,A02,083761,Staff,0,12,30,30
1650055922938,MATH 20C,B01,083762,Staff,16,0,30,14
1650055922938,MATH 20C,B02,083763,Staff,28,0,30,2
1650055928967,MATH 20D,A01,083765,Staff,0,2,30,30
1650055928967,MATH 20D,A02,083766,Staff,15,0,30,15
1650055928967,MATH 20D,A03,083767,Staff,28,0,30,2
1650055934998,MATH 20E,A01,083771,Staff,10,0,30,20
1650055934998,MATH 20E,A02,083772,Staff,20,0,30,10
1650055934998,MATH 20E,B01,083773,Staff,1,1,30,29
1650055934998,MATH 20E,B02,083774,Staff,17,0,30,13
1650055941021,MATH 103A,A01,083777,Staff,0,6,30,30
1650055941021,MATH 103A,A02,083778,Staff,0,7,30,30
1650055941021,MATH 103A,B01,083779,Staff,0,8,30,30
1650055941021,MATH 103A,B02,083780,Staff,0,6,30,30
1650055947049,MATH 105,A01,085443,Staff,0,11,30,30
1650055953075,MATH 109,A01,083213,Anzaldo; Leesa B,0,4,30,30
1650055953075,MATH 109,A02,083214,Anzaldo; Leesa B,0,4,30,30
1650055953075,MATH 109,B01,083215,Anzaldo; Leesa B,0,2,30,30
1650055953075,MATH 109,B02,083216,Anzaldo; Leesa B,1,3,30,29
1650055959109,MATH 142A,A01,083219,Chow; Bennett,0,8,30,30
1650055959109,MATH 142A,A02,083220,Chow; Bennett,0,8,30,30
1650055959109,MATH 142A,B01,083221,Chow; Bennett,0,9,30,30
1650055959109,MATH 142A,B02,083222,Chow; Bennett,0,9,30,30
1650055965133,MATH 193A,A01,083224,Staff,0,4,30,30
1650055965133,MATH 193A,A02,083225,Staff,0,4,30,30
1650055965133,MATH 193A,A03,083781,Staff,0,0,30,30
1650055965133,MATH 193A,A04,083782,Staff,8,0,30,22
1650055971158,MATH 197,001,091859,McAuley; Julian John,9998,0,9999,1
1650055977211,COGS 9,A01,083615,Staff,3,17,60,57
1650055983239,COGS 11,A01,083617,Boyle; Mary E. T.,25,0,40,15
1650055989355,COGS 13,A01,083071,Staff,0,28,40,40
1650055995380,COGS 14A,A01,092681,Staff,0,8,100,100
1650056001403,COGS 14B,A01,083073,Cheng; Tzu-Han,0,3,50,50
1650056007426,COGS 17,A01,092677,Staff,35,0,75,40
1650056013447,COGS 100,A01,083619,Staff,0,17,60,60
1650056019475,COGS 101A,A01,083621,Davis; Joshua Daniel,0,16,60,60
1650056025502,COGS 101B,A01,091572,Staff,14,0,60,46
1650056031537,COGS 101C,A01,083625,Delgado; Tania,21,0,30,9
1650056037563,COGS 107A,A01,083627,Boyle; Mary E. T.,1,2,60,59
1650056043592,COGS 118A,A01,083075,Staff,19,0,60,41
1650056049617,CSE 3,A50,083646,Miranda; Gregory Joseph,22,0,38,16
1650056049617,CSE 3,A51,083647,Miranda; Gregory Joseph,37,0,37,0
1650056055641,CSE 8A,A50,083650,Miranda; Gregory Joseph,0,16,40,40
1650056061665,CSE 11,A01,083080,Cao; Yingjun,0,63,40,40
1650056067689,CSE 12,A01,083652,Staff,0,1,100,100
1650056073713,CSE 15L,A01,083654,Staff,0,0,50,50
1650056073713,CSE 15L,A02,083655,Staff,11,0,50,39
1650056079740,CSE 20,A01,083657,Staff,58,0,80,22
1650056085765,CSE 30,A01,083084,Eldon; John,0,63,40,40
1650056091793,CSE 100,A01,083659,Cao; Yingjun,0,57,50,50
1650056097818,CSE 134B,A01,083661,Powell; Thomas Allan,1,27,65,64
1650056103842,CSE 140,A01,083663,Staff,7,0,75,68
1650056109866,CSE 140L,A01,083088,Eldon; John,2,0,75,73
1650056115898,CSE 175,A01,083665,Kumar; Rakesh,9,0,25,16
1650056121924,CSE 190,A00,092507,Dubnov; Shlomo,14,0,20,6
1650056127947,ECE 45,A01,083139,Staff,0,12,40,40
1650056133976,ECE 65,A50,083695,Staff,0,3,30,30
1650056140013,ECE 109,A01,091882,Touri; Behrouz,48,0,70,22
1650056146036,ECE 180,A00,083140,Abi Samra; Nicholas Camill,24,0,30,6
1650056146036,ECE 180,B00,083141,Abi Samra; Nicholas Camill,8,0,30,22
1650056152068,MATH 10A,A01,083735,Patchell; Gregory David,12,0,30,18
1650056152068,MATH 10A,A02,083736,Patchell; Gregory David,28,0,30,2
1650056152068,MATH 10A,A03,083737,Patchell; Gregory David,27,0,30,3
1650056158090,MATH 10B,A01,083207,Staff,0,5,30,30
1650056158090,MATH 10B,A02,083208,Staff,0,2,30,30
1650056158090,MATH 10B,B01,083739,Staff,19,0,30,11
1650056158090,MATH 10B,B02,083740,Staff,30,0,30,0
1650056164116,MATH 18,A01,083743,Staff,10,0,30,20
1650056164116,MATH 18,A02,083744,Staff,28,0,30,2
1650056164116,MATH 18,A03,083745,Staff,23,0,30,7
1650056164116,MATH 18,A04,083746,Staff,27,0,30,3
1650056164116,MATH 18,B01,083748,Staff,0,9,30,30
1650056164116,MATH 18,B02,083749,Staff,1,6,30,29
1650056164116,MATH 18,B03,083750,Staff,0,6,30,30
1650056164116,MATH 18,B04,083751,Staff,1,7,30,29
1650056170152,MATH 20A,A01,083754,Staff,26,0,40,14
1650056176185,MATH 20B,A01,083756,Staff,0,5,30,30
1650056176185,MATH 20B,A02,083757,Staff,0,1,30,30
1650056182208,MATH 20C,A01,083760,Staff,0,9,30,30
1650056182208,MATH 20C,A02,083761,Staff,0,12,30,30
1650056182208,MATH 20C,B01,083762,Staff,16,0,30,14
1650056182208,MATH 20C,B02,083763,Staff,28,0,30,2
1650056188234,MATH 20D,A01,083765,Staff,0,2,30,30
1650056188234,MATH 20D,A02,083766,Staff,15,0,30,15
1650056188234,MATH 20D,A03,083767,Staff,28,0,30,2
1650056194258,MATH 20E,A01,083771,Staff,10,0,30,20
1650056194258,MATH 20E,A02,083772,Staff,20,0,30,10
1650056194258,MATH 20E,B01,083773,Staff,1,1,30,29
1650056194258,MATH 20E,B02,083774,Staff,17,0,30,13
1650056200281,MATH 103A,A01,083777,Staff,0,6,30,30
1650056200281,MATH 103A,A02,083778,Staff,0,7,30,30
1650056200281,MATH 103A,B01,083779,Staff,0,8,30,30
1650056200281,MATH 103A,B02,083780,Staff,0,6,30,30
1650056206323,MATH 105,A01,085443,Staff,0,11,30,30
1650056212352,MATH 109,A01,083213,Anzaldo; Leesa B,0,4,30,30
1650056212352,MATH 109,A02,083214,Anzaldo; Leesa B,0,4,30,30
1650056212352,MATH 109,B01,083215,Anzaldo; Leesa B,0,2,30,30
1650056212352,MATH 109,B02,083216,Anzaldo; Leesa B,1,3,30,29
1650056218379,MATH 142A,A01,083219,Chow; Bennett,0,8,30,30
1650056218379,MATH 142A,A02,083220,Chow; Bennett,0,8,30,30
1650056218379,MATH 142A,B01,083221,Chow; Bennett,0,9,30,30
1650056218379,MATH 142A,B02,083222,Chow; Bennett,0,9,30,30
1650056224409,MATH 193A,A01,083224,Staff,0,4,30,30
1650056224409,MATH 193A,A02,083225,Staff,0,4,30,30
1650056224409,MATH 193A,A03,083781,Staff,0,0,30,30
1650056224409,MATH 193A,A04,083782,Staff,8,0,30,22
1650056230436,MATH 197,001,091859,McAuley; Julian John,9998,0,9999,1
1650056236486,COGS 9,A01,083615,Staff,3,17,60,57
1650056242511,COGS 11,A01,083617,Boyle; Mary E. T.,25,0,40,15
1650056248536,COGS 13,A01,083071,Staff,0,28,40,40
1650056254560,COGS 14A,A01,092681,Staff,0,8,100,100
1650056260583,COGS 14B,A01,083073,Cheng; Tzu-Han,0,3,50,50
1650056266611,COGS 17,A01,092677,Staff,35,0,75,40
1650056272635,COGS 100,A01,083619,Staff,0,17,60,60
1650056278661,COGS 101A,A01,083621,Davis; Joshua Daniel,0,16,60,60
1650056284683,COGS 101B,A01,091572,Staff,14,0,60,46
1650056290707,COGS 101C,A01,083625,Delgado; Tania,21,0,30,9
1650056296742,COGS 107A,A01,083627,Boyle; Mary E. T.,1,2,60,59
1650056302778,COGS 118A,A01,083075,Staff,19,0,60,41
1650056308802,CSE 3,A50,083646,Miranda; Gregory Joseph,22,0,38,16
1650056308802,CSE 3,A51,083647,Miranda; Gregory Joseph,37,0,37,0
1650056314825,CSE 8A,A50,083650,Miranda; Gregory Joseph,0,16,40,40
1650056320848,CSE 11,A01,083080,Cao; Yingjun,0,63,40,40
1650056326874,CSE 12,A01,083652,Staff,0,1,100,100
1650056332901,CSE 15L,A01,083654,Staff,0,0,50,50
1650056332901,CSE 15L,A02,083655,Staff,11,0,50,39
1650056338935,CSE 20,A01,083657,Staff,58,0,80,22
1650056344967,CSE 30,A01,083084,Eldon; John,0,63,40,40
1650056350993,CSE 100,A01,083659,Cao; Yingjun,0,57,50,50
1650056357017,CSE 134B,A01,083661,Powell; Thomas Allan,1,27,65,64
1650056363046,CSE 140,A01,083663,Staff,7,0,75,68
1650056369072,CSE 140L,A01,083088,Eldon; John,2,0,75,73
1650056375098,CSE 175,A01,083665,Kumar; Rakesh,9,0,25,16
1650056381123,CSE 190,A00,092507,Dubnov; Shlomo,14,0,20,6
1650056387152,ECE 45,A01,083139,Staff,0,12,40,40
1650056393217,ECE 65,A50,083695,Staff,0,3,30,30
1650056399241,ECE 109,A01,091882,Touri; Behrouz,48,0,70,22
1650056405264,ECE 180,A00,083140,Abi Samra; Nicholas Camill,24,0,30,6
1650056405264,ECE 180,B00,083141,Abi Samra; Nicholas Camill,8,0,30,22
1650056411292,MATH 10A,A01,083735,Patchell; Gregory David,12,0,30,18
1650056411292,MATH 10A,A02,083736,Patchell; Gregory David,28,0,30,2
1650056411292,MATH 10A,A03,083737,Patchell; Gregory David,27,0,30,3
1650056417317,MATH 10B,A01,083207,Staff,0,5,30,30
1650056417317,MATH 10B,A02,083208,Staff,0,2,30,30
1650056417317,MATH 10B,B01,083739,Staff,20,0,30,10
1650056417317,MATH 10B,B02,083740,Staff,30,0,30,0
1650056423343,MATH 18,A01,083743,Staff,10,0,30,20
1650056423343,MATH 18,A02,083744,Staff,28,0,30,2
1650056423343,MATH 18,A03,083745,Staff,23,0,30,7
1650056423343,MATH 18,A04,083746,Staff,27,0,30,3
1650056423343,MATH 18,B01,083748,Staff,0,9,30,30
1650056423343,MATH 18,B02,083749,Staff,1,6,30,29
1650056423343,MATH 18,B03,083750,Staff,0,6,30,30
1650056423343,MATH 18,B04,083751,Staff,1,7,30,29
1650056429373,MATH 20A,A01,083754,Staff,26,0,40,14
1650056435394,MATH 20B,A01,083756,Staff,0,5,30,30
1650056435394,MATH 20B,A02,083757,Staff,0,1,30,30
1650056441431,MATH 20C,A01,083760,Staff,0,9,30,30
1650056441431,MATH 20C,A02,083761,Staff,0,12,30,30
1650056441431,MATH 20C,B01,083762,Staff,16,0,30,14
1650056441431,MATH 20C,B02,083763,Staff,28,0,30,2
1650056447461,MATH 20D,A01,083765,Staff,0,2,30,30
1650056447461,MATH 20D,A02,083766,Staff,15,0,30,15
1650056447461,MATH 20D,A03,083767,Staff,28,0,30,2
1650056453484,MATH 20E,A01,083771,Staff,10,0,30,20
1650056453484,MATH 20E,A02,083772,Staff,20,0,30,10
1650056453484,MATH 20E,B01,083773,Staff,1,1,30,29
1650056453484,MATH 20E,B02,083774,Staff,17,0,30,13
1650056459510,MATH 103A,A01,083777,Staff,0,6,30,30
1650056459510,MATH 103A,A02,083778,Staff,0,7,30,30
1650056459510,MATH 103A,B01,083779,Staff,0,8,30,30
1650056459510,MATH 103A,B02,083780,Staff,0,6,30,30
1650056465539,MATH 105,A01,085443,Staff,0,11,30,30
1650056471566,MATH 109,A01,083213,Anzaldo; Leesa B,0,4,30,30
1650056471566,MATH 109,A02,083214,Anzaldo; Leesa B,0,4,30,30
1650056471566,MATH 109,B01,083215,Anzaldo; Leesa B,0,2,30,30
1650056471566,MATH 109,B02,083216,Anzaldo; Leesa B,1,3,30,29
1650056477597,MATH 142A,A01,083219,Chow; Bennett,0,8,30,30
1650056477597,MATH 142A,A02,083220,Chow; Bennett,0,8,30,30
1650056477597,MATH 142A,B01,083221,Chow; Bennett,0,9,30,30
1650056477597,MATH 142A,B02,083222,Chow; Bennett,0,9,30,30
1650056483621,MATH 193A,A01,083224,Staff,0,4,30,30
1650056483621,MATH 193A,A02,083225,Staff,0,4,30,30
1650056483621,MATH 193A,A03,083781,Staff,0,0,30,30
1650056483621,MATH 193A,A04,083782,Staff,8,0,30,22
1650056489644,MATH 197,001,091859,McAuley; Julian John,9998,0,9999,1
1650056495694,COGS 9,A01,083615,Staff,3,17,60,57
1650056501721,COGS 11,A01,083617,Boyle; Mary E. T.,25,0,40,15
1650056507755,COGS 13,A01,083071,Staff,0,28,40,40
1650056513778,COGS 14A,A01,092681,Staff,0,8,100,100
1650056519800,COGS 14B,A01,083073,Cheng; Tzu-Han,0,3,50,50
1650056525829,COGS 17,A01,092677,Staff,35,0,75,40
1650056531853,COGS 100,A01,083619,Staff,0,17,60,60
1650056537879,COGS 101A,A01,083621,Davis; Joshua Daniel,0,16,60,60
1650056543904,COGS 101B,A01,091572,Staff,14,0,60,46
1650056549930,COGS 101C,A01,083625,Delgado; Tania,21,0,30,9
1650056555956,COGS 107A,A01,083627,Boyle; Mary E. T.,1,2,60,59
1650056561978,COGS 118A,A01,083075,Staff,19,0,60,41
1650056568006,CSE 3,A50,083646,Miranda; Gregory Joseph,22,0,38,16
1650056568006,CSE 3,A51,083647,Miranda; Gregory Joseph,37,0,37,0
1650056574033,CSE 8A,A50,083650,Miranda; Gregory Joseph,0,16,40,40
1650056580058,CSE 11,A01,083080,Cao; Yingjun,0,63,40,40
1650056586176,CSE 12,A01,083652,Staff,0,1,100,100
1650056592201,CSE 15L,A01,083654,Staff,0,0,50,50
1650056592201,CSE 15L,A02,083655,Staff,11,0,50,39
1650056598226,CSE 20,A01,083657,Staff,58,0,80,22
1650056604253,CSE 30,A01,083084,Eldon; John,0,63,40,40
1650056610277,CSE 100,A01,083659,Cao; Yingjun,0,57,50,50
1650056616308,CSE 134B,A01,083661,Powell; Thomas Allan,1,27,65,64
1650056622338,CSE 140,A01,083663,Staff,7,0,75,68
1650056628364,CSE 140L,A01,083088,Eldon; John,2,0,75,73
1650056634400,CSE 175,A01,083665,Kumar; Rakesh,9,0,25,16
1650056640423,CSE 190,A00,092507,Dubnov; Shlomo,14,0,20,6
1650056646451,ECE 45,A01,083139,Staff,0,12,40,40
1650056652477,ECE 65,A50,083695,Staff,0,3,30,30
1650056658506,ECE 109,A01,091882,Touri; Behrouz,48,0,70,22
1650056664534,ECE 180,A00,083140,Abi Samra; Nicholas Camill,24,0,30,6
1650056664534,ECE 180,B00,083141,Abi Samra; Nicholas Camill,8,0,30,22
1650056670571,MATH 10A,A01,083735,Patchell; Gregory David,12,0,30,18
1650056670571,MATH 10A,A02,083736,Patchell; Gregory David,28,0,30,2
1650056670571,MATH 10A,A03,083737,Patchell; Gregory David,27,0,30,3
1650056676595,MATH 10B,A01,083207,Staff,0,5,30,30
1650056676595,MATH 10B,A02,083208,Staff,0,2,30,30
1650056676595,MATH 10B,B01,083739,Staff,20,0,30,10
1650056676595,MATH 10B,B02,083740,Staff,30,0,30,0
1650056682621,MATH 18,A01,083743,Staff,10,0,30,20
1650056682621,MATH 18,A02,083744,Staff,28,0,30,2
1650056682621,MATH 18,A03,083745,Staff,23,0,30,7
1650056682621,MATH 18,A04,083746,Staff,27,0,30,3
1650056682621,MATH 18,B01,083748,Staff,0,9,30,30
1650056682621,MATH 18,B02,083749,Staff,1,6,30,29
1650056682621,MATH 18,B03,083750,Staff,0,6,30,30
1650056682621,MATH 18,B04,083751,Staff,1,7,30,29
1650056688649,MATH 20A,A01,083754,Staff,26,0,40,14
1650056694679,MATH 20B,A01,083756,Staff,0,5,30,30
1650056694679,MATH 20B,A02,083757,Staff,0,1,30,30
1650056700701,MATH 20C,A01,083760,Staff,0,9,30,30
1650056700701,MATH 20C,A02,083761,Staff,0,12,30,30
1650056700701,MATH 20C,B01,083762,Staff,16,0,30,14
1650056700701,MATH 20C,B02,083763,Staff,28,0,30,2
1650056706730,MATH 20D,A01,083765,Staff,0,2,30,30
1650056706730,MATH 20D,A02,083766,Staff,15,0,30,15
1650056706730,MATH 20D,A03,083767,Staff,28,0,30,2
1650056712761,MATH 20E,A01,083771,Staff,10,0,30,20
1650056712761,MATH 20E,A02,083772,Staff,20,0,30,10
1650056712761,MATH 20E,B01,083773,Staff,1,1,30,29
1650056712761,MATH 20E,B02,083774,Staff,17,0,30,13
1650056718786,MATH 103A,A01,083777,Staff,0,6,30,30
1650056718786,MATH 103A,A02,083778,Staff,0,7,30,30
1650056718786,MATH 103A,B01,083779,Staff,0,8,30,30
1650056718786,MATH 103A,B02,083780,Staff,0,6,30,30
1650056724834,MATH 105,A01,085443,Staff,0,11,30,30
1650056730864,MATH 109,A01,083213,Anzaldo; Leesa B,0,4,30,30
1650056730864,MATH 109,A02,083214,Anzaldo; Leesa B,0,4,30,30
1650056730864,MATH 109,B01,083215,Anzaldo; Leesa B,0,2,30,30
1650056730864,MATH 109,B02,083216,Anzaldo; Leesa B,1,3,30,29
1650056736890,MATH 142A,A01,083219,Chow; Bennett,0,8,30,30
1650056736890,MATH 142A,A02,083220,Chow; Bennett,0,8,30,30
1650056736890,MATH 142A,B01,083221,Chow; Bennett,0,9,30,30
1650056736890,MATH 142A,B02,083222,Chow; Bennett,0,9,30,30
1650056742925,MATH 193A,A01,083224,Staff,0,4,30,30
1650056742925,MATH 193A,A02,083225,Staff,0,4,30,30
1650056742925,MATH 193A,A03,083781,Staff,0,0,30,30
1650056742925,MATH 193A,A04,083782,Staff,8,0,30,22
1650056748951,MATH 197,001,091859,McAuley; Julian John,9998,0,9999,1
1650056755010,COGS 9,A01,083615,Staff,3,17,60,57
1650056761034,COGS 11,A01,083617,Boyle; Mary E. T.,25,0,40,15
1650056767061,COGS 13,A01,083071,Staff,0,28,40,40
1650056773094,COGS 14A,A01,092681,Staff,0,8,100,100
1650056779124,COGS 14B,A01,083073,Cheng; Tzu-Han,0,3,50,50
1650056785151,COGS 17,A01,092677,Staff,35,0,75,40
1650056791189,COGS 100,A01,083619,Staff,0,17,60,60
1650056797212,COGS 101A,A01,083621,Davis; Joshua Daniel,0,16,60,60
1650056803242,COGS 101B,A01,091572,Staff,14,0,60,46
1650056809269,COGS 101C,A01,083625,Delgado; Tania,21,0,30,9
1650056815292,COGS 107A,A01,083627,Boyle; Mary E. T.,1,2,60,59
1650056821319,COGS 118A,A01,083075,Staff,19,0,60,41
1650056827353,CSE 3,A50,083646,Miranda; Gregory Joseph,22,0,38,16
1650056827353,CSE 3,A51,083647,Miranda; Gregory Joseph,37,0,37,0
1650056833377,CSE 8A,A50,083650,Miranda; Gregory Joseph,0,16,40,40
1650056839408,CSE 11,A01,083080,Cao; Yingjun,0,62,40,40
1650056845439,CSE 12,A01,083652,Staff,0,1,100,100
1650056851467,CSE 15L,A01,083654,Staff,0,0,50,50
1650056851467,CSE 15L,A02,083655,Staff,11,0,50,39
1650056857501,CSE 20,A01,083657,Staff,58,0,80,22
1650056863535,CSE 30,A01,083084,Eldon; John,0,63,40,40
1650056869558,CSE 100,A01,083659,Cao; Yingjun,0,57,50,50
1650056875581,CSE 134B,A01,083661,Powell; Thomas Allan,1,27,65,64
1650056881610,CSE 140,A01,083663,Staff,7,0,75,68
1650056887634,CSE 140L,A01,083088,Eldon; John,2,0,75,73
1650056893674,CSE 175,A01,083665,Kumar; Rakesh,9,0,25,16
1650056899701,CSE 190,A00,092507,Dubnov; Shlomo,14,0,20,6
1650056905728,ECE 45,A01,083139,Staff,0,12,40,40
1650056911755,ECE 65,A50,083695,Staff,0,3,30,30
1650056917777,ECE 109,A01,091882,Touri; Behrouz,48,0,70,22
1650056923813,ECE 180,A00,083140,Abi Samra; Nicholas Camill,24,0,30,6
1650056923813,ECE 180,B00,083141,Abi Samra; Nicholas Camill,8,0,30,22
1650056929845,MATH 10A,A01,083735,Patchell; Gregory David,12,0,30,18
1650056929845,MATH 10A,A02,083736,Patchell; Gregory David,28,0,30,2
1650056929845,MATH 10A,A03,083737,Patchell; Gregory David,27,0,30,3
1650056935869,MATH 10B,A01,083207,Staff,0,5,30,30
1650056935869,MATH 10B,A02,083208,Staff,0,2,30,30
1650056935869,MATH 10B,B01,083739,Staff,20,0,30,10
1650056935869,MATH 10B,B02,083740,Staff,30,0,30,0
1650056941899,MATH 18,A01,083743,Staff,10,0,30,20
1650056941899,MATH 18,A02,083744,Staff,28,0,30,2
1650056941899,MATH 18,A03,083745,Staff,23,0,30,7
1650056941899,MATH 18,A04,083746,Staff,27,0,30,3
1650056941899,MATH 18,B01,083748,Staff,0,9,30,30
1650056941899,MATH 18,B02,083749,Staff,1,6,30,29
1650056941899,MATH 18,B03,083750,Staff,0,6,30,30
1650056941899,MATH 18,B04,083751,Staff,1,7,30,29
1650056947921,MATH 20A,A01,083754,Staff,26,0,40,14
1650056953949,MATH 20B,A01,083756,Staff,0,5,30,30
1650056953949,MATH 20B,A02,083757,Staff,0,1,30,30
1650056959983,MATH 20C,A01,083760,Staff,0,9,30,30
1650056959983,MATH 20C,A02,083761,Staff,0,12,30,30
1650056959983,MATH 20C,B01,083762,Staff,16,0,30,14
1650056959983,MATH 20C,B02,083763,Staff,28,0,30,2
1650056966005,MATH 20D,A01,083765,Staff,0,2,30,30
1650056966005,MATH 20D,A02,083766,Staff,15,0,30,15
1650056966005,MATH 20D,A03,083767,Staff,28,0,30,2
1650056972030,MATH 20E,A01,083771,Staff,10,0,30,20
1650056972030,MATH 20E,A02,083772,Staff,20,0,30,10
1650056972030,MATH 20E,B01,083773,Staff,1,1,30,29
1650056972030,MATH 20E,B02,083774,Staff,17,0,30,13
1650056978055,MATH 103A,A01,083777,Staff,0,6,30,30
1650056978055,MATH 103A,A02,083778,Staff,0,7,30,30
1650056978055,MATH 103A,B01,083779,Staff,0,8,30,30
1650056978055,MATH 103A,B02,083780,Staff,0,6,30,30
1650056984079,MATH 105,A01,085443,Staff,0,11,30,30
1650056990104,MATH 109,A01,083213,Anzaldo; Leesa B,0,4,30,30
1650056990104,MATH 109,A02,083214,Anzaldo; Leesa B,0,4,30,30
1650056990104,MATH 109,B01,083215,Anzaldo; Leesa B,0,2,30,30
1650056990104,MATH 109,B02,083216,Anzaldo; Leesa B,1,3,30,29
1650056996132,MATH 142A,A01,083219,Chow; Bennett,0,8,30,30
1650056996132,MATH 142A,A02,083220,Chow; Bennett,0,8,30,30
1650056996132,MATH 142A,B01,083221,Chow; Bennett,0,9,30,30
1650056996132,MATH 142A,B02,083222,Chow; Bennett,0,9,30,30
1650057002154,MATH 193A,A01,083224,Staff,0,4,30,30
1650057002154,MATH 193A,A02,083225,Staff,0,4,30,30
1650057002154,MATH 193A,A03,083781,Staff,0,0,30,30
1650057002154,MATH 193A,A04,083782,Staff,8,0,30,22
1650057008180,MATH 197,001,091859,McAuley; Julian John,9998,0,9999,1
1650057014240,COGS 9,A01,083615,Staff,3,17,60,57
1650057020266,COGS 11,A01,083617,Boyle; Mary E. T.,25,0,40,15
1650057026291,COGS 13,A01,083071,Staff,0,28,40,40
1650057032314,COGS 14A,A01,092681,Staff,0,8,100,100
1650057038336,COGS 14B,A01,083073,Cheng; Tzu-Han,0,3,50,50
1650057044362,COGS 17,A01,092677,Staff,35,0,75,40
1650057050385,COGS 100,A01,083619,Staff,0,17,60,60
1650057056407,COGS 101A,A01,083621,Davis; Joshua Daniel,0,16,60,60
1650057062434,COGS 101B,A01,091572,Staff,14,0,60,46
1650057068460,COGS 101C,A01,083625,Delgado; Tania,21,0,30,9
1650057074494,COGS 107A,A01,083627,Boyle; Mary E. T.,1,2,60,59
1650057080521,COGS 118A,A01,083075,Staff,19,0,60,41
1650057086545,CSE 3,A50,083646,Miranda; Gregory Joseph,22,0,38,16
1650057086545,CSE 3,A51,083647,Miranda; Gregory Joseph,37,0,37,0
1650057092568,CSE 8A,A50,083650,Miranda; Gregory Joseph,0,16,40,40
1650057098603,CSE 11,A01,083080,Cao; Yingjun,0,62,40,40
1650057104628,CSE 12,A01,083652,Staff,0,1,100,100
1650057110657,CSE 15L,A01,083654,Staff,0,0,50,50
1650057110657,CSE 15L,A02,083655,Staff,11,0,50,39
1650057116685,CSE 20,A01,083657,Staff,58,0,80,22
1650057122708,CSE 30,A01,083084,Eldon; John,0,63,40,40
1650057128735,CSE 100,A01,083659,Cao; Yingjun,0,57,50,50
1650057134763,CSE 134B,A01,083661,Powell; Thomas Allan,1,27,65,64
1650057140786,CSE 140,A01,083663,Staff,7,0,75,68
1650057146820,CSE 140L,A01,083088,Eldon; John,2,0,75,73
1650057152846,CSE 175,A01,083665,Kumar; Rakesh,9,0,25,16
1650057158872,CSE 190,A00,092507,Dubnov; Shlomo,14,0,20,6
1650057164896,ECE 45,A01,083139,Staff,0,12,40,40
1650057170919,ECE 65,A50,083695,Staff,0,3,30,30
1650057176949,ECE 109,A01,091882,Touri; Behrouz,48,0,70,22
1650057183069,ECE 180,A00,083140,Abi Samra; Nicholas Camill,24,0,30,6
1650057183069,ECE 180,B00,083141,Abi Samra; Nicholas Camill,8,0,30,22
1650057189097,MATH 10A,A01,083735,Patchell; Gregory David,12,0,30,18
1650057189097,MATH 10A,A02,083736,Patchell; Gregory David,28,0,30,2
1650057189097,MATH 10A,A03,083737,Patchell; Gregory David,27,0,30,3
1650057195127,MATH 10B,A01,083207,Staff,0,5,30,30
1650057195127,MATH 10B,A02,083208,Staff,0,2,30,30
1650057195127,MATH 10B,B01,083739,Staff,20,0,30,10
1650057195127,MATH 10B,B02,083740,Staff,30,0,30,0
1650057201157,MATH 18,A01,083743,Staff,10,0,30,20
1650057201157,MATH 18,A02,083744,Staff,28,0,30,2
1650057201157,MATH 18,A03,083745,Staff,23,0,30,7
1650057201157,MATH 18,A04,083746,Staff,27,0,30,3
1650057201157,MATH 18,B01,083748,Staff,0,9,30,30
1650057201157,MATH 18,B02,083749,Staff,1,6,30,29
1650057201157,MATH 18,B03,083750,Staff,0,6,30,30
1650057201157,MATH 18,B04,083751,Staff,1,7,30,29
1650057207190,MATH 20A,A01,083754,Staff,26,0,40,14
1650057213216,MATH 20B,A01,083756,Staff,0,5,30,30
1650057213216,MATH 20B,A02,083757,Staff,0,1,30,30
1650057219248,MATH 20C,A01,083760,Staff,0,9,30,30
1650057219248,MATH 20C,A02,083761,Staff,0,12,30,30
1650057219248,MATH 20C,B01,083762,Staff,16,0,30,14
1650057219248,MATH 20C,B02,083763,Staff,28,0,30,2
1650057225283,MATH 20D,A01,083765,Staff,0,2,30,30
1650057225283,MATH 20D,A02,083766,Staff,15,0,30,15
1650057225283,MATH 20D,A03,083767,Staff,28,0,30,2
1650057231306,MATH 20E,A01,083771,Staff,10,0,30,20
1650057231306,MATH 20E,A02,083772,Staff,20,0,30,10
1650057231306,MATH 20E,B01,083773,Staff,1,1,30,29
1650057231306,MATH 20E,B02,083774,Staff,17,0,30,13
1650057237341,MATH 103A,A01,083777,Staff,0,6,30,30
1650057237341,MATH 103A,A02,083778,Staff,0,7,30,30
1650057237341,MATH 103A,B01,083779,Staff,0,8,30,30
1650057237341,MATH 103A,B02,083780,Staff,0,6,30,30
1650057243369,MATH 105,A01,085443,Staff,0,11,30,30
1650057249393,MATH 109,A01,083213,Anzaldo; Leesa B,0,4,30,30
1650057249393,MATH 109,A02,083214,Anzaldo; Leesa B,0,4,30,30
1650057249393,MATH 109,B01,083215,Anzaldo; Leesa B,0,2,30,30
1650057249393,MATH 109,B02,083216,Anzaldo; Leesa B,1,3,30,29
1650057255425,MATH 142A,A01,083219,Chow; Bennett,0,8,30,30
1650057255425,MATH 142A,A02,083220,Chow; Bennett,0,8,30,30
1650057255425,MATH 142A,B01,083221,Chow; Bennett,0,9,30,30
1650057255425,MATH 142A,B02,083222,Chow; Bennett,0,9,30,30
1650057261467,MATH 193A,A01,083224,Staff,0,4,30,30
1650057261467,MATH 193A,A02,083225,Staff,0,4,30,30
1650057261467,MATH 193A,A03,083781,Staff,0,0,30,30
1650057261467,MATH 193A,A04,083782,Staff,8,0,30,22
1650057267498,MATH 197,001,091859,McAuley; Julian John,9998,0,9999,1
1650057273561,COGS 9,A01,083615,Staff,3,17,60,57
1650057279585,COGS 11,A01,083617,Boyle; Mary E. T.,25,0,40,15
1650057285621,COGS 13,A01,083071,Staff,0,28,40,40
1650057291671,COGS 14A,A01,092681,Staff,0,8,100,100
1650057297694,COGS 14B,A01,083073,Cheng; Tzu-Han,0,3,50,50
1650057303717,COGS 17,A01,092677,Staff,35,0,75,40
1650057309742,COGS 100,A01,083619,Staff,0,17,60,60
1650057315768,COGS 101A,A01,083621,Davis; Joshua Daniel,0,16,60,60
1650057321797,COGS 101B,A01,091572,Staff,14,0,60,46
1650057327821,COGS 101C,A01,083625,Delgado; Tania,21,0,30,9
1650057333845,COGS 107A,A01,083627,Boyle; Mary E. T.,1,2,60,59
1650057339869,COGS 118A,A01,083075,Staff,19,0,60,41
1650057345904,CSE 3,A50,083646,Miranda; Gregory Joseph,22,0,38,16
1650057345904,CSE 3,A51,083647,Miranda; Gregory Joseph,37,0,37,0
1650057351927,CSE 8A,A50,083650,Miranda; Gregory Joseph,0,16,40,40
1650057357954,CSE 11,A01,083080,Cao; Yingjun,0,62,40,40
1650057363999,CSE 12,A01,083652,Staff,0,1,100,100
1650057370033,CSE 15L,A01,083654,Staff,0,0,50,50
1650057370033,CSE 15L,A02,083655,Staff,11,0,50,39
1650057376070,CSE 20,A01,083657,Staff,58,0,80,22
1650057382093,CSE 30,A01,083084,Eldon; John,0,63,40,40
1650057388116,CSE 100,A01,083659,Cao; Yingjun,0,57,50,50
1650057394144,CSE 134B,A01,083661,Powell; Thomas Allan,1,27,65,64
1650057400166,CSE 140,A01,083663,Staff,7,0,75,68
1650057406201,CSE 140L,A01,083088,Eldon; John,2,0,75,73
1650057412238,CSE 175,A01,083665,Kumar; Rakesh,9,0,25,16
1650057418264,CSE 190,A00,092507,Dubnov; Shlomo,14,0,20,6
1650057424293,ECE 45,A01,083139,Staff,0,12,40,40
1650057430317,ECE 65,A50,083695,Staff,0,3,30,30
1650057436352,ECE 109,A01,091882,Touri; Behrouz,48,0,70,22
1650057442388,ECE 180,A00,083140,Abi Samra; Nicholas Camill,24,0,30,6
1650057442388,ECE 180,B00,083141,Abi Samra; Nicholas Camill,8,0,30,22
1650057448413,MATH 10A,A01,083735,Patchell; Gregory David,12,0,30,18
1650057448413,MATH 10A,A02,083736,Patchell; Gregory David,28,0,30,2
1650057448413,MATH 10A,A03,083737,Patchell; Gregory David,27,0,30,3
1650057454436,MATH 10B,A01,083207,Staff,0,5,30,30
1650057454436,MATH 10B,A02,083208,Staff,0,2,30,30
1650057454436,MATH 10B,B01,083739,Staff,20,0,30,10
1650057454436,MATH 10B,B02,083740,Staff,30,0,30,0
1650057460461,MATH 18,A01,083743,Staff,10,0,30,20
1650057460461,MATH 18,A02,083744,Staff,28,0,30,2
1650057460461,MATH 18,A03,083745,Staff,23,0,30,7
1650057460461,MATH 18,A04,083746,Staff,27,0,30,3
1650057460461,MATH 18,B01,083748,Staff,0,9,30,30
1650057460461,MATH 18,B02,083749,Staff,1,6,30,29
1650057460461,MATH 18,B03,083750,Staff,0,6,30,30
1650057460461,MATH 18,B04,083751,Staff,1,7,30,29
1650057466497,MATH 20A,A01,083754,Staff,26,0,40,14
1650057472525,MATH 20B,A01,083756,Staff,0,5,30,30
1650057472525,MATH 20B,A02,083757,Staff,0,1,30,30
1650057478560,MATH 20C,A01,083760,Staff,0,9,30,30
1650057478560,MATH 20C,A02,083761,Staff,0,12,30,30
1650057478560,MATH 20C,B01,083762,Staff,16,0,30,14
1650057478560,MATH 20C,B02,083763,Staff,28,0,30,2
1650057484611,MATH 20D,A01,083765,Staff,0,2,30,30
1650057484611,MATH 20D,A02,083766,Staff,15,0,30,15
1650057484611,MATH 20D,A03,083767,Staff,28,0,30,2
1650057490635,MATH 20E,A01,083771,Staff,10,0,30,20
1650057490635,MATH 20E,A02,083772,Staff,20,0,30,10
1650057490635,MATH 20E,B01,083773,Staff,1,1,30,29
1650057490635,MATH 20E,B02,083774,Staff,17,0,30,13
1650057496663,MATH 103A,A01,083777,Staff,0,6,30,30
1650057496663,MATH 103A,A02,083778,Staff,0,7,30,30
1650057496663,MATH 103A,B01,083779,Staff,0,8,30,30
1650057496663,MATH 103A,B02,083780,Staff,0,6,30,30
1650057502699,MATH 105,A01,085443,Staff,0,11,30,30
1650057508734,MATH 109,A01,083213,Anzaldo; Leesa B,0,4,30,30
1650057508734,MATH 109,A02,083214,Anzaldo; Leesa B,0,4,30,30
1650057508734,MATH 109,B01,083215,Anzaldo; Leesa B,0,2,30,30
1650057508734,MATH 109,B02,083216,Anzaldo; Leesa B,1,3,30,29
1650057514770,MATH 142A,A01,083219,Chow; Bennett,0,8,30,30
1650057514770,MATH 142A,A02,083220,Chow; Bennett,0,8,30,30
1650057514770,MATH 142A,B01,083221,Chow; Bennett,0,9,30,30
1650057514770,MATH 142A,B02,083222,Chow; Bennett,0,9,30,30
1650057520800,MATH 193A,A01,083224,Staff,0,4,30,30
1650057520800,MATH 193A,A02,083225,Staff,0,4,30,30
1650057520800,MATH 193A,A03,083781,Staff,0,0,30,30
1650057520800,MATH 193A,A04,083782,Staff,8,0,30,22
1650057526826,MATH 197,001,091859,McAuley; Julian John,9998,0,9999,1
1650057532875,COGS 9,A01,083615,Staff,3,17,60,57
1650057538896,COGS 11,A01,083617,Boyle; Mary E. T.,25,0,40,15
1650057544919,COGS 13,A01,083071,Staff,0,28,40,40
1650057550944,COGS 14A,A01,092681,Staff,0,8,100,100
1650057556968,COGS 14B,A01,083073,Cheng; Tzu-Han,0,3,50,50
1650057562994,COGS 17,A01,092677,Staff,36,0,75,39
1650057569039,COGS 100,A01,083619,Staff,0,17,60,60
1650057575065,COGS 101A,A01,083621,Davis; Joshua Daniel,0,16,60,60
1650057581089,COGS 101B,A01,091572,Staff,14,0,60,46
1650057587113,COGS 101C,A01,083625,Delgado; Tania,21,0,30,9
1650057593143,COGS 107A,A01,083627,Boyle; Mary E. T.,1,2,60,59
1650057599168,COGS 118A,A01,083075,Staff,19,0,60,41
1650057605197,CSE 3,A50,083646,Miranda; Gregory Joseph,22,0,38,16
1650057605197,CSE 3,A51,083647,Miranda; Gregory Joseph,37,0,37,0
1650057611222,CSE 8A,A50,083650,Miranda; Gregory Joseph,0,16,40,40
1650057617246,CSE 11,A01,083080,Cao; Yingjun,0,62,40,40
1650057623269,CSE 12,A01,083652,Staff,0,1,100,100
1650057629304,CSE 15L,A01,083654,Staff,0,0,50,50
1650057629304,CSE 15L,A02,083655,Staff,11,0,50,39
1650057635327,CSE 20,A01,083657,Staff,58,0,80,22
1650057641348,CSE 30,A01,083084,Eldon; John,0,63,40,40
1650057647375,CSE 100,A01,083659,Cao; Yingjun,0,57,50,50
1650057653407,CSE 134B,A01,083661,Powell; Thomas Allan,1,27,65,64
1650057659429,CSE 140,A01,083663,Staff,7,0,75,68
1650057665455,CSE 140L,A01,083088,Eldon; John,2,0,75,73
1650057671490,CSE 175,A01,083665,Kumar; Rakesh,9,0,25,16
1650057677513,CSE 190,A00,092507,Dubnov; Shlomo,14,0,20,6
1650057683548,ECE 45,A01,083139,Staff,0,12,40,40
1650057689576,ECE 65,A50,083695,Staff,0,3,30,30
1650057695603,ECE 109,A01,091882,Touri; Behrouz,48,0,70,22
1650057701631,ECE 180,A00,083140,Abi Samra; Nicholas Camill,24,0,30,6
1650057701631,ECE 180,B00,083141,Abi Samra; Nicholas Camill,8,0,30,22
1650057707659,MATH 10A,A01,083735,Patchell; Gregory David,12,0,30,18
1650057707659,MATH 10A,A02,083736,Patchell; Gregory David,28,0,30,2
1650057707659,MATH 10A,A03,083737,Patchell; Gregory David,27,0,30,3
1650057713681,MATH 10B,A01,083207,Staff,0,5,30,30
1650057713681,MATH 10B,A02,083208,Staff,0,2,30,30
1650057713681,MATH 10B,B01,083739,Staff,20,0,30,10
1650057713681,MATH 10B,B02,083740,Staff,30,0,30,0
1650057719706,MATH 18,A01,083743,Staff,10,0,30,20
1650057719706,MATH 18,A02,083744,Staff,28,0,30,2
1650057719706,MATH 18,A03,083745,Staff,23,0,30,7
1650057719706,MATH 18,A04,083746,Staff,27,0,30,3
1650057719706,MATH 18,B01,083748,Staff,0,9,30,30
1650057719706,MATH 18,B02,083749,Staff,1,6,30,29
1650057719706,MATH 18,B03,083750,Staff,0,6,30,30
1650057719706,MATH 18,B04,083751,Staff,1,7,30,29
1650057725734,MATH 20A,A01,083754,Staff,26,0,40,14
1650057731764,MATH 20B,A01,083756,Staff,0,5,30,30
1650057731764,MATH 20B,A02,083757,Staff,0,1,30,30
1650057737807,MATH 20C,A01,083760,Staff,0,9,30,30
1650057737807,MATH 20C,A02,083761,Staff,0,12,30,30
1650057737807,MATH 20C,B01,083762,Staff,16,0,30,14
1650057737807,MATH 20C,B02,083763,Staff,28,0,30,2
1650057743841,MATH 20D,A01,083765,Staff,0,2,30,30
1650057743841,MATH 20D,A02,083766,Staff,15,0,30,15
1650057743841,MATH 20D,A03,083767,Staff,28,0,30,2
1650057749874,MATH 20E,A01,083771,Staff,10,0,30,20
1650057749874,MATH 20E,A02,083772,Staff,20,0,30,10
1650057749874,MATH 20E,B01,083773,Staff,1,1,30,29
1650057749874,MATH 20E,B02,083774,Staff,17,0,30,13
1650057755915,MATH 103A,A01,083777,Staff,0,6,30,30
1650057755915,MATH 103A,A02,083778,Staff,0,7,30,30
1650057755915,MATH 103A,B01,083779,Staff,0,8,30,30
1650057755915,MATH 103A,B02,083780,Staff,0,6,30,30
1650057761944,MATH 105,A01,085443,Staff,0,11,30,30
1650057767967,MATH 109,A01,083213,Anzaldo; Leesa B,0,4,30,30
1650057767967,MATH 109,A02,083214,Anzaldo; Leesa B,0,4,30,30
1650057767967,MATH 109,B01,083215,Anzaldo; Leesa B,0,2,30,30
1650057767967,MATH 109,B02,083216,Anzaldo; Leesa B,1,3,30,29
1650057774008,MATH 142A,A01,083219,Chow; Bennett,0,8,30,30
1650057774008,MATH 142A,A02,083220,Chow; Bennett,0,8,30,30
1650057774008,MATH 142A,B01,083221,Chow; Bennett,0,9,30,30
1650057774008,MATH 142A,B02,083222,Chow; Bennett,0,9,30,30
1650057780154,MATH 193A,A01,083224,Staff,0,4,30,30
1650057780154,MATH 193A,A02,083225,Staff,0,4,30,30
1650057780154,MATH 193A,A03,083781,Staff,0,0,30,30
1650057780154,MATH 193A,A04,083782,Staff,8,0,30,22
1650057786189,MATH 197,001,091859,McAuley; Julian John,9998,0,9999,1
1650057792238,COGS 9,A01,083615,Staff,3,17,60,57
1650057798265,COGS 11,A01,083617,Boyle; Mary E. T.,25,0,40,15
1650057804295,COGS 13,A01,083071,Staff,0,28,40,40
1650057810318,COGS 14A,A01,092681,Staff,0,9,100,100
1650057816344,COGS 14B,A01,083073,Cheng; Tzu-Han,0,3,50,50
1650057822372,COGS 17,A01,092677,Staff,35,0,75,40
1650057828399,COGS 100,A01,083619,Staff,0,18,60,60
1650057834423,COGS 101A,A01,083621,Davis; Joshua Daniel,0,16,60,60
1650057840454,COGS 101B,A01,091572,Staff,14,0,60,46
1650057846477,COGS 101C,A01,083625,Delgado; Tania,21,0,30,9
1650057852505,COGS 107A,A01,083627,Boyle; Mary E. T.,1,2,60,59
1650057858526,COGS 118A,A01,083075,Staff,19,0,60,41
1650057864549,CSE 3,A50,083646,Miranda; Gregory Joseph,22,0,38,16
1650057864549,CSE 3,A51,083647,Miranda; Gregory Joseph,37,0,37,0
1650057870581,CSE 8A,A50,083650,Miranda; Gregory Joseph,0,16,40,40
1650057876603,CSE 11,A01,083080,Cao; Yingjun,0,62,40,40
1650057882630,CSE 12,A01,083652,Staff,0,1,100,100
1650057888654,CSE 15L,A01,083654,Staff,0,0,50,50
1650057888654,CSE 15L,A02,083655,Staff,11,0,50,39
1650057894677,CSE 20,A01,083657,Staff,58,0,80,22
1650057900701,CSE 30,A01,083084,Eldon; John,0,63,40,40
1650057906723,CSE 100,A01,083659,Cao; Yingjun,0,57,50,50
1650057912747,CSE 134B,A01,083661,Powell; Thomas Allan,1,27,65,64
1650057918788,CSE 140,A01,083663,Staff,7,0,75,68
1650057924825,CSE 140L,A01,083088,Eldon; John,2,0,75,73
1650057930852,CSE 175,A01,083665,Kumar; Rakesh,9,0,25,16
1650057936876,CSE 190,A00,092507,Dubnov; Shlomo,14,0,20,6
1650057942897,ECE 45,A01,083139,Staff,0,12,40,40
1650057948919,ECE 65,A50,083695,Staff,0,3,30,30
1650057954948,ECE 109,A01,091882,Touri; Behrouz,48,0,70,22
1650057960985,ECE 180,A00,083140,Abi Samra; Nicholas Camill,24,0,30,6
1650057960985,ECE 180,B00,083141,Abi Samra; Nicholas Camill,8,0,30,22
1650057967023,MATH 10A,A01,083735,Patchell; Gregory David,12,0,30,18
1650057967023,MATH 10A,A02,083736,Patchell; Gregory David,28,0,30,2
1650057967023,MATH 10A,A03,083737,Patchell; Gregory David,27,0,30,3
1650057973051,MATH 10B,A01,083207,Staff,0,5,30,30
1650057973051,MATH 10B,A02,083208,Staff,0,2,30,30
1650057973051,MATH 10B,B01,083739,Staff,20,0,30,10
1650057973051,MATH 10B,B02,083740,Staff,30,0,30,0
1650057979080,MATH 18,A01,083743,Staff,10,0,30,20
1650057979080,MATH 18,A02,083744,Staff,28,0,30,2
1650057979080,MATH 18,A03,083745,Staff,23,0,30,7
1650057979080,MATH 18,A04,083746,Staff,27,0,30,3
1650057979080,MATH 18,B01,083748,Staff,0,9,30,30
1650057979080,MATH 18,B02,083749,Staff,1,6,30,29
1650057979080,MATH 18,B03,083750,Staff,0,6,30,30
1650057979080,MATH 18,B04,083751,Staff,1,7,30,29
1650057985103,MATH 20A,A01,083754,Staff,26,0,40,14
1650057991131,MATH 20B,A01,083756,Staff,0,5,30,30
1650057991131,MATH 20B,A02,083757,Staff,0,1,30,30
1650057997159,MATH 20C,A01,083760,Staff,0,9,30,30
1650057997159,MATH 20C,A02,083761,Staff,0,12,30,30
1650057997159,MATH 20C,B01,083762,Staff,16,0,30,14
1650057997159,MATH 20C,B02,083763,Staff,28,0,30,2
1650058003183,MATH 20D,A01,083765,Staff,0,2,30,30
1650058003183,MATH 20D,A02,083766,Staff,15,0,30,15
1650058003183,MATH 20D,A03,083767,Staff,28,0,30,2
1650058009214,MATH 20E,A01,083771,Staff,10,0,30,20
1650058009214,MATH 20E,A02,083772,Staff,20,0,30,10
1650058009214,MATH 20E,B01,083773,Staff,1,1,30,29
1650058009214,MATH 20E,B02,083774,Staff,17,0,30,13
1650058015241,MATH 103A,A01,083777,Staff,0,6,30,30
1650058015241,MATH 103A,A02,083778,Staff,0,7,30,30
1650058015241,MATH 103A,B01,083779,Staff,0,8,30,30
1650058015241,MATH 103A,B02,083780,Staff,0,6,30,30
1650058021264,MATH 105,A01,085443,Staff,0,11,30,30
1650058027292,MATH 109,A01,083213,Anzaldo; Leesa B,0,4,30,30
1650058027292,MATH 109,A02,083214,Anzaldo; Leesa B,0,4,30,30
1650058027292,MATH 109,B01,083215,Anzaldo; Leesa B,0,2,30,30
1650058027292,MATH 109,B02,083216,Anzaldo; Leesa B,1,3,30,29
1650058033329,MATH 142A,A01,083219,Chow; Bennett,0,8,30,30
1650058033329,MATH 142A,A02,083220,Chow; Bennett,0,8,30,30
1650058033329,MATH 142A,B01,083221,Chow; Bennett,0,9,30,30
1650058033329,MATH 142A,B02,083222,Chow; Bennett,0,9,30,30
1650058039355,MATH 193A,A01,083224,Staff,0,4,30,30
1650058039355,MATH 193A,A02,083225,Staff,0,4,30,30
1650058039355,MATH 193A,A03,083781,Staff,0,0,30,30
1650058039355,MATH 193A,A04,083782,Staff,8,0,30,22
1650058045385,MATH 197,001,091859,McAuley; Julian John,9998,0,9999,1
1650058051445,COGS 9,A01,083615,Staff,3,17,60,57
1650058057472,COGS 11,A01,083617,Boyle; Mary E. T.,25,0,40,15
1650058063495,COGS 13,A01,083071,Staff,0,28,40,40
1650058069522,COGS 14A,A01,092681,Staff,0,9,100,100
1650058075551,COGS 14B,A01,083073,Cheng; Tzu-Han,0,3,50,50
1650058081573,COGS 17,A01,092677,Staff,35,0,75,40
1650058087596,COGS 100,A01,083619,Staff,0,18,60,60
1650058093630,COGS 101A,A01,083621,Davis; Joshua Daniel,0,16,60,60
1650058099660,COGS 101B,A01,091572,Staff,14,0,60,46
1650058105682,COGS 101C,A01,083625,Delgado; Tania,21,0,30,9
1650058111705,COGS 107A,A01,083627,Boyle; Mary E. T.,1,2,60,59
1650058117728,COGS 118A,A01,083075,Staff,19,0,60,41
1650058123751,CSE 3,A50,083646,Miranda; Gregory Joseph,22,0,38,16
1650058123751,CSE 3,A51,083647,Miranda; Gregory Joseph,37,0,37,0
1650058129775,CSE 8A,A50,083650,Miranda; Gregory Joseph,0,16,40,40
1650058135800,CSE 11,A01,083080,Cao; Yingjun,0,62,40,40
1650058141827,CSE 12,A01,083652,Staff,0,1,100,100
1650058147863,CSE 15L,A01,083654,Staff,0,0,50,50
1650058147863,CSE 15L,A02,083655,Staff,11,0,50,39
1650058153887,CSE 20,A01,083657,Staff,58,0,80,22
1650058159912,CSE 30,A01,083084,Eldon; John,0,63,40,40
1650058165940,CSE 100,A01,083659,Cao; Yingjun,0,57,50,50
1650058171963,CSE 134B,A01,083661,Powell; Thomas Allan,1,27,65,64
1650058177990,CSE 140,A01,083663,Staff,7,0,75,68
1650058184017,CSE 140L,A01,083088,Eldon; John,2,0,75,73
1650058190041,CSE 175,A01,083665,Kumar; Rakesh,9,0,25,16
1650058196064,CSE 190,A00,092507,Dubnov; Shlomo,14,0,20,6
1650058202088,ECE 45,A01,083139,Staff,0,12,40,40
1650058208111,ECE 65,A50,083695,Staff,0,3,30,30
1650058214136,ECE 109,A01,091882,Touri; Behrouz,48,0,70,22
1650058220172,ECE 180,A00,083140,Abi Samra; Nicholas Camill,24,0,30,6
1650058220172,ECE 180,B00,083141,Abi Samra; Nicholas Camill,8,0,30,22
1650058226209,MATH 10A,A01,083735,Patchell; Gregory David,12,0,30,18
1650058226209,MATH 10A,A02,083736,Patchell; Gregory David,28,0,30,2
1650058226209,MATH 10A,A03,083737,Patchell; Gregory David,27,0,30,3
1650058232234,MATH 10B,A01,083207,Staff,0,5,30,30
1650058232234,MATH 10B,A02,083208,Staff,0,2,30,30
1650058232234,MATH 10B,B01,083739,Staff,20,0,30,10
1650058232234,MATH 10B,B02,083740,Staff,30,0,30,0
1650058238264,MATH 18,A01,083743,Staff,10,0,30,20
1650058238264,MATH 18,A02,083744,Staff,28,0,30,2
1650058238264,MATH 18,A03,083745,Staff,23,0,30,7
1650058238264,MATH 18,A04,083746,Staff,27,0,30,3
1650058238264,MATH 18,B01,083748,Staff,0,9,30,30
1650058238264,MATH 18,B02,083749,Staff,1,6,30,29
1650058238264,MATH 18,B03,083750,Staff,0,6,30,30
1650058238264,MATH 18,B04,083751,Staff,1,7,30,29
1650058244290,MATH 20A,A01,083754,Staff,26,0,40,14
1650058250319,MATH 20B,A01,083756,Staff,0,5,30,30
1650058250319,MATH 20B,A02,083757,Staff,0,1,30,30
1650058256346,MATH 20C,A01,083760,Staff,0,9,30,30
1650058256346,MATH 20C,A02,083761,Staff,0,12,30,30
1650058256346,MATH 20C,B01,083762,Staff,16,0,30,14
1650058256346,MATH 20C,B02,083763,Staff,28,0,30,2
1650058262374,MATH 20D,A01,083765,Staff,0,2,30,30
1650058262374,MATH 20D,A02,083766,Staff,15,0,30,15
1650058262374,MATH 20D,A03,083767,Staff,28,0,30,2
1650058268397,MATH 20E,A01,083771,Staff,10,0,30,20
1650058268397,MATH 20E,A02,083772,Staff,20,0,30,10
1650058268397,MATH 20E,B01,083773,Staff,1,1,30,29
1650058268397,MATH 20E,B02,083774,Staff,17,0,30,13
1650058274420,MATH 103A,A01,083777,Staff,0,6,30,30
1650058274420,MATH 103A,A02,083778,Staff,0,7,30,30
1650058274420,MATH 103A,B01,083779,Staff,0,8,30,30
1650058274420,MATH 103A,B02,083780,Staff,0,6,30,30
1650058280468,MATH 105,A01,085443,Staff,0,11,30,30
1650058286491,MATH 109,A01,083213,Anzaldo; Leesa B,0,4,30,30
1650058286491,MATH 109,A02,083214,Anzaldo; Leesa B,0,4,30,30
1650058286491,MATH 109,B01,083215,Anzaldo; Leesa B,0,2,30,30
1650058286491,MATH 109,B02,083216,Anzaldo; Leesa B,1,3,30,29
1650058292519,MATH 142A,A01,083219,Chow; Bennett,0,8,30,30
1650058292519,MATH 142A,A02,083220,Chow; Bennett,0,8,30,30
1650058292519,MATH 142A,B01,083221,Chow; Bennett,0,9,30,30
1650058292519,MATH 142A,B02,083222,Chow; Bennett,0,9,30,30
1650058298550,MATH 193A,A01,083224,Staff,0,4,30,30
1650058298550,MATH 193A,A02,083225,Staff,0,4,30,30
1650058298550,MATH 193A,A03,083781,Staff,0,0,30,30
1650058298550,MATH 193A,A04,083782,Staff,8,0,30,22
1650058304579,MATH 197,001,091859,McAuley; Julian John,9998,0,9999,1
1650058310641,COGS 9,A01,083615,Staff,3,17,60,57
1650058316664,COGS 11,A01,083617,Boyle; Mary E. T.,25,0,40,15
1650058322693,COGS 13,A01,083071,Staff,0,28,40,40
1650058328721,COGS 14A,A01,092681,Staff,0,9,100,100
1650058334757,COGS 14B,A01,083073,Cheng; Tzu-Han,0,3,50,50
1650058340781,COGS 17,A01,092677,Staff,35,0,75,40
1650058346804,COGS 100,A01,083619,Staff,0,18,60,60
1650058352827,COGS 101A,A01,083621,Davis; Joshua Daniel,0,16,60,60
1650058358864,COGS 101B,A01,091572,Staff,14,0,60,46
1650058364887,COGS 101C,A01,083625,Delgado; Tania,21,0,30,9
1650058371027,COGS 107A,A01,083627,Boyle; Mary E. T.,1,2,60,59
1650058377050,COGS 118A,A01,083075,Staff,19,0,60,41
1650058383077,CSE 3,A50,083646,Miranda; Gregory Joseph,22,0,38,16
1650058383077,CSE 3,A51,083647,Miranda; Gregory Joseph,37,0,37,0
1650058389105,CSE 8A,A50,083650,Miranda; Gregory Joseph,0,16,40,40
1650058395130,CSE 11,A01,083080,Cao; Yingjun,0,62,40,40
1650058401153,CSE 12,A01,083652,Staff,0,1,100,100
1650058407175,CSE 15L,A01,083654,Staff,0,0,50,50
1650058407175,CSE 15L,A02,083655,Staff,11,0,50,39
1650058413210,CSE 20,A01,083657,Staff,58,0,80,22
1650058419234,CSE 30,A01,083084,Eldon; John,0,63,40,40
1650058425257,CSE 100,A01,083659,Cao; Yingjun,0,57,50,50
1650058431280,CSE 134B,A01,083661,Powell; Thomas Allan,1,27,65,64
1650058437317,CSE 140,A01,083663,Staff,7,0,75,68
1650058443340,CSE 140L,A01,083088,Eldon; John,2,0,75,73
1650058449362,CSE 175,A01,083665,Kumar; Rakesh,9,0,25,16
1650058455387,CSE 190,A00,092507,Dubnov; Shlomo,14,0,20,6
1650058461413,ECE 45,A01,083139,Staff,0,12,40,40
1650058467449,ECE 65,A50,083695,Staff,0,3,30,30
1650058473472,ECE 109,A01,091882,Touri; Behrouz,48,0,70,22
1650058479505,ECE 180,A00,083140,Abi Samra; Nicholas Camill,24,0,30,6
1650058479505,ECE 180,B00,083141,Abi Samra; Nicholas Camill,8,0,30,22
1650058485527,MATH 10A,A01,083735,Patchell; Gregory David,12,0,30,18
1650058485527,MATH 10A,A02,083736,Patchell; Gregory David,28,0,30,2
1650058485527,MATH 10A,A03,083737,Patchell; Gregory David,27,0,30,3
1650058491551,MATH 10B,A01,083207,Staff,0,5,30,30
1650058491551,MATH 10B,A02,083208,Staff,0,2,30,30
1650058491551,MATH 10B,B01,083739,Staff,20,0,30,10
1650058491551,MATH 10B,B02,083740,Staff,30,0,30,0
1650058497582,MATH 18,A01,083743,Staff,10,0,30,20
1650058497582,MATH 18,A02,083744,Staff,28,0,30,2
1650058497582,MATH 18,A03,083745,Staff,23,0,30,7
1650058497582,MATH 18,A04,083746,Staff,27,0,30,3
1650058497582,MATH 18,B01,083748,Staff,0,9,30,30
1650058497582,MATH 18,B02,083749,Staff,1,6,30,29
1650058497582,MATH 18,B03,083750,Staff,0,6,30,30
1650058497582,MATH 18,B04,083751,Staff,1,7,30,29
1650058503605,MATH 20A,A01,083754,Staff,26,0,40,14
1650058509638,MATH 20B,A01,083756,Staff,0,5,30,30
1650058509638,MATH 20B,A02,083757,Staff,0,1,30,30
1650058515669,MATH 20C,A01,083760,Staff,0,9,30,30
1650058515669,MATH 20C,A02,083761,Staff,0,12,30,30
1650058515669,MATH 20C,B01,083762,Staff,16,0,30,14
1650058515669,MATH 20C,B02,083763,Staff,28,0,30,2
1650058521693,MATH 20D,A01,083765,Staff,0,2,30,30
1650058521693,MATH 20D,A02,083766,Staff,15,0,30,15
1650058521693,MATH 20D,A03,083767,Staff,28,0,30,2
1650058527729,MATH 20E,A01,083771,Staff,10,0,30,20
1650058527729,MATH 20E,A02,083772,Staff,20,0,30,10
1650058527729,MATH 20E,B01,083773,Staff,1,1,30,29
1650058527729,MATH 20E,B02,083774,Staff,17,0,30,13
1650058533752,MATH 103A,A01,083777,Staff,0,6,30,30
1650058533752,MATH 103A,A02,083778,Staff,0,7,30,30
1650058533752,MATH 103A,B01,083779,Staff,0,8,30,30
1650058533752,MATH 103A,B02,083780,Staff,0,6,30,30
1650058539778,MATH 105,A01,085443,Staff,0,11,30,30
1650058545809,MATH 109,A01,083213,Anzaldo; Leesa B,0,4,30,30
1650058545809,MATH 109,A02,083214,Anzaldo; Leesa B,0,4,30,30
1650058545809,MATH 109,B01,083215,Anzaldo; Leesa B,0,2,30,30
1650058545809,MATH 109,B02,083216,Anzaldo; Leesa B,1,3,30,29
1650058551833,MATH 142A,A01,083219,Chow; Bennett,0,8,30,30
1650058551833,MATH 142A,A02,083220,Chow; Bennett,0,8,30,30
1650058551833,MATH 142A,B01,083221,Chow; Bennett,0,9,30,30
1650058551833,MATH 142A,B02,083222,Chow; Bennett,0,9,30,30
1650058557855,MATH 193A,A01,083224,Staff,0,4,30,30
1650058557855,MATH 193A,A02,083225,Staff,0,4,30,30
1650058557855,MATH 193A,A03,083781,Staff,0,0,30,30
1650058557855,MATH 193A,A04,083782,Staff,8,0,30,22
1650058563881,MATH 197,001,091859,McAuley; Julian John,9998,0,9999,1
1650058569979,COGS 9,A01,083615,Staff,3,17,60,57
1650058576002,COGS 11,A01,083617,Boyle; Mary E. T.,25,0,40,15
1650058582025,COGS 13,A01,083071,Staff,0,28,40,40
1650058588048,COGS 14A,A01,092681,Staff,0,9,100,100
1650058594071,COGS 14B,A01,083073,Cheng; Tzu-Han,0,3,50,50
1650058600105,COGS 17,A01,092677,Staff,35,0,75,40
1650058606140,COGS 100,A01,083619,Staff,0,18,60,60
1650058612166,COGS 101A,A01,083621,Davis; Joshua Daniel,0,16,60,60
1650058618194,COGS 101B,A01,091572,Staff,14,0,60,46
1650058624217,COGS 101C,A01,083625,Delgado; Tania,21,0,30,9
1650058630241,COGS 107A,A01,083627,Boyle; Mary E. T.,1,2,60,59
1650058636264,COGS 118A,A01,083075,Staff,19,0,60,41
1650058642293,CSE 3,A50,083646,Miranda; Gregory Joseph,22,0,38,16
1650058642293,CSE 3,A51,083647,Miranda; Gregory Joseph,37,0,37,0
1650058648319,CSE 8A,A50,083650,Miranda; Gregory Joseph,0,16,40,40
1650058654346,CSE 11,A01,083080,Cao; Yingjun,0,62,40,40
1650058660374,CSE 12,A01,083652,Staff,0,1,100,100
1650058666398,CSE 15L,A01,083654,Staff,0,0,50,50
1650058666398,CSE 15L,A02,083655,Staff,11,0,50,39
1650058672421,CSE 20,A01,083657,Staff,58,0,80,22
1650058678448,CSE 30,A01,083084,Eldon; John,0,63,40,40
1650058684477,CSE 100,A01,083659,Cao; Yingjun,0,57,50,50
1650058690505,CSE 134B,A01,083661,Powell; Thomas Allan,1,27,65,64
1650058696532,CSE 140,A01,083663,Staff,7,0,75,68
1650058702556,CSE 140L,A01,083088,Eldon; John,2,0,75,73
1650058708579,CSE 175,A01,083665,Kumar; Rakesh,9,0,25,16
1650058714602,CSE 190,A00,092507,Dubnov; Shlomo,14,0,20,6
1650058720629,ECE 45,A01,083139,Staff,0,12,40,40
1650058726652,ECE 65,A50,083695,Staff,0,3,30,30
1650058732680,ECE 109,A01,091882,Touri; Behrouz,48,0,70,22
1650058738708,ECE 180,A00,083140,Abi Samra; Nicholas Camill,24,0,30,6
1650058738708,ECE 180,B00,083141,Abi Samra; Nicholas Camill,8,0,30,22
1650058744737,MATH 10A,A01,083735,Patchell; Gregory David,12,0,30,18
1650058744737,MATH 10A,A02,083736,Patchell; Gregory David,28,0,30,2
1650058744737,MATH 10A,A03,083737,Patchell; Gregory David,27,0,30,3
1650058750764,MATH 10B,A01,083207,Staff,0,5,30,30
1650058750764,MATH 10B,A02,083208,Staff,0,2,30,30
1650058750764,MATH 10B,B01,083739,Staff,20,0,30,10
1650058750764,MATH 10B,B02,083740,Staff,30,0,30,0
1650058756793,MATH 18,A01,083743,Staff,10,0,30,20
1650058756793,MATH 18,A02,083744,Staff,28,0,30,2
1650058756793,MATH 18,A03,083745,Staff,23,0,30,7
1650058756793,MATH 18,A04,083746,Staff,27,0,30,3
1650058756793,MATH 18,B01,083748,Staff,0,9,30,30
1650058756793,MATH 18,B02,083749,Staff,1,6,30,29
1650058756793,MATH 18,B03,083750,Staff,0,6,30,30
1650058756793,MATH 18,B04,083751,Staff,1,7,30,29
1650058762820,MATH 20A,A01,083754,Staff,26,0,40,14
1650058768851,MATH 20B,A01,083756,Staff,0,5,30,30
1650058768851,MATH 20B,A02,083757,Staff,0,1,30,30
1650058774879,MATH 20C,A01,083760,Staff,0,9,30,30
1650058774879,MATH 20C,A02,083761,Staff,0,12,30,30
1650058774879,MATH 20C,B01,083762,Staff,16,0,30,14
1650058774879,MATH 20C,B02,083763,Staff,28,0,30,2
1650058780910,MATH 20D,A01,083765,Staff,0,2,30,30
1650058780910,MATH 20D,A02,083766,Staff,14,0,30,16
1650058780910,MATH 20D,A03,083767,Staff,28,0,30,2
1650058786945,MATH 20E,A01,083771,Staff,10,0,30,20
1650058786945,MATH 20E,A02,083772,Staff,20,0,30,10
1650058786945,MATH 20E,B01,083773,Staff,1,1,30,29
1650058786945,MATH 20E,B02,083774,Staff,17,0,30,13
1650058792978,MATH 103A,A01,083777,Staff,0,6,30,30
1650058792978,MATH 103A,A02,083778,Staff,0,7,30,30
1650058792978,MATH 103A,B01,083779,Staff,0,8,30,30
1650058792978,MATH 103A,B02,083780,Staff,0,6,30,30
1650058799002,MATH 105,A01,085443,Staff,1,11,30,29
1650058805026,MATH 109,A01,083213,Anzaldo; Leesa B,0,4,30,30
1650058805026,MATH 109,A02,083214,Anzaldo; Leesa B,0,4,30,30
1650058805026,MATH 109,B01,083215,Anzaldo; Leesa B,0,2,30,30
1650058805026,MATH 109,B02,083216,Anzaldo; Leesa B,1,3,30,29
1650058811060,MATH 142A,A01,083219,Chow; Bennett,0,8,30,30
1650058811060,MATH 142A,A02,083220,Chow; Bennett,0,8,30,30
1650058811060,MATH 142A,B01,083221,Chow; Bennett,0,9,30,30
1650058811060,MATH 142A,B02,083222,Chow; Bennett,0,9,30,30
1650058817087,MATH 193A,A01,083224,Staff,0,4,30,30
1650058817087,MATH 193A,A02,083225,Staff,0,4,30,30
1650058817087,MATH 193A,A03,083781,Staff,0,0,30,30
1650058817087,MATH 193A,A04,083782,Staff,8,0,30,22
1650058823111,MATH 197,001,091859,McAuley; Julian John,9998,0,9999,1
1650058829172,COGS 9,A01,083615,Staff,3,17,60,57
1650058835201,COGS 11,A01,083617,Boyle; Mary E. T.,25,0,40,15
1650058841236,COGS 13,A01,083071,Staff,0,28,40,40
1650058847259,COGS 14A,A01,092681,Staff,0,10,100,100
1650058853282,COGS 14B,A01,083073,Cheng; Tzu-Han,0,3,50,50
1650058859305,COGS 17,A01,092677,Staff,35,0,75,40
1650058865329,COGS 100,A01,083619,Staff,0,18,60,60
1650058871362,COGS 101A,A01,083621,Davis; Joshua Daniel,0,16,60,60
1650058877389,COGS 101B,A01,091572,Staff,14,0,60,46
1650058883415,COGS 101C,A01,083625,Delgado; Tania,21,0,30,9
1650058889447,COGS 107A,A01,083627,Boyle; Mary E. T.,1,2,60,59
1650058895470,COGS 118A,A01,083075,Staff,19,0,60,41
1650058901493,CSE 3,A50,083646,Miranda; Gregory Joseph,22,0,38,16
1650058901493,CSE 3,A51,083647,Miranda; Gregory Joseph,37,0,37,0
1650058907528,CSE 8A,A50,083650,Miranda; Gregory Joseph,0,16,40,40
1650058913554,CSE 11,A01,083080,Cao; Yingjun,0,62,40,40
1650058919575,CSE 12,A01,083652,Staff,0,1,100,100
1650058925599,CSE 15L,A01,083654,Staff,0,0,50,50
1650058925599,CSE 15L,A02,083655,Staff,11,0,50,39
1650058931626,CSE 20,A01,083657,Staff,58,0,80,22
1650058937648,CSE 30,A01,083084,Eldon; John,0,63,40,40
1650058943675,CSE 100,A01,083659,Cao; Yingjun,0,57,50,50
1650058949702,CSE 134B,A01,083661,Powell; Thomas Allan,1,27,65,64
1650058955726,CSE 140,A01,083663,Staff,7,0,75,68
1650058961748,CSE 140L,A01,083088,Eldon; John,2,0,75,73
1650058967867,CSE 175,A01,083665,Kumar; Rakesh,9,0,25,16
1650058973898,CSE 190,A00,092507,Dubnov; Shlomo,14,0,20,6
1650058979925,ECE 45,A01,083139,Staff,0,12,40,40
1650058985955,ECE 65,A50,083695,Staff,0,3,30,30
1650058991983,ECE 109,A01,091882,Touri; Behrouz,48,0,70,22
1650058998006,ECE 180,A00,083140,Abi Samra; Nicholas Camill,24,0,30,6
1650058998006,ECE 180,B00,083141,Abi Samra; Nicholas Camill,8,0,30,22
1650059004034,MATH 10A,A01,083735,Patchell; Gregory David,12,0,30,18
1650059004034,MATH 10A,A02,083736,Patchell; Gregory David,28,0,30,2
1650059004034,MATH 10A,A03,083737,Patchell; Gregory David,27,0,30,3
1650059010064,MATH 10B,A01,083207,Staff,0,5,30,30
1650059010064,MATH 10B,A02,083208,Staff,0,2,30,30
1650059010064,MATH 10B,B01,083739,Staff,20,0,30,10
1650059010064,MATH 10B,B02,083740,Staff,30,0,30,0
1650059016095,MATH 18,A01,083743,Staff,10,0,30,20
1650059016095,MATH 18,A02,083744,Staff,28,0,30,2
1650059016095,MATH 18,A03,083745,Staff,23,0,30,7
1650059016095,MATH 18,A04,083746,Staff,27,0,30,3
1650059016095,MATH 18,B01,083748,Staff,0,9,30,30
1650059016095,MATH 18,B02,083749,Staff,1,6,30,29
1650059016095,MATH 18,B03,083750,Staff,0,6,30,30
1650059016095,MATH 18,B04,083751,Staff,1,7,30,29
1650059022123,MATH 20A,A01,083754,Staff,26,0,40,14
1650059028152,MATH 20B,A01,083756,Staff,0,5,30,30
1650059028152,MATH 20B,A02,083757,Staff,0,1,30,30
1650059034181,MATH 20C,A01,083760,Staff,0,9,30,30
1650059034181,MATH 20C,A02,083761,Staff,0,12,30,30
1650059034181,MATH 20C,B01,083762,Staff,16,0,30,14
1650059034181,MATH 20C,B02,083763,Staff,28,0,30,2
1650059040214,MATH 20D,A01,083765,Staff,0,2,30,30
1650059040214,MATH 20D,A02,083766,Staff,14,0,30,16
1650059040214,MATH 20D,A03,083767,Staff,28,0,30,2
1650059046238,MATH 20E,A01,083771,Staff,10,0,30,20
1650059046238,MATH 20E,A02,083772,Staff,20,0,30,10
1650059046238,MATH 20E,B01,083773,Staff,1,1,30,29
1650059046238,MATH 20E,B02,083774,Staff,17,0,30,13
1650059052274,MATH 103A,A01,083777,Staff,0,6,30,30
1650059052274,MATH 103A,A02,083778,Staff,0,7,30,30
1650059052274,MATH 103A,B01,083779,Staff,0,8,30,30
1650059052274,MATH 103A,B02,083780,Staff,0,6,30,30
1650059058297,MATH 105,A01,085443,Staff,1,11,30,29
1650059064321,MATH 109,A01,083213,Anzaldo; Leesa B,0,4,30,30
1650059064321,MATH 109,A02,083214,Anzaldo; Leesa B,0,4,30,30
1650059064321,MATH 109,B01,083215,Anzaldo; Leesa B,0,2,30,30
1650059064321,MATH 109,B02,083216,Anzaldo; Leesa B,1,3,30,29
1650059070359,MATH 142A,A01,083219,Chow; Bennett,0,8,30,30
1650059070359,MATH 142A,A02,083220,Chow; Bennett,0,8,30,30
1650059070359,MATH 142A,B01,083221,Chow; Bennett,0,9,30,30
1650059070359,MATH 142A,B02,083222,Chow; Bennett,0,9,30,30
1650059076384,MATH 193A,A01,083224,Staff,0,4,30,30
1650059076384,MATH 193A,A02,083225,Staff,0,4,30,30
1650059076384,MATH 193A,A03,083781,Staff,0,0,30,30
1650059076384,MATH 193A,A04,083782,Staff,8,0,30,22
1650059082410,MATH 197,001,091859,McAuley; Julian John,9998,0,9999,1
1650059088466,COGS 9,A01,083615,Staff,3,17,60,57
1650059094491,COGS 11,A01,083617,Boyle; Mary E. T.,25,0,40,15
1650059100514,COGS 13,A01,083071,Staff,0,28,40,40
1650059106536,COGS 14A,A01,092681,Staff,0,10,100,100
1650059112568,COGS 14B,A01,083073,Cheng; Tzu-Han,0,3,50,50
1650059118590,COGS 17,A01,092677,Staff,35,0,75,40
1650059124617,COGS 100,A01,083619,Staff,0,18,60,60
1650059130642,COGS 101A,A01,083621,Davis; Joshua Daniel,0,16,60,60
1650059136664,COGS 101B,A01,091572,Staff,14,0,60,46
1650059142688,COGS 101C,A01,083625,Delgado; Tania,21,0,30,9
1650059148710,COGS 107A,A01,083627,Boyle; Mary E. T.,1,2,60,59
1650059154736,COGS 118A,A01,083075,Staff,19,0,60,41
1650059160763,CSE 3,A50,083646,Miranda; Gregory Joseph,22,0,38,16
1650059160763,CSE 3,A51,083647,Miranda; Gregory Joseph,37,0,37,0
1650059166791,CSE 8A,A50,083650,Miranda; Gregory Joseph,0,16,40,40
1650059172816,CSE 11,A01,083080,Cao; Yingjun,0,62,40,40
1650059178839,CSE 12,A01,083652,Staff,0,1,100,100
1650059184868,CSE 15L,A01,083654,Staff,0,0,50,50
1650059184868,CSE 15L,A02,083655,Staff,11,0,50,39
1650059190897,CSE 20,A01,083657,Staff,58,0,80,22
1650059196923,CSE 30,A01,083084,Eldon; John,0,63,40,40
1650059202949,CSE 100,A01,083659,Cao; Yingjun,0,57,50,50
1650059208972,CSE 134B,A01,083661,Powell; Thomas Allan,1,27,65,64
1650059214995,CSE 140,A01,083663,Staff,7,0,75,68
1650059221020,CSE 140L,A01,083088,Eldon; John,2,0,75,73
1650059227042,CSE 175,A01,083665,Kumar; Rakesh,9,0,25,16
1650059233068,CSE 190,A00,092507,Dubnov; Shlomo,14,0,20,6
1650059239091,ECE 45,A01,083139,Staff,0,12,40,40
1650059245114,ECE 65,A50,083695,Staff,0,3,30,30
1650059251142,ECE 109,A01,091882,Touri; Behrouz,48,0,70,22
1650059257168,ECE 180,A00,083140,Abi Samra; Nicholas Camill,24,0,30,6
1650059257168,ECE 180,B00,083141,Abi Samra; Nicholas Camill,8,0,30,22
1650059263199,MATH 10A,A01,083735,Patchell; Gregory David,12,0,30,18
1650059263199,MATH 10A,A02,083736,Patchell; Gregory David,28,0,30,2
1650059263199,MATH 10A,A03,083737,Patchell; Gregory David,27,0,30,3
1650059269223,MATH 10B,A01,083207,Staff,0,5,30,30
1650059269223,MATH 10B,A02,083208,Staff,0,2,30,30
1650059269223,MATH 10B,B01,083739,Staff,20,0,30,10
1650059269223,MATH 10B,B02,083740,Staff,30,0,30,0
1650059275260,MATH 18,A01,083743,Staff,10,0,30,20
1650059275260,MATH 18,A02,083744,Staff,28,0,30,2
1650059275260,MATH 18,A03,083745,Staff,23,0,30,7
1650059275260,MATH 18,A04,083746,Staff,27,0,30,3
1650059275260,MATH 18,B01,083748,Staff,0,9,30,30
1650059275260,MATH 18,B02,083749,Staff,1,7,30,29
1650059275260,MATH 18,B03,083750,Staff,0,6,30,30
1650059275260,MATH 18,B04,083751,Staff,1,7,30,29
1650059281291,MATH 20A,A01,083754,Staff,26,0,40,14
1650059287313,MATH 20B,A01,083756,Staff,0,5,30,30
1650059287313,MATH 20B,A02,083757,Staff,0,1,30,30
1650059293342,MATH 20C,A01,083760,Staff,0,9,30,30
1650059293342,MATH 20C,A02,083761,Staff,0,12,30,30
1650059293342,MATH 20C,B01,083762,Staff,16,0,30,14
1650059293342,MATH 20C,B02,083763,Staff,28,0,30,2
1650059299366,MATH 20D,A01,083765,Staff,0,2,30,30
1650059299366,MATH 20D,A02,083766,Staff,14,0,30,16
1650059299366,MATH 20D,A03,083767,Staff,28,0,30,2
1650059305391,MATH 20E,A01,083771,Staff,10,0,30,20
1650059305391,MATH 20E,A02,083772,Staff,20,0,30,10
1650059305391,MATH 20E,B01,083773,Staff,1,1,30,29
1650059305391,MATH 20E,B02,083774,Staff,17,0,30,13
1650059311420,MATH 103A,A01,083777,Staff,0,6,30,30
1650059311420,MATH 103A,A02,083778,Staff,0,7,30,30
1650059311420,MATH 103A,B01,083779,Staff,0,8,30,30
1650059311420,MATH 103A,B02,083780,Staff,0,6,30,30
1650059317448,MATH 105,A01,085443,Staff,1,11,30,29
1650059323478,MATH 109,A01,083213,Anzaldo; Leesa B,0,4,30,30
1650059323478,MATH 109,A02,083214,Anzaldo; Leesa B,0,4,30,30
1650059323478,MATH 109,B01,083215,Anzaldo; Leesa B,0,2,30,30
1650059323478,MATH 109,B02,083216,Anzaldo; Leesa B,1,3,30,29
1650059329508,MATH 142A,A01,083219,Chow; Bennett,0,8,30,30
1650059329508,MATH 142A,A02,083220,Chow; Bennett,0,8,30,30
1650059329508,MATH 142A,B01,083221,Chow; Bennett,0,9,30,30
1650059329508,MATH 142A,B02,083222,Chow; Bennett,0,9,30,30
1650059335531,MATH 193A,A01,083224,Staff,0,4,30,30
1650059335531,MATH 193A,A02,083225,Staff,0,4,30,30
1650059335531,MATH 193A,A03,083781,Staff,0,0,30,30
1650059335531,MATH 193A,A04,083782,Staff,8,0,30,22
1650059341561,MATH 197,001,091859,McAuley; Julian John,9998,0,9999,1
1650059347627,COGS 9,A01,083615,Staff,3,17,60,57
1650059353650,COGS 11,A01,083617,Boyle; Mary E. T.,25,0,40,15
1650059359673,COGS 13,A01,083071,Staff,0,28,40,40
1650059365702,COGS 14A,A01,092681,Staff,0,10,100,100
1650059371734,COGS 14B,A01,083073,Cheng; Tzu-Han,0,3,50,50
1650059377762,COGS 17,A01,092677,Staff,35,0,75,40
1650059383794,COGS 100,A01,083619,Staff,0,18,60,60
1650059389819,COGS 101A,A01,083621,Davis; Joshua Daniel,0,16,60,60
1650059395845,COGS 101B,A01,091572,Staff,14,0,60,46
1650059401868,COGS 101C,A01,083625,Delgado; Tania,21,0,30,9
1650059407897,COGS 107A,A01,083627,Boyle; Mary E. T.,1,2,60,59
1650059413919,COGS 118A,A01,083075,Staff,19,0,60,41
1650059419959,CSE 3,A50,083646,Miranda; Gregory Joseph,22,0,38,16
1650059419959,CSE 3,A51,083647,Miranda; Gregory Joseph,37,0,37,0
1650059425983,CSE 8A,A50,083650,Miranda; Gregory Joseph,0,16,40,40
1650059432013,CSE 11,A01,083080,Cao; Yingjun,0,62,40,40
1650059438036,CSE 12,A01,083652,Staff,0,1,100,100
1650059444064,CSE 15L,A01,083654,Staff,0,0,50,50
1650059444064,CSE 15L,A02,083655,Staff,11,0,50,39
1650059450102,CSE 20,A01,083657,Staff,58,0,80,22
1650059456128,CSE 30,A01,083084,Eldon; John,0,63,40,40
1650059462150,CSE 100,A01,083659,Cao; Yingjun,0,57,50,50
1650059468177,CSE 134B,A01,083661,Powell; Thomas Allan,1,27,65,64
1650059474203,CSE 140,A01,083663,Staff,7,0,75,68
1650059480226,CSE 140L,A01,083088,Eldon; John,2,0,75,73
1650059486249,CSE 175,A01,083665,Kumar; Rakesh,9,0,25,16
1650059492276,CSE 190,A00,092507,Dubnov; Shlomo,14,0,20,6
1650059498298,ECE 45,A01,083139,Staff,0,12,40,40
1650059504326,ECE 65,A50,083695,Staff,0,3,30,30
1650059510348,ECE 109,A01,091882,Touri; Behrouz,48,0,70,22
1650059516372,ECE 180,A00,083140,Abi Samra; Nicholas Camill,24,0,30,6
1650059516372,ECE 180,B00,083141,Abi Samra; Nicholas Camill,8,0,30,22
1650059522399,MATH 10A,A01,083735,Patchell; Gregory David,12,0,30,18
1650059522399,MATH 10A,A02,083736,Patchell; Gregory David,28,0,30,2
1650059522399,MATH 10A,A03,083737,Patchell; Gregory David,27,0,30,3
1650059528428,MATH 10B,A01,083207,Staff,0,5,30,30
1650059528428,MATH 10B,A02,083208,Staff,0,2,30,30
1650059528428,MATH 10B,B01,083739,Staff,20,0,30,10
1650059528428,MATH 10B,B02,083740,Staff,30,0,30,0
1650059534454,MATH 18,A01,083743,Staff,10,0,30,20
1650059534454,MATH 18,A02,083744,Staff,28,0,30,2
1650059534454,MATH 18,A03,083745,Staff,23,0,30,7
1650059534454,MATH 18,A04,083746,Staff,27,0,30,3
1650059534454,MATH 18,B01,083748,Staff,0,9,30,30
1650059534454,MATH 18,B02,083749,Staff,1,7,30,29
1650059534454,MATH 18,B03,083750,Staff,0,6,30,30
1650059534454,MATH 18,B04,083751,Staff,1,7,30,29
1650059540477,MATH 20A,A01,083754,Staff,26,0,40,14
1650059546499,MATH 20B,A01,083756,Staff,0,5,30,30
1650059546499,MATH 20B,A02,083757,Staff,0,1,30,30
1650059552533,MATH 20C,A01,083760,Staff,0,9,30,30
1650059552533,MATH 20C,A02,083761,Staff,0,12,30,30
1650059552533,MATH 20C,B01,083762,Staff,16,0,30,14
1650059552533,MATH 20C,B02,083763,Staff,28,0,30,2
1650059558563,MATH 20D,A01,083765,Staff,0,2,30,30
1650059558563,MATH 20D,A02,083766,Staff,14,0,30,16
1650059558563,MATH 20D,A03,083767,Staff,28,0,30,2
1650059564681,MATH 20E,A01,083771,Staff,10,0,30,20
1650059564681,MATH 20E,A02,083772,Staff,20,0,30,10
1650059564681,MATH 20E,B01,083773,Staff,1,1,30,29
1650059564681,MATH 20E,B02,083774,Staff,17,0,30,13
1650059570712,MATH 103A,A01,083777,Staff,0,6,30,30
1650059570712,MATH 103A,A02,083778,Staff,0,7,30,30
1650059570712,MATH 103A,B01,083779,Staff,0,8,30,30
1650059570712,MATH 103A,B02,083780,Staff,0,6,30,30
1650059576745,MATH 105,A01,085443,Staff,1,11,30,29
1650059582767,MATH 109,A01,083213,Anzaldo; Leesa B,0,4,30,30
1650059582767,MATH 109,A02,083214,Anzaldo; Leesa B,0,4,30,30
1650059582767,MATH 109,B01,083215,Anzaldo; Leesa B,0,2,30,30
1650059582767,MATH 109,B02,083216,Anzaldo; Leesa B,1,3,30,29
1650059588793,MATH 142A,A01,083219,Chow; Bennett,0,8,30,30
1650059588793,MATH 142A,A02,083220,Chow; Bennett,0,8,30,30
1650059588793,MATH 142A,B01,083221,Chow; Bennett,0,9,30,30
1650059588793,MATH 142A,B02,083222,Chow; Bennett,0,9,30,30
1650059594816,MATH 193A,A01,083224,Staff,0,4,30,30
1650059594816,MATH 193A,A02,083225,Staff,0,4,30,30
1650059594816,MATH 193A,A03,083781,Staff,0,0,30,30
1650059594816,MATH 193A,A04,083782,Staff,8,0,30,22
1650059600838,MATH 197,001,091859,McAuley; Julian John,9998,0,9999,1
1650059606900,COGS 9,A01,083615,Staff,3,17,60,57
1650059612924,COGS 11,A01,083617,Boyle; Mary E. T.,25,0,40,15
1650059618950,COGS 13,A01,083071,Staff,0,28,40,40
1650059624983,COGS 14A,A01,092681,Staff,0,10,100,100
1650059631007,COGS 14B,A01,083073,Cheng; Tzu-Han,0,3,50,50
1650059637035,COGS 17,A01,092677,Staff,35,0,75,40
1650059643075,COGS 100,A01,083619,Staff,0,18,60,60
1650059649098,COGS 101A,A01,083621,Davis; Joshua Daniel,0,16,60,60
1650059655124,COGS 101B,A01,091572,Staff,14,0,60,46
1650059661149,COGS 101C,A01,083625,Delgado; Tania,21,0,30,9
1650059667200,COGS 107A,A01,083627,Boyle; Mary E. T.,1,2,60,59
1650059673222,COGS 118A,A01,083075,Staff,19,0,60,41
1650059679246,CSE 3,A50,083646,Miranda; Gregory Joseph,22,0,38,16
1650059679246,CSE 3,A51,083647,Miranda; Gregory Joseph,37,0,37,0
1650059685271,CSE 8A,A50,083650,Miranda; Gregory Joseph,0,16,40,40
1650059691295,CSE 11,A01,083080,Cao; Yingjun,0,62,40,40
1650059697319,CSE 12,A01,083652,Staff,0,1,100,100
1650059703364,CSE 15L,A01,083654,Staff,0,0,50,50
1650059703364,CSE 15L,A02,083655,Staff,11,0,50,39
1650059709392,CSE 20,A01,083657,Staff,58,0,80,22
1650059715419,CSE 30,A01,083084,Eldon; John,0,63,40,40
1650059721447,CSE 100,A01,083659,Cao; Yingjun,0,57,50,50
1650059727481,CSE 134B,A01,083661,Powell; Thomas Allan,1,27,65,64
1650059733503,CSE 140,A01,083663,Staff,7,0,75,68
1650059739528,CSE 140L,A01,083088,Eldon; John,2,0,75,73
1650059745564,CSE 175,A01,083665,Kumar; Rakesh,9,0,25,16
1650059751592,CSE 190,A00,092507,Dubnov; Shlomo,14,0,20,6
1650059757613,ECE 45,A01,083139,Staff,0,12,40,40
1650059763636,ECE 65,A50,083695,Staff,0,3,30,30
1650059769672,ECE 109,A01,091882,Touri; Behrouz,48,0,70,22
1650059775705,ECE 180,A00,083140,Abi Samra; Nicholas Camill,24,0,30,6
1650059775705,ECE 180,B00,083141,Abi Samra; Nicholas Camill,8,0,30,22
1650059781735,MATH 10A,A01,083735,Patchell; Gregory David,12,0,30,18
1650059781735,MATH 10A,A02,083736,Patchell; Gregory David,28,0,30,2
1650059781735,MATH 10A,A03,083737,Patchell; Gregory David,27,0,30,3
1650059787762,MATH 10B,A01,083207,Staff,0,5,30,30
1650059787762,MATH 10B,A02,083208,Staff,0,2,30,30
1650059787762,MATH 10B,B01,083739,Staff,19,0,30,11
1650059787762,MATH 10B,B02,083740,Staff,30,0,30,0
1650059793792,MATH 18,A01,083743,Staff,10,0,30,20
1650059793792,MATH 18,A02,083744,Staff,28,0,30,2
1650059793792,MATH 18,A03,083745,Staff,23,0,30,7
1650059793792,MATH 18,A04,083746,Staff,27,0,30,3
1650059793792,MATH 18,B01,083748,Staff,0,9,30,30
1650059793792,MATH 18,B02,083749,Staff,1,7,30,29
1650059793792,MATH 18,B03,083750,Staff,0,6,30,30
1650059793792,MATH 18,B04,083751,Staff,1,7,30,29
1650059799823,MATH 20A,A01,083754,Staff,26,0,40,14
1650059805844,MATH 20B,A01,083756,Staff,0,5,30,30
1650059805844,MATH 20B,A02,083757,Staff,0,1,30,30
1650059811873,MATH 20C,A01,083760,Staff,0,9,30,30
1650059811873,MATH 20C,A02,083761,Staff,0,12,30,30
1650059811873,MATH 20C,B01,083762,Staff,16,0,30,14
1650059811873,MATH 20C,B02,083763,Staff,28,0,30,2
1650059817905,MATH 20D,A01,083765,Staff,0,2,30,30
1650059817905,MATH 20D,A02,083766,Staff,14,0,30,16
1650059817905,MATH 20D,A03,083767,Staff,28,0,30,2
1650059823938,MATH 20E,A01,083771,Staff,10,0,30,20
1650059823938,MATH 20E,A02,083772,Staff,20,0,30,10
1650059823938,MATH 20E,B01,083773,Staff,1,1,30,29
1650059823938,MATH 20E,B02,083774,Staff,17,0,30,13
1650059829963,MATH 103A,A01,083777,Staff,0,6,30,30
1650059829963,MATH 103A,A02,083778,Staff,0,7,30,30
1650059829963,MATH 103A,B01,083779,Staff,0,8,30,30
1650059829963,MATH 103A,B02,083780,Staff,0,6,30,30
1650059835987,MATH 105,A01,085443,Staff,1,11,30,29
1650059842010,MATH 109,A01,083213,Anzaldo; Leesa B,0,4,30,30
1650059842010,MATH 109,A02,083214,Anzaldo; Leesa B,0,4,30,30
1650059842010,MATH 109,B01,083215,Anzaldo; Leesa B,0,2,30,30
1650059842010,MATH 109,B02,083216,Anzaldo; Leesa B,1,3,30,29
1650059858105,MATH 142A,A01,083219,Chow; Bennett,0,8,30,30
1650059858105,MATH 142A,A02,083220,Chow; Bennett,0,8,30,30
1650059858105,MATH 142A,B01,083221,Chow; Bennett,0,9,30,30
1650059858105,MATH 142A,B02,083222,Chow; Bennett,0,9,30,30
1650059864133,MATH 193A,A01,083224,Staff,0,4,30,30
1650059864133,MATH 193A,A02,083225,Staff,0,4,30,30
1650059864133,MATH 193A,A03,083781,Staff,0,0,30,30
1650059864133,MATH 193A,A04,083782,Staff,8,0,30,22
1650059870155,MATH 197,001,091859,McAuley; Julian John,9998,0,9999,1
1650059876217,COGS 9,A01,083615,Staff,3,17,60,57
1650059882238,COGS 11,A01,083617,Boyle; Mary E. T.,25,0,40,15
1650059888261,COGS 13,A01,083071,Staff,0,28,40,40
1650059894300,COGS 14A,A01,092681,Staff,0,10,100,100
1650059900322,COGS 14B,A01,083073,Cheng; Tzu-Han,0,3,50,50
1650059906353,COGS 17,A01,092677,Staff,35,0,75,40
1650059912381,COGS 100,A01,083619,Staff,0,18,60,60
1650059918415,COGS 101A,A01,083621,Davis; Joshua Daniel,0,16,60,60
1650059924444,COGS 101B,A01,091572,Staff,14,0,60,46
1650059930468,COGS 101C,A01,083625,Delgado; Tania,21,0,30,9
1650059936492,COGS 107A,A01,083627,Boyle; Mary E. T.,1,2,60,59
1650059942515,COGS 118A,A01,083075,Staff,19,0,60,41
1650059948541,CSE 3,A50,083646,Miranda; Gregory Joseph,22,0,38,16
1650059948541,CSE 3,A51,083647,Miranda; Gregory Joseph,37,0,37,0
1650059954563,CSE 8A,A50,083650,Miranda; Gregory Joseph,0,16,40,40
1650059960590,CSE 11,A01,083080,Cao; Yingjun,0,62,40,40
1650059966614,CSE 12,A01,083652,Staff,0,1,100,100
1650059972646,CSE 15L,A01,083654,Staff,0,0,50,50
1650059972646,CSE 15L,A02,083655,Staff,11,0,50,39
1650059978674,CSE 20,A01,083657,Staff,58,0,80,22
1650059984700,CSE 30,A01,083084,Eldon; John,0,63,40,40
1650059990727,CSE 100,A01,083659,Cao; Yingjun,0,57,50,50
1650059996754,CSE 134B,A01,083661,Powell; Thomas Allan,1,27,65,64
1650060002781,CSE 140,A01,083663,Staff,7,0,75,68
1650060008813,CSE 140L,A01,083088,Eldon; John,2,0,75,73
1650060014842,CSE 175,A01,083665,Kumar; Rakesh,9,0,25,16
1650060020868,CSE 190,A00,092507,Dubnov; Shlomo,14,0,20,6
1650060026891,ECE 45,A01,083139,Staff,0,12,40,40
1650060032925,ECE 65,A50,083695,Staff,0,3,30,30
1650060038950,ECE 109,A01,091882,Touri; Behrouz,48,0,70,22
1650060044979,ECE 180,A00,083140,Abi Samra; Nicholas Camill,24,0,30,6
1650060044979,ECE 180,B00,083141,Abi Samra; Nicholas Camill,8,0,30,22
1650060051003,MATH 10A,A01,083735,Patchell; Gregory David,12,0,30,18
1650060051003,MATH 10A,A02,083736,Patchell; Gregory David,28,0,30,2
1650060051003,MATH 10A,A03,083737,Patchell; Gregory David,27,0,30,3
1650060057029,MATH 10B,A01,083207,Staff,0,5,30,30
1650060057029,MATH 10B,A02,083208,Staff,0,2,30,30
1650060057029,MATH 10B,B01,083739,Staff,19,0,30,11
1650060057029,MATH 10B,B02,083740,Staff,30,0,30,0
1650060063054,MATH 18,A01,083743,Staff,10,0,30,20
1650060063054,MATH 18,A02,083744,Staff,28,0,30,2
1650060063054,MATH 18,A03,083745,Staff,23,0,30,7
1650060063054,MATH 18,A04,083746,Staff,27,0,30,3
1650060063054,MATH 18,B01,083748,Staff,0,9,30,30
1650060063054,MATH 18,B02,083749,Staff,1,7,30,29
1650060063054,MATH 18,B03,083750,Staff,0,6,30,30
1650060063054,MATH 18,B04,083751,Staff,1,7,30,29
1650060069078,MATH 20A,A01,083754,Staff,26,0,40,14
1650060075102,MATH 20B,A01,083756,Staff,0,5,30,30
1650060075102,MATH 20B,A02,083757,Staff,0,1,30,30
1650060081126,MATH 20C,A01,083760,Staff,0,9,30,30
1650060081126,MATH 20C,A02,083761,Staff,0,12,30,30
1650060081126,MATH 20C,B01,083762,Staff,16,0,30,14
1650060081126,MATH 20C,B02,083763,Staff,28,0,30,2
1650060087153,MATH 20D,A01,083765,Staff,0,2,30,30
1650060087153,MATH 20D,A02,083766,Staff,14,0,30,16
1650060087153,MATH 20D,A03,083767,Staff,28,0,30,2
1650060093181,MATH 20E,A01,083771,Staff,10,0,30,20
1650060093181,MATH 20E,A02,083772,Staff,20,0,30,10
1650060093181,MATH 20E,B01,083773,Staff,1,1,30,29
1650060093181,MATH 20E,B02,083774,Staff,17,0,30,13
1650060099209,MATH 103A,A01,083777,Staff,0,6,30,30
1650060099209,MATH 103A,A02,083778,Staff,0,7,30,30
1650060099209,MATH 103A,B01,083779,Staff,0,8,30,30
1650060099209,MATH 103A,B02,083780,Staff,0,6,30,30
1650060105233,MATH 105,A01,085443,Staff,1,11,30,29
1650060111259,MATH 109,A01,083213,Anzaldo; Leesa B,0,4,30,30
1650060111259,MATH 109,A02,083214,Anzaldo; Leesa B,0,4,30,30
1650060111259,MATH 109,B01,083215,Anzaldo; Leesa B,0,2,30,30
1650060111259,MATH 109,B02,083216,Anzaldo; Leesa B,1,3,30,29
1650060117289,MATH 142A,A01,083219,Chow; Bennett,0,8,30,30
1650060117289,MATH 142A,A02,083220,Chow; Bennett,0,8,30,30
1650060117289,MATH 142A,B01,083221,Chow; Bennett,0,9,30,30
1650060117289,MATH 142A,B02,083222,Chow; Bennett,0,9,30,30
1650060123314,MATH 193A,A01,083224,Staff,0,4,30,30
1650060123314,MATH 193A,A02,083225,Staff,0,4,30,30
1650060123314,MATH 193A,A03,083781,Staff,0,0,30,30
1650060123314,MATH 193A,A04,083782,Staff,8,0,30,22
1650060129338,MATH 197,001,091859,McAuley; Julian John,9998,0,9999,1
1650060135393,COGS 9,A01,083615,Staff,3,17,60,57
1650060141415,COGS 11,A01,083617,Boyle; Mary E. T.,25,0,40,15
1650060147440,COGS 13,A01,083071,Staff,0,28,40,40
1650060153463,COGS 14A,A01,092681,Staff,0,10,100,100
1650060159486,COGS 14B,A01,083073,Cheng; Tzu-Han,0,3,50,50
1650060165708,COGS 17,A01,092677,Staff,35,0,75,40
1650060171734,COGS 100,A01,083619,Staff,0,18,60,60
1650060177758,COGS 101A,A01,083621,Davis; Joshua Daniel,0,16,60,60
1650060183788,COGS 101B,A01,091572,Staff,14,0,60,46
1650060189810,COGS 101C,A01,083625,Delgado; Tania,21,0,30,9
1650060195833,COGS 107A,A01,083627,Boyle; Mary E. T.,1,2,60,59
1650060201859,COGS 118A,A01,083075,Staff,19,0,60,41
1650060207889,CSE 3,A50,083646,Miranda; Gregory Joseph,22,0,38,16
1650060207889,CSE 3,A51,083647,Miranda; Gregory Joseph,37,0,37,0
1650060213922,CSE 8A,A50,083650,Miranda; Gregory Joseph,0,16,40,40
1650060219947,CSE 11,A01,083080,Cao; Yingjun,0,62,40,40
1650060225969,CSE 12,A01,083652,Staff,0,1,100,100
1650060231993,CSE 15L,A01,083654,Staff,0,0,50,50
1650060231993,CSE 15L,A02,083655,Staff,11,0,50,39
1650060238016,CSE 20,A01,083657,Staff,58,0,80,22
1650060244044,CSE 30,A01,083084,Eldon; John,0,63,40,40
1650060250075,CSE 100,A01,083659,Cao; Yingjun,0,57,50,50
1650060256098,CSE 134B,A01,083661,Powell; Thomas Allan,1,27,65,64
1650060262132,CSE 140,A01,083663,Staff,7,0,75,68
1650060268154,CSE 140L,A01,083088,Eldon; John,2,0,75,73
1650060274179,CSE 175,A01,083665,Kumar; Rakesh,9,0,25,16
1650060280202,CSE 190,A00,092507,Dubnov; Shlomo,14,0,20,6
1650060286226,ECE 45,A01,083139,Staff,0,12,40,40
1650060292250,ECE 65,A50,083695,Staff,0,3,30,30
1650060298290,ECE 109,A01,091882,Touri; Behrouz,48,0,70,22
1650060304319,ECE 180,A00,083140,Abi Samra; Nicholas Camill,24,0,30,6
1650060304319,ECE 180,B00,083141,Abi Samra; Nicholas Camill,8,0,30,22
1650060310351,MATH 10A,A01,083735,Patchell; Gregory David,12,0,30,18
1650060310351,MATH 10A,A02,083736,Patchell; Gregory David,28,0,30,2
1650060310351,MATH 10A,A03,083737,Patchell; Gregory David,27,0,30,3
1650060316379,MATH 10B,A01,083207,Staff,0,5,30,30
1650060316379,MATH 10B,A02,083208,Staff,0,2,30,30
1650060316379,MATH 10B,B01,083739,Staff,19,0,30,11
1650060316379,MATH 10B,B02,083740,Staff,30,0,30,0
1650060322410,MATH 18,A01,083743,Staff,10,0,30,20
1650060322410,MATH 18,A02,083744,Staff,28,0,30,2
1650060322410,MATH 18,A03,083745,Staff,23,0,30,7
1650060322410,MATH 18,A04,083746,Staff,27,0,30,3
1650060322410,MATH 18,B01,083748,Staff,0,9,30,30
1650060322410,MATH 18,B02,083749,Staff,1,7,30,29
1650060322410,MATH 18,B03,083750,Staff,0,6,30,30
1650060322410,MATH 18,B04,083751,Staff,1,7,30,29
1650060328434,MATH 20A,A01,083754,Staff,26,0,40,14
1650060334472,MATH 20B,A01,083756,Staff,0,5,30,30
1650060334472,MATH 20B,A02,083757,Staff,0,1,30,30
1650060340496,MATH 20C,A01,083760,Staff,0,9,30,30
1650060340496,MATH 20C,A02,083761,Staff,0,12,30,30
1650060340496,MATH 20C,B01,083762,Staff,16,0,30,14
1650060340496,MATH 20C,B02,083763,Staff,28,0,30,2
1650060346525,MATH 20D,A01,083765,Staff,0,2,30,30
1650060346525,MATH 20D,A02,083766,Staff,14,0,30,16
1650060346525,MATH 20D,A03,083767,Staff,28,0,30,2
1650060352553,MATH 20E,A01,083771,Staff,10,0,30,20
1650060352553,MATH 20E,A02,083772,Staff,20,0,30,10
1650060352553,MATH 20E,B01,083773,Staff,1,1,30,29
1650060352553,MATH 20E,B02,083774,Staff,17,0,30,13
1650060358584,MATH 103A,A01,083777,Staff,0,6,30,30
1650060358584,MATH 103A,A02,083778,Staff,0,7,30,30
1650060358584,MATH 103A,B01,083779,Staff,0,8,30,30
1650060358584,MATH 103A,B02,083780,Staff,0,6,30,30
1650060364611,MATH 105,A01,085443,Staff,1,11,30,29
1650060370641,MATH 109,A01,083213,Anzaldo; Leesa B,0,4,30,30
1650060370641,MATH 109,A02,083214,Anzaldo; Leesa B,0,4,30,30
1650060370641,MATH 109,B01,083215,Anzaldo; Leesa B,0,2,30,30
1650060370641,MATH 109,B02,083216,Anzaldo; Leesa B,1,3,30,29
1650060376669,MATH 142A,A01,083219,Chow; Bennett,0,8,30,30
1650060376669,MATH 142A,A02,083220,Chow; Bennett,0,8,30,30
1650060376669,MATH 142A,B01,083221,Chow; Bennett,0,9,30,30
1650060376669,MATH 142A,B02,083222,Chow; Bennett,0,9,30,30
1650060382695,MATH 193A,A01,083224,Staff,0,4,30,30
1650060382695,MATH 193A,A02,083225,Staff,0,4,30,30
1650060382695,MATH 193A,A03,083781,Staff,0,0,30,30
1650060382695,MATH 193A,A04,083782,Staff,8,0,30,22
1650060388728,MATH 197,001,091859,McAuley; Julian John,9998,0,9999,1
1650060394792,COGS 9,A01,083615,Staff,3,17,60,57
1650060400819,COGS 11,A01,083617,Boyle; Mary E. T.,25,0,40,15
1650060406847,COGS 13,A01,083071,Staff,0,28,40,40
1650060412874,COGS 14A,A01,092681,Staff,0,10,100,100
1650060418897,COGS 14B,A01,083073,Cheng; Tzu-Han,0,3,50,50
1650060424921,COGS 17,A01,092677,Staff,35,0,75,40
1650060430954,COGS 100,A01,083619,Staff,0,18,60,60
1650060436983,COGS 101A,A01,083621,Davis; Joshua Daniel,0,16,60,60
1650060443007,COGS 101B,A01,091572,Staff,14,0,60,46
1650060449032,COGS 101C,A01,083625,Delgado; Tania,21,0,30,9
1650060455056,COGS 107A,A01,083627,Boyle; Mary E. T.,1,2,60,59
1650060461077,COGS 118A,A01,083075,Staff,19,0,60,41
1650060467101,CSE 3,A50,083646,Miranda; Gregory Joseph,22,0,38,16
1650060467101,CSE 3,A51,083647,Miranda; Gregory Joseph,37,0,37,0
1650060473133,CSE 8A,A50,083650,Miranda; Gregory Joseph,0,16,40,40
1650060479155,CSE 11,A01,083080,Cao; Yingjun,0,63,40,40
1650060485177,CSE 12,A01,083652,Staff,0,1,100,100
1650060491206,CSE 15L,A01,083654,Staff,0,0,50,50
1650060491206,CSE 15L,A02,083655,Staff,11,0,50,39
1650060497235,CSE 20,A01,083657,Staff,58,0,80,22
1650060503258,CSE 30,A01,083084,Eldon; John,0,63,40,40
1650060509284,CSE 100,A01,083659,Cao; Yingjun,0,57,50,50
1650060515314,CSE 134B,A01,083661,Powell; Thomas Allan,1,27,65,64
1650060521336,CSE 140,A01,083663,Staff,7,0,75,68
1650060527363,CSE 140L,A01,083088,Eldon; John,2,0,75,73
1650060533386,CSE 175,A01,083665,Kumar; Rakesh,9,0,25,16
1650060539415,CSE 190,A00,092507,Dubnov; Shlomo,14,0,20,6
1650060545442,ECE 45,A01,083139,Staff,0,12,40,40
1650060551482,ECE 65,A50,083695,Staff,0,3,30,30
1650060557504,ECE 109,A01,091882,Touri; Behrouz,48,0,70,22
1650060563527,ECE 180,A00,083140,Abi Samra; Nicholas Camill,24,0,30,6
1650060563527,ECE 180,B00,083141,Abi Samra; Nicholas Camill,8,0,30,22
1650060569554,MATH 10A,A01,083735,Patchell; Gregory David,12,0,30,18
1650060569554,MATH 10A,A02,083736,Patchell; Gregory David,28,0,30,2
1650060569554,MATH 10A,A03,083737,Patchell; Gregory David,27,0,30,3
1650060575582,MATH 10B,A01,083207,Staff,0,5,30,30
1650060575582,MATH 10B,A02,083208,Staff,0,2,30,30
1650060575582,MATH 10B,B01,083739,Staff,19,0,30,11
1650060575582,MATH 10B,B02,083740,Staff,30,0,30,0
1650060581609,MATH 18,A01,083743,Staff,10,0,30,20
1650060581609,MATH 18,A02,083744,Staff,28,0,30,2
1650060581609,MATH 18,A03,083745,Staff,23,0,30,7
1650060581609,MATH 18,A04,083746,Staff,27,0,30,3
1650060581609,MATH 18,B01,083748,Staff,0,9,30,30
1650060581609,MATH 18,B02,083749,Staff,1,7,30,29
1650060581609,MATH 18,B03,083750,Staff,0,6,30,30
1650060581609,MATH 18,B04,083751,Staff,1,8,30,29
1650060587633,MATH 20A,A01,083754,Staff,26,0,40,14
1650060593658,MATH 20B,A01,083756,Staff,0,5,30,30
1650060593658,MATH 20B,A02,083757,Staff,0,1,30,30
1650060599683,MATH 20C,A01,083760,Staff,0,10,30,30
1650060599683,MATH 20C,A02,083761,Staff,0,12,30,30
1650060599683,MATH 20C,B01,083762,Staff,16,0,30,14
1650060599683,MATH 20C,B02,083763,Staff,28,0,30,2
1650060605711,MATH 20D,A01,083765,Staff,0,2,30,30
1650060605711,MATH 20D,A02,083766,Staff,14,0,30,16
1650060605711,MATH 20D,A03,083767,Staff,28,0,30,2
1650060611737,MATH 20E,A01,083771,Staff,10,0,30,20
1650060611737,MATH 20E,A02,083772,Staff,20,0,30,10
1650060611737,MATH 20E,B01,083773,Staff,1,1,30,29
1650060611737,MATH 20E,B02,083774,Staff,17,0,30,13
1650060617770,MATH 103A,A01,083777,Staff,0,6,30,30
1650060617770,MATH 103A,A02,083778,Staff,0,7,30,30
1650060617770,MATH 103A,B01,083779,Staff,0,8,30,30
1650060617770,MATH 103A,B02,083780,Staff,0,6,30,30
1650060623799,MATH 105,A01,085443,Staff,1,11,30,29
1650060629826,MATH 109,A01,083213,Anzaldo; Leesa B,0,4,30,30
1650060629826,MATH 109,A02,083214,Anzaldo; Leesa B,0,4,30,30
1650060629826,MATH 109,B01,083215,Anzaldo; Leesa B,0,2,30,30
1650060629826,MATH 109,B02,083216,Anzaldo; Leesa B,1,3,30,29
1650060635855,MATH 142A,A01,083219,Chow; Bennett,0,8,30,30
1650060635855,MATH 142A,A02,083220,Chow; Bennett,0,8,30,30
1650060635855,MATH 142A,B01,083221,Chow; Bennett,0,9,30,30
1650060635855,MATH 142A,B02,083222,Chow; Bennett,0,9,30,30
1650060641880,MATH 193A,A01,083224,Staff,0,4,30,30
1650060641880,MATH 193A,A02,083225,Staff,0,4,30,30
1650060641880,MATH 193A,A03,083781,Staff,0,0,30,30
1650060641880,MATH 193A,A04,083782,Staff,8,0,30,22
1650060647905,MATH 197,001,091859,McAuley; Julian John,9998,0,9999,1
1650060653962,COGS 9,A01,083615,Staff,3,17,60,57
1650060659984,COGS 11,A01,083617,Boyle; Mary E. T.,25,0,40,15
1650060666014,COGS 13,A01,083071,Staff,0,28,40,40
1650060672040,COGS 14A,A01,092681,Staff,0,10,100,100
1650060678071,COGS 14B,A01,083073,Cheng; Tzu-Han,0,3,50,50
1650060684097,COGS 17,A01,092677,Staff,35,0,75,40
1650060690121,COGS 100,A01,083619,Staff,0,18,60,60
1650060696151,COGS 101A,A01,083621,Davis; Joshua Daniel,0,16,60,60
1650060702173,COGS 101B,A01,091572,Staff,14,0,60,46
1650060708203,COGS 101C,A01,083625,Delgado; Tania,21,0,30,9
1650060714228,COGS 107A,A01,083627,Boyle; Mary E. T.,1,2,60,59
1650060720250,COGS 118A,A01,083075,Staff,19,0,60,41
1650060726278,CSE 3,A50,083646,Miranda; Gregory Joseph,22,0,38,16
1650060726278,CSE 3,A51,083647,Miranda; Gregory Joseph,37,0,37,0
1650060732306,CSE 8A,A50,083650,Miranda; Gregory Joseph,0,16,40,40
1650060738343,CSE 11,A01,083080,Cao; Yingjun,0,63,40,40
1650060744371,CSE 12,A01,083652,Staff,0,1,100,100
1650060750393,CSE 15L,A01,083654,Staff,0,0,50,50
1650060750393,CSE 15L,A02,083655,Staff,11,0,50,39
1650060756419,CSE 20,A01,083657,Staff,58,0,80,22
1650060762543,CSE 30,A01,083084,Eldon; John,0,63,40,40
1650060768567,CSE 100,A01,083659,Cao; Yingjun,0,57,50,50
1650060774603,CSE 134B,A01,083661,Powell; Thomas Allan,1,27,65,64
1650060780626,CSE 140,A01,083663,Staff,7,0,75,68
1650060786649,CSE 140L,A01,083088,Eldon; John,2,0,75,73
1650060792673,CSE 175,A01,083665,Kumar; Rakesh,9,0,25,16
1650060798699,CSE 190,A00,092507,Dubnov; Shlomo,14,0,20,6
1650060804733,ECE 45,A01,083139,Staff,0,12,40,40
1650060810758,ECE 65,A50,083695,Staff,0,3,30,30
1650060816786,ECE 109,A01,091882,Touri; Behrouz,48,0,70,22
1650060822811,ECE 180,A00,083140,Abi Samra; Nicholas Camill,24,0,30,6
1650060822811,ECE 180,B00,083141,Abi Samra; Nicholas Camill,8,0,30,22
1650060828837,MATH 10A,A01,083735,Patchell; Gregory David,12,0,30,18
1650060828837,MATH 10A,A02,083736,Patchell; Gregory David,28,0,30,2
1650060828837,MATH 10A,A03,083737,Patchell; Gregory David,27,0,30,3
1650060834863,MATH 10B,A01,083207,Staff,0,5,30,30
1650060834863,MATH 10B,A02,083208,Staff,0,2,30,30
1650060834863,MATH 10B,B01,083739,Staff,19,0,30,11
1650060834863,MATH 10B,B02,083740,Staff,30,0,30,0
1650060840887,MATH 18,A01,083743,Staff,10,0,30,20
1650060840887,MATH 18,A02,083744,Staff,28,0,30,2
1650060840887,MATH 18,A03,083745,Staff,23,0,30,7
1650060840887,MATH 18,A04,083746,Staff,27,0,30,3
1650060840887,MATH 18,B01,083748,Staff,0,9,30,30
1650060840887,MATH 18,B02,083749,Staff,1,7,30,29
1650060840887,MATH 18,B03,083750,Staff,0,6,30,30
1650060840887,MATH 18,B04,083751,Staff,1,8,30,29
1650060846912,MATH 20A,A01,083754,Staff,26,0,40,14
1650060852941,MATH 20B,A01,083756,Staff,0,5,30,30
1650060852941,MATH 20B,A02,083757,Staff,0,1,30,30
1650060858964,MATH 20C,A01,083760,Staff,0,10,30,30
1650060858964,MATH 20C,A02,083761,Staff,0,12,30,30
1650060858964,MATH 20C,B01,083762,Staff,16,0,30,14
1650060858964,MATH 20C,B02,083763,Staff,28,0,30,2
1650060864996,MATH 20D,A01,083765,Staff,0,2,30,30
1650060864996,MATH 20D,A02,083766,Staff,14,0,30,16
1650060864996,MATH 20D,A03,083767,Staff,28,0,30,2
1650060871033,MATH 20E,A01,083771,Staff,10,0,30,20
1650060871033,MATH 20E,A02,083772,Staff,20,0,30,10
1650060871033,MATH 20E,B01,083773,Staff,1,1,30,29
1650060871033,MATH 20E,B02,083774,Staff,17,0,30,13
1650060877063,MATH 103A,A01,083777,Staff,0,6,30,30
1650060877063,MATH 103A,A02,083778,Staff,0,7,30,30
1650060877063,MATH 103A,B01,083779,Staff,0,8,30,30
1650060877063,MATH 103A,B02,083780,Staff,0,6,30,30
1650060883091,MATH 105,A01,085443,Staff,1,11,30,29
1650060889122,MATH 109,A01,083213,Anzaldo; Leesa B,0,4,30,30
1650060889122,MATH 109,A02,083214,Anzaldo; Leesa B,0,4,30,30
1650060889122,MATH 109,B01,083215,Anzaldo; Leesa B,0,2,30,30
1650060889122,MATH 109,B02,083216,Anzaldo; Leesa B,1,3,30,29
1650060895144,MATH 142A,A01,083219,Chow; Bennett,0,8,30,30
1650060895144,MATH 142A,A02,083220,Chow; Bennett,0,8,30,30
1650060895144,MATH 142A,B01,083221,Chow; Bennett,0,9,30,30
1650060895144,MATH 142A,B02,083222,Chow; Bennett,0,9,30,30
1650060901180,MATH 193A,A01,083224,Staff,0,4,30,30
1650060901180,MATH 193A,A02,083225,Staff,0,4,30,30
1650060901180,MATH 193A,A03,083781,Staff,0,0,30,30
1650060901180,MATH 193A,A04,083782,Staff,8,0,30,22
1650060907201,MATH 197,001,091859,McAuley; Julian John,9998,0,9999,1
1650060913258,COGS 9,A01,083615,Staff,3,17,60,57
1650060919282,COGS 11,A01,083617,Boyle; Mary E. T.,25,0,40,15
1650060925304,COGS 13,A01,083071,Staff,0,28,40,40
1650060931328,COGS 14A,A01,092681,Staff,0,10,100,100
1650060937357,COGS 14B,A01,083073,Cheng; Tzu-Han,0,3,50,50
1650060943384,COGS 17,A01,092677,Staff,35,0,75,40
1650060949411,COGS 100,A01,083619,Staff,0,18,60,60
1650060955434,COGS 101A,A01,083621,Davis; Joshua Daniel,0,16,60,60
1650060961461,COGS 101B,A01,091572,Staff,13,0,60,47
1650060967490,COGS 101C,A01,083625,Delgado; Tania,21,0,30,9
1650060973524,COGS 107A,A01,083627,Boyle; Mary E. T.,1,3,60,59
1650060979551,COGS 118A,A01,083075,Staff,19,0,60,41
1650060985581,CSE 3,A50,083646,Miranda; Gregory Joseph,22,0,38,16
1650060985581,CSE 3,A51,083647,Miranda; Gregory Joseph,37,0,37,0
1650060991603,CSE 8A,A50,083650,Miranda; Gregory Joseph,0,16,40,40
1650060997633,CSE 11,A01,083080,Cao; Yingjun,0,63,40,40
1650061003657,CSE 12,A01,083652,Staff,0,1,100,100
1650061009680,CSE 15L,A01,083654,Staff,0,0,50,50
1650061009680,CSE 15L,A02,083655,Staff,11,0,50,39
1650061015705,CSE 20,A01,083657,Staff,58,0,80,22
1650061021731,CSE 30,A01,083084,Eldon; John,0,63,40,40
1650061027753,CSE 100,A01,083659,Cao; Yingjun,0,57,50,50
1650061033784,CSE 134B,A01,083661,Powell; Thomas Allan,1,27,65,64
1650061039806,CSE 140,A01,083663,Staff,7,0,75,68
1650061045830,CSE 140L,A01,083088,Eldon; John,2,0,75,73
1650061051856,CSE 175,A01,083665,Kumar; Rakesh,9,0,25,16
1650061057885,CSE 190,A00,092507,Dubnov; Shlomo,14,0,20,6
1650061063912,ECE 45,A01,083139,Staff,0,12,40,40
1650061069936,ECE 65,A50,083695,Staff,0,3,30,30
1650061075969,ECE 109,A01,091882,Touri; Behrouz,48,0,70,22
1650061081992,ECE 180,A00,083140,Abi Samra; Nicholas Camill,24,0,30,6
1650061081992,ECE 180,B00,083141,Abi Samra; Nicholas Camill,8,0,30,22
1650061088017,MATH 10A,A01,083735,Patchell; Gregory David,12,0,30,18
1650061088017,MATH 10A,A02,083736,Patchell; Gregory David,28,0,30,2
1650061088017,MATH 10A,A03,083737,Patchell; Gregory David,27,0,30,3
1650061094045,MATH 10B,A01,083207,Staff,0,5,30,30
1650061094045,MATH 10B,A02,083208,Staff,0,2,30,30
1650061094045,MATH 10B,B01,083739,Staff,19,0,30,11
1650061094045,MATH 10B,B02,083740,Staff,30,0,30,0
1650061100072,MATH 18,A01,083743,Staff,10,0,30,20
1650061100072,MATH 18,A02,083744,Staff,28,0,30,2
1650061100072,MATH 18,A03,083745,Staff,23,0,30,7
1650061100072,MATH 18,A04,083746,Staff,27,0,30,3
1650061100072,MATH 18,B01,083748,Staff,0,9,30,30
1650061100072,MATH 18,B02,083749,Staff,1,7,30,29
1650061100072,MATH 18,B03,083750,Staff,0,6,30,30
1650061100072,MATH 18,B04,083751,Staff,1,8,30,29
1650061106101,MATH 20A,A01,083754,Staff,26,0,40,14
1650061112129,MATH 20B,A01,083756,Staff,0,5,30,30
1650061112129,MATH 20B,A02,083757,Staff,0,1,30,30
1650061118158,MATH 20C,A01,083760,Staff,0,10,30,30
1650061118158,MATH 20C,A02,083761,Staff,0,12,30,30
1650061118158,MATH 20C,B01,083762,Staff,16,0,30,14
1650061118158,MATH 20C,B02,083763,Staff,28,0,30,2
1650061124182,MATH 20D,A01,083765,Staff,0,2,30,30
1650061124182,MATH 20D,A02,083766,Staff,14,0,30,16
1650061124182,MATH 20D,A03,083767,Staff,28,0,30,2
1650061130216,MATH 20E,A01,083771,Staff,10,0,30,20
1650061130216,MATH 20E,A02,083772,Staff,20,0,30,10
1650061130216,MATH 20E,B01,083773,Staff,1,1,30,29
1650061130216,MATH 20E,B02,083774,Staff,17,0,30,13
1650061136243,MATH 103A,A01,083777,Staff,0,6,30,30
1650061136243,MATH 103A,A02,083778,Staff,0,7,30,30
1650061136243,MATH 103A,B01,083779,Staff,0,8,30,30
1650061136243,MATH 103A,B02,083780,Staff,0,6,30,30
1650061142270,MATH 105,A01,085443,Staff,1,11,30,29
1650061148296,MATH 109,A01,083213,Anzaldo; Leesa B,0,4,30,30
1650061148296,MATH 109,A02,083214,Anzaldo; Leesa B,0,4,30,30
1650061148296,MATH 109,B01,083215,Anzaldo; Leesa B,0,2,30,30
1650061148296,MATH 109,B02,083216,Anzaldo; Leesa B,1,3,30,29
1650061154323,MATH 142A,A01,083219,Chow; Bennett,0,9,30,30
1650061154323,MATH 142A,A02,083220,Chow; Bennett,0,8,30,30
1650061154323,MATH 142A,B01,083221,Chow; Bennett,0,9,30,30
1650061154323,MATH 142A,B02,083222,Chow; Bennett,0,9,30,30
1650061160349,MATH 193A,A01,083224,Staff,0,4,30,30
1650061160349,MATH 193A,A02,083225,Staff,0,4,30,30
1650061160349,MATH 193A,A03,083781,Staff,0,0,30,30
1650061160349,MATH 193A,A04,083782,Staff,8,0,30,22
1650061166375,MATH 197,001,091859,McAuley; Julian John,9998,0,9999,1
1650061172424,COGS 9,A01,083615,Staff,3,17,60,57
1650061178451,COGS 11,A01,083617,Boyle; Mary E. T.,24,0,40,16
1650061184478,COGS 13,A01,083071,Staff,0,28,40,40
1650061190502,COGS 14A,A01,092681,Staff,0,10,100,100
1650061196541,COGS 14B,A01,083073,Cheng; Tzu-Han,0,3,50,50
1650061202564,COGS 17,A01,092677,Staff,35,0,75,40
1650061208587,COGS 100,A01,083619,Staff,0,18,60,60
1650061214610,COGS 101A,A01,083621,Davis; Joshua Daniel,0,16,60,60
1650061220641,COGS 101B,A01,091572,Staff,13,0,60,47
1650061226670,COGS 101C,A01,083625,Delgado; Tania,21,0,30,9
1650061232698,COGS 107A,A01,083627,Boyle; Mary E. T.,1,3,60,59
1650061238722,COGS 118A,A01,083075,Staff,19,0,60,41
1650061244764,CSE 3,A50,083646,Miranda; Gregory Joseph,22,0,38,16
1650061244764,CSE 3,A51,083647,Miranda; Gregory Joseph,37,0,37,0
1650061250786,CSE 8A,A50,083650,Miranda; Gregory Joseph,0,16,40,40
1650061256819,CSE 11,A01,083080,Cao; Yingjun,0,63,40,40
1650061262845,CSE 12,A01,083652,Staff,0,1,100,100
1650061268868,CSE 15L,A01,083654,Staff,0,0,50,50
1650061268868,CSE 15L,A02,083655,Staff,11,0,50,39
1650061274894,CSE 20,A01,083657,Staff,58,0,80,22
1650061280918,CSE 30,A01,083084,Eldon; John,0,63,40,40
1650061286947,CSE 100,A01,083659,Cao; Yingjun,0,57,50,50
1650061292971,CSE 134B,A01,083661,Powell; Thomas Allan,1,27,65,64
1650061298997,CSE 140,A01,083663,Staff,7,0,75,68
1650061305024,CSE 140L,A01,083088,Eldon; John,2,0,75,73
1650061311047,CSE 175,A01,083665,Kumar; Rakesh,9,0,25,16
1650061317071,CSE 190,A00,092507,Dubnov; Shlomo,14,0,20,6
1650061323105,ECE 45,A01,083139,Staff,0,12,40,40
1650061329127,ECE 65,A50,083695,Staff,0,3,30,30
1650061335153,ECE 109,A01,091882,Touri; Behrouz,48,0,70,22
1650061341177,ECE 180,A00,083140,Abi Samra; Nicholas Camill,24,0,30,6
1650061341177,ECE 180,B00,083141,Abi Samra; Nicholas Camill,8,0,30,22
1650061347206,MATH 10A,A01,083735,Patchell; Gregory David,12,0,30,18
1650061347206,MATH 10A,A02,083736,Patchell; Gregory David,28,0,30,2
1650061347206,MATH 10A,A03,083737,Patchell; Gregory David,27,0,30,3
1650061353239,MATH 10B,A01,083207,Staff,0,5,30,30
1650061353239,MATH 10B,A02,083208,Staff,0,2,30,30
1650061353239,MATH 10B,B01,083739,Staff,19,0,30,11
1650061353239,MATH 10B,B02,083740,Staff,30,0,30,0
1650061359352,MATH 18,A01,083743,Staff,10,0,30,20
1650061359352,MATH 18,A02,083744,Staff,28,0,30,2
1650061359352,MATH 18,A03,083745,Staff,23,0,30,7
1650061359352,MATH 18,A04,083746,Staff,27,0,30,3
1650061359352,MATH 18,B01,083748,Staff,0,9,30,30
1650061359352,MATH 18,B02,083749,Staff,1,7,30,29
1650061359352,MATH 18,B03,083750,Staff,0,6,30,30
1650061359352,MATH 18,B04,083751,Staff,1,8,30,29
1650061365375,MATH 20A,A01,083754,Staff,26,0,40,14
1650061371399,MATH 20B,A01,083756,Staff,0,5,30,30
1650061371399,MATH 20B,A02,083757,Staff,0,1,30,30
1650061377422,MATH 20C,A01,083760,Staff,0,9,30,30
1650061377422,MATH 20C,A02,083761,Staff,0,12,30,30
1650061377422,MATH 20C,B01,083762,Staff,16,0,30,14
1650061377422,MATH 20C,B02,083763,Staff,28,0,30,2
1650061383450,MATH 20D,A01,083765,Staff,0,2,30,30
1650061383450,MATH 20D,A02,083766,Staff,14,0,30,16
1650061383450,MATH 20D,A03,083767,Staff,28,0,30,2
1650061389476,MATH 20E,A01,083771,Staff,10,0,30,20
1650061389476,MATH 20E,A02,083772,Staff,20,0,30,10
1650061389476,MATH 20E,B01,083773,Staff,1,1,30,29
1650061389476,MATH 20E,B02,083774,Staff,17,0,30,13
1650061395504,MATH 103A,A01,083777,Staff,0,6,30,30
1650061395504,MATH 103A,A02,083778,Staff,0,7,30,30
1650061395504,MATH 103A,B01,083779,Staff,0,8,30,30
1650061395504,MATH 103A,B02,083780,Staff,0,6,30,30
1650061401531,MATH 105,A01,085443,Staff,1,11,30,29
1650061407560,MATH 109,A01,083213,Anzaldo; Leesa B,1,4,30,29
1650061407560,MATH 109,A02,083214,Anzaldo; Leesa B,0,4,30,30
1650061407560,MATH 109,B01,083215,Anzaldo; Leesa B,0,2,30,30
1650061407560,MATH 109,B02,083216,Anzaldo; Leesa B,1,3,30,29
1650061413587,MATH 142A,A01,083219,Chow; Bennett,0,9,30,30
1650061413587,MATH 142A,A02,083220,Chow; Bennett,0,8,30,30
1650061413587,MATH 142A,B01,083221,Chow; Bennett,0,9,30,30
1650061413587,MATH 142A,B02,083222,Chow; Bennett,0,9,30,30
1650061419610,MATH 193A,A01,083224,Staff,0,4,30,30
1650061419610,MATH 193A,A02,083225,Staff,0,4,30,30
1650061419610,MATH 193A,A03,083781,Staff,0,0,30,30
1650061419610,MATH 193A,A04,083782,Staff,8,0,30,22
1650061425634,MATH 197,001,091859,McAuley; Julian John,9998,0,9999,1
1650061431692,COGS 9,A01,083615,Staff,3,17,60,57
1650061437726,COGS 11,A01,083617,Boyle; Mary E. T.,24,0,40,16
1650061443755,COGS 13,A01,083071,Staff,0,28,40,40
1650061449781,COGS 14A,A01,092681,Staff,0,10,100,100
1650061455808,COGS 14B,A01,083073,Cheng; Tzu-Han,0,3,50,50
1650061461832,COGS 17,A01,092677,Staff,35,0,75,40
1650061467856,COGS 100,A01,083619,Staff,0,18,60,60
1650061473893,COGS 101A,A01,083621,Davis; Joshua Daniel,0,16,60,60
1650061479923,COGS 101B,A01,091572,Staff,13,0,60,47
1650061485951,COGS 101C,A01,083625,Delgado; Tania,21,0,30,9
1650061491986,COGS 107A,A01,083627,Boyle; Mary E. T.,1,3,60,59
1650061498017,COGS 118A,A01,083075,Staff,18,0,60,42
1650061504049,CSE 3,A50,083646,Miranda; Gregory Joseph,22,0,38,16
1650061504049,CSE 3,A51,083647,Miranda; Gregory Joseph,37,0,37,0
1650061510071,CSE 8A,A50,083650,Miranda; Gregory Joseph,0,16,40,40
1650061516094,CSE 11,A01,083080,Cao; Yingjun,0,63,40,40
1650061522123,CSE 12,A01,083652,Staff,0,2,100,100
1650061528157,CSE 15L,A01,083654,Staff,0,0,50,50
1650061528157,CSE 15L,A02,083655,Staff,10,0,50,40
1650061534185,CSE 20,A01,083657,Staff,58,0,80,22
1650061540211,CSE 30,A01,083084,Eldon; John,0,63,40,40
1650061546237,CSE 100,A01,083659,Cao; Yingjun,0,57,50,50
1650061552263,CSE 134B,A01,083661,Powell; Thomas Allan,1,27,65,64
1650061558286,CSE 140,A01,083663,Staff,7,0,75,68
1650061564308,CSE 140L,A01,083088,Eldon; John,2,0,75,73
1650061570333,CSE 175,A01,083665,Kumar; Rakesh,9,0,25,16
1650061576363,CSE 190,A00,092507,Dubnov; Shlomo,14,0,20,6
1650061582392,ECE 45,A01,083139,Staff,0,12,40,40
1650061588413,ECE 65,A50,083695,Staff,0,3,30,30
1650061594435,ECE 109,A01,091882,Touri; Behrouz,48,0,70,22
1650061600462,ECE 180,A00,083140,Abi Samra; Nicholas Camill,24,0,30,6
1650061600462,ECE 180,B00,083141,Abi Samra; Nicholas Camill,8,0,30,22
1650061606486,MATH 10A,A01,083735,Patchell; Gregory David,12,0,30,18
1650061606486,MATH 10A,A02,083736,Patchell; Gregory David,28,0,30,2
1650061606486,MATH 10A,A03,083737,Patchell; Gregory David,27,0,30,3
1650061612514,MATH 10B,A01,083207,Staff,0,5,30,30
1650061612514,MATH 10B,A02,083208,Staff,0,2,30,30
1650061612514,MATH 10B,B01,083739,Staff,19,0,30,11
1650061612514,MATH 10B,B02,083740,Staff,30,0,30,0
1650061618544,MATH 18,A01,083743,Staff,10,0,30,20
1650061618544,MATH 18,A02,083744,Staff,28,0,30,2
1650061618544,MATH 18,A03,083745,Staff,23,0,30,7
1650061618544,MATH 18,A04,083746,Staff,27,0,30,3
1650061618544,MATH 18,B01,083748,Staff,0,9,30,30
1650061618544,MATH 18,B02,083749,Staff,1,7,30,29
1650061618544,MATH 18,B03,083750,Staff,0,6,30,30
1650061618544,MATH 18,B04,083751,Staff,1,8,30,29
1650061624567,MATH 20A,A01,083754,Staff,26,0,40,14
1650061630597,MATH 20B,A01,083756,Staff,0,5,30,30
1650061630597,MATH 20B,A02,083757,Staff,0,1,30,30
1650061636625,MATH 20C,A01,083760,Staff,0,9,30,30
1650061636625,MATH 20C,A02,083761,Staff,0,12,30,30
1650061636625,MATH 20C,B01,083762,Staff,16,0,30,14
1650061636625,MATH 20C,B02,083763,Staff,28,0,30,2
1650061642654,MATH 20D,A01,083765,Staff,0,2,30,30
1650061642654,MATH 20D,A02,083766,Staff,14,0,30,16
1650061642654,MATH 20D,A03,083767,Staff,28,0,30,2
1650061648686,MATH 20E,A01,083771,Staff,10,0,30,20
1650061648686,MATH 20E,A02,083772,Staff,20,0,30,10
1650061648686,MATH 20E,B01,083773,Staff,2,1,30,28
1650061648686,MATH 20E,B02,083774,Staff,17,0,30,13
1650061654714,MATH 103A,A01,083777,Staff,0,7,30,30
1650061654714,MATH 103A,A02,083778,Staff,0,7,30,30
1650061654714,MATH 103A,B01,083779,Staff,0,8,30,30
1650061654714,MATH 103A,B02,083780,Staff,0,6,30,30
1650061660742,MATH 105,A01,085443,Staff,1,11,30,29
1650061666768,MATH 109,A01,083213,Anzaldo; Leesa B,1,4,30,29
1650061666768,MATH 109,A02,083214,Anzaldo; Leesa B,0,4,30,30
1650061666768,MATH 109,B01,083215,Anzaldo; Leesa B,0,2,30,30
1650061666768,MATH 109,B02,083216,Anzaldo; Leesa B,1,3,30,29
1650061672790,MATH 142A,A01,083219,Chow; Bennett,0,9,30,30
1650061672790,MATH 142A,A02,083220,Chow; Bennett,0,8,30,30
1650061672790,MATH 142A,B01,083221,Chow; Bennett,0,9,30,30
1650061672790,MATH 142A,B02,083222,Chow; Bennett,0,9,30,30
1650061678815,MATH 193A,A01,083224,Staff,0,4,30,30
1650061678815,MATH 193A,A02,083225,Staff,0,4,30,30
1650061678815,MATH 193A,A03,083781,Staff,0,0,30,30
1650061678815,MATH 193A,A04,083782,Staff,8,0,30,22
1650061684842,MATH 197,001,091859,McAuley; Julian John,9998,0,9999,1
1650061690902,COGS 9,A01,083615,Staff,3,17,60,57
1650061696925,COGS 11,A01,083617,Boyle; Mary E. T.,24,0,40,16
1650061702950,COGS 13,A01,083071,Staff,0,28,40,40
1650061708977,COGS 14A,A01,092681,Staff,0,10,100,100
1650061715011,COGS 14B,A01,083073,Cheng; Tzu-Han,0,3,50,50
1650061721045,COGS 17,A01,092677,Staff,35,0,75,40
1650061727068,COGS 100,A01,083619,Staff,0,18,60,60
1650061733102,COGS 101A,A01,083621,Davis; Joshua Daniel,0,16,60,60
1650061739125,COGS 101B,A01,091572,Staff,13,0,60,47
1650061745148,COGS 101C,A01,083625,Delgado; Tania,21,0,30,9
1650061751171,COGS 107A,A01,083627,Boyle; Mary E. T.,1,3,60,59
1650061757209,COGS 118A,A01,083075,Staff,18,0,60,42
1650061763234,CSE 3,A50,083646,Miranda; Gregory Joseph,22,0,38,16
1650061763234,CSE 3,A51,083647,Miranda; Gregory Joseph,37,0,37,0
1650061769263,CSE 8A,A50,083650,Miranda; Gregory Joseph,0,16,40,40
1650061775286,CSE 11,A01,083080,Cao; Yingjun,0,63,40,40
1650061781316,CSE 12,A01,083652,Staff,0,2,100,100
1650061787345,CSE 15L,A01,083654,Staff,0,0,50,50
1650061787345,CSE 15L,A02,083655,Staff,10,0,50,40
1650061793372,CSE 20,A01,083657,Staff,58,0,80,22
1650061799396,CSE 30,A01,083084,Eldon; John,0,63,40,40
1650061805418,CSE 100,A01,083659,Cao; Yingjun,0,57,50,50
1650061811444,CSE 134B,A01,083661,Powell; Thomas Allan,1,27,65,64
1650061817471,CSE 140,A01,083663,Staff,7,0,75,68
1650061823494,CSE 140L,A01,083088,Eldon; John,2,0,75,73
1650061829529,CSE 175,A01,083665,Kumar; Rakesh,9,0,25,16
1650061835552,CSE 190,A00,092507,Dubnov; Shlomo,14,0,20,6
1650061841576,ECE 45,A01,083139,Staff,0,13,40,40
1650061847597,ECE 65,A50,083695,Staff,0,3,30,30
1650061853626,ECE 109,A01,091882,Touri; Behrouz,48,0,70,22
1650061859652,ECE 180,A00,083140,Abi Samra; Nicholas Camill,24,0,30,6
1650061859652,ECE 180,B00,083141,Abi Samra; Nicholas Camill,8,0,30,22
1650061865677,MATH 10A,A01,083735,Patchell; Gregory David,12,0,30,18
1650061865677,MATH 10A,A02,083736,Patchell; Gregory David,28,0,30,2
1650061865677,MATH 10A,A03,083737,Patchell; Gregory David,27,0,30,3
1650061871714,MATH 10B,A01,083207,Staff,0,5,30,30
1650061871714,MATH 10B,A02,083208,Staff,0,3,30,30
1650061871714,MATH 10B,B01,083739,Staff,19,0,30,11
1650061871714,MATH 10B,B02,083740,Staff,30,0,30,0
1650061877738,MATH 18,A01,083743,Staff,10,0,30,20
1650061877738,MATH 18,A02,083744,Staff,28,0,30,2
1650061877738,MATH 18,A03,083745,Staff,23,0,30,7
1650061877738,MATH 18,A04,083746,Staff,27,0,30,3
1650061877738,MATH 18,B01,083748,Staff,0,9,30,30
1650061877738,MATH 18,B02,083749,Staff,1,7,30,29
1650061877738,MATH 18,B03,083750,Staff,0,6,30,30
1650061877738,MATH 18,B04,083751,Staff,1,8,30,29
1650061883769,MATH 20A,A01,083754,Staff,26,0,40,14
1650061889796,MATH 20B,A01,083756,Staff,0,5,30,30
1650061889796,MATH 20B,A02,083757,Staff,0,1,30,30
1650061895822,MATH 20C,A01,083760,Staff,0,9,30,30
1650061895822,MATH 20C,A02,083761,Staff,0,12,30,30
1650061895822,MATH 20C,B01,083762,Staff,16,0,30,14
1650061895822,MATH 20C,B02,083763,Staff,28,0,30,2
1650061901850,MATH 20D,A01,083765,Staff,0,2,30,30
1650061901850,MATH 20D,A02,083766,Staff,14,0,30,16
1650061901850,MATH 20D,A03,083767,Staff,28,0,30,2
1650061907874,MATH 20E,A01,083771,Staff,10,0,30,20
1650061907874,MATH 20E,A02,083772,Staff,20,0,30,10
1650061907874,MATH 20E,B01,083773,Staff,2,1,30,28
1650061907874,MATH 20E,B02,083774,Staff,17,0,30,13
1650061913898,MATH 103A,A01,083777,Staff,0,7,30,30
1650061913898,MATH 103A,A02,083778,Staff,0,7,30,30
1650061913898,MATH 103A,B01,083779,Staff,0,8,30,30
1650061913898,MATH 103A,B02,083780,Staff,0,6,30,30
1650061919924,MATH 105,A01,085443,Staff,1,11,30,29
1650061925947,MATH 109,A01,083213,Anzaldo; Leesa B,1,4,30,29
1650061925947,MATH 109,A02,083214,Anzaldo; Leesa B,0,4,30,30
1650061925947,MATH 109,B01,083215,Anzaldo; Leesa B,0,2,30,30
1650061925947,MATH 109,B02,083216,Anzaldo; Leesa B,1,3,30,29
1650061931971,MATH 142A,A01,083219,Chow; Bennett,0,9,30,30
1650061931971,MATH 142A,A02,083220,Chow; Bennett,0,9,30,30
1650061931971,MATH 142A,B01,083221,Chow; Bennett,0,9,30,30
1650061931971,MATH 142A,B02,083222,Chow; Bennett,0,9,30,30
1650061937998,MATH 193A,A01,083224,Staff,0,4,30,30
1650061937998,MATH 193A,A02,083225,Staff,0,4,30,30
1650061937998,MATH 193A,A03,083781,Staff,0,0,30,30
1650061937998,MATH 193A,A04,083782,Staff,8,0,30,22
1650061944020,MATH 197,001,091859,McAuley; Julian John,9998,0,9999,1
1650061950164,COGS 9,A01,083615,Staff,3,17,60,57
1650061956191,COGS 11,A01,083617,Boyle; Mary E. T.,24,0,40,16
1650061962224,COGS 13,A01,083071,Staff,0,28,40,40
1650061968252,COGS 14A,A01,092681,Staff,0,10,100,100
1650061974278,COGS 14B,A01,083073,Cheng; Tzu-Han,0,3,50,50
1650061980312,COGS 17,A01,092677,Staff,35,0,75,40
1650061986341,COGS 100,A01,083619,Staff,0,18,60,60
1650061992362,COGS 101A,A01,083621,Davis; Joshua Daniel,0,16,60,60
1650061998385,COGS 101B,A01,091572,Staff,13,0,60,47
1650062004407,COGS 101C,A01,083625,Delgado; Tania,21,0,30,9
1650062010438,COGS 107A,A01,083627,Boyle; Mary E. T.,1,3,60,59
1650062016462,COGS 118A,A01,083075,Staff,18,0,60,42
1650062022487,CSE 3,A50,083646,Miranda; Gregory Joseph,22,0,38,16
1650062022487,CSE 3,A51,083647,Miranda; Gregory Joseph,37,0,37,0
1650062028518,CSE 8A,A50,083650,Miranda; Gregory Joseph,0,16,40,40
1650062034540,CSE 11,A01,083080,Cao; Yingjun,0,63,40,40
1650062040568,CSE 12,A01,083652,Staff,0,2,100,100
1650062046591,CSE 15L,A01,083654,Staff,0,0,50,50
1650062046591,CSE 15L,A02,083655,Staff,10,0,50,40
1650062052621,CSE 20,A01,083657,Staff,58,0,80,22
1650062058648,CSE 30,A01,083084,Eldon; John,0,63,40,40
1650062064670,CSE 100,A01,083659,Cao; Yingjun,0,57,50,50
1650062070693,CSE 134B,A01,083661,Powell; Thomas Allan,1,27,65,64
1650062076718,CSE 140,A01,083663,Staff,7,0,75,68
1650062082749,CSE 140L,A01,083088,Eldon; John,2,0,75,73
1650062088770,CSE 175,A01,083665,Kumar; Rakesh,9,0,25,16
1650062094798,CSE 190,A00,092507,Dubnov; Shlomo,14,0,20,6
1650062100828,ECE 45,A01,083139,Staff,0,13,40,40
1650062106851,ECE 65,A50,083695,Staff,0,3,30,30
1650062112928,ECE 109,A01,091882,Touri; Behrouz,48,0,70,22
1650062118950,ECE 180,A00,083140,Abi Samra; Nicholas Camill,24,0,30,6
1650062118950,ECE 180,B00,083141,Abi Samra; Nicholas Camill,8,0,30,22
1650062124975,MATH 10A,A01,083735,Patchell; Gregory David,12,0,30,18
1650062124975,MATH 10A,A02,083736,Patchell; Gregory David,28,0,30,2
1650062124975,MATH 10A,A03,083737,Patchell; Gregory David,27,0,30,3
1650062131001,MATH 10B,A01,083207,Staff,0,5,30,30
1650062131001,MATH 10B,A02,083208,Staff,0,3,30,30
1650062131001,MATH 10B,B01,083739,Staff,19,0,30,11
1650062131001,MATH 10B,B02,083740,Staff,30,0,30,0
1650062137024,MATH 18,A01,083743,Staff,10,0,30,20
1650062137024,MATH 18,A02,083744,Staff,28,0,30,2
1650062137024,MATH 18,A03,083745,Staff,23,0,30,7
1650062137024,MATH 18,A04,083746,Staff,27,0,30,3
1650062137024,MATH 18,B01,083748,Staff,0,9,30,30
1650062137024,MATH 18,B02,083749,Staff,1,7,30,29
1650062137024,MATH 18,B03,083750,Staff,0,6,30,30
1650062137024,MATH 18,B04,083751,Staff,1,8,30,29
1650062143051,MATH 20A,A01,083754,Staff,26,0,40,14
1650062149074,MATH 20B,A01,083756,Staff,0,5,30,30
1650062149074,MATH 20B,A02,083757,Staff,0,1,30,30
1650062155098,MATH 20C,A01,083760,Staff,0,9,30,30
1650062155098,MATH 20C,A02,083761,Staff,0,12,30,30
1650062155098,MATH 20C,B01,083762,Staff,16,0,30,14
1650062155098,MATH 20C,B02,083763,Staff,28,0,30,2
1650062161125,MATH 20D,A01,083765,Staff,0,2,30,30
1650062161125,MATH 20D,A02,083766,Staff,14,0,30,16
1650062161125,MATH 20D,A03,083767,Staff,28,0,30,2
1650062167158,MATH 20E,A01,083771,Staff,10,0,30,20
1650062167158,MATH 20E,A02,083772,Staff,20,0,30,10
1650062167158,MATH 20E,B01,083773,Staff,2,1,30,28
1650062167158,MATH 20E,B02,083774,Staff,17,0,30,13
1650062173186,MATH 103A,A01,083777,Staff,0,7,30,30
1650062173186,MATH 103A,A02,083778,Staff,0,7,30,30
1650062173186,MATH 103A,B01,083779,Staff,0,8,30,30
1650062173186,MATH 103A,B02,083780,Staff,0,6,30,30
1650062179210,MATH 105,A01,085443,Staff,1,11,30,29
1650062185241,MATH 109,A01,083213,Anzaldo; Leesa B,1,4,30,29
1650062185241,MATH 109,A02,083214,Anzaldo; Leesa B,0,4,30,30
1650062185241,MATH 109,B01,083215,Anzaldo; Leesa B,0,2,30,30
1650062185241,MATH 109,B02,083216,Anzaldo; Leesa B,1,3,30,29
1650062191268,MATH 142A,A01,083219,Chow; Bennett,0,9,30,30
1650062191268,MATH 142A,A02,083220,Chow; Bennett,0,9,30,30
1650062191268,MATH 142A,B01,083221,Chow; Bennett,0,9,30,30
1650062191268,MATH 142A,B02,083222,Chow; Bennett,0,9,30,30
1650062197296,MATH 193A,A01,083224,Staff,0,4,30,30
1650062197296,MATH 193A,A02,083225,Staff,0,4,30,30
1650062197296,MATH 193A,A03,083781,Staff,0,0,30,30
1650062197296,MATH 193A,A04,083782,Staff,8,0,30,22
1650062203320,MATH 197,001,091859,McAuley; Julian John,9998,0,9999,1
1650062209379,COGS 9,A01,083615,Staff,3,17,60,57
1650062215404,COGS 11,A01,083617,Boyle; Mary E. T.,24,0,40,16
1650062221428,COGS 13,A01,083071,Staff,0,28,40,40
1650062227452,COGS 14A,A01,092681,Staff,0,10,100,100
1650062233488,COGS 14B,A01,083073,Cheng; Tzu-Han,0,3,50,50
1650062239511,COGS 17,A01,092677,Staff,35,0,75,40
1650062245542,COGS 100,A01,083619,Staff,0,18,60,60
1650062251564,COGS 101A,A01,083621,Davis; Joshua Daniel,0,16,60,60
1650062257588,COGS 101B,A01,091572,Staff,13,0,60,47
1650062263617,COGS 101C,A01,083625,Delgado; Tania,21,0,30,9
1650062269650,COGS 107A,A01,083627,Boyle; Mary E. T.,1,3,60,59
1650062275677,COGS 118A,A01,083075,Staff,18,0,60,42
1650062281699,CSE 3,A50,083646,Miranda; Gregory Joseph,22,0,38,16
1650062281699,CSE 3,A51,083647,Miranda; Gregory Joseph,37,0,37,0
1650062287726,CSE 8A,A50,083650,Miranda; Gregory Joseph,0,16,40,40
1650062293758,CSE 11,A01,083080,Cao; Yingjun,0,63,40,40
1650062299783,CSE 12,A01,083652,Staff,0,2,100,100
1650062305805,CSE 15L,A01,083654,Staff,0,0,50,50
1650062305805,CSE 15L,A02,083655,Staff,10,0,50,40
1650062311835,CSE 20,A01,083657,Staff,58,0,80,22
1650062317862,CSE 30,A01,083084,Eldon; John,0,63,40,40
1650062323885,CSE 100,A01,083659,Cao; Yingjun,0,57,50,50
1650062329907,CSE 134B,A01,083661,Powell; Thomas Allan,1,27,65,64
1650062335933,CSE 140,A01,083663,Staff,7,0,75,68
1650062341956,CSE 140L,A01,083088,Eldon; John,2,0,75,73
1650062347979,CSE 175,A01,083665,Kumar; Rakesh,9,0,25,16
1650062354003,CSE 190,A00,092507,Dubnov; Shlomo,14,0,20,6
1650062360028,ECE 45,A01,083139,Staff,0,13,40,40
1650062366074,ECE 65,A50,083695,Staff,0,3,30,30
1650062372100,ECE 109,A01,091882,Touri; Behrouz,48,0,70,22
1650062378124,ECE 180,A00,083140,Abi Samra; Nicholas Camill,24,0,30,6
1650062378124,ECE 180,B00,083141,Abi Samra; Nicholas Camill,8,0,30,22
1650062384159,MATH 10A,A01,083735,Patchell; Gregory David,12,0,30,18
1650062384159,MATH 10A,A02,083736,Patchell; Gregory David,28,0,30,2
1650062384159,MATH 10A,A03,083737,Patchell; Gregory David,27,0,30,3
1650062390181,MATH 10B,A01,083207,Staff,0,5,30,30
1650062390181,MATH 10B,A02,083208,Staff,0,3,30,30
1650062390181,MATH 10B,B01,083739,Staff,19,0,30,11
1650062390181,MATH 10B,B02,083740,Staff,30,0,30,0
1650062396212,MATH 18,A01,083743,Staff,10,0,30,20
1650062396212,MATH 18,A02,083744,Staff,28,0,30,2
1650062396212,MATH 18,A03,083745,Staff,23,0,30,7
1650062396212,MATH 18,A04,083746,Staff,27,0,30,3
1650062396212,MATH 18,B01,083748,Staff,0,9,30,30
1650062396212,MATH 18,B02,083749,Staff,1,7,30,29
1650062396212,MATH 18,B03,083750,Staff,0,6,30,30
1650062396212,MATH 18,B04,083751,Staff,1,8,30,29
1650062402250,MATH 20A,A01,083754,Staff,26,0,40,14
1650062408273,MATH 20B,A01,083756,Staff,0,5,30,30
1650062408273,MATH 20B,A02,083757,Staff,0,1,30,30
1650062414297,MATH 20C,A01,083760,Staff,0,9,30,30
1650062414297,MATH 20C,A02,083761,Staff,0,12,30,30
1650062414297,MATH 20C,B01,083762,Staff,16,0,30,14
1650062414297,MATH 20C,B02,083763,Staff,28,0,30,2
1650062420327,MATH 20D,A01,083765,Staff,0,2,30,30
1650062420327,MATH 20D,A02,083766,Staff,14,0,30,16
1650062420327,MATH 20D,A03,083767,Staff,28,0,30,2
1650062426355,MATH 20E,A01,083771,Staff,10,0,30,20
1650062426355,MATH 20E,A02,083772,Staff,20,0,30,10
1650062426355,MATH 20E,B01,083773,Staff,2,2,30,28
1650062426355,MATH 20E,B02,083774,Staff,17,0,30,13
1650062432385,MATH 103A,A01,083777,Staff,0,7,30,30
1650062432385,MATH 103A,A02,083778,Staff,0,7,30,30
1650062432385,MATH 103A,B01,083779,Staff,0,8,30,30
1650062432385,MATH 103A,B02,083780,Staff,0,6,30,30
1650062438409,MATH 105,A01,085443,Staff,1,11,30,29
1650062444443,MATH 109,A01,083213,Anzaldo; Leesa B,1,4,30,29
1650062444443,MATH 109,A02,083214,Anzaldo; Leesa B,0,4,30,30
1650062444443,MATH 109,B01,083215,Anzaldo; Leesa B,0,2,30,30
1650062444443,MATH 109,B02,083216,Anzaldo; Leesa B,1,3,30,29
1650062450466,MATH 142A,A01,083219,Chow; Bennett,0,9,30,30
1650062450466,MATH 142A,A02,083220,Chow; Bennett,0,9,30,30
1650062450466,MATH 142A,B01,083221,Chow; Bennett,0,9,30,30
1650062450466,MATH 142A,B02,083222,Chow; Bennett,0,9,30,30
1650062456513,MATH 193A,A01,083224,Staff,0,4,30,30
1650062456513,MATH 193A,A02,083225,Staff,0,4,30,30
1650062456513,MATH 193A,A03,083781,Staff,0,0,30,30
1650062456513,MATH 193A,A04,083782,Staff,8,0,30,22
1650062462536,MATH 197,001,091859,McAuley; Julian John,9998,0,9999,1
1650062468601,COGS 9,A01,083615,Staff,3,17,60,57
1650062474624,COGS 11,A01,083617,Boyle; Mary E. T.,24,0,40,16
1650062480648,COGS 13,A01,083071,Staff,0,28,40,40
1650062486672,COGS 14A,A01,092681,Staff,0,10,100,100
1650062492700,COGS 14B,A01,083073,Cheng; Tzu-Han,0,3,50,50
1650062498736,COGS 17,A01,092677,Staff,35,0,75,40
1650062504759,COGS 100,A01,083619,Staff,0,18,60,60
1650062510787,COGS 101A,A01,083621,Davis; Joshua Daniel,0,16,60,60
1650062516810,COGS 101B,A01,091572,Staff,13,0,60,47
1650062522834,COGS 101C,A01,083625,Delgado; Tania,21,0,30,9
1650062528868,COGS 107A,A01,083627,Boyle; Mary E. T.,1,3,60,59
1650062534895,COGS 118A,A01,083075,Staff,18,0,60,42
1650062540929,CSE 3,A50,083646,Miranda; Gregory Joseph,22,0,38,16
1650062540929,CSE 3,A51,083647,Miranda; Gregory Joseph,37,0,37,0
1650062547042,CSE 8A,A50,083650,Miranda; Gregory Joseph,0,16,40,40
1650062553065,CSE 11,A01,083080,Cao; Yingjun,0,63,40,40
1650062559091,CSE 12,A01,083652,Staff,0,2,100,100
1650062565115,CSE 15L,A01,083654,Staff,0,0,50,50
1650062565115,CSE 15L,A02,083655,Staff,10,0,50,40
1650062571155,CSE 20,A01,083657,Staff,58,0,80,22
1650062577178,CSE 30,A01,083084,Eldon; John,0,63,40,40
1650062583206,CSE 100,A01,083659,Cao; Yingjun,0,57,50,50
1650062589231,CSE 134B,A01,083661,Powell; Thomas Allan,1,27,65,64
1650062595258,CSE 140,A01,083663,Staff,7,0,75,68
1650062601290,CSE 140L,A01,083088,Eldon; John,2,0,75,73
1650062607317,CSE 175,A01,083665,Kumar; Rakesh,9,0,25,16
1650062613351,CSE 190,A00,092507,Dubnov; Shlomo,14,0,20,6
1650062619378,ECE 45,A01,083139,Staff,0,13,40,40
1650062625401,ECE 65,A50,083695,Staff,0,3,30,30
1650062631432,ECE 109,A01,091882,Touri; Behrouz,48,0,70,22
1650062637460,ECE 180,A00,083140,Abi Samra; Nicholas Camill,24,0,30,6
1650062637460,ECE 180,B00,083141,Abi Samra; Nicholas Camill,8,0,30,22
1650062643491,MATH 10A,A01,083735,Patchell; Gregory David,12,0,30,18
1650062643491,MATH 10A,A02,083736,Patchell; Gregory David,28,0,30,2
1650062643491,MATH 10A,A03,083737,Patchell; Gregory David,27,0,30,3
1650062649520,MATH 10B,A01,083207,Staff,0,5,30,30
1650062649520,MATH 10B,A02,083208,Staff,0,3,30,30
1650062649520,MATH 10B,B01,083739,Staff,19,0,30,11
1650062649520,MATH 10B,B02,083740,Staff,30,0,30,0
1650062655553,MATH 18,A01,083743,Staff,10,0,30,20
1650062655553,MATH 18,A02,083744,Staff,28,0,30,2
1650062655553,MATH 18,A03,083745,Staff,23,0,30,7
1650062655553,MATH 18,A04,083746,Staff,27,0,30,3
1650062655553,MATH 18,B01,083748,Staff,0,9,30,30
1650062655553,MATH 18,B02,083749,Staff,1,7,30,29
1650062655553,MATH 18,B03,083750,Staff,0,6,30,30
1650062655553,MATH 18,B04,083751,Staff,1,8,30,29
1650062661576,MATH 20A,A01,083754,Staff,26,0,40,14
1650062667603,MATH 20B,A01,083756,Staff,0,5,30,30
1650062667603,MATH 20B,A02,083757,Staff,0,1,30,30
1650062673632,MATH 20C,A01,083760,Staff,0,9,30,30
1650062673632,MATH 20C,A02,083761,Staff,0,12,30,30
1650062673632,MATH 20C,B01,083762,Staff,16,0,30,14
1650062673632,MATH 20C,B02,083763,Staff,28,0,30,2
1650062679657,MATH 20D,A01,083765,Staff,0,2,30,30
1650062679657,MATH 20D,A02,083766,Staff,14,0,30,16
1650062679657,MATH 20D,A03,083767,Staff,28,0,30,2
1650062685686,MATH 20E,A01,083771,Staff,10,0,30,20
1650062685686,MATH 20E,A02,083772,Staff,20,0,30,10
1650062685686,MATH 20E,B01,083773,Staff,2,2,30,28
1650062685686,MATH 20E,B02,083774,Staff,17,0,30,13
1650062691713,MATH 103A,A01,083777,Staff,0,7,30,30
1650062691713,MATH 103A,A02,083778,Staff,0,7,30,30
1650062691713,MATH 103A,B01,083779,Staff,0,8,30,30
1650062691713,MATH 103A,B02,083780,Staff,0,6,30,30
1650062697741,MATH 105,A01,085443,Staff,1,11,30,29
1650062703772,MATH 109,A01,083213,Anzaldo; Leesa B,1,4,30,29
1650062703772,MATH 109,A02,083214,Anzaldo; Leesa B,0,4,30,30
1650062703772,MATH 109,B01,083215,Anzaldo; Leesa B,0,2,30,30
1650062703772,MATH 109,B02,083216,Anzaldo; Leesa B,1,3,30,29
1650062709796,MATH 142A,A01,083219,Chow; Bennett,0,9,30,30
1650062709796,MATH 142A,A02,083220,Chow; Bennett,0,9,30,30
1650062709796,MATH 142A,B01,083221,Chow; Bennett,0,9,30,30
1650062709796,MATH 142A,B02,083222,Chow; Bennett,0,9,30,30
1650062715825,MATH 193A,A01,083224,Staff,0,4,30,30
1650062715825,MATH 193A,A02,083225,Staff,0,4,30,30
1650062715825,MATH 193A,A03,083781,Staff,0,0,30,30
1650062715825,MATH 193A,A04,083782,Staff,8,0,30,22
1650062721848,MATH 197,001,091859,McAuley; Julian John,9998,0,9999,1
1650062727912,COGS 9,A01,083615,Staff,3,17,60,57
1650062733939,COGS 11,A01,083617,Boyle; Mary E. T.,24,0,40,16
1650062739962,COGS 13,A01,083071,Staff,0,28,40,40
1650062745985,COGS 14A,A01,092681,Staff,0,10,100,100
1650062752013,COGS 14B,A01,083073,Cheng; Tzu-Han,0,3,50,50
1650062758037,COGS 17,A01,092677,Staff,35,0,75,40
1650062764058,COGS 100,A01,083619,Staff,0,18,60,60
1650062770082,COGS 101A,A01,083621,Davis; Joshua Daniel,0,16,60,60
1650062776106,COGS 101B,A01,091572,Staff,13,0,60,47
1650062782129,COGS 101C,A01,083625,Delgado; Tania,21,0,30,9
1650062788157,COGS 107A,A01,083627,Boyle; Mary E. T.,1,3,60,59
1650062794179,COGS 118A,A01,083075,Staff,18,0,60,42
1650062800208,CSE 3,A50,083646,Miranda; Gregory Joseph,22,0,38,16
1650062800208,CSE 3,A51,083647,Miranda; Gregory Joseph,37,0,37,0
1650062806232,CSE 8A,A50,083650,Miranda; Gregory Joseph,0,16,40,40
1650062812259,CSE 11,A01,083080,Cao; Yingjun,0,63,40,40
1650062818287,CSE 12,A01,083652,Staff,0,2,100,100
1650062824313,CSE 15L,A01,083654,Staff,0,0,50,50
1650062824313,CSE 15L,A02,083655,Staff,10,0,50,40
1650062830337,CSE 20,A01,083657,Staff,58,0,80,22
1650062836359,CSE 30,A01,083084,Eldon; John,0,63,40,40
1650062842386,CSE 100,A01,083659,Cao; Yingjun,0,57,50,50
1650062848408,CSE 134B,A01,083661,Powell; Thomas Allan,1,27,65,64
1650062854439,CSE 140,A01,083663,Staff,7,0,75,68
1650062860460,CSE 140L,A01,083088,Eldon; John,2,0,75,73
1650062866487,CSE 175,A01,083665,Kumar; Rakesh,9,0,25,16
1650062872515,CSE 190,A00,092507,Dubnov; Shlomo,14,0,20,6
1650062878549,ECE 45,A01,083139,Staff,0,13,40,40
1650062884571,ECE 65,A50,083695,Staff,0,3,30,30
1650062890602,ECE 109,A01,091882,Touri; Behrouz,48,0,70,22
1650062896626,ECE 180,A00,083140,Abi Samra; Nicholas Camill,24,0,30,6
1650062896626,ECE 180,B00,083141,Abi Samra; Nicholas Camill,8,0,30,22
1650062902655,MATH 10A,A01,083735,Patchell; Gregory David,12,0,30,18
1650062902655,MATH 10A,A02,083736,Patchell; Gregory David,28,0,30,2
1650062902655,MATH 10A,A03,083737,Patchell; Gregory David,27,0,30,3
1650062908678,MATH 10B,A01,083207,Staff,0,5,30,30
1650062908678,MATH 10B,A02,083208,Staff,0,3,30,30
1650062908678,MATH 10B,B01,083739,Staff,19,0,30,11
1650062908678,MATH 10B,B02,083740,Staff,30,0,30,0
1650062914707,MATH 18,A01,083743,Staff,10,0,30,20
1650062914707,MATH 18,A02,083744,Staff,28,0,30,2
1650062914707,MATH 18,A03,083745,Staff,23,0,30,7
1650062914707,MATH 18,A04,083746,Staff,27,0,30,3
1650062914707,MATH 18,B01,083748,Staff,0,9,30,30
1650062914707,MATH 18,B02,083749,Staff,1,7,30,29
1650062914707,MATH 18,B03,083750,Staff,0,6,30,30
1650062914707,MATH 18,B04,083751,Staff,1,8,30,29
1650062920734,MATH 20A,A01,083754,Staff,26,0,40,14
1650062926764,MATH 20B,A01,083756,Staff,0,5,30,30
1650062926764,MATH 20B,A02,083757,Staff,0,1,30,30
1650062932787,MATH 20C,A01,083760,Staff,0,9,30,30
1650062932787,MATH 20C,A02,083761,Staff,0,12,30,30
1650062932787,MATH 20C,B01,083762,Staff,16,0,30,14
1650062932787,MATH 20C,B02,083763,Staff,28,0,30,2
1650062938811,MATH 20D,A01,083765,Staff,0,2,30,30
1650062938811,MATH 20D,A02,083766,Staff,14,0,30,16
1650062938811,MATH 20D,A03,083767,Staff,28,0,30,2
1650062944840,MATH 20E,A01,083771,Staff,10,0,30,20
1650062944840,MATH 20E,A02,083772,Staff,20,0,30,10
1650062944840,MATH 20E,B01,083773,Staff,2,2,30,28
1650062944840,MATH 20E,B02,083774,Staff,17,0,30,13
1650062950865,MATH 103A,A01,083777,Staff,0,7,30,30
1650062950865,MATH 103A,A02,083778,Staff,0,7,30,30
1650062950865,MATH 103A,B01,083779,Staff,0,8,30,30
1650062950865,MATH 103A,B02,083780,Staff,0,6,30,30
1650062956892,MATH 105,A01,085443,Staff,1,11,30,29
1650062962919,MATH 109,A01,083213,Anzaldo; Leesa B,1,4,30,29
1650062962919,MATH 109,A02,083214,Anzaldo; Leesa B,0,4,30,30
1650062962919,MATH 109,B01,083215,Anzaldo; Leesa B,0,2,30,30
1650062962919,MATH 109,B02,083216,Anzaldo; Leesa B,1,3,30,29
1650062968952,MATH 142A,A01,083219,Chow; Bennett,0,9,30,30
1650062968952,MATH 142A,A02,083220,Chow; Bennett,0,9,30,30
1650062968952,MATH 142A,B01,083221,Chow; Bennett,0,9,30,30
1650062968952,MATH 142A,B02,083222,Chow; Bennett,0,9,30,30
1650062974981,MATH 193A,A01,083224,Staff,0,4,30,30
1650062974981,MATH 193A,A02,083225,Staff,0,4,30,30
1650062974981,MATH 193A,A03,083781,Staff,0,0,30,30
1650062974981,MATH 193A,A04,083782,Staff,8,0,30,22
1650062981011,MATH 197,001,091859,McAuley; Julian John,9998,0,9999,1
1650062987085,COGS 9,A01,083615,Staff,3,17,60,57
1650062993107,COGS 11,A01,083617,Boyle; Mary E. T.,24,0,40,16
1650062999134,COGS 13,A01,083071,Staff,0,28,40,40
1650063005158,COGS 14A,A01,092681,Staff,0,10,100,100
1650063011185,COGS 14B,A01,083073,Cheng; Tzu-Han,0,3,50,50
1650063017212,COGS 17,A01,092677,Staff,35,0,75,40
1650063023238,COGS 100,A01,083619,Staff,0,18,60,60
1650063029261,COGS 101A,A01,083621,Davis; Joshua Daniel,0,16,60,60
1650063035283,COGS 101B,A01,091572,Staff,13,0,60,47
1650063041313,COGS 101C,A01,083625,Delgado; Tania,21,0,30,9
1650063047336,COGS 107A,A01,083627,Boyle; Mary E. T.,1,3,60,59
1650063053358,COGS 118A,A01,083075,Staff,18,0,60,42
1650063059382,CSE 3,A50,083646,Miranda; Gregory Joseph,22,0,38,16
1650063059382,CSE 3,A51,083647,Miranda; Gregory Joseph,37,0,37,0
1650063065411,CSE 8A,A50,083650,Miranda; Gregory Joseph,0,16,40,40
1650063071434,CSE 11,A01,083080,Cao; Yingjun,0,63,40,40
1650063077459,CSE 12,A01,083652,Staff,0,2,100,100
1650063083489,CSE 15L,A01,083654,Staff,0,0,50,50
1650063083489,CSE 15L,A02,083655,Staff,10,0,50,40
1650063089511,CSE 20,A01,083657,Staff,58,0,80,22
1650063095537,CSE 30,A01,083084,Eldon; John,0,63,40,40
1650063101559,CSE 100,A01,083659,Cao; Yingjun,0,57,50,50
1650063107585,CSE 134B,A01,083661,Powell; Thomas Allan,1,27,65,64
1650063113612,CSE 140,A01,083663,Staff,7,0,75,68
1650063119635,CSE 140L,A01,083088,Eldon; John,2,0,75,73
1650063125761,CSE 175,A01,083665,Kumar; Rakesh,9,0,25,16
1650063131788,CSE 190,A00,092507,Dubnov; Shlomo,14,0,20,6
1650063137813,ECE 45,A01,083139,Staff,0,13,40,40
1650063143919,ECE 65,A50,083695,Staff,0,3,30,30
1650063149948,ECE 109,A01,091882,Touri; Behrouz,48,0,70,22
1650063155972,ECE 180,A00,083140,Abi Samra; Nicholas Camill,24,0,30,6
1650063155972,ECE 180,B00,083141,Abi Samra; Nicholas Camill,8,0,30,22
1650063162000,MATH 10A,A01,083735,Patchell; Gregory David,12,0,30,18
1650063162000,MATH 10A,A02,083736,Patchell; Gregory David,28,0,30,2
1650063162000,MATH 10A,A03,083737,Patchell; Gregory David,27,0,30,3
1650063168024,MATH 10B,A01,083207,Staff,0,5,30,30
1650063168024,MATH 10B,A02,083208,Staff,0,3,30,30
1650063168024,MATH 10B,B01,083739,Staff,19,0,30,11
1650063168024,MATH 10B,B02,083740,Staff,30,0,30,0
1650063174050,MATH 18,A01,083743,Staff,10,0,30,20
1650063174050,MATH 18,A02,083744,Staff,28,0,30,2
1650063174050,MATH 18,A03,083745,Staff,23,0,30,7
1650063174050,MATH 18,A04,083746,Staff,27,0,30,3
1650063174050,MATH 18,B01,083748,Staff,0,9,30,30
1650063174050,MATH 18,B02,083749,Staff,1,7,30,29
1650063174050,MATH 18,B03,083750,Staff,0,6,30,30
1650063174050,MATH 18,B04,083751,Staff,1,8,30,29
1650063180074,MATH 20A,A01,083754,Staff,26,0,40,14
1650063186101,MATH 20B,A01,083756,Staff,0,5,30,30
1650063186101,MATH 20B,A02,083757,Staff,0,1,30,30
1650063192126,MATH 20C,A01,083760,Staff,0,10,30,30
1650063192126,MATH 20C,A02,083761,Staff,0,12,30,30
1650063192126,MATH 20C,B01,083762,Staff,16,0,30,14
1650063192126,MATH 20C,B02,083763,Staff,28,0,30,2
1650063198159,MATH 20D,A01,083765,Staff,0,2,30,30
1650063198159,MATH 20D,A02,083766,Staff,14,0,30,16
1650063198159,MATH 20D,A03,083767,Staff,28,0,30,2
1650063204193,MATH 20E,A01,083771,Staff,10,0,30,20
1650063204193,MATH 20E,A02,083772,Staff,20,0,30,10
1650063204193,MATH 20E,B01,083773,Staff,2,2,30,28
1650063204193,MATH 20E,B02,083774,Staff,17,0,30,13
1650063210220,MATH 103A,A01,083777,Staff,0,8,30,30
1650063210220,MATH 103A,A02,083778,Staff,0,7,30,30
1650063210220,MATH 103A,B01,083779,Staff,0,8,30,30
1650063210220,MATH 103A,B02,083780,Staff,0,6,30,30
1650063216245,MATH 105,A01,085443,Staff,1,12,30,29
1650063222273,MATH 109,A01,083213,Anzaldo; Leesa B,1,4,30,29
1650063222273,MATH 109,A02,083214,Anzaldo; Leesa B,0,4,30,30
1650063222273,MATH 109,B01,083215,Anzaldo; Leesa B,0,2,30,30
1650063222273,MATH 109,B02,083216,Anzaldo; Leesa B,1,3,30,29
1650063228298,MATH 142A,A01,083219,Chow; Bennett,0,9,30,30
1650063228298,MATH 142A,A02,083220,Chow; Bennett,0,9,30,30
1650063228298,MATH 142A,B01,083221,Chow; Bennett,0,9,30,30
1650063228298,MATH 142A,B02,083222,Chow; Bennett,0,9,30,30
1650063234334,MATH 193A,A01,083224,Staff,0,4,30,30
1650063234334,MATH 193A,A02,083225,Staff,0,4,30,30
1650063234334,MATH 193A,A03,083781,Staff,0,0,30,30
1650063234334,MATH 193A,A04,083782,Staff,8,0,30,22
1650063240356,MATH 197,001,091859,McAuley; Julian John,9998,0,9999,1
1650063246424,COGS 9,A01,083615,Staff,3,17,60,57
1650063252451,COGS 11,A01,083617,Boyle; Mary E. T.,24,0,40,16
1650063258483,COGS 13,A01,083071,Staff,0,28,40,40
1650063264509,COGS 14A,A01,092681,Staff,0,10,100,100
1650063270534,COGS 14B,A01,083073,Cheng; Tzu-Han,0,3,50,50
1650063276565,COGS 17,A01,092677,Staff,35,0,75,40
1650063282592,COGS 100,A01,083619,Staff,0,18,60,60
1650063288615,COGS 101A,A01,083621,Davis; Joshua Daniel,0,16,60,60
1650063294638,COGS 101B,A01,091572,Staff,13,0,60,47
1650063300671,COGS 101C,A01,083625,Delgado; Tania,21,0,30,9
1650063306693,COGS 107A,A01,083627,Boyle; Mary E. T.,1,3,60,59
1650063312717,COGS 118A,A01,083075,Staff,18,0,60,42
1650063318747,CSE 3,A50,083646,Miranda; Gregory Joseph,22,0,38,16
1650063318747,CSE 3,A51,083647,Miranda; Gregory Joseph,37,0,37,0
1650063324771,CSE 8A,A50,083650,Miranda; Gregory Joseph,0,16,40,40
1650063330798,CSE 11,A01,083080,Cao; Yingjun,0,63,40,40
1650063336824,CSE 12,A01,083652,Staff,0,2,100,100
1650063342849,CSE 15L,A01,083654,Staff,0,0,50,50
1650063342849,CSE 15L,A02,083655,Staff,10,0,50,40
1650063348880,CSE 20,A01,083657,Staff,58,0,80,22
1650063354903,CSE 30,A01,083084,Eldon; John,0,63,40,40
1650063360926,CSE 100,A01,083659,Cao; Yingjun,0,57,50,50
1650063366951,CSE 134B,A01,083661,Powell; Thomas Allan,1,27,65,64
1650063372978,CSE 140,A01,083663,Staff,7,0,75,68
1650063379000,CSE 140L,A01,083088,Eldon; John,2,0,75,73
1650063385031,CSE 175,A01,083665,Kumar; Rakesh,9,0,25,16
1650063391066,CSE 190,A00,092507,Dubnov; Shlomo,14,0,20,6
1650063397088,ECE 45,A01,083139,Staff,0,13,40,40
1650063403115,ECE 65,A50,083695,Staff,0,3,30,30
1650063409140,ECE 109,A01,091882,Touri; Behrouz,48,0,70,22
1650063415163,ECE 180,A00,083140,Abi Samra; Nicholas Camill,24,0,30,6
1650063415163,ECE 180,B00,083141,Abi Samra; Nicholas Camill,8,0,30,22
1650063421187,MATH 10A,A01,083735,Patchell; Gregory David,12,0,30,18
1650063421187,MATH 10A,A02,083736,Patchell; Gregory David,28,0,30,2
1650063421187,MATH 10A,A03,083737,Patchell; Gregory David,27,0,30,3
1650063427210,MATH 10B,A01,083207,Staff,0,5,30,30
1650063427210,MATH 10B,A02,083208,Staff,0,3,30,30
1650063427210,MATH 10B,B01,083739,Staff,19,0,30,11
1650063427210,MATH 10B,B02,083740,Staff,30,0,30,0
1650063433235,MATH 18,A01,083743,Staff,10,0,30,20
1650063433235,MATH 18,A02,083744,Staff,28,0,30,2
1650063433235,MATH 18,A03,083745,Staff,23,0,30,7
1650063433235,MATH 18,A04,083746,Staff,27,0,30,3
1650063433235,MATH 18,B01,083748,Staff,0,9,30,30
1650063433235,MATH 18,B02,083749,Staff,1,7,30,29
1650063433235,MATH 18,B03,083750,Staff,0,6,30,30
1650063433235,MATH 18,B04,083751,Staff,1,8,30,29
1650063439259,MATH 20A,A01,083754,Staff,26,0,40,14
1650063445289,MATH 20B,A01,083756,Staff,0,5,30,30
1650063445289,MATH 20B,A02,083757,Staff,0,1,30,30
1650063451316,MATH 20C,A01,083760,Staff,0,10,30,30
1650063451316,MATH 20C,A02,083761,Staff,0,12,30,30
1650063451316,MATH 20C,B01,083762,Staff,16,0,30,14
1650063451316,MATH 20C,B02,083763,Staff,28,0,30,2
1650063457344,MATH 20D,A01,083765,Staff,0,2,30,30
1650063457344,MATH 20D,A02,083766,Staff,14,0,30,16
1650063457344,MATH 20D,A03,083767,Staff,28,0,30,2
1650063463368,MATH 20E,A01,083771,Staff,10,0,30,20
1650063463368,MATH 20E,A02,083772,Staff,20,0,30,10
1650063463368,MATH 20E,B01,083773,Staff,2,2,30,28
1650063463368,MATH 20E,B02,083774,Staff,17,0,30,13
1650063469391,MATH 103A,A01,083777,Staff,0,8,30,30
1650063469391,MATH 103A,A02,083778,Staff,0,7,30,30
1650063469391,MATH 103A,B01,083779,Staff,0,8,30,30
1650063469391,MATH 103A,B02,083780,Staff,0,6,30,30
1650063475421,MATH 105,A01,085443,Staff,1,12,30,29
1650063481445,MATH 109,A01,083213,Anzaldo; Leesa B,1,4,30,29
1650063481445,MATH 109,A02,083214,Anzaldo; Leesa B,0,4,30,30
1650063481445,MATH 109,B01,083215,Anzaldo; Leesa B,0,2,30,30
1650063481445,MATH 109,B02,083216,Anzaldo; Leesa B,1,3,30,29
1650063487475,MATH 142A,A01,083219,Chow; Bennett,0,9,30,30
1650063487475,MATH 142A,A02,083220,Chow; Bennett,0,9,30,30
1650063487475,MATH 142A,B01,083221,Chow; Bennett,0,9,30,30
1650063487475,MATH 142A,B02,083222,Chow; Bennett,0,9,30,30
1650063493498,MATH 193A,A01,083224,Staff,0,4,30,30
1650063493498,MATH 193A,A02,083225,Staff,0,4,30,30
1650063493498,MATH 193A,A03,083781,Staff,0,0,30,30
1650063493498,MATH 193A,A04,083782,Staff,8,0,30,22
1650063499521,MATH 197,001,091859,McAuley; Julian John,9998,0,9999,1
1650063505573,COGS 9,A01,083615,Staff,3,17,60,57
1650063511600,COGS 11,A01,083617,Boyle; Mary E. T.,24,0,40,16
1650063517624,COGS 13,A01,083071,Staff,0,28,40,40
1650063523648,COGS 14A,A01,092681,Staff,0,10,100,100
1650063529685,COGS 14B,A01,083073,Cheng; Tzu-Han,0,3,50,50
1650063535708,COGS 17,A01,092677,Staff,35,0,75,40
1650063541732,COGS 100,A01,083619,Staff,0,18,60,60
1650063547757,COGS 101A,A01,083621,Davis; Joshua Daniel,0,16,60,60
1650063553786,COGS 101B,A01,091572,Staff,13,0,60,47
1650063559813,COGS 101C,A01,083625,Delgado; Tania,21,0,30,9
1650063565836,COGS 107A,A01,083627,Boyle; Mary E. T.,1,3,60,59
1650063571862,COGS 118A,A01,083075,Staff,18,0,60,42
1650063577892,CSE 3,A50,083646,Miranda; Gregory Joseph,22,0,38,16
1650063577892,CSE 3,A51,083647,Miranda; Gregory Joseph,37,0,37,0
1650063583931,CSE 8A,A50,083650,Miranda; Gregory Joseph,0,16,40,40
1650063589953,CSE 11,A01,083080,Cao; Yingjun,0,63,40,40
1650063595982,CSE 12,A01,083652,Staff,0,2,100,100
1650063602012,CSE 15L,A01,083654,Staff,0,0,50,50
1650063602012,CSE 15L,A02,083655,Staff,10,0,50,40
1650063608034,CSE 20,A01,083657,Staff,58,0,80,22
1650063614065,CSE 30,A01,083084,Eldon; John,0,63,40,40
1650063620093,CSE 100,A01,083659,Cao; Yingjun,0,57,50,50
1650063626130,CSE 134B,A01,083661,Powell; Thomas Allan,1,27,65,64
1650063632160,CSE 140,A01,083663,Staff,7,0,75,68
1650063638189,CSE 140L,A01,083088,Eldon; John,2,0,75,73
1650063644211,CSE 175,A01,083665,Kumar; Rakesh,9,0,25,16
1650063650246,CSE 190,A00,092507,Dubnov; Shlomo,14,0,20,6
1650063656272,ECE 45,A01,083139,Staff,0,13,40,40
1650063662294,ECE 65,A50,083695,Staff,0,3,30,30
1650063668320,ECE 109,A01,091882,Touri; Behrouz,48,0,70,22
1650063674347,ECE 180,A00,083140,Abi Samra; Nicholas Camill,24,0,30,6
1650063674347,ECE 180,B00,083141,Abi Samra; Nicholas Camill,8,0,30,22
1650063680375,MATH 10A,A01,083735,Patchell; Gregory David,12,0,30,18
1650063680375,MATH 10A,A02,083736,Patchell; Gregory David,28,0,30,2
1650063680375,MATH 10A,A03,083737,Patchell; Gregory David,27,0,30,3
1650063686397,MATH 10B,A01,083207,Staff,0,5,30,30
1650063686397,MATH 10B,A02,083208,Staff,0,3,30,30
1650063686397,MATH 10B,B01,083739,Staff,19,0,30,11
1650063686397,MATH 10B,B02,083740,Staff,30,0,30,0
1650063692421,MATH 18,A01,083743,Staff,10,0,30,20
1650063692421,MATH 18,A02,083744,Staff,28,0,30,2
1650063692421,MATH 18,A03,083745,Staff,23,0,30,7
1650063692421,MATH 18,A04,083746,Staff,27,0,30,3
1650063692421,MATH 18,B01,083748,Staff,0,9,30,30
1650063692421,MATH 18,B02,083749,Staff,1,7,30,29
1650063692421,MATH 18,B03,083750,Staff,0,6,30,30
1650063692421,MATH 18,B04,083751,Staff,1,8,30,29
1650063698448,MATH 20A,A01,083754,Staff,26,0,40,14
1650063704471,MATH 20B,A01,083756,Staff,0,5,30,30
1650063704471,MATH 20B,A02,083757,Staff,0,1,30,30
1650063710495,MATH 20C,A01,083760,Staff,0,10,30,30
1650063710495,MATH 20C,A02,083761,Staff,0,12,30,30
1650063710495,MATH 20C,B01,083762,Staff,16,0,30,14
1650063710495,MATH 20C,B02,083763,Staff,28,0,30,2
1650063716522,MATH 20D,A01,083765,Staff,0,2,30,30
1650063716522,MATH 20D,A02,083766,Staff,14,0,30,16
1650063716522,MATH 20D,A03,083767,Staff,28,0,30,2
1650063722553,MATH 20E,A01,083771,Staff,10,0,30,20
1650063722553,MATH 20E,A02,083772,Staff,20,0,30,10
1650063722553,MATH 20E,B01,083773,Staff,2,2,30,28
1650063722553,MATH 20E,B02,083774,Staff,17,0,30,13
1650063728577,MATH 103A,A01,083777,Staff,0,8,30,30
1650063728577,MATH 103A,A02,083778,Staff,0,7,30,30
1650063728577,MATH 103A,B01,083779,Staff,0,8,30,30
1650063728577,MATH 103A,B02,083780,Staff,0,6,30,30
1650063734600,MATH 105,A01,085443,Staff,1,12,30,29
1650063740710,MATH 109,A01,083213,Anzaldo; Leesa B,1,4,30,29
1650063740710,MATH 109,A02,083214,Anzaldo; Leesa B,0,4,30,30
1650063740710,MATH 109,B01,083215,Anzaldo; Leesa B,0,2,30,30
1650063740710,MATH 109,B02,083216,Anzaldo; Leesa B,1,3,30,29
1650063746738,MATH 142A,A01,083219,Chow; Bennett,0,9,30,30
1650063746738,MATH 142A,A02,083220,Chow; Bennett,0,9,30,30
1650063746738,MATH 142A,B01,083221,Chow; Bennett,0,9,30,30
1650063746738,MATH 142A,B02,083222,Chow; Bennett,0,9,30,30
1650063752773,MATH 193A,A01,083224,Staff,0,4,30,30
1650063752773,MATH 193A,A02,083225,Staff,0,4,30,30
1650063752773,MATH 193A,A03,083781,Staff,0,0,30,30
1650063752773,MATH 193A,A04,083782,Staff,8,0,30,22
1650063758796,MATH 197,001,091859,McAuley; Julian John,9998,0,9999,1
1650063764852,COGS 9,A01,083615,Staff,3,17,60,57
1650063770875,COGS 11,A01,083617,Boyle; Mary E. T.,24,0,40,16
1650063776899,COGS 13,A01,083071,Staff,0,28,40,40
1650063782923,COGS 14A,A01,092681,Staff,0,10,100,100
1650063788949,COGS 14B,A01,083073,Cheng; Tzu-Han,0,3,50,50
1650063794987,COGS 17,A01,092677,Staff,35,0,75,40
1650063801009,COGS 100,A01,083619,Staff,0,18,60,60
1650063807036,COGS 101A,A01,083621,Davis; Joshua Daniel,0,16,60,60
1650063813060,COGS 101B,A01,091572,Staff,13,0,60,47
1650063819092,COGS 101C,A01,083625,Delgado; Tania,21,0,30,9
1650063825121,COGS 107A,A01,083627,Boyle; Mary E. T.,1,3,60,59
1650063831157,COGS 118A,A01,083075,Staff,18,0,60,42
1650063837184,CSE 3,A50,083646,Miranda; Gregory Joseph,22,0,38,16
1650063837184,CSE 3,A51,083647,Miranda; Gregory Joseph,37,0,37,0
1650063843211,CSE 8A,A50,083650,Miranda; Gregory Joseph,0,16,40,40
1650063849235,CSE 11,A01,083080,Cao; Yingjun,0,63,40,40
1650063855260,CSE 12,A01,083652,Staff,0,2,100,100
1650063861284,CSE 15L,A01,083654,Staff,0,0,50,50
1650063861284,CSE 15L,A02,083655,Staff,10,0,50,40
1650063867305,CSE 20,A01,083657,Staff,58,0,80,22
1650063873332,CSE 30,A01,083084,Eldon; John,0,63,40,40
1650063879358,CSE 100,A01,083659,Cao; Yingjun,0,57,50,50
1650063885389,CSE 134B,A01,083661,Powell; Thomas Allan,1,27,65,64
1650063891412,CSE 140,A01,083663,Staff,7,0,75,68
1650063897442,CSE 140L,A01,083088,Eldon; John,2,0,75,73
1650063903474,CSE 175,A01,083665,Kumar; Rakesh,9,0,25,16
1650063909500,CSE 190,A00,092507,Dubnov; Shlomo,14,0,20,6
1650063915527,ECE 45,A01,083139,Staff,0,13,40,40
1650063921554,ECE 65,A50,083695,Staff,0,3,30,30
1650063927580,ECE 109,A01,091882,Touri; Behrouz,48,0,70,22
1650063933602,ECE 180,A00,083140,Abi Samra; Nicholas Camill,24,0,30,6
1650063933602,ECE 180,B00,083141,Abi Samra; Nicholas Camill,8,0,30,22
1650063939625,MATH 10A,A01,083735,Patchell; Gregory David,12,0,30,18
1650063939625,MATH 10A,A02,083736,Patchell; Gregory David,28,0,30,2
1650063939625,MATH 10A,A03,083737,Patchell; Gregory David,27,0,30,3
1650063945649,MATH 10B,A01,083207,Staff,0,5,30,30
1650063945649,MATH 10B,A02,083208,Staff,0,3,30,30
1650063945649,MATH 10B,B01,083739,Staff,19,0,30,11
1650063945649,MATH 10B,B02,083740,Staff,30,0,30,0
1650063951678,MATH 18,A01,083743,Staff,10,0,30,20
1650063951678,MATH 18,A02,083744,Staff,28,0,30,2
1650063951678,MATH 18,A03,083745,Staff,23,0,30,7
1650063951678,MATH 18,A04,083746,Staff,27,0,30,3
1650063951678,MATH 18,B01,083748,Staff,0,9,30,30
1650063951678,MATH 18,B02,083749,Staff,1,7,30,29
1650063951678,MATH 18,B03,083750,Staff,0,6,30,30
1650063951678,MATH 18,B04,083751,Staff,1,8,30,29
1650063957704,MATH 20A,A01,083754,Staff,26,0,40,14
1650063963728,MATH 20B,A01,083756,Staff,0,5,30,30
1650063963728,MATH 20B,A02,083757,Staff,0,1,30,30
1650063969758,MATH 20C,A01,083760,Staff,0,10,30,30
1650063969758,MATH 20C,A02,083761,Staff,0,12,30,30
1650063969758,MATH 20C,B01,083762,Staff,16,0,30,14
1650063969758,MATH 20C,B02,083763,Staff,28,0,30,2
1650063975786,MATH 20D,A01,083765,Staff,0,2,30,30
1650063975786,MATH 20D,A02,083766,Staff,14,0,30,16
1650063975786,MATH 20D,A03,083767,Staff,28,0,30,2
1650063981810,MATH 20E,A01,083771,Staff,10,0,30,20
1650063981810,MATH 20E,A02,083772,Staff,20,0,30,10
1650063981810,MATH 20E,B01,083773,Staff,2,2,30,28
1650063981810,MATH 20E,B02,083774,Staff,17,0,30,13
1650063987834,MATH 103A,A01,083777,Staff,0,8,30,30
1650063987834,MATH 103A,A02,083778,Staff,0,7,30,30
1650063987834,MATH 103A,B01,083779,Staff,0,8,30,30
1650063987834,MATH 103A,B02,083780,Staff,0,6,30,30
1650063993860,MATH 105,A01,085443,Staff,1,12,30,29
1650063999885,MATH 109,A01,083213,Anzaldo; Leesa B,1,4,30,29
1650063999885,MATH 109,A02,083214,Anzaldo; Leesa B,0,4,30,30
1650063999885,MATH 109,B01,083215,Anzaldo; Leesa B,0,2,30,30
1650063999885,MATH 109,B02,083216,Anzaldo; Leesa B,1,3,30,29
1650064005909,MATH 142A,A01,083219,Chow; Bennett,0,9,30,30
1650064005909,MATH 142A,A02,083220,Chow; Bennett,0,9,30,30
1650064005909,MATH 142A,B01,083221,Chow; Bennett,0,9,30,30
1650064005909,MATH 142A,B02,083222,Chow; Bennett,0,9,30,30
1650064011949,MATH 193A,A01,083224,Staff,0,4,30,30
1650064011949,MATH 193A,A02,083225,Staff,0,4,30,30
1650064011949,MATH 193A,A03,083781,Staff,0,0,30,30
1650064011949,MATH 193A,A04,083782,Staff,8,0,30,22
1650064017971,MATH 197,001,091859,McAuley; Julian John,9998,0,9999,1
1650064024029,COGS 9,A01,083615,Staff,3,17,60,57
1650064030052,COGS 11,A01,083617,Boyle; Mary E. T.,24,0,40,16
1650064036087,COGS 13,A01,083071,Staff,0,28,40,40
1650064042125,COGS 14A,A01,092681,Staff,0,10,100,100
1650064048152,COGS 14B,A01,083073,Cheng; Tzu-Han,0,3,50,50
1650064054176,COGS 17,A01,092677,Staff,35,0,75,40
1650064060200,COGS 100,A01,083619,Staff,0,18,60,60
1650064066227,COGS 101A,A01,083621,Davis; Joshua Daniel,0,16,60,60
1650064072256,COGS 101B,A01,091572,Staff,13,0,60,47
1650064078280,COGS 101C,A01,083625,Delgado; Tania,21,0,30,9
1650064084309,COGS 107A,A01,083627,Boyle; Mary E. T.,1,3,60,59
1650064090333,COGS 118A,A01,083075,Staff,18,0,60,42
1650064096360,CSE 3,A50,083646,Miranda; Gregory Joseph,22,0,38,16
1650064096360,CSE 3,A51,083647,Miranda; Gregory Joseph,37,0,37,0
1650064102402,CSE 8A,A50,083650,Miranda; Gregory Joseph,0,16,40,40
1650064108429,CSE 11,A01,083080,Cao; Yingjun,0,63,40,40
1650064114469,CSE 12,A01,083652,Staff,0,2,100,100
1650064120499,CSE 15L,A01,083654,Staff,0,0,50,50
1650064120499,CSE 15L,A02,083655,Staff,10,0,50,40
1650064126526,CSE 20,A01,083657,Staff,58,0,80,22
1650064132557,CSE 30,A01,083084,Eldon; John,0,63,40,40
1650064138579,CSE 100,A01,083659,Cao; Yingjun,0,57,50,50
1650064144606,CSE 134B,A01,083661,Powell; Thomas Allan,1,27,65,64
1650064150630,CSE 140,A01,083663,Staff,7,0,75,68
1650064156661,CSE 140L,A01,083088,Eldon; John,2,0,75,73
1650064162686,CSE 175,A01,083665,Kumar; Rakesh,9,0,25,16
1650064168709,CSE 190,A00,092507,Dubnov; Shlomo,14,0,20,6
1650064174738,ECE 45,A01,083139,Staff,0,13,40,40
1650064180768,ECE 65,A50,083695,Staff,0,3,30,30
1650064186808,ECE 109,A01,091882,Touri; Behrouz,48,0,70,22
1650064192837,ECE 180,A00,083140,Abi Samra; Nicholas Camill,24,0,30,6
1650064192837,ECE 180,B00,083141,Abi Samra; Nicholas Camill,8,0,30,22
1650064198860,MATH 10A,A01,083735,Patchell; Gregory David,12,0,30,18
1650064198860,MATH 10A,A02,083736,Patchell; Gregory David,28,0,30,2
1650064198860,MATH 10A,A03,083737,Patchell; Gregory David,27,0,30,3
1650064204894,MATH 10B,A01,083207,Staff,0,5,30,30
1650064204894,MATH 10B,A02,083208,Staff,0,3,30,30
1650064204894,MATH 10B,B01,083739,Staff,19,0,30,11
1650064204894,MATH 10B,B02,083740,Staff,30,0,30,0
1650064210926,MATH 18,A01,083743,Staff,10,0,30,20
1650064210926,MATH 18,A02,083744,Staff,28,0,30,2
1650064210926,MATH 18,A03,083745,Staff,23,0,30,7
1650064210926,MATH 18,A04,083746,Staff,27,0,30,3
1650064210926,MATH 18,B01,083748,Staff,0,9,30,30
1650064210926,MATH 18,B02,083749,Staff,1,7,30,29
1650064210926,MATH 18,B03,083750,Staff,0,6,30,30
1650064210926,MATH 18,B04,083751,Staff,1,8,30,29
1650064216950,MATH 20A,A01,083754,Staff,26,0,40,14
1650064222974,MATH 20B,A01,083756,Staff,0,5,30,30
1650064222974,MATH 20B,A02,083757,Staff,0,1,30,30
1650064228997,MATH 20C,A01,083760,Staff,0,10,30,30
1650064228997,MATH 20C,A02,083761,Staff,0,12,30,30
1650064228997,MATH 20C,B01,083762,Staff,16,0,30,14
1650064228997,MATH 20C,B02,083763,Staff,28,0,30,2
1650064235021,MATH 20D,A01,083765,Staff,0,2,30,30
1650064235021,MATH 20D,A02,083766,Staff,14,0,30,16
1650064235021,MATH 20D,A03,083767,Staff,28,0,30,2
1650064241049,MATH 20E,A01,083771,Staff,10,0,30,20
1650064241049,MATH 20E,A02,083772,Staff,20,0,30,10
1650064241049,MATH 20E,B01,083773,Staff,2,2,30,28
1650064241049,MATH 20E,B02,083774,Staff,17,0,30,13
1650064247078,MATH 103A,A01,083777,Staff,0,8,30,30
1650064247078,MATH 103A,A02,083778,Staff,0,7,30,30
1650064247078,MATH 103A,B01,083779,Staff,0,8,30,30
1650064247078,MATH 103A,B02,083780,Staff,0,6,30,30
1650064253111,MATH 105,A01,085443,Staff,1,12,30,29
1650064259137,MATH 109,A01,083213,Anzaldo; Leesa B,1,4,30,29
1650064259137,MATH 109,A02,083214,Anzaldo; Leesa B,0,4,30,30
1650064259137,MATH 109,B01,083215,Anzaldo; Leesa B,0,2,30,30
1650064259137,MATH 109,B02,083216,Anzaldo; Leesa B,1,3,30,29
1650064265174,MATH 142A,A01,083219,Chow; Bennett,0,9,30,30
1650064265174,MATH 142A,A02,083220,Chow; Bennett,0,9,30,30
1650064265174,MATH 142A,B01,083221,Chow; Bennett,0,9,30,30
1650064265174,MATH 142A,B02,083222,Chow; Bennett,0,9,30,30
1650064271204,MATH 193A,A01,083224,Staff,0,4,30,30
1650064271204,MATH 193A,A02,083225,Staff,0,4,30,30
1650064271204,MATH 193A,A03,083781,Staff,0,0,30,30
1650064271204,MATH 193A,A04,083782,Staff,8,0,30,22
1650064277256,MATH 197,001,091859,McAuley; Julian John,9998,0,9999,1
1650064283310,COGS 9,A01,083615,Staff,3,17,60,57
1650064289333,COGS 11,A01,083617,Boyle; Mary E. T.,24,0,40,16
1650064295355,COGS 13,A01,083071,Staff,0,28,40,40
1650064301378,COGS 14A,A01,092681,Staff,0,10,100,100
1650064307401,COGS 14B,A01,083073,Cheng; Tzu-Han,0,3,50,50
1650064313427,COGS 17,A01,092677,Staff,35,0,75,40
1650064319453,COGS 100,A01,083619,Staff,0,18,60,60
1650064325475,COGS 101A,A01,083621,Davis; Joshua Daniel,0,16,60,60
1650064331611,COGS 101B,A01,091572,Staff,13,0,60,47
1650064337638,COGS 101C,A01,083625,Delgado; Tania,21,0,30,9
1650064343661,COGS 107A,A01,083627,Boyle; Mary E. T.,1,3,60,59
1650064349684,COGS 118A,A01,083075,Staff,18,0,60,42
1650064355707,CSE 3,A50,083646,Miranda; Gregory Joseph,22,0,38,16
1650064355707,CSE 3,A51,083647,Miranda; Gregory Joseph,37,0,37,0
1650064361734,CSE 8A,A50,083650,Miranda; Gregory Joseph,0,16,40,40
1650064367757,CSE 11,A01,083080,Cao; Yingjun,0,63,40,40
1650064373792,CSE 12,A01,083652,Staff,0,2,100,100
1650064379822,CSE 15L,A01,083654,Staff,0,0,50,50
1650064379822,CSE 15L,A02,083655,Staff,10,0,50,40
1650064385850,CSE 20,A01,083657,Staff,58,0,80,22
1650064391873,CSE 30,A01,083084,Eldon; John,0,63,40,40
1650064397898,CSE 100,A01,083659,Cao; Yingjun,0,58,50,50
1650064403922,CSE 134B,A01,083661,Powell; Thomas Allan,1,27,65,64
1650064409945,CSE 140,A01,083663,Staff,7,0,75,68
1650064415969,CSE 140L,A01,083088,Eldon; John,2,0,75,73
1650064422004,CSE 175,A01,083665,Kumar; Rakesh,9,0,25,16
1650064428027,CSE 190,A00,092507,Dubnov; Shlomo,14,0,20,6
1650064434052,ECE 45,A01,083139,Staff,0,13,40,40
1650064440078,ECE 65,A50,083695,Staff,0,3,30,30
1650064446107,ECE 109,A01,091882,Touri; Behrouz,48,0,70,22
1650064452133,ECE 180,A00,083140,Abi Samra; Nicholas Camill,24,0,30,6
1650064452133,ECE 180,B00,083141,Abi Samra; Nicholas Camill,8,0,30,22
1650064458167,MATH 10A,A01,083735,Patchell; Gregory David,12,0,30,18
1650064458167,MATH 10A,A02,083736,Patchell; Gregory David,28,0,30,2
1650064458167,MATH 10A,A03,083737,Patchell; Gregory David,27,0,30,3
1650064464190,MATH 10B,A01,083207,Staff,0,5,30,30
1650064464190,MATH 10B,A02,083208,Staff,0,3,30,30
1650064464190,MATH 10B,B01,083739,Staff,19,0,30,11
1650064464190,MATH 10B,B02,083740,Staff,30,0,30,0
1650064470215,MATH 18,A01,083743,Staff,10,0,30,20
1650064470215,MATH 18,A02,083744,Staff,28,0,30,2
1650064470215,MATH 18,A03,083745,Staff,23,0,30,7
1650064470215,MATH 18,A04,083746,Staff,27,0,30,3
1650064470215,MATH 18,B01,083748,Staff,0,9,30,30
1650064470215,MATH 18,B02,083749,Staff,1,7,30,29
1650064470215,MATH 18,B03,083750,Staff,0,6,30,30
1650064470215,MATH 18,B04,083751,Staff,1,8,30,29
1650064476242,MATH 20A,A01,083754,Staff,26,0,40,14
1650064490283,MATH 20B,A01,083756,Staff,0,5,30,30
1650064490283,MATH 20B,A02,083757,Staff,0,1,30,30
1650064496306,MATH 20C,A01,083760,Staff,0,10,30,30
1650064496306,MATH 20C,A02,083761,Staff,0,12,30,30
1650064496306,MATH 20C,B01,083762,Staff,16,0,30,14
1650064496306,MATH 20C,B02,083763,Staff,28,0,30,2
1650064502329,MATH 20D,A01,083765,Staff,0,2,30,30
1650064502329,MATH 20D,A02,083766,Staff,14,0,30,16
1650064502329,MATH 20D,A03,083767,Staff,28,0,30,2
1650064508359,MATH 20E,A01,083771,Staff,10,0,30,20
1650064508359,MATH 20E,A02,083772,Staff,20,0,30,10
1650064508359,MATH 20E,B01,083773,Staff,2,2,30,28
1650064508359,MATH 20E,B02,083774,Staff,17,0,30,13
1650064514408,MATH 103A,A01,083777,Staff,0,8,30,30
1650064514408,MATH 103A,A02,083778,Staff,0,7,30,30
1650064514408,MATH 103A,B01,083779,Staff,0,8,30,30
1650064514408,MATH 103A,B02,083780,Staff,0,6,30,30
1650064520430,MATH 105,A01,085443,Staff,1,12,30,29
1650064526454,MATH 109,A01,083213,Anzaldo; Leesa B,1,4,30,29
1650064526454,MATH 109,A02,083214,Anzaldo; Leesa B,0,4,30,30
1650064526454,MATH 109,B01,083215,Anzaldo; Leesa B,0,2,30,30
1650064526454,MATH 109,B02,083216,Anzaldo; Leesa B,1,3,30,29
1650064532484,MATH 142A,A01,083219,Chow; Bennett,0,9,30,30
1650064532484,MATH 142A,A02,083220,Chow; Bennett,0,9,30,30
1650064532484,MATH 142A,B01,083221,Chow; Bennett,0,9,30,30
1650064532484,MATH 142A,B02,083222,Chow; Bennett,0,9,30,30
1650064538516,MATH 193A,A01,083224,Staff,0,4,30,30
1650064538516,MATH 193A,A02,083225,Staff,0,4,30,30
1650064538516,MATH 193A,A03,083781,Staff,0,0,30,30
1650064538516,MATH 193A,A04,083782,Staff,8,0,30,22
1650064544540,MATH 197,001,091859,McAuley; Julian John,9998,0,9999,1
1650064550600,COGS 9,A01,083615,Staff,3,17,60,57
1650064556623,COGS 11,A01,083617,Boyle; Mary E. T.,24,0,40,16
1650064562647,COGS 13,A01,083071,Staff,0,28,40,40
1650064568674,COGS 14A,A01,092681,Staff,0,10,100,100
1650064574700,COGS 14B,A01,083073,Cheng; Tzu-Han,0,3,50,50
1650064580726,COGS 17,A01,092677,Staff,35,0,75,40
1650064586751,COGS 100,A01,083619,Staff,0,18,60,60
1650064592781,COGS 101A,A01,083621,Davis; Joshua Daniel,0,16,60,60
1650064598806,COGS 101B,A01,091572,Staff,13,0,60,47
1650064604830,COGS 101C,A01,083625,Delgado; Tania,21,0,30,9
1650064610859,COGS 107A,A01,083627,Boyle; Mary E. T.,1,3,60,59
1650064616884,COGS 118A,A01,083075,Staff,18,0,60,42
1650064622914,CSE 3,A50,083646,Miranda; Gregory Joseph,22,0,38,16
1650064622914,CSE 3,A51,083647,Miranda; Gregory Joseph,37,0,37,0
1650064628941,CSE 8A,A50,083650,Miranda; Gregory Joseph,0,16,40,40
1650064634970,CSE 11,A01,083080,Cao; Yingjun,0,63,40,40
1650064640993,CSE 12,A01,083652,Staff,0,2,100,100
1650064647035,CSE 15L,A01,083654,Staff,0,0,50,50
1650064647035,CSE 15L,A02,083655,Staff,10,0,50,40
1650064653063,CSE 20,A01,083657,Staff,58,0,80,22
1650064659086,CSE 30,A01,083084,Eldon; John,0,63,40,40
1650064665122,CSE 100,A01,083659,Cao; Yingjun,0,58,50,50
1650064671144,CSE 134B,A01,083661,Powell; Thomas Allan,1,27,65,64
1650064677168,CSE 140,A01,083663,Staff,7,0,75,68
1650064683199,CSE 140L,A01,083088,Eldon; John,2,0,75,73
1650064689223,CSE 175,A01,083665,Kumar; Rakesh,9,0,25,16
1650064695248,CSE 190,A00,092507,Dubnov; Shlomo,14,0,20,6
1650064701271,ECE 45,A01,083139,Staff,0,13,40,40
1650064707309,ECE 65,A50,083695,Staff,0,3,30,30
1650064713333,ECE 109,A01,091882,Touri; Behrouz,48,0,70,22
1650064719358,ECE 180,A00,083140,Abi Samra; Nicholas Camill,24,0,30,6
1650064719358,ECE 180,B00,083141,Abi Samra; Nicholas Camill,8,0,30,22
1650064725389,MATH 10A,A01,083735,Patchell; Gregory David,12,0,30,18
1650064725389,MATH 10A,A02,083736,Patchell; Gregory David,28,0,30,2
1650064725389,MATH 10A,A03,083737,Patchell; Gregory David,27,0,30,3
1650064731418,MATH 10B,A01,083207,Staff,0,5,30,30
1650064731418,MATH 10B,A02,083208,Staff,0,3,30,30
1650064731418,MATH 10B,B01,083739,Staff,19,0,30,11
1650064731418,MATH 10B,B02,083740,Staff,30,0,30,0
1650064737450,MATH 18,A01,083743,Staff,10,0,30,20
1650064737450,MATH 18,A02,083744,Staff,28,0,30,2
1650064737450,MATH 18,A03,083745,Staff,23,0,30,7
1650064737450,MATH 18,A04,083746,Staff,27,0,30,3
1650064737450,MATH 18,B01,083748,Staff,0,9,30,30
1650064737450,MATH 18,B02,083749,Staff,1,7,30,29
1650064737450,MATH 18,B03,083750,Staff,0,6,30,30
1650064737450,MATH 18,B04,083751,Staff,1,8,30,29
1650064743471,MATH 20A,A01,083754,Staff,26,0,40,14
1650064749496,MATH 20B,A01,083756,Staff,0,5,30,30
1650064749496,MATH 20B,A02,083757,Staff,0,1,30,30
1650064755520,MATH 20C,A01,083760,Staff,0,10,30,30
1650064755520,MATH 20C,A02,083761,Staff,0,12,30,30
1650064755520,MATH 20C,B01,083762,Staff,16,0,30,14
1650064755520,MATH 20C,B02,083763,Staff,28,0,30,2
1650064761546,MATH 20D,A01,083765,Staff,0,2,30,30
1650064761546,MATH 20D,A02,083766,Staff,14,0,30,16
1650064761546,MATH 20D,A03,083767,Staff,28,0,30,2
1650064767574,MATH 20E,A01,083771,Staff,10,0,30,20
1650064767574,MATH 20E,A02,083772,Staff,20,0,30,10
1650064767574,MATH 20E,B01,083773,Staff,2,2,30,28
1650064767574,MATH 20E,B02,083774,Staff,17,0,30,13
1650064773596,MATH 103A,A01,083777,Staff,0,8,30,30
1650064773596,MATH 103A,A02,083778,Staff,0,7,30,30
1650064773596,MATH 103A,B01,083779,Staff,0,8,30,30
1650064773596,MATH 103A,B02,083780,Staff,0,6,30,30
1650064779617,MATH 105,A01,085443,Staff,1,12,30,29
1650064785641,MATH 109,A01,083213,Anzaldo; Leesa B,1,4,30,29
1650064785641,MATH 109,A02,083214,Anzaldo; Leesa B,0,4,30,30
1650064785641,MATH 109,B01,083215,Anzaldo; Leesa B,0,2,30,30
1650064785641,MATH 109,B02,083216,Anzaldo; Leesa B,1,3,30,29
1650064791671,MATH 142A,A01,083219,Chow; Bennett,0,10,30,30
1650064791671,MATH 142A,A02,083220,Chow; Bennett,0,9,30,30
1650064791671,MATH 142A,B01,083221,Chow; Bennett,0,9,30,30
1650064791671,MATH 142A,B02,083222,Chow; Bennett,0,9,30,30
1650064797696,MATH 193A,A01,083224,Staff,0,4,30,30
1650064797696,MATH 193A,A02,083225,Staff,0,4,30,30
1650064797696,MATH 193A,A03,083781,Staff,0,0,30,30
1650064797696,MATH 193A,A04,083782,Staff,8,0,30,22
1650064803723,MATH 197,001,091859,McAuley; Julian John,9998,0,9999,1
1650064809773,COGS 9,A01,083615,Staff,3,17,60,57
1650064815800,COGS 11,A01,083617,Boyle; Mary E. T.,24,0,40,16
1650064821824,COGS 13,A01,083071,Staff,0,28,40,40
1650064827850,COGS 14A,A01,092681,Staff,0,10,100,100
1650064833873,COGS 14B,A01,083073,Cheng; Tzu-Han,0,3,50,50
1650064839897,COGS 17,A01,092677,Staff,35,0,75,40
1650064845923,COGS 100,A01,083619,Staff,0,18,60,60
1650064851947,COGS 101A,A01,083621,Davis; Joshua Daniel,0,16,60,60
1650064857977,COGS 101B,A01,091572,Staff,13,0,60,47
1650064864005,COGS 101C,A01,083625,Delgado; Tania,21,0,30,9
1650064870034,COGS 107A,A01,083627,Boyle; Mary E. T.,1,3,60,59
1650064876059,COGS 118A,A01,083075,Staff,18,0,60,42
1650064882083,CSE 3,A50,083646,Miranda; Gregory Joseph,22,0,38,16
1650064882083,CSE 3,A51,083647,Miranda; Gregory Joseph,37,0,37,0
1650064888109,CSE 8A,A50,083650,Miranda; Gregory Joseph,0,16,40,40
1650064894135,CSE 11,A01,083080,Cao; Yingjun,0,63,40,40
1650064900162,CSE 12,A01,083652,Staff,0,2,100,100
1650064906195,CSE 15L,A01,083654,Staff,0,0,50,50
1650064906195,CSE 15L,A02,083655,Staff,10,0,50,40
1650064912218,CSE 20,A01,083657,Staff,58,0,80,22
1650064918241,CSE 30,A01,083084,Eldon; John,0,63,40,40
1650064924264,CSE 100,A01,083659,Cao; Yingjun,0,58,50,50
1650064930296,CSE 134B,A01,083661,Powell; Thomas Allan,1,27,65,64
1650064936396,CSE 140,A01,083663,Staff,6,0,75,69
1650064942435,CSE 140L,A01,083088,Eldon; John,1,0,75,74
1650064948470,CSE 175,A01,083665,Kumar; Rakesh,9,0,25,16
1650064954497,CSE 190,A00,092507,Dubnov; Shlomo,14,0,20,6
1650064960524,ECE 45,A01,083139,Staff,0,13,40,40
1650064966557,ECE 65,A50,083695,Staff,0,3,30,30
1650064972580,ECE 109,A01,091882,Touri; Behrouz,48,0,70,22
1650064978615,ECE 180,A00,083140,Abi Samra; Nicholas Camill,24,0,30,6
1650064978615,ECE 180,B00,083141,Abi Samra; Nicholas Camill,8,0,30,22
1650064984644,MATH 10A,A01,083735,Patchell; Gregory David,12,0,30,18
1650064984644,MATH 10A,A02,083736,Patchell; Gregory David,28,0,30,2
1650064984644,MATH 10A,A03,083737,Patchell; Gregory David,27,0,30,3
1650064990667,MATH 10B,A01,083207,Staff,0,5,30,30
1650064990667,MATH 10B,A02,083208,Staff,0,3,30,30
1650064990667,MATH 10B,B01,083739,Staff,19,0,30,11
1650064990667,MATH 10B,B02,083740,Staff,30,0,30,0
1650064996703,MATH 18,A01,083743,Staff,10,0,30,20
1650064996703,MATH 18,A02,083744,Staff,28,0,30,2
1650064996703,MATH 18,A03,083745,Staff,23,0,30,7
1650064996703,MATH 18,A04,083746,Staff,27,0,30,3
1650064996703,MATH 18,B01,083748,Staff,0,9,30,30
1650064996703,MATH 18,B02,083749,Staff,1,7,30,29
1650064996703,MATH 18,B03,083750,Staff,0,6,30,30
1650064996703,MATH 18,B04,083751,Staff,1,8,30,29
1650065002739,MATH 20A,A01,083754,Staff,26,0,40,14
1650065008777,MATH 20B,A01,083756,Staff,0,5,30,30
1650065008777,MATH 20B,A02,083757,Staff,0,1,30,30
1650065014806,MATH 20C,A01,083760,Staff,0,10,30,30
1650065014806,MATH 20C,A02,083761,Staff,0,12,30,30
1650065014806,MATH 20C,B01,083762,Staff,16,0,30,14
1650065014806,MATH 20C,B02,083763,Staff,28,0,30,2
1650065020841,MATH 20D,A01,083765,Staff,0,2,30,30
1650065020841,MATH 20D,A02,083766,Staff,14,0,30,16
1650065020841,MATH 20D,A03,083767,Staff,28,0,30,2
1650065026864,MATH 20E,A01,083771,Staff,10,0,30,20
1650065026864,MATH 20E,A02,083772,Staff,20,0,30,10
1650065026864,MATH 20E,B01,083773,Staff,2,2,30,28
1650065026864,MATH 20E,B02,083774,Staff,17,0,30,13
1650065032899,MATH 103A,A01,083777,Staff,0,8,30,30
1650065032899,MATH 103A,A02,083778,Staff,0,7,30,30
1650065032899,MATH 103A,B01,083779,Staff,0,8,30,30
1650065032899,MATH 103A,B02,083780,Staff,0,6,30,30
1650065038922,MATH 105,A01,085443,Staff,1,12,30,29
1650065044950,MATH 109,A01,083213,Anzaldo; Leesa B,1,4,30,29
1650065044950,MATH 109,A02,083214,Anzaldo; Leesa B,0,4,30,30
1650065044950,MATH 109,B01,083215,Anzaldo; Leesa B,0,2,30,30
1650065044950,MATH 109,B02,083216,Anzaldo; Leesa B,1,3,30,29
1650065050978,MATH 142A,A01,083219,Chow; Bennett,0,10,30,30
1650065050978,MATH 142A,A02,083220,Chow; Bennett,0,9,30,30
1650065050978,MATH 142A,B01,083221,Chow; Bennett,0,9,30,30
1650065050978,MATH 142A,B02,083222,Chow; Bennett,0,9,30,30
1650065057001,MATH 193A,A01,083224,Staff,0,4,30,30
1650065057001,MATH 193A,A02,083225,Staff,0,4,30,30
1650065057001,MATH 193A,A03,083781,Staff,0,0,30,30
1650065057001,MATH 193A,A04,083782,Staff,8,0,30,22
1650065063029,MATH 197,001,091859,McAuley; Julian John,9998,0,9999,1
1650065069105,COGS 9,A01,083615,Staff,3,17,60,57
1650065075128,COGS 11,A01,083617,Boyle; Mary E. T.,24,0,40,16
1650065081152,COGS 13,A01,083071,Staff,0,28,40,40
1650065087174,COGS 14A,A01,092681,Staff,0,10,100,100
1650065093207,COGS 14B,A01,083073,Cheng; Tzu-Han,0,3,50,50
1650065099242,COGS 17,A01,092677,Staff,35,0,75,40
1650065105268,COGS 100,A01,083619,Staff,0,18,60,60
1650065111291,COGS 101A,A01,083621,Davis; Joshua Daniel,0,16,60,60
1650065117322,COGS 101B,A01,091572,Staff,13,0,60,47
1650065123364,COGS 101C,A01,083625,Delgado; Tania,21,0,30,9
1650065129388,COGS 107A,A01,083627,Boyle; Mary E. T.,1,3,60,59
1650065135415,COGS 118A,A01,083075,Staff,18,0,60,42
1650065141442,CSE 3,A50,083646,Miranda; Gregory Joseph,22,0,38,16
1650065141442,CSE 3,A51,083647,Miranda; Gregory Joseph,37,0,37,0
1650065147469,CSE 8A,A50,083650,Miranda; Gregory Joseph,0,16,40,40
1650065153492,CSE 11,A01,083080,Cao; Yingjun,0,63,40,40
1650065159515,CSE 12,A01,083652,Staff,0,2,100,100
1650065165539,CSE 15L,A01,083654,Staff,0,0,50,50
1650065165539,CSE 15L,A02,083655,Staff,10,0,50,40
1650065171566,CSE 20,A01,083657,Staff,58,0,80,22
1650065177597,CSE 30,A01,083084,Eldon; John,0,63,40,40
1650065183621,CSE 100,A01,083659,Cao; Yingjun,0,58,50,50
1650065189655,CSE 134B,A01,083661,Powell; Thomas Allan,1,27,65,64
1650065195689,CSE 140,A01,083663,Staff,6,0,75,69
1650065201718,CSE 140L,A01,083088,Eldon; John,1,0,75,74
1650065207745,CSE 175,A01,083665,Kumar; Rakesh,9,0,25,16
1650065213774,CSE 190,A00,092507,Dubnov; Shlomo,14,0,20,6
1650065219804,ECE 45,A01,083139,Staff,0,13,40,40
1650065225836,ECE 65,A50,083695,Staff,0,3,30,30
1650065231859,ECE 109,A01,091882,Touri; Behrouz,48,0,70,22
1650065237882,ECE 180,A00,083140,Abi Samra; Nicholas Camill,24,0,30,6
1650065237882,ECE 180,B00,083141,Abi Samra; Nicholas Camill,8,0,30,22
1650065243908,MATH 10A,A01,083735,Patchell; Gregory David,12,0,30,18
1650065243908,MATH 10A,A02,083736,Patchell; Gregory David,28,0,30,2
1650065243908,MATH 10A,A03,083737,Patchell; Gregory David,27,0,30,3
1650065249939,MATH 10B,A01,083207,Staff,0,5,30,30
1650065249939,MATH 10B,A02,083208,Staff,0,3,30,30
1650065249939,MATH 10B,B01,083739,Staff,19,0,30,11
1650065249939,MATH 10B,B02,083740,Staff,30,0,30,0
1650065255964,MATH 18,A01,083743,Staff,10,0,30,20
1650065255964,MATH 18,A02,083744,Staff,28,0,30,2
1650065255964,MATH 18,A03,083745,Staff,23,0,30,7
1650065255964,MATH 18,A04,083746,Staff,27,0,30,3
1650065255964,MATH 18,B01,083748,Staff,0,9,30,30
1650065255964,MATH 18,B02,083749,Staff,1,7,30,29
1650065255964,MATH 18,B03,083750,Staff,0,6,30,30
1650065255964,MATH 18,B04,083751,Staff,1,8,30,29
1650065261988,MATH 20A,A01,083754,Staff,26,0,40,14
1650065268015,MATH 20B,A01,083756,Staff,0,5,30,30
1650065268015,MATH 20B,A02,083757,Staff,0,1,30,30
1650065274042,MATH 20C,A01,083760,Staff,0,10,30,30
1650065274042,MATH 20C,A02,083761,Staff,0,12,30,30
1650065274042,MATH 20C,B01,083762,Staff,16,0,30,14
1650065274042,MATH 20C,B02,083763,Staff,28,0,30,2
1650065280067,MATH 20D,A01,083765,Staff,0,2,30,30
1650065280067,MATH 20D,A02,083766,Staff,14,0,30,16
1650065280067,MATH 20D,A03,083767,Staff,28,0,30,2
1650065286093,MATH 20E,A01,083771,Staff,10,0,30,20
1650065286093,MATH 20E,A02,083772,Staff,20,0,30,10
1650065286093,MATH 20E,B01,083773,Staff,2,2,30,28
1650065286093,MATH 20E,B02,083774,Staff,17,0,30,13
1650065292121,MATH 103A,A01,083777,Staff,0,8,30,30
1650065292121,MATH 103A,A02,083778,Staff,0,7,30,30
1650065292121,MATH 103A,B01,083779,Staff,0,8,30,30
1650065292121,MATH 103A,B02,083780,Staff,0,6,30,30
1650065298146,MATH 105,A01,085443,Staff,1,12,30,29
1650065304170,MATH 109,A01,083213,Anzaldo; Leesa B,1,4,30,29
1650065304170,MATH 109,A02,083214,Anzaldo; Leesa B,0,4,30,30
1650065304170,MATH 109,B01,083215,Anzaldo; Leesa B,0,2,30,30
1650065304170,MATH 109,B02,083216,Anzaldo; Leesa B,1,3,30,29
1650065310194,MATH 142A,A01,083219,Chow; Bennett,0,10,30,30
1650065310194,MATH 142A,A02,083220,Chow; Bennett,0,9,30,30
1650065310194,MATH 142A,B01,083221,Chow; Bennett,0,9,30,30
1650065310194,MATH 142A,B02,083222,Chow; Bennett,0,9,30,30
1650065316217,MATH 193A,A01,083224,Staff,0,4,30,30
1650065316217,MATH 193A,A02,083225,Staff,0,4,30,30
1650065316217,MATH 193A,A03,083781,Staff,0,0,30,30
1650065316217,MATH 193A,A04,083782,Staff,8,0,30,22
1650065322242,MATH 197,001,091859,McAuley; Julian John,9998,0,9999,1
1650065328303,COGS 9,A01,083615,Staff,3,17,60,57
1650065334325,COGS 11,A01,083617,Boyle; Mary E. T.,24,0,40,16
1650065340353,COGS 13,A01,083071,Staff,0,28,40,40
1650065346380,COGS 14A,A01,092681,Staff,0,10,100,100
1650065352403,COGS 14B,A01,083073,Cheng; Tzu-Han,0,3,50,50
1650065358429,COGS 17,A01,092677,Staff,35,0,75,40
1650065364453,COGS 100,A01,083619,Staff,0,18,60,60
1650065370480,COGS 101A,A01,083621,Davis; Joshua Daniel,0,16,60,60
1650065376506,COGS 101B,A01,091572,Staff,13,0,60,47
1650065382531,COGS 101C,A01,083625,Delgado; Tania,21,0,30,9
1650065388555,COGS 107A,A01,083627,Boyle; Mary E. T.,1,3,60,59
1650065394579,COGS 118A,A01,083075,Staff,18,0,60,42
1650065400603,CSE 3,A50,083646,Miranda; Gregory Joseph,22,0,38,16
1650065400603,CSE 3,A51,083647,Miranda; Gregory Joseph,37,0,37,0
1650065406632,CSE 8A,A50,083650,Miranda; Gregory Joseph,0,16,40,40
1650065412660,CSE 11,A01,083080,Cao; Yingjun,0,63,40,40
1650065418686,CSE 12,A01,083652,Staff,0,2,100,100
1650065424709,CSE 15L,A01,083654,Staff,0,0,50,50
1650065424709,CSE 15L,A02,083655,Staff,10,0,50,40
1650065430732,CSE 20,A01,083657,Staff,58,0,80,22
1650065436764,CSE 30,A01,083084,Eldon; John,0,63,40,40
1650065442787,CSE 100,A01,083659,Cao; Yingjun,0,58,50,50
1650065448816,CSE 134B,A01,083661,Powell; Thomas Allan,1,27,65,64
1650065454840,CSE 140,A01,083663,Staff,6,0,75,69
1650065460869,CSE 140L,A01,083088,Eldon; John,1,0,75,74
1650065466899,CSE 175,A01,083665,Kumar; Rakesh,9,0,25,16
1650065472926,CSE 190,A00,092507,Dubnov; Shlomo,14,0,20,6
1650065478967,ECE 45,A01,083139,Staff,0,13,40,40
1650065484994,ECE 65,A50,083695,Staff,0,3,30,30
1650065491017,ECE 109,A01,091882,Touri; Behrouz,48,0,70,22
1650065497047,ECE 180,A00,083140,Abi Samra; Nicholas Camill,24,0,30,6
1650065497047,ECE 180,B00,083141,Abi Samra; Nicholas Camill,8,0,30,22
1650065503075,MATH 10A,A01,083735,Patchell; Gregory David,12,0,30,18
1650065503075,MATH 10A,A02,083736,Patchell; Gregory David,28,0,30,2
1650065503075,MATH 10A,A03,083737,Patchell; Gregory David,27,0,30,3
1650065509106,MATH 10B,A01,083207,Staff,0,5,30,30
1650065509106,MATH 10B,A02,083208,Staff,0,3,30,30
1650065509106,MATH 10B,B01,083739,Staff,19,0,30,11
1650065509106,MATH 10B,B02,083740,Staff,30,0,30,0
1650065515131,MATH 18,A01,083743,Staff,10,0,30,20
1650065515131,MATH 18,A02,083744,Staff,28,0,30,2
1650065515131,MATH 18,A03,083745,Staff,23,0,30,7
1650065515131,MATH 18,A04,083746,Staff,27,0,30,3
1650065515131,MATH 18,B01,083748,Staff,0,9,30,30
1650065515131,MATH 18,B02,083749,Staff,1,7,30,29
1650065515131,MATH 18,B03,083750,Staff,0,6,30,30
1650065515131,MATH 18,B04,083751,Staff,1,8,30,29
1650065521154,MATH 20A,A01,083754,Staff,26,0,40,14
1650065527182,MATH 20B,A01,083756,Staff,0,5,30,30
1650065527182,MATH 20B,A02,083757,Staff,0,1,30,30
1650065533279,MATH 20C,A01,083760,Staff,0,10,30,30
1650065533279,MATH 20C,A02,083761,Staff,0,12,30,30
1650065533279,MATH 20C,B01,083762,Staff,16,0,30,14
1650065533279,MATH 20C,B02,083763,Staff,28,0,30,2
1650065539311,MATH 20D,A01,083765,Staff,0,2,30,30
1650065539311,MATH 20D,A02,083766,Staff,14,0,30,16
1650065539311,MATH 20D,A03,083767,Staff,28,0,30,2
1650065545341,MATH 20E,A01,083771,Staff,10,0,30,20
1650065545341,MATH 20E,A02,083772,Staff,20,0,30,10
1650065545341,MATH 20E,B01,083773,Staff,2,2,30,28
1650065545341,MATH 20E,B02,083774,Staff,17,0,30,13
1650065551374,MATH 103A,A01,083777,Staff,0,8,30,30
1650065551374,MATH 103A,A02,083778,Staff,0,7,30,30
1650065551374,MATH 103A,B01,083779,Staff,0,8,30,30
1650065551374,MATH 103A,B02,083780,Staff,0,6,30,30
1650065557403,MATH 105,A01,085443,Staff,1,12,30,29
1650065563427,MATH 109,A01,083213,Anzaldo; Leesa B,1,4,30,29
1650065563427,MATH 109,A02,083214,Anzaldo; Leesa B,0,4,30,30
1650065563427,MATH 109,B01,083215,Anzaldo; Leesa B,0,2,30,30
1650065563427,MATH 109,B02,083216,Anzaldo; Leesa B,1,3,30,29
1650065569451,MATH 142A,A01,083219,Chow; Bennett,0,10,30,30
1650065569451,MATH 142A,A02,083220,Chow; Bennett,0,9,30,30
1650065569451,MATH 142A,B01,083221,Chow; Bennett,0,9,30,30
1650065569451,MATH 142A,B02,083222,Chow; Bennett,0,9,30,30
1650065575478,MATH 193A,A01,083224,Staff,0,4,30,30
1650065575478,MATH 193A,A02,083225,Staff,0,4,30,30
1650065575478,MATH 193A,A03,083781,Staff,0,0,30,30
1650065575478,MATH 193A,A04,083782,Staff,8,0,30,22
1650065581501,MATH 197,001,091859,McAuley; Julian John,9998,0,9999,1
1650065587561,COGS 9,A01,083615,Staff,3,17,60,57
1650065593590,COGS 11,A01,083617,Boyle; Mary E. T.,24,0,40,16
1650065599619,COGS 13,A01,083071,Staff,0,28,40,40
1650065605647,COGS 14A,A01,092681,Staff,0,10,100,100
1650065611670,COGS 14B,A01,083073,Cheng; Tzu-Han,0,3,50,50
1650065617693,COGS 17,A01,092677,Staff,35,0,75,40
1650065623716,COGS 100,A01,083619,Staff,0,18,60,60
1650065629742,COGS 101A,A01,083621,Davis; Joshua Daniel,0,16,60,60
1650065635774,COGS 101B,A01,091572,Staff,13,0,60,47
1650065641799,COGS 101C,A01,083625,Delgado; Tania,21,0,30,9
1650065647836,COGS 107A,A01,083627,Boyle; Mary E. T.,1,3,60,59
1650065653872,COGS 118A,A01,083075,Staff,18,0,60,42
1650065659896,CSE 3,A50,083646,Miranda; Gregory Joseph,22,0,38,16
1650065659896,CSE 3,A51,083647,Miranda; Gregory Joseph,37,0,37,0
1650065665919,CSE 8A,A50,083650,Miranda; Gregory Joseph,0,16,40,40
1650065671944,CSE 11,A01,083080,Cao; Yingjun,0,63,40,40
1650065677971,CSE 12,A01,083652,Staff,0,2,100,100
1650065684000,CSE 15L,A01,083654,Staff,0,0,50,50
1650065684000,CSE 15L,A02,083655,Staff,10,0,50,40
1650065690024,CSE 20,A01,083657,Staff,58,0,80,22
1650065696051,CSE 30,A01,083084,Eldon; John,0,63,40,40
1650065702080,CSE 100,A01,083659,Cao; Yingjun,0,58,50,50
1650065708108,CSE 134B,A01,083661,Powell; Thomas Allan,1,27,65,64
1650065714132,CSE 140,A01,083663,Staff,6,0,75,69
1650065720156,CSE 140L,A01,083088,Eldon; John,1,0,75,74
1650065726177,CSE 175,A01,083665,Kumar; Rakesh,9,0,25,16
1650065732206,CSE 190,A00,092507,Dubnov; Shlomo,14,0,20,6
1650065738227,ECE 45,A01,083139,Staff,0,13,40,40
1650065744252,ECE 65,A50,083695,Staff,0,3,30,30
1650065750287,ECE 109,A01,091882,Touri; Behrouz,48,0,70,22
1650065756310,ECE 180,A00,083140,Abi Samra; Nicholas Camill,24,0,30,6
1650065756310,ECE 180,B00,083141,Abi Samra; Nicholas Camill,8,0,30,22
1650065762338,MATH 10A,A01,083735,Patchell; Gregory David,12,0,30,18
1650065762338,MATH 10A,A02,083736,Patchell; Gregory David,28,0,30,2
1650065762338,MATH 10A,A03,083737,Patchell; Gregory David,27,0,30,3
1650065768364,MATH 10B,A01,083207,Staff,0,5,30,30
1650065768364,MATH 10B,A02,083208,Staff,0,3,30,30
1650065768364,MATH 10B,B01,083739,Staff,19,0,30,11
1650065768364,MATH 10B,B02,083740,Staff,30,0,30,0
1650065774394,MATH 18,A01,083743,Staff,10,0,30,20
1650065774394,MATH 18,A02,083744,Staff,28,0,30,2
1650065774394,MATH 18,A03,083745,Staff,23,0,30,7
1650065774394,MATH 18,A04,083746,Staff,27,0,30,3
1650065774394,MATH 18,B01,083748,Staff,0,9,30,30
1650065774394,MATH 18,B02,083749,Staff,1,7,30,29
1650065774394,MATH 18,B03,083750,Staff,0,6,30,30
1650065774394,MATH 18,B04,083751,Staff,1,8,30,29
1650065780421,MATH 20A,A01,083754,Staff,26,0,40,14
1650065786447,MATH 20B,A01,083756,Staff,0,5,30,30
1650065786447,MATH 20B,A02,083757,Staff,0,1,30,30
1650065792469,MATH 20C,A01,083760,Staff,0,10,30,30
1650065792469,MATH 20C,A02,083761,Staff,0,12,30,30
1650065792469,MATH 20C,B01,083762,Staff,16,0,30,14
1650065792469,MATH 20C,B02,083763,Staff,28,0,30,2
1650065798496,MATH 20D,A01,083765,Staff,0,2,30,30
1650065798496,MATH 20D,A02,083766,Staff,14,0,30,16
1650065798496,MATH 20D,A03,083767,Staff,28,0,30,2
1650065804523,MATH 20E,A01,083771,Staff,10,0,30,20
1650065804523,MATH 20E,A02,083772,Staff,20,0,30,10
1650065804523,MATH 20E,B01,083773,Staff,2,2,30,28
1650065804523,MATH 20E,B02,083774,Staff,17,0,30,13
1650065810561,MATH 103A,A01,083777,Staff,0,8,30,30
1650065810561,MATH 103A,A02,083778,Staff,0,7,30,30
1650065810561,MATH 103A,B01,083779,Staff,0,8,30,30
1650065810561,MATH 103A,B02,083780,Staff,0,6,30,30
1650065816586,MATH 105,A01,085443,Staff,1,12,30,29
1650065822614,MATH 109,A01,083213,Anzaldo; Leesa B,1,4,30,29
1650065822614,MATH 109,A02,083214,Anzaldo; Leesa B,0,4,30,30
1650065822614,MATH 109,B01,083215,Anzaldo; Leesa B,0,2,30,30
1650065822614,MATH 109,B02,083216,Anzaldo; Leesa B,1,3,30,29
1650065828637,MATH 142A,A01,083219,Chow; Bennett,0,10,30,30
1650065828637,MATH 142A,A02,083220,Chow; Bennett,0,9,30,30
1650065828637,MATH 142A,B01,083221,Chow; Bennett,0,9,30,30
1650065828637,MATH 142A,B02,083222,Chow; Bennett,0,9,30,30
1650065834661,MATH 193A,A01,083224,Staff,0,4,30,30
1650065834661,MATH 193A,A02,083225,Staff,0,4,30,30
1650065834661,MATH 193A,A03,083781,Staff,0,0,30,30
1650065834661,MATH 193A,A04,083782,Staff,8,0,30,22
1650065840684,MATH 197,001,091859,McAuley; Julian John,9998,0,9999,1
1650065846745,COGS 9,A01,083615,Staff,3,17,60,57
1650065852771,COGS 11,A01,083617,Boyle; Mary E. T.,24,0,40,16
1650065858803,COGS 13,A01,083071,Staff,0,28,40,40
1650065864830,COGS 14A,A01,092681,Staff,0,10,100,100
1650065870854,COGS 14B,A01,083073,Cheng; Tzu-Han,0,3,50,50
1650065876878,COGS 17,A01,092677,Staff,35,0,75,40
1650065882901,COGS 100,A01,083619,Staff,0,18,60,60
1650065888930,COGS 101A,A01,083621,Davis; Joshua Daniel,0,16,60,60
1650065894957,COGS 101B,A01,091572,Staff,13,0,60,47
1650065900993,COGS 101C,A01,083625,Delgado; Tania,21,0,30,9
1650065907020,COGS 107A,A01,083627,Boyle; Mary E. T.,1,3,60,59
1650065913042,COGS 118A,A01,083075,Staff,18,0,60,42
1650065919071,CSE 3,A50,083646,Miranda; Gregory Joseph,22,0,38,16
1650065919071,CSE 3,A51,083647,Miranda; Gregory Joseph,37,0,37,0
1650065925101,CSE 8A,A50,083650,Miranda; Gregory Joseph,0,16,40,40
1650065931132,CSE 11,A01,083080,Cao; Yingjun,0,63,40,40
1650065937156,CSE 12,A01,083652,Staff,0,2,100,100
1650065943180,CSE 15L,A01,083654,Staff,0,0,50,50
1650065943180,CSE 15L,A02,083655,Staff,10,0,50,40
1650065949207,CSE 20,A01,083657,Staff,58,0,80,22
1650065955231,CSE 30,A01,083084,Eldon; John,0,63,40,40
1650065961260,CSE 100,A01,083659,Cao; Yingjun,0,58,50,50
1650065967305,CSE 134B,A01,083661,Powell; Thomas Allan,1,27,65,64
1650065973331,CSE 140,A01,083663,Staff,6,0,75,69
1650065979356,CSE 140L,A01,083088,Eldon; John,1,0,75,74
1650065985380,CSE 175,A01,083665,Kumar; Rakesh,9,0,25,16
1650065991403,CSE 190,A00,092507,Dubnov; Shlomo,14,0,20,6
1650065997437,ECE 45,A01,083139,Staff,0,13,40,40
1650066003461,ECE 65,A50,083695,Staff,0,3,30,30
1650066009491,ECE 109,A01,091882,Touri; Behrouz,48,0,70,22
1650066015514,ECE 180,A00,083140,Abi Samra; Nicholas Camill,24,0,30,6
1650066015514,ECE 180,B00,083141,Abi Samra; Nicholas Camill,8,0,30,22
1650066021536,MATH 10A,A01,083735,Patchell; Gregory David,12,0,30,18
1650066021536,MATH 10A,A02,083736,Patchell; Gregory David,28,0,30,2
1650066021536,MATH 10A,A03,083737,Patchell; Gregory David,27,0,30,3
1650066027560,MATH 10B,A01,083207,Staff,0,5,30,30
1650066027560,MATH 10B,A02,083208,Staff,0,3,30,30
1650066027560,MATH 10B,B01,083739,Staff,19,0,30,11
1650066027560,MATH 10B,B02,083740,Staff,30,0,30,0
1650066033585,MATH 18,A01,083743,Staff,10,0,30,20
1650066033585,MATH 18,A02,083744,Staff,28,0,30,2
1650066033585,MATH 18,A03,083745,Staff,23,0,30,7
1650066033585,MATH 18,A04,083746,Staff,27,0,30,3
1650066033585,MATH 18,B01,083748,Staff,0,9,30,30
1650066033585,MATH 18,B02,083749,Staff,1,7,30,29
1650066033585,MATH 18,B03,083750,Staff,0,6,30,30
1650066033585,MATH 18,B04,083751,Staff,1,8,30,29
1650066039609,MATH 20A,A01,083754,Staff,26,0,40,14
1650066045632,MATH 20B,A01,083756,Staff,0,5,30,30
1650066045632,MATH 20B,A02,083757,Staff,0,1,30,30
1650066051656,MATH 20C,A01,083760,Staff,0,10,30,30
1650066051656,MATH 20C,A02,083761,Staff,0,12,30,30
1650066051656,MATH 20C,B01,083762,Staff,16,0,30,14
1650066051656,MATH 20C,B02,083763,Staff,28,0,30,2
1650066057683,MATH 20D,A01,083765,Staff,0,2,30,30
1650066057683,MATH 20D,A02,083766,Staff,14,0,30,16
1650066057683,MATH 20D,A03,083767,Staff,28,0,30,2
1650066063708,MATH 20E,A01,083771,Staff,10,0,30,20
1650066063708,MATH 20E,A02,083772,Staff,20,0,30,10
1650066063708,MATH 20E,B01,083773,Staff,2,2,30,28
1650066063708,MATH 20E,B02,083774,Staff,17,0,30,13
1650066069731,MATH 103A,A01,083777,Staff,0,8,30,30
1650066069731,MATH 103A,A02,083778,Staff,0,7,30,30
1650066069731,MATH 103A,B01,083779,Staff,0,8,30,30
1650066069731,MATH 103A,B02,083780,Staff,0,6,30,30
1650066075758,MATH 105,A01,085443,Staff,1,12,30,29
1650066081782,MATH 109,A01,083213,Anzaldo; Leesa B,1,4,30,29
1650066081782,MATH 109,A02,083214,Anzaldo; Leesa B,0,4,30,30
1650066081782,MATH 109,B01,083215,Anzaldo; Leesa B,0,2,30,30
1650066081782,MATH 109,B02,083216,Anzaldo; Leesa B,1,3,30,29
1650066087809,MATH 142A,A01,083219,Chow; Bennett,0,10,30,30
1650066087809,MATH 142A,A02,083220,Chow; Bennett,0,9,30,30
1650066087809,MATH 142A,B01,083221,Chow; Bennett,0,9,30,30
1650066087809,MATH 142A,B02,083222,Chow; Bennett,0,9,30,30
1650066093836,MATH 193A,A01,083224,Staff,0,4,30,30
1650066093836,MATH 193A,A02,083225,Staff,0,4,30,30
1650066093836,MATH 193A,A03,083781,Staff,0,0,30,30
1650066093836,MATH 193A,A04,083782,Staff,8,0,30,22
1650066099863,MATH 197,001,091859,McAuley; Julian John,9998,0,9999,1
1650066105920,COGS 9,A01,083615,Staff,3,17,60,57
1650066111950,COGS 11,A01,083617,Boyle; Mary E. T.,24,0,40,16
1650066117975,COGS 13,A01,083071,Staff,0,28,40,40
1650066124094,COGS 14A,A01,092681,Staff,0,10,100,100
1650066130122,COGS 14B,A01,083073,Cheng; Tzu-Han,0,3,50,50
1650066136159,COGS 17,A01,092677,Staff,35,0,75,40
1650066142188,COGS 100,A01,083619,Staff,0,18,60,60
1650066148216,COGS 101A,A01,083621,Davis; Joshua Daniel,0,16,60,60
1650066154242,COGS 101B,A01,091572,Staff,13,0,60,47
1650066160266,COGS 101C,A01,083625,Delgado; Tania,21,0,30,9
1650066166293,COGS 107A,A01,083627,Boyle; Mary E. T.,1,3,60,59
1650066172316,COGS 118A,A01,083075,Staff,18,0,60,42
1650066178340,CSE 3,A50,083646,Miranda; Gregory Joseph,22,0,38,16
1650066178340,CSE 3,A51,083647,Miranda; Gregory Joseph,37,0,37,0
1650066184364,CSE 8A,A50,083650,Miranda; Gregory Joseph,0,16,40,40
1650066190387,CSE 11,A01,083080,Cao; Yingjun,0,63,40,40
1650066196422,CSE 12,A01,083652,Staff,0,2,100,100
1650066202448,CSE 15L,A01,083654,Staff,0,0,50,50
1650066202448,CSE 15L,A02,083655,Staff,10,0,50,40
1650066208472,CSE 20,A01,083657,Staff,58,0,80,22
1650066214499,CSE 30,A01,083084,Eldon; John,0,63,40,40
1650066220522,CSE 100,A01,083659,Cao; Yingjun,0,58,50,50
1650066226550,CSE 134B,A01,083661,Powell; Thomas Allan,1,27,65,64
1650066232572,CSE 140,A01,083663,Staff,6,0,75,69
1650066238601,CSE 140L,A01,083088,Eldon; John,1,0,75,74
1650066244626,CSE 175,A01,083665,Kumar; Rakesh,9,0,25,16
1650066250653,CSE 190,A00,092507,Dubnov; Shlomo,14,0,20,6
1650066256677,ECE 45,A01,083139,Staff,0,13,40,40
1650066262706,ECE 65,A50,083695,Staff,0,3,30,30
1650066268730,ECE 109,A01,091882,Touri; Behrouz,48,0,70,22
1650066274757,ECE 180,A00,083140,Abi Samra; Nicholas Camill,24,0,30,6
1650066274757,ECE 180,B00,083141,Abi Samra; Nicholas Camill,8,0,30,22
1650066280781,MATH 10A,A01,083735,Patchell; Gregory David,12,0,30,18
1650066280781,MATH 10A,A02,083736,Patchell; Gregory David,28,0,30,2
1650066280781,MATH 10A,A03,083737,Patchell; Gregory David,27,0,30,3
1650066286810,MATH 10B,A01,083207,Staff,0,5,30,30
1650066286810,MATH 10B,A02,083208,Staff,0,3,30,30
1650066286810,MATH 10B,B01,083739,Staff,19,0,30,11
1650066286810,MATH 10B,B02,083740,Staff,30,0,30,0
1650066292845,MATH 18,A01,083743,Staff,10,0,30,20
1650066292845,MATH 18,A02,083744,Staff,28,0,30,2
1650066292845,MATH 18,A03,083745,Staff,23,0,30,7
1650066292845,MATH 18,A04,083746,Staff,27,0,30,3
1650066292845,MATH 18,B01,083748,Staff,0,9,30,30
1650066292845,MATH 18,B02,083749,Staff,1,7,30,29
1650066292845,MATH 18,B03,083750,Staff,0,6,30,30
1650066292845,MATH 18,B04,083751,Staff,1,8,30,29
1650066298877,MATH 20A,A01,083754,Staff,26,0,40,14
1650066304905,MATH 20B,A01,083756,Staff,0,5,30,30
1650066304905,MATH 20B,A02,083757,Staff,0,1,30,30
1650066310930,MATH 20C,A01,083760,Staff,0,10,30,30
1650066310930,MATH 20C,A02,083761,Staff,0,12,30,30
1650066310930,MATH 20C,B01,083762,Staff,16,0,30,14
1650066310930,MATH 20C,B02,083763,Staff,28,0,30,2
1650066316953,MATH 20D,A01,083765,Staff,0,2,30,30
1650066316953,MATH 20D,A02,083766,Staff,14,0,30,16
1650066316953,MATH 20D,A03,083767,Staff,28,0,30,2
1650066322982,MATH 20E,A01,083771,Staff,10,0,30,20
1650066322982,MATH 20E,A02,083772,Staff,20,0,30,10
1650066322982,MATH 20E,B01,083773,Staff,2,2,30,28
1650066322982,MATH 20E,B02,083774,Staff,17,0,30,13
1650066329007,MATH 103A,A01,083777,Staff,0,8,30,30
1650066329007,MATH 103A,A02,083778,Staff,0,7,30,30
1650066329007,MATH 103A,B01,083779,Staff,0,8,30,30
1650066329007,MATH 103A,B02,083780,Staff,0,6,30,30
1650066335038,MATH 105,A01,085443,Staff,1,12,30,29
1650066341078,MATH 109,A01,083213,Anzaldo; Leesa B,1,4,30,29
1650066341078,MATH 109,A02,083214,Anzaldo; Leesa B,0,4,30,30
1650066341078,MATH 109,B01,083215,Anzaldo; Leesa B,0,2,30,30
1650066341078,MATH 109,B02,083216,Anzaldo; Leesa B,1,3,30,29
1650066347101,MATH 142A,A01,083219,Chow; Bennett,0,10,30,30
1650066347101,MATH 142A,A02,083220,Chow; Bennett,0,9,30,30
1650066347101,MATH 142A,B01,083221,Chow; Bennett,0,9,30,30
1650066347101,MATH 142A,B02,083222,Chow; Bennett,0,9,30,30
1650066353125,MATH 193A,A01,083224,Staff,0,4,30,30
1650066353125,MATH 193A,A02,083225,Staff,0,4,30,30
1650066353125,MATH 193A,A03,083781,Staff,0,0,30,30
1650066353125,MATH 193A,A04,083782,Staff,8,0,30,22
1650066359148,MATH 197,001,091859,McAuley; Julian John,9998,0,9999,1
1650066365219,COGS 9,A01,083615,Staff,3,17,60,57
1650066371246,COGS 11,A01,083617,Boyle; Mary E. T.,24,0,40,16
1650066377269,COGS 13,A01,083071,Staff,0,28,40,40
1650066383294,COGS 14A,A01,092681,Staff,0,10,100,100
1650066389321,COGS 14B,A01,083073,Cheng; Tzu-Han,0,3,50,50
1650066395354,COGS 17,A01,092677,Staff,35,0,75,40
1650066401380,COGS 100,A01,083619,Staff,0,18,60,60
1650066407415,COGS 101A,A01,083621,Davis; Joshua Daniel,0,16,60,60
1650066413440,COGS 101B,A01,091572,Staff,13,0,60,47
1650066419468,COGS 101C,A01,083625,Delgado; Tania,21,0,30,9
1650066425495,COGS 107A,A01,083627,Boyle; Mary E. T.,1,3,60,59
1650066431518,COGS 118A,A01,083075,Staff,18,0,60,42
1650066437545,CSE 3,A50,083646,Miranda; Gregory Joseph,22,0,38,16
1650066437545,CSE 3,A51,083647,Miranda; Gregory Joseph,37,0,37,0
1650066443568,CSE 8A,A50,083650,Miranda; Gregory Joseph,0,16,40,40
1650066449594,CSE 11,A01,083080,Cao; Yingjun,0,63,40,40
1650066455616,CSE 12,A01,083652,Staff,0,2,100,100
1650066461640,CSE 15L,A01,083654,Staff,0,0,50,50
1650066461640,CSE 15L,A02,083655,Staff,10,0,50,40
1650066467673,CSE 20,A01,083657,Staff,58,0,80,22
1650066473696,CSE 30,A01,083084,Eldon; John,0,63,40,40
1650066479719,CSE 100,A01,083659,Cao; Yingjun,0,58,50,50
1650066485748,CSE 134B,A01,083661,Powell; Thomas Allan,1,27,65,64
1650066491774,CSE 140,A01,083663,Staff,6,0,75,69
1650066497797,CSE 140L,A01,083088,Eldon; John,1,0,75,74
1650066503821,CSE 175,A01,083665,Kumar; Rakesh,9,0,25,16
1650066509851,CSE 190,A00,092507,Dubnov; Shlomo,14,0,20,6
1650066515879,ECE 45,A01,083139,Staff,0,13,40,40
1650066521902,ECE 65,A50,083695,Staff,0,3,30,30
1650066527926,ECE 109,A01,091882,Touri; Behrouz,48,0,70,22
1650066533968,ECE 180,A00,083140,Abi Samra; Nicholas Camill,24,0,30,6
1650066533968,ECE 180,B00,083141,Abi Samra; Nicholas Camill,8,0,30,22
1650066540001,MATH 10A,A01,083735,Patchell; Gregory David,12,0,30,18
1650066540001,MATH 10A,A02,083736,Patchell; Gregory David,28,0,30,2
1650066540001,MATH 10A,A03,083737,Patchell; Gregory David,27,0,30,3
1650066546025,MATH 10B,A01,083207,Staff,0,5,30,30
1650066546025,MATH 10B,A02,083208,Staff,0,3,30,30
1650066546025,MATH 10B,B01,083739,Staff,18,0,30,12
1650066546025,MATH 10B,B02,083740,Staff,30,0,30,0
1650066552054,MATH 18,A01,083743,Staff,10,0,30,20
1650066552054,MATH 18,A02,083744,Staff,28,0,30,2
1650066552054,MATH 18,A03,083745,Staff,23,0,30,7
1650066552054,MATH 18,A04,083746,Staff,27,0,30,3
1650066552054,MATH 18,B01,083748,Staff,0,9,30,30
1650066552054,MATH 18,B02,083749,Staff,1,7,30,29
1650066552054,MATH 18,B03,083750,Staff,0,6,30,30
1650066552054,MATH 18,B04,083751,Staff,1,8,30,29
1650066558093,MATH 20A,A01,083754,Staff,26,0,40,14
1650066564118,MATH 20B,A01,083756,Staff,0,5,30,30
1650066564118,MATH 20B,A02,083757,Staff,0,1,30,30
1650066570146,MATH 20C,A01,083760,Staff,0,10,30,30
1650066570146,MATH 20C,A02,083761,Staff,0,12,30,30
1650066570146,MATH 20C,B01,083762,Staff,16,0,30,14
1650066570146,MATH 20C,B02,083763,Staff,28,0,30,2
1650066576172,MATH 20D,A01,083765,Staff,0,2,30,30
1650066576172,MATH 20D,A02,083766,Staff,14,0,30,16
1650066576172,MATH 20D,A03,083767,Staff,28,0,30,2
1650066582200,MATH 20E,A01,083771,Staff,10,0,30,20
1650066582200,MATH 20E,A02,083772,Staff,20,0,30,10
1650066582200,MATH 20E,B01,083773,Staff,2,2,30,28
1650066582200,MATH 20E,B02,083774,Staff,17,0,30,13
1650066588230,MATH 103A,A01,083777,Staff,0,8,30,30
1650066588230,MATH 103A,A02,083778,Staff,0,7,30,30
1650066588230,MATH 103A,B01,083779,Staff,0,8,30,30
1650066588230,MATH 103A,B02,083780,Staff,0,6,30,30
1650066594255,MATH 105,A01,085443,Staff,1,12,30,29
1650066600278,MATH 109,A01,083213,Anzaldo; Leesa B,1,4,30,29
1650066600278,MATH 109,A02,083214,Anzaldo; Leesa B,0,4,30,30
1650066600278,MATH 109,B01,083215,Anzaldo; Leesa B,0,2,30,30
1650066600278,MATH 109,B02,083216,Anzaldo; Leesa B,1,3,30,29
1650066606309,MATH 142A,A01,083219,Chow; Bennett,0,10,30,30
1650066606309,MATH 142A,A02,083220,Chow; Bennett,0,9,30,30
1650066606309,MATH 142A,B01,083221,Chow; Bennett,0,9,30,30
1650066606309,MATH 142A,B02,083222,Chow; Bennett,0,9,30,30
1650066612337,MATH 193A,A01,083224,Staff,0,4,30,30
1650066612337,MATH 193A,A02,083225,Staff,0,4,30,30
1650066612337,MATH 193A,A03,083781,Staff,0,0,30,30
1650066612337,MATH 193A,A04,083782,Staff,8,0,30,22
1650066618365,MATH 197,001,091859,McAuley; Julian John,9998,0,9999,1
1650066624436,COGS 9,A01,083615,Staff,3,17,60,57
1650066630475,COGS 11,A01,083617,Boyle; Mary E. T.,24,0,40,16
1650066636499,COGS 13,A01,083071,Staff,0,28,40,40
1650066642529,COGS 14A,A01,092681,Staff,0,10,100,100
1650066648553,COGS 14B,A01,083073,Cheng; Tzu-Han,0,4,50,50
1650066654577,COGS 17,A01,092677,Staff,35,0,75,40
1650066660605,COGS 100,A01,083619,Staff,0,19,60,60
1650066666635,COGS 101A,A01,083621,Davis; Joshua Daniel,0,16,60,60
1650066672661,COGS 101B,A01,091572,Staff,13,0,60,47
1650066678685,COGS 101C,A01,083625,Delgado; Tania,21,0,30,9
1650066684717,COGS 107A,A01,083627,Boyle; Mary E. T.,1,3,60,59
1650066690745,COGS 118A,A01,083075,Staff,18,0,60,42
1650066696769,CSE 3,A50,083646,Miranda; Gregory Joseph,22,0,38,16
1650066696769,CSE 3,A51,083647,Miranda; Gregory Joseph,37,0,37,0
1650066702793,CSE 8A,A50,083650,Miranda; Gregory Joseph,0,16,40,40
1650066708820,CSE 11,A01,083080,Cao; Yingjun,0,64,40,40
1650066714846,CSE 12,A01,083652,Staff,0,2,100,100
1650066720960,CSE 15L,A01,083654,Staff,0,0,50,50
1650066720960,CSE 15L,A02,083655,Staff,10,0,50,40
1650066726984,CSE 20,A01,083657,Staff,58,0,80,22
1650066733012,CSE 30,A01,083084,Eldon; John,0,63,40,40
1650066739036,CSE 100,A01,083659,Cao; Yingjun,0,58,50,50
1650066745059,CSE 134B,A01,083661,Powell; Thomas Allan,1,27,65,64
1650066751083,CSE 140,A01,083663,Staff,6,0,75,69
1650066757112,CSE 140L,A01,083088,Eldon; John,1,0,75,74
1650066763137,CSE 175,A01,083665,Kumar; Rakesh,9,0,25,16
1650066769169,CSE 190,A00,092507,Dubnov; Shlomo,14,0,20,6
1650066775195,ECE 45,A01,083139,Staff,0,13,40,40
1650066781225,ECE 65,A50,083695,Staff,0,3,30,30
1650066787249,ECE 109,A01,091882,Touri; Behrouz,48,0,70,22
1650066793272,ECE 180,A00,083140,Abi Samra; Nicholas Camill,24,0,30,6
1650066793272,ECE 180,B00,083141,Abi Samra; Nicholas Camill,8,0,30,22
1650066799295,MATH 10A,A01,083735,Patchell; Gregory David,12,0,30,18
1650066799295,MATH 10A,A02,083736,Patchell; Gregory David,28,0,30,2
1650066799295,MATH 10A,A03,083737,Patchell; Gregory David,27,0,30,3
1650066805319,MATH 10B,A01,083207,Staff,0,5,30,30
1650066805319,MATH 10B,A02,083208,Staff,0,3,30,30
1650066805319,MATH 10B,B01,083739,Staff,18,0,30,12
1650066805319,MATH 10B,B02,083740,Staff,30,0,30,0
1650066811345,MATH 18,A01,083743,Staff,10,0,30,20
1650066811345,MATH 18,A02,083744,Staff,28,0,30,2
1650066811345,MATH 18,A03,083745,Staff,23,0,30,7
1650066811345,MATH 18,A04,083746,Staff,27,0,30,3
1650066811345,MATH 18,B01,083748,Staff,0,9,30,30
1650066811345,MATH 18,B02,083749,Staff,1,7,30,29
1650066811345,MATH 18,B03,083750,Staff,0,6,30,30
1650066811345,MATH 18,B04,083751,Staff,1,8,30,29
1650066817369,MATH 20A,A01,083754,Staff,26,0,40,14
1650066823395,MATH 20B,A01,083756,Staff,0,5,30,30
1650066823395,MATH 20B,A02,083757,Staff,0,1,30,30
1650066829422,MATH 20C,A01,083760,Staff,0,10,30,30
1650066829422,MATH 20C,A02,083761,Staff,0,12,30,30
1650066829422,MATH 20C,B01,083762,Staff,16,0,30,14
1650066829422,MATH 20C,B02,083763,Staff,28,0,30,2
1650066835446,MATH 20D,A01,083765,Staff,0,2,30,30
1650066835446,MATH 20D,A02,083766,Staff,14,0,30,16
1650066835446,MATH 20D,A03,083767,Staff,28,0,30,2
1650066841473,MATH 20E,A01,083771,Staff,10,0,30,20
1650066841473,MATH 20E,A02,083772,Staff,20,0,30,10
1650066841473,MATH 20E,B01,083773,Staff,2,2,30,28
1650066841473,MATH 20E,B02,083774,Staff,17,0,30,13
1650066847501,MATH 103A,A01,083777,Staff,0,8,30,30
1650066847501,MATH 103A,A02,083778,Staff,0,7,30,30
1650066847501,MATH 103A,B01,083779,Staff,0,8,30,30
1650066847501,MATH 103A,B02,083780,Staff,0,6,30,30
1650066853527,MATH 105,A01,085443,Staff,1,12,30,29
1650066859551,MATH 109,A01,083213,Anzaldo; Leesa B,1,4,30,29
1650066859551,MATH 109,A02,083214,Anzaldo; Leesa B,0,4,30,30
1650066859551,MATH 109,B01,083215,Anzaldo; Leesa B,0,2,30,30
1650066859551,MATH 109,B02,083216,Anzaldo; Leesa B,1,3,30,29
1650066865574,MATH 142A,A01,083219,Chow; Bennett,0,10,30,30
1650066865574,MATH 142A,A02,083220,Chow; Bennett,0,9,30,30
1650066865574,MATH 142A,B01,083221,Chow; Bennett,0,9,30,30
1650066865574,MATH 142A,B02,083222,Chow; Bennett,0,9,30,30
1650066871608,MATH 193A,A01,083224,Staff,0,4,30,30
1650066871608,MATH 193A,A02,083225,Staff,0,4,30,30
1650066871608,MATH 193A,A03,083781,Staff,0,0,30,30
1650066871608,MATH 193A,A04,083782,Staff,8,0,30,22
1650066877639,MATH 197,001,091859,McAuley; Julian John,9998,0,9999,1
1650066883705,COGS 9,A01,083615,Staff,3,17,60,57
1650066889729,COGS 11,A01,083617,Boyle; Mary E. T.,24,0,40,16
1650066895756,COGS 13,A01,083071,Staff,0,28,40,40
1650066901789,COGS 14A,A01,092681,Staff,0,10,100,100
1650066907813,COGS 14B,A01,083073,Cheng; Tzu-Han,0,4,50,50
1650066913836,COGS 17,A01,092677,Staff,35,0,75,40
1650066919870,COGS 100,A01,083619,Staff,0,19,60,60
1650066925897,COGS 101A,A01,083621,Davis; Joshua Daniel,0,16,60,60
1650066931924,COGS 101B,A01,091572,Staff,13,0,60,47
1650066937948,COGS 101C,A01,083625,Delgado; Tania,21,0,30,9
1650066943986,COGS 107A,A01,083627,Boyle; Mary E. T.,1,3,60,59
1650066950010,COGS 118A,A01,083075,Staff,18,0,60,42
1650066956037,CSE 3,A50,083646,Miranda; Gregory Joseph,22,0,38,16
1650066956037,CSE 3,A51,083647,Miranda; Gregory Joseph,37,0,37,0
1650066962064,CSE 8A,A50,083650,Miranda; Gregory Joseph,0,16,40,40
1650066968096,CSE 11,A01,083080,Cao; Yingjun,0,64,40,40
1650066974127,CSE 12,A01,083652,Staff,0,2,100,100
1650066980156,CSE 15L,A01,083654,Staff,0,0,50,50
1650066980156,CSE 15L,A02,083655,Staff,10,0,50,40
1650066986179,CSE 20,A01,083657,Staff,58,0,80,22
1650066992205,CSE 30,A01,083084,Eldon; John,0,63,40,40
1650066998231,CSE 100,A01,083659,Cao; Yingjun,0,58,50,50
1650067004261,CSE 134B,A01,083661,Powell; Thomas Allan,1,27,65,64
1650067010284,CSE 140,A01,083663,Staff,6,0,75,69
1650067016306,CSE 140L,A01,083088,Eldon; John,1,0,75,74
1650067022329,CSE 175,A01,083665,Kumar; Rakesh,9,0,25,16
1650067028351,CSE 190,A00,092507,Dubnov; Shlomo,14,0,20,6
1650067034377,ECE 45,A01,083139,Staff,0,13,40,40
1650067040402,ECE 65,A50,083695,Staff,0,3,30,30
1650067046426,ECE 109,A01,091882,Touri; Behrouz,48,0,70,22
1650067052449,ECE 180,A00,083140,Abi Samra; Nicholas Camill,24,0,30,6
1650067052449,ECE 180,B00,083141,Abi Samra; Nicholas Camill,8,0,30,22
1650067058471,MATH 10A,A01,083735,Patchell; Gregory David,12,0,30,18
1650067058471,MATH 10A,A02,083736,Patchell; Gregory David,28,0,30,2
1650067058471,MATH 10A,A03,083737,Patchell; Gregory David,27,0,30,3
1650067064499,MATH 10B,A01,083207,Staff,0,5,30,30
1650067064499,MATH 10B,A02,083208,Staff,0,3,30,30
1650067064499,MATH 10B,B01,083739,Staff,18,0,30,12
1650067064499,MATH 10B,B02,083740,Staff,30,0,30,0
1650067070528,MATH 18,A01,083743,Staff,10,0,30,20
1650067070528,MATH 18,A02,083744,Staff,28,0,30,2
1650067070528,MATH 18,A03,083745,Staff,23,0,30,7
1650067070528,MATH 18,A04,083746,Staff,27,0,30,3
1650067070528,MATH 18,B01,083748,Staff,0,9,30,30
1650067070528,MATH 18,B02,083749,Staff,1,7,30,29
1650067070528,MATH 18,B03,083750,Staff,0,6,30,30
1650067070528,MATH 18,B04,083751,Staff,1,8,30,29
1650067076552,MATH 20A,A01,083754,Staff,26,0,40,14
1650067082583,MATH 20B,A01,083756,Staff,0,5,30,30
1650067082583,MATH 20B,A02,083757,Staff,0,1,30,30
1650067088610,MATH 20C,A01,083760,Staff,0,10,30,30
1650067088610,MATH 20C,A02,083761,Staff,0,12,30,30
1650067088610,MATH 20C,B01,083762,Staff,16,0,30,14
1650067088610,MATH 20C,B02,083763,Staff,28,0,30,2
1650067094635,MATH 20D,A01,083765,Staff,0,2,30,30
1650067094635,MATH 20D,A02,083766,Staff,14,0,30,16
1650067094635,MATH 20D,A03,083767,Staff,28,0,30,2
1650067100660,MATH 20E,A01,083771,Staff,10,0,30,20
1650067100660,MATH 20E,A02,083772,Staff,20,0,30,10
1650067100660,MATH 20E,B01,083773,Staff,2,2,30,28
1650067100660,MATH 20E,B02,083774,Staff,17,0,30,13
1650067106685,MATH 103A,A01,083777,Staff,0,8,30,30
1650067106685,MATH 103A,A02,083778,Staff,0,7,30,30
1650067106685,MATH 103A,B01,083779,Staff,0,8,30,30
1650067106685,MATH 103A,B02,083780,Staff,0,6,30,30
1650067112709,MATH 105,A01,085443,Staff,1,12,30,29
1650067118739,MATH 109,A01,083213,Anzaldo; Leesa B,1,4,30,29
1650067118739,MATH 109,A02,083214,Anzaldo; Leesa B,0,4,30,30
1650067118739,MATH 109,B01,083215,Anzaldo; Leesa B,0,2,30,30
1650067118739,MATH 109,B02,083216,Anzaldo; Leesa B,1,3,30,29
1650067124763,MATH 142A,A01,083219,Chow; Bennett,0,10,30,30
1650067124763,MATH 142A,A02,083220,Chow; Bennett,0,9,30,30
1650067124763,MATH 142A,B01,083221,Chow; Bennett,0,9,30,30
1650067124763,MATH 142A,B02,083222,Chow; Bennett,0,9,30,30
1650067130787,MATH 193A,A01,083224,Staff,0,4,30,30
1650067130787,MATH 193A,A02,083225,Staff,0,4,30,30
1650067130787,MATH 193A,A03,083781,Staff,0,0,30,30
1650067130787,MATH 193A,A04,083782,Staff,8,0,30,22
1650067136810,MATH 197,001,091859,McAuley; Julian John,9998,0,9999,1
1650067142881,COGS 9,A01,083615,Staff,3,17,60,57
1650067148907,COGS 11,A01,083617,Boyle; Mary E. T.,24,0,40,16
1650067154933,COGS 13,A01,083071,Staff,0,28,40,40
1650067160959,COGS 14A,A01,092681,Staff,0,10,100,100
1650067166982,COGS 14B,A01,083073,Cheng; Tzu-Han,0,4,50,50
1650067173004,COGS 17,A01,092677,Staff,35,0,75,40
1650067179029,COGS 100,A01,083619,Staff,0,19,60,60
1650067185059,COGS 101A,A01,083621,Davis; Joshua Daniel,0,16,60,60
1650067191083,COGS 101B,A01,091572,Staff,13,0,60,47
1650067197108,COGS 101C,A01,083625,Delgado; Tania,21,0,30,9
1650067203130,COGS 107A,A01,083627,Boyle; Mary E. T.,1,3,60,59
1650067209154,COGS 118A,A01,083075,Staff,18,0,60,42
1650067215196,CSE 3,A50,083646,Miranda; Gregory Joseph,22,0,38,16
1650067215196,CSE 3,A51,083647,Miranda; Gregory Joseph,37,0,37,0
1650067221220,CSE 8A,A50,083650,Miranda; Gregory Joseph,0,16,40,40
1650067227250,CSE 11,A01,083080,Cao; Yingjun,0,64,40,40
1650067233299,CSE 12,A01,083652,Staff,0,2,100,100
1650067239326,CSE 15L,A01,083654,Staff,0,0,50,50
1650067239326,CSE 15L,A02,083655,Staff,10,0,50,40
1650067245351,CSE 20,A01,083657,Staff,58,0,80,22
1650067251386,CSE 30,A01,083084,Eldon; John,0,63,40,40
1650067257409,CSE 100,A01,083659,Cao; Yingjun,0,58,50,50
1650067263459,CSE 134B,A01,083661,Powell; Thomas Allan,1,27,65,64
1650067269483,CSE 140,A01,083663,Staff,6,0,75,69
1650067275517,CSE 140L,A01,083088,Eldon; John,1,0,75,74
1650067281555,CSE 175,A01,083665,Kumar; Rakesh,9,0,25,16
1650067287582,CSE 190,A00,092507,Dubnov; Shlomo,14,0,20,6
1650067293608,ECE 45,A01,083139,Staff,0,13,40,40
1650067299631,ECE 65,A50,083695,Staff,0,3,30,30
1650067305657,ECE 109,A01,091882,Touri; Behrouz,48,0,70,22
1650067311680,ECE 180,A00,083140,Abi Samra; Nicholas Camill,24,0,30,6
1650067311680,ECE 180,B00,083141,Abi Samra; Nicholas Camill,8,0,30,22
1650067317807,MATH 10A,A01,083735,Patchell; Gregory David,12,0,30,18
1650067317807,MATH 10A,A02,083736,Patchell; Gregory David,28,0,30,2
1650067317807,MATH 10A,A03,083737,Patchell; Gregory David,27,0,30,3
1650067323838,MATH 10B,A01,083207,Staff,0,5,30,30
1650067323838,MATH 10B,A02,083208,Staff,0,3,30,30
1650067323838,MATH 10B,B01,083739,Staff,18,0,30,12
1650067323838,MATH 10B,B02,083740,Staff,30,0,30,0
1650067329882,MATH 18,A01,083743,Staff,10,0,30,20
1650067329882,MATH 18,A02,083744,Staff,28,0,30,2
1650067329882,MATH 18,A03,083745,Staff,23,0,30,7
1650067329882,MATH 18,A04,083746,Staff,27,0,30,3
1650067329882,MATH 18,B01,083748,Staff,0,9,30,30
1650067329882,MATH 18,B02,083749,Staff,1,7,30,29
1650067329882,MATH 18,B03,083750,Staff,0,6,30,30
1650067329882,MATH 18,B04,083751,Staff,1,8,30,29
1650067335910,MATH 20A,A01,083754,Staff,26,0,40,14
1650067341934,MATH 20B,A01,083756,Staff,0,5,30,30
1650067341934,MATH 20B,A02,083757,Staff,0,1,30,30
1650067347959,MATH 20C,A01,083760,Staff,0,10,30,30
1650067347959,MATH 20C,A02,083761,Staff,0,12,30,30
1650067347959,MATH 20C,B01,083762,Staff,16,0,30,14
1650067347959,MATH 20C,B02,083763,Staff,28,0,30,2
1650067353985,MATH 20D,A01,083765,Staff,0,2,30,30
1650067353985,MATH 20D,A02,083766,Staff,14,0,30,16
1650067353985,MATH 20D,A03,083767,Staff,28,0,30,2
1650067360018,MATH 20E,A01,083771,Staff,10,0,30,20
1650067360018,MATH 20E,A02,083772,Staff,20,0,30,10
1650067360018,MATH 20E,B01,083773,Staff,2,2,30,28
1650067360018,MATH 20E,B02,083774,Staff,17,0,30,13
1650067366064,MATH 103A,A01,083777,Staff,0,8,30,30
1650067366064,MATH 103A,A02,083778,Staff,0,7,30,30
1650067366064,MATH 103A,B01,083779,Staff,0,8,30,30
1650067366064,MATH 103A,B02,083780,Staff,0,6,30,30
1650067372088,MATH 105,A01,085443,Staff,1,12,30,29
1650067378123,MATH 109,A01,083213,Anzaldo; Leesa B,1,4,30,29
1650067378123,MATH 109,A02,083214,Anzaldo; Leesa B,0,4,30,30
1650067378123,MATH 109,B01,083215,Anzaldo; Leesa B,0,2,30,30
1650067378123,MATH 109,B02,083216,Anzaldo; Leesa B,1,3,30,29
1650067384165,MATH 142A,A01,083219,Chow; Bennett,0,10,30,30
1650067384165,MATH 142A,A02,083220,Chow; Bennett,0,9,30,30
1650067384165,MATH 142A,B01,083221,Chow; Bennett,0,9,30,30
1650067384165,MATH 142A,B02,083222,Chow; Bennett,0,9,30,30
1650067390195,MATH 193A,A01,083224,Staff,0,4,30,30
1650067390195,MATH 193A,A02,083225,Staff,0,4,30,30
1650067390195,MATH 193A,A03,083781,Staff,0,0,30,30
1650067390195,MATH 193A,A04,083782,Staff,8,0,30,22
1650067396222,MATH 197,001,091859,McAuley; Julian John,9998,0,9999,1
1650067402274,COGS 9,A01,083615,Staff,3,17,60,57
1650067408302,COGS 11,A01,083617,Boyle; Mary E. T.,24,0,40,16
1650067414330,COGS 13,A01,083071,Staff,0,28,40,40
1650067420356,COGS 14A,A01,092681,Staff,0,10,100,100
1650067426379,COGS 14B,A01,083073,Cheng; Tzu-Han,0,4,50,50
1650067432403,COGS 17,A01,092677,Staff,35,0,75,40
1650067438430,COGS 100,A01,083619,Staff,0,19,60,60
1650067444512,COGS 101A,A01,083621,Davis; Joshua Daniel,0,16,60,60
1650067450539,COGS 101B,A01,091572,Staff,13,0,60,47
1650067456564,COGS 101C,A01,083625,Delgado; Tania,21,0,30,9
1650067462590,COGS 107A,A01,083627,Boyle; Mary E. T.,1,3,60,59
1650067468617,COGS 118A,A01,083075,Staff,18,0,60,42
1650067474639,CSE 3,A50,083646,Miranda; Gregory Joseph,22,0,38,16
1650067474639,CSE 3,A51,083647,Miranda; Gregory Joseph,37,0,37,0
1650067480667,CSE 8A,A50,083650,Miranda; Gregory Joseph,0,16,40,40
1650067486694,CSE 11,A01,083080,Cao; Yingjun,0,64,40,40
1650067492718,CSE 12,A01,083652,Staff,0,2,100,100
1650067498741,CSE 15L,A01,083654,Staff,0,0,50,50
1650067498741,CSE 15L,A02,083655,Staff,10,0,50,40
1650067504763,CSE 20,A01,083657,Staff,58,0,80,22
1650067510793,CSE 30,A01,083084,Eldon; John,0,63,40,40
1650067516826,CSE 100,A01,083659,Cao; Yingjun,0,58,50,50
1650067522850,CSE 134B,A01,083661,Powell; Thomas Allan,1,27,65,64
1650067528880,CSE 140,A01,083663,Staff,6,0,75,69
1650067534904,CSE 140L,A01,083088,Eldon; John,1,0,75,74
1650067540934,CSE 175,A01,083665,Kumar; Rakesh,9,0,25,16
1650067547010,CSE 190,A00,092507,Dubnov; Shlomo,14,0,20,6
1650067553039,ECE 45,A01,083139,Staff,0,13,40,40
1650067559065,ECE 65,A50,083695,Staff,0,3,30,30
1650067565088,ECE 109,A01,091882,Touri; Behrouz,48,0,70,22
1650067571117,ECE 180,A00,083140,Abi Samra; Nicholas Camill,24,0,30,6
1650067571117,ECE 180,B00,083141,Abi Samra; Nicholas Camill,8,0,30,22
1650067577139,MATH 10A,A01,083735,Patchell; Gregory David,12,0,30,18
1650067577139,MATH 10A,A02,083736,Patchell; Gregory David,28,0,30,2
1650067577139,MATH 10A,A03,083737,Patchell; Gregory David,27,0,30,3
1650067583164,MATH 10B,A01,083207,Staff,0,5,30,30
1650067583164,MATH 10B,A02,083208,Staff,0,3,30,30
1650067583164,MATH 10B,B01,083739,Staff,18,0,30,12
1650067583164,MATH 10B,B02,083740,Staff,30,0,30,0
1650067589190,MATH 18,A01,083743,Staff,10,0,30,20
1650067589190,MATH 18,A02,083744,Staff,28,0,30,2
1650067589190,MATH 18,A03,083745,Staff,23,0,30,7
1650067589190,MATH 18,A04,083746,Staff,27,0,30,3
1650067589190,MATH 18,B01,083748,Staff,0,9,30,30
1650067589190,MATH 18,B02,083749,Staff,1,7,30,29
1650067589190,MATH 18,B03,083750,Staff,0,6,30,30
1650067589190,MATH 18,B04,083751,Staff,1,8,30,29
1650067595212,MATH 20A,A01,083754,Staff,26,0,40,14
1650067601239,MATH 20B,A01,083756,Staff,0,5,30,30
1650067601239,MATH 20B,A02,083757,Staff,0,1,30,30
1650067607260,MATH 20C,A01,083760,Staff,0,10,30,30
1650067607260,MATH 20C,A02,083761,Staff,0,12,30,30
1650067607260,MATH 20C,B01,083762,Staff,16,0,30,14
1650067607260,MATH 20C,B02,083763,Staff,28,0,30,2
1650067613292,MATH 20D,A01,083765,Staff,0,2,30,30
1650067613292,MATH 20D,A02,083766,Staff,14,0,30,16
1650067613292,MATH 20D,A03,083767,Staff,28,0,30,2
1650067619320,MATH 20E,A01,083771,Staff,10,0,30,20
1650067619320,MATH 20E,A02,083772,Staff,20,0,30,10
1650067619320,MATH 20E,B01,083773,Staff,2,2,30,28
1650067619320,MATH 20E,B02,083774,Staff,17,0,30,13
1650067625342,MATH 103A,A01,083777,Staff,0,8,30,30
1650067625342,MATH 103A,A02,083778,Staff,0,7,30,30
1650067625342,MATH 103A,B01,083779,Staff,0,8,30,30
1650067625342,MATH 103A,B02,083780,Staff,0,7,30,30
1650067631370,MATH 105,A01,085443,Staff,1,12,30,29
1650067637394,MATH 109,A01,083213,Anzaldo; Leesa B,1,4,30,29
1650067637394,MATH 109,A02,083214,Anzaldo; Leesa B,0,4,30,30
1650067637394,MATH 109,B01,083215,Anzaldo; Leesa B,0,2,30,30
1650067637394,MATH 109,B02,083216,Anzaldo; Leesa B,1,3,30,29
1650067643419,MATH 142A,A01,083219,Chow; Bennett,0,10,30,30
1650067643419,MATH 142A,A02,083220,Chow; Bennett,0,9,30,30
1650067643419,MATH 142A,B01,083221,Chow; Bennett,0,10,30,30
1650067643419,MATH 142A,B02,083222,Chow; Bennett,0,9,30,30
1650067649444,MATH 193A,A01,083224,Staff,0,4,30,30
1650067649444,MATH 193A,A02,083225,Staff,0,4,30,30
1650067649444,MATH 193A,A03,083781,Staff,0,0,30,30
1650067649444,MATH 193A,A04,083782,Staff,7,0,30,23
1650067655470,MATH 197,001,091859,McAuley; Julian John,9998,0,9999,1
1650067661527,COGS 9,A01,083615,Staff,3,17,60,57
1650067667567,COGS 11,A01,083617,Boyle; Mary E. T.,24,0,40,16
1650067673594,COGS 13,A01,083071,Staff,0,28,40,40
1650067679618,COGS 14A,A01,092681,Staff,0,10,100,100
1650067685652,COGS 14B,A01,083073,Cheng; Tzu-Han,0,4,50,50
1650067691690,COGS 17,A01,092677,Staff,35,0,75,40
1650067697716,COGS 100,A01,083619,Staff,0,19,60,60
1650067703743,COGS 101A,A01,083621,Davis; Joshua Daniel,0,16,60,60
1650067709776,COGS 101B,A01,091572,Staff,13,0,60,47
1650067715822,COGS 101C,A01,083625,Delgado; Tania,21,0,30,9
1650067721846,COGS 107A,A01,083627,Boyle; Mary E. T.,1,3,60,59
1650067727870,COGS 118A,A01,083075,Staff,18,0,60,42
1650067733896,CSE 3,A50,083646,Miranda; Gregory Joseph,22,0,38,16
1650067733896,CSE 3,A51,083647,Miranda; Gregory Joseph,37,0,37,0
1650067739919,CSE 8A,A50,083650,Miranda; Gregory Joseph,0,16,40,40
1650067745943,CSE 11,A01,083080,Cao; Yingjun,0,64,40,40
1650067751968,CSE 12,A01,083652,Staff,0,2,100,100
1650067757990,CSE 15L,A01,083654,Staff,0,0,50,50
1650067757990,CSE 15L,A02,083655,Staff,10,0,50,40
1650067764018,CSE 20,A01,083657,Staff,58,0,80,22
1650067770040,CSE 30,A01,083084,Eldon; John,0,63,40,40
1650067776065,CSE 100,A01,083659,Cao; Yingjun,0,58,50,50
1650067782093,CSE 134B,A01,083661,Powell; Thomas Allan,1,27,65,64
1650067788116,CSE 140,A01,083663,Staff,6,0,75,69
1650067794139,CSE 140L,A01,083088,Eldon; John,1,0,75,74
1650067800167,CSE 175,A01,083665,Kumar; Rakesh,9,0,25,16
1650067806204,CSE 190,A00,092507,Dubnov; Shlomo,14,0,20,6
1650067812228,ECE 45,A01,083139,Staff,0,13,40,40
1650067818252,ECE 65,A50,083695,Staff,0,3,30,30
1650067824279,ECE 109,A01,091882,Touri; Behrouz,48,0,70,22
1650067830311,ECE 180,A00,083140,Abi Samra; Nicholas Camill,24,0,30,6
1650067830311,ECE 180,B00,083141,Abi Samra; Nicholas Camill,8,0,30,22
1650067836338,MATH 10A,A01,083735,Patchell; Gregory David,12,0,30,18
1650067836338,MATH 10A,A02,083736,Patchell; Gregory David,28,0,30,2
1650067836338,MATH 10A,A03,083737,Patchell; Gregory David,27,0,30,3
1650067842367,MATH 10B,A01,083207,Staff,0,5,30,30
1650067842367,MATH 10B,A02,083208,Staff,0,3,30,30
1650067842367,MATH 10B,B01,083739,Staff,18,0,30,12
1650067842367,MATH 10B,B02,083740,Staff,30,0,30,0
1650067848398,MATH 18,A01,083743,Staff,10,0,30,20
1650067848398,MATH 18,A02,083744,Staff,28,0,30,2
1650067848398,MATH 18,A03,083745,Staff,23,0,30,7
1650067848398,MATH 18,A04,083746,Staff,27,0,30,3
1650067848398,MATH 18,B01,083748,Staff,0,9,30,30
1650067848398,MATH 18,B02,083749,Staff,1,7,30,29
1650067848398,MATH 18,B03,083750,Staff,0,6,30,30
1650067848398,MATH 18,B04,083751,Staff,1,8,30,29
1650067854422,MATH 20A,A01,083754,Staff,26,0,40,14
1650067860451,MATH 20B,A01,083756,Staff,0,5,30,30
1650067860451,MATH 20B,A02,083757,Staff,0,1,30,30
1650067866475,MATH 20C,A01,083760,Staff,0,10,30,30
1650067866475,MATH 20C,A02,083761,Staff,0,12,30,30
1650067866475,MATH 20C,B01,083762,Staff,16,0,30,14
1650067866475,MATH 20C,B02,083763,Staff,28,0,30,2
1650067872504,MATH 20D,A01,083765,Staff,0,2,30,30
1650067872504,MATH 20D,A02,083766,Staff,14,0,30,16
1650067872504,MATH 20D,A03,083767,Staff,28,0,30,2
1650067878533,MATH 20E,A01,083771,Staff,10,0,30,20
1650067878533,MATH 20E,A02,083772,Staff,20,0,30,10
1650067878533,MATH 20E,B01,083773,Staff,2,2,30,28
1650067878533,MATH 20E,B02,083774,Staff,17,0,30,13
1650067884557,MATH 103A,A01,083777,Staff,0,8,30,30
1650067884557,MATH 103A,A02,083778,Staff,0,7,30,30
1650067884557,MATH 103A,B01,083779,Staff,0,8,30,30
1650067884557,MATH 103A,B02,083780,Staff,0,7,30,30
1650067890592,MATH 105,A01,085443,Staff,1,12,30,29
1650067896625,MATH 109,A01,083213,Anzaldo; Leesa B,1,4,30,29
1650067896625,MATH 109,A02,083214,Anzaldo; Leesa B,0,4,30,30
1650067896625,MATH 109,B01,083215,Anzaldo; Leesa B,0,2,30,30
1650067896625,MATH 109,B02,083216,Anzaldo; Leesa B,1,3,30,29
1650067902663,MATH 142A,A01,083219,Chow; Bennett,0,10,30,30
1650067902663,MATH 142A,A02,083220,Chow; Bennett,0,9,30,30
1650067902663,MATH 142A,B01,083221,Chow; Bennett,0,10,30,30
1650067902663,MATH 142A,B02,083222,Chow; Bennett,0,9,30,30
1650067908693,MATH 193A,A01,083224,Staff,0,4,30,30
1650067908693,MATH 193A,A02,083225,Staff,0,4,30,30
1650067908693,MATH 193A,A03,083781,Staff,0,0,30,30
1650067908693,MATH 193A,A04,083782,Staff,6,0,30,24
1650067914814,MATH 197,001,091859,McAuley; Julian John,9998,0,9999,1
1650067920875,COGS 9,A01,083615,Staff,3,17,60,57
1650067926904,COGS 11,A01,083617,Boyle; Mary E. T.,24,0,40,16
1650067932935,COGS 13,A01,083071,Staff,0,28,40,40
1650067938958,COGS 14A,A01,092681,Staff,0,10,100,100
1650067944985,COGS 14B,A01,083073,Cheng; Tzu-Han,0,4,50,50
1650067951009,COGS 17,A01,092677,Staff,35,0,75,40
1650067957033,COGS 100,A01,083619,Staff,0,19,60,60
1650067963062,COGS 101A,A01,083621,Davis; Joshua Daniel,0,16,60,60
1650067969086,COGS 101B,A01,091572,Staff,13,0,60,47
1650067975115,COGS 101C,A01,083625,Delgado; Tania,21,0,30,9
1650067981139,COGS 107A,A01,083627,Boyle; Mary E. T.,1,3,60,59
1650067987166,COGS 118A,A01,083075,Staff,18,0,60,42
1650067993192,CSE 3,A50,083646,Miranda; Gregory Joseph,22,0,38,16
1650067993192,CSE 3,A51,083647,Miranda; Gregory Joseph,37,0,37,0
1650067999220,CSE 8A,A50,083650,Miranda; Gregory Joseph,0,15,40,40
1650068005244,CSE 11,A01,083080,Cao; Yingjun,0,65,40,40
1650068011268,CSE 12,A01,083652,Staff,0,2,100,100
1650068017294,CSE 15L,A01,083654,Staff,0,0,50,50
1650068017294,CSE 15L,A02,083655,Staff,10,0,50,40
1650068023318,CSE 20,A01,083657,Staff,58,0,80,22
1650068029344,CSE 30,A01,083084,Eldon; John,0,63,40,40
1650068035367,CSE 100,A01,083659,Cao; Yingjun,0,58,50,50
1650068041399,CSE 134B,A01,083661,Powell; Thomas Allan,1,27,65,64
1650068047432,CSE 140,A01,083663,Staff,6,0,75,69
1650068053459,CSE 140L,A01,083088,Eldon; John,1,0,75,74
1650068059486,CSE 175,A01,083665,Kumar; Rakesh,9,0,25,16
1650068065513,CSE 190,A00,092507,Dubnov; Shlomo,14,0,20,6
1650068071546,ECE 45,A01,083139,Staff,0,13,40,40
1650068077570,ECE 65,A50,083695,Staff,0,3,30,30
1650068083594,ECE 109,A01,091882,Touri; Behrouz,48,0,70,22
1650068089619,ECE 180,A00,083140,Abi Samra; Nicholas Camill,24,0,30,6
1650068089619,ECE 180,B00,083141,Abi Samra; Nicholas Camill,8,0,30,22
1650068095653,MATH 10A,A01,083735,Patchell; Gregory David,12,0,30,18
1650068095653,MATH 10A,A02,083736,Patchell; Gregory David,28,0,30,2
1650068095653,MATH 10A,A03,083737,Patchell; Gregory David,27,0,30,3
1650068101677,MATH 10B,A01,083207,Staff,0,5,30,30
1650068101677,MATH 10B,A02,083208,Staff,0,3,30,30
1650068101677,MATH 10B,B01,083739,Staff,18,0,30,12
1650068101677,MATH 10B,B02,083740,Staff,30,0,30,0
1650068107702,MATH 18,A01,083743,Staff,10,0,30,20
1650068107702,MATH 18,A02,083744,Staff,28,0,30,2
1650068107702,MATH 18,A03,083745,Staff,23,0,30,7
1650068107702,MATH 18,A04,083746,Staff,27,0,30,3
1650068107702,MATH 18,B01,083748,Staff,0,9,30,30
1650068107702,MATH 18,B02,083749,Staff,1,7,30,29
1650068107702,MATH 18,B03,083750,Staff,0,6,30,30
1650068107702,MATH 18,B04,083751,Staff,1,8,30,29
1650068113728,MATH 20A,A01,083754,Staff,26,0,40,14
1650068119754,MATH 20B,A01,083756,Staff,0,5,30,30
1650068119754,MATH 20B,A02,083757,Staff,0,1,30,30
1650068125780,MATH 20C,A01,083760,Staff,0,10,30,30
1650068125780,MATH 20C,A02,083761,Staff,0,12,30,30
1650068125780,MATH 20C,B01,083762,Staff,16,0,30,14
1650068125780,MATH 20C,B02,083763,Staff,28,0,30,2
1650068131804,MATH 20D,A01,083765,Staff,0,2,30,30
1650068131804,MATH 20D,A02,083766,Staff,14,0,30,16
1650068131804,MATH 20D,A03,083767,Staff,28,0,30,2
1650068137831,MATH 20E,A01,083771,Staff,10,0,30,20
1650068137831,MATH 20E,A02,083772,Staff,20,0,30,10
1650068137831,MATH 20E,B01,083773,Staff,2,2,30,28
1650068137831,MATH 20E,B02,083774,Staff,17,0,30,13
1650068143855,MATH 103A,A01,083777,Staff,0,8,30,30
1650068143855,MATH 103A,A02,083778,Staff,0,7,30,30
1650068143855,MATH 103A,B01,083779,Staff,0,8,30,30
1650068143855,MATH 103A,B02,083780,Staff,1,7,30,29
1650068149878,MATH 105,A01,085443,Staff,1,12,30,29
1650068155901,MATH 109,A01,083213,Anzaldo; Leesa B,1,4,30,29
1650068155901,MATH 109,A02,083214,Anzaldo; Leesa B,0,4,30,30
1650068155901,MATH 109,B01,083215,Anzaldo; Leesa B,0,2,30,30
1650068155901,MATH 109,B02,083216,Anzaldo; Leesa B,1,3,30,29
1650068161925,MATH 142A,A01,083219,Chow; Bennett,0,10,30,30
1650068161925,MATH 142A,A02,083220,Chow; Bennett,0,9,30,30
1650068161925,MATH 142A,B01,083221,Chow; Bennett,0,10,30,30
1650068161925,MATH 142A,B02,083222,Chow; Bennett,0,9,30,30
1650068167949,MATH 193A,A01,083224,Staff,0,4,30,30
1650068167949,MATH 193A,A02,083225,Staff,0,4,30,30
1650068167949,MATH 193A,A03,083781,Staff,0,0,30,30
1650068167949,MATH 193A,A04,083782,Staff,6,0,30,24
1650068173977,MATH 197,001,091859,McAuley; Julian John,9998,0,9999,1
1650068180039,COGS 9,A01,083615,Staff,3,17,60,57
1650068186063,COGS 11,A01,083617,Boyle; Mary E. T.,24,0,40,16
1650068192101,COGS 13,A01,083071,Staff,0,28,40,40
1650068198124,COGS 14A,A01,092681,Staff,0,10,100,100
1650068204146,COGS 14B,A01,083073,Cheng; Tzu-Han,0,4,50,50
1650068210171,COGS 17,A01,092677,Staff,35,0,75,40
1650068216195,COGS 100,A01,083619,Staff,0,19,60,60
1650068222218,COGS 101A,A01,083621,Davis; Joshua Daniel,0,16,60,60
1650068228243,COGS 101B,A01,091572,Staff,13,0,60,47
1650068234276,COGS 101C,A01,083625,Delgado; Tania,21,0,30,9
1650068240302,COGS 107A,A01,083627,Boyle; Mary E. T.,1,3,60,59
1650068246333,COGS 118A,A01,083075,Staff,18,0,60,42
1650068252361,CSE 3,A50,083646,Miranda; Gregory Joseph,22,0,38,16
1650068252361,CSE 3,A51,083647,Miranda; Gregory Joseph,37,0,37,0
1650068258396,CSE 8A,A50,083650,Miranda; Gregory Joseph,0,15,40,40
1650068264419,CSE 11,A01,083080,Cao; Yingjun,0,65,40,40
1650068270455,CSE 12,A01,083652,Staff,0,2,100,100
1650068276482,CSE 15L,A01,083654,Staff,0,0,50,50
1650068276482,CSE 15L,A02,083655,Staff,10,0,50,40
1650068282505,CSE 20,A01,083657,Staff,58,0,80,22
1650068288528,CSE 30,A01,083084,Eldon; John,0,63,40,40
1650068294552,CSE 100,A01,083659,Cao; Yingjun,0,58,50,50
1650068300583,CSE 134B,A01,083661,Powell; Thomas Allan,1,27,65,64
1650068306610,CSE 140,A01,083663,Staff,6,0,75,69
1650068312645,CSE 140L,A01,083088,Eldon; John,1,0,75,74
1650068318680,CSE 175,A01,083665,Kumar; Rakesh,9,0,25,16
1650068324706,CSE 190,A00,092507,Dubnov; Shlomo,14,0,20,6
1650068330729,ECE 45,A01,083139,Staff,0,13,40,40
1650068336750,ECE 65,A50,083695,Staff,0,3,30,30
1650068342773,ECE 109,A01,091882,Touri; Behrouz,48,0,70,22
1650068348800,ECE 180,A00,083140,Abi Samra; Nicholas Camill,24,0,30,6
1650068348800,ECE 180,B00,083141,Abi Samra; Nicholas Camill,8,0,30,22
1650068354826,MATH 10A,A01,083735,Patchell; Gregory David,12,0,30,18
1650068354826,MATH 10A,A02,083736,Patchell; Gregory David,28,0,30,2
1650068354826,MATH 10A,A03,083737,Patchell; Gregory David,27,0,30,3
1650068360854,MATH 10B,A01,083207,Staff,0,5,30,30
1650068360854,MATH 10B,A02,083208,Staff,0,3,30,30
1650068360854,MATH 10B,B01,083739,Staff,18,0,30,12
1650068360854,MATH 10B,B02,083740,Staff,30,0,30,0
1650068366879,MATH 18,A01,083743,Staff,10,0,30,20
1650068366879,MATH 18,A02,083744,Staff,28,0,30,2
1650068366879,MATH 18,A03,083745,Staff,23,0,30,7
1650068366879,MATH 18,A04,083746,Staff,27,0,30,3
1650068366879,MATH 18,B01,083748,Staff,0,9,30,30
1650068366879,MATH 18,B02,083749,Staff,1,7,30,29
1650068366879,MATH 18,B03,083750,Staff,0,6,30,30
1650068366879,MATH 18,B04,083751,Staff,1,8,30,29
1650068372910,MATH 20A,A01,083754,Staff,26,0,40,14
1650068378936,MATH 20B,A01,083756,Staff,0,5,30,30
1650068378936,MATH 20B,A02,083757,Staff,0,1,30,30
1650068384958,MATH 20C,A01,083760,Staff,0,10,30,30
1650068384958,MATH 20C,A02,083761,Staff,0,12,30,30
1650068384958,MATH 20C,B01,083762,Staff,16,0,30,14
1650068384958,MATH 20C,B02,083763,Staff,28,0,30,2
1650068390989,MATH 20D,A01,083765,Staff,0,2,30,30
1650068390989,MATH 20D,A02,083766,Staff,14,0,30,16
1650068390989,MATH 20D,A03,083767,Staff,28,0,30,2
1650068397025,MATH 20E,A01,083771,Staff,10,0,30,20
1650068397025,MATH 20E,A02,083772,Staff,20,0,30,10
1650068397025,MATH 20E,B01,083773,Staff,2,2,30,28
1650068397025,MATH 20E,B02,083774,Staff,17,0,30,13
1650068403049,MATH 103A,A01,083777,Staff,0,8,30,30
1650068403049,MATH 103A,A02,083778,Staff,0,7,30,30
1650068403049,MATH 103A,B01,083779,Staff,0,8,30,30
1650068403049,MATH 103A,B02,083780,Staff,1,7,30,29
1650068409071,MATH 105,A01,085443,Staff,1,12,30,29
1650068415095,MATH 109,A01,083213,Anzaldo; Leesa B,1,4,30,29
1650068415095,MATH 109,A02,083214,Anzaldo; Leesa B,0,4,30,30
1650068415095,MATH 109,B01,083215,Anzaldo; Leesa B,0,2,30,30
1650068415095,MATH 109,B02,083216,Anzaldo; Leesa B,1,3,30,29
1650068421117,MATH 142A,A01,083219,Chow; Bennett,0,10,30,30
1650068421117,MATH 142A,A02,083220,Chow; Bennett,0,9,30,30
1650068421117,MATH 142A,B01,083221,Chow; Bennett,0,10,30,30
1650068421117,MATH 142A,B02,083222,Chow; Bennett,0,9,30,30
1650068427141,MATH 193A,A01,083224,Staff,0,4,30,30
1650068427141,MATH 193A,A02,083225,Staff,0,4,30,30
1650068427141,MATH 193A,A03,083781,Staff,0,0,30,30
1650068427141,MATH 193A,A04,083782,Staff,6,0,30,24
1650068433163,MATH 197,001,091859,McAuley; Julian John,9998,0,9999,1
1650068439220,COGS 9,A01,083615,Staff,3,17,60,57
1650068445242,COGS 11,A01,083617,Boyle; Mary E. T.,24,0,40,16
1650068451270,COGS 13,A01,083071,Staff,0,28,40,40
1650068457307,COGS 14A,A01,092681,Staff,0,10,100,100
1650068463332,COGS 14B,A01,083073,Cheng; Tzu-Han,0,4,50,50
1650068469360,COGS 17,A01,092677,Staff,35,0,75,40
1650068475383,COGS 100,A01,083619,Staff,0,19,60,60
1650068481416,COGS 101A,A01,083621,Davis; Joshua Daniel,0,16,60,60
1650068487443,COGS 101B,A01,091572,Staff,13,0,60,47
1650068493471,COGS 101C,A01,083625,Delgado; Tania,21,0,30,9
1650068499495,COGS 107A,A01,083627,Boyle; Mary E. T.,1,3,60,59
1650068505618,COGS 118A,A01,083075,Staff,18,0,60,42
1650068511641,CSE 3,A50,083646,Miranda; Gregory Joseph,22,0,38,16
1650068511641,CSE 3,A51,083647,Miranda; Gregory Joseph,37,0,37,0
1650068517666,CSE 8A,A50,083650,Miranda; Gregory Joseph,0,15,40,40
1650068523689,CSE 11,A01,083080,Cao; Yingjun,0,65,40,40
1650068529715,CSE 12,A01,083652,Staff,0,2,100,100
1650068535743,CSE 15L,A01,083654,Staff,0,0,50,50
1650068535743,CSE 15L,A02,083655,Staff,10,0,50,40
1650068541771,CSE 20,A01,083657,Staff,58,0,80,22
1650068547798,CSE 30,A01,083084,Eldon; John,0,63,40,40
1650068553822,CSE 100,A01,083659,Cao; Yingjun,0,58,50,50
1650068559846,CSE 134B,A01,083661,Powell; Thomas Allan,1,27,65,64
1650068565882,CSE 140,A01,083663,Staff,6,0,75,69
1650068571912,CSE 140L,A01,083088,Eldon; John,1,0,75,74
1650068577936,CSE 175,A01,083665,Kumar; Rakesh,9,0,25,16
1650068583964,CSE 190,A00,092507,Dubnov; Shlomo,14,0,20,6
1650068589992,ECE 45,A01,083139,Staff,0,13,40,40
1650068596016,ECE 65,A50,083695,Staff,0,3,30,30
1650068602039,ECE 109,A01,091882,Touri; Behrouz,48,0,70,22
1650068608065,ECE 180,A00,083140,Abi Samra; Nicholas Camill,24,0,30,6
1650068608065,ECE 180,B00,083141,Abi Samra; Nicholas Camill,8,0,30,22
1650068614090,MATH 10A,A01,083735,Patchell; Gregory David,12,0,30,18
1650068614090,MATH 10A,A02,083736,Patchell; Gregory David,28,0,30,2
1650068614090,MATH 10A,A03,083737,Patchell; Gregory David,27,0,30,3
1650068620128,MATH 10B,A01,083207,Staff,0,5,30,30
1650068620128,MATH 10B,A02,083208,Staff,0,3,30,30
1650068620128,MATH 10B,B01,083739,Staff,18,0,30,12
1650068620128,MATH 10B,B02,083740,Staff,30,0,30,0
1650068626172,MATH 18,A01,083743,Staff,10,0,30,20
1650068626172,MATH 18,A02,083744,Staff,28,0,30,2
1650068626172,MATH 18,A03,083745,Staff,23,0,30,7
1650068626172,MATH 18,A04,083746,Staff,27,0,30,3
1650068626172,MATH 18,B01,083748,Staff,0,9,30,30
1650068626172,MATH 18,B02,083749,Staff,1,7,30,29
1650068626172,MATH 18,B03,083750,Staff,0,6,30,30
1650068626172,MATH 18,B04,083751,Staff,1,8,30,29
1650068632204,MATH 20A,A01,083754,Staff,26,0,40,14
1650068638234,MATH 20B,A01,083756,Staff,0,5,30,30
1650068638234,MATH 20B,A02,083757,Staff,0,1,30,30
1650068644259,MATH 20C,A01,083760,Staff,0,10,30,30
1650068644259,MATH 20C,A02,083761,Staff,0,12,30,30
1650068644259,MATH 20C,B01,083762,Staff,16,0,30,14
1650068644259,MATH 20C,B02,083763,Staff,28,0,30,2
1650068650287,MATH 20D,A01,083765,Staff,0,2,30,30
1650068650287,MATH 20D,A02,083766,Staff,14,0,30,16
1650068650287,MATH 20D,A03,083767,Staff,28,0,30,2
1650068656309,MATH 20E,A01,083771,Staff,10,0,30,20
1650068656309,MATH 20E,A02,083772,Staff,20,0,30,10
1650068656309,MATH 20E,B01,083773,Staff,2,2,30,28
1650068656309,MATH 20E,B02,083774,Staff,17,0,30,13
1650068662334,MATH 103A,A01,083777,Staff,0,8,30,30
1650068662334,MATH 103A,A02,083778,Staff,0,7,30,30
1650068662334,MATH 103A,B01,083779,Staff,0,8,30,30
1650068662334,MATH 103A,B02,083780,Staff,1,7,30,29
1650068668359,MATH 105,A01,085443,Staff,1,12,30,29
1650068674384,MATH 109,A01,083213,Anzaldo; Leesa B,1,4,30,29
1650068674384,MATH 109,A02,083214,Anzaldo; Leesa B,0,4,30,30
1650068674384,MATH 109,B01,083215,Anzaldo; Leesa B,0,2,30,30
1650068674384,MATH 109,B02,083216,Anzaldo; Leesa B,1,3,30,29
1650068680409,MATH 142A,A01,083219,Chow; Bennett,0,10,30,30
1650068680409,MATH 142A,A02,083220,Chow; Bennett,0,9,30,30
1650068680409,MATH 142A,B01,083221,Chow; Bennett,0,10,30,30
1650068680409,MATH 142A,B02,083222,Chow; Bennett,0,9,30,30
1650068686437,MATH 193A,A01,083224,Staff,0,4,30,30
1650068686437,MATH 193A,A02,083225,Staff,0,4,30,30
1650068686437,MATH 193A,A03,083781,Staff,0,0,30,30
1650068686437,MATH 193A,A04,083782,Staff,6,0,30,24
1650068692466,MATH 197,001,091859,McAuley; Julian John,9998,0,9999,1
1650068698535,COGS 9,A01,083615,Staff,3,17,60,57
1650068704565,COGS 11,A01,083617,Boyle; Mary E. T.,24,0,40,16
1650068710588,COGS 13,A01,083071,Staff,0,28,40,40
1650068716612,COGS 14A,A01,092681,Staff,0,10,100,100
1650068722639,COGS 14B,A01,083073,Cheng; Tzu-Han,0,4,50,50
1650068728661,COGS 17,A01,092677,Staff,35,0,75,40
1650068734683,COGS 100,A01,083619,Staff,0,19,60,60
1650068740711,COGS 101A,A01,083621,Davis; Joshua Daniel,0,16,60,60
1650068746735,COGS 101B,A01,091572,Staff,13,0,60,47
1650068752761,COGS 101C,A01,083625,Delgado; Tania,21,0,30,9
1650068758789,COGS 107A,A01,083627,Boyle; Mary E. T.,1,3,60,59
1650068764826,COGS 118A,A01,083075,Staff,18,0,60,42
1650068770851,CSE 3,A50,083646,Miranda; Gregory Joseph,22,0,38,16
1650068770851,CSE 3,A51,083647,Miranda; Gregory Joseph,37,0,37,0
1650068776874,CSE 8A,A50,083650,Miranda; Gregory Joseph,0,15,40,40
1650068782901,CSE 11,A01,083080,Cao; Yingjun,0,65,40,40
1650068788928,CSE 12,A01,083652,Staff,0,2,100,100
1650068794956,CSE 15L,A01,083654,Staff,0,0,50,50
1650068794956,CSE 15L,A02,083655,Staff,10,0,50,40
1650068800979,CSE 20,A01,083657,Staff,58,0,80,22
1650068807003,CSE 30,A01,083084,Eldon; John,0,63,40,40
1650068813027,CSE 100,A01,083659,Cao; Yingjun,0,58,50,50
1650068819052,CSE 134B,A01,083661,Powell; Thomas Allan,1,27,65,64
1650068825075,CSE 140,A01,083663,Staff,6,0,75,69
1650068831098,CSE 140L,A01,083088,Eldon; John,1,0,75,74
1650068837123,CSE 175,A01,083665,Kumar; Rakesh,9,0,25,16
1650068843146,CSE 190,A00,092507,Dubnov; Shlomo,14,0,20,6
1650068849168,ECE 45,A01,083139,Staff,0,13,40,40
1650068855198,ECE 65,A50,083695,Staff,0,3,30,30
1650068861226,ECE 109,A01,091882,Touri; Behrouz,48,0,70,22
1650068867264,ECE 180,A00,083140,Abi Samra; Nicholas Camill,24,0,30,6
1650068867264,ECE 180,B00,083141,Abi Samra; Nicholas Camill,8,0,30,22
1650068873296,MATH 10A,A01,083735,Patchell; Gregory David,12,0,30,18
1650068873296,MATH 10A,A02,083736,Patchell; Gregory David,28,0,30,2
1650068873296,MATH 10A,A03,083737,Patchell; Gregory David,27,0,30,3
1650068879321,MATH 10B,A01,083207,Staff,0,5,30,30
1650068879321,MATH 10B,A02,083208,Staff,0,3,30,30
1650068879321,MATH 10B,B01,083739,Staff,18,0,30,12
1650068879321,MATH 10B,B02,083740,Staff,30,0,30,0
1650068885349,MATH 18,A01,083743,Staff,10,0,30,20
1650068885349,MATH 18,A02,083744,Staff,28,0,30,2
1650068885349,MATH 18,A03,083745,Staff,23,0,30,7
1650068885349,MATH 18,A04,083746,Staff,27,0,30,3
1650068885349,MATH 18,B01,083748,Staff,0,9,30,30
1650068885349,MATH 18,B02,083749,Staff,1,7,30,29
1650068885349,MATH 18,B03,083750,Staff,0,6,30,30
1650068885349,MATH 18,B04,083751,Staff,1,8,30,29
1650068891375,MATH 20A,A01,083754,Staff,26,0,40,14
1650068897401,MATH 20B,A01,083756,Staff,0,5,30,30
1650068897401,MATH 20B,A02,083757,Staff,0,1,30,30
1650068903424,MATH 20C,A01,083760,Staff,0,10,30,30
1650068903424,MATH 20C,A02,083761,Staff,0,12,30,30
1650068903424,MATH 20C,B01,083762,Staff,16,0,30,14
1650068903424,MATH 20C,B02,083763,Staff,28,0,30,2
1650068909451,MATH 20D,A01,083765,Staff,0,2,30,30
1650068909451,MATH 20D,A02,083766,Staff,14,0,30,16
1650068909451,MATH 20D,A03,083767,Staff,28,0,30,2
1650068915477,MATH 20E,A01,083771,Staff,10,0,30,20
1650068915477,MATH 20E,A02,083772,Staff,20,0,30,10
1650068915477,MATH 20E,B01,083773,Staff,2,2,30,28
1650068915477,MATH 20E,B02,083774,Staff,17,0,30,13
1650068921504,MATH 103A,A01,083777,Staff,0,8,30,30
1650068921504,MATH 103A,A02,083778,Staff,0,7,30,30
1650068921504,MATH 103A,B01,083779,Staff,0,8,30,30
1650068921504,MATH 103A,B02,083780,Staff,1,7,30,29
1650068927527,MATH 105,A01,085443,Staff,1,12,30,29
1650068933567,MATH 109,A01,083213,Anzaldo; Leesa B,1,4,30,29
1650068933567,MATH 109,A02,083214,Anzaldo; Leesa B,0,4,30,30
1650068933567,MATH 109,B01,083215,Anzaldo; Leesa B,0,2,30,30
1650068933567,MATH 109,B02,083216,Anzaldo; Leesa B,1,3,30,29
1650068939589,MATH 142A,A01,083219,Chow; Bennett,0,10,30,30
1650068939589,MATH 142A,A02,083220,Chow; Bennett,0,9,30,30
1650068939589,MATH 142A,B01,083221,Chow; Bennett,0,10,30,30
1650068939589,MATH 142A,B02,083222,Chow; Bennett,0,9,30,30
1650068945618,MATH 193A,A01,083224,Staff,0,4,30,30
1650068945618,MATH 193A,A02,083225,Staff,0,4,30,30
1650068945618,MATH 193A,A03,083781,Staff,0,0,30,30
1650068945618,MATH 193A,A04,083782,Staff,6,0,30,24
1650068951641,MATH 197,001,091859,McAuley; Julian John,9998,0,9999,1
1650068957695,COGS 9,A01,083615,Staff,3,17,60,57
1650068963727,COGS 11,A01,083617,Boyle; Mary E. T.,24,0,40,16
1650068969755,COGS 13,A01,083071,Staff,0,28,40,40
1650068975782,COGS 14A,A01,092681,Staff,0,10,100,100
1650068981809,COGS 14B,A01,083073,Cheng; Tzu-Han,0,4,50,50
1650068987835,COGS 17,A01,092677,Staff,35,0,75,40
1650068993859,COGS 100,A01,083619,Staff,0,19,60,60
1650068999882,COGS 101A,A01,083621,Davis; Joshua Daniel,0,16,60,60
1650069005905,COGS 101B,A01,091572,Staff,13,0,60,47
1650069011929,COGS 101C,A01,083625,Delgado; Tania,21,0,30,9
1650069017956,COGS 107A,A01,083627,Boyle; Mary E. T.,1,3,60,59
1650069023983,COGS 118A,A01,083075,Staff,18,0,60,42
1650069030013,CSE 3,A50,083646,Miranda; Gregory Joseph,22,0,38,16
1650069030013,CSE 3,A51,083647,Miranda; Gregory Joseph,37,0,37,0
1650069036040,CSE 8A,A50,083650,Miranda; Gregory Joseph,0,15,40,40
1650069042068,CSE 11,A01,083080,Cao; Yingjun,0,65,40,40
1650069048096,CSE 12,A01,083652,Staff,0,2,100,100
1650069054118,CSE 15L,A01,083654,Staff,0,0,50,50
1650069054118,CSE 15L,A02,083655,Staff,10,0,50,40
1650069060142,CSE 20,A01,083657,Staff,58,0,80,22
1650069066166,CSE 30,A01,083084,Eldon; John,0,63,40,40
1650069072191,CSE 100,A01,083659,Cao; Yingjun,0,58,50,50
1650069078215,CSE 134B,A01,083661,Powell; Thomas Allan,1,27,65,64
1650069084243,CSE 140,A01,083663,Staff,6,0,75,69
1650069090266,CSE 140L,A01,083088,Eldon; John,1,0,75,74
1650069096295,CSE 175,A01,083665,Kumar; Rakesh,9,0,25,16
1650069102414,CSE 190,A00,092507,Dubnov; Shlomo,14,0,20,6
1650069108446,ECE 45,A01,083139,Staff,0,13,40,40
1650069114474,ECE 65,A50,083695,Staff,0,3,30,30
1650069120501,ECE 109,A01,091882,Touri; Behrouz,48,0,70,22
1650069126535,ECE 180,A00,083140,Abi Samra; Nicholas Camill,24,0,30,6
1650069126535,ECE 180,B00,083141,Abi Samra; Nicholas Camill,8,0,30,22
1650069132564,MATH 10A,A01,083735,Patchell; Gregory David,12,0,30,18
1650069132564,MATH 10A,A02,083736,Patchell; Gregory David,28,0,30,2
1650069132564,MATH 10A,A03,083737,Patchell; Gregory David,27,0,30,3
1650069138594,MATH 10B,A01,083207,Staff,0,5,30,30
1650069138594,MATH 10B,A02,083208,Staff,0,3,30,30
1650069138594,MATH 10B,B01,083739,Staff,18,0,30,12
1650069138594,MATH 10B,B02,083740,Staff,29,0,30,1
1650069144619,MATH 18,A01,083743,Staff,10,0,30,20
1650069144619,MATH 18,A02,083744,Staff,28,0,30,2
1650069144619,MATH 18,A03,083745,Staff,23,0,30,7
1650069144619,MATH 18,A04,083746,Staff,27,0,30,3
1650069144619,MATH 18,B01,083748,Staff,0,9,30,30
1650069144619,MATH 18,B02,083749,Staff,1,7,30,29
1650069144619,MATH 18,B03,083750,Staff,0,6,30,30
1650069144619,MATH 18,B04,083751,Staff,1,8,30,29
1650069150643,MATH 20A,A01,083754,Staff,26,0,40,14
1650069156673,MATH 20B,A01,083756,Staff,0,5,30,30
1650069156673,MATH 20B,A02,083757,Staff,0,1,30,30
1650069162698,MATH 20C,A01,083760,Staff,0,10,30,30
1650069162698,MATH 20C,A02,083761,Staff,0,12,30,30
1650069162698,MATH 20C,B01,083762,Staff,16,0,30,14
1650069162698,MATH 20C,B02,083763,Staff,28,0,30,2
1650069168726,MATH 20D,A01,083765,Staff,0,2,30,30
1650069168726,MATH 20D,A02,083766,Staff,14,0,30,16
1650069168726,MATH 20D,A03,083767,Staff,28,0,30,2
1650069174760,MATH 20E,A01,083771,Staff,10,0,30,20
1650069174760,MATH 20E,A02,083772,Staff,20,0,30,10
1650069174760,MATH 20E,B01,083773,Staff,2,2,30,28
1650069174760,MATH 20E,B02,083774,Staff,17,0,30,13
1650069180787,MATH 103A,A01,083777,Staff,0,8,30,30
1650069180787,MATH 103A,A02,083778,Staff,0,7,30,30
1650069180787,MATH 103A,B01,083779,Staff,0,8,30,30
1650069180787,MATH 103A,B02,083780,Staff,1,7,30,29
1650069186813,MATH 105,A01,085443,Staff,1,12,30,29
1650069192838,MATH 109,A01,083213,Anzaldo; Leesa B,1,4,30,29
1650069192838,MATH 109,A02,083214,Anzaldo; Leesa B,0,4,30,30
1650069192838,MATH 109,B01,083215,Anzaldo; Leesa B,0,2,30,30
1650069192838,MATH 109,B02,083216,Anzaldo; Leesa B,1,3,30,29
1650069198862,MATH 142A,A01,083219,Chow; Bennett,0,10,30,30
1650069198862,MATH 142A,A02,083220,Chow; Bennett,0,9,30,30
1650069198862,MATH 142A,B01,083221,Chow; Bennett,0,10,30,30
1650069198862,MATH 142A,B02,083222,Chow; Bennett,0,9,30,30
1650069204886,MATH 193A,A01,083224,Staff,0,4,30,30
1650069204886,MATH 193A,A02,083225,Staff,0,4,30,30
1650069204886,MATH 193A,A03,083781,Staff,0,0,30,30
1650069204886,MATH 193A,A04,083782,Staff,6,0,30,24
1650069210910,MATH 197,001,091859,McAuley; Julian John,9998,0,9999,1
1650069216972,COGS 9,A01,083615,Staff,3,17,60,57
1650069222999,COGS 11,A01,083617,Boyle; Mary E. T.,24,0,40,16
1650069229021,COGS 13,A01,083071,Staff,0,28,40,40
1650069235045,COGS 14A,A01,092681,Staff,0,10,100,100
1650069241069,COGS 14B,A01,083073,Cheng; Tzu-Han,0,4,50,50
1650069247096,COGS 17,A01,092677,Staff,35,0,75,40
1650069253119,COGS 100,A01,083619,Staff,0,19,60,60
1650069259142,COGS 101A,A01,083621,Davis; Joshua Daniel,0,16,60,60
1650069265177,COGS 101B,A01,091572,Staff,13,0,60,47
1650069271213,COGS 101C,A01,083625,Delgado; Tania,21,0,30,9
1650069277236,COGS 107A,A01,083627,Boyle; Mary E. T.,1,3,60,59
1650069283262,COGS 118A,A01,083075,Staff,18,0,60,42
1650069289286,CSE 3,A50,083646,Miranda; Gregory Joseph,22,0,38,16
1650069289286,CSE 3,A51,083647,Miranda; Gregory Joseph,37,0,37,0
1650069295310,CSE 8A,A50,083650,Miranda; Gregory Joseph,0,15,40,40
1650069301343,CSE 11,A01,083080,Cao; Yingjun,0,65,40,40
1650069307380,CSE 12,A01,083652,Staff,0,2,100,100
1650069313403,CSE 15L,A01,083654,Staff,0,0,50,50
1650069313403,CSE 15L,A02,083655,Staff,10,0,50,40
1650069319428,CSE 20,A01,083657,Staff,58,0,80,22
1650069325452,CSE 30,A01,083084,Eldon; John,0,63,40,40
1650069331479,CSE 100,A01,083659,Cao; Yingjun,0,58,50,50
1650069337506,CSE 134B,A01,083661,Powell; Thomas Allan,1,27,65,64
1650069343529,CSE 140,A01,083663,Staff,6,0,75,69
1650069349559,CSE 140L,A01,083088,Eldon; John,1,0,75,74
1650069355588,CSE 175,A01,083665,Kumar; Rakesh,9,0,25,16
1650069361610,CSE 190,A00,092507,Dubnov; Shlomo,14,0,20,6
1650069367638,ECE 45,A01,083139,Staff,0,13,40,40
1650069373660,ECE 65,A50,083695,Staff,0,3,30,30
1650069379689,ECE 109,A01,091882,Touri; Behrouz,48,0,70,22
1650069385729,ECE 180,A00,083140,Abi Samra; Nicholas Camill,24,0,30,6
1650069385729,ECE 180,B00,083141,Abi Samra; Nicholas Camill,8,0,30,22
1650069391753,MATH 10A,A01,083735,Patchell; Gregory David,12,0,30,18
1650069391753,MATH 10A,A02,083736,Patchell; Gregory David,28,0,30,2
1650069391753,MATH 10A,A03,083737,Patchell; Gregory David,27,0,30,3
1650069397785,MATH 10B,A01,083207,Staff,0,5,30,30
1650069397785,MATH 10B,A02,083208,Staff,0,3,30,30
1650069397785,MATH 10B,B01,083739,Staff,18,0,30,12
1650069397785,MATH 10B,B02,083740,Staff,29,0,30,1
1650069403816,MATH 18,A01,083743,Staff,10,0,30,20
1650069403816,MATH 18,A02,083744,Staff,28,0,30,2
1650069403816,MATH 18,A03,083745,Staff,23,0,30,7
1650069403816,MATH 18,A04,083746,Staff,27,0,30,3
1650069403816,MATH 18,B01,083748,Staff,0,9,30,30
1650069403816,MATH 18,B02,083749,Staff,1,7,30,29
1650069403816,MATH 18,B03,083750,Staff,0,6,30,30
1650069403816,MATH 18,B04,083751,Staff,1,8,30,29
1650069409842,MATH 20A,A01,083754,Staff,26,0,40,14
1650069415870,MATH 20B,A01,083756,Staff,0,5,30,30
1650069415870,MATH 20B,A02,083757,Staff,0,1,30,30
1650069421899,MATH 20C,A01,083760,Staff,0,10,30,30
1650069421899,MATH 20C,A02,083761,Staff,0,12,30,30
1650069421899,MATH 20C,B01,083762,Staff,16,0,30,14
1650069421899,MATH 20C,B02,083763,Staff,28,0,30,2
1650069427929,MATH 20D,A01,083765,Staff,0,2,30,30
1650069427929,MATH 20D,A02,083766,Staff,14,0,30,16
1650069427929,MATH 20D,A03,083767,Staff,28,0,30,2
1650069433954,MATH 20E,A01,083771,Staff,10,0,30,20
1650069433954,MATH 20E,A02,083772,Staff,20,0,30,10
1650069433954,MATH 20E,B01,083773,Staff,2,2,30,28
1650069433954,MATH 20E,B02,083774,Staff,17,0,30,13
1650069439979,MATH 103A,A01,083777,Staff,0,8,30,30
1650069439979,MATH 103A,A02,083778,Staff,0,7,30,30
1650069439979,MATH 103A,B01,083779,Staff,0,8,30,30
1650069439979,MATH 103A,B02,083780,Staff,1,7,30,29
1650069446002,MATH 105,A01,085443,Staff,1,12,30,29
1650069452035,MATH 109,A01,083213,Anzaldo; Leesa B,1,4,30,29
1650069452035,MATH 109,A02,083214,Anzaldo; Leesa B,0,4,30,30
1650069452035,MATH 109,B01,083215,Anzaldo; Leesa B,0,2,30,30
1650069452035,MATH 109,B02,083216,Anzaldo; Leesa B,1,3,30,29
1650069458064,MATH 142A,A01,083219,Chow; Bennett,0,10,30,30
1650069458064,MATH 142A,A02,083220,Chow; Bennett,0,9,30,30
1650069458064,MATH 142A,B01,083221,Chow; Bennett,0,10,30,30
1650069458064,MATH 142A,B02,083222,Chow; Bennett,0,9,30,30
1650069464092,MATH 193A,A01,083224,Staff,0,4,30,30
1650069464092,MATH 193A,A02,083225,Staff,0,4,30,30
1650069464092,MATH 193A,A03,083781,Staff,0,0,30,30
1650069464092,MATH 193A,A04,083782,Staff,6,0,30,24
1650069470114,MATH 197,001,091859,McAuley; Julian John,9998,0,9999,1
1650069476185,COGS 9,A01,083615,Staff,3,17,60,57
1650069482211,COGS 11,A01,083617,Boyle; Mary E. T.,24,0,40,16
1650069488236,COGS 13,A01,083071,Staff,0,28,40,40
1650069494262,COGS 14A,A01,092681,Staff,0,10,100,100
1650069500290,COGS 14B,A01,083073,Cheng; Tzu-Han,0,4,50,50
1650069506313,COGS 17,A01,092677,Staff,35,0,75,40
1650069512339,COGS 100,A01,083619,Staff,0,19,60,60
1650069518375,COGS 101A,A01,083621,Davis; Joshua Daniel,0,16,60,60
1650069524402,COGS 101B,A01,091572,Staff,13,0,60,47
1650069530427,COGS 101C,A01,083625,Delgado; Tania,21,0,30,9
1650069536454,COGS 107A,A01,083627,Boyle; Mary E. T.,1,3,60,59
1650069542481,COGS 118A,A01,083075,Staff,18,0,60,42
1650069548511,CSE 3,A50,083646,Miranda; Gregory Joseph,22,0,38,16
1650069548511,CSE 3,A51,083647,Miranda; Gregory Joseph,37,0,37,0
1650069554538,CSE 8A,A50,083650,Miranda; Gregory Joseph,0,15,40,40
1650069560565,CSE 11,A01,083080,Cao; Yingjun,0,65,40,40
1650069566593,CSE 12,A01,083652,Staff,0,2,100,100
1650069572621,CSE 15L,A01,083654,Staff,0,0,50,50
1650069572621,CSE 15L,A02,083655,Staff,10,0,50,40
1650069578645,CSE 20,A01,083657,Staff,58,0,80,22
1650069584669,CSE 30,A01,083084,Eldon; John,0,63,40,40
1650069590699,CSE 100,A01,083659,Cao; Yingjun,0,58,50,50
1650069596723,CSE 134B,A01,083661,Powell; Thomas Allan,1,27,65,64
1650069602759,CSE 140,A01,083663,Staff,6,0,75,69
1650069608782,CSE 140L,A01,083088,Eldon; John,1,0,75,74
1650069614807,CSE 175,A01,083665,Kumar; Rakesh,9,0,25,16
1650069620835,CSE 190,A00,092507,Dubnov; Shlomo,14,0,20,6
1650069626866,ECE 45,A01,083139,Staff,0,13,40,40
1650069632893,ECE 65,A50,083695,Staff,0,3,30,30
1650069638916,ECE 109,A01,091882,Touri; Behrouz,48,0,70,22
1650069644940,ECE 180,A00,083140,Abi Samra; Nicholas Camill,24,0,30,6
1650069644940,ECE 180,B00,083141,Abi Samra; Nicholas Camill,8,0,30,22
1650069650969,MATH 10A,A01,083735,Patchell; Gregory David,12,0,30,18
1650069650969,MATH 10A,A02,083736,Patchell; Gregory David,28,0,30,2
1650069650969,MATH 10A,A03,083737,Patchell; Gregory David,27,0,30,3
1650069656998,MATH 10B,A01,083207,Staff,0,5,30,30
1650069656998,MATH 10B,A02,083208,Staff,0,3,30,30
1650069656998,MATH 10B,B01,083739,Staff,18,0,30,12
1650069656998,MATH 10B,B02,083740,Staff,29,0,30,1
1650069663023,MATH 18,A01,083743,Staff,10,0,30,20
1650069663023,MATH 18,A02,083744,Staff,28,0,30,2
1650069663023,MATH 18,A03,083745,Staff,23,0,30,7
1650069663023,MATH 18,A04,083746,Staff,27,0,30,3
1650069663023,MATH 18,B01,083748,Staff,0,9,30,30
1650069663023,MATH 18,B02,083749,Staff,1,7,30,29
1650069663023,MATH 18,B03,083750,Staff,0,6,30,30
1650069663023,MATH 18,B04,083751,Staff,1,8,30,29
1650069669051,MATH 20A,A01,083754,Staff,26,0,40,14
1650069675074,MATH 20B,A01,083756,Staff,0,5,30,30
1650069675074,MATH 20B,A02,083757,Staff,0,1,30,30
1650069681109,MATH 20C,A01,083760,Staff,0,10,30,30
1650069681109,MATH 20C,A02,083761,Staff,0,12,30,30
1650069681109,MATH 20C,B01,083762,Staff,16,0,30,14
1650069681109,MATH 20C,B02,083763,Staff,28,0,30,2
1650069687132,MATH 20D,A01,083765,Staff,0,2,30,30
1650069687132,MATH 20D,A02,083766,Staff,14,0,30,16
1650069687132,MATH 20D,A03,083767,Staff,28,0,30,2
1650069693156,MATH 20E,A01,083771,Staff,10,0,30,20
1650069693156,MATH 20E,A02,083772,Staff,20,0,30,10
1650069693156,MATH 20E,B01,083773,Staff,2,2,30,28
1650069693156,MATH 20E,B02,083774,Staff,16,0,30,14
1650069699278,MATH 103A,A01,083777,Staff,0,8,30,30
1650069699278,MATH 103A,A02,083778,Staff,0,7,30,30
1650069699278,MATH 103A,B01,083779,Staff,0,8,30,30
1650069699278,MATH 103A,B02,083780,Staff,1,7,30,29
1650069705302,MATH 105,A01,085443,Staff,1,12,30,29
1650069711327,MATH 109,A01,083213,Anzaldo; Leesa B,1,4,30,29
1650069711327,MATH 109,A02,083214,Anzaldo; Leesa B,0,4,30,30
1650069711327,MATH 109,B01,083215,Anzaldo; Leesa B,0,2,30,30
1650069711327,MATH 109,B02,083216,Anzaldo; Leesa B,1,3,30,29
1650069717357,MATH 142A,A01,083219,Chow; Bennett,0,10,30,30
1650069717357,MATH 142A,A02,083220,Chow; Bennett,0,9,30,30
1650069717357,MATH 142A,B01,083221,Chow; Bennett,0,10,30,30
1650069717357,MATH 142A,B02,083222,Chow; Bennett,0,9,30,30
1650069723383,MATH 193A,A01,083224,Staff,0,4,30,30
1650069723383,MATH 193A,A02,083225,Staff,0,4,30,30
1650069723383,MATH 193A,A03,083781,Staff,0,0,30,30
1650069723383,MATH 193A,A04,083782,Staff,6,0,30,24
1650069729409,MATH 197,001,091859,McAuley; Julian John,9998,0,9999,1
1650069735459,COGS 9,A01,083615,Staff,3,17,60,57
1650069741480,COGS 11,A01,083617,Boyle; Mary E. T.,24,0,40,16
1650069747515,COGS 13,A01,083071,Staff,0,28,40,40
1650069753539,COGS 14A,A01,092681,Staff,0,11,100,100
1650069759566,COGS 14B,A01,083073,Cheng; Tzu-Han,0,4,50,50
1650069765588,COGS 17,A01,092677,Staff,35,0,75,40
1650069771610,COGS 100,A01,083619,Staff,0,19,60,60
1650069777634,COGS 101A,A01,083621,Davis; Joshua Daniel,0,16,60,60
1650069783663,COGS 101B,A01,091572,Staff,13,0,60,47
1650069789690,COGS 101C,A01,083625,Delgado; Tania,21,0,30,9
1650069795716,COGS 107A,A01,083627,Boyle; Mary E. T.,1,3,60,59
1650069801743,COGS 118A,A01,083075,Staff,18,0,60,42
1650069807786,CSE 3,A50,083646,Miranda; Gregory Joseph,22,0,38,16
1650069807786,CSE 3,A51,083647,Miranda; Gregory Joseph,37,0,37,0
1650069813817,CSE 8A,A50,083650,Miranda; Gregory Joseph,0,15,40,40
1650069819850,CSE 11,A01,083080,Cao; Yingjun,0,66,40,40
1650069825874,CSE 12,A01,083652,Staff,0,2,100,100
1650069831901,CSE 15L,A01,083654,Staff,0,0,50,50
1650069831901,CSE 15L,A02,083655,Staff,10,0,50,40
1650069837928,CSE 20,A01,083657,Staff,58,0,80,22
1650069843954,CSE 30,A01,083084,Eldon; John,0,63,40,40
1650069849980,CSE 100,A01,083659,Cao; Yingjun,0,58,50,50
1650069856018,CSE 134B,A01,083661,Powell; Thomas Allan,1,27,65,64
1650069862040,CSE 140,A01,083663,Staff,6,0,75,69
1650069868062,CSE 140L,A01,083088,Eldon; John,1,0,75,74
1650069874093,CSE 175,A01,083665,Kumar; Rakesh,9,0,25,16
1650069880117,CSE 190,A00,092507,Dubnov; Shlomo,14,0,20,6
1650069886140,ECE 45,A01,083139,Staff,0,13,40,40
1650069892168,ECE 65,A50,083695,Staff,0,3,30,30
1650069898191,ECE 109,A01,091882,Touri; Behrouz,48,0,70,22
1650069904214,ECE 180,A00,083140,Abi Samra; Nicholas Camill,24,0,30,6
1650069904214,ECE 180,B00,083141,Abi Samra; Nicholas Camill,8,0,30,22
1650069910238,MATH 10A,A01,083735,Patchell; Gregory David,12,0,30,18
1650069910238,MATH 10A,A02,083736,Patchell; Gregory David,28,0,30,2
1650069910238,MATH 10A,A03,083737,Patchell; Gregory David,27,0,30,3
1650069916267,MATH 10B,A01,083207,Staff,0,5,30,30
1650069916267,MATH 10B,A02,083208,Staff,0,3,30,30
1650069916267,MATH 10B,B01,083739,Staff,18,0,30,12
1650069916267,MATH 10B,B02,083740,Staff,29,0,30,1
1650069922290,MATH 18,A01,083743,Staff,10,0,30,20
1650069922290,MATH 18,A02,083744,Staff,28,0,30,2
1650069922290,MATH 18,A03,083745,Staff,23,0,30,7
1650069922290,MATH 18,A04,083746,Staff,27,0,30,3
1650069922290,MATH 18,B01,083748,Staff,0,9,30,30
1650069922290,MATH 18,B02,083749,Staff,1,7,30,29
1650069922290,MATH 18,B03,083750,Staff,0,6,30,30
1650069922290,MATH 18,B04,083751,Staff,1,8,30,29
1650069928313,MATH 20A,A01,083754,Staff,26,0,40,14
1650069934341,MATH 20B,A01,083756,Staff,0,5,30,30
1650069934341,MATH 20B,A02,083757,Staff,0,1,30,30
1650069940369,MATH 20C,A01,083760,Staff,0,10,30,30
1650069940369,MATH 20C,A02,083761,Staff,0,12,30,30
1650069940369,MATH 20C,B01,083762,Staff,15,0,30,15
1650069940369,MATH 20C,B02,083763,Staff,28,0,30,2
1650069946396,MATH 20D,A01,083765,Staff,0,2,30,30
1650069946396,MATH 20D,A02,083766,Staff,14,0,30,16
1650069946396,MATH 20D,A03,083767,Staff,28,0,30,2
1650069952437,MATH 20E,A01,083771,Staff,10,0,30,20
1650069952437,MATH 20E,A02,083772,Staff,20,0,30,10
1650069952437,MATH 20E,B01,083773,Staff,2,2,30,28
1650069952437,MATH 20E,B02,083774,Staff,16,0,30,14
1650069958475,MATH 103A,A01,083777,Staff,0,8,30,30
1650069958475,MATH 103A,A02,083778,Staff,0,7,30,30
1650069958475,MATH 103A,B01,083779,Staff,0,8,30,30
1650069958475,MATH 103A,B02,083780,Staff,1,7,30,29
1650069964504,MATH 105,A01,085443,Staff,1,12,30,29
1650069970529,MATH 109,A01,083213,Anzaldo; Leesa B,1,4,30,29
1650069970529,MATH 109,A02,083214,Anzaldo; Leesa B,0,4,30,30
1650069970529,MATH 109,B01,083215,Anzaldo; Leesa B,0,2,30,30
1650069970529,MATH 109,B02,083216,Anzaldo; Leesa B,1,3,30,29
1650069976553,MATH 142A,A01,083219,Chow; Bennett,0,10,30,30
1650069976553,MATH 142A,A02,083220,Chow; Bennett,0,9,30,30
1650069976553,MATH 142A,B01,083221,Chow; Bennett,0,10,30,30
1650069976553,MATH 142A,B02,083222,Chow; Bennett,0,9,30,30
1650069982581,MATH 193A,A01,083224,Staff,0,4,30,30
1650069982581,MATH 193A,A02,083225,Staff,0,4,30,30
1650069982581,MATH 193A,A03,083781,Staff,0,0,30,30
1650069982581,MATH 193A,A04,083782,Staff,6,0,30,24
1650069988605,MATH 197,001,091859,McAuley; Julian John,9998,0,9999,1
1650069994655,COGS 9,A01,083615,Staff,3,17,60,57
1650070000694,COGS 11,A01,083617,Boyle; Mary E. T.,24,0,40,16
1650070006717,COGS 13,A01,083071,Staff,0,28,40,40
1650070012740,COGS 14A,A01,092681,Staff,0,11,100,100
1650070018763,COGS 14B,A01,083073,Cheng; Tzu-Han,0,4,50,50
1650070024785,COGS 17,A01,092677,Staff,35,0,75,40
1650070030815,COGS 100,A01,083619,Staff,0,19,60,60
1650070036839,COGS 101A,A01,083621,Davis; Joshua Daniel,0,16,60,60
1650070042865,COGS 101B,A01,091572,Staff,13,0,60,47
1650070048889,COGS 101C,A01,083625,Delgado; Tania,21,0,30,9
1650070054915,COGS 107A,A01,083627,Boyle; Mary E. T.,1,3,60,59
1650070060939,COGS 118A,A01,083075,Staff,18,0,60,42
1650070066967,CSE 3,A50,083646,Miranda; Gregory Joseph,22,0,38,16
1650070066967,CSE 3,A51,083647,Miranda; Gregory Joseph,37,0,37,0
1650070072995,CSE 8A,A50,083650,Miranda; Gregory Joseph,0,15,40,40
1650070079022,CSE 11,A01,083080,Cao; Yingjun,0,66,40,40
1650070085049,CSE 12,A01,083652,Staff,0,2,100,100
1650070091073,CSE 15L,A01,083654,Staff,0,0,50,50
1650070091073,CSE 15L,A02,083655,Staff,10,0,50,40
1650070097095,CSE 20,A01,083657,Staff,58,0,80,22
1650070103120,CSE 30,A01,083084,Eldon; John,0,63,40,40
1650070109144,CSE 100,A01,083659,Cao; Yingjun,0,58,50,50
1650070115166,CSE 134B,A01,083661,Powell; Thomas Allan,1,27,65,64
1650070121189,CSE 140,A01,083663,Staff,6,0,75,69
1650070127216,CSE 140L,A01,083088,Eldon; John,1,0,75,74
1650070133245,CSE 175,A01,083665,Kumar; Rakesh,9,0,25,16
1650070139267,CSE 190,A00,092507,Dubnov; Shlomo,14,0,20,6
1650070145291,ECE 45,A01,083139,Staff,0,13,40,40
1650070151313,ECE 65,A50,083695,Staff,0,3,30,30
1650070157335,ECE 109,A01,091882,Touri; Behrouz,48,0,70,22
1650070163358,ECE 180,A00,083140,Abi Samra; Nicholas Camill,24,0,30,6
1650070163358,ECE 180,B00,083141,Abi Samra; Nicholas Camill,8,0,30,22
1650070169386,MATH 10A,A01,083735,Patchell; Gregory David,12,0,30,18
1650070169386,MATH 10A,A02,083736,Patchell; Gregory David,28,0,30,2
1650070169386,MATH 10A,A03,083737,Patchell; Gregory David,27,0,30,3
1650070175408,MATH 10B,A01,083207,Staff,0,5,30,30
1650070175408,MATH 10B,A02,083208,Staff,0,3,30,30
1650070175408,MATH 10B,B01,083739,Staff,18,0,30,12
1650070175408,MATH 10B,B02,083740,Staff,29,0,30,1
1650070181432,MATH 18,A01,083743,Staff,10,0,30,20
1650070181432,MATH 18,A02,083744,Staff,28,0,30,2
1650070181432,MATH 18,A03,083745,Staff,23,0,30,7
1650070181432,MATH 18,A04,083746,Staff,27,0,30,3
1650070181432,MATH 18,B01,083748,Staff,0,9,30,30
1650070181432,MATH 18,B02,083749,Staff,1,7,30,29
1650070181432,MATH 18,B03,083750,Staff,0,6,30,30
1650070181432,MATH 18,B04,083751,Staff,1,8,30,29
1650070187456,MATH 20A,A01,083754,Staff,26,0,40,14
1650070193484,MATH 20B,A01,083756,Staff,0,5,30,30
1650070193484,MATH 20B,A02,083757,Staff,0,1,30,30
1650070199509,MATH 20C,A01,083760,Staff,0,10,30,30
1650070199509,MATH 20C,A02,083761,Staff,0,12,30,30
1650070199509,MATH 20C,B01,083762,Staff,15,0,30,15
1650070199509,MATH 20C,B02,083763,Staff,28,0,30,2
1650070205533,MATH 20D,A01,083765,Staff,0,2,30,30
1650070205533,MATH 20D,A02,083766,Staff,14,0,30,16
1650070205533,MATH 20D,A03,083767,Staff,28,0,30,2
1650070211573,MATH 20E,A01,083771,Staff,10,0,30,20
1650070211573,MATH 20E,A02,083772,Staff,20,0,30,10
1650070211573,MATH 20E,B01,083773,Staff,2,2,30,28
1650070211573,MATH 20E,B02,083774,Staff,16,0,30,14
1650070217598,MATH 103A,A01,083777,Staff,0,8,30,30
1650070217598,MATH 103A,A02,083778,Staff,0,7,30,30
1650070217598,MATH 103A,B01,083779,Staff,0,8,30,30
1650070217598,MATH 103A,B02,083780,Staff,1,7,30,29
1650070223624,MATH 105,A01,085443,Staff,1,12,30,29
1650070229659,MATH 109,A01,083213,Anzaldo; Leesa B,1,4,30,29
1650070229659,MATH 109,A02,083214,Anzaldo; Leesa B,0,4,30,30
1650070229659,MATH 109,B01,083215,Anzaldo; Leesa B,0,2,30,30
1650070229659,MATH 109,B02,083216,Anzaldo; Leesa B,1,3,30,29
1650070235687,MATH 142A,A01,083219,Chow; Bennett,0,10,30,30
1650070235687,MATH 142A,A02,083220,Chow; Bennett,0,9,30,30
1650070235687,MATH 142A,B01,083221,Chow; Bennett,0,10,30,30
1650070235687,MATH 142A,B02,083222,Chow; Bennett,0,9,30,30
1650070241710,MATH 193A,A01,083224,Staff,0,4,30,30
1650070241710,MATH 193A,A02,083225,Staff,0,4,30,30
1650070241710,MATH 193A,A03,083781,Staff,0,0,30,30
1650070241710,MATH 193A,A04,083782,Staff,6,0,30,24
1650070247737,MATH 197,001,091859,McAuley; Julian John,9998,0,9999,1
1650070253812,COGS 9,A01,083615,Staff,3,17,60,57
1650070259834,COGS 11,A01,083617,Boyle; Mary E. T.,24,0,40,16
1650070265857,COGS 13,A01,083071,Staff,0,28,40,40
1650070271880,COGS 14A,A01,092681,Staff,0,11,100,100
1650070277906,COGS 14B,A01,083073,Cheng; Tzu-Han,0,4,50,50
1650070283932,COGS 17,A01,092677,Staff,35,0,75,40
1650070290049,COGS 100,A01,083619,Staff,0,19,60,60
1650070296079,COGS 101A,A01,083621,Davis; Joshua Daniel,0,16,60,60
1650070302104,COGS 101B,A01,091572,Staff,13,0,60,47
1650070308130,COGS 101C,A01,083625,Delgado; Tania,21,0,30,9
1650070314158,COGS 107A,A01,083627,Boyle; Mary E. T.,1,3,60,59
1650070320181,COGS 118A,A01,083075,Staff,18,0,60,42
1650070326206,CSE 3,A50,083646,Miranda; Gregory Joseph,22,0,38,16
1650070326206,CSE 3,A51,083647,Miranda; Gregory Joseph,37,0,37,0
1650070332230,CSE 8A,A50,083650,Miranda; Gregory Joseph,0,15,40,40
1650070338260,CSE 11,A01,083080,Cao; Yingjun,0,66,40,40
1650070344284,CSE 12,A01,083652,Staff,0,2,100,100
1650070350313,CSE 15L,A01,083654,Staff,0,0,50,50
1650070350313,CSE 15L,A02,083655,Staff,10,0,50,40
1650070356344,CSE 20,A01,083657,Staff,58,0,80,22
1650070362371,CSE 30,A01,083084,Eldon; John,0,63,40,40
1650070368406,CSE 100,A01,083659,Cao; Yingjun,0,58,50,50
1650070374431,CSE 134B,A01,083661,Powell; Thomas Allan,1,27,65,64
1650070380460,CSE 140,A01,083663,Staff,6,0,75,69
1650070386488,CSE 140L,A01,083088,Eldon; John,1,0,75,74
1650070392515,CSE 175,A01,083665,Kumar; Rakesh,9,0,25,16
1650070398553,CSE 190,A00,092507,Dubnov; Shlomo,14,0,20,6
1650070404577,ECE 45,A01,083139,Staff,0,13,40,40
1650070410602,ECE 65,A50,083695,Staff,0,3,30,30
1650070416626,ECE 109,A01,091882,Touri; Behrouz,48,0,70,22
1650070422667,ECE 180,A00,083140,Abi Samra; Nicholas Camill,24,0,30,6
1650070422667,ECE 180,B00,083141,Abi Samra; Nicholas Camill,8,0,30,22
1650070428695,MATH 10A,A01,083735,Patchell; Gregory David,12,0,30,18
1650070428695,MATH 10A,A02,083736,Patchell; Gregory David,28,0,30,2
1650070428695,MATH 10A,A03,083737,Patchell; Gregory David,27,0,30,3
1650070434720,MATH 10B,A01,083207,Staff,0,5,30,30
1650070434720,MATH 10B,A02,083208,Staff,0,3,30,30
1650070434720,MATH 10B,B01,083739,Staff,18,0,30,12
1650070434720,MATH 10B,B02,083740,Staff,29,0,30,1
1650070440754,MATH 18,A01,083743,Staff,10,0,30,20
1650070440754,MATH 18,A02,083744,Staff,28,0,30,2
1650070440754,MATH 18,A03,083745,Staff,23,0,30,7
1650070440754,MATH 18,A04,083746,Staff,27,0,30,3
1650070440754,MATH 18,B01,083748,Staff,0,9,30,30
1650070440754,MATH 18,B02,083749,Staff,1,7,30,29
1650070440754,MATH 18,B03,083750,Staff,0,6,30,30
1650070440754,MATH 18,B04,083751,Staff,1,8,30,29
1650070446777,MATH 20A,A01,083754,Staff,26,0,40,14
1650070452814,MATH 20B,A01,083756,Staff,0,5,30,30
1650070452814,MATH 20B,A02,083757,Staff,0,1,30,30
1650070458841,MATH 20C,A01,083760,Staff,0,10,30,30
1650070458841,MATH 20C,A02,083761,Staff,0,12,30,30
1650070458841,MATH 20C,B01,083762,Staff,15,0,30,15
1650070458841,MATH 20C,B02,083763,Staff,28,0,30,2
1650070464863,MATH 20D,A01,083765,Staff,0,2,30,30
1650070464863,MATH 20D,A02,083766,Staff,14,0,30,16
1650070464863,MATH 20D,A03,083767,Staff,28,0,30,2
1650070470910,MATH 20E,A01,083771,Staff,10,0,30,20
1650070470910,MATH 20E,A02,083772,Staff,20,0,30,10
1650070470910,MATH 20E,B01,083773,Staff,2,2,30,28
1650070470910,MATH 20E,B02,083774,Staff,16,0,30,14
1650070476942,MATH 103A,A01,083777,Staff,0,8,30,30
1650070476942,MATH 103A,A02,083778,Staff,0,7,30,30
1650070476942,MATH 103A,B01,083779,Staff,0,8,30,30
1650070476942,MATH 103A,B02,083780,Staff,1,7,30,29
1650070482988,MATH 105,A01,085443,Staff,1,13,30,29
1650070489016,MATH 109,A01,083213,Anzaldo; Leesa B,1,4,30,29
1650070489016,MATH 109,A02,083214,Anzaldo; Leesa B,0,5,30,30
1650070489016,MATH 109,B01,083215,Anzaldo; Leesa B,0,4,30,30
1650070489016,MATH 109,B02,083216,Anzaldo; Leesa B,1,3,30,29
1650070495047,MATH 142A,A01,083219,Chow; Bennett,0,10,30,30
1650070495047,MATH 142A,A02,083220,Chow; Bennett,0,9,30,30
1650070495047,MATH 142A,B01,083221,Chow; Bennett,0,10,30,30
1650070495047,MATH 142A,B02,083222,Chow; Bennett,0,9,30,30
1650070501089,MATH 193A,A01,083224,Staff,0,4,30,30
1650070501089,MATH 193A,A02,083225,Staff,0,4,30,30
1650070501089,MATH 193A,A03,083781,Staff,0,0,30,30
1650070501089,MATH 193A,A04,083782,Staff,6,0,30,24
1650070507116,MATH 197,001,091859,McAuley; Julian John,9998,0,9999,1
1650070513182,COGS 9,A01,083615,Staff,3,17,60,57
1650070519216,COGS 11,A01,083617,Boyle; Mary E. T.,24,0,40,16
1650070525244,COGS 13,A01,083071,Staff,0,28,40,40
1650070531285,COGS 14A,A01,092681,Staff,0,11,100,100
1650070537315,COGS 14B,A01,083073,Cheng; Tzu-Han,0,4,50,50
1650070543339,COGS 17,A01,092677,Staff,35,0,75,40
1650070549363,COGS 100,A01,083619,Staff,0,19,60,60
1650070555394,COGS 101A,A01,083621,Davis; Joshua Daniel,0,16,60,60
1650070561432,COGS 101B,A01,091572,Staff,13,0,60,47
1650070567456,COGS 101C,A01,083625,Delgado; Tania,21,0,30,9
1650070573486,COGS 107A,A01,083627,Boyle; Mary E. T.,1,3,60,59
1650070579510,COGS 118A,A01,083075,Staff,18,0,60,42
1650070585534,CSE 3,A50,083646,Miranda; Gregory Joseph,22,0,38,16
1650070585534,CSE 3,A51,083647,Miranda; Gregory Joseph,37,0,37,0
1650070591557,CSE 8A,A50,083650,Miranda; Gregory Joseph,0,15,40,40
1650070597583,CSE 11,A01,083080,Cao; Yingjun,0,66,40,40
1650070603607,CSE 12,A01,083652,Staff,0,2,100,100
1650070609642,CSE 15L,A01,083654,Staff,0,0,50,50
1650070609642,CSE 15L,A02,083655,Staff,10,0,50,40
1650070615666,CSE 20,A01,083657,Staff,58,0,80,22
1650070621697,CSE 30,A01,083084,Eldon; John,0,63,40,40
1650070627723,CSE 100,A01,083659,Cao; Yingjun,0,58,50,50
1650070633751,CSE 134B,A01,083661,Powell; Thomas Allan,1,28,65,64
1650070639775,CSE 140,A01,083663,Staff,6,0,75,69
1650070645810,CSE 140L,A01,083088,Eldon; John,1,0,75,74
1650070651845,CSE 175,A01,083665,Kumar; Rakesh,9,0,25,16
1650070657881,CSE 190,A00,092507,Dubnov; Shlomo,14,0,20,6
1650070663905,ECE 45,A01,083139,Staff,0,13,40,40
1650070669928,ECE 65,A50,083695,Staff,0,3,30,30
1650070675956,ECE 109,A01,091882,Touri; Behrouz,48,0,70,22
1650070681988,ECE 180,A00,083140,Abi Samra; Nicholas Camill,24,0,30,6
1650070681988,ECE 180,B00,083141,Abi Samra; Nicholas Camill,8,0,30,22
1650070688014,MATH 10A,A01,083735,Patchell; Gregory David,12,0,30,18
1650070688014,MATH 10A,A02,083736,Patchell; Gregory David,28,0,30,2
1650070688014,MATH 10A,A03,083737,Patchell; Gregory David,27,0,30,3
1650070694042,MATH 10B,A01,083207,Staff,0,5,30,30
1650070694042,MATH 10B,A02,083208,Staff,0,3,30,30
1650070694042,MATH 10B,B01,083739,Staff,18,0,30,12
1650070694042,MATH 10B,B02,083740,Staff,29,0,30,1
1650070700075,MATH 18,A01,083743,Staff,10,0,30,20
1650070700075,MATH 18,A02,083744,Staff,28,0,30,2
1650070700075,MATH 18,A03,083745,Staff,23,0,30,7
1650070700075,MATH 18,A04,083746,Staff,27,0,30,3
1650070700075,MATH 18,B01,083748,Staff,0,9,30,30
1650070700075,MATH 18,B02,083749,Staff,1,7,30,29
1650070700075,MATH 18,B03,083750,Staff,0,6,30,30
1650070700075,MATH 18,B04,083751,Staff,1,8,30,29
1650070706099,MATH 20A,A01,083754,Staff,26,0,40,14
1650070712123,MATH 20B,A01,083756,Staff,0,5,30,30
1650070712123,MATH 20B,A02,083757,Staff,0,1,30,30
1650070718156,MATH 20C,A01,083760,Staff,0,10,30,30
1650070718156,MATH 20C,A02,083761,Staff,0,12,30,30
1650070718156,MATH 20C,B01,083762,Staff,15,0,30,15
1650070718156,MATH 20C,B02,083763,Staff,28,0,30,2
1650070724179,MATH 20D,A01,083765,Staff,0,2,30,30
1650070724179,MATH 20D,A02,083766,Staff,14,0,30,16
1650070724179,MATH 20D,A03,083767,Staff,28,0,30,2
1650070730209,MATH 20E,A01,083771,Staff,10,0,30,20
1650070730209,MATH 20E,A02,083772,Staff,20,0,30,10
1650070730209,MATH 20E,B01,083773,Staff,2,2,30,28
1650070730209,MATH 20E,B02,083774,Staff,16,0,30,14
1650070736233,MATH 103A,A01,083777,Staff,0,8,30,30
1650070736233,MATH 103A,A02,083778,Staff,0,7,30,30
1650070736233,MATH 103A,B01,083779,Staff,0,8,30,30
1650070736233,MATH 103A,B02,083780,Staff,1,7,30,29
1650070742256,MATH 105,A01,085443,Staff,1,13,30,29
1650070748290,MATH 109,A01,083213,Anzaldo; Leesa B,1,4,30,29
1650070748290,MATH 109,A02,083214,Anzaldo; Leesa B,0,5,30,30
1650070748290,MATH 109,B01,083215,Anzaldo; Leesa B,0,4,30,30
1650070748290,MATH 109,B02,083216,Anzaldo; Leesa B,1,3,30,29
1650070754318,MATH 142A,A01,083219,Chow; Bennett,0,10,30,30
1650070754318,MATH 142A,A02,083220,Chow; Bennett,0,9,30,30
1650070754318,MATH 142A,B01,083221,Chow; Bennett,0,10,30,30
1650070754318,MATH 142A,B02,083222,Chow; Bennett,0,9,30,30
1650070760350,MATH 193A,A01,083224,Staff,0,4,30,30
1650070760350,MATH 193A,A02,083225,Staff,0,4,30,30
1650070760350,MATH 193A,A03,083781,Staff,0,0,30,30
1650070760350,MATH 193A,A04,083782,Staff,6,0,30,24
1650070766383,MATH 197,001,091859,McAuley; Julian John,9998,0,9999,1
1650070772460,COGS 9,A01,083615,Staff,3,17,60,57
1650070778487,COGS 11,A01,083617,Boyle; Mary E. T.,24,0,40,16
1650070784511,COGS 13,A01,083071,Staff,0,28,40,40
1650070790540,COGS 14A,A01,092681,Staff,0,11,100,100
1650070796564,COGS 14B,A01,083073,Cheng; Tzu-Han,0,4,50,50
1650070802588,COGS 17,A01,092677,Staff,35,0,75,40
1650070808612,COGS 100,A01,083619,Staff,0,19,60,60
1650070814655,COGS 101A,A01,083621,Davis; Joshua Daniel,0,16,60,60
1650070820681,COGS 101B,A01,091572,Staff,13,0,60,47
1650070826709,COGS 101C,A01,083625,Delgado; Tania,21,0,30,9
1650070832735,COGS 107A,A01,083627,Boyle; Mary E. T.,1,3,60,59
1650070838759,COGS 118A,A01,083075,Staff,18,0,60,42
1650070844784,CSE 3,A50,083646,Miranda; Gregory Joseph,22,0,38,16
1650070844784,CSE 3,A51,083647,Miranda; Gregory Joseph,37,0,37,0
1650070850814,CSE 8A,A50,083650,Miranda; Gregory Joseph,0,15,40,40
1650070856852,CSE 11,A01,083080,Cao; Yingjun,0,66,40,40
1650070862894,CSE 12,A01,083652,Staff,0,2,100,100
1650070868917,CSE 15L,A01,083654,Staff,0,0,50,50
1650070868917,CSE 15L,A02,083655,Staff,10,0,50,40
1650070874951,CSE 20,A01,083657,Staff,58,0,80,22
1650070880974,CSE 30,A01,083084,Eldon; John,0,63,40,40
1650070887087,CSE 100,A01,083659,Cao; Yingjun,0,58,50,50
1650070893115,CSE 134B,A01,083661,Powell; Thomas Allan,1,28,65,64
1650070899147,CSE 140,A01,083663,Staff,6,0,75,69
1650070905173,CSE 140L,A01,083088,Eldon; John,1,0,75,74
1650070911199,CSE 175,A01,083665,Kumar; Rakesh,9,0,25,16
1650070921954,CSE 190,A00,092507,Dubnov; Shlomo,14,0,20,6
1650070927976,ECE 45,A01,083139,Staff,0,13,40,40
1650070934000,ECE 65,A50,083695,Staff,0,3,30,30
1650070940026,ECE 109,A01,091882,Touri; Behrouz,48,0,70,22
1650070946058,ECE 180,A00,083140,Abi Samra; Nicholas Camill,24,0,30,6
1650070946058,ECE 180,B00,083141,Abi Samra; Nicholas Camill,8,0,30,22
1650070952086,MATH 10A,A01,083735,Patchell; Gregory David,12,0,30,18
1650070952086,MATH 10A,A02,083736,Patchell; Gregory David,28,0,30,2
1650070952086,MATH 10A,A03,083737,Patchell; Gregory David,27,0,30,3
1650070958110,MATH 10B,A01,083207,Staff,0,5,30,30
1650070958110,MATH 10B,A02,083208,Staff,0,3,30,30
1650070958110,MATH 10B,B01,083739,Staff,18,0,30,12
1650070958110,MATH 10B,B02,083740,Staff,29,0,30,1
1650070964143,MATH 18,A01,083743,Staff,10,0,30,20
1650070964143,MATH 18,A02,083744,Staff,28,0,30,2
1650070964143,MATH 18,A03,083745,Staff,23,0,30,7
1650070964143,MATH 18,A04,083746,Staff,27,0,30,3
1650070964143,MATH 18,B01,083748,Staff,0,9,30,30
1650070964143,MATH 18,B02,083749,Staff,1,7,30,29
1650070964143,MATH 18,B03,083750,Staff,0,6,30,30
1650070964143,MATH 18,B04,083751,Staff,1,8,30,29
1650070970167,MATH 20A,A01,083754,Staff,26,0,40,14
1650070976191,MATH 20B,A01,083756,Staff,0,5,30,30
1650070976191,MATH 20B,A02,083757,Staff,0,1,30,30
1650070982222,MATH 20C,A01,083760,Staff,0,10,30,30
1650070982222,MATH 20C,A02,083761,Staff,0,12,30,30
1650070982222,MATH 20C,B01,083762,Staff,15,0,30,15
1650070982222,MATH 20C,B02,083763,Staff,28,0,30,2
1650070988261,MATH 20D,A01,083765,Staff,0,2,30,30
1650070988261,MATH 20D,A02,083766,Staff,14,0,30,16
1650070988261,MATH 20D,A03,083767,Staff,28,0,30,2
1650070994287,MATH 20E,A01,083771,Staff,10,0,30,20
1650070994287,MATH 20E,A02,083772,Staff,20,0,30,10
1650070994287,MATH 20E,B01,083773,Staff,2,2,30,28
1650070994287,MATH 20E,B02,083774,Staff,16,0,30,14
1650071000312,MATH 103A,A01,083777,Staff,0,8,30,30
1650071000312,MATH 103A,A02,083778,Staff,0,7,30,30
1650071000312,MATH 103A,B01,083779,Staff,0,8,30,30
1650071000312,MATH 103A,B02,083780,Staff,1,7,30,29
1650071006334,MATH 105,A01,085443,Staff,1,13,30,29
1650071012358,MATH 109,A01,083213,Anzaldo; Leesa B,1,4,30,29
1650071012358,MATH 109,A02,083214,Anzaldo; Leesa B,0,5,30,30
1650071012358,MATH 109,B01,083215,Anzaldo; Leesa B,0,4,30,30
1650071012358,MATH 109,B02,083216,Anzaldo; Leesa B,1,3,30,29
1650071018382,MATH 142A,A01,083219,Chow; Bennett,0,10,30,30
1650071018382,MATH 142A,A02,083220,Chow; Bennett,0,9,30,30
1650071018382,MATH 142A,B01,083221,Chow; Bennett,0,10,30,30
1650071018382,MATH 142A,B02,083222,Chow; Bennett,0,9,30,30
1650071024409,MATH 193A,A01,083224,Staff,0,4,30,30
1650071024409,MATH 193A,A02,083225,Staff,0,4,30,30
1650071024409,MATH 193A,A03,083781,Staff,0,0,30,30
1650071024409,MATH 193A,A04,083782,Staff,6,0,30,24
1650071030444,MATH 197,001,091859,McAuley; Julian John,9998,0,9999,1
1650071036524,COGS 9,A01,083615,Staff,3,17,60,57
1650071042553,COGS 11,A01,083617,Boyle; Mary E. T.,24,0,40,16
1650071048577,COGS 13,A01,083071,Staff,0,28,40,40
1650071054604,COGS 14A,A01,092681,Staff,0,11,100,100
1650071060631,COGS 14B,A01,083073,Cheng; Tzu-Han,0,4,50,50
1650071066655,COGS 17,A01,092677,Staff,35,0,75,40
1650071072680,COGS 100,A01,083619,Staff,0,19,60,60
1650071078708,COGS 101A,A01,083621,Davis; Joshua Daniel,0,16,60,60
1650071084739,COGS 101B,A01,091572,Staff,13,0,60,47
1650071090780,COGS 101C,A01,083625,Delgado; Tania,21,0,30,9
1650071096804,COGS 107A,A01,083627,Boyle; Mary E. T.,1,3,60,59
1650071102834,COGS 118A,A01,083075,Staff,18,0,60,42
1650071108868,CSE 3,A50,083646,Miranda; Gregory Joseph,22,0,38,16
1650071108868,CSE 3,A51,083647,Miranda; Gregory Joseph,37,0,37,0
1650071114892,CSE 8A,A50,083650,Miranda; Gregory Joseph,0,15,40,40
1650071120916,CSE 11,A01,083080,Cao; Yingjun,0,66,40,40
1650071126940,CSE 12,A01,083652,Staff,0,2,100,100
1650071132966,CSE 15L,A01,083654,Staff,0,0,50,50
1650071132966,CSE 15L,A02,083655,Staff,10,0,50,40
1650071138990,CSE 20,A01,083657,Staff,58,0,80,22
1650071145017,CSE 30,A01,083084,Eldon; John,0,63,40,40
1650071151045,CSE 100,A01,083659,Cao; Yingjun,0,58,50,50
1650071157069,CSE 134B,A01,083661,Powell; Thomas Allan,1,28,65,64
1650071163096,CSE 140,A01,083663,Staff,6,0,75,69
1650071169119,CSE 140L,A01,083088,Eldon; John,1,0,75,74
1650071175147,CSE 175,A01,083665,Kumar; Rakesh,9,0,25,16
1650071181170,CSE 190,A00,092507,Dubnov; Shlomo,14,0,20,6
1650071187196,ECE 45,A01,083139,Staff,0,13,40,40
1650071193224,ECE 65,A50,083695,Staff,0,3,30,30
1650071199247,ECE 109,A01,091882,Touri; Behrouz,48,0,70,22
1650071205271,ECE 180,A00,083140,Abi Samra; Nicholas Camill,24,0,30,6
1650071205271,ECE 180,B00,083141,Abi Samra; Nicholas Camill,8,0,30,22
1650071211300,MATH 10A,A01,083735,Patchell; Gregory David,12,0,30,18
1650071211300,MATH 10A,A02,083736,Patchell; Gregory David,28,0,30,2
1650071211300,MATH 10A,A03,083737,Patchell; Gregory David,27,0,30,3
1650071217331,MATH 10B,A01,083207,Staff,0,5,30,30
1650071217331,MATH 10B,A02,083208,Staff,0,3,30,30
1650071217331,MATH 10B,B01,083739,Staff,18,0,30,12
1650071217331,MATH 10B,B02,083740,Staff,29,0,30,1
1650071223374,MATH 18,A01,083743,Staff,10,0,30,20
1650071223374,MATH 18,A02,083744,Staff,28,0,30,2
1650071223374,MATH 18,A03,083745,Staff,23,0,30,7
1650071223374,MATH 18,A04,083746,Staff,27,0,30,3
1650071223374,MATH 18,B01,083748,Staff,0,9,30,30
1650071223374,MATH 18,B02,083749,Staff,1,7,30,29
1650071223374,MATH 18,B03,083750,Staff,0,6,30,30
1650071223374,MATH 18,B04,083751,Staff,1,8,30,29
1650071229400,MATH 20A,A01,083754,Staff,26,0,40,14
1650071235423,MATH 20B,A01,083756,Staff,0,5,30,30
1650071235423,MATH 20B,A02,083757,Staff,0,1,30,30
1650071241453,MATH 20C,A01,083760,Staff,0,10,30,30
1650071241453,MATH 20C,A02,083761,Staff,0,12,30,30
1650071241453,MATH 20C,B01,083762,Staff,15,0,30,15
1650071241453,MATH 20C,B02,083763,Staff,28,0,30,2
1650071247482,MATH 20D,A01,083765,Staff,0,2,30,30
1650071247482,MATH 20D,A02,083766,Staff,14,0,30,16
1650071247482,MATH 20D,A03,083767,Staff,28,0,30,2
1650071253516,MATH 20E,A01,083771,Staff,10,0,30,20
1650071253516,MATH 20E,A02,083772,Staff,20,0,30,10
1650071253516,MATH 20E,B01,083773,Staff,2,2,30,28
1650071253516,MATH 20E,B02,083774,Staff,16,0,30,14
1650071259543,MATH 103A,A01,083777,Staff,0,8,30,30
1650071259543,MATH 103A,A02,083778,Staff,0,7,30,30
1650071259543,MATH 103A,B01,083779,Staff,0,8,30,30
1650071259543,MATH 103A,B02,083780,Staff,1,7,30,29
1650071265580,MATH 105,A01,085443,Staff,1,13,30,29
1650071271604,MATH 109,A01,083213,Anzaldo; Leesa B,1,4,30,29
1650071271604,MATH 109,A02,083214,Anzaldo; Leesa B,0,5,30,30
1650071271604,MATH 109,B01,083215,Anzaldo; Leesa B,0,4,30,30
1650071271604,MATH 109,B02,083216,Anzaldo; Leesa B,1,3,30,29
1650071277632,MATH 142A,A01,083219,Chow; Bennett,0,10,30,30
1650071277632,MATH 142A,A02,083220,Chow; Bennett,0,9,30,30
1650071277632,MATH 142A,B01,083221,Chow; Bennett,0,10,30,30
1650071277632,MATH 142A,B02,083222,Chow; Bennett,0,9,30,30
1650071283672,MATH 193A,A01,083224,Staff,0,4,30,30
1650071283672,MATH 193A,A02,083225,Staff,0,4,30,30
1650071283672,MATH 193A,A03,083781,Staff,0,0,30,30
1650071283672,MATH 193A,A04,083782,Staff,6,0,30,24
1650071289695,MATH 197,001,091859,McAuley; Julian John,9998,0,9999,1
1650071295745,COGS 9,A01,083615,Staff,3,17,60,57
1650071301773,COGS 11,A01,083617,Boyle; Mary E. T.,24,0,40,16
1650071307800,COGS 13,A01,083071,Staff,0,28,40,40
1650071313823,COGS 14A,A01,092681,Staff,0,11,100,100
1650071319851,COGS 14B,A01,083073,Cheng; Tzu-Han,0,4,50,50
1650071325878,COGS 17,A01,092677,Staff,35,0,75,40
1650071331901,COGS 100,A01,083619,Staff,0,19,60,60
1650071337924,COGS 101A,A01,083621,Davis; Joshua Daniel,0,16,60,60
1650071343952,COGS 101B,A01,091572,Staff,13,0,60,47
1650071349976,COGS 101C,A01,083625,Delgado; Tania,21,0,30,9
1650071355999,COGS 107A,A01,083627,Boyle; Mary E. T.,1,3,60,59
1650071362022,COGS 118A,A01,083075,Staff,18,0,60,42
1650071368056,CSE 3,A50,083646,Miranda; Gregory Joseph,22,0,38,16
1650071368056,CSE 3,A51,083647,Miranda; Gregory Joseph,37,0,37,0
1650071374087,CSE 8A,A50,083650,Miranda; Gregory Joseph,0,15,40,40
1650071380109,CSE 11,A01,083080,Cao; Yingjun,0,66,40,40
1650071386138,CSE 12,A01,083652,Staff,0,2,100,100
1650071392163,CSE 15L,A01,083654,Staff,0,0,50,50
1650071392163,CSE 15L,A02,083655,Staff,10,0,50,40
1650071398187,CSE 20,A01,083657,Staff,58,0,80,22
1650071404210,CSE 30,A01,083084,Eldon; John,0,63,40,40
1650071410234,CSE 100,A01,083659,Cao; Yingjun,0,58,50,50
1650071416257,CSE 134B,A01,083661,Powell; Thomas Allan,1,28,65,64
1650071422290,CSE 140,A01,083663,Staff,5,0,75,70
1650071428313,CSE 140L,A01,083088,Eldon; John,0,0,75,75
1650071434341,CSE 175,A01,083665,Kumar; Rakesh,9,0,25,16
1650071440365,CSE 190,A00,092507,Dubnov; Shlomo,14,0,20,6
1650071446388,ECE 45,A01,083139,Staff,0,13,40,40
1650071452420,ECE 65,A50,083695,Staff,0,3,30,30
1650071458447,ECE 109,A01,091882,Touri; Behrouz,48,0,70,22
1650071464470,ECE 180,A00,083140,Abi Samra; Nicholas Camill,24,0,30,6
1650071464470,ECE 180,B00,083141,Abi Samra; Nicholas Camill,8,0,30,22
1650071470500,MATH 10A,A01,083735,Patchell; Gregory David,12,0,30,18
1650071470500,MATH 10A,A02,083736,Patchell; Gregory David,28,0,30,2
1650071470500,MATH 10A,A03,083737,Patchell; Gregory David,27,0,30,3
1650071476524,MATH 10B,A01,083207,Staff,0,5,30,30
1650071476524,MATH 10B,A02,083208,Staff,0,3,30,30
1650071476524,MATH 10B,B01,083739,Staff,18,0,30,12
1650071476524,MATH 10B,B02,083740,Staff,29,0,30,1
1650071482559,MATH 18,A01,083743,Staff,10,0,30,20
1650071482559,MATH 18,A02,083744,Staff,28,0,30,2
1650071482559,MATH 18,A03,083745,Staff,23,0,30,7
1650071482559,MATH 18,A04,083746,Staff,27,0,30,3
1650071482559,MATH 18,B01,083748,Staff,0,9,30,30
1650071482559,MATH 18,B02,083749,Staff,1,7,30,29
1650071482559,MATH 18,B03,083750,Staff,0,6,30,30
1650071482559,MATH 18,B04,083751,Staff,1,8,30,29
1650071488678,MATH 20A,A01,083754,Staff,26,0,40,14
1650071494702,MATH 20B,A01,083756,Staff,0,5,30,30
1650071494702,MATH 20B,A02,083757,Staff,0,1,30,30
1650071500731,MATH 20C,A01,083760,Staff,0,10,30,30
1650071500731,MATH 20C,A02,083761,Staff,0,12,30,30
1650071500731,MATH 20C,B01,083762,Staff,15,0,30,15
1650071500731,MATH 20C,B02,083763,Staff,28,0,30,2
1650071506759,MATH 20D,A01,083765,Staff,0,2,30,30
1650071506759,MATH 20D,A02,083766,Staff,14,0,30,16
1650071506759,MATH 20D,A03,083767,Staff,28,0,30,2
1650071512782,MATH 20E,A01,083771,Staff,10,0,30,20
1650071512782,MATH 20E,A02,083772,Staff,20,0,30,10
1650071512782,MATH 20E,B01,083773,Staff,2,2,30,28
1650071512782,MATH 20E,B02,083774,Staff,16,0,30,14
1650071518806,MATH 103A,A01,083777,Staff,0,8,30,30
1650071518806,MATH 103A,A02,083778,Staff,0,7,30,30
1650071518806,MATH 103A,B01,083779,Staff,0,8,30,30
1650071518806,MATH 103A,B02,083780,Staff,1,7,30,29
1650071524838,MATH 105,A01,085443,Staff,1,13,30,29
1650071530862,MATH 109,A01,083213,Anzaldo; Leesa B,1,4,30,29
1650071530862,MATH 109,A02,083214,Anzaldo; Leesa B,0,5,30,30
1650071530862,MATH 109,B01,083215,Anzaldo; Leesa B,0,4,30,30
1650071530862,MATH 109,B02,083216,Anzaldo; Leesa B,1,3,30,29
1650071536895,MATH 142A,A01,083219,Chow; Bennett,0,10,30,30
1650071536895,MATH 142A,A02,083220,Chow; Bennett,0,9,30,30
1650071536895,MATH 142A,B01,083221,Chow; Bennett,0,10,30,30
1650071536895,MATH 142A,B02,083222,Chow; Bennett,0,9,30,30
1650071542919,MATH 193A,A01,083224,Staff,0,4,30,30
1650071542919,MATH 193A,A02,083225,Staff,0,4,30,30
1650071542919,MATH 193A,A03,083781,Staff,0,0,30,30
1650071542919,MATH 193A,A04,083782,Staff,6,0,30,24
1650071548944,MATH 197,001,091859,McAuley; Julian John,9998,0,9999,1
1650071554994,COGS 9,A01,083615,Staff,3,17,60,57
1650071561036,COGS 11,A01,083617,Boyle; Mary E. T.,24,0,40,16
1650071567060,COGS 13,A01,083071,Staff,0,28,40,40
1650071573094,COGS 14A,A01,092681,Staff,0,11,100,100
1650071579122,COGS 14B,A01,083073,Cheng; Tzu-Han,0,4,50,50
1650071585148,COGS 17,A01,092677,Staff,35,0,75,40
1650071591174,COGS 100,A01,083619,Staff,0,19,60,60
1650071597196,COGS 101A,A01,083621,Davis; Joshua Daniel,0,16,60,60
1650071603218,COGS 101B,A01,091572,Staff,13,0,60,47
1650071609244,COGS 101C,A01,083625,Delgado; Tania,21,0,30,9
1650071615273,COGS 107A,A01,083627,Boyle; Mary E. T.,1,3,60,59
1650071621302,COGS 118A,A01,083075,Staff,18,0,60,42
1650071627330,CSE 3,A50,083646,Miranda; Gregory Joseph,22,0,38,16
1650071627330,CSE 3,A51,083647,Miranda; Gregory Joseph,37,0,37,0
1650071633352,CSE 8A,A50,083650,Miranda; Gregory Joseph,0,15,40,40
1650071639381,CSE 11,A01,083080,Cao; Yingjun,0,66,40,40
1650071645407,CSE 12,A01,083652,Staff,0,2,100,100
1650071651435,CSE 15L,A01,083654,Staff,0,0,50,50
1650071651435,CSE 15L,A02,083655,Staff,10,0,50,40
1650071657473,CSE 20,A01,083657,Staff,58,0,80,22
1650071663495,CSE 30,A01,083084,Eldon; John,0,63,40,40
1650071669523,CSE 100,A01,083659,Cao; Yingjun,0,58,50,50
1650071675554,CSE 134B,A01,083661,Powell; Thomas Allan,1,28,65,64
1650071681577,CSE 140,A01,083663,Staff,5,0,75,70
1650071687608,CSE 140L,A01,083088,Eldon; John,0,0,75,75
1650071693630,CSE 175,A01,083665,Kumar; Rakesh,9,0,25,16
1650071699655,CSE 190,A00,092507,Dubnov; Shlomo,14,0,20,6
1650071705678,ECE 45,A01,083139,Staff,0,13,40,40
1650071711704,ECE 65,A50,083695,Staff,0,3,30,30
1650071717730,ECE 109,A01,091882,Touri; Behrouz,48,0,70,22
1650071723757,ECE 180,A00,083140,Abi Samra; Nicholas Camill,24,0,30,6
1650071723757,ECE 180,B00,083141,Abi Samra; Nicholas Camill,8,0,30,22
1650071729788,MATH 10A,A01,083735,Patchell; Gregory David,12,0,30,18
1650071729788,MATH 10A,A02,083736,Patchell; Gregory David,28,0,30,2
1650071729788,MATH 10A,A03,083737,Patchell; Gregory David,27,0,30,3
1650071735813,MATH 10B,A01,083207,Staff,0,5,30,30
1650071735813,MATH 10B,A02,083208,Staff,0,3,30,30
1650071735813,MATH 10B,B01,083739,Staff,18,0,30,12
1650071735813,MATH 10B,B02,083740,Staff,29,0,30,1
1650071741842,MATH 18,A01,083743,Staff,10,0,30,20
1650071741842,MATH 18,A02,083744,Staff,28,0,30,2
1650071741842,MATH 18,A03,083745,Staff,23,0,30,7
1650071741842,MATH 18,A04,083746,Staff,27,0,30,3
1650071741842,MATH 18,B01,083748,Staff,0,9,30,30
1650071741842,MATH 18,B02,083749,Staff,1,7,30,29
1650071741842,MATH 18,B03,083750,Staff,0,6,30,30
1650071741842,MATH 18,B04,083751,Staff,1,8,30,29
1650071747865,MATH 20A,A01,083754,Staff,26,0,40,14
1650071753900,MATH 20B,A01,083756,Staff,0,5,30,30
1650071753900,MATH 20B,A02,083757,Staff,0,1,30,30
1650071759924,MATH 20C,A01,083760,Staff,0,10,30,30
1650071759924,MATH 20C,A02,083761,Staff,0,12,30,30
1650071759924,MATH 20C,B01,083762,Staff,14,0,30,16
1650071759924,MATH 20C,B02,083763,Staff,28,0,30,2
1650071765956,MATH 20D,A01,083765,Staff,0,2,30,30
1650071765956,MATH 20D,A02,083766,Staff,14,0,30,16
1650071765956,MATH 20D,A03,083767,Staff,28,0,30,2
1650071771982,MATH 20E,A01,083771,Staff,10,0,30,20
1650071771982,MATH 20E,A02,083772,Staff,20,0,30,10
1650071771982,MATH 20E,B01,083773,Staff,2,2,30,28
1650071771982,MATH 20E,B02,083774,Staff,16,0,30,14
1650071778005,MATH 103A,A01,083777,Staff,0,8,30,30
1650071778005,MATH 103A,A02,083778,Staff,0,7,30,30
1650071778005,MATH 103A,B01,083779,Staff,0,8,30,30
1650071778005,MATH 103A,B02,083780,Staff,1,7,30,29
1650071784030,MATH 105,A01,085443,Staff,1,13,30,29
1650071790054,MATH 109,A01,083213,Anzaldo; Leesa B,1,4,30,29
1650071790054,MATH 109,A02,083214,Anzaldo; Leesa B,0,5,30,30
1650071790054,MATH 109,B01,083215,Anzaldo; Leesa B,0,4,30,30
1650071790054,MATH 109,B02,083216,Anzaldo; Leesa B,1,3,30,29
1650071796078,MATH 142A,A01,083219,Chow; Bennett,0,10,30,30
1650071796078,MATH 142A,A02,083220,Chow; Bennett,0,10,30,30
1650071796078,MATH 142A,B01,083221,Chow; Bennett,0,10,30,30
1650071796078,MATH 142A,B02,083222,Chow; Bennett,0,9,30,30
1650071802103,MATH 193A,A01,083224,Staff,0,4,30,30
1650071802103,MATH 193A,A02,083225,Staff,0,4,30,30
1650071802103,MATH 193A,A03,083781,Staff,0,0,30,30
1650071802103,MATH 193A,A04,083782,Staff,6,0,30,24
1650071808129,MATH 197,001,091859,McAuley; Julian John,9998,0,9999,1
1650071814177,COGS 9,A01,083615,Staff,3,17,60,57
1650071820200,COGS 11,A01,083617,Boyle; Mary E. T.,24,0,40,16
1650071826228,COGS 13,A01,083071,Staff,0,28,40,40
1650071832251,COGS 14A,A01,092681,Staff,0,11,100,100
1650071838274,COGS 14B,A01,083073,Cheng; Tzu-Han,0,4,50,50
1650071844300,COGS 17,A01,092677,Staff,35,0,75,40
1650071850323,COGS 100,A01,083619,Staff,0,19,60,60
1650071856352,COGS 101A,A01,083621,Davis; Joshua Daniel,0,16,60,60
1650071862383,COGS 101B,A01,091572,Staff,13,0,60,47
1650071868407,COGS 101C,A01,083625,Delgado; Tania,21,0,30,9
1650071874430,COGS 107A,A01,083627,Boyle; Mary E. T.,1,3,60,59
1650071880456,COGS 118A,A01,083075,Staff,18,0,60,42
1650071886481,CSE 3,A50,083646,Miranda; Gregory Joseph,22,0,38,16
1650071886481,CSE 3,A51,083647,Miranda; Gregory Joseph,37,0,37,0
1650071892505,CSE 8A,A50,083650,Miranda; Gregory Joseph,0,15,40,40
1650071898531,CSE 11,A01,083080,Cao; Yingjun,0,66,40,40
1650071904554,CSE 12,A01,083652,Staff,0,2,100,100
1650071910593,CSE 15L,A01,083654,Staff,0,0,50,50
1650071910593,CSE 15L,A02,083655,Staff,10,0,50,40
1650071916621,CSE 20,A01,083657,Staff,58,0,80,22
1650071922643,CSE 30,A01,083084,Eldon; John,0,63,40,40
1650071928666,CSE 100,A01,083659,Cao; Yingjun,0,58,50,50
1650071934694,CSE 134B,A01,083661,Powell; Thomas Allan,1,28,65,64
1650071940722,CSE 140,A01,083663,Staff,5,0,75,70
1650071946746,CSE 140L,A01,083088,Eldon; John,0,0,75,75
1650071952770,CSE 175,A01,083665,Kumar; Rakesh,9,0,25,16
1650071958804,CSE 190,A00,092507,Dubnov; Shlomo,14,0,20,6
1650071964836,ECE 45,A01,083139,Staff,0,13,40,40
1650071970861,ECE 65,A50,083695,Staff,0,3,30,30
1650071976888,ECE 109,A01,091882,Touri; Behrouz,48,0,70,22
1650071982911,ECE 180,A00,083140,Abi Samra; Nicholas Camill,24,0,30,6
1650071982911,ECE 180,B00,083141,Abi Samra; Nicholas Camill,8,0,30,22
1650071988959,MATH 10A,A01,083735,Patchell; Gregory David,12,0,30,18
1650071988959,MATH 10A,A02,083736,Patchell; Gregory David,28,0,30,2
1650071988959,MATH 10A,A03,083737,Patchell; Gregory David,27,0,30,3
1650071994998,MATH 10B,A01,083207,Staff,0,5,30,30
1650071994998,MATH 10B,A02,083208,Staff,0,3,30,30
1650071994998,MATH 10B,B01,083739,Staff,18,0,30,12
1650071994998,MATH 10B,B02,083740,Staff,29,0,30,1
1650072001023,MATH 18,A01,083743,Staff,10,0,30,20
1650072001023,MATH 18,A02,083744,Staff,28,0,30,2
1650072001023,MATH 18,A03,083745,Staff,23,0,30,7
1650072001023,MATH 18,A04,083746,Staff,27,0,30,3
1650072001023,MATH 18,B01,083748,Staff,0,9,30,30
1650072001023,MATH 18,B02,083749,Staff,1,7,30,29
1650072001023,MATH 18,B03,083750,Staff,0,6,30,30
1650072001023,MATH 18,B04,083751,Staff,1,8,30,29
1650072007058,MATH 20A,A01,083754,Staff,26,0,40,14
1650072013086,MATH 20B,A01,083756,Staff,0,5,30,30
1650072013086,MATH 20B,A02,083757,Staff,0,1,30,30
1650072019110,MATH 20C,A01,083760,Staff,0,10,30,30
1650072019110,MATH 20C,A02,083761,Staff,0,12,30,30
1650072019110,MATH 20C,B01,083762,Staff,14,0,30,16
1650072019110,MATH 20C,B02,083763,Staff,28,0,30,2
1650072025137,MATH 20D,A01,083765,Staff,0,2,30,30
1650072025137,MATH 20D,A02,083766,Staff,14,0,30,16
1650072025137,MATH 20D,A03,083767,Staff,28,0,30,2
1650072031164,MATH 20E,A01,083771,Staff,10,0,30,20
1650072031164,MATH 20E,A02,083772,Staff,20,0,30,10
1650072031164,MATH 20E,B01,083773,Staff,2,2,30,28
1650072031164,MATH 20E,B02,083774,Staff,16,0,30,14
1650072037189,MATH 103A,A01,083777,Staff,0,8,30,30
1650072037189,MATH 103A,A02,083778,Staff,0,7,30,30
1650072037189,MATH 103A,B01,083779,Staff,0,8,30,30
1650072037189,MATH 103A,B02,083780,Staff,1,7,30,29
1650072043218,MATH 105,A01,085443,Staff,1,13,30,29
1650072049242,MATH 109,A01,083213,Anzaldo; Leesa B,1,4,30,29
1650072049242,MATH 109,A02,083214,Anzaldo; Leesa B,0,5,30,30
1650072049242,MATH 109,B01,083215,Anzaldo; Leesa B,0,4,30,30
1650072049242,MATH 109,B02,083216,Anzaldo; Leesa B,1,3,30,29
1650072055272,MATH 142A,A01,083219,Chow; Bennett,0,10,30,30
1650072055272,MATH 142A,A02,083220,Chow; Bennett,0,10,30,30
1650072055272,MATH 142A,B01,083221,Chow; Bennett,0,10,30,30
1650072055272,MATH 142A,B02,083222,Chow; Bennett,0,9,30,30
1650072061300,MATH 193A,A01,083224,Staff,0,4,30,30
1650072061300,MATH 193A,A02,083225,Staff,0,4,30,30
1650072061300,MATH 193A,A03,083781,Staff,0,0,30,30
1650072061300,MATH 193A,A04,083782,Staff,6,0,30,24
1650072067324,MATH 197,001,091859,McAuley; Julian John,9998,0,9999,1
1650072073376,COGS 9,A01,083615,Staff,3,17,60,57
1650072079479,COGS 11,A01,083617,Boyle; Mary E. T.,24,0,40,16
1650072085503,COGS 13,A01,083071,Staff,0,28,40,40
1650072091539,COGS 14A,A01,092681,Staff,0,11,100,100
1650072097568,COGS 14B,A01,083073,Cheng; Tzu-Han,0,4,50,50
1650072103592,COGS 17,A01,092677,Staff,35,0,75,40
1650072109619,COGS 100,A01,083619,Staff,0,19,60,60
1650072115646,COGS 101A,A01,083621,Davis; Joshua Daniel,0,16,60,60
1650072121674,COGS 101B,A01,091572,Staff,13,0,60,47
1650072127701,COGS 101C,A01,083625,Delgado; Tania,21,0,30,9
1650072133728,COGS 107A,A01,083627,Boyle; Mary E. T.,1,3,60,59
1650072139751,COGS 118A,A01,083075,Staff,18,0,60,42
1650072145776,CSE 3,A50,083646,Miranda; Gregory Joseph,22,0,38,16
1650072145776,CSE 3,A51,083647,Miranda; Gregory Joseph,37,0,37,0
1650072151800,CSE 8A,A50,083650,Miranda; Gregory Joseph,0,15,40,40
1650072157824,CSE 11,A01,083080,Cao; Yingjun,0,66,40,40
1650072163849,CSE 12,A01,083652,Staff,0,2,100,100
1650072169880,CSE 15L,A01,083654,Staff,0,0,50,50
1650072169880,CSE 15L,A02,083655,Staff,10,0,50,40
1650072175906,CSE 20,A01,083657,Staff,58,0,80,22
1650072181933,CSE 30,A01,083084,Eldon; John,0,63,40,40
1650072187965,CSE 100,A01,083659,Cao; Yingjun,0,59,50,50
1650072193999,CSE 134B,A01,083661,Powell; Thomas Allan,1,28,65,64
1650072200027,CSE 140,A01,083663,Staff,5,0,75,70
1650072206048,CSE 140L,A01,083088,Eldon; John,0,0,75,75
1650072212075,CSE 175,A01,083665,Kumar; Rakesh,9,0,25,16
1650072218099,CSE 190,A00,092507,Dubnov; Shlomo,14,0,20,6
1650072224123,ECE 45,A01,083139,Staff,0,13,40,40
1650072230148,ECE 65,A50,083695,Staff,0,3,30,30
1650072236176,ECE 109,A01,091882,Touri; Behrouz,48,0,70,22
1650072242199,ECE 180,A00,083140,Abi Samra; Nicholas Camill,24,0,30,6
1650072242199,ECE 180,B00,083141,Abi Samra; Nicholas Camill,8,0,30,22
1650072248221,MATH 10A,A01,083735,Patchell; Gregory David,12,0,30,18
1650072248221,MATH 10A,A02,083736,Patchell; Gregory David,28,0,30,2
1650072248221,MATH 10A,A03,083737,Patchell; Gregory David,27,0,30,3
1650072254248,MATH 10B,A01,083207,Staff,0,5,30,30
1650072254248,MATH 10B,A02,083208,Staff,0,3,30,30
1650072254248,MATH 10B,B01,083739,Staff,18,0,30,12
1650072254248,MATH 10B,B02,083740,Staff,29,0,30,1
1650072260274,MATH 18,A01,083743,Staff,10,0,30,20
1650072260274,MATH 18,A02,083744,Staff,28,0,30,2
1650072260274,MATH 18,A03,083745,Staff,23,0,30,7
1650072260274,MATH 18,A04,083746,Staff,27,0,30,3
1650072260274,MATH 18,B01,083748,Staff,0,9,30,30
1650072260274,MATH 18,B02,083749,Staff,1,7,30,29
1650072260274,MATH 18,B03,083750,Staff,0,6,30,30
1650072260274,MATH 18,B04,083751,Staff,1,8,30,29
1650072266297,MATH 20A,A01,083754,Staff,26,0,40,14
1650072272319,MATH 20B,A01,083756,Staff,0,5,30,30
1650072272319,MATH 20B,A02,083757,Staff,0,1,30,30
1650072278357,MATH 20C,A01,083760,Staff,0,10,30,30
1650072278357,MATH 20C,A02,083761,Staff,0,12,30,30
1650072278357,MATH 20C,B01,083762,Staff,14,0,30,16
1650072278357,MATH 20C,B02,083763,Staff,28,0,30,2
1650072284384,MATH 20D,A01,083765,Staff,0,2,30,30
1650072284384,MATH 20D,A02,083766,Staff,14,0,30,16
1650072284384,MATH 20D,A03,083767,Staff,28,0,30,2
1650072290408,MATH 20E,A01,083771,Staff,10,0,30,20
1650072290408,MATH 20E,A02,083772,Staff,20,0,30,10
1650072290408,MATH 20E,B01,083773,Staff,2,2,30,28
1650072290408,MATH 20E,B02,083774,Staff,16,0,30,14
1650072296432,MATH 103A,A01,083777,Staff,0,8,30,30
1650072296432,MATH 103A,A02,083778,Staff,0,7,30,30
1650072296432,MATH 103A,B01,083779,Staff,0,8,30,30
1650072296432,MATH 103A,B02,083780,Staff,1,7,30,29
1650072302456,MATH 105,A01,085443,Staff,1,13,30,29
1650072308479,MATH 109,A01,083213,Anzaldo; Leesa B,1,4,30,29
1650072308479,MATH 109,A02,083214,Anzaldo; Leesa B,0,5,30,30
1650072308479,MATH 109,B01,083215,Anzaldo; Leesa B,0,4,30,30
1650072308479,MATH 109,B02,083216,Anzaldo; Leesa B,1,3,30,29
1650072314512,MATH 142A,A01,083219,Chow; Bennett,0,10,30,30
1650072314512,MATH 142A,A02,083220,Chow; Bennett,0,10,30,30
1650072314512,MATH 142A,B01,083221,Chow; Bennett,0,10,30,30
1650072314512,MATH 142A,B02,083222,Chow; Bennett,0,9,30,30
1650072320544,MATH 193A,A01,083224,Staff,0,4,30,30
1650072320544,MATH 193A,A02,083225,Staff,0,4,30,30
1650072320544,MATH 193A,A03,083781,Staff,0,0,30,30
1650072320544,MATH 193A,A04,083782,Staff,6,0,30,24
1650072326566,MATH 197,001,091859,McAuley; Julian John,9998,0,9999,1
1650072332629,COGS 9,A01,083615,Staff,3,17,60,57
1650072338657,COGS 11,A01,083617,Boyle; Mary E. T.,24,0,40,16
1650072344679,COGS 13,A01,083071,Staff,0,28,40,40
1650072350706,COGS 14A,A01,092681,Staff,0,11,100,100
1650072356732,COGS 14B,A01,083073,Cheng; Tzu-Han,0,4,50,50
1650072362771,COGS 17,A01,092677,Staff,35,0,75,40
1650072368795,COGS 100,A01,083619,Staff,0,19,60,60
1650072374818,COGS 101A,A01,083621,Davis; Joshua Daniel,0,16,60,60
1650072380839,COGS 101B,A01,091572,Staff,13,0,60,47
1650072386864,COGS 101C,A01,083625,Delgado; Tania,21,0,30,9
1650072392893,COGS 107A,A01,083627,Boyle; Mary E. T.,1,3,60,59
1650072398920,COGS 118A,A01,083075,Staff,18,0,60,42
1650072404945,CSE 3,A50,083646,Miranda; Gregory Joseph,22,0,38,16
1650072404945,CSE 3,A51,083647,Miranda; Gregory Joseph,37,0,37,0
1650072410975,CSE 8A,A50,083650,Miranda; Gregory Joseph,0,15,40,40
1650072416998,CSE 11,A01,083080,Cao; Yingjun,0,66,40,40
1650072423023,CSE 12,A01,083652,Staff,0,2,100,100
1650072429045,CSE 15L,A01,083654,Staff,0,0,50,50
1650072429045,CSE 15L,A02,083655,Staff,10,0,50,40
1650072435072,CSE 20,A01,083657,Staff,58,0,80,22
1650072441096,CSE 30,A01,083084,Eldon; John,0,63,40,40
1650072447120,CSE 100,A01,083659,Cao; Yingjun,0,59,50,50
1650072453146,CSE 134B,A01,083661,Powell; Thomas Allan,1,28,65,64
1650072459172,CSE 140,A01,083663,Staff,5,0,75,70
1650072465197,CSE 140L,A01,083088,Eldon; John,0,0,75,75
1650072471226,CSE 175,A01,083665,Kumar; Rakesh,9,0,25,16
1650072477255,CSE 190,A00,092507,Dubnov; Shlomo,14,0,20,6
1650072483282,ECE 45,A01,083139,Staff,0,13,40,40
1650072489304,ECE 65,A50,083695,Staff,0,3,30,30
1650072495333,ECE 109,A01,091882,Touri; Behrouz,48,0,70,22
1650072501359,ECE 180,A00,083140,Abi Samra; Nicholas Camill,24,0,30,6
1650072501359,ECE 180,B00,083141,Abi Samra; Nicholas Camill,8,0,30,22
1650072507384,MATH 10A,A01,083735,Patchell; Gregory David,12,0,30,18
1650072507384,MATH 10A,A02,083736,Patchell; Gregory David,28,0,30,2
1650072507384,MATH 10A,A03,083737,Patchell; Gregory David,27,0,30,3
1650072513407,MATH 10B,A01,083207,Staff,0,5,30,30
1650072513407,MATH 10B,A02,083208,Staff,0,3,30,30
1650072513407,MATH 10B,B01,083739,Staff,18,0,30,12
1650072513407,MATH 10B,B02,083740,Staff,29,0,30,1
1650072519452,MATH 18,A01,083743,Staff,10,0,30,20
1650072519452,MATH 18,A02,083744,Staff,28,0,30,2
1650072519452,MATH 18,A03,083745,Staff,23,0,30,7
1650072519452,MATH 18,A04,083746,Staff,27,0,30,3
1650072519452,MATH 18,B01,083748,Staff,0,9,30,30
1650072519452,MATH 18,B02,083749,Staff,1,7,30,29
1650072519452,MATH 18,B03,083750,Staff,0,6,30,30
1650072519452,MATH 18,B04,083751,Staff,1,8,30,29
1650072525482,MATH 20A,A01,083754,Staff,26,0,40,14
1650072531504,MATH 20B,A01,083756,Staff,0,5,30,30
1650072531504,MATH 20B,A02,083757,Staff,0,1,30,30
1650072537531,MATH 20C,A01,083760,Staff,0,10,30,30
1650072537531,MATH 20C,A02,083761,Staff,0,12,30,30
1650072537531,MATH 20C,B01,083762,Staff,14,0,30,16
1650072537531,MATH 20C,B02,083763,Staff,28,0,30,2
1650072543559,MATH 20D,A01,083765,Staff,0,2,30,30
1650072543559,MATH 20D,A02,083766,Staff,14,0,30,16
1650072543559,MATH 20D,A03,083767,Staff,28,0,30,2
1650072549582,MATH 20E,A01,083771,Staff,10,0,30,20
1650072549582,MATH 20E,A02,083772,Staff,20,0,30,10
1650072549582,MATH 20E,B01,083773,Staff,2,2,30,28
1650072549582,MATH 20E,B02,083774,Staff,16,0,30,14
1650072555611,MATH 103A,A01,083777,Staff,0,8,30,30
1650072555611,MATH 103A,A02,083778,Staff,0,7,30,30
1650072555611,MATH 103A,B01,083779,Staff,0,8,30,30
1650072555611,MATH 103A,B02,083780,Staff,1,7,30,29
1650072561651,MATH 105,A01,085443,Staff,1,13,30,29
1650072567676,MATH 109,A01,083213,Anzaldo; Leesa B,1,4,30,29
1650072567676,MATH 109,A02,083214,Anzaldo; Leesa B,0,5,30,30
1650072567676,MATH 109,B01,083215,Anzaldo; Leesa B,0,4,30,30
1650072567676,MATH 109,B02,083216,Anzaldo; Leesa B,1,3,30,29
1650072573699,MATH 142A,A01,083219,Chow; Bennett,0,10,30,30
1650072573699,MATH 142A,A02,083220,Chow; Bennett,0,10,30,30
1650072573699,MATH 142A,B01,083221,Chow; Bennett,0,10,30,30
1650072573699,MATH 142A,B02,083222,Chow; Bennett,0,9,30,30
1650072579732,MATH 193A,A01,083224,Staff,0,4,30,30
1650072579732,MATH 193A,A02,083225,Staff,0,4,30,30
1650072579732,MATH 193A,A03,083781,Staff,0,0,30,30
1650072579732,MATH 193A,A04,083782,Staff,6,0,30,24
1650072585772,MATH 197,001,091859,McAuley; Julian John,9998,0,9999,1
1650072591836,COGS 9,A01,083615,Staff,3,17,60,57
1650072597865,COGS 11,A01,083617,Boyle; Mary E. T.,24,0,40,16
1650072603892,COGS 13,A01,083071,Staff,0,28,40,40
1650072609917,COGS 14A,A01,092681,Staff,0,11,100,100
1650072615941,COGS 14B,A01,083073,Cheng; Tzu-Han,0,4,50,50
1650072621966,COGS 17,A01,092677,Staff,35,0,75,40
1650072627988,COGS 100,A01,083619,Staff,0,20,60,60
1650072634014,COGS 101A,A01,083621,Davis; Joshua Daniel,0,17,60,60
1650072640037,COGS 101B,A01,091572,Staff,13,0,60,47
1650072646060,COGS 101C,A01,083625,Delgado; Tania,21,0,30,9
1650072652095,COGS 107A,A01,083627,Boyle; Mary E. T.,1,3,60,59
1650072658120,COGS 118A,A01,083075,Staff,18,0,60,42
1650072664144,CSE 3,A50,083646,Miranda; Gregory Joseph,22,0,38,16
1650072664144,CSE 3,A51,083647,Miranda; Gregory Joseph,37,0,37,0
1650072670171,CSE 8A,A50,083650,Miranda; Gregory Joseph,0,15,40,40
1650072676288,CSE 11,A01,083080,Cao; Yingjun,0,66,40,40
1650072682310,CSE 12,A01,083652,Staff,0,2,100,100
1650072688333,CSE 15L,A01,083654,Staff,0,0,50,50
1650072688333,CSE 15L,A02,083655,Staff,10,0,50,40
1650072694359,CSE 20,A01,083657,Staff,58,0,80,22
1650072700384,CSE 30,A01,083084,Eldon; John,0,63,40,40
1650072706410,CSE 100,A01,083659,Cao; Yingjun,0,59,50,50
1650072712433,CSE 134B,A01,083661,Powell; Thomas Allan,1,28,65,64
1650072718465,CSE 140,A01,083663,Staff,5,0,75,70
1650072724488,CSE 140L,A01,083088,Eldon; John,0,0,75,75
1650072730512,CSE 175,A01,083665,Kumar; Rakesh,9,0,25,16
1650072736535,CSE 190,A00,092507,Dubnov; Shlomo,14,0,20,6
1650072742563,ECE 45,A01,083139,Staff,0,13,40,40
1650072748590,ECE 65,A50,083695,Staff,0,3,30,30
1650072754612,ECE 109,A01,091882,Touri; Behrouz,48,0,70,22
1650072760635,ECE 180,A00,083140,Abi Samra; Nicholas Camill,24,0,30,6
1650072760635,ECE 180,B00,083141,Abi Samra; Nicholas Camill,8,0,30,22
1650072766659,MATH 10A,A01,083735,Patchell; Gregory David,12,0,30,18
1650072766659,MATH 10A,A02,083736,Patchell; Gregory David,28,0,30,2
1650072766659,MATH 10A,A03,083737,Patchell; Gregory David,27,0,30,3
1650072772689,MATH 10B,A01,083207,Staff,0,5,30,30
1650072772689,MATH 10B,A02,083208,Staff,0,3,30,30
1650072772689,MATH 10B,B01,083739,Staff,18,0,30,12
1650072772689,MATH 10B,B02,083740,Staff,29,0,30,1
1650072778718,MATH 18,A01,083743,Staff,10,0,30,20
1650072778718,MATH 18,A02,083744,Staff,28,0,30,2
1650072778718,MATH 18,A03,083745,Staff,23,0,30,7
1650072778718,MATH 18,A04,083746,Staff,27,0,30,3
1650072778718,MATH 18,B01,083748,Staff,0,9,30,30
1650072778718,MATH 18,B02,083749,Staff,1,7,30,29
1650072778718,MATH 18,B03,083750,Staff,0,6,30,30
1650072778718,MATH 18,B04,083751,Staff,1,8,30,29
1650072784745,MATH 20A,A01,083754,Staff,26,0,40,14
1650072790769,MATH 20B,A01,083756,Staff,0,5,30,30
1650072790769,MATH 20B,A02,083757,Staff,0,1,30,30
1650072796793,MATH 20C,A01,083760,Staff,0,10,30,30
1650072796793,MATH 20C,A02,083761,Staff,0,12,30,30
1650072796793,MATH 20C,B01,083762,Staff,14,0,30,16
1650072796793,MATH 20C,B02,083763,Staff,28,0,30,2
1650072802817,MATH 20D,A01,083765,Staff,0,2,30,30
1650072802817,MATH 20D,A02,083766,Staff,14,0,30,16
1650072802817,MATH 20D,A03,083767,Staff,28,0,30,2
1650072808840,MATH 20E,A01,083771,Staff,10,0,30,20
1650072808840,MATH 20E,A02,083772,Staff,20,0,30,10
1650072808840,MATH 20E,B01,083773,Staff,2,2,30,28
1650072808840,MATH 20E,B02,083774,Staff,16,0,30,14
1650072814866,MATH 103A,A01,083777,Staff,0,8,30,30
1650072814866,MATH 103A,A02,083778,Staff,0,7,30,30
1650072814866,MATH 103A,B01,083779,Staff,0,8,30,30
1650072814866,MATH 103A,B02,083780,Staff,1,7,30,29
1650072820889,MATH 105,A01,085443,Staff,1,13,30,29
1650072826920,MATH 109,A01,083213,Anzaldo; Leesa B,1,4,30,29
1650072826920,MATH 109,A02,083214,Anzaldo; Leesa B,0,5,30,30
1650072826920,MATH 109,B01,083215,Anzaldo; Leesa B,0,4,30,30
1650072826920,MATH 109,B02,083216,Anzaldo; Leesa B,1,3,30,29
1650072832956,MATH 142A,A01,083219,Chow; Bennett,0,10,30,30
1650072832956,MATH 142A,A02,083220,Chow; Bennett,0,10,30,30
1650072832956,MATH 142A,B01,083221,Chow; Bennett,0,10,30,30
1650072832956,MATH 142A,B02,083222,Chow; Bennett,0,9,30,30
1650072838980,MATH 193A,A01,083224,Staff,0,4,30,30
1650072838980,MATH 193A,A02,083225,Staff,0,4,30,30
1650072838980,MATH 193A,A03,083781,Staff,0,0,30,30
1650072838980,MATH 193A,A04,083782,Staff,6,0,30,24
1650072845005,MATH 197,001,091859,McAuley; Julian John,9998,0,9999,1
1650072851067,COGS 9,A01,083615,Staff,3,17,60,57
1650072857092,COGS 11,A01,083617,Boyle; Mary E. T.,24,0,40,16
1650072863115,COGS 13,A01,083071,Staff,0,28,40,40
1650072869139,COGS 14A,A01,092681,Staff,0,11,100,100
1650072875169,COGS 14B,A01,083073,Cheng; Tzu-Han,0,4,50,50
1650072881191,COGS 17,A01,092677,Staff,35,0,75,40
1650072887222,COGS 100,A01,083619,Staff,0,20,60,60
1650072893244,COGS 101A,A01,083621,Davis; Joshua Daniel,0,16,60,60
1650072899267,COGS 101B,A01,091572,Staff,12,0,60,48
1650072905289,COGS 101C,A01,083625,Delgado; Tania,21,0,30,9
1650072911320,COGS 107A,A01,083627,Boyle; Mary E. T.,1,3,60,59
1650072917348,COGS 118A,A01,083075,Staff,18,0,60,42
1650072923375,CSE 3,A50,083646,Miranda; Gregory Joseph,22,0,38,16
1650072923375,CSE 3,A51,083647,Miranda; Gregory Joseph,37,0,37,0
1650072929398,CSE 8A,A50,083650,Miranda; Gregory Joseph,0,15,40,40
1650072935425,CSE 11,A01,083080,Cao; Yingjun,0,66,40,40
1650072941456,CSE 12,A01,083652,Staff,0,2,100,100
1650072947484,CSE 15L,A01,083654,Staff,0,0,50,50
1650072947484,CSE 15L,A02,083655,Staff,10,0,50,40
1650072953510,CSE 20,A01,083657,Staff,58,0,80,22
1650072959533,CSE 30,A01,083084,Eldon; John,0,63,40,40
1650072965558,CSE 100,A01,083659,Cao; Yingjun,0,59,50,50
1650072971586,CSE 134B,A01,083661,Powell; Thomas Allan,1,28,65,64
1650072977612,CSE 140,A01,083663,Staff,4,0,75,71
1650072983652,CSE 140L,A01,083088,Eldon; John,0,1,75,75
1650072989678,CSE 175,A01,083665,Kumar; Rakesh,9,0,25,16
1650072995701,CSE 190,A00,092507,Dubnov; Shlomo,14,0,20,6
1650073001725,ECE 45,A01,083139,Staff,0,13,40,40
1650073007752,ECE 65,A50,083695,Staff,0,3,30,30
1650073013776,ECE 109,A01,091882,Touri; Behrouz,48,0,70,22
1650073019798,ECE 180,A00,083140,Abi Samra; Nicholas Camill,24,0,30,6
1650073019798,ECE 180,B00,083141,Abi Samra; Nicholas Camill,8,0,30,22
1650073025826,MATH 10A,A01,083735,Patchell; Gregory David,12,0,30,18
1650073025826,MATH 10A,A02,083736,Patchell; Gregory David,28,0,30,2
1650073025826,MATH 10A,A03,083737,Patchell; Gregory David,27,0,30,3
1650073031858,MATH 10B,A01,083207,Staff,0,5,30,30
1650073031858,MATH 10B,A02,083208,Staff,0,3,30,30
1650073031858,MATH 10B,B01,083739,Staff,18,0,30,12
1650073031858,MATH 10B,B02,083740,Staff,29,0,30,1
1650073037901,MATH 18,A01,083743,Staff,10,0,30,20
1650073037901,MATH 18,A02,083744,Staff,28,0,30,2
1650073037901,MATH 18,A03,083745,Staff,23,0,30,7
1650073037901,MATH 18,A04,083746,Staff,27,0,30,3
1650073037901,MATH 18,B01,083748,Staff,0,9,30,30
1650073037901,MATH 18,B02,083749,Staff,1,7,30,29
1650073037901,MATH 18,B03,083750,Staff,0,6,30,30
1650073037901,MATH 18,B04,083751,Staff,1,8,30,29
1650073043927,MATH 20A,A01,083754,Staff,26,0,40,14
1650073049952,MATH 20B,A01,083756,Staff,0,6,30,30
1650073049952,MATH 20B,A02,083757,Staff,0,1,30,30
1650073055980,MATH 20C,A01,083760,Staff,0,10,30,30
1650073055980,MATH 20C,A02,083761,Staff,0,12,30,30
1650073055980,MATH 20C,B01,083762,Staff,14,0,30,16
1650073055980,MATH 20C,B02,083763,Staff,28,0,30,2
1650073062006,MATH 20D,A01,083765,Staff,0,2,30,30
1650073062006,MATH 20D,A02,083766,Staff,14,0,30,16
1650073062006,MATH 20D,A03,083767,Staff,28,0,30,2
1650073068030,MATH 20E,A01,083771,Staff,10,0,30,20
1650073068030,MATH 20E,A02,083772,Staff,20,0,30,10
1650073068030,MATH 20E,B01,083773,Staff,2,2,30,28
1650073068030,MATH 20E,B02,083774,Staff,16,0,30,14
1650073074058,MATH 103A,A01,083777,Staff,0,8,30,30
1650073074058,MATH 103A,A02,083778,Staff,0,7,30,30
1650073074058,MATH 103A,B01,083779,Staff,0,8,30,30
1650073074058,MATH 103A,B02,083780,Staff,1,7,30,29
1650073080085,MATH 105,A01,085443,Staff,1,13,30,29
1650073086110,MATH 109,A01,083213,Anzaldo; Leesa B,1,4,30,29
1650073086110,MATH 109,A02,083214,Anzaldo; Leesa B,0,5,30,30
1650073086110,MATH 109,B01,083215,Anzaldo; Leesa B,0,4,30,30
1650073086110,MATH 109,B02,083216,Anzaldo; Leesa B,1,3,30,29
1650073092146,MATH 142A,A01,083219,Chow; Bennett,0,10,30,30
1650073092146,MATH 142A,A02,083220,Chow; Bennett,0,10,30,30
1650073092146,MATH 142A,B01,083221,Chow; Bennett,0,10,30,30
1650073092146,MATH 142A,B02,083222,Chow; Bennett,0,9,30,30
1650073098171,MATH 193A,A01,083224,Staff,0,4,30,30
1650073098171,MATH 193A,A02,083225,Staff,0,4,30,30
1650073098171,MATH 193A,A03,083781,Staff,0,0,30,30
1650073098171,MATH 193A,A04,083782,Staff,6,0,30,24
1650073104197,MATH 197,001,091859,McAuley; Julian John,9998,0,9999,1
1650073110259,COGS 9,A01,083615,Staff,3,17,60,57
1650073116283,COGS 11,A01,083617,Boyle; Mary E. T.,24,0,40,16
1650073122310,COGS 13,A01,083071,Staff,0,28,40,40
1650073128337,COGS 14A,A01,092681,Staff,0,11,100,100
1650073134371,COGS 14B,A01,083073,Cheng; Tzu-Han,0,4,50,50
1650073140393,COGS 17,A01,092677,Staff,35,0,75,40
1650073146417,COGS 100,A01,083619,Staff,0,20,60,60
1650073152440,COGS 101A,A01,083621,Davis; Joshua Daniel,0,16,60,60
1650073158472,COGS 101B,A01,091572,Staff,12,0,60,48
1650073164496,COGS 101C,A01,083625,Delgado; Tania,21,0,30,9
1650073170519,COGS 107A,A01,083627,Boyle; Mary E. T.,1,3,60,59
1650073176551,COGS 118A,A01,083075,Staff,18,0,60,42
1650073182575,CSE 3,A50,083646,Miranda; Gregory Joseph,22,0,38,16
1650073182575,CSE 3,A51,083647,Miranda; Gregory Joseph,37,0,37,0
1650073188608,CSE 8A,A50,083650,Miranda; Gregory Joseph,0,15,40,40
1650073194631,CSE 11,A01,083080,Cao; Yingjun,0,66,40,40
1650073200655,CSE 12,A01,083652,Staff,0,2,100,100
1650073206677,CSE 15L,A01,083654,Staff,0,0,50,50
1650073206677,CSE 15L,A02,083655,Staff,10,0,50,40
1650073212699,CSE 20,A01,083657,Staff,58,0,80,22
1650073218723,CSE 30,A01,083084,Eldon; John,0,63,40,40
1650073224748,CSE 100,A01,083659,Cao; Yingjun,0,59,50,50
1650073230771,CSE 134B,A01,083661,Powell; Thomas Allan,1,28,65,64
1650073236802,CSE 140,A01,083663,Staff,4,0,75,71
1650073242830,CSE 140L,A01,083088,Eldon; John,0,1,75,75
1650073248856,CSE 175,A01,083665,Kumar; Rakesh,9,0,25,16
1650073254881,CSE 190,A00,092507,Dubnov; Shlomo,14,0,20,6
1650073260913,ECE 45,A01,083139,Staff,0,13,40,40
1650073266937,ECE 65,A50,083695,Staff,0,3,30,30
1650073273057,ECE 109,A01,091882,Touri; Behrouz,48,0,70,22
1650073279091,ECE 180,A00,083140,Abi Samra; Nicholas Camill,24,0,30,6
1650073279091,ECE 180,B00,083141,Abi Samra; Nicholas Camill,8,0,30,22
1650073285116,MATH 10A,A01,083735,Patchell; Gregory David,12,0,30,18
1650073285116,MATH 10A,A02,083736,Patchell; Gregory David,28,0,30,2
1650073285116,MATH 10A,A03,083737,Patchell; Gregory David,27,0,30,3
1650073291140,MATH 10B,A01,083207,Staff,0,5,30,30
1650073291140,MATH 10B,A02,083208,Staff,0,3,30,30
1650073291140,MATH 10B,B01,083739,Staff,18,0,30,12
1650073291140,MATH 10B,B02,083740,Staff,29,0,30,1
1650073297169,MATH 18,A01,083743,Staff,10,0,30,20
1650073297169,MATH 18,A02,083744,Staff,28,0,30,2
1650073297169,MATH 18,A03,083745,Staff,23,0,30,7
1650073297169,MATH 18,A04,083746,Staff,27,0,30,3
1650073297169,MATH 18,B01,083748,Staff,0,9,30,30
1650073297169,MATH 18,B02,083749,Staff,1,7,30,29
1650073297169,MATH 18,B03,083750,Staff,0,6,30,30
1650073297169,MATH 18,B04,083751,Staff,1,8,30,29
1650073303196,MATH 20A,A01,083754,Staff,26,0,40,14
1650073309223,MATH 20B,A01,083756,Staff,0,6,30,30
1650073309223,MATH 20B,A02,083757,Staff,0,1,30,30
1650073315247,MATH 20C,A01,083760,Staff,0,10,30,30
1650073315247,MATH 20C,A02,083761,Staff,0,12,30,30
1650073315247,MATH 20C,B01,083762,Staff,14,0,30,16
1650073315247,MATH 20C,B02,083763,Staff,28,0,30,2
1650073321270,MATH 20D,A01,083765,Staff,0,2,30,30
1650073321270,MATH 20D,A02,083766,Staff,14,0,30,16
1650073321270,MATH 20D,A03,083767,Staff,28,0,30,2
1650073327292,MATH 20E,A01,083771,Staff,10,0,30,20
1650073327292,MATH 20E,A02,083772,Staff,20,0,30,10
1650073327292,MATH 20E,B01,083773,Staff,2,2,30,28
1650073327292,MATH 20E,B02,083774,Staff,16,0,30,14
1650073333319,MATH 103A,A01,083777,Staff,0,8,30,30
1650073333319,MATH 103A,A02,083778,Staff,0,7,30,30
1650073333319,MATH 103A,B01,083779,Staff,0,8,30,30
1650073333319,MATH 103A,B02,083780,Staff,1,7,30,29
1650073339347,MATH 105,A01,085443,Staff,1,13,30,29
1650073345370,MATH 109,A01,083213,Anzaldo; Leesa B,1,4,30,29
1650073345370,MATH 109,A02,083214,Anzaldo; Leesa B,0,5,30,30
1650073345370,MATH 109,B01,083215,Anzaldo; Leesa B,0,4,30,30
1650073345370,MATH 109,B02,083216,Anzaldo; Leesa B,1,3,30,29
1650073351399,MATH 142A,A01,083219,Chow; Bennett,0,10,30,30
1650073351399,MATH 142A,A02,083220,Chow; Bennett,0,10,30,30
1650073351399,MATH 142A,B01,083221,Chow; Bennett,0,10,30,30
1650073351399,MATH 142A,B02,083222,Chow; Bennett,0,9,30,30
1650073357421,MATH 193A,A01,083224,Staff,0,4,30,30
1650073357421,MATH 193A,A02,083225,Staff,0,4,30,30
1650073357421,MATH 193A,A03,083781,Staff,0,0,30,30
1650073357421,MATH 193A,A04,083782,Staff,6,0,30,24
1650073363447,MATH 197,001,091859,McAuley; Julian John,9998,0,9999,1
1650073369499,COGS 9,A01,083615,Staff,3,17,60,57
1650073375522,COGS 11,A01,083617,Boyle; Mary E. T.,24,0,40,16
1650073381546,COGS 13,A01,083071,Staff,0,29,40,40
1650073387587,COGS 14A,A01,092681,Staff,0,11,100,100
1650073393612,COGS 14B,A01,083073,Cheng; Tzu-Han,0,4,50,50
1650073399649,COGS 17,A01,092677,Staff,35,0,75,40
1650073405672,COGS 100,A01,083619,Staff,0,20,60,60
1650073411695,COGS 101A,A01,083621,Davis; Joshua Daniel,0,16,60,60
1650073417719,COGS 101B,A01,091572,Staff,12,0,60,48
1650073423744,COGS 101C,A01,083625,Delgado; Tania,21,0,30,9
1650073429771,COGS 107A,A01,083627,Boyle; Mary E. T.,1,3,60,59
1650073435797,COGS 118A,A01,083075,Staff,18,0,60,42
1650073441824,CSE 3,A50,083646,Miranda; Gregory Joseph,22,0,38,16
1650073441824,CSE 3,A51,083647,Miranda; Gregory Joseph,37,0,37,0
1650073447849,CSE 8A,A50,083650,Miranda; Gregory Joseph,0,15,40,40
1650073453885,CSE 11,A01,083080,Cao; Yingjun,0,66,40,40
1650073459912,CSE 12,A01,083652,Staff,0,2,100,100
1650073465945,CSE 15L,A01,083654,Staff,0,0,50,50
1650073465945,CSE 15L,A02,083655,Staff,10,0,50,40
1650073471968,CSE 20,A01,083657,Staff,58,0,80,22
1650073478002,CSE 30,A01,083084,Eldon; John,0,63,40,40
1650073484027,CSE 100,A01,083659,Cao; Yingjun,0,59,50,50
1650073490052,CSE 134B,A01,083661,Powell; Thomas Allan,1,28,65,64
1650073496078,CSE 140,A01,083663,Staff,4,0,75,71
1650073502102,CSE 140L,A01,083088,Eldon; John,0,1,75,75
1650073508137,CSE 175,A01,083665,Kumar; Rakesh,9,0,25,16
1650073514179,CSE 190,A00,092507,Dubnov; Shlomo,14,0,20,6
1650073520202,ECE 45,A01,083139,Staff,0,13,40,40
1650073526224,ECE 65,A50,083695,Staff,0,3,30,30
1650073532248,ECE 109,A01,091882,Touri; Behrouz,48,0,70,22
1650073538270,ECE 180,A00,083140,Abi Samra; Nicholas Camill,24,0,30,6
1650073538270,ECE 180,B00,083141,Abi Samra; Nicholas Camill,8,0,30,22
1650073544296,MATH 10A,A01,083735,Patchell; Gregory David,12,0,30,18
1650073544296,MATH 10A,A02,083736,Patchell; Gregory David,28,0,30,2
1650073544296,MATH 10A,A03,083737,Patchell; Gregory David,27,0,30,3
1650073550323,MATH 10B,A01,083207,Staff,0,5,30,30
1650073550323,MATH 10B,A02,083208,Staff,0,3,30,30
1650073550323,MATH 10B,B01,083739,Staff,18,0,30,12
1650073550323,MATH 10B,B02,083740,Staff,29,0,30,1
1650073556356,MATH 18,A01,083743,Staff,10,0,30,20
1650073556356,MATH 18,A02,083744,Staff,28,0,30,2
1650073556356,MATH 18,A03,083745,Staff,23,0,30,7
1650073556356,MATH 18,A04,083746,Staff,27,0,30,3
1650073556356,MATH 18,B01,083748,Staff,0,9,30,30
1650073556356,MATH 18,B02,083749,Staff,1,7,30,29
1650073556356,MATH 18,B03,083750,Staff,0,6,30,30
1650073556356,MATH 18,B04,083751,Staff,1,8,30,29
1650073562384,MATH 20A,A01,083754,Staff,26,0,40,14
1650073568413,MATH 20B,A01,083756,Staff,0,6,30,30
1650073568413,MATH 20B,A02,083757,Staff,0,1,30,30
1650073574437,MATH 20C,A01,083760,Staff,0,10,30,30
1650073574437,MATH 20C,A02,083761,Staff,0,12,30,30
1650073574437,MATH 20C,B01,083762,Staff,14,0,30,16
1650073574437,MATH 20C,B02,083763,Staff,28,0,30,2
1650073580465,MATH 20D,A01,083765,Staff,0,2,30,30
1650073580465,MATH 20D,A02,083766,Staff,14,0,30,16
1650073580465,MATH 20D,A03,083767,Staff,28,0,30,2
1650073586499,MATH 20E,A01,083771,Staff,10,0,30,20
1650073586499,MATH 20E,A02,083772,Staff,20,0,30,10
1650073586499,MATH 20E,B01,083773,Staff,2,2,30,28
1650073586499,MATH 20E,B02,083774,Staff,16,0,30,14
1650073592524,MATH 103A,A01,083777,Staff,0,8,30,30
1650073592524,MATH 103A,A02,083778,Staff,0,7,30,30
1650073592524,MATH 103A,B01,083779,Staff,0,8,30,30
1650073592524,MATH 103A,B02,083780,Staff,1,7,30,29
1650073598554,MATH 105,A01,085443,Staff,1,13,30,29
1650073604578,MATH 109,A01,083213,Anzaldo; Leesa B,1,4,30,29
1650073604578,MATH 109,A02,083214,Anzaldo; Leesa B,0,5,30,30
1650073604578,MATH 109,B01,083215,Anzaldo; Leesa B,0,4,30,30
1650073604578,MATH 109,B02,083216,Anzaldo; Leesa B,1,3,30,29
1650073610603,MATH 142A,A01,083219,Chow; Bennett,0,10,30,30
1650073610603,MATH 142A,A02,083220,Chow; Bennett,0,10,30,30
1650073610603,MATH 142A,B01,083221,Chow; Bennett,0,10,30,30
1650073610603,MATH 142A,B02,083222,Chow; Bennett,0,9,30,30
1650073616625,MATH 193A,A01,083224,Staff,0,4,30,30
1650073616625,MATH 193A,A02,083225,Staff,0,4,30,30
1650073616625,MATH 193A,A03,083781,Staff,0,0,30,30
1650073616625,MATH 193A,A04,083782,Staff,6,0,30,24
1650073622651,MATH 197,001,091859,McAuley; Julian John,9998,0,9999,1
1650073628719,COGS 9,A01,083615,Staff,3,17,60,57
1650073634742,COGS 11,A01,083617,Boyle; Mary E. T.,24,0,40,16
1650073640772,COGS 13,A01,083071,Staff,0,29,40,40
1650073646797,COGS 14A,A01,092681,Staff,0,11,100,100
1650073652822,COGS 14B,A01,083073,Cheng; Tzu-Han,0,4,50,50
1650073658846,COGS 17,A01,092677,Staff,35,0,75,40
1650073664874,COGS 100,A01,083619,Staff,0,20,60,60
1650073670901,COGS 101A,A01,083621,Davis; Joshua Daniel,0,16,60,60
1650073676928,COGS 101B,A01,091572,Staff,11,0,60,49
1650073682951,COGS 101C,A01,083625,Delgado; Tania,21,0,30,9
1650073688978,COGS 107A,A01,083627,Boyle; Mary E. T.,1,3,60,59
1650073695005,COGS 118A,A01,083075,Staff,18,0,60,42
1650073701042,CSE 3,A50,083646,Miranda; Gregory Joseph,22,0,38,16
1650073701042,CSE 3,A51,083647,Miranda; Gregory Joseph,37,0,37,0
1650073707070,CSE 8A,A50,083650,Miranda; Gregory Joseph,0,15,40,40
1650073713094,CSE 11,A01,083080,Cao; Yingjun,0,66,40,40
1650073719118,CSE 12,A01,083652,Staff,0,2,100,100
1650073725145,CSE 15L,A01,083654,Staff,0,0,50,50
1650073725145,CSE 15L,A02,083655,Staff,10,0,50,40
1650073731167,CSE 20,A01,083657,Staff,58,0,80,22
1650073737193,CSE 30,A01,083084,Eldon; John,0,63,40,40
1650073743217,CSE 100,A01,083659,Cao; Yingjun,0,59,50,50
1650073749245,CSE 134B,A01,083661,Powell; Thomas Allan,1,28,65,64
1650073755268,CSE 140,A01,083663,Staff,4,0,75,71
1650073761314,CSE 140L,A01,083088,Eldon; John,0,1,75,75
1650073767337,CSE 175,A01,083665,Kumar; Rakesh,9,0,25,16
1650073773360,CSE 190,A00,092507,Dubnov; Shlomo,14,0,20,6
1650073779383,ECE 45,A01,083139,Staff,0,13,40,40
1650073785406,ECE 65,A50,083695,Staff,0,3,30,30
1650073791428,ECE 109,A01,091882,Touri; Behrouz,48,0,70,22
1650073797452,ECE 180,A00,083140,Abi Samra; Nicholas Camill,24,0,30,6
1650073797452,ECE 180,B00,083141,Abi Samra; Nicholas Camill,8,0,30,22
1650073803479,MATH 10A,A01,083735,Patchell; Gregory David,12,0,30,18
1650073803479,MATH 10A,A02,083736,Patchell; Gregory David,28,0,30,2
1650073803479,MATH 10A,A03,083737,Patchell; Gregory David,27,0,30,3
1650073809504,MATH 10B,A01,083207,Staff,0,5,30,30
1650073809504,MATH 10B,A02,083208,Staff,0,3,30,30
1650073809504,MATH 10B,B01,083739,Staff,18,0,30,12
1650073809504,MATH 10B,B02,083740,Staff,29,0,30,1
1650073815528,MATH 18,A01,083743,Staff,10,0,30,20
1650073815528,MATH 18,A02,083744,Staff,28,0,30,2
1650073815528,MATH 18,A03,083745,Staff,23,0,30,7
1650073815528,MATH 18,A04,083746,Staff,27,0,30,3
1650073815528,MATH 18,B01,083748,Staff,0,9,30,30
1650073815528,MATH 18,B02,083749,Staff,1,7,30,29
1650073815528,MATH 18,B03,083750,Staff,0,6,30,30
1650073815528,MATH 18,B04,083751,Staff,1,8,30,29
1650073821558,MATH 20A,A01,083754,Staff,26,0,40,14
1650073827589,MATH 20B,A01,083756,Staff,0,6,30,30
1650073827589,MATH 20B,A02,083757,Staff,0,1,30,30
1650073833613,MATH 20C,A01,083760,Staff,0,10,30,30
1650073833613,MATH 20C,A02,083761,Staff,0,12,30,30
1650073833613,MATH 20C,B01,083762,Staff,14,0,30,16
1650073833613,MATH 20C,B02,083763,Staff,28,0,30,2
1650073839641,MATH 20D,A01,083765,Staff,0,2,30,30
1650073839641,MATH 20D,A02,083766,Staff,14,0,30,16
1650073839641,MATH 20D,A03,083767,Staff,28,0,30,2
1650073845668,MATH 20E,A01,083771,Staff,10,0,30,20
1650073845668,MATH 20E,A02,083772,Staff,20,0,30,10
1650073845668,MATH 20E,B01,083773,Staff,2,2,30,28
1650073845668,MATH 20E,B02,083774,Staff,16,0,30,14
1650073851698,MATH 103A,A01,083777,Staff,0,8,30,30
1650073851698,MATH 103A,A02,083778,Staff,0,7,30,30
1650073851698,MATH 103A,B01,083779,Staff,0,8,30,30
1650073851698,MATH 103A,B02,083780,Staff,1,7,30,29
1650073857722,MATH 105,A01,085443,Staff,1,13,30,29
1650073863752,MATH 109,A01,083213,Anzaldo; Leesa B,1,4,30,29
1650073863752,MATH 109,A02,083214,Anzaldo; Leesa B,0,5,30,30
1650073863752,MATH 109,B01,083215,Anzaldo; Leesa B,0,4,30,30
1650073863752,MATH 109,B02,083216,Anzaldo; Leesa B,1,3,30,29
1650073869872,MATH 142A,A01,083219,Chow; Bennett,0,10,30,30
1650073869872,MATH 142A,A02,083220,Chow; Bennett,0,10,30,30
1650073869872,MATH 142A,B01,083221,Chow; Bennett,0,10,30,30
1650073869872,MATH 142A,B02,083222,Chow; Bennett,0,9,30,30
1650073875897,MATH 193A,A01,083224,Staff,0,4,30,30
1650073875897,MATH 193A,A02,083225,Staff,0,4,30,30
1650073875897,MATH 193A,A03,083781,Staff,0,0,30,30
1650073875897,MATH 193A,A04,083782,Staff,6,0,30,24
1650073881920,MATH 197,001,091859,McAuley; Julian John,9998,0,9999,1
1650073887980,COGS 9,A01,083615,Staff,3,17,60,57
1650073894004,COGS 11,A01,083617,Boyle; Mary E. T.,24,0,40,16
1650073900031,COGS 13,A01,083071,Staff,0,29,40,40
1650073906060,COGS 14A,A01,092681,Staff,0,11,100,100
1650073912084,COGS 14B,A01,083073,Cheng; Tzu-Han,0,4,50,50
1650073918107,COGS 17,A01,092677,Staff,35,0,75,40
1650073924134,COGS 100,A01,083619,Staff,0,20,60,60
1650073930159,COGS 101A,A01,083621,Davis; Joshua Daniel,0,16,60,60
1650073936183,COGS 101B,A01,091572,Staff,11,0,60,49
1650073942207,COGS 101C,A01,083625,Delgado; Tania,21,0,30,9
1650073948239,COGS 107A,A01,083627,Boyle; Mary E. T.,1,3,60,59
1650073954265,COGS 118A,A01,083075,Staff,18,0,60,42
1650073960292,CSE 3,A50,083646,Miranda; Gregory Joseph,22,0,38,16
1650073960292,CSE 3,A51,083647,Miranda; Gregory Joseph,37,0,37,0
1650073966317,CSE 8A,A50,083650,Miranda; Gregory Joseph,0,15,40,40
1650073972344,CSE 11,A01,083080,Cao; Yingjun,0,66,40,40
1650073978367,CSE 12,A01,083652,Staff,0,2,100,100
1650073984391,CSE 15L,A01,083654,Staff,0,0,50,50
1650073984391,CSE 15L,A02,083655,Staff,10,0,50,40
1650073990434,CSE 20,A01,083657,Staff,58,0,80,22
1650073996460,CSE 30,A01,083084,Eldon; John,0,63,40,40
1650074002491,CSE 100,A01,083659,Cao; Yingjun,0,59,50,50
1650074008524,CSE 134B,A01,083661,Powell; Thomas Allan,1,28,65,64
1650074014547,CSE 140,A01,083663,Staff,4,0,75,71
1650074020574,CSE 140L,A01,083088,Eldon; John,0,1,75,75
1650074026598,CSE 175,A01,083665,Kumar; Rakesh,9,0,25,16
1650074032622,CSE 190,A00,092507,Dubnov; Shlomo,14,0,20,6
1650074038646,ECE 45,A01,083139,Staff,0,13,40,40
1650074044679,ECE 65,A50,083695,Staff,0,3,30,30
1650074050704,ECE 109,A01,091882,Touri; Behrouz,48,0,70,22
1650074056727,ECE 180,A00,083140,Abi Samra; Nicholas Camill,24,0,30,6
1650074056727,ECE 180,B00,083141,Abi Samra; Nicholas Camill,8,0,30,22
1650074062755,MATH 10A,A01,083735,Patchell; Gregory David,12,0,30,18
1650074062755,MATH 10A,A02,083736,Patchell; Gregory David,28,0,30,2
1650074062755,MATH 10A,A03,083737,Patchell; Gregory David,27,0,30,3
1650074068799,MATH 10B,A01,083207,Staff,0,5,30,30
1650074068799,MATH 10B,A02,083208,Staff,0,3,30,30
1650074068799,MATH 10B,B01,083739,Staff,18,0,30,12
1650074068799,MATH 10B,B02,083740,Staff,29,0,30,1
1650074074821,MATH 18,A01,083743,Staff,10,0,30,20
1650074074821,MATH 18,A02,083744,Staff,28,0,30,2
1650074074821,MATH 18,A03,083745,Staff,23,0,30,7
1650074074821,MATH 18,A04,083746,Staff,27,0,30,3
1650074074821,MATH 18,B01,083748,Staff,0,9,30,30
1650074074821,MATH 18,B02,083749,Staff,1,7,30,29
1650074074821,MATH 18,B03,083750,Staff,0,6,30,30
1650074074821,MATH 18,B04,083751,Staff,1,8,30,29
1650074080846,MATH 20A,A01,083754,Staff,26,0,40,14
1650074086874,MATH 20B,A01,083756,Staff,0,6,30,30
1650074086874,MATH 20B,A02,083757,Staff,0,1,30,30
1650074092899,MATH 20C,A01,083760,Staff,0,10,30,30
1650074092899,MATH 20C,A02,083761,Staff,0,12,30,30
1650074092899,MATH 20C,B01,083762,Staff,14,0,30,16
1650074092899,MATH 20C,B02,083763,Staff,28,0,30,2
1650074098922,MATH 20D,A01,083765,Staff,0,2,30,30
1650074098922,MATH 20D,A02,083766,Staff,14,0,30,16
1650074098922,MATH 20D,A03,083767,Staff,28,0,30,2
1650074104947,MATH 20E,A01,083771,Staff,10,0,30,20
1650074104947,MATH 20E,A02,083772,Staff,20,0,30,10
1650074104947,MATH 20E,B01,083773,Staff,2,2,30,28
1650074104947,MATH 20E,B02,083774,Staff,16,0,30,14
1650074110971,MATH 103A,A01,083777,Staff,0,8,30,30
1650074110971,MATH 103A,A02,083778,Staff,0,7,30,30
1650074110971,MATH 103A,B01,083779,Staff,0,8,30,30
1650074110971,MATH 103A,B02,083780,Staff,1,7,30,29
1650074116994,MATH 105,A01,085443,Staff,1,13,30,29
1650074123016,MATH 109,A01,083213,Anzaldo; Leesa B,1,4,30,29
1650074123016,MATH 109,A02,083214,Anzaldo; Leesa B,0,5,30,30
1650074123016,MATH 109,B01,083215,Anzaldo; Leesa B,0,4,30,30
1650074123016,MATH 109,B02,083216,Anzaldo; Leesa B,1,3,30,29
1650074129045,MATH 142A,A01,083219,Chow; Bennett,0,10,30,30
1650074129045,MATH 142A,A02,083220,Chow; Bennett,0,10,30,30
1650074129045,MATH 142A,B01,083221,Chow; Bennett,0,10,30,30
1650074129045,MATH 142A,B02,083222,Chow; Bennett,0,9,30,30
1650074135068,MATH 193A,A01,083224,Staff,0,4,30,30
1650074135068,MATH 193A,A02,083225,Staff,0,4,30,30
1650074135068,MATH 193A,A03,083781,Staff,0,0,30,30
1650074135068,MATH 193A,A04,083782,Staff,6,0,30,24
1650074141094,MATH 197,001,091859,McAuley; Julian John,9998,0,9999,1
1650074147153,COGS 9,A01,083615,Staff,3,17,60,57
1650074153175,COGS 11,A01,083617,Boyle; Mary E. T.,24,0,40,16
1650074159198,COGS 13,A01,083071,Staff,0,29,40,40
1650074165223,COGS 14A,A01,092681,Staff,0,11,100,100
1650074171249,COGS 14B,A01,083073,Cheng; Tzu-Han,0,4,50,50
1650074177273,COGS 17,A01,092677,Staff,35,0,75,40
1650074183300,COGS 100,A01,083619,Staff,0,20,60,60
1650074189323,COGS 101A,A01,083621,Davis; Joshua Daniel,0,16,60,60
1650074195345,COGS 101B,A01,091572,Staff,11,0,60,49
1650074201371,COGS 101C,A01,083625,Delgado; Tania,21,0,30,9
1650074207398,COGS 107A,A01,083627,Boyle; Mary E. T.,1,3,60,59
1650074213424,COGS 118A,A01,083075,Staff,18,0,60,42
1650074219455,CSE 3,A50,083646,Miranda; Gregory Joseph,22,0,38,16
1650074219455,CSE 3,A51,083647,Miranda; Gregory Joseph,37,0,37,0
1650074225498,CSE 8A,A50,083650,Miranda; Gregory Joseph,0,15,40,40
1650074231532,CSE 11,A01,083080,Cao; Yingjun,0,66,40,40
1650074237556,CSE 12,A01,083652,Staff,0,2,100,100
1650074243589,CSE 15L,A01,083654,Staff,0,0,50,50
1650074243589,CSE 15L,A02,083655,Staff,10,0,50,40
1650074249616,CSE 20,A01,083657,Staff,58,0,80,22
1650074255638,CSE 30,A01,083084,Eldon; John,0,63,40,40
1650074261671,CSE 100,A01,083659,Cao; Yingjun,0,59,50,50
1650074267698,CSE 134B,A01,083661,Powell; Thomas Allan,1,28,65,64
1650074273721,CSE 140,A01,083663,Staff,4,0,75,71
1650074279745,CSE 140L,A01,083088,Eldon; John,0,1,75,75
1650074285767,CSE 175,A01,083665,Kumar; Rakesh,9,0,25,16
1650074291790,CSE 190,A00,092507,Dubnov; Shlomo,14,0,20,6
1650074297813,ECE 45,A01,083139,Staff,0,13,40,40
1650074303868,ECE 65,A50,083695,Staff,0,3,30,30
1650074309891,ECE 109,A01,091882,Touri; Behrouz,48,0,70,22
1650074315919,ECE 180,A00,083140,Abi Samra; Nicholas Camill,24,0,30,6
1650074315919,ECE 180,B00,083141,Abi Samra; Nicholas Camill,8,0,30,22
1650074321948,MATH 10A,A01,083735,Patchell; Gregory David,12,0,30,18
1650074321948,MATH 10A,A02,083736,Patchell; Gregory David,28,0,30,2
1650074321948,MATH 10A,A03,083737,Patchell; Gregory David,27,0,30,3
1650074327974,MATH 10B,A01,083207,Staff,0,5,30,30
1650074327974,MATH 10B,A02,083208,Staff,0,3,30,30
1650074327974,MATH 10B,B01,083739,Staff,18,0,30,12
1650074327974,MATH 10B,B02,083740,Staff,29,0,30,1
1650074334015,MATH 18,A01,083743,Staff,10,0,30,20
1650074334015,MATH 18,A02,083744,Staff,28,0,30,2
1650074334015,MATH 18,A03,083745,Staff,23,0,30,7
1650074334015,MATH 18,A04,083746,Staff,27,0,30,3
1650074334015,MATH 18,B01,083748,Staff,0,9,30,30
1650074334015,MATH 18,B02,083749,Staff,1,7,30,29
1650074334015,MATH 18,B03,083750,Staff,0,6,30,30
1650074334015,MATH 18,B04,083751,Staff,1,8,30,29
1650074340039,MATH 20A,A01,083754,Staff,26,0,40,14
1650074346062,MATH 20B,A01,083756,Staff,0,6,30,30
1650074346062,MATH 20B,A02,083757,Staff,0,1,30,30
1650074352086,MATH 20C,A01,083760,Staff,0,10,30,30
1650074352086,MATH 20C,A02,083761,Staff,0,12,30,30
1650074352086,MATH 20C,B01,083762,Staff,14,0,30,16
1650074352086,MATH 20C,B02,083763,Staff,28,0,30,2
1650074358113,MATH 20D,A01,083765,Staff,0,2,30,30
1650074358113,MATH 20D,A02,083766,Staff,14,0,30,16
1650074358113,MATH 20D,A03,083767,Staff,28,0,30,2
1650074364141,MATH 20E,A01,083771,Staff,10,0,30,20
1650074364141,MATH 20E,A02,083772,Staff,20,0,30,10
1650074364141,MATH 20E,B01,083773,Staff,2,2,30,28
1650074364141,MATH 20E,B02,083774,Staff,16,0,30,14
1650074370170,MATH 103A,A01,083777,Staff,0,8,30,30
1650074370170,MATH 103A,A02,083778,Staff,0,7,30,30
1650074370170,MATH 103A,B01,083779,Staff,0,8,30,30
1650074370170,MATH 103A,B02,083780,Staff,1,7,30,29
1650074376203,MATH 105,A01,085443,Staff,1,13,30,29
1650074382228,MATH 109,A01,083213,Anzaldo; Leesa B,1,4,30,29
1650074382228,MATH 109,A02,083214,Anzaldo; Leesa B,0,5,30,30
1650074382228,MATH 109,B01,083215,Anzaldo; Leesa B,0,4,30,30
1650074382228,MATH 109,B02,083216,Anzaldo; Leesa B,1,3,30,29
1650074388254,MATH 142A,A01,083219,Chow; Bennett,0,10,30,30
1650074388254,MATH 142A,A02,083220,Chow; Bennett,0,10,30,30
1650074388254,MATH 142A,B01,083221,Chow; Bennett,0,10,30,30
1650074388254,MATH 142A,B02,083222,Chow; Bennett,0,9,30,30
1650074394288,MATH 193A,A01,083224,Staff,0,4,30,30
1650074394288,MATH 193A,A02,083225,Staff,0,4,30,30
1650074394288,MATH 193A,A03,083781,Staff,0,0,30,30
1650074394288,MATH 193A,A04,083782,Staff,5,0,30,25
1650074400311,MATH 197,001,091859,McAuley; Julian John,9998,0,9999,1
1650074406377,COGS 9,A01,083615,Staff,3,17,60,57
1650074412400,COGS 11,A01,083617,Boyle; Mary E. T.,24,0,40,16
1650074418425,COGS 13,A01,083071,Staff,0,29,40,40
1650074424451,COGS 14A,A01,092681,Staff,0,11,100,100
1650074430475,COGS 14B,A01,083073,Cheng; Tzu-Han,0,4,50,50
1650074436502,COGS 17,A01,092677,Staff,35,0,75,40
1650074442530,COGS 100,A01,083619,Staff,0,21,60,60
1650074448555,COGS 101A,A01,083621,Davis; Joshua Daniel,0,17,60,60
1650074454583,COGS 101B,A01,091572,Staff,11,0,60,49
1650074460702,COGS 101C,A01,083625,Delgado; Tania,21,0,30,9
1650074466726,COGS 107A,A01,083627,Boyle; Mary E. T.,1,3,60,59
1650074472750,COGS 118A,A01,083075,Staff,18,0,60,42
1650074478780,CSE 3,A50,083646,Miranda; Gregory Joseph,22,0,38,16
1650074478780,CSE 3,A51,083647,Miranda; Gregory Joseph,37,0,37,0
1650074484804,CSE 8A,A50,083650,Miranda; Gregory Joseph,0,15,40,40
1650074490827,CSE 11,A01,083080,Cao; Yingjun,0,66,40,40
1650074496854,CSE 12,A01,083652,Staff,0,2,100,100
1650074502886,CSE 15L,A01,083654,Staff,0,0,50,50
1650074502886,CSE 15L,A02,083655,Staff,10,0,50,40
1650074508908,CSE 20,A01,083657,Staff,58,0,80,22
1650074514931,CSE 30,A01,083084,Eldon; John,0,63,40,40
1650074520955,CSE 100,A01,083659,Cao; Yingjun,0,59,50,50
1650074526981,CSE 134B,A01,083661,Powell; Thomas Allan,1,28,65,64
1650074533008,CSE 140,A01,083663,Staff,4,0,75,71
1650074539035,CSE 140L,A01,083088,Eldon; John,0,1,75,75
1650074545061,CSE 175,A01,083665,Kumar; Rakesh,9,0,25,16
1650074551088,CSE 190,A00,092507,Dubnov; Shlomo,14,0,20,6
1650074557116,ECE 45,A01,083139,Staff,0,13,40,40
1650074563138,ECE 65,A50,083695,Staff,0,3,30,30
1650074569162,ECE 109,A01,091882,Touri; Behrouz,48,0,70,22
1650074575188,ECE 180,A00,083140,Abi Samra; Nicholas Camill,24,0,30,6
1650074575188,ECE 180,B00,083141,Abi Samra; Nicholas Camill,8,0,30,22
1650074581217,MATH 10A,A01,083735,Patchell; Gregory David,12,0,30,18
1650074581217,MATH 10A,A02,083736,Patchell; Gregory David,28,0,30,2
1650074581217,MATH 10A,A03,083737,Patchell; Gregory David,27,0,30,3
1650074587247,MATH 10B,A01,083207,Staff,0,5,30,30
1650074587247,MATH 10B,A02,083208,Staff,0,3,30,30
1650074587247,MATH 10B,B01,083739,Staff,18,0,30,12
1650074587247,MATH 10B,B02,083740,Staff,29,0,30,1
1650074593273,MATH 18,A01,083743,Staff,10,0,30,20
1650074593273,MATH 18,A02,083744,Staff,28,0,30,2
1650074593273,MATH 18,A03,083745,Staff,23,0,30,7
1650074593273,MATH 18,A04,083746,Staff,27,0,30,3
1650074593273,MATH 18,B01,083748,Staff,0,9,30,30
1650074593273,MATH 18,B02,083749,Staff,1,7,30,29
1650074593273,MATH 18,B03,083750,Staff,0,6,30,30
1650074593273,MATH 18,B04,083751,Staff,1,8,30,29
1650074599304,MATH 20A,A01,083754,Staff,26,0,40,14
1650074605336,MATH 20B,A01,083756,Staff,0,6,30,30
1650074605336,MATH 20B,A02,083757,Staff,0,1,30,30
1650074611365,MATH 20C,A01,083760,Staff,0,10,30,30
1650074611365,MATH 20C,A02,083761,Staff,0,12,30,30
1650074611365,MATH 20C,B01,083762,Staff,14,0,30,16
1650074611365,MATH 20C,B02,083763,Staff,28,0,30,2
1650074617388,MATH 20D,A01,083765,Staff,0,2,30,30
1650074617388,MATH 20D,A02,083766,Staff,14,0,30,16
1650074617388,MATH 20D,A03,083767,Staff,28,0,30,2
1650074623415,MATH 20E,A01,083771,Staff,10,0,30,20
1650074623415,MATH 20E,A02,083772,Staff,20,0,30,10
1650074623415,MATH 20E,B01,083773,Staff,2,2,30,28
1650074623415,MATH 20E,B02,083774,Staff,16,0,30,14
1650074629440,MATH 103A,A01,083777,Staff,0,8,30,30
1650074629440,MATH 103A,A02,083778,Staff,0,7,30,30
1650074629440,MATH 103A,B01,083779,Staff,0,8,30,30
1650074629440,MATH 103A,B02,083780,Staff,1,7,30,29
1650074635468,MATH 105,A01,085443,Staff,1,13,30,29
1650074641505,MATH 109,A01,083213,Anzaldo; Leesa B,1,4,30,29
1650074641505,MATH 109,A02,083214,Anzaldo; Leesa B,0,5,30,30
1650074641505,MATH 109,B01,083215,Anzaldo; Leesa B,0,4,30,30
1650074641505,MATH 109,B02,083216,Anzaldo; Leesa B,1,3,30,29
1650074647529,MATH 142A,A01,083219,Chow; Bennett,0,10,30,30
1650074647529,MATH 142A,A02,083220,Chow; Bennett,0,10,30,30
1650074647529,MATH 142A,B01,083221,Chow; Bennett,0,10,30,30
1650074647529,MATH 142A,B02,083222,Chow; Bennett,0,9,30,30
1650074653555,MATH 193A,A01,083224,Staff,0,4,30,30
1650074653555,MATH 193A,A02,083225,Staff,0,4,30,30
1650074653555,MATH 193A,A03,083781,Staff,0,0,30,30
1650074653555,MATH 193A,A04,083782,Staff,5,0,30,25
1650074659578,MATH 197,001,091859,McAuley; Julian John,9998,0,9999,1
1650074665631,COGS 9,A01,083615,Staff,3,17,60,57
1650074671654,COGS 11,A01,083617,Boyle; Mary E. T.,24,0,40,16
1650074677678,COGS 13,A01,083071,Staff,0,29,40,40
1650074683702,COGS 14A,A01,092681,Staff,0,11,100,100
1650074689726,COGS 14B,A01,083073,Cheng; Tzu-Han,0,4,50,50
1650074695755,COGS 17,A01,092677,Staff,35,0,75,40
1650074701778,COGS 100,A01,083619,Staff,0,20,60,60
1650074707808,COGS 101A,A01,083621,Davis; Joshua Daniel,0,17,60,60
1650074713837,COGS 101B,A01,091572,Staff,10,0,60,50
1650074719867,COGS 101C,A01,083625,Delgado; Tania,21,0,30,9
1650074725890,COGS 107A,A01,083627,Boyle; Mary E. T.,1,4,60,59
1650074731914,COGS 118A,A01,083075,Staff,18,0,60,42
1650074737940,CSE 3,A50,083646,Miranda; Gregory Joseph,22,0,38,16
1650074737940,CSE 3,A51,083647,Miranda; Gregory Joseph,37,0,37,0
1650074743969,CSE 8A,A50,083650,Miranda; Gregory Joseph,0,15,40,40
1650074749992,CSE 11,A01,083080,Cao; Yingjun,0,66,40,40
1650074756017,CSE 12,A01,083652,Staff,0,2,100,100
1650074762041,CSE 15L,A01,083654,Staff,0,0,50,50
1650074762041,CSE 15L,A02,083655,Staff,10,0,50,40
1650074768066,CSE 20,A01,083657,Staff,58,0,80,22
1650074774090,CSE 30,A01,083084,Eldon; John,0,63,40,40
1650074780118,CSE 100,A01,083659,Cao; Yingjun,0,59,50,50
1650074786140,CSE 134B,A01,083661,Powell; Thomas Allan,1,28,65,64
1650074792161,CSE 140,A01,083663,Staff,4,0,75,71
1650074798190,CSE 140L,A01,083088,Eldon; John,0,1,75,75
1650074804213,CSE 175,A01,083665,Kumar; Rakesh,9,0,25,16
1650074810237,CSE 190,A00,092507,Dubnov; Shlomo,14,0,20,6
1650074816260,ECE 45,A01,083139,Staff,0,13,40,40
1650074822283,ECE 65,A50,083695,Staff,0,3,30,30
1650074828306,ECE 109,A01,091882,Touri; Behrouz,48,0,70,22
1650074834333,ECE 180,A00,083140,Abi Samra; Nicholas Camill,24,0,30,6
1650074834333,ECE 180,B00,083141,Abi Samra; Nicholas Camill,8,0,30,22
1650074840356,MATH 10A,A01,083735,Patchell; Gregory David,12,0,30,18
1650074840356,MATH 10A,A02,083736,Patchell; Gregory David,28,0,30,2
1650074840356,MATH 10A,A03,083737,Patchell; Gregory David,27,0,30,3
1650074846385,MATH 10B,A01,083207,Staff,0,5,30,30
1650074846385,MATH 10B,A02,083208,Staff,0,3,30,30
1650074846385,MATH 10B,B01,083739,Staff,18,0,30,12
1650074846385,MATH 10B,B02,083740,Staff,29,0,30,1
1650074852413,MATH 18,A01,083743,Staff,10,0,30,20
1650074852413,MATH 18,A02,083744,Staff,28,0,30,2
1650074852413,MATH 18,A03,083745,Staff,23,0,30,7
1650074852413,MATH 18,A04,083746,Staff,27,0,30,3
1650074852413,MATH 18,B01,083748,Staff,0,9,30,30
1650074852413,MATH 18,B02,083749,Staff,1,7,30,29
1650074852413,MATH 18,B03,083750,Staff,0,6,30,30
1650074852413,MATH 18,B04,083751,Staff,1,8,30,29
1650074858435,MATH 20A,A01,083754,Staff,26,0,40,14
1650074864461,MATH 20B,A01,083756,Staff,0,6,30,30
1650074864461,MATH 20B,A02,083757,Staff,0,1,30,30
1650074870489,MATH 20C,A01,083760,Staff,0,10,30,30
1650074870489,MATH 20C,A02,083761,Staff,0,12,30,30
1650074870489,MATH 20C,B01,083762,Staff,14,0,30,16
1650074870489,MATH 20C,B02,083763,Staff,28,0,30,2
1650074876516,MATH 20D,A01,083765,Staff,0,2,30,30
1650074876516,MATH 20D,A02,083766,Staff,14,0,30,16
1650074876516,MATH 20D,A03,083767,Staff,28,0,30,2
1650074882544,MATH 20E,A01,083771,Staff,10,0,30,20
1650074882544,MATH 20E,A02,083772,Staff,20,0,30,10
1650074882544,MATH 20E,B01,083773,Staff,2,2,30,28
1650074882544,MATH 20E,B02,083774,Staff,16,0,30,14
1650074888569,MATH 103A,A01,083777,Staff,0,8,30,30
1650074888569,MATH 103A,A02,083778,Staff,0,7,30,30
1650074888569,MATH 103A,B01,083779,Staff,0,8,30,30
1650074888569,MATH 103A,B02,083780,Staff,1,7,30,29
1650074894595,MATH 105,A01,085443,Staff,1,13,30,29
1650074900619,MATH 109,A01,083213,Anzaldo; Leesa B,1,4,30,29
1650074900619,MATH 109,A02,083214,Anzaldo; Leesa B,0,5,30,30
1650074900619,MATH 109,B01,083215,Anzaldo; Leesa B,0,4,30,30
1650074900619,MATH 109,B02,083216,Anzaldo; Leesa B,1,3,30,29
1650074906648,MATH 142A,A01,083219,Chow; Bennett,0,10,30,30
1650074906648,MATH 142A,A02,083220,Chow; Bennett,0,10,30,30
1650074906648,MATH 142A,B01,083221,Chow; Bennett,0,10,30,30
1650074906648,MATH 142A,B02,083222,Chow; Bennett,0,9,30,30
1650074912674,MATH 193A,A01,083224,Staff,0,4,30,30
1650074912674,MATH 193A,A02,083225,Staff,0,4,30,30
1650074912674,MATH 193A,A03,083781,Staff,0,0,30,30
1650074912674,MATH 193A,A04,083782,Staff,5,0,30,25
1650074918704,MATH 197,001,091859,McAuley; Julian John,9998,0,9999,1
1650074924784,COGS 9,A01,083615,Staff,3,17,60,57
1650074930812,COGS 11,A01,083617,Boyle; Mary E. T.,24,0,40,16
1650074936836,COGS 13,A01,083071,Staff,0,29,40,40
1650074942861,COGS 14A,A01,092681,Staff,0,11,100,100
1650074948891,COGS 14B,A01,083073,Cheng; Tzu-Han,0,4,50,50
1650074954916,COGS 17,A01,092677,Staff,35,0,75,40
1650074960943,COGS 100,A01,083619,Staff,0,20,60,60
1650074966966,COGS 101A,A01,083621,Davis; Joshua Daniel,0,17,60,60
1650074972992,COGS 101B,A01,091572,Staff,10,0,60,50
1650074979021,COGS 101C,A01,083625,Delgado; Tania,21,0,30,9
1650074985045,COGS 107A,A01,083627,Boyle; Mary E. T.,1,4,60,59
1650074991069,COGS 118A,A01,083075,Staff,18,0,60,42
1650074997098,CSE 3,A50,083646,Miranda; Gregory Joseph,22,0,38,16
1650074997098,CSE 3,A51,083647,Miranda; Gregory Joseph,37,0,37,0
1650075003140,CSE 8A,A50,083650,Miranda; Gregory Joseph,0,15,40,40
1650075009163,CSE 11,A01,083080,Cao; Yingjun,0,66,40,40
1650075015186,CSE 12,A01,083652,Staff,0,2,100,100
1650075021210,CSE 15L,A01,083654,Staff,0,0,50,50
1650075021210,CSE 15L,A02,083655,Staff,10,0,50,40
1650075027237,CSE 20,A01,083657,Staff,58,0,80,22
1650075033264,CSE 30,A01,083084,Eldon; John,0,63,40,40
1650075039291,CSE 100,A01,083659,Cao; Yingjun,0,59,50,50
1650075045318,CSE 134B,A01,083661,Powell; Thomas Allan,1,28,65,64
1650075051353,CSE 140,A01,083663,Staff,4,0,75,71
1650075057459,CSE 140L,A01,083088,Eldon; John,0,1,75,75
1650075063485,CSE 175,A01,083665,Kumar; Rakesh,9,0,25,16
1650075069508,CSE 190,A00,092507,Dubnov; Shlomo,14,0,20,6
1650075075538,ECE 45,A01,083139,Staff,0,13,40,40
1650075081568,ECE 65,A50,083695,Staff,0,3,30,30
1650075087590,ECE 109,A01,091882,Touri; Behrouz,48,0,70,22
1650075093620,ECE 180,A00,083140,Abi Samra; Nicholas Camill,24,0,30,6
1650075093620,ECE 180,B00,083141,Abi Samra; Nicholas Camill,8,0,30,22
1650075099648,MATH 10A,A01,083735,Patchell; Gregory David,12,0,30,18
1650075099648,MATH 10A,A02,083736,Patchell; Gregory David,28,0,30,2
1650075099648,MATH 10A,A03,083737,Patchell; Gregory David,27,0,30,3
1650075105673,MATH 10B,A01,083207,Staff,0,5,30,30
1650075105673,MATH 10B,A02,083208,Staff,0,3,30,30
1650075105673,MATH 10B,B01,083739,Staff,18,0,30,12
1650075105673,MATH 10B,B02,083740,Staff,29,0,30,1
1650075111707,MATH 18,A01,083743,Staff,10,0,30,20
1650075111707,MATH 18,A02,083744,Staff,28,0,30,2
1650075111707,MATH 18,A03,083745,Staff,23,0,30,7
1650075111707,MATH 18,A04,083746,Staff,27,0,30,3
1650075111707,MATH 18,B01,083748,Staff,0,9,30,30
1650075111707,MATH 18,B02,083749,Staff,1,7,30,29
1650075111707,MATH 18,B03,083750,Staff,0,6,30,30
1650075111707,MATH 18,B04,083751,Staff,1,8,30,29
1650075117730,MATH 20A,A01,083754,Staff,26,0,40,14
1650075123756,MATH 20B,A01,083756,Staff,0,6,30,30
1650075123756,MATH 20B,A02,083757,Staff,0,1,30,30
1650075129810,MATH 20C,A01,083760,Staff,0,10,30,30
1650075129810,MATH 20C,A02,083761,Staff,0,12,30,30
1650075129810,MATH 20C,B01,083762,Staff,14,0,30,16
1650075129810,MATH 20C,B02,083763,Staff,28,0,30,2
1650075135846,MATH 20D,A01,083765,Staff,0,2,30,30
1650075135846,MATH 20D,A02,083766,Staff,14,0,30,16
1650075135846,MATH 20D,A03,083767,Staff,28,0,30,2
1650075141869,MATH 20E,A01,083771,Staff,10,0,30,20
1650075141869,MATH 20E,A02,083772,Staff,20,0,30,10
1650075141869,MATH 20E,B01,083773,Staff,2,2,30,28
1650075141869,MATH 20E,B02,083774,Staff,16,0,30,14
1650075147893,MATH 103A,A01,083777,Staff,0,8,30,30
1650075147893,MATH 103A,A02,083778,Staff,0,7,30,30
1650075147893,MATH 103A,B01,083779,Staff,0,8,30,30
1650075147893,MATH 103A,B02,083780,Staff,1,7,30,29
1650075153926,MATH 105,A01,085443,Staff,1,13,30,29
1650075159959,MATH 109,A01,083213,Anzaldo; Leesa B,1,4,30,29
1650075159959,MATH 109,A02,083214,Anzaldo; Leesa B,0,5,30,30
1650075159959,MATH 109,B01,083215,Anzaldo; Leesa B,0,4,30,30
1650075159959,MATH 109,B02,083216,Anzaldo; Leesa B,1,3,30,29
1650075165988,MATH 142A,A01,083219,Chow; Bennett,0,10,30,30
1650075165988,MATH 142A,A02,083220,Chow; Bennett,0,10,30,30
1650075165988,MATH 142A,B01,083221,Chow; Bennett,0,10,30,30
1650075165988,MATH 142A,B02,083222,Chow; Bennett,0,9,30,30
1650075172013,MATH 193A,A01,083224,Staff,0,4,30,30
1650075172013,MATH 193A,A02,083225,Staff,0,4,30,30
1650075172013,MATH 193A,A03,083781,Staff,0,0,30,30
1650075172013,MATH 193A,A04,083782,Staff,5,0,30,25
1650075178036,MATH 197,001,091859,McAuley; Julian John,9998,0,9999,1
1650075184096,COGS 9,A01,083615,Staff,3,17,60,57
1650075190126,COGS 11,A01,083617,Boyle; Mary E. T.,24,0,40,16
1650075196148,COGS 13,A01,083071,Staff,0,29,40,40
1650075202171,COGS 14A,A01,092681,Staff,0,11,100,100
1650075208195,COGS 14B,A01,083073,Cheng; Tzu-Han,0,4,50,50
1650075214222,COGS 17,A01,092677,Staff,35,0,75,40
1650075220244,COGS 100,A01,083619,Staff,0,20,60,60
1650075226268,COGS 101A,A01,083621,Davis; Joshua Daniel,0,17,60,60
1650075232290,COGS 101B,A01,091572,Staff,10,0,60,50
1650075238323,COGS 101C,A01,083625,Delgado; Tania,21,0,30,9
1650075244355,COGS 107A,A01,083627,Boyle; Mary E. T.,1,4,60,59
1650075250397,COGS 118A,A01,083075,Staff,18,0,60,42
1650075256421,CSE 3,A50,083646,Miranda; Gregory Joseph,22,0,38,16
1650075256421,CSE 3,A51,083647,Miranda; Gregory Joseph,37,0,37,0
1650075262448,CSE 8A,A50,083650,Miranda; Gregory Joseph,0,15,40,40
1650075268479,CSE 11,A01,083080,Cao; Yingjun,0,66,40,40
1650075274529,CSE 12,A01,083652,Staff,0,2,100,100
1650075280557,CSE 15L,A01,083654,Staff,0,0,50,50
1650075280557,CSE 15L,A02,083655,Staff,10,0,50,40
1650075286583,CSE 20,A01,083657,Staff,58,0,80,22
1650075292610,CSE 30,A01,083084,Eldon; John,0,63,40,40
1650075298637,CSE 100,A01,083659,Cao; Yingjun,0,59,50,50
1650075304668,CSE 134B,A01,083661,Powell; Thomas Allan,1,28,65,64
1650075310691,CSE 140,A01,083663,Staff,4,0,75,71
1650075316716,CSE 140L,A01,083088,Eldon; John,0,1,75,75
1650075322743,CSE 175,A01,083665,Kumar; Rakesh,9,0,25,16
1650075328774,CSE 190,A00,092507,Dubnov; Shlomo,14,0,20,6
1650075334800,ECE 45,A01,083139,Staff,0,13,40,40
1650075340823,ECE 65,A50,083695,Staff,0,3,30,30
1650075346847,ECE 109,A01,091882,Touri; Behrouz,48,0,70,22
1650075352872,ECE 180,A00,083140,Abi Samra; Nicholas Camill,24,0,30,6
1650075352872,ECE 180,B00,083141,Abi Samra; Nicholas Camill,8,0,30,22
1650075358896,MATH 10A,A01,083735,Patchell; Gregory David,12,0,30,18
1650075358896,MATH 10A,A02,083736,Patchell; Gregory David,28,0,30,2
1650075358896,MATH 10A,A03,083737,Patchell; Gregory David,27,0,30,3
1650075364924,MATH 10B,A01,083207,Staff,0,5,30,30
1650075364924,MATH 10B,A02,083208,Staff,0,3,30,30
1650075364924,MATH 10B,B01,083739,Staff,18,0,30,12
1650075364924,MATH 10B,B02,083740,Staff,29,0,30,1
1650075370955,MATH 18,A01,083743,Staff,10,0,30,20
1650075370955,MATH 18,A02,083744,Staff,28,0,30,2
1650075370955,MATH 18,A03,083745,Staff,23,0,30,7
1650075370955,MATH 18,A04,083746,Staff,27,0,30,3
1650075370955,MATH 18,B01,083748,Staff,0,9,30,30
1650075370955,MATH 18,B02,083749,Staff,1,7,30,29
1650075370955,MATH 18,B03,083750,Staff,0,6,30,30
1650075370955,MATH 18,B04,083751,Staff,1,8,30,29
1650075376982,MATH 20A,A01,083754,Staff,26,0,40,14
1650075383006,MATH 20B,A01,083756,Staff,0,6,30,30
1650075383006,MATH 20B,A02,083757,Staff,0,1,30,30
1650075389031,MATH 20C,A01,083760,Staff,0,10,30,30
1650075389031,MATH 20C,A02,083761,Staff,0,12,30,30
1650075389031,MATH 20C,B01,083762,Staff,14,0,30,16
1650075389031,MATH 20C,B02,083763,Staff,28,0,30,2
1650075395054,MATH 20D,A01,083765,Staff,0,2,30,30
1650075395054,MATH 20D,A02,083766,Staff,14,0,30,16
1650075395054,MATH 20D,A03,083767,Staff,28,0,30,2
1650075401079,MATH 20E,A01,083771,Staff,10,0,30,20
1650075401079,MATH 20E,A02,083772,Staff,20,0,30,10
1650075401079,MATH 20E,B01,083773,Staff,2,2,30,28
1650075401079,MATH 20E,B02,083774,Staff,16,0,30,14
1650075407105,MATH 103A,A01,083777,Staff,0,8,30,30
1650075407105,MATH 103A,A02,083778,Staff,0,7,30,30
1650075407105,MATH 103A,B01,083779,Staff,0,8,30,30
1650075407105,MATH 103A,B02,083780,Staff,1,7,30,29
1650075413145,MATH 105,A01,085443,Staff,1,13,30,29
1650075419173,MATH 109,A01,083213,Anzaldo; Leesa B,1,4,30,29
1650075419173,MATH 109,A02,083214,Anzaldo; Leesa B,0,5,30,30
1650075419173,MATH 109,B01,083215,Anzaldo; Leesa B,0,4,30,30
1650075419173,MATH 109,B02,083216,Anzaldo; Leesa B,1,3,30,29
1650075425197,MATH 142A,A01,083219,Chow; Bennett,0,10,30,30
1650075425197,MATH 142A,A02,083220,Chow; Bennett,0,10,30,30
1650075425197,MATH 142A,B01,083221,Chow; Bennett,0,10,30,30
1650075425197,MATH 142A,B02,083222,Chow; Bennett,0,9,30,30
1650075431219,MATH 193A,A01,083224,Staff,0,4,30,30
1650075431219,MATH 193A,A02,083225,Staff,0,4,30,30
1650075431219,MATH 193A,A03,083781,Staff,0,0,30,30
1650075431219,MATH 193A,A04,083782,Staff,4,0,30,26
1650075437242,MATH 197,001,091859,McAuley; Julian John,9998,0,9999,1
1650075443305,COGS 9,A01,083615,Staff,3,17,60,57
1650075449331,COGS 11,A01,083617,Boyle; Mary E. T.,24,0,40,16
1650075455357,COGS 13,A01,083071,Staff,0,29,40,40
1650075461381,COGS 14A,A01,092681,Staff,1,11,100,99
1650075467407,COGS 14B,A01,083073,Cheng; Tzu-Han,0,4,50,50
1650075473433,COGS 17,A01,092677,Staff,35,0,75,40
1650075479455,COGS 100,A01,083619,Staff,0,20,60,60
1650075485478,COGS 101A,A01,083621,Davis; Joshua Daniel,0,17,60,60
1650075491502,COGS 101B,A01,091572,Staff,10,0,60,50
1650075497527,COGS 101C,A01,083625,Delgado; Tania,21,0,30,9
1650075503551,COGS 107A,A01,083627,Boyle; Mary E. T.,1,4,60,59
1650075509575,COGS 118A,A01,083075,Staff,18,0,60,42
1650075515600,CSE 3,A50,083646,Miranda; Gregory Joseph,22,0,38,16
1650075515600,CSE 3,A51,083647,Miranda; Gregory Joseph,37,0,37,0
1650075521627,CSE 8A,A50,083650,Miranda; Gregory Joseph,0,15,40,40
1650075527654,CSE 11,A01,083080,Cao; Yingjun,0,66,40,40
1650075533681,CSE 12,A01,083652,Staff,0,2,100,100
1650075539705,CSE 15L,A01,083654,Staff,0,0,50,50
1650075539705,CSE 15L,A02,083655,Staff,10,0,50,40
1650075545729,CSE 20,A01,083657,Staff,58,0,80,22
1650075551756,CSE 30,A01,083084,Eldon; John,0,63,40,40
1650075557785,CSE 100,A01,083659,Cao; Yingjun,0,59,50,50
1650075563811,CSE 134B,A01,083661,Powell; Thomas Allan,1,28,65,64
1650075569834,CSE 140,A01,083663,Staff,4,0,75,71
1650075575858,CSE 140L,A01,083088,Eldon; John,0,1,75,75
1650075581892,CSE 175,A01,083665,Kumar; Rakesh,9,0,25,16
1650075587928,CSE 190,A00,092507,Dubnov; Shlomo,14,0,20,6
1650075593961,ECE 45,A01,083139,Staff,0,13,40,40
1650075599989,ECE 65,A50,083695,Staff,0,3,30,30
1650075606014,ECE 109,A01,091882,Touri; Behrouz,48,0,70,22
1650075612059,ECE 180,A00,083140,Abi Samra; Nicholas Camill,24,0,30,6
1650075612059,ECE 180,B00,083141,Abi Samra; Nicholas Camill,8,0,30,22
1650075618084,MATH 10A,A01,083735,Patchell; Gregory David,12,0,30,18
1650075618084,MATH 10A,A02,083736,Patchell; Gregory David,28,0,30,2
1650075618084,MATH 10A,A03,083737,Patchell; Gregory David,27,0,30,3
1650075624117,MATH 10B,A01,083207,Staff,0,5,30,30
1650075624117,MATH 10B,A02,083208,Staff,0,3,30,30
1650075624117,MATH 10B,B01,083739,Staff,18,0,30,12
1650075624117,MATH 10B,B02,083740,Staff,29,0,30,1
1650075630143,MATH 18,A01,083743,Staff,10,0,30,20
1650075630143,MATH 18,A02,083744,Staff,28,0,30,2
1650075630143,MATH 18,A03,083745,Staff,23,0,30,7
1650075630143,MATH 18,A04,083746,Staff,27,0,30,3
1650075630143,MATH 18,B01,083748,Staff,0,9,30,30
1650075630143,MATH 18,B02,083749,Staff,1,7,30,29
1650075630143,MATH 18,B03,083750,Staff,0,6,30,30
1650075630143,MATH 18,B04,083751,Staff,1,8,30,29
1650075636168,MATH 20A,A01,083754,Staff,26,0,40,14
1650075642195,MATH 20B,A01,083756,Staff,0,6,30,30
1650075642195,MATH 20B,A02,083757,Staff,0,1,30,30
1650075648230,MATH 20C,A01,083760,Staff,0,10,30,30
1650075648230,MATH 20C,A02,083761,Staff,0,12,30,30
1650075648230,MATH 20C,B01,083762,Staff,14,0,30,16
1650075648230,MATH 20C,B02,083763,Staff,28,0,30,2
1650075654342,MATH 20D,A01,083765,Staff,0,2,30,30
1650075654342,MATH 20D,A02,083766,Staff,14,0,30,16
1650075654342,MATH 20D,A03,083767,Staff,28,0,30,2
1650075660368,MATH 20E,A01,083771,Staff,10,0,30,20
1650075660368,MATH 20E,A02,083772,Staff,20,0,30,10
1650075660368,MATH 20E,B01,083773,Staff,2,2,30,28
1650075660368,MATH 20E,B02,083774,Staff,16,0,30,14
1650075666398,MATH 103A,A01,083777,Staff,0,8,30,30
1650075666398,MATH 103A,A02,083778,Staff,0,7,30,30
1650075666398,MATH 103A,B01,083779,Staff,0,8,30,30
1650075666398,MATH 103A,B02,083780,Staff,1,7,30,29
1650075672425,MATH 105,A01,085443,Staff,1,13,30,29
1650075678454,MATH 109,A01,083213,Anzaldo; Leesa B,1,4,30,29
1650075678454,MATH 109,A02,083214,Anzaldo; Leesa B,0,5,30,30
1650075678454,MATH 109,B01,083215,Anzaldo; Leesa B,0,4,30,30
1650075678454,MATH 109,B02,083216,Anzaldo; Leesa B,1,3,30,29
1650075684479,MATH 142A,A01,083219,Chow; Bennett,0,10,30,30
1650075684479,MATH 142A,A02,083220,Chow; Bennett,0,10,30,30
1650075684479,MATH 142A,B01,083221,Chow; Bennett,0,10,30,30
1650075684479,MATH 142A,B02,083222,Chow; Bennett,0,9,30,30
1650075690507,MATH 193A,A01,083224,Staff,0,4,30,30
1650075690507,MATH 193A,A02,083225,Staff,0,4,30,30
1650075690507,MATH 193A,A03,083781,Staff,0,0,30,30
1650075690507,MATH 193A,A04,083782,Staff,4,0,30,26
1650075696530,MATH 197,001,091859,McAuley; Julian John,9998,0,9999,1
1650075702602,COGS 9,A01,083615,Staff,3,17,60,57
1650075708626,COGS 11,A01,083617,Boyle; Mary E. T.,24,0,40,16
1650075714670,COGS 13,A01,083071,Staff,0,29,40,40
1650075720693,COGS 14A,A01,092681,Staff,1,11,100,99
1650075726723,COGS 14B,A01,083073,Cheng; Tzu-Han,0,4,50,50
1650075732748,COGS 17,A01,092677,Staff,35,0,75,40
1650075738770,COGS 100,A01,083619,Staff,0,20,60,60
1650075744807,COGS 101A,A01,083621,Davis; Joshua Daniel,0,17,60,60
1650075750834,COGS 101B,A01,091572,Staff,10,0,60,50
1650075756866,COGS 101C,A01,083625,Delgado; Tania,21,0,30,9
1650075762899,COGS 107A,A01,083627,Boyle; Mary E. T.,1,4,60,59
1650075768923,COGS 118A,A01,083075,Staff,18,0,60,42
1650075774952,CSE 3,A50,083646,Miranda; Gregory Joseph,22,0,38,16
1650075774952,CSE 3,A51,083647,Miranda; Gregory Joseph,37,0,37,0
1650075780975,CSE 8A,A50,083650,Miranda; Gregory Joseph,0,15,40,40
1650075786998,CSE 11,A01,083080,Cao; Yingjun,0,66,40,40
1650075793022,CSE 12,A01,083652,Staff,0,2,100,100
1650075799046,CSE 15L,A01,083654,Staff,0,0,50,50
1650075799046,CSE 15L,A02,083655,Staff,10,0,50,40
1650075805072,CSE 20,A01,083657,Staff,58,0,80,22
1650075811094,CSE 30,A01,083084,Eldon; John,0,63,40,40
1650075817122,CSE 100,A01,083659,Cao; Yingjun,0,59,50,50
1650075823149,CSE 134B,A01,083661,Powell; Thomas Allan,1,28,65,64
1650075829176,CSE 140,A01,083663,Staff,4,0,75,71
1650075835204,CSE 140L,A01,083088,Eldon; John,0,1,75,75
1650075841231,CSE 175,A01,083665,Kumar; Rakesh,9,0,25,16
1650075847362,CSE 190,A00,092507,Dubnov; Shlomo,14,0,20,6
1650075853386,ECE 45,A01,083139,Staff,0,13,40,40
1650075859411,ECE 65,A50,083695,Staff,0,3,30,30
1650075865437,ECE 109,A01,091882,Touri; Behrouz,48,0,70,22
1650075871468,ECE 180,A00,083140,Abi Samra; Nicholas Camill,24,0,30,6
1650075871468,ECE 180,B00,083141,Abi Samra; Nicholas Camill,8,0,30,22
1650075877493,MATH 10A,A01,083735,Patchell; Gregory David,12,0,30,18
1650075877493,MATH 10A,A02,083736,Patchell; Gregory David,28,0,30,2
1650075877493,MATH 10A,A03,083737,Patchell; Gregory David,27,0,30,3
1650075883518,MATH 10B,A01,083207,Staff,0,5,30,30
1650075883518,MATH 10B,A02,083208,Staff,0,3,30,30
1650075883518,MATH 10B,B01,083739,Staff,18,0,30,12
1650075883518,MATH 10B,B02,083740,Staff,29,0,30,1
1650075889544,MATH 18,A01,083743,Staff,10,0,30,20
1650075889544,MATH 18,A02,083744,Staff,28,0,30,2
1650075889544,MATH 18,A03,083745,Staff,23,0,30,7
1650075889544,MATH 18,A04,083746,Staff,27,0,30,3
1650075889544,MATH 18,B01,083748,Staff,0,9,30,30
1650075889544,MATH 18,B02,083749,Staff,1,7,30,29
1650075889544,MATH 18,B03,083750,Staff,0,6,30,30
1650075889544,MATH 18,B04,083751,Staff,1,8,30,29
1650075895569,MATH 20A,A01,083754,Staff,26,0,40,14
1650075901593,MATH 20B,A01,083756,Staff,0,6,30,30
1650075901593,MATH 20B,A02,083757,Staff,0,1,30,30
1650075907618,MATH 20C,A01,083760,Staff,0,10,30,30
1650075907618,MATH 20C,A02,083761,Staff,0,12,30,30
1650075907618,MATH 20C,B01,083762,Staff,14,0,30,16
1650075907618,MATH 20C,B02,083763,Staff,28,0,30,2
1650075913646,MATH 20D,A01,083765,Staff,0,2,30,30
1650075913646,MATH 20D,A02,083766,Staff,14,0,30,16
1650075913646,MATH 20D,A03,083767,Staff,28,0,30,2
1650075919669,MATH 20E,A01,083771,Staff,10,0,30,20
1650075919669,MATH 20E,A02,083772,Staff,20,0,30,10
1650075919669,MATH 20E,B01,083773,Staff,2,2,30,28
1650075919669,MATH 20E,B02,083774,Staff,16,0,30,14
1650075925694,MATH 103A,A01,083777,Staff,0,8,30,30
1650075925694,MATH 103A,A02,083778,Staff,0,7,30,30
1650075925694,MATH 103A,B01,083779,Staff,0,8,30,30
1650075925694,MATH 103A,B02,083780,Staff,1,7,30,29
1650075931717,MATH 105,A01,085443,Staff,1,13,30,29
1650075937747,MATH 109,A01,083213,Anzaldo; Leesa B,1,4,30,29
1650075937747,MATH 109,A02,083214,Anzaldo; Leesa B,0,5,30,30
1650075937747,MATH 109,B01,083215,Anzaldo; Leesa B,0,4,30,30
1650075937747,MATH 109,B02,083216,Anzaldo; Leesa B,1,3,30,29
1650075943770,MATH 142A,A01,083219,Chow; Bennett,0,10,30,30
1650075943770,MATH 142A,A02,083220,Chow; Bennett,0,10,30,30
1650075943770,MATH 142A,B01,083221,Chow; Bennett,0,10,30,30
1650075943770,MATH 142A,B02,083222,Chow; Bennett,0,9,30,30
1650075949794,MATH 193A,A01,083224,Staff,0,4,30,30
1650075949794,MATH 193A,A02,083225,Staff,0,4,30,30
1650075949794,MATH 193A,A03,083781,Staff,0,0,30,30
1650075949794,MATH 193A,A04,083782,Staff,4,0,30,26
1650075955821,MATH 197,001,091859,McAuley; Julian John,9998,0,9999,1
1650075961876,COGS 9,A01,083615,Staff,3,17,60,57
1650075967904,COGS 11,A01,083617,Boyle; Mary E. T.,24,0,40,16
1650075973928,COGS 13,A01,083071,Staff,0,29,40,40
1650075979960,COGS 14A,A01,092681,Staff,1,11,100,99
1650075985985,COGS 14B,A01,083073,Cheng; Tzu-Han,0,4,50,50
1650075992008,COGS 17,A01,092677,Staff,35,0,75,40
1650075998032,COGS 100,A01,083619,Staff,0,20,60,60
1650076004055,COGS 101A,A01,083621,Davis; Joshua Daniel,0,17,60,60
1650076010094,COGS 101B,A01,091572,Staff,10,0,60,50
1650076016117,COGS 101C,A01,083625,Delgado; Tania,21,0,30,9
1650076022144,COGS 107A,A01,083627,Boyle; Mary E. T.,1,4,60,59
1650076028170,COGS 118A,A01,083075,Staff,17,0,60,43
1650076034195,CSE 3,A50,083646,Miranda; Gregory Joseph,22,0,38,16
1650076034195,CSE 3,A51,083647,Miranda; Gregory Joseph,37,0,37,0
1650076040220,CSE 8A,A50,083650,Miranda; Gregory Joseph,0,15,40,40
1650076046243,CSE 11,A01,083080,Cao; Yingjun,0,66,40,40
1650076052273,CSE 12,A01,083652,Staff,0,2,100,100
1650076058299,CSE 15L,A01,083654,Staff,0,0,50,50
1650076058299,CSE 15L,A02,083655,Staff,10,0,50,40
1650076064325,CSE 20,A01,083657,Staff,58,0,80,22
1650076070350,CSE 30,A01,083084,Eldon; John,0,63,40,40
1650076076373,CSE 100,A01,083659,Cao; Yingjun,0,59,50,50
1650076082400,CSE 134B,A01,083661,Powell; Thomas Allan,1,28,65,64
1650076088424,CSE 140,A01,083663,Staff,4,0,75,71
1650076094454,CSE 140L,A01,083088,Eldon; John,0,1,75,75
1650076100488,CSE 175,A01,083665,Kumar; Rakesh,9,0,25,16
1650076106512,CSE 190,A00,092507,Dubnov; Shlomo,14,0,20,6
1650076112539,ECE 45,A01,083139,Staff,0,13,40,40
1650076118564,ECE 65,A50,083695,Staff,0,3,30,30
1650076124591,ECE 109,A01,091882,Touri; Behrouz,48,0,70,22
1650076130616,ECE 180,A00,083140,Abi Samra; Nicholas Camill,24,0,30,6
1650076130616,ECE 180,B00,083141,Abi Samra; Nicholas Camill,8,0,30,22
1650076136639,MATH 10A,A01,083735,Patchell; Gregory David,12,0,30,18
1650076136639,MATH 10A,A02,083736,Patchell; Gregory David,28,0,30,2
1650076136639,MATH 10A,A03,083737,Patchell; Gregory David,27,0,30,3
1650076142665,MATH 10B,A01,083207,Staff,0,5,30,30
1650076142665,MATH 10B,A02,083208,Staff,0,3,30,30
1650076142665,MATH 10B,B01,083739,Staff,18,0,30,12
1650076142665,MATH 10B,B02,083740,Staff,29,0,30,1
1650076148690,MATH 18,A01,083743,Staff,10,0,30,20
1650076148690,MATH 18,A02,083744,Staff,28,0,30,2
1650076148690,MATH 18,A03,083745,Staff,23,0,30,7
1650076148690,MATH 18,A04,083746,Staff,27,0,30,3
1650076148690,MATH 18,B01,083748,Staff,0,9,30,30
1650076148690,MATH 18,B02,083749,Staff,1,7,30,29
1650076148690,MATH 18,B03,083750,Staff,0,6,30,30
1650076148690,MATH 18,B04,083751,Staff,1,8,30,29
1650076154713,MATH 20A,A01,083754,Staff,26,0,40,14
1650076160738,MATH 20B,A01,083756,Staff,0,6,30,30
1650076160738,MATH 20B,A02,083757,Staff,0,1,30,30
1650076166764,MATH 20C,A01,083760,Staff,0,10,30,30
1650076166764,MATH 20C,A02,083761,Staff,0,12,30,30
1650076166764,MATH 20C,B01,083762,Staff,14,0,30,16
1650076166764,MATH 20C,B02,083763,Staff,28,0,30,2
1650076172789,MATH 20D,A01,083765,Staff,0,2,30,30
1650076172789,MATH 20D,A02,083766,Staff,14,0,30,16
1650076172789,MATH 20D,A03,083767,Staff,28,0,30,2
1650076178815,MATH 20E,A01,083771,Staff,10,0,30,20
1650076178815,MATH 20E,A02,083772,Staff,20,0,30,10
1650076178815,MATH 20E,B01,083773,Staff,2,2,30,28
1650076178815,MATH 20E,B02,083774,Staff,16,0,30,14
1650076184839,MATH 103A,A01,083777,Staff,0,8,30,30
1650076184839,MATH 103A,A02,083778,Staff,0,7,30,30
1650076184839,MATH 103A,B01,083779,Staff,0,8,30,30
1650076184839,MATH 103A,B02,083780,Staff,1,7,30,29
1650076190862,MATH 105,A01,085443,Staff,1,13,30,29
1650076196886,MATH 109,A01,083213,Anzaldo; Leesa B,1,4,30,29
1650076196886,MATH 109,A02,083214,Anzaldo; Leesa B,0,5,30,30
1650076196886,MATH 109,B01,083215,Anzaldo; Leesa B,0,4,30,30
1650076196886,MATH 109,B02,083216,Anzaldo; Leesa B,1,3,30,29
1650076202911,MATH 142A,A01,083219,Chow; Bennett,0,10,30,30
1650076202911,MATH 142A,A02,083220,Chow; Bennett,0,10,30,30
1650076202911,MATH 142A,B01,083221,Chow; Bennett,0,10,30,30
1650076202911,MATH 142A,B02,083222,Chow; Bennett,0,9,30,30
1650076208936,MATH 193A,A01,083224,Staff,0,4,30,30
1650076208936,MATH 193A,A02,083225,Staff,0,4,30,30
1650076208936,MATH 193A,A03,083781,Staff,0,0,30,30
1650076208936,MATH 193A,A04,083782,Staff,4,0,30,26
1650076214982,MATH 197,001,091859,McAuley; Julian John,9998,0,9999,1
1650076221044,COGS 9,A01,083615,Staff,3,17,60,57
1650076227068,COGS 11,A01,083617,Boyle; Mary E. T.,24,0,40,16
1650076233092,COGS 13,A01,083071,Staff,0,29,40,40
1650076239120,COGS 14A,A01,092681,Staff,1,11,100,99
1650076245242,COGS 14B,A01,083073,Cheng; Tzu-Han,0,4,50,50
1650076251266,COGS 17,A01,092677,Staff,35,0,75,40
1650076257290,COGS 100,A01,083619,Staff,0,20,60,60
1650076263330,COGS 101A,A01,083621,Davis; Joshua Daniel,0,17,60,60
1650076269356,COGS 101B,A01,091572,Staff,10,0,60,50
1650076275385,COGS 101C,A01,083625,Delgado; Tania,21,0,30,9
1650076281409,COGS 107A,A01,083627,Boyle; Mary E. T.,1,4,60,59
1650076287437,COGS 118A,A01,083075,Staff,17,0,60,43
1650076293467,CSE 3,A50,083646,Miranda; Gregory Joseph,22,0,38,16
1650076293467,CSE 3,A51,083647,Miranda; Gregory Joseph,37,0,37,0
1650076299494,CSE 8A,A50,083650,Miranda; Gregory Joseph,0,15,40,40
1650076305516,CSE 11,A01,083080,Cao; Yingjun,0,66,40,40
1650076311542,CSE 12,A01,083652,Staff,0,2,100,100
1650076317568,CSE 15L,A01,083654,Staff,0,0,50,50
1650076317568,CSE 15L,A02,083655,Staff,10,0,50,40
1650076323590,CSE 20,A01,083657,Staff,58,0,80,22
1650076329614,CSE 30,A01,083084,Eldon; John,0,63,40,40
1650076335657,CSE 100,A01,083659,Cao; Yingjun,0,59,50,50
1650076341688,CSE 134B,A01,083661,Powell; Thomas Allan,1,28,65,64
1650076347711,CSE 140,A01,083663,Staff,4,0,75,71
1650076353749,CSE 140L,A01,083088,Eldon; John,0,1,75,75
1650076359784,CSE 175,A01,083665,Kumar; Rakesh,9,0,25,16
1650076365814,CSE 190,A00,092507,Dubnov; Shlomo,14,0,20,6
1650076371836,ECE 45,A01,083139,Staff,0,13,40,40
1650076377858,ECE 65,A50,083695,Staff,0,3,30,30
1650076383885,ECE 109,A01,091882,Touri; Behrouz,48,0,70,22
1650076389918,ECE 180,A00,083140,Abi Samra; Nicholas Camill,24,0,30,6
1650076389918,ECE 180,B00,083141,Abi Samra; Nicholas Camill,8,0,30,22
1650076395944,MATH 10A,A01,083735,Patchell; Gregory David,12,0,30,18
1650076395944,MATH 10A,A02,083736,Patchell; Gregory David,28,0,30,2
1650076395944,MATH 10A,A03,083737,Patchell; Gregory David,27,0,30,3
1650076401967,MATH 10B,A01,083207,Staff,0,5,30,30
1650076401967,MATH 10B,A02,083208,Staff,0,3,30,30
1650076401967,MATH 10B,B01,083739,Staff,18,0,30,12
1650076401967,MATH 10B,B02,083740,Staff,29,0,30,1
1650076408001,MATH 18,A01,083743,Staff,10,0,30,20
1650076408001,MATH 18,A02,083744,Staff,28,0,30,2
1650076408001,MATH 18,A03,083745,Staff,23,0,30,7
1650076408001,MATH 18,A04,083746,Staff,27,0,30,3
1650076408001,MATH 18,B01,083748,Staff,0,9,30,30
1650076408001,MATH 18,B02,083749,Staff,1,7,30,29
1650076408001,MATH 18,B03,083750,Staff,0,6,30,30
1650076408001,MATH 18,B04,083751,Staff,1,8,30,29
1650076414027,MATH 20A,A01,083754,Staff,26,0,40,14
1650076420050,MATH 20B,A01,083756,Staff,0,6,30,30
1650076420050,MATH 20B,A02,083757,Staff,0,1,30,30
1650076426080,MATH 20C,A01,083760,Staff,0,10,30,30
1650076426080,MATH 20C,A02,083761,Staff,0,12,30,30
1650076426080,MATH 20C,B01,083762,Staff,14,0,30,16
1650076426080,MATH 20C,B02,083763,Staff,28,0,30,2
1650076432107,MATH 20D,A01,083765,Staff,0,2,30,30
1650076432107,MATH 20D,A02,083766,Staff,14,0,30,16
1650076432107,MATH 20D,A03,083767,Staff,28,0,30,2
1650076438130,MATH 20E,A01,083771,Staff,10,0,30,20
1650076438130,MATH 20E,A02,083772,Staff,20,0,30,10
1650076438130,MATH 20E,B01,083773,Staff,2,2,30,28
1650076438130,MATH 20E,B02,083774,Staff,16,0,30,14
1650076444154,MATH 103A,A01,083777,Staff,0,8,30,30
1650076444154,MATH 103A,A02,083778,Staff,0,7,30,30
1650076444154,MATH 103A,B01,083779,Staff,0,8,30,30
1650076444154,MATH 103A,B02,083780,Staff,1,7,30,29
1650076450183,MATH 105,A01,085443,Staff,1,13,30,29
1650076456208,MATH 109,A01,083213,Anzaldo; Leesa B,1,4,30,29
1650076456208,MATH 109,A02,083214,Anzaldo; Leesa B,0,5,30,30
1650076456208,MATH 109,B01,083215,Anzaldo; Leesa B,0,4,30,30
1650076456208,MATH 109,B02,083216,Anzaldo; Leesa B,1,3,30,29
1650076462230,MATH 142A,A01,083219,Chow; Bennett,0,10,30,30
1650076462230,MATH 142A,A02,083220,Chow; Bennett,0,10,30,30
1650076462230,MATH 142A,B01,083221,Chow; Bennett,0,10,30,30
1650076462230,MATH 142A,B02,083222,Chow; Bennett,0,9,30,30
1650076468254,MATH 193A,A01,083224,Staff,0,4,30,30
1650076468254,MATH 193A,A02,083225,Staff,0,4,30,30
1650076468254,MATH 193A,A03,083781,Staff,0,0,30,30
1650076468254,MATH 193A,A04,083782,Staff,4,0,30,26
1650076474285,MATH 197,001,091859,McAuley; Julian John,9998,0,9999,1
1650076480351,COGS 9,A01,083615,Staff,3,17,60,57
1650076486377,COGS 11,A01,083617,Boyle; Mary E. T.,24,0,40,16
1650076492411,COGS 13,A01,083071,Staff,0,29,40,40
1650076498433,COGS 14A,A01,092681,Staff,1,11,100,99
1650076504459,COGS 14B,A01,083073,Cheng; Tzu-Han,0,4,50,50
1650076510486,COGS 17,A01,092677,Staff,35,0,75,40
1650076516522,COGS 100,A01,083619,Staff,0,20,60,60
1650076522551,COGS 101A,A01,083621,Davis; Joshua Daniel,0,17,60,60
1650076528575,COGS 101B,A01,091572,Staff,10,0,60,50
1650076534606,COGS 101C,A01,083625,Delgado; Tania,21,0,30,9
1650076540629,COGS 107A,A01,083627,Boyle; Mary E. T.,1,4,60,59
1650076546662,COGS 118A,A01,083075,Staff,17,0,60,43
1650076552686,CSE 3,A50,083646,Miranda; Gregory Joseph,22,0,38,16
1650076552686,CSE 3,A51,083647,Miranda; Gregory Joseph,37,0,37,0
1650076558730,CSE 8A,A50,083650,Miranda; Gregory Joseph,0,15,40,40
1650076564770,CSE 11,A01,083080,Cao; Yingjun,0,66,40,40
1650076570793,CSE 12,A01,083652,Staff,0,2,100,100
1650076576819,CSE 15L,A01,083654,Staff,0,0,50,50
1650076576819,CSE 15L,A02,083655,Staff,10,0,50,40
1650076582842,CSE 20,A01,083657,Staff,58,0,80,22
1650076588882,CSE 30,A01,083084,Eldon; John,0,63,40,40
1650076594913,CSE 100,A01,083659,Cao; Yingjun,0,59,50,50
1650076600936,CSE 134B,A01,083661,Powell; Thomas Allan,1,28,65,64
1650076606963,CSE 140,A01,083663,Staff,4,0,75,71
1650076612989,CSE 140L,A01,083088,Eldon; John,0,1,75,75
1650076619016,CSE 175,A01,083665,Kumar; Rakesh,9,0,25,16
1650076625045,CSE 190,A00,092507,Dubnov; Shlomo,14,0,20,6
1650076631072,ECE 45,A01,083139,Staff,0,13,40,40
1650076637107,ECE 65,A50,083695,Staff,0,3,30,30
1650076643132,ECE 109,A01,091882,Touri; Behrouz,48,0,70,22
1650076649154,ECE 180,A00,083140,Abi Samra; Nicholas Camill,24,0,30,6
1650076649154,ECE 180,B00,083141,Abi Samra; Nicholas Camill,8,0,30,22
1650076655175,MATH 10A,A01,083735,Patchell; Gregory David,12,0,30,18
1650076655175,MATH 10A,A02,083736,Patchell; Gregory David,28,0,30,2
1650076655175,MATH 10A,A03,083737,Patchell; Gregory David,27,0,30,3
1650076661206,MATH 10B,A01,083207,Staff,0,5,30,30
1650076661206,MATH 10B,A02,083208,Staff,0,3,30,30
1650076661206,MATH 10B,B01,083739,Staff,18,0,30,12
1650076661206,MATH 10B,B02,083740,Staff,29,0,30,1
1650076667232,MATH 18,A01,083743,Staff,10,0,30,20
1650076667232,MATH 18,A02,083744,Staff,28,0,30,2
1650076667232,MATH 18,A03,083745,Staff,23,0,30,7
1650076667232,MATH 18,A04,083746,Staff,27,0,30,3
1650076667232,MATH 18,B01,083748,Staff,0,9,30,30
1650076667232,MATH 18,B02,083749,Staff,1,7,30,29
1650076667232,MATH 18,B03,083750,Staff,0,6,30,30
1650076667232,MATH 18,B04,083751,Staff,1,8,30,29
1650076673256,MATH 20A,A01,083754,Staff,26,0,40,14
1650076679279,MATH 20B,A01,083756,Staff,0,6,30,30
1650076679279,MATH 20B,A02,083757,Staff,0,1,30,30
1650076685314,MATH 20C,A01,083760,Staff,0,10,30,30
1650076685314,MATH 20C,A02,083761,Staff,0,12,30,30
1650076685314,MATH 20C,B01,083762,Staff,14,0,30,16
1650076685314,MATH 20C,B02,083763,Staff,28,0,30,2
1650076691338,MATH 20D,A01,083765,Staff,0,2,30,30
1650076691338,MATH 20D,A02,083766,Staff,14,0,30,16
1650076691338,MATH 20D,A03,083767,Staff,28,0,30,2
1650076697425,MATH 20E,A01,083771,Staff,10,0,30,20
1650076697425,MATH 20E,A02,083772,Staff,20,0,30,10
1650076697425,MATH 20E,B01,083773,Staff,2,2,30,28
1650076697425,MATH 20E,B02,083774,Staff,16,0,30,14
1650076703448,MATH 103A,A01,083777,Staff,0,8,30,30
1650076703448,MATH 103A,A02,083778,Staff,0,7,30,30
1650076703448,MATH 103A,B01,083779,Staff,0,8,30,30
1650076703448,MATH 103A,B02,083780,Staff,1,7,30,29
1650076709473,MATH 105,A01,085443,Staff,1,13,30,29
1650076715494,MATH 109,A01,083213,Anzaldo; Leesa B,1,4,30,29
1650076715494,MATH 109,A02,083214,Anzaldo; Leesa B,0,5,30,30
1650076715494,MATH 109,B01,083215,Anzaldo; Leesa B,0,4,30,30
1650076715494,MATH 109,B02,083216,Anzaldo; Leesa B,1,3,30,29
1650076721517,MATH 142A,A01,083219,Chow; Bennett,0,10,30,30
1650076721517,MATH 142A,A02,083220,Chow; Bennett,0,10,30,30
1650076721517,MATH 142A,B01,083221,Chow; Bennett,0,10,30,30
1650076721517,MATH 142A,B02,083222,Chow; Bennett,0,9,30,30
1650076727546,MATH 193A,A01,083224,Staff,0,4,30,30
1650076727546,MATH 193A,A02,083225,Staff,0,4,30,30
1650076727546,MATH 193A,A03,083781,Staff,0,0,30,30
1650076727546,MATH 193A,A04,083782,Staff,4,0,30,26
1650076733569,MATH 197,001,091859,McAuley; Julian John,9998,0,9999,1
1650076739618,COGS 9,A01,083615,Staff,3,17,60,57
1650076745645,COGS 11,A01,083617,Boyle; Mary E. T.,24,0,40,16
1650076751677,COGS 13,A01,083071,Staff,0,29,40,40
1650076757699,COGS 14A,A01,092681,Staff,1,11,100,99
1650076763727,COGS 14B,A01,083073,Cheng; Tzu-Han,0,4,50,50
1650076769755,COGS 17,A01,092677,Staff,35,0,75,40
1650076775783,COGS 100,A01,083619,Staff,0,20,60,60
1650076781806,COGS 101A,A01,083621,Davis; Joshua Daniel,0,17,60,60
1650076787833,COGS 101B,A01,091572,Staff,10,0,60,50
1650076793855,COGS 101C,A01,083625,Delgado; Tania,21,0,30,9
1650076799897,COGS 107A,A01,083627,Boyle; Mary E. T.,1,4,60,59
1650076805922,COGS 118A,A01,083075,Staff,17,0,60,43
1650076811953,CSE 3,A50,083646,Miranda; Gregory Joseph,22,0,38,16
1650076811953,CSE 3,A51,083647,Miranda; Gregory Joseph,37,0,37,0
1650076817975,CSE 8A,A50,083650,Miranda; Gregory Joseph,0,15,40,40
1650076824000,CSE 11,A01,083080,Cao; Yingjun,0,66,40,40
1650076830025,CSE 12,A01,083652,Staff,0,2,100,100
1650076836048,CSE 15L,A01,083654,Staff,0,0,50,50
1650076836048,CSE 15L,A02,083655,Staff,10,0,50,40
1650076842162,CSE 20,A01,083657,Staff,58,0,80,22
1650076848186,CSE 30,A01,083084,Eldon; John,0,63,40,40
1650076854213,CSE 100,A01,083659,Cao; Yingjun,0,59,50,50
1650076860246,CSE 134B,A01,083661,Powell; Thomas Allan,1,28,65,64
1650076866269,CSE 140,A01,083663,Staff,4,0,75,71
1650076872293,CSE 140L,A01,083088,Eldon; John,0,1,75,75
1650076878328,CSE 175,A01,083665,Kumar; Rakesh,9,0,25,16
1650076884352,CSE 190,A00,092507,Dubnov; Shlomo,14,0,20,6
1650076890378,ECE 45,A01,083139,Staff,0,13,40,40
1650076896404,ECE 65,A50,083695,Staff,0,3,30,30
1650076902435,ECE 109,A01,091882,Touri; Behrouz,48,0,70,22
1650076908462,ECE 180,A00,083140,Abi Samra; Nicholas Camill,24,0,30,6
1650076908462,ECE 180,B00,083141,Abi Samra; Nicholas Camill,8,0,30,22
1650076914486,MATH 10A,A01,083735,Patchell; Gregory David,12,0,30,18
1650076914486,MATH 10A,A02,083736,Patchell; Gregory David,28,0,30,2
1650076914486,MATH 10A,A03,083737,Patchell; Gregory David,27,0,30,3
1650076920508,MATH 10B,A01,083207,Staff,0,5,30,30
1650076920508,MATH 10B,A02,083208,Staff,0,3,30,30
1650076920508,MATH 10B,B01,083739,Staff,18,0,30,12
1650076920508,MATH 10B,B02,083740,Staff,29,0,30,1
1650076926533,MATH 18,A01,083743,Staff,10,0,30,20
1650076926533,MATH 18,A02,083744,Staff,28,0,30,2
1650076926533,MATH 18,A03,083745,Staff,23,0,30,7
1650076926533,MATH 18,A04,083746,Staff,27,0,30,3
1650076926533,MATH 18,B01,083748,Staff,0,9,30,30
1650076926533,MATH 18,B02,083749,Staff,1,7,30,29
1650076926533,MATH 18,B03,083750,Staff,0,6,30,30
1650076926533,MATH 18,B04,083751,Staff,1,8,30,29
1650076932559,MATH 20A,A01,083754,Staff,26,0,40,14
1650076938593,MATH 20B,A01,083756,Staff,0,6,30,30
1650076938593,MATH 20B,A02,083757,Staff,0,1,30,30
1650076944616,MATH 20C,A01,083760,Staff,0,10,30,30
1650076944616,MATH 20C,A02,083761,Staff,0,12,30,30
1650076944616,MATH 20C,B01,083762,Staff,14,0,30,16
1650076944616,MATH 20C,B02,083763,Staff,28,0,30,2
1650076950638,MATH 20D,A01,083765,Staff,0,2,30,30
1650076950638,MATH 20D,A02,083766,Staff,14,0,30,16
1650076950638,MATH 20D,A03,083767,Staff,28,0,30,2
1650076956662,MATH 20E,A01,083771,Staff,10,0,30,20
1650076956662,MATH 20E,A02,083772,Staff,20,0,30,10
1650076956662,MATH 20E,B01,083773,Staff,2,2,30,28
1650076956662,MATH 20E,B02,083774,Staff,16,0,30,14
1650076962703,MATH 103A,A01,083777,Staff,0,8,30,30
1650076962703,MATH 103A,A02,083778,Staff,0,7,30,30
1650076962703,MATH 103A,B01,083779,Staff,0,8,30,30
1650076962703,MATH 103A,B02,083780,Staff,1,7,30,29
1650076968727,MATH 105,A01,085443,Staff,1,13,30,29
1650076974755,MATH 109,A01,083213,Anzaldo; Leesa B,1,4,30,29
1650076974755,MATH 109,A02,083214,Anzaldo; Leesa B,0,5,30,30
1650076974755,MATH 109,B01,083215,Anzaldo; Leesa B,0,4,30,30
1650076974755,MATH 109,B02,083216,Anzaldo; Leesa B,1,3,30,29
1650076980778,MATH 142A,A01,083219,Chow; Bennett,0,10,30,30
1650076980778,MATH 142A,A02,083220,Chow; Bennett,0,10,30,30
1650076980778,MATH 142A,B01,083221,Chow; Bennett,0,10,30,30
1650076980778,MATH 142A,B02,083222,Chow; Bennett,0,9,30,30
1650076986808,MATH 193A,A01,083224,Staff,0,4,30,30
1650076986808,MATH 193A,A02,083225,Staff,0,4,30,30
1650076986808,MATH 193A,A03,083781,Staff,0,0,30,30
1650076986808,MATH 193A,A04,083782,Staff,4,0,30,26
1650076992834,MATH 197,001,091859,McAuley; Julian John,9998,0,9999,1
1650076998888,COGS 9,A01,083615,Staff,3,17,60,57
1650077004914,COGS 11,A01,083617,Boyle; Mary E. T.,24,0,40,16
1650077010936,COGS 13,A01,083071,Staff,0,29,40,40
1650077016966,COGS 14A,A01,092681,Staff,1,11,100,99
1650077022993,COGS 14B,A01,083073,Cheng; Tzu-Han,0,4,50,50
1650077029017,COGS 17,A01,092677,Staff,35,0,75,40
1650077035053,COGS 100,A01,083619,Staff,0,20,60,60
1650077041077,COGS 101A,A01,083621,Davis; Joshua Daniel,0,17,60,60
1650077047100,COGS 101B,A01,091572,Staff,10,0,60,50
1650077053124,COGS 101C,A01,083625,Delgado; Tania,21,0,30,9
1650077059151,COGS 107A,A01,083627,Boyle; Mary E. T.,1,4,60,59
1650077065177,COGS 118A,A01,083075,Staff,17,0,60,43
1650077071215,CSE 3,A50,083646,Miranda; Gregory Joseph,22,0,38,16
1650077071215,CSE 3,A51,083647,Miranda; Gregory Joseph,37,0,37,0
1650077077243,CSE 8A,A50,083650,Miranda; Gregory Joseph,0,15,40,40
1650077083268,CSE 11,A01,083080,Cao; Yingjun,0,66,40,40
1650077089296,CSE 12,A01,083652,Staff,0,2,100,100
1650077095329,CSE 15L,A01,083654,Staff,0,0,50,50
1650077095329,CSE 15L,A02,083655,Staff,10,0,50,40
1650077101367,CSE 20,A01,083657,Staff,58,0,80,22
1650077107403,CSE 30,A01,083084,Eldon; John,0,63,40,40
1650077113430,CSE 100,A01,083659,Cao; Yingjun,0,59,50,50
1650077119453,CSE 134B,A01,083661,Powell; Thomas Allan,1,28,65,64
1650077125476,CSE 140,A01,083663,Staff,4,0,75,71
1650077131501,CSE 140L,A01,083088,Eldon; John,0,1,75,75
1650077137528,CSE 175,A01,083665,Kumar; Rakesh,9,0,25,16
1650077143554,CSE 190,A00,092507,Dubnov; Shlomo,14,0,20,6
1650077149586,ECE 45,A01,083139,Staff,0,13,40,40
1650077155619,ECE 65,A50,083695,Staff,0,3,30,30
1650077161646,ECE 109,A01,091882,Touri; Behrouz,48,0,70,22
1650077167673,ECE 180,A00,083140,Abi Samra; Nicholas Camill,24,0,30,6
1650077167673,ECE 180,B00,083141,Abi Samra; Nicholas Camill,8,0,30,22
1650077173702,MATH 10A,A01,083735,Patchell; Gregory David,12,0,30,18
1650077173702,MATH 10A,A02,083736,Patchell; Gregory David,28,0,30,2
1650077173702,MATH 10A,A03,083737,Patchell; Gregory David,27,0,30,3
1650077179724,MATH 10B,A01,083207,Staff,0,5,30,30
1650077179724,MATH 10B,A02,083208,Staff,0,3,30,30
1650077179724,MATH 10B,B01,083739,Staff,18,0,30,12
1650077179724,MATH 10B,B02,083740,Staff,29,0,30,1
1650077185749,MATH 18,A01,083743,Staff,10,0,30,20
1650077185749,MATH 18,A02,083744,Staff,28,0,30,2
1650077185749,MATH 18,A03,083745,Staff,23,0,30,7
1650077185749,MATH 18,A04,083746,Staff,27,0,30,3
1650077185749,MATH 18,B01,083748,Staff,0,9,30,30
1650077185749,MATH 18,B02,083749,Staff,1,7,30,29
1650077185749,MATH 18,B03,083750,Staff,0,6,30,30
1650077185749,MATH 18,B04,083751,Staff,1,8,30,29
1650077191776,MATH 20A,A01,083754,Staff,26,0,40,14
1650077197801,MATH 20B,A01,083756,Staff,0,6,30,30
1650077197801,MATH 20B,A02,083757,Staff,0,1,30,30
1650077203826,MATH 20C,A01,083760,Staff,0,10,30,30
1650077203826,MATH 20C,A02,083761,Staff,0,12,30,30
1650077203826,MATH 20C,B01,083762,Staff,14,0,30,16
1650077203826,MATH 20C,B02,083763,Staff,28,0,30,2
1650077209860,MATH 20D,A01,083765,Staff,0,2,30,30
1650077209860,MATH 20D,A02,083766,Staff,14,0,30,16
1650077209860,MATH 20D,A03,083767,Staff,28,0,30,2
1650077215886,MATH 20E,A01,083771,Staff,10,0,30,20
1650077215886,MATH 20E,A02,083772,Staff,20,0,30,10
1650077215886,MATH 20E,B01,083773,Staff,2,2,30,28
1650077215886,MATH 20E,B02,083774,Staff,16,0,30,14
1650077221925,MATH 103A,A01,083777,Staff,0,8,30,30
1650077221925,MATH 103A,A02,083778,Staff,0,7,30,30
1650077221925,MATH 103A,B01,083779,Staff,0,8,30,30
1650077221925,MATH 103A,B02,083780,Staff,1,7,30,29
1650077227951,MATH 105,A01,085443,Staff,1,13,30,29
1650077233977,MATH 109,A01,083213,Anzaldo; Leesa B,1,4,30,29
1650077233977,MATH 109,A02,083214,Anzaldo; Leesa B,0,5,30,30
1650077233977,MATH 109,B01,083215,Anzaldo; Leesa B,0,4,30,30
1650077233977,MATH 109,B02,083216,Anzaldo; Leesa B,1,3,30,29
1650077240014,MATH 142A,A01,083219,Chow; Bennett,0,10,30,30
1650077240014,MATH 142A,A02,083220,Chow; Bennett,0,10,30,30
1650077240014,MATH 142A,B01,083221,Chow; Bennett,0,10,30,30
1650077240014,MATH 142A,B02,083222,Chow; Bennett,0,9,30,30
1650077246043,MATH 193A,A01,083224,Staff,0,4,30,30
1650077246043,MATH 193A,A02,083225,Staff,0,4,30,30
1650077246043,MATH 193A,A03,083781,Staff,0,0,30,30
1650077246043,MATH 193A,A04,083782,Staff,4,0,30,26
1650077252068,MATH 197,001,091859,McAuley; Julian John,9998,0,9999,1
1650077258129,COGS 9,A01,083615,Staff,3,17,60,57
1650077264151,COGS 11,A01,083617,Boyle; Mary E. T.,24,0,40,16
1650077270173,COGS 13,A01,083071,Staff,0,29,40,40
1650077276196,COGS 14A,A01,092681,Staff,1,11,100,99
1650077282220,COGS 14B,A01,083073,Cheng; Tzu-Han,0,4,50,50
1650077288244,COGS 17,A01,092677,Staff,35,0,75,40
1650077294266,COGS 100,A01,083619,Staff,0,20,60,60
1650077300288,COGS 101A,A01,083621,Davis; Joshua Daniel,0,17,60,60
1650077306311,COGS 101B,A01,091572,Staff,10,0,60,50
1650077312337,COGS 101C,A01,083625,Delgado; Tania,21,0,30,9
1650077318360,COGS 107A,A01,083627,Boyle; Mary E. T.,1,4,60,59
1650077324383,COGS 118A,A01,083075,Staff,17,0,60,43
1650077330417,CSE 3,A50,083646,Miranda; Gregory Joseph,22,0,38,16
1650077330417,CSE 3,A51,083647,Miranda; Gregory Joseph,37,0,37,0
1650077336444,CSE 8A,A50,083650,Miranda; Gregory Joseph,0,15,40,40
1650077342472,CSE 11,A01,083080,Cao; Yingjun,0,66,40,40
1650077348494,CSE 12,A01,083652,Staff,0,2,100,100
1650077354517,CSE 15L,A01,083654,Staff,0,0,50,50
1650077354517,CSE 15L,A02,083655,Staff,10,0,50,40
1650077360545,CSE 20,A01,083657,Staff,58,0,80,22
1650077366571,CSE 30,A01,083084,Eldon; John,0,63,40,40
1650077372602,CSE 100,A01,083659,Cao; Yingjun,0,59,50,50
1650077378624,CSE 134B,A01,083661,Powell; Thomas Allan,1,28,65,64
1650077384657,CSE 140,A01,083663,Staff,4,0,75,71
1650077390681,CSE 140L,A01,083088,Eldon; John,0,1,75,75
1650077396708,CSE 175,A01,083665,Kumar; Rakesh,9,0,25,16
1650077402736,CSE 190,A00,092507,Dubnov; Shlomo,14,0,20,6
1650077408765,ECE 45,A01,083139,Staff,0,13,40,40
1650077414798,ECE 65,A50,083695,Staff,0,3,30,30
1650077420820,ECE 109,A01,091882,Touri; Behrouz,48,0,70,22
1650077426843,ECE 180,A00,083140,Abi Samra; Nicholas Camill,24,0,30,6
1650077426843,ECE 180,B00,083141,Abi Samra; Nicholas Camill,8,0,30,22
1650077432866,MATH 10A,A01,083735,Patchell; Gregory David,12,0,30,18
1650077432866,MATH 10A,A02,083736,Patchell; Gregory David,28,0,30,2
1650077432866,MATH 10A,A03,083737,Patchell; Gregory David,27,0,30,3
1650077438962,MATH 10B,A01,083207,Staff,0,5,30,30
1650077438962,MATH 10B,A02,083208,Staff,0,4,30,30
1650077438962,MATH 10B,B01,083739,Staff,18,0,30,12
1650077438962,MATH 10B,B02,083740,Staff,29,0,30,1
1650077444987,MATH 18,A01,083743,Staff,10,0,30,20
1650077444987,MATH 18,A02,083744,Staff,28,0,30,2
1650077444987,MATH 18,A03,083745,Staff,23,0,30,7
1650077444987,MATH 18,A04,083746,Staff,27,0,30,3
1650077444987,MATH 18,B01,083748,Staff,0,9,30,30
1650077444987,MATH 18,B02,083749,Staff,1,7,30,29
1650077444987,MATH 18,B03,083750,Staff,0,6,30,30
1650077444987,MATH 18,B04,083751,Staff,1,8,30,29
1650077451012,MATH 20A,A01,083754,Staff,26,0,40,14
1650077457036,MATH 20B,A01,083756,Staff,0,6,30,30
1650077457036,MATH 20B,A02,083757,Staff,0,1,30,30
1650077463064,MATH 20C,A01,083760,Staff,0,11,30,30
1650077463064,MATH 20C,A02,083761,Staff,0,12,30,30
1650077463064,MATH 20C,B01,083762,Staff,14,0,30,16
1650077463064,MATH 20C,B02,083763,Staff,28,0,30,2
1650077469087,MATH 20D,A01,083765,Staff,0,2,30,30
1650077469087,MATH 20D,A02,083766,Staff,14,0,30,16
1650077469087,MATH 20D,A03,083767,Staff,28,0,30,2
1650077475116,MATH 20E,A01,083771,Staff,10,0,30,20
1650077475116,MATH 20E,A02,083772,Staff,20,0,30,10
1650077475116,MATH 20E,B01,083773,Staff,2,2,30,28
1650077475116,MATH 20E,B02,083774,Staff,16,0,30,14
1650077481144,MATH 103A,A01,083777,Staff,0,8,30,30
1650077481144,MATH 103A,A02,083778,Staff,0,7,30,30
1650077481144,MATH 103A,B01,083779,Staff,0,8,30,30
1650077481144,MATH 103A,B02,083780,Staff,1,7,30,29
1650077487172,MATH 105,A01,085443,Staff,1,13,30,29
1650077493197,MATH 109,A01,083213,Anzaldo; Leesa B,1,4,30,29
1650077493197,MATH 109,A02,083214,Anzaldo; Leesa B,0,5,30,30
1650077493197,MATH 109,B01,083215,Anzaldo; Leesa B,0,4,30,30
1650077493197,MATH 109,B02,083216,Anzaldo; Leesa B,1,3,30,29
1650077499220,MATH 142A,A01,083219,Chow; Bennett,0,10,30,30
1650077499220,MATH 142A,A02,083220,Chow; Bennett,0,10,30,30
1650077499220,MATH 142A,B01,083221,Chow; Bennett,0,10,30,30
1650077499220,MATH 142A,B02,083222,Chow; Bennett,0,9,30,30
1650077505252,MATH 193A,A01,083224,Staff,0,4,30,30
1650077505252,MATH 193A,A02,083225,Staff,0,4,30,30
1650077505252,MATH 193A,A03,083781,Staff,0,0,30,30
1650077505252,MATH 193A,A04,083782,Staff,4,0,30,26
1650077511275,MATH 197,001,091859,McAuley; Julian John,9998,0,9999,1
1650077517326,COGS 9,A01,083615,Staff,3,17,60,57
1650077523350,COGS 11,A01,083617,Boyle; Mary E. T.,24,0,40,16
1650077529377,COGS 13,A01,083071,Staff,0,29,40,40
1650077535410,COGS 14A,A01,092681,Staff,1,11,100,99
1650077541437,COGS 14B,A01,083073,Cheng; Tzu-Han,0,4,50,50
1650077547472,COGS 17,A01,092677,Staff,35,0,75,40
1650077553495,COGS 100,A01,083619,Staff,0,20,60,60
1650077559520,COGS 101A,A01,083621,Davis; Joshua Daniel,0,17,60,60
1650077565544,COGS 101B,A01,091572,Staff,10,0,60,50
1650077571567,COGS 101C,A01,083625,Delgado; Tania,21,0,30,9
1650077577592,COGS 107A,A01,083627,Boyle; Mary E. T.,1,4,60,59
1650077583619,COGS 118A,A01,083075,Staff,17,0,60,43
1650077589644,CSE 3,A50,083646,Miranda; Gregory Joseph,22,0,38,16
1650077589644,CSE 3,A51,083647,Miranda; Gregory Joseph,37,0,37,0
1650077595666,CSE 8A,A50,083650,Miranda; Gregory Joseph,0,15,40,40
1650077601700,CSE 11,A01,083080,Cao; Yingjun,0,66,40,40
1650077607737,CSE 12,A01,083652,Staff,0,2,100,100
1650077613760,CSE 15L,A01,083654,Staff,0,0,50,50
1650077613760,CSE 15L,A02,083655,Staff,10,0,50,40
1650077619788,CSE 20,A01,083657,Staff,58,0,80,22
1650077625818,CSE 30,A01,083084,Eldon; John,0,63,40,40
1650077631845,CSE 100,A01,083659,Cao; Yingjun,0,59,50,50
1650077637872,CSE 134B,A01,083661,Powell; Thomas Allan,1,28,65,64
1650077643893,CSE 140,A01,083663,Staff,4,0,75,71
1650077649921,CSE 140L,A01,083088,Eldon; John,0,1,75,75
1650077655948,CSE 175,A01,083665,Kumar; Rakesh,9,0,25,16
1650077661975,CSE 190,A00,092507,Dubnov; Shlomo,14,0,20,6
1650077668000,ECE 45,A01,083139,Staff,0,13,40,40
1650077674026,ECE 65,A50,083695,Staff,0,3,30,30
1650077680051,ECE 109,A01,091882,Touri; Behrouz,48,0,70,22
1650077686080,ECE 180,A00,083140,Abi Samra; Nicholas Camill,24,0,30,6
1650077686080,ECE 180,B00,083141,Abi Samra; Nicholas Camill,8,0,30,22
1650077692109,MATH 10A,A01,083735,Patchell; Gregory David,12,0,30,18
1650077692109,MATH 10A,A02,083736,Patchell; Gregory David,28,0,30,2
1650077692109,MATH 10A,A03,083737,Patchell; Gregory David,27,0,30,3
1650077698133,MATH 10B,A01,083207,Staff,0,5,30,30
1650077698133,MATH 10B,A02,083208,Staff,0,4,30,30
1650077698133,MATH 10B,B01,083739,Staff,18,0,30,12
1650077698133,MATH 10B,B02,083740,Staff,29,0,30,1
1650077704163,MATH 18,A01,083743,Staff,10,0,30,20
1650077704163,MATH 18,A02,083744,Staff,28,0,30,2
1650077704163,MATH 18,A03,083745,Staff,23,0,30,7
1650077704163,MATH 18,A04,083746,Staff,27,0,30,3
1650077704163,MATH 18,B01,083748,Staff,0,9,30,30
1650077704163,MATH 18,B02,083749,Staff,1,7,30,29
1650077704163,MATH 18,B03,083750,Staff,0,6,30,30
1650077704163,MATH 18,B04,083751,Staff,1,8,30,29
1650077710186,MATH 20A,A01,083754,Staff,26,0,40,14
1650077716212,MATH 20B,A01,083756,Staff,0,6,30,30
1650077716212,MATH 20B,A02,083757,Staff,0,1,30,30
1650077722245,MATH 20C,A01,083760,Staff,0,11,30,30
1650077722245,MATH 20C,A02,083761,Staff,0,12,30,30
1650077722245,MATH 20C,B01,083762,Staff,14,0,30,16
1650077722245,MATH 20C,B02,083763,Staff,28,0,30,2
1650077728266,MATH 20D,A01,083765,Staff,0,2,30,30
1650077728266,MATH 20D,A02,083766,Staff,14,0,30,16
1650077728266,MATH 20D,A03,083767,Staff,28,0,30,2
1650077734300,MATH 20E,A01,083771,Staff,10,0,30,20
1650077734300,MATH 20E,A02,083772,Staff,20,0,30,10
1650077734300,MATH 20E,B01,083773,Staff,2,2,30,28
1650077734300,MATH 20E,B02,083774,Staff,16,0,30,14
1650077740323,MATH 103A,A01,083777,Staff,0,8,30,30
1650077740323,MATH 103A,A02,083778,Staff,0,7,30,30
1650077740323,MATH 103A,B01,083779,Staff,0,8,30,30
1650077740323,MATH 103A,B02,083780,Staff,1,7,30,29
1650077746353,MATH 105,A01,085443,Staff,1,13,30,29
1650077752379,MATH 109,A01,083213,Anzaldo; Leesa B,1,4,30,29
1650077752379,MATH 109,A02,083214,Anzaldo; Leesa B,0,5,30,30
1650077752379,MATH 109,B01,083215,Anzaldo; Leesa B,0,4,30,30
1650077752379,MATH 109,B02,083216,Anzaldo; Leesa B,1,3,30,29
1650077758402,MATH 142A,A01,083219,Chow; Bennett,0,10,30,30
1650077758402,MATH 142A,A02,083220,Chow; Bennett,0,10,30,30
1650077758402,MATH 142A,B01,083221,Chow; Bennett,0,10,30,30
1650077758402,MATH 142A,B02,083222,Chow; Bennett,0,9,30,30
1650077764426,MATH 193A,A01,083224,Staff,0,4,30,30
1650077764426,MATH 193A,A02,083225,Staff,0,4,30,30
1650077764426,MATH 193A,A03,083781,Staff,0,0,30,30
1650077764426,MATH 193A,A04,083782,Staff,4,0,30,26
1650077770454,MATH 197,001,091859,McAuley; Julian John,9998,0,9999,1
1650077776505,COGS 9,A01,083615,Staff,3,17,60,57
1650077782527,COGS 11,A01,083617,Boyle; Mary E. T.,24,0,40,16
1650077788551,COGS 13,A01,083071,Staff,0,29,40,40
1650077794582,COGS 14A,A01,092681,Staff,1,11,100,99
1650077800606,COGS 14B,A01,083073,Cheng; Tzu-Han,0,4,50,50
1650077806632,COGS 17,A01,092677,Staff,35,0,75,40
1650077812667,COGS 100,A01,083619,Staff,0,20,60,60
1650077818695,COGS 101A,A01,083621,Davis; Joshua Daniel,0,17,60,60
1650077824725,COGS 101B,A01,091572,Staff,10,0,60,50
1650077830749,COGS 101C,A01,083625,Delgado; Tania,21,0,30,9
1650077836777,COGS 107A,A01,083627,Boyle; Mary E. T.,1,4,60,59
1650077842809,COGS 118A,A01,083075,Staff,17,0,60,43
1650077848849,CSE 3,A50,083646,Miranda; Gregory Joseph,22,0,38,16
1650077848849,CSE 3,A51,083647,Miranda; Gregory Joseph,37,0,37,0
1650077854876,CSE 8A,A50,083650,Miranda; Gregory Joseph,0,15,40,40
1650077860900,CSE 11,A01,083080,Cao; Yingjun,0,66,40,40
1650077866922,CSE 12,A01,083652,Staff,0,2,100,100
1650077872943,CSE 15L,A01,083654,Staff,0,0,50,50
1650077872943,CSE 15L,A02,083655,Staff,10,0,50,40
1650077878966,CSE 20,A01,083657,Staff,58,0,80,22
1650077884991,CSE 30,A01,083084,Eldon; John,0,63,40,40
1650077891015,CSE 100,A01,083659,Cao; Yingjun,0,59,50,50
1650077897042,CSE 134B,A01,083661,Powell; Thomas Allan,1,28,65,64
1650077903068,CSE 140,A01,083663,Staff,4,0,75,71
1650077909100,CSE 140L,A01,083088,Eldon; John,0,1,75,75
1650077915126,CSE 175,A01,083665,Kumar; Rakesh,9,0,25,16
1650077921148,CSE 190,A00,092507,Dubnov; Shlomo,14,0,20,6
1650077927171,ECE 45,A01,083139,Staff,0,13,40,40
1650077933195,ECE 65,A50,083695,Staff,0,3,30,30
1650077939219,ECE 109,A01,091882,Touri; Behrouz,48,0,70,22
1650077945244,ECE 180,A00,083140,Abi Samra; Nicholas Camill,24,0,30,6
1650077945244,ECE 180,B00,083141,Abi Samra; Nicholas Camill,8,0,30,22
1650077951280,MATH 10A,A01,083735,Patchell; Gregory David,12,0,30,18
1650077951280,MATH 10A,A02,083736,Patchell; Gregory David,28,0,30,2
1650077951280,MATH 10A,A03,083737,Patchell; Gregory David,27,0,30,3
1650077957316,MATH 10B,A01,083207,Staff,0,5,30,30
1650077957316,MATH 10B,A02,083208,Staff,0,4,30,30
1650077957316,MATH 10B,B01,083739,Staff,18,0,30,12
1650077957316,MATH 10B,B02,083740,Staff,29,0,30,1
1650077963345,MATH 18,A01,083743,Staff,10,0,30,20
1650077963345,MATH 18,A02,083744,Staff,28,0,30,2
1650077963345,MATH 18,A03,083745,Staff,23,0,30,7
1650077963345,MATH 18,A04,083746,Staff,27,0,30,3
1650077963345,MATH 18,B01,083748,Staff,0,9,30,30
1650077963345,MATH 18,B02,083749,Staff,1,7,30,29
1650077963345,MATH 18,B03,083750,Staff,0,6,30,30
1650077963345,MATH 18,B04,083751,Staff,1,8,30,29
1650077969368,MATH 20A,A01,083754,Staff,26,0,40,14
1650077975395,MATH 20B,A01,083756,Staff,0,6,30,30
1650077975395,MATH 20B,A02,083757,Staff,0,1,30,30
1650077981423,MATH 20C,A01,083760,Staff,0,11,30,30
1650077981423,MATH 20C,A02,083761,Staff,0,12,30,30
1650077981423,MATH 20C,B01,083762,Staff,14,0,30,16
1650077981423,MATH 20C,B02,083763,Staff,28,0,30,2
1650077987451,MATH 20D,A01,083765,Staff,0,2,30,30
1650077987451,MATH 20D,A02,083766,Staff,14,0,30,16
1650077987451,MATH 20D,A03,083767,Staff,28,0,30,2
1650077993483,MATH 20E,A01,083771,Staff,10,0,30,20
1650077993483,MATH 20E,A02,083772,Staff,20,0,30,10
1650077993483,MATH 20E,B01,083773,Staff,2,2,30,28
1650077993483,MATH 20E,B02,083774,Staff,16,0,30,14
1650077999512,MATH 103A,A01,083777,Staff,0,8,30,30
1650077999512,MATH 103A,A02,083778,Staff,0,7,30,30
1650077999512,MATH 103A,B01,083779,Staff,0,8,30,30
1650077999512,MATH 103A,B02,083780,Staff,1,7,30,29
1650078005544,MATH 105,A01,085443,Staff,1,13,30,29
1650078011567,MATH 109,A01,083213,Anzaldo; Leesa B,1,4,30,29
1650078011567,MATH 109,A02,083214,Anzaldo; Leesa B,0,5,30,30
1650078011567,MATH 109,B01,083215,Anzaldo; Leesa B,0,4,30,30
1650078011567,MATH 109,B02,083216,Anzaldo; Leesa B,1,3,30,29
1650078017595,MATH 142A,A01,083219,Chow; Bennett,0,10,30,30
1650078017595,MATH 142A,A02,083220,Chow; Bennett,0,10,30,30
1650078017595,MATH 142A,B01,083221,Chow; Bennett,0,10,30,30
1650078017595,MATH 142A,B02,083222,Chow; Bennett,0,9,30,30
1650078023618,MATH 193A,A01,083224,Staff,0,4,30,30
1650078023618,MATH 193A,A02,083225,Staff,0,4,30,30
1650078023618,MATH 193A,A03,083781,Staff,0,0,30,30
1650078023618,MATH 193A,A04,083782,Staff,4,0,30,26
1650078029643,MATH 197,001,091859,McAuley; Julian John,9998,0,9999,1
1650078035803,COGS 9,A01,083615,Staff,3,17,60,57
1650078041827,COGS 11,A01,083617,Boyle; Mary E. T.,24,0,40,16
1650078047862,COGS 13,A01,083071,Staff,0,29,40,40
1650078053885,COGS 14A,A01,092681,Staff,1,11,100,99
1650078059912,COGS 14B,A01,083073,Cheng; Tzu-Han,0,4,50,50
1650078065943,COGS 17,A01,092677,Staff,35,0,75,40
1650078071970,COGS 100,A01,083619,Staff,0,20,60,60
1650078077996,COGS 101A,A01,083621,Davis; Joshua Daniel,0,17,60,60
1650078084020,COGS 101B,A01,091572,Staff,10,0,60,50
1650078090044,COGS 101C,A01,083625,Delgado; Tania,21,0,30,9
1650078096067,COGS 107A,A01,083627,Boyle; Mary E. T.,1,4,60,59
1650078102094,COGS 118A,A01,083075,Staff,17,0,60,43
1650078108124,CSE 3,A50,083646,Miranda; Gregory Joseph,22,0,38,16
1650078108124,CSE 3,A51,083647,Miranda; Gregory Joseph,37,0,37,0
1650078114157,CSE 8A,A50,083650,Miranda; Gregory Joseph,0,15,40,40
1650078120181,CSE 11,A01,083080,Cao; Yingjun,0,66,40,40
1650078126205,CSE 12,A01,083652,Staff,0,2,100,100
1650078132233,CSE 15L,A01,083654,Staff,0,0,50,50
1650078132233,CSE 15L,A02,083655,Staff,10,0,50,40
1650078138257,CSE 20,A01,083657,Staff,58,0,80,22
1650078144280,CSE 30,A01,083084,Eldon; John,0,63,40,40
1650078150307,CSE 100,A01,083659,Cao; Yingjun,0,59,50,50
1650078156335,CSE 134B,A01,083661,Powell; Thomas Allan,1,28,65,64
1650078162363,CSE 140,A01,083663,Staff,4,0,75,71
1650078168386,CSE 140L,A01,083088,Eldon; John,0,1,75,75
1650078174410,CSE 175,A01,083665,Kumar; Rakesh,9,0,25,16
1650078180444,CSE 190,A00,092507,Dubnov; Shlomo,14,0,20,6
1650078186479,ECE 45,A01,083139,Staff,0,13,40,40
1650078192503,ECE 65,A50,083695,Staff,0,3,30,30
1650078198531,ECE 109,A01,091882,Touri; Behrouz,48,0,70,22
1650078204554,ECE 180,A00,083140,Abi Samra; Nicholas Camill,24,0,30,6
1650078204554,ECE 180,B00,083141,Abi Samra; Nicholas Camill,8,0,30,22
1650078210578,MATH 10A,A01,083735,Patchell; Gregory David,12,0,30,18
1650078210578,MATH 10A,A02,083736,Patchell; Gregory David,28,0,30,2
1650078210578,MATH 10A,A03,083737,Patchell; Gregory David,27,0,30,3
1650078216616,MATH 10B,A01,083207,Staff,0,5,30,30
1650078216616,MATH 10B,A02,083208,Staff,0,4,30,30
1650078216616,MATH 10B,B01,083739,Staff,18,0,30,12
1650078216616,MATH 10B,B02,083740,Staff,29,0,30,1
1650078222647,MATH 18,A01,083743,Staff,10,0,30,20
1650078222647,MATH 18,A02,083744,Staff,28,0,30,2
1650078222647,MATH 18,A03,083745,Staff,23,0,30,7
1650078222647,MATH 18,A04,083746,Staff,27,0,30,3
1650078222647,MATH 18,B01,083748,Staff,0,9,30,30
1650078222647,MATH 18,B02,083749,Staff,1,7,30,29
1650078222647,MATH 18,B03,083750,Staff,0,6,30,30
1650078222647,MATH 18,B04,083751,Staff,1,8,30,29
1650078228670,MATH 20A,A01,083754,Staff,26,0,40,14
1650078234694,MATH 20B,A01,083756,Staff,0,6,30,30
1650078234694,MATH 20B,A02,083757,Staff,0,1,30,30
1650078240721,MATH 20C,A01,083760,Staff,0,11,30,30
1650078240721,MATH 20C,A02,083761,Staff,0,12,30,30
1650078240721,MATH 20C,B01,083762,Staff,14,0,30,16
1650078240721,MATH 20C,B02,083763,Staff,28,0,30,2
1650078246746,MATH 20D,A01,083765,Staff,0,2,30,30
1650078246746,MATH 20D,A02,083766,Staff,14,0,30,16
1650078246746,MATH 20D,A03,083767,Staff,28,0,30,2
1650078252774,MATH 20E,A01,083771,Staff,10,0,30,20
1650078252774,MATH 20E,A02,083772,Staff,20,0,30,10
1650078252774,MATH 20E,B01,083773,Staff,2,2,30,28
1650078252774,MATH 20E,B02,083774,Staff,16,0,30,14
1650078258798,MATH 103A,A01,083777,Staff,0,8,30,30
1650078258798,MATH 103A,A02,083778,Staff,0,7,30,30
1650078258798,MATH 103A,B01,083779,Staff,0,8,30,30
1650078258798,MATH 103A,B02,083780,Staff,1,7,30,29
1650078264824,MATH 105,A01,085443,Staff,1,13,30,29
1650078270853,MATH 109,A01,083213,Anzaldo; Leesa B,1,4,30,29
1650078270853,MATH 109,A02,083214,Anzaldo; Leesa B,0,5,30,30
1650078270853,MATH 109,B01,083215,Anzaldo; Leesa B,0,4,30,30
1650078270853,MATH 109,B02,083216,Anzaldo; Leesa B,1,3,30,29
1650078276876,MATH 142A,A01,083219,Chow; Bennett,0,10,30,30
1650078276876,MATH 142A,A02,083220,Chow; Bennett,0,10,30,30
1650078276876,MATH 142A,B01,083221,Chow; Bennett,0,10,30,30
1650078276876,MATH 142A,B02,083222,Chow; Bennett,0,9,30,30
1650078282904,MATH 193A,A01,083224,Staff,0,4,30,30
1650078282904,MATH 193A,A02,083225,Staff,0,4,30,30
1650078282904,MATH 193A,A03,083781,Staff,0,0,30,30
1650078282904,MATH 193A,A04,083782,Staff,4,0,30,26
1650078288927,MATH 197,001,091859,McAuley; Julian John,9998,0,9999,1
1650078295003,COGS 9,A01,083615,Staff,3,17,60,57
1650078301025,COGS 11,A01,083617,Boyle; Mary E. T.,24,0,40,16
1650078307054,COGS 13,A01,083071,Staff,0,29,40,40
1650078313077,COGS 14A,A01,092681,Staff,1,11,100,99
1650078319105,COGS 14B,A01,083073,Cheng; Tzu-Han,0,4,50,50
1650078325141,COGS 17,A01,092677,Staff,35,0,75,40
1650078331166,COGS 100,A01,083619,Staff,0,20,60,60
1650078337204,COGS 101A,A01,083621,Davis; Joshua Daniel,0,17,60,60
1650078343230,COGS 101B,A01,091572,Staff,10,0,60,50
1650078349255,COGS 101C,A01,083625,Delgado; Tania,21,0,30,9
1650078355278,COGS 107A,A01,083627,Boyle; Mary E. T.,1,4,60,59
1650078361302,COGS 118A,A01,083075,Staff,17,0,60,43
1650078373909,CSE 3,A50,083646,Miranda; Gregory Joseph,22,0,38,16
1650078373909,CSE 3,A51,083647,Miranda; Gregory Joseph,37,0,37,0
1650078379934,CSE 8A,A50,083650,Miranda; Gregory Joseph,0,15,40,40
1650078385963,CSE 11,A01,083080,Cao; Yingjun,0,66,40,40
1650078391986,CSE 12,A01,083652,Staff,0,2,100,100
1650078398011,CSE 15L,A01,083654,Staff,0,0,50,50
1650078398011,CSE 15L,A02,083655,Staff,10,0,50,40
1650078404039,CSE 20,A01,083657,Staff,58,0,80,22
1650078410063,CSE 30,A01,083084,Eldon; John,0,63,40,40
1650078416091,CSE 100,A01,083659,Cao; Yingjun,0,59,50,50
1650078422114,CSE 134B,A01,083661,Powell; Thomas Allan,1,28,65,64
1650078428142,CSE 140,A01,083663,Staff,4,0,75,71
1650078434165,CSE 140L,A01,083088,Eldon; John,0,1,75,75
1650078440187,CSE 175,A01,083665,Kumar; Rakesh,9,0,25,16
1650078446215,CSE 190,A00,092507,Dubnov; Shlomo,14,0,20,6
1650078452237,ECE 45,A01,083139,Staff,0,13,40,40
1650078458259,ECE 65,A50,083695,Staff,0,3,30,30
1650078464280,ECE 109,A01,091882,Touri; Behrouz,48,0,70,22
1650078470302,ECE 180,A00,083140,Abi Samra; Nicholas Camill,24,0,30,6
1650078470302,ECE 180,B00,083141,Abi Samra; Nicholas Camill,8,0,30,22
1650078476326,MATH 10A,A01,083735,Patchell; Gregory David,12,0,30,18
1650078476326,MATH 10A,A02,083736,Patchell; Gregory David,28,0,30,2
1650078476326,MATH 10A,A03,083737,Patchell; Gregory David,27,0,30,3
1650078482360,MATH 10B,A01,083207,Staff,0,5,30,30
1650078482360,MATH 10B,A02,083208,Staff,0,4,30,30
1650078482360,MATH 10B,B01,083739,Staff,18,0,30,12
1650078482360,MATH 10B,B02,083740,Staff,29,0,30,1
1650078488389,MATH 18,A01,083743,Staff,10,0,30,20
1650078488389,MATH 18,A02,083744,Staff,28,0,30,2
1650078488389,MATH 18,A03,083745,Staff,23,0,30,7
1650078488389,MATH 18,A04,083746,Staff,27,0,30,3
1650078488389,MATH 18,B01,083748,Staff,0,9,30,30
1650078488389,MATH 18,B02,083749,Staff,1,7,30,29
1650078488389,MATH 18,B03,083750,Staff,0,6,30,30
1650078488389,MATH 18,B04,083751,Staff,1,8,30,29
1650078494415,MATH 20A,A01,083754,Staff,26,0,40,14
1650078500440,MATH 20B,A01,083756,Staff,0,6,30,30
1650078500440,MATH 20B,A02,083757,Staff,0,1,30,30
1650078506464,MATH 20C,A01,083760,Staff,0,11,30,30
1650078506464,MATH 20C,A02,083761,Staff,0,12,30,30
1650078506464,MATH 20C,B01,083762,Staff,14,0,30,16
1650078506464,MATH 20C,B02,083763,Staff,28,0,30,2
1650078512501,MATH 20D,A01,083765,Staff,0,2,30,30
1650078512501,MATH 20D,A02,083766,Staff,14,0,30,16
1650078512501,MATH 20D,A03,083767,Staff,28,0,30,2
1650078518530,MATH 20E,A01,083771,Staff,10,0,30,20
1650078518530,MATH 20E,A02,083772,Staff,20,0,30,10
1650078518530,MATH 20E,B01,083773,Staff,2,2,30,28
1650078518530,MATH 20E,B02,083774,Staff,16,0,30,14
1650078524560,MATH 103A,A01,083777,Staff,0,8,30,30
1650078524560,MATH 103A,A02,083778,Staff,0,7,30,30
1650078524560,MATH 103A,B01,083779,Staff,0,8,30,30
1650078524560,MATH 103A,B02,083780,Staff,1,7,30,29
1650078530584,MATH 105,A01,085443,Staff,1,13,30,29
1650078536613,MATH 109,A01,083213,Anzaldo; Leesa B,1,4,30,29
1650078536613,MATH 109,A02,083214,Anzaldo; Leesa B,0,5,30,30
1650078536613,MATH 109,B01,083215,Anzaldo; Leesa B,0,4,30,30
1650078536613,MATH 109,B02,083216,Anzaldo; Leesa B,1,3,30,29
1650078542637,MATH 142A,A01,083219,Chow; Bennett,0,10,30,30
1650078542637,MATH 142A,A02,083220,Chow; Bennett,0,10,30,30
1650078542637,MATH 142A,B01,083221,Chow; Bennett,0,10,30,30
1650078542637,MATH 142A,B02,083222,Chow; Bennett,0,9,30,30
1650078548666,MATH 193A,A01,083224,Staff,0,4,30,30
1650078548666,MATH 193A,A02,083225,Staff,0,4,30,30
1650078548666,MATH 193A,A03,083781,Staff,0,0,30,30
1650078548666,MATH 193A,A04,083782,Staff,4,0,30,26
1650078554693,MATH 197,001,091859,McAuley; Julian John,9998,0,9999,1
1650078560747,COGS 9,A01,083615,Staff,3,17,60,57
1650078566773,COGS 11,A01,083617,Boyle; Mary E. T.,24,0,40,16
1650078572797,COGS 13,A01,083071,Staff,0,29,40,40
1650078578824,COGS 14A,A01,092681,Staff,1,11,100,99
1650078584854,COGS 14B,A01,083073,Cheng; Tzu-Han,0,4,50,50
1650078590879,COGS 17,A01,092677,Staff,35,0,75,40
1650078596918,COGS 100,A01,083619,Staff,0,20,60,60
1650078602942,COGS 101A,A01,083621,Davis; Joshua Daniel,0,17,60,60
1650078608966,COGS 101B,A01,091572,Staff,10,0,60,50
1650078614996,COGS 101C,A01,083625,Delgado; Tania,21,0,30,9
1650078621021,COGS 107A,A01,083627,Boyle; Mary E. T.,1,4,60,59
1650078627048,COGS 118A,A01,083075,Staff,17,0,60,43
1650078633164,CSE 3,A50,083646,Miranda; Gregory Joseph,22,0,38,16
1650078633164,CSE 3,A51,083647,Miranda; Gregory Joseph,37,0,37,0
1650078639195,CSE 8A,A50,083650,Miranda; Gregory Joseph,0,15,40,40
1650078645219,CSE 11,A01,083080,Cao; Yingjun,0,66,40,40
1650078651243,CSE 12,A01,083652,Staff,0,2,100,100
1650078657268,CSE 15L,A01,083654,Staff,0,0,50,50
1650078657268,CSE 15L,A02,083655,Staff,10,0,50,40
1650078663292,CSE 20,A01,083657,Staff,58,0,80,22
1650078669315,CSE 30,A01,083084,Eldon; John,0,63,40,40
1650078675339,CSE 100,A01,083659,Cao; Yingjun,0,59,50,50
1650078681364,CSE 134B,A01,083661,Powell; Thomas Allan,1,28,65,64
1650078687393,CSE 140,A01,083663,Staff,4,0,75,71
1650078693416,CSE 140L,A01,083088,Eldon; John,0,1,75,75
1650078699441,CSE 175,A01,083665,Kumar; Rakesh,9,0,25,16
1650078705463,CSE 190,A00,092507,Dubnov; Shlomo,14,0,20,6
1650078711489,ECE 45,A01,083139,Staff,0,13,40,40
1650078717512,ECE 65,A50,083695,Staff,0,3,30,30
1650078723536,ECE 109,A01,091882,Touri; Behrouz,48,0,70,22
1650078729560,ECE 180,A00,083140,Abi Samra; Nicholas Camill,24,0,30,6
1650078729560,ECE 180,B00,083141,Abi Samra; Nicholas Camill,8,0,30,22
1650078735594,MATH 10A,A01,083735,Patchell; Gregory David,12,0,30,18
1650078735594,MATH 10A,A02,083736,Patchell; Gregory David,28,0,30,2
1650078735594,MATH 10A,A03,083737,Patchell; Gregory David,27,0,30,3
1650078741634,MATH 10B,A01,083207,Staff,0,5,30,30
1650078741634,MATH 10B,A02,083208,Staff,0,4,30,30
1650078741634,MATH 10B,B01,083739,Staff,18,0,30,12
1650078741634,MATH 10B,B02,083740,Staff,29,0,30,1
1650078747658,MATH 18,A01,083743,Staff,10,0,30,20
1650078747658,MATH 18,A02,083744,Staff,28,0,30,2
1650078747658,MATH 18,A03,083745,Staff,23,0,30,7
1650078747658,MATH 18,A04,083746,Staff,27,0,30,3
1650078747658,MATH 18,B01,083748,Staff,0,9,30,30
1650078747658,MATH 18,B02,083749,Staff,1,7,30,29
1650078747658,MATH 18,B03,083750,Staff,0,6,30,30
1650078747658,MATH 18,B04,083751,Staff,1,8,30,29
1650078753692,MATH 20A,A01,083754,Staff,26,0,40,14
1650078759718,MATH 20B,A01,083756,Staff,0,6,30,30
1650078759718,MATH 20B,A02,083757,Staff,0,1,30,30
1650078765754,MATH 20C,A01,083760,Staff,0,11,30,30
1650078765754,MATH 20C,A02,083761,Staff,0,12,30,30
1650078765754,MATH 20C,B01,083762,Staff,14,0,30,16
1650078765754,MATH 20C,B02,083763,Staff,28,0,30,2
1650078771787,MATH 20D,A01,083765,Staff,0,2,30,30
1650078771787,MATH 20D,A02,083766,Staff,14,0,30,16
1650078771787,MATH 20D,A03,083767,Staff,28,0,30,2
1650078777810,MATH 20E,A01,083771,Staff,10,0,30,20
1650078777810,MATH 20E,A02,083772,Staff,20,0,30,10
1650078777810,MATH 20E,B01,083773,Staff,2,2,30,28
1650078777810,MATH 20E,B02,083774,Staff,16,0,30,14
1650078783834,MATH 103A,A01,083777,Staff,0,8,30,30
1650078783834,MATH 103A,A02,083778,Staff,0,7,30,30
1650078783834,MATH 103A,B01,083779,Staff,0,8,30,30
1650078783834,MATH 103A,B02,083780,Staff,1,7,30,29
1650078789857,MATH 105,A01,085443,Staff,1,13,30,29
1650078795888,MATH 109,A01,083213,Anzaldo; Leesa B,1,4,30,29
1650078795888,MATH 109,A02,083214,Anzaldo; Leesa B,0,5,30,30
1650078795888,MATH 109,B01,083215,Anzaldo; Leesa B,0,4,30,30
1650078795888,MATH 109,B02,083216,Anzaldo; Leesa B,1,3,30,29
1650078801923,MATH 142A,A01,083219,Chow; Bennett,0,10,30,30
1650078801923,MATH 142A,A02,083220,Chow; Bennett,0,10,30,30
1650078801923,MATH 142A,B01,083221,Chow; Bennett,0,10,30,30
1650078801923,MATH 142A,B02,083222,Chow; Bennett,0,9,30,30
1650078807947,MATH 193A,A01,083224,Staff,0,4,30,30
1650078807947,MATH 193A,A02,083225,Staff,0,4,30,30
1650078807947,MATH 193A,A03,083781,Staff,0,0,30,30
1650078807947,MATH 193A,A04,083782,Staff,4,0,30,26
1650078813974,MATH 197,001,091859,McAuley; Julian John,9998,0,9999,1
1650078820036,COGS 9,A01,083615,Staff,3,17,60,57
1650078826063,COGS 11,A01,083617,Boyle; Mary E. T.,24,0,40,16
1650078832088,COGS 13,A01,083071,Staff,0,29,40,40
1650078838115,COGS 14A,A01,092681,Staff,1,11,100,99
1650078844153,COGS 14B,A01,083073,Cheng; Tzu-Han,0,4,50,50
1650078850179,COGS 17,A01,092677,Staff,35,0,75,40
1650078856207,COGS 100,A01,083619,Staff,0,20,60,60
1650078862230,COGS 101A,A01,083621,Davis; Joshua Daniel,0,17,60,60
1650078868257,COGS 101B,A01,091572,Staff,10,0,60,50
1650078874290,COGS 101C,A01,083625,Delgado; Tania,21,0,30,9
1650078880313,COGS 107A,A01,083627,Boyle; Mary E. T.,1,4,60,59
1650078886341,COGS 118A,A01,083075,Staff,17,0,60,43
1650078892370,CSE 3,A50,083646,Miranda; Gregory Joseph,22,0,38,16
1650078892370,CSE 3,A51,083647,Miranda; Gregory Joseph,37,0,37,0
1650078898394,CSE 8A,A50,083650,Miranda; Gregory Joseph,0,15,40,40
1650078904417,CSE 11,A01,083080,Cao; Yingjun,0,66,40,40
1650078910442,CSE 12,A01,083652,Staff,0,2,100,100
1650078916468,CSE 15L,A01,083654,Staff,0,0,50,50
1650078916468,CSE 15L,A02,083655,Staff,10,0,50,40
1650078922492,CSE 20,A01,083657,Staff,58,0,80,22
1650078928533,CSE 30,A01,083084,Eldon; John,0,63,40,40
1650078934557,CSE 100,A01,083659,Cao; Yingjun,0,59,50,50
1650078940580,CSE 134B,A01,083661,Powell; Thomas Allan,1,28,65,64
1650078946603,CSE 140,A01,083663,Staff,4,0,75,71
1650078952627,CSE 140L,A01,083088,Eldon; John,0,1,75,75
1650078958649,CSE 175,A01,083665,Kumar; Rakesh,9,0,25,16
1650078964677,CSE 190,A00,092507,Dubnov; Shlomo,14,0,20,6
1650078970701,ECE 45,A01,083139,Staff,0,13,40,40
1650078976726,ECE 65,A50,083695,Staff,0,3,30,30
1650078982755,ECE 109,A01,091882,Touri; Behrouz,48,0,70,22
1650078988788,ECE 180,A00,083140,Abi Samra; Nicholas Camill,24,0,30,6
1650078988788,ECE 180,B00,083141,Abi Samra; Nicholas Camill,8,0,30,22
1650078994812,MATH 10A,A01,083735,Patchell; Gregory David,12,0,30,18
1650078994812,MATH 10A,A02,083736,Patchell; Gregory David,28,0,30,2
1650078994812,MATH 10A,A03,083737,Patchell; Gregory David,27,0,30,3
1650079000837,MATH 10B,A01,083207,Staff,0,5,30,30
1650079000837,MATH 10B,A02,083208,Staff,0,4,30,30
1650079000837,MATH 10B,B01,083739,Staff,18,0,30,12
1650079000837,MATH 10B,B02,083740,Staff,29,0,30,1
1650079006862,MATH 18,A01,083743,Staff,10,0,30,20
1650079006862,MATH 18,A02,083744,Staff,28,0,30,2
1650079006862,MATH 18,A03,083745,Staff,23,0,30,7
1650079006862,MATH 18,A04,083746,Staff,27,0,30,3
1650079006862,MATH 18,B01,083748,Staff,0,9,30,30
1650079006862,MATH 18,B02,083749,Staff,1,7,30,29
1650079006862,MATH 18,B03,083750,Staff,0,6,30,30
1650079006862,MATH 18,B04,083751,Staff,1,8,30,29
1650079012886,MATH 20A,A01,083754,Staff,26,0,40,14
1650079018917,MATH 20B,A01,083756,Staff,0,6,30,30
1650079018917,MATH 20B,A02,083757,Staff,0,1,30,30
1650079024945,MATH 20C,A01,083760,Staff,0,11,30,30
1650079024945,MATH 20C,A02,083761,Staff,0,12,30,30
1650079024945,MATH 20C,B01,083762,Staff,14,0,30,16
1650079024945,MATH 20C,B02,083763,Staff,28,0,30,2
1650079030982,MATH 20D,A01,083765,Staff,0,2,30,30
1650079030982,MATH 20D,A02,083766,Staff,14,0,30,16
1650079030982,MATH 20D,A03,083767,Staff,28,0,30,2
1650079037017,MATH 20E,A01,083771,Staff,10,0,30,20
1650079037017,MATH 20E,A02,083772,Staff,20,0,30,10
1650079037017,MATH 20E,B01,083773,Staff,2,2,30,28
1650079037017,MATH 20E,B02,083774,Staff,16,0,30,14
1650079043041,MATH 103A,A01,083777,Staff,0,8,30,30
1650079043041,MATH 103A,A02,083778,Staff,0,7,30,30
1650079043041,MATH 103A,B01,083779,Staff,0,8,30,30
1650079043041,MATH 103A,B02,083780,Staff,1,7,30,29
1650079049075,MATH 105,A01,085443,Staff,1,13,30,29
1650079055102,MATH 109,A01,083213,Anzaldo; Leesa B,1,4,30,29
1650079055102,MATH 109,A02,083214,Anzaldo; Leesa B,0,5,30,30
1650079055102,MATH 109,B01,083215,Anzaldo; Leesa B,0,4,30,30
1650079055102,MATH 109,B02,083216,Anzaldo; Leesa B,1,4,30,29
1650079061126,MATH 142A,A01,083219,Chow; Bennett,0,10,30,30
1650079061126,MATH 142A,A02,083220,Chow; Bennett,0,10,30,30
1650079061126,MATH 142A,B01,083221,Chow; Bennett,0,10,30,30
1650079061126,MATH 142A,B02,083222,Chow; Bennett,0,9,30,30
1650079067150,MATH 193A,A01,083224,Staff,0,4,30,30
1650079067150,MATH 193A,A02,083225,Staff,0,4,30,30
1650079067150,MATH 193A,A03,083781,Staff,0,0,30,30
1650079067150,MATH 193A,A04,083782,Staff,4,0,30,26
1650079073177,MATH 197,001,091859,McAuley; Julian John,9998,0,9999,1
1650079079233,COGS 9,A01,083615,Staff,3,17,60,57
1650079085256,COGS 11,A01,083617,Boyle; Mary E. T.,24,0,40,16
1650079091279,COGS 13,A01,083071,Staff,0,29,40,40
1650079097302,COGS 14A,A01,092681,Staff,1,11,100,99
1650079103328,COGS 14B,A01,083073,Cheng; Tzu-Han,0,4,50,50
1650079109360,COGS 17,A01,092677,Staff,35,0,75,40
1650079115383,COGS 100,A01,083619,Staff,0,20,60,60
1650079121412,COGS 101A,A01,083621,Davis; Joshua Daniel,0,17,60,60
1650079127435,COGS 101B,A01,091572,Staff,10,0,60,50
1650079133468,COGS 101C,A01,083625,Delgado; Tania,21,0,30,9
1650079139491,COGS 107A,A01,083627,Boyle; Mary E. T.,1,4,60,59
1650079145513,COGS 118A,A01,083075,Staff,17,0,60,43
1650079151545,CSE 3,A50,083646,Miranda; Gregory Joseph,22,0,38,16
1650079151545,CSE 3,A51,083647,Miranda; Gregory Joseph,37,0,37,0
1650079157569,CSE 8A,A50,083650,Miranda; Gregory Joseph,0,15,40,40
1650079163593,CSE 11,A01,083080,Cao; Yingjun,0,66,40,40
1650079169620,CSE 12,A01,083652,Staff,0,2,100,100
1650079175644,CSE 15L,A01,083654,Staff,0,0,50,50
1650079175644,CSE 15L,A02,083655,Staff,10,0,50,40
1650079181673,CSE 20,A01,083657,Staff,58,0,80,22
1650079187696,CSE 30,A01,083084,Eldon; John,0,63,40,40
1650079193718,CSE 100,A01,083659,Cao; Yingjun,0,60,50,50
1650079199744,CSE 134B,A01,083661,Powell; Thomas Allan,1,28,65,64
1650079205768,CSE 140,A01,083663,Staff,4,0,75,71
1650079211792,CSE 140L,A01,083088,Eldon; John,0,1,75,75
1650079217831,CSE 175,A01,083665,Kumar; Rakesh,9,0,25,16
1650079223863,CSE 190,A00,092507,Dubnov; Shlomo,14,0,20,6
1650079229978,ECE 45,A01,083139,Staff,0,13,40,40
1650079236002,ECE 65,A50,083695,Staff,0,3,30,30
1650079242025,ECE 109,A01,091882,Touri; Behrouz,48,0,70,22
1650079248054,ECE 180,A00,083140,Abi Samra; Nicholas Camill,24,0,30,6
1650079248054,ECE 180,B00,083141,Abi Samra; Nicholas Camill,8,0,30,22
1650079254090,MATH 10A,A01,083735,Patchell; Gregory David,12,0,30,18
1650079254090,MATH 10A,A02,083736,Patchell; Gregory David,28,0,30,2
1650079254090,MATH 10A,A03,083737,Patchell; Gregory David,27,0,30,3
1650079260115,MATH 10B,A01,083207,Staff,0,5,30,30
1650079260115,MATH 10B,A02,083208,Staff,0,4,30,30
1650079260115,MATH 10B,B01,083739,Staff,18,0,30,12
1650079260115,MATH 10B,B02,083740,Staff,29,0,30,1
1650079266140,MATH 18,A01,083743,Staff,10,0,30,20
1650079266140,MATH 18,A02,083744,Staff,28,0,30,2
1650079266140,MATH 18,A03,083745,Staff,23,0,30,7
1650079266140,MATH 18,A04,083746,Staff,27,0,30,3
1650079266140,MATH 18,B01,083748,Staff,0,9,30,30
1650079266140,MATH 18,B02,083749,Staff,1,7,30,29
1650079266140,MATH 18,B03,083750,Staff,0,6,30,30
1650079266140,MATH 18,B04,083751,Staff,1,8,30,29
1650079272164,MATH 20A,A01,083754,Staff,26,0,40,14
1650079278192,MATH 20B,A01,083756,Staff,0,6,30,30
1650079278192,MATH 20B,A02,083757,Staff,0,1,30,30
1650079284215,MATH 20C,A01,083760,Staff,0,11,30,30
1650079284215,MATH 20C,A02,083761,Staff,0,12,30,30
1650079284215,MATH 20C,B01,083762,Staff,14,0,30,16
1650079284215,MATH 20C,B02,083763,Staff,28,0,30,2
1650079290239,MATH 20D,A01,083765,Staff,0,2,30,30
1650079290239,MATH 20D,A02,083766,Staff,14,0,30,16
1650079290239,MATH 20D,A03,083767,Staff,28,0,30,2
1650079296264,MATH 20E,A01,083771,Staff,10,0,30,20
1650079296264,MATH 20E,A02,083772,Staff,20,0,30,10
1650079296264,MATH 20E,B01,083773,Staff,2,2,30,28
1650079296264,MATH 20E,B02,083774,Staff,16,0,30,14
1650079302289,MATH 103A,A01,083777,Staff,0,8,30,30
1650079302289,MATH 103A,A02,083778,Staff,0,7,30,30
1650079302289,MATH 103A,B01,083779,Staff,0,8,30,30
1650079302289,MATH 103A,B02,083780,Staff,1,7,30,29
1650079308319,MATH 105,A01,085443,Staff,1,13,30,29
1650079314355,MATH 109,A01,083213,Anzaldo; Leesa B,1,4,30,29
1650079314355,MATH 109,A02,083214,Anzaldo; Leesa B,0,5,30,30
1650079314355,MATH 109,B01,083215,Anzaldo; Leesa B,0,4,30,30
1650079314355,MATH 109,B02,083216,Anzaldo; Leesa B,1,4,30,29
1650079320381,MATH 142A,A01,083219,Chow; Bennett,0,10,30,30
1650079320381,MATH 142A,A02,083220,Chow; Bennett,0,10,30,30
1650079320381,MATH 142A,B01,083221,Chow; Bennett,0,10,30,30
1650079320381,MATH 142A,B02,083222,Chow; Bennett,0,9,30,30
1650079326405,MATH 193A,A01,083224,Staff,0,4,30,30
1650079326405,MATH 193A,A02,083225,Staff,0,4,30,30
1650079326405,MATH 193A,A03,083781,Staff,0,0,30,30
1650079326405,MATH 193A,A04,083782,Staff,4,0,30,26
1650079332431,MATH 197,001,091859,McAuley; Julian John,9998,0,9999,1
1650079338482,COGS 9,A01,083615,Staff,3,17,60,57
1650079344504,COGS 11,A01,083617,Boyle; Mary E. T.,24,0,40,16
1650079350535,COGS 13,A01,083071,Staff,0,29,40,40
1650079356563,COGS 14A,A01,092681,Staff,1,11,100,99
1650079362591,COGS 14B,A01,083073,Cheng; Tzu-Han,0,4,50,50
1650079368619,COGS 17,A01,092677,Staff,35,0,75,40
1650079374643,COGS 100,A01,083619,Staff,0,20,60,60
1650079380671,COGS 101A,A01,083621,Davis; Joshua Daniel,0,17,60,60
1650079386698,COGS 101B,A01,091572,Staff,10,0,60,50
1650079392725,COGS 101C,A01,083625,Delgado; Tania,21,0,30,9
1650079398754,COGS 107A,A01,083627,Boyle; Mary E. T.,1,4,60,59
1650079404778,COGS 118A,A01,083075,Staff,17,0,60,43
1650079410803,CSE 3,A50,083646,Miranda; Gregory Joseph,22,0,38,16
1650079410803,CSE 3,A51,083647,Miranda; Gregory Joseph,37,0,37,0
1650079416827,CSE 8A,A50,083650,Miranda; Gregory Joseph,0,15,40,40
1650079422859,CSE 11,A01,083080,Cao; Yingjun,0,66,40,40
1650079428883,CSE 12,A01,083652,Staff,0,2,100,100
1650079434907,CSE 15L,A01,083654,Staff,0,0,50,50
1650079434907,CSE 15L,A02,083655,Staff,10,0,50,40
1650079440945,CSE 20,A01,083657,Staff,58,0,80,22
1650079446978,CSE 30,A01,083084,Eldon; John,0,63,40,40
1650079453002,CSE 100,A01,083659,Cao; Yingjun,0,60,50,50
1650079459026,CSE 134B,A01,083661,Powell; Thomas Allan,1,28,65,64
1650079465049,CSE 140,A01,083663,Staff,4,0,75,71
1650079471072,CSE 140L,A01,083088,Eldon; John,0,1,75,75
1650079477096,CSE 175,A01,083665,Kumar; Rakesh,9,0,25,16
1650079483123,CSE 190,A00,092507,Dubnov; Shlomo,14,0,20,6
1650079489150,ECE 45,A01,083139,Staff,0,13,40,40
1650079495176,ECE 65,A50,083695,Staff,0,3,30,30
1650079501201,ECE 109,A01,091882,Touri; Behrouz,48,0,70,22
1650079507228,ECE 180,A00,083140,Abi Samra; Nicholas Camill,24,0,30,6
1650079507228,ECE 180,B00,083141,Abi Samra; Nicholas Camill,8,0,30,22
1650079513257,MATH 10A,A01,083735,Patchell; Gregory David,12,0,30,18
1650079513257,MATH 10A,A02,083736,Patchell; Gregory David,28,0,30,2
1650079513257,MATH 10A,A03,083737,Patchell; Gregory David,27,0,30,3
1650079519283,MATH 10B,A01,083207,Staff,0,5,30,30
1650079519283,MATH 10B,A02,083208,Staff,0,4,30,30
1650079519283,MATH 10B,B01,083739,Staff,18,0,30,12
1650079519283,MATH 10B,B02,083740,Staff,29,0,30,1
1650079525308,MATH 18,A01,083743,Staff,10,0,30,20
1650079525308,MATH 18,A02,083744,Staff,28,0,30,2
1650079525308,MATH 18,A03,083745,Staff,23,0,30,7
1650079525308,MATH 18,A04,083746,Staff,27,0,30,3
1650079525308,MATH 18,B01,083748,Staff,0,9,30,30
1650079525308,MATH 18,B02,083749,Staff,1,7,30,29
1650079525308,MATH 18,B03,083750,Staff,0,6,30,30
1650079525308,MATH 18,B04,083751,Staff,1,8,30,29
1650079531330,MATH 20A,A01,083754,Staff,26,0,40,14
1650079537357,MATH 20B,A01,083756,Staff,0,6,30,30
1650079537357,MATH 20B,A02,083757,Staff,0,1,30,30
1650079543381,MATH 20C,A01,083760,Staff,0,11,30,30
1650079543381,MATH 20C,A02,083761,Staff,0,12,30,30
1650079543381,MATH 20C,B01,083762,Staff,14,0,30,16
1650079543381,MATH 20C,B02,083763,Staff,28,0,30,2
1650079549405,MATH 20D,A01,083765,Staff,0,2,30,30
1650079549405,MATH 20D,A02,083766,Staff,14,0,30,16
1650079549405,MATH 20D,A03,083767,Staff,28,0,30,2
1650079555432,MATH 20E,A01,083771,Staff,10,0,30,20
1650079555432,MATH 20E,A02,083772,Staff,20,0,30,10
1650079555432,MATH 20E,B01,083773,Staff,2,2,30,28
1650079555432,MATH 20E,B02,083774,Staff,16,0,30,14
1650079561459,MATH 103A,A01,083777,Staff,0,8,30,30
1650079561459,MATH 103A,A02,083778,Staff,0,7,30,30
1650079561459,MATH 103A,B01,083779,Staff,0,8,30,30
1650079561459,MATH 103A,B02,083780,Staff,1,7,30,29
1650079567484,MATH 105,A01,085443,Staff,1,13,30,29
1650079573512,MATH 109,A01,083213,Anzaldo; Leesa B,1,4,30,29
1650079573512,MATH 109,A02,083214,Anzaldo; Leesa B,0,5,30,30
1650079573512,MATH 109,B01,083215,Anzaldo; Leesa B,0,4,30,30
1650079573512,MATH 109,B02,083216,Anzaldo; Leesa B,1,4,30,29
1650079579536,MATH 142A,A01,083219,Chow; Bennett,0,10,30,30
1650079579536,MATH 142A,A02,083220,Chow; Bennett,0,10,30,30
1650079579536,MATH 142A,B01,083221,Chow; Bennett,0,10,30,30
1650079579536,MATH 142A,B02,083222,Chow; Bennett,0,9,30,30
1650079585563,MATH 193A,A01,083224,Staff,0,4,30,30
1650079585563,MATH 193A,A02,083225,Staff,0,4,30,30
1650079585563,MATH 193A,A03,083781,Staff,0,0,30,30
1650079585563,MATH 193A,A04,083782,Staff,4,0,30,26
1650079591588,MATH 197,001,091859,McAuley; Julian John,9998,0,9999,1
1650079597649,COGS 9,A01,083615,Staff,3,17,60,57
1650079603672,COGS 11,A01,083617,Boyle; Mary E. T.,24,0,40,16
1650079609698,COGS 13,A01,083071,Staff,0,29,40,40
1650079615724,COGS 14A,A01,092681,Staff,1,11,100,99
1650079621749,COGS 14B,A01,083073,Cheng; Tzu-Han,0,4,50,50
1650079627776,COGS 17,A01,092677,Staff,35,0,75,40
1650079633799,COGS 100,A01,083619,Staff,0,20,60,60
1650079639823,COGS 101A,A01,083621,Davis; Joshua Daniel,0,17,60,60
1650079645850,COGS 101B,A01,091572,Staff,10,0,60,50
1650079651875,COGS 101C,A01,083625,Delgado; Tania,21,0,30,9
1650079657899,COGS 107A,A01,083627,Boyle; Mary E. T.,1,4,60,59
1650079663923,COGS 118A,A01,083075,Staff,17,0,60,43
1650079669950,CSE 3,A50,083646,Miranda; Gregory Joseph,22,0,38,16
1650079669950,CSE 3,A51,083647,Miranda; Gregory Joseph,37,0,37,0
1650079675979,CSE 8A,A50,083650,Miranda; Gregory Joseph,0,15,40,40
1650079682007,CSE 11,A01,083080,Cao; Yingjun,0,66,40,40
1650079688033,CSE 12,A01,083652,Staff,0,2,100,100
1650079694057,CSE 15L,A01,083654,Staff,0,0,50,50
1650079694057,CSE 15L,A02,083655,Staff,10,0,50,40
1650079700079,CSE 20,A01,083657,Staff,58,0,80,22
1650079706105,CSE 30,A01,083084,Eldon; John,0,63,40,40
1650079712129,CSE 100,A01,083659,Cao; Yingjun,0,60,50,50
1650079718154,CSE 134B,A01,083661,Powell; Thomas Allan,1,28,65,64
1650079724177,CSE 140,A01,083663,Staff,4,0,75,71
1650079730200,CSE 140L,A01,083088,Eldon; John,0,1,75,75
1650079736226,CSE 175,A01,083665,Kumar; Rakesh,9,0,25,16
1650079742251,CSE 190,A00,092507,Dubnov; Shlomo,14,0,20,6
1650079748278,ECE 45,A01,083139,Staff,0,13,40,40
1650079754308,ECE 65,A50,083695,Staff,0,3,30,30
1650079760333,ECE 109,A01,091882,Touri; Behrouz,48,0,70,22
1650079766355,ECE 180,A00,083140,Abi Samra; Nicholas Camill,24,0,30,6
1650079766355,ECE 180,B00,083141,Abi Samra; Nicholas Camill,8,0,30,22
1650079772381,MATH 10A,A01,083735,Patchell; Gregory David,12,0,30,18
1650079772381,MATH 10A,A02,083736,Patchell; Gregory David,28,0,30,2
1650079772381,MATH 10A,A03,083737,Patchell; Gregory David,27,0,30,3
1650079778404,MATH 10B,A01,083207,Staff,0,5,30,30
1650079778404,MATH 10B,A02,083208,Staff,0,4,30,30
1650079778404,MATH 10B,B01,083739,Staff,18,0,30,12
1650079778404,MATH 10B,B02,083740,Staff,29,0,30,1
1650079784431,MATH 18,A01,083743,Staff,10,0,30,20
1650079784431,MATH 18,A02,083744,Staff,28,0,30,2
1650079784431,MATH 18,A03,083745,Staff,23,0,30,7
1650079784431,MATH 18,A04,083746,Staff,27,0,30,3
1650079784431,MATH 18,B01,083748,Staff,0,9,30,30
1650079784431,MATH 18,B02,083749,Staff,1,7,30,29
1650079784431,MATH 18,B03,083750,Staff,0,6,30,30
1650079784431,MATH 18,B04,083751,Staff,1,8,30,29
1650079790457,MATH 20A,A01,083754,Staff,26,0,40,14
1650079796480,MATH 20B,A01,083756,Staff,0,6,30,30
1650079796480,MATH 20B,A02,083757,Staff,0,1,30,30
1650079802514,MATH 20C,A01,083760,Staff,0,11,30,30
1650079802514,MATH 20C,A02,083761,Staff,0,12,30,30
1650079802514,MATH 20C,B01,083762,Staff,14,0,30,16
1650079802514,MATH 20C,B02,083763,Staff,28,0,30,2
1650079808541,MATH 20D,A01,083765,Staff,0,2,30,30
1650079808541,MATH 20D,A02,083766,Staff,14,0,30,16
1650079808541,MATH 20D,A03,083767,Staff,28,0,30,2
1650079814575,MATH 20E,A01,083771,Staff,10,0,30,20
1650079814575,MATH 20E,A02,083772,Staff,20,0,30,10
1650079814575,MATH 20E,B01,083773,Staff,2,2,30,28
1650079814575,MATH 20E,B02,083774,Staff,16,0,30,14
1650079820601,MATH 103A,A01,083777,Staff,0,8,30,30
1650079820601,MATH 103A,A02,083778,Staff,0,7,30,30
1650079820601,MATH 103A,B01,083779,Staff,0,8,30,30
1650079820601,MATH 103A,B02,083780,Staff,1,7,30,29
1650079826732,MATH 105,A01,085443,Staff,1,13,30,29
1650079832757,MATH 109,A01,083213,Anzaldo; Leesa B,1,4,30,29
1650079832757,MATH 109,A02,083214,Anzaldo; Leesa B,0,5,30,30
1650079832757,MATH 109,B01,083215,Anzaldo; Leesa B,0,4,30,30
1650079832757,MATH 109,B02,083216,Anzaldo; Leesa B,1,4,30,29
1650079838787,MATH 142A,A01,083219,Chow; Bennett,0,10,30,30
1650079838787,MATH 142A,A02,083220,Chow; Bennett,0,10,30,30
1650079838787,MATH 142A,B01,083221,Chow; Bennett,0,10,30,30
1650079838787,MATH 142A,B02,083222,Chow; Bennett,0,9,30,30
1650079844825,MATH 193A,A01,083224,Staff,0,4,30,30
1650079844825,MATH 193A,A02,083225,Staff,0,4,30,30
1650079844825,MATH 193A,A03,083781,Staff,0,0,30,30
1650079844825,MATH 193A,A04,083782,Staff,4,0,30,26
1650079850869,MATH 197,001,091859,McAuley; Julian John,9998,0,9999,1
1650079856922,COGS 9,A01,083615,Staff,3,17,60,57
1650079862946,COGS 11,A01,083617,Boyle; Mary E. T.,24,0,40,16
1650079868970,COGS 13,A01,083071,Staff,0,29,40,40
1650079874998,COGS 14A,A01,092681,Staff,1,11,100,99
1650079881021,COGS 14B,A01,083073,Cheng; Tzu-Han,0,4,50,50
1650079887045,COGS 17,A01,092677,Staff,35,0,75,40
1650079893069,COGS 100,A01,083619,Staff,0,20,60,60
1650079899094,COGS 101A,A01,083621,Davis; Joshua Daniel,0,17,60,60
1650079905125,COGS 101B,A01,091572,Staff,10,0,60,50
1650079911152,COGS 101C,A01,083625,Delgado; Tania,21,0,30,9
1650079917176,COGS 107A,A01,083627,Boyle; Mary E. T.,1,4,60,59
1650079923198,COGS 118A,A01,083075,Staff,17,0,60,43
1650079929223,CSE 3,A50,083646,Miranda; Gregory Joseph,22,0,38,16
1650079929223,CSE 3,A51,083647,Miranda; Gregory Joseph,37,0,37,0
1650079935246,CSE 8A,A50,083650,Miranda; Gregory Joseph,0,15,40,40
1650079941276,CSE 11,A01,083080,Cao; Yingjun,0,66,40,40
1650079947304,CSE 12,A01,083652,Staff,0,2,100,100
1650079953329,CSE 15L,A01,083654,Staff,0,0,50,50
1650079953329,CSE 15L,A02,083655,Staff,10,0,50,40
1650079959364,CSE 20,A01,083657,Staff,58,0,80,22
1650079965388,CSE 30,A01,083084,Eldon; John,0,63,40,40
1650079971412,CSE 100,A01,083659,Cao; Yingjun,0,60,50,50
1650079977437,CSE 134B,A01,083661,Powell; Thomas Allan,1,28,65,64
1650079983473,CSE 140,A01,083663,Staff,4,0,75,71
1650079989498,CSE 140L,A01,083088,Eldon; John,0,1,75,75
1650079995525,CSE 175,A01,083665,Kumar; Rakesh,9,0,25,16
1650080001548,CSE 190,A00,092507,Dubnov; Shlomo,14,0,20,6
1650080007577,ECE 45,A01,083139,Staff,0,13,40,40
1650080013607,ECE 65,A50,083695,Staff,0,3,30,30
1650080019631,ECE 109,A01,091882,Touri; Behrouz,48,0,70,22
1650080025656,ECE 180,A00,083140,Abi Samra; Nicholas Camill,24,0,30,6
1650080025656,ECE 180,B00,083141,Abi Samra; Nicholas Camill,8,0,30,22
1650080031684,MATH 10A,A01,083735,Patchell; Gregory David,12,0,30,18
1650080031684,MATH 10A,A02,083736,Patchell; Gregory David,28,0,30,2
1650080031684,MATH 10A,A03,083737,Patchell; Gregory David,27,0,30,3
1650080037710,MATH 10B,A01,083207,Staff,0,5,30,30
1650080037710,MATH 10B,A02,083208,Staff,0,4,30,30
1650080037710,MATH 10B,B01,083739,Staff,18,0,30,12
1650080037710,MATH 10B,B02,083740,Staff,29,0,30,1
1650080043741,MATH 18,A01,083743,Staff,10,0,30,20
1650080043741,MATH 18,A02,083744,Staff,28,0,30,2
1650080043741,MATH 18,A03,083745,Staff,23,0,30,7
1650080043741,MATH 18,A04,083746,Staff,27,0,30,3
1650080043741,MATH 18,B01,083748,Staff,0,9,30,30
1650080043741,MATH 18,B02,083749,Staff,1,7,30,29
1650080043741,MATH 18,B03,083750,Staff,0,6,30,30
1650080043741,MATH 18,B04,083751,Staff,1,8,30,29
1650080049768,MATH 20A,A01,083754,Staff,26,0,40,14
1650080055793,MATH 20B,A01,083756,Staff,0,6,30,30
1650080055793,MATH 20B,A02,083757,Staff,0,1,30,30
1650080061827,MATH 20C,A01,083760,Staff,0,11,30,30
1650080061827,MATH 20C,A02,083761,Staff,0,12,30,30
1650080061827,MATH 20C,B01,083762,Staff,14,0,30,16
1650080061827,MATH 20C,B02,083763,Staff,28,0,30,2
1650080067853,MATH 20D,A01,083765,Staff,0,2,30,30
1650080067853,MATH 20D,A02,083766,Staff,14,0,30,16
1650080067853,MATH 20D,A03,083767,Staff,28,0,30,2
1650080073882,MATH 20E,A01,083771,Staff,10,0,30,20
1650080073882,MATH 20E,A02,083772,Staff,20,0,30,10
1650080073882,MATH 20E,B01,083773,Staff,2,2,30,28
1650080073882,MATH 20E,B02,083774,Staff,16,0,30,14
1650080079910,MATH 103A,A01,083777,Staff,0,8,30,30
1650080079910,MATH 103A,A02,083778,Staff,0,7,30,30
1650080079910,MATH 103A,B01,083779,Staff,0,8,30,30
1650080079910,MATH 103A,B02,083780,Staff,1,7,30,29
1650080085937,MATH 105,A01,085443,Staff,1,13,30,29
1650080091965,MATH 109,A01,083213,Anzaldo; Leesa B,1,4,30,29
1650080091965,MATH 109,A02,083214,Anzaldo; Leesa B,0,5,30,30
1650080091965,MATH 109,B01,083215,Anzaldo; Leesa B,0,4,30,30
1650080091965,MATH 109,B02,083216,Anzaldo; Leesa B,1,4,30,29
1650080097990,MATH 142A,A01,083219,Chow; Bennett,0,10,30,30
1650080097990,MATH 142A,A02,083220,Chow; Bennett,0,10,30,30
1650080097990,MATH 142A,B01,083221,Chow; Bennett,0,10,30,30
1650080097990,MATH 142A,B02,083222,Chow; Bennett,0,9,30,30
1650080104014,MATH 193A,A01,083224,Staff,0,4,30,30
1650080104014,MATH 193A,A02,083225,Staff,0,4,30,30
1650080104014,MATH 193A,A03,083781,Staff,0,0,30,30
1650080104014,MATH 193A,A04,083782,Staff,4,0,30,26
1650080110047,MATH 197,001,091859,McAuley; Julian John,9998,0,9999,1
1650080116101,COGS 9,A01,083615,Staff,3,17,60,57
1650080122129,COGS 11,A01,083617,Boyle; Mary E. T.,24,0,40,16
1650080128153,COGS 13,A01,083071,Staff,0,29,40,40
1650080134177,COGS 14A,A01,092681,Staff,1,11,100,99
1650080140201,COGS 14B,A01,083073,Cheng; Tzu-Han,0,4,50,50
1650080146225,COGS 17,A01,092677,Staff,35,0,75,40
1650080152248,COGS 100,A01,083619,Staff,0,20,60,60
1650080158274,COGS 101A,A01,083621,Davis; Joshua Daniel,0,17,60,60
1650080164306,COGS 101B,A01,091572,Staff,10,0,60,50
1650080170334,COGS 101C,A01,083625,Delgado; Tania,21,0,30,9
1650080176356,COGS 107A,A01,083627,Boyle; Mary E. T.,1,4,60,59
1650080182380,COGS 118A,A01,083075,Staff,17,0,60,43
1650080188409,CSE 3,A50,083646,Miranda; Gregory Joseph,22,0,38,16
1650080188409,CSE 3,A51,083647,Miranda; Gregory Joseph,37,0,37,0
1650080194436,CSE 8A,A50,083650,Miranda; Gregory Joseph,0,15,40,40
1650080200460,CSE 11,A01,083080,Cao; Yingjun,0,66,40,40
1650080206492,CSE 12,A01,083652,Staff,0,2,100,100
1650080212516,CSE 15L,A01,083654,Staff,0,0,50,50
1650080212516,CSE 15L,A02,083655,Staff,10,0,50,40
1650080218540,CSE 20,A01,083657,Staff,58,0,80,22
1650080224564,CSE 30,A01,083084,Eldon; John,0,63,40,40
1650080230596,CSE 100,A01,083659,Cao; Yingjun,0,60,50,50
1650080236621,CSE 134B,A01,083661,Powell; Thomas Allan,1,28,65,64
1650080242645,CSE 140,A01,083663,Staff,4,0,75,71
1650080248672,CSE 140L,A01,083088,Eldon; John,0,1,75,75
1650080254695,CSE 175,A01,083665,Kumar; Rakesh,9,0,25,16
1650080260724,CSE 190,A00,092507,Dubnov; Shlomo,14,0,20,6
1650080266754,ECE 45,A01,083139,Staff,0,13,40,40
1650080272788,ECE 65,A50,083695,Staff,0,3,30,30
1650080278812,ECE 109,A01,091882,Touri; Behrouz,48,0,70,22
1650080284837,ECE 180,A00,083140,Abi Samra; Nicholas Camill,24,0,30,6
1650080284837,ECE 180,B00,083141,Abi Samra; Nicholas Camill,8,0,30,22
1650080290867,MATH 10A,A01,083735,Patchell; Gregory David,12,0,30,18
1650080290867,MATH 10A,A02,083736,Patchell; Gregory David,28,0,30,2
1650080290867,MATH 10A,A03,083737,Patchell; Gregory David,26,0,30,4
1650080296891,MATH 10B,A01,083207,Staff,0,5,30,30
1650080296891,MATH 10B,A02,083208,Staff,0,4,30,30
1650080296891,MATH 10B,B01,083739,Staff,18,0,30,12
1650080296891,MATH 10B,B02,083740,Staff,29,0,30,1
1650080302915,MATH 18,A01,083743,Staff,10,0,30,20
1650080302915,MATH 18,A02,083744,Staff,28,0,30,2
1650080302915,MATH 18,A03,083745,Staff,23,0,30,7
1650080302915,MATH 18,A04,083746,Staff,27,0,30,3
1650080302915,MATH 18,B01,083748,Staff,0,9,30,30
1650080302915,MATH 18,B02,083749,Staff,1,7,30,29
1650080302915,MATH 18,B03,083750,Staff,0,6,30,30
1650080302915,MATH 18,B04,083751,Staff,1,8,30,29
1650080308939,MATH 20A,A01,083754,Staff,26,0,40,14
1650080314962,MATH 20B,A01,083756,Staff,0,6,30,30
1650080314962,MATH 20B,A02,083757,Staff,0,1,30,30
1650080320987,MATH 20C,A01,083760,Staff,0,11,30,30
1650080320987,MATH 20C,A02,083761,Staff,0,12,30,30
1650080320987,MATH 20C,B01,083762,Staff,14,0,30,16
1650080320987,MATH 20C,B02,083763,Staff,28,0,30,2
1650080327019,MATH 20D,A01,083765,Staff,0,2,30,30
1650080327019,MATH 20D,A02,083766,Staff,14,0,30,16
1650080327019,MATH 20D,A03,083767,Staff,28,0,30,2
1650080333043,MATH 20E,A01,083771,Staff,10,0,30,20
1650080333043,MATH 20E,A02,083772,Staff,20,0,30,10
1650080333043,MATH 20E,B01,083773,Staff,2,2,30,28
1650080333043,MATH 20E,B02,083774,Staff,16,0,30,14
1650080339068,MATH 103A,A01,083777,Staff,0,8,30,30
1650080339068,MATH 103A,A02,083778,Staff,0,7,30,30
1650080339068,MATH 103A,B01,083779,Staff,0,8,30,30
1650080339068,MATH 103A,B02,083780,Staff,1,7,30,29
1650080345093,MATH 105,A01,085443,Staff,1,13,30,29
1650080351121,MATH 109,A01,083213,Anzaldo; Leesa B,1,4,30,29
1650080351121,MATH 109,A02,083214,Anzaldo; Leesa B,0,5,30,30
1650080351121,MATH 109,B01,083215,Anzaldo; Leesa B,0,4,30,30
1650080351121,MATH 109,B02,083216,Anzaldo; Leesa B,1,4,30,29
1650080357149,MATH 142A,A01,083219,Chow; Bennett,0,10,30,30
1650080357149,MATH 142A,A02,083220,Chow; Bennett,0,10,30,30
1650080357149,MATH 142A,B01,083221,Chow; Bennett,0,10,30,30
1650080357149,MATH 142A,B02,083222,Chow; Bennett,0,9,30,30
1650080363173,MATH 193A,A01,083224,Staff,0,4,30,30
1650080363173,MATH 193A,A02,083225,Staff,0,4,30,30
1650080363173,MATH 193A,A03,083781,Staff,0,0,30,30
1650080363173,MATH 193A,A04,083782,Staff,4,0,30,26
1650080369196,MATH 197,001,091859,McAuley; Julian John,9998,0,9999,1
1650080375255,COGS 9,A01,083615,Staff,3,17,60,57
1650080381279,COGS 11,A01,083617,Boyle; Mary E. T.,24,0,40,16
1650080387306,COGS 13,A01,083071,Staff,0,29,40,40
1650080393335,COGS 14A,A01,092681,Staff,1,11,100,99
1650080399362,COGS 14B,A01,083073,Cheng; Tzu-Han,0,4,50,50
1650080405386,COGS 17,A01,092677,Staff,35,0,75,40
1650080411411,COGS 100,A01,083619,Staff,0,20,60,60
1650080417511,COGS 101A,A01,083621,Davis; Joshua Daniel,0,17,60,60
1650080423534,COGS 101B,A01,091572,Staff,10,0,60,50
1650080429562,COGS 101C,A01,083625,Delgado; Tania,21,0,30,9
1650080435586,COGS 107A,A01,083627,Boyle; Mary E. T.,1,4,60,59
1650080441609,COGS 118A,A01,083075,Staff,17,0,60,43
1650080447633,CSE 3,A50,083646,Miranda; Gregory Joseph,22,0,38,16
1650080447633,CSE 3,A51,083647,Miranda; Gregory Joseph,37,0,37,0
1650080453667,CSE 8A,A50,083650,Miranda; Gregory Joseph,0,15,40,40
1650080459698,CSE 11,A01,083080,Cao; Yingjun,0,66,40,40
1650080465733,CSE 12,A01,083652,Staff,0,2,100,100
1650080471764,CSE 15L,A01,083654,Staff,0,0,50,50
1650080471764,CSE 15L,A02,083655,Staff,10,0,50,40
1650080477787,CSE 20,A01,083657,Staff,58,0,80,22
1650080483815,CSE 30,A01,083084,Eldon; John,0,63,40,40
1650080489839,CSE 100,A01,083659,Cao; Yingjun,0,60,50,50
1650080495865,CSE 134B,A01,083661,Powell; Thomas Allan,1,28,65,64
1650080501888,CSE 140,A01,083663,Staff,4,0,75,71
1650080507915,CSE 140L,A01,083088,Eldon; John,0,1,75,75
1650080513939,CSE 175,A01,083665,Kumar; Rakesh,9,0,25,16
1650080519961,CSE 190,A00,092507,Dubnov; Shlomo,14,0,20,6
1650080525997,ECE 45,A01,083139,Staff,0,13,40,40
1650080532020,ECE 65,A50,083695,Staff,0,3,30,30
1650080538047,ECE 109,A01,091882,Touri; Behrouz,48,0,70,22
1650080544076,ECE 180,A00,083140,Abi Samra; Nicholas Camill,24,0,30,6
1650080544076,ECE 180,B00,083141,Abi Samra; Nicholas Camill,8,0,30,22
1650080550099,MATH 10A,A01,083735,Patchell; Gregory David,12,0,30,18
1650080550099,MATH 10A,A02,083736,Patchell; Gregory David,28,0,30,2
1650080550099,MATH 10A,A03,083737,Patchell; Gregory David,26,0,30,4
1650080556126,MATH 10B,A01,083207,Staff,0,5,30,30
1650080556126,MATH 10B,A02,083208,Staff,0,4,30,30
1650080556126,MATH 10B,B01,083739,Staff,18,0,30,12
1650080556126,MATH 10B,B02,083740,Staff,29,0,30,1
1650080562157,MATH 18,A01,083743,Staff,10,0,30,20
1650080562157,MATH 18,A02,083744,Staff,28,0,30,2
1650080562157,MATH 18,A03,083745,Staff,23,0,30,7
1650080562157,MATH 18,A04,083746,Staff,27,0,30,3
1650080562157,MATH 18,B01,083748,Staff,0,9,30,30
1650080562157,MATH 18,B02,083749,Staff,1,7,30,29
1650080562157,MATH 18,B03,083750,Staff,0,6,30,30
1650080562157,MATH 18,B04,083751,Staff,1,8,30,29
1650080568181,MATH 20A,A01,083754,Staff,26,0,40,14
1650080574205,MATH 20B,A01,083756,Staff,0,6,30,30
1650080574205,MATH 20B,A02,083757,Staff,0,1,30,30
1650080580233,MATH 20C,A01,083760,Staff,0,11,30,30
1650080580233,MATH 20C,A02,083761,Staff,0,12,30,30
1650080580233,MATH 20C,B01,083762,Staff,14,0,30,16
1650080580233,MATH 20C,B02,083763,Staff,28,0,30,2
1650080586262,MATH 20D,A01,083765,Staff,0,2,30,30
1650080586262,MATH 20D,A02,083766,Staff,14,0,30,16
1650080586262,MATH 20D,A03,083767,Staff,28,0,30,2
1650080592285,MATH 20E,A01,083771,Staff,10,0,30,20
1650080592285,MATH 20E,A02,083772,Staff,20,0,30,10
1650080592285,MATH 20E,B01,083773,Staff,2,2,30,28
1650080592285,MATH 20E,B02,083774,Staff,16,0,30,14
1650080598316,MATH 103A,A01,083777,Staff,0,8,30,30
1650080598316,MATH 103A,A02,083778,Staff,0,7,30,30
1650080598316,MATH 103A,B01,083779,Staff,0,8,30,30
1650080598316,MATH 103A,B02,083780,Staff,1,7,30,29
1650080604343,MATH 105,A01,085443,Staff,1,13,30,29
1650080610373,MATH 109,A01,083213,Anzaldo; Leesa B,1,4,30,29
1650080610373,MATH 109,A02,083214,Anzaldo; Leesa B,0,5,30,30
1650080610373,MATH 109,B01,083215,Anzaldo; Leesa B,0,4,30,30
1650080610373,MATH 109,B02,083216,Anzaldo; Leesa B,1,4,30,29
1650080616398,MATH 142A,A01,083219,Chow; Bennett,0,10,30,30
1650080616398,MATH 142A,A02,083220,Chow; Bennett,0,10,30,30
1650080616398,MATH 142A,B01,083221,Chow; Bennett,0,10,30,30
1650080616398,MATH 142A,B02,083222,Chow; Bennett,0,9,30,30
1650080622423,MATH 193A,A01,083224,Staff,0,4,30,30
1650080622423,MATH 193A,A02,083225,Staff,0,4,30,30
1650080622423,MATH 193A,A03,083781,Staff,0,0,30,30
1650080622423,MATH 193A,A04,083782,Staff,4,0,30,26
1650080628447,MATH 197,001,091859,McAuley; Julian John,9998,0,9999,1
1650080634502,COGS 9,A01,083615,Staff,3,17,60,57
1650080640529,COGS 11,A01,083617,Boyle; Mary E. T.,24,0,40,16
1650080646553,COGS 13,A01,083071,Staff,0,29,40,40
1650080652575,COGS 14A,A01,092681,Staff,1,11,100,99
1650080658605,COGS 14B,A01,083073,Cheng; Tzu-Han,0,4,50,50
1650080664632,COGS 17,A01,092677,Staff,35,0,75,40
1650080670657,COGS 100,A01,083619,Staff,0,20,60,60
1650080676680,COGS 101A,A01,083621,Davis; Joshua Daniel,0,17,60,60
1650080682706,COGS 101B,A01,091572,Staff,10,0,60,50
1650080688730,COGS 101C,A01,083625,Delgado; Tania,21,0,30,9
1650080694757,COGS 107A,A01,083627,Boyle; Mary E. T.,1,4,60,59
1650080700783,COGS 118A,A01,083075,Staff,17,0,60,43
1650080706809,CSE 3,A50,083646,Miranda; Gregory Joseph,22,0,38,16
1650080706809,CSE 3,A51,083647,Miranda; Gregory Joseph,37,0,37,0
1650080712833,CSE 8A,A50,083650,Miranda; Gregory Joseph,0,15,40,40
1650080718858,CSE 11,A01,083080,Cao; Yingjun,0,66,40,40
1650080724882,CSE 12,A01,083652,Staff,0,2,100,100
1650080730906,CSE 15L,A01,083654,Staff,0,0,50,50
1650080730906,CSE 15L,A02,083655,Staff,10,0,50,40
1650080736935,CSE 20,A01,083657,Staff,58,0,80,22
1650080742958,CSE 30,A01,083084,Eldon; John,0,63,40,40
1650080748982,CSE 100,A01,083659,Cao; Yingjun,0,60,50,50
1650080755005,CSE 134B,A01,083661,Powell; Thomas Allan,1,28,65,64
1650080761029,CSE 140,A01,083663,Staff,4,0,75,71
1650080767053,CSE 140L,A01,083088,Eldon; John,0,1,75,75
1650080773080,CSE 175,A01,083665,Kumar; Rakesh,9,0,25,16
1650080779107,CSE 190,A00,092507,Dubnov; Shlomo,14,0,20,6
1650080785131,ECE 45,A01,083139,Staff,0,13,40,40
1650080791156,ECE 65,A50,083695,Staff,0,3,30,30
1650080797180,ECE 109,A01,091882,Touri; Behrouz,48,0,70,22
1650080803211,ECE 180,A00,083140,Abi Samra; Nicholas Camill,24,0,30,6
1650080803211,ECE 180,B00,083141,Abi Samra; Nicholas Camill,8,0,30,22
1650080809238,MATH 10A,A01,083735,Patchell; Gregory David,12,0,30,18
1650080809238,MATH 10A,A02,083736,Patchell; Gregory David,28,0,30,2
1650080809238,MATH 10A,A03,083737,Patchell; Gregory David,26,0,30,4
1650080815263,MATH 10B,A01,083207,Staff,0,5,30,30
1650080815263,MATH 10B,A02,083208,Staff,0,4,30,30
1650080815263,MATH 10B,B01,083739,Staff,18,0,30,12
1650080815263,MATH 10B,B02,083740,Staff,29,0,30,1
1650080821295,MATH 18,A01,083743,Staff,10,0,30,20
1650080821295,MATH 18,A02,083744,Staff,28,0,30,2
1650080821295,MATH 18,A03,083745,Staff,23,0,30,7
1650080821295,MATH 18,A04,083746,Staff,27,0,30,3
1650080821295,MATH 18,B01,083748,Staff,0,9,30,30
1650080821295,MATH 18,B02,083749,Staff,1,7,30,29
1650080821295,MATH 18,B03,083750,Staff,0,6,30,30
1650080821295,MATH 18,B04,083751,Staff,1,8,30,29
1650080827321,MATH 20A,A01,083754,Staff,26,0,40,14
1650080833347,MATH 20B,A01,083756,Staff,0,6,30,30
1650080833347,MATH 20B,A02,083757,Staff,0,1,30,30
1650080839376,MATH 20C,A01,083760,Staff,0,11,30,30
1650080839376,MATH 20C,A02,083761,Staff,0,12,30,30
1650080839376,MATH 20C,B01,083762,Staff,14,0,30,16
1650080839376,MATH 20C,B02,083763,Staff,28,0,30,2
1650080845406,MATH 20D,A01,083765,Staff,0,2,30,30
1650080845406,MATH 20D,A02,083766,Staff,14,0,30,16
1650080845406,MATH 20D,A03,083767,Staff,28,0,30,2
1650080851443,MATH 20E,A01,083771,Staff,10,0,30,20
1650080851443,MATH 20E,A02,083772,Staff,20,0,30,10
1650080851443,MATH 20E,B01,083773,Staff,2,2,30,28
1650080851443,MATH 20E,B02,083774,Staff,16,0,30,14
1650080857471,MATH 103A,A01,083777,Staff,0,8,30,30
1650080857471,MATH 103A,A02,083778,Staff,0,7,30,30
1650080857471,MATH 103A,B01,083779,Staff,0,8,30,30
1650080857471,MATH 103A,B02,083780,Staff,1,7,30,29
1650080863495,MATH 105,A01,085443,Staff,1,13,30,29
1650080869523,MATH 109,A01,083213,Anzaldo; Leesa B,1,4,30,29
1650080869523,MATH 109,A02,083214,Anzaldo; Leesa B,0,5,30,30
1650080869523,MATH 109,B01,083215,Anzaldo; Leesa B,0,4,30,30
1650080869523,MATH 109,B02,083216,Anzaldo; Leesa B,1,4,30,29
1650080875546,MATH 142A,A01,083219,Chow; Bennett,0,10,30,30
1650080875546,MATH 142A,A02,083220,Chow; Bennett,0,10,30,30
1650080875546,MATH 142A,B01,083221,Chow; Bennett,0,10,30,30
1650080875546,MATH 142A,B02,083222,Chow; Bennett,0,9,30,30
1650080881572,MATH 193A,A01,083224,Staff,0,4,30,30
1650080881572,MATH 193A,A02,083225,Staff,0,4,30,30
1650080881572,MATH 193A,A03,083781,Staff,0,0,30,30
1650080881572,MATH 193A,A04,083782,Staff,4,0,30,26
1650080887595,MATH 197,001,091859,McAuley; Julian John,9998,0,9999,1
1650080893653,COGS 9,A01,083615,Staff,3,17,60,57
1650080899681,COGS 11,A01,083617,Boyle; Mary E. T.,24,0,40,16
1650080905712,COGS 13,A01,083071,Staff,0,29,40,40
1650080911736,COGS 14A,A01,092681,Staff,1,11,100,99
1650080917760,COGS 14B,A01,083073,Cheng; Tzu-Han,0,4,50,50
1650080923785,COGS 17,A01,092677,Staff,35,0,75,40
1650080929808,COGS 100,A01,083619,Staff,0,20,60,60
1650080935832,COGS 101A,A01,083621,Davis; Joshua Daniel,0,17,60,60
1650080941855,COGS 101B,A01,091572,Staff,10,0,60,50
1650080947884,COGS 101C,A01,083625,Delgado; Tania,21,0,30,9
1650080953916,COGS 107A,A01,083627,Boyle; Mary E. T.,1,4,60,59
1650080959944,COGS 118A,A01,083075,Staff,17,0,60,43
1650080965967,CSE 3,A50,083646,Miranda; Gregory Joseph,22,0,38,16
1650080965967,CSE 3,A51,083647,Miranda; Gregory Joseph,37,0,37,0
1650080971995,CSE 8A,A50,083650,Miranda; Gregory Joseph,0,15,40,40
1650080978019,CSE 11,A01,083080,Cao; Yingjun,0,66,40,40
1650080984042,CSE 12,A01,083652,Staff,0,2,100,100
1650080990068,CSE 15L,A01,083654,Staff,0,0,50,50
1650080990068,CSE 15L,A02,083655,Staff,10,0,50,40
1650080996093,CSE 20,A01,083657,Staff,58,0,80,22
1650081002121,CSE 30,A01,083084,Eldon; John,0,63,40,40
1650081008146,CSE 100,A01,083659,Cao; Yingjun,0,60,50,50
1650081014257,CSE 134B,A01,083661,Powell; Thomas Allan,1,28,65,64
1650081020281,CSE 140,A01,083663,Staff,4,0,75,71
1650081026309,CSE 140L,A01,083088,Eldon; John,0,1,75,75
1650081032333,CSE 175,A01,083665,Kumar; Rakesh,9,0,25,16
1650081038360,CSE 190,A00,092507,Dubnov; Shlomo,14,0,20,6
1650081044392,ECE 45,A01,083139,Staff,0,13,40,40
1650081050418,ECE 65,A50,083695,Staff,0,3,30,30
1650081056445,ECE 109,A01,091882,Touri; Behrouz,48,0,70,22
1650081062469,ECE 180,A00,083140,Abi Samra; Nicholas Camill,24,0,30,6
1650081062469,ECE 180,B00,083141,Abi Samra; Nicholas Camill,8,0,30,22
1650081068492,MATH 10A,A01,083735,Patchell; Gregory David,12,0,30,18
1650081068492,MATH 10A,A02,083736,Patchell; Gregory David,28,0,30,2
1650081068492,MATH 10A,A03,083737,Patchell; Gregory David,26,0,30,4
1650081074525,MATH 10B,A01,083207,Staff,0,5,30,30
1650081074525,MATH 10B,A02,083208,Staff,0,4,30,30
1650081074525,MATH 10B,B01,083739,Staff,18,0,30,12
1650081074525,MATH 10B,B02,083740,Staff,29,0,30,1
1650081080555,MATH 18,A01,083743,Staff,10,0,30,20
1650081080555,MATH 18,A02,083744,Staff,28,0,30,2
1650081080555,MATH 18,A03,083745,Staff,23,0,30,7
1650081080555,MATH 18,A04,083746,Staff,27,0,30,3
1650081080555,MATH 18,B01,083748,Staff,0,9,30,30
1650081080555,MATH 18,B02,083749,Staff,1,7,30,29
1650081080555,MATH 18,B03,083750,Staff,0,6,30,30
1650081080555,MATH 18,B04,083751,Staff,1,8,30,29
1650081086582,MATH 20A,A01,083754,Staff,26,0,40,14
1650081092606,MATH 20B,A01,083756,Staff,0,6,30,30
1650081092606,MATH 20B,A02,083757,Staff,0,1,30,30
1650081098629,MATH 20C,A01,083760,Staff,0,11,30,30
1650081098629,MATH 20C,A02,083761,Staff,0,12,30,30
1650081098629,MATH 20C,B01,083762,Staff,14,0,30,16
1650081098629,MATH 20C,B02,083763,Staff,28,0,30,2
1650081104653,MATH 20D,A01,083765,Staff,0,2,30,30
1650081104653,MATH 20D,A02,083766,Staff,14,0,30,16
1650081104653,MATH 20D,A03,083767,Staff,28,0,30,2
1650081110686,MATH 20E,A01,083771,Staff,10,0,30,20
1650081110686,MATH 20E,A02,083772,Staff,20,0,30,10
1650081110686,MATH 20E,B01,083773,Staff,2,2,30,28
1650081110686,MATH 20E,B02,083774,Staff,16,0,30,14
1650081116710,MATH 103A,A01,083777,Staff,0,8,30,30
1650081116710,MATH 103A,A02,083778,Staff,0,7,30,30
1650081116710,MATH 103A,B01,083779,Staff,0,8,30,30
1650081116710,MATH 103A,B02,083780,Staff,1,7,30,29
1650081122737,MATH 105,A01,085443,Staff,1,13,30,29
1650081128762,MATH 109,A01,083213,Anzaldo; Leesa B,1,4,30,29
1650081128762,MATH 109,A02,083214,Anzaldo; Leesa B,0,5,30,30
1650081128762,MATH 109,B01,083215,Anzaldo; Leesa B,0,4,30,30
1650081128762,MATH 109,B02,083216,Anzaldo; Leesa B,1,4,30,29
1650081134786,MATH 142A,A01,083219,Chow; Bennett,0,10,30,30
1650081134786,MATH 142A,A02,083220,Chow; Bennett,0,10,30,30
1650081134786,MATH 142A,B01,083221,Chow; Bennett,0,10,30,30
1650081134786,MATH 142A,B02,083222,Chow; Bennett,0,9,30,30
1650081140813,MATH 193A,A01,083224,Staff,0,4,30,30
1650081140813,MATH 193A,A02,083225,Staff,0,4,30,30
1650081140813,MATH 193A,A03,083781,Staff,0,0,30,30
1650081140813,MATH 193A,A04,083782,Staff,4,0,30,26
1650081146836,MATH 197,001,091859,McAuley; Julian John,9998,0,9999,1
1650081152897,COGS 9,A01,083615,Staff,3,17,60,57
1650081158920,COGS 11,A01,083617,Boyle; Mary E. T.,24,0,40,16
1650081164943,COGS 13,A01,083071,Staff,0,29,40,40
1650081170974,COGS 14A,A01,092681,Staff,1,11,100,99
1650081176999,COGS 14B,A01,083073,Cheng; Tzu-Han,0,4,50,50
1650081183028,COGS 17,A01,092677,Staff,35,0,75,40
1650081189054,COGS 100,A01,083619,Staff,0,20,60,60
1650081195078,COGS 101A,A01,083621,Davis; Joshua Daniel,0,17,60,60
1650081201100,COGS 101B,A01,091572,Staff,10,0,60,50
1650081207128,COGS 101C,A01,083625,Delgado; Tania,21,0,30,9
1650081213154,COGS 107A,A01,083627,Boyle; Mary E. T.,1,4,60,59
1650081219181,COGS 118A,A01,083075,Staff,17,0,60,43
1650081225210,CSE 3,A50,083646,Miranda; Gregory Joseph,22,0,38,16
1650081225210,CSE 3,A51,083647,Miranda; Gregory Joseph,37,0,37,0
1650081231239,CSE 8A,A50,083650,Miranda; Gregory Joseph,0,15,40,40
1650081237262,CSE 11,A01,083080,Cao; Yingjun,0,66,40,40
1650081243284,CSE 12,A01,083652,Staff,0,2,100,100
1650081249312,CSE 15L,A01,083654,Staff,0,0,50,50
1650081249312,CSE 15L,A02,083655,Staff,10,0,50,40
1650081255339,CSE 20,A01,083657,Staff,58,0,80,22
1650081261362,CSE 30,A01,083084,Eldon; John,0,63,40,40
1650081267385,CSE 100,A01,083659,Cao; Yingjun,0,60,50,50
1650081273408,CSE 134B,A01,083661,Powell; Thomas Allan,1,28,65,64
1650081279430,CSE 140,A01,083663,Staff,4,0,75,71
1650081285458,CSE 140L,A01,083088,Eldon; John,0,1,75,75
1650081291482,CSE 175,A01,083665,Kumar; Rakesh,9,0,25,16
1650081297506,CSE 190,A00,092507,Dubnov; Shlomo,14,0,20,6
1650081303534,ECE 45,A01,083139,Staff,0,13,40,40
1650081309561,ECE 65,A50,083695,Staff,0,3,30,30
1650081315592,ECE 109,A01,091882,Touri; Behrouz,48,0,70,22
1650081321629,ECE 180,A00,083140,Abi Samra; Nicholas Camill,24,0,30,6
1650081321629,ECE 180,B00,083141,Abi Samra; Nicholas Camill,8,0,30,22
1650081327653,MATH 10A,A01,083735,Patchell; Gregory David,12,0,30,18
1650081327653,MATH 10A,A02,083736,Patchell; Gregory David,28,0,30,2
1650081327653,MATH 10A,A03,083737,Patchell; Gregory David,26,0,30,4
1650081333680,MATH 10B,A01,083207,Staff,0,5,30,30
1650081333680,MATH 10B,A02,083208,Staff,0,4,30,30
1650081333680,MATH 10B,B01,083739,Staff,18,0,30,12
1650081333680,MATH 10B,B02,083740,Staff,29,0,30,1
1650081339710,MATH 18,A01,083743,Staff,10,0,30,20
1650081339710,MATH 18,A02,083744,Staff,28,0,30,2
1650081339710,MATH 18,A03,083745,Staff,23,0,30,7
1650081339710,MATH 18,A04,083746,Staff,27,0,30,3
1650081339710,MATH 18,B01,083748,Staff,0,9,30,30
1650081339710,MATH 18,B02,083749,Staff,1,7,30,29
1650081339710,MATH 18,B03,083750,Staff,0,6,30,30
1650081339710,MATH 18,B04,083751,Staff,1,8,30,29
1650081345733,MATH 20A,A01,083754,Staff,26,0,40,14
1650081351757,MATH 20B,A01,083756,Staff,0,6,30,30
1650081351757,MATH 20B,A02,083757,Staff,0,1,30,30
1650081357783,MATH 20C,A01,083760,Staff,0,11,30,30
1650081357783,MATH 20C,A02,083761,Staff,0,12,30,30
1650081357783,MATH 20C,B01,083762,Staff,14,0,30,16
1650081357783,MATH 20C,B02,083763,Staff,28,0,30,2
1650081363806,MATH 20D,A01,083765,Staff,0,2,30,30
1650081363806,MATH 20D,A02,083766,Staff,14,0,30,16
1650081363806,MATH 20D,A03,083767,Staff,28,0,30,2
1650081369833,MATH 20E,A01,083771,Staff,10,0,30,20
1650081369833,MATH 20E,A02,083772,Staff,20,0,30,10
1650081369833,MATH 20E,B01,083773,Staff,2,2,30,28
1650081369833,MATH 20E,B02,083774,Staff,16,0,30,14
1650081375866,MATH 103A,A01,083777,Staff,0,8,30,30
1650081375866,MATH 103A,A02,083778,Staff,0,7,30,30
1650081375866,MATH 103A,B01,083779,Staff,0,8,30,30
1650081375866,MATH 103A,B02,083780,Staff,1,7,30,29
1650081381889,MATH 105,A01,085443,Staff,1,13,30,29
1650081387913,MATH 109,A01,083213,Anzaldo; Leesa B,1,4,30,29
1650081387913,MATH 109,A02,083214,Anzaldo; Leesa B,0,5,30,30
1650081387913,MATH 109,B01,083215,Anzaldo; Leesa B,0,4,30,30
1650081387913,MATH 109,B02,083216,Anzaldo; Leesa B,1,4,30,29
1650081393936,MATH 142A,A01,083219,Chow; Bennett,0,10,30,30
1650081393936,MATH 142A,A02,083220,Chow; Bennett,0,10,30,30
1650081393936,MATH 142A,B01,083221,Chow; Bennett,0,10,30,30
1650081393936,MATH 142A,B02,083222,Chow; Bennett,0,9,30,30
1650081399961,MATH 193A,A01,083224,Staff,0,4,30,30
1650081399961,MATH 193A,A02,083225,Staff,0,4,30,30
1650081399961,MATH 193A,A03,083781,Staff,0,0,30,30
1650081399961,MATH 193A,A04,083782,Staff,4,0,30,26
1650081405984,MATH 197,001,091859,McAuley; Julian John,9998,0,9999,1
1650081412046,COGS 9,A01,083615,Staff,3,17,60,57
1650081418069,COGS 11,A01,083617,Boyle; Mary E. T.,24,0,40,16
1650081424093,COGS 13,A01,083071,Staff,0,29,40,40
1650081430121,COGS 14A,A01,092681,Staff,1,11,100,99
1650081436144,COGS 14B,A01,083073,Cheng; Tzu-Han,0,4,50,50
1650081442168,COGS 17,A01,092677,Staff,35,0,75,40
1650081448191,COGS 100,A01,083619,Staff,0,20,60,60
1650081454215,COGS 101A,A01,083621,Davis; Joshua Daniel,0,17,60,60
1650081460241,COGS 101B,A01,091572,Staff,10,0,60,50
1650081466265,COGS 101C,A01,083625,Delgado; Tania,21,0,30,9
1650081472290,COGS 107A,A01,083627,Boyle; Mary E. T.,1,4,60,59
1650081478314,COGS 118A,A01,083075,Staff,17,0,60,43
1650081484344,CSE 3,A50,083646,Miranda; Gregory Joseph,22,0,38,16
1650081484344,CSE 3,A51,083647,Miranda; Gregory Joseph,37,0,37,0
1650081490371,CSE 8A,A50,083650,Miranda; Gregory Joseph,0,15,40,40
1650081496395,CSE 11,A01,083080,Cao; Yingjun,0,66,40,40
1650081502424,CSE 12,A01,083652,Staff,0,2,100,100
1650081508451,CSE 15L,A01,083654,Staff,0,0,50,50
1650081508451,CSE 15L,A02,083655,Staff,10,0,50,40
1650081514475,CSE 20,A01,083657,Staff,58,0,80,22
1650081520498,CSE 30,A01,083084,Eldon; John,0,63,40,40
1650081526525,CSE 100,A01,083659,Cao; Yingjun,0,60,50,50
1650081532555,CSE 134B,A01,083661,Powell; Thomas Allan,1,28,65,64
1650081538582,CSE 140,A01,083663,Staff,4,0,75,71
1650081544613,CSE 140L,A01,083088,Eldon; John,0,1,75,75
1650081550638,CSE 175,A01,083665,Kumar; Rakesh,9,0,25,16
1650081556665,CSE 190,A00,092507,Dubnov; Shlomo,14,0,20,6
1650081562688,ECE 45,A01,083139,Staff,0,13,40,40
1650081568711,ECE 65,A50,083695,Staff,0,3,30,30
1650081574736,ECE 109,A01,091882,Touri; Behrouz,48,0,70,22
1650081580761,ECE 180,A00,083140,Abi Samra; Nicholas Camill,24,0,30,6
1650081580761,ECE 180,B00,083141,Abi Samra; Nicholas Camill,8,0,30,22
1650081586810,MATH 10A,A01,083735,Patchell; Gregory David,12,0,30,18
1650081586810,MATH 10A,A02,083736,Patchell; Gregory David,28,0,30,2
1650081586810,MATH 10A,A03,083737,Patchell; Gregory David,26,0,30,4
1650081592835,MATH 10B,A01,083207,Staff,0,5,30,30
1650081592835,MATH 10B,A02,083208,Staff,0,4,30,30
1650081592835,MATH 10B,B01,083739,Staff,18,0,30,12
1650081592835,MATH 10B,B02,083740,Staff,29,0,30,1
1650081598860,MATH 18,A01,083743,Staff,10,0,30,20
1650081598860,MATH 18,A02,083744,Staff,28,0,30,2
1650081598860,MATH 18,A03,083745,Staff,23,0,30,7
1650081598860,MATH 18,A04,083746,Staff,27,0,30,3
1650081598860,MATH 18,B01,083748,Staff,0,9,30,30
1650081598860,MATH 18,B02,083749,Staff,1,7,30,29
1650081598860,MATH 18,B03,083750,Staff,0,6,30,30
1650081598860,MATH 18,B04,083751,Staff,1,8,30,29
1650081604884,MATH 20A,A01,083754,Staff,26,0,40,14
1650081611018,MATH 20B,A01,083756,Staff,0,6,30,30
1650081611018,MATH 20B,A02,083757,Staff,0,1,30,30
1650081617042,MATH 20C,A01,083760,Staff,0,11,30,30
1650081617042,MATH 20C,A02,083761,Staff,0,12,30,30
1650081617042,MATH 20C,B01,083762,Staff,14,0,30,16
1650081617042,MATH 20C,B02,083763,Staff,28,0,30,2
1650081623071,MATH 20D,A01,083765,Staff,0,2,30,30
1650081623071,MATH 20D,A02,083766,Staff,14,0,30,16
1650081623071,MATH 20D,A03,083767,Staff,28,0,30,2
1650081629097,MATH 20E,A01,083771,Staff,10,0,30,20
1650081629097,MATH 20E,A02,083772,Staff,20,0,30,10
1650081629097,MATH 20E,B01,083773,Staff,2,2,30,28
1650081629097,MATH 20E,B02,083774,Staff,16,0,30,14
1650081635125,MATH 103A,A01,083777,Staff,0,8,30,30
1650081635125,MATH 103A,A02,083778,Staff,0,7,30,30
1650081635125,MATH 103A,B01,083779,Staff,0,8,30,30
1650081635125,MATH 103A,B02,083780,Staff,1,7,30,29
1650081641153,MATH 105,A01,085443,Staff,1,13,30,29
1650081647180,MATH 109,A01,083213,Anzaldo; Leesa B,1,4,30,29
1650081647180,MATH 109,A02,083214,Anzaldo; Leesa B,0,5,30,30
1650081647180,MATH 109,B01,083215,Anzaldo; Leesa B,0,4,30,30
1650081647180,MATH 109,B02,083216,Anzaldo; Leesa B,1,4,30,29
1650081653201,MATH 142A,A01,083219,Chow; Bennett,0,10,30,30
1650081653201,MATH 142A,A02,083220,Chow; Bennett,0,10,30,30
1650081653201,MATH 142A,B01,083221,Chow; Bennett,0,10,30,30
1650081653201,MATH 142A,B02,083222,Chow; Bennett,0,9,30,30
1650081659231,MATH 193A,A01,083224,Staff,0,4,30,30
1650081659231,MATH 193A,A02,083225,Staff,0,4,30,30
1650081659231,MATH 193A,A03,083781,Staff,0,0,30,30
1650081659231,MATH 193A,A04,083782,Staff,4,0,30,26
1650081665263,MATH 197,001,091859,McAuley; Julian John,9998,0,9999,1
1650081671312,COGS 9,A01,083615,Staff,3,17,60,57
1650081677335,COGS 11,A01,083617,Boyle; Mary E. T.,24,0,40,16
1650081683371,COGS 13,A01,083071,Staff,0,29,40,40
1650081689398,COGS 14A,A01,092681,Staff,1,11,100,99
1650081695424,COGS 14B,A01,083073,Cheng; Tzu-Han,0,4,50,50
1650081701447,COGS 17,A01,092677,Staff,35,0,75,40
1650081707480,COGS 100,A01,083619,Staff,0,20,60,60
1650081713509,COGS 101A,A01,083621,Davis; Joshua Daniel,0,17,60,60
1650081719539,COGS 101B,A01,091572,Staff,10,0,60,50
1650081725568,COGS 101C,A01,083625,Delgado; Tania,21,0,30,9
1650081731597,COGS 107A,A01,083627,Boyle; Mary E. T.,1,4,60,59
1650081737625,COGS 118A,A01,083075,Staff,17,0,60,43
1650081743649,CSE 3,A50,083646,Miranda; Gregory Joseph,22,0,38,16
1650081743649,CSE 3,A51,083647,Miranda; Gregory Joseph,37,0,37,0
1650081749685,CSE 8A,A50,083650,Miranda; Gregory Joseph,0,15,40,40
1650081755707,CSE 11,A01,083080,Cao; Yingjun,0,66,40,40
1650081761734,CSE 12,A01,083652,Staff,0,2,100,100
1650081767776,CSE 15L,A01,083654,Staff,0,0,50,50
1650081767776,CSE 15L,A02,083655,Staff,10,0,50,40
1650081773803,CSE 20,A01,083657,Staff,58,0,80,22
1650081779829,CSE 30,A01,083084,Eldon; John,0,63,40,40
1650081785856,CSE 100,A01,083659,Cao; Yingjun,0,60,50,50
1650081791880,CSE 134B,A01,083661,Powell; Thomas Allan,1,28,65,64
1650081797908,CSE 140,A01,083663,Staff,4,0,75,71
1650081803931,CSE 140L,A01,083088,Eldon; John,0,1,75,75
1650081809953,CSE 175,A01,083665,Kumar; Rakesh,9,0,25,16
1650081815982,CSE 190,A00,092507,Dubnov; Shlomo,14,0,20,6
1650081822006,ECE 45,A01,083139,Staff,0,13,40,40
1650081828030,ECE 65,A50,083695,Staff,0,3,30,30
1650081834053,ECE 109,A01,091882,Touri; Behrouz,48,0,70,22
1650081840086,ECE 180,A00,083140,Abi Samra; Nicholas Camill,24,0,30,6
1650081840086,ECE 180,B00,083141,Abi Samra; Nicholas Camill,8,0,30,22
1650081846110,MATH 10A,A01,083735,Patchell; Gregory David,12,0,30,18
1650081846110,MATH 10A,A02,083736,Patchell; Gregory David,28,0,30,2
1650081846110,MATH 10A,A03,083737,Patchell; Gregory David,26,0,30,4
1650081852150,MATH 10B,A01,083207,Staff,0,5,30,30
1650081852150,MATH 10B,A02,083208,Staff,0,4,30,30
1650081852150,MATH 10B,B01,083739,Staff,18,0,30,12
1650081852150,MATH 10B,B02,083740,Staff,29,0,30,1
1650081858183,MATH 18,A01,083743,Staff,10,0,30,20
1650081858183,MATH 18,A02,083744,Staff,28,0,30,2
1650081858183,MATH 18,A03,083745,Staff,23,0,30,7
1650081858183,MATH 18,A04,083746,Staff,27,0,30,3
1650081858183,MATH 18,B01,083748,Staff,0,9,30,30
1650081858183,MATH 18,B02,083749,Staff,1,7,30,29
1650081858183,MATH 18,B03,083750,Staff,0,6,30,30
1650081858183,MATH 18,B04,083751,Staff,1,8,30,29
1650081864213,MATH 20A,A01,083754,Staff,26,0,40,14
1650081870239,MATH 20B,A01,083756,Staff,0,6,30,30
1650081870239,MATH 20B,A02,083757,Staff,0,1,30,30
1650081876272,MATH 20C,A01,083760,Staff,0,11,30,30
1650081876272,MATH 20C,A02,083761,Staff,0,12,30,30
1650081876272,MATH 20C,B01,083762,Staff,14,0,30,16
1650081876272,MATH 20C,B02,083763,Staff,28,0,30,2
1650081882311,MATH 20D,A01,083765,Staff,0,2,30,30
1650081882311,MATH 20D,A02,083766,Staff,14,0,30,16
1650081882311,MATH 20D,A03,083767,Staff,28,0,30,2
1650081888335,MATH 20E,A01,083771,Staff,10,0,30,20
1650081888335,MATH 20E,A02,083772,Staff,20,0,30,10
1650081888335,MATH 20E,B01,083773,Staff,2,2,30,28
1650081888335,MATH 20E,B02,083774,Staff,16,0,30,14
1650081894363,MATH 103A,A01,083777,Staff,0,8,30,30
1650081894363,MATH 103A,A02,083778,Staff,0,7,30,30
1650081894363,MATH 103A,B01,083779,Staff,0,8,30,30
1650081894363,MATH 103A,B02,083780,Staff,1,7,30,29
1650081900392,MATH 105,A01,085443,Staff,1,13,30,29
1650081906416,MATH 109,A01,083213,Anzaldo; Leesa B,1,4,30,29
1650081906416,MATH 109,A02,083214,Anzaldo; Leesa B,0,5,30,30
1650081906416,MATH 109,B01,083215,Anzaldo; Leesa B,0,4,30,30
1650081906416,MATH 109,B02,083216,Anzaldo; Leesa B,1,4,30,29
1650081912451,MATH 142A,A01,083219,Chow; Bennett,0,10,30,30
1650081912451,MATH 142A,A02,083220,Chow; Bennett,0,10,30,30
1650081912451,MATH 142A,B01,083221,Chow; Bennett,0,10,30,30
1650081912451,MATH 142A,B02,083222,Chow; Bennett,0,9,30,30
1650081918475,MATH 193A,A01,083224,Staff,0,4,30,30
1650081918475,MATH 193A,A02,083225,Staff,0,4,30,30
1650081918475,MATH 193A,A03,083781,Staff,0,0,30,30
1650081918475,MATH 193A,A04,083782,Staff,4,0,30,26
1650081924498,MATH 197,001,091859,McAuley; Julian John,9998,0,9999,1
1650081930558,COGS 9,A01,083615,Staff,3,17,60,57
1650081936581,COGS 11,A01,083617,Boyle; Mary E. T.,24,0,40,16
1650081942605,COGS 13,A01,083071,Staff,0,29,40,40
1650081948628,COGS 14A,A01,092681,Staff,1,11,100,99
1650081954651,COGS 14B,A01,083073,Cheng; Tzu-Han,0,4,50,50
1650081960675,COGS 17,A01,092677,Staff,35,0,75,40
1650081966698,COGS 100,A01,083619,Staff,0,20,60,60
1650081972724,COGS 101A,A01,083621,Davis; Joshua Daniel,0,17,60,60
1650081978749,COGS 101B,A01,091572,Staff,10,0,60,50
1650081984773,COGS 101C,A01,083625,Delgado; Tania,21,0,30,9
1650081990798,COGS 107A,A01,083627,Boyle; Mary E. T.,1,4,60,59
1650081996832,COGS 118A,A01,083075,Staff,17,0,60,43
1650082002857,CSE 3,A50,083646,Miranda; Gregory Joseph,22,0,38,16
1650082002857,CSE 3,A51,083647,Miranda; Gregory Joseph,37,0,37,0
1650082008883,CSE 8A,A50,083650,Miranda; Gregory Joseph,0,15,40,40
1650082014909,CSE 11,A01,083080,Cao; Yingjun,0,66,40,40
1650082020932,CSE 12,A01,083652,Staff,0,2,100,100
1650082026958,CSE 15L,A01,083654,Staff,0,0,50,50
1650082026958,CSE 15L,A02,083655,Staff,10,0,50,40
1650082032985,CSE 20,A01,083657,Staff,58,0,80,22
1650082039010,CSE 30,A01,083084,Eldon; John,0,63,40,40
1650082045037,CSE 100,A01,083659,Cao; Yingjun,0,60,50,50
1650082051061,CSE 134B,A01,083661,Powell; Thomas Allan,1,28,65,64
1650082057085,CSE 140,A01,083663,Staff,4,0,75,71
1650082063113,CSE 140L,A01,083088,Eldon; John,0,1,75,75
1650082069135,CSE 175,A01,083665,Kumar; Rakesh,9,0,25,16
1650082075168,CSE 190,A00,092507,Dubnov; Shlomo,14,0,20,6
1650082081193,ECE 45,A01,083139,Staff,0,13,40,40
1650082087228,ECE 65,A50,083695,Staff,0,3,30,30
1650082093250,ECE 109,A01,091882,Touri; Behrouz,48,0,70,22
1650082099274,ECE 180,A00,083140,Abi Samra; Nicholas Camill,24,0,30,6
1650082099274,ECE 180,B00,083141,Abi Samra; Nicholas Camill,8,0,30,22
1650082105298,MATH 10A,A01,083735,Patchell; Gregory David,12,0,30,18
1650082105298,MATH 10A,A02,083736,Patchell; Gregory David,28,0,30,2
1650082105298,MATH 10A,A03,083737,Patchell; Gregory David,26,0,30,4
1650082111321,MATH 10B,A01,083207,Staff,0,5,30,30
1650082111321,MATH 10B,A02,083208,Staff,0,4,30,30
1650082111321,MATH 10B,B01,083739,Staff,18,0,30,12
1650082111321,MATH 10B,B02,083740,Staff,29,0,30,1
1650082117349,MATH 18,A01,083743,Staff,10,0,30,20
1650082117349,MATH 18,A02,083744,Staff,28,0,30,2
1650082117349,MATH 18,A03,083745,Staff,23,0,30,7
1650082117349,MATH 18,A04,083746,Staff,27,0,30,3
1650082117349,MATH 18,B01,083748,Staff,0,9,30,30
1650082117349,MATH 18,B02,083749,Staff,1,7,30,29
1650082117349,MATH 18,B03,083750,Staff,0,6,30,30
1650082117349,MATH 18,B04,083751,Staff,1,8,30,29
1650082123376,MATH 20A,A01,083754,Staff,26,0,40,14
1650082129404,MATH 20B,A01,083756,Staff,0,6,30,30
1650082129404,MATH 20B,A02,083757,Staff,0,1,30,30
1650082135431,MATH 20C,A01,083760,Staff,0,11,30,30
1650082135431,MATH 20C,A02,083761,Staff,0,12,30,30
1650082135431,MATH 20C,B01,083762,Staff,14,0,30,16
1650082135431,MATH 20C,B02,083763,Staff,28,0,30,2
1650082141454,MATH 20D,A01,083765,Staff,0,2,30,30
1650082141454,MATH 20D,A02,083766,Staff,14,0,30,16
1650082141454,MATH 20D,A03,083767,Staff,28,0,30,2
1650082147477,MATH 20E,A01,083771,Staff,10,0,30,20
1650082147477,MATH 20E,A02,083772,Staff,20,0,30,10
1650082147477,MATH 20E,B01,083773,Staff,2,2,30,28
1650082147477,MATH 20E,B02,083774,Staff,16,0,30,14
1650082153502,MATH 103A,A01,083777,Staff,0,8,30,30
1650082153502,MATH 103A,A02,083778,Staff,0,7,30,30
1650082153502,MATH 103A,B01,083779,Staff,0,8,30,30
1650082153502,MATH 103A,B02,083780,Staff,1,7,30,29
1650082159526,MATH 105,A01,085443,Staff,1,13,30,29
1650082165560,MATH 109,A01,083213,Anzaldo; Leesa B,1,4,30,29
1650082165560,MATH 109,A02,083214,Anzaldo; Leesa B,0,5,30,30
1650082165560,MATH 109,B01,083215,Anzaldo; Leesa B,0,4,30,30
1650082165560,MATH 109,B02,083216,Anzaldo; Leesa B,1,4,30,29
1650082171592,MATH 142A,A01,083219,Chow; Bennett,0,10,30,30
1650082171592,MATH 142A,A02,083220,Chow; Bennett,0,10,30,30
1650082171592,MATH 142A,B01,083221,Chow; Bennett,0,10,30,30
1650082171592,MATH 142A,B02,083222,Chow; Bennett,0,9,30,30
1650082177616,MATH 193A,A01,083224,Staff,0,4,30,30
1650082177616,MATH 193A,A02,083225,Staff,0,4,30,30
1650082177616,MATH 193A,A03,083781,Staff,0,0,30,30
1650082177616,MATH 193A,A04,083782,Staff,4,0,30,26
1650082183641,MATH 197,001,091859,McAuley; Julian John,9998,0,9999,1
1650082189699,COGS 9,A01,083615,Staff,3,17,60,57
1650082195728,COGS 11,A01,083617,Boyle; Mary E. T.,24,0,40,16
1650082201850,COGS 13,A01,083071,Staff,0,29,40,40
1650082207878,COGS 14A,A01,092681,Staff,1,11,100,99
1650082213912,COGS 14B,A01,083073,Cheng; Tzu-Han,0,4,50,50
1650082219940,COGS 17,A01,092677,Staff,35,0,75,40
1650082225969,COGS 100,A01,083619,Staff,0,20,60,60
1650082232003,COGS 101A,A01,083621,Davis; Joshua Daniel,0,17,60,60
1650082238026,COGS 101B,A01,091572,Staff,10,0,60,50
1650082244049,COGS 101C,A01,083625,Delgado; Tania,21,0,30,9
1650082250072,COGS 107A,A01,083627,Boyle; Mary E. T.,1,4,60,59
1650082256096,COGS 118A,A01,083075,Staff,17,0,60,43
1650082262121,CSE 3,A50,083646,Miranda; Gregory Joseph,22,0,38,16
1650082262121,CSE 3,A51,083647,Miranda; Gregory Joseph,37,0,37,0
1650082268147,CSE 8A,A50,083650,Miranda; Gregory Joseph,0,15,40,40
1650082274175,CSE 11,A01,083080,Cao; Yingjun,0,66,40,40
1650082280198,CSE 12,A01,083652,Staff,0,2,100,100
1650082286225,CSE 15L,A01,083654,Staff,0,0,50,50
1650082286225,CSE 15L,A02,083655,Staff,10,0,50,40
1650082292251,CSE 20,A01,083657,Staff,58,0,80,22
1650082298273,CSE 30,A01,083084,Eldon; John,0,63,40,40
1650082304296,CSE 100,A01,083659,Cao; Yingjun,0,60,50,50
1650082310319,CSE 134B,A01,083661,Powell; Thomas Allan,1,28,65,64
1650082316356,CSE 140,A01,083663,Staff,4,0,75,71
1650082322384,CSE 140L,A01,083088,Eldon; John,0,1,75,75
1650082328411,CSE 175,A01,083665,Kumar; Rakesh,9,0,25,16
1650082334442,CSE 190,A00,092507,Dubnov; Shlomo,14,0,20,6
1650082340465,ECE 45,A01,083139,Staff,0,13,40,40
1650082346493,ECE 65,A50,083695,Staff,0,3,30,30
1650082352517,ECE 109,A01,091882,Touri; Behrouz,48,0,70,22
1650082358547,ECE 180,A00,083140,Abi Samra; Nicholas Camill,24,0,30,6
1650082358547,ECE 180,B00,083141,Abi Samra; Nicholas Camill,8,0,30,22
1650082364580,MATH 10A,A01,083735,Patchell; Gregory David,12,0,30,18
1650082364580,MATH 10A,A02,083736,Patchell; Gregory David,28,0,30,2
1650082364580,MATH 10A,A03,083737,Patchell; Gregory David,26,0,30,4
1650082370608,MATH 10B,A01,083207,Staff,0,5,30,30
1650082370608,MATH 10B,A02,083208,Staff,0,4,30,30
1650082370608,MATH 10B,B01,083739,Staff,18,0,30,12
1650082370608,MATH 10B,B02,083740,Staff,29,0,30,1
1650082376636,MATH 18,A01,083743,Staff,10,0,30,20
1650082376636,MATH 18,A02,083744,Staff,28,0,30,2
1650082376636,MATH 18,A03,083745,Staff,23,0,30,7
1650082376636,MATH 18,A04,083746,Staff,27,0,30,3
1650082376636,MATH 18,B01,083748,Staff,0,9,30,30
1650082376636,MATH 18,B02,083749,Staff,1,7,30,29
1650082376636,MATH 18,B03,083750,Staff,0,6,30,30
1650082376636,MATH 18,B04,083751,Staff,1,8,30,29
1650082382663,MATH 20A,A01,083754,Staff,26,0,40,14
1650082388685,MATH 20B,A01,083756,Staff,0,6,30,30
1650082388685,MATH 20B,A02,083757,Staff,0,1,30,30
1650082394709,MATH 20C,A01,083760,Staff,0,11,30,30
1650082394709,MATH 20C,A02,083761,Staff,0,12,30,30
1650082394709,MATH 20C,B01,083762,Staff,14,0,30,16
1650082394709,MATH 20C,B02,083763,Staff,28,0,30,2
1650082400737,MATH 20D,A01,083765,Staff,0,2,30,30
1650082400737,MATH 20D,A02,083766,Staff,14,0,30,16
1650082400737,MATH 20D,A03,083767,Staff,28,0,30,2
1650082406761,MATH 20E,A01,083771,Staff,10,0,30,20
1650082406761,MATH 20E,A02,083772,Staff,20,0,30,10
1650082406761,MATH 20E,B01,083773,Staff,2,2,30,28
1650082406761,MATH 20E,B02,083774,Staff,16,0,30,14
1650082412785,MATH 103A,A01,083777,Staff,0,8,30,30
1650082412785,MATH 103A,A02,083778,Staff,0,7,30,30
1650082412785,MATH 103A,B01,083779,Staff,0,8,30,30
1650082412785,MATH 103A,B02,083780,Staff,1,7,30,29
1650082418810,MATH 105,A01,085443,Staff,1,13,30,29
1650082424834,MATH 109,A01,083213,Anzaldo; Leesa B,1,4,30,29
1650082424834,MATH 109,A02,083214,Anzaldo; Leesa B,0,5,30,30
1650082424834,MATH 109,B01,083215,Anzaldo; Leesa B,0,4,30,30
1650082424834,MATH 109,B02,083216,Anzaldo; Leesa B,1,4,30,29
1650082430859,MATH 142A,A01,083219,Chow; Bennett,0,10,30,30
1650082430859,MATH 142A,A02,083220,Chow; Bennett,0,10,30,30
1650082430859,MATH 142A,B01,083221,Chow; Bennett,0,10,30,30
1650082430859,MATH 142A,B02,083222,Chow; Bennett,0,9,30,30
1650082436882,MATH 193A,A01,083224,Staff,0,4,30,30
1650082436882,MATH 193A,A02,083225,Staff,0,4,30,30
1650082436882,MATH 193A,A03,083781,Staff,0,0,30,30
1650082436882,MATH 193A,A04,083782,Staff,4,0,30,26
1650082442905,MATH 197,001,091859,McAuley; Julian John,9998,0,9999,1
1650082448968,COGS 9,A01,083615,Staff,3,17,60,57
1650082454992,COGS 11,A01,083617,Boyle; Mary E. T.,24,0,40,16
1650082461016,COGS 13,A01,083071,Staff,0,29,40,40
1650082467040,COGS 14A,A01,092681,Staff,1,11,100,99
1650082473062,COGS 14B,A01,083073,Cheng; Tzu-Han,0,4,50,50
1650082479087,COGS 17,A01,092677,Staff,35,0,75,40
1650082485110,COGS 100,A01,083619,Staff,0,20,60,60
1650082491133,COGS 101A,A01,083621,Davis; Joshua Daniel,0,17,60,60
1650082497164,COGS 101B,A01,091572,Staff,10,0,60,50
1650082503189,COGS 101C,A01,083625,Delgado; Tania,21,0,30,9
1650082509218,COGS 107A,A01,083627,Boyle; Mary E. T.,1,4,60,59
1650082515241,COGS 118A,A01,083075,Staff,17,0,60,43
1650082521269,CSE 3,A50,083646,Miranda; Gregory Joseph,22,0,38,16
1650082521269,CSE 3,A51,083647,Miranda; Gregory Joseph,37,0,37,0
1650082527292,CSE 8A,A50,083650,Miranda; Gregory Joseph,0,15,40,40
1650082533318,CSE 11,A01,083080,Cao; Yingjun,0,66,40,40
1650082539342,CSE 12,A01,083652,Staff,0,2,100,100
1650082545367,CSE 15L,A01,083654,Staff,0,0,50,50
1650082545367,CSE 15L,A02,083655,Staff,10,0,50,40
1650082551396,CSE 20,A01,083657,Staff,58,0,80,22
1650082557420,CSE 30,A01,083084,Eldon; John,0,63,40,40
1650082563458,CSE 100,A01,083659,Cao; Yingjun,0,60,50,50
1650082569482,CSE 134B,A01,083661,Powell; Thomas Allan,1,28,65,64
1650082575506,CSE 140,A01,083663,Staff,4,0,75,71
1650082581532,CSE 140L,A01,083088,Eldon; John,0,1,75,75
1650082587558,CSE 175,A01,083665,Kumar; Rakesh,9,0,25,16
1650082593582,CSE 190,A00,092507,Dubnov; Shlomo,14,0,20,6
1650082599606,ECE 45,A01,083139,Staff,0,13,40,40
1650082605635,ECE 65,A50,083695,Staff,0,3,30,30
1650082611663,ECE 109,A01,091882,Touri; Behrouz,48,0,70,22
1650082617692,ECE 180,A00,083140,Abi Samra; Nicholas Camill,24,0,30,6
1650082617692,ECE 180,B00,083141,Abi Samra; Nicholas Camill,8,0,30,22
1650082623716,MATH 10A,A01,083735,Patchell; Gregory David,12,0,30,18
1650082623716,MATH 10A,A02,083736,Patchell; Gregory David,28,0,30,2
1650082623716,MATH 10A,A03,083737,Patchell; Gregory David,26,0,30,4
1650082629739,MATH 10B,A01,083207,Staff,0,5,30,30
1650082629739,MATH 10B,A02,083208,Staff,0,4,30,30
1650082629739,MATH 10B,B01,083739,Staff,18,0,30,12
1650082629739,MATH 10B,B02,083740,Staff,29,0,30,1
1650082635766,MATH 18,A01,083743,Staff,10,0,30,20
1650082635766,MATH 18,A02,083744,Staff,28,0,30,2
1650082635766,MATH 18,A03,083745,Staff,23,0,30,7
1650082635766,MATH 18,A04,083746,Staff,27,0,30,3
1650082635766,MATH 18,B01,083748,Staff,0,9,30,30
1650082635766,MATH 18,B02,083749,Staff,1,7,30,29
1650082635766,MATH 18,B03,083750,Staff,0,6,30,30
1650082635766,MATH 18,B04,083751,Staff,1,8,30,29
1650082641792,MATH 20A,A01,083754,Staff,26,0,40,14
1650082647816,MATH 20B,A01,083756,Staff,0,6,30,30
1650082647816,MATH 20B,A02,083757,Staff,0,1,30,30
1650082653843,MATH 20C,A01,083760,Staff,0,11,30,30
1650082653843,MATH 20C,A02,083761,Staff,0,12,30,30
1650082653843,MATH 20C,B01,083762,Staff,14,0,30,16
1650082653843,MATH 20C,B02,083763,Staff,28,0,30,2
1650082659870,MATH 20D,A01,083765,Staff,0,2,30,30
1650082659870,MATH 20D,A02,083766,Staff,14,0,30,16
1650082659870,MATH 20D,A03,083767,Staff,28,0,30,2
1650082665903,MATH 20E,A01,083771,Staff,10,0,30,20
1650082665903,MATH 20E,A02,083772,Staff,20,0,30,10
1650082665903,MATH 20E,B01,083773,Staff,2,2,30,28
1650082665903,MATH 20E,B02,083774,Staff,16,0,30,14
1650082671930,MATH 103A,A01,083777,Staff,0,8,30,30
1650082671930,MATH 103A,A02,083778,Staff,0,7,30,30
1650082671930,MATH 103A,B01,083779,Staff,0,8,30,30
1650082671930,MATH 103A,B02,083780,Staff,1,7,30,29
1650082677953,MATH 105,A01,085443,Staff,1,13,30,29
1650082683984,MATH 109,A01,083213,Anzaldo; Leesa B,1,4,30,29
1650082683984,MATH 109,A02,083214,Anzaldo; Leesa B,0,5,30,30
1650082683984,MATH 109,B01,083215,Anzaldo; Leesa B,0,4,30,30
1650082683984,MATH 109,B02,083216,Anzaldo; Leesa B,1,4,30,29
1650082690011,MATH 142A,A01,083219,Chow; Bennett,0,10,30,30
1650082690011,MATH 142A,A02,083220,Chow; Bennett,0,10,30,30
1650082690011,MATH 142A,B01,083221,Chow; Bennett,0,10,30,30
1650082690011,MATH 142A,B02,083222,Chow; Bennett,0,9,30,30
1650082696037,MATH 193A,A01,083224,Staff,0,4,30,30
1650082696037,MATH 193A,A02,083225,Staff,0,4,30,30
1650082696037,MATH 193A,A03,083781,Staff,0,0,30,30
1650082696037,MATH 193A,A04,083782,Staff,4,0,30,26
1650082702068,MATH 197,001,091859,McAuley; Julian John,9998,0,9999,1
1650082708118,COGS 9,A01,083615,Staff,3,17,60,57
1650082714142,COGS 11,A01,083617,Boyle; Mary E. T.,24,0,40,16
1650082720166,COGS 13,A01,083071,Staff,0,29,40,40
1650082726192,COGS 14A,A01,092681,Staff,1,11,100,99
1650082732219,COGS 14B,A01,083073,Cheng; Tzu-Han,0,4,50,50
1650082738241,COGS 17,A01,092677,Staff,35,0,75,40
1650082744264,COGS 100,A01,083619,Staff,0,20,60,60
1650082750287,COGS 101A,A01,083621,Davis; Joshua Daniel,0,17,60,60
1650082756310,COGS 101B,A01,091572,Staff,10,0,60,50
1650082762342,COGS 101C,A01,083625,Delgado; Tania,21,0,30,9
1650082768370,COGS 107A,A01,083627,Boyle; Mary E. T.,1,4,60,59
1650082774394,COGS 118A,A01,083075,Staff,17,0,60,43
1650082780419,CSE 3,A50,083646,Miranda; Gregory Joseph,22,0,38,16
1650082780419,CSE 3,A51,083647,Miranda; Gregory Joseph,37,0,37,0
1650082786444,CSE 8A,A50,083650,Miranda; Gregory Joseph,0,15,40,40
1650082792469,CSE 11,A01,083080,Cao; Yingjun,0,66,40,40
1650082798585,CSE 12,A01,083652,Staff,0,2,100,100
1650082804609,CSE 15L,A01,083654,Staff,0,0,50,50
1650082804609,CSE 15L,A02,083655,Staff,10,0,50,40
1650082810634,CSE 20,A01,083657,Staff,58,0,80,22
1650082816665,CSE 30,A01,083084,Eldon; John,0,63,40,40
1650082822689,CSE 100,A01,083659,Cao; Yingjun,0,60,50,50
1650082828716,CSE 134B,A01,083661,Powell; Thomas Allan,1,28,65,64
1650082834738,CSE 140,A01,083663,Staff,4,0,75,71
1650082840762,CSE 140L,A01,083088,Eldon; John,0,1,75,75
1650082846797,CSE 175,A01,083665,Kumar; Rakesh,9,0,25,16
1650082852822,CSE 190,A00,092507,Dubnov; Shlomo,14,0,20,6
1650082858849,ECE 45,A01,083139,Staff,0,13,40,40
1650082864880,ECE 65,A50,083695,Staff,0,3,30,30
1650082870904,ECE 109,A01,091882,Touri; Behrouz,48,0,70,22
1650082876933,ECE 180,A00,083140,Abi Samra; Nicholas Camill,24,0,30,6
1650082876933,ECE 180,B00,083141,Abi Samra; Nicholas Camill,8,0,30,22
1650082882959,MATH 10A,A01,083735,Patchell; Gregory David,12,0,30,18
1650082882959,MATH 10A,A02,083736,Patchell; Gregory David,28,0,30,2
1650082882959,MATH 10A,A03,083737,Patchell; Gregory David,26,0,30,4
1650082888987,MATH 10B,A01,083207,Staff,0,5,30,30
1650082888987,MATH 10B,A02,083208,Staff,0,4,30,30
1650082888987,MATH 10B,B01,083739,Staff,18,0,30,12
1650082888987,MATH 10B,B02,083740,Staff,29,0,30,1
1650082895013,MATH 18,A01,083743,Staff,10,0,30,20
1650082895013,MATH 18,A02,083744,Staff,28,0,30,2
1650082895013,MATH 18,A03,083745,Staff,23,0,30,7
1650082895013,MATH 18,A04,083746,Staff,27,0,30,3
1650082895013,MATH 18,B01,083748,Staff,0,9,30,30
1650082895013,MATH 18,B02,083749,Staff,1,7,30,29
1650082895013,MATH 18,B03,083750,Staff,0,6,30,30
1650082895013,MATH 18,B04,083751,Staff,1,8,30,29
1650082901040,MATH 20A,A01,083754,Staff,26,0,40,14
1650082907063,MATH 20B,A01,083756,Staff,0,6,30,30
1650082907063,MATH 20B,A02,083757,Staff,0,1,30,30
1650082913092,MATH 20C,A01,083760,Staff,0,11,30,30
1650082913092,MATH 20C,A02,083761,Staff,0,12,30,30
1650082913092,MATH 20C,B01,083762,Staff,14,0,30,16
1650082913092,MATH 20C,B02,083763,Staff,28,0,30,2
1650082919131,MATH 20D,A01,083765,Staff,0,2,30,30
1650082919131,MATH 20D,A02,083766,Staff,14,0,30,16
1650082919131,MATH 20D,A03,083767,Staff,28,0,30,2
1650082925156,MATH 20E,A01,083771,Staff,10,0,30,20
1650082925156,MATH 20E,A02,083772,Staff,20,0,30,10
1650082925156,MATH 20E,B01,083773,Staff,2,2,30,28
1650082925156,MATH 20E,B02,083774,Staff,16,0,30,14
1650082931183,MATH 103A,A01,083777,Staff,0,8,30,30
1650082931183,MATH 103A,A02,083778,Staff,0,7,30,30
1650082931183,MATH 103A,B01,083779,Staff,0,8,30,30
1650082931183,MATH 103A,B02,083780,Staff,1,7,30,29
1650082937206,MATH 105,A01,085443,Staff,1,13,30,29
1650082943233,MATH 109,A01,083213,Anzaldo; Leesa B,1,4,30,29
1650082943233,MATH 109,A02,083214,Anzaldo; Leesa B,0,5,30,30
1650082943233,MATH 109,B01,083215,Anzaldo; Leesa B,0,4,30,30
1650082943233,MATH 109,B02,083216,Anzaldo; Leesa B,1,4,30,29
1650082949255,MATH 142A,A01,083219,Chow; Bennett,0,10,30,30
1650082949255,MATH 142A,A02,083220,Chow; Bennett,0,10,30,30
1650082949255,MATH 142A,B01,083221,Chow; Bennett,0,10,30,30
1650082949255,MATH 142A,B02,083222,Chow; Bennett,0,9,30,30
1650082955277,MATH 193A,A01,083224,Staff,0,4,30,30
1650082955277,MATH 193A,A02,083225,Staff,0,4,30,30
1650082955277,MATH 193A,A03,083781,Staff,0,0,30,30
1650082955277,MATH 193A,A04,083782,Staff,3,0,30,27
1650082961307,MATH 197,001,091859,McAuley; Julian John,9998,0,9999,1
1650082967359,COGS 9,A01,083615,Staff,3,17,60,57
1650082973391,COGS 11,A01,083617,Boyle; Mary E. T.,24,0,40,16
1650082979415,COGS 13,A01,083071,Staff,0,29,40,40
1650082985444,COGS 14A,A01,092681,Staff,1,11,100,99
1650082991470,COGS 14B,A01,083073,Cheng; Tzu-Han,0,4,50,50
1650082997502,COGS 17,A01,092677,Staff,35,0,75,40
1650083003529,COGS 100,A01,083619,Staff,0,20,60,60
1650083009566,COGS 101A,A01,083621,Davis; Joshua Daniel,0,17,60,60
1650083015590,COGS 101B,A01,091572,Staff,10,0,60,50
1650083021618,COGS 101C,A01,083625,Delgado; Tania,21,0,30,9
1650083027643,COGS 107A,A01,083627,Boyle; Mary E. T.,1,4,60,59
1650083033670,COGS 118A,A01,083075,Staff,17,0,60,43
1650083039697,CSE 3,A50,083646,Miranda; Gregory Joseph,22,0,38,16
1650083039697,CSE 3,A51,083647,Miranda; Gregory Joseph,37,0,37,0
1650083045721,CSE 8A,A50,083650,Miranda; Gregory Joseph,0,15,40,40
1650083051748,CSE 11,A01,083080,Cao; Yingjun,0,66,40,40
1650083057775,CSE 12,A01,083652,Staff,0,2,100,100
1650083063808,CSE 15L,A01,083654,Staff,0,0,50,50
1650083063808,CSE 15L,A02,083655,Staff,10,0,50,40
1650083069832,CSE 20,A01,083657,Staff,58,0,80,22
1650083075855,CSE 30,A01,083084,Eldon; John,0,63,40,40
1650083081879,CSE 100,A01,083659,Cao; Yingjun,0,60,50,50
1650083087906,CSE 134B,A01,083661,Powell; Thomas Allan,1,28,65,64
1650083093932,CSE 140,A01,083663,Staff,4,0,75,71
1650083099956,CSE 140L,A01,083088,Eldon; John,0,1,75,75
1650083105980,CSE 175,A01,083665,Kumar; Rakesh,9,0,25,16
1650083112008,CSE 190,A00,092507,Dubnov; Shlomo,14,0,20,6
1650083118031,ECE 45,A01,083139,Staff,0,13,40,40
1650083124054,ECE 65,A50,083695,Staff,0,3,30,30
1650083130079,ECE 109,A01,091882,Touri; Behrouz,48,0,70,22
1650083136104,ECE 180,A00,083140,Abi Samra; Nicholas Camill,24,0,30,6
1650083136104,ECE 180,B00,083141,Abi Samra; Nicholas Camill,8,0,30,22
1650083142130,MATH 10A,A01,083735,Patchell; Gregory David,12,0,30,18
1650083142130,MATH 10A,A02,083736,Patchell; Gregory David,28,0,30,2
1650083142130,MATH 10A,A03,083737,Patchell; Gregory David,26,0,30,4
1650083148159,MATH 10B,A01,083207,Staff,0,5,30,30
1650083148159,MATH 10B,A02,083208,Staff,0,4,30,30
1650083148159,MATH 10B,B01,083739,Staff,18,0,30,12
1650083148159,MATH 10B,B02,083740,Staff,29,0,30,1
1650083154194,MATH 18,A01,083743,Staff,10,0,30,20
1650083154194,MATH 18,A02,083744,Staff,28,0,30,2
1650083154194,MATH 18,A03,083745,Staff,23,0,30,7
1650083154194,MATH 18,A04,083746,Staff,27,0,30,3
1650083154194,MATH 18,B01,083748,Staff,0,9,30,30
1650083154194,MATH 18,B02,083749,Staff,1,7,30,29
1650083154194,MATH 18,B03,083750,Staff,0,6,30,30
1650083154194,MATH 18,B04,083751,Staff,1,8,30,29
1650083160227,MATH 20A,A01,083754,Staff,26,0,40,14
1650083166256,MATH 20B,A01,083756,Staff,0,6,30,30
1650083166256,MATH 20B,A02,083757,Staff,0,1,30,30
1650083172278,MATH 20C,A01,083760,Staff,0,11,30,30
1650083172278,MATH 20C,A02,083761,Staff,0,12,30,30
1650083172278,MATH 20C,B01,083762,Staff,14,0,30,16
1650083172278,MATH 20C,B02,083763,Staff,28,0,30,2
1650083178302,MATH 20D,A01,083765,Staff,0,2,30,30
1650083178302,MATH 20D,A02,083766,Staff,14,0,30,16
1650083178302,MATH 20D,A03,083767,Staff,28,0,30,2
1650083184337,MATH 20E,A01,083771,Staff,10,0,30,20
1650083184337,MATH 20E,A02,083772,Staff,20,0,30,10
1650083184337,MATH 20E,B01,083773,Staff,2,2,30,28
1650083184337,MATH 20E,B02,083774,Staff,16,0,30,14
1650083190367,MATH 103A,A01,083777,Staff,0,8,30,30
1650083190367,MATH 103A,A02,083778,Staff,0,7,30,30
1650083190367,MATH 103A,B01,083779,Staff,0,8,30,30
1650083190367,MATH 103A,B02,083780,Staff,1,7,30,29
1650083196394,MATH 105,A01,085443,Staff,1,13,30,29
1650083202418,MATH 109,A01,083213,Anzaldo; Leesa B,1,4,30,29
1650083202418,MATH 109,A02,083214,Anzaldo; Leesa B,0,5,30,30
1650083202418,MATH 109,B01,083215,Anzaldo; Leesa B,0,4,30,30
1650083202418,MATH 109,B02,083216,Anzaldo; Leesa B,1,4,30,29
1650083208448,MATH 142A,A01,083219,Chow; Bennett,0,10,30,30
1650083208448,MATH 142A,A02,083220,Chow; Bennett,0,10,30,30
1650083208448,MATH 142A,B01,083221,Chow; Bennett,0,10,30,30
1650083208448,MATH 142A,B02,083222,Chow; Bennett,0,9,30,30
1650083214471,MATH 193A,A01,083224,Staff,0,4,30,30
1650083214471,MATH 193A,A02,083225,Staff,0,4,30,30
1650083214471,MATH 193A,A03,083781,Staff,0,0,30,30
1650083214471,MATH 193A,A04,083782,Staff,3,0,30,27
1650083220502,MATH 197,001,091859,McAuley; Julian John,9998,0,9999,1
1650083226557,COGS 9,A01,083615,Staff,3,17,60,57
1650083232581,COGS 11,A01,083617,Boyle; Mary E. T.,24,0,40,16
1650083238605,COGS 13,A01,083071,Staff,0,29,40,40
1650083244635,COGS 14A,A01,092681,Staff,1,11,100,99
1650083250659,COGS 14B,A01,083073,Cheng; Tzu-Han,0,4,50,50
1650083256680,COGS 17,A01,092677,Staff,35,0,75,40
1650083262709,COGS 100,A01,083619,Staff,0,20,60,60
1650083268730,COGS 101A,A01,083621,Davis; Joshua Daniel,0,17,60,60
1650083274753,COGS 101B,A01,091572,Staff,10,0,60,50
1650083280774,COGS 101C,A01,083625,Delgado; Tania,21,0,30,9
1650083286799,COGS 107A,A01,083627,Boyle; Mary E. T.,1,4,60,59
1650083292822,COGS 118A,A01,083075,Staff,17,0,60,43
1650083298851,CSE 3,A50,083646,Miranda; Gregory Joseph,22,0,38,16
1650083298851,CSE 3,A51,083647,Miranda; Gregory Joseph,37,0,37,0
1650083304875,CSE 8A,A50,083650,Miranda; Gregory Joseph,0,15,40,40
1650083310898,CSE 11,A01,083080,Cao; Yingjun,0,66,40,40
1650083316922,CSE 12,A01,083652,Staff,0,2,100,100
1650083322946,CSE 15L,A01,083654,Staff,0,0,50,50
1650083322946,CSE 15L,A02,083655,Staff,10,0,50,40
1650083328969,CSE 20,A01,083657,Staff,58,0,80,22
1650083334992,CSE 30,A01,083084,Eldon; John,0,63,40,40
1650083341022,CSE 100,A01,083659,Cao; Yingjun,0,60,50,50
1650083347046,CSE 134B,A01,083661,Powell; Thomas Allan,1,28,65,64
1650083353072,CSE 140,A01,083663,Staff,4,0,75,71
1650083359095,CSE 140L,A01,083088,Eldon; John,0,1,75,75
1650083365122,CSE 175,A01,083665,Kumar; Rakesh,9,0,25,16
1650083371146,CSE 190,A00,092507,Dubnov; Shlomo,14,0,20,6
1650083377169,ECE 45,A01,083139,Staff,0,13,40,40
1650083383196,ECE 65,A50,083695,Staff,0,3,30,30
1650083389221,ECE 109,A01,091882,Touri; Behrouz,48,0,70,22
1650083395343,ECE 180,A00,083140,Abi Samra; Nicholas Camill,24,0,30,6
1650083395343,ECE 180,B00,083141,Abi Samra; Nicholas Camill,8,0,30,22
1650083401368,MATH 10A,A01,083735,Patchell; Gregory David,12,0,30,18
1650083401368,MATH 10A,A02,083736,Patchell; Gregory David,28,0,30,2
1650083401368,MATH 10A,A03,083737,Patchell; Gregory David,26,0,30,4
1650083407391,MATH 10B,A01,083207,Staff,0,5,30,30
1650083407391,MATH 10B,A02,083208,Staff,0,4,30,30
1650083407391,MATH 10B,B01,083739,Staff,18,0,30,12
1650083407391,MATH 10B,B02,083740,Staff,29,0,30,1
1650083413422,MATH 18,A01,083743,Staff,10,0,30,20
1650083413422,MATH 18,A02,083744,Staff,28,0,30,2
1650083413422,MATH 18,A03,083745,Staff,23,0,30,7
1650083413422,MATH 18,A04,083746,Staff,27,0,30,3
1650083413422,MATH 18,B01,083748,Staff,0,9,30,30
1650083413422,MATH 18,B02,083749,Staff,1,7,30,29
1650083413422,MATH 18,B03,083750,Staff,0,6,30,30
1650083413422,MATH 18,B04,083751,Staff,1,8,30,29
1650083419447,MATH 20A,A01,083754,Staff,26,0,40,14
1650083425476,MATH 20B,A01,083756,Staff,0,6,30,30
1650083425476,MATH 20B,A02,083757,Staff,0,1,30,30
1650083431501,MATH 20C,A01,083760,Staff,0,11,30,30
1650083431501,MATH 20C,A02,083761,Staff,0,12,30,30
1650083431501,MATH 20C,B01,083762,Staff,14,0,30,16
1650083431501,MATH 20C,B02,083763,Staff,28,0,30,2
1650083437528,MATH 20D,A01,083765,Staff,0,2,30,30
1650083437528,MATH 20D,A02,083766,Staff,14,0,30,16
1650083437528,MATH 20D,A03,083767,Staff,28,0,30,2
1650083443557,MATH 20E,A01,083771,Staff,10,0,30,20
1650083443557,MATH 20E,A02,083772,Staff,20,0,30,10
1650083443557,MATH 20E,B01,083773,Staff,2,2,30,28
1650083443557,MATH 20E,B02,083774,Staff,16,0,30,14
1650083449582,MATH 103A,A01,083777,Staff,0,8,30,30
1650083449582,MATH 103A,A02,083778,Staff,0,7,30,30
1650083449582,MATH 103A,B01,083779,Staff,0,8,30,30
1650083449582,MATH 103A,B02,083780,Staff,1,7,30,29
1650083455608,MATH 105,A01,085443,Staff,1,13,30,29
1650083461632,MATH 109,A01,083213,Anzaldo; Leesa B,1,4,30,29
1650083461632,MATH 109,A02,083214,Anzaldo; Leesa B,0,5,30,30
1650083461632,MATH 109,B01,083215,Anzaldo; Leesa B,0,4,30,30
1650083461632,MATH 109,B02,083216,Anzaldo; Leesa B,1,4,30,29
1650083467657,MATH 142A,A01,083219,Chow; Bennett,0,10,30,30
1650083467657,MATH 142A,A02,083220,Chow; Bennett,0,10,30,30
1650083467657,MATH 142A,B01,083221,Chow; Bennett,0,10,30,30
1650083467657,MATH 142A,B02,083222,Chow; Bennett,0,9,30,30
1650083473693,MATH 193A,A01,083224,Staff,0,4,30,30
1650083473693,MATH 193A,A02,083225,Staff,0,4,30,30
1650083473693,MATH 193A,A03,083781,Staff,0,0,30,30
1650083473693,MATH 193A,A04,083782,Staff,3,0,30,27
1650083479763,MATH 197,001,091859,McAuley; Julian John,9998,0,9999,1
1650083485819,COGS 9,A01,083615,Staff,3,17,60,57
1650083491854,COGS 11,A01,083617,Boyle; Mary E. T.,24,0,40,16
1650083497889,COGS 13,A01,083071,Staff,0,29,40,40
1650083503913,COGS 14A,A01,092681,Staff,1,11,100,99
1650083509942,COGS 14B,A01,083073,Cheng; Tzu-Han,0,4,50,50
1650083515974,COGS 17,A01,092677,Staff,35,0,75,40
1650083522006,COGS 100,A01,083619,Staff,0,20,60,60
1650083528035,COGS 101A,A01,083621,Davis; Joshua Daniel,0,17,60,60
1650083534072,COGS 101B,A01,091572,Staff,10,0,60,50
1650083540096,COGS 101C,A01,083625,Delgado; Tania,21,0,30,9
1650083546119,COGS 107A,A01,083627,Boyle; Mary E. T.,1,4,60,59
1650083552146,COGS 118A,A01,083075,Staff,17,0,60,43
1650083558169,CSE 3,A50,083646,Miranda; Gregory Joseph,22,0,38,16
1650083558169,CSE 3,A51,083647,Miranda; Gregory Joseph,37,0,37,0
1650083564190,CSE 8A,A50,083650,Miranda; Gregory Joseph,0,15,40,40
1650083570232,CSE 11,A01,083080,Cao; Yingjun,0,66,40,40
1650083576291,CSE 12,A01,083652,Staff,0,2,100,100
1650083582314,CSE 15L,A01,083654,Staff,0,0,50,50
1650083582314,CSE 15L,A02,083655,Staff,10,0,50,40
1650083588337,CSE 20,A01,083657,Staff,58,0,80,22
1650083594366,CSE 30,A01,083084,Eldon; John,0,63,40,40
1650083600393,CSE 100,A01,083659,Cao; Yingjun,0,60,50,50
1650083606421,CSE 134B,A01,083661,Powell; Thomas Allan,1,28,65,64
1650083612444,CSE 140,A01,083663,Staff,4,0,75,71
1650083618467,CSE 140L,A01,083088,Eldon; John,0,1,75,75
1650083624499,CSE 175,A01,083665,Kumar; Rakesh,9,0,25,16
1650083630527,CSE 190,A00,092507,Dubnov; Shlomo,14,0,20,6
1650083636564,ECE 45,A01,083139,Staff,0,13,40,40
1650083642588,ECE 65,A50,083695,Staff,0,3,30,30
1650083648611,ECE 109,A01,091882,Touri; Behrouz,48,0,70,22
1650083654636,ECE 180,A00,083140,Abi Samra; Nicholas Camill,24,0,30,6
1650083654636,ECE 180,B00,083141,Abi Samra; Nicholas Camill,8,0,30,22
1650083660662,MATH 10A,A01,083735,Patchell; Gregory David,12,0,30,18
1650083660662,MATH 10A,A02,083736,Patchell; Gregory David,28,0,30,2
1650083660662,MATH 10A,A03,083737,Patchell; Gregory David,26,0,30,4
1650083666688,MATH 10B,A01,083207,Staff,0,5,30,30
1650083666688,MATH 10B,A02,083208,Staff,0,4,30,30
1650083666688,MATH 10B,B01,083739,Staff,18,0,30,12
1650083666688,MATH 10B,B02,083740,Staff,29,0,30,1
1650083672787,MATH 18,A01,083743,Staff,10,0,30,20
1650083672787,MATH 18,A02,083744,Staff,28,0,30,2
1650083672787,MATH 18,A03,083745,Staff,23,0,30,7
1650083672787,MATH 18,A04,083746,Staff,27,0,30,3
1650083672787,MATH 18,B01,083748,Staff,0,9,30,30
1650083672787,MATH 18,B02,083749,Staff,1,7,30,29
1650083672787,MATH 18,B03,083750,Staff,0,6,30,30
1650083672787,MATH 18,B04,083751,Staff,1,8,30,29
1650083678811,MATH 20A,A01,083754,Staff,26,0,40,14
1650083684839,MATH 20B,A01,083756,Staff,0,6,30,30
1650083684839,MATH 20B,A02,083757,Staff,0,1,30,30
1650083690863,MATH 20C,A01,083760,Staff,0,11,30,30
1650083690863,MATH 20C,A02,083761,Staff,0,12,30,30
1650083690863,MATH 20C,B01,083762,Staff,14,0,30,16
1650083690863,MATH 20C,B02,083763,Staff,28,0,30,2
1650083696887,MATH 20D,A01,083765,Staff,0,2,30,30
1650083696887,MATH 20D,A02,083766,Staff,14,0,30,16
1650083696887,MATH 20D,A03,083767,Staff,28,0,30,2
1650083702913,MATH 20E,A01,083771,Staff,10,0,30,20
1650083702913,MATH 20E,A02,083772,Staff,20,0,30,10
1650083702913,MATH 20E,B01,083773,Staff,2,2,30,28
1650083702913,MATH 20E,B02,083774,Staff,16,0,30,14
1650083708937,MATH 103A,A01,083777,Staff,0,8,30,30
1650083708937,MATH 103A,A02,083778,Staff,0,7,30,30
1650083708937,MATH 103A,B01,083779,Staff,0,8,30,30
1650083708937,MATH 103A,B02,083780,Staff,1,7,30,29
1650083714963,MATH 105,A01,085443,Staff,1,13,30,29
1650083720992,MATH 109,A01,083213,Anzaldo; Leesa B,1,4,30,29
1650083720992,MATH 109,A02,083214,Anzaldo; Leesa B,0,5,30,30
1650083720992,MATH 109,B01,083215,Anzaldo; Leesa B,0,4,30,30
1650083720992,MATH 109,B02,083216,Anzaldo; Leesa B,1,4,30,29
1650083727015,MATH 142A,A01,083219,Chow; Bennett,0,10,30,30
1650083727015,MATH 142A,A02,083220,Chow; Bennett,0,10,30,30
1650083727015,MATH 142A,B01,083221,Chow; Bennett,0,10,30,30
1650083727015,MATH 142A,B02,083222,Chow; Bennett,0,9,30,30
1650083733038,MATH 193A,A01,083224,Staff,0,4,30,30
1650083733038,MATH 193A,A02,083225,Staff,0,4,30,30
1650083733038,MATH 193A,A03,083781,Staff,0,0,30,30
1650083733038,MATH 193A,A04,083782,Staff,3,0,30,27
1650083739063,MATH 197,001,091859,McAuley; Julian John,9998,0,9999,1
1650083745115,COGS 9,A01,083615,Staff,3,17,60,57
1650083751136,COGS 11,A01,083617,Boyle; Mary E. T.,24,0,40,16
1650083757163,COGS 13,A01,083071,Staff,0,29,40,40
1650083763192,COGS 14A,A01,092681,Staff,1,11,100,99
1650083769220,COGS 14B,A01,083073,Cheng; Tzu-Han,0,4,50,50
1650083775246,COGS 17,A01,092677,Staff,35,0,75,40
1650083781271,COGS 100,A01,083619,Staff,0,20,60,60
1650083787295,COGS 101A,A01,083621,Davis; Joshua Daniel,0,17,60,60
1650083793321,COGS 101B,A01,091572,Staff,10,0,60,50
1650083799349,COGS 101C,A01,083625,Delgado; Tania,21,0,30,9
1650083805377,COGS 107A,A01,083627,Boyle; Mary E. T.,1,4,60,59
1650083811401,COGS 118A,A01,083075,Staff,17,0,60,43
1650083817429,CSE 3,A50,083646,Miranda; Gregory Joseph,22,0,38,16
1650083817429,CSE 3,A51,083647,Miranda; Gregory Joseph,37,0,37,0
1650083823459,CSE 8A,A50,083650,Miranda; Gregory Joseph,0,15,40,40
1650083829488,CSE 11,A01,083080,Cao; Yingjun,0,66,40,40
1650083835515,CSE 12,A01,083652,Staff,0,2,100,100
1650083841537,CSE 15L,A01,083654,Staff,0,0,50,50
1650083841537,CSE 15L,A02,083655,Staff,10,0,50,40
1650083847564,CSE 20,A01,083657,Staff,58,0,80,22
1650083853588,CSE 30,A01,083084,Eldon; John,0,63,40,40
1650083859616,CSE 100,A01,083659,Cao; Yingjun,0,60,50,50
1650083865644,CSE 134B,A01,083661,Powell; Thomas Allan,1,28,65,64
1650083871670,CSE 140,A01,083663,Staff,4,0,75,71
1650083877694,CSE 140L,A01,083088,Eldon; John,0,1,75,75
1650083883718,CSE 175,A01,083665,Kumar; Rakesh,9,0,25,16
1650083889742,CSE 190,A00,092507,Dubnov; Shlomo,14,0,20,6
1650083895773,ECE 45,A01,083139,Staff,0,13,40,40
1650083901797,ECE 65,A50,083695,Staff,0,4,30,30
1650083907820,ECE 109,A01,091882,Touri; Behrouz,48,0,70,22
1650083913844,ECE 180,A00,083140,Abi Samra; Nicholas Camill,24,0,30,6
1650083913844,ECE 180,B00,083141,Abi Samra; Nicholas Camill,8,0,30,22
1650083919868,MATH 10A,A01,083735,Patchell; Gregory David,12,0,30,18
1650083919868,MATH 10A,A02,083736,Patchell; Gregory David,28,0,30,2
1650083919868,MATH 10A,A03,083737,Patchell; Gregory David,26,0,30,4
1650083925896,MATH 10B,A01,083207,Staff,0,5,30,30
1650083925896,MATH 10B,A02,083208,Staff,0,4,30,30
1650083925896,MATH 10B,B01,083739,Staff,18,0,30,12
1650083925896,MATH 10B,B02,083740,Staff,29,0,30,1
1650083931926,MATH 18,A01,083743,Staff,10,0,30,20
1650083931926,MATH 18,A02,083744,Staff,28,0,30,2
1650083931926,MATH 18,A03,083745,Staff,23,0,30,7
1650083931926,MATH 18,A04,083746,Staff,27,0,30,3
1650083931926,MATH 18,B01,083748,Staff,0,9,30,30
1650083931926,MATH 18,B02,083749,Staff,1,7,30,29
1650083931926,MATH 18,B03,083750,Staff,0,6,30,30
1650083931926,MATH 18,B04,083751,Staff,1,8,30,29
1650083937962,MATH 20A,A01,083754,Staff,26,0,40,14
1650083943985,MATH 20B,A01,083756,Staff,0,5,30,30
1650083943985,MATH 20B,A02,083757,Staff,0,2,30,30
1650083950010,MATH 20C,A01,083760,Staff,0,11,30,30
1650083950010,MATH 20C,A02,083761,Staff,0,12,30,30
1650083950010,MATH 20C,B01,083762,Staff,14,0,30,16
1650083950010,MATH 20C,B02,083763,Staff,28,0,30,2
1650083956037,MATH 20D,A01,083765,Staff,0,2,30,30
1650083956037,MATH 20D,A02,083766,Staff,14,0,30,16
1650083956037,MATH 20D,A03,083767,Staff,28,0,30,2
1650083962065,MATH 20E,A01,083771,Staff,10,0,30,20
1650083962065,MATH 20E,A02,083772,Staff,20,0,30,10
1650083962065,MATH 20E,B01,083773,Staff,2,2,30,28
1650083962065,MATH 20E,B02,083774,Staff,16,0,30,14
1650083968090,MATH 103A,A01,083777,Staff,0,8,30,30
1650083968090,MATH 103A,A02,083778,Staff,0,7,30,30
1650083968090,MATH 103A,B01,083779,Staff,0,8,30,30
1650083968090,MATH 103A,B02,083780,Staff,1,7,30,29
1650083974118,MATH 105,A01,085443,Staff,1,13,30,29
1650083980145,MATH 109,A01,083213,Anzaldo; Leesa B,1,4,30,29
1650083980145,MATH 109,A02,083214,Anzaldo; Leesa B,0,5,30,30
1650083980145,MATH 109,B01,083215,Anzaldo; Leesa B,0,4,30,30
1650083980145,MATH 109,B02,083216,Anzaldo; Leesa B,1,4,30,29
1650083986173,MATH 142A,A01,083219,Chow; Bennett,0,10,30,30
1650083986173,MATH 142A,A02,083220,Chow; Bennett,0,10,30,30
1650083986173,MATH 142A,B01,083221,Chow; Bennett,0,10,30,30
1650083986173,MATH 142A,B02,083222,Chow; Bennett,0,9,30,30
1650083992293,MATH 193A,A01,083224,Staff,0,4,30,30
1650083992293,MATH 193A,A02,083225,Staff,0,4,30,30
1650083992293,MATH 193A,A03,083781,Staff,0,0,30,30
1650083992293,MATH 193A,A04,083782,Staff,3,0,30,27
1650083998317,MATH 197,001,091859,McAuley; Julian John,9998,0,9999,1
1650084004370,COGS 9,A01,083615,Staff,3,17,60,57
1650084010396,COGS 11,A01,083617,Boyle; Mary E. T.,24,0,40,16
1650084016420,COGS 13,A01,083071,Staff,0,29,40,40
1650084022460,COGS 14A,A01,092681,Staff,1,11,100,99
1650084028485,COGS 14B,A01,083073,Cheng; Tzu-Han,0,4,50,50
1650084034508,COGS 17,A01,092677,Staff,35,0,75,40
1650084040533,COGS 100,A01,083619,Staff,0,20,60,60
1650084046565,COGS 101A,A01,083621,Davis; Joshua Daniel,0,17,60,60
1650084052589,COGS 101B,A01,091572,Staff,10,0,60,50
1650084058618,COGS 101C,A01,083625,Delgado; Tania,21,0,30,9
1650084064645,COGS 107A,A01,083627,Boyle; Mary E. T.,1,4,60,59
1650084070668,COGS 118A,A01,083075,Staff,17,0,60,43
1650084076699,CSE 3,A50,083646,Miranda; Gregory Joseph,22,0,38,16
1650084076699,CSE 3,A51,083647,Miranda; Gregory Joseph,37,0,37,0
1650084082728,CSE 8A,A50,083650,Miranda; Gregory Joseph,0,15,40,40
1650084088753,CSE 11,A01,083080,Cao; Yingjun,0,66,40,40
1650084094776,CSE 12,A01,083652,Staff,0,2,100,100
1650084100800,CSE 15L,A01,083654,Staff,0,0,50,50
1650084100800,CSE 15L,A02,083655,Staff,10,0,50,40
1650084106824,CSE 20,A01,083657,Staff,58,0,80,22
1650084112848,CSE 30,A01,083084,Eldon; John,0,63,40,40
1650084118872,CSE 100,A01,083659,Cao; Yingjun,0,60,50,50
1650084124900,CSE 134B,A01,083661,Powell; Thomas Allan,1,28,65,64
1650084130931,CSE 140,A01,083663,Staff,4,0,75,71
1650084136956,CSE 140L,A01,083088,Eldon; John,0,1,75,75
1650084142983,CSE 175,A01,083665,Kumar; Rakesh,9,0,25,16
1650084149006,CSE 190,A00,092507,Dubnov; Shlomo,14,0,20,6
1650084155029,ECE 45,A01,083139,Staff,0,13,40,40
1650084161057,ECE 65,A50,083695,Staff,0,4,30,30
1650084167081,ECE 109,A01,091882,Touri; Behrouz,48,0,70,22
1650084173108,ECE 180,A00,083140,Abi Samra; Nicholas Camill,24,0,30,6
1650084173108,ECE 180,B00,083141,Abi Samra; Nicholas Camill,8,0,30,22
1650084179137,MATH 10A,A01,083735,Patchell; Gregory David,12,0,30,18
1650084179137,MATH 10A,A02,083736,Patchell; Gregory David,28,0,30,2
1650084179137,MATH 10A,A03,083737,Patchell; Gregory David,26,0,30,4
1650084185161,MATH 10B,A01,083207,Staff,0,5,30,30
1650084185161,MATH 10B,A02,083208,Staff,0,4,30,30
1650084185161,MATH 10B,B01,083739,Staff,18,0,30,12
1650084185161,MATH 10B,B02,083740,Staff,29,0,30,1
1650084191191,MATH 18,A01,083743,Staff,10,0,30,20
1650084191191,MATH 18,A02,083744,Staff,28,0,30,2
1650084191191,MATH 18,A03,083745,Staff,23,0,30,7
1650084191191,MATH 18,A04,083746,Staff,27,0,30,3
1650084191191,MATH 18,B01,083748,Staff,0,9,30,30
1650084191191,MATH 18,B02,083749,Staff,1,7,30,29
1650084191191,MATH 18,B03,083750,Staff,0,6,30,30
1650084191191,MATH 18,B04,083751,Staff,1,8,30,29
1650084197218,MATH 20A,A01,083754,Staff,26,0,40,14
1650084203243,MATH 20B,A01,083756,Staff,0,5,30,30
1650084203243,MATH 20B,A02,083757,Staff,0,2,30,30
1650084209269,MATH 20C,A01,083760,Staff,0,11,30,30
1650084209269,MATH 20C,A02,083761,Staff,0,12,30,30
1650084209269,MATH 20C,B01,083762,Staff,14,0,30,16
1650084209269,MATH 20C,B02,083763,Staff,28,0,30,2
1650084215296,MATH 20D,A01,083765,Staff,0,2,30,30
1650084215296,MATH 20D,A02,083766,Staff,14,0,30,16
1650084215296,MATH 20D,A03,083767,Staff,28,0,30,2
1650084221320,MATH 20E,A01,083771,Staff,10,0,30,20
1650084221320,MATH 20E,A02,083772,Staff,20,0,30,10
1650084221320,MATH 20E,B01,083773,Staff,2,2,30,28
1650084221320,MATH 20E,B02,083774,Staff,16,0,30,14
1650084227345,MATH 103A,A01,083777,Staff,0,8,30,30
1650084227345,MATH 103A,A02,083778,Staff,0,7,30,30
1650084227345,MATH 103A,B01,083779,Staff,0,8,30,30
1650084227345,MATH 103A,B02,083780,Staff,1,7,30,29
1650084233371,MATH 105,A01,085443,Staff,1,13,30,29
1650084239402,MATH 109,A01,083213,Anzaldo; Leesa B,1,4,30,29
1650084239402,MATH 109,A02,083214,Anzaldo; Leesa B,0,5,30,30
1650084239402,MATH 109,B01,083215,Anzaldo; Leesa B,0,4,30,30
1650084239402,MATH 109,B02,083216,Anzaldo; Leesa B,1,4,30,29
1650084245427,MATH 142A,A01,083219,Chow; Bennett,0,10,30,30
1650084245427,MATH 142A,A02,083220,Chow; Bennett,0,10,30,30
1650084245427,MATH 142A,B01,083221,Chow; Bennett,0,10,30,30
1650084245427,MATH 142A,B02,083222,Chow; Bennett,0,9,30,30
1650084251455,MATH 193A,A01,083224,Staff,0,4,30,30
1650084251455,MATH 193A,A02,083225,Staff,0,4,30,30
1650084251455,MATH 193A,A03,083781,Staff,0,0,30,30
1650084251455,MATH 193A,A04,083782,Staff,3,0,30,27
1650084257488,MATH 197,001,091859,McAuley; Julian John,9998,0,9999,1
1650084263556,COGS 9,A01,083615,Staff,3,17,60,57
1650084269584,COGS 11,A01,083617,Boyle; Mary E. T.,24,0,40,16
1650084275617,COGS 13,A01,083071,Staff,0,29,40,40
1650084281648,COGS 14A,A01,092681,Staff,1,11,100,99
1650084287675,COGS 14B,A01,083073,Cheng; Tzu-Han,0,4,50,50
1650084293701,COGS 17,A01,092677,Staff,35,0,75,40
1650084299725,COGS 100,A01,083619,Staff,0,21,60,60
1650084305751,COGS 101A,A01,083621,Davis; Joshua Daniel,0,17,60,60
1650084311784,COGS 101B,A01,091572,Staff,10,0,60,50
1650084317808,COGS 101C,A01,083625,Delgado; Tania,21,0,30,9
1650084323831,COGS 107A,A01,083627,Boyle; Mary E. T.,1,4,60,59
1650084329855,COGS 118A,A01,083075,Staff,17,0,60,43
1650084335884,CSE 3,A50,083646,Miranda; Gregory Joseph,22,0,38,16
1650084335884,CSE 3,A51,083647,Miranda; Gregory Joseph,37,0,37,0
1650084341907,CSE 8A,A50,083650,Miranda; Gregory Joseph,0,15,40,40
1650084347929,CSE 11,A01,083080,Cao; Yingjun,0,66,40,40
1650084353952,CSE 12,A01,083652,Staff,0,2,100,100
1650084359977,CSE 15L,A01,083654,Staff,0,0,50,50
1650084359977,CSE 15L,A02,083655,Staff,10,0,50,40
1650084366005,CSE 20,A01,083657,Staff,58,0,80,22
1650084372028,CSE 30,A01,083084,Eldon; John,0,63,40,40
1650084378056,CSE 100,A01,083659,Cao; Yingjun,0,60,50,50
1650084384082,CSE 134B,A01,083661,Powell; Thomas Allan,1,28,65,64
1650084390105,CSE 140,A01,083663,Staff,4,0,75,71
1650084396127,CSE 140L,A01,083088,Eldon; John,0,1,75,75
1650084402153,CSE 175,A01,083665,Kumar; Rakesh,9,0,25,16
1650084408177,CSE 190,A00,092507,Dubnov; Shlomo,14,0,20,6
1650084414203,ECE 45,A01,083139,Staff,0,13,40,40
1650084420231,ECE 65,A50,083695,Staff,0,4,30,30
1650084426255,ECE 109,A01,091882,Touri; Behrouz,48,0,70,22
1650084432281,ECE 180,A00,083140,Abi Samra; Nicholas Camill,24,0,30,6
1650084432281,ECE 180,B00,083141,Abi Samra; Nicholas Camill,8,0,30,22
1650084438310,MATH 10A,A01,083735,Patchell; Gregory David,12,0,30,18
1650084438310,MATH 10A,A02,083736,Patchell; Gregory David,28,0,30,2
1650084438310,MATH 10A,A03,083737,Patchell; Gregory David,26,0,30,4
1650084444337,MATH 10B,A01,083207,Staff,0,5,30,30
1650084444337,MATH 10B,A02,083208,Staff,0,4,30,30
1650084444337,MATH 10B,B01,083739,Staff,18,0,30,12
1650084444337,MATH 10B,B02,083740,Staff,29,0,30,1
1650084450369,MATH 18,A01,083743,Staff,10,0,30,20
1650084450369,MATH 18,A02,083744,Staff,28,0,30,2
1650084450369,MATH 18,A03,083745,Staff,23,0,30,7
1650084450369,MATH 18,A04,083746,Staff,27,0,30,3
1650084450369,MATH 18,B01,083748,Staff,0,9,30,30
1650084450369,MATH 18,B02,083749,Staff,1,7,30,29
1650084450369,MATH 18,B03,083750,Staff,0,6,30,30
1650084450369,MATH 18,B04,083751,Staff,1,8,30,29
1650084456396,MATH 20A,A01,083754,Staff,26,0,40,14
1650084462424,MATH 20B,A01,083756,Staff,0,5,30,30
1650084462424,MATH 20B,A02,083757,Staff,0,2,30,30
1650084468448,MATH 20C,A01,083760,Staff,0,11,30,30
1650084468448,MATH 20C,A02,083761,Staff,0,12,30,30
1650084468448,MATH 20C,B01,083762,Staff,14,0,30,16
1650084468448,MATH 20C,B02,083763,Staff,28,0,30,2
1650084474472,MATH 20D,A01,083765,Staff,0,2,30,30
1650084474472,MATH 20D,A02,083766,Staff,14,0,30,16
1650084474472,MATH 20D,A03,083767,Staff,28,0,30,2
1650084480507,MATH 20E,A01,083771,Staff,10,0,30,20
1650084480507,MATH 20E,A02,083772,Staff,20,0,30,10
1650084480507,MATH 20E,B01,083773,Staff,2,2,30,28
1650084480507,MATH 20E,B02,083774,Staff,16,0,30,14
1650084486532,MATH 103A,A01,083777,Staff,0,8,30,30
1650084486532,MATH 103A,A02,083778,Staff,0,7,30,30
1650084486532,MATH 103A,B01,083779,Staff,0,8,30,30
1650084486532,MATH 103A,B02,083780,Staff,1,7,30,29
1650084492558,MATH 105,A01,085443,Staff,1,13,30,29
1650084498585,MATH 109,A01,083213,Anzaldo; Leesa B,1,4,30,29
1650084498585,MATH 109,A02,083214,Anzaldo; Leesa B,0,5,30,30
1650084498585,MATH 109,B01,083215,Anzaldo; Leesa B,0,4,30,30
1650084498585,MATH 109,B02,083216,Anzaldo; Leesa B,1,4,30,29
1650084504609,MATH 142A,A01,083219,Chow; Bennett,0,10,30,30
1650084504609,MATH 142A,A02,083220,Chow; Bennett,0,10,30,30
1650084504609,MATH 142A,B01,083221,Chow; Bennett,0,10,30,30
1650084504609,MATH 142A,B02,083222,Chow; Bennett,0,9,30,30
1650084510633,MATH 193A,A01,083224,Staff,0,4,30,30
1650084510633,MATH 193A,A02,083225,Staff,0,4,30,30
1650084510633,MATH 193A,A03,083781,Staff,0,0,30,30
1650084510633,MATH 193A,A04,083782,Staff,3,0,30,27
1650084516657,MATH 197,001,091859,McAuley; Julian John,9998,0,9999,1
1650084522741,COGS 9,A01,083615,Staff,3,17,60,57
1650084528770,COGS 11,A01,083617,Boyle; Mary E. T.,24,0,40,16
1650084534799,COGS 13,A01,083071,Staff,0,29,40,40
1650084540825,COGS 14A,A01,092681,Staff,1,11,100,99
1650084546854,COGS 14B,A01,083073,Cheng; Tzu-Han,0,4,50,50
1650084552882,COGS 17,A01,092677,Staff,35,0,75,40
1650084558906,COGS 100,A01,083619,Staff,0,21,60,60
1650084564930,COGS 101A,A01,083621,Davis; Joshua Daniel,0,17,60,60
1650084570952,COGS 101B,A01,091572,Staff,10,0,60,50
1650084576978,COGS 101C,A01,083625,Delgado; Tania,21,0,30,9
1650084583092,COGS 107A,A01,083627,Boyle; Mary E. T.,1,4,60,59
1650084589128,COGS 118A,A01,083075,Staff,17,0,60,43
1650084595161,CSE 3,A50,083646,Miranda; Gregory Joseph,22,0,38,16
1650084595161,CSE 3,A51,083647,Miranda; Gregory Joseph,37,0,37,0
1650084601184,CSE 8A,A50,083650,Miranda; Gregory Joseph,0,15,40,40
1650084607213,CSE 11,A01,083080,Cao; Yingjun,0,66,40,40
1650084613238,CSE 12,A01,083652,Staff,0,2,100,100
1650084619265,CSE 15L,A01,083654,Staff,0,0,50,50
1650084619265,CSE 15L,A02,083655,Staff,10,0,50,40
1650084625289,CSE 20,A01,083657,Staff,58,0,80,22
1650084631312,CSE 30,A01,083084,Eldon; John,0,63,40,40
1650084637343,CSE 100,A01,083659,Cao; Yingjun,0,60,50,50
1650084643373,CSE 134B,A01,083661,Powell; Thomas Allan,1,28,65,64
1650084649397,CSE 140,A01,083663,Staff,4,0,75,71
1650084655423,CSE 140L,A01,083088,Eldon; John,0,1,75,75
1650084661449,CSE 175,A01,083665,Kumar; Rakesh,9,0,25,16
1650084667472,CSE 190,A00,092507,Dubnov; Shlomo,14,0,20,6
1650084673504,ECE 45,A01,083139,Staff,0,13,40,40
1650084679532,ECE 65,A50,083695,Staff,0,4,30,30
1650084685555,ECE 109,A01,091882,Touri; Behrouz,48,0,70,22
1650084691580,ECE 180,A00,083140,Abi Samra; Nicholas Camill,24,0,30,6
1650084691580,ECE 180,B00,083141,Abi Samra; Nicholas Camill,8,0,30,22
1650084697607,MATH 10A,A01,083735,Patchell; Gregory David,12,0,30,18
1650084697607,MATH 10A,A02,083736,Patchell; Gregory David,28,0,30,2
1650084697607,MATH 10A,A03,083737,Patchell; Gregory David,26,0,30,4
1650084703633,MATH 10B,A01,083207,Staff,0,5,30,30
1650084703633,MATH 10B,A02,083208,Staff,0,4,30,30
1650084703633,MATH 10B,B01,083739,Staff,18,0,30,12
1650084703633,MATH 10B,B02,083740,Staff,29,0,30,1
1650084709662,MATH 18,A01,083743,Staff,10,0,30,20
1650084709662,MATH 18,A02,083744,Staff,28,0,30,2
1650084709662,MATH 18,A03,083745,Staff,23,0,30,7
1650084709662,MATH 18,A04,083746,Staff,27,0,30,3
1650084709662,MATH 18,B01,083748,Staff,0,9,30,30
1650084709662,MATH 18,B02,083749,Staff,1,7,30,29
1650084709662,MATH 18,B03,083750,Staff,0,6,30,30
1650084709662,MATH 18,B04,083751,Staff,1,8,30,29
1650084715687,MATH 20A,A01,083754,Staff,26,0,40,14
1650084721729,MATH 20B,A01,083756,Staff,0,5,30,30
1650084721729,MATH 20B,A02,083757,Staff,0,2,30,30
1650084727758,MATH 20C,A01,083760,Staff,0,11,30,30
1650084727758,MATH 20C,A02,083761,Staff,0,12,30,30
1650084727758,MATH 20C,B01,083762,Staff,14,0,30,16
1650084727758,MATH 20C,B02,083763,Staff,28,0,30,2
1650084733787,MATH 20D,A01,083765,Staff,0,2,30,30
1650084733787,MATH 20D,A02,083766,Staff,14,0,30,16
1650084733787,MATH 20D,A03,083767,Staff,28,0,30,2
1650084739811,MATH 20E,A01,083771,Staff,10,0,30,20
1650084739811,MATH 20E,A02,083772,Staff,20,0,30,10
1650084739811,MATH 20E,B01,083773,Staff,2,2,30,28
1650084739811,MATH 20E,B02,083774,Staff,16,0,30,14
1650084745840,MATH 103A,A01,083777,Staff,0,8,30,30
1650084745840,MATH 103A,A02,083778,Staff,0,7,30,30
1650084745840,MATH 103A,B01,083779,Staff,0,8,30,30
1650084745840,MATH 103A,B02,083780,Staff,1,7,30,29
1650084751863,MATH 105,A01,085443,Staff,1,13,30,29
1650084757901,MATH 109,A01,083213,Anzaldo; Leesa B,1,4,30,29
1650084757901,MATH 109,A02,083214,Anzaldo; Leesa B,0,5,30,30
1650084757901,MATH 109,B01,083215,Anzaldo; Leesa B,0,4,30,30
1650084757901,MATH 109,B02,083216,Anzaldo; Leesa B,1,4,30,29
1650084763924,MATH 142A,A01,083219,Chow; Bennett,0,10,30,30
1650084763924,MATH 142A,A02,083220,Chow; Bennett,0,10,30,30
1650084763924,MATH 142A,B01,083221,Chow; Bennett,0,10,30,30
1650084763924,MATH 142A,B02,083222,Chow; Bennett,0,9,30,30
1650084769948,MATH 193A,A01,083224,Staff,0,4,30,30
1650084769948,MATH 193A,A02,083225,Staff,0,4,30,30
1650084769948,MATH 193A,A03,083781,Staff,0,0,30,30
1650084769948,MATH 193A,A04,083782,Staff,3,0,30,27
1650084775975,MATH 197,001,091859,McAuley; Julian John,9998,0,9999,1
1650084782032,COGS 9,A01,083615,Staff,3,17,60,57
1650084788057,COGS 11,A01,083617,Boyle; Mary E. T.,24,0,40,16
1650084794080,COGS 13,A01,083071,Staff,0,29,40,40
1650084800110,COGS 14A,A01,092681,Staff,1,11,100,99
1650084806134,COGS 14B,A01,083073,Cheng; Tzu-Han,0,4,50,50
1650084812172,COGS 17,A01,092677,Staff,35,0,75,40
1650084818208,COGS 100,A01,083619,Staff,0,21,60,60
1650084824236,COGS 101A,A01,083621,Davis; Joshua Daniel,0,17,60,60
1650084830262,COGS 101B,A01,091572,Staff,10,0,60,50
1650084836283,COGS 101C,A01,083625,Delgado; Tania,21,0,30,9
1650084842307,COGS 107A,A01,083627,Boyle; Mary E. T.,1,4,60,59
1650084848333,COGS 118A,A01,083075,Staff,17,0,60,43
1650084854362,CSE 3,A50,083646,Miranda; Gregory Joseph,22,0,38,16
1650084854362,CSE 3,A51,083647,Miranda; Gregory Joseph,37,0,37,0
1650084860386,CSE 8A,A50,083650,Miranda; Gregory Joseph,0,15,40,40
1650084866413,CSE 11,A01,083080,Cao; Yingjun,0,66,40,40
1650084872437,CSE 12,A01,083652,Staff,0,2,100,100
1650084878461,CSE 15L,A01,083654,Staff,0,0,50,50
1650084878461,CSE 15L,A02,083655,Staff,10,0,50,40
1650084884485,CSE 20,A01,083657,Staff,58,0,80,22
1650084890508,CSE 30,A01,083084,Eldon; John,0,63,40,40
1650084896536,CSE 100,A01,083659,Cao; Yingjun,0,60,50,50
1650084902563,CSE 134B,A01,083661,Powell; Thomas Allan,1,28,65,64
1650084908591,CSE 140,A01,083663,Staff,4,0,75,71
1650084914614,CSE 140L,A01,083088,Eldon; John,0,1,75,75
1650084920640,CSE 175,A01,083665,Kumar; Rakesh,9,0,25,16
1650084926663,CSE 190,A00,092507,Dubnov; Shlomo,14,0,20,6
1650084932685,ECE 45,A01,083139,Staff,0,13,40,40
1650084938709,ECE 65,A50,083695,Staff,0,4,30,30
1650084944739,ECE 109,A01,091882,Touri; Behrouz,48,0,70,22
1650084950764,ECE 180,A00,083140,Abi Samra; Nicholas Camill,24,0,30,6
1650084950764,ECE 180,B00,083141,Abi Samra; Nicholas Camill,8,0,30,22
1650084956787,MATH 10A,A01,083735,Patchell; Gregory David,12,0,30,18
1650084956787,MATH 10A,A02,083736,Patchell; Gregory David,28,0,30,2
1650084956787,MATH 10A,A03,083737,Patchell; Gregory David,26,0,30,4
1650084962812,MATH 10B,A01,083207,Staff,0,5,30,30
1650084962812,MATH 10B,A02,083208,Staff,0,4,30,30
1650084962812,MATH 10B,B01,083739,Staff,18,0,30,12
1650084962812,MATH 10B,B02,083740,Staff,29,0,30,1
1650084968845,MATH 18,A01,083743,Staff,10,0,30,20
1650084968845,MATH 18,A02,083744,Staff,28,0,30,2
1650084968845,MATH 18,A03,083745,Staff,23,0,30,7
1650084968845,MATH 18,A04,083746,Staff,27,0,30,3
1650084968845,MATH 18,B01,083748,Staff,0,9,30,30
1650084968845,MATH 18,B02,083749,Staff,1,7,30,29
1650084968845,MATH 18,B03,083750,Staff,0,6,30,30
1650084968845,MATH 18,B04,083751,Staff,1,8,30,29
1650084974867,MATH 20A,A01,083754,Staff,26,0,40,14
1650084980891,MATH 20B,A01,083756,Staff,0,5,30,30
1650084980891,MATH 20B,A02,083757,Staff,0,2,30,30
1650084986919,MATH 20C,A01,083760,Staff,0,11,30,30
1650084986919,MATH 20C,A02,083761,Staff,0,12,30,30
1650084986919,MATH 20C,B01,083762,Staff,14,0,30,16
1650084986919,MATH 20C,B02,083763,Staff,28,0,30,2
1650084992947,MATH 20D,A01,083765,Staff,0,2,30,30
1650084992947,MATH 20D,A02,083766,Staff,14,0,30,16
1650084992947,MATH 20D,A03,083767,Staff,28,0,30,2
1650084998970,MATH 20E,A01,083771,Staff,10,0,30,20
1650084998970,MATH 20E,A02,083772,Staff,20,0,30,10
1650084998970,MATH 20E,B01,083773,Staff,2,2,30,28
1650084998970,MATH 20E,B02,083774,Staff,16,0,30,14
1650085004999,MATH 103A,A01,083777,Staff,0,8,30,30
1650085004999,MATH 103A,A02,083778,Staff,0,7,30,30
1650085004999,MATH 103A,B01,083779,Staff,0,8,30,30
1650085004999,MATH 103A,B02,083780,Staff,1,7,30,29
1650085011026,MATH 105,A01,085443,Staff,1,13,30,29
1650085017051,MATH 109,A01,083213,Anzaldo; Leesa B,1,4,30,29
1650085017051,MATH 109,A02,083214,Anzaldo; Leesa B,0,5,30,30
1650085017051,MATH 109,B01,083215,Anzaldo; Leesa B,0,4,30,30
1650085017051,MATH 109,B02,083216,Anzaldo; Leesa B,1,4,30,29
1650085023082,MATH 142A,A01,083219,Chow; Bennett,0,10,30,30
1650085023082,MATH 142A,A02,083220,Chow; Bennett,0,10,30,30
1650085023082,MATH 142A,B01,083221,Chow; Bennett,0,10,30,30
1650085023082,MATH 142A,B02,083222,Chow; Bennett,0,9,30,30
1650085029110,MATH 193A,A01,083224,Staff,0,4,30,30
1650085029110,MATH 193A,A02,083225,Staff,0,4,30,30
1650085029110,MATH 193A,A03,083781,Staff,0,0,30,30
1650085029110,MATH 193A,A04,083782,Staff,3,0,30,27
1650085035134,MATH 197,001,091859,McAuley; Julian John,9998,0,9999,1
1650085041186,COGS 9,A01,083615,Staff,3,17,60,57
1650085047210,COGS 11,A01,083617,Boyle; Mary E. T.,24,0,40,16
1650085053232,COGS 13,A01,083071,Staff,0,29,40,40
1650085059259,COGS 14A,A01,092681,Staff,1,11,100,99
1650085065288,COGS 14B,A01,083073,Cheng; Tzu-Han,0,4,50,50
1650085071311,COGS 17,A01,092677,Staff,35,0,75,40
1650085077338,COGS 100,A01,083619,Staff,0,21,60,60
1650085083366,COGS 101A,A01,083621,Davis; Joshua Daniel,0,17,60,60
1650085089399,COGS 101B,A01,091572,Staff,10,0,60,50
1650085095423,COGS 101C,A01,083625,Delgado; Tania,21,0,30,9
1650085101448,COGS 107A,A01,083627,Boyle; Mary E. T.,1,4,60,59
1650085107485,COGS 118A,A01,083075,Staff,17,0,60,43
1650085113511,CSE 3,A50,083646,Miranda; Gregory Joseph,22,0,38,16
1650085113511,CSE 3,A51,083647,Miranda; Gregory Joseph,37,0,37,0
1650085119538,CSE 8A,A50,083650,Miranda; Gregory Joseph,0,15,40,40
1650085125561,CSE 11,A01,083080,Cao; Yingjun,0,66,40,40
1650085131585,CSE 12,A01,083652,Staff,0,2,100,100
1650085137609,CSE 15L,A01,083654,Staff,0,0,50,50
1650085137609,CSE 15L,A02,083655,Staff,10,0,50,40
1650085143636,CSE 20,A01,083657,Staff,58,0,80,22
1650085149661,CSE 30,A01,083084,Eldon; John,0,63,40,40
1650085155685,CSE 100,A01,083659,Cao; Yingjun,0,60,50,50
1650085161718,CSE 134B,A01,083661,Powell; Thomas Allan,1,28,65,64
1650085167740,CSE 140,A01,083663,Staff,4,0,75,71
1650085173767,CSE 140L,A01,083088,Eldon; John,0,1,75,75
1650085179885,CSE 175,A01,083665,Kumar; Rakesh,9,0,25,16
1650085185913,CSE 190,A00,092507,Dubnov; Shlomo,14,0,20,6
1650085191937,ECE 45,A01,083139,Staff,0,13,40,40
1650085197966,ECE 65,A50,083695,Staff,0,4,30,30
1650085203993,ECE 109,A01,091882,Touri; Behrouz,48,0,70,22
1650085210016,ECE 180,A00,083140,Abi Samra; Nicholas Camill,24,0,30,6
1650085210016,ECE 180,B00,083141,Abi Samra; Nicholas Camill,8,0,30,22
1650085216040,MATH 10A,A01,083735,Patchell; Gregory David,12,0,30,18
1650085216040,MATH 10A,A02,083736,Patchell; Gregory David,28,0,30,2
1650085216040,MATH 10A,A03,083737,Patchell; Gregory David,26,0,30,4
1650085222071,MATH 10B,A01,083207,Staff,0,5,30,30
1650085222071,MATH 10B,A02,083208,Staff,0,4,30,30
1650085222071,MATH 10B,B01,083739,Staff,18,0,30,12
1650085222071,MATH 10B,B02,083740,Staff,29,0,30,1
1650085228095,MATH 18,A01,083743,Staff,10,0,30,20
1650085228095,MATH 18,A02,083744,Staff,28,0,30,2
1650085228095,MATH 18,A03,083745,Staff,23,0,30,7
1650085228095,MATH 18,A04,083746,Staff,27,0,30,3
1650085228095,MATH 18,B01,083748,Staff,0,9,30,30
1650085228095,MATH 18,B02,083749,Staff,1,7,30,29
1650085228095,MATH 18,B03,083750,Staff,0,6,30,30
1650085228095,MATH 18,B04,083751,Staff,1,8,30,29
1650085234119,MATH 20A,A01,083754,Staff,26,0,40,14
1650085240147,MATH 20B,A01,083756,Staff,0,5,30,30
1650085240147,MATH 20B,A02,083757,Staff,0,2,30,30
1650085246171,MATH 20C,A01,083760,Staff,0,11,30,30
1650085246171,MATH 20C,A02,083761,Staff,0,12,30,30
1650085246171,MATH 20C,B01,083762,Staff,14,0,30,16
1650085246171,MATH 20C,B02,083763,Staff,28,0,30,2
1650085252195,MATH 20D,A01,083765,Staff,0,2,30,30
1650085252195,MATH 20D,A02,083766,Staff,14,0,30,16
1650085252195,MATH 20D,A03,083767,Staff,28,0,30,2
1650085258228,MATH 20E,A01,083771,Staff,10,0,30,20
1650085258228,MATH 20E,A02,083772,Staff,20,0,30,10
1650085258228,MATH 20E,B01,083773,Staff,2,2,30,28
1650085258228,MATH 20E,B02,083774,Staff,16,0,30,14
1650085264258,MATH 103A,A01,083777,Staff,0,8,30,30
1650085264258,MATH 103A,A02,083778,Staff,0,7,30,30
1650085264258,MATH 103A,B01,083779,Staff,0,8,30,30
1650085264258,MATH 103A,B02,083780,Staff,1,7,30,29
1650085270283,MATH 105,A01,085443,Staff,1,13,30,29
1650085276308,MATH 109,A01,083213,Anzaldo; Leesa B,1,4,30,29
1650085276308,MATH 109,A02,083214,Anzaldo; Leesa B,0,5,30,30
1650085276308,MATH 109,B01,083215,Anzaldo; Leesa B,0,4,30,30
1650085276308,MATH 109,B02,083216,Anzaldo; Leesa B,1,4,30,29
1650085282344,MATH 142A,A01,083219,Chow; Bennett,0,10,30,30
1650085282344,MATH 142A,A02,083220,Chow; Bennett,0,10,30,30
1650085282344,MATH 142A,B01,083221,Chow; Bennett,0,10,30,30
1650085282344,MATH 142A,B02,083222,Chow; Bennett,0,9,30,30
1650085288382,MATH 193A,A01,083224,Staff,0,4,30,30
1650085288382,MATH 193A,A02,083225,Staff,0,4,30,30
1650085288382,MATH 193A,A03,083781,Staff,0,0,30,30
1650085288382,MATH 193A,A04,083782,Staff,3,0,30,27
1650085294409,MATH 197,001,091859,McAuley; Julian John,9998,0,9999,1
1650085300461,COGS 9,A01,083615,Staff,3,17,60,57
1650085306491,COGS 11,A01,083617,Boyle; Mary E. T.,24,0,40,16
1650085312515,COGS 13,A01,083071,Staff,0,29,40,40
1650085318542,COGS 14A,A01,092681,Staff,1,11,100,99
1650085324566,COGS 14B,A01,083073,Cheng; Tzu-Han,0,4,50,50
1650085330613,COGS 17,A01,092677,Staff,35,0,75,40
1650085336640,COGS 100,A01,083619,Staff,0,21,60,60
1650085342681,COGS 101A,A01,083621,Davis; Joshua Daniel,0,17,60,60
1650085348708,COGS 101B,A01,091572,Staff,10,0,60,50
1650085354733,COGS 101C,A01,083625,Delgado; Tania,21,0,30,9
1650085360761,COGS 107A,A01,083627,Boyle; Mary E. T.,1,4,60,59
1650085366785,COGS 118A,A01,083075,Staff,17,0,60,43
1650085372814,CSE 3,A50,083646,Miranda; Gregory Joseph,22,0,38,16
1650085372814,CSE 3,A51,083647,Miranda; Gregory Joseph,37,0,37,0
1650085378838,CSE 8A,A50,083650,Miranda; Gregory Joseph,0,15,40,40
1650085384861,CSE 11,A01,083080,Cao; Yingjun,0,66,40,40
1650085390886,CSE 12,A01,083652,Staff,0,2,100,100
1650085396910,CSE 15L,A01,083654,Staff,0,0,50,50
1650085396910,CSE 15L,A02,083655,Staff,10,0,50,40
1650085402935,CSE 20,A01,083657,Staff,58,0,80,22
1650085408961,CSE 30,A01,083084,Eldon; John,0,63,40,40
1650085414985,CSE 100,A01,083659,Cao; Yingjun,0,60,50,50
1650085421008,CSE 134B,A01,083661,Powell; Thomas Allan,1,28,65,64
1650085427031,CSE 140,A01,083663,Staff,4,0,75,71
1650085433058,CSE 140L,A01,083088,Eldon; John,0,1,75,75
1650085439084,CSE 175,A01,083665,Kumar; Rakesh,9,0,25,16
1650085445115,CSE 190,A00,092507,Dubnov; Shlomo,14,0,20,6
1650085451138,ECE 45,A01,083139,Staff,0,13,40,40
1650085457162,ECE 65,A50,083695,Staff,0,4,30,30
1650085463185,ECE 109,A01,091882,Touri; Behrouz,48,0,70,22
1650085469208,ECE 180,A00,083140,Abi Samra; Nicholas Camill,24,0,30,6
1650085469208,ECE 180,B00,083141,Abi Samra; Nicholas Camill,8,0,30,22
1650085475230,MATH 10A,A01,083735,Patchell; Gregory David,12,0,30,18
1650085475230,MATH 10A,A02,083736,Patchell; Gregory David,28,0,30,2
1650085475230,MATH 10A,A03,083737,Patchell; Gregory David,26,0,30,4
1650085481254,MATH 10B,A01,083207,Staff,0,5,30,30
1650085481254,MATH 10B,A02,083208,Staff,0,4,30,30
1650085481254,MATH 10B,B01,083739,Staff,18,0,30,12
1650085481254,MATH 10B,B02,083740,Staff,29,0,30,1
1650085487287,MATH 18,A01,083743,Staff,10,0,30,20
1650085487287,MATH 18,A02,083744,Staff,28,0,30,2
1650085487287,MATH 18,A03,083745,Staff,23,0,30,7
1650085487287,MATH 18,A04,083746,Staff,27,0,30,3
1650085487287,MATH 18,B01,083748,Staff,0,9,30,30
1650085487287,MATH 18,B02,083749,Staff,1,7,30,29
1650085487287,MATH 18,B03,083750,Staff,0,6,30,30
1650085487287,MATH 18,B04,083751,Staff,1,8,30,29
1650085493311,MATH 20A,A01,083754,Staff,26,0,40,14
1650085499347,MATH 20B,A01,083756,Staff,0,5,30,30
1650085499347,MATH 20B,A02,083757,Staff,0,2,30,30
1650085505370,MATH 20C,A01,083760,Staff,0,11,30,30
1650085505370,MATH 20C,A02,083761,Staff,0,12,30,30
1650085505370,MATH 20C,B01,083762,Staff,14,0,30,16
1650085505370,MATH 20C,B02,083763,Staff,28,0,30,2
1650085511395,MATH 20D,A01,083765,Staff,0,2,30,30
1650085511395,MATH 20D,A02,083766,Staff,14,0,30,16
1650085511395,MATH 20D,A03,083767,Staff,28,0,30,2
1650085517420,MATH 20E,A01,083771,Staff,10,0,30,20
1650085517420,MATH 20E,A02,083772,Staff,20,0,30,10
1650085517420,MATH 20E,B01,083773,Staff,2,2,30,28
1650085517420,MATH 20E,B02,083774,Staff,16,0,30,14
1650085523442,MATH 103A,A01,083777,Staff,0,8,30,30
1650085523442,MATH 103A,A02,083778,Staff,0,7,30,30
1650085523442,MATH 103A,B01,083779,Staff,0,8,30,30
1650085523442,MATH 103A,B02,083780,Staff,1,7,30,29
1650085529470,MATH 105,A01,085443,Staff,1,13,30,29
1650085535495,MATH 109,A01,083213,Anzaldo; Leesa B,1,4,30,29
1650085535495,MATH 109,A02,083214,Anzaldo; Leesa B,0,5,30,30
1650085535495,MATH 109,B01,083215,Anzaldo; Leesa B,0,4,30,30
1650085535495,MATH 109,B02,083216,Anzaldo; Leesa B,1,4,30,29
1650085541519,MATH 142A,A01,083219,Chow; Bennett,0,10,30,30
1650085541519,MATH 142A,A02,083220,Chow; Bennett,0,10,30,30
1650085541519,MATH 142A,B01,083221,Chow; Bennett,0,10,30,30
1650085541519,MATH 142A,B02,083222,Chow; Bennett,0,9,30,30
1650085547548,MATH 193A,A01,083224,Staff,0,4,30,30
1650085547548,MATH 193A,A02,083225,Staff,0,4,30,30
1650085547548,MATH 193A,A03,083781,Staff,0,0,30,30
1650085547548,MATH 193A,A04,083782,Staff,3,0,30,27
1650085553580,MATH 197,001,091859,McAuley; Julian John,9998,0,9999,1
1650085559634,COGS 9,A01,083615,Staff,3,17,60,57
1650085565658,COGS 11,A01,083617,Boyle; Mary E. T.,24,0,40,16
1650085571699,COGS 13,A01,083071,Staff,0,29,40,40
1650085577734,COGS 14A,A01,092681,Staff,1,11,100,99
1650085583759,COGS 14B,A01,083073,Cheng; Tzu-Han,0,4,50,50
1650085589782,COGS 17,A01,092677,Staff,35,0,75,40
1650085595810,COGS 100,A01,083619,Staff,0,21,60,60
1650085601845,COGS 101A,A01,083621,Davis; Joshua Daniel,0,17,60,60
1650085607874,COGS 101B,A01,091572,Staff,10,0,60,50
1650085613898,COGS 101C,A01,083625,Delgado; Tania,21,0,30,9
1650085619922,COGS 107A,A01,083627,Boyle; Mary E. T.,1,4,60,59
1650085625945,COGS 118A,A01,083075,Staff,17,0,60,43
1650085631975,CSE 3,A50,083646,Miranda; Gregory Joseph,22,0,38,16
1650085631975,CSE 3,A51,083647,Miranda; Gregory Joseph,37,0,37,0
1650085638000,CSE 8A,A50,083650,Miranda; Gregory Joseph,0,15,40,40
1650085644027,CSE 11,A01,083080,Cao; Yingjun,0,66,40,40
1650085650055,CSE 12,A01,083652,Staff,0,2,100,100
1650085656081,CSE 15L,A01,083654,Staff,0,0,50,50
1650085656081,CSE 15L,A02,083655,Staff,10,0,50,40
1650085662106,CSE 20,A01,083657,Staff,58,0,80,22
1650085668133,CSE 30,A01,083084,Eldon; John,0,63,40,40
1650085674161,CSE 100,A01,083659,Cao; Yingjun,0,60,50,50
1650085680195,CSE 134B,A01,083661,Powell; Thomas Allan,1,28,65,64
1650085686219,CSE 140,A01,083663,Staff,4,0,75,71
1650085692242,CSE 140L,A01,083088,Eldon; John,0,1,75,75
1650085698265,CSE 175,A01,083665,Kumar; Rakesh,9,0,25,16
1650085704289,CSE 190,A00,092507,Dubnov; Shlomo,14,0,20,6
1650085710311,ECE 45,A01,083139,Staff,0,13,40,40
1650085716337,ECE 65,A50,083695,Staff,0,4,30,30
1650085722360,ECE 109,A01,091882,Touri; Behrouz,48,0,70,22
1650085728383,ECE 180,A00,083140,Abi Samra; Nicholas Camill,24,0,30,6
1650085728383,ECE 180,B00,083141,Abi Samra; Nicholas Camill,8,0,30,22
1650085734408,MATH 10A,A01,083735,Patchell; Gregory David,12,0,30,18
1650085734408,MATH 10A,A02,083736,Patchell; Gregory David,28,0,30,2
1650085734408,MATH 10A,A03,083737,Patchell; Gregory David,26,0,30,4
1650085740434,MATH 10B,A01,083207,Staff,0,5,30,30
1650085740434,MATH 10B,A02,083208,Staff,0,4,30,30
1650085740434,MATH 10B,B01,083739,Staff,18,0,30,12
1650085740434,MATH 10B,B02,083740,Staff,29,0,30,1
1650085746465,MATH 18,A01,083743,Staff,10,0,30,20
1650085746465,MATH 18,A02,083744,Staff,28,0,30,2
1650085746465,MATH 18,A03,083745,Staff,23,0,30,7
1650085746465,MATH 18,A04,083746,Staff,27,0,30,3
1650085746465,MATH 18,B01,083748,Staff,0,9,30,30
1650085746465,MATH 18,B02,083749,Staff,1,7,30,29
1650085746465,MATH 18,B03,083750,Staff,0,6,30,30
1650085746465,MATH 18,B04,083751,Staff,1,8,30,29
1650085752493,MATH 20A,A01,083754,Staff,26,0,40,14
1650085758517,MATH 20B,A01,083756,Staff,0,5,30,30
1650085758517,MATH 20B,A02,083757,Staff,0,2,30,30
1650085764552,MATH 20C,A01,083760,Staff,0,11,30,30
1650085764552,MATH 20C,A02,083761,Staff,0,12,30,30
1650085764552,MATH 20C,B01,083762,Staff,14,0,30,16
1650085764552,MATH 20C,B02,083763,Staff,28,0,30,2
1650085770582,MATH 20D,A01,083765,Staff,0,2,30,30
1650085770582,MATH 20D,A02,083766,Staff,14,0,30,16
1650085770582,MATH 20D,A03,083767,Staff,28,0,30,2
1650085776688,MATH 20E,A01,083771,Staff,10,0,30,20
1650085776688,MATH 20E,A02,083772,Staff,20,0,30,10
1650085776688,MATH 20E,B01,083773,Staff,2,2,30,28
1650085776688,MATH 20E,B02,083774,Staff,16,0,30,14
1650085782713,MATH 103A,A01,083777,Staff,0,8,30,30
1650085782713,MATH 103A,A02,083778,Staff,0,7,30,30
1650085782713,MATH 103A,B01,083779,Staff,0,8,30,30
1650085782713,MATH 103A,B02,083780,Staff,1,7,30,29
1650085788740,MATH 105,A01,085443,Staff,1,13,30,29
1650085794762,MATH 109,A01,083213,Anzaldo; Leesa B,1,4,30,29
1650085794762,MATH 109,A02,083214,Anzaldo; Leesa B,0,5,30,30
1650085794762,MATH 109,B01,083215,Anzaldo; Leesa B,0,4,30,30
1650085794762,MATH 109,B02,083216,Anzaldo; Leesa B,1,4,30,29
1650085800785,MATH 142A,A01,083219,Chow; Bennett,0,10,30,30
1650085800785,MATH 142A,A02,083220,Chow; Bennett,0,10,30,30
1650085800785,MATH 142A,B01,083221,Chow; Bennett,0,10,30,30
1650085800785,MATH 142A,B02,083222,Chow; Bennett,0,9,30,30
1650085806809,MATH 193A,A01,083224,Staff,0,4,30,30
1650085806809,MATH 193A,A02,083225,Staff,0,4,30,30
1650085806809,MATH 193A,A03,083781,Staff,0,0,30,30
1650085806809,MATH 193A,A04,083782,Staff,3,0,30,27
1650085812845,MATH 197,001,091859,McAuley; Julian John,9998,0,9999,1
1650085818908,COGS 9,A01,083615,Staff,3,17,60,57
1650085824936,COGS 11,A01,083617,Boyle; Mary E. T.,24,0,40,16
1650085830961,COGS 13,A01,083071,Staff,0,29,40,40
1650085836996,COGS 14A,A01,092681,Staff,1,11,100,99
1650085843023,COGS 14B,A01,083073,Cheng; Tzu-Han,0,4,50,50
1650085849046,COGS 17,A01,092677,Staff,35,0,75,40
1650085855081,COGS 100,A01,083619,Staff,0,21,60,60
1650085861112,COGS 101A,A01,083621,Davis; Joshua Daniel,0,18,60,60
1650085867138,COGS 101B,A01,091572,Staff,10,0,60,50
1650085873165,COGS 101C,A01,083625,Delgado; Tania,21,0,30,9
1650085879189,COGS 107A,A01,083627,Boyle; Mary E. T.,1,5,60,59
1650085885216,COGS 118A,A01,083075,Staff,17,0,60,43
1650085891242,CSE 3,A50,083646,Miranda; Gregory Joseph,22,0,38,16
1650085891242,CSE 3,A51,083647,Miranda; Gregory Joseph,37,0,37,0
1650085897266,CSE 8A,A50,083650,Miranda; Gregory Joseph,0,15,40,40
1650085903290,CSE 11,A01,083080,Cao; Yingjun,0,66,40,40
1650085909318,CSE 12,A01,083652,Staff,0,2,100,100
1650085915345,CSE 15L,A01,083654,Staff,0,0,50,50
1650085915345,CSE 15L,A02,083655,Staff,10,0,50,40
1650085921373,CSE 20,A01,083657,Staff,58,0,80,22
1650085927421,CSE 30,A01,083084,Eldon; John,0,63,40,40
1650085933451,CSE 100,A01,083659,Cao; Yingjun,0,60,50,50
1650085939475,CSE 134B,A01,083661,Powell; Thomas Allan,1,28,65,64
1650085945501,CSE 140,A01,083663,Staff,4,0,75,71
1650085951533,CSE 140L,A01,083088,Eldon; John,0,1,75,75
1650085957558,CSE 175,A01,083665,Kumar; Rakesh,9,0,25,16
1650085963582,CSE 190,A00,092507,Dubnov; Shlomo,14,0,20,6
1650085969610,ECE 45,A01,083139,Staff,0,13,40,40
1650085975633,ECE 65,A50,083695,Staff,0,4,30,30
1650085981656,ECE 109,A01,091882,Touri; Behrouz,48,0,70,22
1650085987685,ECE 180,A00,083140,Abi Samra; Nicholas Camill,24,0,30,6
1650085987685,ECE 180,B00,083141,Abi Samra; Nicholas Camill,8,0,30,22
1650085993709,MATH 10A,A01,083735,Patchell; Gregory David,12,0,30,18
1650085993709,MATH 10A,A02,083736,Patchell; Gregory David,28,0,30,2
1650085993709,MATH 10A,A03,083737,Patchell; Gregory David,26,0,30,4
1650085999745,MATH 10B,A01,083207,Staff,0,5,30,30
1650085999745,MATH 10B,A02,083208,Staff,0,4,30,30
1650085999745,MATH 10B,B01,083739,Staff,18,0,30,12
1650085999745,MATH 10B,B02,083740,Staff,29,0,30,1
1650086005777,MATH 18,A01,083743,Staff,10,0,30,20
1650086005777,MATH 18,A02,083744,Staff,28,0,30,2
1650086005777,MATH 18,A03,083745,Staff,23,0,30,7
1650086005777,MATH 18,A04,083746,Staff,27,0,30,3
1650086005777,MATH 18,B01,083748,Staff,0,9,30,30
1650086005777,MATH 18,B02,083749,Staff,1,7,30,29
1650086005777,MATH 18,B03,083750,Staff,0,6,30,30
1650086005777,MATH 18,B04,083751,Staff,1,8,30,29
1650086011800,MATH 20A,A01,083754,Staff,26,0,40,14
1650086017834,MATH 20B,A01,083756,Staff,0,5,30,30
1650086017834,MATH 20B,A02,083757,Staff,0,2,30,30
1650086023861,MATH 20C,A01,083760,Staff,0,11,30,30
1650086023861,MATH 20C,A02,083761,Staff,0,12,30,30
1650086023861,MATH 20C,B01,083762,Staff,14,0,30,16
1650086023861,MATH 20C,B02,083763,Staff,28,0,30,2
1650086029882,MATH 20D,A01,083765,Staff,0,2,30,30
1650086029882,MATH 20D,A02,083766,Staff,14,0,30,16
1650086029882,MATH 20D,A03,083767,Staff,28,0,30,2
1650086035907,MATH 20E,A01,083771,Staff,10,0,30,20
1650086035907,MATH 20E,A02,083772,Staff,20,0,30,10
1650086035907,MATH 20E,B01,083773,Staff,2,2,30,28
1650086035907,MATH 20E,B02,083774,Staff,16,0,30,14
1650086041932,MATH 103A,A01,083777,Staff,0,8,30,30
1650086041932,MATH 103A,A02,083778,Staff,0,7,30,30
1650086041932,MATH 103A,B01,083779,Staff,0,8,30,30
1650086041932,MATH 103A,B02,083780,Staff,1,7,30,29
1650086047960,MATH 105,A01,085443,Staff,1,13,30,29
1650086053984,MATH 109,A01,083213,Anzaldo; Leesa B,1,4,30,29
1650086053984,MATH 109,A02,083214,Anzaldo; Leesa B,0,5,30,30
1650086053984,MATH 109,B01,083215,Anzaldo; Leesa B,0,4,30,30
1650086053984,MATH 109,B02,083216,Anzaldo; Leesa B,1,4,30,29
1650086060018,MATH 142A,A01,083219,Chow; Bennett,0,10,30,30
1650086060018,MATH 142A,A02,083220,Chow; Bennett,0,10,30,30
1650086060018,MATH 142A,B01,083221,Chow; Bennett,0,10,30,30
1650086060018,MATH 142A,B02,083222,Chow; Bennett,0,9,30,30
1650086066051,MATH 193A,A01,083224,Staff,0,4,30,30
1650086066051,MATH 193A,A02,083225,Staff,0,4,30,30
1650086066051,MATH 193A,A03,083781,Staff,0,0,30,30
1650086066051,MATH 193A,A04,083782,Staff,3,0,30,27
1650086072074,MATH 197,001,091859,McAuley; Julian John,9998,0,9999,1
1650086078133,COGS 9,A01,083615,Staff,3,17,60,57
1650086084156,COGS 11,A01,083617,Boyle; Mary E. T.,24,0,40,16
1650086090180,COGS 13,A01,083071,Staff,0,29,40,40
1650086096206,COGS 14A,A01,092681,Staff,1,11,100,99
1650086102230,COGS 14B,A01,083073,Cheng; Tzu-Han,0,4,50,50
1650086108267,COGS 17,A01,092677,Staff,35,0,75,40
1650086114288,COGS 100,A01,083619,Staff,0,22,60,60
1650086120311,COGS 101A,A01,083621,Davis; Joshua Daniel,0,18,60,60
1650086126341,COGS 101B,A01,091572,Staff,10,0,60,50
1650086132363,COGS 101C,A01,083625,Delgado; Tania,21,0,30,9
1650086138398,COGS 107A,A01,083627,Boyle; Mary E. T.,1,5,60,59
1650086144425,COGS 118A,A01,083075,Staff,17,0,60,43
1650086150450,CSE 3,A50,083646,Miranda; Gregory Joseph,22,0,38,16
1650086150450,CSE 3,A51,083647,Miranda; Gregory Joseph,37,0,37,0
1650086156474,CSE 8A,A50,083650,Miranda; Gregory Joseph,0,15,40,40
1650086162509,CSE 11,A01,083080,Cao; Yingjun,0,66,40,40
1650086168533,CSE 12,A01,083652,Staff,0,2,100,100
1650086174561,CSE 15L,A01,083654,Staff,0,0,50,50
1650086174561,CSE 15L,A02,083655,Staff,10,0,50,40
1650086180591,CSE 20,A01,083657,Staff,58,0,80,22
1650086186614,CSE 30,A01,083084,Eldon; John,0,63,40,40
1650086192636,CSE 100,A01,083659,Cao; Yingjun,0,60,50,50
1650086198660,CSE 134B,A01,083661,Powell; Thomas Allan,1,28,65,64
1650086204687,CSE 140,A01,083663,Staff,4,0,75,71
1650086210711,CSE 140L,A01,083088,Eldon; John,0,1,75,75
1650086216735,CSE 175,A01,083665,Kumar; Rakesh,9,0,25,16
1650086222762,CSE 190,A00,092507,Dubnov; Shlomo,14,0,20,6
1650086228786,ECE 45,A01,083139,Staff,0,13,40,40
1650086234818,ECE 65,A50,083695,Staff,0,4,30,30
1650086240863,ECE 109,A01,091882,Touri; Behrouz,48,0,70,22
1650086246891,ECE 180,A00,083140,Abi Samra; Nicholas Camill,24,0,30,6
1650086246891,ECE 180,B00,083141,Abi Samra; Nicholas Camill,8,0,30,22
1650086252920,MATH 10A,A01,083735,Patchell; Gregory David,12,0,30,18
1650086252920,MATH 10A,A02,083736,Patchell; Gregory David,28,0,30,2
1650086252920,MATH 10A,A03,083737,Patchell; Gregory David,26,0,30,4
1650086258944,MATH 10B,A01,083207,Staff,0,5,30,30
1650086258944,MATH 10B,A02,083208,Staff,0,4,30,30
1650086258944,MATH 10B,B01,083739,Staff,18,0,30,12
1650086258944,MATH 10B,B02,083740,Staff,29,0,30,1
1650086264974,MATH 18,A01,083743,Staff,10,0,30,20
1650086264974,MATH 18,A02,083744,Staff,28,0,30,2
1650086264974,MATH 18,A03,083745,Staff,23,0,30,7
1650086264974,MATH 18,A04,083746,Staff,27,0,30,3
1650086264974,MATH 18,B01,083748,Staff,0,9,30,30
1650086264974,MATH 18,B02,083749,Staff,1,7,30,29
1650086264974,MATH 18,B03,083750,Staff,0,6,30,30
1650086264974,MATH 18,B04,083751,Staff,1,8,30,29
1650086270998,MATH 20A,A01,083754,Staff,26,0,40,14
1650086277035,MATH 20B,A01,083756,Staff,0,5,30,30
1650086277035,MATH 20B,A02,083757,Staff,0,2,30,30
1650086283059,MATH 20C,A01,083760,Staff,0,11,30,30
1650086283059,MATH 20C,A02,083761,Staff,0,12,30,30
1650086283059,MATH 20C,B01,083762,Staff,14,0,30,16
1650086283059,MATH 20C,B02,083763,Staff,28,0,30,2
1650086289087,MATH 20D,A01,083765,Staff,0,2,30,30
1650086289087,MATH 20D,A02,083766,Staff,13,0,30,17
1650086289087,MATH 20D,A03,083767,Staff,28,0,30,2
1650086295115,MATH 20E,A01,083771,Staff,10,0,30,20
1650086295115,MATH 20E,A02,083772,Staff,20,0,30,10
1650086295115,MATH 20E,B01,083773,Staff,2,2,30,28
1650086295115,MATH 20E,B02,083774,Staff,15,0,30,15
1650086301146,MATH 103A,A01,083777,Staff,0,8,30,30
1650086301146,MATH 103A,A02,083778,Staff,0,7,30,30
1650086301146,MATH 103A,B01,083779,Staff,0,8,30,30
1650086301146,MATH 103A,B02,083780,Staff,1,7,30,29
1650086307175,MATH 105,A01,085443,Staff,1,13,30,29
1650086313211,MATH 109,A01,083213,Anzaldo; Leesa B,1,4,30,29
1650086313211,MATH 109,A02,083214,Anzaldo; Leesa B,0,5,30,30
1650086313211,MATH 109,B01,083215,Anzaldo; Leesa B,0,4,30,30
1650086313211,MATH 109,B02,083216,Anzaldo; Leesa B,1,4,30,29
1650086319239,MATH 142A,A01,083219,Chow; Bennett,0,10,30,30
1650086319239,MATH 142A,A02,083220,Chow; Bennett,0,10,30,30
1650086319239,MATH 142A,B01,083221,Chow; Bennett,0,10,30,30
1650086319239,MATH 142A,B02,083222,Chow; Bennett,0,9,30,30
1650086325266,MATH 193A,A01,083224,Staff,0,4,30,30
1650086325266,MATH 193A,A02,083225,Staff,0,4,30,30
1650086325266,MATH 193A,A03,083781,Staff,0,0,30,30
1650086325266,MATH 193A,A04,083782,Staff,3,0,30,27
1650086331291,MATH 197,001,091859,McAuley; Julian John,9998,0,9999,1
1650086337341,COGS 9,A01,083615,Staff,3,17,60,57
1650086343365,COGS 11,A01,083617,Boyle; Mary E. T.,24,0,40,16
1650086349391,COGS 13,A01,083071,Staff,0,29,40,40
1650086355416,COGS 14A,A01,092681,Staff,1,11,100,99
1650086361451,COGS 14B,A01,083073,Cheng; Tzu-Han,0,4,50,50
1650086367566,COGS 17,A01,092677,Staff,35,0,75,40
1650086373597,COGS 100,A01,083619,Staff,0,22,60,60
1650086379626,COGS 101A,A01,083621,Davis; Joshua Daniel,0,18,60,60
1650086385653,COGS 101B,A01,091572,Staff,10,0,60,50
1650086391685,COGS 101C,A01,083625,Delgado; Tania,21,0,30,9
1650086397712,COGS 107A,A01,083627,Boyle; Mary E. T.,1,5,60,59
1650086403737,COGS 118A,A01,083075,Staff,17,0,60,43
1650086409760,CSE 3,A50,083646,Miranda; Gregory Joseph,22,0,38,16
1650086409760,CSE 3,A51,083647,Miranda; Gregory Joseph,37,0,37,0
1650086415784,CSE 8A,A50,083650,Miranda; Gregory Joseph,0,15,40,40
1650086421812,CSE 11,A01,083080,Cao; Yingjun,0,66,40,40
1650086427836,CSE 12,A01,083652,Staff,0,2,100,100
1650086433863,CSE 15L,A01,083654,Staff,0,0,50,50
1650086433863,CSE 15L,A02,083655,Staff,10,0,50,40
1650086439890,CSE 20,A01,083657,Staff,58,0,80,22
1650086445917,CSE 30,A01,083084,Eldon; John,0,63,40,40
1650086451941,CSE 100,A01,083659,Cao; Yingjun,0,60,50,50
1650086457966,CSE 134B,A01,083661,Powell; Thomas Allan,1,28,65,64
1650086463989,CSE 140,A01,083663,Staff,4,0,75,71
1650086470017,CSE 140L,A01,083088,Eldon; John,0,1,75,75
1650086485828,CSE 175,A01,083665,Kumar; Rakesh,9,0,25,16
1650086491852,CSE 190,A00,092507,Dubnov; Shlomo,14,0,20,6
1650086497876,ECE 45,A01,083139,Staff,0,13,40,40
1650086503904,ECE 65,A50,083695,Staff,0,4,30,30
1650086509936,ECE 109,A01,091882,Touri; Behrouz,48,0,70,22
1650086515961,ECE 180,A00,083140,Abi Samra; Nicholas Camill,24,0,30,6
1650086515961,ECE 180,B00,083141,Abi Samra; Nicholas Camill,8,0,30,22
1650086521986,MATH 10A,A01,083735,Patchell; Gregory David,12,0,30,18
1650086521986,MATH 10A,A02,083736,Patchell; Gregory David,28,0,30,2
1650086521986,MATH 10A,A03,083737,Patchell; Gregory David,26,0,30,4
1650086528009,MATH 10B,A01,083207,Staff,0,5,30,30
1650086528009,MATH 10B,A02,083208,Staff,0,4,30,30
1650086528009,MATH 10B,B01,083739,Staff,18,0,30,12
1650086528009,MATH 10B,B02,083740,Staff,29,0,30,1
1650086534036,MATH 18,A01,083743,Staff,10,0,30,20
1650086534036,MATH 18,A02,083744,Staff,28,0,30,2
1650086534036,MATH 18,A03,083745,Staff,23,0,30,7
1650086534036,MATH 18,A04,083746,Staff,27,0,30,3
1650086534036,MATH 18,B01,083748,Staff,0,9,30,30
1650086534036,MATH 18,B02,083749,Staff,1,7,30,29
1650086534036,MATH 18,B03,083750,Staff,0,6,30,30
1650086534036,MATH 18,B04,083751,Staff,1,8,30,29
1650086540060,MATH 20A,A01,083754,Staff,26,0,40,14
1650086546085,MATH 20B,A01,083756,Staff,0,5,30,30
1650086546085,MATH 20B,A02,083757,Staff,0,2,30,30
1650086552112,MATH 20C,A01,083760,Staff,0,11,30,30
1650086552112,MATH 20C,A02,083761,Staff,0,12,30,30
1650086552112,MATH 20C,B01,083762,Staff,14,0,30,16
1650086552112,MATH 20C,B02,083763,Staff,28,0,30,2
1650086558135,MATH 20D,A01,083765,Staff,0,2,30,30
1650086558135,MATH 20D,A02,083766,Staff,13,0,30,17
1650086558135,MATH 20D,A03,083767,Staff,28,0,30,2
1650086564157,MATH 20E,A01,083771,Staff,10,0,30,20
1650086564157,MATH 20E,A02,083772,Staff,20,0,30,10
1650086564157,MATH 20E,B01,083773,Staff,2,2,30,28
1650086564157,MATH 20E,B02,083774,Staff,15,0,30,15
1650086570180,MATH 103A,A01,083777,Staff,0,8,30,30
1650086570180,MATH 103A,A02,083778,Staff,0,7,30,30
1650086570180,MATH 103A,B01,083779,Staff,0,8,30,30
1650086570180,MATH 103A,B02,083780,Staff,1,7,30,29
1650086576205,MATH 105,A01,085443,Staff,1,13,30,29
1650086582229,MATH 109,A01,083213,Anzaldo; Leesa B,1,4,30,29
1650086582229,MATH 109,A02,083214,Anzaldo; Leesa B,0,5,30,30
1650086582229,MATH 109,B01,083215,Anzaldo; Leesa B,0,4,30,30
1650086582229,MATH 109,B02,083216,Anzaldo; Leesa B,1,4,30,29
1650086588261,MATH 142A,A01,083219,Chow; Bennett,0,10,30,30
1650086588261,MATH 142A,A02,083220,Chow; Bennett,0,10,30,30
1650086588261,MATH 142A,B01,083221,Chow; Bennett,0,10,30,30
1650086588261,MATH 142A,B02,083222,Chow; Bennett,0,9,30,30
1650086594282,MATH 193A,A01,083224,Staff,0,4,30,30
1650086594282,MATH 193A,A02,083225,Staff,0,4,30,30
1650086594282,MATH 193A,A03,083781,Staff,0,0,30,30
1650086594282,MATH 193A,A04,083782,Staff,3,0,30,27
1650086600308,MATH 197,001,091859,McAuley; Julian John,9998,0,9999,1
1650086606368,COGS 9,A01,083615,Staff,3,17,60,57
1650086612393,COGS 11,A01,083617,Boyle; Mary E. T.,24,0,40,16
1650086618421,COGS 13,A01,083071,Staff,0,29,40,40
1650086624448,COGS 14A,A01,092681,Staff,1,11,100,99
1650086630474,COGS 14B,A01,083073,Cheng; Tzu-Han,0,4,50,50
1650086636502,COGS 17,A01,092677,Staff,35,0,75,40
1650086642526,COGS 100,A01,083619,Staff,0,22,60,60
1650086648555,COGS 101A,A01,083621,Davis; Joshua Daniel,0,18,60,60
1650086654579,COGS 101B,A01,091572,Staff,10,0,60,50
1650086660606,COGS 101C,A01,083625,Delgado; Tania,21,0,30,9
1650086666629,COGS 107A,A01,083627,Boyle; Mary E. T.,1,5,60,59
1650086672667,COGS 118A,A01,083075,Staff,17,0,60,43
1650086678695,CSE 3,A50,083646,Miranda; Gregory Joseph,22,0,38,16
1650086678695,CSE 3,A51,083647,Miranda; Gregory Joseph,37,0,37,0
1650086684718,CSE 8A,A50,083650,Miranda; Gregory Joseph,0,15,40,40
1650086690743,CSE 11,A01,083080,Cao; Yingjun,0,66,40,40
1650086696766,CSE 12,A01,083652,Staff,0,2,100,100
1650086702790,CSE 15L,A01,083654,Staff,0,0,50,50
1650086702790,CSE 15L,A02,083655,Staff,10,0,50,40
1650086708817,CSE 20,A01,083657,Staff,58,0,80,22
1650086714845,CSE 30,A01,083084,Eldon; John,0,63,40,40
1650086720868,CSE 100,A01,083659,Cao; Yingjun,0,60,50,50
1650086726896,CSE 134B,A01,083661,Powell; Thomas Allan,1,28,65,64
1650086732918,CSE 140,A01,083663,Staff,4,0,75,71
1650086738948,CSE 140L,A01,083088,Eldon; John,0,1,75,75
1650086744970,CSE 175,A01,083665,Kumar; Rakesh,9,0,25,16
1650086750993,CSE 190,A00,092507,Dubnov; Shlomo,14,0,20,6
1650086757019,ECE 45,A01,083139,Staff,0,13,40,40
1650086763044,ECE 65,A50,083695,Staff,0,4,30,30
1650086769072,ECE 109,A01,091882,Touri; Behrouz,48,0,70,22
1650086775096,ECE 180,A00,083140,Abi Samra; Nicholas Camill,24,0,30,6
1650086775096,ECE 180,B00,083141,Abi Samra; Nicholas Camill,8,0,30,22
1650086781121,MATH 10A,A01,083735,Patchell; Gregory David,12,0,30,18
1650086781121,MATH 10A,A02,083736,Patchell; Gregory David,28,0,30,2
1650086781121,MATH 10A,A03,083737,Patchell; Gregory David,26,0,30,4
1650086787153,MATH 10B,A01,083207,Staff,0,5,30,30
1650086787153,MATH 10B,A02,083208,Staff,0,4,30,30
1650086787153,MATH 10B,B01,083739,Staff,18,0,30,12
1650086787153,MATH 10B,B02,083740,Staff,29,0,30,1
1650086793194,MATH 18,A01,083743,Staff,10,0,30,20
1650086793194,MATH 18,A02,083744,Staff,28,0,30,2
1650086793194,MATH 18,A03,083745,Staff,23,0,30,7
1650086793194,MATH 18,A04,083746,Staff,27,0,30,3
1650086793194,MATH 18,B01,083748,Staff,0,9,30,30
1650086793194,MATH 18,B02,083749,Staff,0,6,30,30
1650086793194,MATH 18,B03,083750,Staff,0,6,30,30
1650086793194,MATH 18,B04,083751,Staff,0,7,30,30
1650086799219,MATH 20A,A01,083754,Staff,26,0,40,14
1650086805243,MATH 20B,A01,083756,Staff,0,5,30,30
1650086805243,MATH 20B,A02,083757,Staff,0,2,30,30
1650086811266,MATH 20C,A01,083760,Staff,0,11,30,30
1650086811266,MATH 20C,A02,083761,Staff,0,12,30,30
1650086811266,MATH 20C,B01,083762,Staff,14,0,30,16
1650086811266,MATH 20C,B02,083763,Staff,28,0,30,2
1650086817293,MATH 20D,A01,083765,Staff,0,2,30,30
1650086817293,MATH 20D,A02,083766,Staff,13,0,30,17
1650086817293,MATH 20D,A03,083767,Staff,28,0,30,2
1650086823327,MATH 20E,A01,083771,Staff,10,0,30,20
1650086823327,MATH 20E,A02,083772,Staff,20,0,30,10
1650086823327,MATH 20E,B01,083773,Staff,0,0,30,30
1650086823327,MATH 20E,B02,083774,Staff,15,0,30,15
1650086829352,MATH 103A,A01,083777,Staff,0,8,30,30
1650086829352,MATH 103A,A02,083778,Staff,0,7,30,30
1650086829352,MATH 103A,B01,083779,Staff,0,8,30,30
1650086829352,MATH 103A,B02,083780,Staff,0,6,30,30
1650086835377,MATH 105,A01,085443,Staff,0,12,30,30
1650086841402,MATH 109,A01,083213,Anzaldo; Leesa B,0,3,30,30
1650086841402,MATH 109,A02,083214,Anzaldo; Leesa B,0,5,30,30
1650086841402,MATH 109,B01,083215,Anzaldo; Leesa B,0,4,30,30
1650086841402,MATH 109,B02,083216,Anzaldo; Leesa B,0,3,30,30
1650086847431,MATH 142A,A01,083219,Chow; Bennett,0,10,30,30
1650086847431,MATH 142A,A02,083220,Chow; Bennett,0,10,30,30
1650086847431,MATH 142A,B01,083221,Chow; Bennett,0,10,30,30
1650086847431,MATH 142A,B02,083222,Chow; Bennett,0,9,30,30
1650086853462,MATH 193A,A01,083224,Staff,0,4,30,30
1650086853462,MATH 193A,A02,083225,Staff,0,4,30,30
1650086853462,MATH 193A,A03,083781,Staff,0,0,30,30
1650086853462,MATH 193A,A04,083782,Staff,3,0,30,27
1650086859489,MATH 197,001,091859,McAuley; Julian John,9998,0,9999,1
1650086865550,COGS 9,A01,083615,Staff,0,14,60,60
1650086871573,COGS 11,A01,083617,Boyle; Mary E. T.,24,0,40,16
1650086877598,COGS 13,A01,083071,Staff,0,28,40,40
1650086883623,COGS 14A,A01,092681,Staff,0,10,100,100
1650086889647,COGS 14B,A01,083073,Cheng; Tzu-Han,0,4,50,50
1650086895669,COGS 17,A01,092677,Staff,34,0,75,41
1650086901695,COGS 100,A01,083619,Staff,0,22,60,60
1650086907718,COGS 101A,A01,083621,Davis; Joshua Daniel,0,18,60,60
1650086913742,COGS 101B,A01,091572,Staff,10,0,60,50
1650086919773,COGS 101C,A01,083625,Delgado; Tania,21,0,30,9
1650086925802,COGS 107A,A01,083627,Boyle; Mary E. T.,0,4,60,60
1650086931827,COGS 118A,A01,083075,Staff,17,0,60,43
1650086937851,CSE 3,A50,083646,Miranda; Gregory Joseph,22,0,38,16
1650086937851,CSE 3,A51,083647,Miranda; Gregory Joseph,37,0,37,0
1650086943875,CSE 8A,A50,083650,Miranda; Gregory Joseph,0,15,40,40
1650086949902,CSE 11,A01,083080,Cao; Yingjun,0,66,40,40
1650086955926,CSE 12,A01,083652,Staff,0,2,100,100
1650086961950,CSE 15L,A01,083654,Staff,0,0,50,50
1650086961950,CSE 15L,A02,083655,Staff,10,0,50,40
1650086967974,CSE 20,A01,083657,Staff,58,0,80,22
1650086974091,CSE 30,A01,083084,Eldon; John,0,63,40,40
1650086980119,CSE 100,A01,083659,Cao; Yingjun,0,60,50,50
1650086986147,CSE 134B,A01,083661,Powell; Thomas Allan,0,27,65,65
1650086992170,CSE 140,A01,083663,Staff,4,0,75,71
1650086998196,CSE 140L,A01,083088,Eldon; John,0,1,75,75
1650087004220,CSE 175,A01,083665,Kumar; Rakesh,9,0,25,16
1650087010242,CSE 190,A00,092507,Dubnov; Shlomo,14,0,20,6
1650087016270,ECE 45,A01,083139,Staff,0,13,40,40
1650087022293,ECE 65,A50,083695,Staff,0,4,30,30
1650087028318,ECE 109,A01,091882,Touri; Behrouz,48,0,70,22
1650087034343,ECE 180,A00,083140,Abi Samra; Nicholas Camill,24,0,30,6
1650087034343,ECE 180,B00,083141,Abi Samra; Nicholas Camill,8,0,30,22
1650087040375,MATH 10A,A01,083735,Patchell; Gregory David,12,0,30,18
1650087040375,MATH 10A,A02,083736,Patchell; Gregory David,28,0,30,2
1650087040375,MATH 10A,A03,083737,Patchell; Gregory David,26,0,30,4
1650087046409,MATH 10B,A01,083207,Staff,0,5,30,30
1650087046409,MATH 10B,A02,083208,Staff,0,4,30,30
1650087046409,MATH 10B,B01,083739,Staff,18,0,30,12
1650087046409,MATH 10B,B02,083740,Staff,29,0,30,1
1650087052439,MATH 18,A01,083743,Staff,10,0,30,20
1650087052439,MATH 18,A02,083744,Staff,28,0,30,2
1650087052439,MATH 18,A03,083745,Staff,23,0,30,7
1650087052439,MATH 18,A04,083746,Staff,27,0,30,3
1650087052439,MATH 18,B01,083748,Staff,0,9,30,30
1650087052439,MATH 18,B02,083749,Staff,0,6,30,30
1650087052439,MATH 18,B03,083750,Staff,0,6,30,30
1650087052439,MATH 18,B04,083751,Staff,0,7,30,30
1650087058463,MATH 20A,A01,083754,Staff,26,0,40,14
1650087064489,MATH 20B,A01,083756,Staff,0,5,30,30
1650087064489,MATH 20B,A02,083757,Staff,0,2,30,30
1650087070512,MATH 20C,A01,083760,Staff,0,11,30,30
1650087070512,MATH 20C,A02,083761,Staff,0,12,30,30
1650087070512,MATH 20C,B01,083762,Staff,14,0,30,16
1650087070512,MATH 20C,B02,083763,Staff,28,0,30,2
1650087076535,MATH 20D,A01,083765,Staff,0,2,30,30
1650087076535,MATH 20D,A02,083766,Staff,13,0,30,17
1650087076535,MATH 20D,A03,083767,Staff,28,0,30,2
1650087082562,MATH 20E,A01,083771,Staff,10,0,30,20
1650087082562,MATH 20E,A02,083772,Staff,20,0,30,10
1650087082562,MATH 20E,B01,083773,Staff,0,0,30,30
1650087082562,MATH 20E,B02,083774,Staff,15,0,30,15
1650087088585,MATH 103A,A01,083777,Staff,0,8,30,30
1650087088585,MATH 103A,A02,083778,Staff,0,7,30,30
1650087088585,MATH 103A,B01,083779,Staff,0,8,30,30
1650087088585,MATH 103A,B02,083780,Staff,0,6,30,30
1650087094609,MATH 105,A01,085443,Staff,0,12,30,30
1650087100631,MATH 109,A01,083213,Anzaldo; Leesa B,0,3,30,30
1650087100631,MATH 109,A02,083214,Anzaldo; Leesa B,0,5,30,30
1650087100631,MATH 109,B01,083215,Anzaldo; Leesa B,0,4,30,30
1650087100631,MATH 109,B02,083216,Anzaldo; Leesa B,0,3,30,30
1650087106659,MATH 142A,A01,083219,Chow; Bennett,0,10,30,30
1650087106659,MATH 142A,A02,083220,Chow; Bennett,0,10,30,30
1650087106659,MATH 142A,B01,083221,Chow; Bennett,0,10,30,30
1650087106659,MATH 142A,B02,083222,Chow; Bennett,0,9,30,30
1650087112687,MATH 193A,A01,083224,Staff,0,4,30,30
1650087112687,MATH 193A,A02,083225,Staff,0,4,30,30
1650087112687,MATH 193A,A03,083781,Staff,0,0,30,30
1650087112687,MATH 193A,A04,083782,Staff,3,0,30,27
1650087118713,MATH 197,001,091859,McAuley; Julian John,9998,0,9999,1
1650087124778,COGS 9,A01,083615,Staff,0,14,60,60
1650087130803,COGS 11,A01,083617,Boyle; Mary E. T.,24,0,40,16
1650087136826,COGS 13,A01,083071,Staff,0,28,40,40
1650087142848,COGS 14A,A01,092681,Staff,0,10,100,100
1650087148875,COGS 14B,A01,083073,Cheng; Tzu-Han,0,4,50,50
1650087154906,COGS 17,A01,092677,Staff,34,0,75,41
1650087160932,COGS 100,A01,083619,Staff,0,22,60,60
1650087166957,COGS 101A,A01,083621,Davis; Joshua Daniel,0,18,60,60
1650087172980,COGS 101B,A01,091572,Staff,10,0,60,50
1650087179007,COGS 101C,A01,083625,Delgado; Tania,21,0,30,9
1650087185034,COGS 107A,A01,083627,Boyle; Mary E. T.,0,4,60,60
1650087191073,COGS 118A,A01,083075,Staff,17,0,60,43
1650087197114,CSE 3,A50,083646,Miranda; Gregory Joseph,22,0,38,16
1650087197114,CSE 3,A51,083647,Miranda; Gregory Joseph,37,0,37,0
1650087203143,CSE 8A,A50,083650,Miranda; Gregory Joseph,0,15,40,40
1650087209169,CSE 11,A01,083080,Cao; Yingjun,0,66,40,40
1650087215192,CSE 12,A01,083652,Staff,0,2,100,100
1650087221217,CSE 15L,A01,083654,Staff,0,0,50,50
1650087221217,CSE 15L,A02,083655,Staff,10,0,50,40
1650087227256,CSE 20,A01,083657,Staff,58,0,80,22
1650087233282,CSE 30,A01,083084,Eldon; John,0,63,40,40
1650087239307,CSE 100,A01,083659,Cao; Yingjun,0,60,50,50
1650087245333,CSE 134B,A01,083661,Powell; Thomas Allan,0,27,65,65
1650087251359,CSE 140,A01,083663,Staff,4,0,75,71
1650087257386,CSE 140L,A01,083088,Eldon; John,0,1,75,75
1650087263410,CSE 175,A01,083665,Kumar; Rakesh,9,0,25,16
1650087269434,CSE 190,A00,092507,Dubnov; Shlomo,14,0,20,6
1650087275456,ECE 45,A01,083139,Staff,0,13,40,40
1650087281482,ECE 65,A50,083695,Staff,0,4,30,30
1650087287505,ECE 109,A01,091882,Touri; Behrouz,48,0,70,22
1650087293540,ECE 180,A00,083140,Abi Samra; Nicholas Camill,24,0,30,6
1650087293540,ECE 180,B00,083141,Abi Samra; Nicholas Camill,8,0,30,22
1650087299564,MATH 10A,A01,083735,Patchell; Gregory David,12,0,30,18
1650087299564,MATH 10A,A02,083736,Patchell; Gregory David,28,0,30,2
1650087299564,MATH 10A,A03,083737,Patchell; Gregory David,26,0,30,4
1650087305599,MATH 10B,A01,083207,Staff,0,5,30,30
1650087305599,MATH 10B,A02,083208,Staff,0,4,30,30
1650087305599,MATH 10B,B01,083739,Staff,18,0,30,12
1650087305599,MATH 10B,B02,083740,Staff,29,0,30,1
1650087311629,MATH 18,A01,083743,Staff,10,0,30,20
1650087311629,MATH 18,A02,083744,Staff,28,0,30,2
1650087311629,MATH 18,A03,083745,Staff,23,0,30,7
1650087311629,MATH 18,A04,083746,Staff,27,0,30,3
1650087311629,MATH 18,B01,083748,Staff,0,9,30,30
1650087311629,MATH 18,B02,083749,Staff,0,6,30,30
1650087311629,MATH 18,B03,083750,Staff,0,6,30,30
1650087311629,MATH 18,B04,083751,Staff,0,7,30,30
1650087317653,MATH 20A,A01,083754,Staff,26,0,40,14
1650087323684,MATH 20B,A01,083756,Staff,0,5,30,30
1650087323684,MATH 20B,A02,083757,Staff,0,2,30,30
1650087329708,MATH 20C,A01,083760,Staff,0,11,30,30
1650087329708,MATH 20C,A02,083761,Staff,0,12,30,30
1650087329708,MATH 20C,B01,083762,Staff,14,0,30,16
1650087329708,MATH 20C,B02,083763,Staff,28,0,30,2
1650087335741,MATH 20D,A01,083765,Staff,0,2,30,30
1650087335741,MATH 20D,A02,083766,Staff,13,0,30,17
1650087335741,MATH 20D,A03,083767,Staff,28,0,30,2
1650087341770,MATH 20E,A01,083771,Staff,10,0,30,20
1650087341770,MATH 20E,A02,083772,Staff,20,0,30,10
1650087341770,MATH 20E,B01,083773,Staff,0,0,30,30
1650087341770,MATH 20E,B02,083774,Staff,15,0,30,15
1650087347794,MATH 103A,A01,083777,Staff,0,8,30,30
1650087347794,MATH 103A,A02,083778,Staff,0,7,30,30
1650087347794,MATH 103A,B01,083779,Staff,0,8,30,30
1650087347794,MATH 103A,B02,083780,Staff,0,6,30,30
1650087353821,MATH 105,A01,085443,Staff,0,12,30,30
1650087359846,MATH 109,A01,083213,Anzaldo; Leesa B,0,3,30,30
1650087359846,MATH 109,A02,083214,Anzaldo; Leesa B,0,5,30,30
1650087359846,MATH 109,B01,083215,Anzaldo; Leesa B,0,4,30,30
1650087359846,MATH 109,B02,083216,Anzaldo; Leesa B,0,3,30,30
1650087365869,MATH 142A,A01,083219,Chow; Bennett,0,10,30,30
1650087365869,MATH 142A,A02,083220,Chow; Bennett,0,10,30,30
1650087365869,MATH 142A,B01,083221,Chow; Bennett,0,10,30,30
1650087365869,MATH 142A,B02,083222,Chow; Bennett,0,9,30,30
1650087371891,MATH 193A,A01,083224,Staff,0,4,30,30
1650087371891,MATH 193A,A02,083225,Staff,0,4,30,30
1650087371891,MATH 193A,A03,083781,Staff,0,0,30,30
1650087371891,MATH 193A,A04,083782,Staff,3,0,30,27
1650087377916,MATH 197,001,091859,McAuley; Julian John,9998,0,9999,1
1650087383974,COGS 9,A01,083615,Staff,0,14,60,60
1650087390002,COGS 11,A01,083617,Boyle; Mary E. T.,24,0,40,16
1650087396029,COGS 13,A01,083071,Staff,0,28,40,40
1650087402056,COGS 14A,A01,092681,Staff,0,10,100,100
1650087408083,COGS 14B,A01,083073,Cheng; Tzu-Han,0,4,50,50
1650087414107,COGS 17,A01,092677,Staff,34,0,75,41
1650087420130,COGS 100,A01,083619,Staff,0,22,60,60
1650087426155,COGS 101A,A01,083621,Davis; Joshua Daniel,0,18,60,60
1650087432181,COGS 101B,A01,091572,Staff,10,0,60,50
1650087438205,COGS 101C,A01,083625,Delgado; Tania,21,0,30,9
1650087444232,COGS 107A,A01,083627,Boyle; Mary E. T.,0,4,60,60
1650087450259,COGS 118A,A01,083075,Staff,17,0,60,43
1650087456283,CSE 3,A50,083646,Miranda; Gregory Joseph,22,0,38,16
1650087456283,CSE 3,A51,083647,Miranda; Gregory Joseph,37,0,37,0
1650087462309,CSE 8A,A50,083650,Miranda; Gregory Joseph,0,15,40,40
1650087468336,CSE 11,A01,083080,Cao; Yingjun,0,66,40,40
1650087474360,CSE 12,A01,083652,Staff,0,2,100,100
1650087480388,CSE 15L,A01,083654,Staff,0,0,50,50
1650087480388,CSE 15L,A02,083655,Staff,10,0,50,40
1650087486412,CSE 20,A01,083657,Staff,58,0,80,22
1650087492439,CSE 30,A01,083084,Eldon; John,0,63,40,40
1650087498508,CSE 100,A01,083659,Cao; Yingjun,0,60,50,50
1650087504538,CSE 134B,A01,083661,Powell; Thomas Allan,0,27,65,65
1650087510561,CSE 140,A01,083663,Staff,4,0,75,71
1650087516589,CSE 140L,A01,083088,Eldon; John,0,1,75,75
1650087522614,CSE 175,A01,083665,Kumar; Rakesh,9,0,25,16
1650087528637,CSE 190,A00,092507,Dubnov; Shlomo,14,0,20,6
1650087534664,ECE 45,A01,083139,Staff,0,13,40,40
1650087540690,ECE 65,A50,083695,Staff,0,4,30,30
1650087546716,ECE 109,A01,091882,Touri; Behrouz,48,0,70,22
1650087552739,ECE 180,A00,083140,Abi Samra; Nicholas Camill,24,0,30,6
1650087552739,ECE 180,B00,083141,Abi Samra; Nicholas Camill,8,0,30,22
1650087558762,MATH 10A,A01,083735,Patchell; Gregory David,12,0,30,18
1650087558762,MATH 10A,A02,083736,Patchell; Gregory David,28,0,30,2
1650087558762,MATH 10A,A03,083737,Patchell; Gregory David,26,0,30,4
1650087564796,MATH 10B,A01,083207,Staff,0,5,30,30
1650087564796,MATH 10B,A02,083208,Staff,0,4,30,30
1650087564796,MATH 10B,B01,083739,Staff,18,0,30,12
1650087564796,MATH 10B,B02,083740,Staff,29,0,30,1
1650087570925,MATH 18,A01,083743,Staff,10,0,30,20
1650087570925,MATH 18,A02,083744,Staff,28,0,30,2
1650087570925,MATH 18,A03,083745,Staff,23,0,30,7
1650087570925,MATH 18,A04,083746,Staff,27,0,30,3
1650087570925,MATH 18,B01,083748,Staff,0,9,30,30
1650087570925,MATH 18,B02,083749,Staff,0,6,30,30
1650087570925,MATH 18,B03,083750,Staff,0,6,30,30
1650087570925,MATH 18,B04,083751,Staff,0,7,30,30
1650087576955,MATH 20A,A01,083754,Staff,26,0,40,14
1650087582979,MATH 20B,A01,083756,Staff,0,5,30,30
1650087582979,MATH 20B,A02,083757,Staff,0,2,30,30
1650087589002,MATH 20C,A01,083760,Staff,0,11,30,30
1650087589002,MATH 20C,A02,083761,Staff,0,12,30,30
1650087589002,MATH 20C,B01,083762,Staff,14,0,30,16
1650087589002,MATH 20C,B02,083763,Staff,28,0,30,2
1650087595036,MATH 20D,A01,083765,Staff,0,2,30,30
1650087595036,MATH 20D,A02,083766,Staff,12,0,30,18
1650087595036,MATH 20D,A03,083767,Staff,28,0,30,2
1650087601070,MATH 20E,A01,083771,Staff,10,0,30,20
1650087601070,MATH 20E,A02,083772,Staff,20,0,30,10
1650087601070,MATH 20E,B01,083773,Staff,0,0,30,30
1650087601070,MATH 20E,B02,083774,Staff,15,0,30,15
1650087607097,MATH 103A,A01,083777,Staff,0,8,30,30
1650087607097,MATH 103A,A02,083778,Staff,0,7,30,30
1650087607097,MATH 103A,B01,083779,Staff,0,8,30,30
1650087607097,MATH 103A,B02,083780,Staff,0,6,30,30
1650087613125,MATH 105,A01,085443,Staff,0,12,30,30
1650087619149,MATH 109,A01,083213,Anzaldo; Leesa B,0,3,30,30
1650087619149,MATH 109,A02,083214,Anzaldo; Leesa B,0,5,30,30
1650087619149,MATH 109,B01,083215,Anzaldo; Leesa B,0,4,30,30
1650087619149,MATH 109,B02,083216,Anzaldo; Leesa B,0,3,30,30
1650087625173,MATH 142A,A01,083219,Chow; Bennett,0,10,30,30
1650087625173,MATH 142A,A02,083220,Chow; Bennett,0,10,30,30
1650087625173,MATH 142A,B01,083221,Chow; Bennett,0,10,30,30
1650087625173,MATH 142A,B02,083222,Chow; Bennett,0,9,30,30
1650087631201,MATH 193A,A01,083224,Staff,0,4,30,30
1650087631201,MATH 193A,A02,083225,Staff,0,4,30,30
1650087631201,MATH 193A,A03,083781,Staff,0,0,30,30
1650087631201,MATH 193A,A04,083782,Staff,3,0,30,27
1650087637224,MATH 197,001,091859,McAuley; Julian John,9998,0,9999,1
1650087643285,COGS 9,A01,083615,Staff,0,14,60,60
1650087649309,COGS 11,A01,083617,Boyle; Mary E. T.,24,0,40,16
1650087655332,COGS 13,A01,083071,Staff,0,28,40,40
1650087661354,COGS 14A,A01,092681,Staff,0,10,100,100
1650087667377,COGS 14B,A01,083073,Cheng; Tzu-Han,0,4,50,50
1650087673401,COGS 17,A01,092677,Staff,34,0,75,41
1650087679426,COGS 100,A01,083619,Staff,0,22,60,60
1650087685453,COGS 101A,A01,083621,Davis; Joshua Daniel,0,18,60,60
1650087691477,COGS 101B,A01,091572,Staff,10,0,60,50
1650087697500,COGS 101C,A01,083625,Delgado; Tania,21,0,30,9
1650087703524,COGS 107A,A01,083627,Boyle; Mary E. T.,0,4,60,60
1650087709551,COGS 118A,A01,083075,Staff,17,0,60,43
1650087715578,CSE 3,A50,083646,Miranda; Gregory Joseph,22,0,38,16
1650087715578,CSE 3,A51,083647,Miranda; Gregory Joseph,37,0,37,0
1650087721607,CSE 8A,A50,083650,Miranda; Gregory Joseph,0,15,40,40
1650087727630,CSE 11,A01,083080,Cao; Yingjun,0,66,40,40
1650087733653,CSE 12,A01,083652,Staff,0,2,100,100
1650087739680,CSE 15L,A01,083654,Staff,0,0,50,50
1650087739680,CSE 15L,A02,083655,Staff,10,0,50,40
1650087745704,CSE 20,A01,083657,Staff,58,0,80,22
1650087751727,CSE 30,A01,083084,Eldon; John,0,63,40,40
1650087757762,CSE 100,A01,083659,Cao; Yingjun,0,60,50,50
1650087763786,CSE 134B,A01,083661,Powell; Thomas Allan,0,27,65,65
1650087769809,CSE 140,A01,083663,Staff,4,0,75,71
1650087775832,CSE 140L,A01,083088,Eldon; John,0,1,75,75
1650087781858,CSE 175,A01,083665,Kumar; Rakesh,9,0,25,16
1650087787881,CSE 190,A00,092507,Dubnov; Shlomo,14,0,20,6
1650087793905,ECE 45,A01,083139,Staff,0,13,40,40
1650087799930,ECE 65,A50,083695,Staff,0,4,30,30
1650087805957,ECE 109,A01,091882,Touri; Behrouz,48,0,70,22
1650087811981,ECE 180,A00,083140,Abi Samra; Nicholas Camill,24,0,30,6
1650087811981,ECE 180,B00,083141,Abi Samra; Nicholas Camill,8,0,30,22
1650087818008,MATH 10A,A01,083735,Patchell; Gregory David,12,0,30,18
1650087818008,MATH 10A,A02,083736,Patchell; Gregory David,28,0,30,2
1650087818008,MATH 10A,A03,083737,Patchell; Gregory David,26,0,30,4
1650087824032,MATH 10B,A01,083207,Staff,0,5,30,30
1650087824032,MATH 10B,A02,083208,Staff,0,4,30,30
1650087824032,MATH 10B,B01,083739,Staff,18,0,30,12
1650087824032,MATH 10B,B02,083740,Staff,29,0,30,1
1650087830058,MATH 18,A01,083743,Staff,10,0,30,20
1650087830058,MATH 18,A02,083744,Staff,28,0,30,2
1650087830058,MATH 18,A03,083745,Staff,23,0,30,7
1650087830058,MATH 18,A04,083746,Staff,27,0,30,3
1650087830058,MATH 18,B01,083748,Staff,0,9,30,30
1650087830058,MATH 18,B02,083749,Staff,0,6,30,30
1650087830058,MATH 18,B03,083750,Staff,0,6,30,30
1650087830058,MATH 18,B04,083751,Staff,0,7,30,30
1650087836085,MATH 20A,A01,083754,Staff,26,0,40,14
1650087842112,MATH 20B,A01,083756,Staff,0,5,30,30
1650087842112,MATH 20B,A02,083757,Staff,0,2,30,30
1650087848134,MATH 20C,A01,083760,Staff,0,11,30,30
1650087848134,MATH 20C,A02,083761,Staff,0,12,30,30
1650087848134,MATH 20C,B01,083762,Staff,14,0,30,16
1650087848134,MATH 20C,B02,083763,Staff,28,0,30,2
1650087854157,MATH 20D,A01,083765,Staff,0,2,30,30
1650087854157,MATH 20D,A02,083766,Staff,12,0,30,18
1650087854157,MATH 20D,A03,083767,Staff,28,0,30,2
1650087860180,MATH 20E,A01,083771,Staff,10,0,30,20
1650087860180,MATH 20E,A02,083772,Staff,20,0,30,10
1650087860180,MATH 20E,B01,083773,Staff,0,0,30,30
1650087860180,MATH 20E,B02,083774,Staff,15,0,30,15
1650087866204,MATH 103A,A01,083777,Staff,0,8,30,30
1650087866204,MATH 103A,A02,083778,Staff,0,7,30,30
1650087866204,MATH 103A,B01,083779,Staff,0,8,30,30
1650087866204,MATH 103A,B02,083780,Staff,0,6,30,30
1650087872230,MATH 105,A01,085443,Staff,0,12,30,30
1650087878260,MATH 109,A01,083213,Anzaldo; Leesa B,0,3,30,30
1650087878260,MATH 109,A02,083214,Anzaldo; Leesa B,0,5,30,30
1650087878260,MATH 109,B01,083215,Anzaldo; Leesa B,0,4,30,30
1650087878260,MATH 109,B02,083216,Anzaldo; Leesa B,0,3,30,30
1650087884288,MATH 142A,A01,083219,Chow; Bennett,0,10,30,30
1650087884288,MATH 142A,A02,083220,Chow; Bennett,0,10,30,30
1650087884288,MATH 142A,B01,083221,Chow; Bennett,0,10,30,30
1650087884288,MATH 142A,B02,083222,Chow; Bennett,0,9,30,30
1650087890314,MATH 193A,A01,083224,Staff,0,4,30,30
1650087890314,MATH 193A,A02,083225,Staff,0,4,30,30
1650087890314,MATH 193A,A03,083781,Staff,0,0,30,30
1650087890314,MATH 193A,A04,083782,Staff,3,0,30,27
1650087896336,MATH 197,001,091859,McAuley; Julian John,9998,0,9999,1
1650087902397,COGS 9,A01,083615,Staff,0,14,60,60
1650087908419,COGS 11,A01,083617,Boyle; Mary E. T.,24,0,40,16
1650087914449,COGS 13,A01,083071,Staff,0,28,40,40
1650087920479,COGS 14A,A01,092681,Staff,0,10,100,100
1650087926501,COGS 14B,A01,083073,Cheng; Tzu-Han,0,4,50,50
1650087932539,COGS 17,A01,092677,Staff,34,0,75,41
1650087938565,COGS 100,A01,083619,Staff,0,22,60,60
1650087944592,COGS 101A,A01,083621,Davis; Joshua Daniel,0,18,60,60
1650087950615,COGS 101B,A01,091572,Staff,10,0,60,50
1650087956641,COGS 101C,A01,083625,Delgado; Tania,21,0,30,9
1650087962668,COGS 107A,A01,083627,Boyle; Mary E. T.,0,4,60,60
1650087968694,COGS 118A,A01,083075,Staff,17,0,60,43
1650087974724,CSE 3,A50,083646,Miranda; Gregory Joseph,22,0,38,16
1650087974724,CSE 3,A51,083647,Miranda; Gregory Joseph,37,0,37,0
1650087980747,CSE 8A,A50,083650,Miranda; Gregory Joseph,0,15,40,40
1650087986772,CSE 11,A01,083080,Cao; Yingjun,0,66,40,40
1650087992799,CSE 12,A01,083652,Staff,0,2,100,100
1650087998825,CSE 15L,A01,083654,Staff,0,0,50,50
1650087998825,CSE 15L,A02,083655,Staff,10,0,50,40
1650088004852,CSE 20,A01,083657,Staff,58,0,80,22
1650088010875,CSE 30,A01,083084,Eldon; John,0,63,40,40
1650088016901,CSE 100,A01,083659,Cao; Yingjun,0,60,50,50
1650088022932,CSE 134B,A01,083661,Powell; Thomas Allan,0,27,65,65
1650088028957,CSE 140,A01,083663,Staff,4,0,75,71
1650088034983,CSE 140L,A01,083088,Eldon; John,0,1,75,75
1650088041009,CSE 175,A01,083665,Kumar; Rakesh,9,0,25,16
1650088047033,CSE 190,A00,092507,Dubnov; Shlomo,14,0,20,6
1650088053061,ECE 45,A01,083139,Staff,0,13,40,40
1650088059085,ECE 65,A50,083695,Staff,0,4,30,30
1650088065115,ECE 109,A01,091882,Touri; Behrouz,48,0,70,22
1650088071138,ECE 180,A00,083140,Abi Samra; Nicholas Camill,24,0,30,6
1650088071138,ECE 180,B00,083141,Abi Samra; Nicholas Camill,8,0,30,22
1650088077162,MATH 10A,A01,083735,Patchell; Gregory David,12,0,30,18
1650088077162,MATH 10A,A02,083736,Patchell; Gregory David,28,0,30,2
1650088077162,MATH 10A,A03,083737,Patchell; Gregory David,26,0,30,4
1650088083189,MATH 10B,A01,083207,Staff,0,5,30,30
1650088083189,MATH 10B,A02,083208,Staff,0,4,30,30
1650088083189,MATH 10B,B01,083739,Staff,18,0,30,12
1650088083189,MATH 10B,B02,083740,Staff,29,0,30,1
1650088089214,MATH 18,A01,083743,Staff,10,0,30,20
1650088089214,MATH 18,A02,083744,Staff,28,0,30,2
1650088089214,MATH 18,A03,083745,Staff,23,0,30,7
1650088089214,MATH 18,A04,083746,Staff,27,0,30,3
1650088089214,MATH 18,B01,083748,Staff,0,9,30,30
1650088089214,MATH 18,B02,083749,Staff,0,6,30,30
1650088089214,MATH 18,B03,083750,Staff,0,6,30,30
1650088089214,MATH 18,B04,083751,Staff,0,7,30,30
1650088095237,MATH 20A,A01,083754,Staff,26,0,40,14
1650088101266,MATH 20B,A01,083756,Staff,0,5,30,30
1650088101266,MATH 20B,A02,083757,Staff,0,2,30,30
1650088107297,MATH 20C,A01,083760,Staff,0,11,30,30
1650088107297,MATH 20C,A02,083761,Staff,0,12,30,30
1650088107297,MATH 20C,B01,083762,Staff,14,0,30,16
1650088107297,MATH 20C,B02,083763,Staff,28,0,30,2
1650088113325,MATH 20D,A01,083765,Staff,0,2,30,30
1650088113325,MATH 20D,A02,083766,Staff,12,0,30,18
1650088113325,MATH 20D,A03,083767,Staff,28,0,30,2
1650088119352,MATH 20E,A01,083771,Staff,10,0,30,20
1650088119352,MATH 20E,A02,083772,Staff,20,0,30,10
1650088119352,MATH 20E,B01,083773,Staff,0,0,30,30
1650088119352,MATH 20E,B02,083774,Staff,15,0,30,15
1650088125380,MATH 103A,A01,083777,Staff,0,8,30,30
1650088125380,MATH 103A,A02,083778,Staff,0,7,30,30
1650088125380,MATH 103A,B01,083779,Staff,0,8,30,30
1650088125380,MATH 103A,B02,083780,Staff,0,6,30,30
1650088131407,MATH 105,A01,085443,Staff,0,12,30,30
1650088137431,MATH 109,A01,083213,Anzaldo; Leesa B,0,3,30,30
1650088137431,MATH 109,A02,083214,Anzaldo; Leesa B,0,5,30,30
1650088137431,MATH 109,B01,083215,Anzaldo; Leesa B,0,4,30,30
1650088137431,MATH 109,B02,083216,Anzaldo; Leesa B,0,3,30,30
1650088143465,MATH 142A,A01,083219,Chow; Bennett,0,10,30,30
1650088143465,MATH 142A,A02,083220,Chow; Bennett,0,10,30,30
1650088143465,MATH 142A,B01,083221,Chow; Bennett,0,10,30,30
1650088143465,MATH 142A,B02,083222,Chow; Bennett,0,9,30,30
1650088149492,MATH 193A,A01,083224,Staff,0,4,30,30
1650088149492,MATH 193A,A02,083225,Staff,0,4,30,30
1650088149492,MATH 193A,A03,083781,Staff,0,0,30,30
1650088149492,MATH 193A,A04,083782,Staff,3,0,30,27
1650088155515,MATH 197,001,091859,McAuley; Julian John,9998,0,9999,1
1650088161656,COGS 9,A01,083615,Staff,0,14,60,60
1650088167688,COGS 11,A01,083617,Boyle; Mary E. T.,24,0,40,16
1650088173712,COGS 13,A01,083071,Staff,0,28,40,40
1650088179738,COGS 14A,A01,092681,Staff,0,10,100,100
1650088185762,COGS 14B,A01,083073,Cheng; Tzu-Han,0,4,50,50
1650088191787,COGS 17,A01,092677,Staff,34,0,75,41
1650088197811,COGS 100,A01,083619,Staff,0,22,60,60
1650088203835,COGS 101A,A01,083621,Davis; Joshua Daniel,0,18,60,60
1650088209860,COGS 101B,A01,091572,Staff,10,0,60,50
1650088215884,COGS 101C,A01,083625,Delgado; Tania,21,0,30,9
1650088221906,COGS 107A,A01,083627,Boyle; Mary E. T.,0,4,60,60
1650088227929,COGS 118A,A01,083075,Staff,17,0,60,43
1650088233962,CSE 3,A50,083646,Miranda; Gregory Joseph,22,0,38,16
1650088233962,CSE 3,A51,083647,Miranda; Gregory Joseph,37,0,37,0
1650088239994,CSE 8A,A50,083650,Miranda; Gregory Joseph,0,15,40,40
1650088246018,CSE 11,A01,083080,Cao; Yingjun,0,66,40,40
1650088252042,CSE 12,A01,083652,Staff,0,2,100,100
1650088258070,CSE 15L,A01,083654,Staff,0,0,50,50
1650088258070,CSE 15L,A02,083655,Staff,10,0,50,40
1650088264097,CSE 20,A01,083657,Staff,58,0,80,22
1650088270121,CSE 30,A01,083084,Eldon; John,0,63,40,40
1650088276149,CSE 100,A01,083659,Cao; Yingjun,0,60,50,50
1650088282181,CSE 134B,A01,083661,Powell; Thomas Allan,0,27,65,65
1650088288204,CSE 140,A01,083663,Staff,4,0,75,71
1650088294235,CSE 140L,A01,083088,Eldon; John,0,1,75,75
1650088300257,CSE 175,A01,083665,Kumar; Rakesh,9,0,25,16
1650088306284,CSE 190,A00,092507,Dubnov; Shlomo,14,0,20,6
1650088312319,ECE 45,A01,083139,Staff,0,13,40,40
1650088318341,ECE 65,A50,083695,Staff,0,4,30,30
1650088324363,ECE 109,A01,091882,Touri; Behrouz,48,0,70,22
1650088330390,ECE 180,A00,083140,Abi Samra; Nicholas Camill,24,0,30,6
1650088330390,ECE 180,B00,083141,Abi Samra; Nicholas Camill,8,0,30,22
1650088336420,MATH 10A,A01,083735,Patchell; Gregory David,12,0,30,18
1650088336420,MATH 10A,A02,083736,Patchell; Gregory David,28,0,30,2
1650088336420,MATH 10A,A03,083737,Patchell; Gregory David,26,0,30,4
1650088342450,MATH 10B,A01,083207,Staff,0,5,30,30
1650088342450,MATH 10B,A02,083208,Staff,0,4,30,30
1650088342450,MATH 10B,B01,083739,Staff,18,0,30,12
1650088342450,MATH 10B,B02,083740,Staff,29,0,30,1
1650088348475,MATH 18,A01,083743,Staff,10,0,30,20
1650088348475,MATH 18,A02,083744,Staff,28,0,30,2
1650088348475,MATH 18,A03,083745,Staff,23,0,30,7
1650088348475,MATH 18,A04,083746,Staff,27,0,30,3
1650088348475,MATH 18,B01,083748,Staff,0,9,30,30
1650088348475,MATH 18,B02,083749,Staff,0,6,30,30
1650088348475,MATH 18,B03,083750,Staff,0,6,30,30
1650088348475,MATH 18,B04,083751,Staff,0,7,30,30
1650088354498,MATH 20A,A01,083754,Staff,26,0,40,14
1650088360528,MATH 20B,A01,083756,Staff,0,5,30,30
1650088360528,MATH 20B,A02,083757,Staff,0,2,30,30
1650088366550,MATH 20C,A01,083760,Staff,0,11,30,30
1650088366550,MATH 20C,A02,083761,Staff,0,12,30,30
1650088366550,MATH 20C,B01,083762,Staff,14,0,30,16
1650088366550,MATH 20C,B02,083763,Staff,28,0,30,2
1650088372575,MATH 20D,A01,083765,Staff,0,2,30,30
1650088372575,MATH 20D,A02,083766,Staff,12,0,30,18
1650088372575,MATH 20D,A03,083767,Staff,28,0,30,2
1650088378604,MATH 20E,A01,083771,Staff,10,0,30,20
1650088378604,MATH 20E,A02,083772,Staff,20,0,30,10
1650088378604,MATH 20E,B01,083773,Staff,0,0,30,30
1650088378604,MATH 20E,B02,083774,Staff,15,0,30,15
1650088384630,MATH 103A,A01,083777,Staff,0,8,30,30
1650088384630,MATH 103A,A02,083778,Staff,0,7,30,30
1650088384630,MATH 103A,B01,083779,Staff,0,8,30,30
1650088384630,MATH 103A,B02,083780,Staff,0,6,30,30
1650088390654,MATH 105,A01,085443,Staff,0,12,30,30
1650088396682,MATH 109,A01,083213,Anzaldo; Leesa B,0,3,30,30
1650088396682,MATH 109,A02,083214,Anzaldo; Leesa B,0,5,30,30
1650088396682,MATH 109,B01,083215,Anzaldo; Leesa B,0,4,30,30
1650088396682,MATH 109,B02,083216,Anzaldo; Leesa B,0,3,30,30
1650088402704,MATH 142A,A01,083219,Chow; Bennett,0,10,30,30
1650088402704,MATH 142A,A02,083220,Chow; Bennett,0,10,30,30
1650088402704,MATH 142A,B01,083221,Chow; Bennett,0,10,30,30
1650088402704,MATH 142A,B02,083222,Chow; Bennett,0,9,30,30
1650088408728,MATH 193A,A01,083224,Staff,0,4,30,30
1650088408728,MATH 193A,A02,083225,Staff,0,4,30,30
1650088408728,MATH 193A,A03,083781,Staff,0,0,30,30
1650088408728,MATH 193A,A04,083782,Staff,3,0,30,27
1650088414752,MATH 197,001,091859,McAuley; Julian John,9998,0,9999,1
1650088420815,COGS 9,A01,083615,Staff,0,14,60,60
1650088426841,COGS 11,A01,083617,Boyle; Mary E. T.,24,0,40,16
1650088432864,COGS 13,A01,083071,Staff,0,28,40,40
1650088438887,COGS 14A,A01,092681,Staff,0,10,100,100
1650088444911,COGS 14B,A01,083073,Cheng; Tzu-Han,0,4,50,50
1650088450937,COGS 17,A01,092677,Staff,34,0,75,41
1650088456962,COGS 100,A01,083619,Staff,0,22,60,60
1650088462985,COGS 101A,A01,083621,Davis; Joshua Daniel,0,18,60,60
1650088469011,COGS 101B,A01,091572,Staff,10,0,60,50
1650088475036,COGS 101C,A01,083625,Delgado; Tania,21,0,30,9
1650088481060,COGS 107A,A01,083627,Boyle; Mary E. T.,0,4,60,60
1650088487084,COGS 118A,A01,083075,Staff,17,0,60,43
1650088493110,CSE 3,A50,083646,Miranda; Gregory Joseph,22,0,38,16
1650088493110,CSE 3,A51,083647,Miranda; Gregory Joseph,37,0,37,0
1650088499133,CSE 8A,A50,083650,Miranda; Gregory Joseph,0,15,40,40
1650088505156,CSE 11,A01,083080,Cao; Yingjun,0,66,40,40
1650088511178,CSE 12,A01,083652,Staff,0,2,100,100
1650088517205,CSE 15L,A01,083654,Staff,0,0,50,50
1650088517205,CSE 15L,A02,083655,Staff,10,0,50,40
1650088523227,CSE 20,A01,083657,Staff,58,0,80,22
1650088529250,CSE 30,A01,083084,Eldon; John,0,63,40,40
1650088535282,CSE 100,A01,083659,Cao; Yingjun,0,60,50,50
1650088541304,CSE 134B,A01,083661,Powell; Thomas Allan,0,27,65,65
1650088547330,CSE 140,A01,083663,Staff,4,0,75,71
1650088553359,CSE 140L,A01,083088,Eldon; John,0,1,75,75
1650088559386,CSE 175,A01,083665,Kumar; Rakesh,9,0,25,16
1650088565410,CSE 190,A00,092507,Dubnov; Shlomo,14,0,20,6
1650088571436,ECE 45,A01,083139,Staff,0,13,40,40
1650088577484,ECE 65,A50,083695,Staff,0,4,30,30
1650088583511,ECE 109,A01,091882,Touri; Behrouz,48,0,70,22
1650088589537,ECE 180,A00,083140,Abi Samra; Nicholas Camill,24,0,30,6
1650088589537,ECE 180,B00,083141,Abi Samra; Nicholas Camill,8,0,30,22
1650088595561,MATH 10A,A01,083735,Patchell; Gregory David,12,0,30,18
1650088595561,MATH 10A,A02,083736,Patchell; Gregory David,28,0,30,2
1650088595561,MATH 10A,A03,083737,Patchell; Gregory David,26,0,30,4
1650088601585,MATH 10B,A01,083207,Staff,0,5,30,30
1650088601585,MATH 10B,A02,083208,Staff,0,4,30,30
1650088601585,MATH 10B,B01,083739,Staff,18,0,30,12
1650088601585,MATH 10B,B02,083740,Staff,29,0,30,1
1650088607610,MATH 18,A01,083743,Staff,10,0,30,20
1650088607610,MATH 18,A02,083744,Staff,28,0,30,2
1650088607610,MATH 18,A03,083745,Staff,23,0,30,7
1650088607610,MATH 18,A04,083746,Staff,27,0,30,3
1650088607610,MATH 18,B01,083748,Staff,0,9,30,30
1650088607610,MATH 18,B02,083749,Staff,0,6,30,30
1650088607610,MATH 18,B03,083750,Staff,0,6,30,30
1650088607610,MATH 18,B04,083751,Staff,0,7,30,30
1650088613634,MATH 20A,A01,083754,Staff,26,0,40,14
1650088619657,MATH 20B,A01,083756,Staff,0,5,30,30
1650088619657,MATH 20B,A02,083757,Staff,0,2,30,30
1650088625685,MATH 20C,A01,083760,Staff,0,11,30,30
1650088625685,MATH 20C,A02,083761,Staff,0,12,30,30
1650088625685,MATH 20C,B01,083762,Staff,14,0,30,16
1650088625685,MATH 20C,B02,083763,Staff,28,0,30,2
1650088631709,MATH 20D,A01,083765,Staff,0,2,30,30
1650088631709,MATH 20D,A02,083766,Staff,12,0,30,18
1650088631709,MATH 20D,A03,083767,Staff,28,0,30,2
1650088637733,MATH 20E,A01,083771,Staff,10,0,30,20
1650088637733,MATH 20E,A02,083772,Staff,20,0,30,10
1650088637733,MATH 20E,B01,083773,Staff,0,0,30,30
1650088637733,MATH 20E,B02,083774,Staff,15,0,30,15
1650088643758,MATH 103A,A01,083777,Staff,0,8,30,30
1650088643758,MATH 103A,A02,083778,Staff,0,7,30,30
1650088643758,MATH 103A,B01,083779,Staff,0,8,30,30
1650088643758,MATH 103A,B02,083780,Staff,0,6,30,30
1650088649785,MATH 105,A01,085443,Staff,0,12,30,30
1650088655810,MATH 109,A01,083213,Anzaldo; Leesa B,0,3,30,30
1650088655810,MATH 109,A02,083214,Anzaldo; Leesa B,0,5,30,30
1650088655810,MATH 109,B01,083215,Anzaldo; Leesa B,0,4,30,30
1650088655810,MATH 109,B02,083216,Anzaldo; Leesa B,0,3,30,30
1650088661837,MATH 142A,A01,083219,Chow; Bennett,0,10,30,30
1650088661837,MATH 142A,A02,083220,Chow; Bennett,0,10,30,30
1650088661837,MATH 142A,B01,083221,Chow; Bennett,0,10,30,30
1650088661837,MATH 142A,B02,083222,Chow; Bennett,0,9,30,30
1650088667871,MATH 193A,A01,083224,Staff,0,4,30,30
1650088667871,MATH 193A,A02,083225,Staff,0,4,30,30
1650088667871,MATH 193A,A03,083781,Staff,0,0,30,30
1650088667871,MATH 193A,A04,083782,Staff,3,0,30,27
1650088673897,MATH 197,001,091859,McAuley; Julian John,9998,0,9999,1
1650088679956,COGS 9,A01,083615,Staff,0,14,60,60
1650088685982,COGS 11,A01,083617,Boyle; Mary E. T.,24,0,40,16
1650088692006,COGS 13,A01,083071,Staff,0,28,40,40
1650088698033,COGS 14A,A01,092681,Staff,0,10,100,100
1650088704057,COGS 14B,A01,083073,Cheng; Tzu-Han,0,4,50,50
1650088710079,COGS 17,A01,092677,Staff,34,0,75,41
1650088716103,COGS 100,A01,083619,Staff,0,22,60,60
1650088722127,COGS 101A,A01,083621,Davis; Joshua Daniel,0,18,60,60
1650088728154,COGS 101B,A01,091572,Staff,10,0,60,50
1650088734181,COGS 101C,A01,083625,Delgado; Tania,21,0,30,9
1650088740205,COGS 107A,A01,083627,Boyle; Mary E. T.,0,4,60,60
1650088746234,COGS 118A,A01,083075,Staff,17,0,60,43
1650088752262,CSE 3,A50,083646,Miranda; Gregory Joseph,22,0,38,16
1650088752262,CSE 3,A51,083647,Miranda; Gregory Joseph,37,0,37,0
1650088758384,CSE 8A,A50,083650,Miranda; Gregory Joseph,0,15,40,40
1650088764412,CSE 11,A01,083080,Cao; Yingjun,0,66,40,40
1650088770434,CSE 12,A01,083652,Staff,0,2,100,100
1650088776458,CSE 15L,A01,083654,Staff,0,0,50,50
1650088776458,CSE 15L,A02,083655,Staff,10,0,50,40
1650088782483,CSE 20,A01,083657,Staff,58,0,80,22
1650088788508,CSE 30,A01,083084,Eldon; John,0,63,40,40
1650088794544,CSE 100,A01,083659,Cao; Yingjun,0,60,50,50
1650088800584,CSE 134B,A01,083661,Powell; Thomas Allan,0,27,65,65
1650088806607,CSE 140,A01,083663,Staff,4,0,75,71
1650088812635,CSE 140L,A01,083088,Eldon; John,0,1,75,75
1650088818658,CSE 175,A01,083665,Kumar; Rakesh,9,0,25,16
1650088824685,CSE 190,A00,092507,Dubnov; Shlomo,14,0,20,6
1650088830712,ECE 45,A01,083139,Staff,0,13,40,40
1650088836744,ECE 65,A50,083695,Staff,0,4,30,30
1650088842773,ECE 109,A01,091882,Touri; Behrouz,48,0,70,22
1650088848807,ECE 180,A00,083140,Abi Samra; Nicholas Camill,24,0,30,6
1650088848807,ECE 180,B00,083141,Abi Samra; Nicholas Camill,8,0,30,22
1650088854851,MATH 10A,A01,083735,Patchell; Gregory David,12,0,30,18
1650088854851,MATH 10A,A02,083736,Patchell; Gregory David,28,0,30,2
1650088854851,MATH 10A,A03,083737,Patchell; Gregory David,26,0,30,4
1650088860885,MATH 10B,A01,083207,Staff,0,5,30,30
1650088860885,MATH 10B,A02,083208,Staff,0,4,30,30
1650088860885,MATH 10B,B01,083739,Staff,18,0,30,12
1650088860885,MATH 10B,B02,083740,Staff,29,0,30,1
1650088866928,MATH 18,A01,083743,Staff,10,0,30,20
1650088866928,MATH 18,A02,083744,Staff,28,0,30,2
1650088866928,MATH 18,A03,083745,Staff,23,0,30,7
1650088866928,MATH 18,A04,083746,Staff,27,0,30,3
1650088866928,MATH 18,B01,083748,Staff,0,9,30,30
1650088866928,MATH 18,B02,083749,Staff,0,6,30,30
1650088866928,MATH 18,B03,083750,Staff,0,6,30,30
1650088866928,MATH 18,B04,083751,Staff,0,7,30,30
1650088872952,MATH 20A,A01,083754,Staff,26,0,40,14
1650088878977,MATH 20B,A01,083756,Staff,0,5,30,30
1650088878977,MATH 20B,A02,083757,Staff,0,2,30,30
1650088885006,MATH 20C,A01,083760,Staff,0,11,30,30
1650088885006,MATH 20C,A02,083761,Staff,0,12,30,30
1650088885006,MATH 20C,B01,083762,Staff,14,0,30,16
1650088885006,MATH 20C,B02,083763,Staff,28,0,30,2
1650088891031,MATH 20D,A01,083765,Staff,0,2,30,30
1650088891031,MATH 20D,A02,083766,Staff,12,0,30,18
1650088891031,MATH 20D,A03,083767,Staff,28,0,30,2
1650088897061,MATH 20E,A01,083771,Staff,10,0,30,20
1650088897061,MATH 20E,A02,083772,Staff,20,0,30,10
1650088897061,MATH 20E,B01,083773,Staff,0,0,30,30
1650088897061,MATH 20E,B02,083774,Staff,15,0,30,15
1650088903091,MATH 103A,A01,083777,Staff,0,8,30,30
1650088903091,MATH 103A,A02,083778,Staff,0,7,30,30
1650088903091,MATH 103A,B01,083779,Staff,0,8,30,30
1650088903091,MATH 103A,B02,083780,Staff,0,6,30,30
1650088909116,MATH 105,A01,085443,Staff,0,12,30,30
1650088915144,MATH 109,A01,083213,Anzaldo; Leesa B,0,3,30,30
1650088915144,MATH 109,A02,083214,Anzaldo; Leesa B,0,5,30,30
1650088915144,MATH 109,B01,083215,Anzaldo; Leesa B,0,4,30,30
1650088915144,MATH 109,B02,083216,Anzaldo; Leesa B,0,3,30,30
1650088921169,MATH 142A,A01,083219,Chow; Bennett,0,10,30,30
1650088921169,MATH 142A,A02,083220,Chow; Bennett,0,10,30,30
1650088921169,MATH 142A,B01,083221,Chow; Bennett,0,10,30,30
1650088921169,MATH 142A,B02,083222,Chow; Bennett,0,9,30,30
1650088927192,MATH 193A,A01,083224,Staff,0,4,30,30
1650088927192,MATH 193A,A02,083225,Staff,0,4,30,30
1650088927192,MATH 193A,A03,083781,Staff,0,0,30,30
1650088927192,MATH 193A,A04,083782,Staff,3,0,30,27
1650088933216,MATH 197,001,091859,McAuley; Julian John,9998,0,9999,1
1650088939290,COGS 9,A01,083615,Staff,0,14,60,60
1650088945319,COGS 11,A01,083617,Boyle; Mary E. T.,24,0,40,16
1650088951350,COGS 13,A01,083071,Staff,0,28,40,40
1650088957382,COGS 14A,A01,092681,Staff,0,10,100,100
1650088963406,COGS 14B,A01,083073,Cheng; Tzu-Han,0,4,50,50
1650088969431,COGS 17,A01,092677,Staff,34,0,75,41
1650088975459,COGS 100,A01,083619,Staff,0,22,60,60
1650088981486,COGS 101A,A01,083621,Davis; Joshua Daniel,0,18,60,60
1650088987514,COGS 101B,A01,091572,Staff,10,0,60,50
1650088993542,COGS 101C,A01,083625,Delgado; Tania,21,0,30,9
1650088999569,COGS 107A,A01,083627,Boyle; Mary E. T.,0,4,60,60
1650089005595,COGS 118A,A01,083075,Staff,17,0,60,43
1650089011624,CSE 3,A50,083646,Miranda; Gregory Joseph,22,0,38,16
1650089011624,CSE 3,A51,083647,Miranda; Gregory Joseph,37,0,37,0
1650089017656,CSE 8A,A50,083650,Miranda; Gregory Joseph,0,15,40,40
1650089023681,CSE 11,A01,083080,Cao; Yingjun,0,66,40,40
1650089029708,CSE 12,A01,083652,Staff,0,2,100,100
1650089035737,CSE 15L,A01,083654,Staff,0,0,50,50
1650089035737,CSE 15L,A02,083655,Staff,10,0,50,40
1650089041765,CSE 20,A01,083657,Staff,58,0,80,22
1650089047794,CSE 30,A01,083084,Eldon; John,0,63,40,40
1650089053817,CSE 100,A01,083659,Cao; Yingjun,0,60,50,50
1650089059840,CSE 134B,A01,083661,Powell; Thomas Allan,0,27,65,65
1650089065864,CSE 140,A01,083663,Staff,4,0,75,71
1650089071892,CSE 140L,A01,083088,Eldon; John,0,1,75,75
1650089077922,CSE 175,A01,083665,Kumar; Rakesh,9,0,25,16
1650089083950,CSE 190,A00,092507,Dubnov; Shlomo,14,0,20,6
1650089089974,ECE 45,A01,083139,Staff,0,13,40,40
1650089095999,ECE 65,A50,083695,Staff,0,4,30,30
1650089102030,ECE 109,A01,091882,Touri; Behrouz,48,0,70,22
1650089108060,ECE 180,A00,083140,Abi Samra; Nicholas Camill,24,0,30,6
1650089108060,ECE 180,B00,083141,Abi Samra; Nicholas Camill,8,0,30,22
1650089114082,MATH 10A,A01,083735,Patchell; Gregory David,12,0,30,18
1650089114082,MATH 10A,A02,083736,Patchell; Gregory David,28,0,30,2
1650089114082,MATH 10A,A03,083737,Patchell; Gregory David,26,0,30,4
1650089120114,MATH 10B,A01,083207,Staff,0,5,30,30
1650089120114,MATH 10B,A02,083208,Staff,0,4,30,30
1650089120114,MATH 10B,B01,083739,Staff,18,0,30,12
1650089120114,MATH 10B,B02,083740,Staff,29,0,30,1
1650089126150,MATH 18,A01,083743,Staff,10,0,30,20
1650089126150,MATH 18,A02,083744,Staff,28,0,30,2
1650089126150,MATH 18,A03,083745,Staff,23,0,30,7
1650089126150,MATH 18,A04,083746,Staff,27,0,30,3
1650089126150,MATH 18,B01,083748,Staff,0,9,30,30
1650089126150,MATH 18,B02,083749,Staff,0,6,30,30
1650089126150,MATH 18,B03,083750,Staff,0,6,30,30
1650089126150,MATH 18,B04,083751,Staff,0,7,30,30
1650089132174,MATH 20A,A01,083754,Staff,26,0,40,14
1650089138205,MATH 20B,A01,083756,Staff,0,5,30,30
1650089138205,MATH 20B,A02,083757,Staff,0,2,30,30
1650089144229,MATH 20C,A01,083760,Staff,0,11,30,30
1650089144229,MATH 20C,A02,083761,Staff,0,12,30,30
1650089144229,MATH 20C,B01,083762,Staff,14,0,30,16
1650089144229,MATH 20C,B02,083763,Staff,28,0,30,2
1650089150251,MATH 20D,A01,083765,Staff,0,2,30,30
1650089150251,MATH 20D,A02,083766,Staff,12,0,30,18
1650089150251,MATH 20D,A03,083767,Staff,28,0,30,2
1650089156275,MATH 20E,A01,083771,Staff,10,0,30,20
1650089156275,MATH 20E,A02,083772,Staff,20,0,30,10
1650089156275,MATH 20E,B01,083773,Staff,0,0,30,30
1650089156275,MATH 20E,B02,083774,Staff,15,0,30,15
1650089162298,MATH 103A,A01,083777,Staff,0,8,30,30
1650089162298,MATH 103A,A02,083778,Staff,0,7,30,30
1650089162298,MATH 103A,B01,083779,Staff,0,8,30,30
1650089162298,MATH 103A,B02,083780,Staff,0,6,30,30
1650089168319,MATH 105,A01,085443,Staff,0,12,30,30
1650089174347,MATH 109,A01,083213,Anzaldo; Leesa B,0,3,30,30
1650089174347,MATH 109,A02,083214,Anzaldo; Leesa B,0,5,30,30
1650089174347,MATH 109,B01,083215,Anzaldo; Leesa B,0,4,30,30
1650089174347,MATH 109,B02,083216,Anzaldo; Leesa B,0,3,30,30
1650089180372,MATH 142A,A01,083219,Chow; Bennett,0,10,30,30
1650089180372,MATH 142A,A02,083220,Chow; Bennett,0,10,30,30
1650089180372,MATH 142A,B01,083221,Chow; Bennett,0,10,30,30
1650089180372,MATH 142A,B02,083222,Chow; Bennett,0,9,30,30
1650089186394,MATH 193A,A01,083224,Staff,0,4,30,30
1650089186394,MATH 193A,A02,083225,Staff,0,4,30,30
1650089186394,MATH 193A,A03,083781,Staff,0,0,30,30
1650089186394,MATH 193A,A04,083782,Staff,3,0,30,27
1650089192418,MATH 197,001,091859,McAuley; Julian John,9998,0,9999,1
1650089198486,COGS 9,A01,083615,Staff,0,14,60,60
1650089204514,COGS 11,A01,083617,Boyle; Mary E. T.,24,0,40,16
1650089210538,COGS 13,A01,083071,Staff,0,28,40,40
1650089216560,COGS 14A,A01,092681,Staff,0,10,100,100
1650089222584,COGS 14B,A01,083073,Cheng; Tzu-Han,0,4,50,50
1650089228613,COGS 17,A01,092677,Staff,34,0,75,41
1650089234639,COGS 100,A01,083619,Staff,0,22,60,60
1650089240673,COGS 101A,A01,083621,Davis; Joshua Daniel,0,18,60,60
1650089246697,COGS 101B,A01,091572,Staff,10,0,60,50
1650089252725,COGS 101C,A01,083625,Delgado; Tania,21,0,30,9
1650089258748,COGS 107A,A01,083627,Boyle; Mary E. T.,0,4,60,60
1650089264785,COGS 118A,A01,083075,Staff,17,0,60,43
1650089270813,CSE 3,A50,083646,Miranda; Gregory Joseph,22,0,38,16
1650089270813,CSE 3,A51,083647,Miranda; Gregory Joseph,37,0,37,0
1650089276838,CSE 8A,A50,083650,Miranda; Gregory Joseph,0,15,40,40
1650089282863,CSE 11,A01,083080,Cao; Yingjun,0,66,40,40
1650089288891,CSE 12,A01,083652,Staff,0,2,100,100
1650089294915,CSE 15L,A01,083654,Staff,0,0,50,50
1650089294915,CSE 15L,A02,083655,Staff,10,0,50,40
1650089300939,CSE 20,A01,083657,Staff,58,0,80,22
1650089306966,CSE 30,A01,083084,Eldon; John,0,63,40,40
1650089312994,CSE 100,A01,083659,Cao; Yingjun,0,60,50,50
1650089319025,CSE 134B,A01,083661,Powell; Thomas Allan,0,27,65,65
1650089325052,CSE 140,A01,083663,Staff,4,0,75,71
1650089331080,CSE 140L,A01,083088,Eldon; John,0,1,75,75
1650089337107,CSE 175,A01,083665,Kumar; Rakesh,9,0,25,16
1650089343132,CSE 190,A00,092507,Dubnov; Shlomo,14,0,20,6
1650089349173,ECE 45,A01,083139,Staff,0,13,40,40
1650089355283,ECE 65,A50,083695,Staff,0,4,30,30
1650089361306,ECE 109,A01,091882,Touri; Behrouz,48,0,70,22
1650089367332,ECE 180,A00,083140,Abi Samra; Nicholas Camill,24,0,30,6
1650089367332,ECE 180,B00,083141,Abi Samra; Nicholas Camill,8,0,30,22
1650089373360,MATH 10A,A01,083735,Patchell; Gregory David,12,0,30,18
1650089373360,MATH 10A,A02,083736,Patchell; Gregory David,28,0,30,2
1650089373360,MATH 10A,A03,083737,Patchell; Gregory David,26,0,30,4
1650089379386,MATH 10B,A01,083207,Staff,0,5,30,30
1650089379386,MATH 10B,A02,083208,Staff,0,4,30,30
1650089379386,MATH 10B,B01,083739,Staff,18,0,30,12
1650089379386,MATH 10B,B02,083740,Staff,29,0,30,1
1650089385416,MATH 18,A01,083743,Staff,10,0,30,20
1650089385416,MATH 18,A02,083744,Staff,28,0,30,2
1650089385416,MATH 18,A03,083745,Staff,23,0,30,7
1650089385416,MATH 18,A04,083746,Staff,27,0,30,3
1650089385416,MATH 18,B01,083748,Staff,0,9,30,30
1650089385416,MATH 18,B02,083749,Staff,0,6,30,30
1650089385416,MATH 18,B03,083750,Staff,0,6,30,30
1650089385416,MATH 18,B04,083751,Staff,0,7,30,30
1650089391444,MATH 20A,A01,083754,Staff,26,0,40,14
1650089397466,MATH 20B,A01,083756,Staff,0,5,30,30
1650089397466,MATH 20B,A02,083757,Staff,0,2,30,30
1650089403491,MATH 20C,A01,083760,Staff,0,11,30,30
1650089403491,MATH 20C,A02,083761,Staff,0,12,30,30
1650089403491,MATH 20C,B01,083762,Staff,14,0,30,16
1650089403491,MATH 20C,B02,083763,Staff,28,0,30,2
1650089409518,MATH 20D,A01,083765,Staff,0,2,30,30
1650089409518,MATH 20D,A02,083766,Staff,12,0,30,18
1650089409518,MATH 20D,A03,083767,Staff,28,0,30,2
1650089415542,MATH 20E,A01,083771,Staff,10,0,30,20
1650089415542,MATH 20E,A02,083772,Staff,20,0,30,10
1650089415542,MATH 20E,B01,083773,Staff,0,0,30,30
1650089415542,MATH 20E,B02,083774,Staff,15,0,30,15
1650089421566,MATH 103A,A01,083777,Staff,0,8,30,30
1650089421566,MATH 103A,A02,083778,Staff,0,7,30,30
1650089421566,MATH 103A,B01,083779,Staff,0,8,30,30
1650089421566,MATH 103A,B02,083780,Staff,0,6,30,30
1650089427592,MATH 105,A01,085443,Staff,0,12,30,30
1650089433630,MATH 109,A01,083213,Anzaldo; Leesa B,0,3,30,30
1650089433630,MATH 109,A02,083214,Anzaldo; Leesa B,0,5,30,30
1650089433630,MATH 109,B01,083215,Anzaldo; Leesa B,0,4,30,30
1650089433630,MATH 109,B02,083216,Anzaldo; Leesa B,0,3,30,30
1650089439658,MATH 142A,A01,083219,Chow; Bennett,0,10,30,30
1650089439658,MATH 142A,A02,083220,Chow; Bennett,0,10,30,30
1650089439658,MATH 142A,B01,083221,Chow; Bennett,0,10,30,30
1650089439658,MATH 142A,B02,083222,Chow; Bennett,0,9,30,30
1650089445682,MATH 193A,A01,083224,Staff,0,4,30,30
1650089445682,MATH 193A,A02,083225,Staff,0,4,30,30
1650089445682,MATH 193A,A03,083781,Staff,0,0,30,30
1650089445682,MATH 193A,A04,083782,Staff,3,0,30,27
1650089451707,MATH 197,001,091859,McAuley; Julian John,9998,0,9999,1
1650089457759,COGS 9,A01,083615,Staff,0,14,60,60
1650089463783,COGS 11,A01,083617,Boyle; Mary E. T.,24,0,40,16
1650089469812,COGS 13,A01,083071,Staff,0,28,40,40
1650089475836,COGS 14A,A01,092681,Staff,0,10,100,100
1650089481860,COGS 14B,A01,083073,Cheng; Tzu-Han,0,4,50,50
1650089487884,COGS 17,A01,092677,Staff,34,0,75,41
1650089493907,COGS 100,A01,083619,Staff,0,22,60,60
1650089499932,COGS 101A,A01,083621,Davis; Joshua Daniel,0,18,60,60
1650089505963,COGS 101B,A01,091572,Staff,10,0,60,50
1650089511985,COGS 101C,A01,083625,Delgado; Tania,21,0,30,9
1650089518012,COGS 107A,A01,083627,Boyle; Mary E. T.,0,4,60,60
1650089524035,COGS 118A,A01,083075,Staff,17,0,60,43
1650089530064,CSE 3,A50,083646,Miranda; Gregory Joseph,22,0,38,16
1650089530064,CSE 3,A51,083647,Miranda; Gregory Joseph,37,0,37,0
1650089536089,CSE 8A,A50,083650,Miranda; Gregory Joseph,0,15,40,40
1650089542127,CSE 11,A01,083080,Cao; Yingjun,0,66,40,40
1650089548150,CSE 12,A01,083652,Staff,0,2,100,100
1650089554178,CSE 15L,A01,083654,Staff,0,0,50,50
1650089554178,CSE 15L,A02,083655,Staff,10,0,50,40
1650089560206,CSE 20,A01,083657,Staff,58,0,80,22
1650089566237,CSE 30,A01,083084,Eldon; John,0,63,40,40
1650089572260,CSE 100,A01,083659,Cao; Yingjun,0,60,50,50
1650089578293,CSE 134B,A01,083661,Powell; Thomas Allan,0,27,65,65
1650089584319,CSE 140,A01,083663,Staff,4,0,75,71
1650089590342,CSE 140L,A01,083088,Eldon; John,0,1,75,75
1650089596365,CSE 175,A01,083665,Kumar; Rakesh,9,0,25,16
1650089602392,CSE 190,A00,092507,Dubnov; Shlomo,14,0,20,6
1650089608422,ECE 45,A01,083139,Staff,0,13,40,40
1650089614446,ECE 65,A50,083695,Staff,0,4,30,30
1650089620475,ECE 109,A01,091882,Touri; Behrouz,48,0,70,22
1650089626500,ECE 180,A00,083140,Abi Samra; Nicholas Camill,24,0,30,6
1650089626500,ECE 180,B00,083141,Abi Samra; Nicholas Camill,8,0,30,22
1650089632523,MATH 10A,A01,083735,Patchell; Gregory David,12,0,30,18
1650089632523,MATH 10A,A02,083736,Patchell; Gregory David,28,0,30,2
1650089632523,MATH 10A,A03,083737,Patchell; Gregory David,26,0,30,4
1650089638551,MATH 10B,A01,083207,Staff,0,5,30,30
1650089638551,MATH 10B,A02,083208,Staff,0,4,30,30
1650089638551,MATH 10B,B01,083739,Staff,18,0,30,12
1650089638551,MATH 10B,B02,083740,Staff,29,0,30,1
1650089644583,MATH 18,A01,083743,Staff,10,0,30,20
1650089644583,MATH 18,A02,083744,Staff,28,0,30,2
1650089644583,MATH 18,A03,083745,Staff,23,0,30,7
1650089644583,MATH 18,A04,083746,Staff,27,0,30,3
1650089644583,MATH 18,B01,083748,Staff,0,9,30,30
1650089644583,MATH 18,B02,083749,Staff,0,6,30,30
1650089644583,MATH 18,B03,083750,Staff,0,6,30,30
1650089644583,MATH 18,B04,083751,Staff,0,7,30,30
1650089650611,MATH 20A,A01,083754,Staff,26,0,40,14
1650089656635,MATH 20B,A01,083756,Staff,0,5,30,30
1650089656635,MATH 20B,A02,083757,Staff,0,2,30,30
1650089662660,MATH 20C,A01,083760,Staff,0,11,30,30
1650089662660,MATH 20C,A02,083761,Staff,0,12,30,30
1650089662660,MATH 20C,B01,083762,Staff,14,0,30,16
1650089662660,MATH 20C,B02,083763,Staff,28,0,30,2
1650089668684,MATH 20D,A01,083765,Staff,0,2,30,30
1650089668684,MATH 20D,A02,083766,Staff,12,0,30,18
1650089668684,MATH 20D,A03,083767,Staff,28,0,30,2
1650089674708,MATH 20E,A01,083771,Staff,10,0,30,20
1650089674708,MATH 20E,A02,083772,Staff,20,0,30,10
1650089674708,MATH 20E,B01,083773,Staff,0,0,30,30
1650089674708,MATH 20E,B02,083774,Staff,15,0,30,15
1650089680737,MATH 103A,A01,083777,Staff,0,8,30,30
1650089680737,MATH 103A,A02,083778,Staff,0,7,30,30
1650089680737,MATH 103A,B01,083779,Staff,0,8,30,30
1650089680737,MATH 103A,B02,083780,Staff,0,6,30,30
1650089686766,MATH 105,A01,085443,Staff,0,12,30,30
1650089692800,MATH 109,A01,083213,Anzaldo; Leesa B,0,3,30,30
1650089692800,MATH 109,A02,083214,Anzaldo; Leesa B,0,5,30,30
1650089692800,MATH 109,B01,083215,Anzaldo; Leesa B,0,4,30,30
1650089692800,MATH 109,B02,083216,Anzaldo; Leesa B,0,3,30,30
1650089698830,MATH 142A,A01,083219,Chow; Bennett,0,10,30,30
1650089698830,MATH 142A,A02,083220,Chow; Bennett,0,10,30,30
1650089698830,MATH 142A,B01,083221,Chow; Bennett,0,10,30,30
1650089698830,MATH 142A,B02,083222,Chow; Bennett,0,9,30,30
1650089704865,MATH 193A,A01,083224,Staff,0,4,30,30
1650089704865,MATH 193A,A02,083225,Staff,0,4,30,30
1650089704865,MATH 193A,A03,083781,Staff,0,0,30,30
1650089704865,MATH 193A,A04,083782,Staff,3,0,30,27
1650089710892,MATH 197,001,091859,McAuley; Julian John,9998,0,9999,1
1650089716952,COGS 9,A01,083615,Staff,0,14,60,60
1650089722977,COGS 11,A01,083617,Boyle; Mary E. T.,24,0,40,16
1650089729007,COGS 13,A01,083071,Staff,0,28,40,40
1650089735032,COGS 14A,A01,092681,Staff,0,10,100,100
1650089741059,COGS 14B,A01,083073,Cheng; Tzu-Han,0,4,50,50
1650089747083,COGS 17,A01,092677,Staff,35,0,75,40
1650089753108,COGS 100,A01,083619,Staff,0,22,60,60
1650089759131,COGS 101A,A01,083621,Davis; Joshua Daniel,0,18,60,60
1650089765154,COGS 101B,A01,091572,Staff,10,0,60,50
1650089771181,COGS 101C,A01,083625,Delgado; Tania,21,0,30,9
1650089777204,COGS 107A,A01,083627,Boyle; Mary E. T.,0,4,60,60
1650089783236,COGS 118A,A01,083075,Staff,17,0,60,43
1650089789258,CSE 3,A50,083646,Miranda; Gregory Joseph,22,0,38,16
1650089789258,CSE 3,A51,083647,Miranda; Gregory Joseph,37,0,37,0
1650089795281,CSE 8A,A50,083650,Miranda; Gregory Joseph,0,15,40,40
1650089801304,CSE 11,A01,083080,Cao; Yingjun,0,66,40,40
1650089807333,CSE 12,A01,083652,Staff,0,2,100,100
1650089813357,CSE 15L,A01,083654,Staff,0,0,50,50
1650089813357,CSE 15L,A02,083655,Staff,10,0,50,40
1650089819381,CSE 20,A01,083657,Staff,58,0,80,22
1650089825406,CSE 30,A01,083084,Eldon; John,0,63,40,40
1650089831434,CSE 100,A01,083659,Cao; Yingjun,0,60,50,50
1650089837461,CSE 134B,A01,083661,Powell; Thomas Allan,0,27,65,65
1650089843483,CSE 140,A01,083663,Staff,4,0,75,71
1650089849511,CSE 140L,A01,083088,Eldon; John,0,1,75,75
1650089855533,CSE 175,A01,083665,Kumar; Rakesh,9,0,25,16
1650089861558,CSE 190,A00,092507,Dubnov; Shlomo,14,0,20,6
1650089867587,ECE 45,A01,083139,Staff,0,13,40,40
1650089873617,ECE 65,A50,083695,Staff,0,4,30,30
1650089879641,ECE 109,A01,091882,Touri; Behrouz,48,0,70,22
1650089885666,ECE 180,A00,083140,Abi Samra; Nicholas Camill,24,0,30,6
1650089885666,ECE 180,B00,083141,Abi Samra; Nicholas Camill,8,0,30,22
1650089891694,MATH 10A,A01,083735,Patchell; Gregory David,12,0,30,18
1650089891694,MATH 10A,A02,083736,Patchell; Gregory David,28,0,30,2
1650089891694,MATH 10A,A03,083737,Patchell; Gregory David,26,0,30,4
1650089897721,MATH 10B,A01,083207,Staff,0,5,30,30
1650089897721,MATH 10B,A02,083208,Staff,0,4,30,30
1650089897721,MATH 10B,B01,083739,Staff,18,0,30,12
1650089897721,MATH 10B,B02,083740,Staff,29,0,30,1
1650089903758,MATH 18,A01,083743,Staff,10,0,30,20
1650089903758,MATH 18,A02,083744,Staff,28,0,30,2
1650089903758,MATH 18,A03,083745,Staff,23,0,30,7
1650089903758,MATH 18,A04,083746,Staff,27,0,30,3
1650089903758,MATH 18,B01,083748,Staff,0,9,30,30
1650089903758,MATH 18,B02,083749,Staff,0,6,30,30
1650089903758,MATH 18,B03,083750,Staff,0,6,30,30
1650089903758,MATH 18,B04,083751,Staff,0,7,30,30
1650089909787,MATH 20A,A01,083754,Staff,26,0,40,14
1650089915810,MATH 20B,A01,083756,Staff,0,5,30,30
1650089915810,MATH 20B,A02,083757,Staff,0,2,30,30
1650089921838,MATH 20C,A01,083760,Staff,0,11,30,30
1650089921838,MATH 20C,A02,083761,Staff,0,12,30,30
1650089921838,MATH 20C,B01,083762,Staff,14,0,30,16
1650089921838,MATH 20C,B02,083763,Staff,28,0,30,2
1650089927860,MATH 20D,A01,083765,Staff,0,2,30,30
1650089927860,MATH 20D,A02,083766,Staff,12,0,30,18
1650089927860,MATH 20D,A03,083767,Staff,28,0,30,2
1650089933889,MATH 20E,A01,083771,Staff,10,0,30,20
1650089933889,MATH 20E,A02,083772,Staff,20,0,30,10
1650089933889,MATH 20E,B01,083773,Staff,0,0,30,30
1650089933889,MATH 20E,B02,083774,Staff,15,0,30,15
1650089939913,MATH 103A,A01,083777,Staff,0,8,30,30
1650089939913,MATH 103A,A02,083778,Staff,0,7,30,30
1650089939913,MATH 103A,B01,083779,Staff,0,8,30,30
1650089939913,MATH 103A,B02,083780,Staff,0,6,30,30
1650089945948,MATH 105,A01,085443,Staff,0,12,30,30
1650089952061,MATH 109,A01,083213,Anzaldo; Leesa B,0,3,30,30
1650089952061,MATH 109,A02,083214,Anzaldo; Leesa B,0,5,30,30
1650089952061,MATH 109,B01,083215,Anzaldo; Leesa B,0,4,30,30
1650089952061,MATH 109,B02,083216,Anzaldo; Leesa B,0,3,30,30
1650089958091,MATH 142A,A01,083219,Chow; Bennett,0,10,30,30
1650089958091,MATH 142A,A02,083220,Chow; Bennett,0,10,30,30
1650089958091,MATH 142A,B01,083221,Chow; Bennett,0,10,30,30
1650089958091,MATH 142A,B02,083222,Chow; Bennett,0,9,30,30
1650089964117,MATH 193A,A01,083224,Staff,0,4,30,30
1650089964117,MATH 193A,A02,083225,Staff,0,4,30,30
1650089964117,MATH 193A,A03,083781,Staff,0,0,30,30
1650089964117,MATH 193A,A04,083782,Staff,3,0,30,27
1650089970155,MATH 197,001,091859,McAuley; Julian John,9998,0,9999,1
1650089976211,COGS 9,A01,083615,Staff,0,14,60,60
1650089982239,COGS 11,A01,083617,Boyle; Mary E. T.,24,0,40,16
1650089988264,COGS 13,A01,083071,Staff,0,28,40,40
1650089994288,COGS 14A,A01,092681,Staff,0,10,100,100
1650090000311,COGS 14B,A01,083073,Cheng; Tzu-Han,0,4,50,50
1650090006338,COGS 17,A01,092677,Staff,35,0,75,40
1650090012362,COGS 100,A01,083619,Staff,0,22,60,60
1650090018387,COGS 101A,A01,083621,Davis; Joshua Daniel,0,18,60,60
1650090024414,COGS 101B,A01,091572,Staff,10,0,60,50
1650090030441,COGS 101C,A01,083625,Delgado; Tania,21,0,30,9
1650090036470,COGS 107A,A01,083627,Boyle; Mary E. T.,0,4,60,60
1650090042497,COGS 118A,A01,083075,Staff,17,0,60,43
1650090048533,CSE 3,A50,083646,Miranda; Gregory Joseph,22,0,38,16
1650090048533,CSE 3,A51,083647,Miranda; Gregory Joseph,37,0,37,0
1650090054556,CSE 8A,A50,083650,Miranda; Gregory Joseph,0,15,40,40
1650090060593,CSE 11,A01,083080,Cao; Yingjun,0,66,40,40
1650090066616,CSE 12,A01,083652,Staff,0,2,100,100
1650090072641,CSE 15L,A01,083654,Staff,0,0,50,50
1650090072641,CSE 15L,A02,083655,Staff,10,0,50,40
1650090078666,CSE 20,A01,083657,Staff,58,0,80,22
1650090084689,CSE 30,A01,083084,Eldon; John,0,63,40,40
1650090090714,CSE 100,A01,083659,Cao; Yingjun,0,60,50,50
1650090096743,CSE 134B,A01,083661,Powell; Thomas Allan,0,27,65,65
1650090102772,CSE 140,A01,083663,Staff,4,0,75,71
1650090108794,CSE 140L,A01,083088,Eldon; John,0,1,75,75
1650090114818,CSE 175,A01,083665,Kumar; Rakesh,9,0,25,16
1650090120842,CSE 190,A00,092507,Dubnov; Shlomo,14,0,20,6
1650090126866,ECE 45,A01,083139,Staff,0,13,40,40
1650090132892,ECE 65,A50,083695,Staff,0,4,30,30
1650090138916,ECE 109,A01,091882,Touri; Behrouz,48,0,70,22
1650090144940,ECE 180,A00,083140,Abi Samra; Nicholas Camill,24,0,30,6
1650090144940,ECE 180,B00,083141,Abi Samra; Nicholas Camill,8,0,30,22
1650090150965,MATH 10A,A01,083735,Patchell; Gregory David,12,0,30,18
1650090150965,MATH 10A,A02,083736,Patchell; Gregory David,28,0,30,2
1650090150965,MATH 10A,A03,083737,Patchell; Gregory David,26,0,30,4
1650090156990,MATH 10B,A01,083207,Staff,0,5,30,30
1650090156990,MATH 10B,A02,083208,Staff,0,4,30,30
1650090156990,MATH 10B,B01,083739,Staff,18,0,30,12
1650090156990,MATH 10B,B02,083740,Staff,29,0,30,1
1650090163021,MATH 18,A01,083743,Staff,10,0,30,20
1650090163021,MATH 18,A02,083744,Staff,28,0,30,2
1650090163021,MATH 18,A03,083745,Staff,23,0,30,7
1650090163021,MATH 18,A04,083746,Staff,27,0,30,3
1650090163021,MATH 18,B01,083748,Staff,0,9,30,30
1650090163021,MATH 18,B02,083749,Staff,0,6,30,30
1650090163021,MATH 18,B03,083750,Staff,0,6,30,30
1650090163021,MATH 18,B04,083751,Staff,0,7,30,30
1650090169051,MATH 20A,A01,083754,Staff,26,0,40,14
1650090175075,MATH 20B,A01,083756,Staff,0,5,30,30
1650090175075,MATH 20B,A02,083757,Staff,0,2,30,30
1650090181105,MATH 20C,A01,083760,Staff,0,11,30,30
1650090181105,MATH 20C,A02,083761,Staff,0,12,30,30
1650090181105,MATH 20C,B01,083762,Staff,14,0,30,16
1650090181105,MATH 20C,B02,083763,Staff,28,0,30,2
1650090187133,MATH 20D,A01,083765,Staff,0,2,30,30
1650090187133,MATH 20D,A02,083766,Staff,12,0,30,18
1650090187133,MATH 20D,A03,083767,Staff,28,0,30,2
1650090193157,MATH 20E,A01,083771,Staff,10,0,30,20
1650090193157,MATH 20E,A02,083772,Staff,20,0,30,10
1650090193157,MATH 20E,B01,083773,Staff,0,0,30,30
1650090193157,MATH 20E,B02,083774,Staff,15,0,30,15
1650090199186,MATH 103A,A01,083777,Staff,0,8,30,30
1650090199186,MATH 103A,A02,083778,Staff,0,7,30,30
1650090199186,MATH 103A,B01,083779,Staff,0,8,30,30
1650090199186,MATH 103A,B02,083780,Staff,0,6,30,30
1650090205210,MATH 105,A01,085443,Staff,0,12,30,30
1650090211240,MATH 109,A01,083213,Anzaldo; Leesa B,0,3,30,30
1650090211240,MATH 109,A02,083214,Anzaldo; Leesa B,0,5,30,30
1650090211240,MATH 109,B01,083215,Anzaldo; Leesa B,0,4,30,30
1650090211240,MATH 109,B02,083216,Anzaldo; Leesa B,0,3,30,30
1650090217317,MATH 142A,A01,083219,Chow; Bennett,0,10,30,30
1650090217317,MATH 142A,A02,083220,Chow; Bennett,0,10,30,30
1650090217317,MATH 142A,B01,083221,Chow; Bennett,0,10,30,30
1650090217317,MATH 142A,B02,083222,Chow; Bennett,0,9,30,30
1650090223342,MATH 193A,A01,083224,Staff,0,4,30,30
1650090223342,MATH 193A,A02,083225,Staff,0,4,30,30
1650090223342,MATH 193A,A03,083781,Staff,0,0,30,30
1650090223342,MATH 193A,A04,083782,Staff,3,0,30,27
1650090229368,MATH 197,001,091859,McAuley; Julian John,9998,0,9999,1
1650090235433,COGS 9,A01,083615,Staff,0,14,60,60
1650090241457,COGS 11,A01,083617,Boyle; Mary E. T.,24,0,40,16
1650090247481,COGS 13,A01,083071,Staff,0,28,40,40
1650090253507,COGS 14A,A01,092681,Staff,0,10,100,100
1650090259531,COGS 14B,A01,083073,Cheng; Tzu-Han,0,4,50,50
1650090265556,COGS 17,A01,092677,Staff,35,0,75,40
1650090271607,COGS 100,A01,083619,Staff,0,22,60,60
1650090277631,COGS 101A,A01,083621,Davis; Joshua Daniel,0,18,60,60
1650090283662,COGS 101B,A01,091572,Staff,10,0,60,50
1650090289690,COGS 101C,A01,083625,Delgado; Tania,21,0,30,9
1650090295717,COGS 107A,A01,083627,Boyle; Mary E. T.,0,4,60,60
1650090301746,COGS 118A,A01,083075,Staff,17,0,60,43
1650090307770,CSE 3,A50,083646,Miranda; Gregory Joseph,22,0,38,16
1650090307770,CSE 3,A51,083647,Miranda; Gregory Joseph,37,0,37,0
1650090313798,CSE 8A,A50,083650,Miranda; Gregory Joseph,0,15,40,40
1650090319824,CSE 11,A01,083080,Cao; Yingjun,0,66,40,40
1650090325848,CSE 12,A01,083652,Staff,0,2,100,100
1650090331870,CSE 15L,A01,083654,Staff,0,0,50,50
1650090331870,CSE 15L,A02,083655,Staff,10,0,50,40
1650090337895,CSE 20,A01,083657,Staff,58,0,80,22
1650090343921,CSE 30,A01,083084,Eldon; John,0,63,40,40
1650090349946,CSE 100,A01,083659,Cao; Yingjun,0,60,50,50
1650090355982,CSE 134B,A01,083661,Powell; Thomas Allan,0,27,65,65
1650090362012,CSE 140,A01,083663,Staff,4,0,75,71
1650090368034,CSE 140L,A01,083088,Eldon; John,0,1,75,75
1650090374059,CSE 175,A01,083665,Kumar; Rakesh,9,0,25,16
1650090380082,CSE 190,A00,092507,Dubnov; Shlomo,14,0,20,6
1650090386104,ECE 45,A01,083139,Staff,0,13,40,40
1650090392129,ECE 65,A50,083695,Staff,0,4,30,30
1650090398170,ECE 109,A01,091882,Touri; Behrouz,48,0,70,22
1650090404211,ECE 180,A00,083140,Abi Samra; Nicholas Camill,24,0,30,6
1650090404211,ECE 180,B00,083141,Abi Samra; Nicholas Camill,8,0,30,22
1650090410238,MATH 10A,A01,083735,Patchell; Gregory David,12,0,30,18
1650090410238,MATH 10A,A02,083736,Patchell; Gregory David,28,0,30,2
1650090410238,MATH 10A,A03,083737,Patchell; Gregory David,26,0,30,4
1650090416266,MATH 10B,A01,083207,Staff,0,5,30,30
1650090416266,MATH 10B,A02,083208,Staff,0,4,30,30
1650090416266,MATH 10B,B01,083739,Staff,18,0,30,12
1650090416266,MATH 10B,B02,083740,Staff,29,0,30,1
1650090422298,MATH 18,A01,083743,Staff,10,0,30,20
1650090422298,MATH 18,A02,083744,Staff,28,0,30,2
1650090422298,MATH 18,A03,083745,Staff,23,0,30,7
1650090422298,MATH 18,A04,083746,Staff,27,0,30,3
1650090422298,MATH 18,B01,083748,Staff,0,9,30,30
1650090422298,MATH 18,B02,083749,Staff,0,6,30,30
1650090422298,MATH 18,B03,083750,Staff,0,6,30,30
1650090422298,MATH 18,B04,083751,Staff,0,7,30,30
1650090428323,MATH 20A,A01,083754,Staff,26,0,40,14
1650090434347,MATH 20B,A01,083756,Staff,0,5,30,30
1650090434347,MATH 20B,A02,083757,Staff,0,2,30,30
1650090440379,MATH 20C,A01,083760,Staff,0,11,30,30
1650090440379,MATH 20C,A02,083761,Staff,0,12,30,30
1650090440379,MATH 20C,B01,083762,Staff,14,0,30,16
1650090440379,MATH 20C,B02,083763,Staff,28,0,30,2
1650090446417,MATH 20D,A01,083765,Staff,0,2,30,30
1650090446417,MATH 20D,A02,083766,Staff,12,0,30,18
1650090446417,MATH 20D,A03,083767,Staff,28,0,30,2
1650090452448,MATH 20E,A01,083771,Staff,10,0,30,20
1650090452448,MATH 20E,A02,083772,Staff,20,0,30,10
1650090452448,MATH 20E,B01,083773,Staff,0,0,30,30
1650090452448,MATH 20E,B02,083774,Staff,15,0,30,15
1650090458476,MATH 103A,A01,083777,Staff,0,8,30,30
1650090458476,MATH 103A,A02,083778,Staff,0,7,30,30
1650090458476,MATH 103A,B01,083779,Staff,0,9,30,30
1650090458476,MATH 103A,B02,083780,Staff,0,6,30,30
1650090464503,MATH 105,A01,085443,Staff,0,12,30,30
1650090470531,MATH 109,A01,083213,Anzaldo; Leesa B,0,3,30,30
1650090470531,MATH 109,A02,083214,Anzaldo; Leesa B,0,5,30,30
1650090470531,MATH 109,B01,083215,Anzaldo; Leesa B,0,4,30,30
1650090470531,MATH 109,B02,083216,Anzaldo; Leesa B,0,4,30,30
1650090476561,MATH 142A,A01,083219,Chow; Bennett,0,10,30,30
1650090476561,MATH 142A,A02,083220,Chow; Bennett,0,10,30,30
1650090476561,MATH 142A,B01,083221,Chow; Bennett,0,10,30,30
1650090476561,MATH 142A,B02,083222,Chow; Bennett,0,9,30,30
1650090482588,MATH 193A,A01,083224,Staff,0,4,30,30
1650090482588,MATH 193A,A02,083225,Staff,0,4,30,30
1650090482588,MATH 193A,A03,083781,Staff,0,0,30,30
1650090482588,MATH 193A,A04,083782,Staff,3,0,30,27
1650090488612,MATH 197,001,091859,McAuley; Julian John,9998,0,9999,1
1650090494675,COGS 9,A01,083615,Staff,0,14,60,60
1650090500702,COGS 11,A01,083617,Boyle; Mary E. T.,24,0,40,16
1650090506730,COGS 13,A01,083071,Staff,0,28,40,40
1650090512756,COGS 14A,A01,092681,Staff,0,10,100,100
1650090518790,COGS 14B,A01,083073,Cheng; Tzu-Han,0,4,50,50
1650090524817,COGS 17,A01,092677,Staff,35,0,75,40
1650090530846,COGS 100,A01,083619,Staff,0,22,60,60
1650090536871,COGS 101A,A01,083621,Davis; Joshua Daniel,0,18,60,60
1650090542988,COGS 101B,A01,091572,Staff,10,0,60,50
1650090549012,COGS 101C,A01,083625,Delgado; Tania,21,0,30,9
1650090555039,COGS 107A,A01,083627,Boyle; Mary E. T.,0,4,60,60
1650090561063,COGS 118A,A01,083075,Staff,17,0,60,43
1650090567086,CSE 3,A50,083646,Miranda; Gregory Joseph,22,0,38,16
1650090567086,CSE 3,A51,083647,Miranda; Gregory Joseph,37,0,37,0
1650090573110,CSE 8A,A50,083650,Miranda; Gregory Joseph,0,15,40,40
1650090579133,CSE 11,A01,083080,Cao; Yingjun,0,65,40,40
1650090585156,CSE 12,A01,083652,Staff,0,2,100,100
1650090591183,CSE 15L,A01,083654,Staff,0,0,50,50
1650090591183,CSE 15L,A02,083655,Staff,10,0,50,40
1650090597207,CSE 20,A01,083657,Staff,58,0,80,22
1650090603236,CSE 30,A01,083084,Eldon; John,0,63,40,40
1650090609263,CSE 100,A01,083659,Cao; Yingjun,0,60,50,50
1650090615290,CSE 134B,A01,083661,Powell; Thomas Allan,0,27,65,65
1650090621313,CSE 140,A01,083663,Staff,4,0,75,71
1650090627337,CSE 140L,A01,083088,Eldon; John,0,1,75,75
1650090633363,CSE 175,A01,083665,Kumar; Rakesh,9,0,25,16
1650090639385,CSE 190,A00,092507,Dubnov; Shlomo,14,0,20,6
1650090645408,ECE 45,A01,083139,Staff,0,13,40,40
1650090651434,ECE 65,A50,083695,Staff,0,4,30,30
1650090657457,ECE 109,A01,091882,Touri; Behrouz,48,0,70,22
1650090663482,ECE 180,A00,083140,Abi Samra; Nicholas Camill,24,0,30,6
1650090663482,ECE 180,B00,083141,Abi Samra; Nicholas Camill,8,0,30,22
1650090669505,MATH 10A,A01,083735,Patchell; Gregory David,12,0,30,18
1650090669505,MATH 10A,A02,083736,Patchell; Gregory David,28,0,30,2
1650090669505,MATH 10A,A03,083737,Patchell; Gregory David,26,0,30,4
1650090675529,MATH 10B,A01,083207,Staff,0,5,30,30
1650090675529,MATH 10B,A02,083208,Staff,0,4,30,30
1650090675529,MATH 10B,B01,083739,Staff,18,0,30,12
1650090675529,MATH 10B,B02,083740,Staff,29,0,30,1
1650090681560,MATH 18,A01,083743,Staff,10,0,30,20
1650090681560,MATH 18,A02,083744,Staff,28,0,30,2
1650090681560,MATH 18,A03,083745,Staff,23,0,30,7
1650090681560,MATH 18,A04,083746,Staff,27,0,30,3
1650090681560,MATH 18,B01,083748,Staff,0,9,30,30
1650090681560,MATH 18,B02,083749,Staff,0,6,30,30
1650090681560,MATH 18,B03,083750,Staff,0,6,30,30
1650090681560,MATH 18,B04,083751,Staff,0,7,30,30
1650090687584,MATH 20A,A01,083754,Staff,26,0,40,14
1650090693611,MATH 20B,A01,083756,Staff,0,5,30,30
1650090693611,MATH 20B,A02,083757,Staff,0,2,30,30
1650090699637,MATH 20C,A01,083760,Staff,0,11,30,30
1650090699637,MATH 20C,A02,083761,Staff,0,12,30,30
1650090699637,MATH 20C,B01,083762,Staff,14,0,30,16
1650090699637,MATH 20C,B02,083763,Staff,28,0,30,2
1650090705675,MATH 20D,A01,083765,Staff,0,2,30,30
1650090705675,MATH 20D,A02,083766,Staff,12,0,30,18
1650090705675,MATH 20D,A03,083767,Staff,28,0,30,2
1650090711696,MATH 20E,A01,083771,Staff,10,0,30,20
1650090711696,MATH 20E,A02,083772,Staff,20,0,30,10
1650090711696,MATH 20E,B01,083773,Staff,0,0,30,30
1650090711696,MATH 20E,B02,083774,Staff,14,0,30,16
1650090717725,MATH 103A,A01,083777,Staff,0,8,30,30
1650090717725,MATH 103A,A02,083778,Staff,0,7,30,30
1650090717725,MATH 103A,B01,083779,Staff,0,9,30,30
1650090717725,MATH 103A,B02,083780,Staff,0,6,30,30
1650090723753,MATH 105,A01,085443,Staff,0,12,30,30
1650090729782,MATH 109,A01,083213,Anzaldo; Leesa B,0,3,30,30
1650090729782,MATH 109,A02,083214,Anzaldo; Leesa B,0,5,30,30
1650090729782,MATH 109,B01,083215,Anzaldo; Leesa B,0,4,30,30
1650090729782,MATH 109,B02,083216,Anzaldo; Leesa B,0,4,30,30
1650090735807,MATH 142A,A01,083219,Chow; Bennett,0,10,30,30
1650090735807,MATH 142A,A02,083220,Chow; Bennett,0,10,30,30
1650090735807,MATH 142A,B01,083221,Chow; Bennett,0,10,30,30
1650090735807,MATH 142A,B02,083222,Chow; Bennett,0,9,30,30
1650090741834,MATH 193A,A01,083224,Staff,0,4,30,30
1650090741834,MATH 193A,A02,083225,Staff,0,4,30,30
1650090741834,MATH 193A,A03,083781,Staff,0,0,30,30
1650090741834,MATH 193A,A04,083782,Staff,3,0,30,27
1650090747857,MATH 197,001,091859,McAuley; Julian John,9998,0,9999,1
1650090753908,COGS 9,A01,083615,Staff,0,14,60,60
1650090759933,COGS 11,A01,083617,Boyle; Mary E. T.,24,0,40,16
1650090765971,COGS 13,A01,083071,Staff,0,28,40,40
1650090771995,COGS 14A,A01,092681,Staff,0,10,100,100
1650090778027,COGS 14B,A01,083073,Cheng; Tzu-Han,0,4,50,50
1650090784054,COGS 17,A01,092677,Staff,35,0,75,40
1650090790080,COGS 100,A01,083619,Staff,0,22,60,60
1650090796109,COGS 101A,A01,083621,Davis; Joshua Daniel,0,18,60,60
1650090802132,COGS 101B,A01,091572,Staff,10,0,60,50
1650090808163,COGS 101C,A01,083625,Delgado; Tania,21,0,30,9
1650090814190,COGS 107A,A01,083627,Boyle; Mary E. T.,0,4,60,60
1650090820213,COGS 118A,A01,083075,Staff,17,0,60,43
1650090826240,CSE 3,A50,083646,Miranda; Gregory Joseph,22,0,38,16
1650090826240,CSE 3,A51,083647,Miranda; Gregory Joseph,37,0,37,0
1650090832266,CSE 8A,A50,083650,Miranda; Gregory Joseph,0,15,40,40
1650090838290,CSE 11,A01,083080,Cao; Yingjun,0,65,40,40
1650090844316,CSE 12,A01,083652,Staff,0,2,100,100
1650090850346,CSE 15L,A01,083654,Staff,0,0,50,50
1650090850346,CSE 15L,A02,083655,Staff,10,0,50,40
1650090856375,CSE 20,A01,083657,Staff,58,0,80,22
1650090862399,CSE 30,A01,083084,Eldon; John,0,63,40,40
1650090868422,CSE 100,A01,083659,Cao; Yingjun,0,60,50,50
1650090874445,CSE 134B,A01,083661,Powell; Thomas Allan,0,27,65,65
1650090880469,CSE 140,A01,083663,Staff,4,0,75,71
1650090886497,CSE 140L,A01,083088,Eldon; John,0,1,75,75
1650090892535,CSE 175,A01,083665,Kumar; Rakesh,9,0,25,16
1650090898558,CSE 190,A00,092507,Dubnov; Shlomo,14,0,20,6
1650090904581,ECE 45,A01,083139,Staff,0,13,40,40
1650090910605,ECE 65,A50,083695,Staff,0,4,30,30
1650090916631,ECE 109,A01,091882,Touri; Behrouz,48,0,70,22
1650090922666,ECE 180,A00,083140,Abi Samra; Nicholas Camill,24,0,30,6
1650090922666,ECE 180,B00,083141,Abi Samra; Nicholas Camill,8,0,30,22
1650090928694,MATH 10A,A01,083735,Patchell; Gregory David,12,0,30,18
1650090928694,MATH 10A,A02,083736,Patchell; Gregory David,28,0,30,2
1650090928694,MATH 10A,A03,083737,Patchell; Gregory David,26,0,30,4
1650090934720,MATH 10B,A01,083207,Staff,0,5,30,30
1650090934720,MATH 10B,A02,083208,Staff,0,4,30,30
1650090934720,MATH 10B,B01,083739,Staff,18,0,30,12
1650090934720,MATH 10B,B02,083740,Staff,29,0,30,1
1650090940753,MATH 18,A01,083743,Staff,10,0,30,20
1650090940753,MATH 18,A02,083744,Staff,28,0,30,2
1650090940753,MATH 18,A03,083745,Staff,23,0,30,7
1650090940753,MATH 18,A04,083746,Staff,27,0,30,3
1650090940753,MATH 18,B01,083748,Staff,0,9,30,30
1650090940753,MATH 18,B02,083749,Staff,0,6,30,30
1650090940753,MATH 18,B03,083750,Staff,0,6,30,30
1650090940753,MATH 18,B04,083751,Staff,0,7,30,30
1650090946782,MATH 20A,A01,083754,Staff,26,0,40,14
1650090952805,MATH 20B,A01,083756,Staff,0,5,30,30
1650090952805,MATH 20B,A02,083757,Staff,0,2,30,30
1650090958851,MATH 20C,A01,083760,Staff,0,11,30,30
1650090958851,MATH 20C,A02,083761,Staff,0,12,30,30
1650090958851,MATH 20C,B01,083762,Staff,14,0,30,16
1650090958851,MATH 20C,B02,083763,Staff,28,0,30,2
1650090964889,MATH 20D,A01,083765,Staff,0,2,30,30
1650090964889,MATH 20D,A02,083766,Staff,12,0,30,18
1650090964889,MATH 20D,A03,083767,Staff,28,0,30,2
1650090970912,MATH 20E,A01,083771,Staff,10,0,30,20
1650090970912,MATH 20E,A02,083772,Staff,20,0,30,10
1650090970912,MATH 20E,B01,083773,Staff,0,0,30,30
1650090970912,MATH 20E,B02,083774,Staff,14,0,30,16
1650090976945,MATH 103A,A01,083777,Staff,0,8,30,30
1650090976945,MATH 103A,A02,083778,Staff,0,7,30,30
1650090976945,MATH 103A,B01,083779,Staff,0,9,30,30
1650090976945,MATH 103A,B02,083780,Staff,0,6,30,30
1650090982968,MATH 105,A01,085443,Staff,0,12,30,30
1650090988997,MATH 109,A01,083213,Anzaldo; Leesa B,0,3,30,30
1650090988997,MATH 109,A02,083214,Anzaldo; Leesa B,0,5,30,30
1650090988997,MATH 109,B01,083215,Anzaldo; Leesa B,0,4,30,30
1650090988997,MATH 109,B02,083216,Anzaldo; Leesa B,0,4,30,30
1650090995024,MATH 142A,A01,083219,Chow; Bennett,0,10,30,30
1650090995024,MATH 142A,A02,083220,Chow; Bennett,0,10,30,30
1650090995024,MATH 142A,B01,083221,Chow; Bennett,0,10,30,30
1650090995024,MATH 142A,B02,083222,Chow; Bennett,0,9,30,30
1650091001047,MATH 193A,A01,083224,Staff,0,4,30,30
1650091001047,MATH 193A,A02,083225,Staff,0,4,30,30
1650091001047,MATH 193A,A03,083781,Staff,0,0,30,30
1650091001047,MATH 193A,A04,083782,Staff,3,0,30,27
1650091007069,MATH 197,001,091859,McAuley; Julian John,9998,0,9999,1
1650091013127,COGS 9,A01,083615,Staff,0,14,60,60
1650091019162,COGS 11,A01,083617,Boyle; Mary E. T.,24,0,40,16
1650091025185,COGS 13,A01,083071,Staff,0,28,40,40
1650091031209,COGS 14A,A01,092681,Staff,0,10,100,100
1650091037232,COGS 14B,A01,083073,Cheng; Tzu-Han,0,4,50,50
1650091043257,COGS 17,A01,092677,Staff,35,0,75,40
1650091049283,COGS 100,A01,083619,Staff,0,22,60,60
1650091055314,COGS 101A,A01,083621,Davis; Joshua Daniel,0,18,60,60
1650091061349,COGS 101B,A01,091572,Staff,10,0,60,50
1650091067377,COGS 101C,A01,083625,Delgado; Tania,21,0,30,9
1650091073405,COGS 107A,A01,083627,Boyle; Mary E. T.,0,4,60,60
1650091079432,COGS 118A,A01,083075,Staff,17,0,60,43
1650091085471,CSE 3,A50,083646,Miranda; Gregory Joseph,22,0,38,16
1650091085471,CSE 3,A51,083647,Miranda; Gregory Joseph,37,0,37,0
1650091091507,CSE 8A,A50,083650,Miranda; Gregory Joseph,0,15,40,40
1650091097544,CSE 11,A01,083080,Cao; Yingjun,0,65,40,40
1650091103566,CSE 12,A01,083652,Staff,0,2,100,100
1650091109605,CSE 15L,A01,083654,Staff,0,0,50,50
1650091109605,CSE 15L,A02,083655,Staff,10,0,50,40
1650091115639,CSE 20,A01,083657,Staff,58,0,80,22
1650091121666,CSE 30,A01,083084,Eldon; John,0,63,40,40
1650091127694,CSE 100,A01,083659,Cao; Yingjun,0,60,50,50
1650091133718,CSE 134B,A01,083661,Powell; Thomas Allan,0,27,65,65
1650091139819,CSE 140,A01,083663,Staff,4,0,75,71
1650091145847,CSE 140L,A01,083088,Eldon; John,0,1,75,75
1650091151872,CSE 175,A01,083665,Kumar; Rakesh,9,0,25,16
1650091157895,CSE 190,A00,092507,Dubnov; Shlomo,14,0,20,6
1650091163922,ECE 45,A01,083139,Staff,0,13,40,40
1650091169948,ECE 65,A50,083695,Staff,0,4,30,30
1650091175997,ECE 109,A01,091882,Touri; Behrouz,48,0,70,22
1650091182023,ECE 180,A00,083140,Abi Samra; Nicholas Camill,24,0,30,6
1650091182023,ECE 180,B00,083141,Abi Samra; Nicholas Camill,8,0,30,22
1650091188047,MATH 10A,A01,083735,Patchell; Gregory David,12,0,30,18
1650091188047,MATH 10A,A02,083736,Patchell; Gregory David,28,0,30,2
1650091188047,MATH 10A,A03,083737,Patchell; Gregory David,26,0,30,4
1650091194072,MATH 10B,A01,083207,Staff,0,5,30,30
1650091194072,MATH 10B,A02,083208,Staff,0,4,30,30
1650091194072,MATH 10B,B01,083739,Staff,18,0,30,12
1650091194072,MATH 10B,B02,083740,Staff,29,0,30,1
1650091200095,MATH 18,A01,083743,Staff,10,0,30,20
1650091200095,MATH 18,A02,083744,Staff,28,0,30,2
1650091200095,MATH 18,A03,083745,Staff,23,0,30,7
1650091200095,MATH 18,A04,083746,Staff,27,0,30,3
1650091200095,MATH 18,B01,083748,Staff,0,9,30,30
1650091200095,MATH 18,B02,083749,Staff,0,6,30,30
1650091200095,MATH 18,B03,083750,Staff,0,6,30,30
1650091200095,MATH 18,B04,083751,Staff,0,7,30,30
1650091206121,MATH 20A,A01,083754,Staff,26,0,40,14
1650091212145,MATH 20B,A01,083756,Staff,0,5,30,30
1650091212145,MATH 20B,A02,083757,Staff,0,2,30,30
1650091218175,MATH 20C,A01,083760,Staff,0,11,30,30
1650091218175,MATH 20C,A02,083761,Staff,0,12,30,30
1650091218175,MATH 20C,B01,083762,Staff,14,0,30,16
1650091218175,MATH 20C,B02,083763,Staff,28,0,30,2
1650091224199,MATH 20D,A01,083765,Staff,0,2,30,30
1650091224199,MATH 20D,A02,083766,Staff,12,0,30,18
1650091224199,MATH 20D,A03,083767,Staff,28,0,30,2
1650091230232,MATH 20E,A01,083771,Staff,10,0,30,20
1650091230232,MATH 20E,A02,083772,Staff,20,0,30,10
1650091230232,MATH 20E,B01,083773,Staff,0,0,30,30
1650091230232,MATH 20E,B02,083774,Staff,14,0,30,16
1650091236257,MATH 103A,A01,083777,Staff,0,8,30,30
1650091236257,MATH 103A,A02,083778,Staff,0,7,30,30
1650091236257,MATH 103A,B01,083779,Staff,0,9,30,30
1650091236257,MATH 103A,B02,083780,Staff,0,6,30,30
1650091242281,MATH 105,A01,085443,Staff,0,12,30,30
1650091248309,MATH 109,A01,083213,Anzaldo; Leesa B,0,3,30,30
1650091248309,MATH 109,A02,083214,Anzaldo; Leesa B,0,5,30,30
1650091248309,MATH 109,B01,083215,Anzaldo; Leesa B,0,4,30,30
1650091248309,MATH 109,B02,083216,Anzaldo; Leesa B,0,4,30,30
1650091254343,MATH 142A,A01,083219,Chow; Bennett,0,10,30,30
1650091254343,MATH 142A,A02,083220,Chow; Bennett,0,10,30,30
1650091254343,MATH 142A,B01,083221,Chow; Bennett,0,10,30,30
1650091254343,MATH 142A,B02,083222,Chow; Bennett,0,9,30,30
1650091260370,MATH 193A,A01,083224,Staff,0,4,30,30
1650091260370,MATH 193A,A02,083225,Staff,0,4,30,30
1650091260370,MATH 193A,A03,083781,Staff,0,0,30,30
1650091260370,MATH 193A,A04,083782,Staff,3,0,30,27
1650091266404,MATH 197,001,091859,McAuley; Julian John,9998,0,9999,1
1650091272458,COGS 9,A01,083615,Staff,0,14,60,60
1650091278486,COGS 11,A01,083617,Boyle; Mary E. T.,24,0,40,16
1650091284521,COGS 13,A01,083071,Staff,0,28,40,40
1650091290552,COGS 14A,A01,092681,Staff,0,10,100,100
1650091296582,COGS 14B,A01,083073,Cheng; Tzu-Han,0,4,50,50
1650091302610,COGS 17,A01,092677,Staff,35,0,75,40
1650091308633,COGS 100,A01,083619,Staff,0,22,60,60
1650091314656,COGS 101A,A01,083621,Davis; Joshua Daniel,0,18,60,60
1650091320681,COGS 101B,A01,091572,Staff,10,0,60,50
1650091326709,COGS 101C,A01,083625,Delgado; Tania,21,0,30,9
1650091332732,COGS 107A,A01,083627,Boyle; Mary E. T.,0,4,60,60
1650091338756,COGS 118A,A01,083075,Staff,17,0,60,43
1650091344780,CSE 3,A50,083646,Miranda; Gregory Joseph,22,0,38,16
1650091344780,CSE 3,A51,083647,Miranda; Gregory Joseph,37,0,37,0
1650091350808,CSE 8A,A50,083650,Miranda; Gregory Joseph,0,15,40,40
1650091356849,CSE 11,A01,083080,Cao; Yingjun,0,65,40,40
1650091362872,CSE 12,A01,083652,Staff,0,2,100,100
1650091368928,CSE 15L,A01,083654,Staff,0,0,50,50
1650091368928,CSE 15L,A02,083655,Staff,10,0,50,40
1650091374952,CSE 20,A01,083657,Staff,58,0,80,22
1650091380980,CSE 30,A01,083084,Eldon; John,0,63,40,40
1650091387004,CSE 100,A01,083659,Cao; Yingjun,0,60,50,50
1650091393030,CSE 134B,A01,083661,Powell; Thomas Allan,0,27,65,65
1650091399057,CSE 140,A01,083663,Staff,4,0,75,71
1650091405082,CSE 140L,A01,083088,Eldon; John,0,1,75,75
1650091411104,CSE 175,A01,083665,Kumar; Rakesh,9,0,25,16
1650091417131,CSE 190,A00,092507,Dubnov; Shlomo,14,0,20,6
1650091423157,ECE 45,A01,083139,Staff,0,13,40,40
1650091429182,ECE 65,A50,083695,Staff,0,4,30,30
1650091435205,ECE 109,A01,091882,Touri; Behrouz,48,0,70,22
1650091441233,ECE 180,A00,083140,Abi Samra; Nicholas Camill,24,0,30,6
1650091441233,ECE 180,B00,083141,Abi Samra; Nicholas Camill,8,0,30,22
1650091447255,MATH 10A,A01,083735,Patchell; Gregory David,12,0,30,18
1650091447255,MATH 10A,A02,083736,Patchell; Gregory David,28,0,30,2
1650091447255,MATH 10A,A03,083737,Patchell; Gregory David,26,0,30,4
1650091453282,MATH 10B,A01,083207,Staff,0,5,30,30
1650091453282,MATH 10B,A02,083208,Staff,0,4,30,30
1650091453282,MATH 10B,B01,083739,Staff,18,0,30,12
1650091453282,MATH 10B,B02,083740,Staff,29,0,30,1
1650091459319,MATH 18,A01,083743,Staff,10,0,30,20
1650091459319,MATH 18,A02,083744,Staff,28,0,30,2
1650091459319,MATH 18,A03,083745,Staff,23,0,30,7
1650091459319,MATH 18,A04,083746,Staff,27,0,30,3
1650091459319,MATH 18,B01,083748,Staff,0,9,30,30
1650091459319,MATH 18,B02,083749,Staff,0,6,30,30
1650091459319,MATH 18,B03,083750,Staff,0,6,30,30
1650091459319,MATH 18,B04,083751,Staff,0,7,30,30
1650091465348,MATH 20A,A01,083754,Staff,26,0,40,14
1650091471374,MATH 20B,A01,083756,Staff,0,5,30,30
1650091471374,MATH 20B,A02,083757,Staff,0,2,30,30
1650091477410,MATH 20C,A01,083760,Staff,0,11,30,30
1650091477410,MATH 20C,A02,083761,Staff,0,12,30,30
1650091477410,MATH 20C,B01,083762,Staff,14,0,30,16
1650091477410,MATH 20C,B02,083763,Staff,28,0,30,2
1650091483433,MATH 20D,A01,083765,Staff,0,2,30,30
1650091483433,MATH 20D,A02,083766,Staff,12,0,30,18
1650091483433,MATH 20D,A03,083767,Staff,28,0,30,2
1650091489475,MATH 20E,A01,083771,Staff,10,0,30,20
1650091489475,MATH 20E,A02,083772,Staff,20,0,30,10
1650091489475,MATH 20E,B01,083773,Staff,0,0,30,30
1650091489475,MATH 20E,B02,083774,Staff,14,0,30,16
1650091495500,MATH 103A,A01,083777,Staff,0,8,30,30
1650091495500,MATH 103A,A02,083778,Staff,0,7,30,30
1650091495500,MATH 103A,B01,083779,Staff,0,9,30,30
1650091495500,MATH 103A,B02,083780,Staff,0,6,30,30
1650091501523,MATH 105,A01,085443,Staff,0,12,30,30
1650091507545,MATH 109,A01,083213,Anzaldo; Leesa B,0,3,30,30
1650091507545,MATH 109,A02,083214,Anzaldo; Leesa B,0,5,30,30
1650091507545,MATH 109,B01,083215,Anzaldo; Leesa B,0,4,30,30
1650091507545,MATH 109,B02,083216,Anzaldo; Leesa B,0,4,30,30
1650091513569,MATH 142A,A01,083219,Chow; Bennett,0,10,30,30
1650091513569,MATH 142A,A02,083220,Chow; Bennett,0,10,30,30
1650091513569,MATH 142A,B01,083221,Chow; Bennett,0,10,30,30
1650091513569,MATH 142A,B02,083222,Chow; Bennett,0,9,30,30
1650091519593,MATH 193A,A01,083224,Staff,0,4,30,30
1650091519593,MATH 193A,A02,083225,Staff,0,4,30,30
1650091519593,MATH 193A,A03,083781,Staff,0,0,30,30
1650091519593,MATH 193A,A04,083782,Staff,3,0,30,27
1650091525616,MATH 197,001,091859,McAuley; Julian John,9998,0,9999,1
1650091531667,COGS 9,A01,083615,Staff,0,14,60,60
1650091537691,COGS 11,A01,083617,Boyle; Mary E. T.,24,0,40,16
1650091543720,COGS 13,A01,083071,Staff,0,28,40,40
1650091549749,COGS 14A,A01,092681,Staff,0,10,100,100
1650091555774,COGS 14B,A01,083073,Cheng; Tzu-Han,0,4,50,50
1650091561801,COGS 17,A01,092677,Staff,35,0,75,40
1650091567828,COGS 100,A01,083619,Staff,0,22,60,60
1650091573856,COGS 101A,A01,083621,Davis; Joshua Daniel,0,18,60,60
1650091579886,COGS 101B,A01,091572,Staff,10,0,60,50
1650091585911,COGS 101C,A01,083625,Delgado; Tania,21,0,30,9
1650091591937,COGS 107A,A01,083627,Boyle; Mary E. T.,0,4,60,60
1650091597964,COGS 118A,A01,083075,Staff,17,0,60,43
1650091603993,CSE 3,A50,083646,Miranda; Gregory Joseph,22,0,38,16
1650091603993,CSE 3,A51,083647,Miranda; Gregory Joseph,37,0,37,0
1650091610017,CSE 8A,A50,083650,Miranda; Gregory Joseph,0,15,40,40
1650091616045,CSE 11,A01,083080,Cao; Yingjun,0,65,40,40
1650091622074,CSE 12,A01,083652,Staff,0,2,100,100
1650091628101,CSE 15L,A01,083654,Staff,0,0,50,50
1650091628101,CSE 15L,A02,083655,Staff,10,0,50,40
1650091634124,CSE 20,A01,083657,Staff,58,0,80,22
1650091640146,CSE 30,A01,083084,Eldon; John,0,63,40,40
1650091646171,CSE 100,A01,083659,Cao; Yingjun,0,60,50,50
1650091652193,CSE 134B,A01,083661,Powell; Thomas Allan,0,27,65,65
1650091658216,CSE 140,A01,083663,Staff,4,0,75,71
1650091664242,CSE 140L,A01,083088,Eldon; John,0,1,75,75
1650091670266,CSE 175,A01,083665,Kumar; Rakesh,9,0,25,16
1650091676297,CSE 190,A00,092507,Dubnov; Shlomo,14,0,20,6
1650091682323,ECE 45,A01,083139,Staff,0,13,40,40
1650091688347,ECE 65,A50,083695,Staff,0,4,30,30
1650091694386,ECE 109,A01,091882,Touri; Behrouz,48,0,70,22
1650091700412,ECE 180,A00,083140,Abi Samra; Nicholas Camill,24,0,30,6
1650091700412,ECE 180,B00,083141,Abi Samra; Nicholas Camill,8,0,30,22
1650091706439,MATH 10A,A01,083735,Patchell; Gregory David,12,0,30,18
1650091706439,MATH 10A,A02,083736,Patchell; Gregory David,28,0,30,2
1650091706439,MATH 10A,A03,083737,Patchell; Gregory David,26,0,30,4
1650091712464,MATH 10B,A01,083207,Staff,0,5,30,30
1650091712464,MATH 10B,A02,083208,Staff,0,4,30,30
1650091712464,MATH 10B,B01,083739,Staff,18,0,30,12
1650091712464,MATH 10B,B02,083740,Staff,29,0,30,1
1650091718496,MATH 18,A01,083743,Staff,10,0,30,20
1650091718496,MATH 18,A02,083744,Staff,28,0,30,2
1650091718496,MATH 18,A03,083745,Staff,23,0,30,7
1650091718496,MATH 18,A04,083746,Staff,27,0,30,3
1650091718496,MATH 18,B01,083748,Staff,0,9,30,30
1650091718496,MATH 18,B02,083749,Staff,0,6,30,30
1650091718496,MATH 18,B03,083750,Staff,0,6,30,30
1650091718496,MATH 18,B04,083751,Staff,0,7,30,30
1650091724519,MATH 20A,A01,083754,Staff,26,0,40,14
1650091730543,MATH 20B,A01,083756,Staff,0,5,30,30
1650091730543,MATH 20B,A02,083757,Staff,0,2,30,30
1650091736656,MATH 20C,A01,083760,Staff,0,11,30,30
1650091736656,MATH 20C,A02,083761,Staff,0,12,30,30
1650091736656,MATH 20C,B01,083762,Staff,14,0,30,16
1650091736656,MATH 20C,B02,083763,Staff,28,0,30,2
1650091742679,MATH 20D,A01,083765,Staff,0,2,30,30
1650091742679,MATH 20D,A02,083766,Staff,12,0,30,18
1650091742679,MATH 20D,A03,083767,Staff,28,0,30,2
1650091748704,MATH 20E,A01,083771,Staff,10,0,30,20
1650091748704,MATH 20E,A02,083772,Staff,20,0,30,10
1650091748704,MATH 20E,B01,083773,Staff,0,0,30,30
1650091748704,MATH 20E,B02,083774,Staff,14,0,30,16
1650091754732,MATH 103A,A01,083777,Staff,0,8,30,30
1650091754732,MATH 103A,A02,083778,Staff,0,7,30,30
1650091754732,MATH 103A,B01,083779,Staff,0,9,30,30
1650091754732,MATH 103A,B02,083780,Staff,0,6,30,30
1650091760754,MATH 105,A01,085443,Staff,0,12,30,30
1650091766779,MATH 109,A01,083213,Anzaldo; Leesa B,0,3,30,30
1650091766779,MATH 109,A02,083214,Anzaldo; Leesa B,0,5,30,30
1650091766779,MATH 109,B01,083215,Anzaldo; Leesa B,0,4,30,30
1650091766779,MATH 109,B02,083216,Anzaldo; Leesa B,0,4,30,30
1650091772829,MATH 142A,A01,083219,Chow; Bennett,0,10,30,30
1650091772829,MATH 142A,A02,083220,Chow; Bennett,0,10,30,30
1650091772829,MATH 142A,B01,083221,Chow; Bennett,0,10,30,30
1650091772829,MATH 142A,B02,083222,Chow; Bennett,0,9,30,30
1650091778855,MATH 193A,A01,083224,Staff,0,4,30,30
1650091778855,MATH 193A,A02,083225,Staff,0,4,30,30
1650091778855,MATH 193A,A03,083781,Staff,0,0,30,30
1650091778855,MATH 193A,A04,083782,Staff,3,0,30,27
1650091784880,MATH 197,001,091859,McAuley; Julian John,9998,0,9999,1
1650091790949,COGS 9,A01,083615,Staff,0,14,60,60
1650091796977,COGS 11,A01,083617,Boyle; Mary E. T.,24,0,40,16
1650091803002,COGS 13,A01,083071,Staff,0,28,40,40
1650091809029,COGS 14A,A01,092681,Staff,0,10,100,100
1650091815060,COGS 14B,A01,083073,Cheng; Tzu-Han,0,4,50,50
1650091821083,COGS 17,A01,092677,Staff,35,0,75,40
1650091827111,COGS 100,A01,083619,Staff,0,22,60,60
1650091833135,COGS 101A,A01,083621,Davis; Joshua Daniel,0,18,60,60
1650091839159,COGS 101B,A01,091572,Staff,10,0,60,50
1650091845182,COGS 101C,A01,083625,Delgado; Tania,21,0,30,9
1650091851210,COGS 107A,A01,083627,Boyle; Mary E. T.,0,4,60,60
1650091857239,COGS 118A,A01,083075,Staff,17,0,60,43
1650091863263,CSE 3,A50,083646,Miranda; Gregory Joseph,22,0,38,16
1650091863263,CSE 3,A51,083647,Miranda; Gregory Joseph,37,0,37,0
1650091869288,CSE 8A,A50,083650,Miranda; Gregory Joseph,0,15,40,40
1650091875311,CSE 11,A01,083080,Cao; Yingjun,0,65,40,40
1650091881338,CSE 12,A01,083652,Staff,0,2,100,100
1650091887366,CSE 15L,A01,083654,Staff,0,0,50,50
1650091887366,CSE 15L,A02,083655,Staff,10,0,50,40
1650091893401,CSE 20,A01,083657,Staff,58,0,80,22
1650091899425,CSE 30,A01,083084,Eldon; John,0,63,40,40
1650091905471,CSE 100,A01,083659,Cao; Yingjun,0,60,50,50
1650091911496,CSE 134B,A01,083661,Powell; Thomas Allan,0,27,65,65
1650091917519,CSE 140,A01,083663,Staff,4,0,75,71
1650091923548,CSE 140L,A01,083088,Eldon; John,0,1,75,75
1650091929576,CSE 175,A01,083665,Kumar; Rakesh,9,0,25,16
1650091935599,CSE 190,A00,092507,Dubnov; Shlomo,14,0,20,6
1650091941624,ECE 45,A01,083139,Staff,0,13,40,40
1650091947648,ECE 65,A50,083695,Staff,0,4,30,30
1650091953675,ECE 109,A01,091882,Touri; Behrouz,48,0,70,22
1650091959703,ECE 180,A00,083140,Abi Samra; Nicholas Camill,24,0,30,6
1650091959703,ECE 180,B00,083141,Abi Samra; Nicholas Camill,8,0,30,22
1650091965728,MATH 10A,A01,083735,Patchell; Gregory David,12,0,30,18
1650091965728,MATH 10A,A02,083736,Patchell; Gregory David,28,0,30,2
1650091965728,MATH 10A,A03,083737,Patchell; Gregory David,26,0,30,4
1650091971755,MATH 10B,A01,083207,Staff,0,5,30,30
1650091971755,MATH 10B,A02,083208,Staff,0,4,30,30
1650091971755,MATH 10B,B01,083739,Staff,18,0,30,12
1650091971755,MATH 10B,B02,083740,Staff,29,0,30,1
1650091977778,MATH 18,A01,083743,Staff,10,0,30,20
1650091977778,MATH 18,A02,083744,Staff,28,0,30,2
1650091977778,MATH 18,A03,083745,Staff,23,0,30,7
1650091977778,MATH 18,A04,083746,Staff,27,0,30,3
1650091977778,MATH 18,B01,083748,Staff,0,9,30,30
1650091977778,MATH 18,B02,083749,Staff,0,6,30,30
1650091977778,MATH 18,B03,083750,Staff,0,6,30,30
1650091977778,MATH 18,B04,083751,Staff,0,7,30,30
1650091983802,MATH 20A,A01,083754,Staff,26,0,40,14
1650091989829,MATH 20B,A01,083756,Staff,0,5,30,30
1650091989829,MATH 20B,A02,083757,Staff,0,2,30,30
1650091995853,MATH 20C,A01,083760,Staff,0,11,30,30
1650091995853,MATH 20C,A02,083761,Staff,0,12,30,30
1650091995853,MATH 20C,B01,083762,Staff,14,0,30,16
1650091995853,MATH 20C,B02,083763,Staff,28,0,30,2
1650092001881,MATH 20D,A01,083765,Staff,0,2,30,30
1650092001881,MATH 20D,A02,083766,Staff,12,0,30,18
1650092001881,MATH 20D,A03,083767,Staff,28,0,30,2
1650092007905,MATH 20E,A01,083771,Staff,10,0,30,20
1650092007905,MATH 20E,A02,083772,Staff,20,0,30,10
1650092007905,MATH 20E,B01,083773,Staff,0,0,30,30
1650092007905,MATH 20E,B02,083774,Staff,14,0,30,16
1650092013929,MATH 103A,A01,083777,Staff,0,8,30,30
1650092013929,MATH 103A,A02,083778,Staff,0,7,30,30
1650092013929,MATH 103A,B01,083779,Staff,0,9,30,30
1650092013929,MATH 103A,B02,083780,Staff,0,6,30,30
1650092019957,MATH 105,A01,085443,Staff,0,12,30,30
1650092025987,MATH 109,A01,083213,Anzaldo; Leesa B,0,3,30,30
1650092025987,MATH 109,A02,083214,Anzaldo; Leesa B,0,5,30,30
1650092025987,MATH 109,B01,083215,Anzaldo; Leesa B,0,4,30,30
1650092025987,MATH 109,B02,083216,Anzaldo; Leesa B,0,4,30,30
1650092032010,MATH 142A,A01,083219,Chow; Bennett,0,10,30,30
1650092032010,MATH 142A,A02,083220,Chow; Bennett,0,10,30,30
1650092032010,MATH 142A,B01,083221,Chow; Bennett,0,10,30,30
1650092032010,MATH 142A,B02,083222,Chow; Bennett,0,9,30,30
1650092038039,MATH 193A,A01,083224,Staff,0,4,30,30
1650092038039,MATH 193A,A02,083225,Staff,0,4,30,30
1650092038039,MATH 193A,A03,083781,Staff,0,0,30,30
1650092038039,MATH 193A,A04,083782,Staff,3,0,30,27
1650092044065,MATH 197,001,091859,McAuley; Julian John,9998,0,9999,1
1650092050117,COGS 9,A01,083615,Staff,0,14,60,60
1650092056144,COGS 11,A01,083617,Boyle; Mary E. T.,24,0,40,16
1650092062168,COGS 13,A01,083071,Staff,0,28,40,40
1650092068196,COGS 14A,A01,092681,Staff,0,10,100,100
1650092074220,COGS 14B,A01,083073,Cheng; Tzu-Han,0,4,50,50
1650092080247,COGS 17,A01,092677,Staff,35,0,75,40
1650092086271,COGS 100,A01,083619,Staff,0,22,60,60
1650092092295,COGS 101A,A01,083621,Davis; Joshua Daniel,0,18,60,60
1650092098324,COGS 101B,A01,091572,Staff,10,0,60,50
1650092104352,COGS 101C,A01,083625,Delgado; Tania,21,0,30,9
1650092110378,COGS 107A,A01,083627,Boyle; Mary E. T.,0,4,60,60
1650092116406,COGS 118A,A01,083075,Staff,17,0,60,43
1650092122446,CSE 3,A50,083646,Miranda; Gregory Joseph,22,0,38,16
1650092122446,CSE 3,A51,083647,Miranda; Gregory Joseph,37,0,37,0
1650092128469,CSE 8A,A50,083650,Miranda; Gregory Joseph,0,15,40,40
1650092134492,CSE 11,A01,083080,Cao; Yingjun,0,65,40,40
1650092140518,CSE 12,A01,083652,Staff,0,2,100,100
1650092146541,CSE 15L,A01,083654,Staff,0,0,50,50
1650092146541,CSE 15L,A02,083655,Staff,10,0,50,40
1650092152567,CSE 20,A01,083657,Staff,58,0,80,22
1650092158590,CSE 30,A01,083084,Eldon; John,0,63,40,40
1650092164617,CSE 100,A01,083659,Cao; Yingjun,0,61,50,50
1650092170646,CSE 134B,A01,083661,Powell; Thomas Allan,0,27,65,65
1650092176672,CSE 140,A01,083663,Staff,4,0,75,71
1650092182704,CSE 140L,A01,083088,Eldon; John,0,1,75,75
1650092188732,CSE 175,A01,083665,Kumar; Rakesh,9,0,25,16
1650092194754,CSE 190,A00,092507,Dubnov; Shlomo,14,0,20,6
1650092200777,ECE 45,A01,083139,Staff,0,13,40,40
1650092206801,ECE 65,A50,083695,Staff,0,4,30,30
1650092212826,ECE 109,A01,091882,Touri; Behrouz,48,0,70,22
1650092218854,ECE 180,A00,083140,Abi Samra; Nicholas Camill,24,0,30,6
1650092218854,ECE 180,B00,083141,Abi Samra; Nicholas Camill,8,0,30,22
1650092224882,MATH 10A,A01,083735,Patchell; Gregory David,12,0,30,18
1650092224882,MATH 10A,A02,083736,Patchell; Gregory David,28,0,30,2
1650092224882,MATH 10A,A03,083737,Patchell; Gregory David,26,0,30,4
1650092230911,MATH 10B,A01,083207,Staff,0,5,30,30
1650092230911,MATH 10B,A02,083208,Staff,0,4,30,30
1650092230911,MATH 10B,B01,083739,Staff,18,0,30,12
1650092230911,MATH 10B,B02,083740,Staff,29,0,30,1
1650092236940,MATH 18,A01,083743,Staff,10,0,30,20
1650092236940,MATH 18,A02,083744,Staff,28,0,30,2
1650092236940,MATH 18,A03,083745,Staff,23,0,30,7
1650092236940,MATH 18,A04,083746,Staff,27,0,30,3
1650092236940,MATH 18,B01,083748,Staff,0,9,30,30
1650092236940,MATH 18,B02,083749,Staff,0,6,30,30
1650092236940,MATH 18,B03,083750,Staff,0,6,30,30
1650092236940,MATH 18,B04,083751,Staff,0,7,30,30
1650092242965,MATH 20A,A01,083754,Staff,26,0,40,14
1650092248992,MATH 20B,A01,083756,Staff,0,5,30,30
1650092248992,MATH 20B,A02,083757,Staff,0,2,30,30
1650092255014,MATH 20C,A01,083760,Staff,0,11,30,30
1650092255014,MATH 20C,A02,083761,Staff,0,12,30,30
1650092255014,MATH 20C,B01,083762,Staff,14,0,30,16
1650092255014,MATH 20C,B02,083763,Staff,28,0,30,2
1650092261054,MATH 20D,A01,083765,Staff,0,2,30,30
1650092261054,MATH 20D,A02,083766,Staff,12,0,30,18
1650092261054,MATH 20D,A03,083767,Staff,28,0,30,2
1650092267081,MATH 20E,A01,083771,Staff,10,0,30,20
1650092267081,MATH 20E,A02,083772,Staff,20,0,30,10
1650092267081,MATH 20E,B01,083773,Staff,0,0,30,30
1650092267081,MATH 20E,B02,083774,Staff,14,0,30,16
1650092273111,MATH 103A,A01,083777,Staff,0,8,30,30
1650092273111,MATH 103A,A02,083778,Staff,0,7,30,30
1650092273111,MATH 103A,B01,083779,Staff,0,9,30,30
1650092273111,MATH 103A,B02,083780,Staff,0,6,30,30
1650092279137,MATH 105,A01,085443,Staff,0,13,30,30
1650092285160,MATH 109,A01,083213,Anzaldo; Leesa B,0,3,30,30
1650092285160,MATH 109,A02,083214,Anzaldo; Leesa B,0,5,30,30
1650092285160,MATH 109,B01,083215,Anzaldo; Leesa B,0,4,30,30
1650092285160,MATH 109,B02,083216,Anzaldo; Leesa B,0,4,30,30
1650092291183,MATH 142A,A01,083219,Chow; Bennett,0,10,30,30
1650092291183,MATH 142A,A02,083220,Chow; Bennett,0,10,30,30
1650092291183,MATH 142A,B01,083221,Chow; Bennett,0,10,30,30
1650092291183,MATH 142A,B02,083222,Chow; Bennett,0,9,30,30
1650092297206,MATH 193A,A01,083224,Staff,0,4,30,30
1650092297206,MATH 193A,A02,083225,Staff,0,4,30,30
1650092297206,MATH 193A,A03,083781,Staff,0,0,30,30
1650092297206,MATH 193A,A04,083782,Staff,2,0,30,28
1650092303230,MATH 197,001,091859,McAuley; Julian John,9998,0,9999,1
1650092309281,COGS 9,A01,083615,Staff,0,14,60,60
1650092315309,COGS 11,A01,083617,Boyle; Mary E. T.,24,0,40,16
1650092321332,COGS 13,A01,083071,Staff,0,28,40,40
1650092327449,COGS 14A,A01,092681,Staff,0,10,100,100
1650092333474,COGS 14B,A01,083073,Cheng; Tzu-Han,0,4,50,50
1650092339497,COGS 17,A01,092677,Staff,35,0,75,40
1650092345519,COGS 100,A01,083619,Staff,0,22,60,60
1650092351547,COGS 101A,A01,083621,Davis; Joshua Daniel,0,18,60,60
1650092357574,COGS 101B,A01,091572,Staff,10,0,60,50
1650092363598,COGS 101C,A01,083625,Delgado; Tania,21,0,30,9
1650092369626,COGS 107A,A01,083627,Boyle; Mary E. T.,0,4,60,60
1650092375650,COGS 118A,A01,083075,Staff,17,0,60,43
1650092381685,CSE 3,A50,083646,Miranda; Gregory Joseph,22,0,38,16
1650092381685,CSE 3,A51,083647,Miranda; Gregory Joseph,37,0,37,0
1650092387710,CSE 8A,A50,083650,Miranda; Gregory Joseph,0,15,40,40
1650092393733,CSE 11,A01,083080,Cao; Yingjun,0,65,40,40
1650092399758,CSE 12,A01,083652,Staff,0,2,100,100
1650092405793,CSE 15L,A01,083654,Staff,0,0,50,50
1650092405793,CSE 15L,A02,083655,Staff,10,0,50,40
1650092411816,CSE 20,A01,083657,Staff,58,0,80,22
1650092417845,CSE 30,A01,083084,Eldon; John,0,63,40,40
1650092423872,CSE 100,A01,083659,Cao; Yingjun,0,61,50,50
1650092429897,CSE 134B,A01,083661,Powell; Thomas Allan,0,27,65,65
1650092435921,CSE 140,A01,083663,Staff,4,0,75,71
1650092441944,CSE 140L,A01,083088,Eldon; John,0,1,75,75
1650092447967,CSE 175,A01,083665,Kumar; Rakesh,9,0,25,16
1650092454002,CSE 190,A00,092507,Dubnov; Shlomo,14,0,20,6
1650092460030,ECE 45,A01,083139,Staff,0,13,40,40
1650092466055,ECE 65,A50,083695,Staff,0,4,30,30
1650092472086,ECE 109,A01,091882,Touri; Behrouz,48,0,70,22
1650092478109,ECE 180,A00,083140,Abi Samra; Nicholas Camill,24,0,30,6
1650092478109,ECE 180,B00,083141,Abi Samra; Nicholas Camill,8,0,30,22
1650092484138,MATH 10A,A01,083735,Patchell; Gregory David,12,0,30,18
1650092484138,MATH 10A,A02,083736,Patchell; Gregory David,28,0,30,2
1650092484138,MATH 10A,A03,083737,Patchell; Gregory David,26,0,30,4
1650092490163,MATH 10B,A01,083207,Staff,0,5,30,30
1650092490163,MATH 10B,A02,083208,Staff,0,4,30,30
1650092490163,MATH 10B,B01,083739,Staff,18,0,30,12
1650092490163,MATH 10B,B02,083740,Staff,29,0,30,1
1650092496197,MATH 18,A01,083743,Staff,10,0,30,20
1650092496197,MATH 18,A02,083744,Staff,28,0,30,2
1650092496197,MATH 18,A03,083745,Staff,23,0,30,7
1650092496197,MATH 18,A04,083746,Staff,27,0,30,3
1650092496197,MATH 18,B01,083748,Staff,0,9,30,30
1650092496197,MATH 18,B02,083749,Staff,0,6,30,30
1650092496197,MATH 18,B03,083750,Staff,0,6,30,30
1650092496197,MATH 18,B04,083751,Staff,0,7,30,30
1650092502226,MATH 20A,A01,083754,Staff,26,0,40,14
1650092508255,MATH 20B,A01,083756,Staff,0,5,30,30
1650092508255,MATH 20B,A02,083757,Staff,0,2,30,30
1650092514281,MATH 20C,A01,083760,Staff,0,11,30,30
1650092514281,MATH 20C,A02,083761,Staff,0,12,30,30
1650092514281,MATH 20C,B01,083762,Staff,14,0,30,16
1650092514281,MATH 20C,B02,083763,Staff,28,0,30,2
1650092520310,MATH 20D,A01,083765,Staff,0,2,30,30
1650092520310,MATH 20D,A02,083766,Staff,12,0,30,18
1650092520310,MATH 20D,A03,083767,Staff,28,0,30,2
1650092526343,MATH 20E,A01,083771,Staff,10,0,30,20
1650092526343,MATH 20E,A02,083772,Staff,20,0,30,10
1650092526343,MATH 20E,B01,083773,Staff,0,0,30,30
1650092526343,MATH 20E,B02,083774,Staff,14,0,30,16
1650092532369,MATH 103A,A01,083777,Staff,0,8,30,30
1650092532369,MATH 103A,A02,083778,Staff,0,7,30,30
1650092532369,MATH 103A,B01,083779,Staff,0,9,30,30
1650092532369,MATH 103A,B02,083780,Staff,0,6,30,30
1650092538396,MATH 105,A01,085443,Staff,0,13,30,30
1650092544425,MATH 109,A01,083213,Anzaldo; Leesa B,0,3,30,30
1650092544425,MATH 109,A02,083214,Anzaldo; Leesa B,0,5,30,30
1650092544425,MATH 109,B01,083215,Anzaldo; Leesa B,0,4,30,30
1650092544425,MATH 109,B02,083216,Anzaldo; Leesa B,0,4,30,30
1650092550464,MATH 142A,A01,083219,Chow; Bennett,0,10,30,30
1650092550464,MATH 142A,A02,083220,Chow; Bennett,0,10,30,30
1650092550464,MATH 142A,B01,083221,Chow; Bennett,0,10,30,30
1650092550464,MATH 142A,B02,083222,Chow; Bennett,0,9,30,30
1650092556489,MATH 193A,A01,083224,Staff,0,4,30,30
1650092556489,MATH 193A,A02,083225,Staff,0,4,30,30
1650092556489,MATH 193A,A03,083781,Staff,0,0,30,30
1650092556489,MATH 193A,A04,083782,Staff,2,0,30,28
1650092562513,MATH 197,001,091859,McAuley; Julian John,9998,0,9999,1
1650092568565,COGS 9,A01,083615,Staff,0,14,60,60
1650092574594,COGS 11,A01,083617,Boyle; Mary E. T.,24,0,40,16
1650092580619,COGS 13,A01,083071,Staff,0,28,40,40
1650092586648,COGS 14A,A01,092681,Staff,0,10,100,100
1650092592673,COGS 14B,A01,083073,Cheng; Tzu-Han,0,4,50,50
1650092598697,COGS 17,A01,092677,Staff,35,0,75,40
1650092604719,COGS 100,A01,083619,Staff,0,22,60,60
1650092610744,COGS 101A,A01,083621,Davis; Joshua Daniel,0,18,60,60
1650092616767,COGS 101B,A01,091572,Staff,10,0,60,50
1650092622797,COGS 101C,A01,083625,Delgado; Tania,21,0,30,9
1650092628819,COGS 107A,A01,083627,Boyle; Mary E. T.,0,4,60,60
1650092634843,COGS 118A,A01,083075,Staff,17,0,60,43
1650092640867,CSE 3,A50,083646,Miranda; Gregory Joseph,22,0,38,16
1650092640867,CSE 3,A51,083647,Miranda; Gregory Joseph,37,0,37,0
1650092646901,CSE 8A,A50,083650,Miranda; Gregory Joseph,0,15,40,40
1650092652931,CSE 11,A01,083080,Cao; Yingjun,0,65,40,40
1650092658970,CSE 12,A01,083652,Staff,0,2,100,100
1650092664994,CSE 15L,A01,083654,Staff,0,0,50,50
1650092664994,CSE 15L,A02,083655,Staff,10,0,50,40
1650092671019,CSE 20,A01,083657,Staff,58,0,80,22
1650092677044,CSE 30,A01,083084,Eldon; John,0,63,40,40
1650092683081,CSE 100,A01,083659,Cao; Yingjun,0,61,50,50
1650092689109,CSE 134B,A01,083661,Powell; Thomas Allan,0,27,65,65
1650092695133,CSE 140,A01,083663,Staff,4,0,75,71
1650092701158,CSE 140L,A01,083088,Eldon; John,0,1,75,75
1650092707183,CSE 175,A01,083665,Kumar; Rakesh,9,0,25,16
1650092713211,CSE 190,A00,092507,Dubnov; Shlomo,14,0,20,6
1650092719239,ECE 45,A01,083139,Staff,0,13,40,40
1650092725264,ECE 65,A50,083695,Staff,0,4,30,30
1650092731297,ECE 109,A01,091882,Touri; Behrouz,48,0,70,22
1650092737321,ECE 180,A00,083140,Abi Samra; Nicholas Camill,24,0,30,6
1650092737321,ECE 180,B00,083141,Abi Samra; Nicholas Camill,8,0,30,22
1650092743345,MATH 10A,A01,083735,Patchell; Gregory David,12,0,30,18
1650092743345,MATH 10A,A02,083736,Patchell; Gregory David,28,0,30,2
1650092743345,MATH 10A,A03,083737,Patchell; Gregory David,26,0,30,4
1650092749380,MATH 10B,A01,083207,Staff,0,5,30,30
1650092749380,MATH 10B,A02,083208,Staff,0,4,30,30
1650092749380,MATH 10B,B01,083739,Staff,18,0,30,12
1650092749380,MATH 10B,B02,083740,Staff,29,0,30,1
1650092755419,MATH 18,A01,083743,Staff,10,0,30,20
1650092755419,MATH 18,A02,083744,Staff,28,0,30,2
1650092755419,MATH 18,A03,083745,Staff,23,0,30,7
1650092755419,MATH 18,A04,083746,Staff,27,0,30,3
1650092755419,MATH 18,B01,083748,Staff,0,9,30,30
1650092755419,MATH 18,B02,083749,Staff,0,6,30,30
1650092755419,MATH 18,B03,083750,Staff,0,6,30,30
1650092755419,MATH 18,B04,083751,Staff,0,7,30,30
1650092761450,MATH 20A,A01,083754,Staff,26,0,40,14
1650092767485,MATH 20B,A01,083756,Staff,0,5,30,30
1650092767485,MATH 20B,A02,083757,Staff,0,2,30,30
1650092773523,MATH 20C,A01,083760,Staff,0,11,30,30
1650092773523,MATH 20C,A02,083761,Staff,0,12,30,30
1650092773523,MATH 20C,B01,083762,Staff,14,0,30,16
1650092773523,MATH 20C,B02,083763,Staff,28,0,30,2
1650092779547,MATH 20D,A01,083765,Staff,0,2,30,30
1650092779547,MATH 20D,A02,083766,Staff,12,0,30,18
1650092779547,MATH 20D,A03,083767,Staff,28,0,30,2
1650092785572,MATH 20E,A01,083771,Staff,10,0,30,20
1650092785572,MATH 20E,A02,083772,Staff,20,0,30,10
1650092785572,MATH 20E,B01,083773,Staff,0,0,30,30
1650092785572,MATH 20E,B02,083774,Staff,14,0,30,16
1650092791597,MATH 103A,A01,083777,Staff,0,8,30,30
1650092791597,MATH 103A,A02,083778,Staff,0,7,30,30
1650092791597,MATH 103A,B01,083779,Staff,0,9,30,30
1650092791597,MATH 103A,B02,083780,Staff,0,6,30,30
1650092797621,MATH 105,A01,085443,Staff,0,13,30,30
1650092803660,MATH 109,A01,083213,Anzaldo; Leesa B,0,3,30,30
1650092803660,MATH 109,A02,083214,Anzaldo; Leesa B,0,5,30,30
1650092803660,MATH 109,B01,083215,Anzaldo; Leesa B,0,4,30,30
1650092803660,MATH 109,B02,083216,Anzaldo; Leesa B,0,4,30,30
1650092809686,MATH 142A,A01,083219,Chow; Bennett,0,10,30,30
1650092809686,MATH 142A,A02,083220,Chow; Bennett,0,10,30,30
1650092809686,MATH 142A,B01,083221,Chow; Bennett,0,10,30,30
1650092809686,MATH 142A,B02,083222,Chow; Bennett,0,9,30,30
1650092815714,MATH 193A,A01,083224,Staff,0,4,30,30
1650092815714,MATH 193A,A02,083225,Staff,0,4,30,30
1650092815714,MATH 193A,A03,083781,Staff,0,0,30,30
1650092815714,MATH 193A,A04,083782,Staff,2,0,30,28
1650092821739,MATH 197,001,091859,McAuley; Julian John,9998,0,9999,1
1650092827802,COGS 9,A01,083615,Staff,0,14,60,60
1650092833826,COGS 11,A01,083617,Boyle; Mary E. T.,24,0,40,16
1650092839850,COGS 13,A01,083071,Staff,0,28,40,40
1650092845877,COGS 14A,A01,092681,Staff,0,10,100,100
1650092851902,COGS 14B,A01,083073,Cheng; Tzu-Han,0,4,50,50
1650092857931,COGS 17,A01,092677,Staff,35,0,75,40
1650092863953,COGS 100,A01,083619,Staff,0,22,60,60
1650092869977,COGS 101A,A01,083621,Davis; Joshua Daniel,0,18,60,60
1650092876005,COGS 101B,A01,091572,Staff,10,0,60,50
1650092882039,COGS 101C,A01,083625,Delgado; Tania,21,0,30,9
1650092888068,COGS 107A,A01,083627,Boyle; Mary E. T.,0,4,60,60
1650092894093,COGS 118A,A01,083075,Staff,17,0,60,43
1650092900117,CSE 3,A50,083646,Miranda; Gregory Joseph,22,0,38,16
1650092900117,CSE 3,A51,083647,Miranda; Gregory Joseph,37,0,37,0
1650092906142,CSE 8A,A50,083650,Miranda; Gregory Joseph,0,15,40,40
1650092912171,CSE 11,A01,083080,Cao; Yingjun,0,65,40,40
1650092918195,CSE 12,A01,083652,Staff,0,2,100,100
1650092924311,CSE 15L,A01,083654,Staff,0,0,50,50
1650092924311,CSE 15L,A02,083655,Staff,10,0,50,40
1650092930334,CSE 20,A01,083657,Staff,58,0,80,22
1650092936360,CSE 30,A01,083084,Eldon; John,0,63,40,40
1650092942388,CSE 100,A01,083659,Cao; Yingjun,0,61,50,50
1650092948416,CSE 134B,A01,083661,Powell; Thomas Allan,0,27,65,65
1650092954439,CSE 140,A01,083663,Staff,4,0,75,71
1650092960468,CSE 140L,A01,083088,Eldon; John,0,1,75,75
1650092966490,CSE 175,A01,083665,Kumar; Rakesh,9,0,25,16
1650092972519,CSE 190,A00,092507,Dubnov; Shlomo,14,0,20,6
1650092978547,ECE 45,A01,083139,Staff,0,13,40,40
1650092984571,ECE 65,A50,083695,Staff,0,4,30,30
1650092990614,ECE 109,A01,091882,Touri; Behrouz,48,0,70,22
1650092996643,ECE 180,A00,083140,Abi Samra; Nicholas Camill,24,0,30,6
1650092996643,ECE 180,B00,083141,Abi Samra; Nicholas Camill,8,0,30,22
1650093002673,MATH 10A,A01,083735,Patchell; Gregory David,12,0,30,18
1650093002673,MATH 10A,A02,083736,Patchell; Gregory David,28,0,30,2
1650093002673,MATH 10A,A03,083737,Patchell; Gregory David,26,0,30,4
1650093008710,MATH 10B,A01,083207,Staff,0,5,30,30
1650093008710,MATH 10B,A02,083208,Staff,0,4,30,30
1650093008710,MATH 10B,B01,083739,Staff,18,0,30,12
1650093008710,MATH 10B,B02,083740,Staff,29,0,30,1
1650093014736,MATH 18,A01,083743,Staff,10,0,30,20
1650093014736,MATH 18,A02,083744,Staff,28,0,30,2
1650093014736,MATH 18,A03,083745,Staff,23,0,30,7
1650093014736,MATH 18,A04,083746,Staff,27,0,30,3
1650093014736,MATH 18,B01,083748,Staff,0,9,30,30
1650093014736,MATH 18,B02,083749,Staff,0,6,30,30
1650093014736,MATH 18,B03,083750,Staff,0,6,30,30
1650093014736,MATH 18,B04,083751,Staff,0,7,30,30
1650093020767,MATH 20A,A01,083754,Staff,26,0,40,14
1650093026792,MATH 20B,A01,083756,Staff,0,5,30,30
1650093026792,MATH 20B,A02,083757,Staff,0,2,30,30
1650093032821,MATH 20C,A01,083760,Staff,0,11,30,30
1650093032821,MATH 20C,A02,083761,Staff,0,12,30,30
1650093032821,MATH 20C,B01,083762,Staff,14,0,30,16
1650093032821,MATH 20C,B02,083763,Staff,28,0,30,2
1650093038849,MATH 20D,A01,083765,Staff,0,2,30,30
1650093038849,MATH 20D,A02,083766,Staff,12,0,30,18
1650093038849,MATH 20D,A03,083767,Staff,28,0,30,2
1650093044873,MATH 20E,A01,083771,Staff,10,0,30,20
1650093044873,MATH 20E,A02,083772,Staff,20,0,30,10
1650093044873,MATH 20E,B01,083773,Staff,0,0,30,30
1650093044873,MATH 20E,B02,083774,Staff,14,0,30,16
1650093050899,MATH 103A,A01,083777,Staff,0,8,30,30
1650093050899,MATH 103A,A02,083778,Staff,0,7,30,30
1650093050899,MATH 103A,B01,083779,Staff,0,9,30,30
1650093050899,MATH 103A,B02,083780,Staff,0,6,30,30
1650093056930,MATH 105,A01,085443,Staff,0,13,30,30
1650093062960,MATH 109,A01,083213,Anzaldo; Leesa B,0,3,30,30
1650093062960,MATH 109,A02,083214,Anzaldo; Leesa B,0,5,30,30
1650093062960,MATH 109,B01,083215,Anzaldo; Leesa B,0,4,30,30
1650093062960,MATH 109,B02,083216,Anzaldo; Leesa B,0,4,30,30
1650093068992,MATH 142A,A01,083219,Chow; Bennett,0,10,30,30
1650093068992,MATH 142A,A02,083220,Chow; Bennett,0,10,30,30
1650093068992,MATH 142A,B01,083221,Chow; Bennett,0,10,30,30
1650093068992,MATH 142A,B02,083222,Chow; Bennett,0,9,30,30
1650093075016,MATH 193A,A01,083224,Staff,0,4,30,30
1650093075016,MATH 193A,A02,083225,Staff,0,4,30,30
1650093075016,MATH 193A,A03,083781,Staff,0,0,30,30
1650093075016,MATH 193A,A04,083782,Staff,2,0,30,28
1650093081041,MATH 197,001,091859,McAuley; Julian John,9998,0,9999,1
1650093087099,COGS 9,A01,083615,Staff,0,14,60,60
1650093093128,COGS 11,A01,083617,Boyle; Mary E. T.,24,0,40,16
1650093099153,COGS 13,A01,083071,Staff,0,28,40,40
1650093105183,COGS 14A,A01,092681,Staff,0,10,100,100
1650093111206,COGS 14B,A01,083073,Cheng; Tzu-Han,0,4,50,50
1650093117230,COGS 17,A01,092677,Staff,35,0,75,40
1650093123389,COGS 100,A01,083619,Staff,0,22,60,60
1650093129632,COGS 101A,A01,083621,Davis; Joshua Daniel,0,18,60,60
1650093135787,COGS 101B,A01,091572,Staff,10,0,60,50
1650093141813,COGS 101C,A01,083625,Delgado; Tania,21,0,30,9
1650093147929,COGS 107A,A01,083627,Boyle; Mary E. T.,0,4,60,60
1650093153956,COGS 118A,A01,083075,Staff,17,0,60,43
1650093159982,CSE 3,A50,083646,Miranda; Gregory Joseph,22,0,38,16
1650093159982,CSE 3,A51,083647,Miranda; Gregory Joseph,37,0,37,0
1650093166020,CSE 8A,A50,083650,Miranda; Gregory Joseph,0,15,40,40
1650093172051,CSE 11,A01,083080,Cao; Yingjun,0,65,40,40
1650093178075,CSE 12,A01,083652,Staff,0,2,100,100
1650093184100,CSE 15L,A01,083654,Staff,0,0,50,50
1650093184100,CSE 15L,A02,083655,Staff,10,0,50,40
1650093190126,CSE 20,A01,083657,Staff,58,0,80,22
1650093196160,CSE 30,A01,083084,Eldon; John,0,63,40,40
1650093202183,CSE 100,A01,083659,Cao; Yingjun,0,61,50,50
1650093208210,CSE 134B,A01,083661,Powell; Thomas Allan,0,27,65,65
1650093214235,CSE 140,A01,083663,Staff,4,0,75,71
1650093220264,CSE 140L,A01,083088,Eldon; John,0,1,75,75
1650093226301,CSE 175,A01,083665,Kumar; Rakesh,9,0,25,16
1650093232326,CSE 190,A00,092507,Dubnov; Shlomo,14,0,20,6
1650093238356,ECE 45,A01,083139,Staff,0,13,40,40
1650093244385,ECE 65,A50,083695,Staff,0,4,30,30
1650093250411,ECE 109,A01,091882,Touri; Behrouz,48,0,70,22
1650093256440,ECE 180,A00,083140,Abi Samra; Nicholas Camill,24,0,30,6
1650093256440,ECE 180,B00,083141,Abi Samra; Nicholas Camill,8,0,30,22
1650093262472,MATH 10A,A01,083735,Patchell; Gregory David,12,0,30,18
1650093262472,MATH 10A,A02,083736,Patchell; Gregory David,28,0,30,2
1650093262472,MATH 10A,A03,083737,Patchell; Gregory David,26,0,30,4
1650093268501,MATH 10B,A01,083207,Staff,0,5,30,30
1650093268501,MATH 10B,A02,083208,Staff,0,4,30,30
1650093268501,MATH 10B,B01,083739,Staff,18,0,30,12
1650093268501,MATH 10B,B02,083740,Staff,29,0,30,1
1650093274527,MATH 18,A01,083743,Staff,10,0,30,20
1650093274527,MATH 18,A02,083744,Staff,28,0,30,2
1650093274527,MATH 18,A03,083745,Staff,23,0,30,7
1650093274527,MATH 18,A04,083746,Staff,27,0,30,3
1650093274527,MATH 18,B01,083748,Staff,0,9,30,30
1650093274527,MATH 18,B02,083749,Staff,0,6,30,30
1650093274527,MATH 18,B03,083750,Staff,0,6,30,30
1650093274527,MATH 18,B04,083751,Staff,0,7,30,30
1650093280553,MATH 20A,A01,083754,Staff,26,0,40,14
1650093286578,MATH 20B,A01,083756,Staff,0,5,30,30
1650093286578,MATH 20B,A02,083757,Staff,0,2,30,30
1650093292604,MATH 20C,A01,083760,Staff,0,11,30,30
1650093292604,MATH 20C,A02,083761,Staff,0,12,30,30
1650093292604,MATH 20C,B01,083762,Staff,14,0,30,16
1650093292604,MATH 20C,B02,083763,Staff,28,0,30,2
1650093298629,MATH 20D,A01,083765,Staff,0,2,30,30
1650093298629,MATH 20D,A02,083766,Staff,12,0,30,18
1650093298629,MATH 20D,A03,083767,Staff,28,0,30,2
1650093304653,MATH 20E,A01,083771,Staff,10,0,30,20
1650093304653,MATH 20E,A02,083772,Staff,20,0,30,10
1650093304653,MATH 20E,B01,083773,Staff,0,0,30,30
1650093304653,MATH 20E,B02,083774,Staff,14,0,30,16
1650093310678,MATH 103A,A01,083777,Staff,0,8,30,30
1650093310678,MATH 103A,A02,083778,Staff,0,7,30,30
1650093310678,MATH 103A,B01,083779,Staff,0,9,30,30
1650093310678,MATH 103A,B02,083780,Staff,0,6,30,30
1650093316705,MATH 105,A01,085443,Staff,0,13,30,30
1650093322728,MATH 109,A01,083213,Anzaldo; Leesa B,0,3,30,30
1650093322728,MATH 109,A02,083214,Anzaldo; Leesa B,0,5,30,30
1650093322728,MATH 109,B01,083215,Anzaldo; Leesa B,0,4,30,30
1650093322728,MATH 109,B02,083216,Anzaldo; Leesa B,0,4,30,30
1650093328754,MATH 142A,A01,083219,Chow; Bennett,0,10,30,30
1650093328754,MATH 142A,A02,083220,Chow; Bennett,0,10,30,30
1650093328754,MATH 142A,B01,083221,Chow; Bennett,0,10,30,30
1650093328754,MATH 142A,B02,083222,Chow; Bennett,0,9,30,30
1650093334780,MATH 193A,A01,083224,Staff,0,4,30,30
1650093334780,MATH 193A,A02,083225,Staff,0,4,30,30
1650093334780,MATH 193A,A03,083781,Staff,0,0,30,30
1650093334780,MATH 193A,A04,083782,Staff,2,0,30,28
1650093340802,MATH 197,001,091859,McAuley; Julian John,9998,0,9999,1
1650093346874,COGS 9,A01,083615,Staff,0,14,60,60
1650093352907,COGS 11,A01,083617,Boyle; Mary E. T.,24,0,40,16
1650093358931,COGS 13,A01,083071,Staff,0,28,40,40
1650093364965,COGS 14A,A01,092681,Staff,0,10,100,100
1650093370987,COGS 14B,A01,083073,Cheng; Tzu-Han,0,4,50,50
1650093377018,COGS 17,A01,092677,Staff,35,0,75,40
1650093383042,COGS 100,A01,083619,Staff,0,22,60,60
1650093389068,COGS 101A,A01,083621,Davis; Joshua Daniel,0,18,60,60
1650093395096,COGS 101B,A01,091572,Staff,10,0,60,50
1650093401126,COGS 101C,A01,083625,Delgado; Tania,21,0,30,9
1650093407154,COGS 107A,A01,083627,Boyle; Mary E. T.,0,4,60,60
1650093413177,COGS 118A,A01,083075,Staff,17,0,60,43
1650093419203,CSE 3,A50,083646,Miranda; Gregory Joseph,22,0,38,16
1650093419203,CSE 3,A51,083647,Miranda; Gregory Joseph,37,0,37,0
1650093425232,CSE 8A,A50,083650,Miranda; Gregory Joseph,0,15,40,40
1650093431272,CSE 11,A01,083080,Cao; Yingjun,0,65,40,40
1650093437297,CSE 12,A01,083652,Staff,0,2,100,100
1650093443324,CSE 15L,A01,083654,Staff,0,0,50,50
1650093443324,CSE 15L,A02,083655,Staff,10,0,50,40
1650093449352,CSE 20,A01,083657,Staff,58,0,80,22
1650093455383,CSE 30,A01,083084,Eldon; John,0,63,40,40
1650093461412,CSE 100,A01,083659,Cao; Yingjun,0,61,50,50
1650093467437,CSE 134B,A01,083661,Powell; Thomas Allan,0,27,65,65
1650093473459,CSE 140,A01,083663,Staff,4,0,75,71
1650093479483,CSE 140L,A01,083088,Eldon; John,0,1,75,75
1650093485507,CSE 175,A01,083665,Kumar; Rakesh,9,0,25,16
1650093491539,CSE 190,A00,092507,Dubnov; Shlomo,14,0,20,6
1650093497569,ECE 45,A01,083139,Staff,0,13,40,40
1650093503598,ECE 65,A50,083695,Staff,0,4,30,30
1650093509624,ECE 109,A01,091882,Touri; Behrouz,48,0,70,22
1650093515653,ECE 180,A00,083140,Abi Samra; Nicholas Camill,24,0,30,6
1650093515653,ECE 180,B00,083141,Abi Samra; Nicholas Camill,8,0,30,22
1650093521780,MATH 10A,A01,083735,Patchell; Gregory David,12,0,30,18
1650093521780,MATH 10A,A02,083736,Patchell; Gregory David,28,0,30,2
1650093521780,MATH 10A,A03,083737,Patchell; Gregory David,26,0,30,4
1650093527811,MATH 10B,A01,083207,Staff,0,5,30,30
1650093527811,MATH 10B,A02,083208,Staff,0,4,30,30
1650093527811,MATH 10B,B01,083739,Staff,18,0,30,12
1650093527811,MATH 10B,B02,083740,Staff,29,0,30,1
1650093533837,MATH 18,A01,083743,Staff,10,0,30,20
1650093533837,MATH 18,A02,083744,Staff,28,0,30,2
1650093533837,MATH 18,A03,083745,Staff,23,0,30,7
1650093533837,MATH 18,A04,083746,Staff,27,0,30,3
1650093533837,MATH 18,B01,083748,Staff,0,9,30,30
1650093533837,MATH 18,B02,083749,Staff,0,6,30,30
1650093533837,MATH 18,B03,083750,Staff,0,6,30,30
1650093533837,MATH 18,B04,083751,Staff,0,7,30,30
1650093539862,MATH 20A,A01,083754,Staff,26,0,40,14
1650093545888,MATH 20B,A01,083756,Staff,0,5,30,30
1650093545888,MATH 20B,A02,083757,Staff,0,2,30,30
1650093551919,MATH 20C,A01,083760,Staff,0,11,30,30
1650093551919,MATH 20C,A02,083761,Staff,0,12,30,30
1650093551919,MATH 20C,B01,083762,Staff,14,0,30,16
1650093551919,MATH 20C,B02,083763,Staff,28,0,30,2
1650093557943,MATH 20D,A01,083765,Staff,0,2,30,30
1650093557943,MATH 20D,A02,083766,Staff,12,0,30,18
1650093557943,MATH 20D,A03,083767,Staff,28,0,30,2
1650093563969,MATH 20E,A01,083771,Staff,10,0,30,20
1650093563969,MATH 20E,A02,083772,Staff,20,0,30,10
1650093563969,MATH 20E,B01,083773,Staff,0,0,30,30
1650093563969,MATH 20E,B02,083774,Staff,13,0,30,17
1650093569993,MATH 103A,A01,083777,Staff,0,8,30,30
1650093569993,MATH 103A,A02,083778,Staff,0,7,30,30
1650093569993,MATH 103A,B01,083779,Staff,0,9,30,30
1650093569993,MATH 103A,B02,083780,Staff,0,6,30,30
1650093576016,MATH 105,A01,085443,Staff,0,13,30,30
1650093582046,MATH 109,A01,083213,Anzaldo; Leesa B,0,3,30,30
1650093582046,MATH 109,A02,083214,Anzaldo; Leesa B,0,5,30,30
1650093582046,MATH 109,B01,083215,Anzaldo; Leesa B,0,4,30,30
1650093582046,MATH 109,B02,083216,Anzaldo; Leesa B,0,4,30,30
1650093588073,MATH 142A,A01,083219,Chow; Bennett,0,10,30,30
1650093588073,MATH 142A,A02,083220,Chow; Bennett,0,10,30,30
1650093588073,MATH 142A,B01,083221,Chow; Bennett,0,10,30,30
1650093588073,MATH 142A,B02,083222,Chow; Bennett,0,9,30,30
1650093594096,MATH 193A,A01,083224,Staff,0,4,30,30
1650093594096,MATH 193A,A02,083225,Staff,0,4,30,30
1650093594096,MATH 193A,A03,083781,Staff,0,0,30,30
1650093594096,MATH 193A,A04,083782,Staff,2,0,30,28
1650093600120,MATH 197,001,091859,McAuley; Julian John,9998,0,9999,1
1650093606178,COGS 9,A01,083615,Staff,0,14,60,60
1650093612208,COGS 11,A01,083617,Boyle; Mary E. T.,24,0,40,16
1650093618239,COGS 13,A01,083071,Staff,0,28,40,40
1650093624269,COGS 14A,A01,092681,Staff,0,10,100,100
1650093630292,COGS 14B,A01,083073,Cheng; Tzu-Han,0,4,50,50
1650093636320,COGS 17,A01,092677,Staff,35,0,75,40
1650093642352,COGS 100,A01,083619,Staff,0,22,60,60
1650093648377,COGS 101A,A01,083621,Davis; Joshua Daniel,0,18,60,60
1650093654408,COGS 101B,A01,091572,Staff,10,0,60,50
1650093660433,COGS 101C,A01,083625,Delgado; Tania,21,0,30,9
1650093666462,COGS 107A,A01,083627,Boyle; Mary E. T.,0,4,60,60
1650093672487,COGS 118A,A01,083075,Staff,17,0,60,43
1650093678514,CSE 3,A50,083646,Miranda; Gregory Joseph,22,0,38,16
1650093678514,CSE 3,A51,083647,Miranda; Gregory Joseph,37,0,37,0
1650093684543,CSE 8A,A50,083650,Miranda; Gregory Joseph,0,15,40,40
1650093690573,CSE 11,A01,083080,Cao; Yingjun,0,65,40,40
1650093696601,CSE 12,A01,083652,Staff,0,2,100,100
1650093702628,CSE 15L,A01,083654,Staff,0,0,50,50
1650093702628,CSE 15L,A02,083655,Staff,10,0,50,40
1650093708655,CSE 20,A01,083657,Staff,58,0,80,22
1650093714681,CSE 30,A01,083084,Eldon; John,0,63,40,40
1650093720710,CSE 100,A01,083659,Cao; Yingjun,0,61,50,50
1650093726744,CSE 134B,A01,083661,Powell; Thomas Allan,0,27,65,65
1650093732771,CSE 140,A01,083663,Staff,4,0,75,71
1650093738799,CSE 140L,A01,083088,Eldon; John,0,1,75,75
1650093744828,CSE 175,A01,083665,Kumar; Rakesh,9,0,25,16
1650093750853,CSE 190,A00,092507,Dubnov; Shlomo,14,0,20,6
1650093756878,ECE 45,A01,083139,Staff,0,13,40,40
1650093762907,ECE 65,A50,083695,Staff,0,4,30,30
1650093768931,ECE 109,A01,091882,Touri; Behrouz,48,0,70,22
1650093774956,ECE 180,A00,083140,Abi Samra; Nicholas Camill,24,0,30,6
1650093774956,ECE 180,B00,083141,Abi Samra; Nicholas Camill,8,0,30,22
1650093780980,MATH 10A,A01,083735,Patchell; Gregory David,12,0,30,18
1650093780980,MATH 10A,A02,083736,Patchell; Gregory David,28,0,30,2
1650093780980,MATH 10A,A03,083737,Patchell; Gregory David,26,0,30,4
1650093787010,MATH 10B,A01,083207,Staff,0,5,30,30
1650093787010,MATH 10B,A02,083208,Staff,0,4,30,30
1650093787010,MATH 10B,B01,083739,Staff,18,0,30,12
1650093787010,MATH 10B,B02,083740,Staff,29,0,30,1
1650093793036,MATH 18,A01,083743,Staff,10,0,30,20
1650093793036,MATH 18,A02,083744,Staff,28,0,30,2
1650093793036,MATH 18,A03,083745,Staff,23,0,30,7
1650093793036,MATH 18,A04,083746,Staff,27,0,30,3
1650093793036,MATH 18,B01,083748,Staff,0,9,30,30
1650093793036,MATH 18,B02,083749,Staff,0,6,30,30
1650093793036,MATH 18,B03,083750,Staff,0,6,30,30
1650093793036,MATH 18,B04,083751,Staff,0,7,30,30
1650093799060,MATH 20A,A01,083754,Staff,26,0,40,14
1650093805085,MATH 20B,A01,083756,Staff,0,5,30,30
1650093805085,MATH 20B,A02,083757,Staff,0,2,30,30
1650093811114,MATH 20C,A01,083760,Staff,0,11,30,30
1650093811114,MATH 20C,A02,083761,Staff,0,12,30,30
1650093811114,MATH 20C,B01,083762,Staff,14,0,30,16
1650093811114,MATH 20C,B02,083763,Staff,28,0,30,2
1650093817141,MATH 20D,A01,083765,Staff,0,2,30,30
1650093817141,MATH 20D,A02,083766,Staff,12,0,30,18
1650093817141,MATH 20D,A03,083767,Staff,28,0,30,2
1650093823168,MATH 20E,A01,083771,Staff,10,0,30,20
1650093823168,MATH 20E,A02,083772,Staff,20,0,30,10
1650093823168,MATH 20E,B01,083773,Staff,0,0,30,30
1650093823168,MATH 20E,B02,083774,Staff,13,0,30,17
1650093829195,MATH 103A,A01,083777,Staff,0,8,30,30
1650093829195,MATH 103A,A02,083778,Staff,0,7,30,30
1650093829195,MATH 103A,B01,083779,Staff,0,9,30,30
1650093829195,MATH 103A,B02,083780,Staff,0,6,30,30
1650093835222,MATH 105,A01,085443,Staff,0,13,30,30
1650093841249,MATH 109,A01,083213,Anzaldo; Leesa B,0,3,30,30
1650093841249,MATH 109,A02,083214,Anzaldo; Leesa B,0,5,30,30
1650093841249,MATH 109,B01,083215,Anzaldo; Leesa B,0,4,30,30
1650093841249,MATH 109,B02,083216,Anzaldo; Leesa B,0,4,30,30
1650093847279,MATH 142A,A01,083219,Chow; Bennett,0,10,30,30
1650093847279,MATH 142A,A02,083220,Chow; Bennett,0,10,30,30
1650093847279,MATH 142A,B01,083221,Chow; Bennett,0,10,30,30
1650093847279,MATH 142A,B02,083222,Chow; Bennett,0,9,30,30
1650093853319,MATH 193A,A01,083224,Staff,0,4,30,30
1650093853319,MATH 193A,A02,083225,Staff,0,4,30,30
1650093853319,MATH 193A,A03,083781,Staff,0,0,30,30
1650093853319,MATH 193A,A04,083782,Staff,2,0,30,28
1650093859348,MATH 197,001,091859,McAuley; Julian John,9998,0,9999,1
1650093865406,COGS 9,A01,083615,Staff,0,14,60,60
1650093871443,COGS 11,A01,083617,Boyle; Mary E. T.,24,0,40,16
1650093877471,COGS 13,A01,083071,Staff,0,28,40,40
1650093883496,COGS 14A,A01,092681,Staff,0,10,100,100
1650093889524,COGS 14B,A01,083073,Cheng; Tzu-Han,0,4,50,50
1650093895549,COGS 17,A01,092677,Staff,35,0,75,40
1650093901573,COGS 100,A01,083619,Staff,0,22,60,60
1650093907604,COGS 101A,A01,083621,Davis; Joshua Daniel,0,18,60,60
1650093913629,COGS 101B,A01,091572,Staff,10,0,60,50
1650093919656,COGS 101C,A01,083625,Delgado; Tania,21,0,30,9
1650093925682,COGS 107A,A01,083627,Boyle; Mary E. T.,0,4,60,60
1650093931709,COGS 118A,A01,083075,Staff,17,0,60,43
1650093937738,CSE 3,A50,083646,Miranda; Gregory Joseph,22,0,38,16
1650093937738,CSE 3,A51,083647,Miranda; Gregory Joseph,37,0,37,0
1650093943763,CSE 8A,A50,083650,Miranda; Gregory Joseph,0,15,40,40
1650093949793,CSE 11,A01,083080,Cao; Yingjun,0,65,40,40
1650093955817,CSE 12,A01,083652,Staff,0,2,100,100
1650093961839,CSE 15L,A01,083654,Staff,0,0,50,50
1650093961839,CSE 15L,A02,083655,Staff,10,0,50,40
1650093967871,CSE 20,A01,083657,Staff,58,0,80,22
1650093973903,CSE 30,A01,083084,Eldon; John,0,63,40,40
1650093979930,CSE 100,A01,083659,Cao; Yingjun,0,61,50,50
1650093985955,CSE 134B,A01,083661,Powell; Thomas Allan,0,27,65,65
1650093991982,CSE 140,A01,083663,Staff,4,0,75,71
1650093998006,CSE 140L,A01,083088,Eldon; John,0,1,75,75
1650094004031,CSE 175,A01,083665,Kumar; Rakesh,9,0,25,16
1650094010060,CSE 190,A00,092507,Dubnov; Shlomo,14,0,20,6
1650094016088,ECE 45,A01,083139,Staff,0,13,40,40
1650094022114,ECE 65,A50,083695,Staff,0,4,30,30
1650094028145,ECE 109,A01,091882,Touri; Behrouz,48,0,70,22
1650094034170,ECE 180,A00,083140,Abi Samra; Nicholas Camill,24,0,30,6
1650094034170,ECE 180,B00,083141,Abi Samra; Nicholas Camill,8,0,30,22
1650094040192,MATH 10A,A01,083735,Patchell; Gregory David,12,0,30,18
1650094040192,MATH 10A,A02,083736,Patchell; Gregory David,28,0,30,2
1650094040192,MATH 10A,A03,083737,Patchell; Gregory David,26,0,30,4
1650094046217,MATH 10B,A01,083207,Staff,0,5,30,30
1650094046217,MATH 10B,A02,083208,Staff,0,4,30,30
1650094046217,MATH 10B,B01,083739,Staff,18,0,30,12
1650094046217,MATH 10B,B02,083740,Staff,29,0,30,1
1650094052242,MATH 18,A01,083743,Staff,10,0,30,20
1650094052242,MATH 18,A02,083744,Staff,28,0,30,2
1650094052242,MATH 18,A03,083745,Staff,23,0,30,7
1650094052242,MATH 18,A04,083746,Staff,27,0,30,3
1650094052242,MATH 18,B01,083748,Staff,0,9,30,30
1650094052242,MATH 18,B02,083749,Staff,0,6,30,30
1650094052242,MATH 18,B03,083750,Staff,0,6,30,30
1650094052242,MATH 18,B04,083751,Staff,0,7,30,30
1650094058268,MATH 20A,A01,083754,Staff,26,0,40,14
1650094064291,MATH 20B,A01,083756,Staff,0,5,30,30
1650094064291,MATH 20B,A02,083757,Staff,0,2,30,30
1650094070318,MATH 20C,A01,083760,Staff,0,11,30,30
1650094070318,MATH 20C,A02,083761,Staff,0,12,30,30
1650094070318,MATH 20C,B01,083762,Staff,14,0,30,16
1650094070318,MATH 20C,B02,083763,Staff,28,0,30,2
1650094076341,MATH 20D,A01,083765,Staff,0,2,30,30
1650094076341,MATH 20D,A02,083766,Staff,12,0,30,18
1650094076341,MATH 20D,A03,083767,Staff,28,0,30,2
1650094082363,MATH 20E,A01,083771,Staff,10,0,30,20
1650094082363,MATH 20E,A02,083772,Staff,20,0,30,10
1650094082363,MATH 20E,B01,083773,Staff,0,0,30,30
1650094082363,MATH 20E,B02,083774,Staff,13,0,30,17
1650094088392,MATH 103A,A01,083777,Staff,0,8,30,30
1650094088392,MATH 103A,A02,083778,Staff,0,7,30,30
1650094088392,MATH 103A,B01,083779,Staff,0,9,30,30
1650094088392,MATH 103A,B02,083780,Staff,0,6,30,30
1650094094414,MATH 105,A01,085443,Staff,0,13,30,30
1650094100442,MATH 109,A01,083213,Anzaldo; Leesa B,0,3,30,30
1650094100442,MATH 109,A02,083214,Anzaldo; Leesa B,0,5,30,30
1650094100442,MATH 109,B01,083215,Anzaldo; Leesa B,0,4,30,30
1650094100442,MATH 109,B02,083216,Anzaldo; Leesa B,0,4,30,30
1650094106473,MATH 142A,A01,083219,Chow; Bennett,0,10,30,30
1650094106473,MATH 142A,A02,083220,Chow; Bennett,0,10,30,30
1650094106473,MATH 142A,B01,083221,Chow; Bennett,0,10,30,30
1650094106473,MATH 142A,B02,083222,Chow; Bennett,0,9,30,30
1650094112499,MATH 193A,A01,083224,Staff,0,4,30,30
1650094112499,MATH 193A,A02,083225,Staff,0,4,30,30
1650094112499,MATH 193A,A03,083781,Staff,0,0,30,30
1650094112499,MATH 193A,A04,083782,Staff,2,0,30,28
1650094118613,MATH 197,001,091859,McAuley; Julian John,9998,0,9999,1
1650094124673,COGS 9,A01,083615,Staff,0,14,60,60
1650094130700,COGS 11,A01,083617,Boyle; Mary E. T.,24,0,40,16
1650094136727,COGS 13,A01,083071,Staff,0,28,40,40
1650094142755,COGS 14A,A01,092681,Staff,0,10,100,100
1650094148785,COGS 14B,A01,083073,Cheng; Tzu-Han,0,4,50,50
1650094154811,COGS 17,A01,092677,Staff,35,0,75,40
1650094160839,COGS 100,A01,083619,Staff,0,22,60,60
1650094166864,COGS 101A,A01,083621,Davis; Joshua Daniel,0,18,60,60
1650094172887,COGS 101B,A01,091572,Staff,10,0,60,50
1650094178911,COGS 101C,A01,083625,Delgado; Tania,21,0,30,9
1650094184935,COGS 107A,A01,083627,Boyle; Mary E. T.,0,4,60,60
1650094190958,COGS 118A,A01,083075,Staff,17,0,60,43
1650094196993,CSE 3,A50,083646,Miranda; Gregory Joseph,22,0,38,16
1650094196993,CSE 3,A51,083647,Miranda; Gregory Joseph,37,0,37,0
1650094203024,CSE 8A,A50,083650,Miranda; Gregory Joseph,0,15,40,40
1650094209057,CSE 11,A01,083080,Cao; Yingjun,0,65,40,40
1650094215083,CSE 12,A01,083652,Staff,0,2,100,100
1650094221105,CSE 15L,A01,083654,Staff,0,0,50,50
1650094221105,CSE 15L,A02,083655,Staff,10,0,50,40
1650094227131,CSE 20,A01,083657,Staff,58,0,80,22
1650094233153,CSE 30,A01,083084,Eldon; John,0,63,40,40
1650094239177,CSE 100,A01,083659,Cao; Yingjun,0,61,50,50
1650094245201,CSE 134B,A01,083661,Powell; Thomas Allan,0,27,65,65
1650094251225,CSE 140,A01,083663,Staff,4,0,75,71
1650094257249,CSE 140L,A01,083088,Eldon; John,0,1,75,75
1650094263279,CSE 175,A01,083665,Kumar; Rakesh,9,0,25,16
1650094269303,CSE 190,A00,092507,Dubnov; Shlomo,14,0,20,6
1650094275328,ECE 45,A01,083139,Staff,0,13,40,40
1650094281362,ECE 65,A50,083695,Staff,0,4,30,30
1650094287385,ECE 109,A01,091882,Touri; Behrouz,48,0,70,22
1650094293412,ECE 180,A00,083140,Abi Samra; Nicholas Camill,24,0,30,6
1650094293412,ECE 180,B00,083141,Abi Samra; Nicholas Camill,8,0,30,22
1650094299444,MATH 10A,A01,083735,Patchell; Gregory David,12,0,30,18
1650094299444,MATH 10A,A02,083736,Patchell; Gregory David,28,0,30,2
1650094299444,MATH 10A,A03,083737,Patchell; Gregory David,26,0,30,4
1650094305474,MATH 10B,A01,083207,Staff,0,5,30,30
1650094305474,MATH 10B,A02,083208,Staff,0,4,30,30
1650094305474,MATH 10B,B01,083739,Staff,18,0,30,12
1650094305474,MATH 10B,B02,083740,Staff,29,0,30,1
1650094311500,MATH 18,A01,083743,Staff,10,0,30,20
1650094311500,MATH 18,A02,083744,Staff,28,0,30,2
1650094311500,MATH 18,A03,083745,Staff,23,0,30,7
1650094311500,MATH 18,A04,083746,Staff,27,0,30,3
1650094311500,MATH 18,B01,083748,Staff,0,9,30,30
1650094311500,MATH 18,B02,083749,Staff,0,6,30,30
1650094311500,MATH 18,B03,083750,Staff,0,6,30,30
1650094311500,MATH 18,B04,083751,Staff,0,6,30,30
1650094317525,MATH 20A,A01,083754,Staff,26,0,40,14
1650094323563,MATH 20B,A01,083756,Staff,0,5,30,30
1650094323563,MATH 20B,A02,083757,Staff,0,2,30,30
1650094329588,MATH 20C,A01,083760,Staff,0,11,30,30
1650094329588,MATH 20C,A02,083761,Staff,0,12,30,30
1650094329588,MATH 20C,B01,083762,Staff,14,0,30,16
1650094329588,MATH 20C,B02,083763,Staff,28,0,30,2
1650094335613,MATH 20D,A01,083765,Staff,0,2,30,30
1650094335613,MATH 20D,A02,083766,Staff,12,0,30,18
1650094335613,MATH 20D,A03,083767,Staff,28,0,30,2
1650094341642,MATH 20E,A01,083771,Staff,10,0,30,20
1650094341642,MATH 20E,A02,083772,Staff,20,0,30,10
1650094341642,MATH 20E,B01,083773,Staff,0,0,30,30
1650094341642,MATH 20E,B02,083774,Staff,13,0,30,17
1650094347664,MATH 103A,A01,083777,Staff,0,8,30,30
1650094347664,MATH 103A,A02,083778,Staff,0,7,30,30
1650094347664,MATH 103A,B01,083779,Staff,0,9,30,30
1650094347664,MATH 103A,B02,083780,Staff,0,6,30,30
1650094353688,MATH 105,A01,085443,Staff,0,13,30,30
1650094359716,MATH 109,A01,083213,Anzaldo; Leesa B,0,3,30,30
1650094359716,MATH 109,A02,083214,Anzaldo; Leesa B,0,5,30,30
1650094359716,MATH 109,B01,083215,Anzaldo; Leesa B,0,4,30,30
1650094359716,MATH 109,B02,083216,Anzaldo; Leesa B,0,4,30,30
1650094365740,MATH 142A,A01,083219,Chow; Bennett,0,10,30,30
1650094365740,MATH 142A,A02,083220,Chow; Bennett,0,10,30,30
1650094365740,MATH 142A,B01,083221,Chow; Bennett,0,10,30,30
1650094365740,MATH 142A,B02,083222,Chow; Bennett,0,9,30,30
1650094371771,MATH 193A,A01,083224,Staff,0,4,30,30
1650094371771,MATH 193A,A02,083225,Staff,0,4,30,30
1650094371771,MATH 193A,A03,083781,Staff,0,0,30,30
1650094371771,MATH 193A,A04,083782,Staff,2,0,30,28
1650094377809,MATH 197,001,091859,McAuley; Julian John,9998,0,9999,1
1650094383898,COGS 9,A01,083615,Staff,0,14,60,60
1650094389922,COGS 11,A01,083617,Boyle; Mary E. T.,24,0,40,16
1650094395962,COGS 13,A01,083071,Staff,0,28,40,40
1650094401987,COGS 14A,A01,092681,Staff,0,10,100,100
1650094408019,COGS 14B,A01,083073,Cheng; Tzu-Han,0,4,50,50
1650094414046,COGS 17,A01,092677,Staff,35,0,75,40
1650094420073,COGS 100,A01,083619,Staff,0,22,60,60
1650094426102,COGS 101A,A01,083621,Davis; Joshua Daniel,0,18,60,60
1650094432135,COGS 101B,A01,091572,Staff,10,0,60,50
1650094438162,COGS 101C,A01,083625,Delgado; Tania,21,0,30,9
1650094444192,COGS 107A,A01,083627,Boyle; Mary E. T.,0,4,60,60
1650094450219,COGS 118A,A01,083075,Staff,17,0,60,43
1650094456246,CSE 3,A50,083646,Miranda; Gregory Joseph,22,0,38,16
1650094456246,CSE 3,A51,083647,Miranda; Gregory Joseph,37,0,37,0
1650094462270,CSE 8A,A50,083650,Miranda; Gregory Joseph,0,15,40,40
1650094468297,CSE 11,A01,083080,Cao; Yingjun,0,65,40,40
1650094474322,CSE 12,A01,083652,Staff,0,2,100,100
1650094480348,CSE 15L,A01,083654,Staff,0,0,50,50
1650094480348,CSE 15L,A02,083655,Staff,10,0,50,40
1650094486373,CSE 20,A01,083657,Staff,58,0,80,22
1650094492398,CSE 30,A01,083084,Eldon; John,0,63,40,40
1650094498424,CSE 100,A01,083659,Cao; Yingjun,0,61,50,50
1650094504449,CSE 134B,A01,083661,Powell; Thomas Allan,0,27,65,65
1650094510480,CSE 140,A01,083663,Staff,4,0,75,71
1650094516507,CSE 140L,A01,083088,Eldon; John,0,1,75,75
1650094522538,CSE 175,A01,083665,Kumar; Rakesh,9,0,25,16
1650094528564,CSE 190,A00,092507,Dubnov; Shlomo,14,0,20,6
1650094534598,ECE 45,A01,083139,Staff,0,13,40,40
1650094540633,ECE 65,A50,083695,Staff,0,4,30,30
1650094546664,ECE 109,A01,091882,Touri; Behrouz,48,0,70,22
1650094552689,ECE 180,A00,083140,Abi Samra; Nicholas Camill,24,0,30,6
1650094552689,ECE 180,B00,083141,Abi Samra; Nicholas Camill,8,0,30,22
1650094558717,MATH 10A,A01,083735,Patchell; Gregory David,12,0,30,18
1650094558717,MATH 10A,A02,083736,Patchell; Gregory David,28,0,30,2
1650094558717,MATH 10A,A03,083737,Patchell; Gregory David,26,0,30,4
1650094564743,MATH 10B,A01,083207,Staff,0,5,30,30
1650094564743,MATH 10B,A02,083208,Staff,0,4,30,30
1650094564743,MATH 10B,B01,083739,Staff,18,0,30,12
1650094564743,MATH 10B,B02,083740,Staff,29,0,30,1
1650094570779,MATH 18,A01,083743,Staff,10,0,30,20
1650094570779,MATH 18,A02,083744,Staff,28,0,30,2
1650094570779,MATH 18,A03,083745,Staff,23,0,30,7
1650094570779,MATH 18,A04,083746,Staff,27,0,30,3
1650094570779,MATH 18,B01,083748,Staff,0,9,30,30
1650094570779,MATH 18,B02,083749,Staff,0,6,30,30
1650094570779,MATH 18,B03,083750,Staff,0,6,30,30
1650094570779,MATH 18,B04,083751,Staff,0,6,30,30
1650094576809,MATH 20A,A01,083754,Staff,26,0,40,14
1650094582834,MATH 20B,A01,083756,Staff,0,5,30,30
1650094582834,MATH 20B,A02,083757,Staff,0,2,30,30
1650094588864,MATH 20C,A01,083760,Staff,0,11,30,30
1650094588864,MATH 20C,A02,083761,Staff,0,12,30,30
1650094588864,MATH 20C,B01,083762,Staff,14,0,30,16
1650094588864,MATH 20C,B02,083763,Staff,28,0,30,2
1650094594888,MATH 20D,A01,083765,Staff,0,2,30,30
1650094594888,MATH 20D,A02,083766,Staff,12,0,30,18
1650094594888,MATH 20D,A03,083767,Staff,28,0,30,2
1650094600918,MATH 20E,A01,083771,Staff,10,0,30,20
1650094600918,MATH 20E,A02,083772,Staff,20,0,30,10
1650094600918,MATH 20E,B01,083773,Staff,0,0,30,30
1650094600918,MATH 20E,B02,083774,Staff,13,0,30,17
1650094606944,MATH 103A,A01,083777,Staff,0,8,30,30
1650094606944,MATH 103A,A02,083778,Staff,0,7,30,30
1650094606944,MATH 103A,B01,083779,Staff,0,9,30,30
1650094606944,MATH 103A,B02,083780,Staff,0,6,30,30
1650094612970,MATH 105,A01,085443,Staff,0,13,30,30
1650094618996,MATH 109,A01,083213,Anzaldo; Leesa B,0,3,30,30
1650094618996,MATH 109,A02,083214,Anzaldo; Leesa B,0,5,30,30
1650094618996,MATH 109,B01,083215,Anzaldo; Leesa B,0,4,30,30
1650094618996,MATH 109,B02,083216,Anzaldo; Leesa B,0,4,30,30
1650094625030,MATH 142A,A01,083219,Chow; Bennett,0,10,30,30
1650094625030,MATH 142A,A02,083220,Chow; Bennett,0,10,30,30
1650094625030,MATH 142A,B01,083221,Chow; Bennett,0,10,30,30
1650094625030,MATH 142A,B02,083222,Chow; Bennett,0,9,30,30
1650094631055,MATH 193A,A01,083224,Staff,0,4,30,30
1650094631055,MATH 193A,A02,083225,Staff,0,4,30,30
1650094631055,MATH 193A,A03,083781,Staff,0,0,30,30
1650094631055,MATH 193A,A04,083782,Staff,2,0,30,28
1650094637082,MATH 197,001,091859,McAuley; Julian John,9998,0,9999,1
1650094643201,COGS 9,A01,083615,Staff,0,14,60,60
1650094649230,COGS 11,A01,083617,Boyle; Mary E. T.,24,0,40,16
1650094655254,COGS 13,A01,083071,Staff,0,28,40,40
1650094661293,COGS 14A,A01,092681,Staff,0,10,100,100
1650094667323,COGS 14B,A01,083073,Cheng; Tzu-Han,0,4,50,50
1650094673352,COGS 17,A01,092677,Staff,35,0,75,40
1650094679377,COGS 100,A01,083619,Staff,0,22,60,60
1650094685414,COGS 101A,A01,083621,Davis; Joshua Daniel,0,18,60,60
1650094691442,COGS 101B,A01,091572,Staff,10,0,60,50
1650094697466,COGS 101C,A01,083625,Delgado; Tania,21,0,30,9
1650094703495,COGS 107A,A01,083627,Boyle; Mary E. T.,0,4,60,60
1650094709608,COGS 118A,A01,083075,Staff,17,0,60,43
1650094715639,CSE 3,A50,083646,Miranda; Gregory Joseph,22,0,38,16
1650094715639,CSE 3,A51,083647,Miranda; Gregory Joseph,37,0,37,0
1650094721663,CSE 8A,A50,083650,Miranda; Gregory Joseph,0,15,40,40
1650094727688,CSE 11,A01,083080,Cao; Yingjun,0,65,40,40
1650094733717,CSE 12,A01,083652,Staff,0,2,100,100
1650094739746,CSE 15L,A01,083654,Staff,0,0,50,50
1650094739746,CSE 15L,A02,083655,Staff,10,0,50,40
1650094745775,CSE 20,A01,083657,Staff,58,0,80,22
1650094751803,CSE 30,A01,083084,Eldon; John,0,63,40,40
1650094757838,CSE 100,A01,083659,Cao; Yingjun,0,61,50,50
1650094763862,CSE 134B,A01,083661,Powell; Thomas Allan,0,27,65,65
1650094769887,CSE 140,A01,083663,Staff,4,0,75,71
1650094775916,CSE 140L,A01,083088,Eldon; John,0,1,75,75
1650094781946,CSE 175,A01,083665,Kumar; Rakesh,9,0,25,16
1650094787973,CSE 190,A00,092507,Dubnov; Shlomo,14,0,20,6
1650094794002,ECE 45,A01,083139,Staff,0,13,40,40
1650094800028,ECE 65,A50,083695,Staff,0,4,30,30
1650094806054,ECE 109,A01,091882,Touri; Behrouz,48,0,70,22
1650094812080,ECE 180,A00,083140,Abi Samra; Nicholas Camill,24,0,30,6
1650094812080,ECE 180,B00,083141,Abi Samra; Nicholas Camill,8,0,30,22
1650094818112,MATH 10A,A01,083735,Patchell; Gregory David,12,0,30,18
1650094818112,MATH 10A,A02,083736,Patchell; Gregory David,28,0,30,2
1650094818112,MATH 10A,A03,083737,Patchell; Gregory David,26,0,30,4
1650094824138,MATH 10B,A01,083207,Staff,0,5,30,30
1650094824138,MATH 10B,A02,083208,Staff,0,4,30,30
1650094824138,MATH 10B,B01,083739,Staff,18,0,30,12
1650094824138,MATH 10B,B02,083740,Staff,29,0,30,1
1650094830175,MATH 18,A01,083743,Staff,10,0,30,20
1650094830175,MATH 18,A02,083744,Staff,28,0,30,2
1650094830175,MATH 18,A03,083745,Staff,23,0,30,7
1650094830175,MATH 18,A04,083746,Staff,27,0,30,3
1650094830175,MATH 18,B01,083748,Staff,0,9,30,30
1650094830175,MATH 18,B02,083749,Staff,0,6,30,30
1650094830175,MATH 18,B03,083750,Staff,0,6,30,30
1650094830175,MATH 18,B04,083751,Staff,0,6,30,30
1650094836216,MATH 20A,A01,083754,Staff,26,0,40,14
1650094842241,MATH 20B,A01,083756,Staff,0,5,30,30
1650094842241,MATH 20B,A02,083757,Staff,0,2,30,30
1650094848270,MATH 20C,A01,083760,Staff,0,11,30,30
1650094848270,MATH 20C,A02,083761,Staff,0,12,30,30
1650094848270,MATH 20C,B01,083762,Staff,14,0,30,16
1650094848270,MATH 20C,B02,083763,Staff,28,0,30,2
1650094854295,MATH 20D,A01,083765,Staff,0,2,30,30
1650094854295,MATH 20D,A02,083766,Staff,12,0,30,18
1650094854295,MATH 20D,A03,083767,Staff,28,0,30,2
1650094860320,MATH 20E,A01,083771,Staff,10,0,30,20
1650094860320,MATH 20E,A02,083772,Staff,20,0,30,10
1650094860320,MATH 20E,B01,083773,Staff,0,0,30,30
1650094860320,MATH 20E,B02,083774,Staff,13,0,30,17
1650094866345,MATH 103A,A01,083777,Staff,0,8,30,30
1650094866345,MATH 103A,A02,083778,Staff,0,7,30,30
1650094866345,MATH 103A,B01,083779,Staff,0,9,30,30
1650094866345,MATH 103A,B02,083780,Staff,0,6,30,30
1650094872374,MATH 105,A01,085443,Staff,0,13,30,30
1650094878406,MATH 109,A01,083213,Anzaldo; Leesa B,0,3,30,30
1650094878406,MATH 109,A02,083214,Anzaldo; Leesa B,0,5,30,30
1650094878406,MATH 109,B01,083215,Anzaldo; Leesa B,0,4,30,30
1650094878406,MATH 109,B02,083216,Anzaldo; Leesa B,0,4,30,30
1650094884433,MATH 142A,A01,083219,Chow; Bennett,0,10,30,30
1650094884433,MATH 142A,A02,083220,Chow; Bennett,0,10,30,30
1650094884433,MATH 142A,B01,083221,Chow; Bennett,0,10,30,30
1650094884433,MATH 142A,B02,083222,Chow; Bennett,0,9,30,30
1650094890463,MATH 193A,A01,083224,Staff,0,4,30,30
1650094890463,MATH 193A,A02,083225,Staff,0,4,30,30
1650094890463,MATH 193A,A03,083781,Staff,0,0,30,30
1650094890463,MATH 193A,A04,083782,Staff,2,0,30,28
1650094896490,MATH 197,001,091859,McAuley; Julian John,9998,0,9999,1
1650094902552,COGS 9,A01,083615,Staff,0,14,60,60
1650094908577,COGS 11,A01,083617,Boyle; Mary E. T.,24,0,40,16
1650094914604,COGS 13,A01,083071,Staff,0,28,40,40
1650094920630,COGS 14A,A01,092681,Staff,0,10,100,100
1650094926659,COGS 14B,A01,083073,Cheng; Tzu-Han,0,4,50,50
1650094932684,COGS 17,A01,092677,Staff,35,0,75,40
1650094938708,COGS 100,A01,083619,Staff,0,22,60,60
1650094944739,COGS 101A,A01,083621,Davis; Joshua Daniel,0,18,60,60
1650094950765,COGS 101B,A01,091572,Staff,10,0,60,50
1650094956791,COGS 101C,A01,083625,Delgado; Tania,21,0,30,9
1650094962820,COGS 107A,A01,083627,Boyle; Mary E. T.,0,4,60,60
1650094968844,COGS 118A,A01,083075,Staff,17,0,60,43
1650094974872,CSE 3,A50,083646,Miranda; Gregory Joseph,22,0,38,16
1650094974872,CSE 3,A51,083647,Miranda; Gregory Joseph,37,0,37,0
1650094980911,CSE 8A,A50,083650,Miranda; Gregory Joseph,0,15,40,40
1650094986949,CSE 11,A01,083080,Cao; Yingjun,0,65,40,40
1650094992972,CSE 12,A01,083652,Staff,0,2,100,100
1650094998999,CSE 15L,A01,083654,Staff,0,0,50,50
1650094998999,CSE 15L,A02,083655,Staff,10,0,50,40
1650095005023,CSE 20,A01,083657,Staff,58,0,80,22
1650095011048,CSE 30,A01,083084,Eldon; John,0,63,40,40
1650095017080,CSE 100,A01,083659,Cao; Yingjun,0,61,50,50
1650095023106,CSE 134B,A01,083661,Powell; Thomas Allan,0,27,65,65
1650095029129,CSE 140,A01,083663,Staff,4,0,75,71
1650095035161,CSE 140L,A01,083088,Eldon; John,0,1,75,75
1650095041191,CSE 175,A01,083665,Kumar; Rakesh,9,0,25,16
1650095047217,CSE 190,A00,092507,Dubnov; Shlomo,14,0,20,6
1650095053245,ECE 45,A01,083139,Staff,0,13,40,40
1650095059271,ECE 65,A50,083695,Staff,0,4,30,30
1650095065297,ECE 109,A01,091882,Touri; Behrouz,48,0,70,22
1650095071323,ECE 180,A00,083140,Abi Samra; Nicholas Camill,24,0,30,6
1650095071323,ECE 180,B00,083141,Abi Samra; Nicholas Camill,8,0,30,22
1650095077350,MATH 10A,A01,083735,Patchell; Gregory David,12,0,30,18
1650095077350,MATH 10A,A02,083736,Patchell; Gregory David,28,0,30,2
1650095077350,MATH 10A,A03,083737,Patchell; Gregory David,26,0,30,4
1650095083373,MATH 10B,A01,083207,Staff,0,5,30,30
1650095083373,MATH 10B,A02,083208,Staff,0,4,30,30
1650095083373,MATH 10B,B01,083739,Staff,18,0,30,12
1650095083373,MATH 10B,B02,083740,Staff,29,0,30,1
1650095089402,MATH 18,A01,083743,Staff,10,0,30,20
1650095089402,MATH 18,A02,083744,Staff,28,0,30,2
1650095089402,MATH 18,A03,083745,Staff,23,0,30,7
1650095089402,MATH 18,A04,083746,Staff,27,0,30,3
1650095089402,MATH 18,B01,083748,Staff,0,9,30,30
1650095089402,MATH 18,B02,083749,Staff,0,6,30,30
1650095089402,MATH 18,B03,083750,Staff,0,6,30,30
1650095089402,MATH 18,B04,083751,Staff,0,6,30,30
1650095095429,MATH 20A,A01,083754,Staff,26,0,40,14
1650095101458,MATH 20B,A01,083756,Staff,0,5,30,30
1650095101458,MATH 20B,A02,083757,Staff,0,2,30,30
1650095107484,MATH 20C,A01,083760,Staff,0,11,30,30
1650095107484,MATH 20C,A02,083761,Staff,0,12,30,30
1650095107484,MATH 20C,B01,083762,Staff,14,0,30,16
1650095107484,MATH 20C,B02,083763,Staff,28,0,30,2
1650095113513,MATH 20D,A01,083765,Staff,0,2,30,30
1650095113513,MATH 20D,A02,083766,Staff,12,0,30,18
1650095113513,MATH 20D,A03,083767,Staff,28,0,30,2
1650095119538,MATH 20E,A01,083771,Staff,10,0,30,20
1650095119538,MATH 20E,A02,083772,Staff,20,0,30,10
1650095119538,MATH 20E,B01,083773,Staff,0,0,30,30
1650095119538,MATH 20E,B02,083774,Staff,13,0,30,17
1650095125561,MATH 103A,A01,083777,Staff,0,8,30,30
1650095125561,MATH 103A,A02,083778,Staff,0,7,30,30
1650095125561,MATH 103A,B01,083779,Staff,0,9,30,30
1650095125561,MATH 103A,B02,083780,Staff,0,6,30,30
1650095137468,MATH 105,A01,085443,Staff,0,13,30,30
1650095143495,MATH 109,A01,083213,Anzaldo; Leesa B,0,3,30,30
1650095143495,MATH 109,A02,083214,Anzaldo; Leesa B,0,5,30,30
1650095143495,MATH 109,B01,083215,Anzaldo; Leesa B,0,4,30,30
1650095143495,MATH 109,B02,083216,Anzaldo; Leesa B,0,4,30,30
1650095149527,MATH 142A,A01,083219,Chow; Bennett,0,10,30,30
1650095149527,MATH 142A,A02,083220,Chow; Bennett,0,10,30,30
1650095149527,MATH 142A,B01,083221,Chow; Bennett,0,10,30,30
1650095149527,MATH 142A,B02,083222,Chow; Bennett,0,9,30,30
1650095155554,MATH 193A,A01,083224,Staff,0,4,30,30
1650095155554,MATH 193A,A02,083225,Staff,0,4,30,30
1650095155554,MATH 193A,A03,083781,Staff,0,0,30,30
1650095155554,MATH 193A,A04,083782,Staff,2,0,30,28
1650095161582,MATH 197,001,091859,McAuley; Julian John,9998,0,9999,1
1650095167635,COGS 9,A01,083615,Staff,0,14,60,60
1650095173664,COGS 11,A01,083617,Boyle; Mary E. T.,24,0,40,16
1650095179693,COGS 13,A01,083071,Staff,0,28,40,40
1650095185718,COGS 14A,A01,092681,Staff,0,10,100,100
1650095191744,COGS 14B,A01,083073,Cheng; Tzu-Han,0,4,50,50
1650095197770,COGS 17,A01,092677,Staff,35,0,75,40
1650095203796,COGS 100,A01,083619,Staff,0,22,60,60
1650095209821,COGS 101A,A01,083621,Davis; Joshua Daniel,0,18,60,60
1650095215846,COGS 101B,A01,091572,Staff,10,0,60,50
1650095221878,COGS 101C,A01,083625,Delgado; Tania,21,0,30,9
1650095227908,COGS 107A,A01,083627,Boyle; Mary E. T.,0,4,60,60
1650095233933,COGS 118A,A01,083075,Staff,17,0,60,43
1650095239964,CSE 3,A50,083646,Miranda; Gregory Joseph,22,0,38,16
1650095239964,CSE 3,A51,083647,Miranda; Gregory Joseph,37,0,37,0
1650095245991,CSE 8A,A50,083650,Miranda; Gregory Joseph,0,15,40,40
1650095252018,CSE 11,A01,083080,Cao; Yingjun,0,65,40,40
1650095258044,CSE 12,A01,083652,Staff,0,2,100,100
1650095264073,CSE 15L,A01,083654,Staff,0,0,50,50
1650095264073,CSE 15L,A02,083655,Staff,10,0,50,40
1650095270101,CSE 20,A01,083657,Staff,58,0,80,22
1650095276129,CSE 30,A01,083084,Eldon; John,0,63,40,40
1650095282154,CSE 100,A01,083659,Cao; Yingjun,0,61,50,50
1650095288189,CSE 134B,A01,083661,Powell; Thomas Allan,0,27,65,65
1650095294211,CSE 140,A01,083663,Staff,4,0,75,71
1650095300240,CSE 140L,A01,083088,Eldon; John,0,1,75,75
1650095306266,CSE 175,A01,083665,Kumar; Rakesh,9,0,25,16
1650095312385,CSE 190,A00,092507,Dubnov; Shlomo,14,0,20,6
1650095318417,ECE 45,A01,083139,Staff,0,13,40,40
1650095324442,ECE 65,A50,083695,Staff,0,4,30,30
1650095330468,ECE 109,A01,091882,Touri; Behrouz,48,0,70,22
1650095336494,ECE 180,A00,083140,Abi Samra; Nicholas Camill,24,0,30,6
1650095336494,ECE 180,B00,083141,Abi Samra; Nicholas Camill,8,0,30,22
1650095342526,MATH 10A,A01,083735,Patchell; Gregory David,12,0,30,18
1650095342526,MATH 10A,A02,083736,Patchell; Gregory David,28,0,30,2
1650095342526,MATH 10A,A03,083737,Patchell; Gregory David,26,0,30,4
1650095348553,MATH 10B,A01,083207,Staff,0,5,30,30
1650095348553,MATH 10B,A02,083208,Staff,0,4,30,30
1650095348553,MATH 10B,B01,083739,Staff,18,0,30,12
1650095348553,MATH 10B,B02,083740,Staff,29,0,30,1
1650095354584,MATH 18,A01,083743,Staff,10,0,30,20
1650095354584,MATH 18,A02,083744,Staff,28,0,30,2
1650095354584,MATH 18,A03,083745,Staff,23,0,30,7
1650095354584,MATH 18,A04,083746,Staff,27,0,30,3
1650095354584,MATH 18,B01,083748,Staff,0,9,30,30
1650095354584,MATH 18,B02,083749,Staff,0,6,30,30
1650095354584,MATH 18,B03,083750,Staff,0,6,30,30
1650095354584,MATH 18,B04,083751,Staff,0,6,30,30
1650095360619,MATH 20A,A01,083754,Staff,26,0,40,14
1650095366650,MATH 20B,A01,083756,Staff,0,5,30,30
1650095366650,MATH 20B,A02,083757,Staff,0,2,30,30
1650095372676,MATH 20C,A01,083760,Staff,0,11,30,30
1650095372676,MATH 20C,A02,083761,Staff,0,12,30,30
1650095372676,MATH 20C,B01,083762,Staff,14,0,30,16
1650095372676,MATH 20C,B02,083763,Staff,28,0,30,2
1650095378700,MATH 20D,A01,083765,Staff,0,2,30,30
1650095378700,MATH 20D,A02,083766,Staff,12,0,30,18
1650095378700,MATH 20D,A03,083767,Staff,28,0,30,2
1650095384731,MATH 20E,A01,083771,Staff,10,0,30,20
1650095384731,MATH 20E,A02,083772,Staff,20,0,30,10
1650095384731,MATH 20E,B01,083773,Staff,0,0,30,30
1650095384731,MATH 20E,B02,083774,Staff,13,0,30,17
1650095390756,MATH 103A,A01,083777,Staff,0,8,30,30
1650095390756,MATH 103A,A02,083778,Staff,0,7,30,30
1650095390756,MATH 103A,B01,083779,Staff,0,9,30,30
1650095390756,MATH 103A,B02,083780,Staff,0,6,30,30
1650095396788,MATH 105,A01,085443,Staff,0,13,30,30
1650095402822,MATH 109,A01,083213,Anzaldo; Leesa B,0,3,30,30
1650095402822,MATH 109,A02,083214,Anzaldo; Leesa B,0,5,30,30
1650095402822,MATH 109,B01,083215,Anzaldo; Leesa B,0,4,30,30
1650095402822,MATH 109,B02,083216,Anzaldo; Leesa B,0,4,30,30
1650095408849,MATH 142A,A01,083219,Chow; Bennett,0,10,30,30
1650095408849,MATH 142A,A02,083220,Chow; Bennett,0,10,30,30
1650095408849,MATH 142A,B01,083221,Chow; Bennett,0,10,30,30
1650095408849,MATH 142A,B02,083222,Chow; Bennett,0,9,30,30
1650095414881,MATH 193A,A01,083224,Staff,0,4,30,30
1650095414881,MATH 193A,A02,083225,Staff,0,4,30,30
1650095414881,MATH 193A,A03,083781,Staff,0,0,30,30
1650095414881,MATH 193A,A04,083782,Staff,2,0,30,28
1650095420905,MATH 197,001,091859,McAuley; Julian John,9998,0,9999,1
1650095426982,COGS 9,A01,083615,Staff,0,14,60,60
1650095433013,COGS 11,A01,083617,Boyle; Mary E. T.,24,0,40,16
1650095439038,COGS 13,A01,083071,Staff,0,28,40,40
1650095445061,COGS 14A,A01,092681,Staff,0,10,100,100
1650095451087,COGS 14B,A01,083073,Cheng; Tzu-Han,0,4,50,50
1650095457111,COGS 17,A01,092677,Staff,35,0,75,40
1650095463137,COGS 100,A01,083619,Staff,0,22,60,60
1650095469169,COGS 101A,A01,083621,Davis; Joshua Daniel,0,18,60,60
1650095475199,COGS 101B,A01,091572,Staff,10,0,60,50
1650095481234,COGS 101C,A01,083625,Delgado; Tania,21,0,30,9
1650095487261,COGS 107A,A01,083627,Boyle; Mary E. T.,0,4,60,60
1650095493308,COGS 118A,A01,083075,Staff,17,0,60,43
1650095499335,CSE 3,A50,083646,Miranda; Gregory Joseph,22,0,38,16
1650095499335,CSE 3,A51,083647,Miranda; Gregory Joseph,37,0,37,0
1650095505360,CSE 8A,A50,083650,Miranda; Gregory Joseph,0,15,40,40
1650095511384,CSE 11,A01,083080,Cao; Yingjun,0,66,40,40
1650095517415,CSE 12,A01,083652,Staff,0,2,100,100
1650095523440,CSE 15L,A01,083654,Staff,0,0,50,50
1650095523440,CSE 15L,A02,083655,Staff,10,0,50,40
1650095529469,CSE 20,A01,083657,Staff,58,0,80,22
1650095535495,CSE 30,A01,083084,Eldon; John,0,63,40,40
1650095541519,CSE 100,A01,083659,Cao; Yingjun,0,61,50,50
1650095547541,CSE 134B,A01,083661,Powell; Thomas Allan,0,27,65,65
1650095553567,CSE 140,A01,083663,Staff,4,0,75,71
1650095559592,CSE 140L,A01,083088,Eldon; John,0,1,75,75
1650095565623,CSE 175,A01,083665,Kumar; Rakesh,9,0,25,16
1650095571648,CSE 190,A00,092507,Dubnov; Shlomo,14,0,20,6
1650095577671,ECE 45,A01,083139,Staff,0,13,40,40
1650095583697,ECE 65,A50,083695,Staff,0,4,30,30
1650095589725,ECE 109,A01,091882,Touri; Behrouz,48,0,70,22
1650095595754,ECE 180,A00,083140,Abi Samra; Nicholas Camill,24,0,30,6
1650095595754,ECE 180,B00,083141,Abi Samra; Nicholas Camill,8,0,30,22
1650095601785,MATH 10A,A01,083735,Patchell; Gregory David,12,0,30,18
1650095601785,MATH 10A,A02,083736,Patchell; Gregory David,28,0,30,2
1650095601785,MATH 10A,A03,083737,Patchell; Gregory David,26,0,30,4
1650095607810,MATH 10B,A01,083207,Staff,0,5,30,30
1650095607810,MATH 10B,A02,083208,Staff,0,4,30,30
1650095607810,MATH 10B,B01,083739,Staff,18,0,30,12
1650095607810,MATH 10B,B02,083740,Staff,29,0,30,1
1650095613836,MATH 18,A01,083743,Staff,10,0,30,20
1650095613836,MATH 18,A02,083744,Staff,28,0,30,2
1650095613836,MATH 18,A03,083745,Staff,23,0,30,7
1650095613836,MATH 18,A04,083746,Staff,27,0,30,3
1650095613836,MATH 18,B01,083748,Staff,0,9,30,30
1650095613836,MATH 18,B02,083749,Staff,0,6,30,30
1650095613836,MATH 18,B03,083750,Staff,0,6,30,30
1650095613836,MATH 18,B04,083751,Staff,0,6,30,30
1650095619866,MATH 20A,A01,083754,Staff,26,0,40,14
1650095625897,MATH 20B,A01,083756,Staff,0,5,30,30
1650095625897,MATH 20B,A02,083757,Staff,0,2,30,30
1650095631923,MATH 20C,A01,083760,Staff,0,11,30,30
1650095631923,MATH 20C,A02,083761,Staff,0,12,30,30
1650095631923,MATH 20C,B01,083762,Staff,14,0,30,16
1650095631923,MATH 20C,B02,083763,Staff,28,0,30,2
1650095637951,MATH 20D,A01,083765,Staff,0,2,30,30
1650095637951,MATH 20D,A02,083766,Staff,12,0,30,18
1650095637951,MATH 20D,A03,083767,Staff,28,0,30,2
1650095643977,MATH 20E,A01,083771,Staff,10,0,30,20
1650095643977,MATH 20E,A02,083772,Staff,20,0,30,10
1650095643977,MATH 20E,B01,083773,Staff,0,0,30,30
1650095643977,MATH 20E,B02,083774,Staff,13,0,30,17
1650095650008,MATH 103A,A01,083777,Staff,0,8,30,30
1650095650008,MATH 103A,A02,083778,Staff,0,7,30,30
1650095650008,MATH 103A,B01,083779,Staff,0,9,30,30
1650095650008,MATH 103A,B02,083780,Staff,0,6,30,30
1650095656036,MATH 105,A01,085443,Staff,0,13,30,30
1650095662062,MATH 109,A01,083213,Anzaldo; Leesa B,0,3,30,30
1650095662062,MATH 109,A02,083214,Anzaldo; Leesa B,0,5,30,30
1650095662062,MATH 109,B01,083215,Anzaldo; Leesa B,0,4,30,30
1650095662062,MATH 109,B02,083216,Anzaldo; Leesa B,0,4,30,30
1650095668094,MATH 142A,A01,083219,Chow; Bennett,0,10,30,30
1650095668094,MATH 142A,A02,083220,Chow; Bennett,0,10,30,30
1650095668094,MATH 142A,B01,083221,Chow; Bennett,0,10,30,30
1650095668094,MATH 142A,B02,083222,Chow; Bennett,0,9,30,30
1650095674120,MATH 193A,A01,083224,Staff,0,4,30,30
1650095674120,MATH 193A,A02,083225,Staff,0,4,30,30
1650095674120,MATH 193A,A03,083781,Staff,0,0,30,30
1650095674120,MATH 193A,A04,083782,Staff,2,0,30,28
1650095680149,MATH 197,001,091859,McAuley; Julian John,9998,0,9999,1
1650095686213,COGS 9,A01,083615,Staff,0,14,60,60
1650095692237,COGS 11,A01,083617,Boyle; Mary E. T.,24,0,40,16
1650095698266,COGS 13,A01,083071,Staff,0,28,40,40
1650095704294,COGS 14A,A01,092681,Staff,0,10,100,100
1650095710318,COGS 14B,A01,083073,Cheng; Tzu-Han,0,4,50,50
1650095716341,COGS 17,A01,092677,Staff,35,0,75,40
1650095722368,COGS 100,A01,083619,Staff,0,22,60,60
1650095728393,COGS 101A,A01,083621,Davis; Joshua Daniel,0,18,60,60
1650095734417,COGS 101B,A01,091572,Staff,10,0,60,50
1650095740447,COGS 101C,A01,083625,Delgado; Tania,21,0,30,9
1650095746472,COGS 107A,A01,083627,Boyle; Mary E. T.,0,4,60,60
1650095752504,COGS 118A,A01,083075,Staff,17,0,60,43
1650095758536,CSE 3,A50,083646,Miranda; Gregory Joseph,22,0,38,16
1650095758536,CSE 3,A51,083647,Miranda; Gregory Joseph,37,0,37,0
1650095764562,CSE 8A,A50,083650,Miranda; Gregory Joseph,0,15,40,40
1650095770586,CSE 11,A01,083080,Cao; Yingjun,0,66,40,40
1650095776611,CSE 12,A01,083652,Staff,0,2,100,100
1650095782636,CSE 15L,A01,083654,Staff,0,0,50,50
1650095782636,CSE 15L,A02,083655,Staff,10,0,50,40
1650095788660,CSE 20,A01,083657,Staff,58,0,80,22
1650095794690,CSE 30,A01,083084,Eldon; John,0,63,40,40
1650095800721,CSE 100,A01,083659,Cao; Yingjun,0,61,50,50
1650095806751,CSE 134B,A01,083661,Powell; Thomas Allan,0,27,65,65
1650095812782,CSE 140,A01,083663,Staff,4,0,75,71
1650095818808,CSE 140L,A01,083088,Eldon; John,0,1,75,75
1650095824841,CSE 175,A01,083665,Kumar; Rakesh,9,0,25,16
1650095830865,CSE 190,A00,092507,Dubnov; Shlomo,14,0,20,6
1650095836893,ECE 45,A01,083139,Staff,0,13,40,40
1650095842918,ECE 65,A50,083695,Staff,0,4,30,30
1650095848949,ECE 109,A01,091882,Touri; Behrouz,48,0,70,22
1650095854977,ECE 180,A00,083140,Abi Samra; Nicholas Camill,24,0,30,6
1650095854977,ECE 180,B00,083141,Abi Samra; Nicholas Camill,8,0,30,22
1650095861004,MATH 10A,A01,083735,Patchell; Gregory David,12,0,30,18
1650095861004,MATH 10A,A02,083736,Patchell; Gregory David,28,0,30,2
1650095861004,MATH 10A,A03,083737,Patchell; Gregory David,26,0,30,4
1650095867031,MATH 10B,A01,083207,Staff,0,5,30,30
1650095867031,MATH 10B,A02,083208,Staff,0,4,30,30
1650095867031,MATH 10B,B01,083739,Staff,18,0,30,12
1650095867031,MATH 10B,B02,083740,Staff,29,0,30,1
1650095873072,MATH 18,A01,083743,Staff,10,0,30,20
1650095873072,MATH 18,A02,083744,Staff,28,0,30,2
1650095873072,MATH 18,A03,083745,Staff,23,0,30,7
1650095873072,MATH 18,A04,083746,Staff,27,0,30,3
1650095873072,MATH 18,B01,083748,Staff,0,9,30,30
1650095873072,MATH 18,B02,083749,Staff,0,6,30,30
1650095873072,MATH 18,B03,083750,Staff,0,6,30,30
1650095873072,MATH 18,B04,083751,Staff,0,6,30,30
1650095879098,MATH 20A,A01,083754,Staff,26,0,40,14
1650095885122,MATH 20B,A01,083756,Staff,0,5,30,30
1650095885122,MATH 20B,A02,083757,Staff,0,2,30,30
1650095891150,MATH 20C,A01,083760,Staff,0,11,30,30
1650095891150,MATH 20C,A02,083761,Staff,0,12,30,30
1650095891150,MATH 20C,B01,083762,Staff,14,0,30,16
1650095891150,MATH 20C,B02,083763,Staff,28,0,30,2
1650095897178,MATH 20D,A01,083765,Staff,0,2,30,30
1650095897178,MATH 20D,A02,083766,Staff,12,0,30,18
1650095897178,MATH 20D,A03,083767,Staff,28,0,30,2
1650095903217,MATH 20E,A01,083771,Staff,10,0,30,20
1650095903217,MATH 20E,A02,083772,Staff,20,0,30,10
1650095903217,MATH 20E,B01,083773,Staff,0,0,30,30
1650095903217,MATH 20E,B02,083774,Staff,13,0,30,17
1650095909331,MATH 103A,A01,083777,Staff,0,8,30,30
1650095909331,MATH 103A,A02,083778,Staff,0,7,30,30
1650095909331,MATH 103A,B01,083779,Staff,0,9,30,30
1650095909331,MATH 103A,B02,083780,Staff,0,6,30,30
1650095915353,MATH 105,A01,085443,Staff,0,13,30,30
1650095921378,MATH 109,A01,083213,Anzaldo; Leesa B,0,3,30,30
1650095921378,MATH 109,A02,083214,Anzaldo; Leesa B,0,5,30,30
1650095921378,MATH 109,B01,083215,Anzaldo; Leesa B,0,4,30,30
1650095921378,MATH 109,B02,083216,Anzaldo; Leesa B,0,4,30,30
1650095927402,MATH 142A,A01,083219,Chow; Bennett,0,10,30,30
1650095927402,MATH 142A,A02,083220,Chow; Bennett,0,10,30,30
1650095927402,MATH 142A,B01,083221,Chow; Bennett,0,10,30,30
1650095927402,MATH 142A,B02,083222,Chow; Bennett,0,9,30,30
1650095933426,MATH 193A,A01,083224,Staff,0,4,30,30
1650095933426,MATH 193A,A02,083225,Staff,0,4,30,30
1650095933426,MATH 193A,A03,083781,Staff,0,0,30,30
1650095933426,MATH 193A,A04,083782,Staff,2,0,30,28
1650095939455,MATH 197,001,091859,McAuley; Julian John,9998,0,9999,1
1650095945516,COGS 9,A01,083615,Staff,0,14,60,60
1650095951545,COGS 11,A01,083617,Boyle; Mary E. T.,24,0,40,16
1650095957571,COGS 13,A01,083071,Staff,0,28,40,40
1650095963599,COGS 14A,A01,092681,Staff,0,10,100,100
1650095969636,COGS 14B,A01,083073,Cheng; Tzu-Han,0,4,50,50
1650095975657,COGS 17,A01,092677,Staff,35,0,75,40
1650095981682,COGS 100,A01,083619,Staff,0,21,60,60
1650095987712,COGS 101A,A01,083621,Davis; Joshua Daniel,0,18,60,60
1650095993740,COGS 101B,A01,091572,Staff,10,0,60,50
1650095999765,COGS 101C,A01,083625,Delgado; Tania,21,0,30,9
1650096005794,COGS 107A,A01,083627,Boyle; Mary E. T.,0,4,60,60
1650096011818,COGS 118A,A01,083075,Staff,17,0,60,43
1650096017843,CSE 3,A50,083646,Miranda; Gregory Joseph,22,0,38,16
1650096017843,CSE 3,A51,083647,Miranda; Gregory Joseph,37,0,37,0
1650096023874,CSE 8A,A50,083650,Miranda; Gregory Joseph,0,15,40,40
1650096029898,CSE 11,A01,083080,Cao; Yingjun,0,66,40,40
1650096035923,CSE 12,A01,083652,Staff,0,2,100,100
1650096041947,CSE 15L,A01,083654,Staff,0,0,50,50
1650096041947,CSE 15L,A02,083655,Staff,10,0,50,40
1650096047975,CSE 20,A01,083657,Staff,58,0,80,22
1650096053999,CSE 30,A01,083084,Eldon; John,0,63,40,40
1650096060023,CSE 100,A01,083659,Cao; Yingjun,0,61,50,50
1650096066049,CSE 134B,A01,083661,Powell; Thomas Allan,0,27,65,65
1650096072074,CSE 140,A01,083663,Staff,4,0,75,71
1650096078097,CSE 140L,A01,083088,Eldon; John,0,1,75,75
1650096084124,CSE 175,A01,083665,Kumar; Rakesh,9,0,25,16
1650096090150,CSE 190,A00,092507,Dubnov; Shlomo,14,0,20,6
1650096096173,ECE 45,A01,083139,Staff,0,13,40,40
1650096102198,ECE 65,A50,083695,Staff,0,4,30,30
1650096108227,ECE 109,A01,091882,Touri; Behrouz,48,0,70,22
1650096114257,ECE 180,A00,083140,Abi Samra; Nicholas Camill,24,0,30,6
1650096114257,ECE 180,B00,083141,Abi Samra; Nicholas Camill,8,0,30,22
1650096120287,MATH 10A,A01,083735,Patchell; Gregory David,12,0,30,18
1650096120287,MATH 10A,A02,083736,Patchell; Gregory David,28,0,30,2
1650096120287,MATH 10A,A03,083737,Patchell; Gregory David,26,0,30,4
1650096126313,MATH 10B,A01,083207,Staff,0,5,30,30
1650096126313,MATH 10B,A02,083208,Staff,0,4,30,30
1650096126313,MATH 10B,B01,083739,Staff,18,0,30,12
1650096126313,MATH 10B,B02,083740,Staff,29,0,30,1
1650096132348,MATH 18,A01,083743,Staff,10,0,30,20
1650096132348,MATH 18,A02,083744,Staff,28,0,30,2
1650096132348,MATH 18,A03,083745,Staff,23,0,30,7
1650096132348,MATH 18,A04,083746,Staff,27,0,30,3
1650096132348,MATH 18,B01,083748,Staff,0,9,30,30
1650096132348,MATH 18,B02,083749,Staff,0,6,30,30
1650096132348,MATH 18,B03,083750,Staff,0,6,30,30
1650096132348,MATH 18,B04,083751,Staff,0,6,30,30
1650096138376,MATH 20A,A01,083754,Staff,26,0,40,14
1650096144400,MATH 20B,A01,083756,Staff,0,5,30,30
1650096144400,MATH 20B,A02,083757,Staff,0,2,30,30
1650096150425,MATH 20C,A01,083760,Staff,0,11,30,30
1650096150425,MATH 20C,A02,083761,Staff,0,12,30,30
1650096150425,MATH 20C,B01,083762,Staff,14,0,30,16
1650096150425,MATH 20C,B02,083763,Staff,28,0,30,2
1650096156457,MATH 20D,A01,083765,Staff,0,2,30,30
1650096156457,MATH 20D,A02,083766,Staff,12,0,30,18
1650096156457,MATH 20D,A03,083767,Staff,28,0,30,2
1650096162512,MATH 20E,A01,083771,Staff,10,0,30,20
1650096162512,MATH 20E,A02,083772,Staff,20,0,30,10
1650096162512,MATH 20E,B01,083773,Staff,0,0,30,30
1650096162512,MATH 20E,B02,083774,Staff,13,0,30,17
1650096168538,MATH 103A,A01,083777,Staff,0,8,30,30
1650096168538,MATH 103A,A02,083778,Staff,0,7,30,30
1650096168538,MATH 103A,B01,083779,Staff,0,9,30,30
1650096168538,MATH 103A,B02,083780,Staff,0,6,30,30
1650096174566,MATH 105,A01,085443,Staff,0,13,30,30
1650096180595,MATH 109,A01,083213,Anzaldo; Leesa B,0,3,30,30
1650096180595,MATH 109,A02,083214,Anzaldo; Leesa B,0,5,30,30
1650096180595,MATH 109,B01,083215,Anzaldo; Leesa B,0,4,30,30
1650096180595,MATH 109,B02,083216,Anzaldo; Leesa B,0,4,30,30
1650096186627,MATH 142A,A01,083219,Chow; Bennett,0,10,30,30
1650096186627,MATH 142A,A02,083220,Chow; Bennett,0,10,30,30
1650096186627,MATH 142A,B01,083221,Chow; Bennett,0,10,30,30
1650096186627,MATH 142A,B02,083222,Chow; Bennett,0,9,30,30
1650096192658,MATH 193A,A01,083224,Staff,0,4,30,30
1650096192658,MATH 193A,A02,083225,Staff,0,4,30,30
1650096192658,MATH 193A,A03,083781,Staff,0,0,30,30
1650096192658,MATH 193A,A04,083782,Staff,2,0,30,28
1650096198684,MATH 197,001,091859,McAuley; Julian John,9998,0,9999,1
1650096204750,COGS 9,A01,083615,Staff,0,14,60,60
1650096210774,COGS 11,A01,083617,Boyle; Mary E. T.,24,0,40,16
1650096216800,COGS 13,A01,083071,Staff,0,28,40,40
1650096222827,COGS 14A,A01,092681,Staff,0,10,100,100
1650096228852,COGS 14B,A01,083073,Cheng; Tzu-Han,0,4,50,50
1650096234877,COGS 17,A01,092677,Staff,35,0,75,40
1650096240902,COGS 100,A01,083619,Staff,0,21,60,60
1650096246927,COGS 101A,A01,083621,Davis; Joshua Daniel,0,18,60,60
1650096252951,COGS 101B,A01,091572,Staff,10,0,60,50
1650096258975,COGS 101C,A01,083625,Delgado; Tania,21,0,30,9
1650096265000,COGS 107A,A01,083627,Boyle; Mary E. T.,0,4,60,60
1650096271025,COGS 118A,A01,083075,Staff,17,0,60,43
1650096277051,CSE 3,A50,083646,Miranda; Gregory Joseph,22,0,38,16
1650096277051,CSE 3,A51,083647,Miranda; Gregory Joseph,37,0,37,0
1650096283075,CSE 8A,A50,083650,Miranda; Gregory Joseph,0,15,40,40
1650096289100,CSE 11,A01,083080,Cao; Yingjun,0,66,40,40
1650096295125,CSE 12,A01,083652,Staff,0,2,100,100
1650096301157,CSE 15L,A01,083654,Staff,0,0,50,50
1650096301157,CSE 15L,A02,083655,Staff,10,0,50,40
1650096307185,CSE 20,A01,083657,Staff,58,0,80,22
1650096313211,CSE 30,A01,083084,Eldon; John,0,63,40,40
1650096319240,CSE 100,A01,083659,Cao; Yingjun,0,61,50,50
1650096325266,CSE 134B,A01,083661,Powell; Thomas Allan,0,27,65,65
1650096331292,CSE 140,A01,083663,Staff,4,0,75,71
1650096337319,CSE 140L,A01,083088,Eldon; John,0,1,75,75
1650096343344,CSE 175,A01,083665,Kumar; Rakesh,9,0,25,16
1650096349369,CSE 190,A00,092507,Dubnov; Shlomo,14,0,20,6
1650096355392,ECE 45,A01,083139,Staff,0,13,40,40
1650096361417,ECE 65,A50,083695,Staff,0,4,30,30
1650096367445,ECE 109,A01,091882,Touri; Behrouz,48,0,70,22
1650096373471,ECE 180,A00,083140,Abi Samra; Nicholas Camill,24,0,30,6
1650096373471,ECE 180,B00,083141,Abi Samra; Nicholas Camill,8,0,30,22
1650096379503,MATH 10A,A01,083735,Patchell; Gregory David,12,0,30,18
1650096379503,MATH 10A,A02,083736,Patchell; Gregory David,28,0,30,2
1650096379503,MATH 10A,A03,083737,Patchell; Gregory David,26,0,30,4
1650096385529,MATH 10B,A01,083207,Staff,0,5,30,30
1650096385529,MATH 10B,A02,083208,Staff,0,4,30,30
1650096385529,MATH 10B,B01,083739,Staff,18,0,30,12
1650096385529,MATH 10B,B02,083740,Staff,29,0,30,1
1650096391555,MATH 18,A01,083743,Staff,10,0,30,20
1650096391555,MATH 18,A02,083744,Staff,28,0,30,2
1650096391555,MATH 18,A03,083745,Staff,23,0,30,7
1650096391555,MATH 18,A04,083746,Staff,27,0,30,3
1650096391555,MATH 18,B01,083748,Staff,0,9,30,30
1650096391555,MATH 18,B02,083749,Staff,0,6,30,30
1650096391555,MATH 18,B03,083750,Staff,0,6,30,30
1650096391555,MATH 18,B04,083751,Staff,0,6,30,30
1650096397580,MATH 20A,A01,083754,Staff,26,0,40,14
1650096403616,MATH 20B,A01,083756,Staff,0,5,30,30
1650096403616,MATH 20B,A02,083757,Staff,0,2,30,30
1650096409641,MATH 20C,A01,083760,Staff,0,11,30,30
1650096409641,MATH 20C,A02,083761,Staff,0,12,30,30
1650096409641,MATH 20C,B01,083762,Staff,14,0,30,16
1650096409641,MATH 20C,B02,083763,Staff,28,0,30,2
1650096415668,MATH 20D,A01,083765,Staff,0,2,30,30
1650096415668,MATH 20D,A02,083766,Staff,12,0,30,18
1650096415668,MATH 20D,A03,083767,Staff,28,0,30,2
1650096421693,MATH 20E,A01,083771,Staff,10,0,30,20
1650096421693,MATH 20E,A02,083772,Staff,20,0,30,10
1650096421693,MATH 20E,B01,083773,Staff,0,0,30,30
1650096421693,MATH 20E,B02,083774,Staff,13,0,30,17
1650096427718,MATH 103A,A01,083777,Staff,0,8,30,30
1650096427718,MATH 103A,A02,083778,Staff,0,7,30,30
1650096427718,MATH 103A,B01,083779,Staff,0,9,30,30
1650096427718,MATH 103A,B02,083780,Staff,0,6,30,30
1650096433747,MATH 105,A01,085443,Staff,0,13,30,30
1650096439771,MATH 109,A01,083213,Anzaldo; Leesa B,0,3,30,30
1650096439771,MATH 109,A02,083214,Anzaldo; Leesa B,0,5,30,30
1650096439771,MATH 109,B01,083215,Anzaldo; Leesa B,0,4,30,30
1650096439771,MATH 109,B02,083216,Anzaldo; Leesa B,0,4,30,30
1650096445804,MATH 142A,A01,083219,Chow; Bennett,0,10,30,30
1650096445804,MATH 142A,A02,083220,Chow; Bennett,0,10,30,30
1650096445804,MATH 142A,B01,083221,Chow; Bennett,0,10,30,30
1650096445804,MATH 142A,B02,083222,Chow; Bennett,0,9,30,30
1650096451830,MATH 193A,A01,083224,Staff,0,4,30,30
1650096451830,MATH 193A,A02,083225,Staff,0,4,30,30
1650096451830,MATH 193A,A03,083781,Staff,0,0,30,30
1650096451830,MATH 193A,A04,083782,Staff,2,0,30,28
1650096457860,MATH 197,001,091859,McAuley; Julian John,9998,0,9999,1
1650096463916,COGS 9,A01,083615,Staff,0,14,60,60
1650096469945,COGS 11,A01,083617,Boyle; Mary E. T.,24,0,40,16
1650096475979,COGS 13,A01,083071,Staff,0,28,40,40
1650096482004,COGS 14A,A01,092681,Staff,0,10,100,100
1650096488028,COGS 14B,A01,083073,Cheng; Tzu-Han,0,4,50,50
1650096494056,COGS 17,A01,092677,Staff,35,0,75,40
1650096500170,COGS 100,A01,083619,Staff,0,21,60,60
1650096506196,COGS 101A,A01,083621,Davis; Joshua Daniel,0,18,60,60
1650096512226,COGS 101B,A01,091572,Staff,10,0,60,50
1650096518253,COGS 101C,A01,083625,Delgado; Tania,21,0,30,9
1650096524280,COGS 107A,A01,083627,Boyle; Mary E. T.,0,4,60,60
1650096530304,COGS 118A,A01,083075,Staff,17,0,60,43
1650096536335,CSE 3,A50,083646,Miranda; Gregory Joseph,22,0,38,16
1650096536335,CSE 3,A51,083647,Miranda; Gregory Joseph,37,0,37,0
1650096542359,CSE 8A,A50,083650,Miranda; Gregory Joseph,0,15,40,40
1650096548388,CSE 11,A01,083080,Cao; Yingjun,0,66,40,40
1650096554414,CSE 12,A01,083652,Staff,0,2,100,100
1650096560438,CSE 15L,A01,083654,Staff,0,0,50,50
1650096560438,CSE 15L,A02,083655,Staff,10,0,50,40
1650096566474,CSE 20,A01,083657,Staff,58,0,80,22
1650096572499,CSE 30,A01,083084,Eldon; John,0,63,40,40
1650096578530,CSE 100,A01,083659,Cao; Yingjun,0,61,50,50
1650096584560,CSE 134B,A01,083661,Powell; Thomas Allan,0,27,65,65
1650096590586,CSE 140,A01,083663,Staff,4,0,75,71
1650096596610,CSE 140L,A01,083088,Eldon; John,0,1,75,75
1650096602647,CSE 175,A01,083665,Kumar; Rakesh,9,0,25,16
1650096608678,CSE 190,A00,092507,Dubnov; Shlomo,14,0,20,6
1650096614702,ECE 45,A01,083139,Staff,0,13,40,40
1650096620733,ECE 65,A50,083695,Staff,0,4,30,30
1650096626761,ECE 109,A01,091882,Touri; Behrouz,48,0,70,22
1650096632794,ECE 180,A00,083140,Abi Samra; Nicholas Camill,24,0,30,6
1650096632794,ECE 180,B00,083141,Abi Samra; Nicholas Camill,8,0,30,22
1650096638830,MATH 10A,A01,083735,Patchell; Gregory David,12,0,30,18
1650096638830,MATH 10A,A02,083736,Patchell; Gregory David,28,0,30,2
1650096638830,MATH 10A,A03,083737,Patchell; Gregory David,26,0,30,4
1650096644854,MATH 10B,A01,083207,Staff,0,5,30,30
1650096644854,MATH 10B,A02,083208,Staff,0,4,30,30
1650096644854,MATH 10B,B01,083739,Staff,18,0,30,12
1650096644854,MATH 10B,B02,083740,Staff,29,0,30,1
1650096650888,MATH 18,A01,083743,Staff,10,0,30,20
1650096650888,MATH 18,A02,083744,Staff,28,0,30,2
1650096650888,MATH 18,A03,083745,Staff,23,0,30,7
1650096650888,MATH 18,A04,083746,Staff,27,0,30,3
1650096650888,MATH 18,B01,083748,Staff,0,9,30,30
1650096650888,MATH 18,B02,083749,Staff,0,6,30,30
1650096650888,MATH 18,B03,083750,Staff,0,6,30,30
1650096650888,MATH 18,B04,083751,Staff,0,6,30,30
1650096656912,MATH 20A,A01,083754,Staff,26,0,40,14
1650096662941,MATH 20B,A01,083756,Staff,0,5,30,30
1650096662941,MATH 20B,A02,083757,Staff,0,2,30,30
1650096668972,MATH 20C,A01,083760,Staff,0,11,30,30
1650096668972,MATH 20C,A02,083761,Staff,0,12,30,30
1650096668972,MATH 20C,B01,083762,Staff,14,0,30,16
1650096668972,MATH 20C,B02,083763,Staff,28,0,30,2
1650096675000,MATH 20D,A01,083765,Staff,0,2,30,30
1650096675000,MATH 20D,A02,083766,Staff,12,0,30,18
1650096675000,MATH 20D,A03,083767,Staff,28,0,30,2
1650096681026,MATH 20E,A01,083771,Staff,10,0,30,20
1650096681026,MATH 20E,A02,083772,Staff,20,0,30,10
1650096681026,MATH 20E,B01,083773,Staff,0,0,30,30
1650096681026,MATH 20E,B02,083774,Staff,13,0,30,17
1650096687051,MATH 103A,A01,083777,Staff,0,8,30,30
1650096687051,MATH 103A,A02,083778,Staff,0,7,30,30
1650096687051,MATH 103A,B01,083779,Staff,0,9,30,30
1650096687051,MATH 103A,B02,083780,Staff,0,6,30,30
1650096693091,MATH 105,A01,085443,Staff,0,13,30,30
1650096699121,MATH 109,A01,083213,Anzaldo; Leesa B,0,3,30,30
1650096699121,MATH 109,A02,083214,Anzaldo; Leesa B,0,5,30,30
1650096699121,MATH 109,B01,083215,Anzaldo; Leesa B,0,4,30,30
1650096699121,MATH 109,B02,083216,Anzaldo; Leesa B,0,4,30,30
1650096705148,MATH 142A,A01,083219,Chow; Bennett,0,10,30,30
1650096705148,MATH 142A,A02,083220,Chow; Bennett,0,10,30,30
1650096705148,MATH 142A,B01,083221,Chow; Bennett,0,10,30,30
1650096705148,MATH 142A,B02,083222,Chow; Bennett,0,9,30,30
1650096711173,MATH 193A,A01,083224,Staff,0,4,30,30
1650096711173,MATH 193A,A02,083225,Staff,0,4,30,30
1650096711173,MATH 193A,A03,083781,Staff,0,0,30,30
1650096711173,MATH 193A,A04,083782,Staff,2,0,30,28
1650096717200,MATH 197,001,091859,McAuley; Julian John,9998,0,9999,1
1650096723264,COGS 9,A01,083615,Staff,0,14,60,60
1650096729296,COGS 11,A01,083617,Boyle; Mary E. T.,24,0,40,16
1650096735322,COGS 13,A01,083071,Staff,0,28,40,40
1650096741347,COGS 14A,A01,092681,Staff,0,10,100,100
1650096747381,COGS 14B,A01,083073,Cheng; Tzu-Han,0,4,50,50
1650096753404,COGS 17,A01,092677,Staff,35,0,75,40
1650096759433,COGS 100,A01,083619,Staff,0,21,60,60
1650096765458,COGS 101A,A01,083621,Davis; Joshua Daniel,0,18,60,60
1650096771489,COGS 101B,A01,091572,Staff,10,0,60,50
1650096777519,COGS 101C,A01,083625,Delgado; Tania,21,0,30,9
1650096783565,COGS 107A,A01,083627,Boyle; Mary E. T.,0,4,60,60
1650096789587,COGS 118A,A01,083075,Staff,17,0,60,43
1650096795621,CSE 3,A50,083646,Miranda; Gregory Joseph,22,0,38,16
1650096795621,CSE 3,A51,083647,Miranda; Gregory Joseph,37,0,37,0
1650096801658,CSE 8A,A50,083650,Miranda; Gregory Joseph,0,15,40,40
1650096807683,CSE 11,A01,083080,Cao; Yingjun,0,66,40,40
1650096813708,CSE 12,A01,083652,Staff,0,2,100,100
1650096819730,CSE 15L,A01,083654,Staff,0,0,50,50
1650096819730,CSE 15L,A02,083655,Staff,10,0,50,40
1650096825757,CSE 20,A01,083657,Staff,58,0,80,22
1650096831783,CSE 30,A01,083084,Eldon; John,0,63,40,40
1650096837808,CSE 100,A01,083659,Cao; Yingjun,0,61,50,50
1650096843833,CSE 134B,A01,083661,Powell; Thomas Allan,0,27,65,65
1650096849857,CSE 140,A01,083663,Staff,4,0,75,71
1650096855882,CSE 140L,A01,083088,Eldon; John,0,1,75,75
1650096861907,CSE 175,A01,083665,Kumar; Rakesh,9,0,25,16
1650096867934,CSE 190,A00,092507,Dubnov; Shlomo,14,0,20,6
1650096873967,ECE 45,A01,083139,Staff,0,13,40,40
1650096879992,ECE 65,A50,083695,Staff,0,4,30,30
1650096886024,ECE 109,A01,091882,Touri; Behrouz,48,0,70,22
1650096892063,ECE 180,A00,083140,Abi Samra; Nicholas Camill,24,0,30,6
1650096892063,ECE 180,B00,083141,Abi Samra; Nicholas Camill,8,0,30,22
1650096898090,MATH 10A,A01,083735,Patchell; Gregory David,12,0,30,18
1650096898090,MATH 10A,A02,083736,Patchell; Gregory David,28,0,30,2
1650096898090,MATH 10A,A03,083737,Patchell; Gregory David,26,0,30,4
1650096904119,MATH 10B,A01,083207,Staff,0,5,30,30
1650096904119,MATH 10B,A02,083208,Staff,0,4,30,30
1650096904119,MATH 10B,B01,083739,Staff,18,0,30,12
1650096904119,MATH 10B,B02,083740,Staff,29,0,30,1
1650096910155,MATH 18,A01,083743,Staff,10,0,30,20
1650096910155,MATH 18,A02,083744,Staff,28,0,30,2
1650096910155,MATH 18,A03,083745,Staff,23,0,30,7
1650096910155,MATH 18,A04,083746,Staff,27,0,30,3
1650096910155,MATH 18,B01,083748,Staff,0,9,30,30
1650096910155,MATH 18,B02,083749,Staff,0,6,30,30
1650096910155,MATH 18,B03,083750,Staff,0,6,30,30
1650096910155,MATH 18,B04,083751,Staff,0,6,30,30
1650096916178,MATH 20A,A01,083754,Staff,26,0,40,14
1650096922209,MATH 20B,A01,083756,Staff,0,5,30,30
1650096922209,MATH 20B,A02,083757,Staff,0,2,30,30
1650096928236,MATH 20C,A01,083760,Staff,0,11,30,30
1650096928236,MATH 20C,A02,083761,Staff,0,12,30,30
1650096928236,MATH 20C,B01,083762,Staff,14,0,30,16
1650096928236,MATH 20C,B02,083763,Staff,28,0,30,2
1650096934264,MATH 20D,A01,083765,Staff,0,2,30,30
1650096934264,MATH 20D,A02,083766,Staff,12,0,30,18
1650096934264,MATH 20D,A03,083767,Staff,28,0,30,2
1650096940293,MATH 20E,A01,083771,Staff,10,0,30,20
1650096940293,MATH 20E,A02,083772,Staff,20,0,30,10
1650096940293,MATH 20E,B01,083773,Staff,0,0,30,30
1650096940293,MATH 20E,B02,083774,Staff,13,0,30,17
1650096946322,MATH 103A,A01,083777,Staff,0,8,30,30
1650096946322,MATH 103A,A02,083778,Staff,0,7,30,30
1650096946322,MATH 103A,B01,083779,Staff,0,9,30,30
1650096946322,MATH 103A,B02,083780,Staff,0,6,30,30
1650096952350,MATH 105,A01,085443,Staff,0,13,30,30
1650096958373,MATH 109,A01,083213,Anzaldo; Leesa B,0,3,30,30
1650096958373,MATH 109,A02,083214,Anzaldo; Leesa B,0,5,30,30
1650096958373,MATH 109,B01,083215,Anzaldo; Leesa B,0,4,30,30
1650096958373,MATH 109,B02,083216,Anzaldo; Leesa B,0,4,30,30
1650096964398,MATH 142A,A01,083219,Chow; Bennett,0,10,30,30
1650096964398,MATH 142A,A02,083220,Chow; Bennett,0,10,30,30
1650096964398,MATH 142A,B01,083221,Chow; Bennett,0,10,30,30
1650096964398,MATH 142A,B02,083222,Chow; Bennett,0,9,30,30
1650096970421,MATH 193A,A01,083224,Staff,0,4,30,30
1650096970421,MATH 193A,A02,083225,Staff,0,4,30,30
1650096970421,MATH 193A,A03,083781,Staff,0,0,30,30
1650096970421,MATH 193A,A04,083782,Staff,2,0,30,28
1650096976445,MATH 197,001,091859,McAuley; Julian John,9998,0,9999,1
1650096982505,COGS 9,A01,083615,Staff,0,14,60,60
1650096988530,COGS 11,A01,083617,Boyle; Mary E. T.,24,0,40,16
1650096994553,COGS 13,A01,083071,Staff,0,28,40,40
1650097000577,COGS 14A,A01,092681,Staff,0,10,100,100
1650097006605,COGS 14B,A01,083073,Cheng; Tzu-Han,0,4,50,50
1650097012634,COGS 17,A01,092677,Staff,35,0,75,40
1650097018658,COGS 100,A01,083619,Staff,0,21,60,60
1650097024695,COGS 101A,A01,083621,Davis; Joshua Daniel,0,18,60,60
1650097030724,COGS 101B,A01,091572,Staff,10,0,60,50
1650097036752,COGS 101C,A01,083625,Delgado; Tania,21,0,30,9
1650097042814,COGS 107A,A01,083627,Boyle; Mary E. T.,0,4,60,60
1650097048839,COGS 118A,A01,083075,Staff,17,0,60,43
1650097054868,CSE 3,A50,083646,Miranda; Gregory Joseph,22,0,38,16
1650097054868,CSE 3,A51,083647,Miranda; Gregory Joseph,37,0,37,0
1650097060893,CSE 8A,A50,083650,Miranda; Gregory Joseph,0,15,40,40
1650097066921,CSE 11,A01,083080,Cao; Yingjun,0,66,40,40
1650097072944,CSE 12,A01,083652,Staff,0,2,100,100
1650097078973,CSE 15L,A01,083654,Staff,0,0,50,50
1650097078973,CSE 15L,A02,083655,Staff,10,0,50,40
1650097085000,CSE 20,A01,083657,Staff,58,0,80,22
1650097091024,CSE 30,A01,083084,Eldon; John,0,63,40,40
1650097097137,CSE 100,A01,083659,Cao; Yingjun,0,61,50,50
1650097103164,CSE 134B,A01,083661,Powell; Thomas Allan,0,27,65,65
1650097109207,CSE 140,A01,083663,Staff,4,0,75,71
1650097115230,CSE 140L,A01,083088,Eldon; John,0,1,75,75
1650097121254,CSE 175,A01,083665,Kumar; Rakesh,9,0,25,16
1650097127281,CSE 190,A00,092507,Dubnov; Shlomo,14,0,20,6
1650097133303,ECE 45,A01,083139,Staff,0,13,40,40
1650097139326,ECE 65,A50,083695,Staff,0,4,30,30
1650097145350,ECE 109,A01,091882,Touri; Behrouz,48,0,70,22
1650097151373,ECE 180,A00,083140,Abi Samra; Nicholas Camill,24,0,30,6
1650097151373,ECE 180,B00,083141,Abi Samra; Nicholas Camill,8,0,30,22
1650097157396,MATH 10A,A01,083735,Patchell; Gregory David,12,0,30,18
1650097157396,MATH 10A,A02,083736,Patchell; Gregory David,28,0,30,2
1650097157396,MATH 10A,A03,083737,Patchell; Gregory David,26,0,30,4
1650097163424,MATH 10B,A01,083207,Staff,0,5,30,30
1650097163424,MATH 10B,A02,083208,Staff,0,4,30,30
1650097163424,MATH 10B,B01,083739,Staff,18,0,30,12
1650097163424,MATH 10B,B02,083740,Staff,29,0,30,1
1650097169456,MATH 18,A01,083743,Staff,10,0,30,20
1650097169456,MATH 18,A02,083744,Staff,28,0,30,2
1650097169456,MATH 18,A03,083745,Staff,23,0,30,7
1650097169456,MATH 18,A04,083746,Staff,27,0,30,3
1650097169456,MATH 18,B01,083748,Staff,0,9,30,30
1650097169456,MATH 18,B02,083749,Staff,0,6,30,30
1650097169456,MATH 18,B03,083750,Staff,0,6,30,30
1650097169456,MATH 18,B04,083751,Staff,0,6,30,30
1650097175484,MATH 20A,A01,083754,Staff,26,0,40,14
1650097181519,MATH 20B,A01,083756,Staff,0,5,30,30
1650097181519,MATH 20B,A02,083757,Staff,0,2,30,30
1650097187543,MATH 20C,A01,083760,Staff,0,11,30,30
1650097187543,MATH 20C,A02,083761,Staff,0,12,30,30
1650097187543,MATH 20C,B01,083762,Staff,14,0,30,16
1650097187543,MATH 20C,B02,083763,Staff,28,0,30,2
1650097193567,MATH 20D,A01,083765,Staff,0,2,30,30
1650097193567,MATH 20D,A02,083766,Staff,12,0,30,18
1650097193567,MATH 20D,A03,083767,Staff,28,0,30,2
1650097199592,MATH 20E,A01,083771,Staff,10,0,30,20
1650097199592,MATH 20E,A02,083772,Staff,20,0,30,10
1650097199592,MATH 20E,B01,083773,Staff,0,0,30,30
1650097199592,MATH 20E,B02,083774,Staff,13,0,30,17
1650097205617,MATH 103A,A01,083777,Staff,0,8,30,30
1650097205617,MATH 103A,A02,083778,Staff,0,7,30,30
1650097205617,MATH 103A,B01,083779,Staff,0,9,30,30
1650097205617,MATH 103A,B02,083780,Staff,0,6,30,30
1650097211642,MATH 105,A01,085443,Staff,0,13,30,30
1650097217677,MATH 109,A01,083213,Anzaldo; Leesa B,0,3,30,30
1650097217677,MATH 109,A02,083214,Anzaldo; Leesa B,0,5,30,30
1650097217677,MATH 109,B01,083215,Anzaldo; Leesa B,0,4,30,30
1650097217677,MATH 109,B02,083216,Anzaldo; Leesa B,0,4,30,30
1650097223704,MATH 142A,A01,083219,Chow; Bennett,0,10,30,30
1650097223704,MATH 142A,A02,083220,Chow; Bennett,0,10,30,30
1650097223704,MATH 142A,B01,083221,Chow; Bennett,0,10,30,30
1650097223704,MATH 142A,B02,083222,Chow; Bennett,0,9,30,30
1650097229732,MATH 193A,A01,083224,Staff,0,4,30,30
1650097229732,MATH 193A,A02,083225,Staff,0,4,30,30
1650097229732,MATH 193A,A03,083781,Staff,0,0,30,30
1650097229732,MATH 193A,A04,083782,Staff,2,0,30,28
1650097235754,MATH 197,001,091859,McAuley; Julian John,9998,0,9999,1
1650097241818,COGS 9,A01,083615,Staff,0,14,60,60
1650097247842,COGS 11,A01,083617,Boyle; Mary E. T.,24,0,40,16
1650097253866,COGS 13,A01,083071,Staff,0,28,40,40
1650097259894,COGS 14A,A01,092681,Staff,0,10,100,100
1650097265919,COGS 14B,A01,083073,Cheng; Tzu-Han,0,4,50,50
1650097271946,COGS 17,A01,092677,Staff,35,0,75,40
1650097277971,COGS 100,A01,083619,Staff,0,21,60,60
1650097284001,COGS 101A,A01,083621,Davis; Joshua Daniel,0,18,60,60
1650097290029,COGS 101B,A01,091572,Staff,10,0,60,50
1650097296055,COGS 101C,A01,083625,Delgado; Tania,21,0,30,9
1650097302084,COGS 107A,A01,083627,Boyle; Mary E. T.,0,4,60,60
1650097308108,COGS 118A,A01,083075,Staff,17,0,60,43
1650097314131,CSE 3,A50,083646,Miranda; Gregory Joseph,22,0,38,16
1650097314131,CSE 3,A51,083647,Miranda; Gregory Joseph,37,0,37,0
1650097320159,CSE 8A,A50,083650,Miranda; Gregory Joseph,0,15,40,40
1650097326187,CSE 11,A01,083080,Cao; Yingjun,0,66,40,40
1650097332210,CSE 12,A01,083652,Staff,0,2,100,100
1650097338235,CSE 15L,A01,083654,Staff,0,0,50,50
1650097338235,CSE 15L,A02,083655,Staff,10,0,50,40
1650097344260,CSE 20,A01,083657,Staff,58,0,80,22
1650097350286,CSE 30,A01,083084,Eldon; John,0,63,40,40
1650097356314,CSE 100,A01,083659,Cao; Yingjun,0,61,50,50
1650097362343,CSE 134B,A01,083661,Powell; Thomas Allan,0,27,65,65
1650097368370,CSE 140,A01,083663,Staff,4,0,75,71
1650097374397,CSE 140L,A01,083088,Eldon; John,0,1,75,75
1650097380424,CSE 175,A01,083665,Kumar; Rakesh,9,0,25,16
1650097386450,CSE 190,A00,092507,Dubnov; Shlomo,14,0,20,6
1650097392478,ECE 45,A01,083139,Staff,0,13,40,40
1650097398508,ECE 65,A50,083695,Staff,0,4,30,30
1650097404531,ECE 109,A01,091882,Touri; Behrouz,48,0,70,22
1650097410555,ECE 180,A00,083140,Abi Samra; Nicholas Camill,24,0,30,6
1650097410555,ECE 180,B00,083141,Abi Samra; Nicholas Camill,8,0,30,22
1650097416580,MATH 10A,A01,083735,Patchell; Gregory David,12,0,30,18
1650097416580,MATH 10A,A02,083736,Patchell; Gregory David,28,0,30,2
1650097416580,MATH 10A,A03,083737,Patchell; Gregory David,26,0,30,4
1650097422604,MATH 10B,A01,083207,Staff,0,5,30,30
1650097422604,MATH 10B,A02,083208,Staff,0,4,30,30
1650097422604,MATH 10B,B01,083739,Staff,18,0,30,12
1650097422604,MATH 10B,B02,083740,Staff,29,0,30,1
1650097428636,MATH 18,A01,083743,Staff,10,0,30,20
1650097428636,MATH 18,A02,083744,Staff,28,0,30,2
1650097428636,MATH 18,A03,083745,Staff,23,0,30,7
1650097428636,MATH 18,A04,083746,Staff,27,0,30,3
1650097428636,MATH 18,B01,083748,Staff,0,9,30,30
1650097428636,MATH 18,B02,083749,Staff,0,6,30,30
1650097428636,MATH 18,B03,083750,Staff,0,6,30,30
1650097428636,MATH 18,B04,083751,Staff,0,6,30,30
1650097434661,MATH 20A,A01,083754,Staff,26,0,40,14
1650097440684,MATH 20B,A01,083756,Staff,0,5,30,30
1650097440684,MATH 20B,A02,083757,Staff,0,2,30,30
1650097446709,MATH 20C,A01,083760,Staff,0,11,30,30
1650097446709,MATH 20C,A02,083761,Staff,0,12,30,30
1650097446709,MATH 20C,B01,083762,Staff,14,0,30,16
1650097446709,MATH 20C,B02,083763,Staff,28,0,30,2
1650097452734,MATH 20D,A01,083765,Staff,0,2,30,30
1650097452734,MATH 20D,A02,083766,Staff,12,0,30,18
1650097452734,MATH 20D,A03,083767,Staff,28,0,30,2
1650097458763,MATH 20E,A01,083771,Staff,10,0,30,20
1650097458763,MATH 20E,A02,083772,Staff,20,0,30,10
1650097458763,MATH 20E,B01,083773,Staff,0,0,30,30
1650097458763,MATH 20E,B02,083774,Staff,13,0,30,17
1650097464793,MATH 103A,A01,083777,Staff,0,8,30,30
1650097464793,MATH 103A,A02,083778,Staff,0,7,30,30
1650097464793,MATH 103A,B01,083779,Staff,0,9,30,30
1650097464793,MATH 103A,B02,083780,Staff,0,6,30,30
1650097470821,MATH 105,A01,085443,Staff,0,13,30,30
1650097476848,MATH 109,A01,083213,Anzaldo; Leesa B,0,3,30,30
1650097476848,MATH 109,A02,083214,Anzaldo; Leesa B,0,5,30,30
1650097476848,MATH 109,B01,083215,Anzaldo; Leesa B,0,4,30,30
1650097476848,MATH 109,B02,083216,Anzaldo; Leesa B,0,4,30,30
1650097482877,MATH 142A,A01,083219,Chow; Bennett,0,10,30,30
1650097482877,MATH 142A,A02,083220,Chow; Bennett,0,10,30,30
1650097482877,MATH 142A,B01,083221,Chow; Bennett,0,10,30,30
1650097482877,MATH 142A,B02,083222,Chow; Bennett,0,9,30,30
1650097488907,MATH 193A,A01,083224,Staff,0,4,30,30
1650097488907,MATH 193A,A02,083225,Staff,0,4,30,30
1650097488907,MATH 193A,A03,083781,Staff,0,0,30,30
1650097488907,MATH 193A,A04,083782,Staff,2,0,30,28
1650097494933,MATH 197,001,091859,McAuley; Julian John,9998,0,9999,1
1650097501007,COGS 9,A01,083615,Staff,0,14,60,60
1650097507035,COGS 11,A01,083617,Boyle; Mary E. T.,24,0,40,16
1650097513062,COGS 13,A01,083071,Staff,0,28,40,40
1650097519085,COGS 14A,A01,092681,Staff,0,10,100,100
1650097525112,COGS 14B,A01,083073,Cheng; Tzu-Han,0,4,50,50
1650097531138,COGS 17,A01,092677,Staff,35,0,75,40
1650097537160,COGS 100,A01,083619,Staff,0,21,60,60
1650097543189,COGS 101A,A01,083621,Davis; Joshua Daniel,0,18,60,60
1650097549213,COGS 101B,A01,091572,Staff,10,0,60,50
1650097555238,COGS 101C,A01,083625,Delgado; Tania,21,0,30,9
1650097561267,COGS 107A,A01,083627,Boyle; Mary E. T.,0,4,60,60
1650097567293,COGS 118A,A01,083075,Staff,17,0,60,43
1650097573318,CSE 3,A50,083646,Miranda; Gregory Joseph,22,0,38,16
1650097573318,CSE 3,A51,083647,Miranda; Gregory Joseph,37,0,37,0
1650097579342,CSE 8A,A50,083650,Miranda; Gregory Joseph,0,15,40,40
1650097585377,CSE 11,A01,083080,Cao; Yingjun,0,66,40,40
1650097591401,CSE 12,A01,083652,Staff,0,2,100,100
1650097597430,CSE 15L,A01,083654,Staff,0,0,50,50
1650097597430,CSE 15L,A02,083655,Staff,10,0,50,40
1650097603456,CSE 20,A01,083657,Staff,58,0,80,22
1650097609499,CSE 30,A01,083084,Eldon; John,0,63,40,40
1650097615525,CSE 100,A01,083659,Cao; Yingjun,0,61,50,50
1650097621549,CSE 134B,A01,083661,Powell; Thomas Allan,0,27,65,65
1650097627576,CSE 140,A01,083663,Staff,4,0,75,71
1650097633606,CSE 140L,A01,083088,Eldon; John,0,1,75,75
1650097639631,CSE 175,A01,083665,Kumar; Rakesh,9,0,25,16
1650097645657,CSE 190,A00,092507,Dubnov; Shlomo,14,0,20,6
1650097651686,ECE 45,A01,083139,Staff,0,13,40,40
1650097657712,ECE 65,A50,083695,Staff,0,4,30,30
1650097663743,ECE 109,A01,091882,Touri; Behrouz,48,0,70,22
1650097669769,ECE 180,A00,083140,Abi Samra; Nicholas Camill,24,0,30,6
1650097669769,ECE 180,B00,083141,Abi Samra; Nicholas Camill,8,0,30,22
1650097675795,MATH 10A,A01,083735,Patchell; Gregory David,12,0,30,18
1650097675795,MATH 10A,A02,083736,Patchell; Gregory David,28,0,30,2
1650097675795,MATH 10A,A03,083737,Patchell; Gregory David,26,0,30,4
1650097681828,MATH 10B,A01,083207,Staff,0,5,30,30
1650097681828,MATH 10B,A02,083208,Staff,0,4,30,30
1650097681828,MATH 10B,B01,083739,Staff,18,0,30,12
1650097681828,MATH 10B,B02,083740,Staff,29,0,30,1
1650097687857,MATH 18,A01,083743,Staff,10,0,30,20
1650097687857,MATH 18,A02,083744,Staff,28,0,30,2
1650097687857,MATH 18,A03,083745,Staff,23,0,30,7
1650097687857,MATH 18,A04,083746,Staff,27,0,30,3
1650097687857,MATH 18,B01,083748,Staff,0,9,30,30
1650097687857,MATH 18,B02,083749,Staff,0,6,30,30
1650097687857,MATH 18,B03,083750,Staff,0,6,30,30
1650097687857,MATH 18,B04,083751,Staff,0,6,30,30
1650097693995,MATH 20A,A01,083754,Staff,26,0,40,14
1650097700033,MATH 20B,A01,083756,Staff,0,5,30,30
1650097700033,MATH 20B,A02,083757,Staff,0,2,30,30
1650097706063,MATH 20C,A01,083760,Staff,0,11,30,30
1650097706063,MATH 20C,A02,083761,Staff,0,12,30,30
1650097706063,MATH 20C,B01,083762,Staff,14,0,30,16
1650097706063,MATH 20C,B02,083763,Staff,28,0,30,2
1650097712091,MATH 20D,A01,083765,Staff,0,2,30,30
1650097712091,MATH 20D,A02,083766,Staff,12,0,30,18
1650097712091,MATH 20D,A03,083767,Staff,28,0,30,2
1650097718127,MATH 20E,A01,083771,Staff,10,0,30,20
1650097718127,MATH 20E,A02,083772,Staff,20,0,30,10
1650097718127,MATH 20E,B01,083773,Staff,0,0,30,30
1650097718127,MATH 20E,B02,083774,Staff,13,0,30,17
1650097724158,MATH 103A,A01,083777,Staff,0,8,30,30
1650097724158,MATH 103A,A02,083778,Staff,0,7,30,30
1650097724158,MATH 103A,B01,083779,Staff,0,9,30,30
1650097724158,MATH 103A,B02,083780,Staff,0,6,30,30
1650097730181,MATH 105,A01,085443,Staff,0,13,30,30
1650097736205,MATH 109,A01,083213,Anzaldo; Leesa B,0,3,30,30
1650097736205,MATH 109,A02,083214,Anzaldo; Leesa B,0,5,30,30
1650097736205,MATH 109,B01,083215,Anzaldo; Leesa B,0,4,30,30
1650097736205,MATH 109,B02,083216,Anzaldo; Leesa B,0,4,30,30
1650097742232,MATH 142A,A01,083219,Chow; Bennett,0,10,30,30
1650097742232,MATH 142A,A02,083220,Chow; Bennett,0,10,30,30
1650097742232,MATH 142A,B01,083221,Chow; Bennett,0,10,30,30
1650097742232,MATH 142A,B02,083222,Chow; Bennett,0,9,30,30
1650097748259,MATH 193A,A01,083224,Staff,0,4,30,30
1650097748259,MATH 193A,A02,083225,Staff,0,4,30,30
1650097748259,MATH 193A,A03,083781,Staff,0,0,30,30
1650097748259,MATH 193A,A04,083782,Staff,2,0,30,28
1650097754288,MATH 197,001,091859,McAuley; Julian John,9998,0,9999,1
1650097760352,COGS 9,A01,083615,Staff,0,14,60,60
1650097766382,COGS 11,A01,083617,Boyle; Mary E. T.,24,0,40,16
1650097772406,COGS 13,A01,083071,Staff,0,28,40,40
1650097778430,COGS 14A,A01,092681,Staff,0,10,100,100
1650097784455,COGS 14B,A01,083073,Cheng; Tzu-Han,0,4,50,50
1650097790480,COGS 17,A01,092677,Staff,35,0,75,40
1650097796507,COGS 100,A01,083619,Staff,0,21,60,60
1650097802534,COGS 101A,A01,083621,Davis; Joshua Daniel,0,18,60,60
1650097808559,COGS 101B,A01,091572,Staff,10,0,60,50
1650097814585,COGS 101C,A01,083625,Delgado; Tania,21,0,30,9
1650097820610,COGS 107A,A01,083627,Boyle; Mary E. T.,0,4,60,60
1650097826635,COGS 118A,A01,083075,Staff,17,0,60,43
1650097832668,CSE 3,A50,083646,Miranda; Gregory Joseph,22,0,38,16
1650097832668,CSE 3,A51,083647,Miranda; Gregory Joseph,37,0,37,0
1650097838694,CSE 8A,A50,083650,Miranda; Gregory Joseph,0,15,40,40
1650097844720,CSE 11,A01,083080,Cao; Yingjun,0,66,40,40
1650097850745,CSE 12,A01,083652,Staff,0,2,100,100
1650097856775,CSE 15L,A01,083654,Staff,0,0,50,50
1650097856775,CSE 15L,A02,083655,Staff,10,0,50,40
1650097862802,CSE 20,A01,083657,Staff,58,0,80,22
1650097868827,CSE 30,A01,083084,Eldon; John,0,63,40,40
1650097874852,CSE 100,A01,083659,Cao; Yingjun,0,61,50,50
1650097880882,CSE 134B,A01,083661,Powell; Thomas Allan,0,27,65,65
1650097886912,CSE 140,A01,083663,Staff,4,0,75,71
1650097892937,CSE 140L,A01,083088,Eldon; John,0,1,75,75
1650097898970,CSE 175,A01,083665,Kumar; Rakesh,9,0,25,16
1650097905001,CSE 190,A00,092507,Dubnov; Shlomo,14,0,20,6
1650097911025,ECE 45,A01,083139,Staff,0,13,40,40
1650097917051,ECE 65,A50,083695,Staff,0,4,30,30
1650097923080,ECE 109,A01,091882,Touri; Behrouz,48,0,70,22
1650097929106,ECE 180,A00,083140,Abi Samra; Nicholas Camill,24,0,30,6
1650097929106,ECE 180,B00,083141,Abi Samra; Nicholas Camill,8,0,30,22
1650097935138,MATH 10A,A01,083735,Patchell; Gregory David,12,0,30,18
1650097935138,MATH 10A,A02,083736,Patchell; Gregory David,28,0,30,2
1650097935138,MATH 10A,A03,083737,Patchell; Gregory David,26,0,30,4
1650097941162,MATH 10B,A01,083207,Staff,0,5,30,30
1650097941162,MATH 10B,A02,083208,Staff,0,4,30,30
1650097941162,MATH 10B,B01,083739,Staff,18,0,30,12
1650097941162,MATH 10B,B02,083740,Staff,29,0,30,1
1650097947200,MATH 18,A01,083743,Staff,10,0,30,20
1650097947200,MATH 18,A02,083744,Staff,28,0,30,2
1650097947200,MATH 18,A03,083745,Staff,23,0,30,7
1650097947200,MATH 18,A04,083746,Staff,27,0,30,3
1650097947200,MATH 18,B01,083748,Staff,0,9,30,30
1650097947200,MATH 18,B02,083749,Staff,0,6,30,30
1650097947200,MATH 18,B03,083750,Staff,0,6,30,30
1650097947200,MATH 18,B04,083751,Staff,0,6,30,30
1650097953231,MATH 20A,A01,083754,Staff,26,0,40,14
1650097959263,MATH 20B,A01,083756,Staff,0,5,30,30
1650097959263,MATH 20B,A02,083757,Staff,0,2,30,30
1650097965305,MATH 20C,A01,083760,Staff,0,11,30,30
1650097965305,MATH 20C,A02,083761,Staff,0,12,30,30
1650097965305,MATH 20C,B01,083762,Staff,14,0,30,16
1650097965305,MATH 20C,B02,083763,Staff,28,0,30,2
1650097971336,MATH 20D,A01,083765,Staff,0,2,30,30
1650097971336,MATH 20D,A02,083766,Staff,12,0,30,18
1650097971336,MATH 20D,A03,083767,Staff,28,0,30,2
1650097977363,MATH 20E,A01,083771,Staff,10,0,30,20
1650097977363,MATH 20E,A02,083772,Staff,20,0,30,10
1650097977363,MATH 20E,B01,083773,Staff,0,0,30,30
1650097977363,MATH 20E,B02,083774,Staff,13,0,30,17
1650097983422,MATH 103A,A01,083777,Staff,0,8,30,30
1650097983422,MATH 103A,A02,083778,Staff,0,7,30,30
1650097983422,MATH 103A,B01,083779,Staff,0,9,30,30
1650097983422,MATH 103A,B02,083780,Staff,0,6,30,30
1650097989452,MATH 105,A01,085443,Staff,0,13,30,30
1650097995483,MATH 109,A01,083213,Anzaldo; Leesa B,0,3,30,30
1650097995483,MATH 109,A02,083214,Anzaldo; Leesa B,0,5,30,30
1650097995483,MATH 109,B01,083215,Anzaldo; Leesa B,0,4,30,30
1650097995483,MATH 109,B02,083216,Anzaldo; Leesa B,0,4,30,30
1650098001509,MATH 142A,A01,083219,Chow; Bennett,0,10,30,30
1650098001509,MATH 142A,A02,083220,Chow; Bennett,0,10,30,30
1650098001509,MATH 142A,B01,083221,Chow; Bennett,0,10,30,30
1650098001509,MATH 142A,B02,083222,Chow; Bennett,0,9,30,30
1650098007548,MATH 193A,A01,083224,Staff,0,4,30,30
1650098007548,MATH 193A,A02,083225,Staff,0,4,30,30
1650098007548,MATH 193A,A03,083781,Staff,0,0,30,30
1650098007548,MATH 193A,A04,083782,Staff,2,0,30,28
1650098013584,MATH 197,001,091859,McAuley; Julian John,9998,0,9999,1
1650098019659,COGS 9,A01,083615,Staff,0,14,60,60
1650098025684,COGS 11,A01,083617,Boyle; Mary E. T.,24,0,40,16
1650098031714,COGS 13,A01,083071,Staff,0,28,40,40
1650098037742,COGS 14A,A01,092681,Staff,0,10,100,100
1650098043773,COGS 14B,A01,083073,Cheng; Tzu-Han,0,4,50,50
1650098049797,COGS 17,A01,092677,Staff,35,0,75,40
1650098055826,COGS 100,A01,083619,Staff,0,21,60,60
1650098061857,COGS 101A,A01,083621,Davis; Joshua Daniel,0,18,60,60
1650098067885,COGS 101B,A01,091572,Staff,10,0,60,50
1650098073919,COGS 101C,A01,083625,Delgado; Tania,21,0,30,9
1650098079945,COGS 107A,A01,083627,Boyle; Mary E. T.,0,4,60,60
1650098085972,COGS 118A,A01,083075,Staff,17,0,60,43
1650098091999,CSE 3,A50,083646,Miranda; Gregory Joseph,22,0,38,16
1650098091999,CSE 3,A51,083647,Miranda; Gregory Joseph,37,0,37,0
1650098098028,CSE 8A,A50,083650,Miranda; Gregory Joseph,0,15,40,40
1650098104052,CSE 11,A01,083080,Cao; Yingjun,0,66,40,40
1650098110076,CSE 12,A01,083652,Staff,0,2,100,100
1650098116102,CSE 15L,A01,083654,Staff,0,0,50,50
1650098116102,CSE 15L,A02,083655,Staff,10,0,50,40
1650098122127,CSE 20,A01,083657,Staff,58,0,80,22
1650098128152,CSE 30,A01,083084,Eldon; John,0,63,40,40
1650098134183,CSE 100,A01,083659,Cao; Yingjun,0,61,50,50
1650098140209,CSE 134B,A01,083661,Powell; Thomas Allan,0,27,65,65
1650098146232,CSE 140,A01,083663,Staff,4,0,75,71
1650098152257,CSE 140L,A01,083088,Eldon; John,0,1,75,75
1650098158283,CSE 175,A01,083665,Kumar; Rakesh,9,0,25,16
1650098164311,CSE 190,A00,092507,Dubnov; Shlomo,14,0,20,6
1650098170346,ECE 45,A01,083139,Staff,0,13,40,40
1650098176372,ECE 65,A50,083695,Staff,0,4,30,30
1650098182404,ECE 109,A01,091882,Touri; Behrouz,48,0,70,22
1650098188430,ECE 180,A00,083140,Abi Samra; Nicholas Camill,24,0,30,6
1650098188430,ECE 180,B00,083141,Abi Samra; Nicholas Camill,8,0,30,22
1650098194464,MATH 10A,A01,083735,Patchell; Gregory David,12,0,30,18
1650098194464,MATH 10A,A02,083736,Patchell; Gregory David,28,0,30,2
1650098194464,MATH 10A,A03,083737,Patchell; Gregory David,26,0,30,4
1650098200490,MATH 10B,A01,083207,Staff,0,5,30,30
1650098200490,MATH 10B,A02,083208,Staff,0,4,30,30
1650098200490,MATH 10B,B01,083739,Staff,18,0,30,12
1650098200490,MATH 10B,B02,083740,Staff,29,0,30,1
1650098206517,MATH 18,A01,083743,Staff,10,0,30,20
1650098206517,MATH 18,A02,083744,Staff,28,0,30,2
1650098206517,MATH 18,A03,083745,Staff,23,0,30,7
1650098206517,MATH 18,A04,083746,Staff,27,0,30,3
1650098206517,MATH 18,B01,083748,Staff,0,9,30,30
1650098206517,MATH 18,B02,083749,Staff,0,6,30,30
1650098206517,MATH 18,B03,083750,Staff,0,6,30,30
1650098206517,MATH 18,B04,083751,Staff,0,6,30,30
1650098212540,MATH 20A,A01,083754,Staff,26,0,40,14
1650098218568,MATH 20B,A01,083756,Staff,0,5,30,30
1650098218568,MATH 20B,A02,083757,Staff,0,2,30,30
1650098224597,MATH 20C,A01,083760,Staff,0,11,30,30
1650098224597,MATH 20C,A02,083761,Staff,0,12,30,30
1650098224597,MATH 20C,B01,083762,Staff,14,0,30,16
1650098224597,MATH 20C,B02,083763,Staff,28,0,30,2
1650098230625,MATH 20D,A01,083765,Staff,0,2,30,30
1650098230625,MATH 20D,A02,083766,Staff,12,0,30,18
1650098230625,MATH 20D,A03,083767,Staff,28,0,30,2
1650098236650,MATH 20E,A01,083771,Staff,10,0,30,20
1650098236650,MATH 20E,A02,083772,Staff,20,0,30,10
1650098236650,MATH 20E,B01,083773,Staff,0,0,30,30
1650098236650,MATH 20E,B02,083774,Staff,13,0,30,17
1650098242678,MATH 103A,A01,083777,Staff,0,8,30,30
1650098242678,MATH 103A,A02,083778,Staff,0,7,30,30
1650098242678,MATH 103A,B01,083779,Staff,0,9,30,30
1650098242678,MATH 103A,B02,083780,Staff,0,6,30,30
1650098248703,MATH 105,A01,085443,Staff,0,13,30,30
1650098254730,MATH 109,A01,083213,Anzaldo; Leesa B,0,3,30,30
1650098254730,MATH 109,A02,083214,Anzaldo; Leesa B,0,5,30,30
1650098254730,MATH 109,B01,083215,Anzaldo; Leesa B,0,4,30,30
1650098254730,MATH 109,B02,083216,Anzaldo; Leesa B,0,4,30,30
1650098260757,MATH 142A,A01,083219,Chow; Bennett,0,10,30,30
1650098260757,MATH 142A,A02,083220,Chow; Bennett,0,10,30,30
1650098260757,MATH 142A,B01,083221,Chow; Bennett,0,10,30,30
1650098260757,MATH 142A,B02,083222,Chow; Bennett,0,9,30,30
1650098266783,MATH 193A,A01,083224,Staff,0,4,30,30
1650098266783,MATH 193A,A02,083225,Staff,0,4,30,30
1650098266783,MATH 193A,A03,083781,Staff,0,0,30,30
1650098266783,MATH 193A,A04,083782,Staff,2,0,30,28
1650098272806,MATH 197,001,091859,McAuley; Julian John,9998,0,9999,1
1650098278881,COGS 9,A01,083615,Staff,0,14,60,60
1650098284988,COGS 11,A01,083617,Boyle; Mary E. T.,24,0,40,16
1650098291014,COGS 13,A01,083071,Staff,0,28,40,40
1650098297041,COGS 14A,A01,092681,Staff,0,10,100,100
1650098303066,COGS 14B,A01,083073,Cheng; Tzu-Han,0,4,50,50
1650098309093,COGS 17,A01,092677,Staff,35,0,75,40
1650098315117,COGS 100,A01,083619,Staff,0,21,60,60
1650098321142,COGS 101A,A01,083621,Davis; Joshua Daniel,0,18,60,60
1650098327171,COGS 101B,A01,091572,Staff,10,0,60,50
1650098333201,COGS 101C,A01,083625,Delgado; Tania,21,0,30,9
1650098339239,COGS 107A,A01,083627,Boyle; Mary E. T.,0,4,60,60
1650098345267,COGS 118A,A01,083075,Staff,17,0,60,43
1650098351294,CSE 3,A50,083646,Miranda; Gregory Joseph,22,0,38,16
1650098351294,CSE 3,A51,083647,Miranda; Gregory Joseph,37,0,37,0
1650098357325,CSE 8A,A50,083650,Miranda; Gregory Joseph,0,15,40,40
1650098363349,CSE 11,A01,083080,Cao; Yingjun,0,66,40,40
1650098369374,CSE 12,A01,083652,Staff,0,2,100,100
1650098375397,CSE 15L,A01,083654,Staff,0,0,50,50
1650098375397,CSE 15L,A02,083655,Staff,10,0,50,40
1650098381423,CSE 20,A01,083657,Staff,58,0,80,22
1650098387449,CSE 30,A01,083084,Eldon; John,0,63,40,40
1650098393479,CSE 100,A01,083659,Cao; Yingjun,0,61,50,50
1650098399508,CSE 134B,A01,083661,Powell; Thomas Allan,0,27,65,65
1650098405532,CSE 140,A01,083663,Staff,4,0,75,71
1650098411562,CSE 140L,A01,083088,Eldon; John,0,1,75,75
1650098417585,CSE 175,A01,083665,Kumar; Rakesh,9,0,25,16
1650098423610,CSE 190,A00,092507,Dubnov; Shlomo,14,0,20,6
1650098429638,ECE 45,A01,083139,Staff,0,13,40,40
1650098435660,ECE 65,A50,083695,Staff,0,4,30,30
1650098441685,ECE 109,A01,091882,Touri; Behrouz,48,0,70,22
1650098447712,ECE 180,A00,083140,Abi Samra; Nicholas Camill,24,0,30,6
1650098447712,ECE 180,B00,083141,Abi Samra; Nicholas Camill,8,0,30,22
1650098453739,MATH 10A,A01,083735,Patchell; Gregory David,12,0,30,18
1650098453739,MATH 10A,A02,083736,Patchell; Gregory David,28,0,30,2
1650098453739,MATH 10A,A03,083737,Patchell; Gregory David,26,0,30,4
1650098459769,MATH 10B,A01,083207,Staff,0,5,30,30
1650098459769,MATH 10B,A02,083208,Staff,0,4,30,30
1650098459769,MATH 10B,B01,083739,Staff,18,0,30,12
1650098459769,MATH 10B,B02,083740,Staff,29,0,30,1
1650098465804,MATH 18,A01,083743,Staff,10,0,30,20
1650098465804,MATH 18,A02,083744,Staff,28,0,30,2
1650098465804,MATH 18,A03,083745,Staff,23,0,30,7
1650098465804,MATH 18,A04,083746,Staff,27,0,30,3
1650098465804,MATH 18,B01,083748,Staff,0,9,30,30
1650098465804,MATH 18,B02,083749,Staff,0,6,30,30
1650098465804,MATH 18,B03,083750,Staff,0,6,30,30
1650098465804,MATH 18,B04,083751,Staff,0,6,30,30
1650098471832,MATH 20A,A01,083754,Staff,26,0,40,14
1650098477857,MATH 20B,A01,083756,Staff,0,5,30,30
1650098477857,MATH 20B,A02,083757,Staff,0,2,30,30
1650098483882,MATH 20C,A01,083760,Staff,0,11,30,30
1650098483882,MATH 20C,A02,083761,Staff,0,12,30,30
1650098483882,MATH 20C,B01,083762,Staff,14,0,30,16
1650098483882,MATH 20C,B02,083763,Staff,28,0,30,2
1650098489905,MATH 20D,A01,083765,Staff,0,2,30,30
1650098489905,MATH 20D,A02,083766,Staff,12,0,30,18
1650098489905,MATH 20D,A03,083767,Staff,28,0,30,2
1650098495936,MATH 20E,A01,083771,Staff,10,0,30,20
1650098495936,MATH 20E,A02,083772,Staff,20,0,30,10
1650098495936,MATH 20E,B01,083773,Staff,0,0,30,30
1650098495936,MATH 20E,B02,083774,Staff,13,0,30,17
1650098501961,MATH 103A,A01,083777,Staff,0,8,30,30
1650098501961,MATH 103A,A02,083778,Staff,0,7,30,30
1650098501961,MATH 103A,B01,083779,Staff,0,9,30,30
1650098501961,MATH 103A,B02,083780,Staff,0,6,30,30
1650098507984,MATH 105,A01,085443,Staff,0,13,30,30
1650098514022,MATH 109,A01,083213,Anzaldo; Leesa B,0,3,30,30
1650098514022,MATH 109,A02,083214,Anzaldo; Leesa B,0,5,30,30
1650098514022,MATH 109,B01,083215,Anzaldo; Leesa B,0,4,30,30
1650098514022,MATH 109,B02,083216,Anzaldo; Leesa B,0,4,30,30
1650098520048,MATH 142A,A01,083219,Chow; Bennett,0,10,30,30
1650098520048,MATH 142A,A02,083220,Chow; Bennett,0,10,30,30
1650098520048,MATH 142A,B01,083221,Chow; Bennett,0,10,30,30
1650098520048,MATH 142A,B02,083222,Chow; Bennett,0,9,30,30
1650098526073,MATH 193A,A01,083224,Staff,0,4,30,30
1650098526073,MATH 193A,A02,083225,Staff,0,4,30,30
1650098526073,MATH 193A,A03,083781,Staff,0,0,30,30
1650098526073,MATH 193A,A04,083782,Staff,2,0,30,28
1650098532098,MATH 197,001,091859,McAuley; Julian John,9998,0,9999,1
1650098538164,COGS 9,A01,083615,Staff,0,14,60,60
1650098544190,COGS 11,A01,083617,Boyle; Mary E. T.,24,0,40,16
1650098550218,COGS 13,A01,083071,Staff,0,28,40,40
1650098556243,COGS 14A,A01,092681,Staff,0,10,100,100
1650098562268,COGS 14B,A01,083073,Cheng; Tzu-Han,0,4,50,50
1650098568292,COGS 17,A01,092677,Staff,35,0,75,40
1650098574315,COGS 100,A01,083619,Staff,0,21,60,60
1650098580343,COGS 101A,A01,083621,Davis; Joshua Daniel,0,18,60,60
1650098586373,COGS 101B,A01,091572,Staff,10,0,60,50
1650098592405,COGS 101C,A01,083625,Delgado; Tania,21,0,30,9
1650098598437,COGS 107A,A01,083627,Boyle; Mary E. T.,0,4,60,60
1650098604468,COGS 118A,A01,083075,Staff,17,0,60,43
1650098610498,CSE 3,A50,083646,Miranda; Gregory Joseph,22,0,38,16
1650098610498,CSE 3,A51,083647,Miranda; Gregory Joseph,37,0,37,0
1650098616526,CSE 8A,A50,083650,Miranda; Gregory Joseph,0,15,40,40
1650098622555,CSE 11,A01,083080,Cao; Yingjun,0,66,40,40
1650098628583,CSE 12,A01,083652,Staff,0,2,100,100
1650098634607,CSE 15L,A01,083654,Staff,0,0,50,50
1650098634607,CSE 15L,A02,083655,Staff,10,0,50,40
1650098640632,CSE 20,A01,083657,Staff,58,0,80,22
1650098646661,CSE 30,A01,083084,Eldon; John,0,63,40,40
1650098652685,CSE 100,A01,083659,Cao; Yingjun,0,61,50,50
1650098658710,CSE 134B,A01,083661,Powell; Thomas Allan,0,27,65,65
1650098664732,CSE 140,A01,083663,Staff,4,0,75,71
1650098670755,CSE 140L,A01,083088,Eldon; John,0,1,75,75
1650098676786,CSE 175,A01,083665,Kumar; Rakesh,9,0,25,16
1650098682810,CSE 190,A00,092507,Dubnov; Shlomo,14,0,20,6
1650098688834,ECE 45,A01,083139,Staff,0,13,40,40
1650098694867,ECE 65,A50,083695,Staff,0,4,30,30
1650098700892,ECE 109,A01,091882,Touri; Behrouz,48,0,70,22
1650098706915,ECE 180,A00,083140,Abi Samra; Nicholas Camill,24,0,30,6
1650098706915,ECE 180,B00,083141,Abi Samra; Nicholas Camill,8,0,30,22
1650098712941,MATH 10A,A01,083735,Patchell; Gregory David,12,0,30,18
1650098712941,MATH 10A,A02,083736,Patchell; Gregory David,28,0,30,2
1650098712941,MATH 10A,A03,083737,Patchell; Gregory David,26,0,30,4
1650098718966,MATH 10B,A01,083207,Staff,0,5,30,30
1650098718966,MATH 10B,A02,083208,Staff,0,4,30,30
1650098718966,MATH 10B,B01,083739,Staff,18,0,30,12
1650098718966,MATH 10B,B02,083740,Staff,29,0,30,1
1650098724991,MATH 18,A01,083743,Staff,10,0,30,20
1650098724991,MATH 18,A02,083744,Staff,28,0,30,2
1650098724991,MATH 18,A03,083745,Staff,23,0,30,7
1650098724991,MATH 18,A04,083746,Staff,27,0,30,3
1650098724991,MATH 18,B01,083748,Staff,0,9,30,30
1650098724991,MATH 18,B02,083749,Staff,0,6,30,30
1650098724991,MATH 18,B03,083750,Staff,0,6,30,30
1650098724991,MATH 18,B04,083751,Staff,0,6,30,30
1650098731018,MATH 20A,A01,083754,Staff,26,0,40,14
1650098737047,MATH 20B,A01,083756,Staff,0,5,30,30
1650098737047,MATH 20B,A02,083757,Staff,0,2,30,30
1650098743076,MATH 20C,A01,083760,Staff,0,11,30,30
1650098743076,MATH 20C,A02,083761,Staff,0,12,30,30
1650098743076,MATH 20C,B01,083762,Staff,14,0,30,16
1650098743076,MATH 20C,B02,083763,Staff,28,0,30,2
1650098749103,MATH 20D,A01,083765,Staff,0,2,30,30
1650098749103,MATH 20D,A02,083766,Staff,12,0,30,18
1650098749103,MATH 20D,A03,083767,Staff,28,0,30,2
1650098755127,MATH 20E,A01,083771,Staff,10,0,30,20
1650098755127,MATH 20E,A02,083772,Staff,20,0,30,10
1650098755127,MATH 20E,B01,083773,Staff,0,0,30,30
1650098755127,MATH 20E,B02,083774,Staff,13,0,30,17
1650098761233,MATH 103A,A01,083777,Staff,0,8,30,30
1650098761233,MATH 103A,A02,083778,Staff,0,7,30,30
1650098761233,MATH 103A,B01,083779,Staff,0,9,30,30
1650098761233,MATH 103A,B02,083780,Staff,0,6,30,30
1650098767257,MATH 105,A01,085443,Staff,0,13,30,30
1650098773288,MATH 109,A01,083213,Anzaldo; Leesa B,0,3,30,30
1650098773288,MATH 109,A02,083214,Anzaldo; Leesa B,0,5,30,30
1650098773288,MATH 109,B01,083215,Anzaldo; Leesa B,0,4,30,30
1650098773288,MATH 109,B02,083216,Anzaldo; Leesa B,0,4,30,30
1650098779312,MATH 142A,A01,083219,Chow; Bennett,0,10,30,30
1650098779312,MATH 142A,A02,083220,Chow; Bennett,0,10,30,30
1650098779312,MATH 142A,B01,083221,Chow; Bennett,0,10,30,30
1650098779312,MATH 142A,B02,083222,Chow; Bennett,0,9,30,30
1650098785340,MATH 193A,A01,083224,Staff,0,4,30,30
1650098785340,MATH 193A,A02,083225,Staff,0,4,30,30
1650098785340,MATH 193A,A03,083781,Staff,0,0,30,30
1650098785340,MATH 193A,A04,083782,Staff,2,0,30,28
1650098791365,MATH 197,001,091859,McAuley; Julian John,9998,0,9999,1
1650098797444,COGS 9,A01,083615,Staff,0,14,60,60
1650098805070,COGS 11,A01,083617,Boyle; Mary E. T.,24,0,40,16
1650098811095,COGS 13,A01,083071,Staff,0,28,40,40
1650098817123,COGS 14A,A01,092681,Staff,0,10,100,100
1650098823155,COGS 14B,A01,083073,Cheng; Tzu-Han,0,4,50,50
1650098829181,COGS 17,A01,092677,Staff,35,0,75,40
1650098835216,COGS 100,A01,083619,Staff,0,21,60,60
1650098841240,COGS 101A,A01,083621,Davis; Joshua Daniel,0,18,60,60
1650098847263,COGS 101B,A01,091572,Staff,10,0,60,50
1650098853289,COGS 101C,A01,083625,Delgado; Tania,21,0,30,9
1650098859314,COGS 107A,A01,083627,Boyle; Mary E. T.,0,4,60,60
1650098865342,COGS 118A,A01,083075,Staff,17,0,60,43
1650098871376,CSE 3,A50,083646,Miranda; Gregory Joseph,22,0,38,16
1650098871376,CSE 3,A51,083647,Miranda; Gregory Joseph,37,0,37,0
1650098877402,CSE 8A,A50,083650,Miranda; Gregory Joseph,0,15,40,40
1650098883513,CSE 11,A01,083080,Cao; Yingjun,0,66,40,40
1650098889536,CSE 12,A01,083652,Staff,0,2,100,100
1650098895559,CSE 15L,A01,083654,Staff,0,0,50,50
1650098895559,CSE 15L,A02,083655,Staff,10,0,50,40
1650098901584,CSE 20,A01,083657,Staff,58,0,80,22
1650098907609,CSE 30,A01,083084,Eldon; John,0,63,40,40
1650098913633,CSE 100,A01,083659,Cao; Yingjun,0,61,50,50
1650098919671,CSE 134B,A01,083661,Powell; Thomas Allan,0,27,65,65
1650098925698,CSE 140,A01,083663,Staff,4,0,75,71
1650098931725,CSE 140L,A01,083088,Eldon; John,0,1,75,75
1650098937766,CSE 175,A01,083665,Kumar; Rakesh,9,0,25,16
1650098943796,CSE 190,A00,092507,Dubnov; Shlomo,14,0,20,6
1650098949820,ECE 45,A01,083139,Staff,0,13,40,40
1650098955851,ECE 65,A50,083695,Staff,0,4,30,30
1650098961875,ECE 109,A01,091882,Touri; Behrouz,48,0,70,22
1650098967900,ECE 180,A00,083140,Abi Samra; Nicholas Camill,24,0,30,6
1650098967900,ECE 180,B00,083141,Abi Samra; Nicholas Camill,8,0,30,22
1650098973929,MATH 10A,A01,083735,Patchell; Gregory David,12,0,30,18
1650098973929,MATH 10A,A02,083736,Patchell; Gregory David,28,0,30,2
1650098973929,MATH 10A,A03,083737,Patchell; Gregory David,26,0,30,4
1650098979952,MATH 10B,A01,083207,Staff,0,5,30,30
1650098979952,MATH 10B,A02,083208,Staff,0,4,30,30
1650098979952,MATH 10B,B01,083739,Staff,18,0,30,12
1650098979952,MATH 10B,B02,083740,Staff,29,0,30,1
1650098985978,MATH 18,A01,083743,Staff,10,0,30,20
1650098985978,MATH 18,A02,083744,Staff,28,0,30,2
1650098985978,MATH 18,A03,083745,Staff,23,0,30,7
1650098985978,MATH 18,A04,083746,Staff,27,0,30,3
1650098985978,MATH 18,B01,083748,Staff,0,9,30,30
1650098985978,MATH 18,B02,083749,Staff,0,6,30,30
1650098985978,MATH 18,B03,083750,Staff,0,6,30,30
1650098985978,MATH 18,B04,083751,Staff,0,6,30,30
1650098992002,MATH 20A,A01,083754,Staff,26,0,40,14
1650098998030,MATH 20B,A01,083756,Staff,0,5,30,30
1650098998030,MATH 20B,A02,083757,Staff,0,2,30,30
1650099004057,MATH 20C,A01,083760,Staff,0,11,30,30
1650099004057,MATH 20C,A02,083761,Staff,0,12,30,30
1650099004057,MATH 20C,B01,083762,Staff,14,0,30,16
1650099004057,MATH 20C,B02,083763,Staff,28,0,30,2
1650099010080,MATH 20D,A01,083765,Staff,0,2,30,30
1650099010080,MATH 20D,A02,083766,Staff,12,0,30,18
1650099010080,MATH 20D,A03,083767,Staff,28,0,30,2
1650099016106,MATH 20E,A01,083771,Staff,10,0,30,20
1650099016106,MATH 20E,A02,083772,Staff,20,0,30,10
1650099016106,MATH 20E,B01,083773,Staff,0,0,30,30
1650099016106,MATH 20E,B02,083774,Staff,13,0,30,17
1650099022131,MATH 103A,A01,083777,Staff,0,8,30,30
1650099022131,MATH 103A,A02,083778,Staff,0,7,30,30
1650099022131,MATH 103A,B01,083779,Staff,0,9,30,30
1650099022131,MATH 103A,B02,083780,Staff,0,6,30,30
1650099028160,MATH 105,A01,085443,Staff,0,13,30,30
1650099034187,MATH 109,A01,083213,Anzaldo; Leesa B,0,3,30,30
1650099034187,MATH 109,A02,083214,Anzaldo; Leesa B,0,5,30,30
1650099034187,MATH 109,B01,083215,Anzaldo; Leesa B,0,4,30,30
1650099034187,MATH 109,B02,083216,Anzaldo; Leesa B,0,4,30,30
1650099040213,MATH 142A,A01,083219,Chow; Bennett,0,10,30,30
1650099040213,MATH 142A,A02,083220,Chow; Bennett,0,10,30,30
1650099040213,MATH 142A,B01,083221,Chow; Bennett,0,10,30,30
1650099040213,MATH 142A,B02,083222,Chow; Bennett,0,9,30,30
1650099046243,MATH 193A,A01,083224,Staff,0,4,30,30
1650099046243,MATH 193A,A02,083225,Staff,0,4,30,30
1650099046243,MATH 193A,A03,083781,Staff,0,0,30,30
1650099046243,MATH 193A,A04,083782,Staff,2,0,30,28
1650099052267,MATH 197,001,091859,McAuley; Julian John,9998,0,9999,1
1650099058342,COGS 9,A01,083615,Staff,0,14,60,60
1650099064379,COGS 11,A01,083617,Boyle; Mary E. T.,24,0,40,16
1650099070407,COGS 13,A01,083071,Staff,0,28,40,40
1650099076435,COGS 14A,A01,092681,Staff,0,10,100,100
1650099082465,COGS 14B,A01,083073,Cheng; Tzu-Han,0,4,50,50
1650099088490,COGS 17,A01,092677,Staff,35,0,75,40
1650099094518,COGS 100,A01,083619,Staff,0,21,60,60
1650099100543,COGS 101A,A01,083621,Davis; Joshua Daniel,0,18,60,60
1650099106568,COGS 101B,A01,091572,Staff,10,0,60,50
1650099112591,COGS 101C,A01,083625,Delgado; Tania,21,0,30,9
1650099118614,COGS 107A,A01,083627,Boyle; Mary E. T.,0,4,60,60
1650099124643,COGS 118A,A01,083075,Staff,17,0,60,43
1650099130668,CSE 3,A50,083646,Miranda; Gregory Joseph,22,0,38,16
1650099130668,CSE 3,A51,083647,Miranda; Gregory Joseph,37,0,37,0
1650099136692,CSE 8A,A50,083650,Miranda; Gregory Joseph,0,15,40,40
1650099142715,CSE 11,A01,083080,Cao; Yingjun,0,66,40,40
1650099148739,CSE 12,A01,083652,Staff,0,2,100,100
1650099154766,CSE 15L,A01,083654,Staff,0,0,50,50
1650099154766,CSE 15L,A02,083655,Staff,10,0,50,40
1650099160789,CSE 20,A01,083657,Staff,58,0,80,22
1650099166812,CSE 30,A01,083084,Eldon; John,0,63,40,40
1650099172836,CSE 100,A01,083659,Cao; Yingjun,0,61,50,50
1650099178863,CSE 134B,A01,083661,Powell; Thomas Allan,0,27,65,65
1650099184887,CSE 140,A01,083663,Staff,4,0,75,71
1650099190914,CSE 140L,A01,083088,Eldon; John,0,1,75,75
1650099196938,CSE 175,A01,083665,Kumar; Rakesh,9,0,25,16
1650099202961,CSE 190,A00,092507,Dubnov; Shlomo,14,0,20,6
1650099208987,ECE 45,A01,083139,Staff,0,13,40,40
1650099215012,ECE 65,A50,083695,Staff,0,4,30,30
1650099221035,ECE 109,A01,091882,Touri; Behrouz,48,0,70,22
1650099227065,ECE 180,A00,083140,Abi Samra; Nicholas Camill,24,0,30,6
1650099227065,ECE 180,B00,083141,Abi Samra; Nicholas Camill,8,0,30,22
1650099233093,MATH 10A,A01,083735,Patchell; Gregory David,12,0,30,18
1650099233093,MATH 10A,A02,083736,Patchell; Gregory David,28,0,30,2
1650099233093,MATH 10A,A03,083737,Patchell; Gregory David,26,0,30,4
1650099239117,MATH 10B,A01,083207,Staff,0,5,30,30
1650099239117,MATH 10B,A02,083208,Staff,0,4,30,30
1650099239117,MATH 10B,B01,083739,Staff,18,0,30,12
1650099239117,MATH 10B,B02,083740,Staff,29,0,30,1
1650099245147,MATH 18,A01,083743,Staff,10,0,30,20
1650099245147,MATH 18,A02,083744,Staff,28,0,30,2
1650099245147,MATH 18,A03,083745,Staff,23,0,30,7
1650099245147,MATH 18,A04,083746,Staff,27,0,30,3
1650099245147,MATH 18,B01,083748,Staff,0,9,30,30
1650099245147,MATH 18,B02,083749,Staff,0,6,30,30
1650099245147,MATH 18,B03,083750,Staff,0,6,30,30
1650099245147,MATH 18,B04,083751,Staff,0,6,30,30
1650099251169,MATH 20A,A01,083754,Staff,26,0,40,14
1650099257192,MATH 20B,A01,083756,Staff,0,5,30,30
1650099257192,MATH 20B,A02,083757,Staff,0,2,30,30
1650099263220,MATH 20C,A01,083760,Staff,0,11,30,30
1650099263220,MATH 20C,A02,083761,Staff,0,12,30,30
1650099263220,MATH 20C,B01,083762,Staff,14,0,30,16
1650099263220,MATH 20C,B02,083763,Staff,28,0,30,2
1650099269244,MATH 20D,A01,083765,Staff,0,2,30,30
1650099269244,MATH 20D,A02,083766,Staff,12,0,30,18
1650099269244,MATH 20D,A03,083767,Staff,28,0,30,2
1650099275267,MATH 20E,A01,083771,Staff,10,0,30,20
1650099275267,MATH 20E,A02,083772,Staff,20,0,30,10
1650099275267,MATH 20E,B01,083773,Staff,0,0,30,30
1650099275267,MATH 20E,B02,083774,Staff,13,0,30,17
1650099281290,MATH 103A,A01,083777,Staff,0,8,30,30
1650099281290,MATH 103A,A02,083778,Staff,0,7,30,30
1650099281290,MATH 103A,B01,083779,Staff,0,9,30,30
1650099281290,MATH 103A,B02,083780,Staff,0,6,30,30
1650099287315,MATH 105,A01,085443,Staff,0,13,30,30
1650099293342,MATH 109,A01,083213,Anzaldo; Leesa B,0,3,30,30
1650099293342,MATH 109,A02,083214,Anzaldo; Leesa B,0,5,30,30
1650099293342,MATH 109,B01,083215,Anzaldo; Leesa B,0,4,30,30
1650099293342,MATH 109,B02,083216,Anzaldo; Leesa B,0,4,30,30
1650099299369,MATH 142A,A01,083219,Chow; Bennett,0,10,30,30
1650099299369,MATH 142A,A02,083220,Chow; Bennett,0,10,30,30
1650099299369,MATH 142A,B01,083221,Chow; Bennett,0,10,30,30
1650099299369,MATH 142A,B02,083222,Chow; Bennett,0,9,30,30
1650099305395,MATH 193A,A01,083224,Staff,0,4,30,30
1650099305395,MATH 193A,A02,083225,Staff,0,4,30,30
1650099305395,MATH 193A,A03,083781,Staff,0,0,30,30
1650099305395,MATH 193A,A04,083782,Staff,2,0,30,28
1650099311422,MATH 197,001,091859,McAuley; Julian John,9998,0,9999,1
1650099317486,COGS 9,A01,083615,Staff,0,14,60,60
1650099323513,COGS 11,A01,083617,Boyle; Mary E. T.,24,0,40,16
1650099329537,COGS 13,A01,083071,Staff,0,28,40,40
1650099335560,COGS 14A,A01,092681,Staff,0,10,100,100
1650099341584,COGS 14B,A01,083073,Cheng; Tzu-Han,0,4,50,50
1650099347614,COGS 17,A01,092677,Staff,35,0,75,40
1650099353638,COGS 100,A01,083619,Staff,0,21,60,60
1650099359664,COGS 101A,A01,083621,Davis; Joshua Daniel,0,18,60,60
1650099365692,COGS 101B,A01,091572,Staff,10,0,60,50
1650099371717,COGS 101C,A01,083625,Delgado; Tania,21,0,30,9
1650099377741,COGS 107A,A01,083627,Boyle; Mary E. T.,0,4,60,60
1650099383763,COGS 118A,A01,083075,Staff,17,0,60,43
1650099389788,CSE 3,A50,083646,Miranda; Gregory Joseph,22,0,38,16
1650099389788,CSE 3,A51,083647,Miranda; Gregory Joseph,37,0,37,0
1650099395812,CSE 8A,A50,083650,Miranda; Gregory Joseph,0,15,40,40
1650099401835,CSE 11,A01,083080,Cao; Yingjun,0,66,40,40
1650099407860,CSE 12,A01,083652,Staff,0,2,100,100
1650099413884,CSE 15L,A01,083654,Staff,0,0,50,50
1650099413884,CSE 15L,A02,083655,Staff,10,0,50,40
1650099419918,CSE 20,A01,083657,Staff,58,0,80,22
1650099425956,CSE 30,A01,083084,Eldon; John,0,63,40,40
1650099431982,CSE 100,A01,083659,Cao; Yingjun,0,61,50,50
1650099438011,CSE 134B,A01,083661,Powell; Thomas Allan,0,27,65,65
1650099444036,CSE 140,A01,083663,Staff,4,0,75,71
1650099450058,CSE 140L,A01,083088,Eldon; John,0,1,75,75
1650099456082,CSE 175,A01,083665,Kumar; Rakesh,9,0,25,16
1650099462107,CSE 190,A00,092507,Dubnov; Shlomo,14,0,20,6
1650099468135,ECE 45,A01,083139,Staff,0,13,40,40
1650099474163,ECE 65,A50,083695,Staff,0,4,30,30
1650099480260,ECE 109,A01,091882,Touri; Behrouz,48,0,70,22
1650099486284,ECE 180,A00,083140,Abi Samra; Nicholas Camill,24,0,30,6
1650099486284,ECE 180,B00,083141,Abi Samra; Nicholas Camill,8,0,30,22
1650099492314,MATH 10A,A01,083735,Patchell; Gregory David,12,0,30,18
1650099492314,MATH 10A,A02,083736,Patchell; Gregory David,28,0,30,2
1650099492314,MATH 10A,A03,083737,Patchell; Gregory David,26,0,30,4
1650099498338,MATH 10B,A01,083207,Staff,0,5,30,30
1650099498338,MATH 10B,A02,083208,Staff,0,4,30,30
1650099498338,MATH 10B,B01,083739,Staff,18,0,30,12
1650099498338,MATH 10B,B02,083740,Staff,29,0,30,1
1650099504370,MATH 18,A01,083743,Staff,10,0,30,20
1650099504370,MATH 18,A02,083744,Staff,28,0,30,2
1650099504370,MATH 18,A03,083745,Staff,23,0,30,7
1650099504370,MATH 18,A04,083746,Staff,27,0,30,3
1650099504370,MATH 18,B01,083748,Staff,0,9,30,30
1650099504370,MATH 18,B02,083749,Staff,0,6,30,30
1650099504370,MATH 18,B03,083750,Staff,0,6,30,30
1650099504370,MATH 18,B04,083751,Staff,0,6,30,30
1650099510397,MATH 20A,A01,083754,Staff,26,0,40,14
1650099516431,MATH 20B,A01,083756,Staff,0,5,30,30
1650099516431,MATH 20B,A02,083757,Staff,0,2,30,30
1650099522455,MATH 20C,A01,083760,Staff,0,11,30,30
1650099522455,MATH 20C,A02,083761,Staff,0,12,30,30
1650099522455,MATH 20C,B01,083762,Staff,14,0,30,16
1650099522455,MATH 20C,B02,083763,Staff,28,0,30,2
1650099528504,MATH 20D,A01,083765,Staff,0,2,30,30
1650099528504,MATH 20D,A02,083766,Staff,12,0,30,18
1650099528504,MATH 20D,A03,083767,Staff,28,0,30,2
1650099534545,MATH 20E,A01,083771,Staff,10,0,30,20
1650099534545,MATH 20E,A02,083772,Staff,20,0,30,10
1650099534545,MATH 20E,B01,083773,Staff,0,0,30,30
1650099534545,MATH 20E,B02,083774,Staff,13,0,30,17
1650099540583,MATH 103A,A01,083777,Staff,0,8,30,30
1650099540583,MATH 103A,A02,083778,Staff,0,7,30,30
1650099540583,MATH 103A,B01,083779,Staff,0,9,30,30
1650099540583,MATH 103A,B02,083780,Staff,0,6,30,30
1650099546606,MATH 105,A01,085443,Staff,0,13,30,30
1650099552630,MATH 109,A01,083213,Anzaldo; Leesa B,0,3,30,30
1650099552630,MATH 109,A02,083214,Anzaldo; Leesa B,0,5,30,30
1650099552630,MATH 109,B01,083215,Anzaldo; Leesa B,0,4,30,30
1650099552630,MATH 109,B02,083216,Anzaldo; Leesa B,0,4,30,30
1650099558658,MATH 142A,A01,083219,Chow; Bennett,0,10,30,30
1650099558658,MATH 142A,A02,083220,Chow; Bennett,0,10,30,30
1650099558658,MATH 142A,B01,083221,Chow; Bennett,0,10,30,30
1650099558658,MATH 142A,B02,083222,Chow; Bennett,0,9,30,30
1650099564683,MATH 193A,A01,083224,Staff,0,4,30,30
1650099564683,MATH 193A,A02,083225,Staff,0,4,30,30
1650099564683,MATH 193A,A03,083781,Staff,0,0,30,30
1650099564683,MATH 193A,A04,083782,Staff,2,0,30,28
1650099570706,MATH 197,001,091859,McAuley; Julian John,9998,0,9999,1
1650099576761,COGS 9,A01,083615,Staff,0,14,60,60
1650099582784,COGS 11,A01,083617,Boyle; Mary E. T.,24,0,40,16
1650099588813,COGS 13,A01,083071,Staff,0,28,40,40
1650099594839,COGS 14A,A01,092681,Staff,0,10,100,100
1650099600866,COGS 14B,A01,083073,Cheng; Tzu-Han,0,4,50,50
1650099606892,COGS 17,A01,092677,Staff,35,0,75,40
1650099612920,COGS 100,A01,083619,Staff,0,21,60,60
1650099618944,COGS 101A,A01,083621,Davis; Joshua Daniel,0,18,60,60
1650099624969,COGS 101B,A01,091572,Staff,10,0,60,50
1650099630992,COGS 101C,A01,083625,Delgado; Tania,21,0,30,9
1650099637016,COGS 107A,A01,083627,Boyle; Mary E. T.,0,4,60,60
1650099643043,COGS 118A,A01,083075,Staff,17,0,60,43
1650099649068,CSE 3,A50,083646,Miranda; Gregory Joseph,22,0,38,16
1650099649068,CSE 3,A51,083647,Miranda; Gregory Joseph,37,0,37,0
1650099655090,CSE 8A,A50,083650,Miranda; Gregory Joseph,0,15,40,40
1650099661117,CSE 11,A01,083080,Cao; Yingjun,0,66,40,40
1650099667145,CSE 12,A01,083652,Staff,0,2,100,100
1650099673171,CSE 15L,A01,083654,Staff,0,0,50,50
1650099673171,CSE 15L,A02,083655,Staff,10,0,50,40
1650099679194,CSE 20,A01,083657,Staff,58,0,80,22
1650099685223,CSE 30,A01,083084,Eldon; John,0,63,40,40
1650099691263,CSE 100,A01,083659,Cao; Yingjun,0,61,50,50
1650099697317,CSE 134B,A01,083661,Powell; Thomas Allan,0,27,65,65
1650099703345,CSE 140,A01,083663,Staff,4,0,75,71
1650099709375,CSE 140L,A01,083088,Eldon; John,0,1,75,75
1650099715398,CSE 175,A01,083665,Kumar; Rakesh,9,0,25,16
1650099721427,CSE 190,A00,092507,Dubnov; Shlomo,14,0,20,6
1650099727455,ECE 45,A01,083139,Staff,0,13,40,40
1650099733479,ECE 65,A50,083695,Staff,0,4,30,30
1650099739503,ECE 109,A01,091882,Touri; Behrouz,48,0,70,22
1650099745529,ECE 180,A00,083140,Abi Samra; Nicholas Camill,24,0,30,6
1650099745529,ECE 180,B00,083141,Abi Samra; Nicholas Camill,8,0,30,22
1650099751569,MATH 10A,A01,083735,Patchell; Gregory David,12,0,30,18
1650099751569,MATH 10A,A02,083736,Patchell; Gregory David,28,0,30,2
1650099751569,MATH 10A,A03,083737,Patchell; Gregory David,26,0,30,4
1650099757594,MATH 10B,A01,083207,Staff,0,5,30,30
1650099757594,MATH 10B,A02,083208,Staff,0,4,30,30
1650099757594,MATH 10B,B01,083739,Staff,18,0,30,12
1650099757594,MATH 10B,B02,083740,Staff,29,0,30,1
1650099763623,MATH 18,A01,083743,Staff,10,0,30,20
1650099763623,MATH 18,A02,083744,Staff,28,0,30,2
1650099763623,MATH 18,A03,083745,Staff,23,0,30,7
1650099763623,MATH 18,A04,083746,Staff,27,0,30,3
1650099763623,MATH 18,B01,083748,Staff,0,9,30,30
1650099763623,MATH 18,B02,083749,Staff,0,6,30,30
1650099763623,MATH 18,B03,083750,Staff,0,6,30,30
1650099763623,MATH 18,B04,083751,Staff,0,6,30,30
1650099769648,MATH 20A,A01,083754,Staff,26,0,40,14
1650099775673,MATH 20B,A01,083756,Staff,0,5,30,30
1650099775673,MATH 20B,A02,083757,Staff,0,2,30,30
1650099781701,MATH 20C,A01,083760,Staff,0,11,30,30
1650099781701,MATH 20C,A02,083761,Staff,0,12,30,30
1650099781701,MATH 20C,B01,083762,Staff,14,0,30,16
1650099781701,MATH 20C,B02,083763,Staff,28,0,30,2
1650099787730,MATH 20D,A01,083765,Staff,0,2,30,30
1650099787730,MATH 20D,A02,083766,Staff,12,0,30,18
1650099787730,MATH 20D,A03,083767,Staff,28,0,30,2
1650099793756,MATH 20E,A01,083771,Staff,10,0,30,20
1650099793756,MATH 20E,A02,083772,Staff,20,0,30,10
1650099793756,MATH 20E,B01,083773,Staff,0,0,30,30
1650099793756,MATH 20E,B02,083774,Staff,13,0,30,17
1650099799793,MATH 103A,A01,083777,Staff,0,8,30,30
1650099799793,MATH 103A,A02,083778,Staff,0,7,30,30
1650099799793,MATH 103A,B01,083779,Staff,0,9,30,30
1650099799793,MATH 103A,B02,083780,Staff,0,6,30,30
1650099805817,MATH 105,A01,085443,Staff,0,13,30,30
1650099811842,MATH 109,A01,083213,Anzaldo; Leesa B,0,3,30,30
1650099811842,MATH 109,A02,083214,Anzaldo; Leesa B,0,5,30,30
1650099811842,MATH 109,B01,083215,Anzaldo; Leesa B,0,4,30,30
1650099811842,MATH 109,B02,083216,Anzaldo; Leesa B,0,4,30,30
1650099817873,MATH 142A,A01,083219,Chow; Bennett,0,10,30,30
1650099817873,MATH 142A,A02,083220,Chow; Bennett,0,10,30,30
1650099817873,MATH 142A,B01,083221,Chow; Bennett,0,10,30,30
1650099817873,MATH 142A,B02,083222,Chow; Bennett,0,9,30,30
1650099823897,MATH 193A,A01,083224,Staff,0,4,30,30
1650099823897,MATH 193A,A02,083225,Staff,0,4,30,30
1650099823897,MATH 193A,A03,083781,Staff,0,0,30,30
1650099823897,MATH 193A,A04,083782,Staff,2,0,30,28
1650099829920,MATH 197,001,091859,McAuley; Julian John,9998,0,9999,1
1650099835989,COGS 9,A01,083615,Staff,0,14,60,60
1650099842013,COGS 11,A01,083617,Boyle; Mary E. T.,24,0,40,16
1650099848041,COGS 13,A01,083071,Staff,0,28,40,40
1650099854071,COGS 14A,A01,092681,Staff,0,10,100,100
1650099860096,COGS 14B,A01,083073,Cheng; Tzu-Han,0,4,50,50
1650099866121,COGS 17,A01,092677,Staff,35,0,75,40
1650099872144,COGS 100,A01,083619,Staff,0,21,60,60
1650099878174,COGS 101A,A01,083621,Davis; Joshua Daniel,0,18,60,60
1650099884203,COGS 101B,A01,091572,Staff,10,0,60,50
1650099890233,COGS 101C,A01,083625,Delgado; Tania,21,0,30,9
1650099896255,COGS 107A,A01,083627,Boyle; Mary E. T.,0,4,60,60
1650099902278,COGS 118A,A01,083075,Staff,17,0,60,43
1650099908308,CSE 3,A50,083646,Miranda; Gregory Joseph,22,0,38,16
1650099908308,CSE 3,A51,083647,Miranda; Gregory Joseph,37,0,37,0
1650099914331,CSE 8A,A50,083650,Miranda; Gregory Joseph,0,15,40,40
1650099920360,CSE 11,A01,083080,Cao; Yingjun,0,66,40,40
1650099926392,CSE 12,A01,083652,Staff,0,2,100,100
1650099932421,CSE 15L,A01,083654,Staff,0,0,50,50
1650099932421,CSE 15L,A02,083655,Staff,10,0,50,40
1650099938445,CSE 20,A01,083657,Staff,58,0,80,22
1650099944475,CSE 30,A01,083084,Eldon; John,0,63,40,40
1650099950507,CSE 100,A01,083659,Cao; Yingjun,0,61,50,50
1650099956541,CSE 134B,A01,083661,Powell; Thomas Allan,0,27,65,65
1650099962565,CSE 140,A01,083663,Staff,4,0,75,71
1650099968593,CSE 140L,A01,083088,Eldon; John,0,1,75,75
1650099974624,CSE 175,A01,083665,Kumar; Rakesh,9,0,25,16
1650099980650,CSE 190,A00,092507,Dubnov; Shlomo,14,0,20,6
1650099986675,ECE 45,A01,083139,Staff,0,13,40,40
1650099992700,ECE 65,A50,083695,Staff,0,4,30,30
1650099998730,ECE 109,A01,091882,Touri; Behrouz,48,0,70,22
1650100004753,ECE 180,A00,083140,Abi Samra; Nicholas Camill,24,0,30,6
1650100004753,ECE 180,B00,083141,Abi Samra; Nicholas Camill,8,0,30,22
1650100010785,MATH 10A,A01,083735,Patchell; Gregory David,12,0,30,18
1650100010785,MATH 10A,A02,083736,Patchell; Gregory David,28,0,30,2
1650100010785,MATH 10A,A03,083737,Patchell; Gregory David,26,0,30,4
1650100016816,MATH 10B,A01,083207,Staff,0,5,30,30
1650100016816,MATH 10B,A02,083208,Staff,0,4,30,30
1650100016816,MATH 10B,B01,083739,Staff,18,0,30,12
1650100016816,MATH 10B,B02,083740,Staff,29,0,30,1
1650100022857,MATH 18,A01,083743,Staff,10,0,30,20
1650100022857,MATH 18,A02,083744,Staff,28,0,30,2
1650100022857,MATH 18,A03,083745,Staff,23,0,30,7
1650100022857,MATH 18,A04,083746,Staff,27,0,30,3
1650100022857,MATH 18,B01,083748,Staff,0,9,30,30
1650100022857,MATH 18,B02,083749,Staff,0,6,30,30
1650100022857,MATH 18,B03,083750,Staff,0,6,30,30
1650100022857,MATH 18,B04,083751,Staff,0,6,30,30
1650100028893,MATH 20A,A01,083754,Staff,26,0,40,14
1650100034924,MATH 20B,A01,083756,Staff,0,5,30,30
1650100034924,MATH 20B,A02,083757,Staff,0,2,30,30
1650100040952,MATH 20C,A01,083760,Staff,0,11,30,30
1650100040952,MATH 20C,A02,083761,Staff,0,12,30,30
1650100040952,MATH 20C,B01,083762,Staff,14,0,30,16
1650100040952,MATH 20C,B02,083763,Staff,28,0,30,2
1650100046981,MATH 20D,A01,083765,Staff,0,2,30,30
1650100046981,MATH 20D,A02,083766,Staff,12,0,30,18
1650100046981,MATH 20D,A03,083767,Staff,28,0,30,2
1650100053006,MATH 20E,A01,083771,Staff,10,0,30,20
1650100053006,MATH 20E,A02,083772,Staff,20,0,30,10
1650100053006,MATH 20E,B01,083773,Staff,0,0,30,30
1650100053006,MATH 20E,B02,083774,Staff,13,0,30,17
1650100059036,MATH 103A,A01,083777,Staff,0,8,30,30
1650100059036,MATH 103A,A02,083778,Staff,0,7,30,30
1650100059036,MATH 103A,B01,083779,Staff,0,9,30,30
1650100059036,MATH 103A,B02,083780,Staff,0,6,30,30
1650100065063,MATH 105,A01,085443,Staff,0,13,30,30
1650100071094,MATH 109,A01,083213,Anzaldo; Leesa B,0,3,30,30
1650100071094,MATH 109,A02,083214,Anzaldo; Leesa B,0,5,30,30
1650100071094,MATH 109,B01,083215,Anzaldo; Leesa B,0,4,30,30
1650100071094,MATH 109,B02,083216,Anzaldo; Leesa B,0,4,30,30
1650100077191,MATH 142A,A01,083219,Chow; Bennett,0,10,30,30
1650100077191,MATH 142A,A02,083220,Chow; Bennett,0,10,30,30
1650100077191,MATH 142A,B01,083221,Chow; Bennett,0,10,30,30
1650100077191,MATH 142A,B02,083222,Chow; Bennett,0,9,30,30
1650100083215,MATH 193A,A01,083224,Staff,0,4,30,30
1650100083215,MATH 193A,A02,083225,Staff,0,4,30,30
1650100083215,MATH 193A,A03,083781,Staff,0,0,30,30
1650100083215,MATH 193A,A04,083782,Staff,2,0,30,28
1650100089240,MATH 197,001,091859,McAuley; Julian John,9998,0,9999,1
1650100095320,COGS 9,A01,083615,Staff,0,14,60,60
1650100101347,COGS 11,A01,083617,Boyle; Mary E. T.,24,0,40,16
1650100107372,COGS 13,A01,083071,Staff,0,28,40,40
1650100113397,COGS 14A,A01,092681,Staff,0,10,100,100
1650100119428,COGS 14B,A01,083073,Cheng; Tzu-Han,0,4,50,50
1650100125458,COGS 17,A01,092677,Staff,35,0,75,40
1650100131483,COGS 100,A01,083619,Staff,0,21,60,60
1650100137508,COGS 101A,A01,083621,Davis; Joshua Daniel,0,18,60,60
1650100143555,COGS 101B,A01,091572,Staff,10,0,60,50
1650100149585,COGS 101C,A01,083625,Delgado; Tania,21,0,30,9
1650100155610,COGS 107A,A01,083627,Boyle; Mary E. T.,0,4,60,60
1650100161632,COGS 118A,A01,083075,Staff,17,0,60,43
1650100167657,CSE 3,A50,083646,Miranda; Gregory Joseph,22,0,38,16
1650100167657,CSE 3,A51,083647,Miranda; Gregory Joseph,37,0,37,0
1650100173682,CSE 8A,A50,083650,Miranda; Gregory Joseph,0,15,40,40
1650100179706,CSE 11,A01,083080,Cao; Yingjun,0,66,40,40
1650100185729,CSE 12,A01,083652,Staff,0,2,100,100
1650100191756,CSE 15L,A01,083654,Staff,0,0,50,50
1650100191756,CSE 15L,A02,083655,Staff,10,0,50,40
1650100197781,CSE 20,A01,083657,Staff,58,0,80,22
1650100203809,CSE 30,A01,083084,Eldon; John,0,63,40,40
1650100209836,CSE 100,A01,083659,Cao; Yingjun,0,61,50,50
1650100215865,CSE 134B,A01,083661,Powell; Thomas Allan,0,27,65,65
1650100221888,CSE 140,A01,083663,Staff,4,0,75,71
1650100227910,CSE 140L,A01,083088,Eldon; John,0,1,75,75
1650100233932,CSE 175,A01,083665,Kumar; Rakesh,9,0,25,16
1650100239957,CSE 190,A00,092507,Dubnov; Shlomo,14,0,20,6
1650100245986,ECE 45,A01,083139,Staff,0,13,40,40
1650100252014,ECE 65,A50,083695,Staff,0,4,30,30
1650100258038,ECE 109,A01,091882,Touri; Behrouz,48,0,70,22
1650100264067,ECE 180,A00,083140,Abi Samra; Nicholas Camill,24,0,30,6
1650100264067,ECE 180,B00,083141,Abi Samra; Nicholas Camill,8,0,30,22
1650100270095,MATH 10A,A01,083735,Patchell; Gregory David,12,0,30,18
1650100270095,MATH 10A,A02,083736,Patchell; Gregory David,28,0,30,2
1650100270095,MATH 10A,A03,083737,Patchell; Gregory David,26,0,30,4
1650100276128,MATH 10B,A01,083207,Staff,0,5,30,30
1650100276128,MATH 10B,A02,083208,Staff,0,4,30,30
1650100276128,MATH 10B,B01,083739,Staff,18,0,30,12
1650100276128,MATH 10B,B02,083740,Staff,29,0,30,1
1650100282155,MATH 18,A01,083743,Staff,10,0,30,20
1650100282155,MATH 18,A02,083744,Staff,28,0,30,2
1650100282155,MATH 18,A03,083745,Staff,23,0,30,7
1650100282155,MATH 18,A04,083746,Staff,27,0,30,3
1650100282155,MATH 18,B01,083748,Staff,0,9,30,30
1650100282155,MATH 18,B02,083749,Staff,0,6,30,30
1650100282155,MATH 18,B03,083750,Staff,0,6,30,30
1650100282155,MATH 18,B04,083751,Staff,0,6,30,30
1650100288178,MATH 20A,A01,083754,Staff,26,0,40,14
1650100294202,MATH 20B,A01,083756,Staff,0,5,30,30
1650100294202,MATH 20B,A02,083757,Staff,0,2,30,30
1650100300240,MATH 20C,A01,083760,Staff,0,11,30,30
1650100300240,MATH 20C,A02,083761,Staff,0,12,30,30
1650100300240,MATH 20C,B01,083762,Staff,14,0,30,16
1650100300240,MATH 20C,B02,083763,Staff,28,0,30,2
1650100306265,MATH 20D,A01,083765,Staff,0,2,30,30
1650100306265,MATH 20D,A02,083766,Staff,12,0,30,18
1650100306265,MATH 20D,A03,083767,Staff,28,0,30,2
1650100312288,MATH 20E,A01,083771,Staff,10,0,30,20
1650100312288,MATH 20E,A02,083772,Staff,20,0,30,10
1650100312288,MATH 20E,B01,083773,Staff,0,0,30,30
1650100312288,MATH 20E,B02,083774,Staff,13,0,30,17
1650100318312,MATH 103A,A01,083777,Staff,0,8,30,30
1650100318312,MATH 103A,A02,083778,Staff,0,7,30,30
1650100318312,MATH 103A,B01,083779,Staff,0,9,30,30
1650100318312,MATH 103A,B02,083780,Staff,0,6,30,30
1650100324335,MATH 105,A01,085443,Staff,0,13,30,30
1650100330358,MATH 109,A01,083213,Anzaldo; Leesa B,0,3,30,30
1650100330358,MATH 109,A02,083214,Anzaldo; Leesa B,0,5,30,30
1650100330358,MATH 109,B01,083215,Anzaldo; Leesa B,0,4,30,30
1650100330358,MATH 109,B02,083216,Anzaldo; Leesa B,0,4,30,30
1650100336383,MATH 142A,A01,083219,Chow; Bennett,0,10,30,30
1650100336383,MATH 142A,A02,083220,Chow; Bennett,0,10,30,30
1650100336383,MATH 142A,B01,083221,Chow; Bennett,0,10,30,30
1650100336383,MATH 142A,B02,083222,Chow; Bennett,0,9,30,30
1650100342411,MATH 193A,A01,083224,Staff,0,4,30,30
1650100342411,MATH 193A,A02,083225,Staff,0,4,30,30
1650100342411,MATH 193A,A03,083781,Staff,0,0,30,30
1650100342411,MATH 193A,A04,083782,Staff,2,0,30,28
1650100348442,MATH 197,001,091859,McAuley; Julian John,9998,0,9999,1
1650100354493,COGS 9,A01,083615,Staff,0,14,60,60
1650100360517,COGS 11,A01,083617,Boyle; Mary E. T.,24,0,40,16
1650100366541,COGS 13,A01,083071,Staff,0,28,40,40
1650100372565,COGS 14A,A01,092681,Staff,0,10,100,100
1650100378590,COGS 14B,A01,083073,Cheng; Tzu-Han,0,4,50,50
1650100384620,COGS 17,A01,092677,Staff,35,0,75,40
1650100390644,COGS 100,A01,083619,Staff,0,21,60,60
1650100396674,COGS 101A,A01,083621,Davis; Joshua Daniel,0,18,60,60
1650100402701,COGS 101B,A01,091572,Staff,10,0,60,50
1650100408725,COGS 101C,A01,083625,Delgado; Tania,21,0,30,9
1650100414751,COGS 107A,A01,083627,Boyle; Mary E. T.,0,4,60,60
1650100420782,COGS 118A,A01,083075,Staff,17,0,60,43
1650100426808,CSE 3,A50,083646,Miranda; Gregory Joseph,22,0,38,16
1650100426808,CSE 3,A51,083647,Miranda; Gregory Joseph,37,0,37,0
1650100432835,CSE 8A,A50,083650,Miranda; Gregory Joseph,0,15,40,40
1650100438858,CSE 11,A01,083080,Cao; Yingjun,0,66,40,40
1650100444881,CSE 12,A01,083652,Staff,0,2,100,100
1650100450909,CSE 15L,A01,083654,Staff,0,0,50,50
1650100450909,CSE 15L,A02,083655,Staff,10,0,50,40
1650100456936,CSE 20,A01,083657,Staff,58,0,80,22
1650100462963,CSE 30,A01,083084,Eldon; John,0,63,40,40
1650100468992,CSE 100,A01,083659,Cao; Yingjun,0,61,50,50
1650100475019,CSE 134B,A01,083661,Powell; Thomas Allan,0,27,65,65
1650100481043,CSE 140,A01,083663,Staff,4,0,75,71
1650100487067,CSE 140L,A01,083088,Eldon; John,0,1,75,75
1650100493097,CSE 175,A01,083665,Kumar; Rakesh,9,0,25,16
1650100499125,CSE 190,A00,092507,Dubnov; Shlomo,14,0,20,6
1650100505148,ECE 45,A01,083139,Staff,0,13,40,40
1650100511173,ECE 65,A50,083695,Staff,0,4,30,30
1650100517194,ECE 109,A01,091882,Touri; Behrouz,48,0,70,22
1650100523218,ECE 180,A00,083140,Abi Samra; Nicholas Camill,24,0,30,6
1650100523218,ECE 180,B00,083141,Abi Samra; Nicholas Camill,8,0,30,22
1650100529246,MATH 10A,A01,083735,Patchell; Gregory David,12,0,30,18
1650100529246,MATH 10A,A02,083736,Patchell; Gregory David,28,0,30,2
1650100529246,MATH 10A,A03,083737,Patchell; Gregory David,26,0,30,4
1650100535272,MATH 10B,A01,083207,Staff,0,5,30,30
1650100535272,MATH 10B,A02,083208,Staff,0,4,30,30
1650100535272,MATH 10B,B01,083739,Staff,18,0,30,12
1650100535272,MATH 10B,B02,083740,Staff,29,0,30,1
1650100541299,MATH 18,A01,083743,Staff,10,0,30,20
1650100541299,MATH 18,A02,083744,Staff,28,0,30,2
1650100541299,MATH 18,A03,083745,Staff,23,0,30,7
1650100541299,MATH 18,A04,083746,Staff,27,0,30,3
1650100541299,MATH 18,B01,083748,Staff,0,9,30,30
1650100541299,MATH 18,B02,083749,Staff,0,6,30,30
1650100541299,MATH 18,B03,083750,Staff,0,6,30,30
1650100541299,MATH 18,B04,083751,Staff,0,6,30,30
1650100547324,MATH 20A,A01,083754,Staff,26,0,40,14
1650100553347,MATH 20B,A01,083756,Staff,0,5,30,30
1650100553347,MATH 20B,A02,083757,Staff,0,2,30,30
1650100559370,MATH 20C,A01,083760,Staff,0,11,30,30
1650100559370,MATH 20C,A02,083761,Staff,0,12,30,30
1650100559370,MATH 20C,B01,083762,Staff,14,0,30,16
1650100559370,MATH 20C,B02,083763,Staff,28,0,30,2
1650100565399,MATH 20D,A01,083765,Staff,0,2,30,30
1650100565399,MATH 20D,A02,083766,Staff,12,0,30,18
1650100565399,MATH 20D,A03,083767,Staff,28,0,30,2
1650100571426,MATH 20E,A01,083771,Staff,10,0,30,20
1650100571426,MATH 20E,A02,083772,Staff,20,0,30,10
1650100571426,MATH 20E,B01,083773,Staff,0,0,30,30
1650100571426,MATH 20E,B02,083774,Staff,13,0,30,17
1650100577454,MATH 103A,A01,083777,Staff,0,8,30,30
1650100577454,MATH 103A,A02,083778,Staff,0,7,30,30
1650100577454,MATH 103A,B01,083779,Staff,0,9,30,30
1650100577454,MATH 103A,B02,083780,Staff,0,6,30,30
1650100583477,MATH 105,A01,085443,Staff,0,13,30,30
1650100589502,MATH 109,A01,083213,Anzaldo; Leesa B,0,3,30,30
1650100589502,MATH 109,A02,083214,Anzaldo; Leesa B,0,5,30,30
1650100589502,MATH 109,B01,083215,Anzaldo; Leesa B,0,4,30,30
1650100589502,MATH 109,B02,083216,Anzaldo; Leesa B,0,4,30,30
1650100595530,MATH 142A,A01,083219,Chow; Bennett,0,10,30,30
1650100595530,MATH 142A,A02,083220,Chow; Bennett,0,10,30,30
1650100595530,MATH 142A,B01,083221,Chow; Bennett,0,10,30,30
1650100595530,MATH 142A,B02,083222,Chow; Bennett,0,9,30,30
1650100601555,MATH 193A,A01,083224,Staff,0,4,30,30
1650100601555,MATH 193A,A02,083225,Staff,0,4,30,30
1650100601555,MATH 193A,A03,083781,Staff,0,0,30,30
1650100601555,MATH 193A,A04,083782,Staff,2,0,30,28
1650100607581,MATH 197,001,091859,McAuley; Julian John,9998,0,9999,1
1650100613668,COGS 9,A01,083615,Staff,0,14,60,60
1650100619691,COGS 11,A01,083617,Boyle; Mary E. T.,24,0,40,16
1650100625711,COGS 13,A01,083071,Staff,0,28,40,40
1650100631738,COGS 14A,A01,092681,Staff,0,10,100,100
1650100637767,COGS 14B,A01,083073,Cheng; Tzu-Han,0,4,50,50
1650100643794,COGS 17,A01,092677,Staff,35,0,75,40
1650100649816,COGS 100,A01,083619,Staff,0,21,60,60
1650100655840,COGS 101A,A01,083621,Davis; Joshua Daniel,0,18,60,60
1650100661865,COGS 101B,A01,091572,Staff,10,0,60,50
1650100667982,COGS 101C,A01,083625,Delgado; Tania,21,0,30,9
1650100674006,COGS 107A,A01,083627,Boyle; Mary E. T.,0,4,60,60
1650100680029,COGS 118A,A01,083075,Staff,17,0,60,43
1650100686054,CSE 3,A50,083646,Miranda; Gregory Joseph,22,0,38,16
1650100686054,CSE 3,A51,083647,Miranda; Gregory Joseph,37,0,37,0
1650100692081,CSE 8A,A50,083650,Miranda; Gregory Joseph,0,15,40,40
1650100698110,CSE 11,A01,083080,Cao; Yingjun,0,66,40,40
1650100704139,CSE 12,A01,083652,Staff,0,2,100,100
1650100710167,CSE 15L,A01,083654,Staff,0,0,50,50
1650100710167,CSE 15L,A02,083655,Staff,10,0,50,40
1650100716191,CSE 20,A01,083657,Staff,58,0,80,22
1650100722219,CSE 30,A01,083084,Eldon; John,0,63,40,40
1650100728245,CSE 100,A01,083659,Cao; Yingjun,0,61,50,50
1650100734268,CSE 134B,A01,083661,Powell; Thomas Allan,0,27,65,65
1650100740299,CSE 140,A01,083663,Staff,4,0,75,71
1650100746324,CSE 140L,A01,083088,Eldon; John,0,1,75,75
1650100752351,CSE 175,A01,083665,Kumar; Rakesh,9,0,25,16
1650100758381,CSE 190,A00,092507,Dubnov; Shlomo,14,0,20,6
1650100764405,ECE 45,A01,083139,Staff,0,13,40,40
1650100770428,ECE 65,A50,083695,Staff,0,4,30,30
1650100776451,ECE 109,A01,091882,Touri; Behrouz,48,0,70,22
1650100782482,ECE 180,A00,083140,Abi Samra; Nicholas Camill,24,0,30,6
1650100782482,ECE 180,B00,083141,Abi Samra; Nicholas Camill,8,0,30,22
1650100788510,MATH 10A,A01,083735,Patchell; Gregory David,12,0,30,18
1650100788510,MATH 10A,A02,083736,Patchell; Gregory David,28,0,30,2
1650100788510,MATH 10A,A03,083737,Patchell; Gregory David,26,0,30,4
1650100794541,MATH 10B,A01,083207,Staff,0,5,30,30
1650100794541,MATH 10B,A02,083208,Staff,0,4,30,30
1650100794541,MATH 10B,B01,083739,Staff,18,0,30,12
1650100794541,MATH 10B,B02,083740,Staff,29,0,30,1
1650100800572,MATH 18,A01,083743,Staff,10,0,30,20
1650100800572,MATH 18,A02,083744,Staff,28,0,30,2
1650100800572,MATH 18,A03,083745,Staff,23,0,30,7
1650100800572,MATH 18,A04,083746,Staff,27,0,30,3
1650100800572,MATH 18,B01,083748,Staff,0,9,30,30
1650100800572,MATH 18,B02,083749,Staff,0,6,30,30
1650100800572,MATH 18,B03,083750,Staff,0,6,30,30
1650100800572,MATH 18,B04,083751,Staff,0,6,30,30
1650100806595,MATH 20A,A01,083754,Staff,26,0,40,14
1650100812619,MATH 20B,A01,083756,Staff,0,5,30,30
1650100812619,MATH 20B,A02,083757,Staff,0,2,30,30
1650100818644,MATH 20C,A01,083760,Staff,0,11,30,30
1650100818644,MATH 20C,A02,083761,Staff,0,12,30,30
1650100818644,MATH 20C,B01,083762,Staff,14,0,30,16
1650100818644,MATH 20C,B02,083763,Staff,28,0,30,2
1650100824667,MATH 20D,A01,083765,Staff,0,2,30,30
1650100824667,MATH 20D,A02,083766,Staff,12,0,30,18
1650100824667,MATH 20D,A03,083767,Staff,28,0,30,2
1650100830691,MATH 20E,A01,083771,Staff,10,0,30,20
1650100830691,MATH 20E,A02,083772,Staff,20,0,30,10
1650100830691,MATH 20E,B01,083773,Staff,0,0,30,30
1650100830691,MATH 20E,B02,083774,Staff,13,0,30,17
1650100836715,MATH 103A,A01,083777,Staff,0,8,30,30
1650100836715,MATH 103A,A02,083778,Staff,0,7,30,30
1650100836715,MATH 103A,B01,083779,Staff,0,9,30,30
1650100836715,MATH 103A,B02,083780,Staff,0,6,30,30
1650100842738,MATH 105,A01,085443,Staff,0,13,30,30
1650100848766,MATH 109,A01,083213,Anzaldo; Leesa B,0,3,30,30
1650100848766,MATH 109,A02,083214,Anzaldo; Leesa B,0,5,30,30
1650100848766,MATH 109,B01,083215,Anzaldo; Leesa B,0,4,30,30
1650100848766,MATH 109,B02,083216,Anzaldo; Leesa B,0,4,30,30
1650100854790,MATH 142A,A01,083219,Chow; Bennett,0,10,30,30
1650100854790,MATH 142A,A02,083220,Chow; Bennett,0,10,30,30
1650100854790,MATH 142A,B01,083221,Chow; Bennett,0,10,30,30
1650100854790,MATH 142A,B02,083222,Chow; Bennett,0,9,30,30
1650100860813,MATH 193A,A01,083224,Staff,0,4,30,30
1650100860813,MATH 193A,A02,083225,Staff,0,4,30,30
1650100860813,MATH 193A,A03,083781,Staff,0,0,30,30
1650100860813,MATH 193A,A04,083782,Staff,2,0,30,28
1650100866836,MATH 197,001,091859,McAuley; Julian John,9998,0,9999,1
1650100872893,COGS 9,A01,083615,Staff,0,14,60,60
1650100878921,COGS 11,A01,083617,Boyle; Mary E. T.,24,0,40,16
1650100884947,COGS 13,A01,083071,Staff,0,28,40,40
1650100890973,COGS 14A,A01,092681,Staff,0,10,100,100
1650100897000,COGS 14B,A01,083073,Cheng; Tzu-Han,0,4,50,50
1650100903027,COGS 17,A01,092677,Staff,35,0,75,40
1650100909049,COGS 100,A01,083619,Staff,0,21,60,60
1650100915072,COGS 101A,A01,083621,Davis; Joshua Daniel,0,18,60,60
1650100921099,COGS 101B,A01,091572,Staff,10,0,60,50
1650100927123,COGS 101C,A01,083625,Delgado; Tania,21,0,30,9
1650100933147,COGS 107A,A01,083627,Boyle; Mary E. T.,0,4,60,60
1650100939176,COGS 118A,A01,083075,Staff,17,0,60,43
1650100945210,CSE 3,A50,083646,Miranda; Gregory Joseph,22,0,38,16
1650100945210,CSE 3,A51,083647,Miranda; Gregory Joseph,37,0,37,0
1650100951237,CSE 8A,A50,083650,Miranda; Gregory Joseph,0,15,40,40
1650100957260,CSE 11,A01,083080,Cao; Yingjun,0,66,40,40
1650100963284,CSE 12,A01,083652,Staff,0,2,100,100
1650100969308,CSE 15L,A01,083654,Staff,0,0,50,50
1650100969308,CSE 15L,A02,083655,Staff,10,0,50,40
1650100975332,CSE 20,A01,083657,Staff,58,0,80,22
1650100981357,CSE 30,A01,083084,Eldon; John,0,63,40,40
1650100987379,CSE 100,A01,083659,Cao; Yingjun,0,61,50,50
1650100993406,CSE 134B,A01,083661,Powell; Thomas Allan,0,27,65,65
1650100999433,CSE 140,A01,083663,Staff,4,0,75,71
1650101005459,CSE 140L,A01,083088,Eldon; John,0,1,75,75
1650101011486,CSE 175,A01,083665,Kumar; Rakesh,9,0,25,16
1650101017519,CSE 190,A00,092507,Dubnov; Shlomo,14,0,20,6
1650101023542,ECE 45,A01,083139,Staff,0,13,40,40
1650101029569,ECE 65,A50,083695,Staff,0,4,30,30
1650101035594,ECE 109,A01,091882,Touri; Behrouz,48,0,70,22
1650101041620,ECE 180,A00,083140,Abi Samra; Nicholas Camill,24,0,30,6
1650101041620,ECE 180,B00,083141,Abi Samra; Nicholas Camill,8,0,30,22
1650101047645,MATH 10A,A01,083735,Patchell; Gregory David,12,0,30,18
1650101047645,MATH 10A,A02,083736,Patchell; Gregory David,28,0,30,2
1650101047645,MATH 10A,A03,083737,Patchell; Gregory David,26,0,30,4
1650101053667,MATH 10B,A01,083207,Staff,0,5,30,30
1650101053667,MATH 10B,A02,083208,Staff,0,4,30,30
1650101053667,MATH 10B,B01,083739,Staff,18,0,30,12
1650101053667,MATH 10B,B02,083740,Staff,29,0,30,1
1650101059692,MATH 18,A01,083743,Staff,10,0,30,20
1650101059692,MATH 18,A02,083744,Staff,28,0,30,2
1650101059692,MATH 18,A03,083745,Staff,23,0,30,7
1650101059692,MATH 18,A04,083746,Staff,27,0,30,3
1650101059692,MATH 18,B01,083748,Staff,0,9,30,30
1650101059692,MATH 18,B02,083749,Staff,0,6,30,30
1650101059692,MATH 18,B03,083750,Staff,0,6,30,30
1650101059692,MATH 18,B04,083751,Staff,0,6,30,30
1650101065716,MATH 20A,A01,083754,Staff,26,0,40,14
1650101071743,MATH 20B,A01,083756,Staff,0,5,30,30
1650101071743,MATH 20B,A02,083757,Staff,0,2,30,30
1650101077777,MATH 20C,A01,083760,Staff,0,11,30,30
1650101077777,MATH 20C,A02,083761,Staff,0,12,30,30
1650101077777,MATH 20C,B01,083762,Staff,14,0,30,16
1650101077777,MATH 20C,B02,083763,Staff,28,0,30,2
1650101083804,MATH 20D,A01,083765,Staff,0,2,30,30
1650101083804,MATH 20D,A02,083766,Staff,12,0,30,18
1650101083804,MATH 20D,A03,083767,Staff,28,0,30,2
1650101089829,MATH 20E,A01,083771,Staff,10,0,30,20
1650101089829,MATH 20E,A02,083772,Staff,20,0,30,10
1650101089829,MATH 20E,B01,083773,Staff,0,0,30,30
1650101089829,MATH 20E,B02,083774,Staff,13,0,30,17
1650101095859,MATH 103A,A01,083777,Staff,0,8,30,30
1650101095859,MATH 103A,A02,083778,Staff,0,7,30,30
1650101095859,MATH 103A,B01,083779,Staff,0,9,30,30
1650101095859,MATH 103A,B02,083780,Staff,0,6,30,30
1650101101881,MATH 105,A01,085443,Staff,0,13,30,30
1650101107909,MATH 109,A01,083213,Anzaldo; Leesa B,0,3,30,30
1650101107909,MATH 109,A02,083214,Anzaldo; Leesa B,0,5,30,30
1650101107909,MATH 109,B01,083215,Anzaldo; Leesa B,0,4,30,30
1650101107909,MATH 109,B02,083216,Anzaldo; Leesa B,0,4,30,30
1650101113932,MATH 142A,A01,083219,Chow; Bennett,0,10,30,30
1650101113932,MATH 142A,A02,083220,Chow; Bennett,0,10,30,30
1650101113932,MATH 142A,B01,083221,Chow; Bennett,0,10,30,30
1650101113932,MATH 142A,B02,083222,Chow; Bennett,0,9,30,30
1650101119956,MATH 193A,A01,083224,Staff,0,4,30,30
1650101119956,MATH 193A,A02,083225,Staff,0,4,30,30
1650101119956,MATH 193A,A03,083781,Staff,0,0,30,30
1650101119956,MATH 193A,A04,083782,Staff,2,0,30,28
1650101125990,MATH 197,001,091859,McAuley; Julian John,9998,0,9999,1
1650101132042,COGS 9,A01,083615,Staff,0,14,60,60
1650101138069,COGS 11,A01,083617,Boyle; Mary E. T.,24,0,40,16
1650101144092,COGS 13,A01,083071,Staff,0,28,40,40
1650101150119,COGS 14A,A01,092681,Staff,0,10,100,100
1650101156141,COGS 14B,A01,083073,Cheng; Tzu-Han,0,4,50,50
1650101162167,COGS 17,A01,092677,Staff,35,0,75,40
1650101168189,COGS 100,A01,083619,Staff,0,21,60,60
1650101174215,COGS 101A,A01,083621,Davis; Joshua Daniel,0,18,60,60
1650101180238,COGS 101B,A01,091572,Staff,10,0,60,50
1650101186260,COGS 101C,A01,083625,Delgado; Tania,21,0,30,9
1650101192288,COGS 107A,A01,083627,Boyle; Mary E. T.,0,4,60,60
1650101198315,COGS 118A,A01,083075,Staff,17,0,60,43
1650101204338,CSE 3,A50,083646,Miranda; Gregory Joseph,22,0,38,16
1650101204338,CSE 3,A51,083647,Miranda; Gregory Joseph,37,0,37,0
1650101210363,CSE 8A,A50,083650,Miranda; Gregory Joseph,0,15,40,40
1650101216386,CSE 11,A01,083080,Cao; Yingjun,0,66,40,40
1650101222409,CSE 12,A01,083652,Staff,0,2,100,100
1650101228433,CSE 15L,A01,083654,Staff,0,0,50,50
1650101228433,CSE 15L,A02,083655,Staff,10,0,50,40
1650101234459,CSE 20,A01,083657,Staff,58,0,80,22
1650101240483,CSE 30,A01,083084,Eldon; John,0,63,40,40
1650101246510,CSE 100,A01,083659,Cao; Yingjun,0,61,50,50
1650101252538,CSE 134B,A01,083661,Powell; Thomas Allan,0,27,65,65
1650101258565,CSE 140,A01,083663,Staff,4,0,75,71
1650101264675,CSE 140L,A01,083088,Eldon; John,0,1,75,75
1650101270702,CSE 175,A01,083665,Kumar; Rakesh,9,0,25,16
1650101276724,CSE 190,A00,092507,Dubnov; Shlomo,14,0,20,6
1650101282747,ECE 45,A01,083139,Staff,0,13,40,40
1650101288775,ECE 65,A50,083695,Staff,0,4,30,30
1650101294812,ECE 109,A01,091882,Touri; Behrouz,48,0,70,22
1650101300838,ECE 180,A00,083140,Abi Samra; Nicholas Camill,24,0,30,6
1650101300838,ECE 180,B00,083141,Abi Samra; Nicholas Camill,8,0,30,22
1650101306864,MATH 10A,A01,083735,Patchell; Gregory David,12,0,30,18
1650101306864,MATH 10A,A02,083736,Patchell; Gregory David,28,0,30,2
1650101306864,MATH 10A,A03,083737,Patchell; Gregory David,26,0,30,4
1650101312889,MATH 10B,A01,083207,Staff,0,5,30,30
1650101312889,MATH 10B,A02,083208,Staff,0,4,30,30
1650101312889,MATH 10B,B01,083739,Staff,18,0,30,12
1650101312889,MATH 10B,B02,083740,Staff,29,0,30,1
1650101318914,MATH 18,A01,083743,Staff,10,0,30,20
1650101318914,MATH 18,A02,083744,Staff,28,0,30,2
1650101318914,MATH 18,A03,083745,Staff,23,0,30,7
1650101318914,MATH 18,A04,083746,Staff,27,0,30,3
1650101318914,MATH 18,B01,083748,Staff,0,9,30,30
1650101318914,MATH 18,B02,083749,Staff,0,6,30,30
1650101318914,MATH 18,B03,083750,Staff,0,6,30,30
1650101318914,MATH 18,B04,083751,Staff,0,6,30,30
1650101324937,MATH 20A,A01,083754,Staff,26,0,40,14
1650101330965,MATH 20B,A01,083756,Staff,0,5,30,30
1650101330965,MATH 20B,A02,083757,Staff,0,2,30,30
1650101336994,MATH 20C,A01,083760,Staff,0,11,30,30
1650101336994,MATH 20C,A02,083761,Staff,0,12,30,30
1650101336994,MATH 20C,B01,083762,Staff,14,0,30,16
1650101336994,MATH 20C,B02,083763,Staff,28,0,30,2
1650101343019,MATH 20D,A01,083765,Staff,0,2,30,30
1650101343019,MATH 20D,A02,083766,Staff,12,0,30,18
1650101343019,MATH 20D,A03,083767,Staff,28,0,30,2
1650101349042,MATH 20E,A01,083771,Staff,10,0,30,20
1650101349042,MATH 20E,A02,083772,Staff,20,0,30,10
1650101349042,MATH 20E,B01,083773,Staff,0,0,30,30
1650101349042,MATH 20E,B02,083774,Staff,13,0,30,17
1650101355066,MATH 103A,A01,083777,Staff,0,8,30,30
1650101355066,MATH 103A,A02,083778,Staff,0,7,30,30
1650101355066,MATH 103A,B01,083779,Staff,0,9,30,30
1650101355066,MATH 103A,B02,083780,Staff,0,6,30,30
1650101361090,MATH 105,A01,085443,Staff,0,13,30,30
1650101367113,MATH 109,A01,083213,Anzaldo; Leesa B,0,3,30,30
1650101367113,MATH 109,A02,083214,Anzaldo; Leesa B,0,5,30,30
1650101367113,MATH 109,B01,083215,Anzaldo; Leesa B,0,4,30,30
1650101367113,MATH 109,B02,083216,Anzaldo; Leesa B,0,4,30,30
1650101373136,MATH 142A,A01,083219,Chow; Bennett,0,10,30,30
1650101373136,MATH 142A,A02,083220,Chow; Bennett,0,10,30,30
1650101373136,MATH 142A,B01,083221,Chow; Bennett,0,10,30,30
1650101373136,MATH 142A,B02,083222,Chow; Bennett,0,9,30,30
1650101379163,MATH 193A,A01,083224,Staff,0,4,30,30
1650101379163,MATH 193A,A02,083225,Staff,0,4,30,30
1650101379163,MATH 193A,A03,083781,Staff,0,0,30,30
1650101379163,MATH 193A,A04,083782,Staff,2,0,30,28
1650101385188,MATH 197,001,091859,McAuley; Julian John,9998,0,9999,1
1650101391250,COGS 9,A01,083615,Staff,0,14,60,60
1650101397278,COGS 11,A01,083617,Boyle; Mary E. T.,24,0,40,16
1650101403301,COGS 13,A01,083071,Staff,0,28,40,40
1650101409324,COGS 14A,A01,092681,Staff,0,10,100,100
1650101415346,COGS 14B,A01,083073,Cheng; Tzu-Han,0,4,50,50
1650101421372,COGS 17,A01,092677,Staff,35,0,75,40
1650101427399,COGS 100,A01,083619,Staff,0,21,60,60
1650101433423,COGS 101A,A01,083621,Davis; Joshua Daniel,0,18,60,60
1650101439446,COGS 101B,A01,091572,Staff,10,0,60,50
1650101445469,COGS 101C,A01,083625,Delgado; Tania,21,0,30,9
1650101451495,COGS 107A,A01,083627,Boyle; Mary E. T.,0,4,60,60
1650101457519,COGS 118A,A01,083075,Staff,17,0,60,43
1650101463552,CSE 3,A50,083646,Miranda; Gregory Joseph,22,0,38,16
1650101463552,CSE 3,A51,083647,Miranda; Gregory Joseph,37,0,37,0
1650101469576,CSE 8A,A50,083650,Miranda; Gregory Joseph,0,15,40,40
1650101475599,CSE 11,A01,083080,Cao; Yingjun,0,66,40,40
1650101481622,CSE 12,A01,083652,Staff,0,2,100,100
1650101487659,CSE 15L,A01,083654,Staff,0,0,50,50
1650101487659,CSE 15L,A02,083655,Staff,10,0,50,40
1650101493686,CSE 20,A01,083657,Staff,58,0,80,22
1650101499709,CSE 30,A01,083084,Eldon; John,0,63,40,40
1650101505736,CSE 100,A01,083659,Cao; Yingjun,0,61,50,50
1650101511764,CSE 134B,A01,083661,Powell; Thomas Allan,0,27,65,65
1650101517786,CSE 140,A01,083663,Staff,4,0,75,71
1650101523814,CSE 140L,A01,083088,Eldon; John,0,1,75,75
1650101529838,CSE 175,A01,083665,Kumar; Rakesh,9,0,25,16
1650101535863,CSE 190,A00,092507,Dubnov; Shlomo,14,0,20,6
1650101541891,ECE 45,A01,083139,Staff,0,13,40,40
1650101547920,ECE 65,A50,083695,Staff,0,4,30,30
1650101553962,ECE 109,A01,091882,Touri; Behrouz,48,0,70,22
1650101559989,ECE 180,A00,083140,Abi Samra; Nicholas Camill,24,0,30,6
1650101559989,ECE 180,B00,083141,Abi Samra; Nicholas Camill,8,0,30,22
1650101566018,MATH 10A,A01,083735,Patchell; Gregory David,12,0,30,18
1650101566018,MATH 10A,A02,083736,Patchell; Gregory David,28,0,30,2
1650101566018,MATH 10A,A03,083737,Patchell; Gregory David,26,0,30,4
1650101572045,MATH 10B,A01,083207,Staff,0,5,30,30
1650101572045,MATH 10B,A02,083208,Staff,0,4,30,30
1650101572045,MATH 10B,B01,083739,Staff,18,0,30,12
1650101572045,MATH 10B,B02,083740,Staff,29,0,30,1
1650101578069,MATH 18,A01,083743,Staff,10,0,30,20
1650101578069,MATH 18,A02,083744,Staff,28,0,30,2
1650101578069,MATH 18,A03,083745,Staff,23,0,30,7
1650101578069,MATH 18,A04,083746,Staff,27,0,30,3
1650101578069,MATH 18,B01,083748,Staff,0,9,30,30
1650101578069,MATH 18,B02,083749,Staff,0,6,30,30
1650101578069,MATH 18,B03,083750,Staff,0,6,30,30
1650101578069,MATH 18,B04,083751,Staff,0,6,30,30
1650101584093,MATH 20A,A01,083754,Staff,26,0,40,14
1650101590117,MATH 20B,A01,083756,Staff,0,5,30,30
1650101590117,MATH 20B,A02,083757,Staff,0,2,30,30
1650101596144,MATH 20C,A01,083760,Staff,0,11,30,30
1650101596144,MATH 20C,A02,083761,Staff,0,12,30,30
1650101596144,MATH 20C,B01,083762,Staff,14,0,30,16
1650101596144,MATH 20C,B02,083763,Staff,28,0,30,2
1650101602173,MATH 20D,A01,083765,Staff,0,2,30,30
1650101602173,MATH 20D,A02,083766,Staff,12,0,30,18
1650101602173,MATH 20D,A03,083767,Staff,28,0,30,2
1650101608199,MATH 20E,A01,083771,Staff,10,0,30,20
1650101608199,MATH 20E,A02,083772,Staff,20,0,30,10
1650101608199,MATH 20E,B01,083773,Staff,0,0,30,30
1650101608199,MATH 20E,B02,083774,Staff,13,0,30,17
1650101614224,MATH 103A,A01,083777,Staff,0,8,30,30
1650101614224,MATH 103A,A02,083778,Staff,0,7,30,30
1650101614224,MATH 103A,B01,083779,Staff,0,9,30,30
1650101614224,MATH 103A,B02,083780,Staff,0,6,30,30
1650101620246,MATH 105,A01,085443,Staff,0,13,30,30
1650101626272,MATH 109,A01,083213,Anzaldo; Leesa B,0,3,30,30
1650101626272,MATH 109,A02,083214,Anzaldo; Leesa B,0,5,30,30
1650101626272,MATH 109,B01,083215,Anzaldo; Leesa B,0,4,30,30
1650101626272,MATH 109,B02,083216,Anzaldo; Leesa B,0,4,30,30
1650101632300,MATH 142A,A01,083219,Chow; Bennett,0,10,30,30
1650101632300,MATH 142A,A02,083220,Chow; Bennett,0,10,30,30
1650101632300,MATH 142A,B01,083221,Chow; Bennett,0,10,30,30
1650101632300,MATH 142A,B02,083222,Chow; Bennett,0,9,30,30
1650101638326,MATH 193A,A01,083224,Staff,0,4,30,30
1650101638326,MATH 193A,A02,083225,Staff,0,4,30,30
1650101638326,MATH 193A,A03,083781,Staff,0,0,30,30
1650101638326,MATH 193A,A04,083782,Staff,2,0,30,28
1650101644353,MATH 197,001,091859,McAuley; Julian John,9998,0,9999,1
1650101650406,COGS 9,A01,083615,Staff,0,14,60,60
1650101656430,COGS 11,A01,083617,Boyle; Mary E. T.,24,0,40,16
1650101662454,COGS 13,A01,083071,Staff,0,28,40,40
1650101668486,COGS 14A,A01,092681,Staff,0,10,100,100
1650101674510,COGS 14B,A01,083073,Cheng; Tzu-Han,0,4,50,50
1650101680538,COGS 17,A01,092677,Staff,35,0,75,40
1650101686559,COGS 100,A01,083619,Staff,0,21,60,60
1650101692586,COGS 101A,A01,083621,Davis; Joshua Daniel,0,18,60,60
1650101698611,COGS 101B,A01,091572,Staff,10,0,60,50
1650101704633,COGS 101C,A01,083625,Delgado; Tania,21,0,30,9
1650101710659,COGS 107A,A01,083627,Boyle; Mary E. T.,0,4,60,60
1650101716682,COGS 118A,A01,083075,Staff,17,0,60,43
1650101722711,CSE 3,A50,083646,Miranda; Gregory Joseph,22,0,38,16
1650101722711,CSE 3,A51,083647,Miranda; Gregory Joseph,37,0,37,0
1650101728734,CSE 8A,A50,083650,Miranda; Gregory Joseph,0,15,40,40
1650101734759,CSE 11,A01,083080,Cao; Yingjun,0,66,40,40
1650101740784,CSE 12,A01,083652,Staff,0,2,100,100
1650101746812,CSE 15L,A01,083654,Staff,0,0,50,50
1650101746812,CSE 15L,A02,083655,Staff,10,0,50,40
1650101752835,CSE 20,A01,083657,Staff,58,0,80,22
1650101758858,CSE 30,A01,083084,Eldon; John,0,63,40,40
1650101764897,CSE 100,A01,083659,Cao; Yingjun,0,61,50,50
1650101770919,CSE 134B,A01,083661,Powell; Thomas Allan,0,27,65,65
1650101776950,CSE 140,A01,083663,Staff,4,0,75,71
1650101782975,CSE 140L,A01,083088,Eldon; John,0,1,75,75
1650101789007,CSE 175,A01,083665,Kumar; Rakesh,9,0,25,16
1650101795030,CSE 190,A00,092507,Dubnov; Shlomo,14,0,20,6
1650101801054,ECE 45,A01,083139,Staff,0,13,40,40
1650101807079,ECE 65,A50,083695,Staff,0,4,30,30
1650101813102,ECE 109,A01,091882,Touri; Behrouz,48,0,70,22
1650101819128,ECE 180,A00,083140,Abi Samra; Nicholas Camill,24,0,30,6
1650101819128,ECE 180,B00,083141,Abi Samra; Nicholas Camill,8,0,30,22
1650101825153,MATH 10A,A01,083735,Patchell; Gregory David,12,0,30,18
1650101825153,MATH 10A,A02,083736,Patchell; Gregory David,28,0,30,2
1650101825153,MATH 10A,A03,083737,Patchell; Gregory David,26,0,30,4
1650101831177,MATH 10B,A01,083207,Staff,0,5,30,30
1650101831177,MATH 10B,A02,083208,Staff,0,4,30,30
1650101831177,MATH 10B,B01,083739,Staff,18,0,30,12
1650101831177,MATH 10B,B02,083740,Staff,29,0,30,1
1650101837203,MATH 18,A01,083743,Staff,10,0,30,20
1650101837203,MATH 18,A02,083744,Staff,28,0,30,2
1650101837203,MATH 18,A03,083745,Staff,23,0,30,7
1650101837203,MATH 18,A04,083746,Staff,27,0,30,3
1650101837203,MATH 18,B01,083748,Staff,0,9,30,30
1650101837203,MATH 18,B02,083749,Staff,0,6,30,30
1650101837203,MATH 18,B03,083750,Staff,0,6,30,30
1650101837203,MATH 18,B04,083751,Staff,0,6,30,30
1650101843228,MATH 20A,A01,083754,Staff,26,0,40,14
1650101849251,MATH 20B,A01,083756,Staff,0,5,30,30
1650101849251,MATH 20B,A02,083757,Staff,0,2,30,30
1650101855280,MATH 20C,A01,083760,Staff,0,11,30,30
1650101855280,MATH 20C,A02,083761,Staff,0,12,30,30
1650101855280,MATH 20C,B01,083762,Staff,14,0,30,16
1650101855280,MATH 20C,B02,083763,Staff,28,0,30,2
1650101861400,MATH 20D,A01,083765,Staff,0,2,30,30
1650101861400,MATH 20D,A02,083766,Staff,12,0,30,18
1650101861400,MATH 20D,A03,083767,Staff,28,0,30,2
1650101867424,MATH 20E,A01,083771,Staff,10,0,30,20
1650101867424,MATH 20E,A02,083772,Staff,20,0,30,10
1650101867424,MATH 20E,B01,083773,Staff,0,0,30,30
1650101867424,MATH 20E,B02,083774,Staff,13,0,30,17
1650101873450,MATH 103A,A01,083777,Staff,0,8,30,30
1650101873450,MATH 103A,A02,083778,Staff,0,7,30,30
1650101873450,MATH 103A,B01,083779,Staff,0,9,30,30
1650101873450,MATH 103A,B02,083780,Staff,0,6,30,30
1650101879476,MATH 105,A01,085443,Staff,0,13,30,30
1650101885502,MATH 109,A01,083213,Anzaldo; Leesa B,0,3,30,30
1650101885502,MATH 109,A02,083214,Anzaldo; Leesa B,0,5,30,30
1650101885502,MATH 109,B01,083215,Anzaldo; Leesa B,0,4,30,30
1650101885502,MATH 109,B02,083216,Anzaldo; Leesa B,0,4,30,30
1650101891526,MATH 142A,A01,083219,Chow; Bennett,0,10,30,30
1650101891526,MATH 142A,A02,083220,Chow; Bennett,0,10,30,30
1650101891526,MATH 142A,B01,083221,Chow; Bennett,0,10,30,30
1650101891526,MATH 142A,B02,083222,Chow; Bennett,0,9,30,30
1650101897548,MATH 193A,A01,083224,Staff,0,4,30,30
1650101897548,MATH 193A,A02,083225,Staff,0,4,30,30
1650101897548,MATH 193A,A03,083781,Staff,0,0,30,30
1650101897548,MATH 193A,A04,083782,Staff,2,0,30,28
1650101903575,MATH 197,001,091859,McAuley; Julian John,9998,0,9999,1
1650101909622,COGS 9,A01,083615,Staff,0,14,60,60
1650101915644,COGS 11,A01,083617,Boyle; Mary E. T.,24,0,40,16
1650101921667,COGS 13,A01,083071,Staff,0,28,40,40
1650101927693,COGS 14A,A01,092681,Staff,0,10,100,100
1650101933718,COGS 14B,A01,083073,Cheng; Tzu-Han,0,4,50,50
1650101939741,COGS 17,A01,092677,Staff,35,0,75,40
1650101945768,COGS 100,A01,083619,Staff,0,21,60,60
1650101951792,COGS 101A,A01,083621,Davis; Joshua Daniel,0,18,60,60
1650101957817,COGS 101B,A01,091572,Staff,10,0,60,50
1650101963840,COGS 101C,A01,083625,Delgado; Tania,21,0,30,9
1650101969864,COGS 107A,A01,083627,Boyle; Mary E. T.,0,4,60,60
1650101975887,COGS 118A,A01,083075,Staff,17,0,60,43
1650101981915,CSE 3,A50,083646,Miranda; Gregory Joseph,22,0,38,16
1650101981915,CSE 3,A51,083647,Miranda; Gregory Joseph,37,0,37,0
1650101987938,CSE 8A,A50,083650,Miranda; Gregory Joseph,0,15,40,40
1650101993962,CSE 11,A01,083080,Cao; Yingjun,0,66,40,40
1650101999985,CSE 12,A01,083652,Staff,0,2,100,100
1650102006012,CSE 15L,A01,083654,Staff,0,0,50,50
1650102006012,CSE 15L,A02,083655,Staff,10,0,50,40
1650102012037,CSE 20,A01,083657,Staff,58,0,80,22
1650102018060,CSE 30,A01,083084,Eldon; John,0,63,40,40
1650102024087,CSE 100,A01,083659,Cao; Yingjun,0,61,50,50
1650102030112,CSE 134B,A01,083661,Powell; Thomas Allan,0,27,65,65
1650102036137,CSE 140,A01,083663,Staff,4,0,75,71
1650102042160,CSE 140L,A01,083088,Eldon; John,0,1,75,75
1650102048187,CSE 175,A01,083665,Kumar; Rakesh,9,0,25,16
1650102054209,CSE 190,A00,092507,Dubnov; Shlomo,14,0,20,6
1650102060232,ECE 45,A01,083139,Staff,0,13,40,40
1650102066255,ECE 65,A50,083695,Staff,0,4,30,30
1650102072280,ECE 109,A01,091882,Touri; Behrouz,48,0,70,22
1650102078303,ECE 180,A00,083140,Abi Samra; Nicholas Camill,24,0,30,6
1650102078303,ECE 180,B00,083141,Abi Samra; Nicholas Camill,8,0,30,22
1650102084349,MATH 10A,A01,083735,Patchell; Gregory David,12,0,30,18
1650102084349,MATH 10A,A02,083736,Patchell; Gregory David,28,0,30,2
1650102084349,MATH 10A,A03,083737,Patchell; Gregory David,26,0,30,4
1650102090373,MATH 10B,A01,083207,Staff,0,5,30,30
1650102090373,MATH 10B,A02,083208,Staff,0,4,30,30
1650102090373,MATH 10B,B01,083739,Staff,18,0,30,12
1650102090373,MATH 10B,B02,083740,Staff,29,0,30,1
1650102096398,MATH 18,A01,083743,Staff,10,0,30,20
1650102096398,MATH 18,A02,083744,Staff,28,0,30,2
1650102096398,MATH 18,A03,083745,Staff,23,0,30,7
1650102096398,MATH 18,A04,083746,Staff,27,0,30,3
1650102096398,MATH 18,B01,083748,Staff,0,9,30,30
1650102096398,MATH 18,B02,083749,Staff,0,6,30,30
1650102096398,MATH 18,B03,083750,Staff,0,6,30,30
1650102096398,MATH 18,B04,083751,Staff,0,6,30,30
1650102102424,MATH 20A,A01,083754,Staff,26,0,40,14
1650102108448,MATH 20B,A01,083756,Staff,0,5,30,30
1650102108448,MATH 20B,A02,083757,Staff,0,2,30,30
1650102114478,MATH 20C,A01,083760,Staff,0,11,30,30
1650102114478,MATH 20C,A02,083761,Staff,0,12,30,30
1650102114478,MATH 20C,B01,083762,Staff,14,0,30,16
1650102114478,MATH 20C,B02,083763,Staff,28,0,30,2
1650102120502,MATH 20D,A01,083765,Staff,0,2,30,30
1650102120502,MATH 20D,A02,083766,Staff,12,0,30,18
1650102120502,MATH 20D,A03,083767,Staff,28,0,30,2
1650102126528,MATH 20E,A01,083771,Staff,10,0,30,20
1650102126528,MATH 20E,A02,083772,Staff,20,0,30,10
1650102126528,MATH 20E,B01,083773,Staff,0,0,30,30
1650102126528,MATH 20E,B02,083774,Staff,13,0,30,17
1650102132560,MATH 103A,A01,083777,Staff,0,8,30,30
1650102132560,MATH 103A,A02,083778,Staff,0,7,30,30
1650102132560,MATH 103A,B01,083779,Staff,0,9,30,30
1650102132560,MATH 103A,B02,083780,Staff,0,6,30,30
1650102138582,MATH 105,A01,085443,Staff,0,13,30,30
1650102144610,MATH 109,A01,083213,Anzaldo; Leesa B,0,3,30,30
1650102144610,MATH 109,A02,083214,Anzaldo; Leesa B,0,5,30,30
1650102144610,MATH 109,B01,083215,Anzaldo; Leesa B,0,4,30,30
1650102144610,MATH 109,B02,083216,Anzaldo; Leesa B,0,4,30,30
1650102150635,MATH 142A,A01,083219,Chow; Bennett,0,10,30,30
1650102150635,MATH 142A,A02,083220,Chow; Bennett,0,10,30,30
1650102150635,MATH 142A,B01,083221,Chow; Bennett,0,10,30,30
1650102150635,MATH 142A,B02,083222,Chow; Bennett,0,9,30,30
1650102156660,MATH 193A,A01,083224,Staff,0,4,30,30
1650102156660,MATH 193A,A02,083225,Staff,0,4,30,30
1650102156660,MATH 193A,A03,083781,Staff,0,0,30,30
1650102156660,MATH 193A,A04,083782,Staff,2,0,30,28
1650102162686,MATH 197,001,091859,McAuley; Julian John,9998,0,9999,1
1650102168752,COGS 9,A01,083615,Staff,0,14,60,60
1650102174775,COGS 11,A01,083617,Boyle; Mary E. T.,24,0,40,16
1650102180801,COGS 13,A01,083071,Staff,0,28,40,40
1650102186826,COGS 14A,A01,092681,Staff,0,10,100,100
1650102192849,COGS 14B,A01,083073,Cheng; Tzu-Han,0,4,50,50
1650102198871,COGS 17,A01,092677,Staff,35,0,75,40
1650102204898,COGS 100,A01,083619,Staff,0,21,60,60
1650102210921,COGS 101A,A01,083621,Davis; Joshua Daniel,0,18,60,60
1650102216946,COGS 101B,A01,091572,Staff,10,0,60,50
1650102222972,COGS 101C,A01,083625,Delgado; Tania,21,0,30,9
1650102229007,COGS 107A,A01,083627,Boyle; Mary E. T.,0,4,60,60
1650102235028,COGS 118A,A01,083075,Staff,17,0,60,43
1650102241052,CSE 3,A50,083646,Miranda; Gregory Joseph,22,0,38,16
1650102241052,CSE 3,A51,083647,Miranda; Gregory Joseph,37,0,37,0
1650102247075,CSE 8A,A50,083650,Miranda; Gregory Joseph,0,15,40,40
1650102253097,CSE 11,A01,083080,Cao; Yingjun,0,66,40,40
1650102259123,CSE 12,A01,083652,Staff,0,2,100,100
1650102265148,CSE 15L,A01,083654,Staff,0,0,50,50
1650102265148,CSE 15L,A02,083655,Staff,10,0,50,40
1650102271173,CSE 20,A01,083657,Staff,58,0,80,22
1650102277199,CSE 30,A01,083084,Eldon; John,0,63,40,40
1650102283229,CSE 100,A01,083659,Cao; Yingjun,0,61,50,50
1650102289252,CSE 134B,A01,083661,Powell; Thomas Allan,0,27,65,65
1650102295276,CSE 140,A01,083663,Staff,4,0,75,71
1650102301308,CSE 140L,A01,083088,Eldon; John,0,1,75,75
1650102307329,CSE 175,A01,083665,Kumar; Rakesh,8,0,25,17
1650102313352,CSE 190,A00,092507,Dubnov; Shlomo,14,0,20,6
1650102319378,ECE 45,A01,083139,Staff,0,13,40,40
1650102325402,ECE 65,A50,083695,Staff,0,4,30,30
1650102331426,ECE 109,A01,091882,Touri; Behrouz,48,0,70,22
1650102337450,ECE 180,A00,083140,Abi Samra; Nicholas Camill,24,0,30,6
1650102337450,ECE 180,B00,083141,Abi Samra; Nicholas Camill,8,0,30,22
1650102343477,MATH 10A,A01,083735,Patchell; Gregory David,12,0,30,18
1650102343477,MATH 10A,A02,083736,Patchell; Gregory David,28,0,30,2
1650102343477,MATH 10A,A03,083737,Patchell; Gregory David,26,0,30,4
1650102349501,MATH 10B,A01,083207,Staff,0,5,30,30
1650102349501,MATH 10B,A02,083208,Staff,0,4,30,30
1650102349501,MATH 10B,B01,083739,Staff,18,0,30,12
1650102349501,MATH 10B,B02,083740,Staff,29,0,30,1
1650102355525,MATH 18,A01,083743,Staff,10,0,30,20
1650102355525,MATH 18,A02,083744,Staff,28,0,30,2
1650102355525,MATH 18,A03,083745,Staff,23,0,30,7
1650102355525,MATH 18,A04,083746,Staff,27,0,30,3
1650102355525,MATH 18,B01,083748,Staff,0,9,30,30
1650102355525,MATH 18,B02,083749,Staff,0,6,30,30
1650102355525,MATH 18,B03,083750,Staff,0,6,30,30
1650102355525,MATH 18,B04,083751,Staff,0,6,30,30
1650102361548,MATH 20A,A01,083754,Staff,26,0,40,14
1650102367573,MATH 20B,A01,083756,Staff,0,5,30,30
1650102367573,MATH 20B,A02,083757,Staff,0,2,30,30
1650102373597,MATH 20C,A01,083760,Staff,0,11,30,30
1650102373597,MATH 20C,A02,083761,Staff,0,12,30,30
1650102373597,MATH 20C,B01,083762,Staff,14,0,30,16
1650102373597,MATH 20C,B02,083763,Staff,28,0,30,2
1650102379624,MATH 20D,A01,083765,Staff,0,2,30,30
1650102379624,MATH 20D,A02,083766,Staff,12,0,30,18
1650102379624,MATH 20D,A03,083767,Staff,28,0,30,2
1650102385649,MATH 20E,A01,083771,Staff,10,0,30,20
1650102385649,MATH 20E,A02,083772,Staff,20,0,30,10
1650102385649,MATH 20E,B01,083773,Staff,0,0,30,30
1650102385649,MATH 20E,B02,083774,Staff,13,0,30,17
1650102391674,MATH 103A,A01,083777,Staff,0,8,30,30
1650102391674,MATH 103A,A02,083778,Staff,0,7,30,30
1650102391674,MATH 103A,B01,083779,Staff,0,9,30,30
1650102391674,MATH 103A,B02,083780,Staff,0,6,30,30
1650102397698,MATH 105,A01,085443,Staff,0,13,30,30
1650102403722,MATH 109,A01,083213,Anzaldo; Leesa B,0,3,30,30
1650102403722,MATH 109,A02,083214,Anzaldo; Leesa B,0,5,30,30
1650102403722,MATH 109,B01,083215,Anzaldo; Leesa B,0,4,30,30
1650102403722,MATH 109,B02,083216,Anzaldo; Leesa B,0,4,30,30
1650102409746,MATH 142A,A01,083219,Chow; Bennett,0,10,30,30
1650102409746,MATH 142A,A02,083220,Chow; Bennett,0,10,30,30
1650102409746,MATH 142A,B01,083221,Chow; Bennett,0,10,30,30
1650102409746,MATH 142A,B02,083222,Chow; Bennett,0,9,30,30
1650102415770,MATH 193A,A01,083224,Staff,0,4,30,30
1650102415770,MATH 193A,A02,083225,Staff,0,4,30,30
1650102415770,MATH 193A,A03,083781,Staff,0,0,30,30
1650102415770,MATH 193A,A04,083782,Staff,2,0,30,28
1650102421795,MATH 197,001,091859,McAuley; Julian John,9998,0,9999,1
1650102427854,COGS 9,A01,083615,Staff,0,14,60,60
1650102433877,COGS 11,A01,083617,Boyle; Mary E. T.,24,0,40,16
1650102439901,COGS 13,A01,083071,Staff,0,28,40,40
1650102445924,COGS 14A,A01,092681,Staff,0,10,100,100
1650102452036,COGS 14B,A01,083073,Cheng; Tzu-Han,0,4,50,50
1650102458062,COGS 17,A01,092677,Staff,35,0,75,40
1650102464085,COGS 100,A01,083619,Staff,0,21,60,60
1650102470112,COGS 101A,A01,083621,Davis; Joshua Daniel,0,18,60,60
1650102476138,COGS 101B,A01,091572,Staff,10,0,60,50
1650102482163,COGS 101C,A01,083625,Delgado; Tania,22,0,30,8
1650102488186,COGS 107A,A01,083627,Boyle; Mary E. T.,0,4,60,60
1650102494209,COGS 118A,A01,083075,Staff,17,0,60,43
1650102500232,CSE 3,A50,083646,Miranda; Gregory Joseph,22,0,38,16
1650102500232,CSE 3,A51,083647,Miranda; Gregory Joseph,37,0,37,0
1650102506259,CSE 8A,A50,083650,Miranda; Gregory Joseph,0,15,40,40
1650102512281,CSE 11,A01,083080,Cao; Yingjun,0,66,40,40
1650102518303,CSE 12,A01,083652,Staff,0,2,100,100
1650102524328,CSE 15L,A01,083654,Staff,0,0,50,50
1650102524328,CSE 15L,A02,083655,Staff,10,0,50,40
1650102530350,CSE 20,A01,083657,Staff,58,0,80,22
1650102536411,CSE 30,A01,083084,Eldon; John,0,63,40,40
1650102542434,CSE 100,A01,083659,Cao; Yingjun,0,61,50,50
1650102548490,CSE 134B,A01,083661,Powell; Thomas Allan,0,27,65,65
1650102554515,CSE 140,A01,083663,Staff,4,0,75,71
1650102560538,CSE 140L,A01,083088,Eldon; John,0,1,75,75
1650102566559,CSE 175,A01,083665,Kumar; Rakesh,8,0,25,17
1650102572583,CSE 190,A00,092507,Dubnov; Shlomo,14,0,20,6
1650102578605,ECE 45,A01,083139,Staff,0,13,40,40
1650102584632,ECE 65,A50,083695,Staff,0,4,30,30
1650102590658,ECE 109,A01,091882,Touri; Behrouz,48,0,70,22
1650102596684,ECE 180,A00,083140,Abi Samra; Nicholas Camill,24,0,30,6
1650102596684,ECE 180,B00,083141,Abi Samra; Nicholas Camill,8,0,30,22
1650102602709,MATH 10A,A01,083735,Patchell; Gregory David,12,0,30,18
1650102602709,MATH 10A,A02,083736,Patchell; Gregory David,28,0,30,2
1650102602709,MATH 10A,A03,083737,Patchell; Gregory David,26,0,30,4
1650102608737,MATH 10B,A01,083207,Staff,0,5,30,30
1650102608737,MATH 10B,A02,083208,Staff,0,4,30,30
1650102608737,MATH 10B,B01,083739,Staff,18,0,30,12
1650102608737,MATH 10B,B02,083740,Staff,29,0,30,1
1650102614768,MATH 18,A01,083743,Staff,10,0,30,20
1650102614768,MATH 18,A02,083744,Staff,28,0,30,2
1650102614768,MATH 18,A03,083745,Staff,23,0,30,7
1650102614768,MATH 18,A04,083746,Staff,27,0,30,3
1650102614768,MATH 18,B01,083748,Staff,0,9,30,30
1650102614768,MATH 18,B02,083749,Staff,0,6,30,30
1650102614768,MATH 18,B03,083750,Staff,0,6,30,30
1650102614768,MATH 18,B04,083751,Staff,0,6,30,30
1650102620791,MATH 20A,A01,083754,Staff,26,0,40,14
1650102626813,MATH 20B,A01,083756,Staff,0,5,30,30
1650102626813,MATH 20B,A02,083757,Staff,0,2,30,30
1650102632836,MATH 20C,A01,083760,Staff,0,11,30,30
1650102632836,MATH 20C,A02,083761,Staff,0,12,30,30
1650102632836,MATH 20C,B01,083762,Staff,14,0,30,16
1650102632836,MATH 20C,B02,083763,Staff,28,0,30,2
1650102638863,MATH 20D,A01,083765,Staff,0,2,30,30
1650102638863,MATH 20D,A02,083766,Staff,12,0,30,18
1650102638863,MATH 20D,A03,083767,Staff,28,0,30,2
1650102644890,MATH 20E,A01,083771,Staff,10,0,30,20
1650102644890,MATH 20E,A02,083772,Staff,20,0,30,10
1650102644890,MATH 20E,B01,083773,Staff,0,0,30,30
1650102644890,MATH 20E,B02,083774,Staff,13,0,30,17
1650102650918,MATH 103A,A01,083777,Staff,0,8,30,30
1650102650918,MATH 103A,A02,083778,Staff,0,7,30,30
1650102650918,MATH 103A,B01,083779,Staff,0,9,30,30
1650102650918,MATH 103A,B02,083780,Staff,0,6,30,30
1650102656941,MATH 105,A01,085443,Staff,0,13,30,30
1650102662966,MATH 109,A01,083213,Anzaldo; Leesa B,0,3,30,30
1650102662966,MATH 109,A02,083214,Anzaldo; Leesa B,0,5,30,30
1650102662966,MATH 109,B01,083215,Anzaldo; Leesa B,0,4,30,30
1650102662966,MATH 109,B02,083216,Anzaldo; Leesa B,0,4,30,30
1650102668990,MATH 142A,A01,083219,Chow; Bennett,0,10,30,30
1650102668990,MATH 142A,A02,083220,Chow; Bennett,0,10,30,30
1650102668990,MATH 142A,B01,083221,Chow; Bennett,0,10,30,30
1650102668990,MATH 142A,B02,083222,Chow; Bennett,0,9,30,30
1650102675016,MATH 193A,A01,083224,Staff,0,4,30,30
1650102675016,MATH 193A,A02,083225,Staff,0,4,30,30
1650102675016,MATH 193A,A03,083781,Staff,0,0,30,30
1650102675016,MATH 193A,A04,083782,Staff,2,0,30,28
1650102681043,MATH 197,001,091859,McAuley; Julian John,9998,0,9999,1
1650102687099,COGS 9,A01,083615,Staff,0,14,60,60
1650102693130,COGS 11,A01,083617,Boyle; Mary E. T.,24,0,40,16
1650102699153,COGS 13,A01,083071,Staff,0,28,40,40
1650102705177,COGS 14A,A01,092681,Staff,0,10,100,100
1650102711212,COGS 14B,A01,083073,Cheng; Tzu-Han,0,4,50,50
1650102717235,COGS 17,A01,092677,Staff,35,0,75,40
1650102723257,COGS 100,A01,083619,Staff,0,21,60,60
1650102729284,COGS 101A,A01,083621,Davis; Joshua Daniel,0,18,60,60
1650102735317,COGS 101B,A01,091572,Staff,10,0,60,50
1650102741340,COGS 101C,A01,083625,Delgado; Tania,22,0,30,8
1650102747363,COGS 107A,A01,083627,Boyle; Mary E. T.,0,4,60,60
1650102753387,COGS 118A,A01,083075,Staff,17,0,60,43
1650102759412,CSE 3,A50,083646,Miranda; Gregory Joseph,22,0,38,16
1650102759412,CSE 3,A51,083647,Miranda; Gregory Joseph,37,0,37,0
1650102765450,CSE 8A,A50,083650,Miranda; Gregory Joseph,0,15,40,40
1650102771476,CSE 11,A01,083080,Cao; Yingjun,0,66,40,40
1650102777502,CSE 12,A01,083652,Staff,0,2,100,100
1650102783525,CSE 15L,A01,083654,Staff,0,0,50,50
1650102783525,CSE 15L,A02,083655,Staff,10,0,50,40
1650102789548,CSE 20,A01,083657,Staff,58,0,80,22
1650102795571,CSE 30,A01,083084,Eldon; John,0,63,40,40
1650102801603,CSE 100,A01,083659,Cao; Yingjun,0,61,50,50
1650102807630,CSE 134B,A01,083661,Powell; Thomas Allan,0,27,65,65
1650102813653,CSE 140,A01,083663,Staff,4,0,75,71
1650102819683,CSE 140L,A01,083088,Eldon; John,0,1,75,75
1650102825709,CSE 175,A01,083665,Kumar; Rakesh,8,0,25,17
1650102831732,CSE 190,A00,092507,Dubnov; Shlomo,14,0,20,6
1650102837755,ECE 45,A01,083139,Staff,0,13,40,40
1650102843784,ECE 65,A50,083695,Staff,0,4,30,30
1650102849808,ECE 109,A01,091882,Touri; Behrouz,48,0,70,22
1650102855836,ECE 180,A00,083140,Abi Samra; Nicholas Camill,24,0,30,6
1650102855836,ECE 180,B00,083141,Abi Samra; Nicholas Camill,8,0,30,22
1650102861863,MATH 10A,A01,083735,Patchell; Gregory David,12,0,30,18
1650102861863,MATH 10A,A02,083736,Patchell; Gregory David,28,0,30,2
1650102861863,MATH 10A,A03,083737,Patchell; Gregory David,26,0,30,4
1650102867886,MATH 10B,A01,083207,Staff,0,5,30,30
1650102867886,MATH 10B,A02,083208,Staff,0,4,30,30
1650102867886,MATH 10B,B01,083739,Staff,18,0,30,12
1650102867886,MATH 10B,B02,083740,Staff,29,0,30,1
1650102873917,MATH 18,A01,083743,Staff,10,0,30,20
1650102873917,MATH 18,A02,083744,Staff,28,0,30,2
1650102873917,MATH 18,A03,083745,Staff,23,0,30,7
1650102873917,MATH 18,A04,083746,Staff,27,0,30,3
1650102873917,MATH 18,B01,083748,Staff,0,9,30,30
1650102873917,MATH 18,B02,083749,Staff,0,6,30,30
1650102873917,MATH 18,B03,083750,Staff,0,6,30,30
1650102873917,MATH 18,B04,083751,Staff,0,6,30,30
1650102879944,MATH 20A,A01,083754,Staff,26,0,40,14
1650102885965,MATH 20B,A01,083756,Staff,0,5,30,30
1650102885965,MATH 20B,A02,083757,Staff,0,2,30,30
1650102891989,MATH 20C,A01,083760,Staff,0,11,30,30
1650102891989,MATH 20C,A02,083761,Staff,0,12,30,30
1650102891989,MATH 20C,B01,083762,Staff,14,0,30,16
1650102891989,MATH 20C,B02,083763,Staff,28,0,30,2
1650102898012,MATH 20D,A01,083765,Staff,0,2,30,30
1650102898012,MATH 20D,A02,083766,Staff,12,0,30,18
1650102898012,MATH 20D,A03,083767,Staff,28,0,30,2
1650102904035,MATH 20E,A01,083771,Staff,10,0,30,20
1650102904035,MATH 20E,A02,083772,Staff,20,0,30,10
1650102904035,MATH 20E,B01,083773,Staff,0,0,30,30
1650102904035,MATH 20E,B02,083774,Staff,13,0,30,17
1650102910061,MATH 103A,A01,083777,Staff,0,8,30,30
1650102910061,MATH 103A,A02,083778,Staff,0,7,30,30
1650102910061,MATH 103A,B01,083779,Staff,0,9,30,30
1650102910061,MATH 103A,B02,083780,Staff,0,6,30,30
1650102916087,MATH 105,A01,085443,Staff,0,13,30,30
1650102922110,MATH 109,A01,083213,Anzaldo; Leesa B,0,3,30,30
1650102922110,MATH 109,A02,083214,Anzaldo; Leesa B,0,5,30,30
1650102922110,MATH 109,B01,083215,Anzaldo; Leesa B,0,4,30,30
1650102922110,MATH 109,B02,083216,Anzaldo; Leesa B,0,4,30,30
1650102928133,MATH 142A,A01,083219,Chow; Bennett,0,10,30,30
1650102928133,MATH 142A,A02,083220,Chow; Bennett,0,10,30,30
1650102928133,MATH 142A,B01,083221,Chow; Bennett,0,10,30,30
1650102928133,MATH 142A,B02,083222,Chow; Bennett,0,9,30,30
1650102934162,MATH 193A,A01,083224,Staff,0,4,30,30
1650102934162,MATH 193A,A02,083225,Staff,0,4,30,30
1650102934162,MATH 193A,A03,083781,Staff,0,0,30,30
1650102934162,MATH 193A,A04,083782,Staff,2,0,30,28
1650102940184,MATH 197,001,091859,McAuley; Julian John,9998,0,9999,1
1650102946235,COGS 9,A01,083615,Staff,0,14,60,60
1650102952256,COGS 11,A01,083617,Boyle; Mary E. T.,24,0,40,16
1650102958277,COGS 13,A01,083071,Staff,0,28,40,40
1650102964300,COGS 14A,A01,092681,Staff,0,10,100,100
1650102970326,COGS 14B,A01,083073,Cheng; Tzu-Han,0,4,50,50
1650102976350,COGS 17,A01,092677,Staff,35,0,75,40
1650102982374,COGS 100,A01,083619,Staff,0,21,60,60
1650102988408,COGS 101A,A01,083621,Davis; Joshua Daniel,0,18,60,60
1650102994431,COGS 101B,A01,091572,Staff,10,0,60,50
1650103000454,COGS 101C,A01,083625,Delgado; Tania,22,0,30,8
1650103006477,COGS 107A,A01,083627,Boyle; Mary E. T.,0,4,60,60
1650103012505,COGS 118A,A01,083075,Staff,17,0,60,43
1650103018528,CSE 3,A50,083646,Miranda; Gregory Joseph,22,0,38,16
1650103018528,CSE 3,A51,083647,Miranda; Gregory Joseph,37,0,37,0
1650103024551,CSE 8A,A50,083650,Miranda; Gregory Joseph,0,15,40,40
1650103030578,CSE 11,A01,083080,Cao; Yingjun,0,66,40,40
1650103036599,CSE 12,A01,083652,Staff,0,2,100,100
1650103042622,CSE 15L,A01,083654,Staff,0,0,50,50
1650103042622,CSE 15L,A02,083655,Staff,10,0,50,40
1650103048730,CSE 20,A01,083657,Staff,58,0,80,22
1650103054753,CSE 30,A01,083084,Eldon; John,0,63,40,40
1650103060776,CSE 100,A01,083659,Cao; Yingjun,0,61,50,50
1650103066800,CSE 134B,A01,083661,Powell; Thomas Allan,0,27,65,65
1650103072827,CSE 140,A01,083663,Staff,4,0,75,71
1650103078850,CSE 140L,A01,083088,Eldon; John,0,1,75,75
1650103084876,CSE 175,A01,083665,Kumar; Rakesh,8,0,25,17
1650103090900,CSE 190,A00,092507,Dubnov; Shlomo,14,0,20,6
1650103096922,ECE 45,A01,083139,Staff,0,13,40,40
1650103102945,ECE 65,A50,083695,Staff,0,4,30,30
1650103108968,ECE 109,A01,091882,Touri; Behrouz,48,0,70,22
1650103114998,ECE 180,A00,083140,Abi Samra; Nicholas Camill,24,0,30,6
1650103114998,ECE 180,B00,083141,Abi Samra; Nicholas Camill,8,0,30,22
1650103121027,MATH 10A,A01,083735,Patchell; Gregory David,12,0,30,18
1650103121027,MATH 10A,A02,083736,Patchell; Gregory David,28,0,30,2
1650103121027,MATH 10A,A03,083737,Patchell; Gregory David,26,0,30,4
1650103127055,MATH 10B,A01,083207,Staff,0,5,30,30
1650103127055,MATH 10B,A02,083208,Staff,0,4,30,30
1650103127055,MATH 10B,B01,083739,Staff,18,0,30,12
1650103127055,MATH 10B,B02,083740,Staff,29,0,30,1
1650103133080,MATH 18,A01,083743,Staff,10,0,30,20
1650103133080,MATH 18,A02,083744,Staff,28,0,30,2
1650103133080,MATH 18,A03,083745,Staff,23,0,30,7
1650103133080,MATH 18,A04,083746,Staff,27,0,30,3
1650103133080,MATH 18,B01,083748,Staff,0,9,30,30
1650103133080,MATH 18,B02,083749,Staff,0,6,30,30
1650103133080,MATH 18,B03,083750,Staff,0,6,30,30
1650103133080,MATH 18,B04,083751,Staff,0,6,30,30
1650103139104,MATH 20A,A01,083754,Staff,26,0,40,14
1650103145132,MATH 20B,A01,083756,Staff,0,5,30,30
1650103145132,MATH 20B,A02,083757,Staff,0,2,30,30
1650103151157,MATH 20C,A01,083760,Staff,0,11,30,30
1650103151157,MATH 20C,A02,083761,Staff,0,12,30,30
1650103151157,MATH 20C,B01,083762,Staff,14,0,30,16
1650103151157,MATH 20C,B02,083763,Staff,28,0,30,2
1650103157181,MATH 20D,A01,083765,Staff,0,2,30,30
1650103157181,MATH 20D,A02,083766,Staff,12,0,30,18
1650103157181,MATH 20D,A03,083767,Staff,28,0,30,2
1650103163206,MATH 20E,A01,083771,Staff,10,0,30,20
1650103163206,MATH 20E,A02,083772,Staff,20,0,30,10
1650103163206,MATH 20E,B01,083773,Staff,0,0,30,30
1650103163206,MATH 20E,B02,083774,Staff,13,0,30,17
1650103169229,MATH 103A,A01,083777,Staff,0,8,30,30
1650103169229,MATH 103A,A02,083778,Staff,0,7,30,30
1650103169229,MATH 103A,B01,083779,Staff,0,9,30,30
1650103169229,MATH 103A,B02,083780,Staff,0,6,30,30
1650103175254,MATH 105,A01,085443,Staff,0,13,30,30
1650103181277,MATH 109,A01,083213,Anzaldo; Leesa B,0,3,30,30
1650103181277,MATH 109,A02,083214,Anzaldo; Leesa B,0,5,30,30
1650103181277,MATH 109,B01,083215,Anzaldo; Leesa B,0,4,30,30
1650103181277,MATH 109,B02,083216,Anzaldo; Leesa B,0,4,30,30
1650103187299,MATH 142A,A01,083219,Chow; Bennett,0,10,30,30
1650103187299,MATH 142A,A02,083220,Chow; Bennett,0,10,30,30
1650103187299,MATH 142A,B01,083221,Chow; Bennett,0,10,30,30
1650103187299,MATH 142A,B02,083222,Chow; Bennett,0,9,30,30
1650103193320,MATH 193A,A01,083224,Staff,0,4,30,30
1650103193320,MATH 193A,A02,083225,Staff,0,4,30,30
1650103193320,MATH 193A,A03,083781,Staff,0,0,30,30
1650103193320,MATH 193A,A04,083782,Staff,2,0,30,28
1650103199342,MATH 197,001,091859,McAuley; Julian John,9998,0,9999,1
1650103205407,COGS 9,A01,083615,Staff,0,14,60,60
1650103211431,COGS 11,A01,083617,Boyle; Mary E. T.,24,0,40,16
1650103217468,COGS 13,A01,083071,Staff,0,28,40,40
1650103223491,COGS 14A,A01,092681,Staff,0,10,100,100
1650103229514,COGS 14B,A01,083073,Cheng; Tzu-Han,0,4,50,50
1650103235536,COGS 17,A01,092677,Staff,35,0,75,40
1650103241560,COGS 100,A01,083619,Staff,0,21,60,60
1650103247584,COGS 101A,A01,083621,Davis; Joshua Daniel,0,18,60,60
1650103253612,COGS 101B,A01,091572,Staff,10,0,60,50
1650103259637,COGS 101C,A01,083625,Delgado; Tania,22,0,30,8
1650103265666,COGS 107A,A01,083627,Boyle; Mary E. T.,0,4,60,60
1650103271691,COGS 118A,A01,083075,Staff,17,0,60,43
1650103277716,CSE 3,A50,083646,Miranda; Gregory Joseph,22,0,38,16
1650103277716,CSE 3,A51,083647,Miranda; Gregory Joseph,37,0,37,0
1650103283742,CSE 8A,A50,083650,Miranda; Gregory Joseph,0,15,40,40
1650103289770,CSE 11,A01,083080,Cao; Yingjun,0,66,40,40
1650103295807,CSE 12,A01,083652,Staff,0,2,100,100
1650103301835,CSE 15L,A01,083654,Staff,0,0,50,50
1650103301835,CSE 15L,A02,083655,Staff,10,0,50,40
1650103307859,CSE 20,A01,083657,Staff,58,0,80,22
1650103313888,CSE 30,A01,083084,Eldon; John,0,63,40,40
1650103319912,CSE 100,A01,083659,Cao; Yingjun,0,61,50,50
1650103325935,CSE 134B,A01,083661,Powell; Thomas Allan,0,27,65,65
1650103331964,CSE 140,A01,083663,Staff,4,0,75,71
1650103337987,CSE 140L,A01,083088,Eldon; John,0,1,75,75
1650103344016,CSE 175,A01,083665,Kumar; Rakesh,8,0,25,17
1650103350043,CSE 190,A00,092507,Dubnov; Shlomo,14,0,20,6
1650103356066,ECE 45,A01,083139,Staff,0,13,40,40
1650103362094,ECE 65,A50,083695,Staff,0,4,30,30
1650103368124,ECE 109,A01,091882,Touri; Behrouz,48,0,70,22
1650103374151,ECE 180,A00,083140,Abi Samra; Nicholas Camill,24,0,30,6
1650103374151,ECE 180,B00,083141,Abi Samra; Nicholas Camill,8,0,30,22
1650103380174,MATH 10A,A01,083735,Patchell; Gregory David,12,0,30,18
1650103380174,MATH 10A,A02,083736,Patchell; Gregory David,28,0,30,2
1650103380174,MATH 10A,A03,083737,Patchell; Gregory David,26,0,30,4
1650103386217,MATH 10B,A01,083207,Staff,0,5,30,30
1650103386217,MATH 10B,A02,083208,Staff,0,4,30,30
1650103386217,MATH 10B,B01,083739,Staff,18,0,30,12
1650103386217,MATH 10B,B02,083740,Staff,29,0,30,1
1650103392243,MATH 18,A01,083743,Staff,10,0,30,20
1650103392243,MATH 18,A02,083744,Staff,28,0,30,2
1650103392243,MATH 18,A03,083745,Staff,23,0,30,7
1650103392243,MATH 18,A04,083746,Staff,27,0,30,3
1650103392243,MATH 18,B01,083748,Staff,0,9,30,30
1650103392243,MATH 18,B02,083749,Staff,0,6,30,30
1650103392243,MATH 18,B03,083750,Staff,0,6,30,30
1650103392243,MATH 18,B04,083751,Staff,0,6,30,30
1650103398265,MATH 20A,A01,083754,Staff,26,0,40,14
1650103404295,MATH 20B,A01,083756,Staff,0,5,30,30
1650103404295,MATH 20B,A02,083757,Staff,0,2,30,30
1650103410320,MATH 20C,A01,083760,Staff,0,11,30,30
1650103410320,MATH 20C,A02,083761,Staff,0,12,30,30
1650103410320,MATH 20C,B01,083762,Staff,14,0,30,16
1650103410320,MATH 20C,B02,083763,Staff,28,0,30,2
1650103416343,MATH 20D,A01,083765,Staff,0,2,30,30
1650103416343,MATH 20D,A02,083766,Staff,12,0,30,18
1650103416343,MATH 20D,A03,083767,Staff,28,0,30,2
1650103422367,MATH 20E,A01,083771,Staff,10,0,30,20
1650103422367,MATH 20E,A02,083772,Staff,20,0,30,10
1650103422367,MATH 20E,B01,083773,Staff,0,0,30,30
1650103422367,MATH 20E,B02,083774,Staff,13,0,30,17
1650103428392,MATH 103A,A01,083777,Staff,0,8,30,30
1650103428392,MATH 103A,A02,083778,Staff,0,7,30,30
1650103428392,MATH 103A,B01,083779,Staff,0,9,30,30
1650103428392,MATH 103A,B02,083780,Staff,0,6,30,30
1650103434419,MATH 105,A01,085443,Staff,0,13,30,30
1650103440444,MATH 109,A01,083213,Anzaldo; Leesa B,0,3,30,30
1650103440444,MATH 109,A02,083214,Anzaldo; Leesa B,0,5,30,30
1650103440444,MATH 109,B01,083215,Anzaldo; Leesa B,0,4,30,30
1650103440444,MATH 109,B02,083216,Anzaldo; Leesa B,0,4,30,30
1650103446473,MATH 142A,A01,083219,Chow; Bennett,0,10,30,30
1650103446473,MATH 142A,A02,083220,Chow; Bennett,0,10,30,30
1650103446473,MATH 142A,B01,083221,Chow; Bennett,0,10,30,30
1650103446473,MATH 142A,B02,083222,Chow; Bennett,0,9,30,30
1650103452500,MATH 193A,A01,083224,Staff,0,4,30,30
1650103452500,MATH 193A,A02,083225,Staff,0,4,30,30
1650103452500,MATH 193A,A03,083781,Staff,0,0,30,30
1650103452500,MATH 193A,A04,083782,Staff,2,0,30,28
1650103458527,MATH 197,001,091859,McAuley; Julian John,9998,0,9999,1
1650103464597,COGS 9,A01,083615,Staff,0,14,60,60
1650103470620,COGS 11,A01,083617,Boyle; Mary E. T.,24,0,40,16
1650103476647,COGS 13,A01,083071,Staff,0,28,40,40
1650103482670,COGS 14A,A01,092681,Staff,0,10,100,100
1650103488692,COGS 14B,A01,083073,Cheng; Tzu-Han,0,4,50,50
1650103494715,COGS 17,A01,092677,Staff,35,0,75,40
1650103500739,COGS 100,A01,083619,Staff,0,21,60,60
1650103506779,COGS 101A,A01,083621,Davis; Joshua Daniel,0,18,60,60
1650103512806,COGS 101B,A01,091572,Staff,10,0,60,50
1650103518828,COGS 101C,A01,083625,Delgado; Tania,22,0,30,8
1650103524856,COGS 107A,A01,083627,Boyle; Mary E. T.,0,4,60,60
1650103530879,COGS 118A,A01,083075,Staff,17,0,60,43
1650103536904,CSE 3,A50,083646,Miranda; Gregory Joseph,22,0,38,16
1650103536904,CSE 3,A51,083647,Miranda; Gregory Joseph,37,0,37,0
1650103542927,CSE 8A,A50,083650,Miranda; Gregory Joseph,0,15,40,40
1650103548953,CSE 11,A01,083080,Cao; Yingjun,0,66,40,40
1650103554977,CSE 12,A01,083652,Staff,0,2,100,100
1650103560999,CSE 15L,A01,083654,Staff,0,0,50,50
1650103560999,CSE 15L,A02,083655,Staff,10,0,50,40
1650103567022,CSE 20,A01,083657,Staff,58,0,80,22
1650103573045,CSE 30,A01,083084,Eldon; John,0,63,40,40
1650103579071,CSE 100,A01,083659,Cao; Yingjun,0,61,50,50
1650103585103,CSE 134B,A01,083661,Powell; Thomas Allan,0,27,65,65
1650103591126,CSE 140,A01,083663,Staff,4,0,75,71
1650103597154,CSE 140L,A01,083088,Eldon; John,0,1,75,75
1650103603177,CSE 175,A01,083665,Kumar; Rakesh,8,0,25,17
1650103609199,CSE 190,A00,092507,Dubnov; Shlomo,14,0,20,6
1650103615227,ECE 45,A01,083139,Staff,0,13,40,40
1650103621255,ECE 65,A50,083695,Staff,0,4,30,30
1650103627290,ECE 109,A01,091882,Touri; Behrouz,48,0,70,22
1650103633317,ECE 180,A00,083140,Abi Samra; Nicholas Camill,24,0,30,6
1650103633317,ECE 180,B00,083141,Abi Samra; Nicholas Camill,8,0,30,22
1650103639345,MATH 10A,A01,083735,Patchell; Gregory David,12,0,30,18
1650103639345,MATH 10A,A02,083736,Patchell; Gregory David,28,0,30,2
1650103639345,MATH 10A,A03,083737,Patchell; Gregory David,26,0,30,4
1650103645462,MATH 10B,A01,083207,Staff,0,5,30,30
1650103645462,MATH 10B,A02,083208,Staff,0,4,30,30
1650103645462,MATH 10B,B01,083739,Staff,18,0,30,12
1650103645462,MATH 10B,B02,083740,Staff,29,0,30,1
1650103651486,MATH 18,A01,083743,Staff,10,0,30,20
1650103651486,MATH 18,A02,083744,Staff,28,0,30,2
1650103651486,MATH 18,A03,083745,Staff,23,0,30,7
1650103651486,MATH 18,A04,083746,Staff,27,0,30,3
1650103651486,MATH 18,B01,083748,Staff,0,9,30,30
1650103651486,MATH 18,B02,083749,Staff,0,6,30,30
1650103651486,MATH 18,B03,083750,Staff,0,6,30,30
1650103651486,MATH 18,B04,083751,Staff,0,6,30,30
1650103657513,MATH 20A,A01,083754,Staff,26,0,40,14
1650103663537,MATH 20B,A01,083756,Staff,0,5,30,30
1650103663537,MATH 20B,A02,083757,Staff,0,2,30,30
1650103669564,MATH 20C,A01,083760,Staff,0,11,30,30
1650103669564,MATH 20C,A02,083761,Staff,0,12,30,30
1650103669564,MATH 20C,B01,083762,Staff,14,0,30,16
1650103669564,MATH 20C,B02,083763,Staff,28,0,30,2
1650103675588,MATH 20D,A01,083765,Staff,0,2,30,30
1650103675588,MATH 20D,A02,083766,Staff,12,0,30,18
1650103675588,MATH 20D,A03,083767,Staff,28,0,30,2
1650103681617,MATH 20E,A01,083771,Staff,10,0,30,20
1650103681617,MATH 20E,A02,083772,Staff,20,0,30,10
1650103681617,MATH 20E,B01,083773,Staff,0,0,30,30
1650103681617,MATH 20E,B02,083774,Staff,13,0,30,17
1650103687653,MATH 103A,A01,083777,Staff,0,8,30,30
1650103687653,MATH 103A,A02,083778,Staff,0,7,30,30
1650103687653,MATH 103A,B01,083779,Staff,0,9,30,30
1650103687653,MATH 103A,B02,083780,Staff,0,6,30,30
1650103693679,MATH 105,A01,085443,Staff,0,13,30,30
1650103699702,MATH 109,A01,083213,Anzaldo; Leesa B,0,3,30,30
1650103699702,MATH 109,A02,083214,Anzaldo; Leesa B,0,5,30,30
1650103699702,MATH 109,B01,083215,Anzaldo; Leesa B,0,4,30,30
1650103699702,MATH 109,B02,083216,Anzaldo; Leesa B,0,4,30,30
1650103705727,MATH 142A,A01,083219,Chow; Bennett,0,10,30,30
1650103705727,MATH 142A,A02,083220,Chow; Bennett,0,10,30,30
1650103705727,MATH 142A,B01,083221,Chow; Bennett,0,10,30,30
1650103705727,MATH 142A,B02,083222,Chow; Bennett,0,9,30,30
1650103711754,MATH 193A,A01,083224,Staff,0,4,30,30
1650103711754,MATH 193A,A02,083225,Staff,0,4,30,30
1650103711754,MATH 193A,A03,083781,Staff,0,0,30,30
1650103711754,MATH 193A,A04,083782,Staff,2,0,30,28
1650103717777,MATH 197,001,091859,McAuley; Julian John,9998,0,9999,1
1650103723840,COGS 9,A01,083615,Staff,0,14,60,60
1650103729863,COGS 11,A01,083617,Boyle; Mary E. T.,24,0,40,16
1650103735891,COGS 13,A01,083071,Staff,0,28,40,40
1650103741918,COGS 14A,A01,092681,Staff,0,10,100,100
1650103747942,COGS 14B,A01,083073,Cheng; Tzu-Han,0,4,50,50
1650103753964,COGS 17,A01,092677,Staff,35,0,75,40
1650103759987,COGS 100,A01,083619,Staff,0,21,60,60
1650103766011,COGS 101A,A01,083621,Davis; Joshua Daniel,0,18,60,60
1650103772039,COGS 101B,A01,091572,Staff,10,0,60,50
1650103778073,COGS 101C,A01,083625,Delgado; Tania,22,0,30,8
1650103784095,COGS 107A,A01,083627,Boyle; Mary E. T.,0,4,60,60
1650103790122,COGS 118A,A01,083075,Staff,17,0,60,43
1650103796144,CSE 3,A50,083646,Miranda; Gregory Joseph,22,0,38,16
1650103796144,CSE 3,A51,083647,Miranda; Gregory Joseph,37,0,37,0
1650103802175,CSE 8A,A50,083650,Miranda; Gregory Joseph,0,15,40,40
1650103808199,CSE 11,A01,083080,Cao; Yingjun,0,66,40,40
1650103814222,CSE 12,A01,083652,Staff,0,2,100,100
1650103820246,CSE 15L,A01,083654,Staff,0,0,50,50
1650103820246,CSE 15L,A02,083655,Staff,10,0,50,40
1650103826268,CSE 20,A01,083657,Staff,58,0,80,22
1650103832290,CSE 30,A01,083084,Eldon; John,0,63,40,40
1650103838315,CSE 100,A01,083659,Cao; Yingjun,0,61,50,50
1650103844340,CSE 134B,A01,083661,Powell; Thomas Allan,0,27,65,65
1650103850366,CSE 140,A01,083663,Staff,4,0,75,71
1650103856394,CSE 140L,A01,083088,Eldon; John,0,1,75,75
1650103862419,CSE 175,A01,083665,Kumar; Rakesh,8,0,25,17
1650103868447,CSE 190,A00,092507,Dubnov; Shlomo,14,0,20,6
1650103874472,ECE 45,A01,083139,Staff,0,13,40,40
1650103880498,ECE 65,A50,083695,Staff,0,4,30,30
1650103886525,ECE 109,A01,091882,Touri; Behrouz,48,0,70,22
1650103892549,ECE 180,A00,083140,Abi Samra; Nicholas Camill,24,0,30,6
1650103892549,ECE 180,B00,083141,Abi Samra; Nicholas Camill,8,0,30,22
1650103898576,MATH 10A,A01,083735,Patchell; Gregory David,12,0,30,18
1650103898576,MATH 10A,A02,083736,Patchell; Gregory David,28,0,30,2
1650103898576,MATH 10A,A03,083737,Patchell; Gregory David,26,0,30,4
1650103904601,MATH 10B,A01,083207,Staff,0,5,30,30
1650103904601,MATH 10B,A02,083208,Staff,0,4,30,30
1650103904601,MATH 10B,B01,083739,Staff,18,0,30,12
1650103904601,MATH 10B,B02,083740,Staff,29,0,30,1
1650103910630,MATH 18,A01,083743,Staff,10,0,30,20
1650103910630,MATH 18,A02,083744,Staff,28,0,30,2
1650103910630,MATH 18,A03,083745,Staff,23,0,30,7
1650103910630,MATH 18,A04,083746,Staff,27,0,30,3
1650103910630,MATH 18,B01,083748,Staff,0,9,30,30
1650103910630,MATH 18,B02,083749,Staff,0,6,30,30
1650103910630,MATH 18,B03,083750,Staff,0,6,30,30
1650103910630,MATH 18,B04,083751,Staff,0,6,30,30
1650103916653,MATH 20A,A01,083754,Staff,26,0,40,14
1650103922676,MATH 20B,A01,083756,Staff,0,5,30,30
1650103922676,MATH 20B,A02,083757,Staff,0,2,30,30
1650103928701,MATH 20C,A01,083760,Staff,0,11,30,30
1650103928701,MATH 20C,A02,083761,Staff,0,12,30,30
1650103928701,MATH 20C,B01,083762,Staff,14,0,30,16
1650103928701,MATH 20C,B02,083763,Staff,28,0,30,2
1650103934728,MATH 20D,A01,083765,Staff,0,2,30,30
1650103934728,MATH 20D,A02,083766,Staff,12,0,30,18
1650103934728,MATH 20D,A03,083767,Staff,28,0,30,2
1650103940756,MATH 20E,A01,083771,Staff,10,0,30,20
1650103940756,MATH 20E,A02,083772,Staff,20,0,30,10
1650103940756,MATH 20E,B01,083773,Staff,0,0,30,30
1650103940756,MATH 20E,B02,083774,Staff,13,0,30,17
1650103946784,MATH 103A,A01,083777,Staff,0,8,30,30
1650103946784,MATH 103A,A02,083778,Staff,0,7,30,30
1650103946784,MATH 103A,B01,083779,Staff,0,9,30,30
1650103946784,MATH 103A,B02,083780,Staff,0,6,30,30
1650103952808,MATH 105,A01,085443,Staff,0,13,30,30
1650103958837,MATH 109,A01,083213,Anzaldo; Leesa B,0,3,30,30
1650103958837,MATH 109,A02,083214,Anzaldo; Leesa B,0,5,30,30
1650103958837,MATH 109,B01,083215,Anzaldo; Leesa B,0,4,30,30
1650103958837,MATH 109,B02,083216,Anzaldo; Leesa B,0,4,30,30
1650103964861,MATH 142A,A01,083219,Chow; Bennett,0,10,30,30
1650103964861,MATH 142A,A02,083220,Chow; Bennett,0,10,30,30
1650103964861,MATH 142A,B01,083221,Chow; Bennett,0,10,30,30
1650103964861,MATH 142A,B02,083222,Chow; Bennett,0,9,30,30
1650103970886,MATH 193A,A01,083224,Staff,0,4,30,30
1650103970886,MATH 193A,A02,083225,Staff,0,4,30,30
1650103970886,MATH 193A,A03,083781,Staff,0,0,30,30
1650103970886,MATH 193A,A04,083782,Staff,2,0,30,28
1650103976910,MATH 197,001,091859,McAuley; Julian John,9998,0,9999,1
1650103982978,COGS 9,A01,083615,Staff,0,14,60,60
1650103989004,COGS 11,A01,083617,Boyle; Mary E. T.,24,0,40,16
1650103995031,COGS 13,A01,083071,Staff,0,28,40,40
1650104001059,COGS 14A,A01,092681,Staff,0,10,100,100
1650104007085,COGS 14B,A01,083073,Cheng; Tzu-Han,0,4,50,50
1650104013109,COGS 17,A01,092677,Staff,35,0,75,40
1650104019139,COGS 100,A01,083619,Staff,0,21,60,60
1650104025164,COGS 101A,A01,083621,Davis; Joshua Daniel,0,18,60,60
1650104031195,COGS 101B,A01,091572,Staff,10,0,60,50
1650104037221,COGS 101C,A01,083625,Delgado; Tania,22,0,30,8
1650104043250,COGS 107A,A01,083627,Boyle; Mary E. T.,0,4,60,60
1650104049275,COGS 118A,A01,083075,Staff,17,0,60,43
1650104055300,CSE 3,A50,083646,Miranda; Gregory Joseph,22,0,38,16
1650104055300,CSE 3,A51,083647,Miranda; Gregory Joseph,37,0,37,0
1650104061327,CSE 8A,A50,083650,Miranda; Gregory Joseph,0,15,40,40
1650104067353,CSE 11,A01,083080,Cao; Yingjun,0,66,40,40
1650104073380,CSE 12,A01,083652,Staff,0,2,100,100
1650104079403,CSE 15L,A01,083654,Staff,0,0,50,50
1650104079403,CSE 15L,A02,083655,Staff,10,0,50,40
1650104085427,CSE 20,A01,083657,Staff,58,0,80,22
1650104091462,CSE 30,A01,083084,Eldon; John,0,63,40,40
1650104097488,CSE 100,A01,083659,Cao; Yingjun,0,61,50,50
1650104103513,CSE 134B,A01,083661,Powell; Thomas Allan,0,27,65,65
1650104109542,CSE 140,A01,083663,Staff,4,0,75,71
1650104115567,CSE 140L,A01,083088,Eldon; John,0,1,75,75
1650104121594,CSE 175,A01,083665,Kumar; Rakesh,8,0,25,17
1650104127626,CSE 190,A00,092507,Dubnov; Shlomo,14,0,20,6
1650104133653,ECE 45,A01,083139,Staff,0,13,40,40
1650104139685,ECE 65,A50,083695,Staff,0,4,30,30
1650104145718,ECE 109,A01,091882,Touri; Behrouz,48,0,70,22
1650104151748,ECE 180,A00,083140,Abi Samra; Nicholas Camill,24,0,30,6
1650104151748,ECE 180,B00,083141,Abi Samra; Nicholas Camill,8,0,30,22
1650104157776,MATH 10A,A01,083735,Patchell; Gregory David,12,0,30,18
1650104157776,MATH 10A,A02,083736,Patchell; Gregory David,28,0,30,2
1650104157776,MATH 10A,A03,083737,Patchell; Gregory David,26,0,30,4
1650104163805,MATH 10B,A01,083207,Staff,0,5,30,30
1650104163805,MATH 10B,A02,083208,Staff,0,4,30,30
1650104163805,MATH 10B,B01,083739,Staff,18,0,30,12
1650104163805,MATH 10B,B02,083740,Staff,29,0,30,1
1650104169851,MATH 18,A01,083743,Staff,10,0,30,20
1650104169851,MATH 18,A02,083744,Staff,28,0,30,2
1650104169851,MATH 18,A03,083745,Staff,23,0,30,7
1650104169851,MATH 18,A04,083746,Staff,27,0,30,3
1650104169851,MATH 18,B01,083748,Staff,0,9,30,30
1650104169851,MATH 18,B02,083749,Staff,0,6,30,30
1650104169851,MATH 18,B03,083750,Staff,0,6,30,30
1650104169851,MATH 18,B04,083751,Staff,0,6,30,30
1650104175876,MATH 20A,A01,083754,Staff,26,0,40,14
1650104181904,MATH 20B,A01,083756,Staff,0,5,30,30
1650104181904,MATH 20B,A02,083757,Staff,0,2,30,30
1650104187930,MATH 20C,A01,083760,Staff,0,11,30,30
1650104187930,MATH 20C,A02,083761,Staff,0,12,30,30
1650104187930,MATH 20C,B01,083762,Staff,14,0,30,16
1650104187930,MATH 20C,B02,083763,Staff,28,0,30,2
1650104193961,MATH 20D,A01,083765,Staff,0,2,30,30
1650104193961,MATH 20D,A02,083766,Staff,12,0,30,18
1650104193961,MATH 20D,A03,083767,Staff,28,0,30,2
1650104199992,MATH 20E,A01,083771,Staff,10,0,30,20
1650104199992,MATH 20E,A02,083772,Staff,20,0,30,10
1650104199992,MATH 20E,B01,083773,Staff,0,0,30,30
1650104199992,MATH 20E,B02,083774,Staff,13,0,30,17
1650104206029,MATH 103A,A01,083777,Staff,0,8,30,30
1650104206029,MATH 103A,A02,083778,Staff,0,7,30,30
1650104206029,MATH 103A,B01,083779,Staff,0,9,30,30
1650104206029,MATH 103A,B02,083780,Staff,0,6,30,30
1650104212060,MATH 105,A01,085443,Staff,0,13,30,30
1650104218090,MATH 109,A01,083213,Anzaldo; Leesa B,0,3,30,30
1650104218090,MATH 109,A02,083214,Anzaldo; Leesa B,0,5,30,30
1650104218090,MATH 109,B01,083215,Anzaldo; Leesa B,0,4,30,30
1650104218090,MATH 109,B02,083216,Anzaldo; Leesa B,0,4,30,30
1650104224134,MATH 142A,A01,083219,Chow; Bennett,0,10,30,30
1650104224134,MATH 142A,A02,083220,Chow; Bennett,0,10,30,30
1650104224134,MATH 142A,B01,083221,Chow; Bennett,0,10,30,30
1650104224134,MATH 142A,B02,083222,Chow; Bennett,0,9,30,30
1650104230171,MATH 193A,A01,083224,Staff,0,4,30,30
1650104230171,MATH 193A,A02,083225,Staff,0,4,30,30
1650104230171,MATH 193A,A03,083781,Staff,0,0,30,30
1650104230171,MATH 193A,A04,083782,Staff,2,0,30,28
1650104236212,MATH 197,001,091859,McAuley; Julian John,9998,0,9999,1
1650104242412,COGS 9,A01,083615,Staff,0,14,60,60
1650104248437,COGS 11,A01,083617,Boyle; Mary E. T.,24,0,40,16
1650104254462,COGS 13,A01,083071,Staff,0,28,40,40
1650104260490,COGS 14A,A01,092681,Staff,0,10,100,100
1650104266521,COGS 14B,A01,083073,Cheng; Tzu-Han,0,4,50,50
1650104272547,COGS 17,A01,092677,Staff,35,0,75,40
1650104278572,COGS 100,A01,083619,Staff,0,21,60,60
1650104284596,COGS 101A,A01,083621,Davis; Joshua Daniel,0,18,60,60
1650104290620,COGS 101B,A01,091572,Staff,10,0,60,50
1650104296644,COGS 101C,A01,083625,Delgado; Tania,22,0,30,8
1650104302669,COGS 107A,A01,083627,Boyle; Mary E. T.,0,4,60,60
1650104308697,COGS 118A,A01,083075,Staff,17,0,60,43
1650104314723,CSE 3,A50,083646,Miranda; Gregory Joseph,22,0,38,16
1650104314723,CSE 3,A51,083647,Miranda; Gregory Joseph,37,0,37,0
1650104320753,CSE 8A,A50,083650,Miranda; Gregory Joseph,0,15,40,40
1650104326777,CSE 11,A01,083080,Cao; Yingjun,0,66,40,40
1650104332809,CSE 12,A01,083652,Staff,0,2,100,100
1650104338834,CSE 15L,A01,083654,Staff,0,0,50,50
1650104338834,CSE 15L,A02,083655,Staff,10,0,50,40
1650104344864,CSE 20,A01,083657,Staff,58,0,80,22
1650104350894,CSE 30,A01,083084,Eldon; John,0,63,40,40
1650104356920,CSE 100,A01,083659,Cao; Yingjun,0,61,50,50
1650104362952,CSE 134B,A01,083661,Powell; Thomas Allan,0,27,65,65
1650104368975,CSE 140,A01,083663,Staff,4,0,75,71
1650104375001,CSE 140L,A01,083088,Eldon; John,0,1,75,75
1650104381038,CSE 175,A01,083665,Kumar; Rakesh,8,0,25,17
1650104387069,CSE 190,A00,092507,Dubnov; Shlomo,14,0,20,6
1650104393097,ECE 45,A01,083139,Staff,0,13,40,40
1650104399125,ECE 65,A50,083695,Staff,0,4,30,30
1650104405150,ECE 109,A01,091882,Touri; Behrouz,48,0,70,22
1650104411179,ECE 180,A00,083140,Abi Samra; Nicholas Camill,24,0,30,6
1650104411179,ECE 180,B00,083141,Abi Samra; Nicholas Camill,8,0,30,22
1650104417207,MATH 10A,A01,083735,Patchell; Gregory David,12,0,30,18
1650104417207,MATH 10A,A02,083736,Patchell; Gregory David,28,0,30,2
1650104417207,MATH 10A,A03,083737,Patchell; Gregory David,26,0,30,4
1650104423238,MATH 10B,A01,083207,Staff,0,5,30,30
1650104423238,MATH 10B,A02,083208,Staff,0,4,30,30
1650104423238,MATH 10B,B01,083739,Staff,18,0,30,12
1650104423238,MATH 10B,B02,083740,Staff,29,0,30,1
1650104429275,MATH 18,A01,083743,Staff,10,0,30,20
1650104429275,MATH 18,A02,083744,Staff,28,0,30,2
1650104429275,MATH 18,A03,083745,Staff,23,0,30,7
1650104429275,MATH 18,A04,083746,Staff,27,0,30,3
1650104429275,MATH 18,B01,083748,Staff,0,9,30,30
1650104429275,MATH 18,B02,083749,Staff,0,6,30,30
1650104429275,MATH 18,B03,083750,Staff,0,6,30,30
1650104429275,MATH 18,B04,083751,Staff,0,6,30,30
1650104435300,MATH 20A,A01,083754,Staff,26,0,40,14
1650104441346,MATH 20B,A01,083756,Staff,0,5,30,30
1650104441346,MATH 20B,A02,083757,Staff,0,2,30,30
1650104447369,MATH 20C,A01,083760,Staff,0,11,30,30
1650104447369,MATH 20C,A02,083761,Staff,0,12,30,30
1650104447369,MATH 20C,B01,083762,Staff,14,0,30,16
1650104447369,MATH 20C,B02,083763,Staff,28,0,30,2
1650104453397,MATH 20D,A01,083765,Staff,0,2,30,30
1650104453397,MATH 20D,A02,083766,Staff,12,0,30,18
1650104453397,MATH 20D,A03,083767,Staff,28,0,30,2
1650104459423,MATH 20E,A01,083771,Staff,10,0,30,20
1650104459423,MATH 20E,A02,083772,Staff,20,0,30,10
1650104459423,MATH 20E,B01,083773,Staff,0,0,30,30
1650104459423,MATH 20E,B02,083774,Staff,13,0,30,17
1650104465449,MATH 103A,A01,083777,Staff,0,8,30,30
1650104465449,MATH 103A,A02,083778,Staff,0,7,30,30
1650104465449,MATH 103A,B01,083779,Staff,0,9,30,30
1650104465449,MATH 103A,B02,083780,Staff,0,6,30,30
1650104471473,MATH 105,A01,085443,Staff,0,13,30,30
1650104477500,MATH 109,A01,083213,Anzaldo; Leesa B,0,3,30,30
1650104477500,MATH 109,A02,083214,Anzaldo; Leesa B,0,5,30,30
1650104477500,MATH 109,B01,083215,Anzaldo; Leesa B,0,4,30,30
1650104477500,MATH 109,B02,083216,Anzaldo; Leesa B,0,4,30,30
1650104483525,MATH 142A,A01,083219,Chow; Bennett,0,10,30,30
1650104483525,MATH 142A,A02,083220,Chow; Bennett,0,10,30,30
1650104483525,MATH 142A,B01,083221,Chow; Bennett,0,10,30,30
1650104483525,MATH 142A,B02,083222,Chow; Bennett,0,9,30,30
1650104489551,MATH 193A,A01,083224,Staff,0,4,30,30
1650104489551,MATH 193A,A02,083225,Staff,0,4,30,30
1650104489551,MATH 193A,A03,083781,Staff,0,0,30,30
1650104489551,MATH 193A,A04,083782,Staff,2,0,30,28
1650104495576,MATH 197,001,091859,McAuley; Julian John,9998,0,9999,1
1650104501635,COGS 9,A01,083615,Staff,0,14,60,60
1650104507665,COGS 11,A01,083617,Boyle; Mary E. T.,24,0,40,16
1650104513691,COGS 13,A01,083071,Staff,0,28,40,40
1650104519719,COGS 14A,A01,092681,Staff,0,10,100,100
1650104525743,COGS 14B,A01,083073,Cheng; Tzu-Han,0,4,50,50
1650104531770,COGS 17,A01,092677,Staff,35,0,75,40
1650104537798,COGS 100,A01,083619,Staff,0,21,60,60
1650104543827,COGS 101A,A01,083621,Davis; Joshua Daniel,0,18,60,60
1650104549849,COGS 101B,A01,091572,Staff,10,0,60,50
1650104555893,COGS 101C,A01,083625,Delgado; Tania,22,0,30,8
1650104561921,COGS 107A,A01,083627,Boyle; Mary E. T.,0,4,60,60
1650104567951,COGS 118A,A01,083075,Staff,17,0,60,43
1650104573977,CSE 3,A50,083646,Miranda; Gregory Joseph,22,0,38,16
1650104573977,CSE 3,A51,083647,Miranda; Gregory Joseph,37,0,37,0
1650104580006,CSE 8A,A50,083650,Miranda; Gregory Joseph,0,15,40,40
1650104586030,CSE 11,A01,083080,Cao; Yingjun,0,66,40,40
1650104592055,CSE 12,A01,083652,Staff,0,2,100,100
1650104598080,CSE 15L,A01,083654,Staff,0,0,50,50
1650104598080,CSE 15L,A02,083655,Staff,10,0,50,40
1650104604105,CSE 20,A01,083657,Staff,58,0,80,22
1650104610130,CSE 30,A01,083084,Eldon; John,0,63,40,40
1650104616156,CSE 100,A01,083659,Cao; Yingjun,0,61,50,50
1650104622185,CSE 134B,A01,083661,Powell; Thomas Allan,0,27,65,65
1650104628210,CSE 140,A01,083663,Staff,4,0,75,71
1650104634238,CSE 140L,A01,083088,Eldon; John,0,1,75,75
1650104640263,CSE 175,A01,083665,Kumar; Rakesh,8,0,25,17
1650104646288,CSE 190,A00,092507,Dubnov; Shlomo,14,0,20,6
1650104652317,ECE 45,A01,083139,Staff,0,13,40,40
1650104658341,ECE 65,A50,083695,Staff,0,4,30,30
1650104664366,ECE 109,A01,091882,Touri; Behrouz,48,0,70,22
1650104670396,ECE 180,A00,083140,Abi Samra; Nicholas Camill,24,0,30,6
1650104670396,ECE 180,B00,083141,Abi Samra; Nicholas Camill,8,0,30,22
1650104676427,MATH 10A,A01,083735,Patchell; Gregory David,12,0,30,18
1650104676427,MATH 10A,A02,083736,Patchell; Gregory David,28,0,30,2
1650104676427,MATH 10A,A03,083737,Patchell; Gregory David,26,0,30,4
1650104682458,MATH 10B,A01,083207,Staff,0,5,30,30
1650104682458,MATH 10B,A02,083208,Staff,0,4,30,30
1650104682458,MATH 10B,B01,083739,Staff,18,0,30,12
1650104682458,MATH 10B,B02,083740,Staff,29,0,30,1
1650104688486,MATH 18,A01,083743,Staff,10,0,30,20
1650104688486,MATH 18,A02,083744,Staff,28,0,30,2
1650104688486,MATH 18,A03,083745,Staff,23,0,30,7
1650104688486,MATH 18,A04,083746,Staff,27,0,30,3
1650104688486,MATH 18,B01,083748,Staff,0,9,30,30
1650104688486,MATH 18,B02,083749,Staff,0,6,30,30
1650104688486,MATH 18,B03,083750,Staff,0,6,30,30
1650104688486,MATH 18,B04,083751,Staff,0,6,30,30
1650104694513,MATH 20A,A01,083754,Staff,26,0,40,14
1650104700544,MATH 20B,A01,083756,Staff,0,5,30,30
1650104700544,MATH 20B,A02,083757,Staff,0,2,30,30
1650104706570,MATH 20C,A01,083760,Staff,0,11,30,30
1650104706570,MATH 20C,A02,083761,Staff,0,12,30,30
1650104706570,MATH 20C,B01,083762,Staff,14,0,30,16
1650104706570,MATH 20C,B02,083763,Staff,28,0,30,2
1650104712596,MATH 20D,A01,083765,Staff,0,2,30,30
1650104712596,MATH 20D,A02,083766,Staff,12,0,30,18
1650104712596,MATH 20D,A03,083767,Staff,28,0,30,2
1650104718621,MATH 20E,A01,083771,Staff,10,0,30,20
1650104718621,MATH 20E,A02,083772,Staff,20,0,30,10
1650104718621,MATH 20E,B01,083773,Staff,0,0,30,30
1650104718621,MATH 20E,B02,083774,Staff,13,0,30,17
1650104724652,MATH 103A,A01,083777,Staff,0,8,30,30
1650104724652,MATH 103A,A02,083778,Staff,0,7,30,30
1650104724652,MATH 103A,B01,083779,Staff,0,9,30,30
1650104724652,MATH 103A,B02,083780,Staff,0,6,30,30
1650104730682,MATH 105,A01,085443,Staff,0,13,30,30
1650104736711,MATH 109,A01,083213,Anzaldo; Leesa B,0,3,30,30
1650104736711,MATH 109,A02,083214,Anzaldo; Leesa B,0,5,30,30
1650104736711,MATH 109,B01,083215,Anzaldo; Leesa B,0,4,30,30
1650104736711,MATH 109,B02,083216,Anzaldo; Leesa B,0,4,30,30
1650104742736,MATH 142A,A01,083219,Chow; Bennett,0,10,30,30
1650104742736,MATH 142A,A02,083220,Chow; Bennett,0,10,30,30
1650104742736,MATH 142A,B01,083221,Chow; Bennett,0,10,30,30
1650104742736,MATH 142A,B02,083222,Chow; Bennett,0,9,30,30
1650104748780,MATH 193A,A01,083224,Staff,0,4,30,30
1650104748780,MATH 193A,A02,083225,Staff,0,4,30,30
1650104748780,MATH 193A,A03,083781,Staff,0,0,30,30
1650104748780,MATH 193A,A04,083782,Staff,2,0,30,28
1650104754807,MATH 197,001,091859,McAuley; Julian John,9998,0,9999,1
1650104760867,COGS 9,A01,083615,Staff,0,14,60,60
1650104766891,COGS 11,A01,083617,Boyle; Mary E. T.,24,0,40,16
1650104772920,COGS 13,A01,083071,Staff,0,28,40,40
1650104778949,COGS 14A,A01,092681,Staff,0,10,100,100
1650104784995,COGS 14B,A01,083073,Cheng; Tzu-Han,0,4,50,50
1650104791019,COGS 17,A01,092677,Staff,35,0,75,40
1650104797051,COGS 100,A01,083619,Staff,0,21,60,60
1650104803076,COGS 101A,A01,083621,Davis; Joshua Daniel,0,18,60,60
1650104809101,COGS 101B,A01,091572,Staff,10,0,60,50
1650104815129,COGS 101C,A01,083625,Delgado; Tania,22,0,30,8
1650104821231,COGS 107A,A01,083627,Boyle; Mary E. T.,0,4,60,60
1650104827267,COGS 118A,A01,083075,Staff,17,0,60,43
1650104833312,CSE 3,A50,083646,Miranda; Gregory Joseph,22,0,38,16
1650104833312,CSE 3,A51,083647,Miranda; Gregory Joseph,37,0,37,0
1650104839336,CSE 8A,A50,083650,Miranda; Gregory Joseph,0,15,40,40
1650104845360,CSE 11,A01,083080,Cao; Yingjun,0,66,40,40
1650104851382,CSE 12,A01,083652,Staff,0,2,100,100
1650104857405,CSE 15L,A01,083654,Staff,0,0,50,50
1650104857405,CSE 15L,A02,083655,Staff,10,0,50,40
1650104863433,CSE 20,A01,083657,Staff,58,0,80,22
1650104869464,CSE 30,A01,083084,Eldon; John,0,63,40,40
1650104875489,CSE 100,A01,083659,Cao; Yingjun,0,61,50,50
1650104881515,CSE 134B,A01,083661,Powell; Thomas Allan,0,27,65,65
1650104887543,CSE 140,A01,083663,Staff,4,0,75,71
1650104893566,CSE 140L,A01,083088,Eldon; John,0,1,75,75
1650104899591,CSE 175,A01,083665,Kumar; Rakesh,8,0,25,17
1650104905622,CSE 190,A00,092507,Dubnov; Shlomo,14,0,20,6
1650104911651,ECE 45,A01,083139,Staff,0,13,40,40
1650104917676,ECE 65,A50,083695,Staff,0,4,30,30
1650104923702,ECE 109,A01,091882,Touri; Behrouz,48,0,70,22
1650104929731,ECE 180,A00,083140,Abi Samra; Nicholas Camill,24,0,30,6
1650104929731,ECE 180,B00,083141,Abi Samra; Nicholas Camill,8,0,30,22
1650104935756,MATH 10A,A01,083735,Patchell; Gregory David,12,0,30,18
1650104935756,MATH 10A,A02,083736,Patchell; Gregory David,28,0,30,2
1650104935756,MATH 10A,A03,083737,Patchell; Gregory David,26,0,30,4
1650104941781,MATH 10B,A01,083207,Staff,0,5,30,30
1650104941781,MATH 10B,A02,083208,Staff,0,4,30,30
1650104941781,MATH 10B,B01,083739,Staff,18,0,30,12
1650104941781,MATH 10B,B02,083740,Staff,29,0,30,1
1650104947830,MATH 18,A01,083743,Staff,10,0,30,20
1650104947830,MATH 18,A02,083744,Staff,28,0,30,2
1650104947830,MATH 18,A03,083745,Staff,23,0,30,7
1650104947830,MATH 18,A04,083746,Staff,27,0,30,3
1650104947830,MATH 18,B01,083748,Staff,0,9,30,30
1650104947830,MATH 18,B02,083749,Staff,0,6,30,30
1650104947830,MATH 18,B03,083750,Staff,0,6,30,30
1650104947830,MATH 18,B04,083751,Staff,0,6,30,30
1650104953858,MATH 20A,A01,083754,Staff,26,0,40,14
1650104959893,MATH 20B,A01,083756,Staff,0,5,30,30
1650104959893,MATH 20B,A02,083757,Staff,0,2,30,30
1650104965924,MATH 20C,A01,083760,Staff,0,11,30,30
1650104965924,MATH 20C,A02,083761,Staff,0,12,30,30
1650104965924,MATH 20C,B01,083762,Staff,14,0,30,16
1650104965924,MATH 20C,B02,083763,Staff,28,0,30,2
1650104971949,MATH 20D,A01,083765,Staff,0,2,30,30
1650104971949,MATH 20D,A02,083766,Staff,12,0,30,18
1650104971949,MATH 20D,A03,083767,Staff,28,0,30,2
1650104977972,MATH 20E,A01,083771,Staff,10,0,30,20
1650104977972,MATH 20E,A02,083772,Staff,20,0,30,10
1650104977972,MATH 20E,B01,083773,Staff,0,0,30,30
1650104977972,MATH 20E,B02,083774,Staff,13,0,30,17
1650104983998,MATH 103A,A01,083777,Staff,0,8,30,30
1650104983998,MATH 103A,A02,083778,Staff,0,7,30,30
1650104983998,MATH 103A,B01,083779,Staff,0,9,30,30
1650104983998,MATH 103A,B02,083780,Staff,0,6,30,30
1650104990030,MATH 105,A01,085443,Staff,0,13,30,30
1650104996061,MATH 109,A01,083213,Anzaldo; Leesa B,0,3,30,30
1650104996061,MATH 109,A02,083214,Anzaldo; Leesa B,0,5,30,30
1650104996061,MATH 109,B01,083215,Anzaldo; Leesa B,0,4,30,30
1650104996061,MATH 109,B02,083216,Anzaldo; Leesa B,0,4,30,30
1650105002090,MATH 142A,A01,083219,Chow; Bennett,0,10,30,30
1650105002090,MATH 142A,A02,083220,Chow; Bennett,0,10,30,30
1650105002090,MATH 142A,B01,083221,Chow; Bennett,0,10,30,30
1650105002090,MATH 142A,B02,083222,Chow; Bennett,0,9,30,30
1650105008129,MATH 193A,A01,083224,Staff,0,4,30,30
1650105008129,MATH 193A,A02,083225,Staff,0,4,30,30
1650105008129,MATH 193A,A03,083781,Staff,0,0,30,30
1650105008129,MATH 193A,A04,083782,Staff,2,0,30,28
1650105014162,MATH 197,001,091859,McAuley; Julian John,9998,0,9999,1
1650105020240,COGS 9,A01,083615,Staff,0,14,60,60
1650105026268,COGS 11,A01,083617,Boyle; Mary E. T.,24,0,40,16
1650105032293,COGS 13,A01,083071,Staff,0,28,40,40
1650105038325,COGS 14A,A01,092681,Staff,0,10,100,100
1650105044349,COGS 14B,A01,083073,Cheng; Tzu-Han,0,4,50,50
1650105050375,COGS 17,A01,092677,Staff,35,0,75,40
1650105056399,COGS 100,A01,083619,Staff,0,21,60,60
1650105062430,COGS 101A,A01,083621,Davis; Joshua Daniel,0,18,60,60
1650105068459,COGS 101B,A01,091572,Staff,10,0,60,50
1650105074484,COGS 101C,A01,083625,Delgado; Tania,22,0,30,8
1650105080510,COGS 107A,A01,083627,Boyle; Mary E. T.,0,4,60,60
1650105086535,COGS 118A,A01,083075,Staff,17,0,60,43
1650105092568,CSE 3,A50,083646,Miranda; Gregory Joseph,22,0,38,16
1650105092568,CSE 3,A51,083647,Miranda; Gregory Joseph,37,0,37,0
1650105098594,CSE 8A,A50,083650,Miranda; Gregory Joseph,0,15,40,40
1650105104625,CSE 11,A01,083080,Cao; Yingjun,0,66,40,40
1650105110656,CSE 12,A01,083652,Staff,0,2,100,100
1650105116679,CSE 15L,A01,083654,Staff,0,0,50,50
1650105116679,CSE 15L,A02,083655,Staff,10,0,50,40
1650105122715,CSE 20,A01,083657,Staff,58,0,80,22
1650105128740,CSE 30,A01,083084,Eldon; John,0,63,40,40
1650105134771,CSE 100,A01,083659,Cao; Yingjun,0,61,50,50
1650105140805,CSE 134B,A01,083661,Powell; Thomas Allan,0,27,65,65
1650105146838,CSE 140,A01,083663,Staff,4,0,75,71
1650105152869,CSE 140L,A01,083088,Eldon; John,0,1,75,75
1650105158895,CSE 175,A01,083665,Kumar; Rakesh,8,0,25,17
1650105164921,CSE 190,A00,092507,Dubnov; Shlomo,14,0,20,6
1650105170947,ECE 45,A01,083139,Staff,0,13,40,40
1650105176971,ECE 65,A50,083695,Staff,0,4,30,30
1650105182998,ECE 109,A01,091882,Touri; Behrouz,48,0,70,22
1650105189028,ECE 180,A00,083140,Abi Samra; Nicholas Camill,24,0,30,6
1650105189028,ECE 180,B00,083141,Abi Samra; Nicholas Camill,8,0,30,22
1650105195065,MATH 10A,A01,083735,Patchell; Gregory David,12,0,30,18
1650105195065,MATH 10A,A02,083736,Patchell; Gregory David,28,0,30,2
1650105195065,MATH 10A,A03,083737,Patchell; Gregory David,26,0,30,4
1650105201100,MATH 10B,A01,083207,Staff,0,5,30,30
1650105201100,MATH 10B,A02,083208,Staff,0,4,30,30
1650105201100,MATH 10B,B01,083739,Staff,18,0,30,12
1650105201100,MATH 10B,B02,083740,Staff,29,0,30,1
1650105207131,MATH 18,A01,083743,Staff,10,0,30,20
1650105207131,MATH 18,A02,083744,Staff,28,0,30,2
1650105207131,MATH 18,A03,083745,Staff,23,0,30,7
1650105207131,MATH 18,A04,083746,Staff,27,0,30,3
1650105207131,MATH 18,B01,083748,Staff,0,9,30,30
1650105207131,MATH 18,B02,083749,Staff,0,6,30,30
1650105207131,MATH 18,B03,083750,Staff,0,6,30,30
1650105207131,MATH 18,B04,083751,Staff,0,6,30,30
1650105213156,MATH 20A,A01,083754,Staff,26,0,40,14
1650105219181,MATH 20B,A01,083756,Staff,0,5,30,30
1650105219181,MATH 20B,A02,083757,Staff,0,2,30,30
1650105225212,MATH 20C,A01,083760,Staff,0,11,30,30
1650105225212,MATH 20C,A02,083761,Staff,0,12,30,30
1650105225212,MATH 20C,B01,083762,Staff,14,0,30,16
1650105225212,MATH 20C,B02,083763,Staff,28,0,30,2
1650105231237,MATH 20D,A01,083765,Staff,0,2,30,30
1650105231237,MATH 20D,A02,083766,Staff,12,0,30,18
1650105231237,MATH 20D,A03,083767,Staff,28,0,30,2
1650105237264,MATH 20E,A01,083771,Staff,10,0,30,20
1650105237264,MATH 20E,A02,083772,Staff,20,0,30,10
1650105237264,MATH 20E,B01,083773,Staff,0,0,30,30
1650105237264,MATH 20E,B02,083774,Staff,13,0,30,17
1650105243290,MATH 103A,A01,083777,Staff,0,8,30,30
1650105243290,MATH 103A,A02,083778,Staff,0,7,30,30
1650105243290,MATH 103A,B01,083779,Staff,0,9,30,30
1650105243290,MATH 103A,B02,083780,Staff,0,6,30,30
1650105249315,MATH 105,A01,085443,Staff,0,13,30,30
1650105255346,MATH 109,A01,083213,Anzaldo; Leesa B,0,3,30,30
1650105255346,MATH 109,A02,083214,Anzaldo; Leesa B,0,5,30,30
1650105255346,MATH 109,B01,083215,Anzaldo; Leesa B,0,4,30,30
1650105255346,MATH 109,B02,083216,Anzaldo; Leesa B,0,4,30,30
1650105261372,MATH 142A,A01,083219,Chow; Bennett,0,10,30,30
1650105261372,MATH 142A,A02,083220,Chow; Bennett,0,10,30,30
1650105261372,MATH 142A,B01,083221,Chow; Bennett,0,10,30,30
1650105261372,MATH 142A,B02,083222,Chow; Bennett,0,9,30,30
1650105267406,MATH 193A,A01,083224,Staff,0,4,30,30
1650105267406,MATH 193A,A02,083225,Staff,0,4,30,30
1650105267406,MATH 193A,A03,083781,Staff,0,0,30,30
1650105267406,MATH 193A,A04,083782,Staff,2,0,30,28
1650105273430,MATH 197,001,091859,McAuley; Julian John,9998,0,9999,1
1650105279526,COGS 9,A01,083615,Staff,0,14,60,60
1650105285551,COGS 11,A01,083617,Boyle; Mary E. T.,24,0,40,16
1650105291582,COGS 13,A01,083071,Staff,0,28,40,40
1650105297605,COGS 14A,A01,092681,Staff,0,10,100,100
1650105303631,COGS 14B,A01,083073,Cheng; Tzu-Han,0,4,50,50
1650105309654,COGS 17,A01,092677,Staff,35,0,75,40
1650105315680,COGS 100,A01,083619,Staff,0,21,60,60
1650105321709,COGS 101A,A01,083621,Davis; Joshua Daniel,0,18,60,60
1650105327741,COGS 101B,A01,091572,Staff,10,0,60,50
1650105333766,COGS 101C,A01,083625,Delgado; Tania,22,0,30,8
1650105339795,COGS 107A,A01,083627,Boyle; Mary E. T.,0,4,60,60
1650105345825,COGS 118A,A01,083075,Staff,17,0,60,43
1650105351858,CSE 3,A50,083646,Miranda; Gregory Joseph,22,0,38,16
1650105351858,CSE 3,A51,083647,Miranda; Gregory Joseph,37,0,37,0
1650105357881,CSE 8A,A50,083650,Miranda; Gregory Joseph,0,15,40,40
1650105363906,CSE 11,A01,083080,Cao; Yingjun,0,66,40,40
1650105369930,CSE 12,A01,083652,Staff,0,2,100,100
1650105375965,CSE 15L,A01,083654,Staff,0,0,50,50
1650105375965,CSE 15L,A02,083655,Staff,10,0,50,40
1650105381989,CSE 20,A01,083657,Staff,58,0,80,22
1650105388018,CSE 30,A01,083084,Eldon; John,0,63,40,40
1650105394042,CSE 100,A01,083659,Cao; Yingjun,0,61,50,50
1650105400068,CSE 134B,A01,083661,Powell; Thomas Allan,0,27,65,65
1650105406097,CSE 140,A01,083663,Staff,4,0,75,71
1650105412121,CSE 140L,A01,083088,Eldon; John,0,1,75,75
1650105418239,CSE 175,A01,083665,Kumar; Rakesh,8,0,25,17
1650105424275,CSE 190,A00,092507,Dubnov; Shlomo,14,0,20,6
1650105430301,ECE 45,A01,083139,Staff,0,13,40,40
1650105436326,ECE 65,A50,083695,Staff,0,4,30,30
1650105442350,ECE 109,A01,091882,Touri; Behrouz,48,0,70,22
1650105448377,ECE 180,A00,083140,Abi Samra; Nicholas Camill,24,0,30,6
1650105448377,ECE 180,B00,083141,Abi Samra; Nicholas Camill,8,0,30,22
1650105454413,MATH 10A,A01,083735,Patchell; Gregory David,12,0,30,18
1650105454413,MATH 10A,A02,083736,Patchell; Gregory David,28,0,30,2
1650105454413,MATH 10A,A03,083737,Patchell; Gregory David,26,0,30,4
1650105460443,MATH 10B,A01,083207,Staff,0,5,30,30
1650105460443,MATH 10B,A02,083208,Staff,0,4,30,30
1650105460443,MATH 10B,B01,083739,Staff,18,0,30,12
1650105460443,MATH 10B,B02,083740,Staff,29,0,30,1
1650105466479,MATH 18,A01,083743,Staff,10,0,30,20
1650105466479,MATH 18,A02,083744,Staff,28,0,30,2
1650105466479,MATH 18,A03,083745,Staff,23,0,30,7
1650105466479,MATH 18,A04,083746,Staff,27,0,30,3
1650105466479,MATH 18,B01,083748,Staff,0,9,30,30
1650105466479,MATH 18,B02,083749,Staff,0,6,30,30
1650105466479,MATH 18,B03,083750,Staff,0,6,30,30
1650105466479,MATH 18,B04,083751,Staff,0,6,30,30
1650105472508,MATH 20A,A01,083754,Staff,26,0,40,14
1650105478534,MATH 20B,A01,083756,Staff,0,5,30,30
1650105478534,MATH 20B,A02,083757,Staff,0,2,30,30
1650105484560,MATH 20C,A01,083760,Staff,0,11,30,30
1650105484560,MATH 20C,A02,083761,Staff,0,12,30,30
1650105484560,MATH 20C,B01,083762,Staff,14,0,30,16
1650105484560,MATH 20C,B02,083763,Staff,28,0,30,2
1650105490593,MATH 20D,A01,083765,Staff,0,2,30,30
1650105490593,MATH 20D,A02,083766,Staff,12,0,30,18
1650105490593,MATH 20D,A03,083767,Staff,28,0,30,2
1650105496617,MATH 20E,A01,083771,Staff,10,0,30,20
1650105496617,MATH 20E,A02,083772,Staff,20,0,30,10
1650105496617,MATH 20E,B01,083773,Staff,0,0,30,30
1650105496617,MATH 20E,B02,083774,Staff,13,0,30,17
1650105502643,MATH 103A,A01,083777,Staff,0,8,30,30
1650105502643,MATH 103A,A02,083778,Staff,0,7,30,30
1650105502643,MATH 103A,B01,083779,Staff,0,9,30,30
1650105502643,MATH 103A,B02,083780,Staff,0,6,30,30
1650105508667,MATH 105,A01,085443,Staff,0,13,30,30
1650105514695,MATH 109,A01,083213,Anzaldo; Leesa B,0,3,30,30
1650105514695,MATH 109,A02,083214,Anzaldo; Leesa B,0,5,30,30
1650105514695,MATH 109,B01,083215,Anzaldo; Leesa B,0,4,30,30
1650105514695,MATH 109,B02,083216,Anzaldo; Leesa B,0,4,30,30
1650105520727,MATH 142A,A01,083219,Chow; Bennett,0,10,30,30
1650105520727,MATH 142A,A02,083220,Chow; Bennett,0,10,30,30
1650105520727,MATH 142A,B01,083221,Chow; Bennett,0,10,30,30
1650105520727,MATH 142A,B02,083222,Chow; Bennett,0,9,30,30
1650105526751,MATH 193A,A01,083224,Staff,0,4,30,30
1650105526751,MATH 193A,A02,083225,Staff,0,4,30,30
1650105526751,MATH 193A,A03,083781,Staff,0,0,30,30
1650105526751,MATH 193A,A04,083782,Staff,2,0,30,28
1650105532778,MATH 197,001,091859,McAuley; Julian John,9998,0,9999,1
1650105538874,COGS 9,A01,083615,Staff,0,14,60,60
1650105544904,COGS 11,A01,083617,Boyle; Mary E. T.,24,0,40,16
1650105550931,COGS 13,A01,083071,Staff,0,28,40,40
1650105556956,COGS 14A,A01,092681,Staff,0,10,100,100
1650105562990,COGS 14B,A01,083073,Cheng; Tzu-Han,0,4,50,50
1650105569018,COGS 17,A01,092677,Staff,35,0,75,40
1650105575042,COGS 100,A01,083619,Staff,0,21,60,60
1650105581073,COGS 101A,A01,083621,Davis; Joshua Daniel,0,18,60,60
1650105587099,COGS 101B,A01,091572,Staff,10,0,60,50
1650105593124,COGS 101C,A01,083625,Delgado; Tania,22,0,30,8
1650105599150,COGS 107A,A01,083627,Boyle; Mary E. T.,0,4,60,60
1650105605174,COGS 118A,A01,083075,Staff,17,0,60,43
1650105611200,CSE 3,A50,083646,Miranda; Gregory Joseph,22,0,38,16
1650105611200,CSE 3,A51,083647,Miranda; Gregory Joseph,37,0,37,0
1650105617232,CSE 8A,A50,083650,Miranda; Gregory Joseph,0,15,40,40
1650105623258,CSE 11,A01,083080,Cao; Yingjun,0,66,40,40
1650105629280,CSE 12,A01,083652,Staff,0,2,100,100
1650105635303,CSE 15L,A01,083654,Staff,0,0,50,50
1650105635303,CSE 15L,A02,083655,Staff,10,0,50,40
1650105641327,CSE 20,A01,083657,Staff,58,0,80,22
1650105647350,CSE 30,A01,083084,Eldon; John,0,63,40,40
1650105653381,CSE 100,A01,083659,Cao; Yingjun,0,61,50,50
1650105659408,CSE 134B,A01,083661,Powell; Thomas Allan,0,27,65,65
1650105665437,CSE 140,A01,083663,Staff,4,0,75,71
1650105671468,CSE 140L,A01,083088,Eldon; John,0,1,75,75
1650105677497,CSE 175,A01,083665,Kumar; Rakesh,8,0,25,17
1650105683520,CSE 190,A00,092507,Dubnov; Shlomo,14,0,20,6
1650105689545,ECE 45,A01,083139,Staff,0,13,40,40
1650105695575,ECE 65,A50,083695,Staff,0,4,30,30
1650105701602,ECE 109,A01,091882,Touri; Behrouz,48,0,70,22
1650105707626,ECE 180,A00,083140,Abi Samra; Nicholas Camill,24,0,30,6
1650105707626,ECE 180,B00,083141,Abi Samra; Nicholas Camill,8,0,30,22
1650105713654,MATH 10A,A01,083735,Patchell; Gregory David,12,0,30,18
1650105713654,MATH 10A,A02,083736,Patchell; Gregory David,28,0,30,2
1650105713654,MATH 10A,A03,083737,Patchell; Gregory David,26,0,30,4
1650105719680,MATH 10B,A01,083207,Staff,0,5,30,30
1650105719680,MATH 10B,A02,083208,Staff,0,4,30,30
1650105719680,MATH 10B,B01,083739,Staff,18,0,30,12
1650105719680,MATH 10B,B02,083740,Staff,29,0,30,1
1650105725722,MATH 18,A01,083743,Staff,10,0,30,20
1650105725722,MATH 18,A02,083744,Staff,28,0,30,2
1650105725722,MATH 18,A03,083745,Staff,23,0,30,7
1650105725722,MATH 18,A04,083746,Staff,27,0,30,3
1650105725722,MATH 18,B01,083748,Staff,0,9,30,30
1650105725722,MATH 18,B02,083749,Staff,0,6,30,30
1650105725722,MATH 18,B03,083750,Staff,0,6,30,30
1650105725722,MATH 18,B04,083751,Staff,0,6,30,30
1650105731746,MATH 20A,A01,083754,Staff,26,0,40,14
1650105737773,MATH 20B,A01,083756,Staff,0,5,30,30
1650105737773,MATH 20B,A02,083757,Staff,0,2,30,30
1650105743798,MATH 20C,A01,083760,Staff,0,11,30,30
1650105743798,MATH 20C,A02,083761,Staff,0,12,30,30
1650105743798,MATH 20C,B01,083762,Staff,14,0,30,16
1650105743798,MATH 20C,B02,083763,Staff,28,0,30,2
1650105749823,MATH 20D,A01,083765,Staff,0,2,30,30
1650105749823,MATH 20D,A02,083766,Staff,12,0,30,18
1650105749823,MATH 20D,A03,083767,Staff,28,0,30,2
1650105755855,MATH 20E,A01,083771,Staff,10,0,30,20
1650105755855,MATH 20E,A02,083772,Staff,20,0,30,10
1650105755855,MATH 20E,B01,083773,Staff,0,0,30,30
1650105755855,MATH 20E,B02,083774,Staff,13,0,30,17
1650105761881,MATH 103A,A01,083777,Staff,0,8,30,30
1650105761881,MATH 103A,A02,083778,Staff,0,7,30,30
1650105761881,MATH 103A,B01,083779,Staff,0,9,30,30
1650105761881,MATH 103A,B02,083780,Staff,0,6,30,30
1650105767911,MATH 105,A01,085443,Staff,0,13,30,30
1650105773936,MATH 109,A01,083213,Anzaldo; Leesa B,0,3,30,30
1650105773936,MATH 109,A02,083214,Anzaldo; Leesa B,0,5,30,30
1650105773936,MATH 109,B01,083215,Anzaldo; Leesa B,0,4,30,30
1650105773936,MATH 109,B02,083216,Anzaldo; Leesa B,0,4,30,30
1650105779960,MATH 142A,A01,083219,Chow; Bennett,0,10,30,30
1650105779960,MATH 142A,A02,083220,Chow; Bennett,0,10,30,30
1650105779960,MATH 142A,B01,083221,Chow; Bennett,0,10,30,30
1650105779960,MATH 142A,B02,083222,Chow; Bennett,0,9,30,30
1650105785983,MATH 193A,A01,083224,Staff,0,4,30,30
1650105785983,MATH 193A,A02,083225,Staff,0,4,30,30
1650105785983,MATH 193A,A03,083781,Staff,0,0,30,30
1650105785983,MATH 193A,A04,083782,Staff,2,0,30,28
1650105792008,MATH 197,001,091859,McAuley; Julian John,9998,0,9999,1
1650105798086,COGS 9,A01,083615,Staff,0,14,60,60
1650105804111,COGS 11,A01,083617,Boyle; Mary E. T.,24,0,40,16
1650105810142,COGS 13,A01,083071,Staff,0,28,40,40
1650105816171,COGS 14A,A01,092681,Staff,0,10,100,100
1650105822199,COGS 14B,A01,083073,Cheng; Tzu-Han,0,4,50,50
1650105828231,COGS 17,A01,092677,Staff,35,0,75,40
1650105834261,COGS 100,A01,083619,Staff,0,21,60,60
1650105840307,COGS 101A,A01,083621,Davis; Joshua Daniel,0,18,60,60
1650105846332,COGS 101B,A01,091572,Staff,10,0,60,50
1650105852357,COGS 101C,A01,083625,Delgado; Tania,22,0,30,8
1650105858381,COGS 107A,A01,083627,Boyle; Mary E. T.,0,4,60,60
1650105864405,COGS 118A,A01,083075,Staff,17,0,60,43
1650105870431,CSE 3,A50,083646,Miranda; Gregory Joseph,22,0,38,16
1650105870431,CSE 3,A51,083647,Miranda; Gregory Joseph,37,0,37,0
1650105876461,CSE 8A,A50,083650,Miranda; Gregory Joseph,0,15,40,40
1650105882490,CSE 11,A01,083080,Cao; Yingjun,0,66,40,40
1650105888520,CSE 12,A01,083652,Staff,0,2,100,100
1650105894545,CSE 15L,A01,083654,Staff,0,0,50,50
1650105894545,CSE 15L,A02,083655,Staff,10,0,50,40
1650105900568,CSE 20,A01,083657,Staff,58,0,80,22
1650105906593,CSE 30,A01,083084,Eldon; John,0,63,40,40
1650105912623,CSE 100,A01,083659,Cao; Yingjun,0,61,50,50
1650105918659,CSE 134B,A01,083661,Powell; Thomas Allan,0,27,65,65
1650105924683,CSE 140,A01,083663,Staff,4,0,75,71
1650105930711,CSE 140L,A01,083088,Eldon; John,0,1,75,75
1650105936735,CSE 175,A01,083665,Kumar; Rakesh,8,0,25,17
1650105942758,CSE 190,A00,092507,Dubnov; Shlomo,14,0,20,6
1650105948781,ECE 45,A01,083139,Staff,0,13,40,40
1650105954814,ECE 65,A50,083695,Staff,0,4,30,30
1650105960837,ECE 109,A01,091882,Touri; Behrouz,48,0,70,22
1650105966861,ECE 180,A00,083140,Abi Samra; Nicholas Camill,24,0,30,6
1650105966861,ECE 180,B00,083141,Abi Samra; Nicholas Camill,8,0,30,22
1650105972902,MATH 10A,A01,083735,Patchell; Gregory David,12,0,30,18
1650105972902,MATH 10A,A02,083736,Patchell; Gregory David,28,0,30,2
1650105972902,MATH 10A,A03,083737,Patchell; Gregory David,26,0,30,4
1650105978931,MATH 10B,A01,083207,Staff,0,5,30,30
1650105978931,MATH 10B,A02,083208,Staff,0,4,30,30
1650105978931,MATH 10B,B01,083739,Staff,18,0,30,12
1650105978931,MATH 10B,B02,083740,Staff,29,0,30,1
1650105984976,MATH 18,A01,083743,Staff,10,0,30,20
1650105984976,MATH 18,A02,083744,Staff,28,0,30,2
1650105984976,MATH 18,A03,083745,Staff,23,0,30,7
1650105984976,MATH 18,A04,083746,Staff,27,0,30,3
1650105984976,MATH 18,B01,083748,Staff,0,9,30,30
1650105984976,MATH 18,B02,083749,Staff,0,6,30,30
1650105984976,MATH 18,B03,083750,Staff,0,6,30,30
1650105984976,MATH 18,B04,083751,Staff,0,6,30,30
1650105990999,MATH 20A,A01,083754,Staff,26,0,40,14
1650105997024,MATH 20B,A01,083756,Staff,0,5,30,30
1650105997024,MATH 20B,A02,083757,Staff,0,2,30,30
1650106003053,MATH 20C,A01,083760,Staff,0,11,30,30
1650106003053,MATH 20C,A02,083761,Staff,0,12,30,30
1650106003053,MATH 20C,B01,083762,Staff,14,0,30,16
1650106003053,MATH 20C,B02,083763,Staff,28,0,30,2
1650106009079,MATH 20D,A01,083765,Staff,0,2,30,30
1650106009079,MATH 20D,A02,083766,Staff,12,0,30,18
1650106009079,MATH 20D,A03,083767,Staff,28,0,30,2
1650106015228,MATH 20E,A01,083771,Staff,10,0,30,20
1650106015228,MATH 20E,A02,083772,Staff,20,0,30,10
1650106015228,MATH 20E,B01,083773,Staff,0,0,30,30
1650106015228,MATH 20E,B02,083774,Staff,13,0,30,17
1650106021259,MATH 103A,A01,083777,Staff,0,8,30,30
1650106021259,MATH 103A,A02,083778,Staff,0,7,30,30
1650106021259,MATH 103A,B01,083779,Staff,0,9,30,30
1650106021259,MATH 103A,B02,083780,Staff,0,6,30,30
1650106027287,MATH 105,A01,085443,Staff,0,13,30,30
1650106033321,MATH 109,A01,083213,Anzaldo; Leesa B,0,3,30,30
1650106033321,MATH 109,A02,083214,Anzaldo; Leesa B,0,5,30,30
1650106033321,MATH 109,B01,083215,Anzaldo; Leesa B,0,4,30,30
1650106033321,MATH 109,B02,083216,Anzaldo; Leesa B,0,4,30,30
1650106039348,MATH 142A,A01,083219,Chow; Bennett,0,10,30,30
1650106039348,MATH 142A,A02,083220,Chow; Bennett,0,10,30,30
1650106039348,MATH 142A,B01,083221,Chow; Bennett,0,10,30,30
1650106039348,MATH 142A,B02,083222,Chow; Bennett,0,9,30,30
1650106045374,MATH 193A,A01,083224,Staff,0,4,30,30
1650106045374,MATH 193A,A02,083225,Staff,0,4,30,30
1650106045374,MATH 193A,A03,083781,Staff,0,0,30,30
1650106045374,MATH 193A,A04,083782,Staff,2,0,30,28
1650106051404,MATH 197,001,091859,McAuley; Julian John,9998,0,9999,1
1650106057464,COGS 9,A01,083615,Staff,0,14,60,60
1650106063489,COGS 11,A01,083617,Boyle; Mary E. T.,24,0,40,16
1650106069522,COGS 13,A01,083071,Staff,0,28,40,40
1650106075551,COGS 14A,A01,092681,Staff,0,10,100,100
1650106081575,COGS 14B,A01,083073,Cheng; Tzu-Han,0,4,50,50
1650106087598,COGS 17,A01,092677,Staff,35,0,75,40
1650106093622,COGS 100,A01,083619,Staff,0,21,60,60
1650106099648,COGS 101A,A01,083621,Davis; Joshua Daniel,0,18,60,60
1650106105671,COGS 101B,A01,091572,Staff,10,0,60,50
1650106111697,COGS 101C,A01,083625,Delgado; Tania,22,0,30,8
1650106117722,COGS 107A,A01,083627,Boyle; Mary E. T.,0,4,60,60
1650106123745,COGS 118A,A01,083075,Staff,17,0,60,43
1650106129777,CSE 3,A50,083646,Miranda; Gregory Joseph,22,0,38,16
1650106129777,CSE 3,A51,083647,Miranda; Gregory Joseph,37,0,37,0
1650106135799,CSE 8A,A50,083650,Miranda; Gregory Joseph,0,15,40,40
1650106141827,CSE 11,A01,083080,Cao; Yingjun,0,66,40,40
1650106147857,CSE 12,A01,083652,Staff,0,2,100,100
1650106153880,CSE 15L,A01,083654,Staff,0,0,50,50
1650106153880,CSE 15L,A02,083655,Staff,10,0,50,40
1650106159907,CSE 20,A01,083657,Staff,58,0,80,22
1650106165937,CSE 30,A01,083084,Eldon; John,0,63,40,40
1650106171966,CSE 100,A01,083659,Cao; Yingjun,0,61,50,50
1650106177999,CSE 134B,A01,083661,Powell; Thomas Allan,0,27,65,65
1650106184023,CSE 140,A01,083663,Staff,4,0,75,71
1650106190057,CSE 140L,A01,083088,Eldon; John,0,1,75,75
1650106196087,CSE 175,A01,083665,Kumar; Rakesh,8,0,25,17
1650106202113,CSE 190,A00,092507,Dubnov; Shlomo,14,0,20,6
1650106208137,ECE 45,A01,083139,Staff,0,13,40,40
1650106214166,ECE 65,A50,083695,Staff,0,4,30,30
1650106220195,ECE 109,A01,091882,Touri; Behrouz,48,0,70,22
1650106226220,ECE 180,A00,083140,Abi Samra; Nicholas Camill,24,0,30,6
1650106226220,ECE 180,B00,083141,Abi Samra; Nicholas Camill,8,0,30,22
1650106232255,MATH 10A,A01,083735,Patchell; Gregory David,12,0,30,18
1650106232255,MATH 10A,A02,083736,Patchell; Gregory David,28,0,30,2
1650106232255,MATH 10A,A03,083737,Patchell; Gregory David,26,0,30,4
1650106238285,MATH 10B,A01,083207,Staff,0,5,30,30
1650106238285,MATH 10B,A02,083208,Staff,0,4,30,30
1650106238285,MATH 10B,B01,083739,Staff,18,0,30,12
1650106238285,MATH 10B,B02,083740,Staff,29,0,30,1
1650106244314,MATH 18,A01,083743,Staff,10,0,30,20
1650106244314,MATH 18,A02,083744,Staff,28,0,30,2
1650106244314,MATH 18,A03,083745,Staff,23,0,30,7
1650106244314,MATH 18,A04,083746,Staff,27,0,30,3
1650106244314,MATH 18,B01,083748,Staff,0,9,30,30
1650106244314,MATH 18,B02,083749,Staff,0,6,30,30
1650106244314,MATH 18,B03,083750,Staff,0,6,30,30
1650106244314,MATH 18,B04,083751,Staff,0,6,30,30
1650106250337,MATH 20A,A01,083754,Staff,26,0,40,14
1650106256362,MATH 20B,A01,083756,Staff,0,5,30,30
1650106256362,MATH 20B,A02,083757,Staff,0,2,30,30
1650106262391,MATH 20C,A01,083760,Staff,0,11,30,30
1650106262391,MATH 20C,A02,083761,Staff,0,12,30,30
1650106262391,MATH 20C,B01,083762,Staff,14,0,30,16
1650106262391,MATH 20C,B02,083763,Staff,28,0,30,2
1650106268416,MATH 20D,A01,083765,Staff,0,2,30,30
1650106268416,MATH 20D,A02,083766,Staff,12,0,30,18
1650106268416,MATH 20D,A03,083767,Staff,28,0,30,2
1650106274452,MATH 20E,A01,083771,Staff,10,0,30,20
1650106274452,MATH 20E,A02,083772,Staff,20,0,30,10
1650106274452,MATH 20E,B01,083773,Staff,0,0,30,30
1650106274452,MATH 20E,B02,083774,Staff,13,0,30,17
1650106280478,MATH 103A,A01,083777,Staff,0,8,30,30
1650106280478,MATH 103A,A02,083778,Staff,0,7,30,30
1650106280478,MATH 103A,B01,083779,Staff,0,9,30,30
1650106280478,MATH 103A,B02,083780,Staff,0,6,30,30
1650106286509,MATH 105,A01,085443,Staff,0,13,30,30
1650106292534,MATH 109,A01,083213,Anzaldo; Leesa B,0,3,30,30
1650106292534,MATH 109,A02,083214,Anzaldo; Leesa B,0,5,30,30
1650106292534,MATH 109,B01,083215,Anzaldo; Leesa B,0,4,30,30
1650106292534,MATH 109,B02,083216,Anzaldo; Leesa B,0,4,30,30
1650106298560,MATH 142A,A01,083219,Chow; Bennett,0,10,30,30
1650106298560,MATH 142A,A02,083220,Chow; Bennett,0,10,30,30
1650106298560,MATH 142A,B01,083221,Chow; Bennett,0,10,30,30
1650106298560,MATH 142A,B02,083222,Chow; Bennett,0,9,30,30
1650106304593,MATH 193A,A01,083224,Staff,0,4,30,30
1650106304593,MATH 193A,A02,083225,Staff,0,4,30,30
1650106304593,MATH 193A,A03,083781,Staff,0,0,30,30
1650106304593,MATH 193A,A04,083782,Staff,2,0,30,28
1650106310619,MATH 197,001,091859,McAuley; Julian John,9998,0,9999,1
1650106316699,COGS 9,A01,083615,Staff,0,14,60,60
1650106322740,COGS 11,A01,083617,Boyle; Mary E. T.,24,0,40,16
1650106328771,COGS 13,A01,083071,Staff,0,28,40,40
1650106334795,COGS 14A,A01,092681,Staff,0,10,100,100
1650106340821,COGS 14B,A01,083073,Cheng; Tzu-Han,0,4,50,50
1650106346846,COGS 17,A01,092677,Staff,35,0,75,40
1650106352870,COGS 100,A01,083619,Staff,0,21,60,60
1650106358897,COGS 101A,A01,083621,Davis; Joshua Daniel,0,18,60,60
1650106364926,COGS 101B,A01,091572,Staff,10,0,60,50
1650106370950,COGS 101C,A01,083625,Delgado; Tania,22,0,30,8
1650106376981,COGS 107A,A01,083627,Boyle; Mary E. T.,0,4,60,60
1650106383010,COGS 118A,A01,083075,Staff,17,0,60,43
1650106389045,CSE 3,A50,083646,Miranda; Gregory Joseph,22,0,38,16
1650106389045,CSE 3,A51,083647,Miranda; Gregory Joseph,37,0,37,0
1650106395075,CSE 8A,A50,083650,Miranda; Gregory Joseph,0,15,40,40
1650106401100,CSE 11,A01,083080,Cao; Yingjun,0,66,40,40
1650106407125,CSE 12,A01,083652,Staff,0,2,100,100
1650106413153,CSE 15L,A01,083654,Staff,0,0,50,50
1650106413153,CSE 15L,A02,083655,Staff,10,0,50,40
1650106419181,CSE 20,A01,083657,Staff,58,0,80,22
1650106425207,CSE 30,A01,083084,Eldon; John,0,63,40,40
1650106431231,CSE 100,A01,083659,Cao; Yingjun,0,61,50,50
1650106437256,CSE 134B,A01,083661,Powell; Thomas Allan,0,27,65,65
1650106443281,CSE 140,A01,083663,Staff,4,0,75,71
1650106449309,CSE 140L,A01,083088,Eldon; John,0,1,75,75
1650106455343,CSE 175,A01,083665,Kumar; Rakesh,8,0,25,17
1650106461370,CSE 190,A00,092507,Dubnov; Shlomo,14,0,20,6
1650106467400,ECE 45,A01,083139,Staff,0,13,40,40
1650106473426,ECE 65,A50,083695,Staff,0,4,30,30
1650106479452,ECE 109,A01,091882,Touri; Behrouz,48,0,70,22
1650106485478,ECE 180,A00,083140,Abi Samra; Nicholas Camill,24,0,30,6
1650106485478,ECE 180,B00,083141,Abi Samra; Nicholas Camill,8,0,30,22
1650106491515,MATH 10A,A01,083735,Patchell; Gregory David,12,0,30,18
1650106491515,MATH 10A,A02,083736,Patchell; Gregory David,28,0,30,2
1650106491515,MATH 10A,A03,083737,Patchell; Gregory David,26,0,30,4
1650106497541,MATH 10B,A01,083207,Staff,0,5,30,30
1650106497541,MATH 10B,A02,083208,Staff,0,4,30,30
1650106497541,MATH 10B,B01,083739,Staff,18,0,30,12
1650106497541,MATH 10B,B02,083740,Staff,29,0,30,1
1650106503586,MATH 18,A01,083743,Staff,10,0,30,20
1650106503586,MATH 18,A02,083744,Staff,28,0,30,2
1650106503586,MATH 18,A03,083745,Staff,23,0,30,7
1650106503586,MATH 18,A04,083746,Staff,27,0,30,3
1650106503586,MATH 18,B01,083748,Staff,0,9,30,30
1650106503586,MATH 18,B02,083749,Staff,0,6,30,30
1650106503586,MATH 18,B03,083750,Staff,0,6,30,30
1650106503586,MATH 18,B04,083751,Staff,0,6,30,30
1650106509611,MATH 20A,A01,083754,Staff,26,0,40,14
1650106515637,MATH 20B,A01,083756,Staff,0,5,30,30
1650106515637,MATH 20B,A02,083757,Staff,0,2,30,30
1650106521671,MATH 20C,A01,083760,Staff,0,11,30,30
1650106521671,MATH 20C,A02,083761,Staff,0,12,30,30
1650106521671,MATH 20C,B01,083762,Staff,14,0,30,16
1650106521671,MATH 20C,B02,083763,Staff,28,0,30,2
1650106527697,MATH 20D,A01,083765,Staff,0,2,30,30
1650106527697,MATH 20D,A02,083766,Staff,12,0,30,18
1650106527697,MATH 20D,A03,083767,Staff,28,0,30,2
1650106533721,MATH 20E,A01,083771,Staff,10,0,30,20
1650106533721,MATH 20E,A02,083772,Staff,20,0,30,10
1650106533721,MATH 20E,B01,083773,Staff,0,0,30,30
1650106533721,MATH 20E,B02,083774,Staff,13,0,30,17
1650106539746,MATH 103A,A01,083777,Staff,0,8,30,30
1650106539746,MATH 103A,A02,083778,Staff,0,7,30,30
1650106539746,MATH 103A,B01,083779,Staff,0,9,30,30
1650106539746,MATH 103A,B02,083780,Staff,0,6,30,30
1650106545770,MATH 105,A01,085443,Staff,0,13,30,30
1650106551798,MATH 109,A01,083213,Anzaldo; Leesa B,0,3,30,30
1650106551798,MATH 109,A02,083214,Anzaldo; Leesa B,0,5,30,30
1650106551798,MATH 109,B01,083215,Anzaldo; Leesa B,0,4,30,30
1650106551798,MATH 109,B02,083216,Anzaldo; Leesa B,0,4,30,30
1650106557822,MATH 142A,A01,083219,Chow; Bennett,0,10,30,30
1650106557822,MATH 142A,A02,083220,Chow; Bennett,0,10,30,30
1650106557822,MATH 142A,B01,083221,Chow; Bennett,0,10,30,30
1650106557822,MATH 142A,B02,083222,Chow; Bennett,0,9,30,30
1650106563847,MATH 193A,A01,083224,Staff,0,4,30,30
1650106563847,MATH 193A,A02,083225,Staff,0,4,30,30
1650106563847,MATH 193A,A03,083781,Staff,0,0,30,30
1650106563847,MATH 193A,A04,083782,Staff,2,0,30,28
1650106569871,MATH 197,001,091859,McAuley; Julian John,9998,0,9999,1
1650106575943,COGS 9,A01,083615,Staff,0,14,60,60
1650106581968,COGS 11,A01,083617,Boyle; Mary E. T.,24,0,40,16
1650106587993,COGS 13,A01,083071,Staff,0,28,40,40
1650106594022,COGS 14A,A01,092681,Staff,0,10,100,100
1650106600047,COGS 14B,A01,083073,Cheng; Tzu-Han,0,4,50,50
1650106606162,COGS 17,A01,092677,Staff,35,0,75,40
1650106612188,COGS 100,A01,083619,Staff,0,21,60,60
1650106618213,COGS 101A,A01,083621,Davis; Joshua Daniel,0,18,60,60
1650106624238,COGS 101B,A01,091572,Staff,10,0,60,50
1650106630269,COGS 101C,A01,083625,Delgado; Tania,22,0,30,8
1650106636293,COGS 107A,A01,083627,Boyle; Mary E. T.,0,4,60,60
1650106642318,COGS 118A,A01,083075,Staff,17,0,60,43
1650106648353,CSE 3,A50,083646,Miranda; Gregory Joseph,22,0,38,16
1650106648353,CSE 3,A51,083647,Miranda; Gregory Joseph,37,0,37,0
1650106654377,CSE 8A,A50,083650,Miranda; Gregory Joseph,0,15,40,40
1650106660403,CSE 11,A01,083080,Cao; Yingjun,0,66,40,40
1650106666426,CSE 12,A01,083652,Staff,0,2,100,100
1650106672454,CSE 15L,A01,083654,Staff,0,0,50,50
1650106672454,CSE 15L,A02,083655,Staff,10,0,50,40
1650106678478,CSE 20,A01,083657,Staff,58,0,80,22
1650106684503,CSE 30,A01,083084,Eldon; John,0,63,40,40
1650106690539,CSE 100,A01,083659,Cao; Yingjun,0,61,50,50
1650106696568,CSE 134B,A01,083661,Powell; Thomas Allan,0,27,65,65
1650106702598,CSE 140,A01,083663,Staff,4,0,75,71
1650106708626,CSE 140L,A01,083088,Eldon; John,0,1,75,75
1650106714651,CSE 175,A01,083665,Kumar; Rakesh,8,0,25,17
1650106720695,CSE 190,A00,092507,Dubnov; Shlomo,14,0,20,6
1650106726720,ECE 45,A01,083139,Staff,0,13,40,40
1650106732750,ECE 65,A50,083695,Staff,0,4,30,30
1650106738774,ECE 109,A01,091882,Touri; Behrouz,48,0,70,22
1650106744809,ECE 180,A00,083140,Abi Samra; Nicholas Camill,24,0,30,6
1650106744809,ECE 180,B00,083141,Abi Samra; Nicholas Camill,8,0,30,22
1650106750836,MATH 10A,A01,083735,Patchell; Gregory David,12,0,30,18
1650106750836,MATH 10A,A02,083736,Patchell; Gregory David,28,0,30,2
1650106750836,MATH 10A,A03,083737,Patchell; Gregory David,26,0,30,4
1650106756861,MATH 10B,A01,083207,Staff,0,5,30,30
1650106756861,MATH 10B,A02,083208,Staff,0,4,30,30
1650106756861,MATH 10B,B01,083739,Staff,18,0,30,12
1650106756861,MATH 10B,B02,083740,Staff,29,0,30,1
1650106762896,MATH 18,A01,083743,Staff,10,0,30,20
1650106762896,MATH 18,A02,083744,Staff,28,0,30,2
1650106762896,MATH 18,A03,083745,Staff,23,0,30,7
1650106762896,MATH 18,A04,083746,Staff,27,0,30,3
1650106762896,MATH 18,B01,083748,Staff,0,9,30,30
1650106762896,MATH 18,B02,083749,Staff,0,6,30,30
1650106762896,MATH 18,B03,083750,Staff,0,6,30,30
1650106762896,MATH 18,B04,083751,Staff,0,6,30,30
1650106768924,MATH 20A,A01,083754,Staff,26,0,40,14
1650106774951,MATH 20B,A01,083756,Staff,0,5,30,30
1650106774951,MATH 20B,A02,083757,Staff,0,2,30,30
1650106780976,MATH 20C,A01,083760,Staff,0,11,30,30
1650106780976,MATH 20C,A02,083761,Staff,0,12,30,30
1650106780976,MATH 20C,B01,083762,Staff,14,0,30,16
1650106780976,MATH 20C,B02,083763,Staff,28,0,30,2
1650106787002,MATH 20D,A01,083765,Staff,0,2,30,30
1650106787002,MATH 20D,A02,083766,Staff,12,0,30,18
1650106787002,MATH 20D,A03,083767,Staff,28,0,30,2
1650106793037,MATH 20E,A01,083771,Staff,10,0,30,20
1650106793037,MATH 20E,A02,083772,Staff,20,0,30,10
1650106793037,MATH 20E,B01,083773,Staff,0,0,30,30
1650106793037,MATH 20E,B02,083774,Staff,13,0,30,17
1650106799067,MATH 103A,A01,083777,Staff,0,8,30,30
1650106799067,MATH 103A,A02,083778,Staff,0,7,30,30
1650106799067,MATH 103A,B01,083779,Staff,0,9,30,30
1650106799067,MATH 103A,B02,083780,Staff,0,6,30,30
1650106805096,MATH 105,A01,085443,Staff,0,13,30,30
1650106811133,MATH 109,A01,083213,Anzaldo; Leesa B,0,3,30,30
1650106811133,MATH 109,A02,083214,Anzaldo; Leesa B,0,5,30,30
1650106811133,MATH 109,B01,083215,Anzaldo; Leesa B,0,4,30,30
1650106811133,MATH 109,B02,083216,Anzaldo; Leesa B,0,4,30,30
1650106817164,MATH 142A,A01,083219,Chow; Bennett,0,10,30,30
1650106817164,MATH 142A,A02,083220,Chow; Bennett,0,10,30,30
1650106817164,MATH 142A,B01,083221,Chow; Bennett,0,10,30,30
1650106817164,MATH 142A,B02,083222,Chow; Bennett,0,9,30,30
1650106823198,MATH 193A,A01,083224,Staff,0,4,30,30
1650106823198,MATH 193A,A02,083225,Staff,0,4,30,30
1650106823198,MATH 193A,A03,083781,Staff,0,0,30,30
1650106823198,MATH 193A,A04,083782,Staff,2,0,30,28
1650106829240,MATH 197,001,091859,McAuley; Julian John,9998,0,9999,1
1650106835318,COGS 9,A01,083615,Staff,0,14,60,60
1650106841343,COGS 11,A01,083617,Boyle; Mary E. T.,24,0,40,16
1650106847372,COGS 13,A01,083071,Staff,0,28,40,40
1650106853397,COGS 14A,A01,092681,Staff,0,10,100,100
1650106859422,COGS 14B,A01,083073,Cheng; Tzu-Han,0,4,50,50
1650106865450,COGS 17,A01,092677,Staff,35,0,75,40
1650106871475,COGS 100,A01,083619,Staff,0,21,60,60
1650106877508,COGS 101A,A01,083621,Davis; Joshua Daniel,0,18,60,60
1650106883532,COGS 101B,A01,091572,Staff,10,0,60,50
1650106889561,COGS 101C,A01,083625,Delgado; Tania,22,0,30,8
1650106895590,COGS 107A,A01,083627,Boyle; Mary E. T.,0,4,60,60
1650106901616,COGS 118A,A01,083075,Staff,17,0,60,43
1650106907651,CSE 3,A50,083646,Miranda; Gregory Joseph,22,0,38,16
1650106907651,CSE 3,A51,083647,Miranda; Gregory Joseph,37,0,37,0
1650106913676,CSE 8A,A50,083650,Miranda; Gregory Joseph,0,15,40,40
1650106919708,CSE 11,A01,083080,Cao; Yingjun,0,66,40,40
1650106925735,CSE 12,A01,083652,Staff,0,2,100,100
1650106931757,CSE 15L,A01,083654,Staff,0,0,50,50
1650106931757,CSE 15L,A02,083655,Staff,10,0,50,40
1650106937782,CSE 20,A01,083657,Staff,58,0,80,22
1650106943813,CSE 30,A01,083084,Eldon; John,0,63,40,40
1650106949845,CSE 100,A01,083659,Cao; Yingjun,0,61,50,50
1650106955872,CSE 134B,A01,083661,Powell; Thomas Allan,0,27,65,65
1650106961902,CSE 140,A01,083663,Staff,4,0,75,71
1650106967926,CSE 140L,A01,083088,Eldon; John,0,1,75,75
1650106973970,CSE 175,A01,083665,Kumar; Rakesh,8,0,25,17
1650106979995,CSE 190,A00,092507,Dubnov; Shlomo,14,0,20,6
1650106986019,ECE 45,A01,083139,Staff,0,13,40,40
1650106992044,ECE 65,A50,083695,Staff,0,4,30,30
1650106998070,ECE 109,A01,091882,Touri; Behrouz,48,0,70,22
1650107004094,ECE 180,A00,083140,Abi Samra; Nicholas Camill,24,0,30,6
1650107004094,ECE 180,B00,083141,Abi Samra; Nicholas Camill,8,0,30,22
1650107010131,MATH 10A,A01,083735,Patchell; Gregory David,12,0,30,18
1650107010131,MATH 10A,A02,083736,Patchell; Gregory David,28,0,30,2
1650107010131,MATH 10A,A03,083737,Patchell; Gregory David,26,0,30,4
1650107016155,MATH 10B,A01,083207,Staff,0,5,30,30
1650107016155,MATH 10B,A02,083208,Staff,0,4,30,30
1650107016155,MATH 10B,B01,083739,Staff,18,0,30,12
1650107016155,MATH 10B,B02,083740,Staff,29,0,30,1
1650107022184,MATH 18,A01,083743,Staff,10,0,30,20
1650107022184,MATH 18,A02,083744,Staff,28,0,30,2
1650107022184,MATH 18,A03,083745,Staff,23,0,30,7
1650107022184,MATH 18,A04,083746,Staff,27,0,30,3
1650107022184,MATH 18,B01,083748,Staff,0,9,30,30
1650107022184,MATH 18,B02,083749,Staff,0,6,30,30
1650107022184,MATH 18,B03,083750,Staff,0,6,30,30
1650107022184,MATH 18,B04,083751,Staff,0,6,30,30
1650107028208,MATH 20A,A01,083754,Staff,26,0,40,14
1650107034238,MATH 20B,A01,083756,Staff,0,5,30,30
1650107034238,MATH 20B,A02,083757,Staff,0,2,30,30
1650107040280,MATH 20C,A01,083760,Staff,0,11,30,30
1650107040280,MATH 20C,A02,083761,Staff,0,12,30,30
1650107040280,MATH 20C,B01,083762,Staff,14,0,30,16
1650107040280,MATH 20C,B02,083763,Staff,28,0,30,2
1650107046306,MATH 20D,A01,083765,Staff,0,2,30,30
1650107046306,MATH 20D,A02,083766,Staff,12,0,30,18
1650107046306,MATH 20D,A03,083767,Staff,28,0,30,2
1650107052342,MATH 20E,A01,083771,Staff,10,0,30,20
1650107052342,MATH 20E,A02,083772,Staff,20,0,30,10
1650107052342,MATH 20E,B01,083773,Staff,0,0,30,30
1650107052342,MATH 20E,B02,083774,Staff,13,0,30,17
1650107058371,MATH 103A,A01,083777,Staff,0,8,30,30
1650107058371,MATH 103A,A02,083778,Staff,0,7,30,30
1650107058371,MATH 103A,B01,083779,Staff,0,9,30,30
1650107058371,MATH 103A,B02,083780,Staff,0,6,30,30
1650107064400,MATH 105,A01,085443,Staff,0,13,30,30
1650107070424,MATH 109,A01,083213,Anzaldo; Leesa B,0,3,30,30
1650107070424,MATH 109,A02,083214,Anzaldo; Leesa B,0,5,30,30
1650107070424,MATH 109,B01,083215,Anzaldo; Leesa B,0,4,30,30
1650107070424,MATH 109,B02,083216,Anzaldo; Leesa B,0,4,30,30
1650107076450,MATH 142A,A01,083219,Chow; Bennett,0,10,30,30
1650107076450,MATH 142A,A02,083220,Chow; Bennett,0,10,30,30
1650107076450,MATH 142A,B01,083221,Chow; Bennett,0,10,30,30
1650107076450,MATH 142A,B02,083222,Chow; Bennett,0,9,30,30
1650107082476,MATH 193A,A01,083224,Staff,0,4,30,30
1650107082476,MATH 193A,A02,083225,Staff,0,4,30,30
1650107082476,MATH 193A,A03,083781,Staff,0,0,30,30
1650107082476,MATH 193A,A04,083782,Staff,2,0,30,28
1650107088512,MATH 197,001,091859,McAuley; Julian John,9998,0,9999,1
1650107094581,COGS 9,A01,083615,Staff,0,14,60,60
1650107100605,COGS 11,A01,083617,Boyle; Mary E. T.,24,0,40,16
1650107106640,COGS 13,A01,083071,Staff,0,28,40,40
1650107112668,COGS 14A,A01,092681,Staff,0,10,100,100
1650107118698,COGS 14B,A01,083073,Cheng; Tzu-Han,0,4,50,50
1650107124734,COGS 17,A01,092677,Staff,35,0,75,40
1650107130758,COGS 100,A01,083619,Staff,0,21,60,60
1650107136784,COGS 101A,A01,083621,Davis; Joshua Daniel,0,18,60,60
1650107142809,COGS 101B,A01,091572,Staff,10,0,60,50
1650107148835,COGS 101C,A01,083625,Delgado; Tania,22,0,30,8
1650107154867,COGS 107A,A01,083627,Boyle; Mary E. T.,0,4,60,60
1650107160899,COGS 118A,A01,083075,Staff,17,0,60,43
1650107166930,CSE 3,A50,083646,Miranda; Gregory Joseph,22,0,38,16
1650107166930,CSE 3,A51,083647,Miranda; Gregory Joseph,37,0,37,0
1650107172961,CSE 8A,A50,083650,Miranda; Gregory Joseph,0,15,40,40
1650107178986,CSE 11,A01,083080,Cao; Yingjun,0,66,40,40
1650107185019,CSE 12,A01,083652,Staff,0,2,100,100
1650107191044,CSE 15L,A01,083654,Staff,0,0,50,50
1650107191044,CSE 15L,A02,083655,Staff,10,0,50,40
1650107197069,CSE 20,A01,083657,Staff,58,0,80,22
1650107203182,CSE 30,A01,083084,Eldon; John,0,63,40,40
1650107209208,CSE 100,A01,083659,Cao; Yingjun,0,61,50,50
1650107215239,CSE 134B,A01,083661,Powell; Thomas Allan,0,27,65,65
1650107221264,CSE 140,A01,083663,Staff,4,0,75,71
1650107227290,CSE 140L,A01,083088,Eldon; John,0,1,75,75
1650107233317,CSE 175,A01,083665,Kumar; Rakesh,8,0,25,17
1650107239348,CSE 190,A00,092507,Dubnov; Shlomo,14,0,20,6
1650107245378,ECE 45,A01,083139,Staff,0,13,40,40
1650107251404,ECE 65,A50,083695,Staff,0,4,30,30
1650107257446,ECE 109,A01,091882,Touri; Behrouz,48,0,70,22
1650107263479,ECE 180,A00,083140,Abi Samra; Nicholas Camill,24,0,30,6
1650107263479,ECE 180,B00,083141,Abi Samra; Nicholas Camill,8,0,30,22
1650107269506,MATH 10A,A01,083735,Patchell; Gregory David,12,0,30,18
1650107269506,MATH 10A,A02,083736,Patchell; Gregory David,28,0,30,2
1650107269506,MATH 10A,A03,083737,Patchell; Gregory David,26,0,30,4
1650107275618,MATH 10B,A01,083207,Staff,0,5,30,30
1650107275618,MATH 10B,A02,083208,Staff,0,4,30,30
1650107275618,MATH 10B,B01,083739,Staff,18,0,30,12
1650107275618,MATH 10B,B02,083740,Staff,29,0,30,1
1650107281647,MATH 18,A01,083743,Staff,10,0,30,20
1650107281647,MATH 18,A02,083744,Staff,28,0,30,2
1650107281647,MATH 18,A03,083745,Staff,23,0,30,7
1650107281647,MATH 18,A04,083746,Staff,27,0,30,3
1650107281647,MATH 18,B01,083748,Staff,0,9,30,30
1650107281647,MATH 18,B02,083749,Staff,0,6,30,30
1650107281647,MATH 18,B03,083750,Staff,0,6,30,30
1650107281647,MATH 18,B04,083751,Staff,0,6,30,30
1650107287675,MATH 20A,A01,083754,Staff,26,0,40,14
1650107293705,MATH 20B,A01,083756,Staff,0,5,30,30
1650107293705,MATH 20B,A02,083757,Staff,0,2,30,30
1650107299731,MATH 20C,A01,083760,Staff,0,11,30,30
1650107299731,MATH 20C,A02,083761,Staff,0,12,30,30
1650107299731,MATH 20C,B01,083762,Staff,14,0,30,16
1650107299731,MATH 20C,B02,083763,Staff,28,0,30,2
1650107305754,MATH 20D,A01,083765,Staff,0,2,30,30
1650107305754,MATH 20D,A02,083766,Staff,12,0,30,18
1650107305754,MATH 20D,A03,083767,Staff,28,0,30,2
1650107311780,MATH 20E,A01,083771,Staff,10,0,30,20
1650107311780,MATH 20E,A02,083772,Staff,20,0,30,10
1650107311780,MATH 20E,B01,083773,Staff,0,0,30,30
1650107311780,MATH 20E,B02,083774,Staff,13,0,30,17
1650107317806,MATH 103A,A01,083777,Staff,0,8,30,30
1650107317806,MATH 103A,A02,083778,Staff,0,7,30,30
1650107317806,MATH 103A,B01,083779,Staff,0,9,30,30
1650107317806,MATH 103A,B02,083780,Staff,0,6,30,30
1650107323833,MATH 105,A01,085443,Staff,0,13,30,30
1650107329859,MATH 109,A01,083213,Anzaldo; Leesa B,0,3,30,30
1650107329859,MATH 109,A02,083214,Anzaldo; Leesa B,0,5,30,30
1650107329859,MATH 109,B01,083215,Anzaldo; Leesa B,0,4,30,30
1650107329859,MATH 109,B02,083216,Anzaldo; Leesa B,0,4,30,30
1650107335886,MATH 142A,A01,083219,Chow; Bennett,0,10,30,30
1650107335886,MATH 142A,A02,083220,Chow; Bennett,0,10,30,30
1650107335886,MATH 142A,B01,083221,Chow; Bennett,0,10,30,30
1650107335886,MATH 142A,B02,083222,Chow; Bennett,0,9,30,30
1650107341910,MATH 193A,A01,083224,Staff,0,4,30,30
1650107341910,MATH 193A,A02,083225,Staff,0,4,30,30
1650107341910,MATH 193A,A03,083781,Staff,0,0,30,30
1650107341910,MATH 193A,A04,083782,Staff,2,0,30,28
1650107347935,MATH 197,001,091859,McAuley; Julian John,9998,0,9999,1
1650107354011,COGS 9,A01,083615,Staff,0,14,60,60
1650107360044,COGS 11,A01,083617,Boyle; Mary E. T.,24,0,40,16
1650107366067,COGS 13,A01,083071,Staff,0,28,40,40
1650107372098,COGS 14A,A01,092681,Staff,0,10,100,100
1650107378132,COGS 14B,A01,083073,Cheng; Tzu-Han,0,4,50,50
1650107384159,COGS 17,A01,092677,Staff,35,0,75,40
1650107390185,COGS 100,A01,083619,Staff,0,21,60,60
1650107396217,COGS 101A,A01,083621,Davis; Joshua Daniel,0,18,60,60
1650107402248,COGS 101B,A01,091572,Staff,10,0,60,50
1650107408271,COGS 101C,A01,083625,Delgado; Tania,22,0,30,8
1650107414295,COGS 107A,A01,083627,Boyle; Mary E. T.,0,4,60,60
1650107420321,COGS 118A,A01,083075,Staff,17,0,60,43
1650107426356,CSE 3,A50,083646,Miranda; Gregory Joseph,22,0,38,16
1650107426356,CSE 3,A51,083647,Miranda; Gregory Joseph,37,0,37,0
1650107432381,CSE 8A,A50,083650,Miranda; Gregory Joseph,0,15,40,40
1650107438407,CSE 11,A01,083080,Cao; Yingjun,0,66,40,40
1650107444434,CSE 12,A01,083652,Staff,0,2,100,100
1650107450462,CSE 15L,A01,083654,Staff,0,0,50,50
1650107450462,CSE 15L,A02,083655,Staff,10,0,50,40
1650107456487,CSE 20,A01,083657,Staff,58,0,80,22
1650107462518,CSE 30,A01,083084,Eldon; John,0,63,40,40
1650107468544,CSE 100,A01,083659,Cao; Yingjun,0,61,50,50
1650107474570,CSE 134B,A01,083661,Powell; Thomas Allan,0,27,65,65
1650107480594,CSE 140,A01,083663,Staff,4,0,75,71
1650107486623,CSE 140L,A01,083088,Eldon; John,0,1,75,75
1650107492653,CSE 175,A01,083665,Kumar; Rakesh,8,0,25,17
1650107509184,CSE 190,A00,092507,Dubnov; Shlomo,14,0,20,6
1650107515213,ECE 45,A01,083139,Staff,0,13,40,40
1650107521238,ECE 65,A50,083695,Staff,0,4,30,30
1650107527263,ECE 109,A01,091882,Touri; Behrouz,48,0,70,22
1650107533288,ECE 180,A00,083140,Abi Samra; Nicholas Camill,24,0,30,6
1650107533288,ECE 180,B00,083141,Abi Samra; Nicholas Camill,8,0,30,22
1650107539324,MATH 10A,A01,083735,Patchell; Gregory David,12,0,30,18
1650107539324,MATH 10A,A02,083736,Patchell; Gregory David,28,0,30,2
1650107539324,MATH 10A,A03,083737,Patchell; Gregory David,26,0,30,4
1650107545356,MATH 10B,A01,083207,Staff,0,5,30,30
1650107545356,MATH 10B,A02,083208,Staff,0,4,30,30
1650107545356,MATH 10B,B01,083739,Staff,18,0,30,12
1650107545356,MATH 10B,B02,083740,Staff,29,0,30,1
1650107551393,MATH 18,A01,083743,Staff,10,0,30,20
1650107551393,MATH 18,A02,083744,Staff,28,0,30,2
1650107551393,MATH 18,A03,083745,Staff,23,0,30,7
1650107551393,MATH 18,A04,083746,Staff,27,0,30,3
1650107551393,MATH 18,B01,083748,Staff,0,9,30,30
1650107551393,MATH 18,B02,083749,Staff,0,6,30,30
1650107551393,MATH 18,B03,083750,Staff,0,6,30,30
1650107551393,MATH 18,B04,083751,Staff,0,6,30,30
1650107557419,MATH 20A,A01,083754,Staff,26,0,40,14
1650107563448,MATH 20B,A01,083756,Staff,0,5,30,30
1650107563448,MATH 20B,A02,083757,Staff,0,2,30,30
1650107569474,MATH 20C,A01,083760,Staff,0,11,30,30
1650107569474,MATH 20C,A02,083761,Staff,0,12,30,30
1650107569474,MATH 20C,B01,083762,Staff,14,0,30,16
1650107569474,MATH 20C,B02,083763,Staff,28,0,30,2
1650107575498,MATH 20D,A01,083765,Staff,0,2,30,30
1650107575498,MATH 20D,A02,083766,Staff,12,0,30,18
1650107575498,MATH 20D,A03,083767,Staff,28,0,30,2
1650107581525,MATH 20E,A01,083771,Staff,10,0,30,20
1650107581525,MATH 20E,A02,083772,Staff,20,0,30,10
1650107581525,MATH 20E,B01,083773,Staff,0,0,30,30
1650107581525,MATH 20E,B02,083774,Staff,13,0,30,17
1650107587555,MATH 103A,A01,083777,Staff,0,8,30,30
1650107587555,MATH 103A,A02,083778,Staff,0,7,30,30
1650107587555,MATH 103A,B01,083779,Staff,0,9,30,30
1650107587555,MATH 103A,B02,083780,Staff,0,6,30,30
1650107593581,MATH 105,A01,085443,Staff,0,13,30,30
1650107599608,MATH 109,A01,083213,Anzaldo; Leesa B,0,3,30,30
1650107599608,MATH 109,A02,083214,Anzaldo; Leesa B,0,5,30,30
1650107599608,MATH 109,B01,083215,Anzaldo; Leesa B,0,4,30,30
1650107599608,MATH 109,B02,083216,Anzaldo; Leesa B,0,4,30,30
1650107605633,MATH 142A,A01,083219,Chow; Bennett,0,10,30,30
1650107605633,MATH 142A,A02,083220,Chow; Bennett,0,10,30,30
1650107605633,MATH 142A,B01,083221,Chow; Bennett,0,10,30,30
1650107605633,MATH 142A,B02,083222,Chow; Bennett,0,9,30,30
1650107611657,MATH 193A,A01,083224,Staff,0,4,30,30
1650107611657,MATH 193A,A02,083225,Staff,0,4,30,30
1650107611657,MATH 193A,A03,083781,Staff,0,0,30,30
1650107611657,MATH 193A,A04,083782,Staff,2,0,30,28
1650107617683,MATH 197,001,091859,McAuley; Julian John,9998,0,9999,1
1650107623747,COGS 9,A01,083615,Staff,0,14,60,60
1650107629776,COGS 11,A01,083617,Boyle; Mary E. T.,24,0,40,16
1650107635805,COGS 13,A01,083071,Staff,0,28,40,40
1650107641830,COGS 14A,A01,092681,Staff,0,10,100,100
1650107647871,COGS 14B,A01,083073,Cheng; Tzu-Han,0,4,50,50
1650107653898,COGS 17,A01,092677,Staff,35,0,75,40
1650107659924,COGS 100,A01,083619,Staff,0,21,60,60
1650107665950,COGS 101A,A01,083621,Davis; Joshua Daniel,0,18,60,60
1650107671973,COGS 101B,A01,091572,Staff,10,0,60,50
1650107678002,COGS 101C,A01,083625,Delgado; Tania,22,0,30,8
1650107684026,COGS 107A,A01,083627,Boyle; Mary E. T.,0,4,60,60
1650107690050,COGS 118A,A01,083075,Staff,17,0,60,43
1650107696083,CSE 3,A50,083646,Miranda; Gregory Joseph,22,0,38,16
1650107696083,CSE 3,A51,083647,Miranda; Gregory Joseph,37,0,37,0
1650107702114,CSE 8A,A50,083650,Miranda; Gregory Joseph,0,15,40,40
1650107708139,CSE 11,A01,083080,Cao; Yingjun,0,66,40,40
1650107714169,CSE 12,A01,083652,Staff,0,2,100,100
1650107720192,CSE 15L,A01,083654,Staff,0,0,50,50
1650107720192,CSE 15L,A02,083655,Staff,10,0,50,40
1650107726220,CSE 20,A01,083657,Staff,58,0,80,22
1650107732244,CSE 30,A01,083084,Eldon; John,0,63,40,40
1650107738267,CSE 100,A01,083659,Cao; Yingjun,0,61,50,50
1650107744291,CSE 134B,A01,083661,Powell; Thomas Allan,0,27,65,65
1650107750317,CSE 140,A01,083663,Staff,4,0,75,71
1650107756354,CSE 140L,A01,083088,Eldon; John,0,1,75,75
1650107762384,CSE 175,A01,083665,Kumar; Rakesh,8,0,25,17
1650107768408,CSE 190,A00,092507,Dubnov; Shlomo,14,0,20,6
1650107774438,ECE 45,A01,083139,Staff,0,13,40,40
1650107780462,ECE 65,A50,083695,Staff,0,4,30,30
1650107786487,ECE 109,A01,091882,Touri; Behrouz,48,0,70,22
1650107792513,ECE 180,A00,083140,Abi Samra; Nicholas Camill,24,0,30,6
1650107792513,ECE 180,B00,083141,Abi Samra; Nicholas Camill,8,0,30,22
1650107798539,MATH 10A,A01,083735,Patchell; Gregory David,12,0,30,18
1650107798539,MATH 10A,A02,083736,Patchell; Gregory David,28,0,30,2
1650107798539,MATH 10A,A03,083737,Patchell; Gregory David,26,0,30,4
1650107804565,MATH 10B,A01,083207,Staff,0,5,30,30
1650107804565,MATH 10B,A02,083208,Staff,0,4,30,30
1650107804565,MATH 10B,B01,083739,Staff,18,0,30,12
1650107804565,MATH 10B,B02,083740,Staff,29,0,30,1
1650107810665,MATH 18,A01,083743,Staff,10,0,30,20
1650107810665,MATH 18,A02,083744,Staff,28,0,30,2
1650107810665,MATH 18,A03,083745,Staff,23,0,30,7
1650107810665,MATH 18,A04,083746,Staff,27,0,30,3
1650107810665,MATH 18,B01,083748,Staff,0,9,30,30
1650107810665,MATH 18,B02,083749,Staff,0,6,30,30
1650107810665,MATH 18,B03,083750,Staff,0,6,30,30
1650107810665,MATH 18,B04,083751,Staff,0,6,30,30
1650107816692,MATH 20A,A01,083754,Staff,26,0,40,14
1650107822720,MATH 20B,A01,083756,Staff,0,5,30,30
1650107822720,MATH 20B,A02,083757,Staff,0,2,30,30
1650107828751,MATH 20C,A01,083760,Staff,0,11,30,30
1650107828751,MATH 20C,A02,083761,Staff,0,12,30,30
1650107828751,MATH 20C,B01,083762,Staff,14,0,30,16
1650107828751,MATH 20C,B02,083763,Staff,28,0,30,2
1650107834774,MATH 20D,A01,083765,Staff,0,2,30,30
1650107834774,MATH 20D,A02,083766,Staff,12,0,30,18
1650107834774,MATH 20D,A03,083767,Staff,28,0,30,2
1650107840800,MATH 20E,A01,083771,Staff,10,0,30,20
1650107840800,MATH 20E,A02,083772,Staff,20,0,30,10
1650107840800,MATH 20E,B01,083773,Staff,0,0,30,30
1650107840800,MATH 20E,B02,083774,Staff,13,0,30,17
1650107846832,MATH 103A,A01,083777,Staff,0,8,30,30
1650107846832,MATH 103A,A02,083778,Staff,0,7,30,30
1650107846832,MATH 103A,B01,083779,Staff,0,9,30,30
1650107846832,MATH 103A,B02,083780,Staff,0,6,30,30
1650107852862,MATH 105,A01,085443,Staff,0,13,30,30
1650107858888,MATH 109,A01,083213,Anzaldo; Leesa B,0,3,30,30
1650107858888,MATH 109,A02,083214,Anzaldo; Leesa B,0,5,30,30
1650107858888,MATH 109,B01,083215,Anzaldo; Leesa B,0,4,30,30
1650107858888,MATH 109,B02,083216,Anzaldo; Leesa B,0,4,30,30
1650107864914,MATH 142A,A01,083219,Chow; Bennett,0,10,30,30
1650107864914,MATH 142A,A02,083220,Chow; Bennett,0,10,30,30
1650107864914,MATH 142A,B01,083221,Chow; Bennett,0,10,30,30
1650107864914,MATH 142A,B02,083222,Chow; Bennett,0,9,30,30
1650107870942,MATH 193A,A01,083224,Staff,0,4,30,30
1650107870942,MATH 193A,A02,083225,Staff,0,4,30,30
1650107870942,MATH 193A,A03,083781,Staff,0,0,30,30
1650107870942,MATH 193A,A04,083782,Staff,2,0,30,28
1650107876967,MATH 197,001,091859,McAuley; Julian John,9998,0,9999,1
1650107883021,COGS 9,A01,083615,Staff,0,14,60,60
