time,subj_course_id,sec_code,sec_id,prof,available,waitlist,total,enrolled_ct
1650108873841,COGS 9,A01,083615,Staff,0,14,60,60
1650108879872,COGS 11,A01,083617,Boyle; Mary E. T.,24,0,40,16
1650108885899,COGS 13,A01,083071,Staff,0,28,40,40
1650108891931,COGS 14A,A01,092681,Staff,0,10,100,100
1650108897957,COGS 14B,A01,083073,Cheng; Tzu-Han,0,4,50,50
1650108904002,COGS 17,A01,092677,Staff,35,0,75,40
1650108910027,COGS 100,A01,083619,Staff,0,21,60,60
1650108916056,COGS 101A,A01,083621,Davis; Joshua Daniel,0,18,60,60
1650108922087,COGS 101B,A01,091572,Staff,10,0,60,50
1650108928114,COGS 101C,A01,083625,Delgado; Tania,22,0,30,8
1650108934140,COGS 107A,A01,083627,Boyle; Mary E. T.,0,4,60,60
1650108940169,COGS 118A,A01,083075,Staff,17,0,60,43
1650108946204,CSE 3,A50,083646,Miranda; Gregory Joseph,22,0,38,16
1650108946204,CSE 3,A51,083647,Miranda; Gregory Joseph,37,0,37,0
1650108952234,CSE 8A,A50,083650,Miranda; Gregory Joseph,0,15,40,40
1650108958266,CSE 11,A01,083080,Cao; Yingjun,0,66,40,40
1650108964293,CSE 12,A01,083652,Staff,0,2,100,100
1650108970325,CSE 15L,A01,083654,Staff,0,0,50,50
1650108970325,CSE 15L,A02,083655,Staff,10,0,50,40
1650108976349,CSE 20,A01,083657,Staff,58,0,80,22
1650108982374,CSE 30,A01,083084,Eldon; John,0,63,40,40
1650108988408,CSE 100,A01,083659,Cao; Yingjun,0,61,50,50
1650108994435,CSE 134B,A01,083661,Powell; Thomas Allan,0,27,65,65
1650109000459,CSE 140,A01,083663,Staff,4,0,75,71
1650109006484,CSE 140L,A01,083088,Eldon; John,0,1,75,75
1650109012517,CSE 175,A01,083665,Kumar; Rakesh,8,0,25,17
1650109018550,CSE 190,A00,092507,Dubnov; Shlomo,14,0,20,6
1650109024577,ECE 45,A01,083139,Staff,0,13,40,40
1650109030609,ECE 65,A50,083695,Staff,0,4,30,30
1650109036644,ECE 109,A01,091882,Touri; Behrouz,48,0,70,22
1650109042672,ECE 180,A00,083140,Abi Samra; Nicholas Camill,24,0,30,6
1650109042672,ECE 180,B00,083141,Abi Samra; Nicholas Camill,8,0,30,22
1650109048703,MATH 10A,A01,083735,Patchell; Gregory David,12,0,30,18
1650109048703,MATH 10A,A02,083736,Patchell; Gregory David,28,0,30,2
1650109048703,MATH 10A,A03,083737,Patchell; Gregory David,26,0,30,4
1650109054733,MATH 10B,A01,083207,Staff,0,5,30,30
1650109054733,MATH 10B,A02,083208,Staff,0,4,30,30
1650109054733,MATH 10B,B01,083739,Staff,18,0,30,12
1650109054733,MATH 10B,B02,083740,Staff,29,0,30,1
1650109060768,MATH 18,A01,083743,Staff,10,0,30,20
1650109060768,MATH 18,A02,083744,Staff,28,0,30,2
1650109060768,MATH 18,A03,083745,Staff,23,0,30,7
1650109060768,MATH 18,A04,083746,Staff,27,0,30,3
1650109060768,MATH 18,B01,083748,Staff,0,9,30,30
1650109060768,MATH 18,B02,083749,Staff,0,7,30,30
1650109060768,MATH 18,B03,083750,Staff,0,6,30,30
1650109060768,MATH 18,B04,083751,Staff,0,6,30,30
1650109066800,MATH 20A,A01,083754,Staff,26,0,40,14
1650109072828,MATH 20B,A01,083756,Staff,0,5,30,30
1650109072828,MATH 20B,A02,083757,Staff,0,2,30,30
1650109078862,MATH 20C,A01,083760,Staff,0,11,30,30
1650109078862,MATH 20C,A02,083761,Staff,0,12,30,30
1650109078862,MATH 20C,B01,083762,Staff,14,0,30,16
1650109078862,MATH 20C,B02,083763,Staff,28,0,30,2
1650109084893,MATH 20D,A01,083765,Staff,0,2,30,30
1650109084893,MATH 20D,A02,083766,Staff,12,0,30,18
1650109084893,MATH 20D,A03,083767,Staff,28,0,30,2
1650109090927,MATH 20E,A01,083771,Staff,10,0,30,20
1650109090927,MATH 20E,A02,083772,Staff,20,0,30,10
1650109090927,MATH 20E,B01,083773,Staff,0,0,30,30
1650109090927,MATH 20E,B02,083774,Staff,13,0,30,17
1650109096956,MATH 103A,A01,083777,Staff,0,8,30,30
1650109096956,MATH 103A,A02,083778,Staff,0,7,30,30
1650109096956,MATH 103A,B01,083779,Staff,0,9,30,30
1650109096956,MATH 103A,B02,083780,Staff,0,6,30,30
1650109102987,MATH 105,A01,085443,Staff,0,13,30,30
1650109109021,MATH 109,A01,083213,Anzaldo; Leesa B,0,3,30,30
1650109109021,MATH 109,A02,083214,Anzaldo; Leesa B,0,5,30,30
1650109109021,MATH 109,B01,083215,Anzaldo; Leesa B,0,4,30,30
1650109109021,MATH 109,B02,083216,Anzaldo; Leesa B,0,4,30,30
1650109115053,MATH 142A,A01,083219,Chow; Bennett,0,10,30,30
1650109115053,MATH 142A,A02,083220,Chow; Bennett,0,10,30,30
1650109115053,MATH 142A,B01,083221,Chow; Bennett,0,10,30,30
1650109115053,MATH 142A,B02,083222,Chow; Bennett,0,9,30,30
1650109121085,MATH 193A,A01,083224,Staff,0,4,30,30
1650109121085,MATH 193A,A02,083225,Staff,0,4,30,30
1650109121085,MATH 193A,A03,083781,Staff,0,0,30,30
1650109121085,MATH 193A,A04,083782,Staff,2,0,30,28
1650109127120,MATH 197,001,091859,McAuley; Julian John,9998,0,9999,1
1650109133228,COGS 9,A01,083615,Staff,0,14,60,60
1650109139255,COGS 11,A01,083617,Boyle; Mary E. T.,24,0,40,16
1650109145284,COGS 13,A01,083071,Staff,0,28,40,40
1650109151311,COGS 14A,A01,092681,Staff,0,10,100,100
1650109157340,COGS 14B,A01,083073,Cheng; Tzu-Han,0,4,50,50
1650109163370,COGS 17,A01,092677,Staff,35,0,75,40
1650109169398,COGS 100,A01,083619,Staff,0,21,60,60
1650109175428,COGS 101A,A01,083621,Davis; Joshua Daniel,0,18,60,60
1650109181455,COGS 101B,A01,091572,Staff,10,0,60,50
1650109187486,COGS 101C,A01,083625,Delgado; Tania,22,0,30,8
1650109193514,COGS 107A,A01,083627,Boyle; Mary E. T.,0,4,60,60
1650109199541,COGS 118A,A01,083075,Staff,17,0,60,43
1650109205570,CSE 3,A50,083646,Miranda; Gregory Joseph,22,0,38,16
1650109205570,CSE 3,A51,083647,Miranda; Gregory Joseph,37,0,37,0
1650109211614,CSE 8A,A50,083650,Miranda; Gregory Joseph,0,15,40,40
1650109217641,CSE 11,A01,083080,Cao; Yingjun,0,66,40,40
1650109223669,CSE 12,A01,083652,Staff,0,2,100,100
1650109229694,CSE 15L,A01,083654,Staff,0,0,50,50
1650109229694,CSE 15L,A02,083655,Staff,10,0,50,40
1650109235724,CSE 20,A01,083657,Staff,58,0,80,22
1650109241751,CSE 30,A01,083084,Eldon; John,0,63,40,40
1650109247782,CSE 100,A01,083659,Cao; Yingjun,0,61,50,50
1650109253813,CSE 134B,A01,083661,Powell; Thomas Allan,0,27,65,65
1650109259842,CSE 140,A01,083663,Staff,4,0,75,71
1650109265877,CSE 140L,A01,083088,Eldon; John,0,1,75,75
1650109271910,CSE 175,A01,083665,Kumar; Rakesh,8,0,25,17
1650109277937,CSE 190,A00,092507,Dubnov; Shlomo,14,0,20,6
1650109283973,ECE 45,A01,083139,Staff,0,13,40,40
1650109290005,ECE 65,A50,083695,Staff,0,4,30,30
1650109296033,ECE 109,A01,091882,Touri; Behrouz,48,0,70,22
1650109302061,ECE 180,A00,083140,Abi Samra; Nicholas Camill,24,0,30,6
1650109302061,ECE 180,B00,083141,Abi Samra; Nicholas Camill,8,0,30,22
1650109308091,MATH 10A,A01,083735,Patchell; Gregory David,12,0,30,18
1650109308091,MATH 10A,A02,083736,Patchell; Gregory David,28,0,30,2
1650109308091,MATH 10A,A03,083737,Patchell; Gregory David,26,0,30,4
1650109314123,MATH 10B,A01,083207,Staff,0,5,30,30
1650109314123,MATH 10B,A02,083208,Staff,0,4,30,30
1650109314123,MATH 10B,B01,083739,Staff,18,0,30,12
1650109314123,MATH 10B,B02,083740,Staff,29,0,30,1
1650109320160,MATH 18,A01,083743,Staff,10,0,30,20
1650109320160,MATH 18,A02,083744,Staff,28,0,30,2
1650109320160,MATH 18,A03,083745,Staff,23,0,30,7
1650109320160,MATH 18,A04,083746,Staff,27,0,30,3
1650109320160,MATH 18,B01,083748,Staff,0,9,30,30
1650109320160,MATH 18,B02,083749,Staff,0,7,30,30
1650109320160,MATH 18,B03,083750,Staff,0,6,30,30
1650109320160,MATH 18,B04,083751,Staff,0,6,30,30
1650109326186,MATH 20A,A01,083754,Staff,26,0,40,14
1650109332213,MATH 20B,A01,083756,Staff,0,5,30,30
1650109332213,MATH 20B,A02,083757,Staff,0,2,30,30
1650109338240,MATH 20C,A01,083760,Staff,0,11,30,30
1650109338240,MATH 20C,A02,083761,Staff,0,12,30,30
1650109338240,MATH 20C,B01,083762,Staff,14,0,30,16
1650109338240,MATH 20C,B02,083763,Staff,28,0,30,2
1650109344267,MATH 20D,A01,083765,Staff,0,2,30,30
1650109344267,MATH 20D,A02,083766,Staff,12,0,30,18
1650109344267,MATH 20D,A03,083767,Staff,28,0,30,2
1650109350295,MATH 20E,A01,083771,Staff,10,0,30,20
1650109350295,MATH 20E,A02,083772,Staff,20,0,30,10
1650109350295,MATH 20E,B01,083773,Staff,0,0,30,30
1650109350295,MATH 20E,B02,083774,Staff,13,0,30,17
1650109356337,MATH 103A,A01,083777,Staff,0,8,30,30
1650109356337,MATH 103A,A02,083778,Staff,0,7,30,30
1650109356337,MATH 103A,B01,083779,Staff,0,9,30,30
1650109356337,MATH 103A,B02,083780,Staff,0,6,30,30
1650109362365,MATH 105,A01,085443,Staff,0,13,30,30
1650109368392,MATH 109,A01,083213,Anzaldo; Leesa B,0,3,30,30
1650109368392,MATH 109,A02,083214,Anzaldo; Leesa B,0,5,30,30
1650109368392,MATH 109,B01,083215,Anzaldo; Leesa B,0,4,30,30
1650109368392,MATH 109,B02,083216,Anzaldo; Leesa B,0,4,30,30
1650109374427,MATH 142A,A01,083219,Chow; Bennett,0,10,30,30
1650109374427,MATH 142A,A02,083220,Chow; Bennett,0,10,30,30
1650109374427,MATH 142A,B01,083221,Chow; Bennett,0,10,30,30
1650109374427,MATH 142A,B02,083222,Chow; Bennett,0,9,30,30
1650109380459,MATH 193A,A01,083224,Staff,0,4,30,30
1650109380459,MATH 193A,A02,083225,Staff,0,4,30,30
1650109380459,MATH 193A,A03,083781,Staff,0,0,30,30
1650109380459,MATH 193A,A04,083782,Staff,2,0,30,28
1650109386487,MATH 197,001,091859,McAuley; Julian John,9998,0,9999,1
1650109392565,COGS 9,A01,083615,Staff,0,14,60,60
1650109398600,COGS 11,A01,083617,Boyle; Mary E. T.,24,0,40,16
1650109404631,COGS 13,A01,083071,Staff,0,28,40,40
1650109410656,COGS 14A,A01,092681,Staff,0,10,100,100
1650109416683,COGS 14B,A01,083073,Cheng; Tzu-Han,0,4,50,50
1650109422711,COGS 17,A01,092677,Staff,35,0,75,40
1650109428738,COGS 100,A01,083619,Staff,0,21,60,60
1650109434766,COGS 101A,A01,083621,Davis; Joshua Daniel,0,18,60,60
1650109440793,COGS 101B,A01,091572,Staff,10,0,60,50
1650109446895,COGS 101C,A01,083625,Delgado; Tania,22,0,30,8
1650109452927,COGS 107A,A01,083627,Boyle; Mary E. T.,0,4,60,60
1650109458957,COGS 118A,A01,083075,Staff,17,0,60,43
1650109464990,CSE 3,A50,083646,Miranda; Gregory Joseph,22,0,38,16
1650109464990,CSE 3,A51,083647,Miranda; Gregory Joseph,37,0,37,0
1650109471019,CSE 8A,A50,083650,Miranda; Gregory Joseph,0,15,40,40
1650109477050,CSE 11,A01,083080,Cao; Yingjun,0,66,40,40
1650109483088,CSE 12,A01,083652,Staff,0,2,100,100
1650109489117,CSE 15L,A01,083654,Staff,0,0,50,50
1650109489117,CSE 15L,A02,083655,Staff,10,0,50,40
1650109495145,CSE 20,A01,083657,Staff,58,0,80,22
1650109501171,CSE 30,A01,083084,Eldon; John,0,63,40,40
1650109507198,CSE 100,A01,083659,Cao; Yingjun,0,61,50,50
1650109513225,CSE 134B,A01,083661,Powell; Thomas Allan,0,27,65,65
1650109519251,CSE 140,A01,083663,Staff,4,0,75,71
1650109525278,CSE 140L,A01,083088,Eldon; John,0,1,75,75
1650109531303,CSE 175,A01,083665,Kumar; Rakesh,8,0,25,17
1650109537331,CSE 190,A00,092507,Dubnov; Shlomo,14,0,20,6
1650109543359,ECE 45,A01,083139,Staff,0,13,40,40
1650109549387,ECE 65,A50,083695,Staff,0,4,30,30
1650109555415,ECE 109,A01,091882,Touri; Behrouz,48,0,70,22
1650109561444,ECE 180,A00,083140,Abi Samra; Nicholas Camill,24,0,30,6
1650109561444,ECE 180,B00,083141,Abi Samra; Nicholas Camill,8,0,30,22
1650109567471,MATH 10A,A01,083735,Patchell; Gregory David,12,0,30,18
1650109567471,MATH 10A,A02,083736,Patchell; Gregory David,28,0,30,2
1650109567471,MATH 10A,A03,083737,Patchell; Gregory David,26,0,30,4
1650109573502,MATH 10B,A01,083207,Staff,0,5,30,30
1650109573502,MATH 10B,A02,083208,Staff,0,4,30,30
1650109573502,MATH 10B,B01,083739,Staff,18,0,30,12
1650109573502,MATH 10B,B02,083740,Staff,29,0,30,1
1650109579537,MATH 18,A01,083743,Staff,10,0,30,20
1650109579537,MATH 18,A02,083744,Staff,28,0,30,2
1650109579537,MATH 18,A03,083745,Staff,23,0,30,7
1650109579537,MATH 18,A04,083746,Staff,27,0,30,3
1650109579537,MATH 18,B01,083748,Staff,0,9,30,30
1650109579537,MATH 18,B02,083749,Staff,0,7,30,30
1650109579537,MATH 18,B03,083750,Staff,0,6,30,30
1650109579537,MATH 18,B04,083751,Staff,0,6,30,30
1650109585563,MATH 20A,A01,083754,Staff,26,0,40,14
1650109591595,MATH 20B,A01,083756,Staff,0,5,30,30
1650109591595,MATH 20B,A02,083757,Staff,0,2,30,30
1650109597623,MATH 20C,A01,083760,Staff,0,11,30,30
1650109597623,MATH 20C,A02,083761,Staff,0,12,30,30
1650109597623,MATH 20C,B01,083762,Staff,14,0,30,16
1650109597623,MATH 20C,B02,083763,Staff,28,0,30,2
1650109603653,MATH 20D,A01,083765,Staff,0,2,30,30
1650109603653,MATH 20D,A02,083766,Staff,12,0,30,18
1650109603653,MATH 20D,A03,083767,Staff,28,0,30,2
1650109609684,MATH 20E,A01,083771,Staff,10,0,30,20
1650109609684,MATH 20E,A02,083772,Staff,20,0,30,10
1650109609684,MATH 20E,B01,083773,Staff,0,0,30,30
1650109609684,MATH 20E,B02,083774,Staff,13,0,30,17
1650109615712,MATH 103A,A01,083777,Staff,0,8,30,30
1650109615712,MATH 103A,A02,083778,Staff,0,7,30,30
1650109615712,MATH 103A,B01,083779,Staff,0,9,30,30
1650109615712,MATH 103A,B02,083780,Staff,0,6,30,30
1650109621743,MATH 105,A01,085443,Staff,0,13,30,30
1650109627775,MATH 109,A01,083213,Anzaldo; Leesa B,0,3,30,30
1650109627775,MATH 109,A02,083214,Anzaldo; Leesa B,0,5,30,30
1650109627775,MATH 109,B01,083215,Anzaldo; Leesa B,0,4,30,30
1650109627775,MATH 109,B02,083216,Anzaldo; Leesa B,0,4,30,30
1650109633803,MATH 142A,A01,083219,Chow; Bennett,0,10,30,30
1650109633803,MATH 142A,A02,083220,Chow; Bennett,0,10,30,30
1650109633803,MATH 142A,B01,083221,Chow; Bennett,0,10,30,30
1650109633803,MATH 142A,B02,083222,Chow; Bennett,0,9,30,30
1650109639834,MATH 193A,A01,083224,Staff,0,4,30,30
1650109639834,MATH 193A,A02,083225,Staff,0,4,30,30
1650109639834,MATH 193A,A03,083781,Staff,0,0,30,30
1650109639834,MATH 193A,A04,083782,Staff,2,0,30,28
1650109645862,MATH 197,001,091859,McAuley; Julian John,9998,0,9999,1
1650109651937,COGS 9,A01,083615,Staff,0,14,60,60
1650109657963,COGS 11,A01,083617,Boyle; Mary E. T.,24,0,40,16
1650109663990,COGS 13,A01,083071,Staff,0,28,40,40
1650109670019,COGS 14A,A01,092681,Staff,0,10,100,100
1650109676046,COGS 14B,A01,083073,Cheng; Tzu-Han,0,4,50,50
1650109682072,COGS 17,A01,092677,Staff,35,0,75,40
1650109688097,COGS 100,A01,083619,Staff,0,21,60,60
1650109694122,COGS 101A,A01,083621,Davis; Joshua Daniel,0,18,60,60
1650109700151,COGS 101B,A01,091572,Staff,10,0,60,50
1650109706181,COGS 101C,A01,083625,Delgado; Tania,22,0,30,8
1650109712209,COGS 107A,A01,083627,Boyle; Mary E. T.,0,4,60,60
1650109718239,COGS 118A,A01,083075,Staff,17,0,60,43
1650109724270,CSE 3,A50,083646,Miranda; Gregory Joseph,22,0,38,16
1650109724270,CSE 3,A51,083647,Miranda; Gregory Joseph,37,0,37,0
1650109730296,CSE 8A,A50,083650,Miranda; Gregory Joseph,0,15,40,40
1650109736326,CSE 11,A01,083080,Cao; Yingjun,0,66,40,40
1650109742353,CSE 12,A01,083652,Staff,0,2,100,100
1650109748380,CSE 15L,A01,083654,Staff,0,0,50,50
1650109748380,CSE 15L,A02,083655,Staff,10,0,50,40
1650109754405,CSE 20,A01,083657,Staff,58,0,80,22
1650109760432,CSE 30,A01,083084,Eldon; John,0,63,40,40
1650109766464,CSE 100,A01,083659,Cao; Yingjun,0,61,50,50
1650109772495,CSE 134B,A01,083661,Powell; Thomas Allan,0,27,65,65
1650109778524,CSE 140,A01,083663,Staff,4,0,75,71
1650109784549,CSE 140L,A01,083088,Eldon; John,0,1,75,75
1650109790580,CSE 175,A01,083665,Kumar; Rakesh,8,0,25,17
1650109796609,CSE 190,A00,092507,Dubnov; Shlomo,14,0,20,6
1650109802639,ECE 45,A01,083139,Staff,0,13,40,40
1650109808666,ECE 65,A50,083695,Staff,0,4,30,30
1650109814693,ECE 109,A01,091882,Touri; Behrouz,48,0,70,22
1650109820723,ECE 180,A00,083140,Abi Samra; Nicholas Camill,24,0,30,6
1650109820723,ECE 180,B00,083141,Abi Samra; Nicholas Camill,8,0,30,22
1650109826758,MATH 10A,A01,083735,Patchell; Gregory David,12,0,30,18
1650109826758,MATH 10A,A02,083736,Patchell; Gregory David,28,0,30,2
1650109826758,MATH 10A,A03,083737,Patchell; Gregory David,26,0,30,4
1650109832787,MATH 10B,A01,083207,Staff,0,5,30,30
1650109832787,MATH 10B,A02,083208,Staff,0,4,30,30
1650109832787,MATH 10B,B01,083739,Staff,18,0,30,12
1650109832787,MATH 10B,B02,083740,Staff,29,0,30,1
1650109838823,MATH 18,A01,083743,Staff,10,0,30,20
1650109838823,MATH 18,A02,083744,Staff,28,0,30,2
1650109838823,MATH 18,A03,083745,Staff,23,0,30,7
1650109838823,MATH 18,A04,083746,Staff,27,0,30,3
1650109838823,MATH 18,B01,083748,Staff,0,9,30,30
1650109838823,MATH 18,B02,083749,Staff,0,7,30,30
1650109838823,MATH 18,B03,083750,Staff,0,6,30,30
1650109838823,MATH 18,B04,083751,Staff,0,6,30,30
1650109844848,MATH 20A,A01,083754,Staff,26,0,40,14
1650109850878,MATH 20B,A01,083756,Staff,0,5,30,30
1650109850878,MATH 20B,A02,083757,Staff,0,2,30,30
1650109856911,MATH 20C,A01,083760,Staff,0,11,30,30
1650109856911,MATH 20C,A02,083761,Staff,0,12,30,30
1650109856911,MATH 20C,B01,083762,Staff,14,0,30,16
1650109856911,MATH 20C,B02,083763,Staff,28,0,30,2
1650109862934,MATH 20D,A01,083765,Staff,0,2,30,30
1650109862934,MATH 20D,A02,083766,Staff,12,0,30,18
1650109862934,MATH 20D,A03,083767,Staff,28,0,30,2
1650109868963,MATH 20E,A01,083771,Staff,10,0,30,20
1650109868963,MATH 20E,A02,083772,Staff,20,0,30,10
1650109868963,MATH 20E,B01,083773,Staff,0,0,30,30
1650109868963,MATH 20E,B02,083774,Staff,13,0,30,17
1650109874989,MATH 103A,A01,083777,Staff,0,8,30,30
1650109874989,MATH 103A,A02,083778,Staff,0,7,30,30
1650109874989,MATH 103A,B01,083779,Staff,0,9,30,30
1650109874989,MATH 103A,B02,083780,Staff,0,6,30,30
1650109881028,MATH 105,A01,085443,Staff,0,13,30,30
1650109887056,MATH 109,A01,083213,Anzaldo; Leesa B,0,3,30,30
1650109887056,MATH 109,A02,083214,Anzaldo; Leesa B,0,5,30,30
1650109887056,MATH 109,B01,083215,Anzaldo; Leesa B,0,4,30,30
1650109887056,MATH 109,B02,083216,Anzaldo; Leesa B,0,4,30,30
1650109893083,MATH 142A,A01,083219,Chow; Bennett,0,10,30,30
1650109893083,MATH 142A,A02,083220,Chow; Bennett,0,10,30,30
1650109893083,MATH 142A,B01,083221,Chow; Bennett,0,10,30,30
1650109893083,MATH 142A,B02,083222,Chow; Bennett,0,9,30,30
1650109899109,MATH 193A,A01,083224,Staff,0,4,30,30
1650109899109,MATH 193A,A02,083225,Staff,0,4,30,30
1650109899109,MATH 193A,A03,083781,Staff,0,0,30,30
1650109899109,MATH 193A,A04,083782,Staff,2,0,30,28
1650109905135,MATH 197,001,091859,McAuley; Julian John,9998,0,9999,1
1650109911217,COGS 9,A01,083615,Staff,0,14,60,60
1650109917244,COGS 11,A01,083617,Boyle; Mary E. T.,24,0,40,16
1650109923271,COGS 13,A01,083071,Staff,0,28,40,40
1650109929296,COGS 14A,A01,092681,Staff,0,10,100,100
1650109935323,COGS 14B,A01,083073,Cheng; Tzu-Han,0,4,50,50
1650109941350,COGS 17,A01,092677,Staff,35,0,75,40
1650109947381,COGS 100,A01,083619,Staff,0,21,60,60
1650109953412,COGS 101A,A01,083621,Davis; Joshua Daniel,0,18,60,60
1650109959441,COGS 101B,A01,091572,Staff,10,0,60,50
1650109965487,COGS 101C,A01,083625,Delgado; Tania,22,0,30,8
1650109971513,COGS 107A,A01,083627,Boyle; Mary E. T.,0,4,60,60
1650109977543,COGS 118A,A01,083075,Staff,17,0,60,43
1650109983572,CSE 3,A50,083646,Miranda; Gregory Joseph,22,0,38,16
1650109983572,CSE 3,A51,083647,Miranda; Gregory Joseph,37,0,37,0
1650109989599,CSE 8A,A50,083650,Miranda; Gregory Joseph,0,15,40,40
1650109995623,CSE 11,A01,083080,Cao; Yingjun,0,66,40,40
1650110001650,CSE 12,A01,083652,Staff,0,2,100,100
1650110007682,CSE 15L,A01,083654,Staff,0,0,50,50
1650110007682,CSE 15L,A02,083655,Staff,10,0,50,40
1650110013708,CSE 20,A01,083657,Staff,58,0,80,22
1650110019739,CSE 30,A01,083084,Eldon; John,0,63,40,40
1650110025774,CSE 100,A01,083659,Cao; Yingjun,0,61,50,50
1650110031801,CSE 134B,A01,083661,Powell; Thomas Allan,0,27,65,65
1650110037829,CSE 140,A01,083663,Staff,4,0,75,71
1650110043930,CSE 140L,A01,083088,Eldon; John,0,1,75,75
1650110049960,CSE 175,A01,083665,Kumar; Rakesh,8,0,25,17
1650110055987,CSE 190,A00,092507,Dubnov; Shlomo,14,0,20,6
1650110062025,ECE 45,A01,083139,Staff,0,13,40,40
1650110068051,ECE 65,A50,083695,Staff,0,4,30,30
1650110074079,ECE 109,A01,091882,Touri; Behrouz,48,0,70,22
1650110080109,ECE 180,A00,083140,Abi Samra; Nicholas Camill,24,0,30,6
1650110080109,ECE 180,B00,083141,Abi Samra; Nicholas Camill,8,0,30,22
1650110086149,MATH 10A,A01,083735,Patchell; Gregory David,12,0,30,18
1650110086149,MATH 10A,A02,083736,Patchell; Gregory David,28,0,30,2
1650110086149,MATH 10A,A03,083737,Patchell; Gregory David,26,0,30,4
1650110092176,MATH 10B,A01,083207,Staff,0,5,30,30
1650110092176,MATH 10B,A02,083208,Staff,0,4,30,30
1650110092176,MATH 10B,B01,083739,Staff,18,0,30,12
1650110092176,MATH 10B,B02,083740,Staff,29,0,30,1
1650110098214,MATH 18,A01,083743,Staff,10,0,30,20
1650110098214,MATH 18,A02,083744,Staff,28,0,30,2
1650110098214,MATH 18,A03,083745,Staff,23,0,30,7
1650110098214,MATH 18,A04,083746,Staff,27,0,30,3
1650110098214,MATH 18,B01,083748,Staff,0,9,30,30
1650110098214,MATH 18,B02,083749,Staff,0,7,30,30
1650110098214,MATH 18,B03,083750,Staff,0,6,30,30
1650110098214,MATH 18,B04,083751,Staff,0,6,30,30
1650110104242,MATH 20A,A01,083754,Staff,26,0,40,14
1650110110273,MATH 20B,A01,083756,Staff,0,5,30,30
1650110110273,MATH 20B,A02,083757,Staff,0,2,30,30
1650110116298,MATH 20C,A01,083760,Staff,0,11,30,30
1650110116298,MATH 20C,A02,083761,Staff,0,12,30,30
1650110116298,MATH 20C,B01,083762,Staff,14,0,30,16
1650110116298,MATH 20C,B02,083763,Staff,28,0,30,2
1650110122346,MATH 20D,A01,083765,Staff,0,2,30,30
1650110122346,MATH 20D,A02,083766,Staff,12,0,30,18
1650110122346,MATH 20D,A03,083767,Staff,28,0,30,2
1650110128372,MATH 20E,A01,083771,Staff,10,0,30,20
1650110128372,MATH 20E,A02,083772,Staff,20,0,30,10
1650110128372,MATH 20E,B01,083773,Staff,0,0,30,30
1650110128372,MATH 20E,B02,083774,Staff,13,0,30,17
1650110134398,MATH 103A,A01,083777,Staff,0,8,30,30
1650110134398,MATH 103A,A02,083778,Staff,0,7,30,30
1650110134398,MATH 103A,B01,083779,Staff,0,9,30,30
1650110134398,MATH 103A,B02,083780,Staff,0,6,30,30
1650110140424,MATH 105,A01,085443,Staff,0,13,30,30
1650110146451,MATH 109,A01,083213,Anzaldo; Leesa B,0,3,30,30
1650110146451,MATH 109,A02,083214,Anzaldo; Leesa B,0,5,30,30
1650110146451,MATH 109,B01,083215,Anzaldo; Leesa B,0,4,30,30
1650110146451,MATH 109,B02,083216,Anzaldo; Leesa B,0,4,30,30
1650110152478,MATH 142A,A01,083219,Chow; Bennett,0,10,30,30
1650110152478,MATH 142A,A02,083220,Chow; Bennett,0,10,30,30
1650110152478,MATH 142A,B01,083221,Chow; Bennett,0,10,30,30
1650110152478,MATH 142A,B02,083222,Chow; Bennett,0,9,30,30
1650110158512,MATH 193A,A01,083224,Staff,0,4,30,30
1650110158512,MATH 193A,A02,083225,Staff,0,4,30,30
1650110158512,MATH 193A,A03,083781,Staff,0,0,30,30
1650110158512,MATH 193A,A04,083782,Staff,2,0,30,28
1650110164538,MATH 197,001,091859,McAuley; Julian John,9998,0,9999,1
1650110170603,COGS 9,A01,083615,Staff,0,14,60,60
1650110176627,COGS 11,A01,083617,Boyle; Mary E. T.,24,0,40,16
1650110182651,COGS 13,A01,083071,Staff,0,28,40,40
1650110188680,COGS 14A,A01,092681,Staff,0,10,100,100
1650110194711,COGS 14B,A01,083073,Cheng; Tzu-Han,0,4,50,50
1650110200737,COGS 17,A01,092677,Staff,35,0,75,40
1650110206762,COGS 100,A01,083619,Staff,0,21,60,60
1650110212793,COGS 101A,A01,083621,Davis; Joshua Daniel,0,18,60,60
1650110218823,COGS 101B,A01,091572,Staff,10,0,60,50
1650110224849,COGS 101C,A01,083625,Delgado; Tania,22,0,30,8
1650110230876,COGS 107A,A01,083627,Boyle; Mary E. T.,0,4,60,60
1650110236902,COGS 118A,A01,083075,Staff,17,0,60,43
1650110242935,CSE 3,A50,083646,Miranda; Gregory Joseph,22,0,38,16
1650110242935,CSE 3,A51,083647,Miranda; Gregory Joseph,37,0,37,0
1650110248965,CSE 8A,A50,083650,Miranda; Gregory Joseph,0,15,40,40
1650110254993,CSE 11,A01,083080,Cao; Yingjun,0,66,40,40
1650110261023,CSE 12,A01,083652,Staff,0,2,100,100
1650110267050,CSE 15L,A01,083654,Staff,0,0,50,50
1650110267050,CSE 15L,A02,083655,Staff,10,0,50,40
1650110273077,CSE 20,A01,083657,Staff,58,0,80,22
1650110279106,CSE 30,A01,083084,Eldon; John,0,63,40,40
1650110285133,CSE 100,A01,083659,Cao; Yingjun,0,61,50,50
1650110291162,CSE 134B,A01,083661,Powell; Thomas Allan,0,27,65,65
1650110297188,CSE 140,A01,083663,Staff,4,0,75,71
1650110303213,CSE 140L,A01,083088,Eldon; John,0,1,75,75
1650110309241,CSE 175,A01,083665,Kumar; Rakesh,8,0,25,17
1650110315267,CSE 190,A00,092507,Dubnov; Shlomo,14,0,20,6
1650110321296,ECE 45,A01,083139,Staff,0,13,40,40
1650110327328,ECE 65,A50,083695,Staff,0,4,30,30
1650110333358,ECE 109,A01,091882,Touri; Behrouz,48,0,70,22
1650110339390,ECE 180,A00,083140,Abi Samra; Nicholas Camill,24,0,30,6
1650110339390,ECE 180,B00,083141,Abi Samra; Nicholas Camill,8,0,30,22
1650110345418,MATH 10A,A01,083735,Patchell; Gregory David,12,0,30,18
1650110345418,MATH 10A,A02,083736,Patchell; Gregory David,28,0,30,2
1650110345418,MATH 10A,A03,083737,Patchell; Gregory David,26,0,30,4
1650110351446,MATH 10B,A01,083207,Staff,0,5,30,30
1650110351446,MATH 10B,A02,083208,Staff,0,4,30,30
1650110351446,MATH 10B,B01,083739,Staff,18,0,30,12
1650110351446,MATH 10B,B02,083740,Staff,29,0,30,1
1650110357478,MATH 18,A01,083743,Staff,10,0,30,20
1650110357478,MATH 18,A02,083744,Staff,28,0,30,2
1650110357478,MATH 18,A03,083745,Staff,23,0,30,7
1650110357478,MATH 18,A04,083746,Staff,27,0,30,3
1650110357478,MATH 18,B01,083748,Staff,0,9,30,30
1650110357478,MATH 18,B02,083749,Staff,0,7,30,30
1650110357478,MATH 18,B03,083750,Staff,0,6,30,30
1650110357478,MATH 18,B04,083751,Staff,0,6,30,30
1650110363506,MATH 20A,A01,083754,Staff,26,0,40,14
1650110369533,MATH 20B,A01,083756,Staff,0,5,30,30
1650110369533,MATH 20B,A02,083757,Staff,0,2,30,30
1650110375565,MATH 20C,A01,083760,Staff,0,11,30,30
1650110375565,MATH 20C,A02,083761,Staff,0,12,30,30
1650110375565,MATH 20C,B01,083762,Staff,14,0,30,16
1650110375565,MATH 20C,B02,083763,Staff,28,0,30,2
1650110381591,MATH 20D,A01,083765,Staff,0,2,30,30
1650110381591,MATH 20D,A02,083766,Staff,12,0,30,18
1650110381591,MATH 20D,A03,083767,Staff,28,0,30,2
1650110387623,MATH 20E,A01,083771,Staff,10,0,30,20
1650110387623,MATH 20E,A02,083772,Staff,20,0,30,10
1650110387623,MATH 20E,B01,083773,Staff,0,0,30,30
1650110387623,MATH 20E,B02,083774,Staff,13,0,30,17
1650110393651,MATH 103A,A01,083777,Staff,0,8,30,30
1650110393651,MATH 103A,A02,083778,Staff,0,7,30,30
1650110393651,MATH 103A,B01,083779,Staff,0,9,30,30
1650110393651,MATH 103A,B02,083780,Staff,0,6,30,30
1650110399676,MATH 105,A01,085443,Staff,0,13,30,30
1650110405699,MATH 109,A01,083213,Anzaldo; Leesa B,0,3,30,30
1650110405699,MATH 109,A02,083214,Anzaldo; Leesa B,0,5,30,30
1650110405699,MATH 109,B01,083215,Anzaldo; Leesa B,0,4,30,30
1650110405699,MATH 109,B02,083216,Anzaldo; Leesa B,0,4,30,30
1650110411729,MATH 142A,A01,083219,Chow; Bennett,0,10,30,30
1650110411729,MATH 142A,A02,083220,Chow; Bennett,0,10,30,30
1650110411729,MATH 142A,B01,083221,Chow; Bennett,0,10,30,30
1650110411729,MATH 142A,B02,083222,Chow; Bennett,0,9,30,30
1650110417755,MATH 193A,A01,083224,Staff,0,4,30,30
1650110417755,MATH 193A,A02,083225,Staff,0,4,30,30
1650110417755,MATH 193A,A03,083781,Staff,0,0,30,30
1650110417755,MATH 193A,A04,083782,Staff,2,0,30,28
1650110423781,MATH 197,001,091859,McAuley; Julian John,9998,0,9999,1
1650110429845,COGS 9,A01,083615,Staff,0,14,60,60
1650110435870,COGS 11,A01,083617,Boyle; Mary E. T.,24,0,40,16
1650110441896,COGS 13,A01,083071,Staff,0,28,40,40
1650110447924,COGS 14A,A01,092681,Staff,0,10,100,100
1650110453955,COGS 14B,A01,083073,Cheng; Tzu-Han,0,4,50,50
1650110459981,COGS 17,A01,092677,Staff,35,0,75,40
1650110466012,COGS 100,A01,083619,Staff,0,21,60,60
1650110472043,COGS 101A,A01,083621,Davis; Joshua Daniel,0,18,60,60
1650110478067,COGS 101B,A01,091572,Staff,10,0,60,50
1650110484096,COGS 101C,A01,083625,Delgado; Tania,22,0,30,8
1650110490122,COGS 107A,A01,083627,Boyle; Mary E. T.,0,4,60,60
1650110496149,COGS 118A,A01,083075,Staff,17,0,60,43
1650110502174,CSE 3,A50,083646,Miranda; Gregory Joseph,22,0,38,16
1650110502174,CSE 3,A51,083647,Miranda; Gregory Joseph,37,0,37,0
1650110508205,CSE 8A,A50,083650,Miranda; Gregory Joseph,0,15,40,40
1650110514235,CSE 11,A01,083080,Cao; Yingjun,0,66,40,40
1650110520270,CSE 12,A01,083652,Staff,0,2,100,100
1650110526298,CSE 15L,A01,083654,Staff,0,0,50,50
1650110526298,CSE 15L,A02,083655,Staff,10,0,50,40
1650110532329,CSE 20,A01,083657,Staff,58,0,80,22
1650110538358,CSE 30,A01,083084,Eldon; John,0,63,40,40
1650110544385,CSE 100,A01,083659,Cao; Yingjun,0,61,50,50
1650110550409,CSE 134B,A01,083661,Powell; Thomas Allan,0,27,65,65
1650110556444,CSE 140,A01,083663,Staff,4,0,75,71
1650110562469,CSE 140L,A01,083088,Eldon; John,0,1,75,75
1650110568494,CSE 175,A01,083665,Kumar; Rakesh,8,0,25,17
1650110574524,CSE 190,A00,092507,Dubnov; Shlomo,14,0,20,6
1650110580551,ECE 45,A01,083139,Staff,0,13,40,40
1650110586577,ECE 65,A50,083695,Staff,0,4,30,30
1650110592603,ECE 109,A01,091882,Touri; Behrouz,48,0,70,22
1650110598634,ECE 180,A00,083140,Abi Samra; Nicholas Camill,24,0,30,6
1650110598634,ECE 180,B00,083141,Abi Samra; Nicholas Camill,8,0,30,22
1650110604661,MATH 10A,A01,083735,Patchell; Gregory David,12,0,30,18
1650110604661,MATH 10A,A02,083736,Patchell; Gregory David,28,0,30,2
1650110604661,MATH 10A,A03,083737,Patchell; Gregory David,26,0,30,4
1650110610689,MATH 10B,A01,083207,Staff,0,5,30,30
1650110610689,MATH 10B,A02,083208,Staff,0,4,30,30
1650110610689,MATH 10B,B01,083739,Staff,18,0,30,12
1650110610689,MATH 10B,B02,083740,Staff,29,0,30,1
1650110616716,MATH 18,A01,083743,Staff,10,0,30,20
1650110616716,MATH 18,A02,083744,Staff,28,0,30,2
1650110616716,MATH 18,A03,083745,Staff,23,0,30,7
1650110616716,MATH 18,A04,083746,Staff,27,0,30,3
1650110616716,MATH 18,B01,083748,Staff,0,9,30,30
1650110616716,MATH 18,B02,083749,Staff,0,7,30,30
1650110616716,MATH 18,B03,083750,Staff,0,6,30,30
1650110616716,MATH 18,B04,083751,Staff,0,6,30,30
1650110622740,MATH 20A,A01,083754,Staff,26,0,40,14
1650110628767,MATH 20B,A01,083756,Staff,0,5,30,30
1650110628767,MATH 20B,A02,083757,Staff,0,2,30,30
1650110634796,MATH 20C,A01,083760,Staff,0,11,30,30
1650110634796,MATH 20C,A02,083761,Staff,0,12,30,30
1650110634796,MATH 20C,B01,083762,Staff,14,0,30,16
1650110634796,MATH 20C,B02,083763,Staff,28,0,30,2
1650110640898,MATH 20D,A01,083765,Staff,0,2,30,30
1650110640898,MATH 20D,A02,083766,Staff,12,0,30,18
1650110640898,MATH 20D,A03,083767,Staff,28,0,30,2
1650110646924,MATH 20E,A01,083771,Staff,10,0,30,20
1650110646924,MATH 20E,A02,083772,Staff,20,0,30,10
1650110646924,MATH 20E,B01,083773,Staff,0,0,30,30
1650110646924,MATH 20E,B02,083774,Staff,13,0,30,17
1650110652955,MATH 103A,A01,083777,Staff,0,8,30,30
1650110652955,MATH 103A,A02,083778,Staff,0,7,30,30
1650110652955,MATH 103A,B01,083779,Staff,0,9,30,30
1650110652955,MATH 103A,B02,083780,Staff,0,6,30,30
1650110658996,MATH 105,A01,085443,Staff,0,13,30,30
1650110665026,MATH 109,A01,083213,Anzaldo; Leesa B,0,3,30,30
1650110665026,MATH 109,A02,083214,Anzaldo; Leesa B,0,5,30,30
1650110665026,MATH 109,B01,083215,Anzaldo; Leesa B,0,4,30,30
1650110665026,MATH 109,B02,083216,Anzaldo; Leesa B,0,4,30,30
1650110671057,MATH 142A,A01,083219,Chow; Bennett,0,10,30,30
1650110671057,MATH 142A,A02,083220,Chow; Bennett,0,10,30,30
1650110671057,MATH 142A,B01,083221,Chow; Bennett,0,10,30,30
1650110671057,MATH 142A,B02,083222,Chow; Bennett,0,9,30,30
1650110677085,MATH 193A,A01,083224,Staff,0,4,30,30
1650110677085,MATH 193A,A02,083225,Staff,0,4,30,30
1650110677085,MATH 193A,A03,083781,Staff,0,0,30,30
1650110677085,MATH 193A,A04,083782,Staff,2,0,30,28
1650110683113,MATH 197,001,091859,McAuley; Julian John,9998,0,9999,1
1650110689184,COGS 9,A01,083615,Staff,0,14,60,60
1650110695217,COGS 11,A01,083617,Boyle; Mary E. T.,24,0,40,16
1650110701244,COGS 13,A01,083071,Staff,0,28,40,40
1650110707277,COGS 14A,A01,092681,Staff,0,10,100,100
1650110713303,COGS 14B,A01,083073,Cheng; Tzu-Han,0,4,50,50
1650110719326,COGS 17,A01,092677,Staff,35,0,75,40
1650110725356,COGS 100,A01,083619,Staff,0,21,60,60
1650110731388,COGS 101A,A01,083621,Davis; Joshua Daniel,0,18,60,60
1650110737413,COGS 101B,A01,091572,Staff,10,0,60,50
1650110743438,COGS 101C,A01,083625,Delgado; Tania,22,0,30,8
1650110749464,COGS 107A,A01,083627,Boyle; Mary E. T.,0,4,60,60
1650110755493,COGS 118A,A01,083075,Staff,17,0,60,43
1650110761533,CSE 3,A50,083646,Miranda; Gregory Joseph,22,0,38,16
1650110761533,CSE 3,A51,083647,Miranda; Gregory Joseph,37,0,37,0
1650110767567,CSE 8A,A50,083650,Miranda; Gregory Joseph,0,15,40,40
1650110773594,CSE 11,A01,083080,Cao; Yingjun,0,66,40,40
1650110779621,CSE 12,A01,083652,Staff,0,2,100,100
1650110785648,CSE 15L,A01,083654,Staff,0,0,50,50
1650110785648,CSE 15L,A02,083655,Staff,10,0,50,40
1650110791677,CSE 20,A01,083657,Staff,58,0,80,22
1650110797707,CSE 30,A01,083084,Eldon; John,0,63,40,40
1650110803740,CSE 100,A01,083659,Cao; Yingjun,0,61,50,50
1650110809769,CSE 134B,A01,083661,Powell; Thomas Allan,0,27,65,65
1650110815795,CSE 140,A01,083663,Staff,4,0,75,71
1650110821825,CSE 140L,A01,083088,Eldon; John,0,1,75,75
1650110827855,CSE 175,A01,083665,Kumar; Rakesh,8,0,25,17
1650110833891,CSE 190,A00,092507,Dubnov; Shlomo,14,0,20,6
1650110839917,ECE 45,A01,083139,Staff,0,13,40,40
1650110845943,ECE 65,A50,083695,Staff,0,4,30,30
1650110851970,ECE 109,A01,091882,Touri; Behrouz,48,0,70,22
1650110857999,ECE 180,A00,083140,Abi Samra; Nicholas Camill,24,0,30,6
1650110857999,ECE 180,B00,083141,Abi Samra; Nicholas Camill,8,0,30,22
1650110864032,MATH 10A,A01,083735,Patchell; Gregory David,12,0,30,18
1650110864032,MATH 10A,A02,083736,Patchell; Gregory David,28,0,30,2
1650110864032,MATH 10A,A03,083737,Patchell; Gregory David,26,0,30,4
1650110870063,MATH 10B,A01,083207,Staff,0,5,30,30
1650110870063,MATH 10B,A02,083208,Staff,0,4,30,30
1650110870063,MATH 10B,B01,083739,Staff,18,0,30,12
1650110870063,MATH 10B,B02,083740,Staff,29,0,30,1
1650110876099,MATH 18,A01,083743,Staff,10,0,30,20
1650110876099,MATH 18,A02,083744,Staff,28,0,30,2
1650110876099,MATH 18,A03,083745,Staff,23,0,30,7
1650110876099,MATH 18,A04,083746,Staff,27,0,30,3
1650110876099,MATH 18,B01,083748,Staff,0,9,30,30
1650110876099,MATH 18,B02,083749,Staff,0,7,30,30
1650110876099,MATH 18,B03,083750,Staff,0,6,30,30
1650110876099,MATH 18,B04,083751,Staff,0,6,30,30
1650110882124,MATH 20A,A01,083754,Staff,26,0,40,14
1650110888156,MATH 20B,A01,083756,Staff,0,5,30,30
1650110888156,MATH 20B,A02,083757,Staff,0,2,30,30
1650110894190,MATH 20C,A01,083760,Staff,0,11,30,30
1650110894190,MATH 20C,A02,083761,Staff,0,12,30,30
1650110894190,MATH 20C,B01,083762,Staff,14,0,30,16
1650110894190,MATH 20C,B02,083763,Staff,28,0,30,2
1650110900213,MATH 20D,A01,083765,Staff,0,2,30,30
1650110900213,MATH 20D,A02,083766,Staff,12,0,30,18
1650110900213,MATH 20D,A03,083767,Staff,28,0,30,2
1650110906242,MATH 20E,A01,083771,Staff,10,0,30,20
1650110906242,MATH 20E,A02,083772,Staff,20,0,30,10
1650110906242,MATH 20E,B01,083773,Staff,0,0,30,30
1650110906242,MATH 20E,B02,083774,Staff,13,0,30,17
1650110912268,MATH 103A,A01,083777,Staff,0,8,30,30
1650110912268,MATH 103A,A02,083778,Staff,0,7,30,30
1650110912268,MATH 103A,B01,083779,Staff,0,9,30,30
1650110912268,MATH 103A,B02,083780,Staff,0,6,30,30
1650110918304,MATH 105,A01,085443,Staff,0,13,30,30
1650110924335,MATH 109,A01,083213,Anzaldo; Leesa B,0,3,30,30
1650110924335,MATH 109,A02,083214,Anzaldo; Leesa B,0,5,30,30
1650110924335,MATH 109,B01,083215,Anzaldo; Leesa B,0,4,30,30
1650110924335,MATH 109,B02,083216,Anzaldo; Leesa B,0,4,30,30
1650110930366,MATH 142A,A01,083219,Chow; Bennett,0,10,30,30
1650110930366,MATH 142A,A02,083220,Chow; Bennett,0,10,30,30
1650110930366,MATH 142A,B01,083221,Chow; Bennett,0,10,30,30
1650110930366,MATH 142A,B02,083222,Chow; Bennett,0,9,30,30
1650110936391,MATH 193A,A01,083224,Staff,0,4,30,30
1650110936391,MATH 193A,A02,083225,Staff,0,4,30,30
1650110936391,MATH 193A,A03,083781,Staff,0,0,30,30
1650110936391,MATH 193A,A04,083782,Staff,2,0,30,28
1650110942420,MATH 197,001,091859,McAuley; Julian John,9998,0,9999,1
1650110948500,COGS 9,A01,083615,Staff,0,14,60,60
1650110954526,COGS 11,A01,083617,Boyle; Mary E. T.,24,0,40,16
1650110960555,COGS 13,A01,083071,Staff,0,28,40,40
1650110966581,COGS 14A,A01,092681,Staff,0,10,100,100
1650110972607,COGS 14B,A01,083073,Cheng; Tzu-Han,0,4,50,50
1650110978632,COGS 17,A01,092677,Staff,35,0,75,40
1650110984675,COGS 100,A01,083619,Staff,0,21,60,60
1650110990702,COGS 101A,A01,083621,Davis; Joshua Daniel,0,18,60,60
1650110996732,COGS 101B,A01,091572,Staff,10,0,60,50
1650111002770,COGS 101C,A01,083625,Delgado; Tania,22,0,30,8
1650111008796,COGS 107A,A01,083627,Boyle; Mary E. T.,0,4,60,60
1650111014827,COGS 118A,A01,083075,Staff,17,0,60,43
1650111020861,CSE 3,A50,083646,Miranda; Gregory Joseph,22,0,38,16
1650111020861,CSE 3,A51,083647,Miranda; Gregory Joseph,37,0,37,0
1650111026898,CSE 8A,A50,083650,Miranda; Gregory Joseph,0,15,40,40
1650111032928,CSE 11,A01,083080,Cao; Yingjun,0,66,40,40
1650111038954,CSE 12,A01,083652,Staff,0,2,100,100
1650111044983,CSE 15L,A01,083654,Staff,0,0,50,50
1650111044983,CSE 15L,A02,083655,Staff,10,0,50,40
1650111051009,CSE 20,A01,083657,Staff,58,0,80,22
1650111057045,CSE 30,A01,083084,Eldon; John,0,63,40,40
1650111063078,CSE 100,A01,083659,Cao; Yingjun,0,61,50,50
1650111069108,CSE 134B,A01,083661,Powell; Thomas Allan,0,27,65,65
1650111075137,CSE 140,A01,083663,Staff,4,0,75,71
1650111081163,CSE 140L,A01,083088,Eldon; John,0,1,75,75
1650111087194,CSE 175,A01,083665,Kumar; Rakesh,8,0,25,17
1650111093221,CSE 190,A00,092507,Dubnov; Shlomo,14,0,20,6
1650111099247,ECE 45,A01,083139,Staff,0,13,40,40
1650111105276,ECE 65,A50,083695,Staff,0,4,30,30
1650111111311,ECE 109,A01,091882,Touri; Behrouz,48,0,70,22
1650111117337,ECE 180,A00,083140,Abi Samra; Nicholas Camill,24,0,30,6
1650111117337,ECE 180,B00,083141,Abi Samra; Nicholas Camill,8,0,30,22
1650111123371,MATH 10A,A01,083735,Patchell; Gregory David,12,0,30,18
1650111123371,MATH 10A,A02,083736,Patchell; Gregory David,28,0,30,2
1650111123371,MATH 10A,A03,083737,Patchell; Gregory David,26,0,30,4
1650111129402,MATH 10B,A01,083207,Staff,0,5,30,30
1650111129402,MATH 10B,A02,083208,Staff,0,4,30,30
1650111129402,MATH 10B,B01,083739,Staff,18,0,30,12
1650111129402,MATH 10B,B02,083740,Staff,29,0,30,1
1650111135440,MATH 18,A01,083743,Staff,10,0,30,20
1650111135440,MATH 18,A02,083744,Staff,28,0,30,2
1650111135440,MATH 18,A03,083745,Staff,23,0,30,7
1650111135440,MATH 18,A04,083746,Staff,27,0,30,3
1650111135440,MATH 18,B01,083748,Staff,0,9,30,30
1650111135440,MATH 18,B02,083749,Staff,0,7,30,30
1650111135440,MATH 18,B03,083750,Staff,0,6,30,30
1650111135440,MATH 18,B04,083751,Staff,0,6,30,30
1650111141466,MATH 20A,A01,083754,Staff,26,0,40,14
1650111147497,MATH 20B,A01,083756,Staff,0,5,30,30
1650111147497,MATH 20B,A02,083757,Staff,0,2,30,30
1650111153528,MATH 20C,A01,083760,Staff,0,11,30,30
1650111153528,MATH 20C,A02,083761,Staff,0,12,30,30
1650111153528,MATH 20C,B01,083762,Staff,14,0,30,16
1650111153528,MATH 20C,B02,083763,Staff,28,0,30,2
1650111159553,MATH 20D,A01,083765,Staff,0,2,30,30
1650111159553,MATH 20D,A02,083766,Staff,12,0,30,18
1650111159553,MATH 20D,A03,083767,Staff,28,0,30,2
1650111165585,MATH 20E,A01,083771,Staff,10,0,30,20
1650111165585,MATH 20E,A02,083772,Staff,20,0,30,10
1650111165585,MATH 20E,B01,083773,Staff,0,0,30,30
1650111165585,MATH 20E,B02,083774,Staff,13,0,30,17
1650111171611,MATH 103A,A01,083777,Staff,0,8,30,30
1650111171611,MATH 103A,A02,083778,Staff,0,7,30,30
1650111171611,MATH 103A,B01,083779,Staff,0,9,30,30
1650111171611,MATH 103A,B02,083780,Staff,0,6,30,30
1650111177639,MATH 105,A01,085443,Staff,0,13,30,30
1650111183669,MATH 109,A01,083213,Anzaldo; Leesa B,0,3,30,30
1650111183669,MATH 109,A02,083214,Anzaldo; Leesa B,0,5,30,30
1650111183669,MATH 109,B01,083215,Anzaldo; Leesa B,0,4,30,30
1650111183669,MATH 109,B02,083216,Anzaldo; Leesa B,0,4,30,30
1650111189705,MATH 142A,A01,083219,Chow; Bennett,0,10,30,30
1650111189705,MATH 142A,A02,083220,Chow; Bennett,0,10,30,30
1650111189705,MATH 142A,B01,083221,Chow; Bennett,0,10,30,30
1650111189705,MATH 142A,B02,083222,Chow; Bennett,0,9,30,30
1650111195736,MATH 193A,A01,083224,Staff,0,4,30,30
1650111195736,MATH 193A,A02,083225,Staff,0,4,30,30
1650111195736,MATH 193A,A03,083781,Staff,0,0,30,30
1650111195736,MATH 193A,A04,083782,Staff,2,0,30,28
1650111201768,MATH 197,001,091859,McAuley; Julian John,9998,0,9999,1
1650111207854,COGS 9,A01,083615,Staff,0,14,60,60
1650111213885,COGS 11,A01,083617,Boyle; Mary E. T.,24,0,40,16
1650111219910,COGS 13,A01,083071,Staff,0,28,40,40
1650111225935,COGS 14A,A01,092681,Staff,0,10,100,100
1650111232059,COGS 14B,A01,083073,Cheng; Tzu-Han,0,4,50,50
1650111238095,COGS 17,A01,092677,Staff,35,0,75,40
1650111244122,COGS 100,A01,083619,Staff,0,21,60,60
1650111250148,COGS 101A,A01,083621,Davis; Joshua Daniel,0,18,60,60
1650111256173,COGS 101B,A01,091572,Staff,10,0,60,50
1650111262201,COGS 101C,A01,083625,Delgado; Tania,22,0,30,8
1650111268230,COGS 107A,A01,083627,Boyle; Mary E. T.,0,4,60,60
1650111274260,COGS 118A,A01,083075,Staff,17,0,60,43
1650111280285,CSE 3,A50,083646,Miranda; Gregory Joseph,22,0,38,16
1650111280285,CSE 3,A51,083647,Miranda; Gregory Joseph,37,0,37,0
1650111286334,CSE 8A,A50,083650,Miranda; Gregory Joseph,0,15,40,40
1650111292369,CSE 11,A01,083080,Cao; Yingjun,0,66,40,40
1650111298400,CSE 12,A01,083652,Staff,0,2,100,100
1650111304425,CSE 15L,A01,083654,Staff,0,0,50,50
1650111304425,CSE 15L,A02,083655,Staff,10,0,50,40
1650111310454,CSE 20,A01,083657,Staff,58,0,80,22
1650111316490,CSE 30,A01,083084,Eldon; John,0,63,40,40
1650111322516,CSE 100,A01,083659,Cao; Yingjun,0,61,50,50
1650111328543,CSE 134B,A01,083661,Powell; Thomas Allan,0,27,65,65
1650111334581,CSE 140,A01,083663,Staff,4,0,75,71
1650111340607,CSE 140L,A01,083088,Eldon; John,0,1,75,75
1650111346636,CSE 175,A01,083665,Kumar; Rakesh,8,0,25,17
1650111352667,CSE 190,A00,092507,Dubnov; Shlomo,14,0,20,6
1650111358703,ECE 45,A01,083139,Staff,0,13,40,40
1650111364734,ECE 65,A50,083695,Staff,0,4,30,30
1650111370760,ECE 109,A01,091882,Touri; Behrouz,48,0,70,22
1650111376786,ECE 180,A00,083140,Abi Samra; Nicholas Camill,24,0,30,6
1650111376786,ECE 180,B00,083141,Abi Samra; Nicholas Camill,8,0,30,22
1650111382821,MATH 10A,A01,083735,Patchell; Gregory David,12,0,30,18
1650111382821,MATH 10A,A02,083736,Patchell; Gregory David,28,0,30,2
1650111382821,MATH 10A,A03,083737,Patchell; Gregory David,26,0,30,4
1650111388851,MATH 10B,A01,083207,Staff,0,5,30,30
1650111388851,MATH 10B,A02,083208,Staff,0,4,30,30
1650111388851,MATH 10B,B01,083739,Staff,18,0,30,12
1650111388851,MATH 10B,B02,083740,Staff,29,0,30,1
1650111394887,MATH 18,A01,083743,Staff,10,0,30,20
1650111394887,MATH 18,A02,083744,Staff,28,0,30,2
1650111394887,MATH 18,A03,083745,Staff,23,0,30,7
1650111394887,MATH 18,A04,083746,Staff,27,0,30,3
1650111394887,MATH 18,B01,083748,Staff,0,9,30,30
1650111394887,MATH 18,B02,083749,Staff,0,7,30,30
1650111394887,MATH 18,B03,083750,Staff,0,6,30,30
1650111394887,MATH 18,B04,083751,Staff,0,6,30,30
1650111400911,MATH 20A,A01,083754,Staff,26,0,40,14
1650111406938,MATH 20B,A01,083756,Staff,0,5,30,30
1650111406938,MATH 20B,A02,083757,Staff,0,2,30,30
1650111412965,MATH 20C,A01,083760,Staff,0,11,30,30
1650111412965,MATH 20C,A02,083761,Staff,0,12,30,30
1650111412965,MATH 20C,B01,083762,Staff,14,0,30,16
1650111412965,MATH 20C,B02,083763,Staff,28,0,30,2
1650111418994,MATH 20D,A01,083765,Staff,0,2,30,30
1650111418994,MATH 20D,A02,083766,Staff,12,0,30,18
1650111418994,MATH 20D,A03,083767,Staff,28,0,30,2
1650111425028,MATH 20E,A01,083771,Staff,10,0,30,20
1650111425028,MATH 20E,A02,083772,Staff,20,0,30,10
1650111425028,MATH 20E,B01,083773,Staff,0,0,30,30
1650111425028,MATH 20E,B02,083774,Staff,13,0,30,17
1650111431055,MATH 103A,A01,083777,Staff,0,8,30,30
1650111431055,MATH 103A,A02,083778,Staff,0,7,30,30
1650111431055,MATH 103A,B01,083779,Staff,0,9,30,30
1650111431055,MATH 103A,B02,083780,Staff,0,6,30,30
1650111437080,MATH 105,A01,085443,Staff,0,13,30,30
1650111443110,MATH 109,A01,083213,Anzaldo; Leesa B,0,3,30,30
1650111443110,MATH 109,A02,083214,Anzaldo; Leesa B,0,5,30,30
1650111443110,MATH 109,B01,083215,Anzaldo; Leesa B,0,4,30,30
1650111443110,MATH 109,B02,083216,Anzaldo; Leesa B,0,4,30,30
1650111449141,MATH 142A,A01,083219,Chow; Bennett,0,10,30,30
1650111449141,MATH 142A,A02,083220,Chow; Bennett,0,10,30,30
1650111449141,MATH 142A,B01,083221,Chow; Bennett,0,10,30,30
1650111449141,MATH 142A,B02,083222,Chow; Bennett,0,9,30,30
1650111455170,MATH 193A,A01,083224,Staff,0,4,30,30
1650111455170,MATH 193A,A02,083225,Staff,0,4,30,30
1650111455170,MATH 193A,A03,083781,Staff,0,0,30,30
1650111455170,MATH 193A,A04,083782,Staff,2,0,30,28
1650111461194,MATH 197,001,091859,McAuley; Julian John,9998,0,9999,1
1650111467268,COGS 9,A01,083615,Staff,0,14,60,60
1650111473292,COGS 11,A01,083617,Boyle; Mary E. T.,24,0,40,16
1650111479317,COGS 13,A01,083071,Staff,0,28,40,40
1650111485345,COGS 14A,A01,092681,Staff,0,10,100,100
1650111491372,COGS 14B,A01,083073,Cheng; Tzu-Han,0,4,50,50
1650111497410,COGS 17,A01,092677,Staff,35,0,75,40
1650111503461,COGS 100,A01,083619,Staff,0,21,60,60
1650111509488,COGS 101A,A01,083621,Davis; Joshua Daniel,0,18,60,60
1650111515520,COGS 101B,A01,091572,Staff,10,0,60,50
1650111521546,COGS 101C,A01,083625,Delgado; Tania,22,0,30,8
1650111527572,COGS 107A,A01,083627,Boyle; Mary E. T.,0,4,60,60
1650111533603,COGS 118A,A01,083075,Staff,17,0,60,43
1650111539642,CSE 3,A50,083646,Miranda; Gregory Joseph,22,0,38,16
1650111539642,CSE 3,A51,083647,Miranda; Gregory Joseph,37,0,37,0
1650111545674,CSE 8A,A50,083650,Miranda; Gregory Joseph,0,15,40,40
1650111551716,CSE 11,A01,083080,Cao; Yingjun,0,66,40,40
1650111557746,CSE 12,A01,083652,Staff,0,2,100,100
1650111563773,CSE 15L,A01,083654,Staff,0,0,50,50
1650111563773,CSE 15L,A02,083655,Staff,10,0,50,40
1650111569797,CSE 20,A01,083657,Staff,58,0,80,22
1650111575828,CSE 30,A01,083084,Eldon; John,0,63,40,40
1650111581858,CSE 100,A01,083659,Cao; Yingjun,0,61,50,50
1650111587883,CSE 134B,A01,083661,Powell; Thomas Allan,0,27,65,65
1650111593910,CSE 140,A01,083663,Staff,4,0,75,71
1650111599937,CSE 140L,A01,083088,Eldon; John,0,1,75,75
1650111605967,CSE 175,A01,083665,Kumar; Rakesh,8,0,25,17
1650111611999,CSE 190,A00,092507,Dubnov; Shlomo,14,0,20,6
1650111618040,ECE 45,A01,083139,Staff,0,13,40,40
1650111624071,ECE 65,A50,083695,Staff,0,4,30,30
1650111630115,ECE 109,A01,091882,Touri; Behrouz,48,0,70,22
1650111636150,ECE 180,A00,083140,Abi Samra; Nicholas Camill,24,0,30,6
1650111636150,ECE 180,B00,083141,Abi Samra; Nicholas Camill,8,0,30,22
1650111642177,MATH 10A,A01,083735,Patchell; Gregory David,12,0,30,18
1650111642177,MATH 10A,A02,083736,Patchell; Gregory David,28,0,30,2
1650111642177,MATH 10A,A03,083737,Patchell; Gregory David,26,0,30,4
1650111648208,MATH 10B,A01,083207,Staff,0,5,30,30
1650111648208,MATH 10B,A02,083208,Staff,0,4,30,30
1650111648208,MATH 10B,B01,083739,Staff,18,0,30,12
1650111648208,MATH 10B,B02,083740,Staff,29,0,30,1
1650111654237,MATH 18,A01,083743,Staff,10,0,30,20
1650111654237,MATH 18,A02,083744,Staff,28,0,30,2
1650111654237,MATH 18,A03,083745,Staff,23,0,30,7
1650111654237,MATH 18,A04,083746,Staff,27,0,30,3
1650111654237,MATH 18,B01,083748,Staff,0,9,30,30
1650111654237,MATH 18,B02,083749,Staff,0,7,30,30
1650111654237,MATH 18,B03,083750,Staff,0,6,30,30
1650111654237,MATH 18,B04,083751,Staff,0,6,30,30
1650111660272,MATH 20A,A01,083754,Staff,26,0,40,14
1650111666297,MATH 20B,A01,083756,Staff,0,5,30,30
1650111666297,MATH 20B,A02,083757,Staff,0,2,30,30
1650111672330,MATH 20C,A01,083760,Staff,0,11,30,30
1650111672330,MATH 20C,A02,083761,Staff,0,12,30,30
1650111672330,MATH 20C,B01,083762,Staff,14,0,30,16
1650111672330,MATH 20C,B02,083763,Staff,28,0,30,2
1650111678356,MATH 20D,A01,083765,Staff,0,2,30,30
1650111678356,MATH 20D,A02,083766,Staff,12,0,30,18
1650111678356,MATH 20D,A03,083767,Staff,28,0,30,2
1650111684383,MATH 20E,A01,083771,Staff,10,0,30,20
1650111684383,MATH 20E,A02,083772,Staff,20,0,30,10
1650111684383,MATH 20E,B01,083773,Staff,0,0,30,30
1650111684383,MATH 20E,B02,083774,Staff,13,0,30,17
1650111690411,MATH 103A,A01,083777,Staff,0,8,30,30
1650111690411,MATH 103A,A02,083778,Staff,0,7,30,30
1650111690411,MATH 103A,B01,083779,Staff,0,9,30,30
1650111690411,MATH 103A,B02,083780,Staff,0,6,30,30
1650111696437,MATH 105,A01,085443,Staff,0,13,30,30
1650111702468,MATH 109,A01,083213,Anzaldo; Leesa B,0,3,30,30
1650111702468,MATH 109,A02,083214,Anzaldo; Leesa B,0,5,30,30
1650111702468,MATH 109,B01,083215,Anzaldo; Leesa B,0,4,30,30
1650111702468,MATH 109,B02,083216,Anzaldo; Leesa B,0,4,30,30
1650111708510,MATH 142A,A01,083219,Chow; Bennett,0,10,30,30
1650111708510,MATH 142A,A02,083220,Chow; Bennett,0,10,30,30
1650111708510,MATH 142A,B01,083221,Chow; Bennett,0,10,30,30
1650111708510,MATH 142A,B02,083222,Chow; Bennett,0,9,30,30
1650111714545,MATH 193A,A01,083224,Staff,0,4,30,30
1650111714545,MATH 193A,A02,083225,Staff,0,4,30,30
1650111714545,MATH 193A,A03,083781,Staff,0,0,30,30
1650111714545,MATH 193A,A04,083782,Staff,2,0,30,28
1650111720584,MATH 197,001,091859,McAuley; Julian John,9998,0,9999,1
1650111726653,COGS 9,A01,083615,Staff,0,14,60,60
1650111732678,COGS 11,A01,083617,Boyle; Mary E. T.,24,0,40,16
1650111738709,COGS 13,A01,083071,Staff,0,28,40,40
1650111744734,COGS 14A,A01,092681,Staff,0,10,100,100
1650111750789,COGS 14B,A01,083073,Cheng; Tzu-Han,0,4,50,50
1650111756817,COGS 17,A01,092677,Staff,35,0,75,40
1650111762852,COGS 100,A01,083619,Staff,0,21,60,60
1650111768879,COGS 101A,A01,083621,Davis; Joshua Daniel,0,18,60,60
1650111774907,COGS 101B,A01,091572,Staff,10,0,60,50
1650111780938,COGS 101C,A01,083625,Delgado; Tania,22,0,30,8
1650111786969,COGS 107A,A01,083627,Boyle; Mary E. T.,0,4,60,60
1650111793008,COGS 118A,A01,083075,Staff,17,0,60,43
1650111799035,CSE 3,A50,083646,Miranda; Gregory Joseph,22,0,38,16
1650111799035,CSE 3,A51,083647,Miranda; Gregory Joseph,37,0,37,0
1650111805066,CSE 8A,A50,083650,Miranda; Gregory Joseph,0,15,40,40
1650111811098,CSE 11,A01,083080,Cao; Yingjun,0,66,40,40
1650111817137,CSE 12,A01,083652,Staff,0,2,100,100
1650111823173,CSE 15L,A01,083654,Staff,0,0,50,50
1650111823173,CSE 15L,A02,083655,Staff,10,0,50,40
1650111829275,CSE 20,A01,083657,Staff,58,0,80,22
1650111835303,CSE 30,A01,083084,Eldon; John,0,63,40,40
1650111841338,CSE 100,A01,083659,Cao; Yingjun,0,61,50,50
1650111847364,CSE 134B,A01,083661,Powell; Thomas Allan,0,27,65,65
1650111853403,CSE 140,A01,083663,Staff,4,0,75,71
1650111859435,CSE 140L,A01,083088,Eldon; John,0,1,75,75
1650111865475,CSE 175,A01,083665,Kumar; Rakesh,8,0,25,17
1650111871507,CSE 190,A00,092507,Dubnov; Shlomo,14,0,20,6
1650111877535,ECE 45,A01,083139,Staff,0,13,40,40
1650111883561,ECE 65,A50,083695,Staff,0,4,30,30
1650111889588,ECE 109,A01,091882,Touri; Behrouz,48,0,70,22
1650111895613,ECE 180,A00,083140,Abi Samra; Nicholas Camill,24,0,30,6
1650111895613,ECE 180,B00,083141,Abi Samra; Nicholas Camill,8,0,30,22
1650111901650,MATH 10A,A01,083735,Patchell; Gregory David,12,0,30,18
1650111901650,MATH 10A,A02,083736,Patchell; Gregory David,28,0,30,2
1650111901650,MATH 10A,A03,083737,Patchell; Gregory David,26,0,30,4
1650111907677,MATH 10B,A01,083207,Staff,0,5,30,30
1650111907677,MATH 10B,A02,083208,Staff,0,4,30,30
1650111907677,MATH 10B,B01,083739,Staff,18,0,30,12
1650111907677,MATH 10B,B02,083740,Staff,29,0,30,1
1650111913711,MATH 18,A01,083743,Staff,10,0,30,20
1650111913711,MATH 18,A02,083744,Staff,28,0,30,2
1650111913711,MATH 18,A03,083745,Staff,23,0,30,7
1650111913711,MATH 18,A04,083746,Staff,27,0,30,3
1650111913711,MATH 18,B01,083748,Staff,0,9,30,30
1650111913711,MATH 18,B02,083749,Staff,0,7,30,30
1650111913711,MATH 18,B03,083750,Staff,0,6,30,30
1650111913711,MATH 18,B04,083751,Staff,0,6,30,30
1650111919748,MATH 20A,A01,083754,Staff,26,0,40,14
1650111925782,MATH 20B,A01,083756,Staff,0,5,30,30
1650111925782,MATH 20B,A02,083757,Staff,0,2,30,30
1650111931836,MATH 20C,A01,083760,Staff,0,11,30,30
1650111931836,MATH 20C,A02,083761,Staff,0,12,30,30
1650111931836,MATH 20C,B01,083762,Staff,14,0,30,16
1650111931836,MATH 20C,B02,083763,Staff,28,0,30,2
1650111937865,MATH 20D,A01,083765,Staff,0,2,30,30
1650111937865,MATH 20D,A02,083766,Staff,12,0,30,18
1650111937865,MATH 20D,A03,083767,Staff,28,0,30,2
1650111943912,MATH 20E,A01,083771,Staff,10,0,30,20
1650111943912,MATH 20E,A02,083772,Staff,20,0,30,10
1650111943912,MATH 20E,B01,083773,Staff,0,0,30,30
1650111943912,MATH 20E,B02,083774,Staff,13,0,30,17
1650111949941,MATH 103A,A01,083777,Staff,0,8,30,30
1650111949941,MATH 103A,A02,083778,Staff,0,7,30,30
1650111949941,MATH 103A,B01,083779,Staff,0,9,30,30
1650111949941,MATH 103A,B02,083780,Staff,0,6,30,30
1650111955971,MATH 105,A01,085443,Staff,0,13,30,30
1650111962002,MATH 109,A01,083213,Anzaldo; Leesa B,0,3,30,30
1650111962002,MATH 109,A02,083214,Anzaldo; Leesa B,0,5,30,30
1650111962002,MATH 109,B01,083215,Anzaldo; Leesa B,0,4,30,30
1650111962002,MATH 109,B02,083216,Anzaldo; Leesa B,0,4,30,30
1650111968044,MATH 142A,A01,083219,Chow; Bennett,0,10,30,30
1650111968044,MATH 142A,A02,083220,Chow; Bennett,0,10,30,30
1650111968044,MATH 142A,B01,083221,Chow; Bennett,0,10,30,30
1650111968044,MATH 142A,B02,083222,Chow; Bennett,0,9,30,30
1650111974070,MATH 193A,A01,083224,Staff,0,4,30,30
1650111974070,MATH 193A,A02,083225,Staff,0,4,30,30
1650111974070,MATH 193A,A03,083781,Staff,0,0,30,30
1650111974070,MATH 193A,A04,083782,Staff,2,0,30,28
1650111980099,MATH 197,001,091859,McAuley; Julian John,9998,0,9999,1
1650111986188,COGS 9,A01,083615,Staff,0,14,60,60
1650111992232,COGS 11,A01,083617,Boyle; Mary E. T.,24,0,40,16
1650111998257,COGS 13,A01,083071,Staff,0,28,40,40
1650112004287,COGS 14A,A01,092681,Staff,0,10,100,100
1650112010316,COGS 14B,A01,083073,Cheng; Tzu-Han,0,4,50,50
1650112016341,COGS 17,A01,092677,Staff,35,0,75,40
1650112022371,COGS 100,A01,083619,Staff,0,21,60,60
1650112028397,COGS 101A,A01,083621,Davis; Joshua Daniel,0,18,60,60
1650112034430,COGS 101B,A01,091572,Staff,10,0,60,50
1650112040460,COGS 101C,A01,083625,Delgado; Tania,22,0,30,8
1650112046490,COGS 107A,A01,083627,Boyle; Mary E. T.,0,4,60,60
1650112052545,COGS 118A,A01,083075,Staff,17,0,60,43
1650112058574,CSE 3,A50,083646,Miranda; Gregory Joseph,22,0,38,16
1650112058574,CSE 3,A51,083647,Miranda; Gregory Joseph,37,0,37,0
1650112064600,CSE 8A,A50,083650,Miranda; Gregory Joseph,0,15,40,40
1650112070626,CSE 11,A01,083080,Cao; Yingjun,0,66,40,40
1650112076653,CSE 12,A01,083652,Staff,0,2,100,100
1650112082679,CSE 15L,A01,083654,Staff,0,0,50,50
1650112082679,CSE 15L,A02,083655,Staff,10,0,50,40
1650112088709,CSE 20,A01,083657,Staff,58,0,80,22
1650112094747,CSE 30,A01,083084,Eldon; John,0,63,40,40
1650112100773,CSE 100,A01,083659,Cao; Yingjun,0,61,50,50
1650112106811,CSE 134B,A01,083661,Powell; Thomas Allan,0,27,65,65
1650112112837,CSE 140,A01,083663,Staff,4,0,75,71
1650112118863,CSE 140L,A01,083088,Eldon; John,0,1,75,75
1650112124891,CSE 175,A01,083665,Kumar; Rakesh,8,0,25,17
1650112130921,CSE 190,A00,092507,Dubnov; Shlomo,14,0,20,6
1650112136950,ECE 45,A01,083139,Staff,0,13,40,40
1650112142976,ECE 65,A50,083695,Staff,0,4,30,30
1650112149019,ECE 109,A01,091882,Touri; Behrouz,48,0,70,22
1650112155048,ECE 180,A00,083140,Abi Samra; Nicholas Camill,24,0,30,6
1650112155048,ECE 180,B00,083141,Abi Samra; Nicholas Camill,8,0,30,22
1650112161081,MATH 10A,A01,083735,Patchell; Gregory David,12,0,30,18
1650112161081,MATH 10A,A02,083736,Patchell; Gregory David,28,0,30,2
1650112161081,MATH 10A,A03,083737,Patchell; Gregory David,26,0,30,4
1650112167113,MATH 10B,A01,083207,Staff,0,5,30,30
1650112167113,MATH 10B,A02,083208,Staff,0,4,30,30
1650112167113,MATH 10B,B01,083739,Staff,18,0,30,12
1650112167113,MATH 10B,B02,083740,Staff,29,0,30,1
1650112173145,MATH 18,A01,083743,Staff,10,0,30,20
1650112173145,MATH 18,A02,083744,Staff,28,0,30,2
1650112173145,MATH 18,A03,083745,Staff,23,0,30,7
1650112173145,MATH 18,A04,083746,Staff,27,0,30,3
1650112173145,MATH 18,B01,083748,Staff,0,9,30,30
1650112173145,MATH 18,B02,083749,Staff,0,7,30,30
1650112173145,MATH 18,B03,083750,Staff,0,6,30,30
1650112173145,MATH 18,B04,083751,Staff,0,6,30,30
1650112179172,MATH 20A,A01,083754,Staff,26,0,40,14
1650112185209,MATH 20B,A01,083756,Staff,0,5,30,30
1650112185209,MATH 20B,A02,083757,Staff,0,2,30,30
1650112191236,MATH 20C,A01,083760,Staff,0,11,30,30
1650112191236,MATH 20C,A02,083761,Staff,0,12,30,30
1650112191236,MATH 20C,B01,083762,Staff,14,0,30,16
1650112191236,MATH 20C,B02,083763,Staff,28,0,30,2
1650112197262,MATH 20D,A01,083765,Staff,0,2,30,30
1650112197262,MATH 20D,A02,083766,Staff,12,0,30,18
1650112197262,MATH 20D,A03,083767,Staff,28,0,30,2
1650112203298,MATH 20E,A01,083771,Staff,10,0,30,20
1650112203298,MATH 20E,A02,083772,Staff,20,0,30,10
1650112203298,MATH 20E,B01,083773,Staff,0,0,30,30
1650112203298,MATH 20E,B02,083774,Staff,13,0,30,17
1650112209325,MATH 103A,A01,083777,Staff,0,8,30,30
1650112209325,MATH 103A,A02,083778,Staff,0,7,30,30
1650112209325,MATH 103A,B01,083779,Staff,0,9,30,30
1650112209325,MATH 103A,B02,083780,Staff,0,6,30,30
1650112215356,MATH 105,A01,085443,Staff,0,13,30,30
1650112221392,MATH 109,A01,083213,Anzaldo; Leesa B,0,3,30,30
1650112221392,MATH 109,A02,083214,Anzaldo; Leesa B,0,5,30,30
1650112221392,MATH 109,B01,083215,Anzaldo; Leesa B,0,4,30,30
1650112221392,MATH 109,B02,083216,Anzaldo; Leesa B,0,4,30,30
1650112227427,MATH 142A,A01,083219,Chow; Bennett,0,10,30,30
1650112227427,MATH 142A,A02,083220,Chow; Bennett,0,10,30,30
1650112227427,MATH 142A,B01,083221,Chow; Bennett,0,10,30,30
1650112227427,MATH 142A,B02,083222,Chow; Bennett,0,9,30,30
1650112233453,MATH 193A,A01,083224,Staff,0,4,30,30
1650112233453,MATH 193A,A02,083225,Staff,0,4,30,30
1650112233453,MATH 193A,A03,083781,Staff,0,0,30,30
1650112233453,MATH 193A,A04,083782,Staff,2,0,30,28
1650112239483,MATH 197,001,091859,McAuley; Julian John,9998,0,9999,1
1650112245560,COGS 9,A01,083615,Staff,0,14,60,60
1650112251596,COGS 11,A01,083617,Boyle; Mary E. T.,24,0,40,16
1650112257622,COGS 13,A01,083071,Staff,0,28,40,40
1650112263649,COGS 14A,A01,092681,Staff,0,10,100,100
1650112269675,COGS 14B,A01,083073,Cheng; Tzu-Han,0,4,50,50
1650112275699,COGS 17,A01,092677,Staff,35,0,75,40
1650112281729,COGS 100,A01,083619,Staff,0,21,60,60
1650112287759,COGS 101A,A01,083621,Davis; Joshua Daniel,0,18,60,60
1650112293791,COGS 101B,A01,091572,Staff,10,0,60,50
1650112299817,COGS 101C,A01,083625,Delgado; Tania,22,0,30,8
1650112305844,COGS 107A,A01,083627,Boyle; Mary E. T.,0,4,60,60
1650112311869,COGS 118A,A01,083075,Staff,17,0,60,43
1650112317896,CSE 3,A50,083646,Miranda; Gregory Joseph,22,0,38,16
1650112317896,CSE 3,A51,083647,Miranda; Gregory Joseph,37,0,37,0
1650112323925,CSE 8A,A50,083650,Miranda; Gregory Joseph,0,15,40,40
1650112329975,CSE 11,A01,083080,Cao; Yingjun,0,66,40,40
1650112336004,CSE 12,A01,083652,Staff,0,2,100,100
1650112342027,CSE 15L,A01,083654,Staff,0,0,50,50
1650112342027,CSE 15L,A02,083655,Staff,10,0,50,40
1650112354566,CSE 20,A01,083657,Staff,58,0,80,22
1650112360598,CSE 30,A01,083084,Eldon; John,0,63,40,40
1650112376326,CSE 100,A01,083659,Cao; Yingjun,0,61,50,50
1650112382377,CSE 134B,A01,083661,Powell; Thomas Allan,0,27,65,65
1650112397966,CSE 140,A01,083663,Staff,4,0,75,71
1650112403996,CSE 140L,A01,083088,Eldon; John,0,1,75,75
1650112419945,CSE 175,A01,083665,Kumar; Rakesh,8,0,25,17
1650112425972,CSE 190,A00,092507,Dubnov; Shlomo,14,0,20,6
1650112442341,ECE 45,A01,083139,Staff,0,13,40,40
1650112448378,ECE 65,A50,083695,Staff,0,4,30,30
1650112463979,ECE 109,A01,091882,Touri; Behrouz,48,0,70,22
1650112470007,ECE 180,A00,083140,Abi Samra; Nicholas Camill,24,0,30,6
1650112470007,ECE 180,B00,083141,Abi Samra; Nicholas Camill,8,0,30,22
1650112485357,MATH 10A,A01,083735,Patchell; Gregory David,12,0,30,18
1650112485357,MATH 10A,A02,083736,Patchell; Gregory David,28,0,30,2
1650112485357,MATH 10A,A03,083737,Patchell; Gregory David,26,0,30,4
1650112492127,MATH 10B,A01,083207,Staff,0,5,30,30
1650112492127,MATH 10B,A02,083208,Staff,0,4,30,30
1650112492127,MATH 10B,B01,083739,Staff,18,0,30,12
1650112492127,MATH 10B,B02,083740,Staff,29,0,30,1
1650112500551,MATH 18,A01,083743,Staff,10,0,30,20
1650112500551,MATH 18,A02,083744,Staff,28,0,30,2
1650112500551,MATH 18,A03,083745,Staff,23,0,30,7
1650112500551,MATH 18,A04,083746,Staff,27,0,30,3
1650112500551,MATH 18,B01,083748,Staff,0,9,30,30
1650112500551,MATH 18,B02,083749,Staff,0,7,30,30
1650112500551,MATH 18,B03,083750,Staff,0,6,30,30
1650112500551,MATH 18,B04,083751,Staff,0,6,30,30
1650112506576,MATH 20A,A01,083754,Staff,26,0,40,14
1650112512604,MATH 20B,A01,083756,Staff,0,5,30,30
1650112512604,MATH 20B,A02,083757,Staff,0,2,30,30
1650112518638,MATH 20C,A01,083760,Staff,0,11,30,30
1650112518638,MATH 20C,A02,083761,Staff,0,12,30,30
1650112518638,MATH 20C,B01,083762,Staff,14,0,30,16
1650112518638,MATH 20C,B02,083763,Staff,28,0,30,2
1650112524675,MATH 20D,A01,083765,Staff,0,2,30,30
1650112524675,MATH 20D,A02,083766,Staff,12,0,30,18
1650112524675,MATH 20D,A03,083767,Staff,28,0,30,2
1650112530700,MATH 20E,A01,083771,Staff,10,0,30,20
1650112530700,MATH 20E,A02,083772,Staff,20,0,30,10
1650112530700,MATH 20E,B01,083773,Staff,0,0,30,30
1650112530700,MATH 20E,B02,083774,Staff,13,0,30,17
1650112536734,MATH 103A,A01,083777,Staff,0,8,30,30
1650112536734,MATH 103A,A02,083778,Staff,0,7,30,30
1650112536734,MATH 103A,B01,083779,Staff,0,9,30,30
1650112536734,MATH 103A,B02,083780,Staff,0,6,30,30
1650112542764,MATH 105,A01,085443,Staff,0,13,30,30
1650112548791,MATH 109,A01,083213,Anzaldo; Leesa B,0,3,30,30
1650112548791,MATH 109,A02,083214,Anzaldo; Leesa B,0,5,30,30
1650112548791,MATH 109,B01,083215,Anzaldo; Leesa B,0,4,30,30
1650112548791,MATH 109,B02,083216,Anzaldo; Leesa B,0,4,30,30
1650112554825,MATH 142A,A01,083219,Chow; Bennett,0,10,30,30
1650112554825,MATH 142A,A02,083220,Chow; Bennett,0,10,30,30
1650112554825,MATH 142A,B01,083221,Chow; Bennett,0,10,30,30
1650112554825,MATH 142A,B02,083222,Chow; Bennett,0,9,30,30
1650112560860,MATH 193A,A01,083224,Staff,0,4,30,30
1650112560860,MATH 193A,A02,083225,Staff,0,4,30,30
1650112560860,MATH 193A,A03,083781,Staff,0,0,30,30
1650112560860,MATH 193A,A04,083782,Staff,2,0,30,28
1650112566886,MATH 197,001,091859,McAuley; Julian John,9998,0,9999,1
1650112572978,COGS 9,A01,083615,Staff,0,14,60,60
1650112579013,COGS 11,A01,083617,Boyle; Mary E. T.,24,0,40,16
1650112585041,COGS 13,A01,083071,Staff,0,28,40,40
1650112591076,COGS 14A,A01,092681,Staff,0,10,100,100
1650112597103,COGS 14B,A01,083073,Cheng; Tzu-Han,0,4,50,50
1650112603134,COGS 17,A01,092677,Staff,35,0,75,40
1650112609167,COGS 100,A01,083619,Staff,0,21,60,60
1650112615199,COGS 101A,A01,083621,Davis; Joshua Daniel,0,18,60,60
1650112621226,COGS 101B,A01,091572,Staff,10,0,60,50
1650112627251,COGS 101C,A01,083625,Delgado; Tania,22,0,30,8
1650112633278,COGS 107A,A01,083627,Boyle; Mary E. T.,0,4,60,60
1650112639307,COGS 118A,A01,083075,Staff,17,0,60,43
1650112651015,CSE 3,A50,083646,Miranda; Gregory Joseph,22,0,38,16
1650112651015,CSE 3,A51,083647,Miranda; Gregory Joseph,37,0,37,0
1650112657051,CSE 8A,A50,083650,Miranda; Gregory Joseph,0,15,40,40
1650112664904,CSE 11,A01,083080,Cao; Yingjun,0,66,40,40
1650112670932,CSE 12,A01,083652,Staff,0,2,100,100
1650112676957,CSE 15L,A01,083654,Staff,0,0,50,50
1650112676957,CSE 15L,A02,083655,Staff,10,0,50,40
1650112682984,CSE 20,A01,083657,Staff,58,0,80,22
1650112689016,CSE 30,A01,083084,Eldon; John,0,63,40,40
1650112695043,CSE 100,A01,083659,Cao; Yingjun,0,61,50,50
1650112701071,CSE 134B,A01,083661,Powell; Thomas Allan,0,27,65,65
1650112710777,CSE 140,A01,083663,Staff,4,0,75,71
1650112716806,CSE 140L,A01,083088,Eldon; John,0,1,75,75
1650112722833,CSE 175,A01,083665,Kumar; Rakesh,8,0,25,17
1650112728859,CSE 190,A00,092507,Dubnov; Shlomo,14,0,20,6
1650112734914,ECE 45,A01,083139,Staff,0,13,40,40
1650112740950,ECE 65,A50,083695,Staff,0,4,30,30
1650112746976,ECE 109,A01,091882,Touri; Behrouz,48,0,70,22
1650112753007,ECE 180,A00,083140,Abi Samra; Nicholas Camill,24,0,30,6
1650112753007,ECE 180,B00,083141,Abi Samra; Nicholas Camill,8,0,30,22
1650112759040,MATH 10A,A01,083735,Patchell; Gregory David,12,0,30,18
1650112759040,MATH 10A,A02,083736,Patchell; Gregory David,28,0,30,2
1650112759040,MATH 10A,A03,083737,Patchell; Gregory David,26,0,30,4
1650112765073,MATH 10B,A01,083207,Staff,0,5,30,30
1650112765073,MATH 10B,A02,083208,Staff,0,4,30,30
1650112765073,MATH 10B,B01,083739,Staff,18,0,30,12
1650112765073,MATH 10B,B02,083740,Staff,29,0,30,1
1650112771109,MATH 18,A01,083743,Staff,10,0,30,20
1650112771109,MATH 18,A02,083744,Staff,28,0,30,2
1650112771109,MATH 18,A03,083745,Staff,23,0,30,7
1650112771109,MATH 18,A04,083746,Staff,27,0,30,3
1650112771109,MATH 18,B01,083748,Staff,0,9,30,30
1650112771109,MATH 18,B02,083749,Staff,0,7,30,30
1650112771109,MATH 18,B03,083750,Staff,0,6,30,30
1650112771109,MATH 18,B04,083751,Staff,0,6,30,30
1650112777139,MATH 20A,A01,083754,Staff,26,0,40,14
1650112783174,MATH 20B,A01,083756,Staff,0,5,30,30
1650112783174,MATH 20B,A02,083757,Staff,0,2,30,30
1650112789202,MATH 20C,A01,083760,Staff,0,11,30,30
1650112789202,MATH 20C,A02,083761,Staff,0,12,30,30
1650112789202,MATH 20C,B01,083762,Staff,14,0,30,16
1650112789202,MATH 20C,B02,083763,Staff,28,0,30,2
1650112795233,MATH 20D,A01,083765,Staff,0,2,30,30
1650112795233,MATH 20D,A02,083766,Staff,12,0,30,18
1650112795233,MATH 20D,A03,083767,Staff,28,0,30,2
1650112801265,MATH 20E,A01,083771,Staff,10,0,30,20
1650112801265,MATH 20E,A02,083772,Staff,20,0,30,10
1650112801265,MATH 20E,B01,083773,Staff,0,0,30,30
1650112801265,MATH 20E,B02,083774,Staff,13,0,30,17
1650112807290,MATH 103A,A01,083777,Staff,0,8,30,30
1650112807290,MATH 103A,A02,083778,Staff,0,7,30,30
1650112807290,MATH 103A,B01,083779,Staff,0,9,30,30
1650112807290,MATH 103A,B02,083780,Staff,0,6,30,30
1650112813315,MATH 105,A01,085443,Staff,0,13,30,30
1650112819346,MATH 109,A01,083213,Anzaldo; Leesa B,0,3,30,30
1650112819346,MATH 109,A02,083214,Anzaldo; Leesa B,0,5,30,30
1650112819346,MATH 109,B01,083215,Anzaldo; Leesa B,0,4,30,30
1650112819346,MATH 109,B02,083216,Anzaldo; Leesa B,0,4,30,30
1650112825379,MATH 142A,A01,083219,Chow; Bennett,0,10,30,30
1650112825379,MATH 142A,A02,083220,Chow; Bennett,0,10,30,30
1650112825379,MATH 142A,B01,083221,Chow; Bennett,0,10,30,30
1650112825379,MATH 142A,B02,083222,Chow; Bennett,0,9,30,30
1650112831405,MATH 193A,A01,083224,Staff,0,4,30,30
1650112831405,MATH 193A,A02,083225,Staff,0,4,30,30
1650112831405,MATH 193A,A03,083781,Staff,0,0,30,30
1650112831405,MATH 193A,A04,083782,Staff,2,0,30,28
1650112837430,MATH 197,001,091859,McAuley; Julian John,9998,0,9999,1
1650112843495,COGS 9,A01,083615,Staff,0,14,60,60
1650112849527,COGS 11,A01,083617,Boyle; Mary E. T.,24,0,40,16
1650112855563,COGS 13,A01,083071,Staff,0,28,40,40
1650112861589,COGS 14A,A01,092681,Staff,0,10,100,100
1650112867613,COGS 14B,A01,083073,Cheng; Tzu-Han,0,4,50,50
1650112873651,COGS 17,A01,092677,Staff,35,0,75,40
1650112879684,COGS 100,A01,083619,Staff,0,21,60,60
1650112885715,COGS 101A,A01,083621,Davis; Joshua Daniel,0,18,60,60
1650112891754,COGS 101B,A01,091572,Staff,10,0,60,50
1650112897787,COGS 101C,A01,083625,Delgado; Tania,22,0,30,8
1650112903813,COGS 107A,A01,083627,Boyle; Mary E. T.,0,4,60,60
1650112909842,COGS 118A,A01,083075,Staff,17,0,60,43
1650112915870,CSE 3,A50,083646,Miranda; Gregory Joseph,22,0,38,16
1650112915870,CSE 3,A51,083647,Miranda; Gregory Joseph,37,0,37,0
1650112921906,CSE 8A,A50,083650,Miranda; Gregory Joseph,0,15,40,40
1650112927931,CSE 11,A01,083080,Cao; Yingjun,0,66,40,40
1650112933962,CSE 12,A01,083652,Staff,0,2,100,100
1650112939988,CSE 15L,A01,083654,Staff,0,0,50,50
1650112939988,CSE 15L,A02,083655,Staff,10,0,50,40
1650112946014,CSE 20,A01,083657,Staff,58,0,80,22
1650112952037,CSE 30,A01,083084,Eldon; John,0,63,40,40
1650112958066,CSE 100,A01,083659,Cao; Yingjun,0,61,50,50
1650112964090,CSE 134B,A01,083661,Powell; Thomas Allan,0,27,65,65
1650112970116,CSE 140,A01,083663,Staff,4,0,75,71
1650112976142,CSE 140L,A01,083088,Eldon; John,0,1,75,75
1650112982169,CSE 175,A01,083665,Kumar; Rakesh,8,0,25,17
1650112988194,CSE 190,A00,092507,Dubnov; Shlomo,14,0,20,6
1650112994217,ECE 45,A01,083139,Staff,0,13,40,40
1650113000243,ECE 65,A50,083695,Staff,0,4,30,30
1650113006266,ECE 109,A01,091882,Touri; Behrouz,48,0,70,22
1650113012291,ECE 180,A00,083140,Abi Samra; Nicholas Camill,24,0,30,6
1650113012291,ECE 180,B00,083141,Abi Samra; Nicholas Camill,8,0,30,22
1650113018328,MATH 10A,A01,083735,Patchell; Gregory David,12,0,30,18
1650113018328,MATH 10A,A02,083736,Patchell; Gregory David,28,0,30,2
1650113018328,MATH 10A,A03,083737,Patchell; Gregory David,26,0,30,4
1650113024359,MATH 10B,A01,083207,Staff,0,5,30,30
1650113024359,MATH 10B,A02,083208,Staff,0,4,30,30
1650113024359,MATH 10B,B01,083739,Staff,18,0,30,12
1650113024359,MATH 10B,B02,083740,Staff,29,0,30,1
1650113030398,MATH 18,A01,083743,Staff,10,0,30,20
1650113030398,MATH 18,A02,083744,Staff,28,0,30,2
1650113030398,MATH 18,A03,083745,Staff,23,0,30,7
1650113030398,MATH 18,A04,083746,Staff,27,0,30,3
1650113030398,MATH 18,B01,083748,Staff,0,9,30,30
1650113030398,MATH 18,B02,083749,Staff,0,7,30,30
1650113030398,MATH 18,B03,083750,Staff,0,6,30,30
1650113030398,MATH 18,B04,083751,Staff,0,6,30,30
1650113036425,MATH 20A,A01,083754,Staff,26,0,40,14
1650113042451,MATH 20B,A01,083756,Staff,0,5,30,30
1650113042451,MATH 20B,A02,083757,Staff,0,2,30,30
1650113048483,MATH 20C,A01,083760,Staff,0,11,30,30
1650113048483,MATH 20C,A02,083761,Staff,0,12,30,30
1650113048483,MATH 20C,B01,083762,Staff,14,0,30,16
1650113048483,MATH 20C,B02,083763,Staff,28,0,30,2
1650113054510,MATH 20D,A01,083765,Staff,0,2,30,30
1650113054510,MATH 20D,A02,083766,Staff,12,0,30,18
1650113054510,MATH 20D,A03,083767,Staff,28,0,30,2
1650113060543,MATH 20E,A01,083771,Staff,10,0,30,20
1650113060543,MATH 20E,A02,083772,Staff,20,0,30,10
1650113060543,MATH 20E,B01,083773,Staff,0,0,30,30
1650113060543,MATH 20E,B02,083774,Staff,13,0,30,17
1650113066569,MATH 103A,A01,083777,Staff,0,8,30,30
1650113066569,MATH 103A,A02,083778,Staff,0,7,30,30
1650113066569,MATH 103A,B01,083779,Staff,0,9,30,30
1650113066569,MATH 103A,B02,083780,Staff,0,6,30,30
1650113072595,MATH 105,A01,085443,Staff,0,13,30,30
1650113078622,MATH 109,A01,083213,Anzaldo; Leesa B,0,3,30,30
1650113078622,MATH 109,A02,083214,Anzaldo; Leesa B,0,5,30,30
1650113078622,MATH 109,B01,083215,Anzaldo; Leesa B,0,4,30,30
1650113078622,MATH 109,B02,083216,Anzaldo; Leesa B,0,4,30,30
1650113084648,MATH 142A,A01,083219,Chow; Bennett,0,10,30,30
1650113084648,MATH 142A,A02,083220,Chow; Bennett,0,10,30,30
1650113084648,MATH 142A,B01,083221,Chow; Bennett,0,10,30,30
1650113084648,MATH 142A,B02,083222,Chow; Bennett,0,9,30,30
1650113090674,MATH 193A,A01,083224,Staff,0,4,30,30
1650113090674,MATH 193A,A02,083225,Staff,0,4,30,30
1650113090674,MATH 193A,A03,083781,Staff,0,0,30,30
1650113090674,MATH 193A,A04,083782,Staff,2,0,30,28
1650113096708,MATH 197,001,091859,McAuley; Julian John,9998,0,9999,1
1650113102878,COGS 9,A01,083615,Staff,0,14,60,60
1650113108904,COGS 11,A01,083617,Boyle; Mary E. T.,24,0,40,16
1650113114929,COGS 13,A01,083071,Staff,0,28,40,40
1650113120954,COGS 14A,A01,092681,Staff,0,10,100,100
1650113126983,COGS 14B,A01,083073,Cheng; Tzu-Han,0,4,50,50
1650113133008,COGS 17,A01,092677,Staff,35,0,75,40
1650113139035,COGS 100,A01,083619,Staff,0,21,60,60
1650113145072,COGS 101A,A01,083621,Davis; Joshua Daniel,0,18,60,60
1650113151101,COGS 101B,A01,091572,Staff,10,0,60,50
1650113157128,COGS 101C,A01,083625,Delgado; Tania,22,0,30,8
1650113163159,COGS 107A,A01,083627,Boyle; Mary E. T.,0,4,60,60
1650113169184,COGS 118A,A01,083075,Staff,17,0,60,43
1650113175212,CSE 3,A50,083646,Miranda; Gregory Joseph,22,0,38,16
1650113175212,CSE 3,A51,083647,Miranda; Gregory Joseph,37,0,37,0
1650113181245,CSE 8A,A50,083650,Miranda; Gregory Joseph,0,15,40,40
1650113187275,CSE 11,A01,083080,Cao; Yingjun,0,66,40,40
1650113193301,CSE 12,A01,083652,Staff,0,2,100,100
1650113199328,CSE 15L,A01,083654,Staff,0,0,50,50
1650113199328,CSE 15L,A02,083655,Staff,10,0,50,40
1650113205357,CSE 20,A01,083657,Staff,58,0,80,22
1650113211382,CSE 30,A01,083084,Eldon; John,0,63,40,40
1650113217409,CSE 100,A01,083659,Cao; Yingjun,0,61,50,50
1650113223443,CSE 134B,A01,083661,Powell; Thomas Allan,0,27,65,65
1650113229467,CSE 140,A01,083663,Staff,4,0,75,71
1650113235493,CSE 140L,A01,083088,Eldon; John,0,1,75,75
1650113241524,CSE 175,A01,083665,Kumar; Rakesh,8,0,25,17
1650113247548,CSE 190,A00,092507,Dubnov; Shlomo,14,0,20,6
1650113253574,ECE 45,A01,083139,Staff,0,13,40,40
1650113259600,ECE 65,A50,083695,Staff,0,4,30,30
1650113265632,ECE 109,A01,091882,Touri; Behrouz,48,0,70,22
1650113271659,ECE 180,A00,083140,Abi Samra; Nicholas Camill,24,0,30,6
1650113271659,ECE 180,B00,083141,Abi Samra; Nicholas Camill,8,0,30,22
1650113277694,MATH 10A,A01,083735,Patchell; Gregory David,12,0,30,18
1650113277694,MATH 10A,A02,083736,Patchell; Gregory David,28,0,30,2
1650113277694,MATH 10A,A03,083737,Patchell; Gregory David,26,0,30,4
1650113283721,MATH 10B,A01,083207,Staff,0,5,30,30
1650113283721,MATH 10B,A02,083208,Staff,0,4,30,30
1650113283721,MATH 10B,B01,083739,Staff,18,0,30,12
1650113283721,MATH 10B,B02,083740,Staff,29,0,30,1
1650113289750,MATH 18,A01,083743,Staff,10,0,30,20
1650113289750,MATH 18,A02,083744,Staff,28,0,30,2
1650113289750,MATH 18,A03,083745,Staff,23,0,30,7
1650113289750,MATH 18,A04,083746,Staff,27,0,30,3
1650113289750,MATH 18,B01,083748,Staff,0,9,30,30
1650113289750,MATH 18,B02,083749,Staff,0,7,30,30
1650113289750,MATH 18,B03,083750,Staff,0,6,30,30
1650113289750,MATH 18,B04,083751,Staff,0,6,30,30
1650113295779,MATH 20A,A01,083754,Staff,26,0,40,14
1650113301806,MATH 20B,A01,083756,Staff,0,5,30,30
1650113301806,MATH 20B,A02,083757,Staff,0,2,30,30
1650113307833,MATH 20C,A01,083760,Staff,0,11,30,30
1650113307833,MATH 20C,A02,083761,Staff,0,12,30,30
1650113307833,MATH 20C,B01,083762,Staff,14,0,30,16
1650113307833,MATH 20C,B02,083763,Staff,28,0,30,2
1650113313863,MATH 20D,A01,083765,Staff,0,2,30,30
1650113313863,MATH 20D,A02,083766,Staff,12,0,30,18
1650113313863,MATH 20D,A03,083767,Staff,28,0,30,2
1650113319894,MATH 20E,A01,083771,Staff,10,0,30,20
1650113319894,MATH 20E,A02,083772,Staff,20,0,30,10
1650113319894,MATH 20E,B01,083773,Staff,0,0,30,30
1650113319894,MATH 20E,B02,083774,Staff,13,0,30,17
1650113325926,MATH 103A,A01,083777,Staff,0,8,30,30
1650113325926,MATH 103A,A02,083778,Staff,0,7,30,30
1650113325926,MATH 103A,B01,083779,Staff,0,9,30,30
1650113325926,MATH 103A,B02,083780,Staff,0,6,30,30
1650113331952,MATH 105,A01,085443,Staff,0,13,30,30
1650113337978,MATH 109,A01,083213,Anzaldo; Leesa B,0,3,30,30
1650113337978,MATH 109,A02,083214,Anzaldo; Leesa B,0,5,30,30
1650113337978,MATH 109,B01,083215,Anzaldo; Leesa B,0,4,30,30
1650113337978,MATH 109,B02,083216,Anzaldo; Leesa B,0,4,30,30
1650113344010,MATH 142A,A01,083219,Chow; Bennett,0,10,30,30
1650113344010,MATH 142A,A02,083220,Chow; Bennett,0,10,30,30
1650113344010,MATH 142A,B01,083221,Chow; Bennett,0,10,30,30
1650113344010,MATH 142A,B02,083222,Chow; Bennett,0,9,30,30
1650113350037,MATH 193A,A01,083224,Staff,0,4,30,30
1650113350037,MATH 193A,A02,083225,Staff,0,4,30,30
1650113350037,MATH 193A,A03,083781,Staff,0,0,30,30
1650113350037,MATH 193A,A04,083782,Staff,2,0,30,28
1650113356071,MATH 197,001,091859,McAuley; Julian John,9998,0,9999,1
1650113362138,COGS 9,A01,083615,Staff,0,14,60,60
1650113368168,COGS 11,A01,083617,Boyle; Mary E. T.,24,0,40,16
1650113374194,COGS 13,A01,083071,Staff,0,28,40,40
1650113380221,COGS 14A,A01,092681,Staff,0,10,100,100
1650113386246,COGS 14B,A01,083073,Cheng; Tzu-Han,0,4,50,50
1650113392271,COGS 17,A01,092677,Staff,35,0,75,40
1650113398297,COGS 100,A01,083619,Staff,0,21,60,60
1650113404323,COGS 101A,A01,083621,Davis; Joshua Daniel,0,18,60,60
1650113410354,COGS 101B,A01,091572,Staff,10,0,60,50
1650113416382,COGS 101C,A01,083625,Delgado; Tania,22,0,30,8
1650113422408,COGS 107A,A01,083627,Boyle; Mary E. T.,0,4,60,60
1650113428437,COGS 118A,A01,083075,Staff,17,0,60,43
1650113434464,CSE 3,A50,083646,Miranda; Gregory Joseph,22,0,38,16
1650113434464,CSE 3,A51,083647,Miranda; Gregory Joseph,37,0,37,0
1650113440494,CSE 8A,A50,083650,Miranda; Gregory Joseph,0,15,40,40
1650113446523,CSE 11,A01,083080,Cao; Yingjun,0,66,40,40
1650113452550,CSE 12,A01,083652,Staff,0,2,100,100
1650113458575,CSE 15L,A01,083654,Staff,0,0,50,50
1650113458575,CSE 15L,A02,083655,Staff,10,0,50,40
1650113464606,CSE 20,A01,083657,Staff,58,0,80,22
1650113470643,CSE 30,A01,083084,Eldon; John,0,63,40,40
1650113476673,CSE 100,A01,083659,Cao; Yingjun,0,61,50,50
1650113482706,CSE 134B,A01,083661,Powell; Thomas Allan,0,27,65,65
1650113488735,CSE 140,A01,083663,Staff,4,0,75,71
1650113494765,CSE 140L,A01,083088,Eldon; John,0,1,75,75
1650113500796,CSE 175,A01,083665,Kumar; Rakesh,8,0,25,17
1650113506823,CSE 190,A00,092507,Dubnov; Shlomo,14,0,20,6
1650113512850,ECE 45,A01,083139,Staff,0,13,40,40
1650113518880,ECE 65,A50,083695,Staff,0,4,30,30
1650113524906,ECE 109,A01,091882,Touri; Behrouz,48,0,70,22
1650113530937,ECE 180,A00,083140,Abi Samra; Nicholas Camill,24,0,30,6
1650113530937,ECE 180,B00,083141,Abi Samra; Nicholas Camill,8,0,30,22
1650113536965,MATH 10A,A01,083735,Patchell; Gregory David,12,0,30,18
1650113536965,MATH 10A,A02,083736,Patchell; Gregory David,28,0,30,2
1650113536965,MATH 10A,A03,083737,Patchell; Gregory David,26,0,30,4
1650113542999,MATH 10B,A01,083207,Staff,0,5,30,30
1650113542999,MATH 10B,A02,083208,Staff,0,4,30,30
1650113542999,MATH 10B,B01,083739,Staff,18,0,30,12
1650113542999,MATH 10B,B02,083740,Staff,29,0,30,1
1650113549037,MATH 18,A01,083743,Staff,10,0,30,20
1650113549037,MATH 18,A02,083744,Staff,28,0,30,2
1650113549037,MATH 18,A03,083745,Staff,23,0,30,7
1650113549037,MATH 18,A04,083746,Staff,27,0,30,3
1650113549037,MATH 18,B01,083748,Staff,0,9,30,30
1650113549037,MATH 18,B02,083749,Staff,0,7,30,30
1650113549037,MATH 18,B03,083750,Staff,0,6,30,30
1650113549037,MATH 18,B04,083751,Staff,0,6,30,30
1650113555075,MATH 20A,A01,083754,Staff,26,0,40,14
1650113561106,MATH 20B,A01,083756,Staff,0,5,30,30
1650113561106,MATH 20B,A02,083757,Staff,0,2,30,30
1650113567147,MATH 20C,A01,083760,Staff,0,11,30,30
1650113567147,MATH 20C,A02,083761,Staff,0,12,30,30
1650113567147,MATH 20C,B01,083762,Staff,14,0,30,16
1650113567147,MATH 20C,B02,083763,Staff,28,0,30,2
1650113573174,MATH 20D,A01,083765,Staff,0,2,30,30
1650113573174,MATH 20D,A02,083766,Staff,12,0,30,18
1650113573174,MATH 20D,A03,083767,Staff,28,0,30,2
1650113579207,MATH 20E,A01,083771,Staff,10,0,30,20
1650113579207,MATH 20E,A02,083772,Staff,20,0,30,10
1650113579207,MATH 20E,B01,083773,Staff,0,0,30,30
1650113579207,MATH 20E,B02,083774,Staff,13,0,30,17
1650113585247,MATH 103A,A01,083777,Staff,0,8,30,30
1650113585247,MATH 103A,A02,083778,Staff,0,7,30,30
1650113585247,MATH 103A,B01,083779,Staff,0,9,30,30
1650113585247,MATH 103A,B02,083780,Staff,0,6,30,30
1650113591276,MATH 105,A01,085443,Staff,0,13,30,30
1650113597299,MATH 109,A01,083213,Anzaldo; Leesa B,0,3,30,30
1650113597299,MATH 109,A02,083214,Anzaldo; Leesa B,0,5,30,30
1650113597299,MATH 109,B01,083215,Anzaldo; Leesa B,0,4,30,30
1650113597299,MATH 109,B02,083216,Anzaldo; Leesa B,0,4,30,30
1650113603330,MATH 142A,A01,083219,Chow; Bennett,0,10,30,30
1650113603330,MATH 142A,A02,083220,Chow; Bennett,0,10,30,30
1650113603330,MATH 142A,B01,083221,Chow; Bennett,0,10,30,30
1650113603330,MATH 142A,B02,083222,Chow; Bennett,0,9,30,30
1650113609361,MATH 193A,A01,083224,Staff,0,4,30,30
1650113609361,MATH 193A,A02,083225,Staff,0,4,30,30
1650113609361,MATH 193A,A03,083781,Staff,0,0,30,30
1650113609361,MATH 193A,A04,083782,Staff,2,0,30,28
1650113615392,MATH 197,001,091859,McAuley; Julian John,9998,0,9999,1
1650113621460,COGS 9,A01,083615,Staff,0,14,60,60
1650113627484,COGS 11,A01,083617,Boyle; Mary E. T.,24,0,40,16
1650113633510,COGS 13,A01,083071,Staff,0,28,40,40
1650113639534,COGS 14A,A01,092681,Staff,0,10,100,100
1650113645587,COGS 14B,A01,083073,Cheng; Tzu-Han,0,4,50,50
1650113651613,COGS 17,A01,092677,Staff,35,0,75,40
1650113657643,COGS 100,A01,083619,Staff,0,21,60,60
1650113663669,COGS 101A,A01,083621,Davis; Joshua Daniel,0,18,60,60
1650113669698,COGS 101B,A01,091572,Staff,10,0,60,50
1650113675728,COGS 101C,A01,083625,Delgado; Tania,22,0,30,8
1650113681767,COGS 107A,A01,083627,Boyle; Mary E. T.,0,4,60,60
1650113687792,COGS 118A,A01,083075,Staff,17,0,60,43
1650113693933,CSE 3,A50,083646,Miranda; Gregory Joseph,22,0,38,16
1650113693933,CSE 3,A51,083647,Miranda; Gregory Joseph,37,0,37,0
1650113699962,CSE 8A,A50,083650,Miranda; Gregory Joseph,0,15,40,40
1650113705987,CSE 11,A01,083080,Cao; Yingjun,0,66,40,40
1650113712013,CSE 12,A01,083652,Staff,0,2,100,100
1650113718041,CSE 15L,A01,083654,Staff,0,0,50,50
1650113718041,CSE 15L,A02,083655,Staff,10,0,50,40
1650113724066,CSE 20,A01,083657,Staff,58,0,80,22
1650113730092,CSE 30,A01,083084,Eldon; John,0,63,40,40
1650113736122,CSE 100,A01,083659,Cao; Yingjun,0,61,50,50
1650113742153,CSE 134B,A01,083661,Powell; Thomas Allan,0,27,65,65
1650113748177,CSE 140,A01,083663,Staff,4,0,75,71
1650113754212,CSE 140L,A01,083088,Eldon; John,0,1,75,75
1650113760244,CSE 175,A01,083665,Kumar; Rakesh,8,0,25,17
1650113766269,CSE 190,A00,092507,Dubnov; Shlomo,14,0,20,6
1650113772292,ECE 45,A01,083139,Staff,0,13,40,40
1650113778317,ECE 65,A50,083695,Staff,0,4,30,30
1650113784344,ECE 109,A01,091882,Touri; Behrouz,48,0,70,22
1650113790371,ECE 180,A00,083140,Abi Samra; Nicholas Camill,24,0,30,6
1650113790371,ECE 180,B00,083141,Abi Samra; Nicholas Camill,8,0,30,22
1650113796403,MATH 10A,A01,083735,Patchell; Gregory David,12,0,30,18
1650113796403,MATH 10A,A02,083736,Patchell; Gregory David,28,0,30,2
1650113796403,MATH 10A,A03,083737,Patchell; Gregory David,26,0,30,4
1650113802453,MATH 10B,A01,083207,Staff,0,5,30,30
1650113802453,MATH 10B,A02,083208,Staff,0,4,30,30
1650113802453,MATH 10B,B01,083739,Staff,18,0,30,12
1650113802453,MATH 10B,B02,083740,Staff,29,0,30,1
1650113808489,MATH 18,A01,083743,Staff,10,0,30,20
1650113808489,MATH 18,A02,083744,Staff,28,0,30,2
1650113808489,MATH 18,A03,083745,Staff,23,0,30,7
1650113808489,MATH 18,A04,083746,Staff,27,0,30,3
1650113808489,MATH 18,B01,083748,Staff,0,9,30,30
1650113808489,MATH 18,B02,083749,Staff,0,7,30,30
1650113808489,MATH 18,B03,083750,Staff,0,6,30,30
1650113808489,MATH 18,B04,083751,Staff,0,6,30,30
1650113814518,MATH 20A,A01,083754,Staff,26,0,40,14
1650113820548,MATH 20B,A01,083756,Staff,0,5,30,30
1650113820548,MATH 20B,A02,083757,Staff,0,2,30,30
1650113826574,MATH 20C,A01,083760,Staff,0,11,30,30
1650113826574,MATH 20C,A02,083761,Staff,0,12,30,30
1650113826574,MATH 20C,B01,083762,Staff,14,0,30,16
1650113826574,MATH 20C,B02,083763,Staff,28,0,30,2
1650113832604,MATH 20D,A01,083765,Staff,0,2,30,30
1650113832604,MATH 20D,A02,083766,Staff,12,0,30,18
1650113832604,MATH 20D,A03,083767,Staff,28,0,30,2
1650113838637,MATH 20E,A01,083771,Staff,10,0,30,20
1650113838637,MATH 20E,A02,083772,Staff,20,0,30,10
1650113838637,MATH 20E,B01,083773,Staff,0,0,30,30
1650113838637,MATH 20E,B02,083774,Staff,13,0,30,17
1650113844661,MATH 103A,A01,083777,Staff,0,8,30,30
1650113844661,MATH 103A,A02,083778,Staff,0,7,30,30
1650113844661,MATH 103A,B01,083779,Staff,0,9,30,30
1650113844661,MATH 103A,B02,083780,Staff,0,6,30,30
1650113850692,MATH 105,A01,085443,Staff,0,13,30,30
1650113856722,MATH 109,A01,083213,Anzaldo; Leesa B,0,3,30,30
1650113856722,MATH 109,A02,083214,Anzaldo; Leesa B,0,5,30,30
1650113856722,MATH 109,B01,083215,Anzaldo; Leesa B,0,4,30,30
1650113856722,MATH 109,B02,083216,Anzaldo; Leesa B,0,4,30,30
1650113862764,MATH 142A,A01,083219,Chow; Bennett,0,10,30,30
1650113862764,MATH 142A,A02,083220,Chow; Bennett,0,10,30,30
1650113862764,MATH 142A,B01,083221,Chow; Bennett,0,10,30,30
1650113862764,MATH 142A,B02,083222,Chow; Bennett,0,9,30,30
1650113868794,MATH 193A,A01,083224,Staff,0,4,30,30
1650113868794,MATH 193A,A02,083225,Staff,0,4,30,30
1650113868794,MATH 193A,A03,083781,Staff,0,0,30,30
1650113868794,MATH 193A,A04,083782,Staff,2,0,30,28
1650113874820,MATH 197,001,091859,McAuley; Julian John,9998,0,9999,1
1650113880881,COGS 9,A01,083615,Staff,0,14,60,60
1650113886910,COGS 11,A01,083617,Boyle; Mary E. T.,24,0,40,16
1650113892942,COGS 13,A01,083071,Staff,0,28,40,40
1650113898967,COGS 14A,A01,092681,Staff,0,10,100,100
1650113905026,COGS 14B,A01,083073,Cheng; Tzu-Han,0,4,50,50
1650113911053,COGS 17,A01,092677,Staff,35,0,75,40
1650113917096,COGS 100,A01,083619,Staff,0,21,60,60
1650113923122,COGS 101A,A01,083621,Davis; Joshua Daniel,0,18,60,60
1650113929151,COGS 101B,A01,091572,Staff,10,0,60,50
1650113935184,COGS 101C,A01,083625,Delgado; Tania,22,0,30,8
1650113941210,COGS 107A,A01,083627,Boyle; Mary E. T.,0,4,60,60
1650113947240,COGS 118A,A01,083075,Staff,17,0,60,43
1650113953267,CSE 3,A50,083646,Miranda; Gregory Joseph,22,0,38,16
1650113953267,CSE 3,A51,083647,Miranda; Gregory Joseph,37,0,37,0
1650113959292,CSE 8A,A50,083650,Miranda; Gregory Joseph,0,15,40,40
1650113965323,CSE 11,A01,083080,Cao; Yingjun,0,66,40,40
1650113971349,CSE 12,A01,083652,Staff,0,2,100,100
1650113977374,CSE 15L,A01,083654,Staff,0,0,50,50
1650113977374,CSE 15L,A02,083655,Staff,10,0,50,40
1650113983406,CSE 20,A01,083657,Staff,58,0,80,22
1650113989438,CSE 30,A01,083084,Eldon; John,0,63,40,40
1650113995464,CSE 100,A01,083659,Cao; Yingjun,0,61,50,50
1650114001493,CSE 134B,A01,083661,Powell; Thomas Allan,0,27,65,65
1650114007529,CSE 140,A01,083663,Staff,4,0,75,71
1650114013554,CSE 140L,A01,083088,Eldon; John,0,1,75,75
1650114019592,CSE 175,A01,083665,Kumar; Rakesh,8,0,25,17
1650114025616,CSE 190,A00,092507,Dubnov; Shlomo,14,0,20,6
1650114031642,ECE 45,A01,083139,Staff,0,13,40,40
1650114037668,ECE 65,A50,083695,Staff,0,4,30,30
1650114043694,ECE 109,A01,091882,Touri; Behrouz,48,0,70,22
1650114049720,ECE 180,A00,083140,Abi Samra; Nicholas Camill,24,0,30,6
1650114049720,ECE 180,B00,083141,Abi Samra; Nicholas Camill,8,0,30,22
1650114055748,MATH 10A,A01,083735,Patchell; Gregory David,12,0,30,18
1650114055748,MATH 10A,A02,083736,Patchell; Gregory David,28,0,30,2
1650114055748,MATH 10A,A03,083737,Patchell; Gregory David,26,0,30,4
1650114061775,MATH 10B,A01,083207,Staff,0,5,30,30
1650114061775,MATH 10B,A02,083208,Staff,0,4,30,30
1650114061775,MATH 10B,B01,083739,Staff,18,0,30,12
1650114061775,MATH 10B,B02,083740,Staff,29,0,30,1
1650114067807,MATH 18,A01,083743,Staff,10,0,30,20
1650114067807,MATH 18,A02,083744,Staff,28,0,30,2
1650114067807,MATH 18,A03,083745,Staff,23,0,30,7
1650114067807,MATH 18,A04,083746,Staff,27,0,30,3
1650114067807,MATH 18,B01,083748,Staff,0,9,30,30
1650114067807,MATH 18,B02,083749,Staff,0,7,30,30
1650114067807,MATH 18,B03,083750,Staff,0,6,30,30
1650114067807,MATH 18,B04,083751,Staff,0,6,30,30
1650114073832,MATH 20A,A01,083754,Staff,26,0,40,14
1650114079857,MATH 20B,A01,083756,Staff,0,5,30,30
1650114079857,MATH 20B,A02,083757,Staff,0,2,30,30
1650114085885,MATH 20C,A01,083760,Staff,0,11,30,30
1650114085885,MATH 20C,A02,083761,Staff,0,12,30,30
1650114085885,MATH 20C,B01,083762,Staff,14,0,30,16
1650114085885,MATH 20C,B02,083763,Staff,28,0,30,2
1650114091909,MATH 20D,A01,083765,Staff,0,2,30,30
1650114091909,MATH 20D,A02,083766,Staff,12,0,30,18
1650114091909,MATH 20D,A03,083767,Staff,28,0,30,2
1650114097935,MATH 20E,A01,083771,Staff,10,0,30,20
1650114097935,MATH 20E,A02,083772,Staff,20,0,30,10
1650114097935,MATH 20E,B01,083773,Staff,0,0,30,30
1650114097935,MATH 20E,B02,083774,Staff,13,0,30,17
1650114103969,MATH 103A,A01,083777,Staff,0,8,30,30
1650114103969,MATH 103A,A02,083778,Staff,0,7,30,30
1650114103969,MATH 103A,B01,083779,Staff,0,9,30,30
1650114103969,MATH 103A,B02,083780,Staff,0,6,30,30
1650114109995,MATH 105,A01,085443,Staff,0,13,30,30
1650114116021,MATH 109,A01,083213,Anzaldo; Leesa B,0,3,30,30
1650114116021,MATH 109,A02,083214,Anzaldo; Leesa B,0,5,30,30
1650114116021,MATH 109,B01,083215,Anzaldo; Leesa B,0,4,30,30
1650114116021,MATH 109,B02,083216,Anzaldo; Leesa B,0,4,30,30
1650114122054,MATH 142A,A01,083219,Chow; Bennett,0,10,30,30
1650114122054,MATH 142A,A02,083220,Chow; Bennett,0,10,30,30
1650114122054,MATH 142A,B01,083221,Chow; Bennett,0,10,30,30
1650114122054,MATH 142A,B02,083222,Chow; Bennett,0,9,30,30
1650114128082,MATH 193A,A01,083224,Staff,0,4,30,30
1650114128082,MATH 193A,A02,083225,Staff,0,4,30,30
1650114128082,MATH 193A,A03,083781,Staff,0,0,30,30
1650114128082,MATH 193A,A04,083782,Staff,2,0,30,28
1650114134112,MATH 197,001,091859,McAuley; Julian John,9998,0,9999,1
1650114140183,COGS 9,A01,083615,Staff,0,14,60,60
1650114146208,COGS 11,A01,083617,Boyle; Mary E. T.,24,0,40,16
1650114152239,COGS 13,A01,083071,Staff,0,28,40,40
1650114158264,COGS 14A,A01,092681,Staff,0,10,100,100
1650114164289,COGS 14B,A01,083073,Cheng; Tzu-Han,0,4,50,50
1650114170316,COGS 17,A01,092677,Staff,35,0,75,40
1650114176346,COGS 100,A01,083619,Staff,0,21,60,60
1650114182375,COGS 101A,A01,083621,Davis; Joshua Daniel,0,18,60,60
1650114188406,COGS 101B,A01,091572,Staff,10,0,60,50
1650114194439,COGS 101C,A01,083625,Delgado; Tania,22,0,30,8
1650114200464,COGS 107A,A01,083627,Boyle; Mary E. T.,0,4,60,60
1650114206494,COGS 118A,A01,083075,Staff,17,0,60,43
1650114212524,CSE 3,A50,083646,Miranda; Gregory Joseph,22,0,38,16
1650114212524,CSE 3,A51,083647,Miranda; Gregory Joseph,37,0,37,0
1650114218551,CSE 8A,A50,083650,Miranda; Gregory Joseph,0,15,40,40
1650114224614,CSE 11,A01,083080,Cao; Yingjun,0,66,40,40
1650114230642,CSE 12,A01,083652,Staff,0,2,100,100
1650114236671,CSE 15L,A01,083654,Staff,0,0,50,50
1650114236671,CSE 15L,A02,083655,Staff,10,0,50,40
1650114242697,CSE 20,A01,083657,Staff,58,0,80,22
1650114248727,CSE 30,A01,083084,Eldon; John,0,63,40,40
1650114254772,CSE 100,A01,083659,Cao; Yingjun,0,61,50,50
1650114260800,CSE 134B,A01,083661,Powell; Thomas Allan,0,27,65,65
1650114266829,CSE 140,A01,083663,Staff,4,0,75,71
1650114272858,CSE 140L,A01,083088,Eldon; John,0,1,75,75
1650114278884,CSE 175,A01,083665,Kumar; Rakesh,8,0,25,17
1650114284914,CSE 190,A00,092507,Dubnov; Shlomo,14,0,20,6
1650114291035,ECE 45,A01,083139,Staff,0,13,40,40
1650114297061,ECE 65,A50,083695,Staff,0,4,30,30
1650114303088,ECE 109,A01,091882,Touri; Behrouz,48,0,70,22
1650114309118,ECE 180,A00,083140,Abi Samra; Nicholas Camill,24,0,30,6
1650114309118,ECE 180,B00,083141,Abi Samra; Nicholas Camill,8,0,30,22
1650114315147,MATH 10A,A01,083735,Patchell; Gregory David,12,0,30,18
1650114315147,MATH 10A,A02,083736,Patchell; Gregory David,28,0,30,2
1650114315147,MATH 10A,A03,083737,Patchell; Gregory David,26,0,30,4
1650114321186,MATH 10B,A01,083207,Staff,0,5,30,30
1650114321186,MATH 10B,A02,083208,Staff,0,4,30,30
1650114321186,MATH 10B,B01,083739,Staff,18,0,30,12
1650114321186,MATH 10B,B02,083740,Staff,29,0,30,1
1650114327221,MATH 18,A01,083743,Staff,10,0,30,20
1650114327221,MATH 18,A02,083744,Staff,28,0,30,2
1650114327221,MATH 18,A03,083745,Staff,23,0,30,7
1650114327221,MATH 18,A04,083746,Staff,27,0,30,3
1650114327221,MATH 18,B01,083748,Staff,0,9,30,30
1650114327221,MATH 18,B02,083749,Staff,0,7,30,30
1650114327221,MATH 18,B03,083750,Staff,0,6,30,30
1650114327221,MATH 18,B04,083751,Staff,0,6,30,30
1650114333250,MATH 20A,A01,083754,Staff,26,0,40,14
1650114339283,MATH 20B,A01,083756,Staff,0,5,30,30
1650114339283,MATH 20B,A02,083757,Staff,0,2,30,30
1650114345317,MATH 20C,A01,083760,Staff,0,11,30,30
1650114345317,MATH 20C,A02,083761,Staff,0,12,30,30
1650114345317,MATH 20C,B01,083762,Staff,14,0,30,16
1650114345317,MATH 20C,B02,083763,Staff,28,0,30,2
1650114351347,MATH 20D,A01,083765,Staff,0,2,30,30
1650114351347,MATH 20D,A02,083766,Staff,12,0,30,18
1650114351347,MATH 20D,A03,083767,Staff,28,0,30,2
1650114357384,MATH 20E,A01,083771,Staff,10,0,30,20
1650114357384,MATH 20E,A02,083772,Staff,20,0,30,10
1650114357384,MATH 20E,B01,083773,Staff,0,0,30,30
1650114357384,MATH 20E,B02,083774,Staff,13,0,30,17
1650114363412,MATH 103A,A01,083777,Staff,0,8,30,30
1650114363412,MATH 103A,A02,083778,Staff,0,7,30,30
1650114363412,MATH 103A,B01,083779,Staff,0,9,30,30
1650114363412,MATH 103A,B02,083780,Staff,0,6,30,30
1650114369440,MATH 105,A01,085443,Staff,0,13,30,30
1650114375466,MATH 109,A01,083213,Anzaldo; Leesa B,0,3,30,30
1650114375466,MATH 109,A02,083214,Anzaldo; Leesa B,0,5,30,30
1650114375466,MATH 109,B01,083215,Anzaldo; Leesa B,0,4,30,30
1650114375466,MATH 109,B02,083216,Anzaldo; Leesa B,0,4,30,30
1650114381493,MATH 142A,A01,083219,Chow; Bennett,0,10,30,30
1650114381493,MATH 142A,A02,083220,Chow; Bennett,0,10,30,30
1650114381493,MATH 142A,B01,083221,Chow; Bennett,0,10,30,30
1650114381493,MATH 142A,B02,083222,Chow; Bennett,0,9,30,30
1650114387522,MATH 193A,A01,083224,Staff,0,4,30,30
1650114387522,MATH 193A,A02,083225,Staff,0,4,30,30
1650114387522,MATH 193A,A03,083781,Staff,0,0,30,30
1650114387522,MATH 193A,A04,083782,Staff,2,0,30,28
1650114393550,MATH 197,001,091859,McAuley; Julian John,9998,0,9999,1
1650114399621,COGS 9,A01,083615,Staff,0,14,60,60
1650114405648,COGS 11,A01,083617,Boyle; Mary E. T.,24,0,40,16
1650114411680,COGS 13,A01,083071,Staff,0,28,40,40
1650114417706,COGS 14A,A01,092681,Staff,0,10,100,100
1650114423732,COGS 14B,A01,083073,Cheng; Tzu-Han,0,4,50,50
1650114429759,COGS 17,A01,092677,Staff,35,0,75,40
1650114435790,COGS 100,A01,083619,Staff,0,21,60,60
1650114441820,COGS 101A,A01,083621,Davis; Joshua Daniel,0,18,60,60
1650114447850,COGS 101B,A01,091572,Staff,10,0,60,50
1650114453876,COGS 101C,A01,083625,Delgado; Tania,22,0,30,8
1650114459906,COGS 107A,A01,083627,Boyle; Mary E. T.,0,4,60,60
1650114465934,COGS 118A,A01,083075,Staff,17,0,60,43
1650114471969,CSE 3,A50,083646,Miranda; Gregory Joseph,22,0,38,16
1650114471969,CSE 3,A51,083647,Miranda; Gregory Joseph,37,0,37,0
1650114477995,CSE 8A,A50,083650,Miranda; Gregory Joseph,0,15,40,40
1650114484020,CSE 11,A01,083080,Cao; Yingjun,0,66,40,40
1650114490068,CSE 12,A01,083652,Staff,0,2,100,100
1650114496097,CSE 15L,A01,083654,Staff,0,0,50,50
1650114496097,CSE 15L,A02,083655,Staff,10,0,50,40
1650114502122,CSE 20,A01,083657,Staff,58,0,80,22
1650114508184,CSE 30,A01,083084,Eldon; John,0,63,40,40
1650114514211,CSE 100,A01,083659,Cao; Yingjun,0,61,50,50
1650114520235,CSE 134B,A01,083661,Powell; Thomas Allan,0,27,65,65
1650114526260,CSE 140,A01,083663,Staff,4,0,75,71
1650114532289,CSE 140L,A01,083088,Eldon; John,0,1,75,75
1650114538313,CSE 175,A01,083665,Kumar; Rakesh,8,0,25,17
1650114544343,CSE 190,A00,092507,Dubnov; Shlomo,14,0,20,6
1650114550373,ECE 45,A01,083139,Staff,0,13,40,40
1650114556404,ECE 65,A50,083695,Staff,0,4,30,30
1650114562431,ECE 109,A01,091882,Touri; Behrouz,48,0,70,22
1650114568461,ECE 180,A00,083140,Abi Samra; Nicholas Camill,24,0,30,6
1650114568461,ECE 180,B00,083141,Abi Samra; Nicholas Camill,8,0,30,22
1650114574487,MATH 10A,A01,083735,Patchell; Gregory David,12,0,30,18
1650114574487,MATH 10A,A02,083736,Patchell; Gregory David,28,0,30,2
1650114574487,MATH 10A,A03,083737,Patchell; Gregory David,26,0,30,4
1650114580514,MATH 10B,A01,083207,Staff,0,5,30,30
1650114580514,MATH 10B,A02,083208,Staff,0,4,30,30
1650114580514,MATH 10B,B01,083739,Staff,18,0,30,12
1650114580514,MATH 10B,B02,083740,Staff,29,0,30,1
1650114586543,MATH 18,A01,083743,Staff,10,0,30,20
1650114586543,MATH 18,A02,083744,Staff,28,0,30,2
1650114586543,MATH 18,A03,083745,Staff,23,0,30,7
1650114586543,MATH 18,A04,083746,Staff,27,0,30,3
1650114586543,MATH 18,B01,083748,Staff,0,9,30,30
1650114586543,MATH 18,B02,083749,Staff,0,7,30,30
1650114586543,MATH 18,B03,083750,Staff,0,6,30,30
1650114586543,MATH 18,B04,083751,Staff,0,6,30,30
1650114592568,MATH 20A,A01,083754,Staff,26,0,40,14
1650114598600,MATH 20B,A01,083756,Staff,0,5,30,30
1650114598600,MATH 20B,A02,083757,Staff,0,2,30,30
1650114604632,MATH 20C,A01,083760,Staff,0,11,30,30
1650114604632,MATH 20C,A02,083761,Staff,0,12,30,30
1650114604632,MATH 20C,B01,083762,Staff,14,0,30,16
1650114604632,MATH 20C,B02,083763,Staff,28,0,30,2
1650114610657,MATH 20D,A01,083765,Staff,0,2,30,30
1650114610657,MATH 20D,A02,083766,Staff,12,0,30,18
1650114610657,MATH 20D,A03,083767,Staff,28,0,30,2
1650114616684,MATH 20E,A01,083771,Staff,10,0,30,20
1650114616684,MATH 20E,A02,083772,Staff,20,0,30,10
1650114616684,MATH 20E,B01,083773,Staff,0,0,30,30
1650114616684,MATH 20E,B02,083774,Staff,13,0,30,17
1650114622711,MATH 103A,A01,083777,Staff,0,8,30,30
1650114622711,MATH 103A,A02,083778,Staff,0,7,30,30
1650114622711,MATH 103A,B01,083779,Staff,0,9,30,30
1650114622711,MATH 103A,B02,083780,Staff,0,6,30,30
1650114628749,MATH 105,A01,085443,Staff,0,13,30,30
1650114634776,MATH 109,A01,083213,Anzaldo; Leesa B,0,3,30,30
1650114634776,MATH 109,A02,083214,Anzaldo; Leesa B,0,5,30,30
1650114634776,MATH 109,B01,083215,Anzaldo; Leesa B,0,4,30,30
1650114634776,MATH 109,B02,083216,Anzaldo; Leesa B,0,4,30,30
1650114640802,MATH 142A,A01,083219,Chow; Bennett,0,10,30,30
1650114640802,MATH 142A,A02,083220,Chow; Bennett,0,10,30,30
1650114640802,MATH 142A,B01,083221,Chow; Bennett,0,10,30,30
1650114640802,MATH 142A,B02,083222,Chow; Bennett,0,9,30,30
1650114646827,MATH 193A,A01,083224,Staff,0,4,30,30
1650114646827,MATH 193A,A02,083225,Staff,0,4,30,30
1650114646827,MATH 193A,A03,083781,Staff,0,0,30,30
1650114646827,MATH 193A,A04,083782,Staff,2,0,30,28
1650114652854,MATH 197,001,091859,McAuley; Julian John,9998,0,9999,1
1650114658928,COGS 9,A01,083615,Staff,0,14,60,60
1650114664960,COGS 11,A01,083617,Boyle; Mary E. T.,24,0,40,16
1650114670984,COGS 13,A01,083071,Staff,0,28,40,40
1650114677013,COGS 14A,A01,092681,Staff,0,10,100,100
1650114683041,COGS 14B,A01,083073,Cheng; Tzu-Han,0,4,50,50
1650114689067,COGS 17,A01,092677,Staff,35,0,75,40
1650114695099,COGS 100,A01,083619,Staff,0,21,60,60
1650114701126,COGS 101A,A01,083621,Davis; Joshua Daniel,0,18,60,60
1650114707152,COGS 101B,A01,091572,Staff,10,0,60,50
1650114713180,COGS 101C,A01,083625,Delgado; Tania,22,0,30,8
1650114719205,COGS 107A,A01,083627,Boyle; Mary E. T.,0,4,60,60
1650114725232,COGS 118A,A01,083075,Staff,17,0,60,43
1650114731265,CSE 3,A50,083646,Miranda; Gregory Joseph,22,0,38,16
1650114731265,CSE 3,A51,083647,Miranda; Gregory Joseph,37,0,37,0
1650114737294,CSE 8A,A50,083650,Miranda; Gregory Joseph,0,15,40,40
1650114743323,CSE 11,A01,083080,Cao; Yingjun,0,66,40,40
1650114749348,CSE 12,A01,083652,Staff,0,2,100,100
1650114755386,CSE 15L,A01,083654,Staff,0,0,50,50
1650114755386,CSE 15L,A02,083655,Staff,10,0,50,40
1650114761410,CSE 20,A01,083657,Staff,58,0,80,22
1650114767437,CSE 30,A01,083084,Eldon; John,0,63,40,40
1650114773461,CSE 100,A01,083659,Cao; Yingjun,0,61,50,50
1650114779486,CSE 134B,A01,083661,Powell; Thomas Allan,0,27,65,65
1650114785512,CSE 140,A01,083663,Staff,4,0,75,71
1650114791540,CSE 140L,A01,083088,Eldon; John,0,1,75,75
1650114797570,CSE 175,A01,083665,Kumar; Rakesh,8,0,25,17
1650114803599,CSE 190,A00,092507,Dubnov; Shlomo,14,0,20,6
1650114809625,ECE 45,A01,083139,Staff,0,13,40,40
1650114815652,ECE 65,A50,083695,Staff,0,4,30,30
1650114821683,ECE 109,A01,091882,Touri; Behrouz,48,0,70,22
1650114827708,ECE 180,A00,083140,Abi Samra; Nicholas Camill,24,0,30,6
1650114827708,ECE 180,B00,083141,Abi Samra; Nicholas Camill,8,0,30,22
1650114833742,MATH 10A,A01,083735,Patchell; Gregory David,12,0,30,18
1650114833742,MATH 10A,A02,083736,Patchell; Gregory David,28,0,30,2
1650114833742,MATH 10A,A03,083737,Patchell; Gregory David,26,0,30,4
1650114839772,MATH 10B,A01,083207,Staff,0,5,30,30
1650114839772,MATH 10B,A02,083208,Staff,0,4,30,30
1650114839772,MATH 10B,B01,083739,Staff,18,0,30,12
1650114839772,MATH 10B,B02,083740,Staff,29,0,30,1
1650114845800,MATH 18,A01,083743,Staff,10,0,30,20
1650114845800,MATH 18,A02,083744,Staff,28,0,30,2
1650114845800,MATH 18,A03,083745,Staff,23,0,30,7
1650114845800,MATH 18,A04,083746,Staff,27,0,30,3
1650114845800,MATH 18,B01,083748,Staff,0,9,30,30
1650114845800,MATH 18,B02,083749,Staff,0,7,30,30
1650114845800,MATH 18,B03,083750,Staff,0,6,30,30
1650114845800,MATH 18,B04,083751,Staff,0,6,30,30
1650114851825,MATH 20A,A01,083754,Staff,26,0,40,14
1650114857850,MATH 20B,A01,083756,Staff,0,5,30,30
1650114857850,MATH 20B,A02,083757,Staff,0,2,30,30
1650114863875,MATH 20C,A01,083760,Staff,0,11,30,30
1650114863875,MATH 20C,A02,083761,Staff,0,12,30,30
1650114863875,MATH 20C,B01,083762,Staff,14,0,30,16
1650114863875,MATH 20C,B02,083763,Staff,28,0,30,2
1650114869901,MATH 20D,A01,083765,Staff,0,2,30,30
1650114869901,MATH 20D,A02,083766,Staff,12,0,30,18
1650114869901,MATH 20D,A03,083767,Staff,28,0,30,2
1650114875933,MATH 20E,A01,083771,Staff,10,0,30,20
1650114875933,MATH 20E,A02,083772,Staff,20,0,30,10
1650114875933,MATH 20E,B01,083773,Staff,0,0,30,30
1650114875933,MATH 20E,B02,083774,Staff,13,0,30,17
1650114881967,MATH 103A,A01,083777,Staff,0,8,30,30
1650114881967,MATH 103A,A02,083778,Staff,0,7,30,30
1650114881967,MATH 103A,B01,083779,Staff,0,9,30,30
1650114881967,MATH 103A,B02,083780,Staff,0,6,30,30
1650114888085,MATH 105,A01,085443,Staff,0,13,30,30
1650114894112,MATH 109,A01,083213,Anzaldo; Leesa B,0,3,30,30
1650114894112,MATH 109,A02,083214,Anzaldo; Leesa B,0,5,30,30
1650114894112,MATH 109,B01,083215,Anzaldo; Leesa B,0,4,30,30
1650114894112,MATH 109,B02,083216,Anzaldo; Leesa B,0,4,30,30
1650114900136,MATH 142A,A01,083219,Chow; Bennett,0,10,30,30
1650114900136,MATH 142A,A02,083220,Chow; Bennett,0,10,30,30
1650114900136,MATH 142A,B01,083221,Chow; Bennett,0,10,30,30
1650114900136,MATH 142A,B02,083222,Chow; Bennett,0,9,30,30
1650114906161,MATH 193A,A01,083224,Staff,0,4,30,30
1650114906161,MATH 193A,A02,083225,Staff,0,4,30,30
1650114906161,MATH 193A,A03,083781,Staff,0,0,30,30
1650114906161,MATH 193A,A04,083782,Staff,2,0,30,28
1650114912185,MATH 197,001,091859,McAuley; Julian John,9998,0,9999,1
1650114918264,COGS 9,A01,083615,Staff,0,14,60,60
1650114924298,COGS 11,A01,083617,Boyle; Mary E. T.,24,0,40,16
1650114930324,COGS 13,A01,083071,Staff,0,28,40,40
1650114936350,COGS 14A,A01,092681,Staff,0,10,100,100
1650114942377,COGS 14B,A01,083073,Cheng; Tzu-Han,0,4,50,50
1650114948402,COGS 17,A01,092677,Staff,35,0,75,40
1650114954426,COGS 100,A01,083619,Staff,0,21,60,60
1650114960452,COGS 101A,A01,083621,Davis; Joshua Daniel,0,18,60,60
1650114966478,COGS 101B,A01,091572,Staff,10,0,60,50
1650114972504,COGS 101C,A01,083625,Delgado; Tania,22,0,30,8
1650114978531,COGS 107A,A01,083627,Boyle; Mary E. T.,0,4,60,60
1650114984562,COGS 118A,A01,083075,Staff,17,0,60,43
1650114990590,CSE 3,A50,083646,Miranda; Gregory Joseph,22,0,38,16
1650114990590,CSE 3,A51,083647,Miranda; Gregory Joseph,37,0,37,0
1650114996614,CSE 8A,A50,083650,Miranda; Gregory Joseph,0,15,40,40
1650115002641,CSE 11,A01,083080,Cao; Yingjun,0,66,40,40
1650115008667,CSE 12,A01,083652,Staff,0,2,100,100
1650115014691,CSE 15L,A01,083654,Staff,0,0,50,50
1650115014691,CSE 15L,A02,083655,Staff,10,0,50,40
1650115020717,CSE 20,A01,083657,Staff,58,0,80,22
1650115026748,CSE 30,A01,083084,Eldon; John,0,63,40,40
1650115032780,CSE 100,A01,083659,Cao; Yingjun,0,61,50,50
1650115038805,CSE 134B,A01,083661,Powell; Thomas Allan,0,27,65,65
1650115044834,CSE 140,A01,083663,Staff,4,0,75,71
1650115050864,CSE 140L,A01,083088,Eldon; John,0,1,75,75
1650115056892,CSE 175,A01,083665,Kumar; Rakesh,8,0,25,17
1650115062916,CSE 190,A00,092507,Dubnov; Shlomo,14,0,20,6
1650115068944,ECE 45,A01,083139,Staff,0,13,40,40
1650115074970,ECE 65,A50,083695,Staff,0,4,30,30
1650115081002,ECE 109,A01,091882,Touri; Behrouz,48,0,70,22
1650115087029,ECE 180,A00,083140,Abi Samra; Nicholas Camill,24,0,30,6
1650115087029,ECE 180,B00,083141,Abi Samra; Nicholas Camill,8,0,30,22
1650115093056,MATH 10A,A01,083735,Patchell; Gregory David,12,0,30,18
1650115093056,MATH 10A,A02,083736,Patchell; Gregory David,28,0,30,2
1650115093056,MATH 10A,A03,083737,Patchell; Gregory David,26,0,30,4
1650115099083,MATH 10B,A01,083207,Staff,0,5,30,30
1650115099083,MATH 10B,A02,083208,Staff,0,4,30,30
1650115099083,MATH 10B,B01,083739,Staff,18,0,30,12
1650115099083,MATH 10B,B02,083740,Staff,29,0,30,1
1650115105121,MATH 18,A01,083743,Staff,10,0,30,20
1650115105121,MATH 18,A02,083744,Staff,28,0,30,2
1650115105121,MATH 18,A03,083745,Staff,23,0,30,7
1650115105121,MATH 18,A04,083746,Staff,27,0,30,3
1650115105121,MATH 18,B01,083748,Staff,0,9,30,30
1650115105121,MATH 18,B02,083749,Staff,0,7,30,30
1650115105121,MATH 18,B03,083750,Staff,0,6,30,30
1650115105121,MATH 18,B04,083751,Staff,0,6,30,30
1650115111147,MATH 20A,A01,083754,Staff,26,0,40,14
1650115117174,MATH 20B,A01,083756,Staff,0,5,30,30
1650115117174,MATH 20B,A02,083757,Staff,0,2,30,30
1650115123205,MATH 20C,A01,083760,Staff,0,11,30,30
1650115123205,MATH 20C,A02,083761,Staff,0,12,30,30
1650115123205,MATH 20C,B01,083762,Staff,14,0,30,16
1650115123205,MATH 20C,B02,083763,Staff,28,0,30,2
1650115129230,MATH 20D,A01,083765,Staff,0,2,30,30
1650115129230,MATH 20D,A02,083766,Staff,12,0,30,18
1650115129230,MATH 20D,A03,083767,Staff,28,0,30,2
1650115135256,MATH 20E,A01,083771,Staff,10,0,30,20
1650115135256,MATH 20E,A02,083772,Staff,20,0,30,10
1650115135256,MATH 20E,B01,083773,Staff,0,0,30,30
1650115135256,MATH 20E,B02,083774,Staff,13,0,30,17
1650115141281,MATH 103A,A01,083777,Staff,0,8,30,30
1650115141281,MATH 103A,A02,083778,Staff,0,7,30,30
1650115141281,MATH 103A,B01,083779,Staff,0,9,30,30
1650115141281,MATH 103A,B02,083780,Staff,0,6,30,30
1650115147309,MATH 105,A01,085443,Staff,0,13,30,30
1650115153334,MATH 109,A01,083213,Anzaldo; Leesa B,0,3,30,30
1650115153334,MATH 109,A02,083214,Anzaldo; Leesa B,0,5,30,30
1650115153334,MATH 109,B01,083215,Anzaldo; Leesa B,0,4,30,30
1650115153334,MATH 109,B02,083216,Anzaldo; Leesa B,0,4,30,30
1650115159362,MATH 142A,A01,083219,Chow; Bennett,0,10,30,30
1650115159362,MATH 142A,A02,083220,Chow; Bennett,0,10,30,30
1650115159362,MATH 142A,B01,083221,Chow; Bennett,0,10,30,30
1650115159362,MATH 142A,B02,083222,Chow; Bennett,0,9,30,30
1650115165389,MATH 193A,A01,083224,Staff,0,4,30,30
1650115165389,MATH 193A,A02,083225,Staff,0,4,30,30
1650115165389,MATH 193A,A03,083781,Staff,0,0,30,30
1650115165389,MATH 193A,A04,083782,Staff,2,0,30,28
1650115171413,MATH 197,001,091859,McAuley; Julian John,9998,0,9999,1
1650115177475,COGS 9,A01,083615,Staff,0,14,60,60
1650115183504,COGS 11,A01,083617,Boyle; Mary E. T.,24,0,40,16
1650115189529,COGS 13,A01,083071,Staff,0,28,40,40
1650115195556,COGS 14A,A01,092681,Staff,0,10,100,100
1650115201588,COGS 14B,A01,083073,Cheng; Tzu-Han,0,4,50,50
1650115207614,COGS 17,A01,092677,Staff,35,0,75,40
1650115213643,COGS 100,A01,083619,Staff,0,21,60,60
1650115219670,COGS 101A,A01,083621,Davis; Joshua Daniel,0,18,60,60
1650115225696,COGS 101B,A01,091572,Staff,10,0,60,50
1650115231723,COGS 101C,A01,083625,Delgado; Tania,22,0,30,8
1650115237754,COGS 107A,A01,083627,Boyle; Mary E. T.,0,4,60,60
1650115243782,COGS 118A,A01,083075,Staff,17,0,60,43
1650115249817,CSE 3,A50,083646,Miranda; Gregory Joseph,22,0,38,16
1650115249817,CSE 3,A51,083647,Miranda; Gregory Joseph,37,0,37,0
1650115255843,CSE 8A,A50,083650,Miranda; Gregory Joseph,0,15,40,40
1650115261869,CSE 11,A01,083080,Cao; Yingjun,0,66,40,40
1650115267895,CSE 12,A01,083652,Staff,0,2,100,100
1650115273920,CSE 15L,A01,083654,Staff,0,0,50,50
1650115273920,CSE 15L,A02,083655,Staff,10,0,50,40
1650115279950,CSE 20,A01,083657,Staff,58,0,80,22
1650115285980,CSE 30,A01,083084,Eldon; John,0,63,40,40
1650115292004,CSE 100,A01,083659,Cao; Yingjun,0,61,50,50
1650115298030,CSE 134B,A01,083661,Powell; Thomas Allan,0,27,65,65
1650115304058,CSE 140,A01,083663,Staff,4,0,75,71
1650115310083,CSE 140L,A01,083088,Eldon; John,0,1,75,75
1650115316116,CSE 175,A01,083665,Kumar; Rakesh,8,0,25,17
1650115322144,CSE 190,A00,092507,Dubnov; Shlomo,14,0,20,6
1650115328170,ECE 45,A01,083139,Staff,0,13,40,40
1650115334197,ECE 65,A50,083695,Staff,0,4,30,30
1650115340226,ECE 109,A01,091882,Touri; Behrouz,48,0,70,22
1650115346251,ECE 180,A00,083140,Abi Samra; Nicholas Camill,24,0,30,6
1650115346251,ECE 180,B00,083141,Abi Samra; Nicholas Camill,8,0,30,22
1650115352277,MATH 10A,A01,083735,Patchell; Gregory David,12,0,30,18
1650115352277,MATH 10A,A02,083736,Patchell; Gregory David,28,0,30,2
1650115352277,MATH 10A,A03,083737,Patchell; Gregory David,26,0,30,4
1650115358307,MATH 10B,A01,083207,Staff,0,5,30,30
1650115358307,MATH 10B,A02,083208,Staff,0,4,30,30
1650115358307,MATH 10B,B01,083739,Staff,18,0,30,12
1650115358307,MATH 10B,B02,083740,Staff,29,0,30,1
1650115364334,MATH 18,A01,083743,Staff,10,0,30,20
1650115364334,MATH 18,A02,083744,Staff,28,0,30,2
1650115364334,MATH 18,A03,083745,Staff,23,0,30,7
1650115364334,MATH 18,A04,083746,Staff,27,0,30,3
1650115364334,MATH 18,B01,083748,Staff,0,9,30,30
1650115364334,MATH 18,B02,083749,Staff,0,7,30,30
1650115364334,MATH 18,B03,083750,Staff,0,6,30,30
1650115364334,MATH 18,B04,083751,Staff,0,6,30,30
1650115370360,MATH 20A,A01,083754,Staff,26,0,40,14
1650115376386,MATH 20B,A01,083756,Staff,0,5,30,30
1650115376386,MATH 20B,A02,083757,Staff,0,2,30,30
1650115382413,MATH 20C,A01,083760,Staff,0,11,30,30
1650115382413,MATH 20C,A02,083761,Staff,0,12,30,30
1650115382413,MATH 20C,B01,083762,Staff,14,0,30,16
1650115382413,MATH 20C,B02,083763,Staff,28,0,30,2
1650115388442,MATH 20D,A01,083765,Staff,0,2,30,30
1650115388442,MATH 20D,A02,083766,Staff,12,0,30,18
1650115388442,MATH 20D,A03,083767,Staff,28,0,30,2
1650115394469,MATH 20E,A01,083771,Staff,10,0,30,20
1650115394469,MATH 20E,A02,083772,Staff,20,0,30,10
1650115394469,MATH 20E,B01,083773,Staff,0,0,30,30
1650115394469,MATH 20E,B02,083774,Staff,13,0,30,17
1650115400494,MATH 103A,A01,083777,Staff,0,8,30,30
1650115400494,MATH 103A,A02,083778,Staff,0,7,30,30
1650115400494,MATH 103A,B01,083779,Staff,0,9,30,30
1650115400494,MATH 103A,B02,083780,Staff,0,6,30,30
1650115406525,MATH 105,A01,085443,Staff,0,13,30,30
1650115412550,MATH 109,A01,083213,Anzaldo; Leesa B,0,3,30,30
1650115412550,MATH 109,A02,083214,Anzaldo; Leesa B,0,5,30,30
1650115412550,MATH 109,B01,083215,Anzaldo; Leesa B,0,4,30,30
1650115412550,MATH 109,B02,083216,Anzaldo; Leesa B,0,4,30,30
1650115418583,MATH 142A,A01,083219,Chow; Bennett,0,10,30,30
1650115418583,MATH 142A,A02,083220,Chow; Bennett,0,10,30,30
1650115418583,MATH 142A,B01,083221,Chow; Bennett,0,10,30,30
1650115418583,MATH 142A,B02,083222,Chow; Bennett,0,9,30,30
1650115424617,MATH 193A,A01,083224,Staff,0,4,30,30
1650115424617,MATH 193A,A02,083225,Staff,0,4,30,30
1650115424617,MATH 193A,A03,083781,Staff,0,0,30,30
1650115424617,MATH 193A,A04,083782,Staff,2,0,30,28
1650115430643,MATH 197,001,091859,McAuley; Julian John,9998,0,9999,1
1650115436705,COGS 9,A01,083615,Staff,0,14,60,60
1650115442731,COGS 11,A01,083617,Boyle; Mary E. T.,24,0,40,16
1650115448757,COGS 13,A01,083071,Staff,0,28,40,40
1650115454782,COGS 14A,A01,092681,Staff,0,10,100,100
1650115460812,COGS 14B,A01,083073,Cheng; Tzu-Han,0,4,50,50
1650115466837,COGS 17,A01,092677,Staff,35,0,75,40
1650115472861,COGS 100,A01,083619,Staff,0,21,60,60
1650115478961,COGS 101A,A01,083621,Davis; Joshua Daniel,0,18,60,60
1650115484987,COGS 101B,A01,091572,Staff,10,0,60,50
1650115491014,COGS 101C,A01,083625,Delgado; Tania,22,0,30,8
1650115497055,COGS 107A,A01,083627,Boyle; Mary E. T.,0,4,60,60
1650115503080,COGS 118A,A01,083075,Staff,17,0,60,43
1650115509109,CSE 3,A50,083646,Miranda; Gregory Joseph,22,0,38,16
1650115509109,CSE 3,A51,083647,Miranda; Gregory Joseph,37,0,37,0
1650115515138,CSE 8A,A50,083650,Miranda; Gregory Joseph,0,15,40,40
1650115521163,CSE 11,A01,083080,Cao; Yingjun,0,66,40,40
1650115527191,CSE 12,A01,083652,Staff,0,2,100,100
1650115533217,CSE 15L,A01,083654,Staff,0,0,50,50
1650115533217,CSE 15L,A02,083655,Staff,10,0,50,40
1650115539244,CSE 20,A01,083657,Staff,58,0,80,22
1650115545272,CSE 30,A01,083084,Eldon; John,0,63,40,40
1650115551298,CSE 100,A01,083659,Cao; Yingjun,0,61,50,50
1650115557325,CSE 134B,A01,083661,Powell; Thomas Allan,0,27,65,65
1650115563349,CSE 140,A01,083663,Staff,4,0,75,71
1650115569378,CSE 140L,A01,083088,Eldon; John,0,1,75,75
1650115575405,CSE 175,A01,083665,Kumar; Rakesh,8,0,25,17
1650115581432,CSE 190,A00,092507,Dubnov; Shlomo,14,0,20,6
1650115587459,ECE 45,A01,083139,Staff,0,13,40,40
1650115593490,ECE 65,A50,083695,Staff,0,4,30,30
1650115599516,ECE 109,A01,091882,Touri; Behrouz,48,0,70,22
1650115605542,ECE 180,A00,083140,Abi Samra; Nicholas Camill,24,0,30,6
1650115605542,ECE 180,B00,083141,Abi Samra; Nicholas Camill,8,0,30,22
1650115611572,MATH 10A,A01,083735,Patchell; Gregory David,12,0,30,18
1650115611572,MATH 10A,A02,083736,Patchell; Gregory David,28,0,30,2
1650115611572,MATH 10A,A03,083737,Patchell; Gregory David,26,0,30,4
1650115617599,MATH 10B,A01,083207,Staff,0,5,30,30
1650115617599,MATH 10B,A02,083208,Staff,0,4,30,30
1650115617599,MATH 10B,B01,083739,Staff,18,0,30,12
1650115617599,MATH 10B,B02,083740,Staff,29,0,30,1
1650115623641,MATH 18,A01,083743,Staff,10,0,30,20
1650115623641,MATH 18,A02,083744,Staff,28,0,30,2
1650115623641,MATH 18,A03,083745,Staff,23,0,30,7
1650115623641,MATH 18,A04,083746,Staff,27,0,30,3
1650115623641,MATH 18,B01,083748,Staff,0,9,30,30
1650115623641,MATH 18,B02,083749,Staff,0,7,30,30
1650115623641,MATH 18,B03,083750,Staff,0,6,30,30
1650115623641,MATH 18,B04,083751,Staff,0,6,30,30
1650115629678,MATH 20A,A01,083754,Staff,26,0,40,14
1650115635706,MATH 20B,A01,083756,Staff,0,5,30,30
1650115635706,MATH 20B,A02,083757,Staff,0,2,30,30
1650115641737,MATH 20C,A01,083760,Staff,0,11,30,30
1650115641737,MATH 20C,A02,083761,Staff,0,12,30,30
1650115641737,MATH 20C,B01,083762,Staff,14,0,30,16
1650115641737,MATH 20C,B02,083763,Staff,28,0,30,2
1650115647766,MATH 20D,A01,083765,Staff,0,2,30,30
1650115647766,MATH 20D,A02,083766,Staff,12,0,30,18
1650115647766,MATH 20D,A03,083767,Staff,28,0,30,2
1650115653800,MATH 20E,A01,083771,Staff,10,0,30,20
1650115653800,MATH 20E,A02,083772,Staff,20,0,30,10
1650115653800,MATH 20E,B01,083773,Staff,0,0,30,30
1650115653800,MATH 20E,B02,083774,Staff,13,0,30,17
1650115659833,MATH 103A,A01,083777,Staff,0,8,30,30
1650115659833,MATH 103A,A02,083778,Staff,0,7,30,30
1650115659833,MATH 103A,B01,083779,Staff,0,9,30,30
1650115659833,MATH 103A,B02,083780,Staff,0,6,30,30
1650115665863,MATH 105,A01,085443,Staff,0,13,30,30
1650115671892,MATH 109,A01,083213,Anzaldo; Leesa B,0,3,30,30
1650115671892,MATH 109,A02,083214,Anzaldo; Leesa B,0,5,30,30
1650115671892,MATH 109,B01,083215,Anzaldo; Leesa B,0,4,30,30
1650115671892,MATH 109,B02,083216,Anzaldo; Leesa B,0,4,30,30
1650115677918,MATH 142A,A01,083219,Chow; Bennett,0,10,30,30
1650115677918,MATH 142A,A02,083220,Chow; Bennett,0,10,30,30
1650115677918,MATH 142A,B01,083221,Chow; Bennett,0,10,30,30
1650115677918,MATH 142A,B02,083222,Chow; Bennett,0,9,30,30
1650115683954,MATH 193A,A01,083224,Staff,0,4,30,30
1650115683954,MATH 193A,A02,083225,Staff,0,4,30,30
1650115683954,MATH 193A,A03,083781,Staff,0,0,30,30
1650115683954,MATH 193A,A04,083782,Staff,2,0,30,28
1650115689982,MATH 197,001,091859,McAuley; Julian John,9998,0,9999,1
1650115696042,COGS 9,A01,083615,Staff,0,14,60,60
1650115702073,COGS 11,A01,083617,Boyle; Mary E. T.,24,0,40,16
1650115708099,COGS 13,A01,083071,Staff,0,28,40,40
1650115714137,COGS 14A,A01,092681,Staff,0,10,100,100
1650115720161,COGS 14B,A01,083073,Cheng; Tzu-Han,0,4,50,50
1650115726188,COGS 17,A01,092677,Staff,35,0,75,40
1650115732214,COGS 100,A01,083619,Staff,0,21,60,60
1650115738401,COGS 101A,A01,083621,Davis; Joshua Daniel,0,18,60,60
1650115744431,COGS 101B,A01,091572,Staff,10,0,60,50
1650115750459,COGS 101C,A01,083625,Delgado; Tania,22,0,30,8
1650115756487,COGS 107A,A01,083627,Boyle; Mary E. T.,0,4,60,60
1650115762515,COGS 118A,A01,083075,Staff,17,0,60,43
1650115768541,CSE 3,A50,083646,Miranda; Gregory Joseph,22,0,38,16
1650115768541,CSE 3,A51,083647,Miranda; Gregory Joseph,37,0,37,0
1650115774567,CSE 8A,A50,083650,Miranda; Gregory Joseph,0,15,40,40
1650115780593,CSE 11,A01,083080,Cao; Yingjun,0,66,40,40
1650115786619,CSE 12,A01,083652,Staff,0,2,100,100
1650115792645,CSE 15L,A01,083654,Staff,0,0,50,50
1650115792645,CSE 15L,A02,083655,Staff,10,0,50,40
1650115798675,CSE 20,A01,083657,Staff,58,0,80,22
1650115804706,CSE 30,A01,083084,Eldon; John,0,63,40,40
1650115810738,CSE 100,A01,083659,Cao; Yingjun,0,61,50,50
1650115816771,CSE 134B,A01,083661,Powell; Thomas Allan,0,27,65,65
1650115822796,CSE 140,A01,083663,Staff,4,0,75,71
1650115828821,CSE 140L,A01,083088,Eldon; John,0,1,75,75
1650115834848,CSE 175,A01,083665,Kumar; Rakesh,8,0,25,17
1650115840877,CSE 190,A00,092507,Dubnov; Shlomo,14,0,20,6
1650115846902,ECE 45,A01,083139,Staff,0,13,40,40
1650115852934,ECE 65,A50,083695,Staff,0,4,30,30
1650115858967,ECE 109,A01,091882,Touri; Behrouz,48,0,70,22
1650115864995,ECE 180,A00,083140,Abi Samra; Nicholas Camill,24,0,30,6
1650115864995,ECE 180,B00,083141,Abi Samra; Nicholas Camill,8,0,30,22
1650115871020,MATH 10A,A01,083735,Patchell; Gregory David,12,0,30,18
1650115871020,MATH 10A,A02,083736,Patchell; Gregory David,28,0,30,2
1650115871020,MATH 10A,A03,083737,Patchell; Gregory David,26,0,30,4
1650115877047,MATH 10B,A01,083207,Staff,0,5,30,30
1650115877047,MATH 10B,A02,083208,Staff,0,4,30,30
1650115877047,MATH 10B,B01,083739,Staff,18,0,30,12
1650115877047,MATH 10B,B02,083740,Staff,29,0,30,1
1650115883076,MATH 18,A01,083743,Staff,10,0,30,20
1650115883076,MATH 18,A02,083744,Staff,28,0,30,2
1650115883076,MATH 18,A03,083745,Staff,23,0,30,7
1650115883076,MATH 18,A04,083746,Staff,27,0,30,3
1650115883076,MATH 18,B01,083748,Staff,0,9,30,30
1650115883076,MATH 18,B02,083749,Staff,0,7,30,30
1650115883076,MATH 18,B03,083750,Staff,0,6,30,30
1650115883076,MATH 18,B04,083751,Staff,0,6,30,30
1650115889114,MATH 20A,A01,083754,Staff,26,0,40,14
1650115895145,MATH 20B,A01,083756,Staff,0,5,30,30
1650115895145,MATH 20B,A02,083757,Staff,0,2,30,30
1650115901173,MATH 20C,A01,083760,Staff,0,11,30,30
1650115901173,MATH 20C,A02,083761,Staff,0,12,30,30
1650115901173,MATH 20C,B01,083762,Staff,14,0,30,16
1650115901173,MATH 20C,B02,083763,Staff,28,0,30,2
1650115907202,MATH 20D,A01,083765,Staff,0,2,30,30
1650115907202,MATH 20D,A02,083766,Staff,12,0,30,18
1650115907202,MATH 20D,A03,083767,Staff,28,0,30,2
1650115913227,MATH 20E,A01,083771,Staff,10,0,30,20
1650115913227,MATH 20E,A02,083772,Staff,20,0,30,10
1650115913227,MATH 20E,B01,083773,Staff,0,0,30,30
1650115913227,MATH 20E,B02,083774,Staff,13,0,30,17
1650115919266,MATH 103A,A01,083777,Staff,0,8,30,30
1650115919266,MATH 103A,A02,083778,Staff,0,7,30,30
1650115919266,MATH 103A,B01,083779,Staff,0,9,30,30
1650115919266,MATH 103A,B02,083780,Staff,0,6,30,30
1650115925304,MATH 105,A01,085443,Staff,0,13,30,30
1650115931329,MATH 109,A01,083213,Anzaldo; Leesa B,0,3,30,30
1650115931329,MATH 109,A02,083214,Anzaldo; Leesa B,0,5,30,30
1650115931329,MATH 109,B01,083215,Anzaldo; Leesa B,0,4,30,30
1650115931329,MATH 109,B02,083216,Anzaldo; Leesa B,0,4,30,30
1650115937353,MATH 142A,A01,083219,Chow; Bennett,0,10,30,30
1650115937353,MATH 142A,A02,083220,Chow; Bennett,0,10,30,30
1650115937353,MATH 142A,B01,083221,Chow; Bennett,0,10,30,30
1650115937353,MATH 142A,B02,083222,Chow; Bennett,0,9,30,30
1650115943379,MATH 193A,A01,083224,Staff,0,4,30,30
1650115943379,MATH 193A,A02,083225,Staff,0,4,30,30
1650115943379,MATH 193A,A03,083781,Staff,0,0,30,30
1650115943379,MATH 193A,A04,083782,Staff,2,0,30,28
1650115949406,MATH 197,001,091859,McAuley; Julian John,9998,0,9999,1
1650115955466,COGS 9,A01,083615,Staff,0,14,60,60
1650115961496,COGS 11,A01,083617,Boyle; Mary E. T.,24,0,40,16
1650115967521,COGS 13,A01,083071,Staff,0,28,40,40
1650115973545,COGS 14A,A01,092681,Staff,0,10,100,100
1650115979575,COGS 14B,A01,083073,Cheng; Tzu-Han,0,4,50,50
1650115985598,COGS 17,A01,092677,Staff,35,0,75,40
1650115991623,COGS 100,A01,083619,Staff,0,21,60,60
1650115997653,COGS 101A,A01,083621,Davis; Joshua Daniel,0,18,60,60
1650116003678,COGS 101B,A01,091572,Staff,10,0,60,50
1650116009705,COGS 101C,A01,083625,Delgado; Tania,22,0,30,8
1650116015730,COGS 107A,A01,083627,Boyle; Mary E. T.,0,4,60,60
1650116021759,COGS 118A,A01,083075,Staff,17,0,60,43
1650116027785,CSE 3,A50,083646,Miranda; Gregory Joseph,22,0,38,16
1650116027785,CSE 3,A51,083647,Miranda; Gregory Joseph,37,0,37,0
1650116033814,CSE 8A,A50,083650,Miranda; Gregory Joseph,0,15,40,40
1650116039839,CSE 11,A01,083080,Cao; Yingjun,0,66,40,40
1650116045866,CSE 12,A01,083652,Staff,0,2,100,100
1650116051890,CSE 15L,A01,083654,Staff,0,0,50,50
1650116051890,CSE 15L,A02,083655,Staff,10,0,50,40
1650116057920,CSE 20,A01,083657,Staff,58,0,80,22
1650116063950,CSE 30,A01,083084,Eldon; John,0,63,40,40
1650116069976,CSE 100,A01,083659,Cao; Yingjun,0,61,50,50
1650116076088,CSE 134B,A01,083661,Powell; Thomas Allan,0,27,65,65
1650116082116,CSE 140,A01,083663,Staff,4,0,75,71
1650116088141,CSE 140L,A01,083088,Eldon; John,0,1,75,75
1650116094168,CSE 175,A01,083665,Kumar; Rakesh,8,0,25,17
1650116100198,CSE 190,A00,092507,Dubnov; Shlomo,14,0,20,6
1650116106227,ECE 45,A01,083139,Staff,0,13,40,40
1650116112258,ECE 65,A50,083695,Staff,0,4,30,30
1650116118284,ECE 109,A01,091882,Touri; Behrouz,48,0,70,22
1650116124318,ECE 180,A00,083140,Abi Samra; Nicholas Camill,24,0,30,6
1650116124318,ECE 180,B00,083141,Abi Samra; Nicholas Camill,8,0,30,22
1650116130345,MATH 10A,A01,083735,Patchell; Gregory David,12,0,30,18
1650116130345,MATH 10A,A02,083736,Patchell; Gregory David,28,0,30,2
1650116130345,MATH 10A,A03,083737,Patchell; Gregory David,26,0,30,4
1650116136371,MATH 10B,A01,083207,Staff,0,5,30,30
1650116136371,MATH 10B,A02,083208,Staff,0,4,30,30
1650116136371,MATH 10B,B01,083739,Staff,18,0,30,12
1650116136371,MATH 10B,B02,083740,Staff,29,0,30,1
1650116142419,MATH 18,A01,083743,Staff,10,0,30,20
1650116142419,MATH 18,A02,083744,Staff,28,0,30,2
1650116142419,MATH 18,A03,083745,Staff,23,0,30,7
1650116142419,MATH 18,A04,083746,Staff,27,0,30,3
1650116142419,MATH 18,B01,083748,Staff,0,9,30,30
1650116142419,MATH 18,B02,083749,Staff,0,7,30,30
1650116142419,MATH 18,B03,083750,Staff,0,6,30,30
1650116142419,MATH 18,B04,083751,Staff,0,6,30,30
1650116148444,MATH 20A,A01,083754,Staff,26,0,40,14
1650116154470,MATH 20B,A01,083756,Staff,0,5,30,30
1650116154470,MATH 20B,A02,083757,Staff,0,2,30,30
1650116160495,MATH 20C,A01,083760,Staff,0,11,30,30
1650116160495,MATH 20C,A02,083761,Staff,0,12,30,30
1650116160495,MATH 20C,B01,083762,Staff,14,0,30,16
1650116160495,MATH 20C,B02,083763,Staff,28,0,30,2
1650116166527,MATH 20D,A01,083765,Staff,0,2,30,30
1650116166527,MATH 20D,A02,083766,Staff,12,0,30,18
1650116166527,MATH 20D,A03,083767,Staff,28,0,30,2
1650116172558,MATH 20E,A01,083771,Staff,10,0,30,20
1650116172558,MATH 20E,A02,083772,Staff,20,0,30,10
1650116172558,MATH 20E,B01,083773,Staff,0,0,30,30
1650116172558,MATH 20E,B02,083774,Staff,13,0,30,17
1650116178587,MATH 103A,A01,083777,Staff,0,8,30,30
1650116178587,MATH 103A,A02,083778,Staff,0,7,30,30
1650116178587,MATH 103A,B01,083779,Staff,0,9,30,30
1650116178587,MATH 103A,B02,083780,Staff,0,6,30,30
1650116184617,MATH 105,A01,085443,Staff,0,13,30,30
1650116190641,MATH 109,A01,083213,Anzaldo; Leesa B,0,3,30,30
1650116190641,MATH 109,A02,083214,Anzaldo; Leesa B,0,5,30,30
1650116190641,MATH 109,B01,083215,Anzaldo; Leesa B,0,4,30,30
1650116190641,MATH 109,B02,083216,Anzaldo; Leesa B,0,4,30,30
1650116196670,MATH 142A,A01,083219,Chow; Bennett,0,10,30,30
1650116196670,MATH 142A,A02,083220,Chow; Bennett,0,10,30,30
1650116196670,MATH 142A,B01,083221,Chow; Bennett,0,10,30,30
1650116196670,MATH 142A,B02,083222,Chow; Bennett,0,9,30,30
1650116202697,MATH 193A,A01,083224,Staff,0,4,30,30
1650116202697,MATH 193A,A02,083225,Staff,0,4,30,30
1650116202697,MATH 193A,A03,083781,Staff,0,0,30,30
1650116202697,MATH 193A,A04,083782,Staff,2,0,30,28
1650116208723,MATH 197,001,091859,McAuley; Julian John,9998,0,9999,1
1650116214801,COGS 9,A01,083615,Staff,0,14,60,60
1650116220828,COGS 11,A01,083617,Boyle; Mary E. T.,24,0,40,16
1650116226859,COGS 13,A01,083071,Staff,0,28,40,40
1650116232887,COGS 14A,A01,092681,Staff,0,10,100,100
1650116238917,COGS 14B,A01,083073,Cheng; Tzu-Han,0,4,50,50
1650116244943,COGS 17,A01,092677,Staff,35,0,75,40
1650116250969,COGS 100,A01,083619,Staff,0,21,60,60
1650116256994,COGS 101A,A01,083621,Davis; Joshua Daniel,0,18,60,60
1650116263020,COGS 101B,A01,091572,Staff,10,0,60,50
1650116269051,COGS 101C,A01,083625,Delgado; Tania,22,0,30,8
1650116275079,COGS 107A,A01,083627,Boyle; Mary E. T.,0,4,60,60
1650116281103,COGS 118A,A01,083075,Staff,17,0,60,43
1650116287131,CSE 3,A50,083646,Miranda; Gregory Joseph,22,0,38,16
1650116287131,CSE 3,A51,083647,Miranda; Gregory Joseph,37,0,37,0
1650116293157,CSE 8A,A50,083650,Miranda; Gregory Joseph,0,15,40,40
1650116299188,CSE 11,A01,083080,Cao; Yingjun,0,66,40,40
1650116305219,CSE 12,A01,083652,Staff,0,2,100,100
1650116311245,CSE 15L,A01,083654,Staff,0,0,50,50
1650116311245,CSE 15L,A02,083655,Staff,10,0,50,40
1650116317270,CSE 20,A01,083657,Staff,58,0,80,22
1650116323302,CSE 30,A01,083084,Eldon; John,0,63,40,40
1650116329329,CSE 100,A01,083659,Cao; Yingjun,0,61,50,50
1650116335355,CSE 134B,A01,083661,Powell; Thomas Allan,0,27,65,65
1650116341396,CSE 140,A01,083663,Staff,4,0,75,71
1650116347420,CSE 140L,A01,083088,Eldon; John,0,1,75,75
1650116353449,CSE 175,A01,083665,Kumar; Rakesh,8,0,25,17
1650116359480,CSE 190,A00,092507,Dubnov; Shlomo,14,0,20,6
1650116365509,ECE 45,A01,083139,Staff,0,13,40,40
1650116371535,ECE 65,A50,083695,Staff,0,4,30,30
1650116377577,ECE 109,A01,091882,Touri; Behrouz,48,0,70,22
1650116383608,ECE 180,A00,083140,Abi Samra; Nicholas Camill,24,0,30,6
1650116383608,ECE 180,B00,083141,Abi Samra; Nicholas Camill,8,0,30,22
1650116389635,MATH 10A,A01,083735,Patchell; Gregory David,12,0,30,18
1650116389635,MATH 10A,A02,083736,Patchell; Gregory David,28,0,30,2
1650116389635,MATH 10A,A03,083737,Patchell; Gregory David,26,0,30,4
1650116395673,MATH 10B,A01,083207,Staff,0,5,30,30
1650116395673,MATH 10B,A02,083208,Staff,0,4,30,30
1650116395673,MATH 10B,B01,083739,Staff,18,0,30,12
1650116395673,MATH 10B,B02,083740,Staff,29,0,30,1
1650116401700,MATH 18,A01,083743,Staff,10,0,30,20
1650116401700,MATH 18,A02,083744,Staff,28,0,30,2
1650116401700,MATH 18,A03,083745,Staff,23,0,30,7
1650116401700,MATH 18,A04,083746,Staff,27,0,30,3
1650116401700,MATH 18,B01,083748,Staff,0,9,30,30
1650116401700,MATH 18,B02,083749,Staff,0,7,30,30
1650116401700,MATH 18,B03,083750,Staff,0,6,30,30
1650116401700,MATH 18,B04,083751,Staff,0,6,30,30
1650116407725,MATH 20A,A01,083754,Staff,26,0,40,14
1650116413749,MATH 20B,A01,083756,Staff,0,5,30,30
1650116413749,MATH 20B,A02,083757,Staff,0,2,30,30
1650116419775,MATH 20C,A01,083760,Staff,0,11,30,30
1650116419775,MATH 20C,A02,083761,Staff,0,12,30,30
1650116419775,MATH 20C,B01,083762,Staff,14,0,30,16
1650116419775,MATH 20C,B02,083763,Staff,28,0,30,2
1650116425810,MATH 20D,A01,083765,Staff,0,2,30,30
1650116425810,MATH 20D,A02,083766,Staff,12,0,30,18
1650116425810,MATH 20D,A03,083767,Staff,28,0,30,2
1650116431841,MATH 20E,A01,083771,Staff,10,0,30,20
1650116431841,MATH 20E,A02,083772,Staff,20,0,30,10
1650116431841,MATH 20E,B01,083773,Staff,0,0,30,30
1650116431841,MATH 20E,B02,083774,Staff,13,0,30,17
1650116437869,MATH 103A,A01,083777,Staff,0,8,30,30
1650116437869,MATH 103A,A02,083778,Staff,0,7,30,30
1650116437869,MATH 103A,B01,083779,Staff,0,9,30,30
1650116437869,MATH 103A,B02,083780,Staff,0,6,30,30
1650116443895,MATH 105,A01,085443,Staff,0,13,30,30
1650116449937,MATH 109,A01,083213,Anzaldo; Leesa B,0,3,30,30
1650116449937,MATH 109,A02,083214,Anzaldo; Leesa B,0,5,30,30
1650116449937,MATH 109,B01,083215,Anzaldo; Leesa B,0,4,30,30
1650116449937,MATH 109,B02,083216,Anzaldo; Leesa B,0,4,30,30
1650116455965,MATH 142A,A01,083219,Chow; Bennett,0,10,30,30
1650116455965,MATH 142A,A02,083220,Chow; Bennett,0,10,30,30
1650116455965,MATH 142A,B01,083221,Chow; Bennett,0,10,30,30
1650116455965,MATH 142A,B02,083222,Chow; Bennett,0,9,30,30
1650116461998,MATH 193A,A01,083224,Staff,0,4,30,30
1650116461998,MATH 193A,A02,083225,Staff,0,4,30,30
1650116461998,MATH 193A,A03,083781,Staff,0,0,30,30
1650116461998,MATH 193A,A04,083782,Staff,2,0,30,28
1650116468025,MATH 197,001,091859,McAuley; Julian John,9998,0,9999,1
1650116474116,COGS 9,A01,083615,Staff,0,14,60,60
1650116480146,COGS 11,A01,083617,Boyle; Mary E. T.,24,0,40,16
1650116486175,COGS 13,A01,083071,Staff,0,28,40,40
1650116492206,COGS 14A,A01,092681,Staff,0,10,100,100
1650116498238,COGS 14B,A01,083073,Cheng; Tzu-Han,0,4,50,50
1650116504262,COGS 17,A01,092677,Staff,35,0,75,40
1650116510293,COGS 100,A01,083619,Staff,0,21,60,60
1650116516318,COGS 101A,A01,083621,Davis; Joshua Daniel,0,18,60,60
1650116522343,COGS 101B,A01,091572,Staff,10,0,60,50
1650116528378,COGS 101C,A01,083625,Delgado; Tania,22,0,30,8
1650116534404,COGS 107A,A01,083627,Boyle; Mary E. T.,0,4,60,60
1650116540435,COGS 118A,A01,083075,Staff,17,0,60,43
1650116546470,CSE 3,A50,083646,Miranda; Gregory Joseph,22,0,38,16
1650116546470,CSE 3,A51,083647,Miranda; Gregory Joseph,37,0,37,0
1650116552495,CSE 8A,A50,083650,Miranda; Gregory Joseph,0,15,40,40
1650116558530,CSE 11,A01,083080,Cao; Yingjun,0,66,40,40
1650116564555,CSE 12,A01,083652,Staff,0,2,100,100
1650116570590,CSE 15L,A01,083654,Staff,0,0,50,50
1650116570590,CSE 15L,A02,083655,Staff,10,0,50,40
1650116576615,CSE 20,A01,083657,Staff,58,0,80,22
1650116582638,CSE 30,A01,083084,Eldon; John,0,63,40,40
1650116588663,CSE 100,A01,083659,Cao; Yingjun,0,61,50,50
1650116594693,CSE 134B,A01,083661,Powell; Thomas Allan,0,27,65,65
1650116600722,CSE 140,A01,083663,Staff,4,0,75,71
1650116606751,CSE 140L,A01,083088,Eldon; John,0,1,75,75
1650116612777,CSE 175,A01,083665,Kumar; Rakesh,8,0,25,17
1650116618805,CSE 190,A00,092507,Dubnov; Shlomo,14,0,20,6
1650116624836,ECE 45,A01,083139,Staff,0,13,40,40
1650116630862,ECE 65,A50,083695,Staff,0,4,30,30
1650116636893,ECE 109,A01,091882,Touri; Behrouz,48,0,70,22
1650116642926,ECE 180,A00,083140,Abi Samra; Nicholas Camill,24,0,30,6
1650116642926,ECE 180,B00,083141,Abi Samra; Nicholas Camill,8,0,30,22
1650116648953,MATH 10A,A01,083735,Patchell; Gregory David,12,0,30,18
1650116648953,MATH 10A,A02,083736,Patchell; Gregory David,28,0,30,2
1650116648953,MATH 10A,A03,083737,Patchell; Gregory David,26,0,30,4
1650116654979,MATH 10B,A01,083207,Staff,0,5,30,30
1650116654979,MATH 10B,A02,083208,Staff,0,4,30,30
1650116654979,MATH 10B,B01,083739,Staff,18,0,30,12
1650116654979,MATH 10B,B02,083740,Staff,29,0,30,1
1650116661012,MATH 18,A01,083743,Staff,10,0,30,20
1650116661012,MATH 18,A02,083744,Staff,28,0,30,2
1650116661012,MATH 18,A03,083745,Staff,23,0,30,7
1650116661012,MATH 18,A04,083746,Staff,27,0,30,3
1650116661012,MATH 18,B01,083748,Staff,0,9,30,30
1650116661012,MATH 18,B02,083749,Staff,0,7,30,30
1650116661012,MATH 18,B03,083750,Staff,0,6,30,30
1650116661012,MATH 18,B04,083751,Staff,0,6,30,30
1650116667037,MATH 20A,A01,083754,Staff,26,0,40,14
1650116673156,MATH 20B,A01,083756,Staff,0,5,30,30
1650116673156,MATH 20B,A02,083757,Staff,0,2,30,30
1650116679187,MATH 20C,A01,083760,Staff,0,11,30,30
1650116679187,MATH 20C,A02,083761,Staff,0,12,30,30
1650116679187,MATH 20C,B01,083762,Staff,14,0,30,16
1650116679187,MATH 20C,B02,083763,Staff,28,0,30,2
1650116685214,MATH 20D,A01,083765,Staff,0,2,30,30
1650116685214,MATH 20D,A02,083766,Staff,12,0,30,18
1650116685214,MATH 20D,A03,083767,Staff,28,0,30,2
1650116691242,MATH 20E,A01,083771,Staff,10,0,30,20
1650116691242,MATH 20E,A02,083772,Staff,20,0,30,10
1650116691242,MATH 20E,B01,083773,Staff,0,0,30,30
1650116691242,MATH 20E,B02,083774,Staff,13,0,30,17
1650116697275,MATH 103A,A01,083777,Staff,0,8,30,30
1650116697275,MATH 103A,A02,083778,Staff,0,7,30,30
1650116697275,MATH 103A,B01,083779,Staff,0,9,30,30
1650116697275,MATH 103A,B02,083780,Staff,0,6,30,30
1650116703306,MATH 105,A01,085443,Staff,0,13,30,30
1650116709333,MATH 109,A01,083213,Anzaldo; Leesa B,0,3,30,30
1650116709333,MATH 109,A02,083214,Anzaldo; Leesa B,0,5,30,30
1650116709333,MATH 109,B01,083215,Anzaldo; Leesa B,0,4,30,30
1650116709333,MATH 109,B02,083216,Anzaldo; Leesa B,0,4,30,30
1650116715361,MATH 142A,A01,083219,Chow; Bennett,0,10,30,30
1650116715361,MATH 142A,A02,083220,Chow; Bennett,0,10,30,30
1650116715361,MATH 142A,B01,083221,Chow; Bennett,0,10,30,30
1650116715361,MATH 142A,B02,083222,Chow; Bennett,0,9,30,30
1650116721388,MATH 193A,A01,083224,Staff,0,4,30,30
1650116721388,MATH 193A,A02,083225,Staff,0,4,30,30
1650116721388,MATH 193A,A03,083781,Staff,0,0,30,30
1650116721388,MATH 193A,A04,083782,Staff,2,0,30,28
1650116727417,MATH 197,001,091859,McAuley; Julian John,9998,0,9999,1
1650116733492,COGS 9,A01,083615,Staff,0,14,60,60
1650116739520,COGS 11,A01,083617,Boyle; Mary E. T.,24,0,40,16
1650116745550,COGS 13,A01,083071,Staff,0,28,40,40
1650116751576,COGS 14A,A01,092681,Staff,0,10,100,100
1650116757607,COGS 14B,A01,083073,Cheng; Tzu-Han,0,4,50,50
1650116763646,COGS 17,A01,092677,Staff,35,0,75,40
1650116769671,COGS 100,A01,083619,Staff,0,21,60,60
1650116775696,COGS 101A,A01,083621,Davis; Joshua Daniel,0,18,60,60
1650116781729,COGS 101B,A01,091572,Staff,10,0,60,50
1650116787757,COGS 101C,A01,083625,Delgado; Tania,22,0,30,8
1650116793789,COGS 107A,A01,083627,Boyle; Mary E. T.,0,4,60,60
1650116799819,COGS 118A,A01,083075,Staff,17,0,60,43
1650116805845,CSE 3,A50,083646,Miranda; Gregory Joseph,22,0,38,16
1650116805845,CSE 3,A51,083647,Miranda; Gregory Joseph,37,0,37,0
1650116811871,CSE 8A,A50,083650,Miranda; Gregory Joseph,0,15,40,40
1650116817902,CSE 11,A01,083080,Cao; Yingjun,0,66,40,40
1650116823928,CSE 12,A01,083652,Staff,0,2,100,100
1650116829957,CSE 15L,A01,083654,Staff,0,0,50,50
1650116829957,CSE 15L,A02,083655,Staff,10,0,50,40
1650116835986,CSE 20,A01,083657,Staff,58,0,80,22
1650116842011,CSE 30,A01,083084,Eldon; John,0,63,40,40
1650116848043,CSE 100,A01,083659,Cao; Yingjun,0,61,50,50
1650116854069,CSE 134B,A01,083661,Powell; Thomas Allan,0,27,65,65
1650116860103,CSE 140,A01,083663,Staff,4,0,75,71
1650116866128,CSE 140L,A01,083088,Eldon; John,0,1,75,75
1650116872156,CSE 175,A01,083665,Kumar; Rakesh,8,0,25,17
1650116878185,CSE 190,A00,092507,Dubnov; Shlomo,14,0,20,6
1650116884212,ECE 45,A01,083139,Staff,0,13,40,40
1650116890243,ECE 65,A50,083695,Staff,0,4,30,30
1650116896269,ECE 109,A01,091882,Touri; Behrouz,48,0,70,22
1650116902295,ECE 180,A00,083140,Abi Samra; Nicholas Camill,24,0,30,6
1650116902295,ECE 180,B00,083141,Abi Samra; Nicholas Camill,8,0,30,22
1650116908325,MATH 10A,A01,083735,Patchell; Gregory David,12,0,30,18
1650116908325,MATH 10A,A02,083736,Patchell; Gregory David,28,0,30,2
1650116908325,MATH 10A,A03,083737,Patchell; Gregory David,26,0,30,4
1650116914350,MATH 10B,A01,083207,Staff,0,5,30,30
1650116914350,MATH 10B,A02,083208,Staff,0,4,30,30
1650116914350,MATH 10B,B01,083739,Staff,18,0,30,12
1650116914350,MATH 10B,B02,083740,Staff,29,0,30,1
1650116920384,MATH 18,A01,083743,Staff,10,0,30,20
1650116920384,MATH 18,A02,083744,Staff,28,0,30,2
1650116920384,MATH 18,A03,083745,Staff,23,0,30,7
1650116920384,MATH 18,A04,083746,Staff,27,0,30,3
1650116920384,MATH 18,B01,083748,Staff,0,9,30,30
1650116920384,MATH 18,B02,083749,Staff,0,7,30,30
1650116920384,MATH 18,B03,083750,Staff,0,6,30,30
1650116920384,MATH 18,B04,083751,Staff,0,6,30,30
1650116926409,MATH 20A,A01,083754,Staff,26,0,40,14
1650116932439,MATH 20B,A01,083756,Staff,0,5,30,30
1650116932439,MATH 20B,A02,083757,Staff,0,2,30,30
1650116938464,MATH 20C,A01,083760,Staff,0,11,30,30
1650116938464,MATH 20C,A02,083761,Staff,0,12,30,30
1650116938464,MATH 20C,B01,083762,Staff,14,0,30,16
1650116938464,MATH 20C,B02,083763,Staff,28,0,30,2
1650116944496,MATH 20D,A01,083765,Staff,0,2,30,30
1650116944496,MATH 20D,A02,083766,Staff,12,0,30,18
1650116944496,MATH 20D,A03,083767,Staff,28,0,30,2
1650116950527,MATH 20E,A01,083771,Staff,10,0,30,20
1650116950527,MATH 20E,A02,083772,Staff,20,0,30,10
1650116950527,MATH 20E,B01,083773,Staff,0,0,30,30
1650116950527,MATH 20E,B02,083774,Staff,13,0,30,17
1650116956559,MATH 103A,A01,083777,Staff,0,8,30,30
1650116956559,MATH 103A,A02,083778,Staff,0,7,30,30
1650116956559,MATH 103A,B01,083779,Staff,0,9,30,30
1650116956559,MATH 103A,B02,083780,Staff,0,6,30,30
1650116962584,MATH 105,A01,085443,Staff,0,13,30,30
1650116968616,MATH 109,A01,083213,Anzaldo; Leesa B,0,3,30,30
1650116968616,MATH 109,A02,083214,Anzaldo; Leesa B,0,5,30,30
1650116968616,MATH 109,B01,083215,Anzaldo; Leesa B,0,4,30,30
1650116968616,MATH 109,B02,083216,Anzaldo; Leesa B,0,4,30,30
1650116974648,MATH 142A,A01,083219,Chow; Bennett,0,10,30,30
1650116974648,MATH 142A,A02,083220,Chow; Bennett,0,10,30,30
1650116974648,MATH 142A,B01,083221,Chow; Bennett,0,10,30,30
1650116974648,MATH 142A,B02,083222,Chow; Bennett,0,9,30,30
1650116980684,MATH 193A,A01,083224,Staff,0,4,30,30
1650116980684,MATH 193A,A02,083225,Staff,0,4,30,30
1650116980684,MATH 193A,A03,083781,Staff,0,0,30,30
1650116980684,MATH 193A,A04,083782,Staff,2,0,30,28
1650116986719,MATH 197,001,091859,McAuley; Julian John,9998,0,9999,1
1650116992778,COGS 9,A01,083615,Staff,0,14,60,60
1650116998809,COGS 11,A01,083617,Boyle; Mary E. T.,24,0,40,16
1650117004835,COGS 13,A01,083071,Staff,0,28,40,40
1650117010860,COGS 14A,A01,092681,Staff,0,10,100,100
1650117016886,COGS 14B,A01,083073,Cheng; Tzu-Han,0,4,50,50
1650117022916,COGS 17,A01,092677,Staff,35,0,75,40
1650117028949,COGS 100,A01,083619,Staff,0,21,60,60
1650117034981,COGS 101A,A01,083621,Davis; Joshua Daniel,0,18,60,60
1650117041007,COGS 101B,A01,091572,Staff,10,0,60,50
1650117047034,COGS 101C,A01,083625,Delgado; Tania,22,0,30,8
1650117053068,COGS 107A,A01,083627,Boyle; Mary E. T.,0,4,60,60
1650117059093,COGS 118A,A01,083075,Staff,17,0,60,43
1650117065121,CSE 3,A50,083646,Miranda; Gregory Joseph,22,0,38,16
1650117065121,CSE 3,A51,083647,Miranda; Gregory Joseph,37,0,37,0
1650117071148,CSE 8A,A50,083650,Miranda; Gregory Joseph,0,15,40,40
1650117077172,CSE 11,A01,083080,Cao; Yingjun,0,66,40,40
1650117083198,CSE 12,A01,083652,Staff,0,2,100,100
1650117089239,CSE 15L,A01,083654,Staff,0,0,50,50
1650117089239,CSE 15L,A02,083655,Staff,10,0,50,40
1650117095266,CSE 20,A01,083657,Staff,58,0,80,22
1650117101297,CSE 30,A01,083084,Eldon; John,0,63,40,40
1650117107332,CSE 100,A01,083659,Cao; Yingjun,0,61,50,50
1650117113356,CSE 134B,A01,083661,Powell; Thomas Allan,0,27,65,65
1650117119386,CSE 140,A01,083663,Staff,4,0,75,71
1650117125418,CSE 140L,A01,083088,Eldon; John,0,1,75,75
1650117131448,CSE 175,A01,083665,Kumar; Rakesh,8,0,25,17
1650117137475,CSE 190,A00,092507,Dubnov; Shlomo,14,0,20,6
1650117143504,ECE 45,A01,083139,Staff,0,13,40,40
1650117149536,ECE 65,A50,083695,Staff,0,4,30,30
1650117155562,ECE 109,A01,091882,Touri; Behrouz,48,0,70,22
1650117161591,ECE 180,A00,083140,Abi Samra; Nicholas Camill,24,0,30,6
1650117161591,ECE 180,B00,083141,Abi Samra; Nicholas Camill,8,0,30,22
1650117167619,MATH 10A,A01,083735,Patchell; Gregory David,12,0,30,18
1650117167619,MATH 10A,A02,083736,Patchell; Gregory David,28,0,30,2
1650117167619,MATH 10A,A03,083737,Patchell; Gregory David,26,0,30,4
1650117173680,MATH 10B,A01,083207,Staff,0,5,30,30
1650117173680,MATH 10B,A02,083208,Staff,0,4,30,30
1650117173680,MATH 10B,B01,083739,Staff,18,0,30,12
1650117173680,MATH 10B,B02,083740,Staff,29,0,30,1
1650117179716,MATH 18,A01,083743,Staff,10,0,30,20
1650117179716,MATH 18,A02,083744,Staff,28,0,30,2
1650117179716,MATH 18,A03,083745,Staff,23,0,30,7
1650117179716,MATH 18,A04,083746,Staff,27,0,30,3
1650117179716,MATH 18,B01,083748,Staff,0,9,30,30
1650117179716,MATH 18,B02,083749,Staff,0,7,30,30
1650117179716,MATH 18,B03,083750,Staff,0,6,30,30
1650117179716,MATH 18,B04,083751,Staff,0,6,30,30
1650117185741,MATH 20A,A01,083754,Staff,26,0,40,14
1650117191768,MATH 20B,A01,083756,Staff,0,5,30,30
1650117191768,MATH 20B,A02,083757,Staff,0,2,30,30
1650117197794,MATH 20C,A01,083760,Staff,0,11,30,30
1650117197794,MATH 20C,A02,083761,Staff,0,12,30,30
1650117197794,MATH 20C,B01,083762,Staff,14,0,30,16
1650117197794,MATH 20C,B02,083763,Staff,28,0,30,2
1650117203822,MATH 20D,A01,083765,Staff,0,2,30,30
1650117203822,MATH 20D,A02,083766,Staff,12,0,30,18
1650117203822,MATH 20D,A03,083767,Staff,28,0,30,2
1650117209848,MATH 20E,A01,083771,Staff,10,0,30,20
1650117209848,MATH 20E,A02,083772,Staff,20,0,30,10
1650117209848,MATH 20E,B01,083773,Staff,0,0,30,30
1650117209848,MATH 20E,B02,083774,Staff,13,0,30,17
1650117215874,MATH 103A,A01,083777,Staff,0,8,30,30
1650117215874,MATH 103A,A02,083778,Staff,0,7,30,30
1650117215874,MATH 103A,B01,083779,Staff,0,9,30,30
1650117215874,MATH 103A,B02,083780,Staff,0,6,30,30
1650117221901,MATH 105,A01,085443,Staff,0,13,30,30
1650117227933,MATH 109,A01,083213,Anzaldo; Leesa B,0,3,30,30
1650117227933,MATH 109,A02,083214,Anzaldo; Leesa B,0,5,30,30
1650117227933,MATH 109,B01,083215,Anzaldo; Leesa B,0,4,30,30
1650117227933,MATH 109,B02,083216,Anzaldo; Leesa B,0,4,30,30
1650117233960,MATH 142A,A01,083219,Chow; Bennett,0,10,30,30
1650117233960,MATH 142A,A02,083220,Chow; Bennett,0,10,30,30
1650117233960,MATH 142A,B01,083221,Chow; Bennett,0,10,30,30
1650117233960,MATH 142A,B02,083222,Chow; Bennett,0,9,30,30
1650117239987,MATH 193A,A01,083224,Staff,0,4,30,30
1650117239987,MATH 193A,A02,083225,Staff,0,4,30,30
1650117239987,MATH 193A,A03,083781,Staff,0,0,30,30
1650117239987,MATH 193A,A04,083782,Staff,2,0,30,28
1650117246011,MATH 197,001,091859,McAuley; Julian John,9998,0,9999,1
1650117252082,COGS 9,A01,083615,Staff,0,14,60,60
1650117258108,COGS 11,A01,083617,Boyle; Mary E. T.,24,0,40,16
1650117264214,COGS 13,A01,083071,Staff,0,28,40,40
1650117270238,COGS 14A,A01,092681,Staff,0,10,100,100
1650117276268,COGS 14B,A01,083073,Cheng; Tzu-Han,0,4,50,50
1650117282296,COGS 17,A01,092677,Staff,35,0,75,40
1650117288323,COGS 100,A01,083619,Staff,0,21,60,60
1650117294348,COGS 101A,A01,083621,Davis; Joshua Daniel,0,18,60,60
1650117300375,COGS 101B,A01,091572,Staff,10,0,60,50
1650117306407,COGS 101C,A01,083625,Delgado; Tania,22,0,30,8
1650117312438,COGS 107A,A01,083627,Boyle; Mary E. T.,0,4,60,60
1650117318463,COGS 118A,A01,083075,Staff,17,0,60,43
1650117324491,CSE 3,A50,083646,Miranda; Gregory Joseph,22,0,38,16
1650117324491,CSE 3,A51,083647,Miranda; Gregory Joseph,37,0,37,0
1650117330520,CSE 8A,A50,083650,Miranda; Gregory Joseph,0,15,40,40
1650117336546,CSE 11,A01,083080,Cao; Yingjun,0,66,40,40
1650117342570,CSE 12,A01,083652,Staff,0,2,100,100
1650117348599,CSE 15L,A01,083654,Staff,0,0,50,50
1650117348599,CSE 15L,A02,083655,Staff,10,0,50,40
1650117354630,CSE 20,A01,083657,Staff,58,0,80,22
1650117360660,CSE 30,A01,083084,Eldon; John,0,63,40,40
1650117366690,CSE 100,A01,083659,Cao; Yingjun,0,61,50,50
1650117372715,CSE 134B,A01,083661,Powell; Thomas Allan,0,27,65,65
1650117378737,CSE 140,A01,083663,Staff,4,0,75,71
1650117384763,CSE 140L,A01,083088,Eldon; John,0,1,75,75
1650117390790,CSE 175,A01,083665,Kumar; Rakesh,8,0,25,17
1650117396819,CSE 190,A00,092507,Dubnov; Shlomo,14,0,20,6
1650117402850,ECE 45,A01,083139,Staff,0,13,40,40
1650117408886,ECE 65,A50,083695,Staff,0,4,30,30
1650117414912,ECE 109,A01,091882,Touri; Behrouz,48,0,70,22
1650117420940,ECE 180,A00,083140,Abi Samra; Nicholas Camill,24,0,30,6
1650117420940,ECE 180,B00,083141,Abi Samra; Nicholas Camill,8,0,30,22
1650117426980,MATH 10A,A01,083735,Patchell; Gregory David,12,0,30,18
1650117426980,MATH 10A,A02,083736,Patchell; Gregory David,28,0,30,2
1650117426980,MATH 10A,A03,083737,Patchell; Gregory David,26,0,30,4
1650117433006,MATH 10B,A01,083207,Staff,0,5,30,30
1650117433006,MATH 10B,A02,083208,Staff,0,4,30,30
1650117433006,MATH 10B,B01,083739,Staff,18,0,30,12
1650117433006,MATH 10B,B02,083740,Staff,29,0,30,1
1650117439042,MATH 18,A01,083743,Staff,10,0,30,20
1650117439042,MATH 18,A02,083744,Staff,28,0,30,2
1650117439042,MATH 18,A03,083745,Staff,23,0,30,7
1650117439042,MATH 18,A04,083746,Staff,27,0,30,3
1650117439042,MATH 18,B01,083748,Staff,0,9,30,30
1650117439042,MATH 18,B02,083749,Staff,0,7,30,30
1650117439042,MATH 18,B03,083750,Staff,0,6,30,30
1650117439042,MATH 18,B04,083751,Staff,0,6,30,30
1650117445067,MATH 20A,A01,083754,Staff,26,0,40,14
1650117451098,MATH 20B,A01,083756,Staff,0,5,30,30
1650117451098,MATH 20B,A02,083757,Staff,0,2,30,30
1650117457128,MATH 20C,A01,083760,Staff,0,11,30,30
1650117457128,MATH 20C,A02,083761,Staff,0,12,30,30
1650117457128,MATH 20C,B01,083762,Staff,14,0,30,16
1650117457128,MATH 20C,B02,083763,Staff,28,0,30,2
1650117463156,MATH 20D,A01,083765,Staff,0,2,30,30
1650117463156,MATH 20D,A02,083766,Staff,12,0,30,18
1650117463156,MATH 20D,A03,083767,Staff,28,0,30,2
1650117469183,MATH 20E,A01,083771,Staff,10,0,30,20
1650117469183,MATH 20E,A02,083772,Staff,20,0,30,10
1650117469183,MATH 20E,B01,083773,Staff,0,0,30,30
1650117469183,MATH 20E,B02,083774,Staff,13,0,30,17
1650117475209,MATH 103A,A01,083777,Staff,0,8,30,30
1650117475209,MATH 103A,A02,083778,Staff,0,7,30,30
1650117475209,MATH 103A,B01,083779,Staff,0,9,30,30
1650117475209,MATH 103A,B02,083780,Staff,0,6,30,30
1650117481238,MATH 105,A01,085443,Staff,0,13,30,30
1650117487265,MATH 109,A01,083213,Anzaldo; Leesa B,0,3,30,30
1650117487265,MATH 109,A02,083214,Anzaldo; Leesa B,0,5,30,30
1650117487265,MATH 109,B01,083215,Anzaldo; Leesa B,0,4,30,30
1650117487265,MATH 109,B02,083216,Anzaldo; Leesa B,0,4,30,30
1650117493296,MATH 142A,A01,083219,Chow; Bennett,0,10,30,30
1650117493296,MATH 142A,A02,083220,Chow; Bennett,0,10,30,30
1650117493296,MATH 142A,B01,083221,Chow; Bennett,0,10,30,30
1650117493296,MATH 142A,B02,083222,Chow; Bennett,0,9,30,30
1650117499323,MATH 193A,A01,083224,Staff,0,4,30,30
1650117499323,MATH 193A,A02,083225,Staff,0,4,30,30
1650117499323,MATH 193A,A03,083781,Staff,0,0,30,30
1650117499323,MATH 193A,A04,083782,Staff,2,0,30,28
1650117505354,MATH 197,001,091859,McAuley; Julian John,9998,0,9999,1
1650117511428,COGS 9,A01,083615,Staff,0,14,60,60
1650117517458,COGS 11,A01,083617,Boyle; Mary E. T.,24,0,40,16
1650117523488,COGS 13,A01,083071,Staff,0,28,40,40
1650117529518,COGS 14A,A01,092681,Staff,0,10,100,100
1650117535543,COGS 14B,A01,083073,Cheng; Tzu-Han,0,4,50,50
1650117541569,COGS 17,A01,092677,Staff,35,0,75,40
1650117547598,COGS 100,A01,083619,Staff,0,21,60,60
1650117553624,COGS 101A,A01,083621,Davis; Joshua Daniel,0,18,60,60
1650117559651,COGS 101B,A01,091572,Staff,10,0,60,50
1650117565683,COGS 101C,A01,083625,Delgado; Tania,22,0,30,8
1650117571713,COGS 107A,A01,083627,Boyle; Mary E. T.,0,4,60,60
1650117577738,COGS 118A,A01,083075,Staff,17,0,60,43
1650117583767,CSE 3,A50,083646,Miranda; Gregory Joseph,22,0,38,16
1650117583767,CSE 3,A51,083647,Miranda; Gregory Joseph,37,0,37,0
1650117589792,CSE 8A,A50,083650,Miranda; Gregory Joseph,0,15,40,40
1650117595817,CSE 11,A01,083080,Cao; Yingjun,0,66,40,40
1650117601843,CSE 12,A01,083652,Staff,0,2,100,100
1650117607867,CSE 15L,A01,083654,Staff,0,0,50,50
1650117607867,CSE 15L,A02,083655,Staff,10,0,50,40
1650117613892,CSE 20,A01,083657,Staff,58,0,80,22
1650117619919,CSE 30,A01,083084,Eldon; John,0,63,40,40
1650117625946,CSE 100,A01,083659,Cao; Yingjun,0,61,50,50
1650117631976,CSE 134B,A01,083661,Powell; Thomas Allan,0,27,65,65
1650117638002,CSE 140,A01,083663,Staff,4,0,75,71
1650117644031,CSE 140L,A01,083088,Eldon; John,0,1,75,75
1650117650062,CSE 175,A01,083665,Kumar; Rakesh,8,0,25,17
1650117656090,CSE 190,A00,092507,Dubnov; Shlomo,14,0,20,6
1650117662115,ECE 45,A01,083139,Staff,0,13,40,40
1650117668214,ECE 65,A50,083695,Staff,0,4,30,30
1650117674238,ECE 109,A01,091882,Touri; Behrouz,48,0,70,22
1650117680264,ECE 180,A00,083140,Abi Samra; Nicholas Camill,24,0,30,6
1650117680264,ECE 180,B00,083141,Abi Samra; Nicholas Camill,8,0,30,22
1650117686294,MATH 10A,A01,083735,Patchell; Gregory David,12,0,30,18
1650117686294,MATH 10A,A02,083736,Patchell; Gregory David,28,0,30,2
1650117686294,MATH 10A,A03,083737,Patchell; Gregory David,26,0,30,4
1650117692333,MATH 10B,A01,083207,Staff,0,5,30,30
1650117692333,MATH 10B,A02,083208,Staff,0,4,30,30
1650117692333,MATH 10B,B01,083739,Staff,18,0,30,12
1650117692333,MATH 10B,B02,083740,Staff,29,0,30,1
1650117698363,MATH 18,A01,083743,Staff,10,0,30,20
1650117698363,MATH 18,A02,083744,Staff,28,0,30,2
1650117698363,MATH 18,A03,083745,Staff,23,0,30,7
1650117698363,MATH 18,A04,083746,Staff,27,0,30,3
1650117698363,MATH 18,B01,083748,Staff,0,9,30,30
1650117698363,MATH 18,B02,083749,Staff,0,7,30,30
1650117698363,MATH 18,B03,083750,Staff,0,6,30,30
1650117698363,MATH 18,B04,083751,Staff,0,6,30,30
1650117704388,MATH 20A,A01,083754,Staff,26,0,40,14
1650117710418,MATH 20B,A01,083756,Staff,0,5,30,30
1650117710418,MATH 20B,A02,083757,Staff,0,2,30,30
1650117716451,MATH 20C,A01,083760,Staff,0,11,30,30
1650117716451,MATH 20C,A02,083761,Staff,0,12,30,30
1650117716451,MATH 20C,B01,083762,Staff,14,0,30,16
1650117716451,MATH 20C,B02,083763,Staff,28,0,30,2
1650117722477,MATH 20D,A01,083765,Staff,0,2,30,30
1650117722477,MATH 20D,A02,083766,Staff,12,0,30,18
1650117722477,MATH 20D,A03,083767,Staff,28,0,30,2
1650117728510,MATH 20E,A01,083771,Staff,10,0,30,20
1650117728510,MATH 20E,A02,083772,Staff,20,0,30,10
1650117728510,MATH 20E,B01,083773,Staff,0,0,30,30
1650117728510,MATH 20E,B02,083774,Staff,13,0,30,17
1650117734537,MATH 103A,A01,083777,Staff,0,8,30,30
1650117734537,MATH 103A,A02,083778,Staff,0,7,30,30
1650117734537,MATH 103A,B01,083779,Staff,0,9,30,30
1650117734537,MATH 103A,B02,083780,Staff,0,6,30,30
1650117740563,MATH 105,A01,085443,Staff,0,13,30,30
1650117746594,MATH 109,A01,083213,Anzaldo; Leesa B,0,3,30,30
1650117746594,MATH 109,A02,083214,Anzaldo; Leesa B,0,5,30,30
1650117746594,MATH 109,B01,083215,Anzaldo; Leesa B,0,4,30,30
1650117746594,MATH 109,B02,083216,Anzaldo; Leesa B,0,4,30,30
1650117752627,MATH 142A,A01,083219,Chow; Bennett,0,10,30,30
1650117752627,MATH 142A,A02,083220,Chow; Bennett,0,10,30,30
1650117752627,MATH 142A,B01,083221,Chow; Bennett,0,10,30,30
1650117752627,MATH 142A,B02,083222,Chow; Bennett,0,9,30,30
1650117758657,MATH 193A,A01,083224,Staff,0,4,30,30
1650117758657,MATH 193A,A02,083225,Staff,0,4,30,30
1650117758657,MATH 193A,A03,083781,Staff,0,0,30,30
1650117758657,MATH 193A,A04,083782,Staff,2,0,30,28
1650117764687,MATH 197,001,091859,McAuley; Julian John,9998,0,9999,1
1650117770754,COGS 9,A01,083615,Staff,0,14,60,60
1650117776781,COGS 11,A01,083617,Boyle; Mary E. T.,24,0,40,16
1650117782823,COGS 13,A01,083071,Staff,0,28,40,40
1650117788853,COGS 14A,A01,092681,Staff,0,10,100,100
1650117794879,COGS 14B,A01,083073,Cheng; Tzu-Han,0,4,50,50
1650117800906,COGS 17,A01,092677,Staff,35,0,75,40
1650117806932,COGS 100,A01,083619,Staff,0,21,60,60
1650117812958,COGS 101A,A01,083621,Davis; Joshua Daniel,0,18,60,60
1650117818985,COGS 101B,A01,091572,Staff,10,0,60,50
1650117825016,COGS 101C,A01,083625,Delgado; Tania,22,0,30,8
1650117831047,COGS 107A,A01,083627,Boyle; Mary E. T.,0,4,60,60
1650117837077,COGS 118A,A01,083075,Staff,17,0,60,43
1650117843104,CSE 3,A50,083646,Miranda; Gregory Joseph,22,0,38,16
1650117843104,CSE 3,A51,083647,Miranda; Gregory Joseph,37,0,37,0
1650117849129,CSE 8A,A50,083650,Miranda; Gregory Joseph,0,15,40,40
1650117855155,CSE 11,A01,083080,Cao; Yingjun,0,66,40,40
1650117861255,CSE 12,A01,083652,Staff,0,2,100,100
1650117867282,CSE 15L,A01,083654,Staff,0,0,50,50
1650117867282,CSE 15L,A02,083655,Staff,10,0,50,40
1650117873307,CSE 20,A01,083657,Staff,58,0,80,22
1650117879333,CSE 30,A01,083084,Eldon; John,0,63,40,40
1650117885360,CSE 100,A01,083659,Cao; Yingjun,0,61,50,50
1650117891392,CSE 134B,A01,083661,Powell; Thomas Allan,0,27,65,65
1650117897417,CSE 140,A01,083663,Staff,4,0,75,71
1650117903445,CSE 140L,A01,083088,Eldon; John,0,1,75,75
1650117909472,CSE 175,A01,083665,Kumar; Rakesh,8,0,25,17
1650117915497,CSE 190,A00,092507,Dubnov; Shlomo,14,0,20,6
1650117921527,ECE 45,A01,083139,Staff,0,13,40,40
1650117927554,ECE 65,A50,083695,Staff,0,4,30,30
1650117933585,ECE 109,A01,091882,Touri; Behrouz,48,0,70,22
1650117939611,ECE 180,A00,083140,Abi Samra; Nicholas Camill,24,0,30,6
1650117939611,ECE 180,B00,083141,Abi Samra; Nicholas Camill,8,0,30,22
1650117945643,MATH 10A,A01,083735,Patchell; Gregory David,12,0,30,18
1650117945643,MATH 10A,A02,083736,Patchell; Gregory David,28,0,30,2
1650117945643,MATH 10A,A03,083737,Patchell; Gregory David,26,0,30,4
1650117951667,MATH 10B,A01,083207,Staff,0,5,30,30
1650117951667,MATH 10B,A02,083208,Staff,0,4,30,30
1650117951667,MATH 10B,B01,083739,Staff,18,0,30,12
1650117951667,MATH 10B,B02,083740,Staff,29,0,30,1
1650117957692,MATH 18,A01,083743,Staff,10,0,30,20
1650117957692,MATH 18,A02,083744,Staff,28,0,30,2
1650117957692,MATH 18,A03,083745,Staff,23,0,30,7
1650117957692,MATH 18,A04,083746,Staff,27,0,30,3
1650117957692,MATH 18,B01,083748,Staff,0,9,30,30
1650117957692,MATH 18,B02,083749,Staff,0,7,30,30
1650117957692,MATH 18,B03,083750,Staff,0,6,30,30
1650117957692,MATH 18,B04,083751,Staff,0,6,30,30
1650117963717,MATH 20A,A01,083754,Staff,26,0,40,14
1650117969748,MATH 20B,A01,083756,Staff,0,5,30,30
1650117969748,MATH 20B,A02,083757,Staff,0,2,30,30
1650117975773,MATH 20C,A01,083760,Staff,0,11,30,30
1650117975773,MATH 20C,A02,083761,Staff,0,12,30,30
1650117975773,MATH 20C,B01,083762,Staff,14,0,30,16
1650117975773,MATH 20C,B02,083763,Staff,28,0,30,2
1650117981800,MATH 20D,A01,083765,Staff,0,2,30,30
1650117981800,MATH 20D,A02,083766,Staff,12,0,30,18
1650117981800,MATH 20D,A03,083767,Staff,28,0,30,2
1650117987832,MATH 20E,A01,083771,Staff,10,0,30,20
1650117987832,MATH 20E,A02,083772,Staff,20,0,30,10
1650117987832,MATH 20E,B01,083773,Staff,0,0,30,30
1650117987832,MATH 20E,B02,083774,Staff,13,0,30,17
1650117993857,MATH 103A,A01,083777,Staff,0,8,30,30
1650117993857,MATH 103A,A02,083778,Staff,0,7,30,30
1650117993857,MATH 103A,B01,083779,Staff,0,9,30,30
1650117993857,MATH 103A,B02,083780,Staff,0,6,30,30
1650117999883,MATH 105,A01,085443,Staff,0,13,30,30
1650118005912,MATH 109,A01,083213,Anzaldo; Leesa B,0,3,30,30
1650118005912,MATH 109,A02,083214,Anzaldo; Leesa B,0,5,30,30
1650118005912,MATH 109,B01,083215,Anzaldo; Leesa B,0,4,30,30
1650118005912,MATH 109,B02,083216,Anzaldo; Leesa B,0,4,30,30
1650118011943,MATH 142A,A01,083219,Chow; Bennett,0,10,30,30
1650118011943,MATH 142A,A02,083220,Chow; Bennett,0,10,30,30
1650118011943,MATH 142A,B01,083221,Chow; Bennett,0,10,30,30
1650118011943,MATH 142A,B02,083222,Chow; Bennett,0,9,30,30
1650118017968,MATH 193A,A01,083224,Staff,0,4,30,30
1650118017968,MATH 193A,A02,083225,Staff,0,4,30,30
1650118017968,MATH 193A,A03,083781,Staff,0,0,30,30
1650118017968,MATH 193A,A04,083782,Staff,2,0,30,28
1650118023996,MATH 197,001,091859,McAuley; Julian John,9998,0,9999,1
1650118030068,COGS 9,A01,083615,Staff,0,14,60,60
1650118036096,COGS 11,A01,083617,Boyle; Mary E. T.,24,0,40,16
1650118042124,COGS 13,A01,083071,Staff,0,28,40,40
1650118048161,COGS 14A,A01,092681,Staff,0,10,100,100
1650118054192,COGS 14B,A01,083073,Cheng; Tzu-Han,0,4,50,50
1650118060217,COGS 17,A01,092677,Staff,35,0,75,40
1650118066243,COGS 100,A01,083619,Staff,0,21,60,60
1650118072270,COGS 101A,A01,083621,Davis; Joshua Daniel,0,18,60,60
1650118078295,COGS 101B,A01,091572,Staff,10,0,60,50
1650118084325,COGS 101C,A01,083625,Delgado; Tania,22,0,30,8
1650118090349,COGS 107A,A01,083627,Boyle; Mary E. T.,0,4,60,60
1650118096374,COGS 118A,A01,083075,Staff,17,0,60,43
1650118102408,CSE 3,A50,083646,Miranda; Gregory Joseph,22,0,38,16
1650118102408,CSE 3,A51,083647,Miranda; Gregory Joseph,37,0,37,0
1650118108433,CSE 8A,A50,083650,Miranda; Gregory Joseph,0,15,40,40
1650118114458,CSE 11,A01,083080,Cao; Yingjun,0,66,40,40
1650118120484,CSE 12,A01,083652,Staff,0,2,100,100
1650118126508,CSE 15L,A01,083654,Staff,0,0,50,50
1650118126508,CSE 15L,A02,083655,Staff,10,0,50,40
1650118132538,CSE 20,A01,083657,Staff,58,0,80,22
1650118138568,CSE 30,A01,083084,Eldon; John,0,63,40,40
1650118144594,CSE 100,A01,083659,Cao; Yingjun,0,61,50,50
1650118150625,CSE 134B,A01,083661,Powell; Thomas Allan,0,27,65,65
1650118156649,CSE 140,A01,083663,Staff,4,0,75,71
1650118162677,CSE 140L,A01,083088,Eldon; John,0,1,75,75
1650118168707,CSE 175,A01,083665,Kumar; Rakesh,8,0,25,17
1650118174740,CSE 190,A00,092507,Dubnov; Shlomo,14,0,20,6
1650118180810,ECE 45,A01,083139,Staff,0,13,40,40
1650118186840,ECE 65,A50,083695,Staff,0,4,30,30
1650118192871,ECE 109,A01,091882,Touri; Behrouz,48,0,70,22
1650118198897,ECE 180,A00,083140,Abi Samra; Nicholas Camill,24,0,30,6
1650118198897,ECE 180,B00,083141,Abi Samra; Nicholas Camill,8,0,30,22
1650118204925,MATH 10A,A01,083735,Patchell; Gregory David,12,0,30,18
1650118204925,MATH 10A,A02,083736,Patchell; Gregory David,28,0,30,2
1650118204925,MATH 10A,A03,083737,Patchell; Gregory David,26,0,30,4
1650118210956,MATH 10B,A01,083207,Staff,0,5,30,30
1650118210956,MATH 10B,A02,083208,Staff,0,4,30,30
1650118210956,MATH 10B,B01,083739,Staff,18,0,30,12
1650118210956,MATH 10B,B02,083740,Staff,29,0,30,1
1650118216986,MATH 18,A01,083743,Staff,10,0,30,20
1650118216986,MATH 18,A02,083744,Staff,28,0,30,2
1650118216986,MATH 18,A03,083745,Staff,23,0,30,7
1650118216986,MATH 18,A04,083746,Staff,27,0,30,3
1650118216986,MATH 18,B01,083748,Staff,0,9,30,30
1650118216986,MATH 18,B02,083749,Staff,0,7,30,30
1650118216986,MATH 18,B03,083750,Staff,0,6,30,30
1650118216986,MATH 18,B04,083751,Staff,0,6,30,30
1650118223011,MATH 20A,A01,083754,Staff,26,0,40,14
1650118229044,MATH 20B,A01,083756,Staff,0,5,30,30
1650118229044,MATH 20B,A02,083757,Staff,0,2,30,30
1650118235074,MATH 20C,A01,083760,Staff,0,11,30,30
1650118235074,MATH 20C,A02,083761,Staff,0,12,30,30
1650118235074,MATH 20C,B01,083762,Staff,14,0,30,16
1650118235074,MATH 20C,B02,083763,Staff,28,0,30,2
1650118241101,MATH 20D,A01,083765,Staff,0,2,30,30
1650118241101,MATH 20D,A02,083766,Staff,12,0,30,18
1650118241101,MATH 20D,A03,083767,Staff,28,0,30,2
1650118247130,MATH 20E,A01,083771,Staff,10,0,30,20
1650118247130,MATH 20E,A02,083772,Staff,20,0,30,10
1650118247130,MATH 20E,B01,083773,Staff,0,0,30,30
1650118247130,MATH 20E,B02,083774,Staff,13,0,30,17
1650118253157,MATH 103A,A01,083777,Staff,0,8,30,30
1650118253157,MATH 103A,A02,083778,Staff,0,7,30,30
1650118253157,MATH 103A,B01,083779,Staff,0,9,30,30
1650118253157,MATH 103A,B02,083780,Staff,0,6,30,30
1650118259183,MATH 105,A01,085443,Staff,0,13,30,30
1650118265207,MATH 109,A01,083213,Anzaldo; Leesa B,0,3,30,30
1650118265207,MATH 109,A02,083214,Anzaldo; Leesa B,0,5,30,30
1650118265207,MATH 109,B01,083215,Anzaldo; Leesa B,0,4,30,30
1650118265207,MATH 109,B02,083216,Anzaldo; Leesa B,0,4,30,30
1650118271238,MATH 142A,A01,083219,Chow; Bennett,0,10,30,30
1650118271238,MATH 142A,A02,083220,Chow; Bennett,0,10,30,30
1650118271238,MATH 142A,B01,083221,Chow; Bennett,0,10,30,30
1650118271238,MATH 142A,B02,083222,Chow; Bennett,0,9,30,30
1650118277264,MATH 193A,A01,083224,Staff,0,4,30,30
1650118277264,MATH 193A,A02,083225,Staff,0,4,30,30
1650118277264,MATH 193A,A03,083781,Staff,0,0,30,30
1650118277264,MATH 193A,A04,083782,Staff,2,0,30,28
1650118283287,MATH 197,001,091859,McAuley; Julian John,9998,0,9999,1
1650118289361,COGS 9,A01,083615,Staff,0,14,60,60
1650118295385,COGS 11,A01,083617,Boyle; Mary E. T.,24,0,40,16
1650118301418,COGS 13,A01,083071,Staff,0,28,40,40
1650118307442,COGS 14A,A01,092681,Staff,0,10,100,100
1650118313468,COGS 14B,A01,083073,Cheng; Tzu-Han,0,4,50,50
1650118319496,COGS 17,A01,092677,Staff,35,0,75,40
1650118325525,COGS 100,A01,083619,Staff,0,21,60,60
1650118331551,COGS 101A,A01,083621,Davis; Joshua Daniel,0,18,60,60
1650118337577,COGS 101B,A01,091572,Staff,10,0,60,50
1650118343603,COGS 101C,A01,083625,Delgado; Tania,22,0,30,8
1650118349631,COGS 107A,A01,083627,Boyle; Mary E. T.,0,4,60,60
1650118355658,COGS 118A,A01,083075,Staff,17,0,60,43
1650118361693,CSE 3,A50,083646,Miranda; Gregory Joseph,22,0,38,16
1650118361693,CSE 3,A51,083647,Miranda; Gregory Joseph,37,0,37,0
1650118367728,CSE 8A,A50,083650,Miranda; Gregory Joseph,0,15,40,40
1650118373756,CSE 11,A01,083080,Cao; Yingjun,0,66,40,40
1650118379781,CSE 12,A01,083652,Staff,0,2,100,100
1650118385813,CSE 15L,A01,083654,Staff,0,0,50,50
1650118385813,CSE 15L,A02,083655,Staff,10,0,50,40
1650118391846,CSE 20,A01,083657,Staff,58,0,80,22
1650118397874,CSE 30,A01,083084,Eldon; John,0,63,40,40
1650118403900,CSE 100,A01,083659,Cao; Yingjun,0,61,50,50
1650118409926,CSE 134B,A01,083661,Powell; Thomas Allan,0,27,65,65
1650118415952,CSE 140,A01,083663,Staff,4,0,75,71
1650118421983,CSE 140L,A01,083088,Eldon; John,0,1,75,75
1650118428013,CSE 175,A01,083665,Kumar; Rakesh,8,0,25,17
1650118434038,CSE 190,A00,092507,Dubnov; Shlomo,14,0,20,6
1650118440064,ECE 45,A01,083139,Staff,0,13,40,40
1650118446090,ECE 65,A50,083695,Staff,0,4,30,30
1650118452116,ECE 109,A01,091882,Touri; Behrouz,48,0,70,22
1650118458234,ECE 180,A00,083140,Abi Samra; Nicholas Camill,24,0,30,6
1650118458234,ECE 180,B00,083141,Abi Samra; Nicholas Camill,8,0,30,22
1650118464266,MATH 10A,A01,083735,Patchell; Gregory David,12,0,30,18
1650118464266,MATH 10A,A02,083736,Patchell; Gregory David,28,0,30,2
1650118464266,MATH 10A,A03,083737,Patchell; Gregory David,26,0,30,4
1650118470293,MATH 10B,A01,083207,Staff,0,5,30,30
1650118470293,MATH 10B,A02,083208,Staff,0,4,30,30
1650118470293,MATH 10B,B01,083739,Staff,18,0,30,12
1650118470293,MATH 10B,B02,083740,Staff,29,0,30,1
1650118476321,MATH 18,A01,083743,Staff,10,0,30,20
1650118476321,MATH 18,A02,083744,Staff,28,0,30,2
1650118476321,MATH 18,A03,083745,Staff,23,0,30,7
1650118476321,MATH 18,A04,083746,Staff,27,0,30,3
1650118476321,MATH 18,B01,083748,Staff,0,9,30,30
1650118476321,MATH 18,B02,083749,Staff,0,7,30,30
1650118476321,MATH 18,B03,083750,Staff,0,6,30,30
1650118476321,MATH 18,B04,083751,Staff,0,6,30,30
1650118482347,MATH 20A,A01,083754,Staff,26,0,40,14
1650118488372,MATH 20B,A01,083756,Staff,0,5,30,30
1650118488372,MATH 20B,A02,083757,Staff,0,2,30,30
1650118494399,MATH 20C,A01,083760,Staff,0,11,30,30
1650118494399,MATH 20C,A02,083761,Staff,0,12,30,30
1650118494399,MATH 20C,B01,083762,Staff,14,0,30,16
1650118494399,MATH 20C,B02,083763,Staff,28,0,30,2
1650118500428,MATH 20D,A01,083765,Staff,0,2,30,30
1650118500428,MATH 20D,A02,083766,Staff,12,0,30,18
1650118500428,MATH 20D,A03,083767,Staff,28,0,30,2
1650118506451,MATH 20E,A01,083771,Staff,10,0,30,20
1650118506451,MATH 20E,A02,083772,Staff,20,0,30,10
1650118506451,MATH 20E,B01,083773,Staff,0,0,30,30
1650118506451,MATH 20E,B02,083774,Staff,13,0,30,17
1650118512489,MATH 103A,A01,083777,Staff,0,8,30,30
1650118512489,MATH 103A,A02,083778,Staff,0,7,30,30
1650118512489,MATH 103A,B01,083779,Staff,0,9,30,30
1650118512489,MATH 103A,B02,083780,Staff,0,6,30,30
1650118518514,MATH 105,A01,085443,Staff,0,13,30,30
1650118524546,MATH 109,A01,083213,Anzaldo; Leesa B,0,3,30,30
1650118524546,MATH 109,A02,083214,Anzaldo; Leesa B,0,5,30,30
1650118524546,MATH 109,B01,083215,Anzaldo; Leesa B,0,4,30,30
1650118524546,MATH 109,B02,083216,Anzaldo; Leesa B,0,4,30,30
1650118530579,MATH 142A,A01,083219,Chow; Bennett,0,10,30,30
1650118530579,MATH 142A,A02,083220,Chow; Bennett,0,10,30,30
1650118530579,MATH 142A,B01,083221,Chow; Bennett,0,10,30,30
1650118530579,MATH 142A,B02,083222,Chow; Bennett,0,9,30,30
1650118536613,MATH 193A,A01,083224,Staff,0,4,30,30
1650118536613,MATH 193A,A02,083225,Staff,0,4,30,30
1650118536613,MATH 193A,A03,083781,Staff,0,0,30,30
1650118536613,MATH 193A,A04,083782,Staff,2,0,30,28
1650118542669,MATH 197,001,091859,McAuley; Julian John,9998,0,9999,1
1650118548737,COGS 9,A01,083615,Staff,0,14,60,60
1650118554767,COGS 11,A01,083617,Boyle; Mary E. T.,24,0,40,16
1650118560796,COGS 13,A01,083071,Staff,0,28,40,40
1650118566820,COGS 14A,A01,092681,Staff,0,10,100,100
1650118572846,COGS 14B,A01,083073,Cheng; Tzu-Han,0,4,50,50
1650118578871,COGS 17,A01,092677,Staff,35,0,75,40
1650118584897,COGS 100,A01,083619,Staff,0,21,60,60
1650118590923,COGS 101A,A01,083621,Davis; Joshua Daniel,0,18,60,60
1650118596947,COGS 101B,A01,091572,Staff,10,0,60,50
1650118602978,COGS 101C,A01,083625,Delgado; Tania,22,0,30,8
1650118609005,COGS 107A,A01,083627,Boyle; Mary E. T.,0,4,60,60
1650118615039,COGS 118A,A01,083075,Staff,17,0,60,43
1650118621064,CSE 3,A50,083646,Miranda; Gregory Joseph,22,0,38,16
1650118621064,CSE 3,A51,083647,Miranda; Gregory Joseph,37,0,37,0
1650118627090,CSE 8A,A50,083650,Miranda; Gregory Joseph,0,15,40,40
1650118633116,CSE 11,A01,083080,Cao; Yingjun,0,66,40,40
1650118639141,CSE 12,A01,083652,Staff,0,2,100,100
1650118645170,CSE 15L,A01,083654,Staff,0,0,50,50
1650118645170,CSE 15L,A02,083655,Staff,10,0,50,40
1650118651195,CSE 20,A01,083657,Staff,58,0,80,22
1650118657221,CSE 30,A01,083084,Eldon; John,0,63,40,40
1650118663253,CSE 100,A01,083659,Cao; Yingjun,0,61,50,50
1650118669282,CSE 134B,A01,083661,Powell; Thomas Allan,0,27,65,65
1650118675311,CSE 140,A01,083663,Staff,4,0,75,71
1650118681343,CSE 140L,A01,083088,Eldon; John,0,1,75,75
1650118687373,CSE 175,A01,083665,Kumar; Rakesh,8,0,25,17
1650118693399,CSE 190,A00,092507,Dubnov; Shlomo,14,0,20,6
1650118699431,ECE 45,A01,083139,Staff,0,13,40,40
1650118705463,ECE 65,A50,083695,Staff,0,4,30,30
1650118711496,ECE 109,A01,091882,Touri; Behrouz,48,0,70,22
1650118717523,ECE 180,A00,083140,Abi Samra; Nicholas Camill,24,0,30,6
1650118717523,ECE 180,B00,083141,Abi Samra; Nicholas Camill,8,0,30,22
1650118723562,MATH 10A,A01,083735,Patchell; Gregory David,12,0,30,18
1650118723562,MATH 10A,A02,083736,Patchell; Gregory David,28,0,30,2
1650118723562,MATH 10A,A03,083737,Patchell; Gregory David,26,0,30,4
1650118729596,MATH 10B,A01,083207,Staff,0,5,30,30
1650118729596,MATH 10B,A02,083208,Staff,0,4,30,30
1650118729596,MATH 10B,B01,083739,Staff,18,0,30,12
1650118729596,MATH 10B,B02,083740,Staff,29,0,30,1
1650118735629,MATH 18,A01,083743,Staff,10,0,30,20
1650118735629,MATH 18,A02,083744,Staff,28,0,30,2
1650118735629,MATH 18,A03,083745,Staff,23,0,30,7
1650118735629,MATH 18,A04,083746,Staff,27,0,30,3
1650118735629,MATH 18,B01,083748,Staff,0,9,30,30
1650118735629,MATH 18,B02,083749,Staff,0,7,30,30
1650118735629,MATH 18,B03,083750,Staff,0,6,30,30
1650118735629,MATH 18,B04,083751,Staff,0,6,30,30
1650118741654,MATH 20A,A01,083754,Staff,26,0,40,14
1650118747682,MATH 20B,A01,083756,Staff,0,5,30,30
1650118747682,MATH 20B,A02,083757,Staff,0,2,30,30
1650118753709,MATH 20C,A01,083760,Staff,0,11,30,30
1650118753709,MATH 20C,A02,083761,Staff,0,12,30,30
1650118753709,MATH 20C,B01,083762,Staff,14,0,30,16
1650118753709,MATH 20C,B02,083763,Staff,28,0,30,2
1650118759733,MATH 20D,A01,083765,Staff,0,2,30,30
1650118759733,MATH 20D,A02,083766,Staff,12,0,30,18
1650118759733,MATH 20D,A03,083767,Staff,28,0,30,2
1650118765764,MATH 20E,A01,083771,Staff,10,0,30,20
1650118765764,MATH 20E,A02,083772,Staff,20,0,30,10
1650118765764,MATH 20E,B01,083773,Staff,0,0,30,30
1650118765764,MATH 20E,B02,083774,Staff,13,0,30,17
1650118771791,MATH 103A,A01,083777,Staff,0,8,30,30
1650118771791,MATH 103A,A02,083778,Staff,0,7,30,30
1650118771791,MATH 103A,B01,083779,Staff,0,9,30,30
1650118771791,MATH 103A,B02,083780,Staff,0,6,30,30
1650118777830,MATH 105,A01,085443,Staff,0,13,30,30
1650118783856,MATH 109,A01,083213,Anzaldo; Leesa B,0,3,30,30
1650118783856,MATH 109,A02,083214,Anzaldo; Leesa B,0,5,30,30
1650118783856,MATH 109,B01,083215,Anzaldo; Leesa B,0,4,30,30
1650118783856,MATH 109,B02,083216,Anzaldo; Leesa B,0,4,30,30
1650118789888,MATH 142A,A01,083219,Chow; Bennett,0,10,30,30
1650118789888,MATH 142A,A02,083220,Chow; Bennett,0,10,30,30
1650118789888,MATH 142A,B01,083221,Chow; Bennett,0,10,30,30
1650118789888,MATH 142A,B02,083222,Chow; Bennett,0,9,30,30
1650118795914,MATH 193A,A01,083224,Staff,0,4,30,30
1650118795914,MATH 193A,A02,083225,Staff,0,4,30,30
1650118795914,MATH 193A,A03,083781,Staff,0,0,30,30
1650118795914,MATH 193A,A04,083782,Staff,2,0,30,28
1650118801938,MATH 197,001,091859,McAuley; Julian John,9998,0,9999,1
1650118808036,COGS 9,A01,083615,Staff,0,14,60,60
1650118814064,COGS 11,A01,083617,Boyle; Mary E. T.,24,0,40,16
1650118820089,COGS 13,A01,083071,Staff,0,28,40,40
1650118826113,COGS 14A,A01,092681,Staff,0,10,100,100
1650118832138,COGS 14B,A01,083073,Cheng; Tzu-Han,0,4,50,50
1650118838162,COGS 17,A01,092677,Staff,35,0,75,40
1650118844188,COGS 100,A01,083619,Staff,0,21,60,60
1650118850215,COGS 101A,A01,083621,Davis; Joshua Daniel,0,18,60,60
1650118856256,COGS 101B,A01,091572,Staff,10,0,60,50
1650118862282,COGS 101C,A01,083625,Delgado; Tania,22,0,30,8
1650118868311,COGS 107A,A01,083627,Boyle; Mary E. T.,0,4,60,60
1650118874338,COGS 118A,A01,083075,Staff,17,0,60,43
1650118880376,CSE 3,A50,083646,Miranda; Gregory Joseph,22,0,38,16
1650118880376,CSE 3,A51,083647,Miranda; Gregory Joseph,37,0,37,0
1650118886403,CSE 8A,A50,083650,Miranda; Gregory Joseph,0,15,40,40
1650118892433,CSE 11,A01,083080,Cao; Yingjun,0,66,40,40
1650118898465,CSE 12,A01,083652,Staff,0,2,100,100
1650118904490,CSE 15L,A01,083654,Staff,0,0,50,50
1650118904490,CSE 15L,A02,083655,Staff,10,0,50,40
1650118910520,CSE 20,A01,083657,Staff,58,0,80,22
1650118916546,CSE 30,A01,083084,Eldon; John,0,63,40,40
1650118922576,CSE 100,A01,083659,Cao; Yingjun,0,61,50,50
1650118928600,CSE 134B,A01,083661,Powell; Thomas Allan,0,27,65,65
1650118934630,CSE 140,A01,083663,Staff,4,0,75,71
1650118940655,CSE 140L,A01,083088,Eldon; John,0,1,75,75
1650118946686,CSE 175,A01,083665,Kumar; Rakesh,8,0,25,17
1650118952716,CSE 190,A00,092507,Dubnov; Shlomo,14,0,20,6
1650118958745,ECE 45,A01,083139,Staff,0,13,40,40
1650118964786,ECE 65,A50,083695,Staff,0,4,30,30
1650118970821,ECE 109,A01,091882,Touri; Behrouz,48,0,70,22
1650118976848,ECE 180,A00,083140,Abi Samra; Nicholas Camill,24,0,30,6
1650118976848,ECE 180,B00,083141,Abi Samra; Nicholas Camill,8,0,30,22
1650118982890,MATH 10A,A01,083735,Patchell; Gregory David,12,0,30,18
1650118982890,MATH 10A,A02,083736,Patchell; Gregory David,28,0,30,2
1650118982890,MATH 10A,A03,083737,Patchell; Gregory David,26,0,30,4
1650118988920,MATH 10B,A01,083207,Staff,0,5,30,30
1650118988920,MATH 10B,A02,083208,Staff,0,4,30,30
1650118988920,MATH 10B,B01,083739,Staff,18,0,30,12
1650118988920,MATH 10B,B02,083740,Staff,29,0,30,1
1650118994949,MATH 18,A01,083743,Staff,10,0,30,20
1650118994949,MATH 18,A02,083744,Staff,28,0,30,2
1650118994949,MATH 18,A03,083745,Staff,23,0,30,7
1650118994949,MATH 18,A04,083746,Staff,27,0,30,3
1650118994949,MATH 18,B01,083748,Staff,0,9,30,30
1650118994949,MATH 18,B02,083749,Staff,0,7,30,30
1650118994949,MATH 18,B03,083750,Staff,0,6,30,30
1650118994949,MATH 18,B04,083751,Staff,0,6,30,30
1650119000980,MATH 20A,A01,083754,Staff,26,0,40,14
1650119007012,MATH 20B,A01,083756,Staff,0,5,30,30
1650119007012,MATH 20B,A02,083757,Staff,0,2,30,30
1650119013048,MATH 20C,A01,083760,Staff,0,11,30,30
1650119013048,MATH 20C,A02,083761,Staff,0,12,30,30
1650119013048,MATH 20C,B01,083762,Staff,14,0,30,16
1650119013048,MATH 20C,B02,083763,Staff,28,0,30,2
1650119019072,MATH 20D,A01,083765,Staff,0,2,30,30
1650119019072,MATH 20D,A02,083766,Staff,12,0,30,18
1650119019072,MATH 20D,A03,083767,Staff,28,0,30,2
1650119025099,MATH 20E,A01,083771,Staff,10,0,30,20
1650119025099,MATH 20E,A02,083772,Staff,20,0,30,10
1650119025099,MATH 20E,B01,083773,Staff,0,0,30,30
1650119025099,MATH 20E,B02,083774,Staff,13,0,30,17
1650119031123,MATH 103A,A01,083777,Staff,0,8,30,30
1650119031123,MATH 103A,A02,083778,Staff,0,7,30,30
1650119031123,MATH 103A,B01,083779,Staff,0,9,30,30
1650119031123,MATH 103A,B02,083780,Staff,0,6,30,30
1650119037153,MATH 105,A01,085443,Staff,0,13,30,30
1650119043183,MATH 109,A01,083213,Anzaldo; Leesa B,0,3,30,30
1650119043183,MATH 109,A02,083214,Anzaldo; Leesa B,0,5,30,30
1650119043183,MATH 109,B01,083215,Anzaldo; Leesa B,0,4,30,30
1650119043183,MATH 109,B02,083216,Anzaldo; Leesa B,0,4,30,30
1650119049209,MATH 142A,A01,083219,Chow; Bennett,0,10,30,30
1650119049209,MATH 142A,A02,083220,Chow; Bennett,0,10,30,30
1650119049209,MATH 142A,B01,083221,Chow; Bennett,0,10,30,30
1650119049209,MATH 142A,B02,083222,Chow; Bennett,0,9,30,30
1650119055316,MATH 193A,A01,083224,Staff,0,4,30,30
1650119055316,MATH 193A,A02,083225,Staff,0,4,30,30
1650119055316,MATH 193A,A03,083781,Staff,0,0,30,30
1650119055316,MATH 193A,A04,083782,Staff,2,0,30,28
1650119061348,MATH 197,001,091859,McAuley; Julian John,9998,0,9999,1
1650119067418,COGS 9,A01,083615,Staff,0,14,60,60
1650119073444,COGS 11,A01,083617,Boyle; Mary E. T.,24,0,40,16
1650119079475,COGS 13,A01,083071,Staff,0,28,40,40
1650119085501,COGS 14A,A01,092681,Staff,0,10,100,100
1650119091532,COGS 14B,A01,083073,Cheng; Tzu-Han,0,4,50,50
1650119097559,COGS 17,A01,092677,Staff,35,0,75,40
1650119103585,COGS 100,A01,083619,Staff,0,21,60,60
1650119109617,COGS 101A,A01,083621,Davis; Joshua Daniel,0,18,60,60
1650119115643,COGS 101B,A01,091572,Staff,10,0,60,50
1650119121672,COGS 101C,A01,083625,Delgado; Tania,22,0,30,8
1650119127697,COGS 107A,A01,083627,Boyle; Mary E. T.,0,4,60,60
1650119133731,COGS 118A,A01,083075,Staff,17,0,60,43
1650119139767,CSE 3,A50,083646,Miranda; Gregory Joseph,22,0,38,16
1650119139767,CSE 3,A51,083647,Miranda; Gregory Joseph,37,0,37,0
1650119145790,CSE 8A,A50,083650,Miranda; Gregory Joseph,0,15,40,40
1650119151820,CSE 11,A01,083080,Cao; Yingjun,0,66,40,40
1650119157846,CSE 12,A01,083652,Staff,0,2,100,100
1650119163895,CSE 15L,A01,083654,Staff,0,0,50,50
1650119163895,CSE 15L,A02,083655,Staff,10,0,50,40
1650119169924,CSE 20,A01,083657,Staff,58,0,80,22
1650119175951,CSE 30,A01,083084,Eldon; John,0,63,40,40
1650119181977,CSE 100,A01,083659,Cao; Yingjun,0,61,50,50
1650119188006,CSE 134B,A01,083661,Powell; Thomas Allan,0,27,65,65
1650119194034,CSE 140,A01,083663,Staff,4,0,75,71
1650119200059,CSE 140L,A01,083088,Eldon; John,0,1,75,75
1650119206095,CSE 175,A01,083665,Kumar; Rakesh,8,0,25,17
1650119212121,CSE 190,A00,092507,Dubnov; Shlomo,14,0,20,6
1650119218147,ECE 45,A01,083139,Staff,0,13,40,40
1650119224174,ECE 65,A50,083695,Staff,0,4,30,30
1650119230200,ECE 109,A01,091882,Touri; Behrouz,48,0,70,22
1650119236235,ECE 180,A00,083140,Abi Samra; Nicholas Camill,24,0,30,6
1650119236235,ECE 180,B00,083141,Abi Samra; Nicholas Camill,8,0,30,22
1650119242261,MATH 10A,A01,083735,Patchell; Gregory David,12,0,30,18
1650119242261,MATH 10A,A02,083736,Patchell; Gregory David,28,0,30,2
1650119242261,MATH 10A,A03,083737,Patchell; Gregory David,26,0,30,4
1650119248298,MATH 10B,A01,083207,Staff,0,5,30,30
1650119248298,MATH 10B,A02,083208,Staff,0,4,30,30
1650119248298,MATH 10B,B01,083739,Staff,18,0,30,12
1650119248298,MATH 10B,B02,083740,Staff,29,0,30,1
1650119254328,MATH 18,A01,083743,Staff,10,0,30,20
1650119254328,MATH 18,A02,083744,Staff,28,0,30,2
1650119254328,MATH 18,A03,083745,Staff,23,0,30,7
1650119254328,MATH 18,A04,083746,Staff,27,0,30,3
1650119254328,MATH 18,B01,083748,Staff,0,9,30,30
1650119254328,MATH 18,B02,083749,Staff,0,7,30,30
1650119254328,MATH 18,B03,083750,Staff,0,6,30,30
1650119254328,MATH 18,B04,083751,Staff,0,6,30,30
1650119260374,MATH 20A,A01,083754,Staff,26,0,40,14
1650119266401,MATH 20B,A01,083756,Staff,0,5,30,30
1650119266401,MATH 20B,A02,083757,Staff,0,2,30,30
1650119272428,MATH 20C,A01,083760,Staff,0,11,30,30
1650119272428,MATH 20C,A02,083761,Staff,0,12,30,30
1650119272428,MATH 20C,B01,083762,Staff,14,0,30,16
1650119272428,MATH 20C,B02,083763,Staff,28,0,30,2
1650119278453,MATH 20D,A01,083765,Staff,0,2,30,30
1650119278453,MATH 20D,A02,083766,Staff,12,0,30,18
1650119278453,MATH 20D,A03,083767,Staff,28,0,30,2
1650119284486,MATH 20E,A01,083771,Staff,10,0,30,20
1650119284486,MATH 20E,A02,083772,Staff,20,0,30,10
1650119284486,MATH 20E,B01,083773,Staff,0,0,30,30
1650119284486,MATH 20E,B02,083774,Staff,13,0,30,17
1650119290532,MATH 103A,A01,083777,Staff,0,8,30,30
1650119290532,MATH 103A,A02,083778,Staff,0,7,30,30
1650119290532,MATH 103A,B01,083779,Staff,0,9,30,30
1650119290532,MATH 103A,B02,083780,Staff,0,6,30,30
1650119296562,MATH 105,A01,085443,Staff,0,13,30,30
1650119302587,MATH 109,A01,083213,Anzaldo; Leesa B,0,3,30,30
1650119302587,MATH 109,A02,083214,Anzaldo; Leesa B,0,5,30,30
1650119302587,MATH 109,B01,083215,Anzaldo; Leesa B,0,4,30,30
1650119302587,MATH 109,B02,083216,Anzaldo; Leesa B,0,4,30,30
1650119308613,MATH 142A,A01,083219,Chow; Bennett,0,10,30,30
1650119308613,MATH 142A,A02,083220,Chow; Bennett,0,10,30,30
1650119308613,MATH 142A,B01,083221,Chow; Bennett,0,10,30,30
1650119308613,MATH 142A,B02,083222,Chow; Bennett,0,9,30,30
1650119314638,MATH 193A,A01,083224,Staff,0,4,30,30
1650119314638,MATH 193A,A02,083225,Staff,0,4,30,30
1650119314638,MATH 193A,A03,083781,Staff,0,0,30,30
1650119314638,MATH 193A,A04,083782,Staff,2,0,30,28
1650119320663,MATH 197,001,091859,McAuley; Julian John,9998,0,9999,1
1650119326735,COGS 9,A01,083615,Staff,0,14,60,60
1650119332762,COGS 11,A01,083617,Boyle; Mary E. T.,24,0,40,16
1650119338787,COGS 13,A01,083071,Staff,0,28,40,40
1650119344812,COGS 14A,A01,092681,Staff,0,10,100,100
1650119350838,COGS 14B,A01,083073,Cheng; Tzu-Han,0,4,50,50
1650119356865,COGS 17,A01,092677,Staff,35,0,75,40
1650119362889,COGS 100,A01,083619,Staff,0,21,60,60
1650119368919,COGS 101A,A01,083621,Davis; Joshua Daniel,0,18,60,60
1650119374947,COGS 101B,A01,091572,Staff,10,0,60,50
1650119380974,COGS 101C,A01,083625,Delgado; Tania,22,0,30,8
1650119387001,COGS 107A,A01,083627,Boyle; Mary E. T.,0,4,60,60
1650119393028,COGS 118A,A01,083075,Staff,17,0,60,43
1650119399056,CSE 3,A50,083646,Miranda; Gregory Joseph,22,0,38,16
1650119399056,CSE 3,A51,083647,Miranda; Gregory Joseph,37,0,37,0
1650119405085,CSE 8A,A50,083650,Miranda; Gregory Joseph,0,15,40,40
1650119411112,CSE 11,A01,083080,Cao; Yingjun,0,66,40,40
1650119417137,CSE 12,A01,083652,Staff,0,2,100,100
1650119423161,CSE 15L,A01,083654,Staff,0,0,50,50
1650119423161,CSE 15L,A02,083655,Staff,10,0,50,40
1650119429186,CSE 20,A01,083657,Staff,58,0,80,22
1650119435212,CSE 30,A01,083084,Eldon; John,0,63,40,40
1650119441237,CSE 100,A01,083659,Cao; Yingjun,0,61,50,50
1650119447264,CSE 134B,A01,083661,Powell; Thomas Allan,0,27,65,65
1650119453301,CSE 140,A01,083663,Staff,4,0,75,71
1650119459333,CSE 140L,A01,083088,Eldon; John,0,1,75,75
1650119465361,CSE 175,A01,083665,Kumar; Rakesh,8,0,25,17
1650119471391,CSE 190,A00,092507,Dubnov; Shlomo,14,0,20,6
1650119477427,ECE 45,A01,083139,Staff,0,13,40,40
1650119483452,ECE 65,A50,083695,Staff,0,4,30,30
1650119489483,ECE 109,A01,091882,Touri; Behrouz,48,0,70,22
1650119495513,ECE 180,A00,083140,Abi Samra; Nicholas Camill,24,0,30,6
1650119495513,ECE 180,B00,083141,Abi Samra; Nicholas Camill,8,0,30,22
1650119501548,MATH 10A,A01,083735,Patchell; Gregory David,12,0,30,18
1650119501548,MATH 10A,A02,083736,Patchell; Gregory David,28,0,30,2
1650119501548,MATH 10A,A03,083737,Patchell; Gregory David,26,0,30,4
1650119507572,MATH 10B,A01,083207,Staff,0,5,30,30
1650119507572,MATH 10B,A02,083208,Staff,0,4,30,30
1650119507572,MATH 10B,B01,083739,Staff,18,0,30,12
1650119507572,MATH 10B,B02,083740,Staff,29,0,30,1
1650119513602,MATH 18,A01,083743,Staff,10,0,30,20
1650119513602,MATH 18,A02,083744,Staff,28,0,30,2
1650119513602,MATH 18,A03,083745,Staff,23,0,30,7
1650119513602,MATH 18,A04,083746,Staff,27,0,30,3
1650119513602,MATH 18,B01,083748,Staff,0,9,30,30
1650119513602,MATH 18,B02,083749,Staff,0,7,30,30
1650119513602,MATH 18,B03,083750,Staff,0,6,30,30
1650119513602,MATH 18,B04,083751,Staff,0,6,30,30
1650119519640,MATH 20A,A01,083754,Staff,26,0,40,14
1650119525665,MATH 20B,A01,083756,Staff,0,5,30,30
1650119525665,MATH 20B,A02,083757,Staff,0,2,30,30
1650119531696,MATH 20C,A01,083760,Staff,0,11,30,30
1650119531696,MATH 20C,A02,083761,Staff,0,12,30,30
1650119531696,MATH 20C,B01,083762,Staff,14,0,30,16
1650119531696,MATH 20C,B02,083763,Staff,28,0,30,2
1650119537723,MATH 20D,A01,083765,Staff,0,2,30,30
1650119537723,MATH 20D,A02,083766,Staff,12,0,30,18
1650119537723,MATH 20D,A03,083767,Staff,28,0,30,2
1650119543751,MATH 20E,A01,083771,Staff,10,0,30,20
1650119543751,MATH 20E,A02,083772,Staff,20,0,30,10
1650119543751,MATH 20E,B01,083773,Staff,0,0,30,30
1650119543751,MATH 20E,B02,083774,Staff,13,0,30,17
1650119549786,MATH 103A,A01,083777,Staff,0,8,30,30
1650119549786,MATH 103A,A02,083778,Staff,0,7,30,30
1650119549786,MATH 103A,B01,083779,Staff,0,9,30,30
1650119549786,MATH 103A,B02,083780,Staff,0,6,30,30
1650119555815,MATH 105,A01,085443,Staff,0,13,30,30
1650119561841,MATH 109,A01,083213,Anzaldo; Leesa B,0,3,30,30
1650119561841,MATH 109,A02,083214,Anzaldo; Leesa B,0,5,30,30
1650119561841,MATH 109,B01,083215,Anzaldo; Leesa B,0,4,30,30
1650119561841,MATH 109,B02,083216,Anzaldo; Leesa B,0,4,30,30
1650119567876,MATH 142A,A01,083219,Chow; Bennett,0,10,30,30
1650119567876,MATH 142A,A02,083220,Chow; Bennett,0,10,30,30
1650119567876,MATH 142A,B01,083221,Chow; Bennett,0,10,30,30
1650119567876,MATH 142A,B02,083222,Chow; Bennett,0,9,30,30
1650119573904,MATH 193A,A01,083224,Staff,0,4,30,30
1650119573904,MATH 193A,A02,083225,Staff,0,4,30,30
1650119573904,MATH 193A,A03,083781,Staff,0,0,30,30
1650119573904,MATH 193A,A04,083782,Staff,2,0,30,28
1650119579930,MATH 197,001,091859,McAuley; Julian John,9998,0,9999,1
1650119585992,COGS 9,A01,083615,Staff,0,14,60,60
1650119592023,COGS 11,A01,083617,Boyle; Mary E. T.,24,0,40,16
1650119598050,COGS 13,A01,083071,Staff,0,28,40,40
1650119604078,COGS 14A,A01,092681,Staff,0,10,100,100
1650119610104,COGS 14B,A01,083073,Cheng; Tzu-Han,0,4,50,50
1650119616129,COGS 17,A01,092677,Staff,35,0,75,40
1650119622158,COGS 100,A01,083619,Staff,0,21,60,60
1650119628188,COGS 101A,A01,083621,Davis; Joshua Daniel,0,18,60,60
1650119634217,COGS 101B,A01,091572,Staff,10,0,60,50
1650119640241,COGS 101C,A01,083625,Delgado; Tania,22,0,30,8
1650119646501,COGS 107A,A01,083627,Boyle; Mary E. T.,0,4,60,60
1650119652527,COGS 118A,A01,083075,Staff,17,0,60,43
1650119658561,CSE 3,A50,083646,Miranda; Gregory Joseph,22,0,38,16
1650119658561,CSE 3,A51,083647,Miranda; Gregory Joseph,37,0,37,0
1650119664588,CSE 8A,A50,083650,Miranda; Gregory Joseph,0,15,40,40
1650119670616,CSE 11,A01,083080,Cao; Yingjun,0,66,40,40
1650119676644,CSE 12,A01,083652,Staff,0,2,100,100
1650119682669,CSE 15L,A01,083654,Staff,0,0,50,50
1650119682669,CSE 15L,A02,083655,Staff,10,0,50,40
1650119688699,CSE 20,A01,083657,Staff,58,0,80,22
1650119694724,CSE 30,A01,083084,Eldon; John,0,63,40,40
1650119700751,CSE 100,A01,083659,Cao; Yingjun,0,61,50,50
1650119706780,CSE 134B,A01,083661,Powell; Thomas Allan,0,27,65,65
1650119712803,CSE 140,A01,083663,Staff,4,0,75,71
1650119718828,CSE 140L,A01,083088,Eldon; John,0,1,75,75
1650119724853,CSE 175,A01,083665,Kumar; Rakesh,8,0,25,17
1650119730881,CSE 190,A00,092507,Dubnov; Shlomo,14,0,20,6
1650119736916,ECE 45,A01,083139,Staff,0,13,40,40
1650119742942,ECE 65,A50,083695,Staff,0,4,30,30
1650119748965,ECE 109,A01,091882,Touri; Behrouz,48,0,70,22
1650119754990,ECE 180,A00,083140,Abi Samra; Nicholas Camill,24,0,30,6
1650119754990,ECE 180,B00,083141,Abi Samra; Nicholas Camill,8,0,30,22
1650119761022,MATH 10A,A01,083735,Patchell; Gregory David,12,0,30,18
1650119761022,MATH 10A,A02,083736,Patchell; Gregory David,28,0,30,2
1650119761022,MATH 10A,A03,083737,Patchell; Gregory David,26,0,30,4
1650119767053,MATH 10B,A01,083207,Staff,0,5,30,30
1650119767053,MATH 10B,A02,083208,Staff,0,4,30,30
1650119767053,MATH 10B,B01,083739,Staff,18,0,30,12
1650119767053,MATH 10B,B02,083740,Staff,29,0,30,1
1650119773084,MATH 18,A01,083743,Staff,10,0,30,20
1650119773084,MATH 18,A02,083744,Staff,28,0,30,2
1650119773084,MATH 18,A03,083745,Staff,23,0,30,7
1650119773084,MATH 18,A04,083746,Staff,27,0,30,3
1650119773084,MATH 18,B01,083748,Staff,0,9,30,30
1650119773084,MATH 18,B02,083749,Staff,0,7,30,30
1650119773084,MATH 18,B03,083750,Staff,0,6,30,30
1650119773084,MATH 18,B04,083751,Staff,0,6,30,30
1650119779117,MATH 20A,A01,083754,Staff,26,0,40,14
1650119785151,MATH 20B,A01,083756,Staff,0,5,30,30
1650119785151,MATH 20B,A02,083757,Staff,0,2,30,30
1650119791176,MATH 20C,A01,083760,Staff,0,11,30,30
1650119791176,MATH 20C,A02,083761,Staff,0,12,30,30
1650119791176,MATH 20C,B01,083762,Staff,14,0,30,16
1650119791176,MATH 20C,B02,083763,Staff,28,0,30,2
1650119797201,MATH 20D,A01,083765,Staff,0,2,30,30
1650119797201,MATH 20D,A02,083766,Staff,12,0,30,18
1650119797201,MATH 20D,A03,083767,Staff,28,0,30,2
1650119803227,MATH 20E,A01,083771,Staff,10,0,30,20
1650119803227,MATH 20E,A02,083772,Staff,20,0,30,10
1650119803227,MATH 20E,B01,083773,Staff,0,0,30,30
1650119803227,MATH 20E,B02,083774,Staff,13,0,30,17
1650119809259,MATH 103A,A01,083777,Staff,0,8,30,30
1650119809259,MATH 103A,A02,083778,Staff,0,7,30,30
1650119809259,MATH 103A,B01,083779,Staff,0,9,30,30
1650119809259,MATH 103A,B02,083780,Staff,0,6,30,30
1650119815292,MATH 105,A01,085443,Staff,0,13,30,30
1650119821317,MATH 109,A01,083213,Anzaldo; Leesa B,0,3,30,30
1650119821317,MATH 109,A02,083214,Anzaldo; Leesa B,0,5,30,30
1650119821317,MATH 109,B01,083215,Anzaldo; Leesa B,0,4,30,30
1650119821317,MATH 109,B02,083216,Anzaldo; Leesa B,0,4,30,30
1650119827339,MATH 142A,A01,083219,Chow; Bennett,0,10,30,30
1650119827339,MATH 142A,A02,083220,Chow; Bennett,0,10,30,30
1650119827339,MATH 142A,B01,083221,Chow; Bennett,0,10,30,30
1650119827339,MATH 142A,B02,083222,Chow; Bennett,0,9,30,30
1650119833368,MATH 193A,A01,083224,Staff,0,4,30,30
1650119833368,MATH 193A,A02,083225,Staff,0,4,30,30
1650119833368,MATH 193A,A03,083781,Staff,0,0,30,30
1650119833368,MATH 193A,A04,083782,Staff,2,0,30,28
1650119839393,MATH 197,001,091859,McAuley; Julian John,9998,0,9999,1
1650119845466,COGS 9,A01,083615,Staff,0,14,60,60
1650119851503,COGS 11,A01,083617,Boyle; Mary E. T.,24,0,40,16
1650119857532,COGS 13,A01,083071,Staff,0,28,40,40
1650119863557,COGS 14A,A01,092681,Staff,0,10,100,100
1650119869582,COGS 14B,A01,083073,Cheng; Tzu-Han,0,4,50,50
1650119875610,COGS 17,A01,092677,Staff,35,0,75,40
1650119881637,COGS 100,A01,083619,Staff,0,21,60,60
1650119887661,COGS 101A,A01,083621,Davis; Joshua Daniel,0,18,60,60
1650119893686,COGS 101B,A01,091572,Staff,10,0,60,50
1650119899713,COGS 101C,A01,083625,Delgado; Tania,22,0,30,8
1650119905740,COGS 107A,A01,083627,Boyle; Mary E. T.,0,4,60,60
1650119911767,COGS 118A,A01,083075,Staff,17,0,60,43
1650119917791,CSE 3,A50,083646,Miranda; Gregory Joseph,22,0,38,16
1650119917791,CSE 3,A51,083647,Miranda; Gregory Joseph,37,0,37,0
1650119923815,CSE 8A,A50,083650,Miranda; Gregory Joseph,0,15,40,40
1650119929845,CSE 11,A01,083080,Cao; Yingjun,0,66,40,40
1650119935875,CSE 12,A01,083652,Staff,0,2,100,100
1650119941899,CSE 15L,A01,083654,Staff,0,0,50,50
1650119941899,CSE 15L,A02,083655,Staff,10,0,50,40
1650119947927,CSE 20,A01,083657,Staff,58,0,80,22
1650119953954,CSE 30,A01,083084,Eldon; John,0,63,40,40
1650119959981,CSE 100,A01,083659,Cao; Yingjun,0,61,50,50
1650119966012,CSE 134B,A01,083661,Powell; Thomas Allan,0,27,65,65
1650119972039,CSE 140,A01,083663,Staff,4,0,75,71
1650119978074,CSE 140L,A01,083088,Eldon; John,0,1,75,75
1650119984099,CSE 175,A01,083665,Kumar; Rakesh,8,0,25,17
1650119990125,CSE 190,A00,092507,Dubnov; Shlomo,14,0,20,6
1650119996152,ECE 45,A01,083139,Staff,0,13,40,40
1650120002176,ECE 65,A50,083695,Staff,0,4,30,30
1650120008199,ECE 109,A01,091882,Touri; Behrouz,48,0,70,22
1650120014224,ECE 180,A00,083140,Abi Samra; Nicholas Camill,24,0,30,6
1650120014224,ECE 180,B00,083141,Abi Samra; Nicholas Camill,8,0,30,22
1650120020252,MATH 10A,A01,083735,Patchell; Gregory David,12,0,30,18
1650120020252,MATH 10A,A02,083736,Patchell; Gregory David,28,0,30,2
1650120020252,MATH 10A,A03,083737,Patchell; Gregory David,26,0,30,4
1650120026279,MATH 10B,A01,083207,Staff,0,5,30,30
1650120026279,MATH 10B,A02,083208,Staff,0,4,30,30
1650120026279,MATH 10B,B01,083739,Staff,18,0,30,12
1650120026279,MATH 10B,B02,083740,Staff,29,0,30,1
1650120032308,MATH 18,A01,083743,Staff,10,0,30,20
1650120032308,MATH 18,A02,083744,Staff,28,0,30,2
1650120032308,MATH 18,A03,083745,Staff,23,0,30,7
1650120032308,MATH 18,A04,083746,Staff,27,0,30,3
1650120032308,MATH 18,B01,083748,Staff,0,9,30,30
1650120032308,MATH 18,B02,083749,Staff,0,7,30,30
1650120032308,MATH 18,B03,083750,Staff,0,6,30,30
1650120032308,MATH 18,B04,083751,Staff,0,6,30,30
1650120038330,MATH 20A,A01,083754,Staff,26,0,40,14
1650120044357,MATH 20B,A01,083756,Staff,0,5,30,30
1650120044357,MATH 20B,A02,083757,Staff,0,2,30,30
1650120050381,MATH 20C,A01,083760,Staff,0,11,30,30
1650120050381,MATH 20C,A02,083761,Staff,0,12,30,30
1650120050381,MATH 20C,B01,083762,Staff,14,0,30,16
1650120050381,MATH 20C,B02,083763,Staff,28,0,30,2
1650120056409,MATH 20D,A01,083765,Staff,0,2,30,30
1650120056409,MATH 20D,A02,083766,Staff,12,0,30,18
1650120056409,MATH 20D,A03,083767,Staff,28,0,30,2
1650120062435,MATH 20E,A01,083771,Staff,10,0,30,20
1650120062435,MATH 20E,A02,083772,Staff,20,0,30,10
1650120062435,MATH 20E,B01,083773,Staff,0,0,30,30
1650120062435,MATH 20E,B02,083774,Staff,13,0,30,17
1650120068459,MATH 103A,A01,083777,Staff,0,8,30,30
1650120068459,MATH 103A,A02,083778,Staff,0,7,30,30
1650120068459,MATH 103A,B01,083779,Staff,0,9,30,30
1650120068459,MATH 103A,B02,083780,Staff,0,6,30,30
1650120074482,MATH 105,A01,085443,Staff,0,13,30,30
1650120080510,MATH 109,A01,083213,Anzaldo; Leesa B,0,3,30,30
1650120080510,MATH 109,A02,083214,Anzaldo; Leesa B,0,5,30,30
1650120080510,MATH 109,B01,083215,Anzaldo; Leesa B,0,4,30,30
1650120080510,MATH 109,B02,083216,Anzaldo; Leesa B,0,4,30,30
1650120086539,MATH 142A,A01,083219,Chow; Bennett,0,10,30,30
1650120086539,MATH 142A,A02,083220,Chow; Bennett,0,10,30,30
1650120086539,MATH 142A,B01,083221,Chow; Bennett,0,10,30,30
1650120086539,MATH 142A,B02,083222,Chow; Bennett,0,9,30,30
1650120092564,MATH 193A,A01,083224,Staff,0,4,30,30
1650120092564,MATH 193A,A02,083225,Staff,0,4,30,30
1650120092564,MATH 193A,A03,083781,Staff,0,0,30,30
1650120092564,MATH 193A,A04,083782,Staff,2,0,30,28
1650120098590,MATH 197,001,091859,McAuley; Julian John,9998,0,9999,1
1650120104659,COGS 9,A01,083615,Staff,0,14,60,60
1650120110688,COGS 11,A01,083617,Boyle; Mary E. T.,24,0,40,16
1650120116722,COGS 13,A01,083071,Staff,0,28,40,40
1650120122746,COGS 14A,A01,092681,Staff,0,10,100,100
1650120128775,COGS 14B,A01,083073,Cheng; Tzu-Han,0,4,50,50
1650120134811,COGS 17,A01,092677,Staff,35,0,75,40
1650120140839,COGS 100,A01,083619,Staff,0,21,60,60
1650120146865,COGS 101A,A01,083621,Davis; Joshua Daniel,0,18,60,60
1650120152893,COGS 101B,A01,091572,Staff,10,0,60,50
1650120158921,COGS 101C,A01,083625,Delgado; Tania,22,0,30,8
1650120164946,COGS 107A,A01,083627,Boyle; Mary E. T.,0,4,60,60
1650120170971,COGS 118A,A01,083075,Staff,17,0,60,43
1650120176998,CSE 3,A50,083646,Miranda; Gregory Joseph,22,0,38,16
1650120176998,CSE 3,A51,083647,Miranda; Gregory Joseph,37,0,37,0
1650120183036,CSE 8A,A50,083650,Miranda; Gregory Joseph,0,15,40,40
1650120189064,CSE 11,A01,083080,Cao; Yingjun,0,66,40,40
1650120195092,CSE 12,A01,083652,Staff,0,2,100,100
1650120201154,CSE 15L,A01,083654,Staff,0,0,50,50
1650120201154,CSE 15L,A02,083655,Staff,10,0,50,40
1650120207179,CSE 20,A01,083657,Staff,58,0,80,22
1650120213203,CSE 30,A01,083084,Eldon; John,0,63,40,40
1650120219229,CSE 100,A01,083659,Cao; Yingjun,0,61,50,50
1650120225255,CSE 134B,A01,083661,Powell; Thomas Allan,0,27,65,65
1650120231279,CSE 140,A01,083663,Staff,4,0,75,71
1650120237307,CSE 140L,A01,083088,Eldon; John,0,1,75,75
1650120243411,CSE 175,A01,083665,Kumar; Rakesh,8,0,25,17
1650120249445,CSE 190,A00,092507,Dubnov; Shlomo,14,0,20,6
1650120255471,ECE 45,A01,083139,Staff,0,13,40,40
1650120261497,ECE 65,A50,083695,Staff,0,4,30,30
1650120267523,ECE 109,A01,091882,Touri; Behrouz,48,0,70,22
1650120273555,ECE 180,A00,083140,Abi Samra; Nicholas Camill,24,0,30,6
1650120273555,ECE 180,B00,083141,Abi Samra; Nicholas Camill,8,0,30,22
1650120279587,MATH 10A,A01,083735,Patchell; Gregory David,12,0,30,18
1650120279587,MATH 10A,A02,083736,Patchell; Gregory David,28,0,30,2
1650120279587,MATH 10A,A03,083737,Patchell; Gregory David,26,0,30,4
1650120285622,MATH 10B,A01,083207,Staff,0,5,30,30
1650120285622,MATH 10B,A02,083208,Staff,0,4,30,30
1650120285622,MATH 10B,B01,083739,Staff,18,0,30,12
1650120285622,MATH 10B,B02,083740,Staff,29,0,30,1
1650120291656,MATH 18,A01,083743,Staff,10,0,30,20
1650120291656,MATH 18,A02,083744,Staff,28,0,30,2
1650120291656,MATH 18,A03,083745,Staff,23,0,30,7
1650120291656,MATH 18,A04,083746,Staff,27,0,30,3
1650120291656,MATH 18,B01,083748,Staff,0,9,30,30
1650120291656,MATH 18,B02,083749,Staff,0,7,30,30
1650120291656,MATH 18,B03,083750,Staff,0,6,30,30
1650120291656,MATH 18,B04,083751,Staff,0,6,30,30
1650120297681,MATH 20A,A01,083754,Staff,26,0,40,14
1650120303713,MATH 20B,A01,083756,Staff,0,5,30,30
1650120303713,MATH 20B,A02,083757,Staff,0,2,30,30
1650120309739,MATH 20C,A01,083760,Staff,0,11,30,30
1650120309739,MATH 20C,A02,083761,Staff,0,12,30,30
1650120309739,MATH 20C,B01,083762,Staff,14,0,30,16
1650120309739,MATH 20C,B02,083763,Staff,28,0,30,2
1650120315768,MATH 20D,A01,083765,Staff,0,2,30,30
1650120315768,MATH 20D,A02,083766,Staff,12,0,30,18
1650120315768,MATH 20D,A03,083767,Staff,28,0,30,2
1650120321800,MATH 20E,A01,083771,Staff,10,0,30,20
1650120321800,MATH 20E,A02,083772,Staff,20,0,30,10
1650120321800,MATH 20E,B01,083773,Staff,0,0,30,30
1650120321800,MATH 20E,B02,083774,Staff,13,0,30,17
1650120327824,MATH 103A,A01,083777,Staff,0,8,30,30
1650120327824,MATH 103A,A02,083778,Staff,0,7,30,30
1650120327824,MATH 103A,B01,083779,Staff,0,9,30,30
1650120327824,MATH 103A,B02,083780,Staff,0,6,30,30
1650120333849,MATH 105,A01,085443,Staff,0,13,30,30
1650120339880,MATH 109,A01,083213,Anzaldo; Leesa B,0,3,30,30
1650120339880,MATH 109,A02,083214,Anzaldo; Leesa B,0,5,30,30
1650120339880,MATH 109,B01,083215,Anzaldo; Leesa B,0,4,30,30
1650120339880,MATH 109,B02,083216,Anzaldo; Leesa B,0,4,30,30
1650120345910,MATH 142A,A01,083219,Chow; Bennett,0,10,30,30
1650120345910,MATH 142A,A02,083220,Chow; Bennett,0,10,30,30
1650120345910,MATH 142A,B01,083221,Chow; Bennett,0,10,30,30
1650120345910,MATH 142A,B02,083222,Chow; Bennett,0,9,30,30
1650120351943,MATH 193A,A01,083224,Staff,0,4,30,30
1650120351943,MATH 193A,A02,083225,Staff,0,4,30,30
1650120351943,MATH 193A,A03,083781,Staff,0,0,30,30
1650120351943,MATH 193A,A04,083782,Staff,2,0,30,28
1650120357968,MATH 197,001,091859,McAuley; Julian John,9998,0,9999,1
1650120364053,COGS 9,A01,083615,Staff,0,14,60,60
1650120370085,COGS 11,A01,083617,Boyle; Mary E. T.,24,0,40,16
1650120376110,COGS 13,A01,083071,Staff,0,28,40,40
1650120382153,COGS 14A,A01,092681,Staff,0,10,100,100
1650120388179,COGS 14B,A01,083073,Cheng; Tzu-Han,0,4,50,50
1650120394207,COGS 17,A01,092677,Staff,35,0,75,40
1650120400232,COGS 100,A01,083619,Staff,0,21,60,60
1650120406257,COGS 101A,A01,083621,Davis; Joshua Daniel,0,18,60,60
1650120412282,COGS 101B,A01,091572,Staff,10,0,60,50
1650120418308,COGS 101C,A01,083625,Delgado; Tania,22,0,30,8
1650120424343,COGS 107A,A01,083627,Boyle; Mary E. T.,0,4,60,60
1650120430368,COGS 118A,A01,083075,Staff,17,0,60,43
1650120436408,CSE 3,A50,083646,Miranda; Gregory Joseph,22,0,38,16
1650120436408,CSE 3,A51,083647,Miranda; Gregory Joseph,37,0,37,0
1650120442438,CSE 8A,A50,083650,Miranda; Gregory Joseph,0,15,40,40
1650120448462,CSE 11,A01,083080,Cao; Yingjun,0,66,40,40
1650120454488,CSE 12,A01,083652,Staff,0,2,100,100
1650120460514,CSE 15L,A01,083654,Staff,0,0,50,50
1650120460514,CSE 15L,A02,083655,Staff,10,0,50,40
1650120466539,CSE 20,A01,083657,Staff,58,0,80,22
1650120472568,CSE 30,A01,083084,Eldon; John,0,63,40,40
1650120478594,CSE 100,A01,083659,Cao; Yingjun,0,61,50,50
1650120484618,CSE 134B,A01,083661,Powell; Thomas Allan,0,27,65,65
1650120490642,CSE 140,A01,083663,Staff,4,0,75,71
1650120496675,CSE 140L,A01,083088,Eldon; John,0,1,75,75
1650120502702,CSE 175,A01,083665,Kumar; Rakesh,8,0,25,17
1650120508728,CSE 190,A00,092507,Dubnov; Shlomo,14,0,20,6
1650120514755,ECE 45,A01,083139,Staff,0,13,40,40
1650120520780,ECE 65,A50,083695,Staff,0,4,30,30
1650120526806,ECE 109,A01,091882,Touri; Behrouz,48,0,70,22
1650120532835,ECE 180,A00,083140,Abi Samra; Nicholas Camill,24,0,30,6
1650120532835,ECE 180,B00,083141,Abi Samra; Nicholas Camill,8,0,30,22
1650120538870,MATH 10A,A01,083735,Patchell; Gregory David,12,0,30,18
1650120538870,MATH 10A,A02,083736,Patchell; Gregory David,28,0,30,2
1650120538870,MATH 10A,A03,083737,Patchell; Gregory David,26,0,30,4
1650120544900,MATH 10B,A01,083207,Staff,0,5,30,30
1650120544900,MATH 10B,A02,083208,Staff,0,4,30,30
1650120544900,MATH 10B,B01,083739,Staff,18,0,30,12
1650120544900,MATH 10B,B02,083740,Staff,29,0,30,1
1650120550950,MATH 18,A01,083743,Staff,10,0,30,20
1650120550950,MATH 18,A02,083744,Staff,28,0,30,2
1650120550950,MATH 18,A03,083745,Staff,23,0,30,7
1650120550950,MATH 18,A04,083746,Staff,27,0,30,3
1650120550950,MATH 18,B01,083748,Staff,0,9,30,30
1650120550950,MATH 18,B02,083749,Staff,0,7,30,30
1650120550950,MATH 18,B03,083750,Staff,0,6,30,30
1650120550950,MATH 18,B04,083751,Staff,0,6,30,30
1650120556975,MATH 20A,A01,083754,Staff,26,0,40,14
1650120563004,MATH 20B,A01,083756,Staff,0,5,30,30
1650120563004,MATH 20B,A02,083757,Staff,0,2,30,30
1650120569030,MATH 20C,A01,083760,Staff,0,11,30,30
1650120569030,MATH 20C,A02,083761,Staff,0,12,30,30
1650120569030,MATH 20C,B01,083762,Staff,14,0,30,16
1650120569030,MATH 20C,B02,083763,Staff,28,0,30,2
1650120575058,MATH 20D,A01,083765,Staff,0,2,30,30
1650120575058,MATH 20D,A02,083766,Staff,12,0,30,18
1650120575058,MATH 20D,A03,083767,Staff,28,0,30,2
1650120581088,MATH 20E,A01,083771,Staff,10,0,30,20
1650120581088,MATH 20E,A02,083772,Staff,20,0,30,10
1650120581088,MATH 20E,B01,083773,Staff,0,0,30,30
1650120581088,MATH 20E,B02,083774,Staff,13,0,30,17
1650120587117,MATH 103A,A01,083777,Staff,0,8,30,30
1650120587117,MATH 103A,A02,083778,Staff,0,7,30,30
1650120587117,MATH 103A,B01,083779,Staff,0,9,30,30
1650120587117,MATH 103A,B02,083780,Staff,0,6,30,30
1650120593142,MATH 105,A01,085443,Staff,0,13,30,30
1650120599168,MATH 109,A01,083213,Anzaldo; Leesa B,0,3,30,30
1650120599168,MATH 109,A02,083214,Anzaldo; Leesa B,0,5,30,30
1650120599168,MATH 109,B01,083215,Anzaldo; Leesa B,0,4,30,30
1650120599168,MATH 109,B02,083216,Anzaldo; Leesa B,0,4,30,30
1650120605193,MATH 142A,A01,083219,Chow; Bennett,0,10,30,30
1650120605193,MATH 142A,A02,083220,Chow; Bennett,0,10,30,30
1650120605193,MATH 142A,B01,083221,Chow; Bennett,0,10,30,30
1650120605193,MATH 142A,B02,083222,Chow; Bennett,0,9,30,30
1650120611223,MATH 193A,A01,083224,Staff,0,4,30,30
1650120611223,MATH 193A,A02,083225,Staff,0,4,30,30
1650120611223,MATH 193A,A03,083781,Staff,0,0,30,30
1650120611223,MATH 193A,A04,083782,Staff,2,0,30,28
1650120617252,MATH 197,001,091859,McAuley; Julian John,9998,0,9999,1
1650120623326,COGS 9,A01,083615,Staff,0,14,60,60
1650120629359,COGS 11,A01,083617,Boyle; Mary E. T.,24,0,40,16
1650120635382,COGS 13,A01,083071,Staff,0,28,40,40
1650120641429,COGS 14A,A01,092681,Staff,0,10,100,100
1650120647454,COGS 14B,A01,083073,Cheng; Tzu-Han,0,4,50,50
1650120653476,COGS 17,A01,092677,Staff,35,0,75,40
1650120659523,COGS 100,A01,083619,Staff,0,21,60,60
1650120665550,COGS 101A,A01,083621,Davis; Joshua Daniel,0,18,60,60
1650120671578,COGS 101B,A01,091572,Staff,10,0,60,50
1650120677607,COGS 101C,A01,083625,Delgado; Tania,22,0,30,8
1650120683646,COGS 107A,A01,083627,Boyle; Mary E. T.,0,4,60,60
1650120689677,COGS 118A,A01,083075,Staff,17,0,60,43
1650120695716,CSE 3,A50,083646,Miranda; Gregory Joseph,22,0,38,16
1650120695716,CSE 3,A51,083647,Miranda; Gregory Joseph,37,0,37,0
1650120701745,CSE 8A,A50,083650,Miranda; Gregory Joseph,0,15,40,40
1650120707784,CSE 11,A01,083080,Cao; Yingjun,0,66,40,40
1650120713818,CSE 12,A01,083652,Staff,0,2,100,100
1650120719847,CSE 15L,A01,083654,Staff,0,0,50,50
1650120719847,CSE 15L,A02,083655,Staff,10,0,50,40
1650120725871,CSE 20,A01,083657,Staff,58,0,80,22
1650120731905,CSE 30,A01,083084,Eldon; John,0,63,40,40
1650120737952,CSE 100,A01,083659,Cao; Yingjun,0,61,50,50
1650120743977,CSE 134B,A01,083661,Powell; Thomas Allan,0,27,65,65
1650120750006,CSE 140,A01,083663,Staff,4,0,75,71
1650120756030,CSE 140L,A01,083088,Eldon; John,0,1,75,75
1650120762061,CSE 175,A01,083665,Kumar; Rakesh,8,0,25,17
1650120768089,CSE 190,A00,092507,Dubnov; Shlomo,14,0,20,6
1650120774114,ECE 45,A01,083139,Staff,0,13,40,40
1650120780151,ECE 65,A50,083695,Staff,0,4,30,30
1650120786177,ECE 109,A01,091882,Touri; Behrouz,48,0,70,22
1650120794590,ECE 180,A00,083140,Abi Samra; Nicholas Camill,24,0,30,6
1650120794590,ECE 180,B00,083141,Abi Samra; Nicholas Camill,8,0,30,22
1650120800625,MATH 10A,A01,083735,Patchell; Gregory David,12,0,30,18
1650120800625,MATH 10A,A02,083736,Patchell; Gregory David,28,0,30,2
1650120800625,MATH 10A,A03,083737,Patchell; Gregory David,26,0,30,4
1650120806662,MATH 10B,A01,083207,Staff,0,5,30,30
1650120806662,MATH 10B,A02,083208,Staff,0,4,30,30
1650120806662,MATH 10B,B01,083739,Staff,18,0,30,12
1650120806662,MATH 10B,B02,083740,Staff,29,0,30,1
1650120812696,MATH 18,A01,083743,Staff,10,0,30,20
1650120812696,MATH 18,A02,083744,Staff,28,0,30,2
1650120812696,MATH 18,A03,083745,Staff,23,0,30,7
1650120812696,MATH 18,A04,083746,Staff,27,0,30,3
1650120812696,MATH 18,B01,083748,Staff,0,9,30,30
1650120812696,MATH 18,B02,083749,Staff,0,7,30,30
1650120812696,MATH 18,B03,083750,Staff,0,6,30,30
1650120812696,MATH 18,B04,083751,Staff,0,6,30,30
1650120818724,MATH 20A,A01,083754,Staff,26,0,40,14
1650120824754,MATH 20B,A01,083756,Staff,0,5,30,30
1650120824754,MATH 20B,A02,083757,Staff,0,2,30,30
1650120830779,MATH 20C,A01,083760,Staff,0,11,30,30
1650120830779,MATH 20C,A02,083761,Staff,0,12,30,30
1650120830779,MATH 20C,B01,083762,Staff,14,0,30,16
1650120830779,MATH 20C,B02,083763,Staff,28,0,30,2
1650120836808,MATH 20D,A01,083765,Staff,0,2,30,30
1650120836808,MATH 20D,A02,083766,Staff,12,0,30,18
1650120836808,MATH 20D,A03,083767,Staff,28,0,30,2
1650120842906,MATH 20E,A01,083771,Staff,10,0,30,20
1650120842906,MATH 20E,A02,083772,Staff,20,0,30,10
1650120842906,MATH 20E,B01,083773,Staff,0,0,30,30
1650120842906,MATH 20E,B02,083774,Staff,13,0,30,17
1650120848937,MATH 103A,A01,083777,Staff,0,8,30,30
1650120848937,MATH 103A,A02,083778,Staff,0,7,30,30
1650120848937,MATH 103A,B01,083779,Staff,0,9,30,30
1650120848937,MATH 103A,B02,083780,Staff,0,6,30,30
1650120854963,MATH 105,A01,085443,Staff,0,13,30,30
1650120860989,MATH 109,A01,083213,Anzaldo; Leesa B,0,3,30,30
1650120860989,MATH 109,A02,083214,Anzaldo; Leesa B,0,5,30,30
1650120860989,MATH 109,B01,083215,Anzaldo; Leesa B,0,4,30,30
1650120860989,MATH 109,B02,083216,Anzaldo; Leesa B,0,4,30,30
1650120867014,MATH 142A,A01,083219,Chow; Bennett,0,10,30,30
1650120867014,MATH 142A,A02,083220,Chow; Bennett,0,10,30,30
1650120867014,MATH 142A,B01,083221,Chow; Bennett,0,10,30,30
1650120867014,MATH 142A,B02,083222,Chow; Bennett,0,9,30,30
1650120873045,MATH 193A,A01,083224,Staff,0,4,30,30
1650120873045,MATH 193A,A02,083225,Staff,0,4,30,30
1650120873045,MATH 193A,A03,083781,Staff,0,0,30,30
1650120873045,MATH 193A,A04,083782,Staff,2,0,30,28
1650120879072,MATH 197,001,091859,McAuley; Julian John,9998,0,9999,1
1650120885132,COGS 9,A01,083615,Staff,0,14,60,60
1650120891176,COGS 11,A01,083617,Boyle; Mary E. T.,24,0,40,16
1650120897215,COGS 13,A01,083071,Staff,0,28,40,40
1650120903239,COGS 14A,A01,092681,Staff,0,10,100,100
1650120909294,COGS 14B,A01,083073,Cheng; Tzu-Han,0,4,50,50
1650120915316,COGS 17,A01,092677,Staff,35,0,75,40
1650120921341,COGS 100,A01,083619,Staff,0,21,60,60
1650120927367,COGS 101A,A01,083621,Davis; Joshua Daniel,0,18,60,60
1650120933391,COGS 101B,A01,091572,Staff,10,0,60,50
1650120939445,COGS 101C,A01,083625,Delgado; Tania,22,0,30,8
1650120945474,COGS 107A,A01,083627,Boyle; Mary E. T.,0,4,60,60
1650120951514,COGS 118A,A01,083075,Staff,17,0,60,43
1650120957540,CSE 3,A50,083646,Miranda; Gregory Joseph,22,0,38,16
1650120957540,CSE 3,A51,083647,Miranda; Gregory Joseph,37,0,37,0
1650120963567,CSE 8A,A50,083650,Miranda; Gregory Joseph,0,15,40,40
1650120969590,CSE 11,A01,083080,Cao; Yingjun,0,66,40,40
1650120975630,CSE 12,A01,083652,Staff,0,2,100,100
1650120981655,CSE 15L,A01,083654,Staff,0,0,50,50
1650120981655,CSE 15L,A02,083655,Staff,10,0,50,40
1650120987680,CSE 20,A01,083657,Staff,58,0,80,22
1650120993708,CSE 30,A01,083084,Eldon; John,0,63,40,40
1650120999738,CSE 100,A01,083659,Cao; Yingjun,0,61,50,50
1650121005770,CSE 134B,A01,083661,Powell; Thomas Allan,0,27,65,65
1650121011798,CSE 140,A01,083663,Staff,4,0,75,71
1650121017822,CSE 140L,A01,083088,Eldon; John,0,1,75,75
1650121023847,CSE 175,A01,083665,Kumar; Rakesh,8,0,25,17
1650121029875,CSE 190,A00,092507,Dubnov; Shlomo,14,0,20,6
1650121035899,ECE 45,A01,083139,Staff,0,13,40,40
1650121041928,ECE 65,A50,083695,Staff,0,4,30,30
1650121047957,ECE 109,A01,091882,Touri; Behrouz,48,0,70,22
1650121053983,ECE 180,A00,083140,Abi Samra; Nicholas Camill,24,0,30,6
1650121053983,ECE 180,B00,083141,Abi Samra; Nicholas Camill,8,0,30,22
1650121060024,MATH 10A,A01,083735,Patchell; Gregory David,12,0,30,18
1650121060024,MATH 10A,A02,083736,Patchell; Gregory David,28,0,30,2
1650121060024,MATH 10A,A03,083737,Patchell; Gregory David,26,0,30,4
1650121066056,MATH 10B,A01,083207,Staff,0,5,30,30
1650121066056,MATH 10B,A02,083208,Staff,0,4,30,30
1650121066056,MATH 10B,B01,083739,Staff,18,0,30,12
1650121066056,MATH 10B,B02,083740,Staff,29,0,30,1
1650121072088,MATH 18,A01,083743,Staff,10,0,30,20
1650121072088,MATH 18,A02,083744,Staff,28,0,30,2
1650121072088,MATH 18,A03,083745,Staff,23,0,30,7
1650121072088,MATH 18,A04,083746,Staff,27,0,30,3
1650121072088,MATH 18,B01,083748,Staff,0,9,30,30
1650121072088,MATH 18,B02,083749,Staff,0,7,30,30
1650121072088,MATH 18,B03,083750,Staff,0,6,30,30
1650121072088,MATH 18,B04,083751,Staff,0,6,30,30
1650121078116,MATH 20A,A01,083754,Staff,26,0,40,14
1650121084147,MATH 20B,A01,083756,Staff,0,5,30,30
1650121084147,MATH 20B,A02,083757,Staff,0,2,30,30
1650121090176,MATH 20C,A01,083760,Staff,0,11,30,30
1650121090176,MATH 20C,A02,083761,Staff,0,12,30,30
1650121090176,MATH 20C,B01,083762,Staff,14,0,30,16
1650121090176,MATH 20C,B02,083763,Staff,28,0,30,2
1650121096205,MATH 20D,A01,083765,Staff,0,2,30,30
1650121096205,MATH 20D,A02,083766,Staff,12,0,30,18
1650121096205,MATH 20D,A03,083767,Staff,28,0,30,2
1650121102237,MATH 20E,A01,083771,Staff,10,0,30,20
1650121102237,MATH 20E,A02,083772,Staff,20,0,30,10
1650121102237,MATH 20E,B01,083773,Staff,0,0,30,30
1650121102237,MATH 20E,B02,083774,Staff,13,0,30,17
1650121108269,MATH 103A,A01,083777,Staff,0,8,30,30
1650121108269,MATH 103A,A02,083778,Staff,0,7,30,30
1650121108269,MATH 103A,B01,083779,Staff,0,9,30,30
1650121108269,MATH 103A,B02,083780,Staff,0,6,30,30
1650121114298,MATH 105,A01,085443,Staff,0,13,30,30
1650121120324,MATH 109,A01,083213,Anzaldo; Leesa B,0,3,30,30
1650121120324,MATH 109,A02,083214,Anzaldo; Leesa B,0,5,30,30
1650121120324,MATH 109,B01,083215,Anzaldo; Leesa B,0,4,30,30
1650121120324,MATH 109,B02,083216,Anzaldo; Leesa B,0,4,30,30
1650121126348,MATH 142A,A01,083219,Chow; Bennett,0,10,30,30
1650121126348,MATH 142A,A02,083220,Chow; Bennett,0,10,30,30
1650121126348,MATH 142A,B01,083221,Chow; Bennett,0,10,30,30
1650121126348,MATH 142A,B02,083222,Chow; Bennett,0,9,30,30
1650121132374,MATH 193A,A01,083224,Staff,0,4,30,30
1650121132374,MATH 193A,A02,083225,Staff,0,4,30,30
1650121132374,MATH 193A,A03,083781,Staff,0,0,30,30
1650121132374,MATH 193A,A04,083782,Staff,2,0,30,28
1650121138400,MATH 197,001,091859,McAuley; Julian John,9998,0,9999,1
1650121144474,COGS 9,A01,083615,Staff,0,14,60,60
1650121150500,COGS 11,A01,083617,Boyle; Mary E. T.,24,0,40,16
1650121156532,COGS 13,A01,083071,Staff,0,28,40,40
1650121162560,COGS 14A,A01,092681,Staff,0,10,100,100
1650121168586,COGS 14B,A01,083073,Cheng; Tzu-Han,0,4,50,50
1650121174611,COGS 17,A01,092677,Staff,35,0,75,40
1650121180636,COGS 100,A01,083619,Staff,0,21,60,60
1650121186662,COGS 101A,A01,083621,Davis; Joshua Daniel,0,18,60,60
1650121192688,COGS 101B,A01,091572,Staff,10,0,60,50
1650121198714,COGS 101C,A01,083625,Delgado; Tania,22,0,30,8
1650121204739,COGS 107A,A01,083627,Boyle; Mary E. T.,0,4,60,60
1650121210763,COGS 118A,A01,083075,Staff,17,0,60,43
1650121216790,CSE 3,A50,083646,Miranda; Gregory Joseph,22,0,38,16
1650121216790,CSE 3,A51,083647,Miranda; Gregory Joseph,37,0,37,0
1650121222815,CSE 8A,A50,083650,Miranda; Gregory Joseph,0,15,40,40
1650121228845,CSE 11,A01,083080,Cao; Yingjun,0,66,40,40
1650121234868,CSE 12,A01,083652,Staff,0,2,100,100
1650121240925,CSE 15L,A01,083654,Staff,0,0,50,50
1650121240925,CSE 15L,A02,083655,Staff,10,0,50,40
1650121246953,CSE 20,A01,083657,Staff,58,0,80,22
1650121252982,CSE 30,A01,083084,Eldon; John,0,63,40,40
1650121259012,CSE 100,A01,083659,Cao; Yingjun,0,61,50,50
1650121265037,CSE 134B,A01,083661,Powell; Thomas Allan,0,27,65,65
1650121271094,CSE 140,A01,083663,Staff,4,0,75,71
1650121277118,CSE 140L,A01,083088,Eldon; John,0,1,75,75
1650121283148,CSE 175,A01,083665,Kumar; Rakesh,8,0,25,17
1650121289173,CSE 190,A00,092507,Dubnov; Shlomo,14,0,20,6
1650121295201,ECE 45,A01,083139,Staff,0,13,40,40
1650121301227,ECE 65,A50,083695,Staff,0,4,30,30
1650121307259,ECE 109,A01,091882,Touri; Behrouz,48,0,70,22
1650121313283,ECE 180,A00,083140,Abi Samra; Nicholas Camill,24,0,30,6
1650121313283,ECE 180,B00,083141,Abi Samra; Nicholas Camill,8,0,30,22
1650121319315,MATH 10A,A01,083735,Patchell; Gregory David,12,0,30,18
1650121319315,MATH 10A,A02,083736,Patchell; Gregory David,28,0,30,2
1650121319315,MATH 10A,A03,083737,Patchell; Gregory David,26,0,30,4
1650121325344,MATH 10B,A01,083207,Staff,0,5,30,30
1650121325344,MATH 10B,A02,083208,Staff,0,4,30,30
1650121325344,MATH 10B,B01,083739,Staff,18,0,30,12
1650121325344,MATH 10B,B02,083740,Staff,29,0,30,1
1650121331371,MATH 18,A01,083743,Staff,10,0,30,20
1650121331371,MATH 18,A02,083744,Staff,28,0,30,2
1650121331371,MATH 18,A03,083745,Staff,23,0,30,7
1650121331371,MATH 18,A04,083746,Staff,27,0,30,3
1650121331371,MATH 18,B01,083748,Staff,0,9,30,30
1650121331371,MATH 18,B02,083749,Staff,0,7,30,30
1650121331371,MATH 18,B03,083750,Staff,0,6,30,30
1650121331371,MATH 18,B04,083751,Staff,0,6,30,30
1650121337398,MATH 20A,A01,083754,Staff,26,0,40,14
1650121343427,MATH 20B,A01,083756,Staff,0,5,30,30
1650121343427,MATH 20B,A02,083757,Staff,0,2,30,30
1650121349454,MATH 20C,A01,083760,Staff,0,11,30,30
1650121349454,MATH 20C,A02,083761,Staff,0,12,30,30
1650121349454,MATH 20C,B01,083762,Staff,14,0,30,16
1650121349454,MATH 20C,B02,083763,Staff,28,0,30,2
1650121355477,MATH 20D,A01,083765,Staff,0,2,30,30
1650121355477,MATH 20D,A02,083766,Staff,12,0,30,18
1650121355477,MATH 20D,A03,083767,Staff,28,0,30,2
1650121361502,MATH 20E,A01,083771,Staff,10,0,30,20
1650121361502,MATH 20E,A02,083772,Staff,20,0,30,10
1650121361502,MATH 20E,B01,083773,Staff,0,0,30,30
1650121361502,MATH 20E,B02,083774,Staff,13,0,30,17
1650121367533,MATH 103A,A01,083777,Staff,0,8,30,30
1650121367533,MATH 103A,A02,083778,Staff,0,7,30,30
1650121367533,MATH 103A,B01,083779,Staff,0,9,30,30
1650121367533,MATH 103A,B02,083780,Staff,0,6,30,30
1650121373570,MATH 105,A01,085443,Staff,0,13,30,30
1650121379596,MATH 109,A01,083213,Anzaldo; Leesa B,0,3,30,30
1650121379596,MATH 109,A02,083214,Anzaldo; Leesa B,0,5,30,30
1650121379596,MATH 109,B01,083215,Anzaldo; Leesa B,0,4,30,30
1650121379596,MATH 109,B02,083216,Anzaldo; Leesa B,0,4,30,30
1650121385622,MATH 142A,A01,083219,Chow; Bennett,0,10,30,30
1650121385622,MATH 142A,A02,083220,Chow; Bennett,0,10,30,30
1650121385622,MATH 142A,B01,083221,Chow; Bennett,0,10,30,30
1650121385622,MATH 142A,B02,083222,Chow; Bennett,0,9,30,30
1650121391652,MATH 193A,A01,083224,Staff,0,4,30,30
1650121391652,MATH 193A,A02,083225,Staff,0,4,30,30
1650121391652,MATH 193A,A03,083781,Staff,0,0,30,30
1650121391652,MATH 193A,A04,083782,Staff,2,0,30,28
1650121397684,MATH 197,001,091859,McAuley; Julian John,9998,0,9999,1
1650121403764,COGS 9,A01,083615,Staff,0,14,60,60
1650121409794,COGS 11,A01,083617,Boyle; Mary E. T.,24,0,40,16
1650121415819,COGS 13,A01,083071,Staff,0,28,40,40
1650121421847,COGS 14A,A01,092681,Staff,0,10,100,100
1650121427872,COGS 14B,A01,083073,Cheng; Tzu-Han,0,4,50,50
1650121433968,COGS 17,A01,092677,Staff,35,0,75,40
1650121439993,COGS 100,A01,083619,Staff,0,21,60,60
1650121446018,COGS 101A,A01,083621,Davis; Joshua Daniel,0,18,60,60
1650121452043,COGS 101B,A01,091572,Staff,10,0,60,50
1650121458069,COGS 101C,A01,083625,Delgado; Tania,22,0,30,8
1650121464091,COGS 107A,A01,083627,Boyle; Mary E. T.,0,4,60,60
1650121470116,COGS 118A,A01,083075,Staff,17,0,60,43
1650121476142,CSE 3,A50,083646,Miranda; Gregory Joseph,22,0,38,16
1650121476142,CSE 3,A51,083647,Miranda; Gregory Joseph,37,0,37,0
1650121482173,CSE 8A,A50,083650,Miranda; Gregory Joseph,0,15,40,40
1650121488201,CSE 11,A01,083080,Cao; Yingjun,0,66,40,40
1650121494226,CSE 12,A01,083652,Staff,0,2,100,100
1650121500254,CSE 15L,A01,083654,Staff,0,0,50,50
1650121500254,CSE 15L,A02,083655,Staff,10,0,50,40
1650121506278,CSE 20,A01,083657,Staff,58,0,80,22
1650121512301,CSE 30,A01,083084,Eldon; John,0,63,40,40
1650121518330,CSE 100,A01,083659,Cao; Yingjun,0,61,50,50
1650121524362,CSE 134B,A01,083661,Powell; Thomas Allan,0,27,65,65
1650121530386,CSE 140,A01,083663,Staff,4,0,75,71
1650121536411,CSE 140L,A01,083088,Eldon; John,0,1,75,75
1650121542437,CSE 175,A01,083665,Kumar; Rakesh,8,0,25,17
1650121548461,CSE 190,A00,092507,Dubnov; Shlomo,14,0,20,6
1650121554487,ECE 45,A01,083139,Staff,0,13,40,40
1650121560518,ECE 65,A50,083695,Staff,0,4,30,30
1650121566551,ECE 109,A01,091882,Touri; Behrouz,48,0,70,22
1650121572581,ECE 180,A00,083140,Abi Samra; Nicholas Camill,24,0,30,6
1650121572581,ECE 180,B00,083141,Abi Samra; Nicholas Camill,8,0,30,22
1650121578614,MATH 10A,A01,083735,Patchell; Gregory David,12,0,30,18
1650121578614,MATH 10A,A02,083736,Patchell; Gregory David,28,0,30,2
1650121578614,MATH 10A,A03,083737,Patchell; Gregory David,26,0,30,4
1650121584643,MATH 10B,A01,083207,Staff,0,5,30,30
1650121584643,MATH 10B,A02,083208,Staff,0,4,30,30
1650121584643,MATH 10B,B01,083739,Staff,18,0,30,12
1650121584643,MATH 10B,B02,083740,Staff,29,0,30,1
1650121590674,MATH 18,A01,083743,Staff,10,0,30,20
1650121590674,MATH 18,A02,083744,Staff,28,0,30,2
1650121590674,MATH 18,A03,083745,Staff,23,0,30,7
1650121590674,MATH 18,A04,083746,Staff,27,0,30,3
1650121590674,MATH 18,B01,083748,Staff,0,9,30,30
1650121590674,MATH 18,B02,083749,Staff,0,7,30,30
1650121590674,MATH 18,B03,083750,Staff,0,6,30,30
1650121590674,MATH 18,B04,083751,Staff,0,6,30,30
1650121596701,MATH 20A,A01,083754,Staff,26,0,40,14
1650121602726,MATH 20B,A01,083756,Staff,0,5,30,30
1650121602726,MATH 20B,A02,083757,Staff,0,2,30,30
1650121608755,MATH 20C,A01,083760,Staff,0,11,30,30
1650121608755,MATH 20C,A02,083761,Staff,0,12,30,30
1650121608755,MATH 20C,B01,083762,Staff,14,0,30,16
1650121608755,MATH 20C,B02,083763,Staff,28,0,30,2
1650121614788,MATH 20D,A01,083765,Staff,0,2,30,30
1650121614788,MATH 20D,A02,083766,Staff,12,0,30,18
1650121614788,MATH 20D,A03,083767,Staff,28,0,30,2
1650121620816,MATH 20E,A01,083771,Staff,10,0,30,20
1650121620816,MATH 20E,A02,083772,Staff,20,0,30,10
1650121620816,MATH 20E,B01,083773,Staff,0,0,30,30
1650121620816,MATH 20E,B02,083774,Staff,13,0,30,17
1650121626849,MATH 103A,A01,083777,Staff,0,8,30,30
1650121626849,MATH 103A,A02,083778,Staff,0,7,30,30
1650121626849,MATH 103A,B01,083779,Staff,0,9,30,30
1650121626849,MATH 103A,B02,083780,Staff,0,6,30,30
1650121632875,MATH 105,A01,085443,Staff,0,13,30,30
1650121638901,MATH 109,A01,083213,Anzaldo; Leesa B,0,3,30,30
1650121638901,MATH 109,A02,083214,Anzaldo; Leesa B,0,5,30,30
1650121638901,MATH 109,B01,083215,Anzaldo; Leesa B,0,4,30,30
1650121638901,MATH 109,B02,083216,Anzaldo; Leesa B,0,4,30,30
1650121644927,MATH 142A,A01,083219,Chow; Bennett,0,10,30,30
1650121644927,MATH 142A,A02,083220,Chow; Bennett,0,10,30,30
1650121644927,MATH 142A,B01,083221,Chow; Bennett,0,10,30,30
1650121644927,MATH 142A,B02,083222,Chow; Bennett,0,9,30,30
1650121650953,MATH 193A,A01,083224,Staff,0,4,30,30
1650121650953,MATH 193A,A02,083225,Staff,0,4,30,30
1650121650953,MATH 193A,A03,083781,Staff,0,0,30,30
1650121650953,MATH 193A,A04,083782,Staff,2,0,30,28
1650121656977,MATH 197,001,091859,McAuley; Julian John,9998,0,9999,1
1650121663051,COGS 9,A01,083615,Staff,0,14,60,60
1650121669075,COGS 11,A01,083617,Boyle; Mary E. T.,24,0,40,16
1650121675105,COGS 13,A01,083071,Staff,0,28,40,40
1650121681130,COGS 14A,A01,092681,Staff,0,10,100,100
1650121687159,COGS 14B,A01,083073,Cheng; Tzu-Han,0,4,50,50
1650121693187,COGS 17,A01,092677,Staff,35,0,75,40
1650121699210,COGS 100,A01,083619,Staff,0,21,60,60
1650121705238,COGS 101A,A01,083621,Davis; Joshua Daniel,0,18,60,60
1650121711266,COGS 101B,A01,091572,Staff,10,0,60,50
1650121717295,COGS 101C,A01,083625,Delgado; Tania,22,0,30,8
1650121723321,COGS 107A,A01,083627,Boyle; Mary E. T.,0,4,60,60
1650121729346,COGS 118A,A01,083075,Staff,17,0,60,43
1650121735381,CSE 3,A50,083646,Miranda; Gregory Joseph,22,0,38,16
1650121735381,CSE 3,A51,083647,Miranda; Gregory Joseph,37,0,37,0
1650121741406,CSE 8A,A50,083650,Miranda; Gregory Joseph,0,15,40,40
1650121747432,CSE 11,A01,083080,Cao; Yingjun,0,66,40,40
1650121753460,CSE 12,A01,083652,Staff,0,2,100,100
1650121759485,CSE 15L,A01,083654,Staff,0,0,50,50
1650121759485,CSE 15L,A02,083655,Staff,10,0,50,40
1650121765514,CSE 20,A01,083657,Staff,58,0,80,22
1650121771540,CSE 30,A01,083084,Eldon; John,0,63,40,40
1650121777579,CSE 100,A01,083659,Cao; Yingjun,0,61,50,50
1650121783618,CSE 134B,A01,083661,Powell; Thomas Allan,0,27,65,65
1650121789643,CSE 140,A01,083663,Staff,4,0,75,71
1650121795673,CSE 140L,A01,083088,Eldon; John,0,1,75,75
1650121801698,CSE 175,A01,083665,Kumar; Rakesh,8,0,25,17
1650121807721,CSE 190,A00,092507,Dubnov; Shlomo,14,0,20,6
1650121813745,ECE 45,A01,083139,Staff,0,13,40,40
1650121819769,ECE 65,A50,083695,Staff,0,4,30,30
1650121825795,ECE 109,A01,091882,Touri; Behrouz,48,0,70,22
1650121831818,ECE 180,A00,083140,Abi Samra; Nicholas Camill,24,0,30,6
1650121831818,ECE 180,B00,083141,Abi Samra; Nicholas Camill,8,0,30,22
1650121837848,MATH 10A,A01,083735,Patchell; Gregory David,12,0,30,18
1650121837848,MATH 10A,A02,083736,Patchell; Gregory David,28,0,30,2
1650121837848,MATH 10A,A03,083737,Patchell; Gregory David,26,0,30,4
1650121843878,MATH 10B,A01,083207,Staff,0,5,30,30
1650121843878,MATH 10B,A02,083208,Staff,0,4,30,30
1650121843878,MATH 10B,B01,083739,Staff,18,0,30,12
1650121843878,MATH 10B,B02,083740,Staff,29,0,30,1
1650121849907,MATH 18,A01,083743,Staff,10,0,30,20
1650121849907,MATH 18,A02,083744,Staff,28,0,30,2
1650121849907,MATH 18,A03,083745,Staff,23,0,30,7
1650121849907,MATH 18,A04,083746,Staff,27,0,30,3
1650121849907,MATH 18,B01,083748,Staff,0,9,30,30
1650121849907,MATH 18,B02,083749,Staff,0,7,30,30
1650121849907,MATH 18,B03,083750,Staff,0,6,30,30
1650121849907,MATH 18,B04,083751,Staff,0,6,30,30
1650121855935,MATH 20A,A01,083754,Staff,26,0,40,14
1650121861965,MATH 20B,A01,083756,Staff,0,5,30,30
1650121861965,MATH 20B,A02,083757,Staff,0,2,30,30
1650121868003,MATH 20C,A01,083760,Staff,0,11,30,30
1650121868003,MATH 20C,A02,083761,Staff,0,12,30,30
1650121868003,MATH 20C,B01,083762,Staff,14,0,30,16
1650121868003,MATH 20C,B02,083763,Staff,28,0,30,2
1650121874028,MATH 20D,A01,083765,Staff,0,2,30,30
1650121874028,MATH 20D,A02,083766,Staff,12,0,30,18
1650121874028,MATH 20D,A03,083767,Staff,28,0,30,2
1650121880064,MATH 20E,A01,083771,Staff,10,0,30,20
1650121880064,MATH 20E,A02,083772,Staff,20,0,30,10
1650121880064,MATH 20E,B01,083773,Staff,0,0,30,30
1650121880064,MATH 20E,B02,083774,Staff,13,0,30,17
1650121886096,MATH 103A,A01,083777,Staff,0,8,30,30
1650121886096,MATH 103A,A02,083778,Staff,0,7,30,30
1650121886096,MATH 103A,B01,083779,Staff,0,9,30,30
1650121886096,MATH 103A,B02,083780,Staff,0,6,30,30
1650121892120,MATH 105,A01,085443,Staff,0,13,30,30
1650121898147,MATH 109,A01,083213,Anzaldo; Leesa B,0,3,30,30
1650121898147,MATH 109,A02,083214,Anzaldo; Leesa B,0,5,30,30
1650121898147,MATH 109,B01,083215,Anzaldo; Leesa B,0,4,30,30
1650121898147,MATH 109,B02,083216,Anzaldo; Leesa B,0,4,30,30
1650121904172,MATH 142A,A01,083219,Chow; Bennett,0,10,30,30
1650121904172,MATH 142A,A02,083220,Chow; Bennett,0,10,30,30
1650121904172,MATH 142A,B01,083221,Chow; Bennett,0,10,30,30
1650121904172,MATH 142A,B02,083222,Chow; Bennett,0,9,30,30
1650121910197,MATH 193A,A01,083224,Staff,0,4,30,30
1650121910197,MATH 193A,A02,083225,Staff,0,4,30,30
1650121910197,MATH 193A,A03,083781,Staff,0,0,30,30
1650121910197,MATH 193A,A04,083782,Staff,2,0,30,28
1650121916227,MATH 197,001,091859,McAuley; Julian John,9998,0,9999,1
1650121922289,COGS 9,A01,083615,Staff,0,14,60,60
1650121928312,COGS 11,A01,083617,Boyle; Mary E. T.,24,0,40,16
1650121934346,COGS 13,A01,083071,Staff,0,28,40,40
1650121940370,COGS 14A,A01,092681,Staff,0,10,100,100
1650121946400,COGS 14B,A01,083073,Cheng; Tzu-Han,0,4,50,50
1650121952425,COGS 17,A01,092677,Staff,35,0,75,40
1650121958454,COGS 100,A01,083619,Staff,0,21,60,60
1650121964478,COGS 101A,A01,083621,Davis; Joshua Daniel,0,18,60,60
1650121970509,COGS 101B,A01,091572,Staff,10,0,60,50
1650121976534,COGS 101C,A01,083625,Delgado; Tania,22,0,30,8
1650121982557,COGS 107A,A01,083627,Boyle; Mary E. T.,0,4,60,60
1650121988582,COGS 118A,A01,083075,Staff,17,0,60,43
1650121994613,CSE 3,A50,083646,Miranda; Gregory Joseph,22,0,38,16
1650121994613,CSE 3,A51,083647,Miranda; Gregory Joseph,37,0,37,0
1650122000643,CSE 8A,A50,083650,Miranda; Gregory Joseph,0,15,40,40
1650122006681,CSE 11,A01,083080,Cao; Yingjun,0,66,40,40
1650122012710,CSE 12,A01,083652,Staff,0,2,100,100
1650122018737,CSE 15L,A01,083654,Staff,0,0,50,50
1650122018737,CSE 15L,A02,083655,Staff,10,0,50,40
1650122024761,CSE 20,A01,083657,Staff,58,0,80,22
1650122030859,CSE 30,A01,083084,Eldon; John,0,63,40,40
1650122036883,CSE 100,A01,083659,Cao; Yingjun,0,61,50,50
1650122042911,CSE 134B,A01,083661,Powell; Thomas Allan,0,27,65,65
1650122048940,CSE 140,A01,083663,Staff,4,0,75,71
1650122054963,CSE 140L,A01,083088,Eldon; John,0,1,75,75
1650122060988,CSE 175,A01,083665,Kumar; Rakesh,8,0,25,17
1650122067013,CSE 190,A00,092507,Dubnov; Shlomo,14,0,20,6
1650122073038,ECE 45,A01,083139,Staff,0,13,40,40
1650122079064,ECE 65,A50,083695,Staff,0,4,30,30
1650122085090,ECE 109,A01,091882,Touri; Behrouz,48,0,70,22
1650122091118,ECE 180,A00,083140,Abi Samra; Nicholas Camill,24,0,30,6
1650122091118,ECE 180,B00,083141,Abi Samra; Nicholas Camill,8,0,30,22
1650122097145,MATH 10A,A01,083735,Patchell; Gregory David,12,0,30,18
1650122097145,MATH 10A,A02,083736,Patchell; Gregory David,28,0,30,2
1650122097145,MATH 10A,A03,083737,Patchell; Gregory David,26,0,30,4
1650122103173,MATH 10B,A01,083207,Staff,0,5,30,30
1650122103173,MATH 10B,A02,083208,Staff,0,4,30,30
1650122103173,MATH 10B,B01,083739,Staff,18,0,30,12
1650122103173,MATH 10B,B02,083740,Staff,29,0,30,1
1650122109209,MATH 18,A01,083743,Staff,10,0,30,20
1650122109209,MATH 18,A02,083744,Staff,28,0,30,2
1650122109209,MATH 18,A03,083745,Staff,23,0,30,7
1650122109209,MATH 18,A04,083746,Staff,27,0,30,3
1650122109209,MATH 18,B01,083748,Staff,0,9,30,30
1650122109209,MATH 18,B02,083749,Staff,0,7,30,30
1650122109209,MATH 18,B03,083750,Staff,0,6,30,30
1650122109209,MATH 18,B04,083751,Staff,0,6,30,30
1650122115236,MATH 20A,A01,083754,Staff,26,0,40,14
1650122121268,MATH 20B,A01,083756,Staff,0,5,30,30
1650122121268,MATH 20B,A02,083757,Staff,0,2,30,30
1650122127295,MATH 20C,A01,083760,Staff,0,11,30,30
1650122127295,MATH 20C,A02,083761,Staff,0,12,30,30
1650122127295,MATH 20C,B01,083762,Staff,14,0,30,16
1650122127295,MATH 20C,B02,083763,Staff,28,0,30,2
1650122133323,MATH 20D,A01,083765,Staff,0,2,30,30
1650122133323,MATH 20D,A02,083766,Staff,12,0,30,18
1650122133323,MATH 20D,A03,083767,Staff,28,0,30,2
1650122139353,MATH 20E,A01,083771,Staff,10,0,30,20
1650122139353,MATH 20E,A02,083772,Staff,20,0,30,10
1650122139353,MATH 20E,B01,083773,Staff,0,0,30,30
1650122139353,MATH 20E,B02,083774,Staff,13,0,30,17
1650122145387,MATH 103A,A01,083777,Staff,0,8,30,30
1650122145387,MATH 103A,A02,083778,Staff,0,7,30,30
1650122145387,MATH 103A,B01,083779,Staff,0,9,30,30
1650122145387,MATH 103A,B02,083780,Staff,0,6,30,30
1650122151412,MATH 105,A01,085443,Staff,0,13,30,30
1650122157454,MATH 109,A01,083213,Anzaldo; Leesa B,0,3,30,30
1650122157454,MATH 109,A02,083214,Anzaldo; Leesa B,0,5,30,30
1650122157454,MATH 109,B01,083215,Anzaldo; Leesa B,0,4,30,30
1650122157454,MATH 109,B02,083216,Anzaldo; Leesa B,0,4,30,30
1650122163484,MATH 142A,A01,083219,Chow; Bennett,0,10,30,30
1650122163484,MATH 142A,A02,083220,Chow; Bennett,0,10,30,30
1650122163484,MATH 142A,B01,083221,Chow; Bennett,0,10,30,30
1650122163484,MATH 142A,B02,083222,Chow; Bennett,0,9,30,30
1650122169511,MATH 193A,A01,083224,Staff,0,4,30,30
1650122169511,MATH 193A,A02,083225,Staff,0,4,30,30
1650122169511,MATH 193A,A03,083781,Staff,0,0,30,30
1650122169511,MATH 193A,A04,083782,Staff,2,0,30,28
1650122175540,MATH 197,001,091859,McAuley; Julian John,9998,0,9999,1
1650122181616,COGS 9,A01,083615,Staff,0,14,60,60
1650122187641,COGS 11,A01,083617,Boyle; Mary E. T.,24,0,40,16
1650122193665,COGS 13,A01,083071,Staff,0,28,40,40
1650122199694,COGS 14A,A01,092681,Staff,0,10,100,100
1650122205721,COGS 14B,A01,083073,Cheng; Tzu-Han,0,4,50,50
1650122211744,COGS 17,A01,092677,Staff,35,0,75,40
1650122217780,COGS 100,A01,083619,Staff,0,21,60,60
1650122223804,COGS 101A,A01,083621,Davis; Joshua Daniel,0,18,60,60
1650122229829,COGS 101B,A01,091572,Staff,10,0,60,50
1650122235852,COGS 101C,A01,083625,Delgado; Tania,22,0,30,8
1650122241878,COGS 107A,A01,083627,Boyle; Mary E. T.,0,4,60,60
1650122247900,COGS 118A,A01,083075,Staff,17,0,60,43
1650122253929,CSE 3,A50,083646,Miranda; Gregory Joseph,22,0,38,16
1650122253929,CSE 3,A51,083647,Miranda; Gregory Joseph,37,0,37,0
1650122259958,CSE 8A,A50,083650,Miranda; Gregory Joseph,0,15,40,40
1650122265983,CSE 11,A01,083080,Cao; Yingjun,0,66,40,40
1650122272009,CSE 12,A01,083652,Staff,0,2,100,100
1650122278037,CSE 15L,A01,083654,Staff,0,0,50,50
1650122278037,CSE 15L,A02,083655,Staff,10,0,50,40
1650122284064,CSE 20,A01,083657,Staff,58,0,80,22
1650122290090,CSE 30,A01,083084,Eldon; John,0,63,40,40
1650122296114,CSE 100,A01,083659,Cao; Yingjun,0,61,50,50
1650122302138,CSE 134B,A01,083661,Powell; Thomas Allan,0,27,65,65
1650122308166,CSE 140,A01,083663,Staff,4,0,75,71
1650122314193,CSE 140L,A01,083088,Eldon; John,0,1,75,75
1650122320224,CSE 175,A01,083665,Kumar; Rakesh,8,0,25,17
1650122326248,CSE 190,A00,092507,Dubnov; Shlomo,14,0,20,6
1650122332272,ECE 45,A01,083139,Staff,0,13,40,40
1650122338299,ECE 65,A50,083695,Staff,0,4,30,30
1650122344330,ECE 109,A01,091882,Touri; Behrouz,48,0,70,22
1650122350366,ECE 180,A00,083140,Abi Samra; Nicholas Camill,24,0,30,6
1650122350366,ECE 180,B00,083141,Abi Samra; Nicholas Camill,8,0,30,22
1650122356396,MATH 10A,A01,083735,Patchell; Gregory David,12,0,30,18
1650122356396,MATH 10A,A02,083736,Patchell; Gregory David,28,0,30,2
1650122356396,MATH 10A,A03,083737,Patchell; Gregory David,26,0,30,4
1650122362424,MATH 10B,A01,083207,Staff,0,5,30,30
1650122362424,MATH 10B,A02,083208,Staff,0,4,30,30
1650122362424,MATH 10B,B01,083739,Staff,18,0,30,12
1650122362424,MATH 10B,B02,083740,Staff,29,0,30,1
1650122368450,MATH 18,A01,083743,Staff,10,0,30,20
1650122368450,MATH 18,A02,083744,Staff,28,0,30,2
1650122368450,MATH 18,A03,083745,Staff,23,0,30,7
1650122368450,MATH 18,A04,083746,Staff,27,0,30,3
1650122368450,MATH 18,B01,083748,Staff,0,9,30,30
1650122368450,MATH 18,B02,083749,Staff,0,7,30,30
1650122368450,MATH 18,B03,083750,Staff,0,6,30,30
1650122368450,MATH 18,B04,083751,Staff,0,6,30,30
1650122374479,MATH 20A,A01,083754,Staff,26,0,40,14
1650122380501,MATH 20B,A01,083756,Staff,0,5,30,30
1650122380501,MATH 20B,A02,083757,Staff,0,2,30,30
1650122386529,MATH 20C,A01,083760,Staff,0,11,30,30
1650122386529,MATH 20C,A02,083761,Staff,0,12,30,30
1650122386529,MATH 20C,B01,083762,Staff,14,0,30,16
1650122386529,MATH 20C,B02,083763,Staff,28,0,30,2
1650122392555,MATH 20D,A01,083765,Staff,0,2,30,30
1650122392555,MATH 20D,A02,083766,Staff,12,0,30,18
1650122392555,MATH 20D,A03,083767,Staff,28,0,30,2
1650122398580,MATH 20E,A01,083771,Staff,10,0,30,20
1650122398580,MATH 20E,A02,083772,Staff,20,0,30,10
1650122398580,MATH 20E,B01,083773,Staff,0,0,30,30
1650122398580,MATH 20E,B02,083774,Staff,13,0,30,17
1650122404604,MATH 103A,A01,083777,Staff,0,8,30,30
1650122404604,MATH 103A,A02,083778,Staff,0,7,30,30
1650122404604,MATH 103A,B01,083779,Staff,0,9,30,30
1650122404604,MATH 103A,B02,083780,Staff,0,6,30,30
1650122410633,MATH 105,A01,085443,Staff,0,13,30,30
1650122416657,MATH 109,A01,083213,Anzaldo; Leesa B,0,3,30,30
1650122416657,MATH 109,A02,083214,Anzaldo; Leesa B,0,5,30,30
1650122416657,MATH 109,B01,083215,Anzaldo; Leesa B,0,4,30,30
1650122416657,MATH 109,B02,083216,Anzaldo; Leesa B,0,4,30,30
1650122422687,MATH 142A,A01,083219,Chow; Bennett,0,10,30,30
1650122422687,MATH 142A,A02,083220,Chow; Bennett,0,10,30,30
1650122422687,MATH 142A,B01,083221,Chow; Bennett,0,10,30,30
1650122422687,MATH 142A,B02,083222,Chow; Bennett,0,9,30,30
1650122428711,MATH 193A,A01,083224,Staff,0,4,30,30
1650122428711,MATH 193A,A02,083225,Staff,0,4,30,30
1650122428711,MATH 193A,A03,083781,Staff,0,0,30,30
1650122428711,MATH 193A,A04,083782,Staff,2,0,30,28
1650122434735,MATH 197,001,091859,McAuley; Julian John,9998,0,9999,1
1650122440788,COGS 9,A01,083615,Staff,0,14,60,60
1650122446815,COGS 11,A01,083617,Boyle; Mary E. T.,24,0,40,16
1650122452839,COGS 13,A01,083071,Staff,0,28,40,40
1650122458863,COGS 14A,A01,092681,Staff,0,10,100,100
1650122464888,COGS 14B,A01,083073,Cheng; Tzu-Han,0,4,50,50
1650122470915,COGS 17,A01,092677,Staff,35,0,75,40
1650122476950,COGS 100,A01,083619,Staff,0,21,60,60
1650122482975,COGS 101A,A01,083621,Davis; Joshua Daniel,0,18,60,60
1650122489007,COGS 101B,A01,091572,Staff,10,0,60,50
1650122495036,COGS 101C,A01,083625,Delgado; Tania,22,0,30,8
1650122501060,COGS 107A,A01,083627,Boyle; Mary E. T.,0,4,60,60
1650122507093,COGS 118A,A01,083075,Staff,17,0,60,43
1650122513118,CSE 3,A50,083646,Miranda; Gregory Joseph,22,0,38,16
1650122513118,CSE 3,A51,083647,Miranda; Gregory Joseph,37,0,37,0
1650122519144,CSE 8A,A50,083650,Miranda; Gregory Joseph,0,15,40,40
1650122525167,CSE 11,A01,083080,Cao; Yingjun,0,66,40,40
1650122531194,CSE 12,A01,083652,Staff,0,2,100,100
1650122537220,CSE 15L,A01,083654,Staff,0,0,50,50
1650122537220,CSE 15L,A02,083655,Staff,10,0,50,40
1650122543244,CSE 20,A01,083657,Staff,58,0,80,22
1650122549267,CSE 30,A01,083084,Eldon; John,0,63,40,40
1650122555292,CSE 100,A01,083659,Cao; Yingjun,0,61,50,50
1650122561319,CSE 134B,A01,083661,Powell; Thomas Allan,0,27,65,65
1650122567345,CSE 140,A01,083663,Staff,4,0,75,71
1650122573374,CSE 140L,A01,083088,Eldon; John,0,1,75,75
1650122579404,CSE 175,A01,083665,Kumar; Rakesh,8,0,25,17
1650122585432,CSE 190,A00,092507,Dubnov; Shlomo,14,0,20,6
1650122591461,ECE 45,A01,083139,Staff,0,13,40,40
1650122597490,ECE 65,A50,083695,Staff,0,4,30,30
1650122603514,ECE 109,A01,091882,Touri; Behrouz,48,0,70,22
1650122609540,ECE 180,A00,083140,Abi Samra; Nicholas Camill,24,0,30,6
1650122609540,ECE 180,B00,083141,Abi Samra; Nicholas Camill,8,0,30,22
1650122615572,MATH 10A,A01,083735,Patchell; Gregory David,12,0,30,18
1650122615572,MATH 10A,A02,083736,Patchell; Gregory David,28,0,30,2
1650122615572,MATH 10A,A03,083737,Patchell; Gregory David,26,0,30,4
1650122621598,MATH 10B,A01,083207,Staff,0,5,30,30
1650122621598,MATH 10B,A02,083208,Staff,0,4,30,30
1650122621598,MATH 10B,B01,083739,Staff,18,0,30,12
1650122621598,MATH 10B,B02,083740,Staff,29,0,30,1
1650122627703,MATH 18,A01,083743,Staff,10,0,30,20
1650122627703,MATH 18,A02,083744,Staff,28,0,30,2
1650122627703,MATH 18,A03,083745,Staff,23,0,30,7
1650122627703,MATH 18,A04,083746,Staff,27,0,30,3
1650122627703,MATH 18,B01,083748,Staff,0,9,30,30
1650122627703,MATH 18,B02,083749,Staff,0,7,30,30
1650122627703,MATH 18,B03,083750,Staff,0,6,30,30
1650122627703,MATH 18,B04,083751,Staff,0,6,30,30
1650122633730,MATH 20A,A01,083754,Staff,26,0,40,14
1650122639761,MATH 20B,A01,083756,Staff,0,5,30,30
1650122639761,MATH 20B,A02,083757,Staff,0,2,30,30
1650122645791,MATH 20C,A01,083760,Staff,0,11,30,30
1650122645791,MATH 20C,A02,083761,Staff,0,12,30,30
1650122645791,MATH 20C,B01,083762,Staff,14,0,30,16
1650122645791,MATH 20C,B02,083763,Staff,28,0,30,2
1650122651819,MATH 20D,A01,083765,Staff,0,2,30,30
1650122651819,MATH 20D,A02,083766,Staff,12,0,30,18
1650122651819,MATH 20D,A03,083767,Staff,28,0,30,2
1650122657852,MATH 20E,A01,083771,Staff,10,0,30,20
1650122657852,MATH 20E,A02,083772,Staff,20,0,30,10
1650122657852,MATH 20E,B01,083773,Staff,0,0,30,30
1650122657852,MATH 20E,B02,083774,Staff,13,0,30,17
1650122663882,MATH 103A,A01,083777,Staff,0,8,30,30
1650122663882,MATH 103A,A02,083778,Staff,0,7,30,30
1650122663882,MATH 103A,B01,083779,Staff,0,9,30,30
1650122663882,MATH 103A,B02,083780,Staff,0,6,30,30
1650122669932,MATH 105,A01,085443,Staff,0,13,30,30
1650122675973,MATH 109,A01,083213,Anzaldo; Leesa B,0,3,30,30
1650122675973,MATH 109,A02,083214,Anzaldo; Leesa B,0,5,30,30
1650122675973,MATH 109,B01,083215,Anzaldo; Leesa B,0,4,30,30
1650122675973,MATH 109,B02,083216,Anzaldo; Leesa B,0,4,30,30
1650122682015,MATH 142A,A01,083219,Chow; Bennett,0,10,30,30
1650122682015,MATH 142A,A02,083220,Chow; Bennett,0,10,30,30
1650122682015,MATH 142A,B01,083221,Chow; Bennett,0,10,30,30
1650122682015,MATH 142A,B02,083222,Chow; Bennett,0,9,30,30
1650122688039,MATH 193A,A01,083224,Staff,0,4,30,30
1650122688039,MATH 193A,A02,083225,Staff,0,4,30,30
1650122688039,MATH 193A,A03,083781,Staff,0,0,30,30
1650122688039,MATH 193A,A04,083782,Staff,2,0,30,28
1650122694066,MATH 197,001,091859,McAuley; Julian John,9998,0,9999,1
1650122700134,COGS 9,A01,083615,Staff,0,14,60,60
1650122706159,COGS 11,A01,083617,Boyle; Mary E. T.,24,0,40,16
1650122712186,COGS 13,A01,083071,Staff,0,28,40,40
1650122718212,COGS 14A,A01,092681,Staff,0,10,100,100
1650122724237,COGS 14B,A01,083073,Cheng; Tzu-Han,0,4,50,50
1650122730261,COGS 17,A01,092677,Staff,35,0,75,40
1650122736285,COGS 100,A01,083619,Staff,0,21,60,60
1650122742315,COGS 101A,A01,083621,Davis; Joshua Daniel,0,18,60,60
1650122748340,COGS 101B,A01,091572,Staff,10,0,60,50
1650122754363,COGS 101C,A01,083625,Delgado; Tania,22,0,30,8
1650122760389,COGS 107A,A01,083627,Boyle; Mary E. T.,0,4,60,60
1650122766422,COGS 118A,A01,083075,Staff,17,0,60,43
1650122772449,CSE 3,A50,083646,Miranda; Gregory Joseph,22,0,38,16
1650122772449,CSE 3,A51,083647,Miranda; Gregory Joseph,37,0,37,0
1650122778473,CSE 8A,A50,083650,Miranda; Gregory Joseph,0,15,40,40
1650122784512,CSE 11,A01,083080,Cao; Yingjun,0,66,40,40
1650122790548,CSE 12,A01,083652,Staff,0,2,100,100
1650122796583,CSE 15L,A01,083654,Staff,0,0,50,50
1650122796583,CSE 15L,A02,083655,Staff,10,0,50,40
1650122802628,CSE 20,A01,083657,Staff,58,0,80,22
1650122808652,CSE 30,A01,083084,Eldon; John,0,63,40,40
1650122814676,CSE 100,A01,083659,Cao; Yingjun,0,61,50,50
1650122820705,CSE 134B,A01,083661,Powell; Thomas Allan,0,27,65,65
1650122826731,CSE 140,A01,083663,Staff,4,0,75,71
1650122832760,CSE 140L,A01,083088,Eldon; John,0,1,75,75
1650122838793,CSE 175,A01,083665,Kumar; Rakesh,8,0,25,17
1650122844836,CSE 190,A00,092507,Dubnov; Shlomo,14,0,20,6
1650122850863,ECE 45,A01,083139,Staff,0,13,40,40
1650122856892,ECE 65,A50,083695,Staff,0,4,30,30
1650122862946,ECE 109,A01,091882,Touri; Behrouz,48,0,70,22
1650122868971,ECE 180,A00,083140,Abi Samra; Nicholas Camill,24,0,30,6
1650122868971,ECE 180,B00,083141,Abi Samra; Nicholas Camill,8,0,30,22
1650122875004,MATH 10A,A01,083735,Patchell; Gregory David,12,0,30,18
1650122875004,MATH 10A,A02,083736,Patchell; Gregory David,28,0,30,2
1650122875004,MATH 10A,A03,083737,Patchell; Gregory David,26,0,30,4
1650122881034,MATH 10B,A01,083207,Staff,0,5,30,30
1650122881034,MATH 10B,A02,083208,Staff,0,4,30,30
1650122881034,MATH 10B,B01,083739,Staff,18,0,30,12
1650122881034,MATH 10B,B02,083740,Staff,29,0,30,1
1650122887059,MATH 18,A01,083743,Staff,10,0,30,20
1650122887059,MATH 18,A02,083744,Staff,28,0,30,2
1650122887059,MATH 18,A03,083745,Staff,23,0,30,7
1650122887059,MATH 18,A04,083746,Staff,27,0,30,3
1650122887059,MATH 18,B01,083748,Staff,0,9,30,30
1650122887059,MATH 18,B02,083749,Staff,0,7,30,30
1650122887059,MATH 18,B03,083750,Staff,0,6,30,30
1650122887059,MATH 18,B04,083751,Staff,0,6,30,30
1650122893087,MATH 20A,A01,083754,Staff,26,0,40,14
1650122899112,MATH 20B,A01,083756,Staff,0,5,30,30
1650122899112,MATH 20B,A02,083757,Staff,0,2,30,30
1650122905137,MATH 20C,A01,083760,Staff,0,11,30,30
1650122905137,MATH 20C,A02,083761,Staff,0,12,30,30
1650122905137,MATH 20C,B01,083762,Staff,14,0,30,16
1650122905137,MATH 20C,B02,083763,Staff,28,0,30,2
1650122911162,MATH 20D,A01,083765,Staff,0,2,30,30
1650122911162,MATH 20D,A02,083766,Staff,12,0,30,18
1650122911162,MATH 20D,A03,083767,Staff,28,0,30,2
1650122917187,MATH 20E,A01,083771,Staff,10,0,30,20
1650122917187,MATH 20E,A02,083772,Staff,20,0,30,10
1650122917187,MATH 20E,B01,083773,Staff,0,0,30,30
1650122917187,MATH 20E,B02,083774,Staff,13,0,30,17
1650122923213,MATH 103A,A01,083777,Staff,0,8,30,30
1650122923213,MATH 103A,A02,083778,Staff,0,7,30,30
1650122923213,MATH 103A,B01,083779,Staff,0,9,30,30
1650122923213,MATH 103A,B02,083780,Staff,0,6,30,30
1650122929241,MATH 105,A01,085443,Staff,0,13,30,30
1650122935267,MATH 109,A01,083213,Anzaldo; Leesa B,0,3,30,30
1650122935267,MATH 109,A02,083214,Anzaldo; Leesa B,0,5,30,30
1650122935267,MATH 109,B01,083215,Anzaldo; Leesa B,0,4,30,30
1650122935267,MATH 109,B02,083216,Anzaldo; Leesa B,0,4,30,30
1650122941292,MATH 142A,A01,083219,Chow; Bennett,0,10,30,30
1650122941292,MATH 142A,A02,083220,Chow; Bennett,0,10,30,30
1650122941292,MATH 142A,B01,083221,Chow; Bennett,0,10,30,30
1650122941292,MATH 142A,B02,083222,Chow; Bennett,0,9,30,30
1650122947329,MATH 193A,A01,083224,Staff,0,4,30,30
1650122947329,MATH 193A,A02,083225,Staff,0,4,30,30
1650122947329,MATH 193A,A03,083781,Staff,0,0,30,30
1650122947329,MATH 193A,A04,083782,Staff,2,0,30,28
1650122953353,MATH 197,001,091859,McAuley; Julian John,9998,0,9999,1
1650122959437,COGS 9,A01,083615,Staff,0,14,60,60
1650122965472,COGS 11,A01,083617,Boyle; Mary E. T.,24,0,40,16
1650122971503,COGS 13,A01,083071,Staff,0,28,40,40
1650122977529,COGS 14A,A01,092681,Staff,0,10,100,100
1650122983558,COGS 14B,A01,083073,Cheng; Tzu-Han,0,4,50,50
1650122989583,COGS 17,A01,092677,Staff,35,0,75,40
1650122995630,COGS 100,A01,083619,Staff,0,21,60,60
1650123001663,COGS 101A,A01,083621,Davis; Joshua Daniel,0,18,60,60
1650123007686,COGS 101B,A01,091572,Staff,10,0,60,50
1650123013724,COGS 101C,A01,083625,Delgado; Tania,22,0,30,8
1650123019749,COGS 107A,A01,083627,Boyle; Mary E. T.,0,4,60,60
1650123025793,COGS 118A,A01,083075,Staff,17,0,60,43
1650123031824,CSE 3,A50,083646,Miranda; Gregory Joseph,22,0,38,16
1650123031824,CSE 3,A51,083647,Miranda; Gregory Joseph,37,0,37,0
1650123037884,CSE 8A,A50,083650,Miranda; Gregory Joseph,0,15,40,40
1650123043907,CSE 11,A01,083080,Cao; Yingjun,0,66,40,40
1650123049930,CSE 12,A01,083652,Staff,0,2,100,100
1650123055958,CSE 15L,A01,083654,Staff,0,0,50,50
1650123055958,CSE 15L,A02,083655,Staff,10,0,50,40
1650123061988,CSE 20,A01,083657,Staff,58,0,80,22
1650123068016,CSE 30,A01,083084,Eldon; John,0,63,40,40
1650123074040,CSE 100,A01,083659,Cao; Yingjun,0,61,50,50
1650123080065,CSE 134B,A01,083661,Powell; Thomas Allan,0,27,65,65
1650123086088,CSE 140,A01,083663,Staff,4,0,75,71
1650123092114,CSE 140L,A01,083088,Eldon; John,0,1,75,75
1650123098150,CSE 175,A01,083665,Kumar; Rakesh,8,0,25,17
1650123104173,CSE 190,A00,092507,Dubnov; Shlomo,14,0,20,6
1650123110220,ECE 45,A01,083139,Staff,0,13,40,40
1650123116248,ECE 65,A50,083695,Staff,0,4,30,30
1650123122280,ECE 109,A01,091882,Touri; Behrouz,48,0,70,22
1650123128315,ECE 180,A00,083140,Abi Samra; Nicholas Camill,24,0,30,6
1650123128315,ECE 180,B00,083141,Abi Samra; Nicholas Camill,8,0,30,22
1650123134343,MATH 10A,A01,083735,Patchell; Gregory David,12,0,30,18
1650123134343,MATH 10A,A02,083736,Patchell; Gregory David,28,0,30,2
1650123134343,MATH 10A,A03,083737,Patchell; Gregory David,26,0,30,4
1650123140366,MATH 10B,A01,083207,Staff,0,5,30,30
1650123140366,MATH 10B,A02,083208,Staff,0,4,30,30
1650123140366,MATH 10B,B01,083739,Staff,18,0,30,12
1650123140366,MATH 10B,B02,083740,Staff,29,0,30,1
1650123146395,MATH 18,A01,083743,Staff,10,0,30,20
1650123146395,MATH 18,A02,083744,Staff,28,0,30,2
1650123146395,MATH 18,A03,083745,Staff,23,0,30,7
1650123146395,MATH 18,A04,083746,Staff,27,0,30,3
1650123146395,MATH 18,B01,083748,Staff,0,9,30,30
1650123146395,MATH 18,B02,083749,Staff,0,7,30,30
1650123146395,MATH 18,B03,083750,Staff,0,6,30,30
1650123146395,MATH 18,B04,083751,Staff,0,6,30,30
1650123152434,MATH 20A,A01,083754,Staff,26,0,40,14
1650123158467,MATH 20B,A01,083756,Staff,0,5,30,30
1650123158467,MATH 20B,A02,083757,Staff,0,2,30,30
1650123164510,MATH 20C,A01,083760,Staff,0,11,30,30
1650123164510,MATH 20C,A02,083761,Staff,0,12,30,30
1650123164510,MATH 20C,B01,083762,Staff,14,0,30,16
1650123164510,MATH 20C,B02,083763,Staff,28,0,30,2
1650123170541,MATH 20D,A01,083765,Staff,0,2,30,30
1650123170541,MATH 20D,A02,083766,Staff,12,0,30,18
1650123170541,MATH 20D,A03,083767,Staff,28,0,30,2
1650123176567,MATH 20E,A01,083771,Staff,10,0,30,20
1650123176567,MATH 20E,A02,083772,Staff,20,0,30,10
1650123176567,MATH 20E,B01,083773,Staff,0,0,30,30
1650123176567,MATH 20E,B02,083774,Staff,13,0,30,17
1650123182592,MATH 103A,A01,083777,Staff,0,8,30,30
1650123182592,MATH 103A,A02,083778,Staff,0,7,30,30
1650123182592,MATH 103A,B01,083779,Staff,0,9,30,30
1650123182592,MATH 103A,B02,083780,Staff,0,6,30,30
1650123188616,MATH 105,A01,085443,Staff,0,13,30,30
1650123194646,MATH 109,A01,083213,Anzaldo; Leesa B,0,3,30,30
1650123194646,MATH 109,A02,083214,Anzaldo; Leesa B,0,5,30,30
1650123194646,MATH 109,B01,083215,Anzaldo; Leesa B,0,4,30,30
1650123194646,MATH 109,B02,083216,Anzaldo; Leesa B,0,4,30,30
1650123200671,MATH 142A,A01,083219,Chow; Bennett,0,10,30,30
1650123200671,MATH 142A,A02,083220,Chow; Bennett,0,10,30,30
1650123200671,MATH 142A,B01,083221,Chow; Bennett,0,10,30,30
1650123200671,MATH 142A,B02,083222,Chow; Bennett,0,9,30,30
1650123206717,MATH 193A,A01,083224,Staff,0,4,30,30
1650123206717,MATH 193A,A02,083225,Staff,0,4,30,30
1650123206717,MATH 193A,A03,083781,Staff,0,0,30,30
1650123206717,MATH 193A,A04,083782,Staff,2,0,30,28
1650123212777,MATH 197,001,091859,McAuley; Julian John,9998,0,9999,1
1650123218911,COGS 9,A01,083615,Staff,0,14,60,60
1650123224941,COGS 11,A01,083617,Boyle; Mary E. T.,24,0,40,16
1650123230966,COGS 13,A01,083071,Staff,0,28,40,40
1650123236992,COGS 14A,A01,092681,Staff,0,10,100,100
1650123243025,COGS 14B,A01,083073,Cheng; Tzu-Han,0,4,50,50
1650123249049,COGS 17,A01,092677,Staff,35,0,75,40
1650123255078,COGS 100,A01,083619,Staff,0,21,60,60
1650123261114,COGS 101A,A01,083621,Davis; Joshua Daniel,0,18,60,60
1650123267143,COGS 101B,A01,091572,Staff,10,0,60,50
1650123273187,COGS 101C,A01,083625,Delgado; Tania,22,0,30,8
1650123279215,COGS 107A,A01,083627,Boyle; Mary E. T.,0,4,60,60
1650123285273,COGS 118A,A01,083075,Staff,17,0,60,43
1650123291300,CSE 3,A50,083646,Miranda; Gregory Joseph,22,0,38,16
1650123291300,CSE 3,A51,083647,Miranda; Gregory Joseph,37,0,37,0
1650123297349,CSE 8A,A50,083650,Miranda; Gregory Joseph,0,15,40,40
1650123303374,CSE 11,A01,083080,Cao; Yingjun,0,66,40,40
1650123309420,CSE 12,A01,083652,Staff,0,2,100,100
1650123315443,CSE 15L,A01,083654,Staff,0,0,50,50
1650123315443,CSE 15L,A02,083655,Staff,10,0,50,40
1650123321475,CSE 20,A01,083657,Staff,58,0,80,22
1650123327507,CSE 30,A01,083084,Eldon; John,0,63,40,40
1650123333559,CSE 100,A01,083659,Cao; Yingjun,0,61,50,50
1650123339586,CSE 134B,A01,083661,Powell; Thomas Allan,0,27,65,65
1650123345615,CSE 140,A01,083663,Staff,4,0,75,71
1650123351638,CSE 140L,A01,083088,Eldon; John,0,1,75,75
1650123357663,CSE 175,A01,083665,Kumar; Rakesh,8,0,25,17
1650123363689,CSE 190,A00,092507,Dubnov; Shlomo,14,0,20,6
1650123369728,ECE 45,A01,083139,Staff,0,13,40,40
1650123375757,ECE 65,A50,083695,Staff,0,4,30,30
1650123381782,ECE 109,A01,091882,Touri; Behrouz,48,0,70,22
1650123387807,ECE 180,A00,083140,Abi Samra; Nicholas Camill,24,0,30,6
1650123387807,ECE 180,B00,083141,Abi Samra; Nicholas Camill,8,0,30,22
1650123393831,MATH 10A,A01,083735,Patchell; Gregory David,12,0,30,18
1650123393831,MATH 10A,A02,083736,Patchell; Gregory David,28,0,30,2
1650123393831,MATH 10A,A03,083737,Patchell; Gregory David,26,0,30,4
1650123399874,MATH 10B,A01,083207,Staff,0,5,30,30
1650123399874,MATH 10B,A02,083208,Staff,0,4,30,30
1650123399874,MATH 10B,B01,083739,Staff,18,0,30,12
1650123399874,MATH 10B,B02,083740,Staff,29,0,30,1
1650123405904,MATH 18,A01,083743,Staff,10,0,30,20
1650123405904,MATH 18,A02,083744,Staff,28,0,30,2
1650123405904,MATH 18,A03,083745,Staff,23,0,30,7
1650123405904,MATH 18,A04,083746,Staff,27,0,30,3
1650123405904,MATH 18,B01,083748,Staff,0,9,30,30
1650123405904,MATH 18,B02,083749,Staff,0,7,30,30
1650123405904,MATH 18,B03,083750,Staff,0,6,30,30
1650123405904,MATH 18,B04,083751,Staff,0,6,30,30
1650123411948,MATH 20A,A01,083754,Staff,26,0,40,14
1650123418003,MATH 20B,A01,083756,Staff,0,5,30,30
1650123418003,MATH 20B,A02,083757,Staff,0,2,30,30
1650123424028,MATH 20C,A01,083760,Staff,0,11,30,30
1650123424028,MATH 20C,A02,083761,Staff,0,12,30,30
1650123424028,MATH 20C,B01,083762,Staff,14,0,30,16
1650123424028,MATH 20C,B02,083763,Staff,28,0,30,2
1650123430068,MATH 20D,A01,083765,Staff,0,2,30,30
1650123430068,MATH 20D,A02,083766,Staff,12,0,30,18
1650123430068,MATH 20D,A03,083767,Staff,28,0,30,2
1650123436091,MATH 20E,A01,083771,Staff,10,0,30,20
1650123436091,MATH 20E,A02,083772,Staff,20,0,30,10
1650123436091,MATH 20E,B01,083773,Staff,0,0,30,30
1650123436091,MATH 20E,B02,083774,Staff,13,0,30,17
1650123442124,MATH 103A,A01,083777,Staff,0,8,30,30
1650123442124,MATH 103A,A02,083778,Staff,0,7,30,30
1650123442124,MATH 103A,B01,083779,Staff,0,9,30,30
1650123442124,MATH 103A,B02,083780,Staff,0,6,30,30
1650123448148,MATH 105,A01,085443,Staff,0,13,30,30
1650123454180,MATH 109,A01,083213,Anzaldo; Leesa B,0,3,30,30
1650123454180,MATH 109,A02,083214,Anzaldo; Leesa B,0,5,30,30
1650123454180,MATH 109,B01,083215,Anzaldo; Leesa B,0,4,30,30
1650123454180,MATH 109,B02,083216,Anzaldo; Leesa B,0,4,30,30
1650123460204,MATH 142A,A01,083219,Chow; Bennett,0,10,30,30
1650123460204,MATH 142A,A02,083220,Chow; Bennett,0,10,30,30
1650123460204,MATH 142A,B01,083221,Chow; Bennett,0,10,30,30
1650123460204,MATH 142A,B02,083222,Chow; Bennett,0,9,30,30
1650123466233,MATH 193A,A01,083224,Staff,0,4,30,30
1650123466233,MATH 193A,A02,083225,Staff,0,4,30,30
1650123466233,MATH 193A,A03,083781,Staff,0,0,30,30
1650123466233,MATH 193A,A04,083782,Staff,2,0,30,28
1650123472268,MATH 197,001,091859,McAuley; Julian John,9998,0,9999,1
1650123478347,COGS 9,A01,083615,Staff,0,14,60,60
1650123484373,COGS 11,A01,083617,Boyle; Mary E. T.,24,0,40,16
1650123490398,COGS 13,A01,083071,Staff,0,28,40,40
1650123496427,COGS 14A,A01,092681,Staff,0,10,100,100
1650123502453,COGS 14B,A01,083073,Cheng; Tzu-Han,0,4,50,50
1650123508492,COGS 17,A01,092677,Staff,35,0,75,40
1650123514517,COGS 100,A01,083619,Staff,0,21,60,60
1650123520544,COGS 101A,A01,083621,Davis; Joshua Daniel,0,18,60,60
1650123526571,COGS 101B,A01,091572,Staff,10,0,60,50
1650123532601,COGS 101C,A01,083625,Delgado; Tania,22,0,30,8
1650123538636,COGS 107A,A01,083627,Boyle; Mary E. T.,0,4,60,60
1650123544664,COGS 118A,A01,083075,Staff,17,0,60,43
1650123550696,CSE 3,A50,083646,Miranda; Gregory Joseph,22,0,38,16
1650123550696,CSE 3,A51,083647,Miranda; Gregory Joseph,37,0,37,0
1650123556720,CSE 8A,A50,083650,Miranda; Gregory Joseph,0,16,40,40
1650123562745,CSE 11,A01,083080,Cao; Yingjun,0,66,40,40
1650123568779,CSE 12,A01,083652,Staff,0,2,100,100
1650123574813,CSE 15L,A01,083654,Staff,0,0,50,50
1650123574813,CSE 15L,A02,083655,Staff,10,0,50,40
1650123580865,CSE 20,A01,083657,Staff,58,0,80,22
1650123586889,CSE 30,A01,083084,Eldon; John,0,63,40,40
1650123592918,CSE 100,A01,083659,Cao; Yingjun,0,61,50,50
1650123598943,CSE 134B,A01,083661,Powell; Thomas Allan,0,27,65,65
1650123604967,CSE 140,A01,083663,Staff,4,0,75,71
1650123610994,CSE 140L,A01,083088,Eldon; John,0,1,75,75
1650123617019,CSE 175,A01,083665,Kumar; Rakesh,8,0,25,17
1650123623051,CSE 190,A00,092507,Dubnov; Shlomo,14,0,20,6
1650123629076,ECE 45,A01,083139,Staff,0,13,40,40
1650123635099,ECE 65,A50,083695,Staff,0,4,30,30
1650123641122,ECE 109,A01,091882,Touri; Behrouz,48,0,70,22
1650123647158,ECE 180,A00,083140,Abi Samra; Nicholas Camill,24,0,30,6
1650123647158,ECE 180,B00,083141,Abi Samra; Nicholas Camill,8,0,30,22
1650123653192,MATH 10A,A01,083735,Patchell; Gregory David,12,0,30,18
1650123653192,MATH 10A,A02,083736,Patchell; Gregory David,28,0,30,2
1650123653192,MATH 10A,A03,083737,Patchell; Gregory David,26,0,30,4
1650123659219,MATH 10B,A01,083207,Staff,0,5,30,30
1650123659219,MATH 10B,A02,083208,Staff,0,4,30,30
1650123659219,MATH 10B,B01,083739,Staff,18,0,30,12
1650123659219,MATH 10B,B02,083740,Staff,29,0,30,1
1650123665242,MATH 18,A01,083743,Staff,10,0,30,20
1650123665242,MATH 18,A02,083744,Staff,28,0,30,2
1650123665242,MATH 18,A03,083745,Staff,23,0,30,7
1650123665242,MATH 18,A04,083746,Staff,27,0,30,3
1650123665242,MATH 18,B01,083748,Staff,0,9,30,30
1650123665242,MATH 18,B02,083749,Staff,0,7,30,30
1650123665242,MATH 18,B03,083750,Staff,0,6,30,30
1650123665242,MATH 18,B04,083751,Staff,0,6,30,30
1650123671266,MATH 20A,A01,083754,Staff,26,0,40,14
1650123677313,MATH 20B,A01,083756,Staff,0,5,30,30
1650123677313,MATH 20B,A02,083757,Staff,0,2,30,30
1650123683362,MATH 20C,A01,083760,Staff,0,11,30,30
1650123683362,MATH 20C,A02,083761,Staff,0,12,30,30
1650123683362,MATH 20C,B01,083762,Staff,14,0,30,16
1650123683362,MATH 20C,B02,083763,Staff,28,0,30,2
1650123689401,MATH 20D,A01,083765,Staff,0,2,30,30
1650123689401,MATH 20D,A02,083766,Staff,12,0,30,18
1650123689401,MATH 20D,A03,083767,Staff,28,0,30,2
1650123695434,MATH 20E,A01,083771,Staff,10,0,30,20
1650123695434,MATH 20E,A02,083772,Staff,20,0,30,10
1650123695434,MATH 20E,B01,083773,Staff,0,0,30,30
1650123695434,MATH 20E,B02,083774,Staff,13,0,30,17
1650123701464,MATH 103A,A01,083777,Staff,0,8,30,30
1650123701464,MATH 103A,A02,083778,Staff,0,7,30,30
1650123701464,MATH 103A,B01,083779,Staff,0,9,30,30
1650123701464,MATH 103A,B02,083780,Staff,0,6,30,30
1650123707493,MATH 105,A01,085443,Staff,0,13,30,30
1650123713519,MATH 109,A01,083213,Anzaldo; Leesa B,0,3,30,30
1650123713519,MATH 109,A02,083214,Anzaldo; Leesa B,0,5,30,30
1650123713519,MATH 109,B01,083215,Anzaldo; Leesa B,0,4,30,30
1650123713519,MATH 109,B02,083216,Anzaldo; Leesa B,0,4,30,30
1650123719543,MATH 142A,A01,083219,Chow; Bennett,0,10,30,30
1650123719543,MATH 142A,A02,083220,Chow; Bennett,0,10,30,30
1650123719543,MATH 142A,B01,083221,Chow; Bennett,0,10,30,30
1650123719543,MATH 142A,B02,083222,Chow; Bennett,0,10,30,30
1650123725568,MATH 193A,A01,083224,Staff,0,4,30,30
1650123725568,MATH 193A,A02,083225,Staff,0,4,30,30
1650123725568,MATH 193A,A03,083781,Staff,0,0,30,30
1650123725568,MATH 193A,A04,083782,Staff,2,0,30,28
1650123731605,MATH 197,001,091859,McAuley; Julian John,9998,0,9999,1
1650123737692,COGS 9,A01,083615,Staff,0,14,60,60
1650123743747,COGS 11,A01,083617,Boyle; Mary E. T.,24,0,40,16
1650123749776,COGS 13,A01,083071,Staff,0,28,40,40
1650123755800,COGS 14A,A01,092681,Staff,0,10,100,100
1650123761836,COGS 14B,A01,083073,Cheng; Tzu-Han,0,4,50,50
1650123767870,COGS 17,A01,092677,Staff,35,0,75,40
1650123773907,COGS 100,A01,083619,Staff,0,21,60,60
1650123779934,COGS 101A,A01,083621,Davis; Joshua Daniel,0,18,60,60
1650123785981,COGS 101B,A01,091572,Staff,10,0,60,50
1650123792005,COGS 101C,A01,083625,Delgado; Tania,22,0,30,8
1650123798030,COGS 107A,A01,083627,Boyle; Mary E. T.,0,4,60,60
1650123804062,COGS 118A,A01,083075,Staff,17,0,60,43
1650123810112,CSE 3,A50,083646,Miranda; Gregory Joseph,22,0,38,16
1650123810112,CSE 3,A51,083647,Miranda; Gregory Joseph,37,0,37,0
1650123816240,CSE 8A,A50,083650,Miranda; Gregory Joseph,0,16,40,40
1650123822275,CSE 11,A01,083080,Cao; Yingjun,0,66,40,40
1650123828298,CSE 12,A01,083652,Staff,0,2,100,100
1650123834332,CSE 15L,A01,083654,Staff,0,0,50,50
1650123834332,CSE 15L,A02,083655,Staff,10,0,50,40
1650123840355,CSE 20,A01,083657,Staff,58,0,80,22
1650123846379,CSE 30,A01,083084,Eldon; John,0,63,40,40
1650123852416,CSE 100,A01,083659,Cao; Yingjun,0,61,50,50
1650123858444,CSE 134B,A01,083661,Powell; Thomas Allan,0,27,65,65
1650123864489,CSE 140,A01,083663,Staff,4,0,75,71
1650123870543,CSE 140L,A01,083088,Eldon; John,0,1,75,75
1650123876593,CSE 175,A01,083665,Kumar; Rakesh,8,0,25,17
1650123882626,CSE 190,A00,092507,Dubnov; Shlomo,14,0,20,6
1650123888654,ECE 45,A01,083139,Staff,0,13,40,40
1650123894678,ECE 65,A50,083695,Staff,0,4,30,30
1650123900708,ECE 109,A01,091882,Touri; Behrouz,48,0,70,22
1650123906760,ECE 180,A00,083140,Abi Samra; Nicholas Camill,24,0,30,6
1650123906760,ECE 180,B00,083141,Abi Samra; Nicholas Camill,8,0,30,22
1650123912818,MATH 10A,A01,083735,Patchell; Gregory David,12,0,30,18
1650123912818,MATH 10A,A02,083736,Patchell; Gregory David,28,0,30,2
1650123912818,MATH 10A,A03,083737,Patchell; Gregory David,26,0,30,4
1650123918845,MATH 10B,A01,083207,Staff,0,5,30,30
1650123918845,MATH 10B,A02,083208,Staff,0,4,30,30
1650123918845,MATH 10B,B01,083739,Staff,18,0,30,12
1650123918845,MATH 10B,B02,083740,Staff,29,0,30,1
1650123924878,MATH 18,A01,083743,Staff,10,0,30,20
1650123924878,MATH 18,A02,083744,Staff,28,0,30,2
1650123924878,MATH 18,A03,083745,Staff,23,0,30,7
1650123924878,MATH 18,A04,083746,Staff,27,0,30,3
1650123924878,MATH 18,B01,083748,Staff,0,9,30,30
1650123924878,MATH 18,B02,083749,Staff,0,7,30,30
1650123924878,MATH 18,B03,083750,Staff,0,6,30,30
1650123924878,MATH 18,B04,083751,Staff,0,6,30,30
1650123930902,MATH 20A,A01,083754,Staff,26,0,40,14
1650123936929,MATH 20B,A01,083756,Staff,0,5,30,30
1650123936929,MATH 20B,A02,083757,Staff,0,2,30,30
1650123942953,MATH 20C,A01,083760,Staff,0,11,30,30
1650123942953,MATH 20C,A02,083761,Staff,0,12,30,30
1650123942953,MATH 20C,B01,083762,Staff,14,0,30,16
1650123942953,MATH 20C,B02,083763,Staff,28,0,30,2
1650123948980,MATH 20D,A01,083765,Staff,0,2,30,30
1650123948980,MATH 20D,A02,083766,Staff,12,0,30,18
1650123948980,MATH 20D,A03,083767,Staff,28,0,30,2
1650123955018,MATH 20E,A01,083771,Staff,10,0,30,20
1650123955018,MATH 20E,A02,083772,Staff,20,0,30,10
1650123955018,MATH 20E,B01,083773,Staff,0,0,30,30
1650123955018,MATH 20E,B02,083774,Staff,13,0,30,17
1650123961046,MATH 103A,A01,083777,Staff,0,8,30,30
1650123961046,MATH 103A,A02,083778,Staff,0,7,30,30
1650123961046,MATH 103A,B01,083779,Staff,0,9,30,30
1650123961046,MATH 103A,B02,083780,Staff,0,6,30,30
1650123967070,MATH 105,A01,085443,Staff,0,13,30,30
1650123973120,MATH 109,A01,083213,Anzaldo; Leesa B,0,3,30,30
1650123973120,MATH 109,A02,083214,Anzaldo; Leesa B,0,5,30,30
1650123973120,MATH 109,B01,083215,Anzaldo; Leesa B,0,4,30,30
1650123973120,MATH 109,B02,083216,Anzaldo; Leesa B,0,4,30,30
1650123979162,MATH 142A,A01,083219,Chow; Bennett,0,10,30,30
1650123979162,MATH 142A,A02,083220,Chow; Bennett,0,10,30,30
1650123979162,MATH 142A,B01,083221,Chow; Bennett,0,10,30,30
1650123979162,MATH 142A,B02,083222,Chow; Bennett,0,10,30,30
1650123985187,MATH 193A,A01,083224,Staff,0,4,30,30
1650123985187,MATH 193A,A02,083225,Staff,0,4,30,30
1650123985187,MATH 193A,A03,083781,Staff,0,0,30,30
1650123985187,MATH 193A,A04,083782,Staff,2,0,30,28
1650123991213,MATH 197,001,091859,McAuley; Julian John,9998,0,9999,1
1650123997283,COGS 9,A01,083615,Staff,0,14,60,60
1650124003306,COGS 11,A01,083617,Boyle; Mary E. T.,24,0,40,16
1650124009332,COGS 13,A01,083071,Staff,0,28,40,40
1650124015358,COGS 14A,A01,092681,Staff,0,10,100,100
1650124021390,COGS 14B,A01,083073,Cheng; Tzu-Han,0,4,50,50
1650124027419,COGS 17,A01,092677,Staff,35,0,75,40
1650124033454,COGS 100,A01,083619,Staff,0,21,60,60
1650124039501,COGS 101A,A01,083621,Davis; Joshua Daniel,0,18,60,60
1650124045543,COGS 101B,A01,091572,Staff,10,0,60,50
1650124051573,COGS 101C,A01,083625,Delgado; Tania,22,0,30,8
1650124057601,COGS 107A,A01,083627,Boyle; Mary E. T.,0,4,60,60
1650124063634,COGS 118A,A01,083075,Staff,17,0,60,43
1650124069667,CSE 3,A50,083646,Miranda; Gregory Joseph,22,0,38,16
1650124069667,CSE 3,A51,083647,Miranda; Gregory Joseph,37,0,37,0
1650124075691,CSE 8A,A50,083650,Miranda; Gregory Joseph,0,16,40,40
1650124081716,CSE 11,A01,083080,Cao; Yingjun,0,66,40,40
1650124087741,CSE 12,A01,083652,Staff,0,2,100,100
1650124093772,CSE 15L,A01,083654,Staff,0,0,50,50
1650124093772,CSE 15L,A02,083655,Staff,10,0,50,40
1650124099806,CSE 20,A01,083657,Staff,58,0,80,22
1650124105830,CSE 30,A01,083084,Eldon; John,0,63,40,40
1650124111867,CSE 100,A01,083659,Cao; Yingjun,0,61,50,50
1650124117892,CSE 134B,A01,083661,Powell; Thomas Allan,0,27,65,65
1650124123915,CSE 140,A01,083663,Staff,4,0,75,71
1650124129940,CSE 140L,A01,083088,Eldon; John,0,1,75,75
1650124135964,CSE 175,A01,083665,Kumar; Rakesh,8,0,25,17
1650124141993,CSE 190,A00,092507,Dubnov; Shlomo,14,0,20,6
1650124148021,ECE 45,A01,083139,Staff,0,13,40,40
1650124154052,ECE 65,A50,083695,Staff,0,4,30,30
1650124160086,ECE 109,A01,091882,Touri; Behrouz,48,0,70,22
1650124166111,ECE 180,A00,083140,Abi Samra; Nicholas Camill,24,0,30,6
1650124166111,ECE 180,B00,083141,Abi Samra; Nicholas Camill,8,0,30,22
1650124172138,MATH 10A,A01,083735,Patchell; Gregory David,12,0,30,18
1650124172138,MATH 10A,A02,083736,Patchell; Gregory David,28,0,30,2
1650124172138,MATH 10A,A03,083737,Patchell; Gregory David,26,0,30,4
1650124178186,MATH 10B,A01,083207,Staff,0,5,30,30
1650124178186,MATH 10B,A02,083208,Staff,0,4,30,30
1650124178186,MATH 10B,B01,083739,Staff,18,0,30,12
1650124178186,MATH 10B,B02,083740,Staff,29,0,30,1
1650124184216,MATH 18,A01,083743,Staff,10,0,30,20
1650124184216,MATH 18,A02,083744,Staff,28,0,30,2
1650124184216,MATH 18,A03,083745,Staff,23,0,30,7
1650124184216,MATH 18,A04,083746,Staff,27,0,30,3
1650124184216,MATH 18,B01,083748,Staff,0,9,30,30
1650124184216,MATH 18,B02,083749,Staff,0,7,30,30
1650124184216,MATH 18,B03,083750,Staff,0,6,30,30
1650124184216,MATH 18,B04,083751,Staff,0,6,30,30
1650124190256,MATH 20A,A01,083754,Staff,26,0,40,14
1650124196303,MATH 20B,A01,083756,Staff,0,5,30,30
1650124196303,MATH 20B,A02,083757,Staff,0,2,30,30
1650124202331,MATH 20C,A01,083760,Staff,0,11,30,30
1650124202331,MATH 20C,A02,083761,Staff,0,12,30,30
1650124202331,MATH 20C,B01,083762,Staff,14,0,30,16
1650124202331,MATH 20C,B02,083763,Staff,28,0,30,2
1650124208365,MATH 20D,A01,083765,Staff,0,2,30,30
1650124208365,MATH 20D,A02,083766,Staff,12,0,30,18
1650124208365,MATH 20D,A03,083767,Staff,28,0,30,2
1650124214390,MATH 20E,A01,083771,Staff,10,0,30,20
1650124214390,MATH 20E,A02,083772,Staff,20,0,30,10
1650124214390,MATH 20E,B01,083773,Staff,0,0,30,30
1650124214390,MATH 20E,B02,083774,Staff,13,0,30,17
1650124220440,MATH 103A,A01,083777,Staff,0,8,30,30
1650124220440,MATH 103A,A02,083778,Staff,0,7,30,30
1650124220440,MATH 103A,B01,083779,Staff,0,9,30,30
1650124220440,MATH 103A,B02,083780,Staff,0,6,30,30
1650124226465,MATH 105,A01,085443,Staff,0,13,30,30
1650124232490,MATH 109,A01,083213,Anzaldo; Leesa B,0,3,30,30
1650124232490,MATH 109,A02,083214,Anzaldo; Leesa B,0,5,30,30
1650124232490,MATH 109,B01,083215,Anzaldo; Leesa B,0,4,30,30
1650124232490,MATH 109,B02,083216,Anzaldo; Leesa B,0,4,30,30
1650124238514,MATH 142A,A01,083219,Chow; Bennett,0,10,30,30
1650124238514,MATH 142A,A02,083220,Chow; Bennett,0,10,30,30
1650124238514,MATH 142A,B01,083221,Chow; Bennett,0,10,30,30
1650124238514,MATH 142A,B02,083222,Chow; Bennett,0,10,30,30
1650124244539,MATH 193A,A01,083224,Staff,0,4,30,30
1650124244539,MATH 193A,A02,083225,Staff,0,4,30,30
1650124244539,MATH 193A,A03,083781,Staff,0,0,30,30
1650124244539,MATH 193A,A04,083782,Staff,2,0,30,28
1650124250568,MATH 197,001,091859,McAuley; Julian John,9998,0,9999,1
1650124256637,COGS 9,A01,083615,Staff,0,14,60,60
1650124262663,COGS 11,A01,083617,Boyle; Mary E. T.,24,0,40,16
1650124268693,COGS 13,A01,083071,Staff,0,28,40,40
1650124274738,COGS 14A,A01,092681,Staff,0,10,100,100
1650124280767,COGS 14B,A01,083073,Cheng; Tzu-Han,0,4,50,50
1650124286791,COGS 17,A01,092677,Staff,35,0,75,40
1650124292815,COGS 100,A01,083619,Staff,0,21,60,60
1650124298844,COGS 101A,A01,083621,Davis; Joshua Daniel,0,18,60,60
1650124304867,COGS 101B,A01,091572,Staff,10,0,60,50
1650124310892,COGS 101C,A01,083625,Delgado; Tania,22,0,30,8
1650124316935,COGS 107A,A01,083627,Boyle; Mary E. T.,0,4,60,60
1650124322970,COGS 118A,A01,083075,Staff,17,0,60,43
1650124328995,CSE 3,A50,083646,Miranda; Gregory Joseph,22,0,38,16
1650124328995,CSE 3,A51,083647,Miranda; Gregory Joseph,37,0,37,0
1650124335023,CSE 8A,A50,083650,Miranda; Gregory Joseph,0,16,40,40
1650124341053,CSE 11,A01,083080,Cao; Yingjun,0,66,40,40
1650124347077,CSE 12,A01,083652,Staff,0,2,100,100
1650124353115,CSE 15L,A01,083654,Staff,0,0,50,50
1650124353115,CSE 15L,A02,083655,Staff,10,0,50,40
1650124359144,CSE 20,A01,083657,Staff,58,0,80,22
1650124365190,CSE 30,A01,083084,Eldon; John,0,63,40,40
1650124371221,CSE 100,A01,083659,Cao; Yingjun,0,61,50,50
1650124377247,CSE 134B,A01,083661,Powell; Thomas Allan,0,27,65,65
1650124383271,CSE 140,A01,083663,Staff,4,0,75,71
1650124389300,CSE 140L,A01,083088,Eldon; John,0,1,75,75
1650124395347,CSE 175,A01,083665,Kumar; Rakesh,8,0,25,17
1650124401377,CSE 190,A00,092507,Dubnov; Shlomo,14,0,20,6
1650124407412,ECE 45,A01,083139,Staff,0,13,40,40
1650124413517,ECE 65,A50,083695,Staff,0,4,30,30
1650124419555,ECE 109,A01,091882,Touri; Behrouz,48,0,70,22
1650124425583,ECE 180,A00,083140,Abi Samra; Nicholas Camill,24,0,30,6
1650124425583,ECE 180,B00,083141,Abi Samra; Nicholas Camill,8,0,30,22
1650124431613,MATH 10A,A01,083735,Patchell; Gregory David,12,0,30,18
1650124431613,MATH 10A,A02,083736,Patchell; Gregory David,28,0,30,2
1650124431613,MATH 10A,A03,083737,Patchell; Gregory David,26,0,30,4
1650124437638,MATH 10B,A01,083207,Staff,0,5,30,30
1650124437638,MATH 10B,A02,083208,Staff,0,4,30,30
1650124437638,MATH 10B,B01,083739,Staff,18,0,30,12
1650124437638,MATH 10B,B02,083740,Staff,29,0,30,1
1650124443669,MATH 18,A01,083743,Staff,10,0,30,20
1650124443669,MATH 18,A02,083744,Staff,28,0,30,2
1650124443669,MATH 18,A03,083745,Staff,23,0,30,7
1650124443669,MATH 18,A04,083746,Staff,27,0,30,3
1650124443669,MATH 18,B01,083748,Staff,0,9,30,30
1650124443669,MATH 18,B02,083749,Staff,0,7,30,30
1650124443669,MATH 18,B03,083750,Staff,0,6,30,30
1650124443669,MATH 18,B04,083751,Staff,0,6,30,30
1650124449696,MATH 20A,A01,083754,Staff,26,0,40,14
1650124455740,MATH 20B,A01,083756,Staff,0,5,30,30
1650124455740,MATH 20B,A02,083757,Staff,0,2,30,30
1650124461766,MATH 20C,A01,083760,Staff,0,11,30,30
1650124461766,MATH 20C,A02,083761,Staff,0,12,30,30
1650124461766,MATH 20C,B01,083762,Staff,14,0,30,16
1650124461766,MATH 20C,B02,083763,Staff,28,0,30,2
1650124467799,MATH 20D,A01,083765,Staff,0,2,30,30
1650124467799,MATH 20D,A02,083766,Staff,12,0,30,18
1650124467799,MATH 20D,A03,083767,Staff,28,0,30,2
1650124473834,MATH 20E,A01,083771,Staff,10,0,30,20
1650124473834,MATH 20E,A02,083772,Staff,20,0,30,10
1650124473834,MATH 20E,B01,083773,Staff,0,0,30,30
1650124473834,MATH 20E,B02,083774,Staff,13,0,30,17
1650124479858,MATH 103A,A01,083777,Staff,0,8,30,30
1650124479858,MATH 103A,A02,083778,Staff,0,7,30,30
1650124479858,MATH 103A,B01,083779,Staff,0,9,30,30
1650124479858,MATH 103A,B02,083780,Staff,0,6,30,30
1650124485890,MATH 105,A01,085443,Staff,0,13,30,30
1650124491918,MATH 109,A01,083213,Anzaldo; Leesa B,0,3,30,30
1650124491918,MATH 109,A02,083214,Anzaldo; Leesa B,0,5,30,30
1650124491918,MATH 109,B01,083215,Anzaldo; Leesa B,0,4,30,30
1650124491918,MATH 109,B02,083216,Anzaldo; Leesa B,0,4,30,30
1650124497949,MATH 142A,A01,083219,Chow; Bennett,0,10,30,30
1650124497949,MATH 142A,A02,083220,Chow; Bennett,0,10,30,30
1650124497949,MATH 142A,B01,083221,Chow; Bennett,0,10,30,30
1650124497949,MATH 142A,B02,083222,Chow; Bennett,0,10,30,30
1650124503980,MATH 193A,A01,083224,Staff,0,4,30,30
1650124503980,MATH 193A,A02,083225,Staff,0,4,30,30
1650124503980,MATH 193A,A03,083781,Staff,0,0,30,30
1650124503980,MATH 193A,A04,083782,Staff,2,0,30,28
1650124510007,MATH 197,001,091859,McAuley; Julian John,9998,0,9999,1
1650124516088,COGS 9,A01,083615,Staff,0,14,60,60
1650124522111,COGS 11,A01,083617,Boyle; Mary E. T.,24,0,40,16
1650124528149,COGS 13,A01,083071,Staff,0,28,40,40
1650124534173,COGS 14A,A01,092681,Staff,0,10,100,100
1650124540218,COGS 14B,A01,083073,Cheng; Tzu-Han,0,4,50,50
1650124546244,COGS 17,A01,092677,Staff,35,0,75,40
1650124552275,COGS 100,A01,083619,Staff,0,21,60,60
1650124558304,COGS 101A,A01,083621,Davis; Joshua Daniel,0,18,60,60
1650124564333,COGS 101B,A01,091572,Staff,10,0,60,50
1650124570359,COGS 101C,A01,083625,Delgado; Tania,22,0,30,8
1650124576394,COGS 107A,A01,083627,Boyle; Mary E. T.,0,4,60,60
1650124582417,COGS 118A,A01,083075,Staff,17,0,60,43
1650124588444,CSE 3,A50,083646,Miranda; Gregory Joseph,22,0,38,16
1650124588444,CSE 3,A51,083647,Miranda; Gregory Joseph,37,0,37,0
1650124594479,CSE 8A,A50,083650,Miranda; Gregory Joseph,0,16,40,40
1650124600534,CSE 11,A01,083080,Cao; Yingjun,0,66,40,40
1650124606560,CSE 12,A01,083652,Staff,0,2,100,100
1650124612584,CSE 15L,A01,083654,Staff,0,0,50,50
1650124612584,CSE 15L,A02,083655,Staff,10,0,50,40
1650124618609,CSE 20,A01,083657,Staff,58,0,80,22
1650124624640,CSE 30,A01,083084,Eldon; John,0,63,40,40
1650124630664,CSE 100,A01,083659,Cao; Yingjun,0,61,50,50
1650124636705,CSE 134B,A01,083661,Powell; Thomas Allan,0,27,65,65
1650124642732,CSE 140,A01,083663,Staff,4,0,75,71
1650124648759,CSE 140L,A01,083088,Eldon; John,0,1,75,75
1650124654786,CSE 175,A01,083665,Kumar; Rakesh,8,0,25,17
1650124660814,CSE 190,A00,092507,Dubnov; Shlomo,14,0,20,6
1650124666836,ECE 45,A01,083139,Staff,0,13,40,40
1650124672858,ECE 65,A50,083695,Staff,0,4,30,30
1650124678891,ECE 109,A01,091882,Touri; Behrouz,48,0,70,22
1650124684919,ECE 180,A00,083140,Abi Samra; Nicholas Camill,24,0,30,6
1650124684919,ECE 180,B00,083141,Abi Samra; Nicholas Camill,8,0,30,22
1650124690945,MATH 10A,A01,083735,Patchell; Gregory David,12,0,30,18
1650124690945,MATH 10A,A02,083736,Patchell; Gregory David,28,0,30,2
1650124690945,MATH 10A,A03,083737,Patchell; Gregory David,26,0,30,4
1650124696980,MATH 10B,A01,083207,Staff,0,5,30,30
1650124696980,MATH 10B,A02,083208,Staff,0,4,30,30
1650124696980,MATH 10B,B01,083739,Staff,18,0,30,12
1650124696980,MATH 10B,B02,083740,Staff,29,0,30,1
1650124703013,MATH 18,A01,083743,Staff,10,0,30,20
1650124703013,MATH 18,A02,083744,Staff,28,0,30,2
1650124703013,MATH 18,A03,083745,Staff,23,0,30,7
1650124703013,MATH 18,A04,083746,Staff,27,0,30,3
1650124703013,MATH 18,B01,083748,Staff,0,9,30,30
1650124703013,MATH 18,B02,083749,Staff,0,7,30,30
1650124703013,MATH 18,B03,083750,Staff,0,6,30,30
1650124703013,MATH 18,B04,083751,Staff,0,6,30,30
1650124709050,MATH 20A,A01,083754,Staff,26,0,40,14
1650124715075,MATH 20B,A01,083756,Staff,0,5,30,30
1650124715075,MATH 20B,A02,083757,Staff,0,2,30,30
1650124721131,MATH 20C,A01,083760,Staff,0,11,30,30
1650124721131,MATH 20C,A02,083761,Staff,0,12,30,30
1650124721131,MATH 20C,B01,083762,Staff,14,0,30,16
1650124721131,MATH 20C,B02,083763,Staff,28,0,30,2
1650124727154,MATH 20D,A01,083765,Staff,0,2,30,30
1650124727154,MATH 20D,A02,083766,Staff,12,0,30,18
1650124727154,MATH 20D,A03,083767,Staff,28,0,30,2
1650124733181,MATH 20E,A01,083771,Staff,10,0,30,20
1650124733181,MATH 20E,A02,083772,Staff,20,0,30,10
1650124733181,MATH 20E,B01,083773,Staff,0,0,30,30
1650124733181,MATH 20E,B02,083774,Staff,13,0,30,17
1650124739208,MATH 103A,A01,083777,Staff,0,8,30,30
1650124739208,MATH 103A,A02,083778,Staff,0,7,30,30
1650124739208,MATH 103A,B01,083779,Staff,0,9,30,30
1650124739208,MATH 103A,B02,083780,Staff,0,6,30,30
1650124745237,MATH 105,A01,085443,Staff,0,13,30,30
1650124751262,MATH 109,A01,083213,Anzaldo; Leesa B,0,3,30,30
1650124751262,MATH 109,A02,083214,Anzaldo; Leesa B,0,5,30,30
1650124751262,MATH 109,B01,083215,Anzaldo; Leesa B,0,4,30,30
1650124751262,MATH 109,B02,083216,Anzaldo; Leesa B,0,4,30,30
1650124757298,MATH 142A,A01,083219,Chow; Bennett,0,10,30,30
1650124757298,MATH 142A,A02,083220,Chow; Bennett,0,10,30,30
1650124757298,MATH 142A,B01,083221,Chow; Bennett,0,10,30,30
1650124757298,MATH 142A,B02,083222,Chow; Bennett,0,10,30,30
1650124763326,MATH 193A,A01,083224,Staff,0,4,30,30
1650124763326,MATH 193A,A02,083225,Staff,0,4,30,30
1650124763326,MATH 193A,A03,083781,Staff,0,0,30,30
1650124763326,MATH 193A,A04,083782,Staff,2,0,30,28
1650124769359,MATH 197,001,091859,McAuley; Julian John,9998,0,9999,1
1650124775432,COGS 9,A01,083615,Staff,0,14,60,60
1650124781456,COGS 11,A01,083617,Boyle; Mary E. T.,24,0,40,16
1650124787481,COGS 13,A01,083071,Staff,0,28,40,40
1650124793508,COGS 14A,A01,092681,Staff,0,10,100,100
1650124799551,COGS 14B,A01,083073,Cheng; Tzu-Han,0,4,50,50
1650124805576,COGS 17,A01,092677,Staff,35,0,75,40
1650124811602,COGS 100,A01,083619,Staff,0,21,60,60
1650124817629,COGS 101A,A01,083621,Davis; Joshua Daniel,0,18,60,60
1650124823659,COGS 101B,A01,091572,Staff,10,0,60,50
1650124829696,COGS 101C,A01,083625,Delgado; Tania,22,0,30,8
1650124835733,COGS 107A,A01,083627,Boyle; Mary E. T.,0,4,60,60
1650124841759,COGS 118A,A01,083075,Staff,17,0,60,43
1650124847808,CSE 3,A50,083646,Miranda; Gregory Joseph,22,0,38,16
1650124847808,CSE 3,A51,083647,Miranda; Gregory Joseph,37,0,37,0
1650124853843,CSE 8A,A50,083650,Miranda; Gregory Joseph,0,16,40,40
1650124859870,CSE 11,A01,083080,Cao; Yingjun,0,66,40,40
1650124865905,CSE 12,A01,083652,Staff,0,2,100,100
1650124871940,CSE 15L,A01,083654,Staff,0,0,50,50
1650124871940,CSE 15L,A02,083655,Staff,10,0,50,40
1650124877968,CSE 20,A01,083657,Staff,58,0,80,22
1650124883995,CSE 30,A01,083084,Eldon; John,0,63,40,40
1650124890019,CSE 100,A01,083659,Cao; Yingjun,0,61,50,50
1650124896046,CSE 134B,A01,083661,Powell; Thomas Allan,0,27,65,65
1650124902070,CSE 140,A01,083663,Staff,4,0,75,71
1650124908099,CSE 140L,A01,083088,Eldon; John,0,1,75,75
1650124914137,CSE 175,A01,083665,Kumar; Rakesh,8,0,25,17
1650124920158,CSE 190,A00,092507,Dubnov; Shlomo,14,0,20,6
1650124926185,ECE 45,A01,083139,Staff,0,13,40,40
1650124932209,ECE 65,A50,083695,Staff,0,4,30,30
1650124938240,ECE 109,A01,091882,Touri; Behrouz,48,0,70,22
1650124944282,ECE 180,A00,083140,Abi Samra; Nicholas Camill,24,0,30,6
1650124944282,ECE 180,B00,083141,Abi Samra; Nicholas Camill,8,0,30,22
1650124950314,MATH 10A,A01,083735,Patchell; Gregory David,12,0,30,18
1650124950314,MATH 10A,A02,083736,Patchell; Gregory David,28,0,30,2
1650124950314,MATH 10A,A03,083737,Patchell; Gregory David,26,0,30,4
1650124956350,MATH 10B,A01,083207,Staff,0,5,30,30
1650124956350,MATH 10B,A02,083208,Staff,0,4,30,30
1650124956350,MATH 10B,B01,083739,Staff,18,0,30,12
1650124956350,MATH 10B,B02,083740,Staff,29,0,30,1
1650124962378,MATH 18,A01,083743,Staff,10,0,30,20
1650124962378,MATH 18,A02,083744,Staff,28,0,30,2
1650124962378,MATH 18,A03,083745,Staff,23,0,30,7
1650124962378,MATH 18,A04,083746,Staff,27,0,30,3
1650124962378,MATH 18,B01,083748,Staff,0,9,30,30
1650124962378,MATH 18,B02,083749,Staff,0,7,30,30
1650124962378,MATH 18,B03,083750,Staff,0,6,30,30
1650124962378,MATH 18,B04,083751,Staff,0,6,30,30
1650124968415,MATH 20A,A01,083754,Staff,26,0,40,14
1650124974445,MATH 20B,A01,083756,Staff,0,5,30,30
1650124974445,MATH 20B,A02,083757,Staff,0,2,30,30
1650124980469,MATH 20C,A01,083760,Staff,0,11,30,30
1650124980469,MATH 20C,A02,083761,Staff,0,12,30,30
1650124980469,MATH 20C,B01,083762,Staff,14,0,30,16
1650124980469,MATH 20C,B02,083763,Staff,28,0,30,2
1650124986497,MATH 20D,A01,083765,Staff,0,2,30,30
1650124986497,MATH 20D,A02,083766,Staff,12,0,30,18
1650124986497,MATH 20D,A03,083767,Staff,28,0,30,2
1650124992531,MATH 20E,A01,083771,Staff,10,0,30,20
1650124992531,MATH 20E,A02,083772,Staff,20,0,30,10
1650124992531,MATH 20E,B01,083773,Staff,0,0,30,30
1650124992531,MATH 20E,B02,083774,Staff,13,0,30,17
1650124998583,MATH 103A,A01,083777,Staff,0,8,30,30
1650124998583,MATH 103A,A02,083778,Staff,0,7,30,30
1650124998583,MATH 103A,B01,083779,Staff,0,9,30,30
1650124998583,MATH 103A,B02,083780,Staff,0,6,30,30
1650125004609,MATH 105,A01,085443,Staff,0,13,30,30
1650125010706,MATH 109,A01,083213,Anzaldo; Leesa B,0,3,30,30
1650125010706,MATH 109,A02,083214,Anzaldo; Leesa B,0,5,30,30
1650125010706,MATH 109,B01,083215,Anzaldo; Leesa B,0,4,30,30
1650125010706,MATH 109,B02,083216,Anzaldo; Leesa B,0,4,30,30
1650125016731,MATH 142A,A01,083219,Chow; Bennett,0,10,30,30
1650125016731,MATH 142A,A02,083220,Chow; Bennett,0,10,30,30
1650125016731,MATH 142A,B01,083221,Chow; Bennett,0,10,30,30
1650125016731,MATH 142A,B02,083222,Chow; Bennett,0,10,30,30
1650125022758,MATH 193A,A01,083224,Staff,0,4,30,30
1650125022758,MATH 193A,A02,083225,Staff,0,4,30,30
1650125022758,MATH 193A,A03,083781,Staff,0,0,30,30
1650125022758,MATH 193A,A04,083782,Staff,2,0,30,28
1650125028785,MATH 197,001,091859,McAuley; Julian John,9998,0,9999,1
1650125034849,COGS 9,A01,083615,Staff,0,14,60,60
1650125040874,COGS 11,A01,083617,Boyle; Mary E. T.,24,0,40,16
1650125046898,COGS 13,A01,083071,Staff,0,28,40,40
1650125052926,COGS 14A,A01,092681,Staff,0,10,100,100
1650125058962,COGS 14B,A01,083073,Cheng; Tzu-Han,0,4,50,50
1650125064987,COGS 17,A01,092677,Staff,35,0,75,40
1650125071015,COGS 100,A01,083619,Staff,0,21,60,60
1650125077056,COGS 101A,A01,083621,Davis; Joshua Daniel,0,18,60,60
1650125083080,COGS 101B,A01,091572,Staff,10,0,60,50
1650125089104,COGS 101C,A01,083625,Delgado; Tania,22,0,30,8
1650125095128,COGS 107A,A01,083627,Boyle; Mary E. T.,0,4,60,60
1650125101151,COGS 118A,A01,083075,Staff,17,0,60,43
1650125107193,CSE 3,A50,083646,Miranda; Gregory Joseph,22,0,38,16
1650125107193,CSE 3,A51,083647,Miranda; Gregory Joseph,37,0,37,0
1650125113218,CSE 8A,A50,083650,Miranda; Gregory Joseph,0,16,40,40
1650125119254,CSE 11,A01,083080,Cao; Yingjun,0,66,40,40
1650125125287,CSE 12,A01,083652,Staff,0,2,100,100
1650125131321,CSE 15L,A01,083654,Staff,0,0,50,50
1650125131321,CSE 15L,A02,083655,Staff,10,0,50,40
1650125137349,CSE 20,A01,083657,Staff,58,0,80,22
1650125143388,CSE 30,A01,083084,Eldon; John,0,63,40,40
1650125149418,CSE 100,A01,083659,Cao; Yingjun,0,61,50,50
1650125155448,CSE 134B,A01,083661,Powell; Thomas Allan,0,27,65,65
1650125161472,CSE 140,A01,083663,Staff,4,0,75,71
1650125167498,CSE 140L,A01,083088,Eldon; John,0,1,75,75
1650125173523,CSE 175,A01,083665,Kumar; Rakesh,8,0,25,17
1650125179555,CSE 190,A00,092507,Dubnov; Shlomo,14,0,20,6
1650125185588,ECE 45,A01,083139,Staff,0,13,40,40
1650125191616,ECE 65,A50,083695,Staff,0,4,30,30
1650125197639,ECE 109,A01,091882,Touri; Behrouz,48,0,70,22
1650125203662,ECE 180,A00,083140,Abi Samra; Nicholas Camill,24,0,30,6
1650125203662,ECE 180,B00,083141,Abi Samra; Nicholas Camill,8,0,30,22
1650125209691,MATH 10A,A01,083735,Patchell; Gregory David,12,0,30,18
1650125209691,MATH 10A,A02,083736,Patchell; Gregory David,28,0,30,2
1650125209691,MATH 10A,A03,083737,Patchell; Gregory David,26,0,30,4
1650125215722,MATH 10B,A01,083207,Staff,0,5,30,30
1650125215722,MATH 10B,A02,083208,Staff,0,4,30,30
1650125215722,MATH 10B,B01,083739,Staff,18,0,30,12
1650125215722,MATH 10B,B02,083740,Staff,29,0,30,1
1650125221754,MATH 18,A01,083743,Staff,10,0,30,20
1650125221754,MATH 18,A02,083744,Staff,28,0,30,2
1650125221754,MATH 18,A03,083745,Staff,23,0,30,7
1650125221754,MATH 18,A04,083746,Staff,27,0,30,3
1650125221754,MATH 18,B01,083748,Staff,0,9,30,30
1650125221754,MATH 18,B02,083749,Staff,0,7,30,30
1650125221754,MATH 18,B03,083750,Staff,0,6,30,30
1650125221754,MATH 18,B04,083751,Staff,0,6,30,30
1650125227786,MATH 20A,A01,083754,Staff,26,0,40,14
1650125233817,MATH 20B,A01,083756,Staff,0,5,30,30
1650125233817,MATH 20B,A02,083757,Staff,0,2,30,30
1650125239841,MATH 20C,A01,083760,Staff,0,11,30,30
1650125239841,MATH 20C,A02,083761,Staff,0,12,30,30
1650125239841,MATH 20C,B01,083762,Staff,14,0,30,16
1650125239841,MATH 20C,B02,083763,Staff,28,0,30,2
1650125245867,MATH 20D,A01,083765,Staff,0,2,30,30
1650125245867,MATH 20D,A02,083766,Staff,12,0,30,18
1650125245867,MATH 20D,A03,083767,Staff,28,0,30,2
1650125251894,MATH 20E,A01,083771,Staff,10,0,30,20
1650125251894,MATH 20E,A02,083772,Staff,20,0,30,10
1650125251894,MATH 20E,B01,083773,Staff,0,0,30,30
1650125251894,MATH 20E,B02,083774,Staff,13,0,30,17
1650125257932,MATH 103A,A01,083777,Staff,0,8,30,30
1650125257932,MATH 103A,A02,083778,Staff,0,7,30,30
1650125257932,MATH 103A,B01,083779,Staff,0,9,30,30
1650125257932,MATH 103A,B02,083780,Staff,0,6,30,30
1650125263956,MATH 105,A01,085443,Staff,0,13,30,30
1650125269983,MATH 109,A01,083213,Anzaldo; Leesa B,0,3,30,30
1650125269983,MATH 109,A02,083214,Anzaldo; Leesa B,0,5,30,30
1650125269983,MATH 109,B01,083215,Anzaldo; Leesa B,0,4,30,30
1650125269983,MATH 109,B02,083216,Anzaldo; Leesa B,0,4,30,30
1650125276008,MATH 142A,A01,083219,Chow; Bennett,0,10,30,30
1650125276008,MATH 142A,A02,083220,Chow; Bennett,0,10,30,30
1650125276008,MATH 142A,B01,083221,Chow; Bennett,0,10,30,30
1650125276008,MATH 142A,B02,083222,Chow; Bennett,0,10,30,30
1650125282033,MATH 193A,A01,083224,Staff,0,4,30,30
1650125282033,MATH 193A,A02,083225,Staff,0,4,30,30
1650125282033,MATH 193A,A03,083781,Staff,0,0,30,30
1650125282033,MATH 193A,A04,083782,Staff,2,0,30,28
1650125288060,MATH 197,001,091859,McAuley; Julian John,9998,0,9999,1
1650125294163,COGS 9,A01,083615,Staff,0,14,60,60
1650125300197,COGS 11,A01,083617,Boyle; Mary E. T.,24,0,40,16
1650125306220,COGS 13,A01,083071,Staff,0,28,40,40
1650125312264,COGS 14A,A01,092681,Staff,0,10,100,100
1650125318290,COGS 14B,A01,083073,Cheng; Tzu-Han,0,4,50,50
1650125324312,COGS 17,A01,092677,Staff,35,0,75,40
1650125330344,COGS 100,A01,083619,Staff,0,21,60,60
1650125336369,COGS 101A,A01,083621,Davis; Joshua Daniel,0,18,60,60
1650125342415,COGS 101B,A01,091572,Staff,10,0,60,50
1650125348444,COGS 101C,A01,083625,Delgado; Tania,22,0,30,8
1650125354467,COGS 107A,A01,083627,Boyle; Mary E. T.,0,4,60,60
1650125360497,COGS 118A,A01,083075,Staff,17,0,60,43
1650125366527,CSE 3,A50,083646,Miranda; Gregory Joseph,22,0,38,16
1650125366527,CSE 3,A51,083647,Miranda; Gregory Joseph,37,0,37,0
1650125372564,CSE 8A,A50,083650,Miranda; Gregory Joseph,0,16,40,40
1650125378588,CSE 11,A01,083080,Cao; Yingjun,0,66,40,40
1650125384623,CSE 12,A01,083652,Staff,0,2,100,100
1650125390665,CSE 15L,A01,083654,Staff,0,0,50,50
1650125390665,CSE 15L,A02,083655,Staff,10,0,50,40
1650125396699,CSE 20,A01,083657,Staff,58,0,80,22
1650125402727,CSE 30,A01,083084,Eldon; John,0,63,40,40
1650125408755,CSE 100,A01,083659,Cao; Yingjun,0,61,50,50
1650125414797,CSE 134B,A01,083661,Powell; Thomas Allan,0,27,65,65
1650125420835,CSE 140,A01,083663,Staff,4,0,75,71
1650125426870,CSE 140L,A01,083088,Eldon; John,0,1,75,75
1650125432899,CSE 175,A01,083665,Kumar; Rakesh,8,0,25,17
1650125438923,CSE 190,A00,092507,Dubnov; Shlomo,14,0,20,6
1650125444947,ECE 45,A01,083139,Staff,0,13,40,40
1650125450979,ECE 65,A50,083695,Staff,0,4,30,30
1650125457003,ECE 109,A01,091882,Touri; Behrouz,48,0,70,22
1650125463027,ECE 180,A00,083140,Abi Samra; Nicholas Camill,24,0,30,6
1650125463027,ECE 180,B00,083141,Abi Samra; Nicholas Camill,8,0,30,22
1650125469056,MATH 10A,A01,083735,Patchell; Gregory David,12,0,30,18
1650125469056,MATH 10A,A02,083736,Patchell; Gregory David,28,0,30,2
1650125469056,MATH 10A,A03,083737,Patchell; Gregory David,26,0,30,4
1650125475090,MATH 10B,A01,083207,Staff,0,5,30,30
1650125475090,MATH 10B,A02,083208,Staff,0,4,30,30
1650125475090,MATH 10B,B01,083739,Staff,18,0,30,12
1650125475090,MATH 10B,B02,083740,Staff,29,0,30,1
1650125481134,MATH 18,A01,083743,Staff,10,0,30,20
1650125481134,MATH 18,A02,083744,Staff,28,0,30,2
1650125481134,MATH 18,A03,083745,Staff,23,0,30,7
1650125481134,MATH 18,A04,083746,Staff,27,0,30,3
1650125481134,MATH 18,B01,083748,Staff,0,9,30,30
1650125481134,MATH 18,B02,083749,Staff,0,7,30,30
1650125481134,MATH 18,B03,083750,Staff,0,6,30,30
1650125481134,MATH 18,B04,083751,Staff,0,6,30,30
1650125487162,MATH 20A,A01,083754,Staff,26,0,40,14
1650125493195,MATH 20B,A01,083756,Staff,0,5,30,30
1650125493195,MATH 20B,A02,083757,Staff,0,2,30,30
1650125499223,MATH 20C,A01,083760,Staff,0,11,30,30
1650125499223,MATH 20C,A02,083761,Staff,0,12,30,30
1650125499223,MATH 20C,B01,083762,Staff,14,0,30,16
1650125499223,MATH 20C,B02,083763,Staff,28,0,30,2
1650125505247,MATH 20D,A01,083765,Staff,0,2,30,30
1650125505247,MATH 20D,A02,083766,Staff,12,0,30,18
1650125505247,MATH 20D,A03,083767,Staff,28,0,30,2
1650125511271,MATH 20E,A01,083771,Staff,10,0,30,20
1650125511271,MATH 20E,A02,083772,Staff,20,0,30,10
1650125511271,MATH 20E,B01,083773,Staff,0,0,30,30
1650125511271,MATH 20E,B02,083774,Staff,13,0,30,17
1650125517293,MATH 103A,A01,083777,Staff,0,8,30,30
1650125517293,MATH 103A,A02,083778,Staff,0,7,30,30
1650125517293,MATH 103A,B01,083779,Staff,0,9,30,30
1650125517293,MATH 103A,B02,083780,Staff,0,6,30,30
1650125523335,MATH 105,A01,085443,Staff,0,13,30,30
1650125529367,MATH 109,A01,083213,Anzaldo; Leesa B,0,3,30,30
1650125529367,MATH 109,A02,083214,Anzaldo; Leesa B,0,5,30,30
1650125529367,MATH 109,B01,083215,Anzaldo; Leesa B,0,4,30,30
1650125529367,MATH 109,B02,083216,Anzaldo; Leesa B,0,4,30,30
1650125535391,MATH 142A,A01,083219,Chow; Bennett,0,10,30,30
1650125535391,MATH 142A,A02,083220,Chow; Bennett,0,10,30,30
1650125535391,MATH 142A,B01,083221,Chow; Bennett,0,10,30,30
1650125535391,MATH 142A,B02,083222,Chow; Bennett,0,10,30,30
1650125541433,MATH 193A,A01,083224,Staff,0,4,30,30
1650125541433,MATH 193A,A02,083225,Staff,0,4,30,30
1650125541433,MATH 193A,A03,083781,Staff,0,0,30,30
1650125541433,MATH 193A,A04,083782,Staff,2,0,30,28
1650125547475,MATH 197,001,091859,McAuley; Julian John,9998,0,9999,1
1650125553543,COGS 9,A01,083615,Staff,0,14,60,60
1650125559583,COGS 11,A01,083617,Boyle; Mary E. T.,24,0,40,16
1650125565609,COGS 13,A01,083071,Staff,0,28,40,40
1650125571657,COGS 14A,A01,092681,Staff,0,10,100,100
1650125577685,COGS 14B,A01,083073,Cheng; Tzu-Han,0,4,50,50
1650125583708,COGS 17,A01,092677,Staff,35,0,75,40
1650125589731,COGS 100,A01,083619,Staff,0,21,60,60
1650125595754,COGS 101A,A01,083621,Davis; Joshua Daniel,0,18,60,60
1650125601851,COGS 101B,A01,091572,Staff,10,0,60,50
1650125607875,COGS 101C,A01,083625,Delgado; Tania,22,0,30,8
1650125613899,COGS 107A,A01,083627,Boyle; Mary E. T.,0,4,60,60
1650125619923,COGS 118A,A01,083075,Staff,17,0,60,43
1650125625947,CSE 3,A50,083646,Miranda; Gregory Joseph,22,0,38,16
1650125625947,CSE 3,A51,083647,Miranda; Gregory Joseph,37,0,37,0
1650125631971,CSE 8A,A50,083650,Miranda; Gregory Joseph,0,16,40,40
1650125638003,CSE 11,A01,083080,Cao; Yingjun,0,66,40,40
1650125644031,CSE 12,A01,083652,Staff,0,2,100,100
1650125650072,CSE 15L,A01,083654,Staff,0,0,50,50
1650125650072,CSE 15L,A02,083655,Staff,10,0,50,40
1650125656101,CSE 20,A01,083657,Staff,58,0,80,22
1650125662136,CSE 30,A01,083084,Eldon; John,0,63,40,40
1650125668187,CSE 100,A01,083659,Cao; Yingjun,0,61,50,50
1650125674211,CSE 134B,A01,083661,Powell; Thomas Allan,0,27,65,65
1650125680249,CSE 140,A01,083663,Staff,4,0,75,71
1650125686275,CSE 140L,A01,083088,Eldon; John,0,1,75,75
1650125692299,CSE 175,A01,083665,Kumar; Rakesh,8,0,25,17
1650125698333,CSE 190,A00,092507,Dubnov; Shlomo,14,0,20,6
1650125704357,ECE 45,A01,083139,Staff,0,13,40,40
1650125710381,ECE 65,A50,083695,Staff,0,4,30,30
1650125716412,ECE 109,A01,091882,Touri; Behrouz,48,0,70,22
1650125722444,ECE 180,A00,083140,Abi Samra; Nicholas Camill,24,0,30,6
1650125722444,ECE 180,B00,083141,Abi Samra; Nicholas Camill,8,0,30,22
1650125728469,MATH 10A,A01,083735,Patchell; Gregory David,12,0,30,18
1650125728469,MATH 10A,A02,083736,Patchell; Gregory David,28,0,30,2
1650125728469,MATH 10A,A03,083737,Patchell; Gregory David,26,0,30,4
1650125734496,MATH 10B,A01,083207,Staff,0,5,30,30
1650125734496,MATH 10B,A02,083208,Staff,0,4,30,30
1650125734496,MATH 10B,B01,083739,Staff,18,0,30,12
1650125734496,MATH 10B,B02,083740,Staff,29,0,30,1
1650125740526,MATH 18,A01,083743,Staff,10,0,30,20
1650125740526,MATH 18,A02,083744,Staff,28,0,30,2
1650125740526,MATH 18,A03,083745,Staff,23,0,30,7
1650125740526,MATH 18,A04,083746,Staff,27,0,30,3
1650125740526,MATH 18,B01,083748,Staff,0,9,30,30
1650125740526,MATH 18,B02,083749,Staff,0,7,30,30
1650125740526,MATH 18,B03,083750,Staff,0,6,30,30
1650125740526,MATH 18,B04,083751,Staff,0,6,30,30
1650125746563,MATH 20A,A01,083754,Staff,26,0,40,14
1650125752587,MATH 20B,A01,083756,Staff,0,5,30,30
1650125752587,MATH 20B,A02,083757,Staff,0,2,30,30
1650125758628,MATH 20C,A01,083760,Staff,0,11,30,30
1650125758628,MATH 20C,A02,083761,Staff,0,12,30,30
1650125758628,MATH 20C,B01,083762,Staff,14,0,30,16
1650125758628,MATH 20C,B02,083763,Staff,28,0,30,2
1650125764655,MATH 20D,A01,083765,Staff,0,2,30,30
1650125764655,MATH 20D,A02,083766,Staff,12,0,30,18
1650125764655,MATH 20D,A03,083767,Staff,28,0,30,2
1650125770679,MATH 20E,A01,083771,Staff,10,0,30,20
1650125770679,MATH 20E,A02,083772,Staff,20,0,30,10
1650125770679,MATH 20E,B01,083773,Staff,0,0,30,30
1650125770679,MATH 20E,B02,083774,Staff,13,0,30,17
1650125776703,MATH 103A,A01,083777,Staff,0,8,30,30
1650125776703,MATH 103A,A02,083778,Staff,0,7,30,30
1650125776703,MATH 103A,B01,083779,Staff,0,9,30,30
1650125776703,MATH 103A,B02,083780,Staff,0,6,30,30
1650125782752,MATH 105,A01,085443,Staff,0,13,30,30
1650125788782,MATH 109,A01,083213,Anzaldo; Leesa B,0,3,30,30
1650125788782,MATH 109,A02,083214,Anzaldo; Leesa B,0,5,30,30
1650125788782,MATH 109,B01,083215,Anzaldo; Leesa B,0,4,30,30
1650125788782,MATH 109,B02,083216,Anzaldo; Leesa B,0,4,30,30
1650125794822,MATH 142A,A01,083219,Chow; Bennett,0,11,30,30
1650125794822,MATH 142A,A02,083220,Chow; Bennett,0,10,30,30
1650125794822,MATH 142A,B01,083221,Chow; Bennett,0,10,30,30
1650125794822,MATH 142A,B02,083222,Chow; Bennett,0,10,30,30
1650125800846,MATH 193A,A01,083224,Staff,0,4,30,30
1650125800846,MATH 193A,A02,083225,Staff,0,4,30,30
1650125800846,MATH 193A,A03,083781,Staff,0,0,30,30
1650125800846,MATH 193A,A04,083782,Staff,2,0,30,28
1650125806888,MATH 197,001,091859,McAuley; Julian John,9998,0,9999,1
1650125812972,COGS 9,A01,083615,Staff,0,14,60,60
1650125819007,COGS 11,A01,083617,Boyle; Mary E. T.,24,0,40,16
1650125825043,COGS 13,A01,083071,Staff,0,28,40,40
1650125831070,COGS 14A,A01,092681,Staff,0,10,100,100
1650125837094,COGS 14B,A01,083073,Cheng; Tzu-Han,0,4,50,50
1650125843118,COGS 17,A01,092677,Staff,35,0,75,40
1650125849154,COGS 100,A01,083619,Staff,0,21,60,60
1650125855175,COGS 101A,A01,083621,Davis; Joshua Daniel,0,18,60,60
1650125861199,COGS 101B,A01,091572,Staff,10,0,60,50
1650125867245,COGS 101C,A01,083625,Delgado; Tania,22,0,30,8
1650125873269,COGS 107A,A01,083627,Boyle; Mary E. T.,0,4,60,60
1650125879321,COGS 118A,A01,083075,Staff,17,0,60,43
1650125885357,CSE 3,A50,083646,Miranda; Gregory Joseph,22,0,38,16
1650125885357,CSE 3,A51,083647,Miranda; Gregory Joseph,37,0,37,0
1650125891396,CSE 8A,A50,083650,Miranda; Gregory Joseph,0,16,40,40
1650125897427,CSE 11,A01,083080,Cao; Yingjun,0,66,40,40
1650125903453,CSE 12,A01,083652,Staff,0,2,100,100
1650125909478,CSE 15L,A01,083654,Staff,0,0,50,50
1650125909478,CSE 15L,A02,083655,Staff,10,0,50,40
1650125915510,CSE 20,A01,083657,Staff,58,0,80,22
1650125921535,CSE 30,A01,083084,Eldon; John,0,63,40,40
1650125927558,CSE 100,A01,083659,Cao; Yingjun,0,61,50,50
1650125933592,CSE 134B,A01,083661,Powell; Thomas Allan,0,27,65,65
1650125939615,CSE 140,A01,083663,Staff,4,0,75,71
1650125945662,CSE 140L,A01,083088,Eldon; John,0,1,75,75
1650125951701,CSE 175,A01,083665,Kumar; Rakesh,8,0,25,17
1650125957736,CSE 190,A00,092507,Dubnov; Shlomo,14,0,20,6
1650125963761,ECE 45,A01,083139,Staff,0,13,40,40
1650125969788,ECE 65,A50,083695,Staff,0,4,30,30
1650125975811,ECE 109,A01,091882,Touri; Behrouz,48,0,70,22
1650125981844,ECE 180,A00,083140,Abi Samra; Nicholas Camill,24,0,30,6
1650125981844,ECE 180,B00,083141,Abi Samra; Nicholas Camill,8,0,30,22
1650125987869,MATH 10A,A01,083735,Patchell; Gregory David,12,0,30,18
1650125987869,MATH 10A,A02,083736,Patchell; Gregory David,28,0,30,2
1650125987869,MATH 10A,A03,083737,Patchell; Gregory David,26,0,30,4
1650125993893,MATH 10B,A01,083207,Staff,0,5,30,30
1650125993893,MATH 10B,A02,083208,Staff,0,4,30,30
1650125993893,MATH 10B,B01,083739,Staff,18,0,30,12
1650125993893,MATH 10B,B02,083740,Staff,29,0,30,1
1650125999922,MATH 18,A01,083743,Staff,10,0,30,20
1650125999922,MATH 18,A02,083744,Staff,28,0,30,2
1650125999922,MATH 18,A03,083745,Staff,23,0,30,7
1650125999922,MATH 18,A04,083746,Staff,27,0,30,3
1650125999922,MATH 18,B01,083748,Staff,0,9,30,30
1650125999922,MATH 18,B02,083749,Staff,0,7,30,30
1650125999922,MATH 18,B03,083750,Staff,0,6,30,30
1650125999922,MATH 18,B04,083751,Staff,0,6,30,30
1650126005946,MATH 20A,A01,083754,Staff,26,0,40,14
1650126011996,MATH 20B,A01,083756,Staff,0,5,30,30
1650126011996,MATH 20B,A02,083757,Staff,0,2,30,30
1650126018043,MATH 20C,A01,083760,Staff,0,11,30,30
1650126018043,MATH 20C,A02,083761,Staff,0,12,30,30
1650126018043,MATH 20C,B01,083762,Staff,14,0,30,16
1650126018043,MATH 20C,B02,083763,Staff,28,0,30,2
1650126024065,MATH 20D,A01,083765,Staff,0,2,30,30
1650126024065,MATH 20D,A02,083766,Staff,12,0,30,18
1650126024065,MATH 20D,A03,083767,Staff,28,0,30,2
1650126030109,MATH 20E,A01,083771,Staff,10,0,30,20
1650126030109,MATH 20E,A02,083772,Staff,20,0,30,10
1650126030109,MATH 20E,B01,083773,Staff,0,0,30,30
1650126030109,MATH 20E,B02,083774,Staff,13,0,30,17
1650126036137,MATH 103A,A01,083777,Staff,0,8,30,30
1650126036137,MATH 103A,A02,083778,Staff,0,7,30,30
1650126036137,MATH 103A,B01,083779,Staff,0,9,30,30
1650126036137,MATH 103A,B02,083780,Staff,0,6,30,30
1650126042161,MATH 105,A01,085443,Staff,0,13,30,30
1650126048186,MATH 109,A01,083213,Anzaldo; Leesa B,0,3,30,30
1650126048186,MATH 109,A02,083214,Anzaldo; Leesa B,0,5,30,30
1650126048186,MATH 109,B01,083215,Anzaldo; Leesa B,0,4,30,30
1650126048186,MATH 109,B02,083216,Anzaldo; Leesa B,0,4,30,30
1650126054217,MATH 142A,A01,083219,Chow; Bennett,0,11,30,30
1650126054217,MATH 142A,A02,083220,Chow; Bennett,0,10,30,30
1650126054217,MATH 142A,B01,083221,Chow; Bennett,0,10,30,30
1650126054217,MATH 142A,B02,083222,Chow; Bennett,0,10,30,30
1650126060242,MATH 193A,A01,083224,Staff,0,4,30,30
1650126060242,MATH 193A,A02,083225,Staff,0,4,30,30
1650126060242,MATH 193A,A03,083781,Staff,0,0,30,30
1650126060242,MATH 193A,A04,083782,Staff,2,0,30,28
1650126066273,MATH 197,001,091859,McAuley; Julian John,9998,0,9999,1
1650126072366,COGS 9,A01,083615,Staff,0,14,60,60
1650126078390,COGS 11,A01,083617,Boyle; Mary E. T.,24,0,40,16
1650126084428,COGS 13,A01,083071,Staff,0,28,40,40
1650126090457,COGS 14A,A01,092681,Staff,0,10,100,100
1650126096484,COGS 14B,A01,083073,Cheng; Tzu-Han,0,4,50,50
1650126102521,COGS 17,A01,092677,Staff,35,0,75,40
1650126108549,COGS 100,A01,083619,Staff,0,21,60,60
1650126114574,COGS 101A,A01,083621,Davis; Joshua Daniel,0,18,60,60
1650126120600,COGS 101B,A01,091572,Staff,10,0,60,50
1650126126646,COGS 101C,A01,083625,Delgado; Tania,22,0,30,8
1650126132674,COGS 107A,A01,083627,Boyle; Mary E. T.,0,4,60,60
1650126138699,COGS 118A,A01,083075,Staff,17,0,60,43
1650126144724,CSE 3,A50,083646,Miranda; Gregory Joseph,22,0,38,16
1650126144724,CSE 3,A51,083647,Miranda; Gregory Joseph,37,0,37,0
1650126150752,CSE 8A,A50,083650,Miranda; Gregory Joseph,0,16,40,40
1650126156776,CSE 11,A01,083080,Cao; Yingjun,0,66,40,40
1650126162804,CSE 12,A01,083652,Staff,0,2,100,100
1650126168830,CSE 15L,A01,083654,Staff,0,0,50,50
1650126168830,CSE 15L,A02,083655,Staff,10,0,50,40
1650126174857,CSE 20,A01,083657,Staff,58,0,80,22
1650126180883,CSE 30,A01,083084,Eldon; John,0,63,40,40
1650126186935,CSE 100,A01,083659,Cao; Yingjun,0,61,50,50
1650126192982,CSE 134B,A01,083661,Powell; Thomas Allan,0,27,65,65
1650126199085,CSE 140,A01,083663,Staff,4,0,75,71
1650126205124,CSE 140L,A01,083088,Eldon; John,0,1,75,75
1650126211158,CSE 175,A01,083665,Kumar; Rakesh,8,0,25,17
1650126217185,CSE 190,A00,092507,Dubnov; Shlomo,14,0,20,6
1650126223207,ECE 45,A01,083139,Staff,0,13,40,40
1650126229257,ECE 65,A50,083695,Staff,0,4,30,30
1650126235280,ECE 109,A01,091882,Touri; Behrouz,48,0,70,22
1650126241327,ECE 180,A00,083140,Abi Samra; Nicholas Camill,24,0,30,6
1650126241327,ECE 180,B00,083141,Abi Samra; Nicholas Camill,8,0,30,22
1650126247362,MATH 10A,A01,083735,Patchell; Gregory David,12,0,30,18
1650126247362,MATH 10A,A02,083736,Patchell; Gregory David,28,0,30,2
1650126247362,MATH 10A,A03,083737,Patchell; Gregory David,26,0,30,4
1650126253391,MATH 10B,A01,083207,Staff,0,5,30,30
1650126253391,MATH 10B,A02,083208,Staff,0,4,30,30
1650126253391,MATH 10B,B01,083739,Staff,18,0,30,12
1650126253391,MATH 10B,B02,083740,Staff,29,0,30,1
1650126259417,MATH 18,A01,083743,Staff,10,0,30,20
1650126259417,MATH 18,A02,083744,Staff,28,0,30,2
1650126259417,MATH 18,A03,083745,Staff,23,0,30,7
1650126259417,MATH 18,A04,083746,Staff,27,0,30,3
1650126259417,MATH 18,B01,083748,Staff,0,9,30,30
1650126259417,MATH 18,B02,083749,Staff,0,7,30,30
1650126259417,MATH 18,B03,083750,Staff,0,6,30,30
1650126259417,MATH 18,B04,083751,Staff,0,7,30,30
1650126265441,MATH 20A,A01,083754,Staff,26,0,40,14
1650126271469,MATH 20B,A01,083756,Staff,0,5,30,30
1650126271469,MATH 20B,A02,083757,Staff,0,2,30,30
1650126277496,MATH 20C,A01,083760,Staff,0,11,30,30
1650126277496,MATH 20C,A02,083761,Staff,0,12,30,30
1650126277496,MATH 20C,B01,083762,Staff,14,0,30,16
1650126277496,MATH 20C,B02,083763,Staff,28,0,30,2
1650126283532,MATH 20D,A01,083765,Staff,0,2,30,30
1650126283532,MATH 20D,A02,083766,Staff,12,0,30,18
1650126283532,MATH 20D,A03,083767,Staff,28,0,30,2
1650126289560,MATH 20E,A01,083771,Staff,10,0,30,20
1650126289560,MATH 20E,A02,083772,Staff,20,0,30,10
1650126289560,MATH 20E,B01,083773,Staff,0,0,30,30
1650126289560,MATH 20E,B02,083774,Staff,13,0,30,17
1650126295585,MATH 103A,A01,083777,Staff,0,8,30,30
1650126295585,MATH 103A,A02,083778,Staff,0,7,30,30
1650126295585,MATH 103A,B01,083779,Staff,0,9,30,30
1650126295585,MATH 103A,B02,083780,Staff,0,6,30,30
1650126301615,MATH 105,A01,085443,Staff,0,13,30,30
1650126307643,MATH 109,A01,083213,Anzaldo; Leesa B,0,3,30,30
1650126307643,MATH 109,A02,083214,Anzaldo; Leesa B,0,5,30,30
1650126307643,MATH 109,B01,083215,Anzaldo; Leesa B,0,4,30,30
1650126307643,MATH 109,B02,083216,Anzaldo; Leesa B,0,4,30,30
1650126313670,MATH 142A,A01,083219,Chow; Bennett,0,11,30,30
1650126313670,MATH 142A,A02,083220,Chow; Bennett,0,10,30,30
1650126313670,MATH 142A,B01,083221,Chow; Bennett,0,10,30,30
1650126313670,MATH 142A,B02,083222,Chow; Bennett,0,10,30,30
1650126319723,MATH 193A,A01,083224,Staff,0,4,30,30
1650126319723,MATH 193A,A02,083225,Staff,0,4,30,30
1650126319723,MATH 193A,A03,083781,Staff,0,0,30,30
1650126319723,MATH 193A,A04,083782,Staff,2,0,30,28
1650126325747,MATH 197,001,091859,McAuley; Julian John,9998,0,9999,1
1650126331824,COGS 9,A01,083615,Staff,0,14,60,60
1650126337866,COGS 11,A01,083617,Boyle; Mary E. T.,24,0,40,16
1650126343890,COGS 13,A01,083071,Staff,0,28,40,40
1650126349914,COGS 14A,A01,092681,Staff,0,10,100,100
1650126355940,COGS 14B,A01,083073,Cheng; Tzu-Han,0,4,50,50
1650126361984,COGS 17,A01,092677,Staff,34,0,75,41
1650126368010,COGS 100,A01,083619,Staff,0,21,60,60
1650126374034,COGS 101A,A01,083621,Davis; Joshua Daniel,0,18,60,60
1650126380066,COGS 101B,A01,091572,Staff,10,0,60,50
1650126386098,COGS 101C,A01,083625,Delgado; Tania,22,0,30,8
1650126392123,COGS 107A,A01,083627,Boyle; Mary E. T.,0,4,60,60
1650126398161,COGS 118A,A01,083075,Staff,17,0,60,43
1650126404185,CSE 3,A50,083646,Miranda; Gregory Joseph,22,0,38,16
1650126404185,CSE 3,A51,083647,Miranda; Gregory Joseph,37,0,37,0
1650126410207,CSE 8A,A50,083650,Miranda; Gregory Joseph,0,16,40,40
1650126416230,CSE 11,A01,083080,Cao; Yingjun,0,66,40,40
1650126422252,CSE 12,A01,083652,Staff,0,2,100,100
1650126428277,CSE 15L,A01,083654,Staff,0,0,50,50
1650126428277,CSE 15L,A02,083655,Staff,10,0,50,40
1650126434303,CSE 20,A01,083657,Staff,58,0,80,22
1650126440334,CSE 30,A01,083084,Eldon; John,0,63,40,40
1650126446357,CSE 100,A01,083659,Cao; Yingjun,0,61,50,50
1650126452381,CSE 134B,A01,083661,Powell; Thomas Allan,0,27,65,65
1650126458404,CSE 140,A01,083663,Staff,4,0,75,71
1650126464442,CSE 140L,A01,083088,Eldon; John,0,1,75,75
1650126470465,CSE 175,A01,083665,Kumar; Rakesh,8,0,25,17
1650126476495,CSE 190,A00,092507,Dubnov; Shlomo,14,0,20,6
1650126482518,ECE 45,A01,083139,Staff,0,13,40,40
1650126488550,ECE 65,A50,083695,Staff,0,4,30,30
1650126494574,ECE 109,A01,091882,Touri; Behrouz,48,0,70,22
1650126500611,ECE 180,A00,083140,Abi Samra; Nicholas Camill,24,0,30,6
1650126500611,ECE 180,B00,083141,Abi Samra; Nicholas Camill,8,0,30,22
1650126506656,MATH 10A,A01,083735,Patchell; Gregory David,12,0,30,18
1650126506656,MATH 10A,A02,083736,Patchell; Gregory David,28,0,30,2
1650126506656,MATH 10A,A03,083737,Patchell; Gregory David,26,0,30,4
1650126512683,MATH 10B,A01,083207,Staff,0,5,30,30
1650126512683,MATH 10B,A02,083208,Staff,0,4,30,30
1650126512683,MATH 10B,B01,083739,Staff,18,0,30,12
1650126512683,MATH 10B,B02,083740,Staff,29,0,30,1
1650126518719,MATH 18,A01,083743,Staff,10,0,30,20
1650126518719,MATH 18,A02,083744,Staff,28,0,30,2
1650126518719,MATH 18,A03,083745,Staff,23,0,30,7
1650126518719,MATH 18,A04,083746,Staff,27,0,30,3
1650126518719,MATH 18,B01,083748,Staff,0,9,30,30
1650126518719,MATH 18,B02,083749,Staff,0,7,30,30
1650126518719,MATH 18,B03,083750,Staff,0,6,30,30
1650126518719,MATH 18,B04,083751,Staff,0,7,30,30
1650126524751,MATH 20A,A01,083754,Staff,26,0,40,14
1650126530776,MATH 20B,A01,083756,Staff,0,5,30,30
1650126530776,MATH 20B,A02,083757,Staff,0,2,30,30
1650126536801,MATH 20C,A01,083760,Staff,0,11,30,30
1650126536801,MATH 20C,A02,083761,Staff,0,12,30,30
1650126536801,MATH 20C,B01,083762,Staff,14,0,30,16
1650126536801,MATH 20C,B02,083763,Staff,28,0,30,2
1650126542829,MATH 20D,A01,083765,Staff,0,2,30,30
1650126542829,MATH 20D,A02,083766,Staff,12,0,30,18
1650126542829,MATH 20D,A03,083767,Staff,28,0,30,2
1650126548856,MATH 20E,A01,083771,Staff,10,0,30,20
1650126548856,MATH 20E,A02,083772,Staff,20,0,30,10
1650126548856,MATH 20E,B01,083773,Staff,0,0,30,30
1650126548856,MATH 20E,B02,083774,Staff,13,0,30,17
1650126554882,MATH 103A,A01,083777,Staff,0,8,30,30
1650126554882,MATH 103A,A02,083778,Staff,0,8,30,30
1650126554882,MATH 103A,B01,083779,Staff,0,9,30,30
1650126554882,MATH 103A,B02,083780,Staff,0,6,30,30
1650126560938,MATH 105,A01,085443,Staff,0,13,30,30
1650126566970,MATH 109,A01,083213,Anzaldo; Leesa B,0,3,30,30
1650126566970,MATH 109,A02,083214,Anzaldo; Leesa B,0,5,30,30
1650126566970,MATH 109,B01,083215,Anzaldo; Leesa B,0,4,30,30
1650126566970,MATH 109,B02,083216,Anzaldo; Leesa B,0,4,30,30
1650126572995,MATH 142A,A01,083219,Chow; Bennett,0,11,30,30
1650126572995,MATH 142A,A02,083220,Chow; Bennett,0,10,30,30
1650126572995,MATH 142A,B01,083221,Chow; Bennett,0,10,30,30
1650126572995,MATH 142A,B02,083222,Chow; Bennett,0,10,30,30
1650126579019,MATH 193A,A01,083224,Staff,0,4,30,30
1650126579019,MATH 193A,A02,083225,Staff,0,4,30,30
1650126579019,MATH 193A,A03,083781,Staff,0,0,30,30
1650126579019,MATH 193A,A04,083782,Staff,2,0,30,28
1650126585043,MATH 197,001,091859,McAuley; Julian John,9998,0,9999,1
1650126591105,COGS 9,A01,083615,Staff,0,14,60,60
1650126597132,COGS 11,A01,083617,Boyle; Mary E. T.,24,0,40,16
1650126603166,COGS 13,A01,083071,Staff,0,28,40,40
1650126609194,COGS 14A,A01,092681,Staff,0,10,100,100
1650126615221,COGS 14B,A01,083073,Cheng; Tzu-Han,0,4,50,50
1650126621245,COGS 17,A01,092677,Staff,34,0,75,41
1650126627287,COGS 100,A01,083619,Staff,0,21,60,60
1650126633319,COGS 101A,A01,083621,Davis; Joshua Daniel,0,18,60,60
1650126639340,COGS 101B,A01,091572,Staff,10,0,60,50
1650126645368,COGS 101C,A01,083625,Delgado; Tania,22,0,30,8
1650126651395,COGS 107A,A01,083627,Boyle; Mary E. T.,0,4,60,60
1650126657421,COGS 118A,A01,083075,Staff,17,0,60,43
1650126663445,CSE 3,A50,083646,Miranda; Gregory Joseph,22,0,38,16
1650126663445,CSE 3,A51,083647,Miranda; Gregory Joseph,37,0,37,0
1650126669470,CSE 8A,A50,083650,Miranda; Gregory Joseph,0,16,40,40
1650126675493,CSE 11,A01,083080,Cao; Yingjun,0,66,40,40
1650126681520,CSE 12,A01,083652,Staff,0,2,100,100
1650126687543,CSE 15L,A01,083654,Staff,0,0,50,50
1650126687543,CSE 15L,A02,083655,Staff,10,0,50,40
1650126693588,CSE 20,A01,083657,Staff,57,0,80,23
1650126699615,CSE 30,A01,083084,Eldon; John,0,63,40,40
1650126705640,CSE 100,A01,083659,Cao; Yingjun,0,61,50,50
1650126711667,CSE 134B,A01,083661,Powell; Thomas Allan,0,27,65,65
1650126717691,CSE 140,A01,083663,Staff,4,0,75,71
1650126723713,CSE 140L,A01,083088,Eldon; John,0,1,75,75
1650126729742,CSE 175,A01,083665,Kumar; Rakesh,8,0,25,17
1650126735779,CSE 190,A00,092507,Dubnov; Shlomo,14,0,20,6
1650126741811,ECE 45,A01,083139,Staff,0,13,40,40
1650126747847,ECE 65,A50,083695,Staff,0,4,30,30
1650126753886,ECE 109,A01,091882,Touri; Behrouz,48,0,70,22
1650126759910,ECE 180,A00,083140,Abi Samra; Nicholas Camill,24,0,30,6
1650126759910,ECE 180,B00,083141,Abi Samra; Nicholas Camill,8,0,30,22
1650126765940,MATH 10A,A01,083735,Patchell; Gregory David,12,0,30,18
1650126765940,MATH 10A,A02,083736,Patchell; Gregory David,28,0,30,2
1650126765940,MATH 10A,A03,083737,Patchell; Gregory David,26,0,30,4
1650126771965,MATH 10B,A01,083207,Staff,0,5,30,30
1650126771965,MATH 10B,A02,083208,Staff,0,4,30,30
1650126771965,MATH 10B,B01,083739,Staff,18,0,30,12
1650126771965,MATH 10B,B02,083740,Staff,29,0,30,1
1650126778006,MATH 18,A01,083743,Staff,10,0,30,20
1650126778006,MATH 18,A02,083744,Staff,28,0,30,2
1650126778006,MATH 18,A03,083745,Staff,23,0,30,7
1650126778006,MATH 18,A04,083746,Staff,27,0,30,3
1650126778006,MATH 18,B01,083748,Staff,0,9,30,30
1650126778006,MATH 18,B02,083749,Staff,0,7,30,30
1650126778006,MATH 18,B03,083750,Staff,0,6,30,30
1650126778006,MATH 18,B04,083751,Staff,0,7,30,30
1650126784035,MATH 20A,A01,083754,Staff,26,0,40,14
1650126790059,MATH 20B,A01,083756,Staff,0,5,30,30
1650126790059,MATH 20B,A02,083757,Staff,0,3,30,30
1650126796160,MATH 20C,A01,083760,Staff,0,11,30,30
1650126796160,MATH 20C,A02,083761,Staff,0,12,30,30
1650126796160,MATH 20C,B01,083762,Staff,14,0,30,16
1650126796160,MATH 20C,B02,083763,Staff,28,0,30,2
1650126802198,MATH 20D,A01,083765,Staff,0,2,30,30
1650126802198,MATH 20D,A02,083766,Staff,12,0,30,18
1650126802198,MATH 20D,A03,083767,Staff,28,0,30,2
1650126808234,MATH 20E,A01,083771,Staff,10,0,30,20
1650126808234,MATH 20E,A02,083772,Staff,20,0,30,10
1650126808234,MATH 20E,B01,083773,Staff,0,0,30,30
1650126808234,MATH 20E,B02,083774,Staff,13,0,30,17
1650126814261,MATH 103A,A01,083777,Staff,0,8,30,30
1650126814261,MATH 103A,A02,083778,Staff,0,8,30,30
1650126814261,MATH 103A,B01,083779,Staff,0,9,30,30
1650126814261,MATH 103A,B02,083780,Staff,0,6,30,30
1650126820295,MATH 105,A01,085443,Staff,0,13,30,30
1650126826347,MATH 109,A01,083213,Anzaldo; Leesa B,0,3,30,30
1650126826347,MATH 109,A02,083214,Anzaldo; Leesa B,0,5,30,30
1650126826347,MATH 109,B01,083215,Anzaldo; Leesa B,0,4,30,30
1650126826347,MATH 109,B02,083216,Anzaldo; Leesa B,0,4,30,30
1650126832387,MATH 142A,A01,083219,Chow; Bennett,0,11,30,30
1650126832387,MATH 142A,A02,083220,Chow; Bennett,0,10,30,30
1650126832387,MATH 142A,B01,083221,Chow; Bennett,0,10,30,30
1650126832387,MATH 142A,B02,083222,Chow; Bennett,0,10,30,30
1650126838414,MATH 193A,A01,083224,Staff,0,4,30,30
1650126838414,MATH 193A,A02,083225,Staff,0,4,30,30
1650126838414,MATH 193A,A03,083781,Staff,0,0,30,30
1650126838414,MATH 193A,A04,083782,Staff,2,0,30,28
1650126844449,MATH 197,001,091859,McAuley; Julian John,9998,0,9999,1
1650126850502,COGS 9,A01,083615,Staff,0,14,60,60
1650126856529,COGS 11,A01,083617,Boyle; Mary E. T.,24,0,40,16
1650126862566,COGS 13,A01,083071,Staff,0,28,40,40
1650126868591,COGS 14A,A01,092681,Staff,0,10,100,100
1650126874616,COGS 14B,A01,083073,Cheng; Tzu-Han,0,4,50,50
1650126880641,COGS 17,A01,092677,Staff,34,0,75,41
1650126886667,COGS 100,A01,083619,Staff,0,21,60,60
1650126892693,COGS 101A,A01,083621,Davis; Joshua Daniel,0,18,60,60
1650126898737,COGS 101B,A01,091572,Staff,10,0,60,50
1650126904760,COGS 101C,A01,083625,Delgado; Tania,22,0,30,8
1650126910784,COGS 107A,A01,083627,Boyle; Mary E. T.,0,4,60,60
1650126916819,COGS 118A,A01,083075,Staff,17,0,60,43
1650126922851,CSE 3,A50,083646,Miranda; Gregory Joseph,22,0,38,16
1650126922851,CSE 3,A51,083647,Miranda; Gregory Joseph,37,0,37,0
1650126928882,CSE 8A,A50,083650,Miranda; Gregory Joseph,0,16,40,40
1650126934905,CSE 11,A01,083080,Cao; Yingjun,0,66,40,40
1650126940942,CSE 12,A01,083652,Staff,0,2,100,100
1650126946969,CSE 15L,A01,083654,Staff,0,0,50,50
1650126946969,CSE 15L,A02,083655,Staff,10,0,50,40
1650126953006,CSE 20,A01,083657,Staff,57,0,80,23
1650126959036,CSE 30,A01,083084,Eldon; John,0,63,40,40
1650126965064,CSE 100,A01,083659,Cao; Yingjun,0,61,50,50
1650126971091,CSE 134B,A01,083661,Powell; Thomas Allan,0,27,65,65
1650126977112,CSE 140,A01,083663,Staff,4,0,75,71
1650126983137,CSE 140L,A01,083088,Eldon; John,0,1,75,75
1650126989169,CSE 175,A01,083665,Kumar; Rakesh,8,0,25,17
1650126995201,CSE 190,A00,092507,Dubnov; Shlomo,14,0,20,6
1650127001243,ECE 45,A01,083139,Staff,0,13,40,40
1650127007269,ECE 65,A50,083695,Staff,0,4,30,30
1650127013300,ECE 109,A01,091882,Touri; Behrouz,48,0,70,22
1650127019331,ECE 180,A00,083140,Abi Samra; Nicholas Camill,24,0,30,6
1650127019331,ECE 180,B00,083141,Abi Samra; Nicholas Camill,8,0,30,22
1650127025370,MATH 10A,A01,083735,Patchell; Gregory David,12,0,30,18
1650127025370,MATH 10A,A02,083736,Patchell; Gregory David,28,0,30,2
1650127025370,MATH 10A,A03,083737,Patchell; Gregory David,26,0,30,4
1650127031422,MATH 10B,A01,083207,Staff,0,5,30,30
1650127031422,MATH 10B,A02,083208,Staff,0,4,30,30
1650127031422,MATH 10B,B01,083739,Staff,18,0,30,12
1650127031422,MATH 10B,B02,083740,Staff,29,0,30,1
1650127037452,MATH 18,A01,083743,Staff,10,0,30,20
1650127037452,MATH 18,A02,083744,Staff,28,0,30,2
1650127037452,MATH 18,A03,083745,Staff,23,0,30,7
1650127037452,MATH 18,A04,083746,Staff,27,0,30,3
1650127037452,MATH 18,B01,083748,Staff,0,9,30,30
1650127037452,MATH 18,B02,083749,Staff,0,7,30,30
1650127037452,MATH 18,B03,083750,Staff,0,6,30,30
1650127037452,MATH 18,B04,083751,Staff,0,7,30,30
1650127043475,MATH 20A,A01,083754,Staff,26,0,40,14
1650127049501,MATH 20B,A01,083756,Staff,0,5,30,30
1650127049501,MATH 20B,A02,083757,Staff,0,3,30,30
1650127055529,MATH 20C,A01,083760,Staff,0,11,30,30
1650127055529,MATH 20C,A02,083761,Staff,0,12,30,30
1650127055529,MATH 20C,B01,083762,Staff,14,0,30,16
1650127055529,MATH 20C,B02,083763,Staff,28,0,30,2
1650127061554,MATH 20D,A01,083765,Staff,0,2,30,30
1650127061554,MATH 20D,A02,083766,Staff,12,0,30,18
1650127061554,MATH 20D,A03,083767,Staff,28,0,30,2
1650127067600,MATH 20E,A01,083771,Staff,10,0,30,20
1650127067600,MATH 20E,A02,083772,Staff,20,0,30,10
1650127067600,MATH 20E,B01,083773,Staff,0,0,30,30
1650127067600,MATH 20E,B02,083774,Staff,13,0,30,17
1650127073624,MATH 103A,A01,083777,Staff,0,8,30,30
1650127073624,MATH 103A,A02,083778,Staff,0,8,30,30
1650127073624,MATH 103A,B01,083779,Staff,0,9,30,30
1650127073624,MATH 103A,B02,083780,Staff,0,6,30,30
1650127079678,MATH 105,A01,085443,Staff,0,13,30,30
1650127085701,MATH 109,A01,083213,Anzaldo; Leesa B,0,3,30,30
1650127085701,MATH 109,A02,083214,Anzaldo; Leesa B,0,5,30,30
1650127085701,MATH 109,B01,083215,Anzaldo; Leesa B,0,4,30,30
1650127085701,MATH 109,B02,083216,Anzaldo; Leesa B,0,4,30,30
1650127091734,MATH 142A,A01,083219,Chow; Bennett,0,11,30,30
1650127091734,MATH 142A,A02,083220,Chow; Bennett,0,10,30,30
1650127091734,MATH 142A,B01,083221,Chow; Bennett,0,10,30,30
1650127091734,MATH 142A,B02,083222,Chow; Bennett,0,10,30,30
1650127097770,MATH 193A,A01,083224,Staff,0,4,30,30
1650127097770,MATH 193A,A02,083225,Staff,0,4,30,30
1650127097770,MATH 193A,A03,083781,Staff,0,0,30,30
1650127097770,MATH 193A,A04,083782,Staff,2,0,30,28
1650127103818,MATH 197,001,091859,McAuley; Julian John,9998,0,9999,1
1650127109879,COGS 9,A01,083615,Staff,0,14,60,60
1650127115902,COGS 11,A01,083617,Boyle; Mary E. T.,24,0,40,16
1650127121925,COGS 13,A01,083071,Staff,0,28,40,40
1650127127970,COGS 14A,A01,092681,Staff,0,10,100,100
1650127134010,COGS 14B,A01,083073,Cheng; Tzu-Han,0,4,50,50
1650127140034,COGS 17,A01,092677,Staff,34,0,75,41
1650127146067,COGS 100,A01,083619,Staff,0,21,60,60
1650127152100,COGS 101A,A01,083621,Davis; Joshua Daniel,0,18,60,60
1650127158140,COGS 101B,A01,091572,Staff,10,0,60,50
1650127164182,COGS 101C,A01,083625,Delgado; Tania,22,0,30,8
1650127170226,COGS 107A,A01,083627,Boyle; Mary E. T.,0,4,60,60
1650127176249,COGS 118A,A01,083075,Staff,17,0,60,43
1650127182273,CSE 3,A50,083646,Miranda; Gregory Joseph,22,0,38,16
1650127182273,CSE 3,A51,083647,Miranda; Gregory Joseph,37,0,37,0
1650127188309,CSE 8A,A50,083650,Miranda; Gregory Joseph,0,16,40,40
1650127194332,CSE 11,A01,083080,Cao; Yingjun,0,66,40,40
1650127200358,CSE 12,A01,083652,Staff,0,2,100,100
1650127206380,CSE 15L,A01,083654,Staff,0,0,50,50
1650127206380,CSE 15L,A02,083655,Staff,10,0,50,40
1650127212409,CSE 20,A01,083657,Staff,57,0,80,23
1650127224681,CSE 30,A01,083084,Eldon; John,0,63,40,40
1650127230704,CSE 100,A01,083659,Cao; Yingjun,0,61,50,50
1650127236727,CSE 134B,A01,083661,Powell; Thomas Allan,0,27,65,65
1650127242770,CSE 140,A01,083663,Staff,4,0,75,71
1650127248798,CSE 140L,A01,083088,Eldon; John,0,1,75,75
1650127254837,CSE 175,A01,083665,Kumar; Rakesh,8,0,25,17
1650127260864,CSE 190,A00,092507,Dubnov; Shlomo,14,0,20,6
1650127266895,ECE 45,A01,083139,Staff,0,13,40,40
1650127272918,ECE 65,A50,083695,Staff,0,4,30,30
1650127278945,ECE 109,A01,091882,Touri; Behrouz,48,0,70,22
1650127284972,ECE 180,A00,083140,Abi Samra; Nicholas Camill,24,0,30,6
1650127284972,ECE 180,B00,083141,Abi Samra; Nicholas Camill,8,0,30,22
1650127290999,MATH 10A,A01,083735,Patchell; Gregory David,12,0,30,18
1650127290999,MATH 10A,A02,083736,Patchell; Gregory David,28,0,30,2
1650127290999,MATH 10A,A03,083737,Patchell; Gregory David,26,0,30,4
1650127297022,MATH 10B,A01,083207,Staff,0,5,30,30
1650127297022,MATH 10B,A02,083208,Staff,0,4,30,30
1650127297022,MATH 10B,B01,083739,Staff,18,0,30,12
1650127297022,MATH 10B,B02,083740,Staff,29,0,30,1
1650127303046,MATH 18,A01,083743,Staff,10,0,30,20
1650127303046,MATH 18,A02,083744,Staff,28,0,30,2
1650127303046,MATH 18,A03,083745,Staff,23,0,30,7
1650127303046,MATH 18,A04,083746,Staff,27,0,30,3
1650127303046,MATH 18,B01,083748,Staff,0,9,30,30
1650127303046,MATH 18,B02,083749,Staff,0,7,30,30
1650127303046,MATH 18,B03,083750,Staff,0,6,30,30
1650127303046,MATH 18,B04,083751,Staff,0,7,30,30
1650127309082,MATH 20A,A01,083754,Staff,26,0,40,14
1650127315117,MATH 20B,A01,083756,Staff,0,5,30,30
1650127315117,MATH 20B,A02,083757,Staff,0,3,30,30
1650127321145,MATH 20C,A01,083760,Staff,0,11,30,30
1650127321145,MATH 20C,A02,083761,Staff,0,12,30,30
1650127321145,MATH 20C,B01,083762,Staff,14,0,30,16
1650127321145,MATH 20C,B02,083763,Staff,28,0,30,2
1650127327169,MATH 20D,A01,083765,Staff,0,2,30,30
1650127327169,MATH 20D,A02,083766,Staff,12,0,30,18
1650127327169,MATH 20D,A03,083767,Staff,28,0,30,2
1650127333196,MATH 20E,A01,083771,Staff,10,0,30,20
1650127333196,MATH 20E,A02,083772,Staff,20,0,30,10
1650127333196,MATH 20E,B01,083773,Staff,0,0,30,30
1650127333196,MATH 20E,B02,083774,Staff,13,0,30,17
1650127339220,MATH 103A,A01,083777,Staff,0,8,30,30
1650127339220,MATH 103A,A02,083778,Staff,0,8,30,30
1650127339220,MATH 103A,B01,083779,Staff,0,9,30,30
1650127339220,MATH 103A,B02,083780,Staff,0,6,30,30
1650127345254,MATH 105,A01,085443,Staff,0,13,30,30
1650127351294,MATH 109,A01,083213,Anzaldo; Leesa B,0,3,30,30
1650127351294,MATH 109,A02,083214,Anzaldo; Leesa B,0,5,30,30
1650127351294,MATH 109,B01,083215,Anzaldo; Leesa B,0,4,30,30
1650127351294,MATH 109,B02,083216,Anzaldo; Leesa B,0,4,30,30
1650127357323,MATH 142A,A01,083219,Chow; Bennett,0,11,30,30
1650127357323,MATH 142A,A02,083220,Chow; Bennett,0,10,30,30
1650127357323,MATH 142A,B01,083221,Chow; Bennett,0,10,30,30
1650127357323,MATH 142A,B02,083222,Chow; Bennett,0,10,30,30
1650127363355,MATH 193A,A01,083224,Staff,0,4,30,30
1650127363355,MATH 193A,A02,083225,Staff,0,4,30,30
1650127363355,MATH 193A,A03,083781,Staff,0,0,30,30
1650127363355,MATH 193A,A04,083782,Staff,2,0,30,28
1650127369381,MATH 197,001,091859,McAuley; Julian John,9998,0,9999,1
1650127375453,COGS 9,A01,083615,Staff,0,14,60,60
1650127381479,COGS 11,A01,083617,Boyle; Mary E. T.,24,0,40,16
1650127387537,COGS 13,A01,083071,Staff,0,28,40,40
1650127393635,COGS 14A,A01,092681,Staff,0,10,100,100
1650127399659,COGS 14B,A01,083073,Cheng; Tzu-Han,0,4,50,50
1650127405682,COGS 17,A01,092677,Staff,34,0,75,41
1650127411705,COGS 100,A01,083619,Staff,0,21,60,60
1650127417733,COGS 101A,A01,083621,Davis; Joshua Daniel,0,18,60,60
1650127423759,COGS 101B,A01,091572,Staff,10,0,60,50
1650127429793,COGS 101C,A01,083625,Delgado; Tania,22,0,30,8
1650127435819,COGS 107A,A01,083627,Boyle; Mary E. T.,0,4,60,60
1650127441853,COGS 118A,A01,083075,Staff,17,0,60,43
1650127447893,CSE 3,A50,083646,Miranda; Gregory Joseph,22,0,38,16
1650127447893,CSE 3,A51,083647,Miranda; Gregory Joseph,37,0,37,0
1650127453918,CSE 8A,A50,083650,Miranda; Gregory Joseph,0,16,40,40
1650127459946,CSE 11,A01,083080,Cao; Yingjun,0,66,40,40
1650127465969,CSE 12,A01,083652,Staff,0,2,100,100
1650127471994,CSE 15L,A01,083654,Staff,0,0,50,50
1650127471994,CSE 15L,A02,083655,Staff,10,0,50,40
1650127478017,CSE 20,A01,083657,Staff,57,0,80,23
1650127484066,CSE 30,A01,083084,Eldon; John,0,63,40,40
1650127490094,CSE 100,A01,083659,Cao; Yingjun,0,61,50,50
1650127496121,CSE 134B,A01,083661,Powell; Thomas Allan,0,27,65,65
1650127502144,CSE 140,A01,083663,Staff,4,0,75,71
1650127508195,CSE 140L,A01,083088,Eldon; John,0,1,75,75
1650127514229,CSE 175,A01,083665,Kumar; Rakesh,8,0,25,17
1650127520273,CSE 190,A00,092507,Dubnov; Shlomo,14,0,20,6
1650127526318,ECE 45,A01,083139,Staff,0,13,40,40
1650127532357,ECE 65,A50,083695,Staff,0,4,30,30
1650127538381,ECE 109,A01,091882,Touri; Behrouz,48,0,70,22
1650127544416,ECE 180,A00,083140,Abi Samra; Nicholas Camill,24,0,30,6
1650127544416,ECE 180,B00,083141,Abi Samra; Nicholas Camill,8,0,30,22
1650127550448,MATH 10A,A01,083735,Patchell; Gregory David,12,0,30,18
1650127550448,MATH 10A,A02,083736,Patchell; Gregory David,28,0,30,2
1650127550448,MATH 10A,A03,083737,Patchell; Gregory David,26,0,30,4
1650127556485,MATH 10B,A01,083207,Staff,0,5,30,30
1650127556485,MATH 10B,A02,083208,Staff,0,4,30,30
1650127556485,MATH 10B,B01,083739,Staff,18,0,30,12
1650127556485,MATH 10B,B02,083740,Staff,29,0,30,1
1650127562514,MATH 18,A01,083743,Staff,10,0,30,20
1650127562514,MATH 18,A02,083744,Staff,28,0,30,2
1650127562514,MATH 18,A03,083745,Staff,23,0,30,7
1650127562514,MATH 18,A04,083746,Staff,27,0,30,3
1650127562514,MATH 18,B01,083748,Staff,0,9,30,30
1650127562514,MATH 18,B02,083749,Staff,0,7,30,30
1650127562514,MATH 18,B03,083750,Staff,0,6,30,30
1650127562514,MATH 18,B04,083751,Staff,0,7,30,30
1650127568538,MATH 20A,A01,083754,Staff,26,0,40,14
1650127574561,MATH 20B,A01,083756,Staff,0,5,30,30
1650127574561,MATH 20B,A02,083757,Staff,0,3,30,30
1650127580602,MATH 20C,A01,083760,Staff,0,11,30,30
1650127580602,MATH 20C,A02,083761,Staff,0,12,30,30
1650127580602,MATH 20C,B01,083762,Staff,14,0,30,16
1650127580602,MATH 20C,B02,083763,Staff,28,0,30,2
1650127586648,MATH 20D,A01,083765,Staff,0,2,30,30
1650127586648,MATH 20D,A02,083766,Staff,12,0,30,18
1650127586648,MATH 20D,A03,083767,Staff,28,0,30,2
1650127592673,MATH 20E,A01,083771,Staff,10,0,30,20
1650127592673,MATH 20E,A02,083772,Staff,20,0,30,10
1650127592673,MATH 20E,B01,083773,Staff,0,0,30,30
1650127592673,MATH 20E,B02,083774,Staff,13,0,30,17
1650127598697,MATH 103A,A01,083777,Staff,0,8,30,30
1650127598697,MATH 103A,A02,083778,Staff,0,8,30,30
1650127598697,MATH 103A,B01,083779,Staff,0,9,30,30
1650127598697,MATH 103A,B02,083780,Staff,0,6,30,30
1650127604723,MATH 105,A01,085443,Staff,0,13,30,30
1650127610772,MATH 109,A01,083213,Anzaldo; Leesa B,0,3,30,30
1650127610772,MATH 109,A02,083214,Anzaldo; Leesa B,0,5,30,30
1650127610772,MATH 109,B01,083215,Anzaldo; Leesa B,0,4,30,30
1650127610772,MATH 109,B02,083216,Anzaldo; Leesa B,0,4,30,30
1650127616822,MATH 142A,A01,083219,Chow; Bennett,0,11,30,30
1650127616822,MATH 142A,A02,083220,Chow; Bennett,0,10,30,30
1650127616822,MATH 142A,B01,083221,Chow; Bennett,0,10,30,30
1650127616822,MATH 142A,B02,083222,Chow; Bennett,0,10,30,30
1650127622853,MATH 193A,A01,083224,Staff,0,4,30,30
1650127622853,MATH 193A,A02,083225,Staff,0,4,30,30
1650127622853,MATH 193A,A03,083781,Staff,0,0,30,30
1650127622853,MATH 193A,A04,083782,Staff,2,0,30,28
1650127628881,MATH 197,001,091859,McAuley; Julian John,9998,0,9999,1
1650127634950,COGS 9,A01,083615,Staff,0,14,60,60
1650127640983,COGS 11,A01,083617,Boyle; Mary E. T.,24,0,40,16
1650127647009,COGS 13,A01,083071,Staff,0,28,40,40
1650127653033,COGS 14A,A01,092681,Staff,0,10,100,100
1650127659068,COGS 14B,A01,083073,Cheng; Tzu-Han,0,4,50,50
1650127665093,COGS 17,A01,092677,Staff,34,0,75,41
1650127671116,COGS 100,A01,083619,Staff,0,21,60,60
1650127677162,COGS 101A,A01,083621,Davis; Joshua Daniel,0,18,60,60
1650127683197,COGS 101B,A01,091572,Staff,10,0,60,50
1650127689230,COGS 101C,A01,083625,Delgado; Tania,22,0,30,8
1650127695254,COGS 107A,A01,083627,Boyle; Mary E. T.,0,4,60,60
1650127701277,COGS 118A,A01,083075,Staff,17,0,60,43
1650127707300,CSE 3,A50,083646,Miranda; Gregory Joseph,22,0,38,16
1650127707300,CSE 3,A51,083647,Miranda; Gregory Joseph,37,0,37,0
1650127713324,CSE 8A,A50,083650,Miranda; Gregory Joseph,0,16,40,40
1650127719359,CSE 11,A01,083080,Cao; Yingjun,0,66,40,40
1650127725394,CSE 12,A01,083652,Staff,0,2,100,100
1650127731446,CSE 15L,A01,083654,Staff,0,0,50,50
1650127731446,CSE 15L,A02,083655,Staff,10,0,50,40
1650127737489,CSE 20,A01,083657,Staff,57,0,80,23
1650127743523,CSE 30,A01,083084,Eldon; John,0,63,40,40
1650127749554,CSE 100,A01,083659,Cao; Yingjun,0,61,50,50
1650127755595,CSE 134B,A01,083661,Powell; Thomas Allan,0,27,65,65
1650127761634,CSE 140,A01,083663,Staff,4,0,75,71
1650127767657,CSE 140L,A01,083088,Eldon; John,0,1,75,75
1650127773684,CSE 175,A01,083665,Kumar; Rakesh,8,0,25,17
1650127779728,CSE 190,A00,092507,Dubnov; Shlomo,14,0,20,6
1650127785758,ECE 45,A01,083139,Staff,0,13,40,40
1650127791785,ECE 65,A50,083695,Staff,0,4,30,30
1650127797816,ECE 109,A01,091882,Touri; Behrouz,48,0,70,22
1650127803853,ECE 180,A00,083140,Abi Samra; Nicholas Camill,24,0,30,6
1650127803853,ECE 180,B00,083141,Abi Samra; Nicholas Camill,8,0,30,22
1650127809878,MATH 10A,A01,083735,Patchell; Gregory David,12,0,30,18
1650127809878,MATH 10A,A02,083736,Patchell; Gregory David,28,0,30,2
1650127809878,MATH 10A,A03,083737,Patchell; Gregory David,26,0,30,4
1650127815930,MATH 10B,A01,083207,Staff,0,5,30,30
1650127815930,MATH 10B,A02,083208,Staff,0,4,30,30
1650127815930,MATH 10B,B01,083739,Staff,18,0,30,12
1650127815930,MATH 10B,B02,083740,Staff,29,0,30,1
1650127821956,MATH 18,A01,083743,Staff,10,0,30,20
1650127821956,MATH 18,A02,083744,Staff,28,0,30,2
1650127821956,MATH 18,A03,083745,Staff,23,0,30,7
1650127821956,MATH 18,A04,083746,Staff,27,0,30,3
1650127821956,MATH 18,B01,083748,Staff,0,9,30,30
1650127821956,MATH 18,B02,083749,Staff,0,7,30,30
1650127821956,MATH 18,B03,083750,Staff,0,6,30,30
1650127821956,MATH 18,B04,083751,Staff,0,7,30,30
1650127827978,MATH 20A,A01,083754,Staff,26,0,40,14
1650127834020,MATH 20B,A01,083756,Staff,0,5,30,30
1650127834020,MATH 20B,A02,083757,Staff,0,3,30,30
1650127840046,MATH 20C,A01,083760,Staff,0,11,30,30
1650127840046,MATH 20C,A02,083761,Staff,0,12,30,30
1650127840046,MATH 20C,B01,083762,Staff,14,0,30,16
1650127840046,MATH 20C,B02,083763,Staff,28,0,30,2
1650127846078,MATH 20D,A01,083765,Staff,0,2,30,30
1650127846078,MATH 20D,A02,083766,Staff,12,0,30,18
1650127846078,MATH 20D,A03,083767,Staff,28,0,30,2
1650127852106,MATH 20E,A01,083771,Staff,10,0,30,20
1650127852106,MATH 20E,A02,083772,Staff,20,0,30,10
1650127852106,MATH 20E,B01,083773,Staff,0,0,30,30
1650127852106,MATH 20E,B02,083774,Staff,13,0,30,17
1650127858151,MATH 103A,A01,083777,Staff,0,8,30,30
1650127858151,MATH 103A,A02,083778,Staff,0,8,30,30
1650127858151,MATH 103A,B01,083779,Staff,0,9,30,30
1650127858151,MATH 103A,B02,083780,Staff,0,6,30,30
1650127864175,MATH 105,A01,085443,Staff,0,13,30,30
1650127870199,MATH 109,A01,083213,Anzaldo; Leesa B,0,3,30,30
1650127870199,MATH 109,A02,083214,Anzaldo; Leesa B,0,5,30,30
1650127870199,MATH 109,B01,083215,Anzaldo; Leesa B,0,4,30,30
1650127870199,MATH 109,B02,083216,Anzaldo; Leesa B,0,4,30,30
1650127876242,MATH 142A,A01,083219,Chow; Bennett,0,11,30,30
1650127876242,MATH 142A,A02,083220,Chow; Bennett,0,10,30,30
1650127876242,MATH 142A,B01,083221,Chow; Bennett,0,10,30,30
1650127876242,MATH 142A,B02,083222,Chow; Bennett,0,10,30,30
1650127882269,MATH 193A,A01,083224,Staff,0,4,30,30
1650127882269,MATH 193A,A02,083225,Staff,0,4,30,30
1650127882269,MATH 193A,A03,083781,Staff,0,0,30,30
1650127882269,MATH 193A,A04,083782,Staff,2,0,30,28
1650127888312,MATH 197,001,091859,McAuley; Julian John,9998,0,9999,1
1650127894391,COGS 9,A01,083615,Staff,0,14,60,60
1650127900424,COGS 11,A01,083617,Boyle; Mary E. T.,24,0,40,16
1650127906455,COGS 13,A01,083071,Staff,0,28,40,40
1650127912493,COGS 14A,A01,092681,Staff,0,10,100,100
1650127918538,COGS 14B,A01,083073,Cheng; Tzu-Han,0,4,50,50
1650127924573,COGS 17,A01,092677,Staff,34,0,75,41
1650127930600,COGS 100,A01,083619,Staff,0,21,60,60
1650127936638,COGS 101A,A01,083621,Davis; Joshua Daniel,0,18,60,60
1650127942688,COGS 101B,A01,091572,Staff,10,0,60,50
1650127948714,COGS 101C,A01,083625,Delgado; Tania,22,0,30,8
1650127954740,COGS 107A,A01,083627,Boyle; Mary E. T.,0,4,60,60
1650127960764,COGS 118A,A01,083075,Staff,17,0,60,43
1650127966791,CSE 3,A50,083646,Miranda; Gregory Joseph,22,0,38,16
1650127966791,CSE 3,A51,083647,Miranda; Gregory Joseph,37,0,37,0
1650127972814,CSE 8A,A50,083650,Miranda; Gregory Joseph,0,16,40,40
1650127978870,CSE 11,A01,083080,Cao; Yingjun,0,66,40,40
1650127984899,CSE 12,A01,083652,Staff,0,2,100,100
1650127991023,CSE 15L,A01,083654,Staff,0,0,50,50
1650127991023,CSE 15L,A02,083655,Staff,10,0,50,40
1650127997060,CSE 20,A01,083657,Staff,57,0,80,23
1650128003090,CSE 30,A01,083084,Eldon; John,0,63,40,40
1650128009117,CSE 100,A01,083659,Cao; Yingjun,0,61,50,50
1650128015152,CSE 134B,A01,083661,Powell; Thomas Allan,0,27,65,65
1650128021184,CSE 140,A01,083663,Staff,4,0,75,71
1650128027211,CSE 140L,A01,083088,Eldon; John,0,1,75,75
1650128033232,CSE 175,A01,083665,Kumar; Rakesh,8,0,25,17
1650128039258,CSE 190,A00,092507,Dubnov; Shlomo,14,0,20,6
1650128045293,ECE 45,A01,083139,Staff,0,13,40,40
1650128051318,ECE 65,A50,083695,Staff,0,4,30,30
1650128057341,ECE 109,A01,091882,Touri; Behrouz,48,0,70,22
1650128063390,ECE 180,A00,083140,Abi Samra; Nicholas Camill,24,0,30,6
1650128063390,ECE 180,B00,083141,Abi Samra; Nicholas Camill,8,0,30,22
1650128069441,MATH 10A,A01,083735,Patchell; Gregory David,12,0,30,18
1650128069441,MATH 10A,A02,083736,Patchell; Gregory David,28,0,30,2
1650128069441,MATH 10A,A03,083737,Patchell; Gregory David,26,0,30,4
1650128075474,MATH 10B,A01,083207,Staff,0,5,30,30
1650128075474,MATH 10B,A02,083208,Staff,0,4,30,30
1650128075474,MATH 10B,B01,083739,Staff,18,0,30,12
1650128075474,MATH 10B,B02,083740,Staff,29,0,30,1
1650128081504,MATH 18,A01,083743,Staff,10,0,30,20
1650128081504,MATH 18,A02,083744,Staff,28,0,30,2
1650128081504,MATH 18,A03,083745,Staff,23,0,30,7
1650128081504,MATH 18,A04,083746,Staff,27,0,30,3
1650128081504,MATH 18,B01,083748,Staff,0,9,30,30
1650128081504,MATH 18,B02,083749,Staff,0,7,30,30
1650128081504,MATH 18,B03,083750,Staff,0,6,30,30
1650128081504,MATH 18,B04,083751,Staff,0,7,30,30
1650128087533,MATH 20A,A01,083754,Staff,26,0,40,14
1650128093571,MATH 20B,A01,083756,Staff,0,5,30,30
1650128093571,MATH 20B,A02,083757,Staff,0,3,30,30
1650128099593,MATH 20C,A01,083760,Staff,0,11,30,30
1650128099593,MATH 20C,A02,083761,Staff,0,12,30,30
1650128099593,MATH 20C,B01,083762,Staff,14,0,30,16
1650128099593,MATH 20C,B02,083763,Staff,28,0,30,2
1650128105617,MATH 20D,A01,083765,Staff,0,2,30,30
1650128105617,MATH 20D,A02,083766,Staff,12,0,30,18
1650128105617,MATH 20D,A03,083767,Staff,28,0,30,2
1650128111648,MATH 20E,A01,083771,Staff,10,0,30,20
1650128111648,MATH 20E,A02,083772,Staff,20,0,30,10
1650128111648,MATH 20E,B01,083773,Staff,0,0,30,30
1650128111648,MATH 20E,B02,083774,Staff,13,0,30,17
1650128117686,MATH 103A,A01,083777,Staff,0,8,30,30
1650128117686,MATH 103A,A02,083778,Staff,0,8,30,30
1650128117686,MATH 103A,B01,083779,Staff,0,9,30,30
1650128117686,MATH 103A,B02,083780,Staff,0,6,30,30
1650128123710,MATH 105,A01,085443,Staff,0,13,30,30
1650128129744,MATH 109,A01,083213,Anzaldo; Leesa B,0,3,30,30
1650128129744,MATH 109,A02,083214,Anzaldo; Leesa B,0,5,30,30
1650128129744,MATH 109,B01,083215,Anzaldo; Leesa B,0,4,30,30
1650128129744,MATH 109,B02,083216,Anzaldo; Leesa B,0,4,30,30
1650128135766,MATH 142A,A01,083219,Chow; Bennett,0,11,30,30
1650128135766,MATH 142A,A02,083220,Chow; Bennett,0,10,30,30
1650128135766,MATH 142A,B01,083221,Chow; Bennett,0,10,30,30
1650128135766,MATH 142A,B02,083222,Chow; Bennett,0,10,30,30
1650128141797,MATH 193A,A01,083224,Staff,0,4,30,30
1650128141797,MATH 193A,A02,083225,Staff,0,4,30,30
1650128141797,MATH 193A,A03,083781,Staff,0,0,30,30
1650128141797,MATH 193A,A04,083782,Staff,2,0,30,28
1650128147826,MATH 197,001,091859,McAuley; Julian John,9998,0,9999,1
1650128153881,COGS 9,A01,083615,Staff,0,14,60,60
1650128159905,COGS 11,A01,083617,Boyle; Mary E. T.,24,0,40,16
1650128165929,COGS 13,A01,083071,Staff,0,28,40,40
1650128171952,COGS 14A,A01,092681,Staff,0,10,100,100
1650128177977,COGS 14B,A01,083073,Cheng; Tzu-Han,0,4,50,50
1650128184000,COGS 17,A01,092677,Staff,34,0,75,41
1650128190026,COGS 100,A01,083619,Staff,0,21,60,60
1650128196058,COGS 101A,A01,083621,Davis; Joshua Daniel,0,18,60,60
1650128202085,COGS 101B,A01,091572,Staff,10,0,60,50
1650128208109,COGS 101C,A01,083625,Delgado; Tania,22,0,30,8
1650128214133,COGS 107A,A01,083627,Boyle; Mary E. T.,0,4,60,60
1650128220160,COGS 118A,A01,083075,Staff,17,0,60,43
1650128226183,CSE 3,A50,083646,Miranda; Gregory Joseph,22,0,38,16
1650128226183,CSE 3,A51,083647,Miranda; Gregory Joseph,37,0,37,0
1650128232211,CSE 8A,A50,083650,Miranda; Gregory Joseph,0,16,40,40
1650128238232,CSE 11,A01,083080,Cao; Yingjun,0,66,40,40
1650128244256,CSE 12,A01,083652,Staff,0,2,100,100
1650128250282,CSE 15L,A01,083654,Staff,0,0,50,50
1650128250282,CSE 15L,A02,083655,Staff,10,0,50,40
1650128256306,CSE 20,A01,083657,Staff,57,0,80,23
1650128262334,CSE 30,A01,083084,Eldon; John,0,63,40,40
1650128268358,CSE 100,A01,083659,Cao; Yingjun,0,61,50,50
1650128274385,CSE 134B,A01,083661,Powell; Thomas Allan,0,27,65,65
1650128280409,CSE 140,A01,083663,Staff,4,0,75,71
1650128286432,CSE 140L,A01,083088,Eldon; John,0,1,75,75
1650128292454,CSE 175,A01,083665,Kumar; Rakesh,8,0,25,17
1650128298478,CSE 190,A00,092507,Dubnov; Shlomo,14,0,20,6
1650128304501,ECE 45,A01,083139,Staff,0,13,40,40
1650128310536,ECE 65,A50,083695,Staff,0,4,30,30
1650128316570,ECE 109,A01,091882,Touri; Behrouz,48,0,70,22
1650128322602,ECE 180,A00,083140,Abi Samra; Nicholas Camill,24,0,30,6
1650128322602,ECE 180,B00,083141,Abi Samra; Nicholas Camill,8,0,30,22
1650128328629,MATH 10A,A01,083735,Patchell; Gregory David,12,0,30,18
1650128328629,MATH 10A,A02,083736,Patchell; Gregory David,28,0,30,2
1650128328629,MATH 10A,A03,083737,Patchell; Gregory David,26,0,30,4
1650128334660,MATH 10B,A01,083207,Staff,0,5,30,30
1650128334660,MATH 10B,A02,083208,Staff,0,4,30,30
1650128334660,MATH 10B,B01,083739,Staff,18,0,30,12
1650128334660,MATH 10B,B02,083740,Staff,29,0,30,1
1650128340698,MATH 18,A01,083743,Staff,10,0,30,20
1650128340698,MATH 18,A02,083744,Staff,28,0,30,2
1650128340698,MATH 18,A03,083745,Staff,23,0,30,7
1650128340698,MATH 18,A04,083746,Staff,27,0,30,3
1650128340698,MATH 18,B01,083748,Staff,0,9,30,30
1650128340698,MATH 18,B02,083749,Staff,0,7,30,30
1650128340698,MATH 18,B03,083750,Staff,0,6,30,30
1650128340698,MATH 18,B04,083751,Staff,0,7,30,30
1650128346722,MATH 20A,A01,083754,Staff,26,0,40,14
1650128352749,MATH 20B,A01,083756,Staff,0,5,30,30
1650128352749,MATH 20B,A02,083757,Staff,0,3,30,30
1650128358776,MATH 20C,A01,083760,Staff,0,11,30,30
1650128358776,MATH 20C,A02,083761,Staff,0,12,30,30
1650128358776,MATH 20C,B01,083762,Staff,14,0,30,16
1650128358776,MATH 20C,B02,083763,Staff,28,0,30,2
1650128364826,MATH 20D,A01,083765,Staff,0,2,30,30
1650128364826,MATH 20D,A02,083766,Staff,12,0,30,18
1650128364826,MATH 20D,A03,083767,Staff,28,0,30,2
1650128370850,MATH 20E,A01,083771,Staff,10,0,30,20
1650128370850,MATH 20E,A02,083772,Staff,20,0,30,10
1650128370850,MATH 20E,B01,083773,Staff,0,0,30,30
1650128370850,MATH 20E,B02,083774,Staff,13,0,30,17
1650128376875,MATH 103A,A01,083777,Staff,0,8,30,30
1650128376875,MATH 103A,A02,083778,Staff,0,8,30,30
1650128376875,MATH 103A,B01,083779,Staff,0,9,30,30
1650128376875,MATH 103A,B02,083780,Staff,0,6,30,30
1650128382902,MATH 105,A01,085443,Staff,0,13,30,30
1650128388941,MATH 109,A01,083213,Anzaldo; Leesa B,0,3,30,30
1650128388941,MATH 109,A02,083214,Anzaldo; Leesa B,0,5,30,30
1650128388941,MATH 109,B01,083215,Anzaldo; Leesa B,0,4,30,30
1650128388941,MATH 109,B02,083216,Anzaldo; Leesa B,0,4,30,30
1650128394969,MATH 142A,A01,083219,Chow; Bennett,0,11,30,30
1650128394969,MATH 142A,A02,083220,Chow; Bennett,0,10,30,30
1650128394969,MATH 142A,B01,083221,Chow; Bennett,0,10,30,30
1650128394969,MATH 142A,B02,083222,Chow; Bennett,0,10,30,30
1650128400998,MATH 193A,A01,083224,Staff,0,4,30,30
1650128400998,MATH 193A,A02,083225,Staff,0,4,30,30
1650128400998,MATH 193A,A03,083781,Staff,0,0,30,30
1650128400998,MATH 193A,A04,083782,Staff,2,0,30,28
1650128407023,MATH 197,001,091859,McAuley; Julian John,9998,0,9999,1
1650128413082,COGS 9,A01,083615,Staff,0,14,60,60
1650128419106,COGS 11,A01,083617,Boyle; Mary E. T.,24,0,40,16
1650128425136,COGS 13,A01,083071,Staff,0,28,40,40
1650128431159,COGS 14A,A01,092681,Staff,0,10,100,100
1650128437194,COGS 14B,A01,083073,Cheng; Tzu-Han,0,4,50,50
1650128443217,COGS 17,A01,092677,Staff,34,0,75,41
1650128449241,COGS 100,A01,083619,Staff,0,21,60,60
1650128455280,COGS 101A,A01,083621,Davis; Joshua Daniel,0,18,60,60
1650128461302,COGS 101B,A01,091572,Staff,10,0,60,50
1650128467327,COGS 101C,A01,083625,Delgado; Tania,22,0,30,8
1650128473366,COGS 107A,A01,083627,Boyle; Mary E. T.,0,4,60,60
1650128479389,COGS 118A,A01,083075,Staff,17,0,60,43
1650128485414,CSE 3,A50,083646,Miranda; Gregory Joseph,22,0,38,16
1650128485414,CSE 3,A51,083647,Miranda; Gregory Joseph,37,0,37,0
1650128491440,CSE 8A,A50,083650,Miranda; Gregory Joseph,0,16,40,40
1650128497467,CSE 11,A01,083080,Cao; Yingjun,0,66,40,40
1650128503497,CSE 12,A01,083652,Staff,0,2,100,100
1650128509519,CSE 15L,A01,083654,Staff,0,0,50,50
1650128509519,CSE 15L,A02,083655,Staff,10,0,50,40
1650128515550,CSE 20,A01,083657,Staff,57,0,80,23
1650128521587,CSE 30,A01,083084,Eldon; John,0,63,40,40
1650128527612,CSE 100,A01,083659,Cao; Yingjun,0,61,50,50
1650128533639,CSE 134B,A01,083661,Powell; Thomas Allan,0,27,65,65
1650128539666,CSE 140,A01,083663,Staff,4,0,75,71
1650128545695,CSE 140L,A01,083088,Eldon; John,0,1,75,75
1650128551721,CSE 175,A01,083665,Kumar; Rakesh,8,0,25,17
1650128557747,CSE 190,A00,092507,Dubnov; Shlomo,14,0,20,6
1650128563773,ECE 45,A01,083139,Staff,0,13,40,40
1650128569798,ECE 65,A50,083695,Staff,0,4,30,30
1650128575821,ECE 109,A01,091882,Touri; Behrouz,48,0,70,22
1650128581849,ECE 180,A00,083140,Abi Samra; Nicholas Camill,24,0,30,6
1650128581849,ECE 180,B00,083141,Abi Samra; Nicholas Camill,8,0,30,22
1650128587951,MATH 10A,A01,083735,Patchell; Gregory David,12,0,30,18
1650128587951,MATH 10A,A02,083736,Patchell; Gregory David,28,0,30,2
1650128587951,MATH 10A,A03,083737,Patchell; Gregory David,26,0,30,4
1650128593975,MATH 10B,A01,083207,Staff,0,5,30,30
1650128593975,MATH 10B,A02,083208,Staff,0,4,30,30
1650128593975,MATH 10B,B01,083739,Staff,18,0,30,12
1650128593975,MATH 10B,B02,083740,Staff,29,0,30,1
1650128600035,MATH 18,A01,083743,Staff,10,0,30,20
1650128600035,MATH 18,A02,083744,Staff,28,0,30,2
1650128600035,MATH 18,A03,083745,Staff,23,0,30,7
1650128600035,MATH 18,A04,083746,Staff,27,0,30,3
1650128600035,MATH 18,B01,083748,Staff,0,9,30,30
1650128600035,MATH 18,B02,083749,Staff,0,7,30,30
1650128600035,MATH 18,B03,083750,Staff,0,6,30,30
1650128600035,MATH 18,B04,083751,Staff,0,7,30,30
1650128606063,MATH 20A,A01,083754,Staff,26,0,40,14
1650128612087,MATH 20B,A01,083756,Staff,0,5,30,30
1650128612087,MATH 20B,A02,083757,Staff,0,3,30,30
1650128618116,MATH 20C,A01,083760,Staff,0,11,30,30
1650128618116,MATH 20C,A02,083761,Staff,0,12,30,30
1650128618116,MATH 20C,B01,083762,Staff,14,0,30,16
1650128618116,MATH 20C,B02,083763,Staff,28,0,30,2
1650128624140,MATH 20D,A01,083765,Staff,0,2,30,30
1650128624140,MATH 20D,A02,083766,Staff,12,0,30,18
1650128624140,MATH 20D,A03,083767,Staff,28,0,30,2
1650128630166,MATH 20E,A01,083771,Staff,10,0,30,20
1650128630166,MATH 20E,A02,083772,Staff,20,0,30,10
1650128630166,MATH 20E,B01,083773,Staff,0,0,30,30
1650128630166,MATH 20E,B02,083774,Staff,13,0,30,17
1650128636200,MATH 103A,A01,083777,Staff,0,8,30,30
1650128636200,MATH 103A,A02,083778,Staff,0,8,30,30
1650128636200,MATH 103A,B01,083779,Staff,0,9,30,30
1650128636200,MATH 103A,B02,083780,Staff,0,6,30,30
1650128642246,MATH 105,A01,085443,Staff,0,13,30,30
1650128648270,MATH 109,A01,083213,Anzaldo; Leesa B,0,3,30,30
1650128648270,MATH 109,A02,083214,Anzaldo; Leesa B,0,5,30,30
1650128648270,MATH 109,B01,083215,Anzaldo; Leesa B,0,4,30,30
1650128648270,MATH 109,B02,083216,Anzaldo; Leesa B,0,4,30,30
1650128654292,MATH 142A,A01,083219,Chow; Bennett,0,11,30,30
1650128654292,MATH 142A,A02,083220,Chow; Bennett,0,10,30,30
1650128654292,MATH 142A,B01,083221,Chow; Bennett,0,10,30,30
1650128654292,MATH 142A,B02,083222,Chow; Bennett,0,10,30,30
1650128660322,MATH 193A,A01,083224,Staff,0,4,30,30
1650128660322,MATH 193A,A02,083225,Staff,0,4,30,30
1650128660322,MATH 193A,A03,083781,Staff,0,0,30,30
1650128660322,MATH 193A,A04,083782,Staff,2,0,30,28
1650128666347,MATH 197,001,091859,McAuley; Julian John,9998,0,9999,1
1650128672394,COGS 9,A01,083615,Staff,0,14,60,60
1650128678421,COGS 11,A01,083617,Boyle; Mary E. T.,24,0,40,16
1650128684444,COGS 13,A01,083071,Staff,0,28,40,40
1650128690467,COGS 14A,A01,092681,Staff,0,10,100,100
1650128696497,COGS 14B,A01,083073,Cheng; Tzu-Han,0,4,50,50
1650128702520,COGS 17,A01,092677,Staff,34,0,75,41
1650128708544,COGS 100,A01,083619,Staff,0,21,60,60
1650128714581,COGS 101A,A01,083621,Davis; Joshua Daniel,0,18,60,60
1650128720606,COGS 101B,A01,091572,Staff,10,0,60,50
1650128726639,COGS 101C,A01,083625,Delgado; Tania,22,0,30,8
1650128732667,COGS 107A,A01,083627,Boyle; Mary E. T.,0,4,60,60
1650128738700,COGS 118A,A01,083075,Staff,17,0,60,43
1650128744734,CSE 3,A50,083646,Miranda; Gregory Joseph,22,0,38,16
1650128744734,CSE 3,A51,083647,Miranda; Gregory Joseph,37,0,37,0
1650128750762,CSE 8A,A50,083650,Miranda; Gregory Joseph,0,16,40,40
1650128756789,CSE 11,A01,083080,Cao; Yingjun,0,66,40,40
1650128762824,CSE 12,A01,083652,Staff,0,2,100,100
1650128768849,CSE 15L,A01,083654,Staff,0,0,50,50
1650128768849,CSE 15L,A02,083655,Staff,10,0,50,40
1650128774873,CSE 20,A01,083657,Staff,57,0,80,23
1650128780906,CSE 30,A01,083084,Eldon; John,0,63,40,40
1650128786933,CSE 100,A01,083659,Cao; Yingjun,0,61,50,50
1650128792964,CSE 134B,A01,083661,Powell; Thomas Allan,0,27,65,65
1650128798998,CSE 140,A01,083663,Staff,4,0,75,71
1650128805035,CSE 140L,A01,083088,Eldon; John,0,1,75,75
1650128811062,CSE 175,A01,083665,Kumar; Rakesh,8,0,25,17
1650128817087,CSE 190,A00,092507,Dubnov; Shlomo,14,0,20,6
1650128823121,ECE 45,A01,083139,Staff,0,13,40,40
1650128829146,ECE 65,A50,083695,Staff,0,4,30,30
1650128835172,ECE 109,A01,091882,Touri; Behrouz,48,0,70,22
1650128841197,ECE 180,A00,083140,Abi Samra; Nicholas Camill,24,0,30,6
1650128841197,ECE 180,B00,083141,Abi Samra; Nicholas Camill,8,0,30,22
1650128847224,MATH 10A,A01,083735,Patchell; Gregory David,12,0,30,18
1650128847224,MATH 10A,A02,083736,Patchell; Gregory David,28,0,30,2
1650128847224,MATH 10A,A03,083737,Patchell; Gregory David,26,0,30,4
1650128853252,MATH 10B,A01,083207,Staff,0,5,30,30
1650128853252,MATH 10B,A02,083208,Staff,0,4,30,30
1650128853252,MATH 10B,B01,083739,Staff,18,0,30,12
1650128853252,MATH 10B,B02,083740,Staff,29,0,30,1
1650128859278,MATH 18,A01,083743,Staff,10,0,30,20
1650128859278,MATH 18,A02,083744,Staff,28,0,30,2
1650128859278,MATH 18,A03,083745,Staff,23,0,30,7
1650128859278,MATH 18,A04,083746,Staff,27,0,30,3
1650128859278,MATH 18,B01,083748,Staff,0,9,30,30
1650128859278,MATH 18,B02,083749,Staff,0,7,30,30
1650128859278,MATH 18,B03,083750,Staff,0,6,30,30
1650128859278,MATH 18,B04,083751,Staff,0,7,30,30
1650128865305,MATH 20A,A01,083754,Staff,26,0,40,14
1650128871331,MATH 20B,A01,083756,Staff,0,5,30,30
1650128871331,MATH 20B,A02,083757,Staff,0,3,30,30
1650128877355,MATH 20C,A01,083760,Staff,0,11,30,30
1650128877355,MATH 20C,A02,083761,Staff,0,12,30,30
1650128877355,MATH 20C,B01,083762,Staff,14,0,30,16
1650128877355,MATH 20C,B02,083763,Staff,28,0,30,2
1650128883381,MATH 20D,A01,083765,Staff,0,2,30,30
1650128883381,MATH 20D,A02,083766,Staff,12,0,30,18
1650128883381,MATH 20D,A03,083767,Staff,28,0,30,2
1650128889410,MATH 20E,A01,083771,Staff,10,0,30,20
1650128889410,MATH 20E,A02,083772,Staff,20,0,30,10
1650128889410,MATH 20E,B01,083773,Staff,0,0,30,30
1650128889410,MATH 20E,B02,083774,Staff,13,0,30,17
1650128895452,MATH 103A,A01,083777,Staff,0,8,30,30
1650128895452,MATH 103A,A02,083778,Staff,0,8,30,30
1650128895452,MATH 103A,B01,083779,Staff,0,9,30,30
1650128895452,MATH 103A,B02,083780,Staff,0,6,30,30
1650128901494,MATH 105,A01,085443,Staff,0,13,30,30
1650128907516,MATH 109,A01,083213,Anzaldo; Leesa B,0,3,30,30
1650128907516,MATH 109,A02,083214,Anzaldo; Leesa B,0,5,30,30
1650128907516,MATH 109,B01,083215,Anzaldo; Leesa B,0,4,30,30
1650128907516,MATH 109,B02,083216,Anzaldo; Leesa B,0,4,30,30
1650128913545,MATH 142A,A01,083219,Chow; Bennett,0,11,30,30
1650128913545,MATH 142A,A02,083220,Chow; Bennett,0,10,30,30
1650128913545,MATH 142A,B01,083221,Chow; Bennett,0,10,30,30
1650128913545,MATH 142A,B02,083222,Chow; Bennett,0,10,30,30
1650128919573,MATH 193A,A01,083224,Staff,0,3,30,30
1650128919573,MATH 193A,A02,083225,Staff,0,4,30,30
1650128919573,MATH 193A,A03,083781,Staff,0,0,30,30
1650128919573,MATH 193A,A04,083782,Staff,1,0,30,29
1650128925596,MATH 197,001,091859,McAuley; Julian John,9998,0,9999,1
1650128931674,COGS 9,A01,083615,Staff,0,14,60,60
1650128937701,COGS 11,A01,083617,Boyle; Mary E. T.,24,0,40,16
1650128943726,COGS 13,A01,083071,Staff,0,28,40,40
1650128949751,COGS 14A,A01,092681,Staff,0,10,100,100
1650128955784,COGS 14B,A01,083073,Cheng; Tzu-Han,0,4,50,50
1650128961811,COGS 17,A01,092677,Staff,34,0,75,41
1650128967833,COGS 100,A01,083619,Staff,0,21,60,60
1650128973861,COGS 101A,A01,083621,Davis; Joshua Daniel,0,18,60,60
1650128979886,COGS 101B,A01,091572,Staff,10,0,60,50
1650128985910,COGS 101C,A01,083625,Delgado; Tania,22,0,30,8
1650128991934,COGS 107A,A01,083627,Boyle; Mary E. T.,0,4,60,60
1650128997960,COGS 118A,A01,083075,Staff,17,0,60,43
1650129003985,CSE 3,A50,083646,Miranda; Gregory Joseph,22,0,38,16
1650129003985,CSE 3,A51,083647,Miranda; Gregory Joseph,37,0,37,0
1650129010008,CSE 8A,A50,083650,Miranda; Gregory Joseph,0,16,40,40
1650129016049,CSE 11,A01,083080,Cao; Yingjun,0,66,40,40
1650129022084,CSE 12,A01,083652,Staff,0,2,100,100
1650129028108,CSE 15L,A01,083654,Staff,0,0,50,50
1650129028108,CSE 15L,A02,083655,Staff,10,0,50,40
1650129034136,CSE 20,A01,083657,Staff,57,0,80,23
1650129040159,CSE 30,A01,083084,Eldon; John,0,63,40,40
1650129046187,CSE 100,A01,083659,Cao; Yingjun,0,61,50,50
1650129052219,CSE 134B,A01,083661,Powell; Thomas Allan,0,27,65,65
1650129058241,CSE 140,A01,083663,Staff,4,0,75,71
1650129064268,CSE 140L,A01,083088,Eldon; John,0,1,75,75
1650129070304,CSE 175,A01,083665,Kumar; Rakesh,8,0,25,17
1650129076328,CSE 190,A00,092507,Dubnov; Shlomo,14,0,20,6
1650129082353,ECE 45,A01,083139,Staff,0,13,40,40
1650129088382,ECE 65,A50,083695,Staff,0,4,30,30
1650129094405,ECE 109,A01,091882,Touri; Behrouz,48,0,70,22
1650129100440,ECE 180,A00,083140,Abi Samra; Nicholas Camill,24,0,30,6
1650129100440,ECE 180,B00,083141,Abi Samra; Nicholas Camill,8,0,30,22
1650129106465,MATH 10A,A01,083735,Patchell; Gregory David,12,0,30,18
1650129106465,MATH 10A,A02,083736,Patchell; Gregory David,28,0,30,2
1650129106465,MATH 10A,A03,083737,Patchell; Gregory David,26,0,30,4
1650129112497,MATH 10B,A01,083207,Staff,0,5,30,30
1650129112497,MATH 10B,A02,083208,Staff,0,4,30,30
1650129112497,MATH 10B,B01,083739,Staff,18,0,30,12
1650129112497,MATH 10B,B02,083740,Staff,29,0,30,1
1650129118528,MATH 18,A01,083743,Staff,10,0,30,20
1650129118528,MATH 18,A02,083744,Staff,28,0,30,2
1650129118528,MATH 18,A03,083745,Staff,23,0,30,7
1650129118528,MATH 18,A04,083746,Staff,27,0,30,3
1650129118528,MATH 18,B01,083748,Staff,0,9,30,30
1650129118528,MATH 18,B02,083749,Staff,0,7,30,30
1650129118528,MATH 18,B03,083750,Staff,0,6,30,30
1650129118528,MATH 18,B04,083751,Staff,0,7,30,30
1650129124552,MATH 20A,A01,083754,Staff,26,0,40,14
1650129130586,MATH 20B,A01,083756,Staff,0,5,30,30
1650129130586,MATH 20B,A02,083757,Staff,0,3,30,30
1650129136619,MATH 20C,A01,083760,Staff,0,11,30,30
1650129136619,MATH 20C,A02,083761,Staff,0,12,30,30
1650129136619,MATH 20C,B01,083762,Staff,14,0,30,16
1650129136619,MATH 20C,B02,083763,Staff,28,0,30,2
1650129142646,MATH 20D,A01,083765,Staff,0,2,30,30
1650129142646,MATH 20D,A02,083766,Staff,12,0,30,18
1650129142646,MATH 20D,A03,083767,Staff,28,0,30,2
1650129148677,MATH 20E,A01,083771,Staff,10,0,30,20
1650129148677,MATH 20E,A02,083772,Staff,20,0,30,10
1650129148677,MATH 20E,B01,083773,Staff,0,0,30,30
1650129148677,MATH 20E,B02,083774,Staff,13,0,30,17
1650129154701,MATH 103A,A01,083777,Staff,0,8,30,30
1650129154701,MATH 103A,A02,083778,Staff,0,8,30,30
1650129154701,MATH 103A,B01,083779,Staff,0,9,30,30
1650129154701,MATH 103A,B02,083780,Staff,0,6,30,30
1650129160741,MATH 105,A01,085443,Staff,0,13,30,30
1650129166778,MATH 109,A01,083213,Anzaldo; Leesa B,0,3,30,30
1650129166778,MATH 109,A02,083214,Anzaldo; Leesa B,0,5,30,30
1650129166778,MATH 109,B01,083215,Anzaldo; Leesa B,0,4,30,30
1650129166778,MATH 109,B02,083216,Anzaldo; Leesa B,0,4,30,30
1650129172803,MATH 142A,A01,083219,Chow; Bennett,0,11,30,30
1650129172803,MATH 142A,A02,083220,Chow; Bennett,0,10,30,30
1650129172803,MATH 142A,B01,083221,Chow; Bennett,0,10,30,30
1650129172803,MATH 142A,B02,083222,Chow; Bennett,0,10,30,30
1650129178828,MATH 193A,A01,083224,Staff,0,3,30,30
1650129178828,MATH 193A,A02,083225,Staff,0,4,30,30
1650129178828,MATH 193A,A03,083781,Staff,0,0,30,30
1650129178828,MATH 193A,A04,083782,Staff,1,0,30,29
1650129184934,MATH 197,001,091859,McAuley; Julian John,9998,0,9999,1
1650129191007,COGS 9,A01,083615,Staff,0,14,60,60
1650129197031,COGS 11,A01,083617,Boyle; Mary E. T.,24,0,40,16
1650129203058,COGS 13,A01,083071,Staff,0,28,40,40
1650129209102,COGS 14A,A01,092681,Staff,0,10,100,100
1650129215125,COGS 14B,A01,083073,Cheng; Tzu-Han,0,4,50,50
1650129221148,COGS 17,A01,092677,Staff,34,0,75,41
1650129227175,COGS 100,A01,083619,Staff,0,21,60,60
1650129233198,COGS 101A,A01,083621,Davis; Joshua Daniel,0,18,60,60
1650129239222,COGS 101B,A01,091572,Staff,10,0,60,50
1650129245248,COGS 101C,A01,083625,Delgado; Tania,22,0,30,8
1650129251274,COGS 107A,A01,083627,Boyle; Mary E. T.,0,4,60,60
1650129257296,COGS 118A,A01,083075,Staff,17,0,60,43
1650129263318,CSE 3,A50,083646,Miranda; Gregory Joseph,22,0,38,16
1650129263318,CSE 3,A51,083647,Miranda; Gregory Joseph,37,0,37,0
1650129269345,CSE 8A,A50,083650,Miranda; Gregory Joseph,0,16,40,40
1650129275371,CSE 11,A01,083080,Cao; Yingjun,0,66,40,40
1650129281392,CSE 12,A01,083652,Staff,0,2,100,100
1650129287419,CSE 15L,A01,083654,Staff,0,0,50,50
1650129287419,CSE 15L,A02,083655,Staff,10,0,50,40
1650129293439,CSE 20,A01,083657,Staff,57,0,80,23
1650129299463,CSE 30,A01,083084,Eldon; John,0,63,40,40
1650129305486,CSE 100,A01,083659,Cao; Yingjun,0,61,50,50
1650129311510,CSE 134B,A01,083661,Powell; Thomas Allan,0,27,65,65
1650129317536,CSE 140,A01,083663,Staff,4,0,75,71
1650129323563,CSE 140L,A01,083088,Eldon; John,0,1,75,75
1650129329595,CSE 175,A01,083665,Kumar; Rakesh,8,0,25,17
1650129335619,CSE 190,A00,092507,Dubnov; Shlomo,14,0,20,6
1650129341644,ECE 45,A01,083139,Staff,0,13,40,40
1650129347671,ECE 65,A50,083695,Staff,0,4,30,30
1650129353695,ECE 109,A01,091882,Touri; Behrouz,48,0,70,22
1650129359721,ECE 180,A00,083140,Abi Samra; Nicholas Camill,24,0,30,6
1650129359721,ECE 180,B00,083141,Abi Samra; Nicholas Camill,8,0,30,22
1650129365745,MATH 10A,A01,083735,Patchell; Gregory David,12,0,30,18
1650129365745,MATH 10A,A02,083736,Patchell; Gregory David,28,0,30,2
1650129365745,MATH 10A,A03,083737,Patchell; Gregory David,26,0,30,4
1650129371774,MATH 10B,A01,083207,Staff,0,5,30,30
1650129371774,MATH 10B,A02,083208,Staff,0,4,30,30
1650129371774,MATH 10B,B01,083739,Staff,18,0,30,12
1650129371774,MATH 10B,B02,083740,Staff,29,0,30,1
1650129377803,MATH 18,A01,083743,Staff,10,0,30,20
1650129377803,MATH 18,A02,083744,Staff,28,0,30,2
1650129377803,MATH 18,A03,083745,Staff,23,0,30,7
1650129377803,MATH 18,A04,083746,Staff,27,0,30,3
1650129377803,MATH 18,B01,083748,Staff,0,9,30,30
1650129377803,MATH 18,B02,083749,Staff,0,7,30,30
1650129377803,MATH 18,B03,083750,Staff,0,6,30,30
1650129377803,MATH 18,B04,083751,Staff,0,7,30,30
1650129383835,MATH 20A,A01,083754,Staff,26,0,40,14
1650129389860,MATH 20B,A01,083756,Staff,0,5,30,30
1650129389860,MATH 20B,A02,083757,Staff,0,3,30,30
1650129395881,MATH 20C,A01,083760,Staff,0,11,30,30
1650129395881,MATH 20C,A02,083761,Staff,0,12,30,30
1650129395881,MATH 20C,B01,083762,Staff,14,0,30,16
1650129395881,MATH 20C,B02,083763,Staff,28,0,30,2
1650129401909,MATH 20D,A01,083765,Staff,0,2,30,30
1650129401909,MATH 20D,A02,083766,Staff,12,0,30,18
1650129401909,MATH 20D,A03,083767,Staff,28,0,30,2
1650129407947,MATH 20E,A01,083771,Staff,10,0,30,20
1650129407947,MATH 20E,A02,083772,Staff,20,0,30,10
1650129407947,MATH 20E,B01,083773,Staff,0,0,30,30
1650129407947,MATH 20E,B02,083774,Staff,13,0,30,17
1650129413979,MATH 103A,A01,083777,Staff,0,8,30,30
1650129413979,MATH 103A,A02,083778,Staff,0,8,30,30
1650129413979,MATH 103A,B01,083779,Staff,0,9,30,30
1650129413979,MATH 103A,B02,083780,Staff,0,6,30,30
1650129420002,MATH 105,A01,085443,Staff,0,13,30,30
1650129426025,MATH 109,A01,083213,Anzaldo; Leesa B,0,3,30,30
1650129426025,MATH 109,A02,083214,Anzaldo; Leesa B,0,5,30,30
1650129426025,MATH 109,B01,083215,Anzaldo; Leesa B,0,4,30,30
1650129426025,MATH 109,B02,083216,Anzaldo; Leesa B,0,4,30,30
1650129432067,MATH 142A,A01,083219,Chow; Bennett,0,11,30,30
1650129432067,MATH 142A,A02,083220,Chow; Bennett,0,10,30,30
1650129432067,MATH 142A,B01,083221,Chow; Bennett,0,10,30,30
1650129432067,MATH 142A,B02,083222,Chow; Bennett,0,10,30,30
1650129438091,MATH 193A,A01,083224,Staff,0,3,30,30
1650129438091,MATH 193A,A02,083225,Staff,0,4,30,30
1650129438091,MATH 193A,A03,083781,Staff,0,0,30,30
1650129438091,MATH 193A,A04,083782,Staff,1,0,30,29
1650129444118,MATH 197,001,091859,McAuley; Julian John,9998,0,9999,1
1650129450167,COGS 9,A01,083615,Staff,0,14,60,60
1650129456194,COGS 11,A01,083617,Boyle; Mary E. T.,24,0,40,16
1650129462221,COGS 13,A01,083071,Staff,0,28,40,40
1650129468251,COGS 14A,A01,092681,Staff,0,10,100,100
1650129474281,COGS 14B,A01,083073,Cheng; Tzu-Han,0,4,50,50
1650129480305,COGS 17,A01,092677,Staff,34,0,75,41
1650129486332,COGS 100,A01,083619,Staff,0,21,60,60
1650129492354,COGS 101A,A01,083621,Davis; Joshua Daniel,0,18,60,60
1650129498378,COGS 101B,A01,091572,Staff,10,0,60,50
1650129504405,COGS 101C,A01,083625,Delgado; Tania,22,0,30,8
1650129510443,COGS 107A,A01,083627,Boyle; Mary E. T.,0,4,60,60
1650129516473,COGS 118A,A01,083075,Staff,17,0,60,43
1650129522511,CSE 3,A50,083646,Miranda; Gregory Joseph,22,0,38,16
1650129522511,CSE 3,A51,083647,Miranda; Gregory Joseph,37,0,37,0
1650129528538,CSE 8A,A50,083650,Miranda; Gregory Joseph,0,16,40,40
1650129534562,CSE 11,A01,083080,Cao; Yingjun,0,66,40,40
1650129540587,CSE 12,A01,083652,Staff,0,2,100,100
1650129546626,CSE 15L,A01,083654,Staff,0,0,50,50
1650129546626,CSE 15L,A02,083655,Staff,10,0,50,40
1650129552651,CSE 20,A01,083657,Staff,57,0,80,23
1650129558675,CSE 30,A01,083084,Eldon; John,0,63,40,40
1650129564701,CSE 100,A01,083659,Cao; Yingjun,0,61,50,50
1650129570727,CSE 134B,A01,083661,Powell; Thomas Allan,0,27,65,65
1650129576753,CSE 140,A01,083663,Staff,4,0,75,71
1650129582797,CSE 140L,A01,083088,Eldon; John,0,1,75,75
1650129588831,CSE 175,A01,083665,Kumar; Rakesh,8,0,25,17
1650129594870,CSE 190,A00,092507,Dubnov; Shlomo,14,0,20,6
1650129600902,ECE 45,A01,083139,Staff,0,13,40,40
1650129606924,ECE 65,A50,083695,Staff,0,4,30,30
1650129612948,ECE 109,A01,091882,Touri; Behrouz,48,0,70,22
1650129618974,ECE 180,A00,083140,Abi Samra; Nicholas Camill,24,0,30,6
1650129618974,ECE 180,B00,083141,Abi Samra; Nicholas Camill,8,0,30,22
1650129624998,MATH 10A,A01,083735,Patchell; Gregory David,12,0,30,18
1650129624998,MATH 10A,A02,083736,Patchell; Gregory David,28,0,30,2
1650129624998,MATH 10A,A03,083737,Patchell; Gregory David,26,0,30,4
1650129631035,MATH 10B,A01,083207,Staff,0,5,30,30
1650129631035,MATH 10B,A02,083208,Staff,0,4,30,30
1650129631035,MATH 10B,B01,083739,Staff,18,0,30,12
1650129631035,MATH 10B,B02,083740,Staff,29,0,30,1
1650129637061,MATH 18,A01,083743,Staff,10,0,30,20
1650129637061,MATH 18,A02,083744,Staff,28,0,30,2
1650129637061,MATH 18,A03,083745,Staff,23,0,30,7
1650129637061,MATH 18,A04,083746,Staff,27,0,30,3
1650129637061,MATH 18,B01,083748,Staff,0,9,30,30
1650129637061,MATH 18,B02,083749,Staff,0,7,30,30
1650129637061,MATH 18,B03,083750,Staff,0,6,30,30
1650129637061,MATH 18,B04,083751,Staff,0,7,30,30
1650129643085,MATH 20A,A01,083754,Staff,26,0,40,14
1650129649109,MATH 20B,A01,083756,Staff,0,5,30,30
1650129649109,MATH 20B,A02,083757,Staff,0,3,30,30
1650129655137,MATH 20C,A01,083760,Staff,0,11,30,30
1650129655137,MATH 20C,A02,083761,Staff,0,12,30,30
1650129655137,MATH 20C,B01,083762,Staff,14,0,30,16
1650129655137,MATH 20C,B02,083763,Staff,28,0,30,2
1650129661162,MATH 20D,A01,083765,Staff,0,2,30,30
1650129661162,MATH 20D,A02,083766,Staff,12,0,30,18
1650129661162,MATH 20D,A03,083767,Staff,28,0,30,2
1650129667188,MATH 20E,A01,083771,Staff,10,0,30,20
1650129667188,MATH 20E,A02,083772,Staff,20,0,30,10
1650129667188,MATH 20E,B01,083773,Staff,0,0,30,30
1650129667188,MATH 20E,B02,083774,Staff,13,0,30,17
1650129673217,MATH 103A,A01,083777,Staff,0,8,30,30
1650129673217,MATH 103A,A02,083778,Staff,0,8,30,30
1650129673217,MATH 103A,B01,083779,Staff,0,9,30,30
1650129673217,MATH 103A,B02,083780,Staff,0,6,30,30
1650129679241,MATH 105,A01,085443,Staff,0,13,30,30
1650129685265,MATH 109,A01,083213,Anzaldo; Leesa B,0,3,30,30
1650129685265,MATH 109,A02,083214,Anzaldo; Leesa B,0,5,30,30
1650129685265,MATH 109,B01,083215,Anzaldo; Leesa B,0,4,30,30
1650129685265,MATH 109,B02,083216,Anzaldo; Leesa B,0,4,30,30
1650129691306,MATH 142A,A01,083219,Chow; Bennett,0,11,30,30
1650129691306,MATH 142A,A02,083220,Chow; Bennett,0,10,30,30
1650129691306,MATH 142A,B01,083221,Chow; Bennett,0,10,30,30
1650129691306,MATH 142A,B02,083222,Chow; Bennett,0,10,30,30
1650129697330,MATH 193A,A01,083224,Staff,0,3,30,30
1650129697330,MATH 193A,A02,083225,Staff,0,4,30,30
1650129697330,MATH 193A,A03,083781,Staff,0,0,30,30
1650129697330,MATH 193A,A04,083782,Staff,1,0,30,29
1650129703356,MATH 197,001,091859,McAuley; Julian John,9998,0,9999,1
1650129709421,COGS 9,A01,083615,Staff,0,14,60,60
1650129715444,COGS 11,A01,083617,Boyle; Mary E. T.,24,0,40,16
1650129721491,COGS 13,A01,083071,Staff,0,28,40,40
1650129727514,COGS 14A,A01,092681,Staff,0,10,100,100
1650129733543,COGS 14B,A01,083073,Cheng; Tzu-Han,0,4,50,50
1650129739570,COGS 17,A01,092677,Staff,34,0,75,41
1650129745593,COGS 100,A01,083619,Staff,0,21,60,60
1650129751640,COGS 101A,A01,083621,Davis; Joshua Daniel,0,18,60,60
1650129757673,COGS 101B,A01,091572,Staff,10,0,60,50
1650129763710,COGS 101C,A01,083625,Delgado; Tania,22,0,30,8
1650129769736,COGS 107A,A01,083627,Boyle; Mary E. T.,0,4,60,60
1650129775836,COGS 118A,A01,083075,Staff,17,0,60,43
1650129781860,CSE 3,A50,083646,Miranda; Gregory Joseph,22,0,38,16
1650129781860,CSE 3,A51,083647,Miranda; Gregory Joseph,37,0,37,0
1650129787902,CSE 8A,A50,083650,Miranda; Gregory Joseph,0,16,40,40
1650129793939,CSE 11,A01,083080,Cao; Yingjun,0,66,40,40
1650129799965,CSE 12,A01,083652,Staff,0,2,100,100
1650129806004,CSE 15L,A01,083654,Staff,0,0,50,50
1650129806004,CSE 15L,A02,083655,Staff,10,0,50,40
1650129812031,CSE 20,A01,083657,Staff,57,0,80,23
1650129818072,CSE 30,A01,083084,Eldon; John,0,63,40,40
1650129824095,CSE 100,A01,083659,Cao; Yingjun,0,61,50,50
1650129830124,CSE 134B,A01,083661,Powell; Thomas Allan,0,27,65,65
1650129836151,CSE 140,A01,083663,Staff,4,0,75,71
1650129842174,CSE 140L,A01,083088,Eldon; John,0,1,75,75
1650129848206,CSE 175,A01,083665,Kumar; Rakesh,8,0,25,17
1650129854231,CSE 190,A00,092507,Dubnov; Shlomo,14,0,20,6
1650129860253,ECE 45,A01,083139,Staff,0,13,40,40
1650129866279,ECE 65,A50,083695,Staff,0,4,30,30
1650129872304,ECE 109,A01,091882,Touri; Behrouz,48,0,70,22
1650129878326,ECE 180,A00,083140,Abi Samra; Nicholas Camill,24,0,30,6
1650129878326,ECE 180,B00,083141,Abi Samra; Nicholas Camill,8,0,30,22
1650129884355,MATH 10A,A01,083735,Patchell; Gregory David,12,0,30,18
1650129884355,MATH 10A,A02,083736,Patchell; Gregory David,28,0,30,2
1650129884355,MATH 10A,A03,083737,Patchell; Gregory David,26,0,30,4
1650129890383,MATH 10B,A01,083207,Staff,0,5,30,30
1650129890383,MATH 10B,A02,083208,Staff,0,4,30,30
1650129890383,MATH 10B,B01,083739,Staff,18,0,30,12
1650129890383,MATH 10B,B02,083740,Staff,29,0,30,1
1650129896417,MATH 18,A01,083743,Staff,10,0,30,20
1650129896417,MATH 18,A02,083744,Staff,28,0,30,2
1650129896417,MATH 18,A03,083745,Staff,23,0,30,7
1650129896417,MATH 18,A04,083746,Staff,27,0,30,3
1650129896417,MATH 18,B01,083748,Staff,0,9,30,30
1650129896417,MATH 18,B02,083749,Staff,0,7,30,30
1650129896417,MATH 18,B03,083750,Staff,0,6,30,30
1650129896417,MATH 18,B04,083751,Staff,0,7,30,30
1650129902441,MATH 20A,A01,083754,Staff,26,0,40,14
1650129908467,MATH 20B,A01,083756,Staff,0,5,30,30
1650129908467,MATH 20B,A02,083757,Staff,0,3,30,30
1650129914491,MATH 20C,A01,083760,Staff,0,11,30,30
1650129914491,MATH 20C,A02,083761,Staff,0,12,30,30
1650129914491,MATH 20C,B01,083762,Staff,14,0,30,16
1650129914491,MATH 20C,B02,083763,Staff,28,0,30,2
1650129920533,MATH 20D,A01,083765,Staff,0,2,30,30
1650129920533,MATH 20D,A02,083766,Staff,12,0,30,18
1650129920533,MATH 20D,A03,083767,Staff,28,0,30,2
1650129926567,MATH 20E,A01,083771,Staff,10,0,30,20
1650129926567,MATH 20E,A02,083772,Staff,20,0,30,10
1650129926567,MATH 20E,B01,083773,Staff,0,0,30,30
1650129926567,MATH 20E,B02,083774,Staff,13,0,30,17
1650129932591,MATH 103A,A01,083777,Staff,0,8,30,30
1650129932591,MATH 103A,A02,083778,Staff,0,8,30,30
1650129932591,MATH 103A,B01,083779,Staff,0,9,30,30
1650129932591,MATH 103A,B02,083780,Staff,0,6,30,30
1650129938615,MATH 105,A01,085443,Staff,0,13,30,30
1650129944639,MATH 109,A01,083213,Anzaldo; Leesa B,0,3,30,30
1650129944639,MATH 109,A02,083214,Anzaldo; Leesa B,0,5,30,30
1650129944639,MATH 109,B01,083215,Anzaldo; Leesa B,0,4,30,30
1650129944639,MATH 109,B02,083216,Anzaldo; Leesa B,0,4,30,30
1650129950673,MATH 142A,A01,083219,Chow; Bennett,0,11,30,30
1650129950673,MATH 142A,A02,083220,Chow; Bennett,0,10,30,30
1650129950673,MATH 142A,B01,083221,Chow; Bennett,0,10,30,30
1650129950673,MATH 142A,B02,083222,Chow; Bennett,0,10,30,30
1650129956698,MATH 193A,A01,083224,Staff,0,3,30,30
1650129956698,MATH 193A,A02,083225,Staff,0,4,30,30
1650129956698,MATH 193A,A03,083781,Staff,0,0,30,30
1650129956698,MATH 193A,A04,083782,Staff,1,0,30,29
1650129962720,MATH 197,001,091859,McAuley; Julian John,9998,0,9999,1
1650129968791,COGS 9,A01,083615,Staff,0,14,60,60
1650129974818,COGS 11,A01,083617,Boyle; Mary E. T.,24,0,40,16
1650129980840,COGS 13,A01,083071,Staff,0,28,40,40
1650129986870,COGS 14A,A01,092681,Staff,0,10,100,100
1650129992909,COGS 14B,A01,083073,Cheng; Tzu-Han,0,4,50,50
1650129998935,COGS 17,A01,092677,Staff,34,0,75,41
1650130004971,COGS 100,A01,083619,Staff,0,21,60,60
1650130011006,COGS 101A,A01,083621,Davis; Joshua Daniel,0,18,60,60
1650130017029,COGS 101B,A01,091572,Staff,10,0,60,50
1650130023058,COGS 101C,A01,083625,Delgado; Tania,22,0,30,8
1650130029097,COGS 107A,A01,083627,Boyle; Mary E. T.,0,4,60,60
1650130035119,COGS 118A,A01,083075,Staff,17,0,60,43
1650130041172,CSE 3,A50,083646,Miranda; Gregory Joseph,22,0,38,16
1650130041172,CSE 3,A51,083647,Miranda; Gregory Joseph,37,0,37,0
1650130047200,CSE 8A,A50,083650,Miranda; Gregory Joseph,0,16,40,40
1650130053224,CSE 11,A01,083080,Cao; Yingjun,0,66,40,40
1650130059247,CSE 12,A01,083652,Staff,0,2,100,100
1650130065271,CSE 15L,A01,083654,Staff,0,0,50,50
1650130065271,CSE 15L,A02,083655,Staff,10,0,50,40
1650130071295,CSE 20,A01,083657,Staff,57,0,80,23
1650130077322,CSE 30,A01,083084,Eldon; John,0,63,40,40
1650130083350,CSE 100,A01,083659,Cao; Yingjun,0,61,50,50
1650130089378,CSE 134B,A01,083661,Powell; Thomas Allan,0,27,65,65
1650130095402,CSE 140,A01,083663,Staff,4,0,75,71
1650130101425,CSE 140L,A01,083088,Eldon; John,0,1,75,75
1650130107447,CSE 175,A01,083665,Kumar; Rakesh,8,0,25,17
1650130113473,CSE 190,A00,092507,Dubnov; Shlomo,14,0,20,6
1650130119506,ECE 45,A01,083139,Staff,0,13,40,40
1650130125528,ECE 65,A50,083695,Staff,0,4,30,30
1650130131554,ECE 109,A01,091882,Touri; Behrouz,48,0,70,22
1650130137578,ECE 180,A00,083140,Abi Samra; Nicholas Camill,24,0,30,6
1650130137578,ECE 180,B00,083141,Abi Samra; Nicholas Camill,8,0,30,22
1650130143607,MATH 10A,A01,083735,Patchell; Gregory David,12,0,30,18
1650130143607,MATH 10A,A02,083736,Patchell; Gregory David,28,0,30,2
1650130143607,MATH 10A,A03,083737,Patchell; Gregory David,26,0,30,4
1650130149630,MATH 10B,A01,083207,Staff,0,5,30,30
1650130149630,MATH 10B,A02,083208,Staff,0,4,30,30
1650130149630,MATH 10B,B01,083739,Staff,18,0,30,12
1650130149630,MATH 10B,B02,083740,Staff,29,0,30,1
1650130155659,MATH 18,A01,083743,Staff,10,0,30,20
1650130155659,MATH 18,A02,083744,Staff,28,0,30,2
1650130155659,MATH 18,A03,083745,Staff,23,0,30,7
1650130155659,MATH 18,A04,083746,Staff,27,0,30,3
1650130155659,MATH 18,B01,083748,Staff,0,9,30,30
1650130155659,MATH 18,B02,083749,Staff,0,7,30,30
1650130155659,MATH 18,B03,083750,Staff,0,6,30,30
1650130155659,MATH 18,B04,083751,Staff,0,7,30,30
1650130161690,MATH 20A,A01,083754,Staff,26,0,40,14
1650130167717,MATH 20B,A01,083756,Staff,0,5,30,30
1650130167717,MATH 20B,A02,083757,Staff,0,3,30,30
1650130173741,MATH 20C,A01,083760,Staff,0,11,30,30
1650130173741,MATH 20C,A02,083761,Staff,0,12,30,30
1650130173741,MATH 20C,B01,083762,Staff,14,0,30,16
1650130173741,MATH 20C,B02,083763,Staff,28,0,30,2
1650130179766,MATH 20D,A01,083765,Staff,0,2,30,30
1650130179766,MATH 20D,A02,083766,Staff,12,0,30,18
1650130179766,MATH 20D,A03,083767,Staff,28,0,30,2
1650130185796,MATH 20E,A01,083771,Staff,10,0,30,20
1650130185796,MATH 20E,A02,083772,Staff,20,0,30,10
1650130185796,MATH 20E,B01,083773,Staff,0,0,30,30
1650130185796,MATH 20E,B02,083774,Staff,13,0,30,17
1650130191822,MATH 103A,A01,083777,Staff,0,8,30,30
1650130191822,MATH 103A,A02,083778,Staff,0,8,30,30
1650130191822,MATH 103A,B01,083779,Staff,0,9,30,30
1650130191822,MATH 103A,B02,083780,Staff,0,6,30,30
1650130197852,MATH 105,A01,085443,Staff,0,13,30,30
1650130203880,MATH 109,A01,083213,Anzaldo; Leesa B,0,3,30,30
1650130203880,MATH 109,A02,083214,Anzaldo; Leesa B,0,5,30,30
1650130203880,MATH 109,B01,083215,Anzaldo; Leesa B,0,4,30,30
1650130203880,MATH 109,B02,083216,Anzaldo; Leesa B,0,4,30,30
1650130209920,MATH 142A,A01,083219,Chow; Bennett,0,11,30,30
1650130209920,MATH 142A,A02,083220,Chow; Bennett,0,10,30,30
1650130209920,MATH 142A,B01,083221,Chow; Bennett,0,10,30,30
1650130209920,MATH 142A,B02,083222,Chow; Bennett,0,10,30,30
1650130215948,MATH 193A,A01,083224,Staff,0,3,30,30
1650130215948,MATH 193A,A02,083225,Staff,0,4,30,30
1650130215948,MATH 193A,A03,083781,Staff,0,0,30,30
1650130215948,MATH 193A,A04,083782,Staff,1,0,30,29
1650130221975,MATH 197,001,091859,McAuley; Julian John,9998,0,9999,1
1650130228036,COGS 9,A01,083615,Staff,0,14,60,60
1650130234086,COGS 11,A01,083617,Boyle; Mary E. T.,24,0,40,16
1650130240113,COGS 13,A01,083071,Staff,0,28,40,40
1650130246146,COGS 14A,A01,092681,Staff,0,10,100,100
1650130252169,COGS 14B,A01,083073,Cheng; Tzu-Han,0,4,50,50
1650130258196,COGS 17,A01,092677,Staff,34,0,75,41
1650130264221,COGS 100,A01,083619,Staff,0,21,60,60
1650130270248,COGS 101A,A01,083621,Davis; Joshua Daniel,0,18,60,60
1650130276284,COGS 101B,A01,091572,Staff,10,0,60,50
1650130282310,COGS 101C,A01,083625,Delgado; Tania,22,0,30,8
1650130288333,COGS 107A,A01,083627,Boyle; Mary E. T.,0,4,60,60
1650130294355,COGS 118A,A01,083075,Staff,17,0,60,43
1650130300379,CSE 3,A50,083646,Miranda; Gregory Joseph,22,0,38,16
1650130300379,CSE 3,A51,083647,Miranda; Gregory Joseph,37,0,37,0
1650130306405,CSE 8A,A50,083650,Miranda; Gregory Joseph,0,16,40,40
1650130312428,CSE 11,A01,083080,Cao; Yingjun,0,66,40,40
1650130318457,CSE 12,A01,083652,Staff,0,2,100,100
1650130324490,CSE 15L,A01,083654,Staff,0,0,50,50
1650130324490,CSE 15L,A02,083655,Staff,10,0,50,40
1650130330516,CSE 20,A01,083657,Staff,57,0,80,23
1650130336550,CSE 30,A01,083084,Eldon; John,0,63,40,40
1650130342582,CSE 100,A01,083659,Cao; Yingjun,0,61,50,50
1650130348608,CSE 134B,A01,083661,Powell; Thomas Allan,0,27,65,65
1650130354634,CSE 140,A01,083663,Staff,4,0,75,71
1650130360658,CSE 140L,A01,083088,Eldon; John,0,1,75,75
1650130366682,CSE 175,A01,083665,Kumar; Rakesh,8,0,25,17
1650130372786,CSE 190,A00,092507,Dubnov; Shlomo,14,0,20,6
1650130378810,ECE 45,A01,083139,Staff,0,13,40,40
1650130384844,ECE 65,A50,083695,Staff,0,4,30,30
1650130390870,ECE 109,A01,091882,Touri; Behrouz,48,0,70,22
1650130396892,ECE 180,A00,083140,Abi Samra; Nicholas Camill,24,0,30,6
1650130396892,ECE 180,B00,083141,Abi Samra; Nicholas Camill,8,0,30,22
1650130402916,MATH 10A,A01,083735,Patchell; Gregory David,12,0,30,18
1650130402916,MATH 10A,A02,083736,Patchell; Gregory David,28,0,30,2
1650130402916,MATH 10A,A03,083737,Patchell; Gregory David,26,0,30,4
1650130408945,MATH 10B,A01,083207,Staff,0,5,30,30
1650130408945,MATH 10B,A02,083208,Staff,0,4,30,30
1650130408945,MATH 10B,B01,083739,Staff,18,0,30,12
1650130408945,MATH 10B,B02,083740,Staff,29,0,30,1
1650130414969,MATH 18,A01,083743,Staff,10,0,30,20
1650130414969,MATH 18,A02,083744,Staff,28,0,30,2
1650130414969,MATH 18,A03,083745,Staff,23,0,30,7
1650130414969,MATH 18,A04,083746,Staff,27,0,30,3
1650130414969,MATH 18,B01,083748,Staff,0,9,30,30
1650130414969,MATH 18,B02,083749,Staff,0,7,30,30
1650130414969,MATH 18,B03,083750,Staff,0,6,30,30
1650130414969,MATH 18,B04,083751,Staff,0,7,30,30
1650130421004,MATH 20A,A01,083754,Staff,26,0,40,14
1650130427037,MATH 20B,A01,083756,Staff,0,5,30,30
1650130427037,MATH 20B,A02,083757,Staff,0,3,30,30
1650130433061,MATH 20C,A01,083760,Staff,0,11,30,30
1650130433061,MATH 20C,A02,083761,Staff,0,12,30,30
1650130433061,MATH 20C,B01,083762,Staff,14,0,30,16
1650130433061,MATH 20C,B02,083763,Staff,28,0,30,2
1650130439087,MATH 20D,A01,083765,Staff,0,2,30,30
1650130439087,MATH 20D,A02,083766,Staff,12,0,30,18
1650130439087,MATH 20D,A03,083767,Staff,28,0,30,2
1650130445113,MATH 20E,A01,083771,Staff,10,0,30,20
1650130445113,MATH 20E,A02,083772,Staff,20,0,30,10
1650130445113,MATH 20E,B01,083773,Staff,0,0,30,30
1650130445113,MATH 20E,B02,083774,Staff,13,0,30,17
1650130451137,MATH 103A,A01,083777,Staff,0,8,30,30
1650130451137,MATH 103A,A02,083778,Staff,0,8,30,30
1650130451137,MATH 103A,B01,083779,Staff,0,9,30,30
1650130451137,MATH 103A,B02,083780,Staff,0,6,30,30
1650130457159,MATH 105,A01,085443,Staff,0,13,30,30
1650130463183,MATH 109,A01,083213,Anzaldo; Leesa B,0,3,30,30
1650130463183,MATH 109,A02,083214,Anzaldo; Leesa B,0,5,30,30
1650130463183,MATH 109,B01,083215,Anzaldo; Leesa B,0,4,30,30
1650130463183,MATH 109,B02,083216,Anzaldo; Leesa B,0,4,30,30
1650130469206,MATH 142A,A01,083219,Chow; Bennett,0,11,30,30
1650130469206,MATH 142A,A02,083220,Chow; Bennett,0,10,30,30
1650130469206,MATH 142A,B01,083221,Chow; Bennett,0,10,30,30
1650130469206,MATH 142A,B02,083222,Chow; Bennett,0,10,30,30
1650130475234,MATH 193A,A01,083224,Staff,0,3,30,30
1650130475234,MATH 193A,A02,083225,Staff,0,4,30,30
1650130475234,MATH 193A,A03,083781,Staff,0,0,30,30
1650130475234,MATH 193A,A04,083782,Staff,1,0,30,29
1650130481258,MATH 197,001,091859,McAuley; Julian John,9998,0,9999,1
1650130487315,COGS 9,A01,083615,Staff,0,14,60,60
1650130493342,COGS 11,A01,083617,Boyle; Mary E. T.,24,0,40,16
1650130499365,COGS 13,A01,083071,Staff,0,28,40,40
1650130505391,COGS 14A,A01,092681,Staff,0,10,100,100
1650130511418,COGS 14B,A01,083073,Cheng; Tzu-Han,0,4,50,50
1650130517446,COGS 17,A01,092677,Staff,34,0,75,41
1650130523477,COGS 100,A01,083619,Staff,0,21,60,60
1650130529501,COGS 101A,A01,083621,Davis; Joshua Daniel,0,18,60,60
1650130535528,COGS 101B,A01,091572,Staff,10,0,60,50
1650130541552,COGS 101C,A01,083625,Delgado; Tania,22,0,30,8
1650130547580,COGS 107A,A01,083627,Boyle; Mary E. T.,0,5,60,60
1650130553607,COGS 118A,A01,083075,Staff,17,0,60,43
1650130559639,CSE 3,A50,083646,Miranda; Gregory Joseph,22,0,38,16
1650130559639,CSE 3,A51,083647,Miranda; Gregory Joseph,37,0,37,0
1650130565662,CSE 8A,A50,083650,Miranda; Gregory Joseph,0,16,40,40
1650130571690,CSE 11,A01,083080,Cao; Yingjun,0,66,40,40
1650130577717,CSE 12,A01,083652,Staff,0,2,100,100
1650130583741,CSE 15L,A01,083654,Staff,0,0,50,50
1650130583741,CSE 15L,A02,083655,Staff,10,0,50,40
1650130589767,CSE 20,A01,083657,Staff,57,0,80,23
1650130595791,CSE 30,A01,083084,Eldon; John,0,63,40,40
1650130601819,CSE 100,A01,083659,Cao; Yingjun,0,61,50,50
1650130607845,CSE 134B,A01,083661,Powell; Thomas Allan,0,27,65,65
1650130613868,CSE 140,A01,083663,Staff,4,0,75,71
1650130619892,CSE 140L,A01,083088,Eldon; John,0,1,75,75
1650130625919,CSE 175,A01,083665,Kumar; Rakesh,8,0,25,17
1650130631946,CSE 190,A00,092507,Dubnov; Shlomo,14,0,20,6
1650130637969,ECE 45,A01,083139,Staff,0,13,40,40
1650130643996,ECE 65,A50,083695,Staff,0,4,30,30
1650130650020,ECE 109,A01,091882,Touri; Behrouz,48,0,70,22
1650130656053,ECE 180,A00,083140,Abi Samra; Nicholas Camill,24,0,30,6
1650130656053,ECE 180,B00,083141,Abi Samra; Nicholas Camill,8,0,30,22
1650130662077,MATH 10A,A01,083735,Patchell; Gregory David,12,0,30,18
1650130662077,MATH 10A,A02,083736,Patchell; Gregory David,28,0,30,2
1650130662077,MATH 10A,A03,083737,Patchell; Gregory David,26,0,30,4
1650130668100,MATH 10B,A01,083207,Staff,0,5,30,30
1650130668100,MATH 10B,A02,083208,Staff,0,4,30,30
1650130668100,MATH 10B,B01,083739,Staff,18,0,30,12
1650130668100,MATH 10B,B02,083740,Staff,29,0,30,1
1650130674130,MATH 18,A01,083743,Staff,10,0,30,20
1650130674130,MATH 18,A02,083744,Staff,28,0,30,2
1650130674130,MATH 18,A03,083745,Staff,23,0,30,7
1650130674130,MATH 18,A04,083746,Staff,27,0,30,3
1650130674130,MATH 18,B01,083748,Staff,0,9,30,30
1650130674130,MATH 18,B02,083749,Staff,0,7,30,30
1650130674130,MATH 18,B03,083750,Staff,0,6,30,30
1650130674130,MATH 18,B04,083751,Staff,0,7,30,30
1650130680172,MATH 20A,A01,083754,Staff,26,0,40,14
1650130686195,MATH 20B,A01,083756,Staff,0,5,30,30
1650130686195,MATH 20B,A02,083757,Staff,0,3,30,30
1650130692224,MATH 20C,A01,083760,Staff,0,11,30,30
1650130692224,MATH 20C,A02,083761,Staff,0,12,30,30
1650130692224,MATH 20C,B01,083762,Staff,14,0,30,16
1650130692224,MATH 20C,B02,083763,Staff,28,0,30,2
1650130698252,MATH 20D,A01,083765,Staff,0,2,30,30
1650130698252,MATH 20D,A02,083766,Staff,12,0,30,18
1650130698252,MATH 20D,A03,083767,Staff,28,0,30,2
1650130704279,MATH 20E,A01,083771,Staff,10,0,30,20
1650130704279,MATH 20E,A02,083772,Staff,20,0,30,10
1650130704279,MATH 20E,B01,083773,Staff,0,0,30,30
1650130704279,MATH 20E,B02,083774,Staff,13,0,30,17
1650130710314,MATH 103A,A01,083777,Staff,0,8,30,30
1650130710314,MATH 103A,A02,083778,Staff,0,8,30,30
1650130710314,MATH 103A,B01,083779,Staff,0,9,30,30
1650130710314,MATH 103A,B02,083780,Staff,0,6,30,30
1650130716337,MATH 105,A01,085443,Staff,0,13,30,30
1650130722365,MATH 109,A01,083213,Anzaldo; Leesa B,0,3,30,30
1650130722365,MATH 109,A02,083214,Anzaldo; Leesa B,0,5,30,30
1650130722365,MATH 109,B01,083215,Anzaldo; Leesa B,0,4,30,30
1650130722365,MATH 109,B02,083216,Anzaldo; Leesa B,0,4,30,30
1650130728389,MATH 142A,A01,083219,Chow; Bennett,0,11,30,30
1650130728389,MATH 142A,A02,083220,Chow; Bennett,0,10,30,30
1650130728389,MATH 142A,B01,083221,Chow; Bennett,0,10,30,30
1650130728389,MATH 142A,B02,083222,Chow; Bennett,0,10,30,30
1650130734421,MATH 193A,A01,083224,Staff,0,3,30,30
1650130734421,MATH 193A,A02,083225,Staff,0,4,30,30
1650130734421,MATH 193A,A03,083781,Staff,0,0,30,30
1650130734421,MATH 193A,A04,083782,Staff,1,0,30,29
1650130740447,MATH 197,001,091859,McAuley; Julian John,9998,0,9999,1
1650130746511,COGS 9,A01,083615,Staff,0,14,60,60
1650130752534,COGS 11,A01,083617,Boyle; Mary E. T.,24,0,40,16
1650130758559,COGS 13,A01,083071,Staff,0,28,40,40
1650130764586,COGS 14A,A01,092681,Staff,0,10,100,100
1650130770611,COGS 14B,A01,083073,Cheng; Tzu-Han,0,4,50,50
1650130776635,COGS 17,A01,092677,Staff,34,0,75,41
1650130782662,COGS 100,A01,083619,Staff,0,21,60,60
1650130788686,COGS 101A,A01,083621,Davis; Joshua Daniel,0,18,60,60
1650130794713,COGS 101B,A01,091572,Staff,10,0,60,50
1650130800736,COGS 101C,A01,083625,Delgado; Tania,22,0,30,8
1650130806759,COGS 107A,A01,083627,Boyle; Mary E. T.,0,5,60,60
1650130812785,COGS 118A,A01,083075,Staff,17,0,60,43
1650130818814,CSE 3,A50,083646,Miranda; Gregory Joseph,22,0,38,16
1650130818814,CSE 3,A51,083647,Miranda; Gregory Joseph,37,0,37,0
1650130824843,CSE 8A,A50,083650,Miranda; Gregory Joseph,0,16,40,40
1650130830866,CSE 11,A01,083080,Cao; Yingjun,0,66,40,40
1650130836892,CSE 12,A01,083652,Staff,0,2,100,100
1650130842916,CSE 15L,A01,083654,Staff,0,0,50,50
1650130842916,CSE 15L,A02,083655,Staff,10,0,50,40
1650130848940,CSE 20,A01,083657,Staff,57,0,80,23
1650130854964,CSE 30,A01,083084,Eldon; John,0,63,40,40
1650130860988,CSE 100,A01,083659,Cao; Yingjun,0,61,50,50
1650130867020,CSE 134B,A01,083661,Powell; Thomas Allan,0,27,65,65
1650130873048,CSE 140,A01,083663,Staff,4,0,75,71
1650130879076,CSE 140L,A01,083088,Eldon; John,0,1,75,75
1650130885098,CSE 175,A01,083665,Kumar; Rakesh,8,0,25,17
1650130891126,CSE 190,A00,092507,Dubnov; Shlomo,14,0,20,6
1650130897149,ECE 45,A01,083139,Staff,0,13,40,40
1650130903185,ECE 65,A50,083695,Staff,0,4,30,30
1650130909209,ECE 109,A01,091882,Touri; Behrouz,48,0,70,22
1650130915233,ECE 180,A00,083140,Abi Samra; Nicholas Camill,24,0,30,6
1650130915233,ECE 180,B00,083141,Abi Samra; Nicholas Camill,8,0,30,22
1650130921259,MATH 10A,A01,083735,Patchell; Gregory David,12,0,30,18
1650130921259,MATH 10A,A02,083736,Patchell; Gregory David,28,0,30,2
1650130921259,MATH 10A,A03,083737,Patchell; Gregory David,26,0,30,4
1650130927286,MATH 10B,A01,083207,Staff,0,5,30,30
1650130927286,MATH 10B,A02,083208,Staff,0,4,30,30
1650130927286,MATH 10B,B01,083739,Staff,18,0,30,12
1650130927286,MATH 10B,B02,083740,Staff,29,0,30,1
1650130933310,MATH 18,A01,083743,Staff,10,0,30,20
1650130933310,MATH 18,A02,083744,Staff,28,0,30,2
1650130933310,MATH 18,A03,083745,Staff,23,0,30,7
1650130933310,MATH 18,A04,083746,Staff,27,0,30,3
1650130933310,MATH 18,B01,083748,Staff,0,9,30,30
1650130933310,MATH 18,B02,083749,Staff,0,7,30,30
1650130933310,MATH 18,B03,083750,Staff,0,6,30,30
1650130933310,MATH 18,B04,083751,Staff,0,7,30,30
1650130939340,MATH 20A,A01,083754,Staff,26,0,40,14
1650130945374,MATH 20B,A01,083756,Staff,0,5,30,30
1650130945374,MATH 20B,A02,083757,Staff,0,3,30,30
1650130951399,MATH 20C,A01,083760,Staff,0,11,30,30
1650130951399,MATH 20C,A02,083761,Staff,0,12,30,30
1650130951399,MATH 20C,B01,083762,Staff,14,0,30,16
1650130951399,MATH 20C,B02,083763,Staff,28,0,30,2
1650130957424,MATH 20D,A01,083765,Staff,0,2,30,30
1650130957424,MATH 20D,A02,083766,Staff,12,0,30,18
1650130957424,MATH 20D,A03,083767,Staff,28,0,30,2
1650130963452,MATH 20E,A01,083771,Staff,10,0,30,20
1650130963452,MATH 20E,A02,083772,Staff,20,0,30,10
1650130963452,MATH 20E,B01,083773,Staff,0,0,30,30
1650130963452,MATH 20E,B02,083774,Staff,13,0,30,17
1650130969565,MATH 103A,A01,083777,Staff,0,8,30,30
1650130969565,MATH 103A,A02,083778,Staff,0,8,30,30
1650130969565,MATH 103A,B01,083779,Staff,0,9,30,30
1650130969565,MATH 103A,B02,083780,Staff,0,6,30,30
1650130975588,MATH 105,A01,085443,Staff,0,13,30,30
1650130981612,MATH 109,A01,083213,Anzaldo; Leesa B,0,3,30,30
1650130981612,MATH 109,A02,083214,Anzaldo; Leesa B,0,5,30,30
1650130981612,MATH 109,B01,083215,Anzaldo; Leesa B,0,4,30,30
1650130981612,MATH 109,B02,083216,Anzaldo; Leesa B,0,4,30,30
1650130987637,MATH 142A,A01,083219,Chow; Bennett,0,11,30,30
1650130987637,MATH 142A,A02,083220,Chow; Bennett,0,10,30,30
1650130987637,MATH 142A,B01,083221,Chow; Bennett,0,10,30,30
1650130987637,MATH 142A,B02,083222,Chow; Bennett,0,10,30,30
1650130993660,MATH 193A,A01,083224,Staff,0,3,30,30
1650130993660,MATH 193A,A02,083225,Staff,0,4,30,30
1650130993660,MATH 193A,A03,083781,Staff,0,0,30,30
1650130993660,MATH 193A,A04,083782,Staff,1,0,30,29
1650130999683,MATH 197,001,091859,McAuley; Julian John,9998,0,9999,1
1650131005741,COGS 9,A01,083615,Staff,0,14,60,60
1650131011765,COGS 11,A01,083617,Boyle; Mary E. T.,24,0,40,16
1650131017790,COGS 13,A01,083071,Staff,0,28,40,40
1650131023817,COGS 14A,A01,092681,Staff,0,10,100,100
1650131029848,COGS 14B,A01,083073,Cheng; Tzu-Han,0,4,50,50
1650131035873,COGS 17,A01,092677,Staff,34,0,75,41
1650131041898,COGS 100,A01,083619,Staff,0,21,60,60
1650131047921,COGS 101A,A01,083621,Davis; Joshua Daniel,0,18,60,60
1650131053947,COGS 101B,A01,091572,Staff,10,0,60,50
1650131059971,COGS 101C,A01,083625,Delgado; Tania,22,0,30,8
1650131065995,COGS 107A,A01,083627,Boyle; Mary E. T.,0,5,60,60
1650131072017,COGS 118A,A01,083075,Staff,17,0,60,43
1650131078047,CSE 3,A50,083646,Miranda; Gregory Joseph,22,0,38,16
1650131078047,CSE 3,A51,083647,Miranda; Gregory Joseph,37,0,37,0
1650131084073,CSE 8A,A50,083650,Miranda; Gregory Joseph,0,16,40,40
1650131090096,CSE 11,A01,083080,Cao; Yingjun,0,66,40,40
1650131096123,CSE 12,A01,083652,Staff,0,2,100,100
1650131102149,CSE 15L,A01,083654,Staff,0,0,50,50
1650131102149,CSE 15L,A02,083655,Staff,10,0,50,40
1650131108173,CSE 20,A01,083657,Staff,57,0,80,23
1650131114200,CSE 30,A01,083084,Eldon; John,0,63,40,40
1650131120227,CSE 100,A01,083659,Cao; Yingjun,0,61,50,50
1650131126251,CSE 134B,A01,083661,Powell; Thomas Allan,0,27,65,65
1650131132274,CSE 140,A01,083663,Staff,4,0,75,71
1650131138298,CSE 140L,A01,083088,Eldon; John,0,1,75,75
1650131144325,CSE 175,A01,083665,Kumar; Rakesh,8,0,25,17
1650131150361,CSE 190,A00,092507,Dubnov; Shlomo,14,0,20,6
1650131156384,ECE 45,A01,083139,Staff,0,13,40,40
1650131162408,ECE 65,A50,083695,Staff,0,4,30,30
1650131168444,ECE 109,A01,091882,Touri; Behrouz,48,0,70,22
1650131174471,ECE 180,A00,083140,Abi Samra; Nicholas Camill,24,0,30,6
1650131174471,ECE 180,B00,083141,Abi Samra; Nicholas Camill,8,0,30,22
1650131180495,MATH 10A,A01,083735,Patchell; Gregory David,12,0,30,18
1650131180495,MATH 10A,A02,083736,Patchell; Gregory David,28,0,30,2
1650131180495,MATH 10A,A03,083737,Patchell; Gregory David,26,0,30,4
1650131186521,MATH 10B,A01,083207,Staff,0,5,30,30
1650131186521,MATH 10B,A02,083208,Staff,0,4,30,30
1650131186521,MATH 10B,B01,083739,Staff,18,0,30,12
1650131186521,MATH 10B,B02,083740,Staff,29,0,30,1
1650131192547,MATH 18,A01,083743,Staff,10,0,30,20
1650131192547,MATH 18,A02,083744,Staff,28,0,30,2
1650131192547,MATH 18,A03,083745,Staff,23,0,30,7
1650131192547,MATH 18,A04,083746,Staff,27,0,30,3
1650131192547,MATH 18,B01,083748,Staff,0,9,30,30
1650131192547,MATH 18,B02,083749,Staff,0,7,30,30
1650131192547,MATH 18,B03,083750,Staff,0,6,30,30
1650131192547,MATH 18,B04,083751,Staff,0,7,30,30
1650131198578,MATH 20A,A01,083754,Staff,26,0,40,14
1650131204616,MATH 20B,A01,083756,Staff,0,5,30,30
1650131204616,MATH 20B,A02,083757,Staff,0,3,30,30
1650131210646,MATH 20C,A01,083760,Staff,0,11,30,30
1650131210646,MATH 20C,A02,083761,Staff,0,12,30,30
1650131210646,MATH 20C,B01,083762,Staff,14,0,30,16
1650131210646,MATH 20C,B02,083763,Staff,28,0,30,2
1650131216669,MATH 20D,A01,083765,Staff,0,2,30,30
1650131216669,MATH 20D,A02,083766,Staff,12,0,30,18
1650131216669,MATH 20D,A03,083767,Staff,28,0,30,2
1650131222692,MATH 20E,A01,083771,Staff,10,0,30,20
1650131222692,MATH 20E,A02,083772,Staff,20,0,30,10
1650131222692,MATH 20E,B01,083773,Staff,0,0,30,30
1650131222692,MATH 20E,B02,083774,Staff,13,0,30,17
1650131228726,MATH 103A,A01,083777,Staff,0,8,30,30
1650131228726,MATH 103A,A02,083778,Staff,0,8,30,30
1650131228726,MATH 103A,B01,083779,Staff,0,9,30,30
1650131228726,MATH 103A,B02,083780,Staff,0,6,30,30
1650131234769,MATH 105,A01,085443,Staff,0,13,30,30
1650131240794,MATH 109,A01,083213,Anzaldo; Leesa B,0,3,30,30
1650131240794,MATH 109,A02,083214,Anzaldo; Leesa B,0,5,30,30
1650131240794,MATH 109,B01,083215,Anzaldo; Leesa B,0,4,30,30
1650131240794,MATH 109,B02,083216,Anzaldo; Leesa B,0,4,30,30
1650131246822,MATH 142A,A01,083219,Chow; Bennett,0,11,30,30
1650131246822,MATH 142A,A02,083220,Chow; Bennett,0,10,30,30
1650131246822,MATH 142A,B01,083221,Chow; Bennett,0,10,30,30
1650131246822,MATH 142A,B02,083222,Chow; Bennett,0,10,30,30
1650131252849,MATH 193A,A01,083224,Staff,0,3,30,30
1650131252849,MATH 193A,A02,083225,Staff,0,4,30,30
1650131252849,MATH 193A,A03,083781,Staff,0,0,30,30
1650131252849,MATH 193A,A04,083782,Staff,1,0,30,29
1650131258876,MATH 197,001,091859,McAuley; Julian John,9998,0,9999,1
1650131264961,COGS 9,A01,083615,Staff,0,14,60,60
1650131270987,COGS 11,A01,083617,Boyle; Mary E. T.,24,0,40,16
1650131277014,COGS 13,A01,083071,Staff,0,28,40,40
1650131283036,COGS 14A,A01,092681,Staff,0,10,100,100
1650131289060,COGS 14B,A01,083073,Cheng; Tzu-Han,0,4,50,50
1650131295087,COGS 17,A01,092677,Staff,34,0,75,41
1650131301111,COGS 100,A01,083619,Staff,0,21,60,60
1650131307133,COGS 101A,A01,083621,Davis; Joshua Daniel,0,18,60,60
1650131313160,COGS 101B,A01,091572,Staff,10,0,60,50
1650131319194,COGS 101C,A01,083625,Delgado; Tania,22,0,30,8
1650131325218,COGS 107A,A01,083627,Boyle; Mary E. T.,0,5,60,60
1650131331242,COGS 118A,A01,083075,Staff,17,0,60,43
1650131337271,CSE 3,A50,083646,Miranda; Gregory Joseph,22,0,38,16
1650131337271,CSE 3,A51,083647,Miranda; Gregory Joseph,37,0,37,0
1650131343306,CSE 8A,A50,083650,Miranda; Gregory Joseph,0,16,40,40
1650131349334,CSE 11,A01,083080,Cao; Yingjun,0,66,40,40
1650131355358,CSE 12,A01,083652,Staff,0,2,100,100
1650131361383,CSE 15L,A01,083654,Staff,0,0,50,50
1650131361383,CSE 15L,A02,083655,Staff,10,0,50,40
1650131367411,CSE 20,A01,083657,Staff,57,0,80,23
1650131373440,CSE 30,A01,083084,Eldon; John,0,63,40,40
1650131379466,CSE 100,A01,083659,Cao; Yingjun,0,61,50,50
1650131385504,CSE 134B,A01,083661,Powell; Thomas Allan,0,27,65,65
1650131391528,CSE 140,A01,083663,Staff,4,0,75,71
1650131397552,CSE 140L,A01,083088,Eldon; John,0,1,75,75
1650131403578,CSE 175,A01,083665,Kumar; Rakesh,8,0,25,17
1650131409603,CSE 190,A00,092507,Dubnov; Shlomo,14,0,20,6
1650131415627,ECE 45,A01,083139,Staff,0,13,40,40
1650131421655,ECE 65,A50,083695,Staff,0,4,30,30
1650131427679,ECE 109,A01,091882,Touri; Behrouz,48,0,70,22
1650131433706,ECE 180,A00,083140,Abi Samra; Nicholas Camill,24,0,30,6
1650131433706,ECE 180,B00,083141,Abi Samra; Nicholas Camill,8,0,30,22
1650131439736,MATH 10A,A01,083735,Patchell; Gregory David,12,0,30,18
1650131439736,MATH 10A,A02,083736,Patchell; Gregory David,28,0,30,2
1650131439736,MATH 10A,A03,083737,Patchell; Gregory David,26,0,30,4
1650131445764,MATH 10B,A01,083207,Staff,0,5,30,30
1650131445764,MATH 10B,A02,083208,Staff,0,4,30,30
1650131445764,MATH 10B,B01,083739,Staff,18,0,30,12
1650131445764,MATH 10B,B02,083740,Staff,29,0,30,1
1650131451794,MATH 18,A01,083743,Staff,10,0,30,20
1650131451794,MATH 18,A02,083744,Staff,28,0,30,2
1650131451794,MATH 18,A03,083745,Staff,23,0,30,7
1650131451794,MATH 18,A04,083746,Staff,27,0,30,3
1650131451794,MATH 18,B01,083748,Staff,0,9,30,30
1650131451794,MATH 18,B02,083749,Staff,0,7,30,30
1650131451794,MATH 18,B03,083750,Staff,0,6,30,30
1650131451794,MATH 18,B04,083751,Staff,0,7,30,30
1650131457818,MATH 20A,A01,083754,Staff,26,0,40,14
1650131463852,MATH 20B,A01,083756,Staff,0,5,30,30
1650131463852,MATH 20B,A02,083757,Staff,0,3,30,30
1650131469881,MATH 20C,A01,083760,Staff,0,11,30,30
1650131469881,MATH 20C,A02,083761,Staff,0,12,30,30
1650131469881,MATH 20C,B01,083762,Staff,14,0,30,16
1650131469881,MATH 20C,B02,083763,Staff,28,0,30,2
1650131475904,MATH 20D,A01,083765,Staff,0,2,30,30
1650131475904,MATH 20D,A02,083766,Staff,12,0,30,18
1650131475904,MATH 20D,A03,083767,Staff,28,0,30,2
1650131481931,MATH 20E,A01,083771,Staff,10,0,30,20
1650131481931,MATH 20E,A02,083772,Staff,20,0,30,10
1650131481931,MATH 20E,B01,083773,Staff,0,0,30,30
1650131481931,MATH 20E,B02,083774,Staff,13,0,30,17
1650131487960,MATH 103A,A01,083777,Staff,0,8,30,30
1650131487960,MATH 103A,A02,083778,Staff,0,8,30,30
1650131487960,MATH 103A,B01,083779,Staff,0,9,30,30
1650131487960,MATH 103A,B02,083780,Staff,0,6,30,30
1650131493986,MATH 105,A01,085443,Staff,0,13,30,30
1650131500010,MATH 109,A01,083213,Anzaldo; Leesa B,0,3,30,30
1650131500010,MATH 109,A02,083214,Anzaldo; Leesa B,0,5,30,30
1650131500010,MATH 109,B01,083215,Anzaldo; Leesa B,0,4,30,30
1650131500010,MATH 109,B02,083216,Anzaldo; Leesa B,0,4,30,30
1650131506042,MATH 142A,A01,083219,Chow; Bennett,0,11,30,30
1650131506042,MATH 142A,A02,083220,Chow; Bennett,0,10,30,30
1650131506042,MATH 142A,B01,083221,Chow; Bennett,0,10,30,30
1650131506042,MATH 142A,B02,083222,Chow; Bennett,0,10,30,30
1650131512067,MATH 193A,A01,083224,Staff,0,3,30,30
1650131512067,MATH 193A,A02,083225,Staff,0,4,30,30
1650131512067,MATH 193A,A03,083781,Staff,0,0,30,30
1650131512067,MATH 193A,A04,083782,Staff,1,0,30,29
1650131518093,MATH 197,001,091859,McAuley; Julian John,9998,0,9999,1
1650131524153,COGS 9,A01,083615,Staff,0,14,60,60
1650131530177,COGS 11,A01,083617,Boyle; Mary E. T.,24,0,40,16
1650131536201,COGS 13,A01,083071,Staff,0,28,40,40
1650131542225,COGS 14A,A01,092681,Staff,0,10,100,100
1650131548252,COGS 14B,A01,083073,Cheng; Tzu-Han,0,4,50,50
1650131554276,COGS 17,A01,092677,Staff,34,0,75,41
1650131560393,COGS 100,A01,083619,Staff,0,21,60,60
1650131566423,COGS 101A,A01,083621,Davis; Joshua Daniel,0,18,60,60
1650131572445,COGS 101B,A01,091572,Staff,10,0,60,50
1650131578471,COGS 101C,A01,083625,Delgado; Tania,22,0,30,8
1650131584499,COGS 107A,A01,083627,Boyle; Mary E. T.,0,5,60,60
1650131590526,COGS 118A,A01,083075,Staff,17,0,60,43
1650131596554,CSE 3,A50,083646,Miranda; Gregory Joseph,22,0,38,16
1650131596554,CSE 3,A51,083647,Miranda; Gregory Joseph,37,0,37,0
1650131602576,CSE 8A,A50,083650,Miranda; Gregory Joseph,0,16,40,40
1650131608610,CSE 11,A01,083080,Cao; Yingjun,0,66,40,40
1650131614635,CSE 12,A01,083652,Staff,0,2,100,100
1650131620659,CSE 15L,A01,083654,Staff,0,0,50,50
1650131620659,CSE 15L,A02,083655,Staff,10,0,50,40
1650131626684,CSE 20,A01,083657,Staff,57,0,80,23
1650131632719,CSE 30,A01,083084,Eldon; John,0,63,40,40
1650131638746,CSE 100,A01,083659,Cao; Yingjun,0,61,50,50
1650131644770,CSE 134B,A01,083661,Powell; Thomas Allan,0,27,65,65
1650131650799,CSE 140,A01,083663,Staff,4,0,75,71
1650131656825,CSE 140L,A01,083088,Eldon; John,0,1,75,75
1650131662849,CSE 175,A01,083665,Kumar; Rakesh,8,0,25,17
1650131668875,CSE 190,A00,092507,Dubnov; Shlomo,14,0,20,6
1650131674899,ECE 45,A01,083139,Staff,0,13,40,40
1650131680923,ECE 65,A50,083695,Staff,0,4,30,30
1650131686947,ECE 109,A01,091882,Touri; Behrouz,48,0,70,22
1650131692971,ECE 180,A00,083140,Abi Samra; Nicholas Camill,24,0,30,6
1650131692971,ECE 180,B00,083141,Abi Samra; Nicholas Camill,8,0,30,22
1650131698998,MATH 10A,A01,083735,Patchell; Gregory David,12,0,30,18
1650131698998,MATH 10A,A02,083736,Patchell; Gregory David,28,0,30,2
1650131698998,MATH 10A,A03,083737,Patchell; Gregory David,26,0,30,4
1650131705023,MATH 10B,A01,083207,Staff,0,5,30,30
1650131705023,MATH 10B,A02,083208,Staff,0,4,30,30
1650131705023,MATH 10B,B01,083739,Staff,18,0,30,12
1650131705023,MATH 10B,B02,083740,Staff,29,0,30,1
1650131711053,MATH 18,A01,083743,Staff,10,0,30,20
1650131711053,MATH 18,A02,083744,Staff,28,0,30,2
1650131711053,MATH 18,A03,083745,Staff,23,0,30,7
1650131711053,MATH 18,A04,083746,Staff,27,0,30,3
1650131711053,MATH 18,B01,083748,Staff,0,9,30,30
1650131711053,MATH 18,B02,083749,Staff,0,7,30,30
1650131711053,MATH 18,B03,083750,Staff,0,6,30,30
1650131711053,MATH 18,B04,083751,Staff,0,7,30,30
1650131717081,MATH 20A,A01,083754,Staff,26,0,40,14
1650131723105,MATH 20B,A01,083756,Staff,0,5,30,30
1650131723105,MATH 20B,A02,083757,Staff,0,3,30,30
1650131729130,MATH 20C,A01,083760,Staff,0,11,30,30
1650131729130,MATH 20C,A02,083761,Staff,0,12,30,30
1650131729130,MATH 20C,B01,083762,Staff,14,0,30,16
1650131729130,MATH 20C,B02,083763,Staff,28,0,30,2
1650131735152,MATH 20D,A01,083765,Staff,0,2,30,30
1650131735152,MATH 20D,A02,083766,Staff,12,0,30,18
1650131735152,MATH 20D,A03,083767,Staff,28,0,30,2
1650131741175,MATH 20E,A01,083771,Staff,10,0,30,20
1650131741175,MATH 20E,A02,083772,Staff,20,0,30,10
1650131741175,MATH 20E,B01,083773,Staff,0,0,30,30
1650131741175,MATH 20E,B02,083774,Staff,13,0,30,17
1650131747202,MATH 103A,A01,083777,Staff,0,8,30,30
1650131747202,MATH 103A,A02,083778,Staff,0,8,30,30
1650131747202,MATH 103A,B01,083779,Staff,0,9,30,30
1650131747202,MATH 103A,B02,083780,Staff,0,6,30,30
1650131753227,MATH 105,A01,085443,Staff,0,13,30,30
1650131759249,MATH 109,A01,083213,Anzaldo; Leesa B,0,3,30,30
1650131759249,MATH 109,A02,083214,Anzaldo; Leesa B,0,5,30,30
1650131759249,MATH 109,B01,083215,Anzaldo; Leesa B,0,4,30,30
1650131759249,MATH 109,B02,083216,Anzaldo; Leesa B,0,4,30,30
1650131765271,MATH 142A,A01,083219,Chow; Bennett,0,11,30,30
1650131765271,MATH 142A,A02,083220,Chow; Bennett,0,10,30,30
1650131765271,MATH 142A,B01,083221,Chow; Bennett,0,10,30,30
1650131765271,MATH 142A,B02,083222,Chow; Bennett,0,10,30,30
1650131771293,MATH 193A,A01,083224,Staff,0,3,30,30
1650131771293,MATH 193A,A02,083225,Staff,0,4,30,30
1650131771293,MATH 193A,A03,083781,Staff,0,0,30,30
1650131771293,MATH 193A,A04,083782,Staff,1,0,30,29
1650131777317,MATH 197,001,091859,McAuley; Julian John,9998,0,9999,1
1650131783379,COGS 9,A01,083615,Staff,0,14,60,60
1650131789406,COGS 11,A01,083617,Boyle; Mary E. T.,24,0,40,16
1650131795433,COGS 13,A01,083071,Staff,0,28,40,40
1650131801465,COGS 14A,A01,092681,Staff,0,10,100,100
1650131807491,COGS 14B,A01,083073,Cheng; Tzu-Han,0,4,50,50
1650131813521,COGS 17,A01,092677,Staff,34,0,75,41
1650131819553,COGS 100,A01,083619,Staff,0,21,60,60
1650131825581,COGS 101A,A01,083621,Davis; Joshua Daniel,0,18,60,60
1650131831614,COGS 101B,A01,091572,Staff,10,0,60,50
1650131837641,COGS 101C,A01,083625,Delgado; Tania,22,0,30,8
1650131843684,COGS 107A,A01,083627,Boyle; Mary E. T.,0,5,60,60
1650131849710,COGS 118A,A01,083075,Staff,17,0,60,43
1650131855732,CSE 3,A50,083646,Miranda; Gregory Joseph,22,0,38,16
1650131855732,CSE 3,A51,083647,Miranda; Gregory Joseph,37,0,37,0
1650131861761,CSE 8A,A50,083650,Miranda; Gregory Joseph,0,16,40,40
1650131867784,CSE 11,A01,083080,Cao; Yingjun,0,66,40,40
1650131873818,CSE 12,A01,083652,Staff,0,2,100,100
1650131879845,CSE 15L,A01,083654,Staff,0,0,50,50
1650131879845,CSE 15L,A02,083655,Staff,10,0,50,40
1650131885880,CSE 20,A01,083657,Staff,57,0,80,23
1650131891909,CSE 30,A01,083084,Eldon; John,0,63,40,40
1650131897933,CSE 100,A01,083659,Cao; Yingjun,0,61,50,50
1650131903961,CSE 134B,A01,083661,Powell; Thomas Allan,0,27,65,65
1650131909990,CSE 140,A01,083663,Staff,4,0,75,71
1650131916024,CSE 140L,A01,083088,Eldon; John,0,1,75,75
1650131922049,CSE 175,A01,083665,Kumar; Rakesh,8,0,25,17
1650131928078,CSE 190,A00,092507,Dubnov; Shlomo,14,0,20,6
1650131934105,ECE 45,A01,083139,Staff,0,13,40,40
1650131940133,ECE 65,A50,083695,Staff,0,4,30,30
1650131946158,ECE 109,A01,091882,Touri; Behrouz,48,0,70,22
1650131952191,ECE 180,A00,083140,Abi Samra; Nicholas Camill,24,0,30,6
1650131952191,ECE 180,B00,083141,Abi Samra; Nicholas Camill,8,0,30,22
1650131958215,MATH 10A,A01,083735,Patchell; Gregory David,12,0,30,18
1650131958215,MATH 10A,A02,083736,Patchell; Gregory David,28,0,30,2
1650131958215,MATH 10A,A03,083737,Patchell; Gregory David,26,0,30,4
1650131964239,MATH 10B,A01,083207,Staff,0,5,30,30
1650131964239,MATH 10B,A02,083208,Staff,0,4,30,30
1650131964239,MATH 10B,B01,083739,Staff,18,0,30,12
1650131964239,MATH 10B,B02,083740,Staff,29,0,30,1
1650131970272,MATH 18,A01,083743,Staff,10,0,30,20
1650131970272,MATH 18,A02,083744,Staff,28,0,30,2
1650131970272,MATH 18,A03,083745,Staff,23,0,30,7
1650131970272,MATH 18,A04,083746,Staff,27,0,30,3
1650131970272,MATH 18,B01,083748,Staff,0,9,30,30
1650131970272,MATH 18,B02,083749,Staff,0,7,30,30
1650131970272,MATH 18,B03,083750,Staff,0,6,30,30
1650131970272,MATH 18,B04,083751,Staff,0,7,30,30
1650131976295,MATH 20A,A01,083754,Staff,26,0,40,14
1650131982319,MATH 20B,A01,083756,Staff,0,5,30,30
1650131982319,MATH 20B,A02,083757,Staff,0,3,30,30
1650131988344,MATH 20C,A01,083760,Staff,0,11,30,30
1650131988344,MATH 20C,A02,083761,Staff,0,12,30,30
1650131988344,MATH 20C,B01,083762,Staff,14,0,30,16
1650131988344,MATH 20C,B02,083763,Staff,28,0,30,2
1650131994372,MATH 20D,A01,083765,Staff,0,2,30,30
1650131994372,MATH 20D,A02,083766,Staff,12,0,30,18
1650131994372,MATH 20D,A03,083767,Staff,28,0,30,2
1650132000401,MATH 20E,A01,083771,Staff,10,0,30,20
1650132000401,MATH 20E,A02,083772,Staff,20,0,30,10
1650132000401,MATH 20E,B01,083773,Staff,0,0,30,30
1650132000401,MATH 20E,B02,083774,Staff,13,0,30,17
1650132006430,MATH 103A,A01,083777,Staff,0,8,30,30
1650132006430,MATH 103A,A02,083778,Staff,0,8,30,30
1650132006430,MATH 103A,B01,083779,Staff,0,9,30,30
1650132006430,MATH 103A,B02,083780,Staff,0,6,30,30
1650132012459,MATH 105,A01,085443,Staff,0,13,30,30
1650132018488,MATH 109,A01,083213,Anzaldo; Leesa B,0,3,30,30
1650132018488,MATH 109,A02,083214,Anzaldo; Leesa B,0,5,30,30
1650132018488,MATH 109,B01,083215,Anzaldo; Leesa B,0,4,30,30
1650132018488,MATH 109,B02,083216,Anzaldo; Leesa B,0,4,30,30
1650132024511,MATH 142A,A01,083219,Chow; Bennett,0,11,30,30
1650132024511,MATH 142A,A02,083220,Chow; Bennett,0,10,30,30
1650132024511,MATH 142A,B01,083221,Chow; Bennett,0,10,30,30
1650132024511,MATH 142A,B02,083222,Chow; Bennett,0,10,30,30
1650132030550,MATH 193A,A01,083224,Staff,0,3,30,30
1650132030550,MATH 193A,A02,083225,Staff,0,4,30,30
1650132030550,MATH 193A,A03,083781,Staff,0,0,30,30
1650132030550,MATH 193A,A04,083782,Staff,1,0,30,29
1650132036574,MATH 197,001,091859,McAuley; Julian John,9998,0,9999,1
1650132042627,COGS 9,A01,083615,Staff,0,14,60,60
1650132048661,COGS 11,A01,083617,Boyle; Mary E. T.,24,0,40,16
1650132054727,COGS 13,A01,083071,Staff,0,28,40,40
1650132060754,COGS 14A,A01,092681,Staff,0,10,100,100
1650132066778,COGS 14B,A01,083073,Cheng; Tzu-Han,0,4,50,50
1650132072807,COGS 17,A01,092677,Staff,34,0,75,41
1650132078829,COGS 100,A01,083619,Staff,0,21,60,60
1650132084853,COGS 101A,A01,083621,Davis; Joshua Daniel,0,18,60,60
1650132090880,COGS 101B,A01,091572,Staff,10,0,60,50
1650132096905,COGS 101C,A01,083625,Delgado; Tania,22,0,30,8
1650132102932,COGS 107A,A01,083627,Boyle; Mary E. T.,0,5,60,60
1650132108956,COGS 118A,A01,083075,Staff,17,0,60,43
1650132114985,CSE 3,A50,083646,Miranda; Gregory Joseph,22,0,38,16
1650132114985,CSE 3,A51,083647,Miranda; Gregory Joseph,37,0,37,0
1650132121012,CSE 8A,A50,083650,Miranda; Gregory Joseph,0,16,40,40
1650132127039,CSE 11,A01,083080,Cao; Yingjun,0,66,40,40
1650132133064,CSE 12,A01,083652,Staff,0,2,100,100
1650132139087,CSE 15L,A01,083654,Staff,0,0,50,50
1650132139087,CSE 15L,A02,083655,Staff,10,0,50,40
1650132145115,CSE 20,A01,083657,Staff,57,0,80,23
1650132151146,CSE 30,A01,083084,Eldon; John,0,63,40,40
1650132157243,CSE 100,A01,083659,Cao; Yingjun,0,61,50,50
1650132163280,CSE 134B,A01,083661,Powell; Thomas Allan,0,27,65,65
1650132169303,CSE 140,A01,083663,Staff,4,0,75,71
1650132175327,CSE 140L,A01,083088,Eldon; John,0,1,75,75
1650132181350,CSE 175,A01,083665,Kumar; Rakesh,8,0,25,17
1650132187373,CSE 190,A00,092507,Dubnov; Shlomo,14,0,20,6
1650132193404,ECE 45,A01,083139,Staff,0,13,40,40
1650132199432,ECE 65,A50,083695,Staff,0,4,30,30
1650132205454,ECE 109,A01,091882,Touri; Behrouz,48,0,70,22
1650132211477,ECE 180,A00,083140,Abi Samra; Nicholas Camill,24,0,30,6
1650132211477,ECE 180,B00,083141,Abi Samra; Nicholas Camill,8,0,30,22
1650132217504,MATH 10A,A01,083735,Patchell; Gregory David,12,0,30,18
1650132217504,MATH 10A,A02,083736,Patchell; Gregory David,28,0,30,2
1650132217504,MATH 10A,A03,083737,Patchell; Gregory David,26,0,30,4
1650132223529,MATH 10B,A01,083207,Staff,0,5,30,30
1650132223529,MATH 10B,A02,083208,Staff,0,4,30,30
1650132223529,MATH 10B,B01,083739,Staff,18,0,30,12
1650132223529,MATH 10B,B02,083740,Staff,29,0,30,1
1650132229560,MATH 18,A01,083743,Staff,10,0,30,20
1650132229560,MATH 18,A02,083744,Staff,28,0,30,2
1650132229560,MATH 18,A03,083745,Staff,23,0,30,7
1650132229560,MATH 18,A04,083746,Staff,27,0,30,3
1650132229560,MATH 18,B01,083748,Staff,0,9,30,30
1650132229560,MATH 18,B02,083749,Staff,0,7,30,30
1650132229560,MATH 18,B03,083750,Staff,0,6,30,30
1650132229560,MATH 18,B04,083751,Staff,0,7,30,30
1650132235590,MATH 20A,A01,083754,Staff,26,0,40,14
1650132241614,MATH 20B,A01,083756,Staff,0,5,30,30
1650132241614,MATH 20B,A02,083757,Staff,0,3,30,30
1650132247646,MATH 20C,A01,083760,Staff,0,11,30,30
1650132247646,MATH 20C,A02,083761,Staff,0,12,30,30
1650132247646,MATH 20C,B01,083762,Staff,14,0,30,16
1650132247646,MATH 20C,B02,083763,Staff,28,0,30,2
1650132253670,MATH 20D,A01,083765,Staff,0,2,30,30
1650132253670,MATH 20D,A02,083766,Staff,12,0,30,18
1650132253670,MATH 20D,A03,083767,Staff,28,0,30,2
1650132259694,MATH 20E,A01,083771,Staff,10,0,30,20
1650132259694,MATH 20E,A02,083772,Staff,20,0,30,10
1650132259694,MATH 20E,B01,083773,Staff,0,0,30,30
1650132259694,MATH 20E,B02,083774,Staff,13,0,30,17
1650132265726,MATH 103A,A01,083777,Staff,0,8,30,30
1650132265726,MATH 103A,A02,083778,Staff,0,8,30,30
1650132265726,MATH 103A,B01,083779,Staff,0,9,30,30
1650132265726,MATH 103A,B02,083780,Staff,0,6,30,30
1650132271749,MATH 105,A01,085443,Staff,0,13,30,30
1650132277776,MATH 109,A01,083213,Anzaldo; Leesa B,0,3,30,30
1650132277776,MATH 109,A02,083214,Anzaldo; Leesa B,0,5,30,30
1650132277776,MATH 109,B01,083215,Anzaldo; Leesa B,0,4,30,30
1650132277776,MATH 109,B02,083216,Anzaldo; Leesa B,0,4,30,30
1650132283800,MATH 142A,A01,083219,Chow; Bennett,0,11,30,30
1650132283800,MATH 142A,A02,083220,Chow; Bennett,0,10,30,30
1650132283800,MATH 142A,B01,083221,Chow; Bennett,0,10,30,30
1650132283800,MATH 142A,B02,083222,Chow; Bennett,0,10,30,30
1650132289829,MATH 193A,A01,083224,Staff,0,3,30,30
1650132289829,MATH 193A,A02,083225,Staff,0,4,30,30
1650132289829,MATH 193A,A03,083781,Staff,0,0,30,30
1650132289829,MATH 193A,A04,083782,Staff,1,0,30,29
1650132295852,MATH 197,001,091859,McAuley; Julian John,9998,0,9999,1
1650132301924,COGS 9,A01,083615,Staff,0,14,60,60
1650132307949,COGS 11,A01,083617,Boyle; Mary E. T.,24,0,40,16
1650132313976,COGS 13,A01,083071,Staff,0,28,40,40
1650132320004,COGS 14A,A01,092681,Staff,0,10,100,100
1650132326031,COGS 14B,A01,083073,Cheng; Tzu-Han,0,4,50,50
1650132332060,COGS 17,A01,092677,Staff,34,0,75,41
1650132338083,COGS 100,A01,083619,Staff,0,21,60,60
1650132344109,COGS 101A,A01,083621,Davis; Joshua Daniel,0,18,60,60
1650132350139,COGS 101B,A01,091572,Staff,10,0,60,50
1650132356164,COGS 101C,A01,083625,Delgado; Tania,22,0,30,8
1650132362186,COGS 107A,A01,083627,Boyle; Mary E. T.,0,5,60,60
1650132368214,COGS 118A,A01,083075,Staff,17,0,60,43
1650132374239,CSE 3,A50,083646,Miranda; Gregory Joseph,22,0,38,16
1650132374239,CSE 3,A51,083647,Miranda; Gregory Joseph,37,0,37,0
1650132380265,CSE 8A,A50,083650,Miranda; Gregory Joseph,0,16,40,40
1650132386290,CSE 11,A01,083080,Cao; Yingjun,0,66,40,40
1650132392314,CSE 12,A01,083652,Staff,0,2,100,100
1650132398337,CSE 15L,A01,083654,Staff,0,0,50,50
1650132398337,CSE 15L,A02,083655,Staff,10,0,50,40
1650132404366,CSE 20,A01,083657,Staff,56,0,80,24
1650132410392,CSE 30,A01,083084,Eldon; John,0,63,40,40
1650132416416,CSE 100,A01,083659,Cao; Yingjun,0,61,50,50
1650132422444,CSE 134B,A01,083661,Powell; Thomas Allan,0,27,65,65
1650132428470,CSE 140,A01,083663,Staff,4,0,75,71
1650132434494,CSE 140L,A01,083088,Eldon; John,0,1,75,75
1650132440518,CSE 175,A01,083665,Kumar; Rakesh,8,0,25,17
1650132446543,CSE 190,A00,092507,Dubnov; Shlomo,14,0,20,6
1650132452574,ECE 45,A01,083139,Staff,0,13,40,40
1650132458600,ECE 65,A50,083695,Staff,0,4,30,30
1650132464624,ECE 109,A01,091882,Touri; Behrouz,48,0,70,22
1650132470647,ECE 180,A00,083140,Abi Samra; Nicholas Camill,24,0,30,6
1650132470647,ECE 180,B00,083141,Abi Samra; Nicholas Camill,8,0,30,22
1650132476677,MATH 10A,A01,083735,Patchell; Gregory David,12,0,30,18
1650132476677,MATH 10A,A02,083736,Patchell; Gregory David,28,0,30,2
1650132476677,MATH 10A,A03,083737,Patchell; Gregory David,26,0,30,4
1650132482704,MATH 10B,A01,083207,Staff,0,5,30,30
1650132482704,MATH 10B,A02,083208,Staff,0,4,30,30
1650132482704,MATH 10B,B01,083739,Staff,18,0,30,12
1650132482704,MATH 10B,B02,083740,Staff,29,0,30,1
1650132488732,MATH 18,A01,083743,Staff,10,0,30,20
1650132488732,MATH 18,A02,083744,Staff,28,0,30,2
1650132488732,MATH 18,A03,083745,Staff,23,0,30,7
1650132488732,MATH 18,A04,083746,Staff,27,0,30,3
1650132488732,MATH 18,B01,083748,Staff,0,9,30,30
1650132488732,MATH 18,B02,083749,Staff,0,7,30,30
1650132488732,MATH 18,B03,083750,Staff,0,6,30,30
1650132488732,MATH 18,B04,083751,Staff,0,7,30,30
1650132494769,MATH 20A,A01,083754,Staff,26,0,40,14
1650132500793,MATH 20B,A01,083756,Staff,0,5,30,30
1650132500793,MATH 20B,A02,083757,Staff,0,3,30,30
1650132506820,MATH 20C,A01,083760,Staff,0,11,30,30
1650132506820,MATH 20C,A02,083761,Staff,0,12,30,30
1650132506820,MATH 20C,B01,083762,Staff,14,0,30,16
1650132506820,MATH 20C,B02,083763,Staff,28,0,30,2
1650132512844,MATH 20D,A01,083765,Staff,0,2,30,30
1650132512844,MATH 20D,A02,083766,Staff,12,0,30,18
1650132512844,MATH 20D,A03,083767,Staff,28,0,30,2
1650132518869,MATH 20E,A01,083771,Staff,10,0,30,20
1650132518869,MATH 20E,A02,083772,Staff,20,0,30,10
1650132518869,MATH 20E,B01,083773,Staff,0,0,30,30
1650132518869,MATH 20E,B02,083774,Staff,13,0,30,17
1650132524893,MATH 103A,A01,083777,Staff,0,8,30,30
1650132524893,MATH 103A,A02,083778,Staff,0,8,30,30
1650132524893,MATH 103A,B01,083779,Staff,0,9,30,30
1650132524893,MATH 103A,B02,083780,Staff,0,6,30,30
1650132530921,MATH 105,A01,085443,Staff,0,13,30,30
1650132536945,MATH 109,A01,083213,Anzaldo; Leesa B,0,3,30,30
1650132536945,MATH 109,A02,083214,Anzaldo; Leesa B,0,5,30,30
1650132536945,MATH 109,B01,083215,Anzaldo; Leesa B,0,4,30,30
1650132536945,MATH 109,B02,083216,Anzaldo; Leesa B,0,4,30,30
1650132542971,MATH 142A,A01,083219,Chow; Bennett,0,11,30,30
1650132542971,MATH 142A,A02,083220,Chow; Bennett,0,10,30,30
1650132542971,MATH 142A,B01,083221,Chow; Bennett,0,10,30,30
1650132542971,MATH 142A,B02,083222,Chow; Bennett,0,10,30,30
1650132548994,MATH 193A,A01,083224,Staff,0,3,30,30
1650132548994,MATH 193A,A02,083225,Staff,0,4,30,30
1650132548994,MATH 193A,A03,083781,Staff,0,0,30,30
1650132548994,MATH 193A,A04,083782,Staff,1,0,30,29
1650132555039,MATH 197,001,091859,McAuley; Julian John,9998,0,9999,1
1650132561104,COGS 9,A01,083615,Staff,0,14,60,60
1650132567128,COGS 11,A01,083617,Boyle; Mary E. T.,24,0,40,16
1650132573152,COGS 13,A01,083071,Staff,0,28,40,40
1650132579177,COGS 14A,A01,092681,Staff,0,10,100,100
1650132585201,COGS 14B,A01,083073,Cheng; Tzu-Han,0,4,50,50
1650132591228,COGS 17,A01,092677,Staff,34,0,75,41
1650132597254,COGS 100,A01,083619,Staff,0,21,60,60
1650132603278,COGS 101A,A01,083621,Davis; Joshua Daniel,0,18,60,60
1650132609311,COGS 101B,A01,091572,Staff,10,0,60,50
1650132615334,COGS 101C,A01,083625,Delgado; Tania,22,0,30,8
1650132621358,COGS 107A,A01,083627,Boyle; Mary E. T.,0,5,60,60
1650132627383,COGS 118A,A01,083075,Staff,17,0,60,43
1650132633410,CSE 3,A50,083646,Miranda; Gregory Joseph,22,0,38,16
1650132633410,CSE 3,A51,083647,Miranda; Gregory Joseph,37,0,37,0
1650132639436,CSE 8A,A50,083650,Miranda; Gregory Joseph,0,16,40,40
1650132645464,CSE 11,A01,083080,Cao; Yingjun,0,66,40,40
1650132651489,CSE 12,A01,083652,Staff,0,2,100,100
1650132657517,CSE 15L,A01,083654,Staff,0,0,50,50
1650132657517,CSE 15L,A02,083655,Staff,10,0,50,40
1650132663540,CSE 20,A01,083657,Staff,56,0,80,24
1650132669565,CSE 30,A01,083084,Eldon; John,0,63,40,40
1650132675588,CSE 100,A01,083659,Cao; Yingjun,0,61,50,50
1650132681617,CSE 134B,A01,083661,Powell; Thomas Allan,0,27,65,65
1650132687642,CSE 140,A01,083663,Staff,4,0,75,71
1650132693666,CSE 140L,A01,083088,Eldon; John,0,1,75,75
1650132699690,CSE 175,A01,083665,Kumar; Rakesh,8,0,25,17
1650132705717,CSE 190,A00,092507,Dubnov; Shlomo,14,0,20,6
1650132711743,ECE 45,A01,083139,Staff,0,13,40,40
1650132717771,ECE 65,A50,083695,Staff,0,4,30,30
1650132723793,ECE 109,A01,091882,Touri; Behrouz,48,0,70,22
1650132729817,ECE 180,A00,083140,Abi Samra; Nicholas Camill,24,0,30,6
1650132729817,ECE 180,B00,083141,Abi Samra; Nicholas Camill,8,0,30,22
1650132735842,MATH 10A,A01,083735,Patchell; Gregory David,12,0,30,18
1650132735842,MATH 10A,A02,083736,Patchell; Gregory David,28,0,30,2
1650132735842,MATH 10A,A03,083737,Patchell; Gregory David,26,0,30,4
1650132741875,MATH 10B,A01,083207,Staff,0,5,30,30
1650132741875,MATH 10B,A02,083208,Staff,0,4,30,30
1650132741875,MATH 10B,B01,083739,Staff,18,0,30,12
1650132741875,MATH 10B,B02,083740,Staff,29,0,30,1
1650132747901,MATH 18,A01,083743,Staff,10,0,30,20
1650132747901,MATH 18,A02,083744,Staff,28,0,30,2
1650132747901,MATH 18,A03,083745,Staff,23,0,30,7
1650132747901,MATH 18,A04,083746,Staff,27,0,30,3
1650132747901,MATH 18,B01,083748,Staff,0,9,30,30
1650132747901,MATH 18,B02,083749,Staff,0,7,30,30
1650132747901,MATH 18,B03,083750,Staff,0,6,30,30
1650132747901,MATH 18,B04,083751,Staff,0,7,30,30
1650132754035,MATH 20A,A01,083754,Staff,26,0,40,14
1650132760060,MATH 20B,A01,083756,Staff,0,5,30,30
1650132760060,MATH 20B,A02,083757,Staff,0,3,30,30
1650132766084,MATH 20C,A01,083760,Staff,0,11,30,30
1650132766084,MATH 20C,A02,083761,Staff,0,12,30,30
1650132766084,MATH 20C,B01,083762,Staff,14,0,30,16
1650132766084,MATH 20C,B02,083763,Staff,28,0,30,2
1650132772110,MATH 20D,A01,083765,Staff,0,2,30,30
1650132772110,MATH 20D,A02,083766,Staff,12,0,30,18
1650132772110,MATH 20D,A03,083767,Staff,28,0,30,2
1650132778138,MATH 20E,A01,083771,Staff,9,0,30,21
1650132778138,MATH 20E,A02,083772,Staff,20,0,30,10
1650132778138,MATH 20E,B01,083773,Staff,0,0,30,30
1650132778138,MATH 20E,B02,083774,Staff,13,0,30,17
1650132784161,MATH 103A,A01,083777,Staff,0,8,30,30
1650132784161,MATH 103A,A02,083778,Staff,0,8,30,30
1650132784161,MATH 103A,B01,083779,Staff,0,9,30,30
1650132784161,MATH 103A,B02,083780,Staff,0,6,30,30
1650132790185,MATH 105,A01,085443,Staff,0,13,30,30
1650132796221,MATH 109,A01,083213,Anzaldo; Leesa B,0,3,30,30
1650132796221,MATH 109,A02,083214,Anzaldo; Leesa B,0,5,30,30
1650132796221,MATH 109,B01,083215,Anzaldo; Leesa B,0,4,30,30
1650132796221,MATH 109,B02,083216,Anzaldo; Leesa B,0,4,30,30
1650132802245,MATH 142A,A01,083219,Chow; Bennett,0,11,30,30
1650132802245,MATH 142A,A02,083220,Chow; Bennett,0,10,30,30
1650132802245,MATH 142A,B01,083221,Chow; Bennett,0,10,30,30
1650132802245,MATH 142A,B02,083222,Chow; Bennett,0,10,30,30
1650132808269,MATH 193A,A01,083224,Staff,0,3,30,30
1650132808269,MATH 193A,A02,083225,Staff,0,4,30,30
1650132808269,MATH 193A,A03,083781,Staff,0,0,30,30
1650132808269,MATH 193A,A04,083782,Staff,1,0,30,29
1650132814293,MATH 197,001,091859,McAuley; Julian John,9998,0,9999,1
1650132820354,COGS 9,A01,083615,Staff,0,14,60,60
1650132826380,COGS 11,A01,083617,Boyle; Mary E. T.,24,0,40,16
1650132832410,COGS 13,A01,083071,Staff,0,28,40,40
1650132838432,COGS 14A,A01,092681,Staff,0,10,100,100
1650132844459,COGS 14B,A01,083073,Cheng; Tzu-Han,0,4,50,50
1650132850483,COGS 17,A01,092677,Staff,34,0,75,41
1650132856510,COGS 100,A01,083619,Staff,0,21,60,60
1650132862535,COGS 101A,A01,083621,Davis; Joshua Daniel,0,18,60,60
1650132868561,COGS 101B,A01,091572,Staff,10,0,60,50
1650132874584,COGS 101C,A01,083625,Delgado; Tania,22,0,30,8
1650132880608,COGS 107A,A01,083627,Boyle; Mary E. T.,0,5,60,60
1650132886632,COGS 118A,A01,083075,Staff,17,0,60,43
1650132892657,CSE 3,A50,083646,Miranda; Gregory Joseph,22,0,38,16
1650132892657,CSE 3,A51,083647,Miranda; Gregory Joseph,37,0,37,0
1650132898680,CSE 8A,A50,083650,Miranda; Gregory Joseph,0,16,40,40
1650132904705,CSE 11,A01,083080,Cao; Yingjun,0,66,40,40
1650132910732,CSE 12,A01,083652,Staff,0,2,100,100
1650132916767,CSE 15L,A01,083654,Staff,0,0,50,50
1650132916767,CSE 15L,A02,083655,Staff,10,0,50,40
1650132922792,CSE 20,A01,083657,Staff,56,0,80,24
1650132928817,CSE 30,A01,083084,Eldon; John,0,63,40,40
1650132934849,CSE 100,A01,083659,Cao; Yingjun,0,61,50,50
1650132940872,CSE 134B,A01,083661,Powell; Thomas Allan,0,27,65,65
1650132946899,CSE 140,A01,083663,Staff,4,0,75,71
1650132952927,CSE 140L,A01,083088,Eldon; John,0,1,75,75
1650132958951,CSE 175,A01,083665,Kumar; Rakesh,8,0,25,17
1650132964975,CSE 190,A00,092507,Dubnov; Shlomo,14,0,20,6
1650132971001,ECE 45,A01,083139,Staff,0,13,40,40
1650132977034,ECE 65,A50,083695,Staff,0,4,30,30
1650132983061,ECE 109,A01,091882,Touri; Behrouz,48,0,70,22
1650132989089,ECE 180,A00,083140,Abi Samra; Nicholas Camill,24,0,30,6
1650132989089,ECE 180,B00,083141,Abi Samra; Nicholas Camill,8,0,30,22
1650132995117,MATH 10A,A01,083735,Patchell; Gregory David,12,0,30,18
1650132995117,MATH 10A,A02,083736,Patchell; Gregory David,28,0,30,2
1650132995117,MATH 10A,A03,083737,Patchell; Gregory David,26,0,30,4
1650133001147,MATH 10B,A01,083207,Staff,0,5,30,30
1650133001147,MATH 10B,A02,083208,Staff,0,4,30,30
1650133001147,MATH 10B,B01,083739,Staff,18,0,30,12
1650133001147,MATH 10B,B02,083740,Staff,29,0,30,1
1650133007174,MATH 18,A01,083743,Staff,10,0,30,20
1650133007174,MATH 18,A02,083744,Staff,28,0,30,2
1650133007174,MATH 18,A03,083745,Staff,23,0,30,7
1650133007174,MATH 18,A04,083746,Staff,27,0,30,3
1650133007174,MATH 18,B01,083748,Staff,0,9,30,30
1650133007174,MATH 18,B02,083749,Staff,0,7,30,30
1650133007174,MATH 18,B03,083750,Staff,0,6,30,30
1650133007174,MATH 18,B04,083751,Staff,0,7,30,30
1650133013202,MATH 20A,A01,083754,Staff,26,0,40,14
1650133019227,MATH 20B,A01,083756,Staff,0,5,30,30
1650133019227,MATH 20B,A02,083757,Staff,0,3,30,30
1650133025253,MATH 20C,A01,083760,Staff,0,11,30,30
1650133025253,MATH 20C,A02,083761,Staff,0,12,30,30
1650133025253,MATH 20C,B01,083762,Staff,14,0,30,16
1650133025253,MATH 20C,B02,083763,Staff,28,0,30,2
1650133031276,MATH 20D,A01,083765,Staff,0,2,30,30
1650133031276,MATH 20D,A02,083766,Staff,12,0,30,18
1650133031276,MATH 20D,A03,083767,Staff,28,0,30,2
1650133037300,MATH 20E,A01,083771,Staff,9,0,30,21
1650133037300,MATH 20E,A02,083772,Staff,20,0,30,10
1650133037300,MATH 20E,B01,083773,Staff,0,0,30,30
1650133037300,MATH 20E,B02,083774,Staff,13,0,30,17
1650133043338,MATH 103A,A01,083777,Staff,0,8,30,30
1650133043338,MATH 103A,A02,083778,Staff,0,8,30,30
1650133043338,MATH 103A,B01,083779,Staff,0,9,30,30
1650133043338,MATH 103A,B02,083780,Staff,0,6,30,30
1650133049359,MATH 105,A01,085443,Staff,0,13,30,30
1650133055387,MATH 109,A01,083213,Anzaldo; Leesa B,0,3,30,30
1650133055387,MATH 109,A02,083214,Anzaldo; Leesa B,0,5,30,30
1650133055387,MATH 109,B01,083215,Anzaldo; Leesa B,0,4,30,30
1650133055387,MATH 109,B02,083216,Anzaldo; Leesa B,0,4,30,30
1650133061412,MATH 142A,A01,083219,Chow; Bennett,0,11,30,30
1650133061412,MATH 142A,A02,083220,Chow; Bennett,0,10,30,30
1650133061412,MATH 142A,B01,083221,Chow; Bennett,0,10,30,30
1650133061412,MATH 142A,B02,083222,Chow; Bennett,0,10,30,30
1650133067436,MATH 193A,A01,083224,Staff,0,3,30,30
1650133067436,MATH 193A,A02,083225,Staff,0,4,30,30
1650133067436,MATH 193A,A03,083781,Staff,0,0,30,30
1650133067436,MATH 193A,A04,083782,Staff,1,0,30,29
1650133073459,MATH 197,001,091859,McAuley; Julian John,9998,0,9999,1
1650133079510,COGS 9,A01,083615,Staff,0,14,60,60
1650133085532,COGS 11,A01,083617,Boyle; Mary E. T.,24,0,40,16
1650133091559,COGS 13,A01,083071,Staff,0,28,40,40
1650133097582,COGS 14A,A01,092681,Staff,0,10,100,100
1650133103610,COGS 14B,A01,083073,Cheng; Tzu-Han,0,4,50,50
1650133109634,COGS 17,A01,092677,Staff,34,0,75,41
1650133115658,COGS 100,A01,083619,Staff,0,21,60,60
1650133121686,COGS 101A,A01,083621,Davis; Joshua Daniel,0,18,60,60
1650133127711,COGS 101B,A01,091572,Staff,10,0,60,50
1650133133736,COGS 101C,A01,083625,Delgado; Tania,22,0,30,8
1650133139761,COGS 107A,A01,083627,Boyle; Mary E. T.,0,5,60,60
1650133145786,COGS 118A,A01,083075,Staff,17,0,60,43
1650133151809,CSE 3,A50,083646,Miranda; Gregory Joseph,22,0,38,16
1650133151809,CSE 3,A51,083647,Miranda; Gregory Joseph,37,0,37,0
1650133157838,CSE 8A,A50,083650,Miranda; Gregory Joseph,0,16,40,40
1650133163866,CSE 11,A01,083080,Cao; Yingjun,0,66,40,40
1650133169896,CSE 12,A01,083652,Staff,0,2,100,100
1650133175920,CSE 15L,A01,083654,Staff,0,0,50,50
1650133175920,CSE 15L,A02,083655,Staff,10,0,50,40
1650133181945,CSE 20,A01,083657,Staff,56,0,80,24
1650133187973,CSE 30,A01,083084,Eldon; John,0,63,40,40
1650133194004,CSE 100,A01,083659,Cao; Yingjun,0,61,50,50
1650133200029,CSE 134B,A01,083661,Powell; Thomas Allan,0,27,65,65
1650133206053,CSE 140,A01,083663,Staff,4,0,75,71
1650133212078,CSE 140L,A01,083088,Eldon; John,0,1,75,75
1650133218105,CSE 175,A01,083665,Kumar; Rakesh,8,0,25,17
1650133224130,CSE 190,A00,092507,Dubnov; Shlomo,14,0,20,6
1650133230154,ECE 45,A01,083139,Staff,0,13,40,40
1650133236179,ECE 65,A50,083695,Staff,0,4,30,30
1650133242218,ECE 109,A01,091882,Touri; Behrouz,48,0,70,22
1650133248241,ECE 180,A00,083140,Abi Samra; Nicholas Camill,24,0,30,6
1650133248241,ECE 180,B00,083141,Abi Samra; Nicholas Camill,8,0,30,22
1650133254266,MATH 10A,A01,083735,Patchell; Gregory David,12,0,30,18
1650133254266,MATH 10A,A02,083736,Patchell; Gregory David,28,0,30,2
1650133254266,MATH 10A,A03,083737,Patchell; Gregory David,26,0,30,4
1650133260299,MATH 10B,A01,083207,Staff,0,5,30,30
1650133260299,MATH 10B,A02,083208,Staff,0,4,30,30
1650133260299,MATH 10B,B01,083739,Staff,18,0,30,12
1650133260299,MATH 10B,B02,083740,Staff,29,0,30,1
1650133266336,MATH 18,A01,083743,Staff,10,0,30,20
1650133266336,MATH 18,A02,083744,Staff,28,0,30,2
1650133266336,MATH 18,A03,083745,Staff,23,0,30,7
1650133266336,MATH 18,A04,083746,Staff,27,0,30,3
1650133266336,MATH 18,B01,083748,Staff,0,9,30,30
1650133266336,MATH 18,B02,083749,Staff,0,7,30,30
1650133266336,MATH 18,B03,083750,Staff,0,6,30,30
1650133266336,MATH 18,B04,083751,Staff,0,7,30,30
1650133272363,MATH 20A,A01,083754,Staff,26,0,40,14
1650133278387,MATH 20B,A01,083756,Staff,0,5,30,30
1650133278387,MATH 20B,A02,083757,Staff,0,3,30,30
1650133284416,MATH 20C,A01,083760,Staff,0,11,30,30
1650133284416,MATH 20C,A02,083761,Staff,0,12,30,30
1650133284416,MATH 20C,B01,083762,Staff,14,0,30,16
1650133284416,MATH 20C,B02,083763,Staff,28,0,30,2
1650133290440,MATH 20D,A01,083765,Staff,0,2,30,30
1650133290440,MATH 20D,A02,083766,Staff,12,0,30,18
1650133290440,MATH 20D,A03,083767,Staff,28,0,30,2
1650133296467,MATH 20E,A01,083771,Staff,9,0,30,21
1650133296467,MATH 20E,A02,083772,Staff,20,0,30,10
1650133296467,MATH 20E,B01,083773,Staff,0,0,30,30
1650133296467,MATH 20E,B02,083774,Staff,13,0,30,17
1650133302490,MATH 103A,A01,083777,Staff,0,8,30,30
1650133302490,MATH 103A,A02,083778,Staff,0,8,30,30
1650133302490,MATH 103A,B01,083779,Staff,0,9,30,30
1650133302490,MATH 103A,B02,083780,Staff,0,6,30,30
1650133308517,MATH 105,A01,085443,Staff,0,13,30,30
1650133314541,MATH 109,A01,083213,Anzaldo; Leesa B,0,3,30,30
1650133314541,MATH 109,A02,083214,Anzaldo; Leesa B,0,5,30,30
1650133314541,MATH 109,B01,083215,Anzaldo; Leesa B,0,4,30,30
1650133314541,MATH 109,B02,083216,Anzaldo; Leesa B,0,4,30,30
1650133320570,MATH 142A,A01,083219,Chow; Bennett,0,11,30,30
1650133320570,MATH 142A,A02,083220,Chow; Bennett,0,10,30,30
1650133320570,MATH 142A,B01,083221,Chow; Bennett,0,10,30,30
1650133320570,MATH 142A,B02,083222,Chow; Bennett,0,10,30,30
1650133326606,MATH 193A,A01,083224,Staff,0,3,30,30
1650133326606,MATH 193A,A02,083225,Staff,0,4,30,30
1650133326606,MATH 193A,A03,083781,Staff,0,0,30,30
1650133326606,MATH 193A,A04,083782,Staff,1,0,30,29
1650133332629,MATH 197,001,091859,McAuley; Julian John,9998,0,9999,1
1650133338681,COGS 9,A01,083615,Staff,0,14,60,60
1650133344781,COGS 11,A01,083617,Boyle; Mary E. T.,24,0,40,16
1650133350804,COGS 13,A01,083071,Staff,0,28,40,40
1650133356827,COGS 14A,A01,092681,Staff,0,10,100,100
1650133362858,COGS 14B,A01,083073,Cheng; Tzu-Han,0,4,50,50
1650133368880,COGS 17,A01,092677,Staff,34,0,75,41
1650133374907,COGS 100,A01,083619,Staff,0,21,60,60
1650133380933,COGS 101A,A01,083621,Davis; Joshua Daniel,0,18,60,60
1650133386959,COGS 101B,A01,091572,Staff,10,0,60,50
1650133392984,COGS 101C,A01,083625,Delgado; Tania,22,0,30,8
1650133399019,COGS 107A,A01,083627,Boyle; Mary E. T.,0,5,60,60
1650133405042,COGS 118A,A01,083075,Staff,17,0,60,43
1650133411071,CSE 3,A50,083646,Miranda; Gregory Joseph,22,0,38,16
1650133411071,CSE 3,A51,083647,Miranda; Gregory Joseph,37,0,37,0
1650133417103,CSE 8A,A50,083650,Miranda; Gregory Joseph,0,16,40,40
1650133423129,CSE 11,A01,083080,Cao; Yingjun,0,66,40,40
1650133429156,CSE 12,A01,083652,Staff,0,2,100,100
1650133435182,CSE 15L,A01,083654,Staff,0,0,50,50
1650133435182,CSE 15L,A02,083655,Staff,10,0,50,40
1650133441210,CSE 20,A01,083657,Staff,56,0,80,24
1650133447236,CSE 30,A01,083084,Eldon; John,0,63,40,40
1650133453260,CSE 100,A01,083659,Cao; Yingjun,0,61,50,50
1650133459286,CSE 134B,A01,083661,Powell; Thomas Allan,0,27,65,65
1650133465312,CSE 140,A01,083663,Staff,4,0,75,71
1650133471335,CSE 140L,A01,083088,Eldon; John,0,1,75,75
1650133477363,CSE 175,A01,083665,Kumar; Rakesh,8,0,25,17
1650133483388,CSE 190,A00,092507,Dubnov; Shlomo,14,0,20,6
1650133489412,ECE 45,A01,083139,Staff,0,13,40,40
1650133495438,ECE 65,A50,083695,Staff,0,4,30,30
1650133501462,ECE 109,A01,091882,Touri; Behrouz,48,0,70,22
1650133507487,ECE 180,A00,083140,Abi Samra; Nicholas Camill,24,0,30,6
1650133507487,ECE 180,B00,083141,Abi Samra; Nicholas Camill,8,0,30,22
1650133513509,MATH 10A,A01,083735,Patchell; Gregory David,12,0,30,18
1650133513509,MATH 10A,A02,083736,Patchell; Gregory David,28,0,30,2
1650133513509,MATH 10A,A03,083737,Patchell; Gregory David,26,0,30,4
1650133519534,MATH 10B,A01,083207,Staff,0,5,30,30
1650133519534,MATH 10B,A02,083208,Staff,0,4,30,30
1650133519534,MATH 10B,B01,083739,Staff,18,0,30,12
1650133519534,MATH 10B,B02,083740,Staff,29,0,30,1
1650133525563,MATH 18,A01,083743,Staff,10,0,30,20
1650133525563,MATH 18,A02,083744,Staff,28,0,30,2
1650133525563,MATH 18,A03,083745,Staff,23,0,30,7
1650133525563,MATH 18,A04,083746,Staff,27,0,30,3
1650133525563,MATH 18,B01,083748,Staff,0,9,30,30
1650133525563,MATH 18,B02,083749,Staff,0,7,30,30
1650133525563,MATH 18,B03,083750,Staff,0,6,30,30
1650133525563,MATH 18,B04,083751,Staff,0,7,30,30
1650133531594,MATH 20A,A01,083754,Staff,26,0,40,14
1650133537621,MATH 20B,A01,083756,Staff,0,5,30,30
1650133537621,MATH 20B,A02,083757,Staff,0,3,30,30
1650133543644,MATH 20C,A01,083760,Staff,0,11,30,30
1650133543644,MATH 20C,A02,083761,Staff,0,12,30,30
1650133543644,MATH 20C,B01,083762,Staff,14,0,30,16
1650133543644,MATH 20C,B02,083763,Staff,28,0,30,2
1650133549668,MATH 20D,A01,083765,Staff,0,2,30,30
1650133549668,MATH 20D,A02,083766,Staff,12,0,30,18
1650133549668,MATH 20D,A03,083767,Staff,28,0,30,2
1650133555693,MATH 20E,A01,083771,Staff,9,0,30,21
1650133555693,MATH 20E,A02,083772,Staff,20,0,30,10
1650133555693,MATH 20E,B01,083773,Staff,0,0,30,30
1650133555693,MATH 20E,B02,083774,Staff,13,0,30,17
1650133561721,MATH 103A,A01,083777,Staff,0,8,30,30
1650133561721,MATH 103A,A02,083778,Staff,0,8,30,30
1650133561721,MATH 103A,B01,083779,Staff,0,9,30,30
1650133561721,MATH 103A,B02,083780,Staff,0,6,30,30
1650133567744,MATH 105,A01,085443,Staff,0,13,30,30
1650133573768,MATH 109,A01,083213,Anzaldo; Leesa B,0,3,30,30
1650133573768,MATH 109,A02,083214,Anzaldo; Leesa B,0,5,30,30
1650133573768,MATH 109,B01,083215,Anzaldo; Leesa B,0,4,30,30
1650133573768,MATH 109,B02,083216,Anzaldo; Leesa B,0,4,30,30
1650133579793,MATH 142A,A01,083219,Chow; Bennett,0,11,30,30
1650133579793,MATH 142A,A02,083220,Chow; Bennett,0,10,30,30
1650133579793,MATH 142A,B01,083221,Chow; Bennett,0,10,30,30
1650133579793,MATH 142A,B02,083222,Chow; Bennett,0,10,30,30
1650133585819,MATH 193A,A01,083224,Staff,0,3,30,30
1650133585819,MATH 193A,A02,083225,Staff,0,4,30,30
1650133585819,MATH 193A,A03,083781,Staff,0,0,30,30
1650133585819,MATH 193A,A04,083782,Staff,1,0,30,29
1650133591842,MATH 197,001,091859,McAuley; Julian John,9998,0,9999,1
1650133597913,COGS 9,A01,083615,Staff,0,14,60,60
1650133603938,COGS 11,A01,083617,Boyle; Mary E. T.,24,0,40,16
1650133609963,COGS 13,A01,083071,Staff,0,28,40,40
1650133615992,COGS 14A,A01,092681,Staff,0,10,100,100
1650133622015,COGS 14B,A01,083073,Cheng; Tzu-Han,0,4,50,50
1650133628038,COGS 17,A01,092677,Staff,34,0,75,41
1650133634064,COGS 100,A01,083619,Staff,0,21,60,60
1650133640088,COGS 101A,A01,083621,Davis; Joshua Daniel,0,18,60,60
1650133646110,COGS 101B,A01,091572,Staff,10,0,60,50
1650133652138,COGS 101C,A01,083625,Delgado; Tania,22,0,30,8
1650133658162,COGS 107A,A01,083627,Boyle; Mary E. T.,0,5,60,60
1650133664190,COGS 118A,A01,083075,Staff,17,0,60,43
1650133670214,CSE 3,A50,083646,Miranda; Gregory Joseph,22,0,38,16
1650133670214,CSE 3,A51,083647,Miranda; Gregory Joseph,37,0,37,0
1650133676241,CSE 8A,A50,083650,Miranda; Gregory Joseph,0,16,40,40
1650133682269,CSE 11,A01,083080,Cao; Yingjun,0,66,40,40
1650133688294,CSE 12,A01,083652,Staff,0,2,100,100
1650133694321,CSE 15L,A01,083654,Staff,0,0,50,50
1650133694321,CSE 15L,A02,083655,Staff,10,0,50,40
1650133700344,CSE 20,A01,083657,Staff,56,0,80,24
1650133706377,CSE 30,A01,083084,Eldon; John,0,63,40,40
1650133712402,CSE 100,A01,083659,Cao; Yingjun,0,61,50,50
1650133718423,CSE 134B,A01,083661,Powell; Thomas Allan,0,27,65,65
1650133724503,CSE 140,A01,083663,Staff,4,0,75,71
1650133730527,CSE 140L,A01,083088,Eldon; John,0,1,75,75
1650133736551,CSE 175,A01,083665,Kumar; Rakesh,8,0,25,17
1650133742575,CSE 190,A00,092507,Dubnov; Shlomo,14,0,20,6
1650133748599,ECE 45,A01,083139,Staff,0,13,40,40
1650133754628,ECE 65,A50,083695,Staff,0,4,30,30
1650133760654,ECE 109,A01,091882,Touri; Behrouz,48,0,70,22
1650133766677,ECE 180,A00,083140,Abi Samra; Nicholas Camill,24,0,30,6
1650133766677,ECE 180,B00,083141,Abi Samra; Nicholas Camill,8,0,30,22
1650133772702,MATH 10A,A01,083735,Patchell; Gregory David,12,0,30,18
1650133772702,MATH 10A,A02,083736,Patchell; Gregory David,28,0,30,2
1650133772702,MATH 10A,A03,083737,Patchell; Gregory David,26,0,30,4
1650133778734,MATH 10B,A01,083207,Staff,0,5,30,30
1650133778734,MATH 10B,A02,083208,Staff,0,4,30,30
1650133778734,MATH 10B,B01,083739,Staff,18,0,30,12
1650133778734,MATH 10B,B02,083740,Staff,29,0,30,1
1650133784762,MATH 18,A01,083743,Staff,10,0,30,20
1650133784762,MATH 18,A02,083744,Staff,28,0,30,2
1650133784762,MATH 18,A03,083745,Staff,23,0,30,7
1650133784762,MATH 18,A04,083746,Staff,27,0,30,3
1650133784762,MATH 18,B01,083748,Staff,0,9,30,30
1650133784762,MATH 18,B02,083749,Staff,0,7,30,30
1650133784762,MATH 18,B03,083750,Staff,0,6,30,30
1650133784762,MATH 18,B04,083751,Staff,0,7,30,30
1650133790788,MATH 20A,A01,083754,Staff,26,0,40,14
1650133796814,MATH 20B,A01,083756,Staff,0,5,30,30
1650133796814,MATH 20B,A02,083757,Staff,0,3,30,30
1650133802843,MATH 20C,A01,083760,Staff,0,11,30,30
1650133802843,MATH 20C,A02,083761,Staff,0,12,30,30
1650133802843,MATH 20C,B01,083762,Staff,14,0,30,16
1650133802843,MATH 20C,B02,083763,Staff,28,0,30,2
1650133808877,MATH 20D,A01,083765,Staff,0,2,30,30
1650133808877,MATH 20D,A02,083766,Staff,12,0,30,18
1650133808877,MATH 20D,A03,083767,Staff,28,0,30,2
1650133814902,MATH 20E,A01,083771,Staff,9,0,30,21
1650133814902,MATH 20E,A02,083772,Staff,20,0,30,10
1650133814902,MATH 20E,B01,083773,Staff,0,0,30,30
1650133814902,MATH 20E,B02,083774,Staff,13,0,30,17
1650133820926,MATH 103A,A01,083777,Staff,0,8,30,30
1650133820926,MATH 103A,A02,083778,Staff,0,8,30,30
1650133820926,MATH 103A,B01,083779,Staff,0,9,30,30
1650133820926,MATH 103A,B02,083780,Staff,0,6,30,30
1650133826948,MATH 105,A01,085443,Staff,0,13,30,30
1650133832973,MATH 109,A01,083213,Anzaldo; Leesa B,0,3,30,30
1650133832973,MATH 109,A02,083214,Anzaldo; Leesa B,0,5,30,30
1650133832973,MATH 109,B01,083215,Anzaldo; Leesa B,0,4,30,30
1650133832973,MATH 109,B02,083216,Anzaldo; Leesa B,0,4,30,30
1650133838998,MATH 142A,A01,083219,Chow; Bennett,0,11,30,30
1650133838998,MATH 142A,A02,083220,Chow; Bennett,0,10,30,30
1650133838998,MATH 142A,B01,083221,Chow; Bennett,0,10,30,30
1650133838998,MATH 142A,B02,083222,Chow; Bennett,0,10,30,30
1650133845026,MATH 193A,A01,083224,Staff,0,3,30,30
1650133845026,MATH 193A,A02,083225,Staff,0,4,30,30
1650133845026,MATH 193A,A03,083781,Staff,0,0,30,30
1650133845026,MATH 193A,A04,083782,Staff,1,0,30,29
1650133851051,MATH 197,001,091859,McAuley; Julian John,9998,0,9999,1
1650133857124,COGS 9,A01,083615,Staff,0,14,60,60
1650133863148,COGS 11,A01,083617,Boyle; Mary E. T.,24,0,40,16
1650133869171,COGS 13,A01,083071,Staff,0,28,40,40
1650133875195,COGS 14A,A01,092681,Staff,0,10,100,100
1650133881222,COGS 14B,A01,083073,Cheng; Tzu-Han,0,4,50,50
1650133887252,COGS 17,A01,092677,Staff,34,0,75,41
1650133893279,COGS 100,A01,083619,Staff,0,21,60,60
1650133899302,COGS 101A,A01,083621,Davis; Joshua Daniel,0,18,60,60
1650133905326,COGS 101B,A01,091572,Staff,10,0,60,50
1650133911349,COGS 101C,A01,083625,Delgado; Tania,22,0,30,8
1650133917377,COGS 107A,A01,083627,Boyle; Mary E. T.,0,5,60,60
1650133923400,COGS 118A,A01,083075,Staff,17,0,60,43
1650133929428,CSE 3,A50,083646,Miranda; Gregory Joseph,22,0,38,16
1650133929428,CSE 3,A51,083647,Miranda; Gregory Joseph,37,0,37,0
1650133935456,CSE 8A,A50,083650,Miranda; Gregory Joseph,0,16,40,40
1650133941557,CSE 11,A01,083080,Cao; Yingjun,0,66,40,40
1650133947580,CSE 12,A01,083652,Staff,0,2,100,100
1650133953604,CSE 15L,A01,083654,Staff,0,0,50,50
1650133953604,CSE 15L,A02,083655,Staff,10,0,50,40
1650133959630,CSE 20,A01,083657,Staff,56,0,80,24
1650133965654,CSE 30,A01,083084,Eldon; John,0,63,40,40
1650133971683,CSE 100,A01,083659,Cao; Yingjun,0,61,50,50
1650133977709,CSE 134B,A01,083661,Powell; Thomas Allan,0,27,65,65
1650133983737,CSE 140,A01,083663,Staff,4,0,75,71
1650133989760,CSE 140L,A01,083088,Eldon; John,0,1,75,75
1650133995783,CSE 175,A01,083665,Kumar; Rakesh,8,0,25,17
1650134001807,CSE 190,A00,092507,Dubnov; Shlomo,14,0,20,6
1650134007829,ECE 45,A01,083139,Staff,0,13,40,40
1650134013856,ECE 65,A50,083695,Staff,0,4,30,30
1650134019880,ECE 109,A01,091882,Touri; Behrouz,48,0,70,22
1650134025908,ECE 180,A00,083140,Abi Samra; Nicholas Camill,24,0,30,6
1650134025908,ECE 180,B00,083141,Abi Samra; Nicholas Camill,8,0,30,22
1650134031935,MATH 10A,A01,083735,Patchell; Gregory David,12,0,30,18
1650134031935,MATH 10A,A02,083736,Patchell; Gregory David,28,0,30,2
1650134031935,MATH 10A,A03,083737,Patchell; Gregory David,26,0,30,4
1650134037966,MATH 10B,A01,083207,Staff,0,5,30,30
1650134037966,MATH 10B,A02,083208,Staff,0,4,30,30
1650134037966,MATH 10B,B01,083739,Staff,18,0,30,12
1650134037966,MATH 10B,B02,083740,Staff,29,0,30,1
1650134043991,MATH 18,A01,083743,Staff,10,0,30,20
1650134043991,MATH 18,A02,083744,Staff,28,0,30,2
1650134043991,MATH 18,A03,083745,Staff,23,0,30,7
1650134043991,MATH 18,A04,083746,Staff,27,0,30,3
1650134043991,MATH 18,B01,083748,Staff,0,9,30,30
1650134043991,MATH 18,B02,083749,Staff,0,7,30,30
1650134043991,MATH 18,B03,083750,Staff,0,6,30,30
1650134043991,MATH 18,B04,083751,Staff,0,7,30,30
1650134050014,MATH 20A,A01,083754,Staff,26,0,40,14
1650134056039,MATH 20B,A01,083756,Staff,0,5,30,30
1650134056039,MATH 20B,A02,083757,Staff,0,3,30,30
1650134062071,MATH 20C,A01,083760,Staff,0,11,30,30
1650134062071,MATH 20C,A02,083761,Staff,0,12,30,30
1650134062071,MATH 20C,B01,083762,Staff,14,0,30,16
1650134062071,MATH 20C,B02,083763,Staff,28,0,30,2
1650134068097,MATH 20D,A01,083765,Staff,0,2,30,30
1650134068097,MATH 20D,A02,083766,Staff,12,0,30,18
1650134068097,MATH 20D,A03,083767,Staff,28,0,30,2
1650134074122,MATH 20E,A01,083771,Staff,9,0,30,21
1650134074122,MATH 20E,A02,083772,Staff,20,0,30,10
1650134074122,MATH 20E,B01,083773,Staff,0,0,30,30
1650134074122,MATH 20E,B02,083774,Staff,13,0,30,17
1650134080145,MATH 103A,A01,083777,Staff,0,8,30,30
1650134080145,MATH 103A,A02,083778,Staff,0,8,30,30
1650134080145,MATH 103A,B01,083779,Staff,0,9,30,30
1650134080145,MATH 103A,B02,083780,Staff,0,6,30,30
1650134086179,MATH 105,A01,085443,Staff,0,13,30,30
1650134092204,MATH 109,A01,083213,Anzaldo; Leesa B,0,3,30,30
1650134092204,MATH 109,A02,083214,Anzaldo; Leesa B,0,5,30,30
1650134092204,MATH 109,B01,083215,Anzaldo; Leesa B,0,4,30,30
1650134092204,MATH 109,B02,083216,Anzaldo; Leesa B,0,4,30,30
1650134098229,MATH 142A,A01,083219,Chow; Bennett,0,11,30,30
1650134098229,MATH 142A,A02,083220,Chow; Bennett,0,10,30,30
1650134098229,MATH 142A,B01,083221,Chow; Bennett,0,10,30,30
1650134098229,MATH 142A,B02,083222,Chow; Bennett,0,10,30,30
1650134104255,MATH 193A,A01,083224,Staff,0,3,30,30
1650134104255,MATH 193A,A02,083225,Staff,0,4,30,30
1650134104255,MATH 193A,A03,083781,Staff,0,0,30,30
1650134104255,MATH 193A,A04,083782,Staff,1,0,30,29
1650134110285,MATH 197,001,091859,McAuley; Julian John,9998,0,9999,1
1650134116340,COGS 9,A01,083615,Staff,0,14,60,60
1650134122367,COGS 11,A01,083617,Boyle; Mary E. T.,24,0,40,16
1650134128394,COGS 13,A01,083071,Staff,0,28,40,40
1650134134421,COGS 14A,A01,092681,Staff,0,10,100,100
1650134140449,COGS 14B,A01,083073,Cheng; Tzu-Han,0,4,50,50
1650134146475,COGS 17,A01,092677,Staff,34,0,75,41
1650134152503,COGS 100,A01,083619,Staff,0,21,60,60
1650134158530,COGS 101A,A01,083621,Davis; Joshua Daniel,0,18,60,60
1650134164557,COGS 101B,A01,091572,Staff,10,0,60,50
1650134170580,COGS 101C,A01,083625,Delgado; Tania,22,0,30,8
1650134176604,COGS 107A,A01,083627,Boyle; Mary E. T.,0,5,60,60
1650134182626,COGS 118A,A01,083075,Staff,17,0,60,43
1650134188653,CSE 3,A50,083646,Miranda; Gregory Joseph,22,0,38,16
1650134188653,CSE 3,A51,083647,Miranda; Gregory Joseph,37,0,37,0
1650134194693,CSE 8A,A50,083650,Miranda; Gregory Joseph,0,16,40,40
1650134200719,CSE 11,A01,083080,Cao; Yingjun,0,66,40,40
1650134206741,CSE 12,A01,083652,Staff,0,2,100,100
1650134212764,CSE 15L,A01,083654,Staff,0,0,50,50
1650134212764,CSE 15L,A02,083655,Staff,10,0,50,40
1650134218788,CSE 20,A01,083657,Staff,56,0,80,24
1650134224810,CSE 30,A01,083084,Eldon; John,0,63,40,40
1650134230834,CSE 100,A01,083659,Cao; Yingjun,0,61,50,50
1650134236859,CSE 134B,A01,083661,Powell; Thomas Allan,0,27,65,65
1650134242882,CSE 140,A01,083663,Staff,4,0,75,71
1650134248907,CSE 140L,A01,083088,Eldon; John,0,1,75,75
1650134254937,CSE 175,A01,083665,Kumar; Rakesh,8,0,25,17
1650134260960,CSE 190,A00,092507,Dubnov; Shlomo,14,0,20,6
1650134266984,ECE 45,A01,083139,Staff,0,13,40,40
1650134273022,ECE 65,A50,083695,Staff,0,4,30,30
1650134279048,ECE 109,A01,091882,Touri; Behrouz,48,0,70,22
1650134285082,ECE 180,A00,083140,Abi Samra; Nicholas Camill,24,0,30,6
1650134285082,ECE 180,B00,083141,Abi Samra; Nicholas Camill,8,0,30,22
1650134291107,MATH 10A,A01,083735,Patchell; Gregory David,12,0,30,18
1650134291107,MATH 10A,A02,083736,Patchell; Gregory David,28,0,30,2
1650134291107,MATH 10A,A03,083737,Patchell; Gregory David,26,0,30,4
1650134297131,MATH 10B,A01,083207,Staff,0,5,30,30
1650134297131,MATH 10B,A02,083208,Staff,0,4,30,30
1650134297131,MATH 10B,B01,083739,Staff,18,0,30,12
1650134297131,MATH 10B,B02,083740,Staff,29,0,30,1
1650134303161,MATH 18,A01,083743,Staff,10,0,30,20
1650134303161,MATH 18,A02,083744,Staff,28,0,30,2
1650134303161,MATH 18,A03,083745,Staff,23,0,30,7
1650134303161,MATH 18,A04,083746,Staff,27,0,30,3
1650134303161,MATH 18,B01,083748,Staff,0,9,30,30
1650134303161,MATH 18,B02,083749,Staff,0,7,30,30
1650134303161,MATH 18,B03,083750,Staff,0,6,30,30
1650134303161,MATH 18,B04,083751,Staff,0,7,30,30
1650134309185,MATH 20A,A01,083754,Staff,26,0,40,14
1650134315208,MATH 20B,A01,083756,Staff,0,5,30,30
1650134315208,MATH 20B,A02,083757,Staff,0,3,30,30
1650134321235,MATH 20C,A01,083760,Staff,0,11,30,30
1650134321235,MATH 20C,A02,083761,Staff,0,12,30,30
1650134321235,MATH 20C,B01,083762,Staff,14,0,30,16
1650134321235,MATH 20C,B02,083763,Staff,28,0,30,2
1650134327261,MATH 20D,A01,083765,Staff,0,2,30,30
1650134327261,MATH 20D,A02,083766,Staff,12,0,30,18
1650134327261,MATH 20D,A03,083767,Staff,28,0,30,2
1650134333284,MATH 20E,A01,083771,Staff,9,0,30,21
1650134333284,MATH 20E,A02,083772,Staff,20,0,30,10
1650134333284,MATH 20E,B01,083773,Staff,0,0,30,30
1650134333284,MATH 20E,B02,083774,Staff,13,0,30,17
1650134339308,MATH 103A,A01,083777,Staff,0,8,30,30
1650134339308,MATH 103A,A02,083778,Staff,0,8,30,30
1650134339308,MATH 103A,B01,083779,Staff,0,9,30,30
1650134339308,MATH 103A,B02,083780,Staff,0,6,30,30
1650134345330,MATH 105,A01,085443,Staff,0,13,30,30
1650134351354,MATH 109,A01,083213,Anzaldo; Leesa B,0,3,30,30
1650134351354,MATH 109,A02,083214,Anzaldo; Leesa B,0,5,30,30
1650134351354,MATH 109,B01,083215,Anzaldo; Leesa B,0,4,30,30
1650134351354,MATH 109,B02,083216,Anzaldo; Leesa B,0,4,30,30
1650134357379,MATH 142A,A01,083219,Chow; Bennett,0,11,30,30
1650134357379,MATH 142A,A02,083220,Chow; Bennett,0,10,30,30
1650134357379,MATH 142A,B01,083221,Chow; Bennett,0,10,30,30
1650134357379,MATH 142A,B02,083222,Chow; Bennett,0,10,30,30
1650134363408,MATH 193A,A01,083224,Staff,0,3,30,30
1650134363408,MATH 193A,A02,083225,Staff,0,4,30,30
1650134363408,MATH 193A,A03,083781,Staff,0,0,30,30
1650134363408,MATH 193A,A04,083782,Staff,1,0,30,29
1650134369432,MATH 197,001,091859,McAuley; Julian John,9998,0,9999,1
1650134375480,COGS 9,A01,083615,Staff,0,14,60,60
1650134381509,COGS 11,A01,083617,Boyle; Mary E. T.,24,0,40,16
1650134387532,COGS 13,A01,083071,Staff,0,28,40,40
1650134393556,COGS 14A,A01,092681,Staff,0,10,100,100
1650134399579,COGS 14B,A01,083073,Cheng; Tzu-Han,0,4,50,50
1650134405605,COGS 17,A01,092677,Staff,34,0,75,41
1650134411632,COGS 100,A01,083619,Staff,0,21,60,60
1650134417655,COGS 101A,A01,083621,Davis; Joshua Daniel,0,18,60,60
1650134423688,COGS 101B,A01,091572,Staff,10,0,60,50
1650134429710,COGS 101C,A01,083625,Delgado; Tania,22,0,30,8
1650134435736,COGS 107A,A01,083627,Boyle; Mary E. T.,0,5,60,60
1650134441759,COGS 118A,A01,083075,Staff,17,0,60,43
1650134447783,CSE 3,A50,083646,Miranda; Gregory Joseph,22,0,38,16
1650134447783,CSE 3,A51,083647,Miranda; Gregory Joseph,37,0,37,0
1650134453807,CSE 8A,A50,083650,Miranda; Gregory Joseph,0,16,40,40
1650134459834,CSE 11,A01,083080,Cao; Yingjun,0,66,40,40
1650134465857,CSE 12,A01,083652,Staff,0,2,100,100
1650134471880,CSE 15L,A01,083654,Staff,0,0,50,50
1650134471880,CSE 15L,A02,083655,Staff,10,0,50,40
1650134477907,CSE 20,A01,083657,Staff,56,0,80,24
1650134483938,CSE 30,A01,083084,Eldon; John,0,63,40,40
1650134489960,CSE 100,A01,083659,Cao; Yingjun,0,61,50,50
1650134495984,CSE 134B,A01,083661,Powell; Thomas Allan,0,27,65,65
1650134502006,CSE 140,A01,083663,Staff,4,0,75,71
1650134508030,CSE 140L,A01,083088,Eldon; John,0,1,75,75
1650134514065,CSE 175,A01,083665,Kumar; Rakesh,8,0,25,17
1650134520088,CSE 190,A00,092507,Dubnov; Shlomo,14,0,20,6
1650134526113,ECE 45,A01,083139,Staff,0,13,40,40
1650134532142,ECE 65,A50,083695,Staff,0,4,30,30
1650134538261,ECE 109,A01,091882,Touri; Behrouz,48,0,70,22
1650134544284,ECE 180,A00,083140,Abi Samra; Nicholas Camill,24,0,30,6
1650134544284,ECE 180,B00,083141,Abi Samra; Nicholas Camill,8,0,30,22
1650134550308,MATH 10A,A01,083735,Patchell; Gregory David,12,0,30,18
1650134550308,MATH 10A,A02,083736,Patchell; Gregory David,28,0,30,2
1650134550308,MATH 10A,A03,083737,Patchell; Gregory David,26,0,30,4
1650134556335,MATH 10B,A01,083207,Staff,0,5,30,30
1650134556335,MATH 10B,A02,083208,Staff,0,4,30,30
1650134556335,MATH 10B,B01,083739,Staff,18,0,30,12
1650134556335,MATH 10B,B02,083740,Staff,29,0,30,1
1650134562361,MATH 18,A01,083743,Staff,10,0,30,20
1650134562361,MATH 18,A02,083744,Staff,28,0,30,2
1650134562361,MATH 18,A03,083745,Staff,23,0,30,7
1650134562361,MATH 18,A04,083746,Staff,27,0,30,3
1650134562361,MATH 18,B01,083748,Staff,0,9,30,30
1650134562361,MATH 18,B02,083749,Staff,0,7,30,30
1650134562361,MATH 18,B03,083750,Staff,0,6,30,30
1650134562361,MATH 18,B04,083751,Staff,0,7,30,30
1650134568393,MATH 20A,A01,083754,Staff,26,0,40,14
1650134574419,MATH 20B,A01,083756,Staff,0,5,30,30
1650134574419,MATH 20B,A02,083757,Staff,0,3,30,30
1650134580450,MATH 20C,A01,083760,Staff,0,11,30,30
1650134580450,MATH 20C,A02,083761,Staff,0,12,30,30
1650134580450,MATH 20C,B01,083762,Staff,14,0,30,16
1650134580450,MATH 20C,B02,083763,Staff,28,0,30,2
1650134586476,MATH 20D,A01,083765,Staff,0,2,30,30
1650134586476,MATH 20D,A02,083766,Staff,12,0,30,18
1650134586476,MATH 20D,A03,083767,Staff,28,0,30,2
1650134592500,MATH 20E,A01,083771,Staff,8,0,30,22
1650134592500,MATH 20E,A02,083772,Staff,20,0,30,10
1650134592500,MATH 20E,B01,083773,Staff,0,0,30,30
1650134592500,MATH 20E,B02,083774,Staff,13,0,30,17
1650134598528,MATH 103A,A01,083777,Staff,0,8,30,30
1650134598528,MATH 103A,A02,083778,Staff,0,8,30,30
1650134598528,MATH 103A,B01,083779,Staff,0,9,30,30
1650134598528,MATH 103A,B02,083780,Staff,0,6,30,30
1650134604550,MATH 105,A01,085443,Staff,0,13,30,30
1650134610573,MATH 109,A01,083213,Anzaldo; Leesa B,0,3,30,30
1650134610573,MATH 109,A02,083214,Anzaldo; Leesa B,0,5,30,30
1650134610573,MATH 109,B01,083215,Anzaldo; Leesa B,0,4,30,30
1650134610573,MATH 109,B02,083216,Anzaldo; Leesa B,0,4,30,30
1650134616598,MATH 142A,A01,083219,Chow; Bennett,0,11,30,30
1650134616598,MATH 142A,A02,083220,Chow; Bennett,0,10,30,30
1650134616598,MATH 142A,B01,083221,Chow; Bennett,0,10,30,30
1650134616598,MATH 142A,B02,083222,Chow; Bennett,0,10,30,30
1650134622621,MATH 193A,A01,083224,Staff,0,3,30,30
1650134622621,MATH 193A,A02,083225,Staff,0,4,30,30
1650134622621,MATH 193A,A03,083781,Staff,0,0,30,30
1650134622621,MATH 193A,A04,083782,Staff,1,0,30,29
1650134628650,MATH 197,001,091859,McAuley; Julian John,9998,0,9999,1
1650134634703,COGS 9,A01,083615,Staff,0,14,60,60
1650134640726,COGS 11,A01,083617,Boyle; Mary E. T.,24,0,40,16
1650134646750,COGS 13,A01,083071,Staff,0,28,40,40
1650134652773,COGS 14A,A01,092681,Staff,0,10,100,100
1650134658797,COGS 14B,A01,083073,Cheng; Tzu-Han,0,4,50,50
1650134664828,COGS 17,A01,092677,Staff,34,0,75,41
1650134670856,COGS 100,A01,083619,Staff,0,21,60,60
1650134676880,COGS 101A,A01,083621,Davis; Joshua Daniel,0,18,60,60
1650134682902,COGS 101B,A01,091572,Staff,10,0,60,50
1650134688930,COGS 101C,A01,083625,Delgado; Tania,22,0,30,8
1650134694952,COGS 107A,A01,083627,Boyle; Mary E. T.,0,5,60,60
1650134700976,COGS 118A,A01,083075,Staff,17,0,60,43
1650134707004,CSE 3,A50,083646,Miranda; Gregory Joseph,22,0,38,16
1650134707004,CSE 3,A51,083647,Miranda; Gregory Joseph,37,0,37,0
1650134713029,CSE 8A,A50,083650,Miranda; Gregory Joseph,0,16,40,40
1650134719052,CSE 11,A01,083080,Cao; Yingjun,0,66,40,40
1650134725094,CSE 12,A01,083652,Staff,0,2,100,100
1650134731124,CSE 15L,A01,083654,Staff,0,0,50,50
1650134731124,CSE 15L,A02,083655,Staff,10,0,50,40
1650134737147,CSE 20,A01,083657,Staff,56,0,80,24
1650134743174,CSE 30,A01,083084,Eldon; John,0,63,40,40
1650134749205,CSE 100,A01,083659,Cao; Yingjun,0,61,50,50
1650134755228,CSE 134B,A01,083661,Powell; Thomas Allan,0,27,65,65
1650134761252,CSE 140,A01,083663,Staff,4,0,75,71
1650134767278,CSE 140L,A01,083088,Eldon; John,0,1,75,75
1650134773306,CSE 175,A01,083665,Kumar; Rakesh,8,0,25,17
1650134779329,CSE 190,A00,092507,Dubnov; Shlomo,14,0,20,6
1650134785356,ECE 45,A01,083139,Staff,0,13,40,40
1650134791387,ECE 65,A50,083695,Staff,0,4,30,30
1650134797410,ECE 109,A01,091882,Touri; Behrouz,48,0,70,22
1650134803433,ECE 180,A00,083140,Abi Samra; Nicholas Camill,24,0,30,6
1650134803433,ECE 180,B00,083141,Abi Samra; Nicholas Camill,8,0,30,22
1650134809457,MATH 10A,A01,083735,Patchell; Gregory David,12,0,30,18
1650134809457,MATH 10A,A02,083736,Patchell; Gregory David,28,0,30,2
1650134809457,MATH 10A,A03,083737,Patchell; Gregory David,26,0,30,4
1650134815485,MATH 10B,A01,083207,Staff,0,5,30,30
1650134815485,MATH 10B,A02,083208,Staff,0,4,30,30
1650134815485,MATH 10B,B01,083739,Staff,18,0,30,12
1650134815485,MATH 10B,B02,083740,Staff,29,0,30,1
1650134821509,MATH 18,A01,083743,Staff,10,0,30,20
1650134821509,MATH 18,A02,083744,Staff,28,0,30,2
1650134821509,MATH 18,A03,083745,Staff,23,0,30,7
1650134821509,MATH 18,A04,083746,Staff,27,0,30,3
1650134821509,MATH 18,B01,083748,Staff,0,9,30,30
1650134821509,MATH 18,B02,083749,Staff,0,7,30,30
1650134821509,MATH 18,B03,083750,Staff,0,6,30,30
1650134821509,MATH 18,B04,083751,Staff,0,7,30,30
1650134827533,MATH 20A,A01,083754,Staff,26,0,40,14
1650134833557,MATH 20B,A01,083756,Staff,0,5,30,30
1650134833557,MATH 20B,A02,083757,Staff,0,3,30,30
1650134839581,MATH 20C,A01,083760,Staff,0,11,30,30
1650134839581,MATH 20C,A02,083761,Staff,0,12,30,30
1650134839581,MATH 20C,B01,083762,Staff,14,0,30,16
1650134839581,MATH 20C,B02,083763,Staff,28,0,30,2
1650134845607,MATH 20D,A01,083765,Staff,0,2,30,30
1650134845607,MATH 20D,A02,083766,Staff,11,0,30,19
1650134845607,MATH 20D,A03,083767,Staff,28,0,30,2
1650134851631,MATH 20E,A01,083771,Staff,8,0,30,22
1650134851631,MATH 20E,A02,083772,Staff,20,0,30,10
1650134851631,MATH 20E,B01,083773,Staff,0,0,30,30
1650134851631,MATH 20E,B02,083774,Staff,13,0,30,17
1650134857655,MATH 103A,A01,083777,Staff,0,8,30,30
1650134857655,MATH 103A,A02,083778,Staff,0,8,30,30
1650134857655,MATH 103A,B01,083779,Staff,0,9,30,30
1650134857655,MATH 103A,B02,083780,Staff,0,6,30,30
1650134863677,MATH 105,A01,085443,Staff,0,13,30,30
1650134869705,MATH 109,A01,083213,Anzaldo; Leesa B,0,3,30,30
1650134869705,MATH 109,A02,083214,Anzaldo; Leesa B,0,5,30,30
1650134869705,MATH 109,B01,083215,Anzaldo; Leesa B,0,4,30,30
1650134869705,MATH 109,B02,083216,Anzaldo; Leesa B,0,4,30,30
1650134875731,MATH 142A,A01,083219,Chow; Bennett,0,11,30,30
1650134875731,MATH 142A,A02,083220,Chow; Bennett,0,10,30,30
1650134875731,MATH 142A,B01,083221,Chow; Bennett,0,10,30,30
1650134875731,MATH 142A,B02,083222,Chow; Bennett,0,10,30,30
1650134881758,MATH 193A,A01,083224,Staff,0,3,30,30
1650134881758,MATH 193A,A02,083225,Staff,0,4,30,30
1650134881758,MATH 193A,A03,083781,Staff,0,0,30,30
1650134881758,MATH 193A,A04,083782,Staff,1,0,30,29
1650134887782,MATH 197,001,091859,McAuley; Julian John,9998,0,9999,1
1650134893833,COGS 9,A01,083615,Staff,0,14,60,60
1650134899862,COGS 11,A01,083617,Boyle; Mary E. T.,24,0,40,16
1650134905889,COGS 13,A01,083071,Staff,0,28,40,40
1650134911911,COGS 14A,A01,092681,Staff,0,10,100,100
1650134917935,COGS 14B,A01,083073,Cheng; Tzu-Han,0,4,50,50
1650134923958,COGS 17,A01,092677,Staff,34,0,75,41
1650134929984,COGS 100,A01,083619,Staff,0,21,60,60
1650134936005,COGS 101A,A01,083621,Davis; Joshua Daniel,0,18,60,60
1650134942031,COGS 101B,A01,091572,Staff,10,0,60,50
1650134948054,COGS 101C,A01,083625,Delgado; Tania,22,0,30,8
1650134954077,COGS 107A,A01,083627,Boyle; Mary E. T.,0,5,60,60
1650134960100,COGS 118A,A01,083075,Staff,17,0,60,43
1650134966126,CSE 3,A50,083646,Miranda; Gregory Joseph,22,0,38,16
1650134966126,CSE 3,A51,083647,Miranda; Gregory Joseph,37,0,37,0
1650134972153,CSE 8A,A50,083650,Miranda; Gregory Joseph,0,16,40,40
1650134978177,CSE 11,A01,083080,Cao; Yingjun,0,66,40,40
1650134984200,CSE 12,A01,083652,Staff,0,2,100,100
1650134990232,CSE 15L,A01,083654,Staff,0,0,50,50
1650134990232,CSE 15L,A02,083655,Staff,10,0,50,40
1650134996258,CSE 20,A01,083657,Staff,56,0,80,24
1650135002282,CSE 30,A01,083084,Eldon; John,0,63,40,40
1650135008305,CSE 100,A01,083659,Cao; Yingjun,0,61,50,50
1650135014331,CSE 134B,A01,083661,Powell; Thomas Allan,0,27,65,65
1650135020361,CSE 140,A01,083663,Staff,4,0,75,71
1650135035753,CSE 140L,A01,083088,Eldon; John,0,1,75,75
1650135041779,CSE 175,A01,083665,Kumar; Rakesh,8,0,25,17
1650135047803,CSE 190,A00,092507,Dubnov; Shlomo,14,0,20,6
1650135053826,ECE 45,A01,083139,Staff,0,13,40,40
1650135059855,ECE 65,A50,083695,Staff,0,4,30,30
1650135065880,ECE 109,A01,091882,Touri; Behrouz,48,0,70,22
1650135071902,ECE 180,A00,083140,Abi Samra; Nicholas Camill,24,0,30,6
1650135071902,ECE 180,B00,083141,Abi Samra; Nicholas Camill,8,0,30,22
1650135077926,MATH 10A,A01,083735,Patchell; Gregory David,12,0,30,18
1650135077926,MATH 10A,A02,083736,Patchell; Gregory David,28,0,30,2
1650135077926,MATH 10A,A03,083737,Patchell; Gregory David,26,0,30,4
1650135083952,MATH 10B,A01,083207,Staff,0,5,30,30
1650135083952,MATH 10B,A02,083208,Staff,0,4,30,30
1650135083952,MATH 10B,B01,083739,Staff,18,0,30,12
1650135083952,MATH 10B,B02,083740,Staff,29,0,30,1
1650135089978,MATH 18,A01,083743,Staff,10,0,30,20
1650135089978,MATH 18,A02,083744,Staff,28,0,30,2
1650135089978,MATH 18,A03,083745,Staff,23,0,30,7
1650135089978,MATH 18,A04,083746,Staff,27,0,30,3
1650135089978,MATH 18,B01,083748,Staff,0,9,30,30
1650135089978,MATH 18,B02,083749,Staff,0,7,30,30
1650135089978,MATH 18,B03,083750,Staff,0,6,30,30
1650135089978,MATH 18,B04,083751,Staff,0,7,30,30
1650135096002,MATH 20A,A01,083754,Staff,26,0,40,14
1650135102024,MATH 20B,A01,083756,Staff,0,5,30,30
1650135102024,MATH 20B,A02,083757,Staff,0,4,30,30
1650135108057,MATH 20C,A01,083760,Staff,0,11,30,30
1650135108057,MATH 20C,A02,083761,Staff,0,12,30,30
1650135108057,MATH 20C,B01,083762,Staff,14,0,30,16
1650135108057,MATH 20C,B02,083763,Staff,28,0,30,2
1650135114085,MATH 20D,A01,083765,Staff,0,2,30,30
1650135114085,MATH 20D,A02,083766,Staff,11,0,30,19
1650135114085,MATH 20D,A03,083767,Staff,28,0,30,2
1650135120110,MATH 20E,A01,083771,Staff,8,0,30,22
1650135120110,MATH 20E,A02,083772,Staff,20,0,30,10
1650135120110,MATH 20E,B01,083773,Staff,0,0,30,30
1650135120110,MATH 20E,B02,083774,Staff,13,0,30,17
1650135126135,MATH 103A,A01,083777,Staff,0,8,30,30
1650135126135,MATH 103A,A02,083778,Staff,0,8,30,30
1650135126135,MATH 103A,B01,083779,Staff,0,9,30,30
1650135126135,MATH 103A,B02,083780,Staff,0,6,30,30
1650135132160,MATH 105,A01,085443,Staff,0,13,30,30
1650135138190,MATH 109,A01,083213,Anzaldo; Leesa B,0,3,30,30
1650135138190,MATH 109,A02,083214,Anzaldo; Leesa B,0,5,30,30
1650135138190,MATH 109,B01,083215,Anzaldo; Leesa B,0,4,30,30
1650135138190,MATH 109,B02,083216,Anzaldo; Leesa B,0,4,30,30
1650135144294,MATH 142A,A01,083219,Chow; Bennett,0,11,30,30
1650135144294,MATH 142A,A02,083220,Chow; Bennett,0,10,30,30
1650135144294,MATH 142A,B01,083221,Chow; Bennett,0,10,30,30
1650135144294,MATH 142A,B02,083222,Chow; Bennett,0,10,30,30
1650135150322,MATH 193A,A01,083224,Staff,0,3,30,30
1650135150322,MATH 193A,A02,083225,Staff,0,4,30,30
1650135150322,MATH 193A,A03,083781,Staff,0,0,30,30
1650135150322,MATH 193A,A04,083782,Staff,1,0,30,29
1650135156344,MATH 197,001,091859,McAuley; Julian John,9998,0,9999,1
1650135162413,COGS 9,A01,083615,Staff,0,14,60,60
1650135168442,COGS 11,A01,083617,Boyle; Mary E. T.,24,0,40,16
1650135174465,COGS 13,A01,083071,Staff,0,28,40,40
1650135180492,COGS 14A,A01,092681,Staff,0,10,100,100
1650135186518,COGS 14B,A01,083073,Cheng; Tzu-Han,0,4,50,50
1650135192547,COGS 17,A01,092677,Staff,34,0,75,41
1650135198569,COGS 100,A01,083619,Staff,0,21,60,60
1650135204592,COGS 101A,A01,083621,Davis; Joshua Daniel,0,18,60,60
1650135210615,COGS 101B,A01,091572,Staff,10,0,60,50
1650135216639,COGS 101C,A01,083625,Delgado; Tania,22,0,30,8
1650135222662,COGS 107A,A01,083627,Boyle; Mary E. T.,0,5,60,60
1650135228690,COGS 118A,A01,083075,Staff,17,0,60,43
1650135234713,CSE 3,A50,083646,Miranda; Gregory Joseph,22,0,38,16
1650135234713,CSE 3,A51,083647,Miranda; Gregory Joseph,37,0,37,0
1650135240759,CSE 8A,A50,083650,Miranda; Gregory Joseph,0,16,40,40
1650135246782,CSE 11,A01,083080,Cao; Yingjun,0,66,40,40
1650135252806,CSE 12,A01,083652,Staff,0,2,100,100
1650135258831,CSE 15L,A01,083654,Staff,0,0,50,50
1650135258831,CSE 15L,A02,083655,Staff,10,0,50,40
1650135264855,CSE 20,A01,083657,Staff,56,0,80,24
1650135270879,CSE 30,A01,083084,Eldon; John,0,63,40,40
1650135276902,CSE 100,A01,083659,Cao; Yingjun,0,61,50,50
1650135282929,CSE 134B,A01,083661,Powell; Thomas Allan,0,27,65,65
1650135288953,CSE 140,A01,083663,Staff,4,0,75,71
1650135294977,CSE 140L,A01,083088,Eldon; John,0,1,75,75
1650135301001,CSE 175,A01,083665,Kumar; Rakesh,8,0,25,17
1650135307028,CSE 190,A00,092507,Dubnov; Shlomo,14,0,20,6
1650135313054,ECE 45,A01,083139,Staff,0,13,40,40
1650135319081,ECE 65,A50,083695,Staff,0,4,30,30
1650135325105,ECE 109,A01,091882,Touri; Behrouz,48,0,70,22
1650135331133,ECE 180,A00,083140,Abi Samra; Nicholas Camill,24,0,30,6
1650135331133,ECE 180,B00,083141,Abi Samra; Nicholas Camill,8,0,30,22
1650135337156,MATH 10A,A01,083735,Patchell; Gregory David,12,0,30,18
1650135337156,MATH 10A,A02,083736,Patchell; Gregory David,28,0,30,2
1650135337156,MATH 10A,A03,083737,Patchell; Gregory David,26,0,30,4
1650135343180,MATH 10B,A01,083207,Staff,0,5,30,30
1650135343180,MATH 10B,A02,083208,Staff,0,4,30,30
1650135343180,MATH 10B,B01,083739,Staff,18,0,30,12
1650135343180,MATH 10B,B02,083740,Staff,29,0,30,1
1650135349206,MATH 18,A01,083743,Staff,10,0,30,20
1650135349206,MATH 18,A02,083744,Staff,28,0,30,2
1650135349206,MATH 18,A03,083745,Staff,23,0,30,7
1650135349206,MATH 18,A04,083746,Staff,27,0,30,3
1650135349206,MATH 18,B01,083748,Staff,0,9,30,30
1650135349206,MATH 18,B02,083749,Staff,0,7,30,30
1650135349206,MATH 18,B03,083750,Staff,0,6,30,30
1650135349206,MATH 18,B04,083751,Staff,0,7,30,30
1650135355230,MATH 20A,A01,083754,Staff,26,0,40,14
1650135361262,MATH 20B,A01,083756,Staff,0,5,30,30
1650135361262,MATH 20B,A02,083757,Staff,0,4,30,30
1650135367303,MATH 20C,A01,083760,Staff,0,11,30,30
1650135367303,MATH 20C,A02,083761,Staff,0,12,30,30
1650135367303,MATH 20C,B01,083762,Staff,14,0,30,16
1650135367303,MATH 20C,B02,083763,Staff,28,0,30,2
1650135373326,MATH 20D,A01,083765,Staff,0,2,30,30
1650135373326,MATH 20D,A02,083766,Staff,11,0,30,19
1650135373326,MATH 20D,A03,083767,Staff,28,0,30,2
1650135379354,MATH 20E,A01,083771,Staff,8,0,30,22
1650135379354,MATH 20E,A02,083772,Staff,20,0,30,10
1650135379354,MATH 20E,B01,083773,Staff,0,0,30,30
1650135379354,MATH 20E,B02,083774,Staff,13,0,30,17
1650135385378,MATH 103A,A01,083777,Staff,0,8,30,30
1650135385378,MATH 103A,A02,083778,Staff,0,8,30,30
1650135385378,MATH 103A,B01,083779,Staff,0,9,30,30
1650135385378,MATH 103A,B02,083780,Staff,0,6,30,30
1650135391401,MATH 105,A01,085443,Staff,0,13,30,30
1650135397435,MATH 109,A01,083213,Anzaldo; Leesa B,0,3,30,30
1650135397435,MATH 109,A02,083214,Anzaldo; Leesa B,0,5,30,30
1650135397435,MATH 109,B01,083215,Anzaldo; Leesa B,0,4,30,30
1650135397435,MATH 109,B02,083216,Anzaldo; Leesa B,0,4,30,30
1650135403459,MATH 142A,A01,083219,Chow; Bennett,0,11,30,30
1650135403459,MATH 142A,A02,083220,Chow; Bennett,0,10,30,30
1650135403459,MATH 142A,B01,083221,Chow; Bennett,0,10,30,30
1650135403459,MATH 142A,B02,083222,Chow; Bennett,0,10,30,30
1650135409487,MATH 193A,A01,083224,Staff,0,3,30,30
1650135409487,MATH 193A,A02,083225,Staff,0,4,30,30
1650135409487,MATH 193A,A03,083781,Staff,0,0,30,30
1650135409487,MATH 193A,A04,083782,Staff,0,0,30,30
1650135415517,MATH 197,001,091859,McAuley; Julian John,9998,0,9999,1
1650135421574,COGS 9,A01,083615,Staff,0,14,60,60
1650135427597,COGS 11,A01,083617,Boyle; Mary E. T.,24,0,40,16
1650135433621,COGS 13,A01,083071,Staff,0,28,40,40
1650135439647,COGS 14A,A01,092681,Staff,0,10,100,100
1650135445673,COGS 14B,A01,083073,Cheng; Tzu-Han,0,4,50,50
1650135451709,COGS 17,A01,092677,Staff,34,0,75,41
1650135457731,COGS 100,A01,083619,Staff,0,21,60,60
1650135463778,COGS 101A,A01,083621,Davis; Joshua Daniel,0,18,60,60
1650135469802,COGS 101B,A01,091572,Staff,10,0,60,50
1650135475829,COGS 101C,A01,083625,Delgado; Tania,22,0,30,8
1650135481852,COGS 107A,A01,083627,Boyle; Mary E. T.,0,5,60,60
1650135487876,COGS 118A,A01,083075,Staff,17,0,60,43
1650135493900,CSE 3,A50,083646,Miranda; Gregory Joseph,22,0,38,16
1650135493900,CSE 3,A51,083647,Miranda; Gregory Joseph,37,0,37,0
1650135499931,CSE 8A,A50,083650,Miranda; Gregory Joseph,0,16,40,40
1650135505955,CSE 11,A01,083080,Cao; Yingjun,0,66,40,40
1650135511979,CSE 12,A01,083652,Staff,0,2,100,100
1650135518006,CSE 15L,A01,083654,Staff,0,0,50,50
1650135518006,CSE 15L,A02,083655,Staff,10,0,50,40
1650135524031,CSE 20,A01,083657,Staff,56,0,80,24
1650135530054,CSE 30,A01,083084,Eldon; John,0,63,40,40
1650135536084,CSE 100,A01,083659,Cao; Yingjun,0,61,50,50
1650135542112,CSE 134B,A01,083661,Powell; Thomas Allan,0,27,65,65
1650135548138,CSE 140,A01,083663,Staff,4,0,75,71
1650135554160,CSE 140L,A01,083088,Eldon; John,0,1,75,75
1650135560187,CSE 175,A01,083665,Kumar; Rakesh,8,0,25,17
1650135566212,CSE 190,A00,092507,Dubnov; Shlomo,14,0,20,6
1650135572237,ECE 45,A01,083139,Staff,0,13,40,40
1650135578263,ECE 65,A50,083695,Staff,0,4,30,30
1650135584287,ECE 109,A01,091882,Touri; Behrouz,48,0,70,22
1650135590316,ECE 180,A00,083140,Abi Samra; Nicholas Camill,24,0,30,6
1650135590316,ECE 180,B00,083141,Abi Samra; Nicholas Camill,8,0,30,22
1650135596343,MATH 10A,A01,083735,Patchell; Gregory David,12,0,30,18
1650135596343,MATH 10A,A02,083736,Patchell; Gregory David,28,0,30,2
1650135596343,MATH 10A,A03,083737,Patchell; Gregory David,26,0,30,4
1650135602369,MATH 10B,A01,083207,Staff,0,5,30,30
1650135602369,MATH 10B,A02,083208,Staff,0,4,30,30
1650135602369,MATH 10B,B01,083739,Staff,18,0,30,12
1650135602369,MATH 10B,B02,083740,Staff,29,0,30,1
1650135608393,MATH 18,A01,083743,Staff,10,0,30,20
1650135608393,MATH 18,A02,083744,Staff,28,0,30,2
1650135608393,MATH 18,A03,083745,Staff,23,0,30,7
1650135608393,MATH 18,A04,083746,Staff,27,0,30,3
1650135608393,MATH 18,B01,083748,Staff,0,9,30,30
1650135608393,MATH 18,B02,083749,Staff,0,7,30,30
1650135608393,MATH 18,B03,083750,Staff,0,6,30,30
1650135608393,MATH 18,B04,083751,Staff,0,7,30,30
1650135614421,MATH 20A,A01,083754,Staff,26,0,40,14
1650135620447,MATH 20B,A01,083756,Staff,0,5,30,30
1650135620447,MATH 20B,A02,083757,Staff,0,4,30,30
1650135626473,MATH 20C,A01,083760,Staff,0,11,30,30
1650135626473,MATH 20C,A02,083761,Staff,0,12,30,30
1650135626473,MATH 20C,B01,083762,Staff,14,0,30,16
1650135626473,MATH 20C,B02,083763,Staff,28,0,30,2
1650135632496,MATH 20D,A01,083765,Staff,0,2,30,30
1650135632496,MATH 20D,A02,083766,Staff,11,0,30,19
1650135632496,MATH 20D,A03,083767,Staff,28,0,30,2
1650135638524,MATH 20E,A01,083771,Staff,8,0,30,22
1650135638524,MATH 20E,A02,083772,Staff,20,0,30,10
1650135638524,MATH 20E,B01,083773,Staff,0,0,30,30
1650135638524,MATH 20E,B02,083774,Staff,13,0,30,17
1650135644553,MATH 103A,A01,083777,Staff,0,8,30,30
1650135644553,MATH 103A,A02,083778,Staff,0,8,30,30
1650135644553,MATH 103A,B01,083779,Staff,0,9,30,30
1650135644553,MATH 103A,B02,083780,Staff,0,6,30,30
1650135650577,MATH 105,A01,085443,Staff,0,13,30,30
1650135656612,MATH 109,A01,083213,Anzaldo; Leesa B,0,3,30,30
1650135656612,MATH 109,A02,083214,Anzaldo; Leesa B,0,5,30,30
1650135656612,MATH 109,B01,083215,Anzaldo; Leesa B,0,4,30,30
1650135656612,MATH 109,B02,083216,Anzaldo; Leesa B,0,4,30,30
1650135662645,MATH 142A,A01,083219,Chow; Bennett,0,11,30,30
1650135662645,MATH 142A,A02,083220,Chow; Bennett,0,10,30,30
1650135662645,MATH 142A,B01,083221,Chow; Bennett,0,10,30,30
1650135662645,MATH 142A,B02,083222,Chow; Bennett,0,10,30,30
1650135668671,MATH 193A,A01,083224,Staff,0,3,30,30
1650135668671,MATH 193A,A02,083225,Staff,0,4,30,30
1650135668671,MATH 193A,A03,083781,Staff,0,0,30,30
1650135668671,MATH 193A,A04,083782,Staff,0,0,30,30
1650135674697,MATH 197,001,091859,McAuley; Julian John,9998,0,9999,1
1650135680749,COGS 9,A01,083615,Staff,0,14,60,60
1650135686772,COGS 11,A01,083617,Boyle; Mary E. T.,24,0,40,16
1650135692796,COGS 13,A01,083071,Staff,0,28,40,40
1650135698822,COGS 14A,A01,092681,Staff,0,10,100,100
1650135704853,COGS 14B,A01,083073,Cheng; Tzu-Han,0,4,50,50
1650135710876,COGS 17,A01,092677,Staff,34,0,75,41
1650135716902,COGS 100,A01,083619,Staff,0,21,60,60
1650135722928,COGS 101A,A01,083621,Davis; Joshua Daniel,0,18,60,60
1650135728952,COGS 101B,A01,091572,Staff,10,0,60,50
1650135735055,COGS 101C,A01,083625,Delgado; Tania,22,0,30,8
1650135741080,COGS 107A,A01,083627,Boyle; Mary E. T.,0,5,60,60
1650135747103,COGS 118A,A01,083075,Staff,17,0,60,43
1650135753133,CSE 3,A50,083646,Miranda; Gregory Joseph,22,0,38,16
1650135753133,CSE 3,A51,083647,Miranda; Gregory Joseph,37,0,37,0
1650135759160,CSE 8A,A50,083650,Miranda; Gregory Joseph,0,16,40,40
1650135765185,CSE 11,A01,083080,Cao; Yingjun,0,66,40,40
1650135771214,CSE 12,A01,083652,Staff,0,2,100,100
1650135777242,CSE 15L,A01,083654,Staff,0,0,50,50
1650135777242,CSE 15L,A02,083655,Staff,10,0,50,40
1650135783265,CSE 20,A01,083657,Staff,56,0,80,24
1650135789289,CSE 30,A01,083084,Eldon; John,0,63,40,40
1650135795313,CSE 100,A01,083659,Cao; Yingjun,0,61,50,50
1650135801345,CSE 134B,A01,083661,Powell; Thomas Allan,0,27,65,65
1650135807369,CSE 140,A01,083663,Staff,4,0,75,71
1650135813397,CSE 140L,A01,083088,Eldon; John,0,1,75,75
1650135819423,CSE 175,A01,083665,Kumar; Rakesh,8,0,25,17
1650135825446,CSE 190,A00,092507,Dubnov; Shlomo,14,0,20,6
1650135831470,ECE 45,A01,083139,Staff,0,13,40,40
1650135837497,ECE 65,A50,083695,Staff,0,4,30,30
1650135843524,ECE 109,A01,091882,Touri; Behrouz,48,0,70,22
1650135849547,ECE 180,A00,083140,Abi Samra; Nicholas Camill,24,0,30,6
1650135849547,ECE 180,B00,083141,Abi Samra; Nicholas Camill,8,0,30,22
1650135855586,MATH 10A,A01,083735,Patchell; Gregory David,12,0,30,18
1650135855586,MATH 10A,A02,083736,Patchell; Gregory David,28,0,30,2
1650135855586,MATH 10A,A03,083737,Patchell; Gregory David,26,0,30,4
1650135861617,MATH 10B,A01,083207,Staff,0,5,30,30
1650135861617,MATH 10B,A02,083208,Staff,0,4,30,30
1650135861617,MATH 10B,B01,083739,Staff,18,0,30,12
1650135861617,MATH 10B,B02,083740,Staff,29,0,30,1
1650135867650,MATH 18,A01,083743,Staff,10,0,30,20
1650135867650,MATH 18,A02,083744,Staff,28,0,30,2
1650135867650,MATH 18,A03,083745,Staff,23,0,30,7
1650135867650,MATH 18,A04,083746,Staff,27,0,30,3
1650135867650,MATH 18,B01,083748,Staff,0,9,30,30
1650135867650,MATH 18,B02,083749,Staff,0,7,30,30
1650135867650,MATH 18,B03,083750,Staff,0,6,30,30
1650135867650,MATH 18,B04,083751,Staff,0,7,30,30
1650135873674,MATH 20A,A01,083754,Staff,26,0,40,14
1650135879697,MATH 20B,A01,083756,Staff,0,5,30,30
1650135879697,MATH 20B,A02,083757,Staff,0,4,30,30
1650135885724,MATH 20C,A01,083760,Staff,0,11,30,30
1650135885724,MATH 20C,A02,083761,Staff,0,12,30,30
1650135885724,MATH 20C,B01,083762,Staff,14,0,30,16
1650135885724,MATH 20C,B02,083763,Staff,28,0,30,2
1650135891752,MATH 20D,A01,083765,Staff,0,2,30,30
1650135891752,MATH 20D,A02,083766,Staff,11,0,30,19
1650135891752,MATH 20D,A03,083767,Staff,28,0,30,2
1650135897793,MATH 20E,A01,083771,Staff,8,0,30,22
1650135897793,MATH 20E,A02,083772,Staff,20,0,30,10
1650135897793,MATH 20E,B01,083773,Staff,0,0,30,30
1650135897793,MATH 20E,B02,083774,Staff,13,0,30,17
1650135903833,MATH 103A,A01,083777,Staff,0,8,30,30
1650135903833,MATH 103A,A02,083778,Staff,0,8,30,30
1650135903833,MATH 103A,B01,083779,Staff,0,9,30,30
1650135903833,MATH 103A,B02,083780,Staff,0,6,30,30
1650135909857,MATH 105,A01,085443,Staff,0,13,30,30
1650135915881,MATH 109,A01,083213,Anzaldo; Leesa B,0,3,30,30
1650135915881,MATH 109,A02,083214,Anzaldo; Leesa B,0,5,30,30
1650135915881,MATH 109,B01,083215,Anzaldo; Leesa B,0,4,30,30
1650135915881,MATH 109,B02,083216,Anzaldo; Leesa B,0,4,30,30
1650135921910,MATH 142A,A01,083219,Chow; Bennett,0,11,30,30
1650135921910,MATH 142A,A02,083220,Chow; Bennett,0,10,30,30
1650135921910,MATH 142A,B01,083221,Chow; Bennett,0,10,30,30
1650135921910,MATH 142A,B02,083222,Chow; Bennett,0,10,30,30
1650135927935,MATH 193A,A01,083224,Staff,0,3,30,30
1650135927935,MATH 193A,A02,083225,Staff,0,4,30,30
1650135927935,MATH 193A,A03,083781,Staff,0,0,30,30
1650135927935,MATH 193A,A04,083782,Staff,0,0,30,30
1650135933957,MATH 197,001,091859,McAuley; Julian John,9998,0,9999,1
1650135940006,COGS 9,A01,083615,Staff,0,14,60,60
1650135946034,COGS 11,A01,083617,Boyle; Mary E. T.,24,0,40,16
1650135952060,COGS 13,A01,083071,Staff,0,28,40,40
1650135958087,COGS 14A,A01,092681,Staff,0,10,100,100
1650135964110,COGS 14B,A01,083073,Cheng; Tzu-Han,0,4,50,50
1650135970137,COGS 17,A01,092677,Staff,34,0,75,41
1650135976164,COGS 100,A01,083619,Staff,0,21,60,60
1650135982187,COGS 101A,A01,083621,Davis; Joshua Daniel,0,18,60,60
1650135988221,COGS 101B,A01,091572,Staff,10,0,60,50
1650135994264,COGS 101C,A01,083625,Delgado; Tania,22,0,30,8
1650136000288,COGS 107A,A01,083627,Boyle; Mary E. T.,0,5,60,60
1650136006310,COGS 118A,A01,083075,Staff,17,0,60,43
1650136012335,CSE 3,A50,083646,Miranda; Gregory Joseph,22,0,38,16
1650136012335,CSE 3,A51,083647,Miranda; Gregory Joseph,37,0,37,0
1650136018363,CSE 8A,A50,083650,Miranda; Gregory Joseph,0,16,40,40
1650136024387,CSE 11,A01,083080,Cao; Yingjun,0,66,40,40
1650136030415,CSE 12,A01,083652,Staff,0,2,100,100
1650136036449,CSE 15L,A01,083654,Staff,0,0,50,50
1650136036449,CSE 15L,A02,083655,Staff,10,0,50,40
1650136042471,CSE 20,A01,083657,Staff,56,0,80,24
1650136048493,CSE 30,A01,083084,Eldon; John,0,63,40,40
1650136054520,CSE 100,A01,083659,Cao; Yingjun,0,61,50,50
1650136060544,CSE 134B,A01,083661,Powell; Thomas Allan,0,27,65,65
1650136066580,CSE 140,A01,083663,Staff,4,0,75,71
1650136072601,CSE 140L,A01,083088,Eldon; John,0,1,75,75
1650136078627,CSE 175,A01,083665,Kumar; Rakesh,8,0,25,17
1650136084662,CSE 190,A00,092507,Dubnov; Shlomo,14,0,20,6
1650136090691,ECE 45,A01,083139,Staff,0,13,40,40
1650136096718,ECE 65,A50,083695,Staff,0,4,30,30
1650136102744,ECE 109,A01,091882,Touri; Behrouz,48,0,70,22
1650136108769,ECE 180,A00,083140,Abi Samra; Nicholas Camill,24,0,30,6
1650136108769,ECE 180,B00,083141,Abi Samra; Nicholas Camill,8,0,30,22
1650136114795,MATH 10A,A01,083735,Patchell; Gregory David,12,0,30,18
1650136114795,MATH 10A,A02,083736,Patchell; Gregory David,28,0,30,2
1650136114795,MATH 10A,A03,083737,Patchell; Gregory David,26,0,30,4
1650136120819,MATH 10B,A01,083207,Staff,0,5,30,30
1650136120819,MATH 10B,A02,083208,Staff,0,4,30,30
1650136120819,MATH 10B,B01,083739,Staff,18,0,30,12
1650136120819,MATH 10B,B02,083740,Staff,29,0,30,1
1650136126848,MATH 18,A01,083743,Staff,10,0,30,20
1650136126848,MATH 18,A02,083744,Staff,28,0,30,2
1650136126848,MATH 18,A03,083745,Staff,23,0,30,7
1650136126848,MATH 18,A04,083746,Staff,27,0,30,3
1650136126848,MATH 18,B01,083748,Staff,0,9,30,30
1650136126848,MATH 18,B02,083749,Staff,0,7,30,30
1650136126848,MATH 18,B03,083750,Staff,0,6,30,30
1650136126848,MATH 18,B04,083751,Staff,0,7,30,30
1650136132877,MATH 20A,A01,083754,Staff,26,0,40,14
1650136138902,MATH 20B,A01,083756,Staff,0,5,30,30
1650136138902,MATH 20B,A02,083757,Staff,0,4,30,30
1650136144930,MATH 20C,A01,083760,Staff,0,11,30,30
1650136144930,MATH 20C,A02,083761,Staff,0,12,30,30
1650136144930,MATH 20C,B01,083762,Staff,14,0,30,16
1650136144930,MATH 20C,B02,083763,Staff,28,0,30,2
1650136150955,MATH 20D,A01,083765,Staff,0,2,30,30
1650136150955,MATH 20D,A02,083766,Staff,11,0,30,19
1650136150955,MATH 20D,A03,083767,Staff,28,0,30,2
1650136156981,MATH 20E,A01,083771,Staff,8,0,30,22
1650136156981,MATH 20E,A02,083772,Staff,20,0,30,10
1650136156981,MATH 20E,B01,083773,Staff,0,0,30,30
1650136156981,MATH 20E,B02,083774,Staff,13,0,30,17
1650136163012,MATH 103A,A01,083777,Staff,0,8,30,30
1650136163012,MATH 103A,A02,083778,Staff,0,8,30,30
1650136163012,MATH 103A,B01,083779,Staff,0,9,30,30
1650136163012,MATH 103A,B02,083780,Staff,0,6,30,30
1650136169038,MATH 105,A01,085443,Staff,0,13,30,30
1650136175065,MATH 109,A01,083213,Anzaldo; Leesa B,0,3,30,30
1650136175065,MATH 109,A02,083214,Anzaldo; Leesa B,0,5,30,30
1650136175065,MATH 109,B01,083215,Anzaldo; Leesa B,0,4,30,30
1650136175065,MATH 109,B02,083216,Anzaldo; Leesa B,0,4,30,30
1650136181093,MATH 142A,A01,083219,Chow; Bennett,0,11,30,30
1650136181093,MATH 142A,A02,083220,Chow; Bennett,0,10,30,30
1650136181093,MATH 142A,B01,083221,Chow; Bennett,0,10,30,30
1650136181093,MATH 142A,B02,083222,Chow; Bennett,0,10,30,30
1650136187118,MATH 193A,A01,083224,Staff,0,3,30,30
1650136187118,MATH 193A,A02,083225,Staff,0,4,30,30
1650136187118,MATH 193A,A03,083781,Staff,0,0,30,30
1650136187118,MATH 193A,A04,083782,Staff,0,0,30,30
1650136193145,MATH 197,001,091859,McAuley; Julian John,9998,0,9999,1
1650136199201,COGS 9,A01,083615,Staff,0,14,60,60
1650136205225,COGS 11,A01,083617,Boyle; Mary E. T.,24,0,40,16
1650136211250,COGS 13,A01,083071,Staff,0,28,40,40
1650136217276,COGS 14A,A01,092681,Staff,0,10,100,100
1650136223298,COGS 14B,A01,083073,Cheng; Tzu-Han,0,4,50,50
1650136229322,COGS 17,A01,092677,Staff,34,0,75,41
1650136235347,COGS 100,A01,083619,Staff,0,21,60,60
1650136241374,COGS 101A,A01,083621,Davis; Joshua Daniel,0,18,60,60
1650136247397,COGS 101B,A01,091572,Staff,10,0,60,50
1650136253420,COGS 101C,A01,083625,Delgado; Tania,22,0,30,8
1650136259444,COGS 107A,A01,083627,Boyle; Mary E. T.,0,5,60,60
1650136265467,COGS 118A,A01,083075,Staff,17,0,60,43
1650136271494,CSE 3,A50,083646,Miranda; Gregory Joseph,22,0,38,16
1650136271494,CSE 3,A51,083647,Miranda; Gregory Joseph,37,0,37,0
1650136277521,CSE 8A,A50,083650,Miranda; Gregory Joseph,0,16,40,40
1650136283547,CSE 11,A01,083080,Cao; Yingjun,0,66,40,40
1650136289571,CSE 12,A01,083652,Staff,0,2,100,100
1650136295597,CSE 15L,A01,083654,Staff,0,0,50,50
1650136295597,CSE 15L,A02,083655,Staff,10,0,50,40
1650136301635,CSE 20,A01,083657,Staff,56,0,80,24
1650136307661,CSE 30,A01,083084,Eldon; John,0,63,40,40
1650136313689,CSE 100,A01,083659,Cao; Yingjun,0,61,50,50
1650136319712,CSE 134B,A01,083661,Powell; Thomas Allan,0,27,65,65
1650136325749,CSE 140,A01,083663,Staff,4,0,75,71
1650136331858,CSE 140L,A01,083088,Eldon; John,0,1,75,75
1650136337884,CSE 175,A01,083665,Kumar; Rakesh,8,0,25,17
1650136343909,CSE 190,A00,092507,Dubnov; Shlomo,14,0,20,6
1650136349933,ECE 45,A01,083139,Staff,0,13,40,40
1650136355956,ECE 65,A50,083695,Staff,0,4,30,30
1650136361990,ECE 109,A01,091882,Touri; Behrouz,48,0,70,22
1650136368024,ECE 180,A00,083140,Abi Samra; Nicholas Camill,24,0,30,6
1650136368024,ECE 180,B00,083141,Abi Samra; Nicholas Camill,8,0,30,22
1650136374052,MATH 10A,A01,083735,Patchell; Gregory David,12,0,30,18
1650136374052,MATH 10A,A02,083736,Patchell; Gregory David,28,0,30,2
1650136374052,MATH 10A,A03,083737,Patchell; Gregory David,26,0,30,4
1650136380076,MATH 10B,A01,083207,Staff,0,5,30,30
1650136380076,MATH 10B,A02,083208,Staff,0,4,30,30
1650136380076,MATH 10B,B01,083739,Staff,18,0,30,12
1650136380076,MATH 10B,B02,083740,Staff,29,0,30,1
1650136386101,MATH 18,A01,083743,Staff,10,0,30,20
1650136386101,MATH 18,A02,083744,Staff,28,0,30,2
1650136386101,MATH 18,A03,083745,Staff,23,0,30,7
1650136386101,MATH 18,A04,083746,Staff,27,0,30,3
1650136386101,MATH 18,B01,083748,Staff,0,9,30,30
1650136386101,MATH 18,B02,083749,Staff,0,7,30,30
1650136386101,MATH 18,B03,083750,Staff,0,6,30,30
1650136386101,MATH 18,B04,083751,Staff,0,7,30,30
1650136392125,MATH 20A,A01,083754,Staff,26,0,40,14
1650136398147,MATH 20B,A01,083756,Staff,0,5,30,30
1650136398147,MATH 20B,A02,083757,Staff,0,4,30,30
1650136404171,MATH 20C,A01,083760,Staff,0,11,30,30
1650136404171,MATH 20C,A02,083761,Staff,0,12,30,30
1650136404171,MATH 20C,B01,083762,Staff,14,0,30,16
1650136404171,MATH 20C,B02,083763,Staff,28,0,30,2
1650136410194,MATH 20D,A01,083765,Staff,0,2,30,30
1650136410194,MATH 20D,A02,083766,Staff,11,0,30,19
1650136410194,MATH 20D,A03,083767,Staff,28,0,30,2
1650136416218,MATH 20E,A01,083771,Staff,8,0,30,22
1650136416218,MATH 20E,A02,083772,Staff,20,0,30,10
1650136416218,MATH 20E,B01,083773,Staff,0,0,30,30
1650136416218,MATH 20E,B02,083774,Staff,13,0,30,17
1650136422246,MATH 103A,A01,083777,Staff,0,8,30,30
1650136422246,MATH 103A,A02,083778,Staff,0,8,30,30
1650136422246,MATH 103A,B01,083779,Staff,0,9,30,30
1650136422246,MATH 103A,B02,083780,Staff,0,6,30,30
1650136428272,MATH 105,A01,085443,Staff,0,13,30,30
1650136434304,MATH 109,A01,083213,Anzaldo; Leesa B,0,3,30,30
1650136434304,MATH 109,A02,083214,Anzaldo; Leesa B,0,5,30,30
1650136434304,MATH 109,B01,083215,Anzaldo; Leesa B,0,4,30,30
1650136434304,MATH 109,B02,083216,Anzaldo; Leesa B,0,4,30,30
1650136440334,MATH 142A,A01,083219,Chow; Bennett,0,11,30,30
1650136440334,MATH 142A,A02,083220,Chow; Bennett,0,10,30,30
1650136440334,MATH 142A,B01,083221,Chow; Bennett,0,10,30,30
1650136440334,MATH 142A,B02,083222,Chow; Bennett,0,10,30,30
1650136446358,MATH 193A,A01,083224,Staff,0,3,30,30
1650136446358,MATH 193A,A02,083225,Staff,0,4,30,30
1650136446358,MATH 193A,A03,083781,Staff,0,0,30,30
1650136446358,MATH 193A,A04,083782,Staff,0,0,30,30
1650136452381,MATH 197,001,091859,McAuley; Julian John,9998,0,9999,1
1650136458434,COGS 9,A01,083615,Staff,0,14,60,60
1650136464456,COGS 11,A01,083617,Boyle; Mary E. T.,24,0,40,16
1650136470479,COGS 13,A01,083071,Staff,0,28,40,40
1650136476503,COGS 14A,A01,092681,Staff,0,10,100,100
1650136482541,COGS 14B,A01,083073,Cheng; Tzu-Han,0,4,50,50
1650136488565,COGS 17,A01,092677,Staff,34,0,75,41
1650136494589,COGS 100,A01,083619,Staff,0,21,60,60
1650136500628,COGS 101A,A01,083621,Davis; Joshua Daniel,0,18,60,60
1650136506658,COGS 101B,A01,091572,Staff,10,0,60,50
1650136512681,COGS 101C,A01,083625,Delgado; Tania,22,0,30,8
1650136518709,COGS 107A,A01,083627,Boyle; Mary E. T.,0,5,60,60
1650136524733,COGS 118A,A01,083075,Staff,17,0,60,43
1650136530759,CSE 3,A50,083646,Miranda; Gregory Joseph,22,0,38,16
1650136530759,CSE 3,A51,083647,Miranda; Gregory Joseph,37,0,37,0
1650136536783,CSE 8A,A50,083650,Miranda; Gregory Joseph,0,16,40,40
1650136542817,CSE 11,A01,083080,Cao; Yingjun,0,66,40,40
1650136548844,CSE 12,A01,083652,Staff,0,2,100,100
1650136554868,CSE 15L,A01,083654,Staff,0,0,50,50
1650136554868,CSE 15L,A02,083655,Staff,10,0,50,40
1650136560902,CSE 20,A01,083657,Staff,56,0,80,24
1650136566923,CSE 30,A01,083084,Eldon; John,0,63,40,40
1650136572950,CSE 100,A01,083659,Cao; Yingjun,0,61,50,50
1650136578972,CSE 134B,A01,083661,Powell; Thomas Allan,0,27,65,65
1650136584994,CSE 140,A01,083663,Staff,4,0,75,71
1650136591017,CSE 140L,A01,083088,Eldon; John,0,1,75,75
1650136597042,CSE 175,A01,083665,Kumar; Rakesh,8,0,25,17
1650136603065,CSE 190,A00,092507,Dubnov; Shlomo,14,0,20,6
1650136609090,ECE 45,A01,083139,Staff,0,13,40,40
1650136615114,ECE 65,A50,083695,Staff,0,4,30,30
1650136621143,ECE 109,A01,091882,Touri; Behrouz,48,0,70,22
1650136627171,ECE 180,A00,083140,Abi Samra; Nicholas Camill,24,0,30,6
1650136627171,ECE 180,B00,083141,Abi Samra; Nicholas Camill,8,0,30,22
1650136633199,MATH 10A,A01,083735,Patchell; Gregory David,12,0,30,18
1650136633199,MATH 10A,A02,083736,Patchell; Gregory David,28,0,30,2
1650136633199,MATH 10A,A03,083737,Patchell; Gregory David,26,0,30,4
1650136639228,MATH 10B,A01,083207,Staff,0,5,30,30
1650136639228,MATH 10B,A02,083208,Staff,0,4,30,30
1650136639228,MATH 10B,B01,083739,Staff,18,0,30,12
1650136639228,MATH 10B,B02,083740,Staff,29,0,30,1
1650136645259,MATH 18,A01,083743,Staff,10,0,30,20
1650136645259,MATH 18,A02,083744,Staff,28,0,30,2
1650136645259,MATH 18,A03,083745,Staff,23,0,30,7
1650136645259,MATH 18,A04,083746,Staff,27,0,30,3
1650136645259,MATH 18,B01,083748,Staff,0,9,30,30
1650136645259,MATH 18,B02,083749,Staff,0,7,30,30
1650136645259,MATH 18,B03,083750,Staff,0,6,30,30
1650136645259,MATH 18,B04,083751,Staff,0,7,30,30
1650136651282,MATH 20A,A01,083754,Staff,26,0,40,14
1650136657310,MATH 20B,A01,083756,Staff,0,5,30,30
1650136657310,MATH 20B,A02,083757,Staff,0,4,30,30
1650136663341,MATH 20C,A01,083760,Staff,0,11,30,30
1650136663341,MATH 20C,A02,083761,Staff,0,12,30,30
1650136663341,MATH 20C,B01,083762,Staff,14,0,30,16
1650136663341,MATH 20C,B02,083763,Staff,28,0,30,2
1650136669381,MATH 20D,A01,083765,Staff,0,3,30,30
1650136669381,MATH 20D,A02,083766,Staff,11,0,30,19
1650136669381,MATH 20D,A03,083767,Staff,28,0,30,2
1650136675407,MATH 20E,A01,083771,Staff,8,0,30,22
1650136675407,MATH 20E,A02,083772,Staff,20,0,30,10
1650136675407,MATH 20E,B01,083773,Staff,0,0,30,30
1650136675407,MATH 20E,B02,083774,Staff,13,0,30,17
1650136681432,MATH 103A,A01,083777,Staff,0,8,30,30
1650136681432,MATH 103A,A02,083778,Staff,0,8,30,30
1650136681432,MATH 103A,B01,083779,Staff,0,9,30,30
1650136681432,MATH 103A,B02,083780,Staff,0,6,30,30
1650136687455,MATH 105,A01,085443,Staff,0,13,30,30
1650136693484,MATH 109,A01,083213,Anzaldo; Leesa B,0,3,30,30
1650136693484,MATH 109,A02,083214,Anzaldo; Leesa B,0,5,30,30
1650136693484,MATH 109,B01,083215,Anzaldo; Leesa B,0,4,30,30
1650136693484,MATH 109,B02,083216,Anzaldo; Leesa B,0,4,30,30
1650136699515,MATH 142A,A01,083219,Chow; Bennett,0,11,30,30
1650136699515,MATH 142A,A02,083220,Chow; Bennett,0,10,30,30
1650136699515,MATH 142A,B01,083221,Chow; Bennett,0,10,30,30
1650136699515,MATH 142A,B02,083222,Chow; Bennett,0,10,30,30
1650136705543,MATH 193A,A01,083224,Staff,0,3,30,30
1650136705543,MATH 193A,A02,083225,Staff,0,4,30,30
1650136705543,MATH 193A,A03,083781,Staff,0,0,30,30
1650136705543,MATH 193A,A04,083782,Staff,0,0,30,30
1650136711566,MATH 197,001,091859,McAuley; Julian John,9998,0,9999,1
1650136717619,COGS 9,A01,083615,Staff,0,14,60,60
1650136723642,COGS 11,A01,083617,Boyle; Mary E. T.,24,0,40,16
1650136729674,COGS 13,A01,083071,Staff,0,28,40,40
1650136735705,COGS 14A,A01,092681,Staff,0,10,100,100
1650136741731,COGS 14B,A01,083073,Cheng; Tzu-Han,0,4,50,50
1650136747754,COGS 17,A01,092677,Staff,34,0,75,41
1650136753779,COGS 100,A01,083619,Staff,0,21,60,60
1650136759803,COGS 101A,A01,083621,Davis; Joshua Daniel,0,18,60,60
1650136765825,COGS 101B,A01,091572,Staff,10,0,60,50
1650136771851,COGS 101C,A01,083625,Delgado; Tania,22,0,30,8
1650136777873,COGS 107A,A01,083627,Boyle; Mary E. T.,0,5,60,60
1650136783897,COGS 118A,A01,083075,Staff,17,0,60,43
1650136789924,CSE 3,A50,083646,Miranda; Gregory Joseph,22,0,38,16
1650136789924,CSE 3,A51,083647,Miranda; Gregory Joseph,37,0,37,0
1650136795949,CSE 8A,A50,083650,Miranda; Gregory Joseph,0,16,40,40
1650136801975,CSE 11,A01,083080,Cao; Yingjun,0,66,40,40
1650136808006,CSE 12,A01,083652,Staff,0,2,100,100
1650136814029,CSE 15L,A01,083654,Staff,0,0,50,50
1650136814029,CSE 15L,A02,083655,Staff,10,0,50,40
1650136820054,CSE 20,A01,083657,Staff,56,0,80,24
1650136826078,CSE 30,A01,083084,Eldon; John,0,63,40,40
1650136832103,CSE 100,A01,083659,Cao; Yingjun,0,61,50,50
1650136838142,CSE 134B,A01,083661,Powell; Thomas Allan,0,27,65,65
1650136844170,CSE 140,A01,083663,Staff,4,0,75,71
1650136850195,CSE 140L,A01,083088,Eldon; John,0,1,75,75
1650136856221,CSE 175,A01,083665,Kumar; Rakesh,8,0,25,17
1650136862245,CSE 190,A00,092507,Dubnov; Shlomo,14,0,20,6
1650136868275,ECE 45,A01,083139,Staff,0,13,40,40
1650136874300,ECE 65,A50,083695,Staff,0,4,30,30
1650136880327,ECE 109,A01,091882,Touri; Behrouz,48,0,70,22
1650136886351,ECE 180,A00,083140,Abi Samra; Nicholas Camill,24,0,30,6
1650136886351,ECE 180,B00,083141,Abi Samra; Nicholas Camill,8,0,30,22
1650136892379,MATH 10A,A01,083735,Patchell; Gregory David,12,0,30,18
1650136892379,MATH 10A,A02,083736,Patchell; Gregory David,28,0,30,2
1650136892379,MATH 10A,A03,083737,Patchell; Gregory David,26,0,30,4
1650136898403,MATH 10B,A01,083207,Staff,0,5,30,30
1650136898403,MATH 10B,A02,083208,Staff,0,4,30,30
1650136898403,MATH 10B,B01,083739,Staff,18,0,30,12
1650136898403,MATH 10B,B02,083740,Staff,29,0,30,1
1650136904439,MATH 18,A01,083743,Staff,10,0,30,20
1650136904439,MATH 18,A02,083744,Staff,28,0,30,2
1650136904439,MATH 18,A03,083745,Staff,23,0,30,7
1650136904439,MATH 18,A04,083746,Staff,27,0,30,3
1650136904439,MATH 18,B01,083748,Staff,0,9,30,30
1650136904439,MATH 18,B02,083749,Staff,0,7,30,30
1650136904439,MATH 18,B03,083750,Staff,0,6,30,30
1650136904439,MATH 18,B04,083751,Staff,0,7,30,30
1650136910462,MATH 20A,A01,083754,Staff,26,0,40,14
1650136916485,MATH 20B,A01,083756,Staff,0,5,30,30
1650136916485,MATH 20B,A02,083757,Staff,0,4,30,30
1650136922513,MATH 20C,A01,083760,Staff,0,11,30,30
1650136922513,MATH 20C,A02,083761,Staff,0,12,30,30
1650136922513,MATH 20C,B01,083762,Staff,14,0,30,16
1650136922513,MATH 20C,B02,083763,Staff,28,0,30,2
1650136928609,MATH 20D,A01,083765,Staff,0,2,30,30
1650136928609,MATH 20D,A02,083766,Staff,11,0,30,19
1650136928609,MATH 20D,A03,083767,Staff,28,0,30,2
1650136934639,MATH 20E,A01,083771,Staff,8,0,30,22
1650136934639,MATH 20E,A02,083772,Staff,20,0,30,10
1650136934639,MATH 20E,B01,083773,Staff,0,0,30,30
1650136934639,MATH 20E,B02,083774,Staff,13,0,30,17
1650136940664,MATH 103A,A01,083777,Staff,0,8,30,30
1650136940664,MATH 103A,A02,083778,Staff,0,8,30,30
1650136940664,MATH 103A,B01,083779,Staff,0,9,30,30
1650136940664,MATH 103A,B02,083780,Staff,0,6,30,30
1650136946691,MATH 105,A01,085443,Staff,0,13,30,30
1650136952716,MATH 109,A01,083213,Anzaldo; Leesa B,0,3,30,30
1650136952716,MATH 109,A02,083214,Anzaldo; Leesa B,0,5,30,30
1650136952716,MATH 109,B01,083215,Anzaldo; Leesa B,0,4,30,30
1650136952716,MATH 109,B02,083216,Anzaldo; Leesa B,0,4,30,30
1650136958745,MATH 142A,A01,083219,Chow; Bennett,0,11,30,30
1650136958745,MATH 142A,A02,083220,Chow; Bennett,0,10,30,30
1650136958745,MATH 142A,B01,083221,Chow; Bennett,0,10,30,30
1650136958745,MATH 142A,B02,083222,Chow; Bennett,0,10,30,30
1650136964772,MATH 193A,A01,083224,Staff,0,3,30,30
1650136964772,MATH 193A,A02,083225,Staff,0,4,30,30
1650136964772,MATH 193A,A03,083781,Staff,0,0,30,30
1650136964772,MATH 193A,A04,083782,Staff,0,0,30,30
1650136970803,MATH 197,001,091859,McAuley; Julian John,9998,0,9999,1
1650136976866,COGS 9,A01,083615,Staff,0,14,60,60
1650136982890,COGS 11,A01,083617,Boyle; Mary E. T.,24,0,40,16
1650136988916,COGS 13,A01,083071,Staff,0,28,40,40
1650136994939,COGS 14A,A01,092681,Staff,0,10,100,100
1650137000964,COGS 14B,A01,083073,Cheng; Tzu-Han,0,4,50,50
1650137006988,COGS 17,A01,092677,Staff,34,0,75,41
1650137013010,COGS 100,A01,083619,Staff,0,21,60,60
1650137019045,COGS 101A,A01,083621,Davis; Joshua Daniel,0,18,60,60
1650137025068,COGS 101B,A01,091572,Staff,10,0,60,50
1650137031093,COGS 101C,A01,083625,Delgado; Tania,22,0,30,8
1650137037118,COGS 107A,A01,083627,Boyle; Mary E. T.,0,5,60,60
1650137043143,COGS 118A,A01,083075,Staff,17,0,60,43
1650137049166,CSE 3,A50,083646,Miranda; Gregory Joseph,22,0,38,16
1650137049166,CSE 3,A51,083647,Miranda; Gregory Joseph,37,0,37,0
1650137055205,CSE 8A,A50,083650,Miranda; Gregory Joseph,0,16,40,40
1650137061229,CSE 11,A01,083080,Cao; Yingjun,0,66,40,40
1650137067265,CSE 12,A01,083652,Staff,0,2,100,100
1650137073289,CSE 15L,A01,083654,Staff,0,0,50,50
1650137073289,CSE 15L,A02,083655,Staff,10,0,50,40
1650137079313,CSE 20,A01,083657,Staff,56,0,80,24
1650137085340,CSE 30,A01,083084,Eldon; John,0,63,40,40
1650137091372,CSE 100,A01,083659,Cao; Yingjun,0,61,50,50
1650137097404,CSE 134B,A01,083661,Powell; Thomas Allan,0,27,65,65
1650137103432,CSE 140,A01,083663,Staff,4,0,75,71
1650137109456,CSE 140L,A01,083088,Eldon; John,0,1,75,75
1650137115479,CSE 175,A01,083665,Kumar; Rakesh,8,0,25,17
1650137121506,CSE 190,A00,092507,Dubnov; Shlomo,14,0,20,6
1650137127528,ECE 45,A01,083139,Staff,0,13,40,40
1650137133554,ECE 65,A50,083695,Staff,0,4,30,30
1650137139578,ECE 109,A01,091882,Touri; Behrouz,48,0,70,22
1650137145607,ECE 180,A00,083140,Abi Samra; Nicholas Camill,24,0,30,6
1650137145607,ECE 180,B00,083141,Abi Samra; Nicholas Camill,8,0,30,22
1650137151635,MATH 10A,A01,083735,Patchell; Gregory David,12,0,30,18
1650137151635,MATH 10A,A02,083736,Patchell; Gregory David,28,0,30,2
1650137151635,MATH 10A,A03,083737,Patchell; Gregory David,26,0,30,4
1650137157662,MATH 10B,A01,083207,Staff,0,5,30,30
1650137157662,MATH 10B,A02,083208,Staff,0,4,30,30
1650137157662,MATH 10B,B01,083739,Staff,18,0,30,12
1650137157662,MATH 10B,B02,083740,Staff,29,0,30,1
1650137163688,MATH 18,A01,083743,Staff,10,0,30,20
1650137163688,MATH 18,A02,083744,Staff,28,0,30,2
1650137163688,MATH 18,A03,083745,Staff,23,0,30,7
1650137163688,MATH 18,A04,083746,Staff,27,0,30,3
1650137163688,MATH 18,B01,083748,Staff,0,9,30,30
1650137163688,MATH 18,B02,083749,Staff,0,7,30,30
1650137163688,MATH 18,B03,083750,Staff,0,6,30,30
1650137163688,MATH 18,B04,083751,Staff,0,7,30,30
1650137169712,MATH 20A,A01,083754,Staff,26,0,40,14
1650137175741,MATH 20B,A01,083756,Staff,0,5,30,30
1650137175741,MATH 20B,A02,083757,Staff,0,4,30,30
1650137181764,MATH 20C,A01,083760,Staff,0,11,30,30
1650137181764,MATH 20C,A02,083761,Staff,0,12,30,30
1650137181764,MATH 20C,B01,083762,Staff,14,0,30,16
1650137181764,MATH 20C,B02,083763,Staff,28,0,30,2
1650137187787,MATH 20D,A01,083765,Staff,0,2,30,30
1650137187787,MATH 20D,A02,083766,Staff,11,0,30,19
1650137187787,MATH 20D,A03,083767,Staff,28,0,30,2
1650137193809,MATH 20E,A01,083771,Staff,8,0,30,22
1650137193809,MATH 20E,A02,083772,Staff,20,0,30,10
1650137193809,MATH 20E,B01,083773,Staff,0,0,30,30
1650137193809,MATH 20E,B02,083774,Staff,13,0,30,17
1650137199836,MATH 103A,A01,083777,Staff,0,8,30,30
1650137199836,MATH 103A,A02,083778,Staff,0,8,30,30
1650137199836,MATH 103A,B01,083779,Staff,0,9,30,30
1650137199836,MATH 103A,B02,083780,Staff,0,6,30,30
1650137205867,MATH 105,A01,085443,Staff,0,13,30,30
1650137211892,MATH 109,A01,083213,Anzaldo; Leesa B,0,3,30,30
1650137211892,MATH 109,A02,083214,Anzaldo; Leesa B,0,5,30,30
1650137211892,MATH 109,B01,083215,Anzaldo; Leesa B,0,4,30,30
1650137211892,MATH 109,B02,083216,Anzaldo; Leesa B,0,4,30,30
1650137217917,MATH 142A,A01,083219,Chow; Bennett,0,11,30,30
1650137217917,MATH 142A,A02,083220,Chow; Bennett,0,10,30,30
1650137217917,MATH 142A,B01,083221,Chow; Bennett,0,10,30,30
1650137217917,MATH 142A,B02,083222,Chow; Bennett,0,11,30,30
1650137223972,MATH 193A,A01,083224,Staff,0,3,30,30
1650137223972,MATH 193A,A02,083225,Staff,0,4,30,30
1650137223972,MATH 193A,A03,083781,Staff,0,0,30,30
1650137223972,MATH 193A,A04,083782,Staff,0,0,30,30
1650137229997,MATH 197,001,091859,McAuley; Julian John,9998,0,9999,1
1650137236049,COGS 9,A01,083615,Staff,0,14,60,60
1650137242072,COGS 11,A01,083617,Boyle; Mary E. T.,24,0,40,16
1650137248099,COGS 13,A01,083071,Staff,0,28,40,40
1650137254122,COGS 14A,A01,092681,Staff,0,10,100,100
1650137260144,COGS 14B,A01,083073,Cheng; Tzu-Han,0,4,50,50
1650137266168,COGS 17,A01,092677,Staff,34,0,75,41
1650137272192,COGS 100,A01,083619,Staff,0,21,60,60
1650137278215,COGS 101A,A01,083621,Davis; Joshua Daniel,0,18,60,60
1650137284237,COGS 101B,A01,091572,Staff,10,0,60,50
1650137290261,COGS 101C,A01,083625,Delgado; Tania,22,0,30,8
1650137296286,COGS 107A,A01,083627,Boyle; Mary E. T.,0,5,60,60
1650137302320,COGS 118A,A01,083075,Staff,17,0,60,43
1650137308343,CSE 3,A50,083646,Miranda; Gregory Joseph,22,0,38,16
1650137308343,CSE 3,A51,083647,Miranda; Gregory Joseph,37,0,37,0
1650137314371,CSE 8A,A50,083650,Miranda; Gregory Joseph,0,16,40,40
1650137320398,CSE 11,A01,083080,Cao; Yingjun,0,66,40,40
1650137326432,CSE 12,A01,083652,Staff,0,2,100,100
1650137332459,CSE 15L,A01,083654,Staff,0,0,50,50
1650137332459,CSE 15L,A02,083655,Staff,10,0,50,40
1650137338486,CSE 20,A01,083657,Staff,56,0,80,24
1650137344512,CSE 30,A01,083084,Eldon; John,0,63,40,40
1650137350539,CSE 100,A01,083659,Cao; Yingjun,0,61,50,50
1650137356562,CSE 134B,A01,083661,Powell; Thomas Allan,0,27,65,65
1650137362584,CSE 140,A01,083663,Staff,4,0,75,71
1650137368609,CSE 140L,A01,083088,Eldon; John,0,1,75,75
1650137374634,CSE 175,A01,083665,Kumar; Rakesh,8,0,25,17
1650137380659,CSE 190,A00,092507,Dubnov; Shlomo,14,0,20,6
1650137386683,ECE 45,A01,083139,Staff,0,13,40,40
1650137392707,ECE 65,A50,083695,Staff,0,4,30,30
1650137398730,ECE 109,A01,091882,Touri; Behrouz,48,0,70,22
1650137404753,ECE 180,A00,083140,Abi Samra; Nicholas Camill,24,0,30,6
1650137404753,ECE 180,B00,083141,Abi Samra; Nicholas Camill,8,0,30,22
1650137410777,MATH 10A,A01,083735,Patchell; Gregory David,12,0,30,18
1650137410777,MATH 10A,A02,083736,Patchell; Gregory David,28,0,30,2
1650137410777,MATH 10A,A03,083737,Patchell; Gregory David,26,0,30,4
1650137416800,MATH 10B,A01,083207,Staff,0,5,30,30
1650137416800,MATH 10B,A02,083208,Staff,0,4,30,30
1650137416800,MATH 10B,B01,083739,Staff,18,0,30,12
1650137416800,MATH 10B,B02,083740,Staff,29,0,30,1
1650137422826,MATH 18,A01,083743,Staff,10,0,30,20
1650137422826,MATH 18,A02,083744,Staff,28,0,30,2
1650137422826,MATH 18,A03,083745,Staff,23,0,30,7
1650137422826,MATH 18,A04,083746,Staff,27,0,30,3
1650137422826,MATH 18,B01,083748,Staff,0,9,30,30
1650137422826,MATH 18,B02,083749,Staff,0,7,30,30
1650137422826,MATH 18,B03,083750,Staff,0,6,30,30
1650137422826,MATH 18,B04,083751,Staff,0,7,30,30
1650137428849,MATH 20A,A01,083754,Staff,26,0,40,14
1650137434872,MATH 20B,A01,083756,Staff,0,5,30,30
1650137434872,MATH 20B,A02,083757,Staff,0,4,30,30
1650137440899,MATH 20C,A01,083760,Staff,0,11,30,30
1650137440899,MATH 20C,A02,083761,Staff,0,12,30,30
1650137440899,MATH 20C,B01,083762,Staff,14,0,30,16
1650137440899,MATH 20C,B02,083763,Staff,28,0,30,2
1650137446924,MATH 20D,A01,083765,Staff,0,2,30,30
1650137446924,MATH 20D,A02,083766,Staff,11,0,30,19
1650137446924,MATH 20D,A03,083767,Staff,28,0,30,2
1650137452949,MATH 20E,A01,083771,Staff,8,0,30,22
1650137452949,MATH 20E,A02,083772,Staff,20,0,30,10
1650137452949,MATH 20E,B01,083773,Staff,0,0,30,30
1650137452949,MATH 20E,B02,083774,Staff,13,0,30,17
1650137458973,MATH 103A,A01,083777,Staff,0,8,30,30
1650137458973,MATH 103A,A02,083778,Staff,0,8,30,30
1650137458973,MATH 103A,B01,083779,Staff,0,9,30,30
1650137458973,MATH 103A,B02,083780,Staff,0,6,30,30
1650137464997,MATH 105,A01,085443,Staff,0,13,30,30
1650137471019,MATH 109,A01,083213,Anzaldo; Leesa B,0,3,30,30
1650137471019,MATH 109,A02,083214,Anzaldo; Leesa B,0,5,30,30
1650137471019,MATH 109,B01,083215,Anzaldo; Leesa B,0,4,30,30
1650137471019,MATH 109,B02,083216,Anzaldo; Leesa B,0,4,30,30
1650137477043,MATH 142A,A01,083219,Chow; Bennett,0,11,30,30
1650137477043,MATH 142A,A02,083220,Chow; Bennett,0,10,30,30
1650137477043,MATH 142A,B01,083221,Chow; Bennett,0,10,30,30
1650137477043,MATH 142A,B02,083222,Chow; Bennett,0,11,30,30
1650137483066,MATH 193A,A01,083224,Staff,0,3,30,30
1650137483066,MATH 193A,A02,083225,Staff,0,4,30,30
1650137483066,MATH 193A,A03,083781,Staff,0,0,30,30
1650137483066,MATH 193A,A04,083782,Staff,0,0,30,30
1650137489093,MATH 197,001,091859,McAuley; Julian John,9998,0,9999,1
1650137495156,COGS 9,A01,083615,Staff,0,14,60,60
1650137501177,COGS 11,A01,083617,Boyle; Mary E. T.,24,0,40,16
1650137507202,COGS 13,A01,083071,Staff,0,28,40,40
1650137513226,COGS 14A,A01,092681,Staff,0,10,100,100
1650137519321,COGS 14B,A01,083073,Cheng; Tzu-Han,0,4,50,50
1650137525346,COGS 17,A01,092677,Staff,34,0,75,41
1650137531369,COGS 100,A01,083619,Staff,0,21,60,60
1650137537392,COGS 101A,A01,083621,Davis; Joshua Daniel,0,18,60,60
1650137543416,COGS 101B,A01,091572,Staff,10,0,60,50
1650137549441,COGS 101C,A01,083625,Delgado; Tania,22,0,30,8
1650137555463,COGS 107A,A01,083627,Boyle; Mary E. T.,0,5,60,60
1650137561488,COGS 118A,A01,083075,Staff,17,0,60,43
1650137567510,CSE 3,A50,083646,Miranda; Gregory Joseph,22,0,38,16
1650137567510,CSE 3,A51,083647,Miranda; Gregory Joseph,37,0,37,0
1650137573538,CSE 8A,A50,083650,Miranda; Gregory Joseph,0,16,40,40
1650137579560,CSE 11,A01,083080,Cao; Yingjun,0,66,40,40
1650137585584,CSE 12,A01,083652,Staff,0,2,100,100
1650137591610,CSE 15L,A01,083654,Staff,0,0,50,50
1650137591610,CSE 15L,A02,083655,Staff,10,0,50,40
1650137597645,CSE 20,A01,083657,Staff,56,0,80,24
1650137603681,CSE 30,A01,083084,Eldon; John,0,63,40,40
1650137609704,CSE 100,A01,083659,Cao; Yingjun,0,61,50,50
1650137615736,CSE 134B,A01,083661,Powell; Thomas Allan,0,27,65,65
1650137621762,CSE 140,A01,083663,Staff,4,0,75,71
1650137627785,CSE 140L,A01,083088,Eldon; John,0,1,75,75
1650137633809,CSE 175,A01,083665,Kumar; Rakesh,8,0,25,17
1650137639835,CSE 190,A00,092507,Dubnov; Shlomo,14,0,20,6
1650137645863,ECE 45,A01,083139,Staff,0,13,40,40
1650137651886,ECE 65,A50,083695,Staff,0,4,30,30
1650137657913,ECE 109,A01,091882,Touri; Behrouz,48,0,70,22
1650137663935,ECE 180,A00,083140,Abi Samra; Nicholas Camill,24,0,30,6
1650137663935,ECE 180,B00,083141,Abi Samra; Nicholas Camill,8,0,30,22
1650137669958,MATH 10A,A01,083735,Patchell; Gregory David,12,0,30,18
1650137669958,MATH 10A,A02,083736,Patchell; Gregory David,28,0,30,2
1650137669958,MATH 10A,A03,083737,Patchell; Gregory David,26,0,30,4
1650137675980,MATH 10B,A01,083207,Staff,0,5,30,30
1650137675980,MATH 10B,A02,083208,Staff,0,4,30,30
1650137675980,MATH 10B,B01,083739,Staff,18,0,30,12
1650137675980,MATH 10B,B02,083740,Staff,29,0,30,1
1650137682011,MATH 18,A01,083743,Staff,10,0,30,20
1650137682011,MATH 18,A02,083744,Staff,28,0,30,2
1650137682011,MATH 18,A03,083745,Staff,23,0,30,7
1650137682011,MATH 18,A04,083746,Staff,27,0,30,3
1650137682011,MATH 18,B01,083748,Staff,0,9,30,30
1650137682011,MATH 18,B02,083749,Staff,0,7,30,30
1650137682011,MATH 18,B03,083750,Staff,0,6,30,30
1650137682011,MATH 18,B04,083751,Staff,0,7,30,30
1650137688040,MATH 20A,A01,083754,Staff,26,0,40,14
1650137694062,MATH 20B,A01,083756,Staff,0,5,30,30
1650137694062,MATH 20B,A02,083757,Staff,0,4,30,30
1650137700085,MATH 20C,A01,083760,Staff,0,11,30,30
1650137700085,MATH 20C,A02,083761,Staff,0,12,30,30
1650137700085,MATH 20C,B01,083762,Staff,14,0,30,16
1650137700085,MATH 20C,B02,083763,Staff,28,0,30,2
1650137706108,MATH 20D,A01,083765,Staff,0,2,30,30
1650137706108,MATH 20D,A02,083766,Staff,11,0,30,19
1650137706108,MATH 20D,A03,083767,Staff,28,0,30,2
1650137712131,MATH 20E,A01,083771,Staff,8,0,30,22
1650137712131,MATH 20E,A02,083772,Staff,20,0,30,10
1650137712131,MATH 20E,B01,083773,Staff,0,0,30,30
1650137712131,MATH 20E,B02,083774,Staff,13,0,30,17
1650137718154,MATH 103A,A01,083777,Staff,0,8,30,30
1650137718154,MATH 103A,A02,083778,Staff,0,8,30,30
1650137718154,MATH 103A,B01,083779,Staff,0,9,30,30
1650137718154,MATH 103A,B02,083780,Staff,0,6,30,30
1650137724178,MATH 105,A01,085443,Staff,0,13,30,30
1650137730205,MATH 109,A01,083213,Anzaldo; Leesa B,0,3,30,30
1650137730205,MATH 109,A02,083214,Anzaldo; Leesa B,0,5,30,30
1650137730205,MATH 109,B01,083215,Anzaldo; Leesa B,0,4,30,30
1650137730205,MATH 109,B02,083216,Anzaldo; Leesa B,0,4,30,30
1650137736229,MATH 142A,A01,083219,Chow; Bennett,0,11,30,30
1650137736229,MATH 142A,A02,083220,Chow; Bennett,0,10,30,30
1650137736229,MATH 142A,B01,083221,Chow; Bennett,0,10,30,30
1650137736229,MATH 142A,B02,083222,Chow; Bennett,0,11,30,30
1650137742257,MATH 193A,A01,083224,Staff,0,3,30,30
1650137742257,MATH 193A,A02,083225,Staff,0,4,30,30
1650137742257,MATH 193A,A03,083781,Staff,0,0,30,30
1650137742257,MATH 193A,A04,083782,Staff,0,0,30,30
1650137748280,MATH 197,001,091859,McAuley; Julian John,9998,0,9999,1
1650137754337,COGS 9,A01,083615,Staff,0,14,60,60
1650137760364,COGS 11,A01,083617,Boyle; Mary E. T.,24,0,40,16
1650137766387,COGS 13,A01,083071,Staff,0,28,40,40
1650137772410,COGS 14A,A01,092681,Staff,0,10,100,100
1650137778432,COGS 14B,A01,083073,Cheng; Tzu-Han,0,4,50,50
1650137784456,COGS 17,A01,092677,Staff,34,0,75,41
1650137790480,COGS 100,A01,083619,Staff,0,21,60,60
1650137796504,COGS 101A,A01,083621,Davis; Joshua Daniel,0,18,60,60
1650137802527,COGS 101B,A01,091572,Staff,10,0,60,50
1650137808561,COGS 101C,A01,083625,Delgado; Tania,22,0,30,8
1650137814587,COGS 107A,A01,083627,Boyle; Mary E. T.,0,5,60,60
1650137820610,COGS 118A,A01,083075,Staff,17,0,60,43
1650137826639,CSE 3,A50,083646,Miranda; Gregory Joseph,22,0,38,16
1650137826639,CSE 3,A51,083647,Miranda; Gregory Joseph,37,0,37,0
1650137832666,CSE 8A,A50,083650,Miranda; Gregory Joseph,0,16,40,40
1650137838690,CSE 11,A01,083080,Cao; Yingjun,0,66,40,40
1650137844713,CSE 12,A01,083652,Staff,0,2,100,100
1650137850741,CSE 15L,A01,083654,Staff,0,0,50,50
1650137850741,CSE 15L,A02,083655,Staff,10,0,50,40
1650137856765,CSE 20,A01,083657,Staff,56,0,80,24
1650137862790,CSE 30,A01,083084,Eldon; John,0,63,40,40
1650137868813,CSE 100,A01,083659,Cao; Yingjun,0,61,50,50
1650137874838,CSE 134B,A01,083661,Powell; Thomas Allan,0,27,65,65
1650137880861,CSE 140,A01,083663,Staff,4,0,75,71
1650137886885,CSE 140L,A01,083088,Eldon; John,0,1,75,75
1650137892912,CSE 175,A01,083665,Kumar; Rakesh,8,0,25,17
1650137898938,CSE 190,A00,092507,Dubnov; Shlomo,14,0,20,6
1650137904965,ECE 45,A01,083139,Staff,0,13,40,40
1650137910988,ECE 65,A50,083695,Staff,0,4,30,30
1650137917012,ECE 109,A01,091882,Touri; Behrouz,48,0,70,22
1650137923040,ECE 180,A00,083140,Abi Samra; Nicholas Camill,24,0,30,6
1650137923040,ECE 180,B00,083141,Abi Samra; Nicholas Camill,8,0,30,22
1650137929068,MATH 10A,A01,083735,Patchell; Gregory David,12,0,30,18
1650137929068,MATH 10A,A02,083736,Patchell; Gregory David,28,0,30,2
1650137929068,MATH 10A,A03,083737,Patchell; Gregory David,26,0,30,4
1650137935095,MATH 10B,A01,083207,Staff,0,5,30,30
1650137935095,MATH 10B,A02,083208,Staff,0,4,30,30
1650137935095,MATH 10B,B01,083739,Staff,18,0,30,12
1650137935095,MATH 10B,B02,083740,Staff,29,0,30,1
1650137941125,MATH 18,A01,083743,Staff,10,0,30,20
1650137941125,MATH 18,A02,083744,Staff,28,0,30,2
1650137941125,MATH 18,A03,083745,Staff,23,0,30,7
1650137941125,MATH 18,A04,083746,Staff,27,0,30,3
1650137941125,MATH 18,B01,083748,Staff,0,9,30,30
1650137941125,MATH 18,B02,083749,Staff,0,7,30,30
1650137941125,MATH 18,B03,083750,Staff,0,6,30,30
1650137941125,MATH 18,B04,083751,Staff,0,7,30,30
1650137947153,MATH 20A,A01,083754,Staff,26,0,40,14
1650137953180,MATH 20B,A01,083756,Staff,0,5,30,30
1650137953180,MATH 20B,A02,083757,Staff,0,4,30,30
1650137959210,MATH 20C,A01,083760,Staff,0,11,30,30
1650137959210,MATH 20C,A02,083761,Staff,0,12,30,30
1650137959210,MATH 20C,B01,083762,Staff,14,0,30,16
1650137959210,MATH 20C,B02,083763,Staff,28,0,30,2
1650137965238,MATH 20D,A01,083765,Staff,0,2,30,30
1650137965238,MATH 20D,A02,083766,Staff,11,0,30,19
1650137965238,MATH 20D,A03,083767,Staff,28,0,30,2
1650137971262,MATH 20E,A01,083771,Staff,8,0,30,22
1650137971262,MATH 20E,A02,083772,Staff,20,0,30,10
1650137971262,MATH 20E,B01,083773,Staff,0,0,30,30
1650137971262,MATH 20E,B02,083774,Staff,13,0,30,17
1650137977290,MATH 103A,A01,083777,Staff,0,8,30,30
1650137977290,MATH 103A,A02,083778,Staff,0,8,30,30
1650137977290,MATH 103A,B01,083779,Staff,0,9,30,30
1650137977290,MATH 103A,B02,083780,Staff,0,6,30,30
1650137983316,MATH 105,A01,085443,Staff,0,13,30,30
1650137989340,MATH 109,A01,083213,Anzaldo; Leesa B,0,3,30,30
1650137989340,MATH 109,A02,083214,Anzaldo; Leesa B,0,5,30,30
1650137989340,MATH 109,B01,083215,Anzaldo; Leesa B,0,4,30,30
1650137989340,MATH 109,B02,083216,Anzaldo; Leesa B,0,4,30,30
1650137995365,MATH 142A,A01,083219,Chow; Bennett,0,11,30,30
1650137995365,MATH 142A,A02,083220,Chow; Bennett,0,10,30,30
1650137995365,MATH 142A,B01,083221,Chow; Bennett,0,10,30,30
1650137995365,MATH 142A,B02,083222,Chow; Bennett,0,11,30,30
1650138001389,MATH 193A,A01,083224,Staff,0,3,30,30
1650138001389,MATH 193A,A02,083225,Staff,0,4,30,30
1650138001389,MATH 193A,A03,083781,Staff,0,0,30,30
1650138001389,MATH 193A,A04,083782,Staff,0,0,30,30
1650138007416,MATH 197,001,091859,McAuley; Julian John,9998,0,9999,1
1650138013479,COGS 9,A01,083615,Staff,0,14,60,60
1650138019502,COGS 11,A01,083617,Boyle; Mary E. T.,24,0,40,16
1650138025528,COGS 13,A01,083071,Staff,0,28,40,40
1650138031564,COGS 14A,A01,092681,Staff,0,10,100,100
1650138037588,COGS 14B,A01,083073,Cheng; Tzu-Han,0,4,50,50
1650138043611,COGS 17,A01,092677,Staff,34,0,75,41
1650138049634,COGS 100,A01,083619,Staff,0,21,60,60
1650138055660,COGS 101A,A01,083621,Davis; Joshua Daniel,0,18,60,60
1650138061687,COGS 101B,A01,091572,Staff,10,0,60,50
1650138067713,COGS 101C,A01,083625,Delgado; Tania,22,0,30,8
1650138073742,COGS 107A,A01,083627,Boyle; Mary E. T.,0,5,60,60
1650138079765,COGS 118A,A01,083075,Staff,17,0,60,43
1650138085788,CSE 3,A50,083646,Miranda; Gregory Joseph,22,0,38,16
1650138085788,CSE 3,A51,083647,Miranda; Gregory Joseph,37,0,37,0
1650138091812,CSE 8A,A50,083650,Miranda; Gregory Joseph,0,16,40,40
1650138097835,CSE 11,A01,083080,Cao; Yingjun,0,66,40,40
1650138103862,CSE 12,A01,083652,Staff,0,3,100,100
1650138109885,CSE 15L,A01,083654,Staff,0,0,50,50
1650138109885,CSE 15L,A02,083655,Staff,9,0,50,41
1650138115998,CSE 20,A01,083657,Staff,56,0,80,24
1650138122026,CSE 30,A01,083084,Eldon; John,0,63,40,40
1650138128049,CSE 100,A01,083659,Cao; Yingjun,0,61,50,50
1650138134086,CSE 134B,A01,083661,Powell; Thomas Allan,0,27,65,65
1650138140111,CSE 140,A01,083663,Staff,4,0,75,71
1650138146135,CSE 140L,A01,083088,Eldon; John,0,1,75,75
1650138152159,CSE 175,A01,083665,Kumar; Rakesh,8,0,25,17
1650138158183,CSE 190,A00,092507,Dubnov; Shlomo,14,0,20,6
1650138164209,ECE 45,A01,083139,Staff,0,13,40,40
1650138170232,ECE 65,A50,083695,Staff,0,4,30,30
1650138176261,ECE 109,A01,091882,Touri; Behrouz,48,0,70,22
1650138182294,ECE 180,A00,083140,Abi Samra; Nicholas Camill,24,0,30,6
1650138182294,ECE 180,B00,083141,Abi Samra; Nicholas Camill,8,0,30,22
1650138188317,MATH 10A,A01,083735,Patchell; Gregory David,12,0,30,18
1650138188317,MATH 10A,A02,083736,Patchell; Gregory David,28,0,30,2
1650138188317,MATH 10A,A03,083737,Patchell; Gregory David,26,0,30,4
1650138194341,MATH 10B,A01,083207,Staff,0,5,30,30
1650138194341,MATH 10B,A02,083208,Staff,0,4,30,30
1650138194341,MATH 10B,B01,083739,Staff,18,0,30,12
1650138194341,MATH 10B,B02,083740,Staff,29,0,30,1
1650138200365,MATH 18,A01,083743,Staff,10,0,30,20
1650138200365,MATH 18,A02,083744,Staff,28,0,30,2
1650138200365,MATH 18,A03,083745,Staff,23,0,30,7
1650138200365,MATH 18,A04,083746,Staff,27,0,30,3
1650138200365,MATH 18,B01,083748,Staff,0,9,30,30
1650138200365,MATH 18,B02,083749,Staff,0,7,30,30
1650138200365,MATH 18,B03,083750,Staff,0,6,30,30
1650138200365,MATH 18,B04,083751,Staff,0,7,30,30
1650138206389,MATH 20A,A01,083754,Staff,26,0,40,14
1650138212413,MATH 20B,A01,083756,Staff,0,5,30,30
1650138212413,MATH 20B,A02,083757,Staff,0,4,30,30
1650138218437,MATH 20C,A01,083760,Staff,0,11,30,30
1650138218437,MATH 20C,A02,083761,Staff,0,12,30,30
1650138218437,MATH 20C,B01,083762,Staff,14,0,30,16
1650138218437,MATH 20C,B02,083763,Staff,28,0,30,2
1650138224465,MATH 20D,A01,083765,Staff,0,2,30,30
1650138224465,MATH 20D,A02,083766,Staff,11,0,30,19
1650138224465,MATH 20D,A03,083767,Staff,28,0,30,2
1650138230492,MATH 20E,A01,083771,Staff,8,0,30,22
1650138230492,MATH 20E,A02,083772,Staff,20,0,30,10
1650138230492,MATH 20E,B01,083773,Staff,0,0,30,30
1650138230492,MATH 20E,B02,083774,Staff,13,0,30,17
1650138236515,MATH 103A,A01,083777,Staff,0,8,30,30
1650138236515,MATH 103A,A02,083778,Staff,0,8,30,30
1650138236515,MATH 103A,B01,083779,Staff,0,9,30,30
1650138236515,MATH 103A,B02,083780,Staff,0,6,30,30
1650138242546,MATH 105,A01,085443,Staff,0,13,30,30
1650138248570,MATH 109,A01,083213,Anzaldo; Leesa B,0,3,30,30
1650138248570,MATH 109,A02,083214,Anzaldo; Leesa B,0,5,30,30
1650138248570,MATH 109,B01,083215,Anzaldo; Leesa B,0,4,30,30
1650138248570,MATH 109,B02,083216,Anzaldo; Leesa B,0,4,30,30
1650138254595,MATH 142A,A01,083219,Chow; Bennett,0,11,30,30
1650138254595,MATH 142A,A02,083220,Chow; Bennett,0,10,30,30
1650138254595,MATH 142A,B01,083221,Chow; Bennett,0,10,30,30
1650138254595,MATH 142A,B02,083222,Chow; Bennett,0,11,30,30
1650138260617,MATH 193A,A01,083224,Staff,0,3,30,30
1650138260617,MATH 193A,A02,083225,Staff,0,4,30,30
1650138260617,MATH 193A,A03,083781,Staff,0,0,30,30
1650138260617,MATH 193A,A04,083782,Staff,0,0,30,30
1650138266650,MATH 197,001,091859,McAuley; Julian John,9998,0,9999,1
1650138272699,COGS 9,A01,083615,Staff,0,14,60,60
1650138278721,COGS 11,A01,083617,Boyle; Mary E. T.,24,0,40,16
1650138284745,COGS 13,A01,083071,Staff,0,28,40,40
1650138290775,COGS 14A,A01,092681,Staff,0,10,100,100
1650138296799,COGS 14B,A01,083073,Cheng; Tzu-Han,0,4,50,50
1650138302822,COGS 17,A01,092677,Staff,34,0,75,41
1650138308847,COGS 100,A01,083619,Staff,0,21,60,60
1650138314874,COGS 101A,A01,083621,Davis; Joshua Daniel,0,18,60,60
1650138320898,COGS 101B,A01,091572,Staff,10,0,60,50
1650138326925,COGS 101C,A01,083625,Delgado; Tania,22,0,30,8
1650138332955,COGS 107A,A01,083627,Boyle; Mary E. T.,0,5,60,60
1650138338985,COGS 118A,A01,083075,Staff,17,0,60,43
1650138345011,CSE 3,A50,083646,Miranda; Gregory Joseph,22,0,38,16
1650138345011,CSE 3,A51,083647,Miranda; Gregory Joseph,37,0,37,0
1650138351036,CSE 8A,A50,083650,Miranda; Gregory Joseph,0,16,40,40
1650138357067,CSE 11,A01,083080,Cao; Yingjun,0,66,40,40
1650138363090,CSE 12,A01,083652,Staff,0,3,100,100
1650138369117,CSE 15L,A01,083654,Staff,0,0,50,50
1650138369117,CSE 15L,A02,083655,Staff,9,0,50,41
1650138375141,CSE 20,A01,083657,Staff,56,0,80,24
1650138381163,CSE 30,A01,083084,Eldon; John,0,63,40,40
1650138387199,CSE 100,A01,083659,Cao; Yingjun,0,61,50,50
1650138393226,CSE 134B,A01,083661,Powell; Thomas Allan,0,27,65,65
1650138399249,CSE 140,A01,083663,Staff,4,0,75,71
1650138405277,CSE 140L,A01,083088,Eldon; John,0,1,75,75
1650138411299,CSE 175,A01,083665,Kumar; Rakesh,8,0,25,17
1650138417327,CSE 190,A00,092507,Dubnov; Shlomo,14,0,20,6
1650138423350,ECE 45,A01,083139,Staff,0,13,40,40
1650138429372,ECE 65,A50,083695,Staff,0,4,30,30
1650138435399,ECE 109,A01,091882,Touri; Behrouz,48,0,70,22
1650138441422,ECE 180,A00,083140,Abi Samra; Nicholas Camill,24,0,30,6
1650138441422,ECE 180,B00,083141,Abi Samra; Nicholas Camill,8,0,30,22
1650138447448,MATH 10A,A01,083735,Patchell; Gregory David,12,0,30,18
1650138447448,MATH 10A,A02,083736,Patchell; Gregory David,28,0,30,2
1650138447448,MATH 10A,A03,083737,Patchell; Gregory David,26,0,30,4
1650138453472,MATH 10B,A01,083207,Staff,0,5,30,30
1650138453472,MATH 10B,A02,083208,Staff,0,4,30,30
1650138453472,MATH 10B,B01,083739,Staff,18,0,30,12
1650138453472,MATH 10B,B02,083740,Staff,29,0,30,1
1650138459498,MATH 18,A01,083743,Staff,10,0,30,20
1650138459498,MATH 18,A02,083744,Staff,28,0,30,2
1650138459498,MATH 18,A03,083745,Staff,23,0,30,7
1650138459498,MATH 18,A04,083746,Staff,27,0,30,3
1650138459498,MATH 18,B01,083748,Staff,0,9,30,30
1650138459498,MATH 18,B02,083749,Staff,0,7,30,30
1650138459498,MATH 18,B03,083750,Staff,0,6,30,30
1650138459498,MATH 18,B04,083751,Staff,0,7,30,30
1650138465528,MATH 20A,A01,083754,Staff,26,0,40,14
1650138471562,MATH 20B,A01,083756,Staff,0,5,30,30
1650138471562,MATH 20B,A02,083757,Staff,0,4,30,30
1650138477587,MATH 20C,A01,083760,Staff,0,11,30,30
1650138477587,MATH 20C,A02,083761,Staff,0,12,30,30
1650138477587,MATH 20C,B01,083762,Staff,14,0,30,16
1650138477587,MATH 20C,B02,083763,Staff,28,0,30,2
1650138483610,MATH 20D,A01,083765,Staff,0,2,30,30
1650138483610,MATH 20D,A02,083766,Staff,11,0,30,19
1650138483610,MATH 20D,A03,083767,Staff,28,0,30,2
1650138489635,MATH 20E,A01,083771,Staff,8,0,30,22
1650138489635,MATH 20E,A02,083772,Staff,20,0,30,10
1650138489635,MATH 20E,B01,083773,Staff,0,0,30,30
1650138489635,MATH 20E,B02,083774,Staff,13,0,30,17
1650138495669,MATH 103A,A01,083777,Staff,0,8,30,30
1650138495669,MATH 103A,A02,083778,Staff,0,8,30,30
1650138495669,MATH 103A,B01,083779,Staff,0,9,30,30
1650138495669,MATH 103A,B02,083780,Staff,0,6,30,30
1650138501692,MATH 105,A01,085443,Staff,0,13,30,30
1650138507732,MATH 109,A01,083213,Anzaldo; Leesa B,0,3,30,30
1650138507732,MATH 109,A02,083214,Anzaldo; Leesa B,0,5,30,30
1650138507732,MATH 109,B01,083215,Anzaldo; Leesa B,0,4,30,30
1650138507732,MATH 109,B02,083216,Anzaldo; Leesa B,0,4,30,30
1650138513756,MATH 142A,A01,083219,Chow; Bennett,0,11,30,30
1650138513756,MATH 142A,A02,083220,Chow; Bennett,0,10,30,30
1650138513756,MATH 142A,B01,083221,Chow; Bennett,0,10,30,30
1650138513756,MATH 142A,B02,083222,Chow; Bennett,0,11,30,30
1650138519781,MATH 193A,A01,083224,Staff,0,3,30,30
1650138519781,MATH 193A,A02,083225,Staff,0,4,30,30
1650138519781,MATH 193A,A03,083781,Staff,0,0,30,30
1650138519781,MATH 193A,A04,083782,Staff,0,0,30,30
1650138525805,MATH 197,001,091859,McAuley; Julian John,9998,0,9999,1
1650138531855,COGS 9,A01,083615,Staff,0,14,60,60
1650138537881,COGS 11,A01,083617,Boyle; Mary E. T.,24,0,40,16
1650138543908,COGS 13,A01,083071,Staff,0,28,40,40
1650138549940,COGS 14A,A01,092681,Staff,0,10,100,100
1650138555964,COGS 14B,A01,083073,Cheng; Tzu-Han,0,4,50,50
1650138561987,COGS 17,A01,092677,Staff,34,0,75,41
1650138568010,COGS 100,A01,083619,Staff,0,21,60,60
1650138574037,COGS 101A,A01,083621,Davis; Joshua Daniel,0,18,60,60
1650138580062,COGS 101B,A01,091572,Staff,10,0,60,50
1650138586085,COGS 101C,A01,083625,Delgado; Tania,22,0,30,8
1650138592113,COGS 107A,A01,083627,Boyle; Mary E. T.,0,5,60,60
1650138598141,COGS 118A,A01,083075,Staff,17,0,60,43
1650138604166,CSE 3,A50,083646,Miranda; Gregory Joseph,22,0,38,16
1650138604166,CSE 3,A51,083647,Miranda; Gregory Joseph,37,0,37,0
1650138610193,CSE 8A,A50,083650,Miranda; Gregory Joseph,0,16,40,40
1650138616220,CSE 11,A01,083080,Cao; Yingjun,0,66,40,40
1650138622251,CSE 12,A01,083652,Staff,0,3,100,100
1650138628277,CSE 15L,A01,083654,Staff,0,0,50,50
1650138628277,CSE 15L,A02,083655,Staff,9,0,50,41
1650138634301,CSE 20,A01,083657,Staff,56,0,80,24
1650138640335,CSE 30,A01,083084,Eldon; John,0,63,40,40
1650138646358,CSE 100,A01,083659,Cao; Yingjun,0,61,50,50
1650138652384,CSE 134B,A01,083661,Powell; Thomas Allan,0,27,65,65
1650138658408,CSE 140,A01,083663,Staff,4,0,75,71
1650138664432,CSE 140L,A01,083088,Eldon; John,0,1,75,75
1650138670455,CSE 175,A01,083665,Kumar; Rakesh,8,0,25,17
1650138676486,CSE 190,A00,092507,Dubnov; Shlomo,14,0,20,6
1650138682516,ECE 45,A01,083139,Staff,0,13,40,40
1650138688539,ECE 65,A50,083695,Staff,0,4,30,30
1650138694566,ECE 109,A01,091882,Touri; Behrouz,48,0,70,22
1650138700589,ECE 180,A00,083140,Abi Samra; Nicholas Camill,24,0,30,6
1650138700589,ECE 180,B00,083141,Abi Samra; Nicholas Camill,8,0,30,22
1650138706616,MATH 10A,A01,083735,Patchell; Gregory David,12,0,30,18
1650138706616,MATH 10A,A02,083736,Patchell; Gregory David,28,0,30,2
1650138706616,MATH 10A,A03,083737,Patchell; Gregory David,26,0,30,4
1650138712721,MATH 10B,A01,083207,Staff,0,5,30,30
1650138712721,MATH 10B,A02,083208,Staff,0,4,30,30
1650138712721,MATH 10B,B01,083739,Staff,18,0,30,12
1650138712721,MATH 10B,B02,083740,Staff,29,0,30,1
1650138718745,MATH 18,A01,083743,Staff,10,0,30,20
1650138718745,MATH 18,A02,083744,Staff,28,0,30,2
1650138718745,MATH 18,A03,083745,Staff,23,0,30,7
1650138718745,MATH 18,A04,083746,Staff,27,0,30,3
1650138718745,MATH 18,B01,083748,Staff,0,9,30,30
1650138718745,MATH 18,B02,083749,Staff,0,7,30,30
1650138718745,MATH 18,B03,083750,Staff,0,6,30,30
1650138718745,MATH 18,B04,083751,Staff,0,7,30,30
1650138724778,MATH 20A,A01,083754,Staff,26,0,40,14
1650138730805,MATH 20B,A01,083756,Staff,0,5,30,30
1650138730805,MATH 20B,A02,083757,Staff,0,4,30,30
1650138736834,MATH 20C,A01,083760,Staff,0,11,30,30
1650138736834,MATH 20C,A02,083761,Staff,0,12,30,30
1650138736834,MATH 20C,B01,083762,Staff,14,0,30,16
1650138736834,MATH 20C,B02,083763,Staff,28,0,30,2
1650138742858,MATH 20D,A01,083765,Staff,0,2,30,30
1650138742858,MATH 20D,A02,083766,Staff,11,0,30,19
1650138742858,MATH 20D,A03,083767,Staff,28,0,30,2
1650138748882,MATH 20E,A01,083771,Staff,8,0,30,22
1650138748882,MATH 20E,A02,083772,Staff,20,0,30,10
1650138748882,MATH 20E,B01,083773,Staff,0,0,30,30
1650138748882,MATH 20E,B02,083774,Staff,13,0,30,17
1650138754918,MATH 103A,A01,083777,Staff,0,8,30,30
1650138754918,MATH 103A,A02,083778,Staff,0,8,30,30
1650138754918,MATH 103A,B01,083779,Staff,0,9,30,30
1650138754918,MATH 103A,B02,083780,Staff,0,6,30,30
1650138760944,MATH 105,A01,085443,Staff,0,13,30,30
1650138766968,MATH 109,A01,083213,Anzaldo; Leesa B,0,3,30,30
1650138766968,MATH 109,A02,083214,Anzaldo; Leesa B,0,5,30,30
1650138766968,MATH 109,B01,083215,Anzaldo; Leesa B,0,4,30,30
1650138766968,MATH 109,B02,083216,Anzaldo; Leesa B,0,4,30,30
1650138772993,MATH 142A,A01,083219,Chow; Bennett,0,11,30,30
1650138772993,MATH 142A,A02,083220,Chow; Bennett,0,10,30,30
1650138772993,MATH 142A,B01,083221,Chow; Bennett,0,10,30,30
1650138772993,MATH 142A,B02,083222,Chow; Bennett,0,11,30,30
1650138779016,MATH 193A,A01,083224,Staff,0,3,30,30
1650138779016,MATH 193A,A02,083225,Staff,0,4,30,30
1650138779016,MATH 193A,A03,083781,Staff,0,0,30,30
1650138779016,MATH 193A,A04,083782,Staff,0,0,30,30
1650138785045,MATH 197,001,091859,McAuley; Julian John,9998,0,9999,1
1650138791101,COGS 9,A01,083615,Staff,0,14,60,60
1650138797126,COGS 11,A01,083617,Boyle; Mary E. T.,24,0,40,16
1650138803149,COGS 13,A01,083071,Staff,0,28,40,40
1650138809171,COGS 14A,A01,092681,Staff,0,10,100,100
1650138815193,COGS 14B,A01,083073,Cheng; Tzu-Han,0,4,50,50
1650138821219,COGS 17,A01,092677,Staff,34,0,75,41
1650138827244,COGS 100,A01,083619,Staff,0,21,60,60
1650138833268,COGS 101A,A01,083621,Davis; Joshua Daniel,0,18,60,60
1650138839291,COGS 101B,A01,091572,Staff,10,0,60,50
1650138845318,COGS 101C,A01,083625,Delgado; Tania,21,0,30,9
1650138851350,COGS 107A,A01,083627,Boyle; Mary E. T.,0,5,60,60
1650138857388,COGS 118A,A01,083075,Staff,17,0,60,43
1650138863412,CSE 3,A50,083646,Miranda; Gregory Joseph,22,0,38,16
1650138863412,CSE 3,A51,083647,Miranda; Gregory Joseph,37,0,37,0
1650138869440,CSE 8A,A50,083650,Miranda; Gregory Joseph,0,16,40,40
1650138875462,CSE 11,A01,083080,Cao; Yingjun,0,66,40,40
1650138881486,CSE 12,A01,083652,Staff,0,3,100,100
1650138887518,CSE 15L,A01,083654,Staff,0,0,50,50
1650138887518,CSE 15L,A02,083655,Staff,9,0,50,41
1650138893544,CSE 20,A01,083657,Staff,56,0,80,24
1650138899567,CSE 30,A01,083084,Eldon; John,0,63,40,40
1650138905593,CSE 100,A01,083659,Cao; Yingjun,0,61,50,50
1650138911627,CSE 134B,A01,083661,Powell; Thomas Allan,0,27,65,65
1650138917649,CSE 140,A01,083663,Staff,4,0,75,71
1650138923676,CSE 140L,A01,083088,Eldon; John,0,1,75,75
1650138929704,CSE 175,A01,083665,Kumar; Rakesh,8,0,25,17
1650138935728,CSE 190,A00,092507,Dubnov; Shlomo,14,0,20,6
1650138941766,ECE 45,A01,083139,Staff,0,13,40,40
1650138947789,ECE 65,A50,083695,Staff,0,4,30,30
1650138953811,ECE 109,A01,091882,Touri; Behrouz,48,0,70,22
1650138959838,ECE 180,A00,083140,Abi Samra; Nicholas Camill,24,0,30,6
1650138959838,ECE 180,B00,083141,Abi Samra; Nicholas Camill,8,0,30,22
1650138965873,MATH 10A,A01,083735,Patchell; Gregory David,12,0,30,18
1650138965873,MATH 10A,A02,083736,Patchell; Gregory David,28,0,30,2
1650138965873,MATH 10A,A03,083737,Patchell; Gregory David,26,0,30,4
1650138971897,MATH 10B,A01,083207,Staff,0,5,30,30
1650138971897,MATH 10B,A02,083208,Staff,0,4,30,30
1650138971897,MATH 10B,B01,083739,Staff,18,0,30,12
1650138971897,MATH 10B,B02,083740,Staff,29,0,30,1
1650138977923,MATH 18,A01,083743,Staff,10,0,30,20
1650138977923,MATH 18,A02,083744,Staff,28,0,30,2
1650138977923,MATH 18,A03,083745,Staff,23,0,30,7
1650138977923,MATH 18,A04,083746,Staff,27,0,30,3
1650138977923,MATH 18,B01,083748,Staff,0,9,30,30
1650138977923,MATH 18,B02,083749,Staff,0,7,30,30
1650138977923,MATH 18,B03,083750,Staff,0,6,30,30
1650138977923,MATH 18,B04,083751,Staff,0,7,30,30
1650138983954,MATH 20A,A01,083754,Staff,26,0,40,14
1650138989979,MATH 20B,A01,083756,Staff,0,5,30,30
1650138989979,MATH 20B,A02,083757,Staff,0,4,30,30
1650138996001,MATH 20C,A01,083760,Staff,0,11,30,30
1650138996001,MATH 20C,A02,083761,Staff,0,12,30,30
1650138996001,MATH 20C,B01,083762,Staff,14,0,30,16
1650138996001,MATH 20C,B02,083763,Staff,28,0,30,2
1650139002025,MATH 20D,A01,083765,Staff,0,2,30,30
1650139002025,MATH 20D,A02,083766,Staff,11,0,30,19
1650139002025,MATH 20D,A03,083767,Staff,28,0,30,2
1650139008048,MATH 20E,A01,083771,Staff,8,0,30,22
1650139008048,MATH 20E,A02,083772,Staff,20,0,30,10
1650139008048,MATH 20E,B01,083773,Staff,0,0,30,30
1650139008048,MATH 20E,B02,083774,Staff,13,0,30,17
1650139014072,MATH 103A,A01,083777,Staff,0,8,30,30
1650139014072,MATH 103A,A02,083778,Staff,0,8,30,30
1650139014072,MATH 103A,B01,083779,Staff,0,9,30,30
1650139014072,MATH 103A,B02,083780,Staff,0,6,30,30
1650139020094,MATH 105,A01,085443,Staff,0,13,30,30
1650139026117,MATH 109,A01,083213,Anzaldo; Leesa B,0,3,30,30
1650139026117,MATH 109,A02,083214,Anzaldo; Leesa B,0,5,30,30
1650139026117,MATH 109,B01,083215,Anzaldo; Leesa B,0,4,30,30
1650139026117,MATH 109,B02,083216,Anzaldo; Leesa B,0,4,30,30
1650139032144,MATH 142A,A01,083219,Chow; Bennett,0,11,30,30
1650139032144,MATH 142A,A02,083220,Chow; Bennett,0,10,30,30
1650139032144,MATH 142A,B01,083221,Chow; Bennett,0,10,30,30
1650139032144,MATH 142A,B02,083222,Chow; Bennett,0,11,30,30
1650139038167,MATH 193A,A01,083224,Staff,0,3,30,30
1650139038167,MATH 193A,A02,083225,Staff,0,4,30,30
1650139038167,MATH 193A,A03,083781,Staff,0,0,30,30
1650139038167,MATH 193A,A04,083782,Staff,0,0,30,30
1650139044190,MATH 197,001,091859,McAuley; Julian John,9998,0,9999,1
1650139050245,COGS 9,A01,083615,Staff,0,14,60,60
1650139056274,COGS 11,A01,083617,Boyle; Mary E. T.,24,0,40,16
1650139062298,COGS 13,A01,083071,Staff,0,28,40,40
1650139068321,COGS 14A,A01,092681,Staff,0,10,100,100
1650139074348,COGS 14B,A01,083073,Cheng; Tzu-Han,0,4,50,50
1650139080371,COGS 17,A01,092677,Staff,34,0,75,41
1650139086394,COGS 100,A01,083619,Staff,0,21,60,60
1650139092421,COGS 101A,A01,083621,Davis; Joshua Daniel,0,18,60,60
1650139098447,COGS 101B,A01,091572,Staff,10,0,60,50
1650139104470,COGS 101C,A01,083625,Delgado; Tania,21,0,30,9
1650139110491,COGS 107A,A01,083627,Boyle; Mary E. T.,0,5,60,60
1650139116517,COGS 118A,A01,083075,Staff,17,0,60,43
1650139122541,CSE 3,A50,083646,Miranda; Gregory Joseph,22,0,38,16
1650139122541,CSE 3,A51,083647,Miranda; Gregory Joseph,37,0,37,0
1650139128566,CSE 8A,A50,083650,Miranda; Gregory Joseph,0,16,40,40
1650139134593,CSE 11,A01,083080,Cao; Yingjun,0,66,40,40
1650139140615,CSE 12,A01,083652,Staff,0,3,100,100
1650139146650,CSE 15L,A01,083654,Staff,0,0,50,50
1650139146650,CSE 15L,A02,083655,Staff,9,0,50,41
1650139152679,CSE 20,A01,083657,Staff,56,0,80,24
1650139158702,CSE 30,A01,083084,Eldon; John,0,63,40,40
1650139164730,CSE 100,A01,083659,Cao; Yingjun,0,61,50,50
1650139170751,CSE 134B,A01,083661,Powell; Thomas Allan,0,27,65,65
1650139176778,CSE 140,A01,083663,Staff,4,0,75,71
1650139182801,CSE 140L,A01,083088,Eldon; John,0,1,75,75
1650139188824,CSE 175,A01,083665,Kumar; Rakesh,8,0,25,17
1650139194848,CSE 190,A00,092507,Dubnov; Shlomo,14,0,20,6
1650139200876,ECE 45,A01,083139,Staff,0,13,40,40
1650139206899,ECE 65,A50,083695,Staff,0,4,30,30
1650139212922,ECE 109,A01,091882,Touri; Behrouz,48,0,70,22
1650139218950,ECE 180,A00,083140,Abi Samra; Nicholas Camill,24,0,30,6
1650139218950,ECE 180,B00,083141,Abi Samra; Nicholas Camill,8,0,30,22
1650139224979,MATH 10A,A01,083735,Patchell; Gregory David,12,0,30,18
1650139224979,MATH 10A,A02,083736,Patchell; Gregory David,28,0,30,2
1650139224979,MATH 10A,A03,083737,Patchell; Gregory David,26,0,30,4
1650139231007,MATH 10B,A01,083207,Staff,0,5,30,30
1650139231007,MATH 10B,A02,083208,Staff,0,4,30,30
1650139231007,MATH 10B,B01,083739,Staff,18,0,30,12
1650139231007,MATH 10B,B02,083740,Staff,29,0,30,1
1650139237036,MATH 18,A01,083743,Staff,10,0,30,20
1650139237036,MATH 18,A02,083744,Staff,28,0,30,2
1650139237036,MATH 18,A03,083745,Staff,23,0,30,7
1650139237036,MATH 18,A04,083746,Staff,27,0,30,3
1650139237036,MATH 18,B01,083748,Staff,0,9,30,30
1650139237036,MATH 18,B02,083749,Staff,0,7,30,30
1650139237036,MATH 18,B03,083750,Staff,0,6,30,30
1650139237036,MATH 18,B04,083751,Staff,0,7,30,30
1650139243073,MATH 20A,A01,083754,Staff,26,0,40,14
1650139249094,MATH 20B,A01,083756,Staff,0,5,30,30
1650139249094,MATH 20B,A02,083757,Staff,0,4,30,30
1650139255117,MATH 20C,A01,083760,Staff,0,11,30,30
1650139255117,MATH 20C,A02,083761,Staff,0,12,30,30
1650139255117,MATH 20C,B01,083762,Staff,14,0,30,16
1650139255117,MATH 20C,B02,083763,Staff,28,0,30,2
1650139261143,MATH 20D,A01,083765,Staff,0,2,30,30
1650139261143,MATH 20D,A02,083766,Staff,11,0,30,19
1650139261143,MATH 20D,A03,083767,Staff,28,0,30,2
1650139267167,MATH 20E,A01,083771,Staff,8,0,30,22
1650139267167,MATH 20E,A02,083772,Staff,20,0,30,10
1650139267167,MATH 20E,B01,083773,Staff,0,0,30,30
1650139267167,MATH 20E,B02,083774,Staff,13,0,30,17
1650139273191,MATH 103A,A01,083777,Staff,0,8,30,30
1650139273191,MATH 103A,A02,083778,Staff,0,8,30,30
1650139273191,MATH 103A,B01,083779,Staff,0,9,30,30
1650139273191,MATH 103A,B02,083780,Staff,0,6,30,30
1650139279214,MATH 105,A01,085443,Staff,0,13,30,30
1650139285237,MATH 109,A01,083213,Anzaldo; Leesa B,0,3,30,30
1650139285237,MATH 109,A02,083214,Anzaldo; Leesa B,0,5,30,30
1650139285237,MATH 109,B01,083215,Anzaldo; Leesa B,0,4,30,30
1650139285237,MATH 109,B02,083216,Anzaldo; Leesa B,0,4,30,30
1650139291268,MATH 142A,A01,083219,Chow; Bennett,0,11,30,30
1650139291268,MATH 142A,A02,083220,Chow; Bennett,0,10,30,30
1650139291268,MATH 142A,B01,083221,Chow; Bennett,0,10,30,30
1650139291268,MATH 142A,B02,083222,Chow; Bennett,0,11,30,30
1650139297293,MATH 193A,A01,083224,Staff,0,3,30,30
1650139297293,MATH 193A,A02,083225,Staff,0,4,30,30
1650139297293,MATH 193A,A03,083781,Staff,0,0,30,30
1650139297293,MATH 193A,A04,083782,Staff,0,0,30,30
1650139303317,MATH 197,001,091859,McAuley; Julian John,9998,0,9999,1
1650139309450,COGS 9,A01,083615,Staff,0,14,60,60
1650139315482,COGS 11,A01,083617,Boyle; Mary E. T.,24,0,40,16
1650139321512,COGS 13,A01,083071,Staff,0,28,40,40
1650139327535,COGS 14A,A01,092681,Staff,0,10,100,100
1650139333560,COGS 14B,A01,083073,Cheng; Tzu-Han,0,4,50,50
1650139339586,COGS 17,A01,092677,Staff,34,0,75,41
1650139345613,COGS 100,A01,083619,Staff,0,21,60,60
1650139351636,COGS 101A,A01,083621,Davis; Joshua Daniel,0,18,60,60
1650139357662,COGS 101B,A01,091572,Staff,10,0,60,50
1650139363688,COGS 101C,A01,083625,Delgado; Tania,21,0,30,9
1650139369715,COGS 107A,A01,083627,Boyle; Mary E. T.,0,5,60,60
1650139375749,COGS 118A,A01,083075,Staff,17,0,60,43
1650139381773,CSE 3,A50,083646,Miranda; Gregory Joseph,22,0,38,16
1650139381773,CSE 3,A51,083647,Miranda; Gregory Joseph,37,0,37,0
1650139387800,CSE 8A,A50,083650,Miranda; Gregory Joseph,0,16,40,40
1650139393828,CSE 11,A01,083080,Cao; Yingjun,0,66,40,40
1650139399851,CSE 12,A01,083652,Staff,0,3,100,100
1650139405879,CSE 15L,A01,083654,Staff,0,0,50,50
1650139405879,CSE 15L,A02,083655,Staff,9,0,50,41
1650139411916,CSE 20,A01,083657,Staff,56,0,80,24
1650139417939,CSE 30,A01,083084,Eldon; John,0,63,40,40
1650139423965,CSE 100,A01,083659,Cao; Yingjun,0,61,50,50
1650139429992,CSE 134B,A01,083661,Powell; Thomas Allan,0,27,65,65
1650139436015,CSE 140,A01,083663,Staff,4,0,75,71
1650139442043,CSE 140L,A01,083088,Eldon; John,0,1,75,75
1650139448067,CSE 175,A01,083665,Kumar; Rakesh,8,0,25,17
1650139454094,CSE 190,A00,092507,Dubnov; Shlomo,14,0,20,6
1650139460117,ECE 45,A01,083139,Staff,0,13,40,40
1650139466140,ECE 65,A50,083695,Staff,0,4,30,30
1650139472167,ECE 109,A01,091882,Touri; Behrouz,48,0,70,22
1650139478197,ECE 180,A00,083140,Abi Samra; Nicholas Camill,24,0,30,6
1650139478197,ECE 180,B00,083141,Abi Samra; Nicholas Camill,8,0,30,22
1650139484224,MATH 10A,A01,083735,Patchell; Gregory David,12,0,30,18
1650139484224,MATH 10A,A02,083736,Patchell; Gregory David,28,0,30,2
1650139484224,MATH 10A,A03,083737,Patchell; Gregory David,26,0,30,4
1650139490251,MATH 10B,A01,083207,Staff,0,5,30,30
1650139490251,MATH 10B,A02,083208,Staff,0,4,30,30
1650139490251,MATH 10B,B01,083739,Staff,18,0,30,12
1650139490251,MATH 10B,B02,083740,Staff,29,0,30,1
1650139496275,MATH 18,A01,083743,Staff,10,0,30,20
1650139496275,MATH 18,A02,083744,Staff,28,0,30,2
1650139496275,MATH 18,A03,083745,Staff,23,0,30,7
1650139496275,MATH 18,A04,083746,Staff,27,0,30,3
1650139496275,MATH 18,B01,083748,Staff,0,9,30,30
1650139496275,MATH 18,B02,083749,Staff,0,7,30,30
1650139496275,MATH 18,B03,083750,Staff,0,6,30,30
1650139496275,MATH 18,B04,083751,Staff,0,7,30,30
1650139502311,MATH 20A,A01,083754,Staff,26,0,40,14
1650139508338,MATH 20B,A01,083756,Staff,0,5,30,30
1650139508338,MATH 20B,A02,083757,Staff,0,4,30,30
1650139514371,MATH 20C,A01,083760,Staff,0,11,30,30
1650139514371,MATH 20C,A02,083761,Staff,0,12,30,30
1650139514371,MATH 20C,B01,083762,Staff,14,0,30,16
1650139514371,MATH 20C,B02,083763,Staff,28,0,30,2
1650139520394,MATH 20D,A01,083765,Staff,0,2,30,30
1650139520394,MATH 20D,A02,083766,Staff,11,0,30,19
1650139520394,MATH 20D,A03,083767,Staff,28,0,30,2
1650139526424,MATH 20E,A01,083771,Staff,8,0,30,22
1650139526424,MATH 20E,A02,083772,Staff,20,0,30,10
1650139526424,MATH 20E,B01,083773,Staff,0,0,30,30
1650139526424,MATH 20E,B02,083774,Staff,13,0,30,17
1650139532453,MATH 103A,A01,083777,Staff,0,8,30,30
1650139532453,MATH 103A,A02,083778,Staff,0,8,30,30
1650139532453,MATH 103A,B01,083779,Staff,0,9,30,30
1650139532453,MATH 103A,B02,083780,Staff,0,6,30,30
1650139538476,MATH 105,A01,085443,Staff,0,13,30,30
1650139544500,MATH 109,A01,083213,Anzaldo; Leesa B,0,3,30,30
1650139544500,MATH 109,A02,083214,Anzaldo; Leesa B,0,5,30,30
1650139544500,MATH 109,B01,083215,Anzaldo; Leesa B,0,4,30,30
1650139544500,MATH 109,B02,083216,Anzaldo; Leesa B,0,4,30,30
1650139550524,MATH 142A,A01,083219,Chow; Bennett,0,11,30,30
1650139550524,MATH 142A,A02,083220,Chow; Bennett,0,10,30,30
1650139550524,MATH 142A,B01,083221,Chow; Bennett,0,10,30,30
1650139550524,MATH 142A,B02,083222,Chow; Bennett,0,11,30,30
1650139556548,MATH 193A,A01,083224,Staff,0,3,30,30
1650139556548,MATH 193A,A02,083225,Staff,0,4,30,30
1650139556548,MATH 193A,A03,083781,Staff,0,0,30,30
1650139556548,MATH 193A,A04,083782,Staff,0,0,30,30
1650139562571,MATH 197,001,091859,McAuley; Julian John,9998,0,9999,1
1650139568622,COGS 9,A01,083615,Staff,0,14,60,60
1650139574650,COGS 11,A01,083617,Boyle; Mary E. T.,24,0,40,16
1650139580677,COGS 13,A01,083071,Staff,0,28,40,40
1650139586700,COGS 14A,A01,092681,Staff,0,10,100,100
1650139592723,COGS 14B,A01,083073,Cheng; Tzu-Han,0,4,50,50
1650139598757,COGS 17,A01,092677,Staff,34,0,75,41
1650139604784,COGS 100,A01,083619,Staff,0,21,60,60
1650139610809,COGS 101A,A01,083621,Davis; Joshua Daniel,0,18,60,60
1650139616838,COGS 101B,A01,091572,Staff,10,0,60,50
1650139622868,COGS 101C,A01,083625,Delgado; Tania,21,0,30,9
1650139628895,COGS 107A,A01,083627,Boyle; Mary E. T.,0,5,60,60
1650139634918,COGS 118A,A01,083075,Staff,17,0,60,43
1650139640941,CSE 3,A50,083646,Miranda; Gregory Joseph,22,0,38,16
1650139640941,CSE 3,A51,083647,Miranda; Gregory Joseph,37,0,37,0
1650139646965,CSE 8A,A50,083650,Miranda; Gregory Joseph,0,16,40,40
1650139652992,CSE 11,A01,083080,Cao; Yingjun,0,66,40,40
1650139659019,CSE 12,A01,083652,Staff,0,3,100,100
1650139665043,CSE 15L,A01,083654,Staff,0,0,50,50
1650139665043,CSE 15L,A02,083655,Staff,9,0,50,41
1650139671072,CSE 20,A01,083657,Staff,56,0,80,24
1650139677099,CSE 30,A01,083084,Eldon; John,0,63,40,40
1650139683123,CSE 100,A01,083659,Cao; Yingjun,0,61,50,50
1650139689146,CSE 134B,A01,083661,Powell; Thomas Allan,0,27,65,65
1650139695173,CSE 140,A01,083663,Staff,4,0,75,71
1650139701197,CSE 140L,A01,083088,Eldon; John,0,1,75,75
1650139707223,CSE 175,A01,083665,Kumar; Rakesh,8,0,25,17
1650139713250,CSE 190,A00,092507,Dubnov; Shlomo,14,0,20,6
1650139719273,ECE 45,A01,083139,Staff,0,13,40,40
1650139725300,ECE 65,A50,083695,Staff,0,4,30,30
1650139731324,ECE 109,A01,091882,Touri; Behrouz,48,0,70,22
1650139737351,ECE 180,A00,083140,Abi Samra; Nicholas Camill,24,0,30,6
1650139737351,ECE 180,B00,083141,Abi Samra; Nicholas Camill,8,0,30,22
1650139743379,MATH 10A,A01,083735,Patchell; Gregory David,12,0,30,18
1650139743379,MATH 10A,A02,083736,Patchell; Gregory David,28,0,30,2
1650139743379,MATH 10A,A03,083737,Patchell; Gregory David,26,0,30,4
1650139749402,MATH 10B,A01,083207,Staff,0,5,30,30
1650139749402,MATH 10B,A02,083208,Staff,0,4,30,30
1650139749402,MATH 10B,B01,083739,Staff,18,0,30,12
1650139749402,MATH 10B,B02,083740,Staff,29,0,30,1
1650139755427,MATH 18,A01,083743,Staff,10,0,30,20
1650139755427,MATH 18,A02,083744,Staff,28,0,30,2
1650139755427,MATH 18,A03,083745,Staff,23,0,30,7
1650139755427,MATH 18,A04,083746,Staff,27,0,30,3
1650139755427,MATH 18,B01,083748,Staff,0,9,30,30
1650139755427,MATH 18,B02,083749,Staff,0,7,30,30
1650139755427,MATH 18,B03,083750,Staff,0,6,30,30
1650139755427,MATH 18,B04,083751,Staff,0,7,30,30
1650139761451,MATH 20A,A01,083754,Staff,26,0,40,14
1650139767475,MATH 20B,A01,083756,Staff,0,5,30,30
1650139767475,MATH 20B,A02,083757,Staff,0,4,30,30
1650139773500,MATH 20C,A01,083760,Staff,0,11,30,30
1650139773500,MATH 20C,A02,083761,Staff,0,12,30,30
1650139773500,MATH 20C,B01,083762,Staff,14,0,30,16
1650139773500,MATH 20C,B02,083763,Staff,28,0,30,2
1650139779525,MATH 20D,A01,083765,Staff,0,2,30,30
1650139779525,MATH 20D,A02,083766,Staff,11,0,30,19
1650139779525,MATH 20D,A03,083767,Staff,28,0,30,2
1650139785555,MATH 20E,A01,083771,Staff,8,0,30,22
1650139785555,MATH 20E,A02,083772,Staff,20,0,30,10
1650139785555,MATH 20E,B01,083773,Staff,0,0,30,30
1650139785555,MATH 20E,B02,083774,Staff,13,0,30,17
1650139791588,MATH 103A,A01,083777,Staff,0,8,30,30
1650139791588,MATH 103A,A02,083778,Staff,0,8,30,30
1650139791588,MATH 103A,B01,083779,Staff,0,9,30,30
1650139791588,MATH 103A,B02,083780,Staff,0,6,30,30
1650139797615,MATH 105,A01,085443,Staff,0,13,30,30
1650139803639,MATH 109,A01,083213,Anzaldo; Leesa B,0,3,30,30
1650139803639,MATH 109,A02,083214,Anzaldo; Leesa B,0,5,30,30
1650139803639,MATH 109,B01,083215,Anzaldo; Leesa B,0,4,30,30
1650139803639,MATH 109,B02,083216,Anzaldo; Leesa B,0,4,30,30
1650139809664,MATH 142A,A01,083219,Chow; Bennett,0,11,30,30
1650139809664,MATH 142A,A02,083220,Chow; Bennett,0,10,30,30
1650139809664,MATH 142A,B01,083221,Chow; Bennett,0,10,30,30
1650139809664,MATH 142A,B02,083222,Chow; Bennett,0,11,30,30
1650139815688,MATH 193A,A01,083224,Staff,0,3,30,30
1650139815688,MATH 193A,A02,083225,Staff,0,4,30,30
1650139815688,MATH 193A,A03,083781,Staff,0,0,30,30
1650139815688,MATH 193A,A04,083782,Staff,0,0,30,30
1650139821715,MATH 197,001,091859,McAuley; Julian John,9998,0,9999,1
1650139827776,COGS 9,A01,083615,Staff,0,14,60,60
1650139833800,COGS 11,A01,083617,Boyle; Mary E. T.,24,0,40,16
1650139839834,COGS 13,A01,083071,Staff,0,28,40,40
1650139845858,COGS 14A,A01,092681,Staff,0,10,100,100
1650139851884,COGS 14B,A01,083073,Cheng; Tzu-Han,0,4,50,50
1650139857907,COGS 17,A01,092677,Staff,34,0,75,41
1650139863936,COGS 100,A01,083619,Staff,0,21,60,60
1650139869959,COGS 101A,A01,083621,Davis; Joshua Daniel,0,18,60,60
1650139875982,COGS 101B,A01,091572,Staff,10,0,60,50
1650139882010,COGS 101C,A01,083625,Delgado; Tania,21,0,30,9
1650139888034,COGS 107A,A01,083627,Boyle; Mary E. T.,0,5,60,60
1650139894056,COGS 118A,A01,083075,Staff,17,0,60,43
1650139900152,CSE 3,A50,083646,Miranda; Gregory Joseph,22,0,38,16
1650139900152,CSE 3,A51,083647,Miranda; Gregory Joseph,37,0,37,0
1650139906185,CSE 8A,A50,083650,Miranda; Gregory Joseph,0,16,40,40
1650139912212,CSE 11,A01,083080,Cao; Yingjun,0,66,40,40
1650139918234,CSE 12,A01,083652,Staff,0,3,100,100
1650139924262,CSE 15L,A01,083654,Staff,0,0,50,50
1650139924262,CSE 15L,A02,083655,Staff,9,0,50,41
1650139930285,CSE 20,A01,083657,Staff,56,0,80,24
1650139936310,CSE 30,A01,083084,Eldon; John,0,63,40,40
1650139942336,CSE 100,A01,083659,Cao; Yingjun,0,61,50,50
1650139948359,CSE 134B,A01,083661,Powell; Thomas Allan,0,27,65,65
1650139954382,CSE 140,A01,083663,Staff,4,0,75,71
1650139960409,CSE 140L,A01,083088,Eldon; John,0,1,75,75
1650139966433,CSE 175,A01,083665,Kumar; Rakesh,8,0,25,17
1650139972456,CSE 190,A00,092507,Dubnov; Shlomo,14,0,20,6
1650139978488,ECE 45,A01,083139,Staff,0,13,40,40
1650139984514,ECE 65,A50,083695,Staff,0,4,30,30
1650139990541,ECE 109,A01,091882,Touri; Behrouz,48,0,70,22
1650139996564,ECE 180,A00,083140,Abi Samra; Nicholas Camill,24,0,30,6
1650139996564,ECE 180,B00,083141,Abi Samra; Nicholas Camill,8,0,30,22
1650140002589,MATH 10A,A01,083735,Patchell; Gregory David,12,0,30,18
1650140002589,MATH 10A,A02,083736,Patchell; Gregory David,28,0,30,2
1650140002589,MATH 10A,A03,083737,Patchell; Gregory David,26,0,30,4
1650140008615,MATH 10B,A01,083207,Staff,0,5,30,30
1650140008615,MATH 10B,A02,083208,Staff,0,4,30,30
1650140008615,MATH 10B,B01,083739,Staff,18,0,30,12
1650140008615,MATH 10B,B02,083740,Staff,29,0,30,1
1650140014650,MATH 18,A01,083743,Staff,10,0,30,20
1650140014650,MATH 18,A02,083744,Staff,28,0,30,2
1650140014650,MATH 18,A03,083745,Staff,23,0,30,7
1650140014650,MATH 18,A04,083746,Staff,27,0,30,3
1650140014650,MATH 18,B01,083748,Staff,0,9,30,30
1650140014650,MATH 18,B02,083749,Staff,0,7,30,30
1650140014650,MATH 18,B03,083750,Staff,0,6,30,30
1650140014650,MATH 18,B04,083751,Staff,0,7,30,30
1650140020679,MATH 20A,A01,083754,Staff,26,0,40,14
1650140026706,MATH 20B,A01,083756,Staff,0,5,30,30
1650140026706,MATH 20B,A02,083757,Staff,0,4,30,30
1650140032730,MATH 20C,A01,083760,Staff,0,11,30,30
1650140032730,MATH 20C,A02,083761,Staff,0,12,30,30
1650140032730,MATH 20C,B01,083762,Staff,14,0,30,16
1650140032730,MATH 20C,B02,083763,Staff,28,0,30,2
1650140038758,MATH 20D,A01,083765,Staff,0,2,30,30
1650140038758,MATH 20D,A02,083766,Staff,11,0,30,19
1650140038758,MATH 20D,A03,083767,Staff,28,0,30,2
1650140044784,MATH 20E,A01,083771,Staff,8,0,30,22
1650140044784,MATH 20E,A02,083772,Staff,20,0,30,10
1650140044784,MATH 20E,B01,083773,Staff,0,0,30,30
1650140044784,MATH 20E,B02,083774,Staff,13,0,30,17
1650140050813,MATH 103A,A01,083777,Staff,0,8,30,30
1650140050813,MATH 103A,A02,083778,Staff,0,8,30,30
1650140050813,MATH 103A,B01,083779,Staff,0,9,30,30
1650140050813,MATH 103A,B02,083780,Staff,0,6,30,30
1650140056836,MATH 105,A01,085443,Staff,0,13,30,30
1650140062863,MATH 109,A01,083213,Anzaldo; Leesa B,0,3,30,30
1650140062863,MATH 109,A02,083214,Anzaldo; Leesa B,0,5,30,30
1650140062863,MATH 109,B01,083215,Anzaldo; Leesa B,0,4,30,30
1650140062863,MATH 109,B02,083216,Anzaldo; Leesa B,0,4,30,30
1650140068890,MATH 142A,A01,083219,Chow; Bennett,0,11,30,30
1650140068890,MATH 142A,A02,083220,Chow; Bennett,0,10,30,30
1650140068890,MATH 142A,B01,083221,Chow; Bennett,0,10,30,30
1650140068890,MATH 142A,B02,083222,Chow; Bennett,0,11,30,30
1650140074918,MATH 193A,A01,083224,Staff,0,3,30,30
1650140074918,MATH 193A,A02,083225,Staff,0,4,30,30
1650140074918,MATH 193A,A03,083781,Staff,0,0,30,30
1650140074918,MATH 193A,A04,083782,Staff,0,0,30,30
1650140080945,MATH 197,001,091859,McAuley; Julian John,9998,0,9999,1
1650140086997,COGS 9,A01,083615,Staff,0,14,60,60
1650140093021,COGS 11,A01,083617,Boyle; Mary E. T.,24,0,40,16
1650140099044,COGS 13,A01,083071,Staff,0,28,40,40
1650140105070,COGS 14A,A01,092681,Staff,0,10,100,100
1650140111092,COGS 14B,A01,083073,Cheng; Tzu-Han,0,4,50,50
1650140117119,COGS 17,A01,092677,Staff,34,0,75,41
1650140123143,COGS 100,A01,083619,Staff,0,21,60,60
1650140129168,COGS 101A,A01,083621,Davis; Joshua Daniel,0,18,60,60
1650140135192,COGS 101B,A01,091572,Staff,10,0,60,50
1650140145930,COGS 101C,A01,083625,Delgado; Tania,21,0,30,9
1650140151954,COGS 107A,A01,083627,Boyle; Mary E. T.,0,5,60,60
1650140157978,COGS 118A,A01,083075,Staff,17,0,60,43
1650140164002,CSE 3,A50,083646,Miranda; Gregory Joseph,22,0,38,16
1650140164002,CSE 3,A51,083647,Miranda; Gregory Joseph,37,0,37,0
1650140170029,CSE 8A,A50,083650,Miranda; Gregory Joseph,0,16,40,40
1650140176053,CSE 11,A01,083080,Cao; Yingjun,0,66,40,40
1650140182080,CSE 12,A01,083652,Staff,0,3,100,100
1650140188103,CSE 15L,A01,083654,Staff,0,0,50,50
1650140188103,CSE 15L,A02,083655,Staff,9,0,50,41
1650140194128,CSE 20,A01,083657,Staff,56,0,80,24
1650140200153,CSE 30,A01,083084,Eldon; John,0,63,40,40
1650140206185,CSE 100,A01,083659,Cao; Yingjun,0,61,50,50
1650140212208,CSE 134B,A01,083661,Powell; Thomas Allan,0,27,65,65
1650140218231,CSE 140,A01,083663,Staff,4,0,75,71
1650140224255,CSE 140L,A01,083088,Eldon; John,0,1,75,75
1650140230279,CSE 175,A01,083665,Kumar; Rakesh,8,0,25,17
1650140236305,CSE 190,A00,092507,Dubnov; Shlomo,14,0,20,6
1650140242332,ECE 45,A01,083139,Staff,0,13,40,40
1650140248356,ECE 65,A50,083695,Staff,0,4,30,30
1650140254380,ECE 109,A01,091882,Touri; Behrouz,48,0,70,22
1650140260411,ECE 180,A00,083140,Abi Samra; Nicholas Camill,24,0,30,6
1650140260411,ECE 180,B00,083141,Abi Samra; Nicholas Camill,8,0,30,22
1650140266467,MATH 10A,A01,083735,Patchell; Gregory David,12,0,30,18
1650140266467,MATH 10A,A02,083736,Patchell; Gregory David,28,0,30,2
1650140266467,MATH 10A,A03,083737,Patchell; Gregory David,26,0,30,4
1650140272491,MATH 10B,A01,083207,Staff,0,5,30,30
1650140272491,MATH 10B,A02,083208,Staff,0,4,30,30
1650140272491,MATH 10B,B01,083739,Staff,18,0,30,12
1650140272491,MATH 10B,B02,083740,Staff,29,0,30,1
1650140278517,MATH 18,A01,083743,Staff,10,0,30,20
1650140278517,MATH 18,A02,083744,Staff,28,0,30,2
1650140278517,MATH 18,A03,083745,Staff,23,0,30,7
1650140278517,MATH 18,A04,083746,Staff,27,0,30,3
1650140278517,MATH 18,B01,083748,Staff,0,9,30,30
1650140278517,MATH 18,B02,083749,Staff,0,7,30,30
1650140278517,MATH 18,B03,083750,Staff,0,6,30,30
1650140278517,MATH 18,B04,083751,Staff,0,7,30,30
1650140284544,MATH 20A,A01,083754,Staff,26,0,40,14
1650140290571,MATH 20B,A01,083756,Staff,0,5,30,30
1650140290571,MATH 20B,A02,083757,Staff,0,4,30,30
1650140296599,MATH 20C,A01,083760,Staff,0,11,30,30
1650140296599,MATH 20C,A02,083761,Staff,0,12,30,30
1650140296599,MATH 20C,B01,083762,Staff,14,0,30,16
1650140296599,MATH 20C,B02,083763,Staff,28,0,30,2
1650140302623,MATH 20D,A01,083765,Staff,0,2,30,30
1650140302623,MATH 20D,A02,083766,Staff,11,0,30,19
1650140302623,MATH 20D,A03,083767,Staff,28,0,30,2
1650140308648,MATH 20E,A01,083771,Staff,8,0,30,22
1650140308648,MATH 20E,A02,083772,Staff,20,0,30,10
1650140308648,MATH 20E,B01,083773,Staff,0,0,30,30
1650140308648,MATH 20E,B02,083774,Staff,13,0,30,17
1650140314678,MATH 103A,A01,083777,Staff,0,8,30,30
1650140314678,MATH 103A,A02,083778,Staff,0,8,30,30
1650140314678,MATH 103A,B01,083779,Staff,0,9,30,30
1650140314678,MATH 103A,B02,083780,Staff,0,6,30,30
1650140320704,MATH 105,A01,085443,Staff,0,13,30,30
1650140326731,MATH 109,A01,083213,Anzaldo; Leesa B,0,3,30,30
1650140326731,MATH 109,A02,083214,Anzaldo; Leesa B,0,5,30,30
1650140326731,MATH 109,B01,083215,Anzaldo; Leesa B,0,4,30,30
1650140326731,MATH 109,B02,083216,Anzaldo; Leesa B,0,4,30,30
1650140332756,MATH 142A,A01,083219,Chow; Bennett,0,11,30,30
1650140332756,MATH 142A,A02,083220,Chow; Bennett,0,10,30,30
1650140332756,MATH 142A,B01,083221,Chow; Bennett,0,10,30,30
1650140332756,MATH 142A,B02,083222,Chow; Bennett,0,11,30,30
1650140338779,MATH 193A,A01,083224,Staff,0,3,30,30
1650140338779,MATH 193A,A02,083225,Staff,0,4,30,30
1650140338779,MATH 193A,A03,083781,Staff,0,0,30,30
1650140338779,MATH 193A,A04,083782,Staff,0,0,30,30
1650140344810,MATH 197,001,091859,McAuley; Julian John,9998,0,9999,1
1650140350864,COGS 9,A01,083615,Staff,0,14,60,60
1650140356888,COGS 11,A01,083617,Boyle; Mary E. T.,24,0,40,16
1650140362914,COGS 13,A01,083071,Staff,0,28,40,40
1650140368940,COGS 14A,A01,092681,Staff,0,10,100,100
1650140374964,COGS 14B,A01,083073,Cheng; Tzu-Han,0,4,50,50
1650140380990,COGS 17,A01,092677,Staff,34,0,75,41
1650140387014,COGS 100,A01,083619,Staff,0,21,60,60
1650140393037,COGS 101A,A01,083621,Davis; Joshua Daniel,0,18,60,60
1650140399060,COGS 101B,A01,091572,Staff,10,0,60,50
1650140405084,COGS 101C,A01,083625,Delgado; Tania,21,0,30,9
1650140411106,COGS 107A,A01,083627,Boyle; Mary E. T.,0,5,60,60
1650140417133,COGS 118A,A01,083075,Staff,17,0,60,43
1650140423159,CSE 3,A50,083646,Miranda; Gregory Joseph,22,0,38,16
1650140423159,CSE 3,A51,083647,Miranda; Gregory Joseph,37,0,37,0
1650140429197,CSE 8A,A50,083650,Miranda; Gregory Joseph,0,16,40,40
1650140435223,CSE 11,A01,083080,Cao; Yingjun,0,66,40,40
1650140441248,CSE 12,A01,083652,Staff,0,3,100,100
1650140447274,CSE 15L,A01,083654,Staff,0,0,50,50
1650140447274,CSE 15L,A02,083655,Staff,9,0,50,41
1650140453306,CSE 20,A01,083657,Staff,56,0,80,24
1650140459328,CSE 30,A01,083084,Eldon; John,0,63,40,40
1650140465350,CSE 100,A01,083659,Cao; Yingjun,0,61,50,50
1650140471381,CSE 134B,A01,083661,Powell; Thomas Allan,0,27,65,65
1650140477407,CSE 140,A01,083663,Staff,4,0,75,71
1650140483436,CSE 140L,A01,083088,Eldon; John,0,1,75,75
1650140489457,CSE 175,A01,083665,Kumar; Rakesh,8,0,25,17
1650140495484,CSE 190,A00,092507,Dubnov; Shlomo,14,0,20,6
1650140501584,ECE 45,A01,083139,Staff,0,13,40,40
1650140507611,ECE 65,A50,083695,Staff,0,4,30,30
1650140513638,ECE 109,A01,091882,Touri; Behrouz,48,0,70,22
1650140519665,ECE 180,A00,083140,Abi Samra; Nicholas Camill,24,0,30,6
1650140519665,ECE 180,B00,083141,Abi Samra; Nicholas Camill,8,0,30,22
1650140525689,MATH 10A,A01,083735,Patchell; Gregory David,12,0,30,18
1650140525689,MATH 10A,A02,083736,Patchell; Gregory David,28,0,30,2
1650140525689,MATH 10A,A03,083737,Patchell; Gregory David,26,0,30,4
1650140531717,MATH 10B,A01,083207,Staff,0,5,30,30
1650140531717,MATH 10B,A02,083208,Staff,0,4,30,30
1650140531717,MATH 10B,B01,083739,Staff,18,0,30,12
1650140531717,MATH 10B,B02,083740,Staff,29,0,30,1
1650140537748,MATH 18,A01,083743,Staff,10,0,30,20
1650140537748,MATH 18,A02,083744,Staff,28,0,30,2
1650140537748,MATH 18,A03,083745,Staff,23,0,30,7
1650140537748,MATH 18,A04,083746,Staff,27,0,30,3
1650140537748,MATH 18,B01,083748,Staff,0,9,30,30
1650140537748,MATH 18,B02,083749,Staff,0,7,30,30
1650140537748,MATH 18,B03,083750,Staff,0,6,30,30
1650140537748,MATH 18,B04,083751,Staff,0,7,30,30
1650140543778,MATH 20A,A01,083754,Staff,26,0,40,14
1650140549802,MATH 20B,A01,083756,Staff,0,5,30,30
1650140549802,MATH 20B,A02,083757,Staff,0,4,30,30
1650140555829,MATH 20C,A01,083760,Staff,0,11,30,30
1650140555829,MATH 20C,A02,083761,Staff,0,12,30,30
1650140555829,MATH 20C,B01,083762,Staff,14,0,30,16
1650140555829,MATH 20C,B02,083763,Staff,28,0,30,2
1650140561858,MATH 20D,A01,083765,Staff,0,2,30,30
1650140561858,MATH 20D,A02,083766,Staff,11,0,30,19
1650140561858,MATH 20D,A03,083767,Staff,28,0,30,2
1650140567887,MATH 20E,A01,083771,Staff,8,0,30,22
1650140567887,MATH 20E,A02,083772,Staff,20,0,30,10
1650140567887,MATH 20E,B01,083773,Staff,0,0,30,30
1650140567887,MATH 20E,B02,083774,Staff,13,0,30,17
1650140573916,MATH 103A,A01,083777,Staff,0,8,30,30
1650140573916,MATH 103A,A02,083778,Staff,0,8,30,30
1650140573916,MATH 103A,B01,083779,Staff,0,9,30,30
1650140573916,MATH 103A,B02,083780,Staff,0,6,30,30
1650140579939,MATH 105,A01,085443,Staff,0,13,30,30
1650140585974,MATH 109,A01,083213,Anzaldo; Leesa B,0,3,30,30
1650140585974,MATH 109,A02,083214,Anzaldo; Leesa B,0,5,30,30
1650140585974,MATH 109,B01,083215,Anzaldo; Leesa B,0,4,30,30
1650140585974,MATH 109,B02,083216,Anzaldo; Leesa B,0,4,30,30
1650140592003,MATH 142A,A01,083219,Chow; Bennett,0,11,30,30
1650140592003,MATH 142A,A02,083220,Chow; Bennett,0,10,30,30
1650140592003,MATH 142A,B01,083221,Chow; Bennett,0,10,30,30
1650140592003,MATH 142A,B02,083222,Chow; Bennett,0,11,30,30
1650140598026,MATH 193A,A01,083224,Staff,0,3,30,30
1650140598026,MATH 193A,A02,083225,Staff,0,4,30,30
1650140598026,MATH 193A,A03,083781,Staff,0,0,30,30
1650140598026,MATH 193A,A04,083782,Staff,0,0,30,30
1650140604048,MATH 197,001,091859,McAuley; Julian John,9998,0,9999,1
1650140610127,COGS 9,A01,083615,Staff,0,14,60,60
1650140616154,COGS 11,A01,083617,Boyle; Mary E. T.,24,0,40,16
1650140622181,COGS 13,A01,083071,Staff,0,28,40,40
1650140628204,COGS 14A,A01,092681,Staff,0,10,100,100
1650140634227,COGS 14B,A01,083073,Cheng; Tzu-Han,0,4,50,50
1650140640263,COGS 17,A01,092677,Staff,34,0,75,41
1650140646300,COGS 100,A01,083619,Staff,0,21,60,60
1650140652327,COGS 101A,A01,083621,Davis; Joshua Daniel,0,18,60,60
1650140658350,COGS 101B,A01,091572,Staff,10,0,60,50
1650140664374,COGS 101C,A01,083625,Delgado; Tania,21,0,30,9
1650140670401,COGS 107A,A01,083627,Boyle; Mary E. T.,0,5,60,60
1650140676425,COGS 118A,A01,083075,Staff,17,0,60,43
1650140682449,CSE 3,A50,083646,Miranda; Gregory Joseph,22,0,38,16
1650140682449,CSE 3,A51,083647,Miranda; Gregory Joseph,37,0,37,0
1650140688478,CSE 8A,A50,083650,Miranda; Gregory Joseph,0,16,40,40
1650140694502,CSE 11,A01,083080,Cao; Yingjun,0,66,40,40
1650140700526,CSE 12,A01,083652,Staff,0,3,100,100
1650140706551,CSE 15L,A01,083654,Staff,0,0,50,50
1650140706551,CSE 15L,A02,083655,Staff,9,0,50,41
1650140712577,CSE 20,A01,083657,Staff,56,0,80,24
1650140718609,CSE 30,A01,083084,Eldon; John,0,63,40,40
1650140724633,CSE 100,A01,083659,Cao; Yingjun,0,61,50,50
1650140730657,CSE 134B,A01,083661,Powell; Thomas Allan,0,27,65,65
1650140736683,CSE 140,A01,083663,Staff,4,0,75,71
1650140742708,CSE 140L,A01,083088,Eldon; John,0,1,75,75
1650140748735,CSE 175,A01,083665,Kumar; Rakesh,8,0,25,17
1650140754760,CSE 190,A00,092507,Dubnov; Shlomo,14,0,20,6
1650140760781,ECE 45,A01,083139,Staff,0,13,40,40
1650140766804,ECE 65,A50,083695,Staff,0,4,30,30
1650140772828,ECE 109,A01,091882,Touri; Behrouz,48,0,70,22
1650140778858,ECE 180,A00,083140,Abi Samra; Nicholas Camill,24,0,30,6
1650140778858,ECE 180,B00,083141,Abi Samra; Nicholas Camill,8,0,30,22
1650140784886,MATH 10A,A01,083735,Patchell; Gregory David,12,0,30,18
1650140784886,MATH 10A,A02,083736,Patchell; Gregory David,28,0,30,2
1650140784886,MATH 10A,A03,083737,Patchell; Gregory David,26,0,30,4
1650140790910,MATH 10B,A01,083207,Staff,0,5,30,30
1650140790910,MATH 10B,A02,083208,Staff,0,4,30,30
1650140790910,MATH 10B,B01,083739,Staff,18,0,30,12
1650140790910,MATH 10B,B02,083740,Staff,29,0,30,1
1650140796937,MATH 18,A01,083743,Staff,10,0,30,20
1650140796937,MATH 18,A02,083744,Staff,28,0,30,2
1650140796937,MATH 18,A03,083745,Staff,23,0,30,7
1650140796937,MATH 18,A04,083746,Staff,27,0,30,3
1650140796937,MATH 18,B01,083748,Staff,0,9,30,30
1650140796937,MATH 18,B02,083749,Staff,0,7,30,30
1650140796937,MATH 18,B03,083750,Staff,0,6,30,30
1650140796937,MATH 18,B04,083751,Staff,0,7,30,30
1650140802961,MATH 20A,A01,083754,Staff,26,0,40,14
1650140808988,MATH 20B,A01,083756,Staff,0,5,30,30
1650140808988,MATH 20B,A02,083757,Staff,0,4,30,30
1650140815012,MATH 20C,A01,083760,Staff,0,11,30,30
1650140815012,MATH 20C,A02,083761,Staff,0,12,30,30
1650140815012,MATH 20C,B01,083762,Staff,14,0,30,16
1650140815012,MATH 20C,B02,083763,Staff,28,0,30,2
1650140821040,MATH 20D,A01,083765,Staff,0,2,30,30
1650140821040,MATH 20D,A02,083766,Staff,11,0,30,19
1650140821040,MATH 20D,A03,083767,Staff,28,0,30,2
1650140827064,MATH 20E,A01,083771,Staff,8,0,30,22
1650140827064,MATH 20E,A02,083772,Staff,20,0,30,10
1650140827064,MATH 20E,B01,083773,Staff,0,0,30,30
1650140827064,MATH 20E,B02,083774,Staff,13,0,30,17
1650140833088,MATH 103A,A01,083777,Staff,0,8,30,30
1650140833088,MATH 103A,A02,083778,Staff,0,8,30,30
1650140833088,MATH 103A,B01,083779,Staff,0,9,30,30
1650140833088,MATH 103A,B02,083780,Staff,0,6,30,30
1650140839116,MATH 105,A01,085443,Staff,0,13,30,30
1650140845142,MATH 109,A01,083213,Anzaldo; Leesa B,0,3,30,30
1650140845142,MATH 109,A02,083214,Anzaldo; Leesa B,0,5,30,30
1650140845142,MATH 109,B01,083215,Anzaldo; Leesa B,0,4,30,30
1650140845142,MATH 109,B02,083216,Anzaldo; Leesa B,0,4,30,30
1650140851164,MATH 142A,A01,083219,Chow; Bennett,0,11,30,30
1650140851164,MATH 142A,A02,083220,Chow; Bennett,0,10,30,30
1650140851164,MATH 142A,B01,083221,Chow; Bennett,0,10,30,30
1650140851164,MATH 142A,B02,083222,Chow; Bennett,0,11,30,30
1650140857187,MATH 193A,A01,083224,Staff,0,3,30,30
1650140857187,MATH 193A,A02,083225,Staff,0,4,30,30
1650140857187,MATH 193A,A03,083781,Staff,0,0,30,30
1650140857187,MATH 193A,A04,083782,Staff,0,0,30,30
1650140863210,MATH 197,001,091859,McAuley; Julian John,9998,0,9999,1
1650140869268,COGS 9,A01,083615,Staff,0,14,60,60
1650140875296,COGS 11,A01,083617,Boyle; Mary E. T.,24,0,40,16
1650140881319,COGS 13,A01,083071,Staff,0,28,40,40
1650140887346,COGS 14A,A01,092681,Staff,0,10,100,100
1650140893369,COGS 14B,A01,083073,Cheng; Tzu-Han,0,4,50,50
1650140899392,COGS 17,A01,092677,Staff,34,0,75,41
1650140905415,COGS 100,A01,083619,Staff,0,21,60,60
1650140911442,COGS 101A,A01,083621,Davis; Joshua Daniel,0,18,60,60
1650140917466,COGS 101B,A01,091572,Staff,10,0,60,50
1650140923489,COGS 101C,A01,083625,Delgado; Tania,21,0,30,9
1650140929516,COGS 107A,A01,083627,Boyle; Mary E. T.,0,5,60,60
1650140935540,COGS 118A,A01,083075,Staff,17,0,60,43
1650140941567,CSE 3,A50,083646,Miranda; Gregory Joseph,22,0,38,16
1650140941567,CSE 3,A51,083647,Miranda; Gregory Joseph,37,0,37,0
1650140947595,CSE 8A,A50,083650,Miranda; Gregory Joseph,0,16,40,40
1650140953618,CSE 11,A01,083080,Cao; Yingjun,0,66,40,40
1650140959649,CSE 12,A01,083652,Staff,0,3,100,100
1650140965675,CSE 15L,A01,083654,Staff,0,0,50,50
1650140965675,CSE 15L,A02,083655,Staff,9,0,50,41
1650140971700,CSE 20,A01,083657,Staff,56,0,80,24
1650140977727,CSE 30,A01,083084,Eldon; John,0,63,40,40
1650140983750,CSE 100,A01,083659,Cao; Yingjun,0,61,50,50
1650140989774,CSE 134B,A01,083661,Powell; Thomas Allan,0,27,65,65
1650140995801,CSE 140,A01,083663,Staff,4,0,75,71
1650141001824,CSE 140L,A01,083088,Eldon; John,0,1,75,75
1650141007852,CSE 175,A01,083665,Kumar; Rakesh,8,0,25,17
1650141013879,CSE 190,A00,092507,Dubnov; Shlomo,14,0,20,6
1650141019901,ECE 45,A01,083139,Staff,0,13,40,40
1650141025934,ECE 65,A50,083695,Staff,0,4,30,30
1650141031958,ECE 109,A01,091882,Touri; Behrouz,48,0,70,22
1650141037987,ECE 180,A00,083140,Abi Samra; Nicholas Camill,24,0,30,6
1650141037987,ECE 180,B00,083141,Abi Samra; Nicholas Camill,8,0,30,22
1650141044021,MATH 10A,A01,083735,Patchell; Gregory David,12,0,30,18
1650141044021,MATH 10A,A02,083736,Patchell; Gregory David,28,0,30,2
1650141044021,MATH 10A,A03,083737,Patchell; Gregory David,26,0,30,4
1650141050046,MATH 10B,A01,083207,Staff,0,5,30,30
1650141050046,MATH 10B,A02,083208,Staff,0,4,30,30
1650141050046,MATH 10B,B01,083739,Staff,18,0,30,12
1650141050046,MATH 10B,B02,083740,Staff,29,0,30,1
1650141056075,MATH 18,A01,083743,Staff,10,0,30,20
1650141056075,MATH 18,A02,083744,Staff,28,0,30,2
1650141056075,MATH 18,A03,083745,Staff,23,0,30,7
1650141056075,MATH 18,A04,083746,Staff,27,0,30,3
1650141056075,MATH 18,B01,083748,Staff,0,9,30,30
1650141056075,MATH 18,B02,083749,Staff,0,7,30,30
1650141056075,MATH 18,B03,083750,Staff,0,6,30,30
1650141056075,MATH 18,B04,083751,Staff,0,7,30,30
1650141062099,MATH 20A,A01,083754,Staff,26,0,40,14
1650141068126,MATH 20B,A01,083756,Staff,0,5,30,30
1650141068126,MATH 20B,A02,083757,Staff,0,4,30,30
1650141074153,MATH 20C,A01,083760,Staff,0,11,30,30
1650141074153,MATH 20C,A02,083761,Staff,0,12,30,30
1650141074153,MATH 20C,B01,083762,Staff,14,0,30,16
1650141074153,MATH 20C,B02,083763,Staff,28,0,30,2
1650141080179,MATH 20D,A01,083765,Staff,0,2,30,30
1650141080179,MATH 20D,A02,083766,Staff,11,0,30,19
1650141080179,MATH 20D,A03,083767,Staff,28,0,30,2
1650141086201,MATH 20E,A01,083771,Staff,8,0,30,22
1650141086201,MATH 20E,A02,083772,Staff,20,0,30,10
1650141086201,MATH 20E,B01,083773,Staff,0,0,30,30
1650141086201,MATH 20E,B02,083774,Staff,13,0,30,17
1650141092226,MATH 103A,A01,083777,Staff,0,8,30,30
1650141092226,MATH 103A,A02,083778,Staff,0,8,30,30
1650141092226,MATH 103A,B01,083779,Staff,0,9,30,30
1650141092226,MATH 103A,B02,083780,Staff,0,6,30,30
1650141098326,MATH 105,A01,085443,Staff,0,13,30,30
1650141104350,MATH 109,A01,083213,Anzaldo; Leesa B,0,3,30,30
1650141104350,MATH 109,A02,083214,Anzaldo; Leesa B,0,5,30,30
1650141104350,MATH 109,B01,083215,Anzaldo; Leesa B,0,4,30,30
1650141104350,MATH 109,B02,083216,Anzaldo; Leesa B,0,4,30,30
1650141110377,MATH 142A,A01,083219,Chow; Bennett,0,11,30,30
1650141110377,MATH 142A,A02,083220,Chow; Bennett,0,10,30,30
1650141110377,MATH 142A,B01,083221,Chow; Bennett,0,10,30,30
1650141110377,MATH 142A,B02,083222,Chow; Bennett,0,11,30,30
1650141116407,MATH 193A,A01,083224,Staff,0,3,30,30
1650141116407,MATH 193A,A02,083225,Staff,0,4,30,30
1650141116407,MATH 193A,A03,083781,Staff,0,0,30,30
1650141116407,MATH 193A,A04,083782,Staff,0,0,30,30
1650141122429,MATH 197,001,091859,McAuley; Julian John,9998,0,9999,1
1650141128489,COGS 9,A01,083615,Staff,0,14,60,60
1650141134514,COGS 11,A01,083617,Boyle; Mary E. T.,24,0,40,16
1650141140541,COGS 13,A01,083071,Staff,0,28,40,40
1650141146569,COGS 14A,A01,092681,Staff,0,10,100,100
1650141152593,COGS 14B,A01,083073,Cheng; Tzu-Han,0,4,50,50
1650141158622,COGS 17,A01,092677,Staff,34,0,75,41
1650141164647,COGS 100,A01,083619,Staff,0,21,60,60
1650141170679,COGS 101A,A01,083621,Davis; Joshua Daniel,0,18,60,60
1650141176703,COGS 101B,A01,091572,Staff,10,0,60,50
1650141182731,COGS 101C,A01,083625,Delgado; Tania,21,0,30,9
1650141188754,COGS 107A,A01,083627,Boyle; Mary E. T.,0,5,60,60
1650141194786,COGS 118A,A01,083075,Staff,17,0,60,43
1650141200813,CSE 3,A50,083646,Miranda; Gregory Joseph,22,0,38,16
1650141200813,CSE 3,A51,083647,Miranda; Gregory Joseph,37,0,37,0
1650141206836,CSE 8A,A50,083650,Miranda; Gregory Joseph,0,16,40,40
1650141212859,CSE 11,A01,083080,Cao; Yingjun,0,66,40,40
1650141218890,CSE 12,A01,083652,Staff,0,3,100,100
1650141224916,CSE 15L,A01,083654,Staff,0,0,50,50
1650141224916,CSE 15L,A02,083655,Staff,9,0,50,41
1650141230940,CSE 20,A01,083657,Staff,56,0,80,24
1650141236964,CSE 30,A01,083084,Eldon; John,0,63,40,40
1650141242989,CSE 100,A01,083659,Cao; Yingjun,0,61,50,50
1650141249017,CSE 134B,A01,083661,Powell; Thomas Allan,0,27,65,65
1650141255040,CSE 140,A01,083663,Staff,4,0,75,71
1650141261064,CSE 140L,A01,083088,Eldon; John,0,1,75,75
1650141267090,CSE 175,A01,083665,Kumar; Rakesh,8,0,25,17
1650141273116,CSE 190,A00,092507,Dubnov; Shlomo,14,0,20,6
1650141279141,ECE 45,A01,083139,Staff,0,13,40,40
1650141285170,ECE 65,A50,083695,Staff,0,4,30,30
1650141291196,ECE 109,A01,091882,Touri; Behrouz,48,0,70,22
1650141297225,ECE 180,A00,083140,Abi Samra; Nicholas Camill,24,0,30,6
1650141297225,ECE 180,B00,083141,Abi Samra; Nicholas Camill,8,0,30,22
1650141303249,MATH 10A,A01,083735,Patchell; Gregory David,12,0,30,18
1650141303249,MATH 10A,A02,083736,Patchell; Gregory David,28,0,30,2
1650141303249,MATH 10A,A03,083737,Patchell; Gregory David,26,0,30,4
1650141309277,MATH 10B,A01,083207,Staff,0,5,30,30
1650141309277,MATH 10B,A02,083208,Staff,0,4,30,30
1650141309277,MATH 10B,B01,083739,Staff,18,0,30,12
1650141309277,MATH 10B,B02,083740,Staff,29,0,30,1
1650141315308,MATH 18,A01,083743,Staff,10,0,30,20
1650141315308,MATH 18,A02,083744,Staff,28,0,30,2
1650141315308,MATH 18,A03,083745,Staff,23,0,30,7
1650141315308,MATH 18,A04,083746,Staff,27,0,30,3
1650141315308,MATH 18,B01,083748,Staff,0,9,30,30
1650141315308,MATH 18,B02,083749,Staff,0,7,30,30
1650141315308,MATH 18,B03,083750,Staff,0,6,30,30
1650141315308,MATH 18,B04,083751,Staff,0,7,30,30
1650141321335,MATH 20A,A01,083754,Staff,26,0,40,14
1650141327375,MATH 20B,A01,083756,Staff,0,5,30,30
1650141327375,MATH 20B,A02,083757,Staff,0,4,30,30
1650141333403,MATH 20C,A01,083760,Staff,0,11,30,30
1650141333403,MATH 20C,A02,083761,Staff,0,12,30,30
1650141333403,MATH 20C,B01,083762,Staff,14,0,30,16
1650141333403,MATH 20C,B02,083763,Staff,28,0,30,2
1650141339436,MATH 20D,A01,083765,Staff,0,2,30,30
1650141339436,MATH 20D,A02,083766,Staff,11,0,30,19
1650141339436,MATH 20D,A03,083767,Staff,28,0,30,2
1650141345460,MATH 20E,A01,083771,Staff,8,0,30,22
1650141345460,MATH 20E,A02,083772,Staff,20,0,30,10
1650141345460,MATH 20E,B01,083773,Staff,0,0,30,30
1650141345460,MATH 20E,B02,083774,Staff,13,0,30,17
1650141351494,MATH 103A,A01,083777,Staff,0,8,30,30
1650141351494,MATH 103A,A02,083778,Staff,0,8,30,30
1650141351494,MATH 103A,B01,083779,Staff,0,9,30,30
1650141351494,MATH 103A,B02,083780,Staff,0,6,30,30
1650141357522,MATH 105,A01,085443,Staff,0,13,30,30
1650141363546,MATH 109,A01,083213,Anzaldo; Leesa B,0,3,30,30
1650141363546,MATH 109,A02,083214,Anzaldo; Leesa B,0,5,30,30
1650141363546,MATH 109,B01,083215,Anzaldo; Leesa B,0,4,30,30
1650141363546,MATH 109,B02,083216,Anzaldo; Leesa B,0,4,30,30
1650141369571,MATH 142A,A01,083219,Chow; Bennett,0,11,30,30
1650141369571,MATH 142A,A02,083220,Chow; Bennett,0,10,30,30
1650141369571,MATH 142A,B01,083221,Chow; Bennett,0,10,30,30
1650141369571,MATH 142A,B02,083222,Chow; Bennett,0,11,30,30
1650141375596,MATH 193A,A01,083224,Staff,0,3,30,30
1650141375596,MATH 193A,A02,083225,Staff,0,4,30,30
1650141375596,MATH 193A,A03,083781,Staff,0,0,30,30
1650141375596,MATH 193A,A04,083782,Staff,0,0,30,30
1650141381630,MATH 197,001,091859,McAuley; Julian John,9998,0,9999,1
1650141387700,COGS 9,A01,083615,Staff,0,14,60,60
1650141393728,COGS 11,A01,083617,Boyle; Mary E. T.,24,0,40,16
1650141399759,COGS 13,A01,083071,Staff,0,28,40,40
1650141405782,COGS 14A,A01,092681,Staff,0,10,100,100
1650141411811,COGS 14B,A01,083073,Cheng; Tzu-Han,0,4,50,50
1650141417845,COGS 17,A01,092677,Staff,34,0,75,41
1650141423868,COGS 100,A01,083619,Staff,0,21,60,60
1650141429896,COGS 101A,A01,083621,Davis; Joshua Daniel,0,18,60,60
1650141435918,COGS 101B,A01,091572,Staff,10,0,60,50
1650141441955,COGS 101C,A01,083625,Delgado; Tania,21,0,30,9
1650141447979,COGS 107A,A01,083627,Boyle; Mary E. T.,0,5,60,60
1650141454006,COGS 118A,A01,083075,Staff,17,0,60,43
1650141460031,CSE 3,A50,083646,Miranda; Gregory Joseph,22,0,38,16
1650141460031,CSE 3,A51,083647,Miranda; Gregory Joseph,37,0,37,0
1650141466058,CSE 8A,A50,083650,Miranda; Gregory Joseph,0,16,40,40
1650141472081,CSE 11,A01,083080,Cao; Yingjun,0,66,40,40
1650141478109,CSE 12,A01,083652,Staff,0,3,100,100
1650141484136,CSE 15L,A01,083654,Staff,0,0,50,50
1650141484136,CSE 15L,A02,083655,Staff,9,0,50,41
1650141490162,CSE 20,A01,083657,Staff,56,0,80,24
1650141496186,CSE 30,A01,083084,Eldon; John,0,63,40,40
1650141502208,CSE 100,A01,083659,Cao; Yingjun,0,61,50,50
1650141508234,CSE 134B,A01,083661,Powell; Thomas Allan,0,27,65,65
1650141514257,CSE 140,A01,083663,Staff,4,0,75,71
1650141520282,CSE 140L,A01,083088,Eldon; John,0,1,75,75
1650141526309,CSE 175,A01,083665,Kumar; Rakesh,8,0,25,17
1650141532333,CSE 190,A00,092507,Dubnov; Shlomo,14,0,20,6
1650141538356,ECE 45,A01,083139,Staff,0,13,40,40
1650141544378,ECE 65,A50,083695,Staff,0,4,30,30
1650141550408,ECE 109,A01,091882,Touri; Behrouz,48,0,70,22
1650141556443,ECE 180,A00,083140,Abi Samra; Nicholas Camill,24,0,30,6
1650141556443,ECE 180,B00,083141,Abi Samra; Nicholas Camill,8,0,30,22
1650141562470,MATH 10A,A01,083735,Patchell; Gregory David,12,0,30,18
1650141562470,MATH 10A,A02,083736,Patchell; Gregory David,28,0,30,2
1650141562470,MATH 10A,A03,083737,Patchell; Gregory David,26,0,30,4
1650141568499,MATH 10B,A01,083207,Staff,0,5,30,30
1650141568499,MATH 10B,A02,083208,Staff,0,4,30,30
1650141568499,MATH 10B,B01,083739,Staff,18,0,30,12
1650141568499,MATH 10B,B02,083740,Staff,29,0,30,1
1650141574525,MATH 18,A01,083743,Staff,10,0,30,20
1650141574525,MATH 18,A02,083744,Staff,28,0,30,2
1650141574525,MATH 18,A03,083745,Staff,23,0,30,7
1650141574525,MATH 18,A04,083746,Staff,27,0,30,3
1650141574525,MATH 18,B01,083748,Staff,0,9,30,30
1650141574525,MATH 18,B02,083749,Staff,0,7,30,30
1650141574525,MATH 18,B03,083750,Staff,0,6,30,30
1650141574525,MATH 18,B04,083751,Staff,0,7,30,30
1650141580550,MATH 20A,A01,083754,Staff,26,0,40,14
1650141586574,MATH 20B,A01,083756,Staff,0,5,30,30
1650141586574,MATH 20B,A02,083757,Staff,0,4,30,30
1650141592598,MATH 20C,A01,083760,Staff,0,11,30,30
1650141592598,MATH 20C,A02,083761,Staff,0,12,30,30
1650141592598,MATH 20C,B01,083762,Staff,14,0,30,16
1650141592598,MATH 20C,B02,083763,Staff,28,0,30,2
1650141598624,MATH 20D,A01,083765,Staff,0,2,30,30
1650141598624,MATH 20D,A02,083766,Staff,11,0,30,19
1650141598624,MATH 20D,A03,083767,Staff,28,0,30,2
1650141604654,MATH 20E,A01,083771,Staff,8,0,30,22
1650141604654,MATH 20E,A02,083772,Staff,20,0,30,10
1650141604654,MATH 20E,B01,083773,Staff,0,0,30,30
1650141604654,MATH 20E,B02,083774,Staff,13,0,30,17
1650141610678,MATH 103A,A01,083777,Staff,0,8,30,30
1650141610678,MATH 103A,A02,083778,Staff,0,8,30,30
1650141610678,MATH 103A,B01,083779,Staff,0,9,30,30
1650141610678,MATH 103A,B02,083780,Staff,0,6,30,30
1650141616701,MATH 105,A01,085443,Staff,0,13,30,30
1650141622730,MATH 109,A01,083213,Anzaldo; Leesa B,0,3,30,30
1650141622730,MATH 109,A02,083214,Anzaldo; Leesa B,0,5,30,30
1650141622730,MATH 109,B01,083215,Anzaldo; Leesa B,0,4,30,30
1650141622730,MATH 109,B02,083216,Anzaldo; Leesa B,0,4,30,30
1650141628758,MATH 142A,A01,083219,Chow; Bennett,0,11,30,30
1650141628758,MATH 142A,A02,083220,Chow; Bennett,0,10,30,30
1650141628758,MATH 142A,B01,083221,Chow; Bennett,0,10,30,30
1650141628758,MATH 142A,B02,083222,Chow; Bennett,0,11,30,30
1650141634782,MATH 193A,A01,083224,Staff,0,3,30,30
1650141634782,MATH 193A,A02,083225,Staff,0,4,30,30
1650141634782,MATH 193A,A03,083781,Staff,0,0,30,30
1650141634782,MATH 193A,A04,083782,Staff,0,0,30,30
1650141640820,MATH 197,001,091859,McAuley; Julian John,9998,0,9999,1
1650141646911,COGS 9,A01,083615,Staff,0,14,60,60
1650141652935,COGS 11,A01,083617,Boyle; Mary E. T.,24,0,40,16
1650141658957,COGS 13,A01,083071,Staff,0,28,40,40
1650141664983,COGS 14A,A01,092681,Staff,0,10,100,100
1650141671009,COGS 14B,A01,083073,Cheng; Tzu-Han,0,4,50,50
1650141677035,COGS 17,A01,092677,Staff,34,0,75,41
1650141683061,COGS 100,A01,083619,Staff,0,21,60,60
1650141689175,COGS 101A,A01,083621,Davis; Joshua Daniel,0,18,60,60
1650141695197,COGS 101B,A01,091572,Staff,10,0,60,50
1650141701219,COGS 101C,A01,083625,Delgado; Tania,21,0,30,9
1650141707242,COGS 107A,A01,083627,Boyle; Mary E. T.,0,5,60,60
1650141713268,COGS 118A,A01,083075,Staff,17,0,60,43
1650141719289,CSE 3,A50,083646,Miranda; Gregory Joseph,22,0,38,16
1650141719289,CSE 3,A51,083647,Miranda; Gregory Joseph,37,0,37,0
1650141725311,CSE 8A,A50,083650,Miranda; Gregory Joseph,0,16,40,40
1650141731339,CSE 11,A01,083080,Cao; Yingjun,0,66,40,40
1650141737366,CSE 12,A01,083652,Staff,0,3,100,100
1650141743394,CSE 15L,A01,083654,Staff,0,0,50,50
1650141743394,CSE 15L,A02,083655,Staff,9,0,50,41
1650141749418,CSE 20,A01,083657,Staff,56,0,80,24
1650141755442,CSE 30,A01,083084,Eldon; John,0,63,40,40
1650141761467,CSE 100,A01,083659,Cao; Yingjun,0,61,50,50
1650141767491,CSE 134B,A01,083661,Powell; Thomas Allan,0,27,65,65
1650141773517,CSE 140,A01,083663,Staff,4,0,75,71
1650141779538,CSE 140L,A01,083088,Eldon; John,0,1,75,75
1650141785560,CSE 175,A01,083665,Kumar; Rakesh,8,0,25,17
1650141791584,CSE 190,A00,092507,Dubnov; Shlomo,14,0,20,6
1650141797613,ECE 45,A01,083139,Staff,0,13,40,40
1650141803638,ECE 65,A50,083695,Staff,0,4,30,30
1650141809665,ECE 109,A01,091882,Touri; Behrouz,48,0,70,22
1650141815689,ECE 180,A00,083140,Abi Samra; Nicholas Camill,24,0,30,6
1650141815689,ECE 180,B00,083141,Abi Samra; Nicholas Camill,8,0,30,22
1650141821712,MATH 10A,A01,083735,Patchell; Gregory David,12,0,30,18
1650141821712,MATH 10A,A02,083736,Patchell; Gregory David,28,0,30,2
1650141821712,MATH 10A,A03,083737,Patchell; Gregory David,26,0,30,4
1650141827735,MATH 10B,A01,083207,Staff,0,5,30,30
1650141827735,MATH 10B,A02,083208,Staff,0,4,30,30
1650141827735,MATH 10B,B01,083739,Staff,18,0,30,12
1650141827735,MATH 10B,B02,083740,Staff,29,0,30,1
1650141833761,MATH 18,A01,083743,Staff,10,0,30,20
1650141833761,MATH 18,A02,083744,Staff,28,0,30,2
1650141833761,MATH 18,A03,083745,Staff,23,0,30,7
1650141833761,MATH 18,A04,083746,Staff,27,0,30,3
1650141833761,MATH 18,B01,083748,Staff,0,9,30,30
1650141833761,MATH 18,B02,083749,Staff,0,7,30,30
1650141833761,MATH 18,B03,083750,Staff,0,6,30,30
1650141833761,MATH 18,B04,083751,Staff,0,7,30,30
1650141839784,MATH 20A,A01,083754,Staff,26,0,40,14
1650141845812,MATH 20B,A01,083756,Staff,0,5,30,30
1650141845812,MATH 20B,A02,083757,Staff,0,4,30,30
1650141851835,MATH 20C,A01,083760,Staff,0,11,30,30
1650141851835,MATH 20C,A02,083761,Staff,0,12,30,30
1650141851835,MATH 20C,B01,083762,Staff,14,0,30,16
1650141851835,MATH 20C,B02,083763,Staff,28,0,30,2
1650141857859,MATH 20D,A01,083765,Staff,0,2,30,30
1650141857859,MATH 20D,A02,083766,Staff,11,0,30,19
1650141857859,MATH 20D,A03,083767,Staff,28,0,30,2
1650141863882,MATH 20E,A01,083771,Staff,8,0,30,22
1650141863882,MATH 20E,A02,083772,Staff,20,0,30,10
1650141863882,MATH 20E,B01,083773,Staff,0,0,30,30
1650141863882,MATH 20E,B02,083774,Staff,13,0,30,17
1650141869912,MATH 103A,A01,083777,Staff,0,8,30,30
1650141869912,MATH 103A,A02,083778,Staff,0,8,30,30
1650141869912,MATH 103A,B01,083779,Staff,0,9,30,30
1650141869912,MATH 103A,B02,083780,Staff,0,6,30,30
1650141875936,MATH 105,A01,085443,Staff,0,13,30,30
1650141881968,MATH 109,A01,083213,Anzaldo; Leesa B,0,3,30,30
1650141881968,MATH 109,A02,083214,Anzaldo; Leesa B,0,5,30,30
1650141881968,MATH 109,B01,083215,Anzaldo; Leesa B,0,4,30,30
1650141881968,MATH 109,B02,083216,Anzaldo; Leesa B,0,4,30,30
1650141887998,MATH 142A,A01,083219,Chow; Bennett,0,11,30,30
1650141887998,MATH 142A,A02,083220,Chow; Bennett,0,10,30,30
1650141887998,MATH 142A,B01,083221,Chow; Bennett,0,10,30,30
1650141887998,MATH 142A,B02,083222,Chow; Bennett,0,11,30,30
1650141894025,MATH 193A,A01,083224,Staff,0,3,30,30
1650141894025,MATH 193A,A02,083225,Staff,0,4,30,30
1650141894025,MATH 193A,A03,083781,Staff,0,0,30,30
1650141894025,MATH 193A,A04,083782,Staff,0,0,30,30
1650141900048,MATH 197,001,091859,McAuley; Julian John,9998,0,9999,1
1650141906103,COGS 9,A01,083615,Staff,0,14,60,60
1650141912138,COGS 11,A01,083617,Boyle; Mary E. T.,24,0,40,16
1650141918162,COGS 13,A01,083071,Staff,0,28,40,40
1650141924186,COGS 14A,A01,092681,Staff,0,10,100,100
1650141930214,COGS 14B,A01,083073,Cheng; Tzu-Han,0,4,50,50
1650141936239,COGS 17,A01,092677,Staff,34,0,75,41
1650141942268,COGS 100,A01,083619,Staff,0,21,60,60
1650141948292,COGS 101A,A01,083621,Davis; Joshua Daniel,0,18,60,60
1650141954318,COGS 101B,A01,091572,Staff,10,0,60,50
1650141960345,COGS 101C,A01,083625,Delgado; Tania,21,0,30,9
1650141966371,COGS 107A,A01,083627,Boyle; Mary E. T.,0,5,60,60
1650141972394,COGS 118A,A01,083075,Staff,17,0,60,43
1650141978419,CSE 3,A50,083646,Miranda; Gregory Joseph,22,0,38,16
1650141978419,CSE 3,A51,083647,Miranda; Gregory Joseph,37,0,37,0
1650141984443,CSE 8A,A50,083650,Miranda; Gregory Joseph,0,16,40,40
1650141990466,CSE 11,A01,083080,Cao; Yingjun,0,66,40,40
1650141996493,CSE 12,A01,083652,Staff,0,3,100,100
1650142002519,CSE 15L,A01,083654,Staff,0,0,50,50
1650142002519,CSE 15L,A02,083655,Staff,9,0,50,41
1650142008544,CSE 20,A01,083657,Staff,56,0,80,24
1650142014568,CSE 30,A01,083084,Eldon; John,0,63,40,40
1650142020600,CSE 100,A01,083659,Cao; Yingjun,0,61,50,50
1650142026627,CSE 134B,A01,083661,Powell; Thomas Allan,0,27,65,65
1650142032649,CSE 140,A01,083663,Staff,4,0,75,71
1650142038676,CSE 140L,A01,083088,Eldon; John,0,1,75,75
1650142044700,CSE 175,A01,083665,Kumar; Rakesh,8,0,25,17
1650142050730,CSE 190,A00,092507,Dubnov; Shlomo,14,0,20,6
1650142056754,ECE 45,A01,083139,Staff,0,13,40,40
1650142062781,ECE 65,A50,083695,Staff,0,4,30,30
1650142068804,ECE 109,A01,091882,Touri; Behrouz,48,0,70,22
1650142074827,ECE 180,A00,083140,Abi Samra; Nicholas Camill,24,0,30,6
1650142074827,ECE 180,B00,083141,Abi Samra; Nicholas Camill,8,0,30,22
1650142080853,MATH 10A,A01,083735,Patchell; Gregory David,12,0,30,18
1650142080853,MATH 10A,A02,083736,Patchell; Gregory David,28,0,30,2
1650142080853,MATH 10A,A03,083737,Patchell; Gregory David,26,0,30,4
1650142086877,MATH 10B,A01,083207,Staff,0,5,30,30
1650142086877,MATH 10B,A02,083208,Staff,0,4,30,30
1650142086877,MATH 10B,B01,083739,Staff,18,0,30,12
1650142086877,MATH 10B,B02,083740,Staff,29,0,30,1
1650142092902,MATH 18,A01,083743,Staff,10,0,30,20
1650142092902,MATH 18,A02,083744,Staff,28,0,30,2
1650142092902,MATH 18,A03,083745,Staff,23,0,30,7
1650142092902,MATH 18,A04,083746,Staff,27,0,30,3
1650142092902,MATH 18,B01,083748,Staff,0,9,30,30
1650142092902,MATH 18,B02,083749,Staff,0,7,30,30
1650142092902,MATH 18,B03,083750,Staff,0,6,30,30
1650142092902,MATH 18,B04,083751,Staff,0,7,30,30
1650142098929,MATH 20A,A01,083754,Staff,26,0,40,14
1650142104952,MATH 20B,A01,083756,Staff,0,5,30,30
1650142104952,MATH 20B,A02,083757,Staff,0,4,30,30
1650142110979,MATH 20C,A01,083760,Staff,0,11,30,30
1650142110979,MATH 20C,A02,083761,Staff,0,12,30,30
1650142110979,MATH 20C,B01,083762,Staff,14,0,30,16
1650142110979,MATH 20C,B02,083763,Staff,28,0,30,2
1650142117006,MATH 20D,A01,083765,Staff,0,2,30,30
1650142117006,MATH 20D,A02,083766,Staff,11,0,30,19
1650142117006,MATH 20D,A03,083767,Staff,28,0,30,2
1650142123031,MATH 20E,A01,083771,Staff,8,0,30,22
1650142123031,MATH 20E,A02,083772,Staff,20,0,30,10
1650142123031,MATH 20E,B01,083773,Staff,0,0,30,30
1650142123031,MATH 20E,B02,083774,Staff,13,0,30,17
1650142129065,MATH 103A,A01,083777,Staff,0,8,30,30
1650142129065,MATH 103A,A02,083778,Staff,0,8,30,30
1650142129065,MATH 103A,B01,083779,Staff,0,9,30,30
1650142129065,MATH 103A,B02,083780,Staff,0,6,30,30
1650142135088,MATH 105,A01,085443,Staff,0,13,30,30
1650142141112,MATH 109,A01,083213,Anzaldo; Leesa B,0,3,30,30
1650142141112,MATH 109,A02,083214,Anzaldo; Leesa B,0,5,30,30
1650142141112,MATH 109,B01,083215,Anzaldo; Leesa B,0,4,30,30
1650142141112,MATH 109,B02,083216,Anzaldo; Leesa B,0,4,30,30
1650142147136,MATH 142A,A01,083219,Chow; Bennett,0,11,30,30
1650142147136,MATH 142A,A02,083220,Chow; Bennett,0,10,30,30
1650142147136,MATH 142A,B01,083221,Chow; Bennett,0,10,30,30
1650142147136,MATH 142A,B02,083222,Chow; Bennett,0,11,30,30
1650142153159,MATH 193A,A01,083224,Staff,0,3,30,30
1650142153159,MATH 193A,A02,083225,Staff,0,4,30,30
1650142153159,MATH 193A,A03,083781,Staff,0,0,30,30
1650142153159,MATH 193A,A04,083782,Staff,0,0,30,30
1650142159186,MATH 197,001,091859,McAuley; Julian John,9998,0,9999,1
1650142165238,COGS 9,A01,083615,Staff,0,14,60,60
1650142171261,COGS 11,A01,083617,Boyle; Mary E. T.,24,0,40,16
1650142177284,COGS 13,A01,083071,Staff,0,28,40,40
1650142183310,COGS 14A,A01,092681,Staff,0,10,100,100
1650142189337,COGS 14B,A01,083073,Cheng; Tzu-Han,0,4,50,50
1650142195364,COGS 17,A01,092677,Staff,34,0,75,41
1650142201390,COGS 100,A01,083619,Staff,0,21,60,60
1650142207415,COGS 101A,A01,083621,Davis; Joshua Daniel,0,18,60,60
1650142213438,COGS 101B,A01,091572,Staff,10,0,60,50
1650142219469,COGS 101C,A01,083625,Delgado; Tania,21,0,30,9
1650142225493,COGS 107A,A01,083627,Boyle; Mary E. T.,0,5,60,60
1650142231519,COGS 118A,A01,083075,Staff,17,0,60,43
1650142237545,CSE 3,A50,083646,Miranda; Gregory Joseph,22,0,38,16
1650142237545,CSE 3,A51,083647,Miranda; Gregory Joseph,37,0,37,0
1650142243575,CSE 8A,A50,083650,Miranda; Gregory Joseph,0,16,40,40
1650142249599,CSE 11,A01,083080,Cao; Yingjun,0,66,40,40
1650142255629,CSE 12,A01,083652,Staff,0,3,100,100
1650142261657,CSE 15L,A01,083654,Staff,0,0,50,50
1650142261657,CSE 15L,A02,083655,Staff,9,0,50,41
1650142267684,CSE 20,A01,083657,Staff,56,0,80,24
1650142273711,CSE 30,A01,083084,Eldon; John,0,63,40,40
1650142279734,CSE 100,A01,083659,Cao; Yingjun,0,61,50,50
1650142285836,CSE 134B,A01,083661,Powell; Thomas Allan,0,27,65,65
1650142291862,CSE 140,A01,083663,Staff,4,0,75,71
1650142297886,CSE 140L,A01,083088,Eldon; John,0,1,75,75
1650142303910,CSE 175,A01,083665,Kumar; Rakesh,8,0,25,17
1650142309935,CSE 190,A00,092507,Dubnov; Shlomo,14,0,20,6
1650142315958,ECE 45,A01,083139,Staff,0,13,40,40
1650142321992,ECE 65,A50,083695,Staff,0,4,30,30
1650142328019,ECE 109,A01,091882,Touri; Behrouz,48,0,70,22
1650142334047,ECE 180,A00,083140,Abi Samra; Nicholas Camill,24,0,30,6
1650142334047,ECE 180,B00,083141,Abi Samra; Nicholas Camill,8,0,30,22
1650142340075,MATH 10A,A01,083735,Patchell; Gregory David,12,0,30,18
1650142340075,MATH 10A,A02,083736,Patchell; Gregory David,28,0,30,2
1650142340075,MATH 10A,A03,083737,Patchell; Gregory David,26,0,30,4
1650142346113,MATH 10B,A01,083207,Staff,0,5,30,30
1650142346113,MATH 10B,A02,083208,Staff,0,4,30,30
1650142346113,MATH 10B,B01,083739,Staff,18,0,30,12
1650142346113,MATH 10B,B02,083740,Staff,29,0,30,1
1650142352141,MATH 18,A01,083743,Staff,10,0,30,20
1650142352141,MATH 18,A02,083744,Staff,28,0,30,2
1650142352141,MATH 18,A03,083745,Staff,23,0,30,7
1650142352141,MATH 18,A04,083746,Staff,27,0,30,3
1650142352141,MATH 18,B01,083748,Staff,0,9,30,30
1650142352141,MATH 18,B02,083749,Staff,0,7,30,30
1650142352141,MATH 18,B03,083750,Staff,0,6,30,30
1650142352141,MATH 18,B04,083751,Staff,0,7,30,30
1650142358163,MATH 20A,A01,083754,Staff,26,0,40,14
1650142364187,MATH 20B,A01,083756,Staff,0,5,30,30
1650142364187,MATH 20B,A02,083757,Staff,0,4,30,30
1650142370209,MATH 20C,A01,083760,Staff,0,11,30,30
1650142370209,MATH 20C,A02,083761,Staff,0,12,30,30
1650142370209,MATH 20C,B01,083762,Staff,14,0,30,16
1650142370209,MATH 20C,B02,083763,Staff,28,0,30,2
1650142376232,MATH 20D,A01,083765,Staff,0,2,30,30
1650142376232,MATH 20D,A02,083766,Staff,11,0,30,19
1650142376232,MATH 20D,A03,083767,Staff,28,0,30,2
1650142382260,MATH 20E,A01,083771,Staff,8,0,30,22
1650142382260,MATH 20E,A02,083772,Staff,20,0,30,10
1650142382260,MATH 20E,B01,083773,Staff,0,0,30,30
1650142382260,MATH 20E,B02,083774,Staff,13,0,30,17
1650142388283,MATH 103A,A01,083777,Staff,0,8,30,30
1650142388283,MATH 103A,A02,083778,Staff,0,8,30,30
1650142388283,MATH 103A,B01,083779,Staff,0,9,30,30
1650142388283,MATH 103A,B02,083780,Staff,0,6,30,30
1650142394308,MATH 105,A01,085443,Staff,0,13,30,30
1650142400341,MATH 109,A01,083213,Anzaldo; Leesa B,0,3,30,30
1650142400341,MATH 109,A02,083214,Anzaldo; Leesa B,0,5,30,30
1650142400341,MATH 109,B01,083215,Anzaldo; Leesa B,0,4,30,30
1650142400341,MATH 109,B02,083216,Anzaldo; Leesa B,0,4,30,30
1650142406370,MATH 142A,A01,083219,Chow; Bennett,0,11,30,30
1650142406370,MATH 142A,A02,083220,Chow; Bennett,0,10,30,30
1650142406370,MATH 142A,B01,083221,Chow; Bennett,0,10,30,30
1650142406370,MATH 142A,B02,083222,Chow; Bennett,0,11,30,30
1650142412396,MATH 193A,A01,083224,Staff,0,3,30,30
1650142412396,MATH 193A,A02,083225,Staff,0,4,30,30
1650142412396,MATH 193A,A03,083781,Staff,0,0,30,30
1650142412396,MATH 193A,A04,083782,Staff,0,0,30,30
1650142418421,MATH 197,001,091859,McAuley; Julian John,9998,0,9999,1
1650142424473,COGS 9,A01,083615,Staff,0,14,60,60
1650142430497,COGS 11,A01,083617,Boyle; Mary E. T.,24,0,40,16
1650142436524,COGS 13,A01,083071,Staff,0,28,40,40
1650142442547,COGS 14A,A01,092681,Staff,0,10,100,100
1650142448574,COGS 14B,A01,083073,Cheng; Tzu-Han,0,4,50,50
1650142454601,COGS 17,A01,092677,Staff,34,0,75,41
1650142460628,COGS 100,A01,083619,Staff,0,21,60,60
1650142466654,COGS 101A,A01,083621,Davis; Joshua Daniel,0,18,60,60
1650142472681,COGS 101B,A01,091572,Staff,10,0,60,50
1650142478705,COGS 101C,A01,083625,Delgado; Tania,21,0,30,9
1650142484730,COGS 107A,A01,083627,Boyle; Mary E. T.,0,5,60,60
1650142490757,COGS 118A,A01,083075,Staff,17,0,60,43
1650142496782,CSE 3,A50,083646,Miranda; Gregory Joseph,22,0,38,16
1650142496782,CSE 3,A51,083647,Miranda; Gregory Joseph,37,0,37,0
1650142502818,CSE 8A,A50,083650,Miranda; Gregory Joseph,0,16,40,40
1650142508877,CSE 11,A01,083080,Cao; Yingjun,0,66,40,40
1650142514905,CSE 12,A01,083652,Staff,0,3,100,100
1650142520929,CSE 15L,A01,083654,Staff,0,0,50,50
1650142520929,CSE 15L,A02,083655,Staff,9,0,50,41
1650142526953,CSE 20,A01,083657,Staff,56,0,80,24
1650142532982,CSE 30,A01,083084,Eldon; John,0,63,40,40
1650142539009,CSE 100,A01,083659,Cao; Yingjun,0,61,50,50
1650142545033,CSE 134B,A01,083661,Powell; Thomas Allan,0,27,65,65
1650142551057,CSE 140,A01,083663,Staff,4,0,75,71
1650142557081,CSE 140L,A01,083088,Eldon; John,0,1,75,75
1650142563106,CSE 175,A01,083665,Kumar; Rakesh,8,0,25,17
1650142569130,CSE 190,A00,092507,Dubnov; Shlomo,14,0,20,6
1650142575156,ECE 45,A01,083139,Staff,0,13,40,40
1650142581181,ECE 65,A50,083695,Staff,0,4,30,30
1650142587210,ECE 109,A01,091882,Touri; Behrouz,48,0,70,22
1650142593241,ECE 180,A00,083140,Abi Samra; Nicholas Camill,24,0,30,6
1650142593241,ECE 180,B00,083141,Abi Samra; Nicholas Camill,8,0,30,22
1650142599265,MATH 10A,A01,083735,Patchell; Gregory David,12,0,30,18
1650142599265,MATH 10A,A02,083736,Patchell; Gregory David,28,0,30,2
1650142599265,MATH 10A,A03,083737,Patchell; Gregory David,26,0,30,4
1650142605299,MATH 10B,A01,083207,Staff,0,5,30,30
1650142605299,MATH 10B,A02,083208,Staff,0,4,30,30
1650142605299,MATH 10B,B01,083739,Staff,18,0,30,12
1650142605299,MATH 10B,B02,083740,Staff,29,0,30,1
1650142611325,MATH 18,A01,083743,Staff,10,0,30,20
1650142611325,MATH 18,A02,083744,Staff,28,0,30,2
1650142611325,MATH 18,A03,083745,Staff,23,0,30,7
1650142611325,MATH 18,A04,083746,Staff,27,0,30,3
1650142611325,MATH 18,B01,083748,Staff,0,9,30,30
1650142611325,MATH 18,B02,083749,Staff,0,7,30,30
1650142611325,MATH 18,B03,083750,Staff,0,6,30,30
1650142611325,MATH 18,B04,083751,Staff,0,7,30,30
1650142617351,MATH 20A,A01,083754,Staff,26,0,40,14
1650142623373,MATH 20B,A01,083756,Staff,0,5,30,30
1650142623373,MATH 20B,A02,083757,Staff,0,4,30,30
1650142629399,MATH 20C,A01,083760,Staff,0,11,30,30
1650142629399,MATH 20C,A02,083761,Staff,0,12,30,30
1650142629399,MATH 20C,B01,083762,Staff,14,0,30,16
1650142629399,MATH 20C,B02,083763,Staff,28,0,30,2
1650142635427,MATH 20D,A01,083765,Staff,0,2,30,30
1650142635427,MATH 20D,A02,083766,Staff,11,0,30,19
1650142635427,MATH 20D,A03,083767,Staff,28,0,30,2
1650142641451,MATH 20E,A01,083771,Staff,8,0,30,22
1650142641451,MATH 20E,A02,083772,Staff,20,0,30,10
1650142641451,MATH 20E,B01,083773,Staff,0,0,30,30
1650142641451,MATH 20E,B02,083774,Staff,13,0,30,17
1650142647476,MATH 103A,A01,083777,Staff,0,8,30,30
1650142647476,MATH 103A,A02,083778,Staff,0,8,30,30
1650142647476,MATH 103A,B01,083779,Staff,0,9,30,30
1650142647476,MATH 103A,B02,083780,Staff,0,6,30,30
1650142653502,MATH 105,A01,085443,Staff,0,13,30,30
1650142659539,MATH 109,A01,083213,Anzaldo; Leesa B,0,3,30,30
1650142659539,MATH 109,A02,083214,Anzaldo; Leesa B,0,5,30,30
1650142659539,MATH 109,B01,083215,Anzaldo; Leesa B,0,4,30,30
1650142659539,MATH 109,B02,083216,Anzaldo; Leesa B,0,4,30,30
1650142665564,MATH 142A,A01,083219,Chow; Bennett,0,11,30,30
1650142665564,MATH 142A,A02,083220,Chow; Bennett,0,10,30,30
1650142665564,MATH 142A,B01,083221,Chow; Bennett,0,10,30,30
1650142665564,MATH 142A,B02,083222,Chow; Bennett,0,11,30,30
1650142671590,MATH 193A,A01,083224,Staff,0,3,30,30
1650142671590,MATH 193A,A02,083225,Staff,0,4,30,30
1650142671590,MATH 193A,A03,083781,Staff,0,0,30,30
1650142671590,MATH 193A,A04,083782,Staff,0,0,30,30
1650142677617,MATH 197,001,091859,McAuley; Julian John,9998,0,9999,1
1650142683684,COGS 9,A01,083615,Staff,0,14,60,60
1650142689708,COGS 11,A01,083617,Boyle; Mary E. T.,24,0,40,16
1650142695731,COGS 13,A01,083071,Staff,0,28,40,40
1650142701758,COGS 14A,A01,092681,Staff,0,10,100,100
1650142707781,COGS 14B,A01,083073,Cheng; Tzu-Han,0,4,50,50
1650142713805,COGS 17,A01,092677,Staff,34,0,75,41
1650142719829,COGS 100,A01,083619,Staff,0,21,60,60
1650142725857,COGS 101A,A01,083621,Davis; Joshua Daniel,0,18,60,60
1650142731884,COGS 101B,A01,091572,Staff,10,0,60,50
1650142737910,COGS 101C,A01,083625,Delgado; Tania,21,0,30,9
1650142743945,COGS 107A,A01,083627,Boyle; Mary E. T.,0,5,60,60
1650142749968,COGS 118A,A01,083075,Staff,17,0,60,43
1650142755992,CSE 3,A50,083646,Miranda; Gregory Joseph,22,0,38,16
1650142755992,CSE 3,A51,083647,Miranda; Gregory Joseph,37,0,37,0
1650142762020,CSE 8A,A50,083650,Miranda; Gregory Joseph,0,16,40,40
1650142768044,CSE 11,A01,083080,Cao; Yingjun,0,66,40,40
1650142774066,CSE 12,A01,083652,Staff,0,3,100,100
1650142780090,CSE 15L,A01,083654,Staff,0,0,50,50
1650142780090,CSE 15L,A02,083655,Staff,9,0,50,41
1650142786117,CSE 20,A01,083657,Staff,56,0,80,24
1650142792141,CSE 30,A01,083084,Eldon; John,0,63,40,40
1650142798163,CSE 100,A01,083659,Cao; Yingjun,0,61,50,50
1650142804191,CSE 134B,A01,083661,Powell; Thomas Allan,0,27,65,65
1650142810215,CSE 140,A01,083663,Staff,4,0,75,71
1650142816249,CSE 140L,A01,083088,Eldon; John,0,1,75,75
1650142822275,CSE 175,A01,083665,Kumar; Rakesh,8,0,25,17
1650142828298,CSE 190,A00,092507,Dubnov; Shlomo,14,0,20,6
1650142834322,ECE 45,A01,083139,Staff,0,13,40,40
1650142840357,ECE 65,A50,083695,Staff,0,4,30,30
1650142846380,ECE 109,A01,091882,Touri; Behrouz,48,0,70,22
1650142852406,ECE 180,A00,083140,Abi Samra; Nicholas Camill,24,0,30,6
1650142852406,ECE 180,B00,083141,Abi Samra; Nicholas Camill,8,0,30,22
1650142858431,MATH 10A,A01,083735,Patchell; Gregory David,12,0,30,18
1650142858431,MATH 10A,A02,083736,Patchell; Gregory David,28,0,30,2
1650142858431,MATH 10A,A03,083737,Patchell; Gregory David,26,0,30,4
1650142864455,MATH 10B,A01,083207,Staff,0,5,30,30
1650142864455,MATH 10B,A02,083208,Staff,0,4,30,30
1650142864455,MATH 10B,B01,083739,Staff,18,0,30,12
1650142864455,MATH 10B,B02,083740,Staff,29,0,30,1
1650142870480,MATH 18,A01,083743,Staff,10,0,30,20
1650142870480,MATH 18,A02,083744,Staff,28,0,30,2
1650142870480,MATH 18,A03,083745,Staff,23,0,30,7
1650142870480,MATH 18,A04,083746,Staff,27,0,30,3
1650142870480,MATH 18,B01,083748,Staff,0,9,30,30
1650142870480,MATH 18,B02,083749,Staff,0,7,30,30
1650142870480,MATH 18,B03,083750,Staff,0,6,30,30
1650142870480,MATH 18,B04,083751,Staff,0,7,30,30
1650142876503,MATH 20A,A01,083754,Staff,26,0,40,14
1650142882604,MATH 20B,A01,083756,Staff,0,5,30,30
1650142882604,MATH 20B,A02,083757,Staff,0,4,30,30
1650142888628,MATH 20C,A01,083760,Staff,0,11,30,30
1650142888628,MATH 20C,A02,083761,Staff,0,12,30,30
1650142888628,MATH 20C,B01,083762,Staff,14,0,30,16
1650142888628,MATH 20C,B02,083763,Staff,28,0,30,2
1650142894657,MATH 20D,A01,083765,Staff,0,2,30,30
1650142894657,MATH 20D,A02,083766,Staff,11,0,30,19
1650142894657,MATH 20D,A03,083767,Staff,28,0,30,2
1650142900685,MATH 20E,A01,083771,Staff,8,0,30,22
1650142900685,MATH 20E,A02,083772,Staff,20,0,30,10
1650142900685,MATH 20E,B01,083773,Staff,0,0,30,30
1650142900685,MATH 20E,B02,083774,Staff,13,0,30,17
1650142906710,MATH 103A,A01,083777,Staff,0,8,30,30
1650142906710,MATH 103A,A02,083778,Staff,0,8,30,30
1650142906710,MATH 103A,B01,083779,Staff,0,9,30,30
1650142906710,MATH 103A,B02,083780,Staff,0,6,30,30
1650142912739,MATH 105,A01,085443,Staff,0,13,30,30
1650142918763,MATH 109,A01,083213,Anzaldo; Leesa B,0,3,30,30
1650142918763,MATH 109,A02,083214,Anzaldo; Leesa B,0,5,30,30
1650142918763,MATH 109,B01,083215,Anzaldo; Leesa B,0,4,30,30
1650142918763,MATH 109,B02,083216,Anzaldo; Leesa B,0,4,30,30
1650142924786,MATH 142A,A01,083219,Chow; Bennett,0,11,30,30
1650142924786,MATH 142A,A02,083220,Chow; Bennett,0,10,30,30
1650142924786,MATH 142A,B01,083221,Chow; Bennett,0,10,30,30
1650142924786,MATH 142A,B02,083222,Chow; Bennett,0,11,30,30
1650142930810,MATH 193A,A01,083224,Staff,0,3,30,30
1650142930810,MATH 193A,A02,083225,Staff,0,4,30,30
1650142930810,MATH 193A,A03,083781,Staff,0,0,30,30
1650142930810,MATH 193A,A04,083782,Staff,0,0,30,30
1650142936842,MATH 197,001,091859,McAuley; Julian John,9998,0,9999,1
1650142942891,COGS 9,A01,083615,Staff,0,14,60,60
1650142948914,COGS 11,A01,083617,Boyle; Mary E. T.,24,0,40,16
1650142954937,COGS 13,A01,083071,Staff,0,28,40,40
1650142960963,COGS 14A,A01,092681,Staff,0,10,100,100
1650142966986,COGS 14B,A01,083073,Cheng; Tzu-Han,0,4,50,50
1650142973010,COGS 17,A01,092677,Staff,34,0,75,41
1650142979032,COGS 100,A01,083619,Staff,0,21,60,60
1650142985058,COGS 101A,A01,083621,Davis; Joshua Daniel,0,18,60,60
1650142991086,COGS 101B,A01,091572,Staff,10,0,60,50
1650142997112,COGS 101C,A01,083625,Delgado; Tania,21,0,30,9
1650143003134,COGS 107A,A01,083627,Boyle; Mary E. T.,0,5,60,60
1650143009158,COGS 118A,A01,083075,Staff,17,0,60,43
1650143015180,CSE 3,A50,083646,Miranda; Gregory Joseph,22,0,38,16
1650143015180,CSE 3,A51,083647,Miranda; Gregory Joseph,37,0,37,0
1650143021216,CSE 8A,A50,083650,Miranda; Gregory Joseph,0,16,40,40
1650143027242,CSE 11,A01,083080,Cao; Yingjun,0,66,40,40
1650143033272,CSE 12,A01,083652,Staff,0,3,100,100
1650143039294,CSE 15L,A01,083654,Staff,0,0,50,50
1650143039294,CSE 15L,A02,083655,Staff,9,0,50,41
1650143045319,CSE 20,A01,083657,Staff,56,0,80,24
1650143051343,CSE 30,A01,083084,Eldon; John,0,63,40,40
1650143057370,CSE 100,A01,083659,Cao; Yingjun,0,61,50,50
1650143063397,CSE 134B,A01,083661,Powell; Thomas Allan,0,27,65,65
1650143069424,CSE 140,A01,083663,Staff,4,0,75,71
1650143075447,CSE 140L,A01,083088,Eldon; John,0,1,75,75
1650143081473,CSE 175,A01,083665,Kumar; Rakesh,8,0,25,17
1650143087499,CSE 190,A00,092507,Dubnov; Shlomo,14,0,20,6
1650143093525,ECE 45,A01,083139,Staff,0,13,40,40
1650143099555,ECE 65,A50,083695,Staff,0,4,30,30
1650143105584,ECE 109,A01,091882,Touri; Behrouz,48,0,70,22
1650143111613,ECE 180,A00,083140,Abi Samra; Nicholas Camill,24,0,30,6
1650143111613,ECE 180,B00,083141,Abi Samra; Nicholas Camill,8,0,30,22
1650143117643,MATH 10A,A01,083735,Patchell; Gregory David,12,0,30,18
1650143117643,MATH 10A,A02,083736,Patchell; Gregory David,28,0,30,2
1650143117643,MATH 10A,A03,083737,Patchell; Gregory David,26,0,30,4
1650143123666,MATH 10B,A01,083207,Staff,0,5,30,30
1650143123666,MATH 10B,A02,083208,Staff,0,4,30,30
1650143123666,MATH 10B,B01,083739,Staff,18,0,30,12
1650143123666,MATH 10B,B02,083740,Staff,29,0,30,1
1650143129692,MATH 18,A01,083743,Staff,10,0,30,20
1650143129692,MATH 18,A02,083744,Staff,28,0,30,2
1650143129692,MATH 18,A03,083745,Staff,23,0,30,7
1650143129692,MATH 18,A04,083746,Staff,27,0,30,3
1650143129692,MATH 18,B01,083748,Staff,0,9,30,30
1650143129692,MATH 18,B02,083749,Staff,0,7,30,30
1650143129692,MATH 18,B03,083750,Staff,0,6,30,30
1650143129692,MATH 18,B04,083751,Staff,0,7,30,30
1650143135719,MATH 20A,A01,083754,Staff,26,0,40,14
1650143141743,MATH 20B,A01,083756,Staff,0,5,30,30
1650143141743,MATH 20B,A02,083757,Staff,0,4,30,30
1650143147767,MATH 20C,A01,083760,Staff,0,11,30,30
1650143147767,MATH 20C,A02,083761,Staff,0,12,30,30
1650143147767,MATH 20C,B01,083762,Staff,14,0,30,16
1650143147767,MATH 20C,B02,083763,Staff,28,0,30,2
1650143153795,MATH 20D,A01,083765,Staff,0,2,30,30
1650143153795,MATH 20D,A02,083766,Staff,11,0,30,19
1650143153795,MATH 20D,A03,083767,Staff,28,0,30,2
1650143159819,MATH 20E,A01,083771,Staff,8,0,30,22
1650143159819,MATH 20E,A02,083772,Staff,20,0,30,10
1650143159819,MATH 20E,B01,083773,Staff,0,0,30,30
1650143159819,MATH 20E,B02,083774,Staff,13,0,30,17
1650143165847,MATH 103A,A01,083777,Staff,0,8,30,30
1650143165847,MATH 103A,A02,083778,Staff,0,8,30,30
1650143165847,MATH 103A,B01,083779,Staff,0,9,30,30
1650143165847,MATH 103A,B02,083780,Staff,0,6,30,30
1650143171870,MATH 105,A01,085443,Staff,0,13,30,30
1650143177896,MATH 109,A01,083213,Anzaldo; Leesa B,0,3,30,30
1650143177896,MATH 109,A02,083214,Anzaldo; Leesa B,0,5,30,30
1650143177896,MATH 109,B01,083215,Anzaldo; Leesa B,0,4,30,30
1650143177896,MATH 109,B02,083216,Anzaldo; Leesa B,0,4,30,30
1650143183920,MATH 142A,A01,083219,Chow; Bennett,0,11,30,30
1650143183920,MATH 142A,A02,083220,Chow; Bennett,0,10,30,30
1650143183920,MATH 142A,B01,083221,Chow; Bennett,0,10,30,30
1650143183920,MATH 142A,B02,083222,Chow; Bennett,0,11,30,30
1650143189947,MATH 193A,A01,083224,Staff,0,3,30,30
1650143189947,MATH 193A,A02,083225,Staff,0,4,30,30
1650143189947,MATH 193A,A03,083781,Staff,0,0,30,30
1650143189947,MATH 193A,A04,083782,Staff,0,0,30,30
1650143195970,MATH 197,001,091859,McAuley; Julian John,9998,0,9999,1
1650143202024,COGS 9,A01,083615,Staff,0,14,60,60
1650143208070,COGS 11,A01,083617,Boyle; Mary E. T.,24,0,40,16
1650143214093,COGS 13,A01,083071,Staff,0,28,40,40
1650143220119,COGS 14A,A01,092681,Staff,0,10,100,100
1650143226143,COGS 14B,A01,083073,Cheng; Tzu-Han,0,4,50,50
1650143232166,COGS 17,A01,092677,Staff,34,0,75,41
1650143238190,COGS 100,A01,083619,Staff,0,21,60,60
1650143244218,COGS 101A,A01,083621,Davis; Joshua Daniel,0,18,60,60
1650143250246,COGS 101B,A01,091572,Staff,10,0,60,50
1650143256276,COGS 101C,A01,083625,Delgado; Tania,21,0,30,9
1650143262299,COGS 107A,A01,083627,Boyle; Mary E. T.,0,5,60,60
1650143268321,COGS 118A,A01,083075,Staff,17,0,60,43
1650143274345,CSE 3,A50,083646,Miranda; Gregory Joseph,22,0,38,16
1650143274345,CSE 3,A51,083647,Miranda; Gregory Joseph,37,0,37,0
1650143280369,CSE 8A,A50,083650,Miranda; Gregory Joseph,0,16,40,40
1650143286392,CSE 11,A01,083080,Cao; Yingjun,0,66,40,40
1650143292415,CSE 12,A01,083652,Staff,0,3,100,100
1650143298441,CSE 15L,A01,083654,Staff,0,0,50,50
1650143298441,CSE 15L,A02,083655,Staff,9,0,50,41
1650143304465,CSE 20,A01,083657,Staff,55,0,80,25
1650143310488,CSE 30,A01,083084,Eldon; John,0,63,40,40
1650143316519,CSE 100,A01,083659,Cao; Yingjun,0,61,50,50
1650143322541,CSE 134B,A01,083661,Powell; Thomas Allan,0,27,65,65
1650143328564,CSE 140,A01,083663,Staff,4,0,75,71
1650143334587,CSE 140L,A01,083088,Eldon; John,0,1,75,75
1650143340611,CSE 175,A01,083665,Kumar; Rakesh,8,0,25,17
1650143346638,CSE 190,A00,092507,Dubnov; Shlomo,14,0,20,6
1650143352662,ECE 45,A01,083139,Staff,0,13,40,40
1650143358684,ECE 65,A50,083695,Staff,0,4,30,30
1650143364711,ECE 109,A01,091882,Touri; Behrouz,48,0,70,22
1650143370738,ECE 180,A00,083140,Abi Samra; Nicholas Camill,24,0,30,6
1650143370738,ECE 180,B00,083141,Abi Samra; Nicholas Camill,8,0,30,22
1650143376761,MATH 10A,A01,083735,Patchell; Gregory David,12,0,30,18
1650143376761,MATH 10A,A02,083736,Patchell; Gregory David,28,0,30,2
1650143376761,MATH 10A,A03,083737,Patchell; Gregory David,26,0,30,4
1650143382785,MATH 10B,A01,083207,Staff,0,5,30,30
1650143382785,MATH 10B,A02,083208,Staff,0,4,30,30
1650143382785,MATH 10B,B01,083739,Staff,18,0,30,12
1650143382785,MATH 10B,B02,083740,Staff,29,0,30,1
1650143388816,MATH 18,A01,083743,Staff,10,0,30,20
1650143388816,MATH 18,A02,083744,Staff,28,0,30,2
1650143388816,MATH 18,A03,083745,Staff,23,0,30,7
1650143388816,MATH 18,A04,083746,Staff,27,0,30,3
1650143388816,MATH 18,B01,083748,Staff,0,9,30,30
1650143388816,MATH 18,B02,083749,Staff,0,7,30,30
1650143388816,MATH 18,B03,083750,Staff,0,6,30,30
1650143388816,MATH 18,B04,083751,Staff,0,7,30,30
1650143394843,MATH 20A,A01,083754,Staff,26,0,40,14
1650143400866,MATH 20B,A01,083756,Staff,0,5,30,30
1650143400866,MATH 20B,A02,083757,Staff,0,4,30,30
1650143406894,MATH 20C,A01,083760,Staff,0,11,30,30
1650143406894,MATH 20C,A02,083761,Staff,0,12,30,30
1650143406894,MATH 20C,B01,083762,Staff,14,0,30,16
1650143406894,MATH 20C,B02,083763,Staff,28,0,30,2
1650143412919,MATH 20D,A01,083765,Staff,0,2,30,30
1650143412919,MATH 20D,A02,083766,Staff,11,0,30,19
1650143412919,MATH 20D,A03,083767,Staff,28,0,30,2
1650143418945,MATH 20E,A01,083771,Staff,8,0,30,22
1650143418945,MATH 20E,A02,083772,Staff,20,0,30,10
1650143418945,MATH 20E,B01,083773,Staff,0,0,30,30
1650143418945,MATH 20E,B02,083774,Staff,13,0,30,17
1650143424973,MATH 103A,A01,083777,Staff,0,8,30,30
1650143424973,MATH 103A,A02,083778,Staff,0,8,30,30
1650143424973,MATH 103A,B01,083779,Staff,0,9,30,30
1650143424973,MATH 103A,B02,083780,Staff,0,6,30,30
1650143431007,MATH 105,A01,085443,Staff,0,13,30,30
1650143437031,MATH 109,A01,083213,Anzaldo; Leesa B,0,3,30,30
1650143437031,MATH 109,A02,083214,Anzaldo; Leesa B,0,5,30,30
1650143437031,MATH 109,B01,083215,Anzaldo; Leesa B,0,4,30,30
1650143437031,MATH 109,B02,083216,Anzaldo; Leesa B,0,4,30,30
1650143443059,MATH 142A,A01,083219,Chow; Bennett,0,11,30,30
1650143443059,MATH 142A,A02,083220,Chow; Bennett,0,11,30,30
1650143443059,MATH 142A,B01,083221,Chow; Bennett,0,10,30,30
1650143443059,MATH 142A,B02,083222,Chow; Bennett,0,11,30,30
1650143449086,MATH 193A,A01,083224,Staff,0,3,30,30
1650143449086,MATH 193A,A02,083225,Staff,0,4,30,30
1650143449086,MATH 193A,A03,083781,Staff,0,0,30,30
1650143449086,MATH 193A,A04,083782,Staff,0,0,30,30
1650143455118,MATH 197,001,091859,McAuley; Julian John,9998,0,9999,1
1650143461170,COGS 9,A01,083615,Staff,0,14,60,60
1650143467193,COGS 11,A01,083617,Boyle; Mary E. T.,24,0,40,16
1650143473323,COGS 13,A01,083071,Staff,0,28,40,40
1650143479349,COGS 14A,A01,092681,Staff,0,10,100,100
1650143485375,COGS 14B,A01,083073,Cheng; Tzu-Han,0,4,50,50
1650143491397,COGS 17,A01,092677,Staff,34,0,75,41
1650143497425,COGS 100,A01,083619,Staff,0,21,60,60
1650143503458,COGS 101A,A01,083621,Davis; Joshua Daniel,0,18,60,60
1650143509481,COGS 101B,A01,091572,Staff,10,0,60,50
1650143515510,COGS 101C,A01,083625,Delgado; Tania,21,0,30,9
1650143521537,COGS 107A,A01,083627,Boyle; Mary E. T.,0,5,60,60
1650143527559,COGS 118A,A01,083075,Staff,17,0,60,43
1650143533583,CSE 3,A50,083646,Miranda; Gregory Joseph,22,0,38,16
1650143533583,CSE 3,A51,083647,Miranda; Gregory Joseph,37,0,37,0
1650143539606,CSE 8A,A50,083650,Miranda; Gregory Joseph,0,16,40,40
1650143545631,CSE 11,A01,083080,Cao; Yingjun,0,66,40,40
1650143551654,CSE 12,A01,083652,Staff,0,4,100,100
1650143557681,CSE 15L,A01,083654,Staff,0,0,50,50
1650143557681,CSE 15L,A02,083655,Staff,9,0,50,41
1650143563704,CSE 20,A01,083657,Staff,55,0,80,25
1650143569730,CSE 30,A01,083084,Eldon; John,0,63,40,40
1650143575757,CSE 100,A01,083659,Cao; Yingjun,0,61,50,50
1650143581780,CSE 134B,A01,083661,Powell; Thomas Allan,0,27,65,65
1650143587803,CSE 140,A01,083663,Staff,4,0,75,71
1650143593830,CSE 140L,A01,083088,Eldon; John,0,1,75,75
1650143599852,CSE 175,A01,083665,Kumar; Rakesh,8,0,25,17
1650143605875,CSE 190,A00,092507,Dubnov; Shlomo,14,0,20,6
1650143611905,ECE 45,A01,083139,Staff,0,13,40,40
1650143617930,ECE 65,A50,083695,Staff,0,4,30,30
1650143623954,ECE 109,A01,091882,Touri; Behrouz,48,0,70,22
1650143629980,ECE 180,A00,083140,Abi Samra; Nicholas Camill,24,0,30,6
1650143629980,ECE 180,B00,083141,Abi Samra; Nicholas Camill,8,0,30,22
1650143636005,MATH 10A,A01,083735,Patchell; Gregory David,12,0,30,18
1650143636005,MATH 10A,A02,083736,Patchell; Gregory David,28,0,30,2
1650143636005,MATH 10A,A03,083737,Patchell; Gregory David,26,0,30,4
1650143642035,MATH 10B,A01,083207,Staff,0,5,30,30
1650143642035,MATH 10B,A02,083208,Staff,0,4,30,30
1650143642035,MATH 10B,B01,083739,Staff,18,0,30,12
1650143642035,MATH 10B,B02,083740,Staff,29,0,30,1
1650143648065,MATH 18,A01,083743,Staff,10,0,30,20
1650143648065,MATH 18,A02,083744,Staff,28,0,30,2
1650143648065,MATH 18,A03,083745,Staff,23,0,30,7
1650143648065,MATH 18,A04,083746,Staff,27,0,30,3
1650143648065,MATH 18,B01,083748,Staff,0,10,30,30
1650143648065,MATH 18,B02,083749,Staff,0,7,30,30
1650143648065,MATH 18,B03,083750,Staff,0,6,30,30
1650143648065,MATH 18,B04,083751,Staff,0,7,30,30
1650143654089,MATH 20A,A01,083754,Staff,26,0,40,14
1650143660110,MATH 20B,A01,083756,Staff,0,5,30,30
1650143660110,MATH 20B,A02,083757,Staff,0,4,30,30
1650143666137,MATH 20C,A01,083760,Staff,0,11,30,30
1650143666137,MATH 20C,A02,083761,Staff,0,12,30,30
1650143666137,MATH 20C,B01,083762,Staff,14,0,30,16
1650143666137,MATH 20C,B02,083763,Staff,28,0,30,2
1650143672174,MATH 20D,A01,083765,Staff,0,2,30,30
1650143672174,MATH 20D,A02,083766,Staff,11,0,30,19
1650143672174,MATH 20D,A03,083767,Staff,28,0,30,2
1650143678196,MATH 20E,A01,083771,Staff,8,0,30,22
1650143678196,MATH 20E,A02,083772,Staff,20,0,30,10
1650143678196,MATH 20E,B01,083773,Staff,0,0,30,30
1650143678196,MATH 20E,B02,083774,Staff,13,0,30,17
1650143684225,MATH 103A,A01,083777,Staff,0,8,30,30
1650143684225,MATH 103A,A02,083778,Staff,0,8,30,30
1650143684225,MATH 103A,B01,083779,Staff,0,9,30,30
1650143684225,MATH 103A,B02,083780,Staff,0,6,30,30
1650143690249,MATH 105,A01,085443,Staff,0,13,30,30
1650143696276,MATH 109,A01,083213,Anzaldo; Leesa B,0,3,30,30
1650143696276,MATH 109,A02,083214,Anzaldo; Leesa B,0,5,30,30
1650143696276,MATH 109,B01,083215,Anzaldo; Leesa B,0,4,30,30
1650143696276,MATH 109,B02,083216,Anzaldo; Leesa B,0,4,30,30
1650143702305,MATH 142A,A01,083219,Chow; Bennett,0,11,30,30
1650143702305,MATH 142A,A02,083220,Chow; Bennett,0,11,30,30
1650143702305,MATH 142A,B01,083221,Chow; Bennett,0,10,30,30
1650143702305,MATH 142A,B02,083222,Chow; Bennett,0,11,30,30
1650143708327,MATH 193A,A01,083224,Staff,0,3,30,30
1650143708327,MATH 193A,A02,083225,Staff,0,4,30,30
1650143708327,MATH 193A,A03,083781,Staff,0,0,30,30
1650143708327,MATH 193A,A04,083782,Staff,0,0,30,30
1650143714359,MATH 197,001,091859,McAuley; Julian John,9998,0,9999,1
1650143720421,COGS 9,A01,083615,Staff,0,14,60,60
1650143726443,COGS 11,A01,083617,Boyle; Mary E. T.,24,0,40,16
1650143732466,COGS 13,A01,083071,Staff,0,28,40,40
1650143738491,COGS 14A,A01,092681,Staff,0,10,100,100
1650143744515,COGS 14B,A01,083073,Cheng; Tzu-Han,0,4,50,50
1650143750542,COGS 17,A01,092677,Staff,34,0,75,41
1650143756564,COGS 100,A01,083619,Staff,0,21,60,60
1650143762588,COGS 101A,A01,083621,Davis; Joshua Daniel,0,18,60,60
1650143768615,COGS 101B,A01,091572,Staff,10,0,60,50
1650143774639,COGS 101C,A01,083625,Delgado; Tania,21,0,30,9
1650143780673,COGS 107A,A01,083627,Boyle; Mary E. T.,0,5,60,60
1650143786696,COGS 118A,A01,083075,Staff,17,0,60,43
1650143792724,CSE 3,A50,083646,Miranda; Gregory Joseph,22,0,38,16
1650143792724,CSE 3,A51,083647,Miranda; Gregory Joseph,37,0,37,0
1650143798748,CSE 8A,A50,083650,Miranda; Gregory Joseph,0,16,40,40
1650143804771,CSE 11,A01,083080,Cao; Yingjun,0,66,40,40
1650143810794,CSE 12,A01,083652,Staff,0,4,100,100
1650143816817,CSE 15L,A01,083654,Staff,0,0,50,50
1650143816817,CSE 15L,A02,083655,Staff,9,0,50,41
1650143822840,CSE 20,A01,083657,Staff,55,0,80,25
1650143828863,CSE 30,A01,083084,Eldon; John,0,63,40,40
1650143834891,CSE 100,A01,083659,Cao; Yingjun,0,61,50,50
1650143840915,CSE 134B,A01,083661,Powell; Thomas Allan,0,27,65,65
1650143846941,CSE 140,A01,083663,Staff,4,0,75,71
1650143852965,CSE 140L,A01,083088,Eldon; John,0,1,75,75
1650143858991,CSE 175,A01,083665,Kumar; Rakesh,8,0,25,17
1650143865018,CSE 190,A00,092507,Dubnov; Shlomo,14,0,20,6
1650143871042,ECE 45,A01,083139,Staff,0,13,40,40
1650143877077,ECE 65,A50,083695,Staff,0,4,30,30
1650143883099,ECE 109,A01,091882,Touri; Behrouz,48,0,70,22
1650143889122,ECE 180,A00,083140,Abi Samra; Nicholas Camill,24,0,30,6
1650143889122,ECE 180,B00,083141,Abi Samra; Nicholas Camill,8,0,30,22
1650143895150,MATH 10A,A01,083735,Patchell; Gregory David,12,0,30,18
1650143895150,MATH 10A,A02,083736,Patchell; Gregory David,28,0,30,2
1650143895150,MATH 10A,A03,083737,Patchell; Gregory David,26,0,30,4
1650143901173,MATH 10B,A01,083207,Staff,0,5,30,30
1650143901173,MATH 10B,A02,083208,Staff,0,4,30,30
1650143901173,MATH 10B,B01,083739,Staff,18,0,30,12
1650143901173,MATH 10B,B02,083740,Staff,29,0,30,1
1650143907200,MATH 18,A01,083743,Staff,10,0,30,20
1650143907200,MATH 18,A02,083744,Staff,28,0,30,2
1650143907200,MATH 18,A03,083745,Staff,23,0,30,7
1650143907200,MATH 18,A04,083746,Staff,27,0,30,3
1650143907200,MATH 18,B01,083748,Staff,0,10,30,30
1650143907200,MATH 18,B02,083749,Staff,0,7,30,30
1650143907200,MATH 18,B03,083750,Staff,0,6,30,30
1650143907200,MATH 18,B04,083751,Staff,0,7,30,30
1650143913222,MATH 20A,A01,083754,Staff,26,0,40,14
1650143919250,MATH 20B,A01,083756,Staff,0,5,30,30
1650143919250,MATH 20B,A02,083757,Staff,0,4,30,30
1650143925274,MATH 20C,A01,083760,Staff,0,11,30,30
1650143925274,MATH 20C,A02,083761,Staff,0,12,30,30
1650143925274,MATH 20C,B01,083762,Staff,14,0,30,16
1650143925274,MATH 20C,B02,083763,Staff,28,0,30,2
1650143931298,MATH 20D,A01,083765,Staff,0,2,30,30
1650143931298,MATH 20D,A02,083766,Staff,11,0,30,19
1650143931298,MATH 20D,A03,083767,Staff,28,0,30,2
1650143937322,MATH 20E,A01,083771,Staff,8,0,30,22
1650143937322,MATH 20E,A02,083772,Staff,20,0,30,10
1650143937322,MATH 20E,B01,083773,Staff,0,0,30,30
1650143937322,MATH 20E,B02,083774,Staff,13,0,30,17
1650143943347,MATH 103A,A01,083777,Staff,0,8,30,30
1650143943347,MATH 103A,A02,083778,Staff,0,8,30,30
1650143943347,MATH 103A,B01,083779,Staff,0,9,30,30
1650143943347,MATH 103A,B02,083780,Staff,0,6,30,30
1650143949371,MATH 105,A01,085443,Staff,0,13,30,30
1650143955394,MATH 109,A01,083213,Anzaldo; Leesa B,0,3,30,30
1650143955394,MATH 109,A02,083214,Anzaldo; Leesa B,0,5,30,30
1650143955394,MATH 109,B01,083215,Anzaldo; Leesa B,0,4,30,30
1650143955394,MATH 109,B02,083216,Anzaldo; Leesa B,0,4,30,30
1650143961418,MATH 142A,A01,083219,Chow; Bennett,0,11,30,30
1650143961418,MATH 142A,A02,083220,Chow; Bennett,0,11,30,30
1650143961418,MATH 142A,B01,083221,Chow; Bennett,0,10,30,30
1650143961418,MATH 142A,B02,083222,Chow; Bennett,0,11,30,30
1650143967442,MATH 193A,A01,083224,Staff,0,3,30,30
1650143967442,MATH 193A,A02,083225,Staff,0,4,30,30
1650143967442,MATH 193A,A03,083781,Staff,0,0,30,30
1650143967442,MATH 193A,A04,083782,Staff,0,0,30,30
1650143973467,MATH 197,001,091859,McAuley; Julian John,9998,0,9999,1
1650143979539,COGS 9,A01,083615,Staff,0,14,60,60
1650143985566,COGS 11,A01,083617,Boyle; Mary E. T.,24,0,40,16
1650143991592,COGS 13,A01,083071,Staff,0,28,40,40
1650143997617,COGS 14A,A01,092681,Staff,0,10,100,100
1650144003640,COGS 14B,A01,083073,Cheng; Tzu-Han,0,4,50,50
1650144009662,COGS 17,A01,092677,Staff,34,0,75,41
1650144015684,COGS 100,A01,083619,Staff,0,21,60,60
1650144021707,COGS 101A,A01,083621,Davis; Joshua Daniel,0,18,60,60
1650144027730,COGS 101B,A01,091572,Staff,9,0,60,51
1650144033753,COGS 101C,A01,083625,Delgado; Tania,21,0,30,9
1650144039776,COGS 107A,A01,083627,Boyle; Mary E. T.,0,5,60,60
1650144045803,COGS 118A,A01,083075,Staff,17,0,60,43
1650144051829,CSE 3,A50,083646,Miranda; Gregory Joseph,22,0,38,16
1650144051829,CSE 3,A51,083647,Miranda; Gregory Joseph,37,0,37,0
1650144057850,CSE 8A,A50,083650,Miranda; Gregory Joseph,0,16,40,40
1650144063878,CSE 11,A01,083080,Cao; Yingjun,0,66,40,40
1650144069978,CSE 12,A01,083652,Staff,0,4,100,100
1650144076005,CSE 15L,A01,083654,Staff,0,0,50,50
1650144076005,CSE 15L,A02,083655,Staff,9,0,50,41
1650144082028,CSE 20,A01,083657,Staff,55,0,80,25
1650144088050,CSE 30,A01,083084,Eldon; John,0,63,40,40
1650144094073,CSE 100,A01,083659,Cao; Yingjun,0,61,50,50
1650144100101,CSE 134B,A01,083661,Powell; Thomas Allan,0,27,65,65
1650144106124,CSE 140,A01,083663,Staff,4,0,75,71
1650144112151,CSE 140L,A01,083088,Eldon; John,0,1,75,75
1650144118176,CSE 175,A01,083665,Kumar; Rakesh,8,0,25,17
1650144124204,CSE 190,A00,092507,Dubnov; Shlomo,14,0,20,6
1650144130227,ECE 45,A01,083139,Staff,0,13,40,40
1650144136251,ECE 65,A50,083695,Staff,0,4,30,30
1650144142276,ECE 109,A01,091882,Touri; Behrouz,48,0,70,22
1650144148307,ECE 180,A00,083140,Abi Samra; Nicholas Camill,24,0,30,6
1650144148307,ECE 180,B00,083141,Abi Samra; Nicholas Camill,8,0,30,22
1650144154335,MATH 10A,A01,083735,Patchell; Gregory David,12,0,30,18
1650144154335,MATH 10A,A02,083736,Patchell; Gregory David,28,0,30,2
1650144154335,MATH 10A,A03,083737,Patchell; Gregory David,26,0,30,4
1650144160359,MATH 10B,A01,083207,Staff,0,5,30,30
1650144160359,MATH 10B,A02,083208,Staff,0,4,30,30
1650144160359,MATH 10B,B01,083739,Staff,18,0,30,12
1650144160359,MATH 10B,B02,083740,Staff,29,0,30,1
1650144166384,MATH 18,A01,083743,Staff,10,0,30,20
1650144166384,MATH 18,A02,083744,Staff,28,0,30,2
1650144166384,MATH 18,A03,083745,Staff,23,0,30,7
1650144166384,MATH 18,A04,083746,Staff,27,0,30,3
1650144166384,MATH 18,B01,083748,Staff,0,10,30,30
1650144166384,MATH 18,B02,083749,Staff,0,7,30,30
1650144166384,MATH 18,B03,083750,Staff,0,6,30,30
1650144166384,MATH 18,B04,083751,Staff,0,7,30,30
1650144172407,MATH 20A,A01,083754,Staff,26,0,40,14
1650144178432,MATH 20B,A01,083756,Staff,0,5,30,30
1650144178432,MATH 20B,A02,083757,Staff,0,4,30,30
1650144184457,MATH 20C,A01,083760,Staff,0,11,30,30
1650144184457,MATH 20C,A02,083761,Staff,0,12,30,30
1650144184457,MATH 20C,B01,083762,Staff,14,0,30,16
1650144184457,MATH 20C,B02,083763,Staff,28,0,30,2
1650144190484,MATH 20D,A01,083765,Staff,0,2,30,30
1650144190484,MATH 20D,A02,083766,Staff,11,0,30,19
1650144190484,MATH 20D,A03,083767,Staff,28,0,30,2
1650144196507,MATH 20E,A01,083771,Staff,8,0,30,22
1650144196507,MATH 20E,A02,083772,Staff,20,0,30,10
1650144196507,MATH 20E,B01,083773,Staff,0,0,30,30
1650144196507,MATH 20E,B02,083774,Staff,13,0,30,17
1650144202530,MATH 103A,A01,083777,Staff,0,8,30,30
1650144202530,MATH 103A,A02,083778,Staff,0,8,30,30
1650144202530,MATH 103A,B01,083779,Staff,0,9,30,30
1650144202530,MATH 103A,B02,083780,Staff,0,6,30,30
1650144208558,MATH 105,A01,085443,Staff,0,13,30,30
1650144214583,MATH 109,A01,083213,Anzaldo; Leesa B,0,3,30,30
1650144214583,MATH 109,A02,083214,Anzaldo; Leesa B,0,5,30,30
1650144214583,MATH 109,B01,083215,Anzaldo; Leesa B,0,4,30,30
1650144214583,MATH 109,B02,083216,Anzaldo; Leesa B,0,4,30,30
1650144220619,MATH 142A,A01,083219,Chow; Bennett,0,11,30,30
1650144220619,MATH 142A,A02,083220,Chow; Bennett,0,11,30,30
1650144220619,MATH 142A,B01,083221,Chow; Bennett,0,10,30,30
1650144220619,MATH 142A,B02,083222,Chow; Bennett,0,11,30,30
1650144226643,MATH 193A,A01,083224,Staff,0,3,30,30
1650144226643,MATH 193A,A02,083225,Staff,0,4,30,30
1650144226643,MATH 193A,A03,083781,Staff,0,0,30,30
1650144226643,MATH 193A,A04,083782,Staff,0,0,30,30
1650144232666,MATH 197,001,091859,McAuley; Julian John,9998,0,9999,1
1650144238717,COGS 9,A01,083615,Staff,0,14,60,60
1650144244742,COGS 11,A01,083617,Boyle; Mary E. T.,24,0,40,16
1650144250771,COGS 13,A01,083071,Staff,0,28,40,40
1650144256792,COGS 14A,A01,092681,Staff,0,10,100,100
1650144262816,COGS 14B,A01,083073,Cheng; Tzu-Han,0,4,50,50
1650144268843,COGS 17,A01,092677,Staff,34,0,75,41
1650144274872,COGS 100,A01,083619,Staff,0,21,60,60
1650144280897,COGS 101A,A01,083621,Davis; Joshua Daniel,0,18,60,60
1650144286923,COGS 101B,A01,091572,Staff,9,0,60,51
1650144292950,COGS 101C,A01,083625,Delgado; Tania,21,0,30,9
1650144298983,COGS 107A,A01,083627,Boyle; Mary E. T.,0,5,60,60
1650144305008,COGS 118A,A01,083075,Staff,17,0,60,43
1650144311036,CSE 3,A50,083646,Miranda; Gregory Joseph,22,0,38,16
1650144311036,CSE 3,A51,083647,Miranda; Gregory Joseph,37,0,37,0
1650144317061,CSE 8A,A50,083650,Miranda; Gregory Joseph,0,16,40,40
1650144323088,CSE 11,A01,083080,Cao; Yingjun,0,66,40,40
1650144329112,CSE 12,A01,083652,Staff,0,4,100,100
1650144335139,CSE 15L,A01,083654,Staff,0,0,50,50
1650144335139,CSE 15L,A02,083655,Staff,9,0,50,41
1650144341162,CSE 20,A01,083657,Staff,55,0,80,25
1650144347197,CSE 30,A01,083084,Eldon; John,0,63,40,40
1650144353223,CSE 100,A01,083659,Cao; Yingjun,0,61,50,50
1650144359250,CSE 134B,A01,083661,Powell; Thomas Allan,0,27,65,65
1650144365272,CSE 140,A01,083663,Staff,4,0,75,71
1650144371294,CSE 140L,A01,083088,Eldon; John,0,1,75,75
1650144377318,CSE 175,A01,083665,Kumar; Rakesh,8,0,25,17
1650144383340,CSE 190,A00,092507,Dubnov; Shlomo,14,0,20,6
1650144389366,ECE 45,A01,083139,Staff,0,13,40,40
1650144395393,ECE 65,A50,083695,Staff,0,4,30,30
1650144401418,ECE 109,A01,091882,Touri; Behrouz,48,0,70,22
1650144407439,ECE 180,A00,083140,Abi Samra; Nicholas Camill,24,0,30,6
1650144407439,ECE 180,B00,083141,Abi Samra; Nicholas Camill,8,0,30,22
1650144413477,MATH 10A,A01,083735,Patchell; Gregory David,12,0,30,18
1650144413477,MATH 10A,A02,083736,Patchell; Gregory David,28,0,30,2
1650144413477,MATH 10A,A03,083737,Patchell; Gregory David,26,0,30,4
1650144419501,MATH 10B,A01,083207,Staff,0,5,30,30
1650144419501,MATH 10B,A02,083208,Staff,0,4,30,30
1650144419501,MATH 10B,B01,083739,Staff,18,0,30,12
1650144419501,MATH 10B,B02,083740,Staff,29,0,30,1
1650144425530,MATH 18,A01,083743,Staff,10,0,30,20
1650144425530,MATH 18,A02,083744,Staff,28,0,30,2
1650144425530,MATH 18,A03,083745,Staff,23,0,30,7
1650144425530,MATH 18,A04,083746,Staff,27,0,30,3
1650144425530,MATH 18,B01,083748,Staff,0,10,30,30
1650144425530,MATH 18,B02,083749,Staff,0,7,30,30
1650144425530,MATH 18,B03,083750,Staff,0,6,30,30
1650144425530,MATH 18,B04,083751,Staff,0,7,30,30
1650144431556,MATH 20A,A01,083754,Staff,26,0,40,14
1650144437588,MATH 20B,A01,083756,Staff,0,5,30,30
1650144437588,MATH 20B,A02,083757,Staff,0,4,30,30
1650144443611,MATH 20C,A01,083760,Staff,0,11,30,30
1650144443611,MATH 20C,A02,083761,Staff,0,12,30,30
1650144443611,MATH 20C,B01,083762,Staff,14,0,30,16
1650144443611,MATH 20C,B02,083763,Staff,28,0,30,2
1650144449636,MATH 20D,A01,083765,Staff,0,2,30,30
1650144449636,MATH 20D,A02,083766,Staff,10,0,30,20
1650144449636,MATH 20D,A03,083767,Staff,28,0,30,2
1650144455703,MATH 20E,A01,083771,Staff,8,0,30,22
1650144455703,MATH 20E,A02,083772,Staff,20,0,30,10
1650144455703,MATH 20E,B01,083773,Staff,0,0,30,30
1650144455703,MATH 20E,B02,083774,Staff,13,0,30,17
1650144461732,MATH 103A,A01,083777,Staff,0,8,30,30
1650144461732,MATH 103A,A02,083778,Staff,0,8,30,30
1650144461732,MATH 103A,B01,083779,Staff,0,9,30,30
1650144461732,MATH 103A,B02,083780,Staff,0,6,30,30
1650144467756,MATH 105,A01,085443,Staff,0,13,30,30
1650144473779,MATH 109,A01,083213,Anzaldo; Leesa B,0,3,30,30
1650144473779,MATH 109,A02,083214,Anzaldo; Leesa B,0,5,30,30
1650144473779,MATH 109,B01,083215,Anzaldo; Leesa B,0,4,30,30
1650144473779,MATH 109,B02,083216,Anzaldo; Leesa B,0,4,30,30
1650144479804,MATH 142A,A01,083219,Chow; Bennett,0,11,30,30
1650144479804,MATH 142A,A02,083220,Chow; Bennett,0,11,30,30
1650144479804,MATH 142A,B01,083221,Chow; Bennett,0,10,30,30
1650144479804,MATH 142A,B02,083222,Chow; Bennett,0,11,30,30
1650144485832,MATH 193A,A01,083224,Staff,0,3,30,30
1650144485832,MATH 193A,A02,083225,Staff,0,4,30,30
1650144485832,MATH 193A,A03,083781,Staff,0,0,30,30
1650144485832,MATH 193A,A04,083782,Staff,0,0,30,30
1650144491854,MATH 197,001,091859,McAuley; Julian John,9998,0,9999,1
1650144497906,COGS 9,A01,083615,Staff,0,14,60,60
1650144503941,COGS 11,A01,083617,Boyle; Mary E. T.,24,0,40,16
1650144509973,COGS 13,A01,083071,Staff,0,28,40,40
1650144515999,COGS 14A,A01,092681,Staff,0,10,100,100
1650144522027,COGS 14B,A01,083073,Cheng; Tzu-Han,0,4,50,50
1650144528052,COGS 17,A01,092677,Staff,34,0,75,41
1650144534081,COGS 100,A01,083619,Staff,0,21,60,60
1650144540109,COGS 101A,A01,083621,Davis; Joshua Daniel,0,18,60,60
1650144546136,COGS 101B,A01,091572,Staff,9,0,60,51
1650144552159,COGS 101C,A01,083625,Delgado; Tania,21,0,30,9
1650144558184,COGS 107A,A01,083627,Boyle; Mary E. T.,0,5,60,60
1650144564208,COGS 118A,A01,083075,Staff,17,0,60,43
1650144570232,CSE 3,A50,083646,Miranda; Gregory Joseph,22,0,38,16
1650144570232,CSE 3,A51,083647,Miranda; Gregory Joseph,37,0,37,0
1650144576255,CSE 8A,A50,083650,Miranda; Gregory Joseph,0,16,40,40
1650144582280,CSE 11,A01,083080,Cao; Yingjun,0,66,40,40
1650144588303,CSE 12,A01,083652,Staff,0,4,100,100
1650144594330,CSE 15L,A01,083654,Staff,0,0,50,50
1650144594330,CSE 15L,A02,083655,Staff,9,0,50,41
1650144600358,CSE 20,A01,083657,Staff,55,0,80,25
1650144606382,CSE 30,A01,083084,Eldon; John,0,63,40,40
1650144612407,CSE 100,A01,083659,Cao; Yingjun,0,61,50,50
1650144618436,CSE 134B,A01,083661,Powell; Thomas Allan,0,27,65,65
1650144624459,CSE 140,A01,083663,Staff,4,0,75,71
1650144630486,CSE 140L,A01,083088,Eldon; John,0,1,75,75
1650144636510,CSE 175,A01,083665,Kumar; Rakesh,8,0,25,17
1650144642539,CSE 190,A00,092507,Dubnov; Shlomo,14,0,20,6
1650144648566,ECE 45,A01,083139,Staff,0,13,40,40
1650144654590,ECE 65,A50,083695,Staff,0,4,30,30
1650144660618,ECE 109,A01,091882,Touri; Behrouz,48,0,70,22
1650144666719,ECE 180,A00,083140,Abi Samra; Nicholas Camill,24,0,30,6
1650144666719,ECE 180,B00,083141,Abi Samra; Nicholas Camill,8,0,30,22
1650144672744,MATH 10A,A01,083735,Patchell; Gregory David,12,0,30,18
1650144672744,MATH 10A,A02,083736,Patchell; Gregory David,28,0,30,2
1650144672744,MATH 10A,A03,083737,Patchell; Gregory David,26,0,30,4
1650144678776,MATH 10B,A01,083207,Staff,0,5,30,30
1650144678776,MATH 10B,A02,083208,Staff,0,4,30,30
1650144678776,MATH 10B,B01,083739,Staff,18,0,30,12
1650144678776,MATH 10B,B02,083740,Staff,29,0,30,1
1650144684805,MATH 18,A01,083743,Staff,10,0,30,20
1650144684805,MATH 18,A02,083744,Staff,28,0,30,2
1650144684805,MATH 18,A03,083745,Staff,23,0,30,7
1650144684805,MATH 18,A04,083746,Staff,27,0,30,3
1650144684805,MATH 18,B01,083748,Staff,0,10,30,30
1650144684805,MATH 18,B02,083749,Staff,0,7,30,30
1650144684805,MATH 18,B03,083750,Staff,0,6,30,30
1650144684805,MATH 18,B04,083751,Staff,0,7,30,30
1650144690829,MATH 20A,A01,083754,Staff,26,0,40,14
1650144696851,MATH 20B,A01,083756,Staff,0,5,30,30
1650144696851,MATH 20B,A02,083757,Staff,0,4,30,30
1650144702881,MATH 20C,A01,083760,Staff,0,11,30,30
1650144702881,MATH 20C,A02,083761,Staff,0,12,30,30
1650144702881,MATH 20C,B01,083762,Staff,14,0,30,16
1650144702881,MATH 20C,B02,083763,Staff,28,0,30,2
1650144708905,MATH 20D,A01,083765,Staff,0,2,30,30
1650144708905,MATH 20D,A02,083766,Staff,10,0,30,20
1650144708905,MATH 20D,A03,083767,Staff,28,0,30,2
1650144714930,MATH 20E,A01,083771,Staff,8,0,30,22
1650144714930,MATH 20E,A02,083772,Staff,20,0,30,10
1650144714930,MATH 20E,B01,083773,Staff,0,0,30,30
1650144714930,MATH 20E,B02,083774,Staff,13,0,30,17
1650144720953,MATH 103A,A01,083777,Staff,0,8,30,30
1650144720953,MATH 103A,A02,083778,Staff,0,8,30,30
1650144720953,MATH 103A,B01,083779,Staff,0,9,30,30
1650144720953,MATH 103A,B02,083780,Staff,0,6,30,30
1650144726978,MATH 105,A01,085443,Staff,0,13,30,30
1650144733005,MATH 109,A01,083213,Anzaldo; Leesa B,0,3,30,30
1650144733005,MATH 109,A02,083214,Anzaldo; Leesa B,0,5,30,30
1650144733005,MATH 109,B01,083215,Anzaldo; Leesa B,0,4,30,30
1650144733005,MATH 109,B02,083216,Anzaldo; Leesa B,0,4,30,30
1650144739030,MATH 142A,A01,083219,Chow; Bennett,0,11,30,30
1650144739030,MATH 142A,A02,083220,Chow; Bennett,0,11,30,30
1650144739030,MATH 142A,B01,083221,Chow; Bennett,0,10,30,30
1650144739030,MATH 142A,B02,083222,Chow; Bennett,0,11,30,30
1650144745055,MATH 193A,A01,083224,Staff,0,3,30,30
1650144745055,MATH 193A,A02,083225,Staff,0,4,30,30
1650144745055,MATH 193A,A03,083781,Staff,0,0,30,30
1650144745055,MATH 193A,A04,083782,Staff,0,0,30,30
1650144751081,MATH 197,001,091859,McAuley; Julian John,9998,0,9999,1
1650144757145,COGS 9,A01,083615,Staff,0,14,60,60
1650144763169,COGS 11,A01,083617,Boyle; Mary E. T.,24,0,40,16
1650144769204,COGS 13,A01,083071,Staff,0,28,40,40
1650144775232,COGS 14A,A01,092681,Staff,0,10,100,100
1650144781255,COGS 14B,A01,083073,Cheng; Tzu-Han,0,4,50,50
1650144787278,COGS 17,A01,092677,Staff,34,0,75,41
1650144793302,COGS 100,A01,083619,Staff,0,21,60,60
1650144799325,COGS 101A,A01,083621,Davis; Joshua Daniel,0,18,60,60
1650144805349,COGS 101B,A01,091572,Staff,9,0,60,51
1650144811373,COGS 101C,A01,083625,Delgado; Tania,21,0,30,9
1650144817407,COGS 107A,A01,083627,Boyle; Mary E. T.,0,5,60,60
1650144823429,COGS 118A,A01,083075,Staff,17,0,60,43
1650144829455,CSE 3,A50,083646,Miranda; Gregory Joseph,22,0,38,16
1650144829455,CSE 3,A51,083647,Miranda; Gregory Joseph,37,0,37,0
1650144835477,CSE 8A,A50,083650,Miranda; Gregory Joseph,0,16,40,40
1650144841501,CSE 11,A01,083080,Cao; Yingjun,0,66,40,40
1650144847530,CSE 12,A01,083652,Staff,0,4,100,100
1650144853554,CSE 15L,A01,083654,Staff,0,0,50,50
1650144853554,CSE 15L,A02,083655,Staff,9,0,50,41
1650144859585,CSE 20,A01,083657,Staff,55,0,80,25
1650144865608,CSE 30,A01,083084,Eldon; John,0,63,40,40
1650144871630,CSE 100,A01,083659,Cao; Yingjun,0,61,50,50
1650144877657,CSE 134B,A01,083661,Powell; Thomas Allan,0,27,65,65
1650144883680,CSE 140,A01,083663,Staff,4,0,75,71
1650144889704,CSE 140L,A01,083088,Eldon; John,0,1,75,75
1650144895730,CSE 175,A01,083665,Kumar; Rakesh,8,0,25,17
1650144901754,CSE 190,A00,092507,Dubnov; Shlomo,14,0,20,6
1650144907777,ECE 45,A01,083139,Staff,0,13,40,40
1650144913801,ECE 65,A50,083695,Staff,0,4,30,30
1650144919829,ECE 109,A01,091882,Touri; Behrouz,48,0,70,22
1650144925852,ECE 180,A00,083140,Abi Samra; Nicholas Camill,24,0,30,6
1650144925852,ECE 180,B00,083141,Abi Samra; Nicholas Camill,8,0,30,22
1650144931884,MATH 10A,A01,083735,Patchell; Gregory David,12,0,30,18
1650144931884,MATH 10A,A02,083736,Patchell; Gregory David,28,0,30,2
1650144931884,MATH 10A,A03,083737,Patchell; Gregory David,26,0,30,4
1650144937910,MATH 10B,A01,083207,Staff,0,5,30,30
1650144937910,MATH 10B,A02,083208,Staff,0,4,30,30
1650144937910,MATH 10B,B01,083739,Staff,18,0,30,12
1650144937910,MATH 10B,B02,083740,Staff,29,0,30,1
1650144943935,MATH 18,A01,083743,Staff,10,0,30,20
1650144943935,MATH 18,A02,083744,Staff,28,0,30,2
1650144943935,MATH 18,A03,083745,Staff,23,0,30,7
1650144943935,MATH 18,A04,083746,Staff,27,0,30,3
1650144943935,MATH 18,B01,083748,Staff,0,10,30,30
1650144943935,MATH 18,B02,083749,Staff,0,7,30,30
1650144943935,MATH 18,B03,083750,Staff,0,6,30,30
1650144943935,MATH 18,B04,083751,Staff,0,7,30,30
1650144949966,MATH 20A,A01,083754,Staff,26,0,40,14
1650144955989,MATH 20B,A01,083756,Staff,0,5,30,30
1650144955989,MATH 20B,A02,083757,Staff,0,4,30,30
1650144962017,MATH 20C,A01,083760,Staff,0,11,30,30
1650144962017,MATH 20C,A02,083761,Staff,0,12,30,30
1650144962017,MATH 20C,B01,083762,Staff,14,0,30,16
1650144962017,MATH 20C,B02,083763,Staff,28,0,30,2
1650144968046,MATH 20D,A01,083765,Staff,0,2,30,30
1650144968046,MATH 20D,A02,083766,Staff,10,0,30,20
1650144968046,MATH 20D,A03,083767,Staff,28,0,30,2
1650144974076,MATH 20E,A01,083771,Staff,8,0,30,22
1650144974076,MATH 20E,A02,083772,Staff,20,0,30,10
1650144974076,MATH 20E,B01,083773,Staff,0,0,30,30
1650144974076,MATH 20E,B02,083774,Staff,13,0,30,17
1650144980100,MATH 103A,A01,083777,Staff,0,8,30,30
1650144980100,MATH 103A,A02,083778,Staff,0,8,30,30
1650144980100,MATH 103A,B01,083779,Staff,0,9,30,30
1650144980100,MATH 103A,B02,083780,Staff,0,6,30,30
1650144986126,MATH 105,A01,085443,Staff,0,13,30,30
1650144992150,MATH 109,A01,083213,Anzaldo; Leesa B,0,3,30,30
1650144992150,MATH 109,A02,083214,Anzaldo; Leesa B,0,6,30,30
1650144992150,MATH 109,B01,083215,Anzaldo; Leesa B,0,4,30,30
1650144992150,MATH 109,B02,083216,Anzaldo; Leesa B,0,4,30,30
1650144998179,MATH 142A,A01,083219,Chow; Bennett,0,11,30,30
1650144998179,MATH 142A,A02,083220,Chow; Bennett,0,11,30,30
1650144998179,MATH 142A,B01,083221,Chow; Bennett,0,10,30,30
1650144998179,MATH 142A,B02,083222,Chow; Bennett,0,11,30,30
1650145004203,MATH 193A,A01,083224,Staff,0,3,30,30
1650145004203,MATH 193A,A02,083225,Staff,0,4,30,30
1650145004203,MATH 193A,A03,083781,Staff,0,0,30,30
1650145004203,MATH 193A,A04,083782,Staff,0,0,30,30
1650145010226,MATH 197,001,091859,McAuley; Julian John,9998,0,9999,1
1650145016282,COGS 9,A01,083615,Staff,0,14,60,60
1650145022312,COGS 11,A01,083617,Boyle; Mary E. T.,24,0,40,16
1650145028342,COGS 13,A01,083071,Staff,0,28,40,40
1650145034366,COGS 14A,A01,092681,Staff,0,10,100,100
1650145040391,COGS 14B,A01,083073,Cheng; Tzu-Han,0,4,50,50
1650145046414,COGS 17,A01,092677,Staff,34,0,75,41
1650145052437,COGS 100,A01,083619,Staff,0,21,60,60
1650145058458,COGS 101A,A01,083621,Davis; Joshua Daniel,0,18,60,60
1650145064484,COGS 101B,A01,091572,Staff,9,0,60,51
1650145070506,COGS 101C,A01,083625,Delgado; Tania,21,0,30,9
1650145076543,COGS 107A,A01,083627,Boyle; Mary E. T.,0,5,60,60
1650145082567,COGS 118A,A01,083075,Staff,17,0,60,43
1650145088595,CSE 3,A50,083646,Miranda; Gregory Joseph,22,0,38,16
1650145088595,CSE 3,A51,083647,Miranda; Gregory Joseph,37,0,37,0
1650145094619,CSE 8A,A50,083650,Miranda; Gregory Joseph,0,16,40,40
1650145100645,CSE 11,A01,083080,Cao; Yingjun,0,66,40,40
1650145106673,CSE 12,A01,083652,Staff,0,4,100,100
1650145112696,CSE 15L,A01,083654,Staff,0,0,50,50
1650145112696,CSE 15L,A02,083655,Staff,9,0,50,41
1650145118722,CSE 20,A01,083657,Staff,55,0,80,25
1650145124746,CSE 30,A01,083084,Eldon; John,0,64,40,40
1650145130775,CSE 100,A01,083659,Cao; Yingjun,0,61,50,50
1650145136801,CSE 134B,A01,083661,Powell; Thomas Allan,0,27,65,65
1650145142828,CSE 140,A01,083663,Staff,4,0,75,71
1650145148854,CSE 140L,A01,083088,Eldon; John,0,1,75,75
1650145154882,CSE 175,A01,083665,Kumar; Rakesh,8,0,25,17
1650145160910,CSE 190,A00,092507,Dubnov; Shlomo,14,0,20,6
1650145166932,ECE 45,A01,083139,Staff,0,13,40,40
1650145172956,ECE 65,A50,083695,Staff,0,4,30,30
1650145178983,ECE 109,A01,091882,Touri; Behrouz,48,0,70,22
1650145185009,ECE 180,A00,083140,Abi Samra; Nicholas Camill,24,0,30,6
1650145185009,ECE 180,B00,083141,Abi Samra; Nicholas Camill,8,0,30,22
1650145191036,MATH 10A,A01,083735,Patchell; Gregory David,12,0,30,18
1650145191036,MATH 10A,A02,083736,Patchell; Gregory David,28,0,30,2
1650145191036,MATH 10A,A03,083737,Patchell; Gregory David,26,0,30,4
1650145197060,MATH 10B,A01,083207,Staff,0,5,30,30
1650145197060,MATH 10B,A02,083208,Staff,0,4,30,30
1650145197060,MATH 10B,B01,083739,Staff,18,0,30,12
1650145197060,MATH 10B,B02,083740,Staff,29,0,30,1
1650145203096,MATH 18,A01,083743,Staff,10,0,30,20
1650145203096,MATH 18,A02,083744,Staff,28,0,30,2
1650145203096,MATH 18,A03,083745,Staff,23,0,30,7
1650145203096,MATH 18,A04,083746,Staff,27,0,30,3
1650145203096,MATH 18,B01,083748,Staff,0,10,30,30
1650145203096,MATH 18,B02,083749,Staff,0,7,30,30
1650145203096,MATH 18,B03,083750,Staff,0,6,30,30
1650145203096,MATH 18,B04,083751,Staff,0,7,30,30
1650145209120,MATH 20A,A01,083754,Staff,26,0,40,14
1650145215149,MATH 20B,A01,083756,Staff,0,5,30,30
1650145215149,MATH 20B,A02,083757,Staff,0,4,30,30
1650145221178,MATH 20C,A01,083760,Staff,0,11,30,30
1650145221178,MATH 20C,A02,083761,Staff,0,12,30,30
1650145221178,MATH 20C,B01,083762,Staff,14,0,30,16
1650145221178,MATH 20C,B02,083763,Staff,28,0,30,2
1650145227206,MATH 20D,A01,083765,Staff,0,2,30,30
1650145227206,MATH 20D,A02,083766,Staff,10,0,30,20
1650145227206,MATH 20D,A03,083767,Staff,28,0,30,2
1650145233233,MATH 20E,A01,083771,Staff,8,0,30,22
1650145233233,MATH 20E,A02,083772,Staff,20,0,30,10
1650145233233,MATH 20E,B01,083773,Staff,0,0,30,30
1650145233233,MATH 20E,B02,083774,Staff,13,0,30,17
1650145239255,MATH 103A,A01,083777,Staff,0,8,30,30
1650145239255,MATH 103A,A02,083778,Staff,0,8,30,30
1650145239255,MATH 103A,B01,083779,Staff,0,9,30,30
1650145239255,MATH 103A,B02,083780,Staff,0,6,30,30
1650145245279,MATH 105,A01,085443,Staff,0,13,30,30
1650145251308,MATH 109,A01,083213,Anzaldo; Leesa B,0,3,30,30
1650145251308,MATH 109,A02,083214,Anzaldo; Leesa B,0,6,30,30
1650145251308,MATH 109,B01,083215,Anzaldo; Leesa B,0,4,30,30
1650145251308,MATH 109,B02,083216,Anzaldo; Leesa B,0,4,30,30
1650145257336,MATH 142A,A01,083219,Chow; Bennett,0,11,30,30
1650145257336,MATH 142A,A02,083220,Chow; Bennett,0,11,30,30
1650145257336,MATH 142A,B01,083221,Chow; Bennett,0,10,30,30
1650145257336,MATH 142A,B02,083222,Chow; Bennett,0,11,30,30
1650145263454,MATH 193A,A01,083224,Staff,0,3,30,30
1650145263454,MATH 193A,A02,083225,Staff,0,4,30,30
1650145263454,MATH 193A,A03,083781,Staff,0,0,30,30
1650145263454,MATH 193A,A04,083782,Staff,0,0,30,30
1650145269478,MATH 197,001,091859,McAuley; Julian John,9998,0,9999,1
1650145275542,COGS 9,A01,083615,Staff,0,14,60,60
1650145281570,COGS 11,A01,083617,Boyle; Mary E. T.,24,0,40,16
1650145287593,COGS 13,A01,083071,Staff,0,28,40,40
1650145293634,COGS 14A,A01,092681,Staff,0,10,100,100
1650145299658,COGS 14B,A01,083073,Cheng; Tzu-Han,0,4,50,50
1650145305684,COGS 17,A01,092677,Staff,34,0,75,41
1650145311707,COGS 100,A01,083619,Staff,0,21,60,60
1650145317735,COGS 101A,A01,083621,Davis; Joshua Daniel,0,18,60,60
1650145323759,COGS 101B,A01,091572,Staff,9,0,60,51
1650145329783,COGS 101C,A01,083625,Delgado; Tania,21,0,30,9
1650145335810,COGS 107A,A01,083627,Boyle; Mary E. T.,0,5,60,60
1650145341834,COGS 118A,A01,083075,Staff,17,0,60,43
1650145347858,CSE 3,A50,083646,Miranda; Gregory Joseph,22,0,38,16
1650145347858,CSE 3,A51,083647,Miranda; Gregory Joseph,37,0,37,0
1650145353881,CSE 8A,A50,083650,Miranda; Gregory Joseph,0,16,40,40
1650145359908,CSE 11,A01,083080,Cao; Yingjun,0,66,40,40
1650145365932,CSE 12,A01,083652,Staff,0,4,100,100
1650145371958,CSE 15L,A01,083654,Staff,0,0,50,50
1650145371958,CSE 15L,A02,083655,Staff,9,0,50,41
1650145377992,CSE 20,A01,083657,Staff,55,0,80,25
1650145384016,CSE 30,A01,083084,Eldon; John,0,64,40,40
1650145390040,CSE 100,A01,083659,Cao; Yingjun,0,61,50,50
1650145396065,CSE 134B,A01,083661,Powell; Thomas Allan,0,27,65,65
1650145402092,CSE 140,A01,083663,Staff,4,0,75,71
1650145408116,CSE 140L,A01,083088,Eldon; John,0,1,75,75
1650145414140,CSE 175,A01,083665,Kumar; Rakesh,8,0,25,17
1650145420163,CSE 190,A00,092507,Dubnov; Shlomo,14,0,20,6
1650145426187,ECE 45,A01,083139,Staff,0,13,40,40
1650145432210,ECE 65,A50,083695,Staff,0,4,30,30
1650145438237,ECE 109,A01,091882,Touri; Behrouz,48,0,70,22
1650145444262,ECE 180,A00,083140,Abi Samra; Nicholas Camill,24,0,30,6
1650145444262,ECE 180,B00,083141,Abi Samra; Nicholas Camill,8,0,30,22
1650145450285,MATH 10A,A01,083735,Patchell; Gregory David,12,0,30,18
1650145450285,MATH 10A,A02,083736,Patchell; Gregory David,28,0,30,2
1650145450285,MATH 10A,A03,083737,Patchell; Gregory David,26,0,30,4
1650145456311,MATH 10B,A01,083207,Staff,0,5,30,30
1650145456311,MATH 10B,A02,083208,Staff,0,4,30,30
1650145456311,MATH 10B,B01,083739,Staff,18,0,30,12
1650145456311,MATH 10B,B02,083740,Staff,29,0,30,1
1650145462341,MATH 18,A01,083743,Staff,10,0,30,20
1650145462341,MATH 18,A02,083744,Staff,28,0,30,2
1650145462341,MATH 18,A03,083745,Staff,23,0,30,7
1650145462341,MATH 18,A04,083746,Staff,27,0,30,3
1650145462341,MATH 18,B01,083748,Staff,0,10,30,30
1650145462341,MATH 18,B02,083749,Staff,0,7,30,30
1650145462341,MATH 18,B03,083750,Staff,0,6,30,30
1650145462341,MATH 18,B04,083751,Staff,0,7,30,30
1650145468368,MATH 20A,A01,083754,Staff,26,0,40,14
1650145474397,MATH 20B,A01,083756,Staff,0,5,30,30
1650145474397,MATH 20B,A02,083757,Staff,0,4,30,30
1650145480421,MATH 20C,A01,083760,Staff,0,11,30,30
1650145480421,MATH 20C,A02,083761,Staff,0,12,30,30
1650145480421,MATH 20C,B01,083762,Staff,14,0,30,16
1650145480421,MATH 20C,B02,083763,Staff,28,0,30,2
1650145486444,MATH 20D,A01,083765,Staff,0,2,30,30
1650145486444,MATH 20D,A02,083766,Staff,10,0,30,20
1650145486444,MATH 20D,A03,083767,Staff,28,0,30,2
1650145492472,MATH 20E,A01,083771,Staff,8,0,30,22
1650145492472,MATH 20E,A02,083772,Staff,20,0,30,10
1650145492472,MATH 20E,B01,083773,Staff,0,0,30,30
1650145492472,MATH 20E,B02,083774,Staff,13,0,30,17
1650145498501,MATH 103A,A01,083777,Staff,0,8,30,30
1650145498501,MATH 103A,A02,083778,Staff,0,8,30,30
1650145498501,MATH 103A,B01,083779,Staff,0,9,30,30
1650145498501,MATH 103A,B02,083780,Staff,0,6,30,30
1650145504530,MATH 105,A01,085443,Staff,0,13,30,30
1650145510554,MATH 109,A01,083213,Anzaldo; Leesa B,0,3,30,30
1650145510554,MATH 109,A02,083214,Anzaldo; Leesa B,0,6,30,30
1650145510554,MATH 109,B01,083215,Anzaldo; Leesa B,0,4,30,30
1650145510554,MATH 109,B02,083216,Anzaldo; Leesa B,0,4,30,30
1650145516583,MATH 142A,A01,083219,Chow; Bennett,0,11,30,30
1650145516583,MATH 142A,A02,083220,Chow; Bennett,0,11,30,30
1650145516583,MATH 142A,B01,083221,Chow; Bennett,0,10,30,30
1650145516583,MATH 142A,B02,083222,Chow; Bennett,0,11,30,30
1650145522613,MATH 193A,A01,083224,Staff,0,3,30,30
1650145522613,MATH 193A,A02,083225,Staff,0,4,30,30
1650145522613,MATH 193A,A03,083781,Staff,0,0,30,30
1650145522613,MATH 193A,A04,083782,Staff,0,0,30,30
1650145528636,MATH 197,001,091859,McAuley; Julian John,9998,0,9999,1
1650145534701,COGS 9,A01,083615,Staff,0,14,60,60
1650145540725,COGS 11,A01,083617,Boyle; Mary E. T.,24,0,40,16
1650145546748,COGS 13,A01,083071,Staff,0,28,40,40
1650145552775,COGS 14A,A01,092681,Staff,0,10,100,100
1650145558809,COGS 14B,A01,083073,Cheng; Tzu-Han,0,4,50,50
1650145564843,COGS 17,A01,092677,Staff,34,0,75,41
1650145570869,COGS 100,A01,083619,Staff,0,21,60,60
1650145576893,COGS 101A,A01,083621,Davis; Joshua Daniel,0,19,60,60
1650145582919,COGS 101B,A01,091572,Staff,9,0,60,51
1650145588946,COGS 101C,A01,083625,Delgado; Tania,21,0,30,9
1650145594970,COGS 107A,A01,083627,Boyle; Mary E. T.,0,5,60,60
1650145600995,COGS 118A,A01,083075,Staff,17,0,60,43
1650145607026,CSE 3,A50,083646,Miranda; Gregory Joseph,22,0,38,16
1650145607026,CSE 3,A51,083647,Miranda; Gregory Joseph,37,0,37,0
1650145613050,CSE 8A,A50,083650,Miranda; Gregory Joseph,0,16,40,40
1650145619077,CSE 11,A01,083080,Cao; Yingjun,0,66,40,40
1650145625102,CSE 12,A01,083652,Staff,0,4,100,100
1650145631129,CSE 15L,A01,083654,Staff,0,0,50,50
1650145631129,CSE 15L,A02,083655,Staff,9,0,50,41
1650145637154,CSE 20,A01,083657,Staff,55,0,80,25
1650145643182,CSE 30,A01,083084,Eldon; John,0,64,40,40
1650145649204,CSE 100,A01,083659,Cao; Yingjun,0,61,50,50
1650145655226,CSE 134B,A01,083661,Powell; Thomas Allan,0,27,65,65
1650145661249,CSE 140,A01,083663,Staff,4,0,75,71
1650145667271,CSE 140L,A01,083088,Eldon; John,0,1,75,75
1650145673296,CSE 175,A01,083665,Kumar; Rakesh,8,0,25,17
1650145679317,CSE 190,A00,092507,Dubnov; Shlomo,14,0,20,6
1650145685343,ECE 45,A01,083139,Staff,0,13,40,40
1650145691367,ECE 65,A50,083695,Staff,0,4,30,30
1650145697392,ECE 109,A01,091882,Touri; Behrouz,48,0,70,22
1650145703416,ECE 180,A00,083140,Abi Samra; Nicholas Camill,24,0,30,6
1650145703416,ECE 180,B00,083141,Abi Samra; Nicholas Camill,8,0,30,22
1650145709448,MATH 10A,A01,083735,Patchell; Gregory David,12,0,30,18
1650145709448,MATH 10A,A02,083736,Patchell; Gregory David,28,0,30,2
1650145709448,MATH 10A,A03,083737,Patchell; Gregory David,26,0,30,4
1650145715472,MATH 10B,A01,083207,Staff,0,5,30,30
1650145715472,MATH 10B,A02,083208,Staff,0,4,30,30
1650145715472,MATH 10B,B01,083739,Staff,18,0,30,12
1650145715472,MATH 10B,B02,083740,Staff,29,0,30,1
1650145721497,MATH 18,A01,083743,Staff,10,0,30,20
1650145721497,MATH 18,A02,083744,Staff,28,0,30,2
1650145721497,MATH 18,A03,083745,Staff,23,0,30,7
1650145721497,MATH 18,A04,083746,Staff,27,0,30,3
1650145721497,MATH 18,B01,083748,Staff,0,10,30,30
1650145721497,MATH 18,B02,083749,Staff,0,7,30,30
1650145721497,MATH 18,B03,083750,Staff,0,6,30,30
1650145721497,MATH 18,B04,083751,Staff,0,7,30,30
1650145727521,MATH 20A,A01,083754,Staff,26,0,40,14
1650145733548,MATH 20B,A01,083756,Staff,0,5,30,30
1650145733548,MATH 20B,A02,083757,Staff,0,4,30,30
1650145739576,MATH 20C,A01,083760,Staff,0,11,30,30
1650145739576,MATH 20C,A02,083761,Staff,0,12,30,30
1650145739576,MATH 20C,B01,083762,Staff,14,0,30,16
1650145739576,MATH 20C,B02,083763,Staff,28,0,30,2
1650145745601,MATH 20D,A01,083765,Staff,0,2,30,30
1650145745601,MATH 20D,A02,083766,Staff,10,0,30,20
1650145745601,MATH 20D,A03,083767,Staff,28,0,30,2
1650145751638,MATH 20E,A01,083771,Staff,8,0,30,22
1650145751638,MATH 20E,A02,083772,Staff,20,0,30,10
1650145751638,MATH 20E,B01,083773,Staff,0,0,30,30
1650145751638,MATH 20E,B02,083774,Staff,13,0,30,17
1650145757662,MATH 103A,A01,083777,Staff,0,8,30,30
1650145757662,MATH 103A,A02,083778,Staff,0,8,30,30
1650145757662,MATH 103A,B01,083779,Staff,0,9,30,30
1650145757662,MATH 103A,B02,083780,Staff,0,6,30,30
1650145763691,MATH 105,A01,085443,Staff,0,13,30,30
1650145769720,MATH 109,A01,083213,Anzaldo; Leesa B,0,3,30,30
1650145769720,MATH 109,A02,083214,Anzaldo; Leesa B,0,6,30,30
1650145769720,MATH 109,B01,083215,Anzaldo; Leesa B,0,4,30,30
1650145769720,MATH 109,B02,083216,Anzaldo; Leesa B,0,4,30,30
1650145775749,MATH 142A,A01,083219,Chow; Bennett,0,11,30,30
1650145775749,MATH 142A,A02,083220,Chow; Bennett,0,11,30,30
1650145775749,MATH 142A,B01,083221,Chow; Bennett,0,10,30,30
1650145775749,MATH 142A,B02,083222,Chow; Bennett,0,11,30,30
1650145781773,MATH 193A,A01,083224,Staff,0,3,30,30
1650145781773,MATH 193A,A02,083225,Staff,0,4,30,30
1650145781773,MATH 193A,A03,083781,Staff,0,0,30,30
1650145781773,MATH 193A,A04,083782,Staff,0,0,30,30
1650145787798,MATH 197,001,091859,McAuley; Julian John,9998,0,9999,1
1650145793860,COGS 9,A01,083615,Staff,0,14,60,60
1650145799895,COGS 11,A01,083617,Boyle; Mary E. T.,24,0,40,16
1650145805923,COGS 13,A01,083071,Staff,0,28,40,40
1650145811949,COGS 14A,A01,092681,Staff,0,10,100,100
1650145817973,COGS 14B,A01,083073,Cheng; Tzu-Han,0,4,50,50
1650145824000,COGS 17,A01,092677,Staff,34,0,75,41
1650145830035,COGS 100,A01,083619,Staff,0,21,60,60
1650145836059,COGS 101A,A01,083621,Davis; Joshua Daniel,0,19,60,60
1650145842086,COGS 101B,A01,091572,Staff,9,0,60,51
1650145848118,COGS 101C,A01,083625,Delgado; Tania,21,0,30,9
1650145854214,COGS 107A,A01,083627,Boyle; Mary E. T.,0,5,60,60
1650145860246,COGS 118A,A01,083075,Staff,17,0,60,43
1650145866275,CSE 3,A50,083646,Miranda; Gregory Joseph,22,0,38,16
1650145866275,CSE 3,A51,083647,Miranda; Gregory Joseph,37,0,37,0
1650145872298,CSE 8A,A50,083650,Miranda; Gregory Joseph,0,16,40,40
1650145878320,CSE 11,A01,083080,Cao; Yingjun,0,66,40,40
1650145884344,CSE 12,A01,083652,Staff,0,4,100,100
1650145890372,CSE 15L,A01,083654,Staff,0,0,50,50
1650145890372,CSE 15L,A02,083655,Staff,9,0,50,41
1650145896411,CSE 20,A01,083657,Staff,55,0,80,25
1650145902434,CSE 30,A01,083084,Eldon; John,0,64,40,40
1650145908458,CSE 100,A01,083659,Cao; Yingjun,0,61,50,50
1650145914485,CSE 134B,A01,083661,Powell; Thomas Allan,0,27,65,65
1650145920508,CSE 140,A01,083663,Staff,4,0,75,71
1650145926534,CSE 140L,A01,083088,Eldon; John,0,1,75,75
1650145932561,CSE 175,A01,083665,Kumar; Rakesh,8,0,25,17
1650145938595,CSE 190,A00,092507,Dubnov; Shlomo,14,0,20,6
1650145944622,ECE 45,A01,083139,Staff,0,13,40,40
1650145950650,ECE 65,A50,083695,Staff,0,4,30,30
1650145956674,ECE 109,A01,091882,Touri; Behrouz,48,0,70,22
1650145962700,ECE 180,A00,083140,Abi Samra; Nicholas Camill,24,0,30,6
1650145962700,ECE 180,B00,083141,Abi Samra; Nicholas Camill,8,0,30,22
1650145968728,MATH 10A,A01,083735,Patchell; Gregory David,12,0,30,18
1650145968728,MATH 10A,A02,083736,Patchell; Gregory David,28,0,30,2
1650145968728,MATH 10A,A03,083737,Patchell; Gregory David,26,0,30,4
1650145974756,MATH 10B,A01,083207,Staff,0,5,30,30
1650145974756,MATH 10B,A02,083208,Staff,0,4,30,30
1650145974756,MATH 10B,B01,083739,Staff,18,0,30,12
1650145974756,MATH 10B,B02,083740,Staff,29,0,30,1
1650145980781,MATH 18,A01,083743,Staff,10,0,30,20
1650145980781,MATH 18,A02,083744,Staff,28,0,30,2
1650145980781,MATH 18,A03,083745,Staff,23,0,30,7
1650145980781,MATH 18,A04,083746,Staff,27,0,30,3
1650145980781,MATH 18,B01,083748,Staff,0,10,30,30
1650145980781,MATH 18,B02,083749,Staff,0,7,30,30
1650145980781,MATH 18,B03,083750,Staff,0,6,30,30
1650145980781,MATH 18,B04,083751,Staff,0,7,30,30
1650145986819,MATH 20A,A01,083754,Staff,26,0,40,14
1650145992842,MATH 20B,A01,083756,Staff,0,5,30,30
1650145992842,MATH 20B,A02,083757,Staff,0,4,30,30
1650145998865,MATH 20C,A01,083760,Staff,0,11,30,30
1650145998865,MATH 20C,A02,083761,Staff,0,12,30,30
1650145998865,MATH 20C,B01,083762,Staff,14,0,30,16
1650145998865,MATH 20C,B02,083763,Staff,28,0,30,2
1650146004897,MATH 20D,A01,083765,Staff,0,2,30,30
1650146004897,MATH 20D,A02,083766,Staff,10,0,30,20
1650146004897,MATH 20D,A03,083767,Staff,28,0,30,2
1650146010921,MATH 20E,A01,083771,Staff,8,0,30,22
1650146010921,MATH 20E,A02,083772,Staff,20,0,30,10
1650146010921,MATH 20E,B01,083773,Staff,0,0,30,30
1650146010921,MATH 20E,B02,083774,Staff,13,0,30,17
1650146016949,MATH 103A,A01,083777,Staff,0,8,30,30
1650146016949,MATH 103A,A02,083778,Staff,0,8,30,30
1650146016949,MATH 103A,B01,083779,Staff,0,9,30,30
1650146016949,MATH 103A,B02,083780,Staff,0,6,30,30
1650146022972,MATH 105,A01,085443,Staff,0,13,30,30
1650146028996,MATH 109,A01,083213,Anzaldo; Leesa B,0,3,30,30
1650146028996,MATH 109,A02,083214,Anzaldo; Leesa B,0,6,30,30
1650146028996,MATH 109,B01,083215,Anzaldo; Leesa B,0,4,30,30
1650146028996,MATH 109,B02,083216,Anzaldo; Leesa B,0,4,30,30
1650146035024,MATH 142A,A01,083219,Chow; Bennett,0,11,30,30
1650146035024,MATH 142A,A02,083220,Chow; Bennett,0,11,30,30
1650146035024,MATH 142A,B01,083221,Chow; Bennett,0,10,30,30
1650146035024,MATH 142A,B02,083222,Chow; Bennett,0,11,30,30
1650146041049,MATH 193A,A01,083224,Staff,0,3,30,30
1650146041049,MATH 193A,A02,083225,Staff,0,4,30,30
1650146041049,MATH 193A,A03,083781,Staff,0,0,30,30
1650146041049,MATH 193A,A04,083782,Staff,0,0,30,30
1650146047077,MATH 197,001,091859,McAuley; Julian John,9998,0,9999,1
1650146053128,COGS 9,A01,083615,Staff,0,14,60,60
1650146059152,COGS 11,A01,083617,Boyle; Mary E. T.,24,0,40,16
1650146065176,COGS 13,A01,083071,Staff,0,29,40,40
1650146071203,COGS 14A,A01,092681,Staff,0,10,100,100
1650146077233,COGS 14B,A01,083073,Cheng; Tzu-Han,0,4,50,50
1650146083257,COGS 17,A01,092677,Staff,34,0,75,41
1650146089283,COGS 100,A01,083619,Staff,0,21,60,60
1650146095307,COGS 101A,A01,083621,Davis; Joshua Daniel,0,19,60,60
1650146101334,COGS 101B,A01,091572,Staff,9,0,60,51
1650146107361,COGS 101C,A01,083625,Delgado; Tania,21,0,30,9
1650146113383,COGS 107A,A01,083627,Boyle; Mary E. T.,0,5,60,60
1650146119409,COGS 118A,A01,083075,Staff,17,0,60,43
1650146125437,CSE 3,A50,083646,Miranda; Gregory Joseph,22,0,38,16
1650146125437,CSE 3,A51,083647,Miranda; Gregory Joseph,37,0,37,0
1650146131460,CSE 8A,A50,083650,Miranda; Gregory Joseph,0,16,40,40
1650146137485,CSE 11,A01,083080,Cao; Yingjun,0,66,40,40
1650146143508,CSE 12,A01,083652,Staff,0,4,100,100
1650146149532,CSE 15L,A01,083654,Staff,0,0,50,50
1650146149532,CSE 15L,A02,083655,Staff,9,0,50,41
1650146155560,CSE 20,A01,083657,Staff,55,0,80,25
1650146161586,CSE 30,A01,083084,Eldon; John,0,64,40,40
1650146167610,CSE 100,A01,083659,Cao; Yingjun,0,61,50,50
1650146173633,CSE 134B,A01,083661,Powell; Thomas Allan,0,27,65,65
1650146179657,CSE 140,A01,083663,Staff,4,0,75,71
1650146185684,CSE 140L,A01,083088,Eldon; John,0,1,75,75
1650146191715,CSE 175,A01,083665,Kumar; Rakesh,8,0,25,17
1650146197738,CSE 190,A00,092507,Dubnov; Shlomo,14,0,20,6
1650146203765,ECE 45,A01,083139,Staff,0,13,40,40
1650146209788,ECE 65,A50,083695,Staff,0,4,30,30
1650146215811,ECE 109,A01,091882,Touri; Behrouz,48,0,70,22
1650146221836,ECE 180,A00,083140,Abi Samra; Nicholas Camill,24,0,30,6
1650146221836,ECE 180,B00,083141,Abi Samra; Nicholas Camill,8,0,30,22
1650146227871,MATH 10A,A01,083735,Patchell; Gregory David,12,0,30,18
1650146227871,MATH 10A,A02,083736,Patchell; Gregory David,28,0,30,2
1650146227871,MATH 10A,A03,083737,Patchell; Gregory David,26,0,30,4
1650146233894,MATH 10B,A01,083207,Staff,0,5,30,30
1650146233894,MATH 10B,A02,083208,Staff,0,4,30,30
1650146233894,MATH 10B,B01,083739,Staff,18,0,30,12
1650146233894,MATH 10B,B02,083740,Staff,29,0,30,1
1650146239921,MATH 18,A01,083743,Staff,10,0,30,20
1650146239921,MATH 18,A02,083744,Staff,28,0,30,2
1650146239921,MATH 18,A03,083745,Staff,23,0,30,7
1650146239921,MATH 18,A04,083746,Staff,27,0,30,3
1650146239921,MATH 18,B01,083748,Staff,0,10,30,30
1650146239921,MATH 18,B02,083749,Staff,0,7,30,30
1650146239921,MATH 18,B03,083750,Staff,0,6,30,30
1650146239921,MATH 18,B04,083751,Staff,0,7,30,30
1650146245947,MATH 20A,A01,083754,Staff,26,0,40,14
1650146251978,MATH 20B,A01,083756,Staff,0,5,30,30
1650146251978,MATH 20B,A02,083757,Staff,0,4,30,30
1650146258012,MATH 20C,A01,083760,Staff,0,11,30,30
1650146258012,MATH 20C,A02,083761,Staff,0,12,30,30
1650146258012,MATH 20C,B01,083762,Staff,14,0,30,16
1650146258012,MATH 20C,B02,083763,Staff,28,0,30,2
1650146264038,MATH 20D,A01,083765,Staff,0,2,30,30
1650146264038,MATH 20D,A02,083766,Staff,10,0,30,20
1650146264038,MATH 20D,A03,083767,Staff,28,0,30,2
1650146270062,MATH 20E,A01,083771,Staff,8,0,30,22
1650146270062,MATH 20E,A02,083772,Staff,20,0,30,10
1650146270062,MATH 20E,B01,083773,Staff,0,0,30,30
1650146270062,MATH 20E,B02,083774,Staff,13,0,30,17
1650146276086,MATH 103A,A01,083777,Staff,0,8,30,30
1650146276086,MATH 103A,A02,083778,Staff,0,8,30,30
1650146276086,MATH 103A,B01,083779,Staff,0,9,30,30
1650146276086,MATH 103A,B02,083780,Staff,0,6,30,30
1650146282113,MATH 105,A01,085443,Staff,0,13,30,30
1650146288136,MATH 109,A01,083213,Anzaldo; Leesa B,0,3,30,30
1650146288136,MATH 109,A02,083214,Anzaldo; Leesa B,0,6,30,30
1650146288136,MATH 109,B01,083215,Anzaldo; Leesa B,0,4,30,30
1650146288136,MATH 109,B02,083216,Anzaldo; Leesa B,0,4,30,30
1650146294160,MATH 142A,A01,083219,Chow; Bennett,0,11,30,30
1650146294160,MATH 142A,A02,083220,Chow; Bennett,0,11,30,30
1650146294160,MATH 142A,B01,083221,Chow; Bennett,0,10,30,30
1650146294160,MATH 142A,B02,083222,Chow; Bennett,0,11,30,30
1650146300187,MATH 193A,A01,083224,Staff,0,3,30,30
1650146300187,MATH 193A,A02,083225,Staff,0,4,30,30
1650146300187,MATH 193A,A03,083781,Staff,0,0,30,30
1650146300187,MATH 193A,A04,083782,Staff,0,0,30,30
1650146306224,MATH 197,001,091859,McAuley; Julian John,9998,0,9999,1
1650146312275,COGS 9,A01,083615,Staff,0,14,60,60
1650146318298,COGS 11,A01,083617,Boyle; Mary E. T.,24,0,40,16
1650146324324,COGS 13,A01,083071,Staff,0,29,40,40
1650146330350,COGS 14A,A01,092681,Staff,0,10,100,100
1650146336374,COGS 14B,A01,083073,Cheng; Tzu-Han,0,4,50,50
1650146342398,COGS 17,A01,092677,Staff,34,0,75,41
1650146348426,COGS 100,A01,083619,Staff,0,21,60,60
1650146354448,COGS 101A,A01,083621,Davis; Joshua Daniel,0,19,60,60
1650146360473,COGS 101B,A01,091572,Staff,9,0,60,51
1650146366496,COGS 101C,A01,083625,Delgado; Tania,21,0,30,9
1650146372520,COGS 107A,A01,083627,Boyle; Mary E. T.,0,5,60,60
1650146378546,COGS 118A,A01,083075,Staff,17,0,60,43
1650146384573,CSE 3,A50,083646,Miranda; Gregory Joseph,22,0,38,16
1650146384573,CSE 3,A51,083647,Miranda; Gregory Joseph,37,0,37,0
1650146390610,CSE 8A,A50,083650,Miranda; Gregory Joseph,0,16,40,40
1650146396635,CSE 11,A01,083080,Cao; Yingjun,0,66,40,40
1650146402664,CSE 12,A01,083652,Staff,0,4,100,100
1650146408687,CSE 15L,A01,083654,Staff,0,0,50,50
1650146408687,CSE 15L,A02,083655,Staff,9,0,50,41
1650146414715,CSE 20,A01,083657,Staff,55,0,80,25
1650146420740,CSE 30,A01,083084,Eldon; John,0,64,40,40
1650146426767,CSE 100,A01,083659,Cao; Yingjun,0,61,50,50
1650146432800,CSE 134B,A01,083661,Powell; Thomas Allan,0,27,65,65
1650146438824,CSE 140,A01,083663,Staff,3,0,75,72
1650146444848,CSE 140L,A01,083088,Eldon; John,0,2,75,75
1650146450945,CSE 175,A01,083665,Kumar; Rakesh,8,0,25,17
1650146456969,CSE 190,A00,092507,Dubnov; Shlomo,14,0,20,6
1650146462997,ECE 45,A01,083139,Staff,0,13,40,40
1650146469020,ECE 65,A50,083695,Staff,0,4,30,30
1650146475043,ECE 109,A01,091882,Touri; Behrouz,48,0,70,22
1650146481066,ECE 180,A00,083140,Abi Samra; Nicholas Camill,24,0,30,6
1650146481066,ECE 180,B00,083141,Abi Samra; Nicholas Camill,8,0,30,22
1650146487094,MATH 10A,A01,083735,Patchell; Gregory David,12,0,30,18
1650146487094,MATH 10A,A02,083736,Patchell; Gregory David,28,0,30,2
1650146487094,MATH 10A,A03,083737,Patchell; Gregory David,26,0,30,4
1650146493119,MATH 10B,A01,083207,Staff,0,5,30,30
1650146493119,MATH 10B,A02,083208,Staff,0,4,30,30
1650146493119,MATH 10B,B01,083739,Staff,18,0,30,12
1650146493119,MATH 10B,B02,083740,Staff,29,0,30,1
1650146499142,MATH 18,A01,083743,Staff,10,0,30,20
1650146499142,MATH 18,A02,083744,Staff,28,0,30,2
1650146499142,MATH 18,A03,083745,Staff,23,0,30,7
1650146499142,MATH 18,A04,083746,Staff,27,0,30,3
1650146499142,MATH 18,B01,083748,Staff,0,10,30,30
1650146499142,MATH 18,B02,083749,Staff,0,7,30,30
1650146499142,MATH 18,B03,083750,Staff,0,6,30,30
1650146499142,MATH 18,B04,083751,Staff,0,7,30,30
1650146505169,MATH 20A,A01,083754,Staff,26,0,40,14
1650146511194,MATH 20B,A01,083756,Staff,0,5,30,30
1650146511194,MATH 20B,A02,083757,Staff,0,4,30,30
1650146517217,MATH 20C,A01,083760,Staff,0,11,30,30
1650146517217,MATH 20C,A02,083761,Staff,0,12,30,30
1650146517217,MATH 20C,B01,083762,Staff,14,0,30,16
1650146517217,MATH 20C,B02,083763,Staff,28,0,30,2
1650146523242,MATH 20D,A01,083765,Staff,0,2,30,30
1650146523242,MATH 20D,A02,083766,Staff,10,0,30,20
1650146523242,MATH 20D,A03,083767,Staff,28,0,30,2
1650146529265,MATH 20E,A01,083771,Staff,8,0,30,22
1650146529265,MATH 20E,A02,083772,Staff,20,0,30,10
1650146529265,MATH 20E,B01,083773,Staff,0,0,30,30
1650146529265,MATH 20E,B02,083774,Staff,13,0,30,17
1650146535295,MATH 103A,A01,083777,Staff,0,8,30,30
1650146535295,MATH 103A,A02,083778,Staff,0,8,30,30
1650146535295,MATH 103A,B01,083779,Staff,0,9,30,30
1650146535295,MATH 103A,B02,083780,Staff,0,6,30,30
1650146541317,MATH 105,A01,085443,Staff,0,13,30,30
1650146547342,MATH 109,A01,083213,Anzaldo; Leesa B,0,3,30,30
1650146547342,MATH 109,A02,083214,Anzaldo; Leesa B,0,6,30,30
1650146547342,MATH 109,B01,083215,Anzaldo; Leesa B,0,4,30,30
1650146547342,MATH 109,B02,083216,Anzaldo; Leesa B,0,4,30,30
1650146553365,MATH 142A,A01,083219,Chow; Bennett,0,11,30,30
1650146553365,MATH 142A,A02,083220,Chow; Bennett,0,11,30,30
1650146553365,MATH 142A,B01,083221,Chow; Bennett,0,10,30,30
1650146553365,MATH 142A,B02,083222,Chow; Bennett,0,11,30,30
1650146559389,MATH 193A,A01,083224,Staff,0,3,30,30
1650146559389,MATH 193A,A02,083225,Staff,0,4,30,30
1650146559389,MATH 193A,A03,083781,Staff,0,0,30,30
1650146559389,MATH 193A,A04,083782,Staff,0,0,30,30
1650146565415,MATH 197,001,091859,McAuley; Julian John,9998,0,9999,1
1650146571469,COGS 9,A01,083615,Staff,0,14,60,60
1650146577496,COGS 11,A01,083617,Boyle; Mary E. T.,24,0,40,16
1650146583534,COGS 13,A01,083071,Staff,0,29,40,40
1650146589561,COGS 14A,A01,092681,Staff,0,10,100,100
1650146595589,COGS 14B,A01,083073,Cheng; Tzu-Han,0,4,50,50
1650146601613,COGS 17,A01,092677,Staff,34,0,75,41
1650146607638,COGS 100,A01,083619,Staff,0,21,60,60
1650146613662,COGS 101A,A01,083621,Davis; Joshua Daniel,0,19,60,60
1650146619688,COGS 101B,A01,091572,Staff,9,0,60,51
1650146625712,COGS 101C,A01,083625,Delgado; Tania,21,0,30,9
1650146631736,COGS 107A,A01,083627,Boyle; Mary E. T.,0,5,60,60
1650146637763,COGS 118A,A01,083075,Staff,17,0,60,43
1650146643800,CSE 3,A50,083646,Miranda; Gregory Joseph,22,0,38,16
1650146643800,CSE 3,A51,083647,Miranda; Gregory Joseph,37,0,37,0
1650146649825,CSE 8A,A50,083650,Miranda; Gregory Joseph,0,16,40,40
1650146655848,CSE 11,A01,083080,Cao; Yingjun,0,66,40,40
1650146661872,CSE 12,A01,083652,Staff,0,4,100,100
1650146667898,CSE 15L,A01,083654,Staff,0,0,50,50
1650146667898,CSE 15L,A02,083655,Staff,9,0,50,41
1650146673926,CSE 20,A01,083657,Staff,55,0,80,25
1650146679951,CSE 30,A01,083084,Eldon; John,0,64,40,40
1650146685976,CSE 100,A01,083659,Cao; Yingjun,0,61,50,50
1650146692004,CSE 134B,A01,083661,Powell; Thomas Allan,0,27,65,65
1650146698027,CSE 140,A01,083663,Staff,3,0,75,72
1650146704052,CSE 140L,A01,083088,Eldon; John,0,2,75,75
1650146710080,CSE 175,A01,083665,Kumar; Rakesh,8,0,25,17
1650146716103,CSE 190,A00,092507,Dubnov; Shlomo,14,0,20,6
1650146722130,ECE 45,A01,083139,Staff,0,13,40,40
1650146728157,ECE 65,A50,083695,Staff,0,4,30,30
1650146734181,ECE 109,A01,091882,Touri; Behrouz,48,0,70,22
1650146740204,ECE 180,A00,083140,Abi Samra; Nicholas Camill,24,0,30,6
1650146740204,ECE 180,B00,083141,Abi Samra; Nicholas Camill,8,0,30,22
1650146746229,MATH 10A,A01,083735,Patchell; Gregory David,12,0,30,18
1650146746229,MATH 10A,A02,083736,Patchell; Gregory David,28,0,30,2
1650146746229,MATH 10A,A03,083737,Patchell; Gregory David,26,0,30,4
1650146752253,MATH 10B,A01,083207,Staff,0,5,30,30
1650146752253,MATH 10B,A02,083208,Staff,0,4,30,30
1650146752253,MATH 10B,B01,083739,Staff,18,0,30,12
1650146752253,MATH 10B,B02,083740,Staff,29,0,30,1
1650146758276,MATH 18,A01,083743,Staff,10,0,30,20
1650146758276,MATH 18,A02,083744,Staff,28,0,30,2
1650146758276,MATH 18,A03,083745,Staff,23,0,30,7
1650146758276,MATH 18,A04,083746,Staff,27,0,30,3
1650146758276,MATH 18,B01,083748,Staff,0,10,30,30
1650146758276,MATH 18,B02,083749,Staff,0,7,30,30
1650146758276,MATH 18,B03,083750,Staff,0,6,30,30
1650146758276,MATH 18,B04,083751,Staff,0,7,30,30
1650146764306,MATH 20A,A01,083754,Staff,26,0,40,14
1650146770329,MATH 20B,A01,083756,Staff,0,5,30,30
1650146770329,MATH 20B,A02,083757,Staff,0,4,30,30
1650146776353,MATH 20C,A01,083760,Staff,0,11,30,30
1650146776353,MATH 20C,A02,083761,Staff,0,12,30,30
1650146776353,MATH 20C,B01,083762,Staff,14,0,30,16
1650146776353,MATH 20C,B02,083763,Staff,28,0,30,2
1650146782385,MATH 20D,A01,083765,Staff,0,2,30,30
1650146782385,MATH 20D,A02,083766,Staff,10,0,30,20
1650146782385,MATH 20D,A03,083767,Staff,28,0,30,2
1650146788409,MATH 20E,A01,083771,Staff,8,0,30,22
1650146788409,MATH 20E,A02,083772,Staff,20,0,30,10
1650146788409,MATH 20E,B01,083773,Staff,0,0,30,30
1650146788409,MATH 20E,B02,083774,Staff,13,0,30,17
1650146794441,MATH 103A,A01,083777,Staff,0,8,30,30
1650146794441,MATH 103A,A02,083778,Staff,0,8,30,30
1650146794441,MATH 103A,B01,083779,Staff,0,9,30,30
1650146794441,MATH 103A,B02,083780,Staff,0,6,30,30
1650146800464,MATH 105,A01,085443,Staff,0,13,30,30
1650146806492,MATH 109,A01,083213,Anzaldo; Leesa B,0,3,30,30
1650146806492,MATH 109,A02,083214,Anzaldo; Leesa B,0,6,30,30
1650146806492,MATH 109,B01,083215,Anzaldo; Leesa B,0,4,30,30
1650146806492,MATH 109,B02,083216,Anzaldo; Leesa B,0,4,30,30
1650146812517,MATH 142A,A01,083219,Chow; Bennett,0,11,30,30
1650146812517,MATH 142A,A02,083220,Chow; Bennett,0,11,30,30
1650146812517,MATH 142A,B01,083221,Chow; Bennett,0,10,30,30
1650146812517,MATH 142A,B02,083222,Chow; Bennett,0,11,30,30
1650146818541,MATH 193A,A01,083224,Staff,0,3,30,30
1650146818541,MATH 193A,A02,083225,Staff,0,4,30,30
1650146818541,MATH 193A,A03,083781,Staff,0,0,30,30
1650146818541,MATH 193A,A04,083782,Staff,0,0,30,30
1650146824565,MATH 197,001,091859,McAuley; Julian John,9998,0,9999,1
1650146830638,COGS 9,A01,083615,Staff,0,14,60,60
1650146836660,COGS 11,A01,083617,Boyle; Mary E. T.,24,0,40,16
1650146842683,COGS 13,A01,083071,Staff,0,29,40,40
1650146848716,COGS 14A,A01,092681,Staff,0,10,100,100
1650146854740,COGS 14B,A01,083073,Cheng; Tzu-Han,0,4,50,50
1650146860764,COGS 17,A01,092677,Staff,34,0,75,41
1650146866791,COGS 100,A01,083619,Staff,0,21,60,60
1650146872818,COGS 101A,A01,083621,Davis; Joshua Daniel,0,19,60,60
1650146878844,COGS 101B,A01,091572,Staff,9,0,60,51
1650146884869,COGS 101C,A01,083625,Delgado; Tania,21,0,30,9
1650146890896,COGS 107A,A01,083627,Boyle; Mary E. T.,0,5,60,60
1650146896920,COGS 118A,A01,083075,Staff,17,0,60,43
1650146902944,CSE 3,A50,083646,Miranda; Gregory Joseph,22,0,38,16
1650146902944,CSE 3,A51,083647,Miranda; Gregory Joseph,37,0,37,0
1650146908972,CSE 8A,A50,083650,Miranda; Gregory Joseph,0,16,40,40
1650146915007,CSE 11,A01,083080,Cao; Yingjun,0,66,40,40
1650146921032,CSE 12,A01,083652,Staff,0,4,100,100
1650146927056,CSE 15L,A01,083654,Staff,0,0,50,50
1650146927056,CSE 15L,A02,083655,Staff,9,0,50,41
1650146933079,CSE 20,A01,083657,Staff,55,0,80,25
1650146939102,CSE 30,A01,083084,Eldon; John,0,64,40,40
1650146945125,CSE 100,A01,083659,Cao; Yingjun,0,61,50,50
1650146951156,CSE 134B,A01,083661,Powell; Thomas Allan,0,27,65,65
1650146957182,CSE 140,A01,083663,Staff,3,0,75,72
1650146963212,CSE 140L,A01,083088,Eldon; John,0,2,75,75
1650146969236,CSE 175,A01,083665,Kumar; Rakesh,8,0,25,17
1650146975266,CSE 190,A00,092507,Dubnov; Shlomo,14,0,20,6
1650146981287,ECE 45,A01,083139,Staff,0,13,40,40
1650146987325,ECE 65,A50,083695,Staff,0,4,30,30
1650146993348,ECE 109,A01,091882,Touri; Behrouz,48,0,70,22
1650146999377,ECE 180,A00,083140,Abi Samra; Nicholas Camill,24,0,30,6
1650146999377,ECE 180,B00,083141,Abi Samra; Nicholas Camill,8,0,30,22
1650147005404,MATH 10A,A01,083735,Patchell; Gregory David,12,0,30,18
1650147005404,MATH 10A,A02,083736,Patchell; Gregory David,28,0,30,2
1650147005404,MATH 10A,A03,083737,Patchell; Gregory David,26,0,30,4
1650147011427,MATH 10B,A01,083207,Staff,0,5,30,30
1650147011427,MATH 10B,A02,083208,Staff,0,4,30,30
1650147011427,MATH 10B,B01,083739,Staff,18,0,30,12
1650147011427,MATH 10B,B02,083740,Staff,29,0,30,1
1650147017456,MATH 18,A01,083743,Staff,10,0,30,20
1650147017456,MATH 18,A02,083744,Staff,28,0,30,2
1650147017456,MATH 18,A03,083745,Staff,23,0,30,7
1650147017456,MATH 18,A04,083746,Staff,27,0,30,3
1650147017456,MATH 18,B01,083748,Staff,0,10,30,30
1650147017456,MATH 18,B02,083749,Staff,0,7,30,30
1650147017456,MATH 18,B03,083750,Staff,0,6,30,30
1650147017456,MATH 18,B04,083751,Staff,0,7,30,30
1650147023480,MATH 20A,A01,083754,Staff,26,0,40,14
1650147029505,MATH 20B,A01,083756,Staff,0,5,30,30
1650147029505,MATH 20B,A02,083757,Staff,0,4,30,30
1650147035532,MATH 20C,A01,083760,Staff,0,11,30,30
1650147035532,MATH 20C,A02,083761,Staff,0,12,30,30
1650147035532,MATH 20C,B01,083762,Staff,14,0,30,16
1650147035532,MATH 20C,B02,083763,Staff,28,0,30,2
1650147041556,MATH 20D,A01,083765,Staff,0,2,30,30
1650147041556,MATH 20D,A02,083766,Staff,10,0,30,20
1650147041556,MATH 20D,A03,083767,Staff,28,0,30,2
1650147047657,MATH 20E,A01,083771,Staff,8,0,30,22
1650147047657,MATH 20E,A02,083772,Staff,20,0,30,10
1650147047657,MATH 20E,B01,083773,Staff,0,0,30,30
1650147047657,MATH 20E,B02,083774,Staff,13,0,30,17
1650147053685,MATH 103A,A01,083777,Staff,0,8,30,30
1650147053685,MATH 103A,A02,083778,Staff,0,8,30,30
1650147053685,MATH 103A,B01,083779,Staff,0,9,30,30
1650147053685,MATH 103A,B02,083780,Staff,0,6,30,30
1650147059717,MATH 105,A01,085443,Staff,0,13,30,30
1650147065741,MATH 109,A01,083213,Anzaldo; Leesa B,0,3,30,30
1650147065741,MATH 109,A02,083214,Anzaldo; Leesa B,0,6,30,30
1650147065741,MATH 109,B01,083215,Anzaldo; Leesa B,0,4,30,30
1650147065741,MATH 109,B02,083216,Anzaldo; Leesa B,0,4,30,30
1650147071773,MATH 142A,A01,083219,Chow; Bennett,0,11,30,30
1650147071773,MATH 142A,A02,083220,Chow; Bennett,0,11,30,30
1650147071773,MATH 142A,B01,083221,Chow; Bennett,0,10,30,30
1650147071773,MATH 142A,B02,083222,Chow; Bennett,0,11,30,30
1650147077797,MATH 193A,A01,083224,Staff,0,3,30,30
1650147077797,MATH 193A,A02,083225,Staff,0,4,30,30
1650147077797,MATH 193A,A03,083781,Staff,0,0,30,30
1650147077797,MATH 193A,A04,083782,Staff,0,0,30,30
1650147083822,MATH 197,001,091859,McAuley; Julian John,9998,0,9999,1
1650147089881,COGS 9,A01,083615,Staff,0,14,60,60
1650147095904,COGS 11,A01,083617,Boyle; Mary E. T.,24,0,40,16
1650147101932,COGS 13,A01,083071,Staff,0,29,40,40
1650147107956,COGS 14A,A01,092681,Staff,0,10,100,100
1650147113980,COGS 14B,A01,083073,Cheng; Tzu-Han,0,4,50,50
1650147120020,COGS 17,A01,092677,Staff,34,0,75,41
1650147126044,COGS 100,A01,083619,Staff,0,21,60,60
1650147132075,COGS 101A,A01,083621,Davis; Joshua Daniel,0,20,60,60
1650147138098,COGS 101B,A01,091572,Staff,9,0,60,51
1650147144124,COGS 101C,A01,083625,Delgado; Tania,21,0,30,9
1650147150152,COGS 107A,A01,083627,Boyle; Mary E. T.,0,6,60,60
1650147156176,COGS 118A,A01,083075,Staff,17,0,60,43
1650147162201,CSE 3,A50,083646,Miranda; Gregory Joseph,22,0,38,16
1650147162201,CSE 3,A51,083647,Miranda; Gregory Joseph,37,0,37,0
1650147168224,CSE 8A,A50,083650,Miranda; Gregory Joseph,0,16,40,40
1650147174253,CSE 11,A01,083080,Cao; Yingjun,0,66,40,40
1650147180275,CSE 12,A01,083652,Staff,0,4,100,100
1650147186302,CSE 15L,A01,083654,Staff,0,0,50,50
1650147186302,CSE 15L,A02,083655,Staff,9,0,50,41
1650147192324,CSE 20,A01,083657,Staff,55,0,80,25
1650147198351,CSE 30,A01,083084,Eldon; John,0,64,40,40
1650147204383,CSE 100,A01,083659,Cao; Yingjun,0,61,50,50
1650147210417,CSE 134B,A01,083661,Powell; Thomas Allan,0,27,65,65
1650147216441,CSE 140,A01,083663,Staff,3,0,75,72
1650147222466,CSE 140L,A01,083088,Eldon; John,0,2,75,75
1650147228489,CSE 175,A01,083665,Kumar; Rakesh,8,0,25,17
1650147234513,CSE 190,A00,092507,Dubnov; Shlomo,14,0,20,6
1650147240538,ECE 45,A01,083139,Staff,0,13,40,40
1650147246562,ECE 65,A50,083695,Staff,0,4,30,30
1650147252584,ECE 109,A01,091882,Touri; Behrouz,48,0,70,22
1650147258609,ECE 180,A00,083140,Abi Samra; Nicholas Camill,24,0,30,6
1650147258609,ECE 180,B00,083141,Abi Samra; Nicholas Camill,8,0,30,22
1650147264634,MATH 10A,A01,083735,Patchell; Gregory David,12,0,30,18
1650147264634,MATH 10A,A02,083736,Patchell; Gregory David,28,0,30,2
1650147264634,MATH 10A,A03,083737,Patchell; Gregory David,26,0,30,4
1650147270657,MATH 10B,A01,083207,Staff,0,5,30,30
1650147270657,MATH 10B,A02,083208,Staff,0,4,30,30
1650147270657,MATH 10B,B01,083739,Staff,18,0,30,12
1650147270657,MATH 10B,B02,083740,Staff,29,0,30,1
1650147276687,MATH 18,A01,083743,Staff,10,0,30,20
1650147276687,MATH 18,A02,083744,Staff,28,0,30,2
1650147276687,MATH 18,A03,083745,Staff,23,0,30,7
1650147276687,MATH 18,A04,083746,Staff,27,0,30,3
1650147276687,MATH 18,B01,083748,Staff,0,10,30,30
1650147276687,MATH 18,B02,083749,Staff,0,7,30,30
1650147276687,MATH 18,B03,083750,Staff,0,6,30,30
1650147276687,MATH 18,B04,083751,Staff,0,7,30,30
1650147282710,MATH 20A,A01,083754,Staff,26,0,40,14
1650147288733,MATH 20B,A01,083756,Staff,0,5,30,30
1650147288733,MATH 20B,A02,083757,Staff,0,4,30,30
1650147294757,MATH 20C,A01,083760,Staff,0,11,30,30
1650147294757,MATH 20C,A02,083761,Staff,0,12,30,30
1650147294757,MATH 20C,B01,083762,Staff,14,0,30,16
1650147294757,MATH 20C,B02,083763,Staff,28,0,30,2
1650147300781,MATH 20D,A01,083765,Staff,0,2,30,30
1650147300781,MATH 20D,A02,083766,Staff,10,0,30,20
1650147300781,MATH 20D,A03,083767,Staff,28,0,30,2
1650147306802,MATH 20E,A01,083771,Staff,8,0,30,22
1650147306802,MATH 20E,A02,083772,Staff,20,0,30,10
1650147306802,MATH 20E,B01,083773,Staff,0,0,30,30
1650147306802,MATH 20E,B02,083774,Staff,13,0,30,17
1650147312830,MATH 103A,A01,083777,Staff,0,8,30,30
1650147312830,MATH 103A,A02,083778,Staff,0,8,30,30
1650147312830,MATH 103A,B01,083779,Staff,0,9,30,30
1650147312830,MATH 103A,B02,083780,Staff,0,6,30,30
1650147318854,MATH 105,A01,085443,Staff,0,13,30,30
1650147324885,MATH 109,A01,083213,Anzaldo; Leesa B,0,3,30,30
1650147324885,MATH 109,A02,083214,Anzaldo; Leesa B,0,6,30,30
1650147324885,MATH 109,B01,083215,Anzaldo; Leesa B,0,4,30,30
1650147324885,MATH 109,B02,083216,Anzaldo; Leesa B,0,4,30,30
1650147330918,MATH 142A,A01,083219,Chow; Bennett,0,11,30,30
1650147330918,MATH 142A,A02,083220,Chow; Bennett,0,11,30,30
1650147330918,MATH 142A,B01,083221,Chow; Bennett,0,10,30,30
1650147330918,MATH 142A,B02,083222,Chow; Bennett,0,11,30,30
1650147336941,MATH 193A,A01,083224,Staff,0,3,30,30
1650147336941,MATH 193A,A02,083225,Staff,0,4,30,30
1650147336941,MATH 193A,A03,083781,Staff,0,0,30,30
1650147336941,MATH 193A,A04,083782,Staff,0,0,30,30
1650147342965,MATH 197,001,091859,McAuley; Julian John,9998,0,9999,1
1650147349027,COGS 9,A01,083615,Staff,0,14,60,60
1650147355051,COGS 11,A01,083617,Boyle; Mary E. T.,24,0,40,16
1650147361074,COGS 13,A01,083071,Staff,0,29,40,40
1650147367097,COGS 14A,A01,092681,Staff,0,10,100,100
1650147373124,COGS 14B,A01,083073,Cheng; Tzu-Han,0,4,50,50
1650147379151,COGS 17,A01,092677,Staff,34,0,75,41
1650147385174,COGS 100,A01,083619,Staff,0,21,60,60
1650147391197,COGS 101A,A01,083621,Davis; Joshua Daniel,0,20,60,60
1650147397223,COGS 101B,A01,091572,Staff,9,0,60,51
1650147403251,COGS 101C,A01,083625,Delgado; Tania,21,0,30,9
1650147409280,COGS 107A,A01,083627,Boyle; Mary E. T.,0,6,60,60
1650147415309,COGS 118A,A01,083075,Staff,17,0,60,43
1650147421334,CSE 3,A50,083646,Miranda; Gregory Joseph,22,0,38,16
1650147421334,CSE 3,A51,083647,Miranda; Gregory Joseph,37,0,37,0
1650147427361,CSE 8A,A50,083650,Miranda; Gregory Joseph,0,16,40,40
1650147433389,CSE 11,A01,083080,Cao; Yingjun,0,66,40,40
1650147439413,CSE 12,A01,083652,Staff,0,4,100,100
1650147445437,CSE 15L,A01,083654,Staff,0,0,50,50
1650147445437,CSE 15L,A02,083655,Staff,9,0,50,41
1650147451468,CSE 20,A01,083657,Staff,55,0,80,25
1650147457490,CSE 30,A01,083084,Eldon; John,0,64,40,40
1650147463513,CSE 100,A01,083659,Cao; Yingjun,0,61,50,50
1650147469540,CSE 134B,A01,083661,Powell; Thomas Allan,0,27,65,65
1650147475565,CSE 140,A01,083663,Staff,3,0,75,72
1650147481589,CSE 140L,A01,083088,Eldon; John,0,2,75,75
1650147487616,CSE 175,A01,083665,Kumar; Rakesh,8,0,25,17
1650147493643,CSE 190,A00,092507,Dubnov; Shlomo,14,0,20,6
1650147499670,ECE 45,A01,083139,Staff,0,13,40,40
1650147505697,ECE 65,A50,083695,Staff,0,4,30,30
1650147511721,ECE 109,A01,091882,Touri; Behrouz,48,0,70,22
1650147517751,ECE 180,A00,083140,Abi Samra; Nicholas Camill,24,0,30,6
1650147517751,ECE 180,B00,083141,Abi Samra; Nicholas Camill,8,0,30,22
1650147523775,MATH 10A,A01,083735,Patchell; Gregory David,12,0,30,18
1650147523775,MATH 10A,A02,083736,Patchell; Gregory David,28,0,30,2
1650147523775,MATH 10A,A03,083737,Patchell; Gregory David,26,0,30,4
1650147529799,MATH 10B,A01,083207,Staff,0,5,30,30
1650147529799,MATH 10B,A02,083208,Staff,0,4,30,30
1650147529799,MATH 10B,B01,083739,Staff,18,0,30,12
1650147529799,MATH 10B,B02,083740,Staff,29,0,30,1
1650147535828,MATH 18,A01,083743,Staff,10,0,30,20
1650147535828,MATH 18,A02,083744,Staff,28,0,30,2
1650147535828,MATH 18,A03,083745,Staff,23,0,30,7
1650147535828,MATH 18,A04,083746,Staff,27,0,30,3
1650147535828,MATH 18,B01,083748,Staff,0,10,30,30
1650147535828,MATH 18,B02,083749,Staff,0,7,30,30
1650147535828,MATH 18,B03,083750,Staff,0,6,30,30
1650147535828,MATH 18,B04,083751,Staff,0,7,30,30
1650147541849,MATH 20A,A01,083754,Staff,26,0,40,14
1650147547873,MATH 20B,A01,083756,Staff,0,5,30,30
1650147547873,MATH 20B,A02,083757,Staff,0,4,30,30
1650147553896,MATH 20C,A01,083760,Staff,0,11,30,30
1650147553896,MATH 20C,A02,083761,Staff,0,12,30,30
1650147553896,MATH 20C,B01,083762,Staff,14,0,30,16
1650147553896,MATH 20C,B02,083763,Staff,28,0,30,2
1650147559925,MATH 20D,A01,083765,Staff,0,2,30,30
1650147559925,MATH 20D,A02,083766,Staff,10,0,30,20
1650147559925,MATH 20D,A03,083767,Staff,28,0,30,2
1650147565949,MATH 20E,A01,083771,Staff,8,0,30,22
1650147565949,MATH 20E,A02,083772,Staff,20,0,30,10
1650147565949,MATH 20E,B01,083773,Staff,0,0,30,30
1650147565949,MATH 20E,B02,083774,Staff,13,0,30,17
1650147571976,MATH 103A,A01,083777,Staff,0,8,30,30
1650147571976,MATH 103A,A02,083778,Staff,0,8,30,30
1650147571976,MATH 103A,B01,083779,Staff,0,9,30,30
1650147571976,MATH 103A,B02,083780,Staff,0,6,30,30
1650147578000,MATH 105,A01,085443,Staff,0,13,30,30
1650147584026,MATH 109,A01,083213,Anzaldo; Leesa B,0,3,30,30
1650147584026,MATH 109,A02,083214,Anzaldo; Leesa B,0,6,30,30
1650147584026,MATH 109,B01,083215,Anzaldo; Leesa B,0,4,30,30
1650147584026,MATH 109,B02,083216,Anzaldo; Leesa B,0,4,30,30
1650147590054,MATH 142A,A01,083219,Chow; Bennett,0,11,30,30
1650147590054,MATH 142A,A02,083220,Chow; Bennett,0,11,30,30
1650147590054,MATH 142A,B01,083221,Chow; Bennett,0,10,30,30
1650147590054,MATH 142A,B02,083222,Chow; Bennett,0,11,30,30
1650147596077,MATH 193A,A01,083224,Staff,0,3,30,30
1650147596077,MATH 193A,A02,083225,Staff,0,4,30,30
1650147596077,MATH 193A,A03,083781,Staff,0,0,30,30
1650147596077,MATH 193A,A04,083782,Staff,0,0,30,30
1650147602101,MATH 197,001,091859,McAuley; Julian John,9998,0,9999,1
1650147608150,COGS 9,A01,083615,Staff,0,14,60,60
1650147614177,COGS 11,A01,083617,Boyle; Mary E. T.,24,0,40,16
1650147620203,COGS 13,A01,083071,Staff,0,29,40,40
1650147626229,COGS 14A,A01,092681,Staff,0,10,100,100
1650147632250,COGS 14B,A01,083073,Cheng; Tzu-Han,0,4,50,50
1650147638346,COGS 17,A01,092677,Staff,34,0,75,41
1650147644370,COGS 100,A01,083619,Staff,0,21,60,60
1650147650394,COGS 101A,A01,083621,Davis; Joshua Daniel,0,20,60,60
1650147656418,COGS 101B,A01,091572,Staff,9,0,60,51
1650147662447,COGS 101C,A01,083625,Delgado; Tania,21,0,30,9
1650147668472,COGS 107A,A01,083627,Boyle; Mary E. T.,0,6,60,60
1650147674495,COGS 118A,A01,083075,Staff,17,0,60,43
1650147680519,CSE 3,A50,083646,Miranda; Gregory Joseph,22,0,38,16
1650147680519,CSE 3,A51,083647,Miranda; Gregory Joseph,37,0,37,0
1650147686548,CSE 8A,A50,083650,Miranda; Gregory Joseph,0,16,40,40
1650147692570,CSE 11,A01,083080,Cao; Yingjun,0,66,40,40
1650147698599,CSE 12,A01,083652,Staff,0,4,100,100
1650147704622,CSE 15L,A01,083654,Staff,0,0,50,50
1650147704622,CSE 15L,A02,083655,Staff,9,0,50,41
1650147710645,CSE 20,A01,083657,Staff,55,0,80,25
1650147716672,CSE 30,A01,083084,Eldon; John,0,64,40,40
1650147722701,CSE 100,A01,083659,Cao; Yingjun,0,61,50,50
1650147728728,CSE 134B,A01,083661,Powell; Thomas Allan,0,27,65,65
1650147734755,CSE 140,A01,083663,Staff,3,0,75,72
1650147740779,CSE 140L,A01,083088,Eldon; John,0,2,75,75
1650147746802,CSE 175,A01,083665,Kumar; Rakesh,8,0,25,17
1650147752825,CSE 190,A00,092507,Dubnov; Shlomo,14,0,20,6
1650147758848,ECE 45,A01,083139,Staff,0,13,40,40
1650147764872,ECE 65,A50,083695,Staff,0,4,30,30
1650147770896,ECE 109,A01,091882,Touri; Behrouz,48,0,70,22
1650147776920,ECE 180,A00,083140,Abi Samra; Nicholas Camill,24,0,30,6
1650147776920,ECE 180,B00,083141,Abi Samra; Nicholas Camill,8,0,30,22
1650147782945,MATH 10A,A01,083735,Patchell; Gregory David,12,0,30,18
1650147782945,MATH 10A,A02,083736,Patchell; Gregory David,28,0,30,2
1650147782945,MATH 10A,A03,083737,Patchell; Gregory David,26,0,30,4
1650147788970,MATH 10B,A01,083207,Staff,0,5,30,30
1650147788970,MATH 10B,A02,083208,Staff,0,4,30,30
1650147788970,MATH 10B,B01,083739,Staff,18,0,30,12
1650147788970,MATH 10B,B02,083740,Staff,29,0,30,1
1650147794995,MATH 18,A01,083743,Staff,10,0,30,20
1650147794995,MATH 18,A02,083744,Staff,28,0,30,2
1650147794995,MATH 18,A03,083745,Staff,23,0,30,7
1650147794995,MATH 18,A04,083746,Staff,27,0,30,3
1650147794995,MATH 18,B01,083748,Staff,0,10,30,30
1650147794995,MATH 18,B02,083749,Staff,0,7,30,30
1650147794995,MATH 18,B03,083750,Staff,0,6,30,30
1650147794995,MATH 18,B04,083751,Staff,0,7,30,30
1650147801031,MATH 20A,A01,083754,Staff,26,0,40,14
1650147807054,MATH 20B,A01,083756,Staff,0,5,30,30
1650147807054,MATH 20B,A02,083757,Staff,0,4,30,30
1650147813084,MATH 20C,A01,083760,Staff,0,11,30,30
1650147813084,MATH 20C,A02,083761,Staff,0,12,30,30
1650147813084,MATH 20C,B01,083762,Staff,14,0,30,16
1650147813084,MATH 20C,B02,083763,Staff,28,0,30,2
1650147819110,MATH 20D,A01,083765,Staff,0,2,30,30
1650147819110,MATH 20D,A02,083766,Staff,10,0,30,20
1650147819110,MATH 20D,A03,083767,Staff,28,0,30,2
1650147825133,MATH 20E,A01,083771,Staff,8,0,30,22
1650147825133,MATH 20E,A02,083772,Staff,20,0,30,10
1650147825133,MATH 20E,B01,083773,Staff,0,0,30,30
1650147825133,MATH 20E,B02,083774,Staff,13,0,30,17
1650147831162,MATH 103A,A01,083777,Staff,0,8,30,30
1650147831162,MATH 103A,A02,083778,Staff,0,8,30,30
1650147831162,MATH 103A,B01,083779,Staff,0,9,30,30
1650147831162,MATH 103A,B02,083780,Staff,0,6,30,30
1650147837186,MATH 105,A01,085443,Staff,0,13,30,30
1650147843210,MATH 109,A01,083213,Anzaldo; Leesa B,0,3,30,30
1650147843210,MATH 109,A02,083214,Anzaldo; Leesa B,0,6,30,30
1650147843210,MATH 109,B01,083215,Anzaldo; Leesa B,0,4,30,30
1650147843210,MATH 109,B02,083216,Anzaldo; Leesa B,0,4,30,30
1650147849239,MATH 142A,A01,083219,Chow; Bennett,0,11,30,30
1650147849239,MATH 142A,A02,083220,Chow; Bennett,0,11,30,30
1650147849239,MATH 142A,B01,083221,Chow; Bennett,0,10,30,30
1650147849239,MATH 142A,B02,083222,Chow; Bennett,0,11,30,30
1650147855270,MATH 193A,A01,083224,Staff,0,3,30,30
1650147855270,MATH 193A,A02,083225,Staff,0,4,30,30
1650147855270,MATH 193A,A03,083781,Staff,0,0,30,30
1650147855270,MATH 193A,A04,083782,Staff,0,0,30,30
1650147861294,MATH 197,001,091859,McAuley; Julian John,9998,0,9999,1
1650147867349,COGS 9,A01,083615,Staff,0,14,60,60
1650147873375,COGS 11,A01,083617,Boyle; Mary E. T.,24,0,40,16
1650147879399,COGS 13,A01,083071,Staff,0,29,40,40
1650147885429,COGS 14A,A01,092681,Staff,0,10,100,100
1650147891453,COGS 14B,A01,083073,Cheng; Tzu-Han,0,4,50,50
1650147897486,COGS 17,A01,092677,Staff,34,0,75,41
1650147903514,COGS 100,A01,083619,Staff,0,21,60,60
1650147909542,COGS 101A,A01,083621,Davis; Joshua Daniel,0,20,60,60
1650147915567,COGS 101B,A01,091572,Staff,9,0,60,51
1650147921603,COGS 101C,A01,083625,Delgado; Tania,21,0,30,9
1650147927625,COGS 107A,A01,083627,Boyle; Mary E. T.,0,6,60,60
1650147933662,COGS 118A,A01,083075,Staff,17,0,60,43
1650147939691,CSE 3,A50,083646,Miranda; Gregory Joseph,22,0,38,16
1650147939691,CSE 3,A51,083647,Miranda; Gregory Joseph,37,0,37,0
1650147945716,CSE 8A,A50,083650,Miranda; Gregory Joseph,0,16,40,40
1650147951742,CSE 11,A01,083080,Cao; Yingjun,0,66,40,40
1650147957768,CSE 12,A01,083652,Staff,0,4,100,100
1650147963791,CSE 15L,A01,083654,Staff,0,0,50,50
1650147963791,CSE 15L,A02,083655,Staff,9,0,50,41
1650147969817,CSE 20,A01,083657,Staff,55,0,80,25
1650147975853,CSE 30,A01,083084,Eldon; John,0,64,40,40
1650147981876,CSE 100,A01,083659,Cao; Yingjun,0,61,50,50
1650147987902,CSE 134B,A01,083661,Powell; Thomas Allan,0,27,65,65
1650147993924,CSE 140,A01,083663,Staff,3,0,75,72
1650147999966,CSE 140L,A01,083088,Eldon; John,0,2,75,75
1650148005988,CSE 175,A01,083665,Kumar; Rakesh,8,0,25,17
1650148012011,CSE 190,A00,092507,Dubnov; Shlomo,14,0,20,6
1650148018033,ECE 45,A01,083139,Staff,0,13,40,40
1650148024057,ECE 65,A50,083695,Staff,0,4,30,30
1650148030080,ECE 109,A01,091882,Touri; Behrouz,48,0,70,22
1650148036104,ECE 180,A00,083140,Abi Samra; Nicholas Camill,24,0,30,6
1650148036104,ECE 180,B00,083141,Abi Samra; Nicholas Camill,8,0,30,22
1650148042137,MATH 10A,A01,083735,Patchell; Gregory David,12,0,30,18
1650148042137,MATH 10A,A02,083736,Patchell; Gregory David,28,0,30,2
1650148042137,MATH 10A,A03,083737,Patchell; Gregory David,26,0,30,4
1650148048164,MATH 10B,A01,083207,Staff,0,5,30,30
1650148048164,MATH 10B,A02,083208,Staff,0,4,30,30
1650148048164,MATH 10B,B01,083739,Staff,18,0,30,12
1650148048164,MATH 10B,B02,083740,Staff,29,0,30,1
1650148054189,MATH 18,A01,083743,Staff,10,0,30,20
1650148054189,MATH 18,A02,083744,Staff,28,0,30,2
1650148054189,MATH 18,A03,083745,Staff,23,0,30,7
1650148054189,MATH 18,A04,083746,Staff,27,0,30,3
1650148054189,MATH 18,B01,083748,Staff,0,10,30,30
1650148054189,MATH 18,B02,083749,Staff,0,7,30,30
1650148054189,MATH 18,B03,083750,Staff,0,6,30,30
1650148054189,MATH 18,B04,083751,Staff,0,7,30,30
1650148060215,MATH 20A,A01,083754,Staff,26,0,40,14
1650148066238,MATH 20B,A01,083756,Staff,0,5,30,30
1650148066238,MATH 20B,A02,083757,Staff,0,4,30,30
1650148072266,MATH 20C,A01,083760,Staff,0,11,30,30
1650148072266,MATH 20C,A02,083761,Staff,0,12,30,30
1650148072266,MATH 20C,B01,083762,Staff,14,0,30,16
1650148072266,MATH 20C,B02,083763,Staff,28,0,30,2
1650148078296,MATH 20D,A01,083765,Staff,0,2,30,30
1650148078296,MATH 20D,A02,083766,Staff,10,0,30,20
1650148078296,MATH 20D,A03,083767,Staff,28,0,30,2
1650148084319,MATH 20E,A01,083771,Staff,8,0,30,22
1650148084319,MATH 20E,A02,083772,Staff,20,0,30,10
1650148084319,MATH 20E,B01,083773,Staff,0,0,30,30
1650148084319,MATH 20E,B02,083774,Staff,13,0,30,17
1650148090355,MATH 103A,A01,083777,Staff,0,8,30,30
1650148090355,MATH 103A,A02,083778,Staff,0,8,30,30
1650148090355,MATH 103A,B01,083779,Staff,0,9,30,30
1650148090355,MATH 103A,B02,083780,Staff,0,6,30,30
1650148096378,MATH 105,A01,085443,Staff,0,13,30,30
1650148102413,MATH 109,A01,083213,Anzaldo; Leesa B,0,3,30,30
1650148102413,MATH 109,A02,083214,Anzaldo; Leesa B,0,6,30,30
1650148102413,MATH 109,B01,083215,Anzaldo; Leesa B,0,4,30,30
1650148102413,MATH 109,B02,083216,Anzaldo; Leesa B,0,4,30,30
1650148108441,MATH 142A,A01,083219,Chow; Bennett,0,11,30,30
1650148108441,MATH 142A,A02,083220,Chow; Bennett,0,11,30,30
1650148108441,MATH 142A,B01,083221,Chow; Bennett,0,10,30,30
1650148108441,MATH 142A,B02,083222,Chow; Bennett,0,11,30,30
1650148114474,MATH 193A,A01,083224,Staff,0,3,30,30
1650148114474,MATH 193A,A02,083225,Staff,0,4,30,30
1650148114474,MATH 193A,A03,083781,Staff,0,0,30,30
1650148114474,MATH 193A,A04,083782,Staff,0,0,30,30
1650148120497,MATH 197,001,091859,McAuley; Julian John,9998,0,9999,1
1650148126550,COGS 9,A01,083615,Staff,0,14,60,60
1650148132576,COGS 11,A01,083617,Boyle; Mary E. T.,24,0,40,16
1650148138598,COGS 13,A01,083071,Staff,0,29,40,40
1650148144622,COGS 14A,A01,092681,Staff,0,10,100,100
1650148150655,COGS 14B,A01,083073,Cheng; Tzu-Han,0,4,50,50
1650148156678,COGS 17,A01,092677,Staff,34,0,75,41
1650148162702,COGS 100,A01,083619,Staff,0,21,60,60
1650148168724,COGS 101A,A01,083621,Davis; Joshua Daniel,0,20,60,60
1650148174751,COGS 101B,A01,091572,Staff,9,0,60,51
1650148180774,COGS 101C,A01,083625,Delgado; Tania,21,0,30,9
1650148186801,COGS 107A,A01,083627,Boyle; Mary E. T.,0,6,60,60
1650148192824,COGS 118A,A01,083075,Staff,17,0,60,43
1650148198851,CSE 3,A50,083646,Miranda; Gregory Joseph,22,0,38,16
1650148198851,CSE 3,A51,083647,Miranda; Gregory Joseph,37,0,37,0
1650148204882,CSE 8A,A50,083650,Miranda; Gregory Joseph,0,16,40,40
1650148210909,CSE 11,A01,083080,Cao; Yingjun,0,66,40,40
1650148216941,CSE 12,A01,083652,Staff,0,4,100,100
1650148222966,CSE 15L,A01,083654,Staff,0,0,50,50
1650148222966,CSE 15L,A02,083655,Staff,9,0,50,41
1650148228989,CSE 20,A01,083657,Staff,55,0,80,25
1650148235091,CSE 30,A01,083084,Eldon; John,0,64,40,40
1650148241165,CSE 100,A01,083659,Cao; Yingjun,0,61,50,50
1650148247193,CSE 134B,A01,083661,Powell; Thomas Allan,0,27,65,65
1650148253223,CSE 140,A01,083663,Staff,3,0,75,72
1650148259245,CSE 140L,A01,083088,Eldon; John,0,2,75,75
1650148265266,CSE 175,A01,083665,Kumar; Rakesh,8,0,25,17
1650148271290,CSE 190,A00,092507,Dubnov; Shlomo,14,0,20,6
1650148277315,ECE 45,A01,083139,Staff,0,13,40,40
1650148283338,ECE 65,A50,083695,Staff,0,4,30,30
1650148289365,ECE 109,A01,091882,Touri; Behrouz,48,0,70,22
1650148295388,ECE 180,A00,083140,Abi Samra; Nicholas Camill,24,0,30,6
1650148295388,ECE 180,B00,083141,Abi Samra; Nicholas Camill,8,0,30,22
1650148301411,MATH 10A,A01,083735,Patchell; Gregory David,12,0,30,18
1650148301411,MATH 10A,A02,083736,Patchell; Gregory David,28,0,30,2
1650148301411,MATH 10A,A03,083737,Patchell; Gregory David,26,0,30,4
1650148307436,MATH 10B,A01,083207,Staff,0,5,30,30
1650148307436,MATH 10B,A02,083208,Staff,0,4,30,30
1650148307436,MATH 10B,B01,083739,Staff,18,0,30,12
1650148307436,MATH 10B,B02,083740,Staff,29,0,30,1
1650148313475,MATH 18,A01,083743,Staff,10,0,30,20
1650148313475,MATH 18,A02,083744,Staff,28,0,30,2
1650148313475,MATH 18,A03,083745,Staff,23,0,30,7
1650148313475,MATH 18,A04,083746,Staff,27,0,30,3
1650148313475,MATH 18,B01,083748,Staff,0,10,30,30
1650148313475,MATH 18,B02,083749,Staff,0,7,30,30
1650148313475,MATH 18,B03,083750,Staff,0,6,30,30
1650148313475,MATH 18,B04,083751,Staff,0,7,30,30
1650148319501,MATH 20A,A01,083754,Staff,26,0,40,14
1650148325529,MATH 20B,A01,083756,Staff,0,5,30,30
1650148325529,MATH 20B,A02,083757,Staff,0,4,30,30
1650148331554,MATH 20C,A01,083760,Staff,0,11,30,30
1650148331554,MATH 20C,A02,083761,Staff,0,12,30,30
1650148331554,MATH 20C,B01,083762,Staff,14,0,30,16
1650148331554,MATH 20C,B02,083763,Staff,28,0,30,2
1650148337577,MATH 20D,A01,083765,Staff,0,2,30,30
1650148337577,MATH 20D,A02,083766,Staff,10,0,30,20
1650148337577,MATH 20D,A03,083767,Staff,28,0,30,2
1650148343601,MATH 20E,A01,083771,Staff,8,0,30,22
1650148343601,MATH 20E,A02,083772,Staff,20,0,30,10
1650148343601,MATH 20E,B01,083773,Staff,0,0,30,30
1650148343601,MATH 20E,B02,083774,Staff,13,0,30,17
1650148349629,MATH 103A,A01,083777,Staff,0,8,30,30
1650148349629,MATH 103A,A02,083778,Staff,0,8,30,30
1650148349629,MATH 103A,B01,083779,Staff,0,9,30,30
1650148349629,MATH 103A,B02,083780,Staff,0,6,30,30
1650148355659,MATH 105,A01,085443,Staff,0,13,30,30
1650148361685,MATH 109,A01,083213,Anzaldo; Leesa B,0,3,30,30
1650148361685,MATH 109,A02,083214,Anzaldo; Leesa B,0,6,30,30
1650148361685,MATH 109,B01,083215,Anzaldo; Leesa B,0,4,30,30
1650148361685,MATH 109,B02,083216,Anzaldo; Leesa B,0,4,30,30
1650148367710,MATH 142A,A01,083219,Chow; Bennett,0,11,30,30
1650148367710,MATH 142A,A02,083220,Chow; Bennett,0,11,30,30
1650148367710,MATH 142A,B01,083221,Chow; Bennett,0,10,30,30
1650148367710,MATH 142A,B02,083222,Chow; Bennett,0,11,30,30
1650148373736,MATH 193A,A01,083224,Staff,0,3,30,30
1650148373736,MATH 193A,A02,083225,Staff,0,4,30,30
1650148373736,MATH 193A,A03,083781,Staff,0,0,30,30
1650148373736,MATH 193A,A04,083782,Staff,0,0,30,30
1650148379760,MATH 197,001,091859,McAuley; Julian John,9998,0,9999,1
1650148385815,COGS 9,A01,083615,Staff,0,14,60,60
1650148391838,COGS 11,A01,083617,Boyle; Mary E. T.,24,0,40,16
1650148397863,COGS 13,A01,083071,Staff,0,29,40,40
1650148403886,COGS 14A,A01,092681,Staff,0,10,100,100
1650148409908,COGS 14B,A01,083073,Cheng; Tzu-Han,0,4,50,50
1650148415930,COGS 17,A01,092677,Staff,34,0,75,41
1650148421962,COGS 100,A01,083619,Staff,0,21,60,60
1650148427986,COGS 101A,A01,083621,Davis; Joshua Daniel,0,20,60,60
1650148434011,COGS 101B,A01,091572,Staff,9,0,60,51
1650148440035,COGS 101C,A01,083625,Delgado; Tania,21,0,30,9
1650148446063,COGS 107A,A01,083627,Boyle; Mary E. T.,0,6,60,60
1650148452093,COGS 118A,A01,083075,Staff,17,0,60,43
1650148458122,CSE 3,A50,083646,Miranda; Gregory Joseph,22,0,38,16
1650148458122,CSE 3,A51,083647,Miranda; Gregory Joseph,37,0,37,0
1650148464147,CSE 8A,A50,083650,Miranda; Gregory Joseph,0,16,40,40
1650148470174,CSE 11,A01,083080,Cao; Yingjun,0,66,40,40
1650148476206,CSE 12,A01,083652,Staff,0,4,100,100
1650148482237,CSE 15L,A01,083654,Staff,0,0,50,50
1650148482237,CSE 15L,A02,083655,Staff,9,0,50,41
1650148488269,CSE 20,A01,083657,Staff,55,0,80,25
1650148494293,CSE 30,A01,083084,Eldon; John,0,64,40,40
1650148500320,CSE 100,A01,083659,Cao; Yingjun,0,61,50,50
1650148506344,CSE 134B,A01,083661,Powell; Thomas Allan,0,27,65,65
1650148512367,CSE 140,A01,083663,Staff,3,0,75,72
1650148518393,CSE 140L,A01,083088,Eldon; John,0,2,75,75
1650148524416,CSE 175,A01,083665,Kumar; Rakesh,8,0,25,17
1650148530440,CSE 190,A00,092507,Dubnov; Shlomo,14,0,20,6
1650148536464,ECE 45,A01,083139,Staff,0,13,40,40
1650148542490,ECE 65,A50,083695,Staff,0,4,30,30
1650148548514,ECE 109,A01,091882,Touri; Behrouz,48,0,70,22
1650148554536,ECE 180,A00,083140,Abi Samra; Nicholas Camill,24,0,30,6
1650148554536,ECE 180,B00,083141,Abi Samra; Nicholas Camill,8,0,30,22
1650148560561,MATH 10A,A01,083735,Patchell; Gregory David,12,0,30,18
1650148560561,MATH 10A,A02,083736,Patchell; Gregory David,28,0,30,2
1650148560561,MATH 10A,A03,083737,Patchell; Gregory David,26,0,30,4
1650148566587,MATH 10B,A01,083207,Staff,0,5,30,30
1650148566587,MATH 10B,A02,083208,Staff,0,4,30,30
1650148566587,MATH 10B,B01,083739,Staff,18,0,30,12
1650148566587,MATH 10B,B02,083740,Staff,29,0,30,1
1650148572619,MATH 18,A01,083743,Staff,10,0,30,20
1650148572619,MATH 18,A02,083744,Staff,28,0,30,2
1650148572619,MATH 18,A03,083745,Staff,23,0,30,7
1650148572619,MATH 18,A04,083746,Staff,27,0,30,3
1650148572619,MATH 18,B01,083748,Staff,0,10,30,30
1650148572619,MATH 18,B02,083749,Staff,0,7,30,30
1650148572619,MATH 18,B03,083750,Staff,0,6,30,30
1650148572619,MATH 18,B04,083751,Staff,0,7,30,30
1650148578650,MATH 20A,A01,083754,Staff,26,0,40,14
1650148584677,MATH 20B,A01,083756,Staff,0,5,30,30
1650148584677,MATH 20B,A02,083757,Staff,0,4,30,30
1650148590705,MATH 20C,A01,083760,Staff,0,11,30,30
1650148590705,MATH 20C,A02,083761,Staff,0,12,30,30
1650148590705,MATH 20C,B01,083762,Staff,14,0,30,16
1650148590705,MATH 20C,B02,083763,Staff,28,0,30,2
1650148596729,MATH 20D,A01,083765,Staff,0,2,30,30
1650148596729,MATH 20D,A02,083766,Staff,10,0,30,20
1650148596729,MATH 20D,A03,083767,Staff,28,0,30,2
1650148602752,MATH 20E,A01,083771,Staff,8,0,30,22
1650148602752,MATH 20E,A02,083772,Staff,20,0,30,10
1650148602752,MATH 20E,B01,083773,Staff,0,0,30,30
1650148602752,MATH 20E,B02,083774,Staff,13,0,30,17
1650148608776,MATH 103A,A01,083777,Staff,0,8,30,30
1650148608776,MATH 103A,A02,083778,Staff,0,8,30,30
1650148608776,MATH 103A,B01,083779,Staff,0,9,30,30
1650148608776,MATH 103A,B02,083780,Staff,0,6,30,30
1650148614803,MATH 105,A01,085443,Staff,0,13,30,30
1650148620827,MATH 109,A01,083213,Anzaldo; Leesa B,0,3,30,30
1650148620827,MATH 109,A02,083214,Anzaldo; Leesa B,0,6,30,30
1650148620827,MATH 109,B01,083215,Anzaldo; Leesa B,0,4,30,30
1650148620827,MATH 109,B02,083216,Anzaldo; Leesa B,0,4,30,30
1650148626853,MATH 142A,A01,083219,Chow; Bennett,0,11,30,30
1650148626853,MATH 142A,A02,083220,Chow; Bennett,0,11,30,30
1650148626853,MATH 142A,B01,083221,Chow; Bennett,0,10,30,30
1650148626853,MATH 142A,B02,083222,Chow; Bennett,0,11,30,30
1650148632876,MATH 193A,A01,083224,Staff,0,3,30,30
1650148632876,MATH 193A,A02,083225,Staff,0,4,30,30
1650148632876,MATH 193A,A03,083781,Staff,0,0,30,30
1650148632876,MATH 193A,A04,083782,Staff,0,0,30,30
1650148638907,MATH 197,001,091859,McAuley; Julian John,9998,0,9999,1
1650148644957,COGS 9,A01,083615,Staff,0,14,60,60
1650148650983,COGS 11,A01,083617,Boyle; Mary E. T.,24,0,40,16
1650148657006,COGS 13,A01,083071,Staff,0,29,40,40
1650148663032,COGS 14A,A01,092681,Staff,0,10,100,100
1650148669060,COGS 14B,A01,083073,Cheng; Tzu-Han,0,4,50,50
1650148675095,COGS 17,A01,092677,Staff,34,0,75,41
1650148681116,COGS 100,A01,083619,Staff,0,21,60,60
1650148687145,COGS 101A,A01,083621,Davis; Joshua Daniel,0,20,60,60
1650148693170,COGS 101B,A01,091572,Staff,9,0,60,51
1650148699198,COGS 101C,A01,083625,Delgado; Tania,21,0,30,9
1650148705222,COGS 107A,A01,083627,Boyle; Mary E. T.,0,6,60,60
1650148711247,COGS 118A,A01,083075,Staff,17,0,60,43
1650148717274,CSE 3,A50,083646,Miranda; Gregory Joseph,22,0,38,16
1650148717274,CSE 3,A51,083647,Miranda; Gregory Joseph,37,0,37,0
1650148723298,CSE 8A,A50,083650,Miranda; Gregory Joseph,0,16,40,40
1650148729328,CSE 11,A01,083080,Cao; Yingjun,0,66,40,40
1650148735362,CSE 12,A01,083652,Staff,0,4,100,100
1650148741387,CSE 15L,A01,083654,Staff,0,0,50,50
1650148741387,CSE 15L,A02,083655,Staff,9,0,50,41
1650148747409,CSE 20,A01,083657,Staff,55,0,80,25
1650148753434,CSE 30,A01,083084,Eldon; John,0,64,40,40
1650148759461,CSE 100,A01,083659,Cao; Yingjun,0,61,50,50
1650148765488,CSE 134B,A01,083661,Powell; Thomas Allan,0,27,65,65
1650148771514,CSE 140,A01,083663,Staff,3,0,75,72
1650148777541,CSE 140L,A01,083088,Eldon; John,0,2,75,75
1650148783565,CSE 175,A01,083665,Kumar; Rakesh,8,0,25,17
1650148789589,CSE 190,A00,092507,Dubnov; Shlomo,14,0,20,6
1650148795616,ECE 45,A01,083139,Staff,0,13,40,40
1650148801642,ECE 65,A50,083695,Staff,0,4,30,30
1650148807670,ECE 109,A01,091882,Touri; Behrouz,48,0,70,22
1650148813696,ECE 180,A00,083140,Abi Samra; Nicholas Camill,24,0,30,6
1650148813696,ECE 180,B00,083141,Abi Samra; Nicholas Camill,8,0,30,22
1650148819720,MATH 10A,A01,083735,Patchell; Gregory David,12,0,30,18
1650148819720,MATH 10A,A02,083736,Patchell; Gregory David,28,0,30,2
1650148819720,MATH 10A,A03,083737,Patchell; Gregory David,26,0,30,4
1650148825745,MATH 10B,A01,083207,Staff,0,5,30,30
1650148825745,MATH 10B,A02,083208,Staff,0,4,30,30
1650148825745,MATH 10B,B01,083739,Staff,18,0,30,12
1650148825745,MATH 10B,B02,083740,Staff,29,0,30,1
1650148831860,MATH 18,A01,083743,Staff,10,0,30,20
1650148831860,MATH 18,A02,083744,Staff,28,0,30,2
1650148831860,MATH 18,A03,083745,Staff,23,0,30,7
1650148831860,MATH 18,A04,083746,Staff,27,0,30,3
1650148831860,MATH 18,B01,083748,Staff,0,10,30,30
1650148831860,MATH 18,B02,083749,Staff,0,7,30,30
1650148831860,MATH 18,B03,083750,Staff,0,6,30,30
1650148831860,MATH 18,B04,083751,Staff,0,7,30,30
1650148837891,MATH 20A,A01,083754,Staff,26,0,40,14
1650148843914,MATH 20B,A01,083756,Staff,0,5,30,30
1650148843914,MATH 20B,A02,083757,Staff,0,4,30,30
1650148849937,MATH 20C,A01,083760,Staff,0,11,30,30
1650148849937,MATH 20C,A02,083761,Staff,0,12,30,30
1650148849937,MATH 20C,B01,083762,Staff,14,0,30,16
1650148849937,MATH 20C,B02,083763,Staff,28,0,30,2
1650148855964,MATH 20D,A01,083765,Staff,0,2,30,30
1650148855964,MATH 20D,A02,083766,Staff,10,0,30,20
1650148855964,MATH 20D,A03,083767,Staff,28,0,30,2
1650148861988,MATH 20E,A01,083771,Staff,8,0,30,22
1650148861988,MATH 20E,A02,083772,Staff,20,0,30,10
1650148861988,MATH 20E,B01,083773,Staff,0,0,30,30
1650148861988,MATH 20E,B02,083774,Staff,13,0,30,17
1650148868012,MATH 103A,A01,083777,Staff,0,8,30,30
1650148868012,MATH 103A,A02,083778,Staff,0,8,30,30
1650148868012,MATH 103A,B01,083779,Staff,0,9,30,30
1650148868012,MATH 103A,B02,083780,Staff,0,6,30,30
1650148874045,MATH 105,A01,085443,Staff,0,13,30,30
1650148880074,MATH 109,A01,083213,Anzaldo; Leesa B,0,3,30,30
1650148880074,MATH 109,A02,083214,Anzaldo; Leesa B,0,6,30,30
1650148880074,MATH 109,B01,083215,Anzaldo; Leesa B,0,4,30,30
1650148880074,MATH 109,B02,083216,Anzaldo; Leesa B,0,4,30,30
1650148886096,MATH 142A,A01,083219,Chow; Bennett,0,11,30,30
1650148886096,MATH 142A,A02,083220,Chow; Bennett,0,11,30,30
1650148886096,MATH 142A,B01,083221,Chow; Bennett,0,10,30,30
1650148886096,MATH 142A,B02,083222,Chow; Bennett,0,11,30,30
1650148892120,MATH 193A,A01,083224,Staff,0,3,30,30
1650148892120,MATH 193A,A02,083225,Staff,0,4,30,30
1650148892120,MATH 193A,A03,083781,Staff,0,0,30,30
1650148892120,MATH 193A,A04,083782,Staff,0,0,30,30
1650148898141,MATH 197,001,091859,McAuley; Julian John,9998,0,9999,1
1650148904200,COGS 9,A01,083615,Staff,0,14,60,60
1650148910228,COGS 11,A01,083617,Boyle; Mary E. T.,24,0,40,16
1650148916254,COGS 13,A01,083071,Staff,0,29,40,40
1650148922275,COGS 14A,A01,092681,Staff,0,10,100,100
1650148928303,COGS 14B,A01,083073,Cheng; Tzu-Han,0,4,50,50
1650148934327,COGS 17,A01,092677,Staff,34,0,75,41
1650148940352,COGS 100,A01,083619,Staff,0,21,60,60
1650148946375,COGS 101A,A01,083621,Davis; Joshua Daniel,0,20,60,60
1650148952399,COGS 101B,A01,091572,Staff,9,0,60,51
1650148958429,COGS 101C,A01,083625,Delgado; Tania,21,0,30,9
1650148964451,COGS 107A,A01,083627,Boyle; Mary E. T.,0,6,60,60
1650148970474,COGS 118A,A01,083075,Staff,17,0,60,43
1650148976498,CSE 3,A50,083646,Miranda; Gregory Joseph,22,0,38,16
1650148976498,CSE 3,A51,083647,Miranda; Gregory Joseph,37,0,37,0
1650148982527,CSE 8A,A50,083650,Miranda; Gregory Joseph,0,16,40,40
1650148988551,CSE 11,A01,083080,Cao; Yingjun,0,66,40,40
1650148994578,CSE 12,A01,083652,Staff,0,4,100,100
1650149000602,CSE 15L,A01,083654,Staff,0,0,50,50
1650149000602,CSE 15L,A02,083655,Staff,9,0,50,41
1650149006627,CSE 20,A01,083657,Staff,55,0,80,25
1650149012652,CSE 30,A01,083084,Eldon; John,0,64,40,40
1650149018680,CSE 100,A01,083659,Cao; Yingjun,0,61,50,50
1650149024705,CSE 134B,A01,083661,Powell; Thomas Allan,0,27,65,65
1650149030732,CSE 140,A01,083663,Staff,3,0,75,72
1650149036755,CSE 140L,A01,083088,Eldon; John,0,2,75,75
1650149042782,CSE 175,A01,083665,Kumar; Rakesh,8,0,25,17
1650149048811,CSE 190,A00,092507,Dubnov; Shlomo,14,0,20,6
1650149054842,ECE 45,A01,083139,Staff,0,13,40,40
1650149060876,ECE 65,A50,083695,Staff,0,4,30,30
1650149066898,ECE 109,A01,091882,Touri; Behrouz,48,0,70,22
1650149072924,ECE 180,A00,083140,Abi Samra; Nicholas Camill,24,0,30,6
1650149072924,ECE 180,B00,083141,Abi Samra; Nicholas Camill,8,0,30,22
1650149078951,MATH 10A,A01,083735,Patchell; Gregory David,12,0,30,18
1650149078951,MATH 10A,A02,083736,Patchell; Gregory David,28,0,30,2
1650149078951,MATH 10A,A03,083737,Patchell; Gregory David,26,0,30,4
1650149084977,MATH 10B,A01,083207,Staff,0,5,30,30
1650149084977,MATH 10B,A02,083208,Staff,0,4,30,30
1650149084977,MATH 10B,B01,083739,Staff,18,0,30,12
1650149084977,MATH 10B,B02,083740,Staff,29,0,30,1
1650149091011,MATH 18,A01,083743,Staff,10,0,30,20
1650149091011,MATH 18,A02,083744,Staff,28,0,30,2
1650149091011,MATH 18,A03,083745,Staff,23,0,30,7
1650149091011,MATH 18,A04,083746,Staff,27,0,30,3
1650149091011,MATH 18,B01,083748,Staff,0,10,30,30
1650149091011,MATH 18,B02,083749,Staff,0,7,30,30
1650149091011,MATH 18,B03,083750,Staff,0,6,30,30
1650149091011,MATH 18,B04,083751,Staff,0,7,30,30
1650149097036,MATH 20A,A01,083754,Staff,26,0,40,14
1650149103060,MATH 20B,A01,083756,Staff,0,5,30,30
1650149103060,MATH 20B,A02,083757,Staff,0,4,30,30
1650149109084,MATH 20C,A01,083760,Staff,0,11,30,30
1650149109084,MATH 20C,A02,083761,Staff,0,12,30,30
1650149109084,MATH 20C,B01,083762,Staff,14,0,30,16
1650149109084,MATH 20C,B02,083763,Staff,28,0,30,2
1650149115107,MATH 20D,A01,083765,Staff,0,2,30,30
1650149115107,MATH 20D,A02,083766,Staff,10,0,30,20
1650149115107,MATH 20D,A03,083767,Staff,28,0,30,2
1650149121131,MATH 20E,A01,083771,Staff,8,0,30,22
1650149121131,MATH 20E,A02,083772,Staff,20,0,30,10
1650149121131,MATH 20E,B01,083773,Staff,0,0,30,30
1650149121131,MATH 20E,B02,083774,Staff,13,0,30,17
1650149127155,MATH 103A,A01,083777,Staff,0,8,30,30
1650149127155,MATH 103A,A02,083778,Staff,0,8,30,30
1650149127155,MATH 103A,B01,083779,Staff,0,9,30,30
1650149127155,MATH 103A,B02,083780,Staff,0,6,30,30
1650149133178,MATH 105,A01,085443,Staff,0,13,30,30
1650149139202,MATH 109,A01,083213,Anzaldo; Leesa B,0,3,30,30
1650149139202,MATH 109,A02,083214,Anzaldo; Leesa B,0,6,30,30
1650149139202,MATH 109,B01,083215,Anzaldo; Leesa B,0,4,30,30
1650149139202,MATH 109,B02,083216,Anzaldo; Leesa B,0,4,30,30
1650149145227,MATH 142A,A01,083219,Chow; Bennett,0,11,30,30
1650149145227,MATH 142A,A02,083220,Chow; Bennett,0,11,30,30
1650149145227,MATH 142A,B01,083221,Chow; Bennett,0,10,30,30
1650149145227,MATH 142A,B02,083222,Chow; Bennett,0,11,30,30
1650149151249,MATH 193A,A01,083224,Staff,0,3,30,30
1650149151249,MATH 193A,A02,083225,Staff,0,4,30,30
1650149151249,MATH 193A,A03,083781,Staff,0,0,30,30
1650149151249,MATH 193A,A04,083782,Staff,0,0,30,30
1650149157275,MATH 197,001,091859,McAuley; Julian John,9998,0,9999,1
1650149163339,COGS 9,A01,083615,Staff,0,14,60,60
1650149169362,COGS 11,A01,083617,Boyle; Mary E. T.,24,0,40,16
1650149175390,COGS 13,A01,083071,Staff,0,29,40,40
1650149181416,COGS 14A,A01,092681,Staff,0,10,100,100
1650149187448,COGS 14B,A01,083073,Cheng; Tzu-Han,0,4,50,50
1650149193474,COGS 17,A01,092677,Staff,34,0,75,41
1650149199496,COGS 100,A01,083619,Staff,0,21,60,60
1650149205524,COGS 101A,A01,083621,Davis; Joshua Daniel,0,20,60,60
1650149211547,COGS 101B,A01,091572,Staff,9,0,60,51
1650149217574,COGS 101C,A01,083625,Delgado; Tania,21,0,30,9
1650149223598,COGS 107A,A01,083627,Boyle; Mary E. T.,0,6,60,60
1650149229622,COGS 118A,A01,083075,Staff,17,0,60,43
1650149235645,CSE 3,A50,083646,Miranda; Gregory Joseph,22,0,38,16
1650149235645,CSE 3,A51,083647,Miranda; Gregory Joseph,37,0,37,0
1650149241672,CSE 8A,A50,083650,Miranda; Gregory Joseph,0,16,40,40
1650149247700,CSE 11,A01,083080,Cao; Yingjun,0,66,40,40
1650149253727,CSE 12,A01,083652,Staff,0,4,100,100
1650149259751,CSE 15L,A01,083654,Staff,0,0,50,50
1650149259751,CSE 15L,A02,083655,Staff,9,0,50,41
1650149265773,CSE 20,A01,083657,Staff,55,0,80,25
1650149271795,CSE 30,A01,083084,Eldon; John,0,64,40,40
1650149277818,CSE 100,A01,083659,Cao; Yingjun,0,61,50,50
1650149283841,CSE 134B,A01,083661,Powell; Thomas Allan,0,27,65,65
1650149289863,CSE 140,A01,083663,Staff,3,0,75,72
1650149295886,CSE 140L,A01,083088,Eldon; John,0,2,75,75
1650149301910,CSE 175,A01,083665,Kumar; Rakesh,8,0,25,17
1650149307932,CSE 190,A00,092507,Dubnov; Shlomo,14,0,20,6
1650149313958,ECE 45,A01,083139,Staff,0,13,40,40
1650149319985,ECE 65,A50,083695,Staff,0,4,30,30
1650149326012,ECE 109,A01,091882,Touri; Behrouz,48,0,70,22
1650149332036,ECE 180,A00,083140,Abi Samra; Nicholas Camill,24,0,30,6
1650149332036,ECE 180,B00,083141,Abi Samra; Nicholas Camill,8,0,30,22
1650149338104,MATH 10A,A01,083735,Patchell; Gregory David,12,0,30,18
1650149338104,MATH 10A,A02,083736,Patchell; Gregory David,28,0,30,2
1650149338104,MATH 10A,A03,083737,Patchell; Gregory David,26,0,30,4
1650149344130,MATH 10B,A01,083207,Staff,0,5,30,30
1650149344130,MATH 10B,A02,083208,Staff,0,4,30,30
1650149344130,MATH 10B,B01,083739,Staff,18,0,30,12
1650149344130,MATH 10B,B02,083740,Staff,29,0,30,1
1650149350161,MATH 18,A01,083743,Staff,10,0,30,20
1650149350161,MATH 18,A02,083744,Staff,28,0,30,2
1650149350161,MATH 18,A03,083745,Staff,23,0,30,7
1650149350161,MATH 18,A04,083746,Staff,27,0,30,3
1650149350161,MATH 18,B01,083748,Staff,0,10,30,30
1650149350161,MATH 18,B02,083749,Staff,0,7,30,30
1650149350161,MATH 18,B03,083750,Staff,0,6,30,30
1650149350161,MATH 18,B04,083751,Staff,0,7,30,30
1650149356188,MATH 20A,A01,083754,Staff,26,0,40,14
1650149362212,MATH 20B,A01,083756,Staff,0,5,30,30
1650149362212,MATH 20B,A02,083757,Staff,0,4,30,30
1650149368235,MATH 20C,A01,083760,Staff,0,11,30,30
1650149368235,MATH 20C,A02,083761,Staff,0,12,30,30
1650149368235,MATH 20C,B01,083762,Staff,14,0,30,16
1650149368235,MATH 20C,B02,083763,Staff,28,0,30,2
1650149374259,MATH 20D,A01,083765,Staff,0,2,30,30
1650149374259,MATH 20D,A02,083766,Staff,10,0,30,20
1650149374259,MATH 20D,A03,083767,Staff,28,0,30,2
1650149380282,MATH 20E,A01,083771,Staff,8,0,30,22
1650149380282,MATH 20E,A02,083772,Staff,20,0,30,10
1650149380282,MATH 20E,B01,083773,Staff,0,0,30,30
1650149380282,MATH 20E,B02,083774,Staff,13,0,30,17
1650149386306,MATH 103A,A01,083777,Staff,0,8,30,30
1650149386306,MATH 103A,A02,083778,Staff,0,8,30,30
1650149386306,MATH 103A,B01,083779,Staff,0,9,30,30
1650149386306,MATH 103A,B02,083780,Staff,0,6,30,30
1650149392333,MATH 105,A01,085443,Staff,0,13,30,30
1650149398361,MATH 109,A01,083213,Anzaldo; Leesa B,0,3,30,30
1650149398361,MATH 109,A02,083214,Anzaldo; Leesa B,0,6,30,30
1650149398361,MATH 109,B01,083215,Anzaldo; Leesa B,0,4,30,30
1650149398361,MATH 109,B02,083216,Anzaldo; Leesa B,0,4,30,30
1650149404388,MATH 142A,A01,083219,Chow; Bennett,0,11,30,30
1650149404388,MATH 142A,A02,083220,Chow; Bennett,0,11,30,30
1650149404388,MATH 142A,B01,083221,Chow; Bennett,0,10,30,30
1650149404388,MATH 142A,B02,083222,Chow; Bennett,0,11,30,30
1650149410417,MATH 193A,A01,083224,Staff,0,3,30,30
1650149410417,MATH 193A,A02,083225,Staff,0,4,30,30
1650149410417,MATH 193A,A03,083781,Staff,0,0,30,30
1650149410417,MATH 193A,A04,083782,Staff,0,0,30,30
1650149416445,MATH 197,001,091859,McAuley; Julian John,9998,0,9999,1
1650149422570,COGS 9,A01,083615,Staff,0,14,60,60
1650149428597,COGS 11,A01,083617,Boyle; Mary E. T.,24,0,40,16
1650149434620,COGS 13,A01,083071,Staff,0,29,40,40
1650149440648,COGS 14A,A01,092681,Staff,0,10,100,100
1650149446672,COGS 14B,A01,083073,Cheng; Tzu-Han,0,4,50,50
1650149452696,COGS 17,A01,092677,Staff,34,0,75,41
1650149458719,COGS 100,A01,083619,Staff,0,21,60,60
1650149464743,COGS 101A,A01,083621,Davis; Joshua Daniel,0,20,60,60
1650149470765,COGS 101B,A01,091572,Staff,9,0,60,51
1650149476792,COGS 101C,A01,083625,Delgado; Tania,21,0,30,9
1650149482820,COGS 107A,A01,083627,Boyle; Mary E. T.,0,6,60,60
1650149488846,COGS 118A,A01,083075,Staff,17,0,60,43
1650149494874,CSE 3,A50,083646,Miranda; Gregory Joseph,22,0,38,16
1650149494874,CSE 3,A51,083647,Miranda; Gregory Joseph,37,0,37,0
1650149500914,CSE 8A,A50,083650,Miranda; Gregory Joseph,0,16,40,40
1650149506937,CSE 11,A01,083080,Cao; Yingjun,0,66,40,40
1650149512972,CSE 12,A01,083652,Staff,0,4,100,100
1650149518996,CSE 15L,A01,083654,Staff,0,0,50,50
1650149518996,CSE 15L,A02,083655,Staff,9,0,50,41
1650149525026,CSE 20,A01,083657,Staff,55,0,80,25
1650149531051,CSE 30,A01,083084,Eldon; John,0,64,40,40
1650149537089,CSE 100,A01,083659,Cao; Yingjun,0,61,50,50
1650149543112,CSE 134B,A01,083661,Powell; Thomas Allan,0,27,65,65
1650149549135,CSE 140,A01,083663,Staff,3,0,75,72
1650149555160,CSE 140L,A01,083088,Eldon; John,0,2,75,75
1650149561184,CSE 175,A01,083665,Kumar; Rakesh,8,0,25,17
1650149567216,CSE 190,A00,092507,Dubnov; Shlomo,14,0,20,6
1650149573240,ECE 45,A01,083139,Staff,0,13,40,40
1650149579264,ECE 65,A50,083695,Staff,0,4,30,30
1650149585285,ECE 109,A01,091882,Touri; Behrouz,48,0,70,22
1650149591311,ECE 180,A00,083140,Abi Samra; Nicholas Camill,24,0,30,6
1650149591311,ECE 180,B00,083141,Abi Samra; Nicholas Camill,8,0,30,22
1650149597333,MATH 10A,A01,083735,Patchell; Gregory David,12,0,30,18
1650149597333,MATH 10A,A02,083736,Patchell; Gregory David,28,0,30,2
1650149597333,MATH 10A,A03,083737,Patchell; Gregory David,26,0,30,4
1650149603367,MATH 10B,A01,083207,Staff,0,5,30,30
1650149603367,MATH 10B,A02,083208,Staff,0,4,30,30
1650149603367,MATH 10B,B01,083739,Staff,18,0,30,12
1650149603367,MATH 10B,B02,083740,Staff,29,0,30,1
1650149609394,MATH 18,A01,083743,Staff,10,0,30,20
1650149609394,MATH 18,A02,083744,Staff,28,0,30,2
1650149609394,MATH 18,A03,083745,Staff,23,0,30,7
1650149609394,MATH 18,A04,083746,Staff,27,0,30,3
1650149609394,MATH 18,B01,083748,Staff,0,10,30,30
1650149609394,MATH 18,B02,083749,Staff,0,7,30,30
1650149609394,MATH 18,B03,083750,Staff,0,6,30,30
1650149609394,MATH 18,B04,083751,Staff,0,7,30,30
1650149615419,MATH 20A,A01,083754,Staff,26,0,40,14
1650149621457,MATH 20B,A01,083756,Staff,0,5,30,30
1650149621457,MATH 20B,A02,083757,Staff,0,4,30,30
1650149627482,MATH 20C,A01,083760,Staff,0,11,30,30
1650149627482,MATH 20C,A02,083761,Staff,0,12,30,30
1650149627482,MATH 20C,B01,083762,Staff,14,0,30,16
1650149627482,MATH 20C,B02,083763,Staff,28,0,30,2
1650149633506,MATH 20D,A01,083765,Staff,0,2,30,30
1650149633506,MATH 20D,A02,083766,Staff,10,0,30,20
1650149633506,MATH 20D,A03,083767,Staff,28,0,30,2
1650149639531,MATH 20E,A01,083771,Staff,8,0,30,22
1650149639531,MATH 20E,A02,083772,Staff,20,0,30,10
1650149639531,MATH 20E,B01,083773,Staff,0,0,30,30
1650149639531,MATH 20E,B02,083774,Staff,13,0,30,17
1650149645555,MATH 103A,A01,083777,Staff,0,8,30,30
1650149645555,MATH 103A,A02,083778,Staff,0,8,30,30
1650149645555,MATH 103A,B01,083779,Staff,0,9,30,30
1650149645555,MATH 103A,B02,083780,Staff,0,6,30,30
1650149651582,MATH 105,A01,085443,Staff,0,13,30,30
1650149657611,MATH 109,A01,083213,Anzaldo; Leesa B,0,3,30,30
1650149657611,MATH 109,A02,083214,Anzaldo; Leesa B,0,6,30,30
1650149657611,MATH 109,B01,083215,Anzaldo; Leesa B,0,4,30,30
1650149657611,MATH 109,B02,083216,Anzaldo; Leesa B,0,4,30,30
1650149663635,MATH 142A,A01,083219,Chow; Bennett,0,11,30,30
1650149663635,MATH 142A,A02,083220,Chow; Bennett,0,11,30,30
1650149663635,MATH 142A,B01,083221,Chow; Bennett,0,10,30,30
1650149663635,MATH 142A,B02,083222,Chow; Bennett,0,11,30,30
1650149669663,MATH 193A,A01,083224,Staff,0,3,30,30
1650149669663,MATH 193A,A02,083225,Staff,0,4,30,30
1650149669663,MATH 193A,A03,083781,Staff,0,0,30,30
1650149669663,MATH 193A,A04,083782,Staff,0,0,30,30
1650149675690,MATH 197,001,091859,McAuley; Julian John,9998,0,9999,1
1650149681742,COGS 9,A01,083615,Staff,0,14,60,60
1650149687769,COGS 11,A01,083617,Boyle; Mary E. T.,24,0,40,16
1650149693793,COGS 13,A01,083071,Staff,0,29,40,40
1650149699816,COGS 14A,A01,092681,Staff,0,10,100,100
1650149705840,COGS 14B,A01,083073,Cheng; Tzu-Han,0,4,50,50
1650149711864,COGS 17,A01,092677,Staff,34,0,75,41
1650149717887,COGS 100,A01,083619,Staff,0,21,60,60
1650149723911,COGS 101A,A01,083621,Davis; Joshua Daniel,0,20,60,60
1650149729937,COGS 101B,A01,091572,Staff,9,0,60,51
1650149735961,COGS 101C,A01,083625,Delgado; Tania,21,0,30,9
1650149741984,COGS 107A,A01,083627,Boyle; Mary E. T.,0,6,60,60
1650149748007,COGS 118A,A01,083075,Staff,17,0,60,43
1650149754033,CSE 3,A50,083646,Miranda; Gregory Joseph,22,0,38,16
1650149754033,CSE 3,A51,083647,Miranda; Gregory Joseph,37,0,37,0
1650149760055,CSE 8A,A50,083650,Miranda; Gregory Joseph,0,16,40,40
1650149766079,CSE 11,A01,083080,Cao; Yingjun,0,66,40,40
1650149772105,CSE 12,A01,083652,Staff,0,5,100,100
1650149778131,CSE 15L,A01,083654,Staff,0,0,50,50
1650149778131,CSE 15L,A02,083655,Staff,9,0,50,41
1650149784157,CSE 20,A01,083657,Staff,55,0,80,25
1650149790187,CSE 30,A01,083084,Eldon; John,0,64,40,40
1650149796214,CSE 100,A01,083659,Cao; Yingjun,0,61,50,50
1650149802241,CSE 134B,A01,083661,Powell; Thomas Allan,0,27,65,65
1650149808267,CSE 140,A01,083663,Staff,3,0,75,72
1650149814293,CSE 140L,A01,083088,Eldon; John,0,2,75,75
1650149820322,CSE 175,A01,083665,Kumar; Rakesh,8,0,25,17
1650149826344,CSE 190,A00,092507,Dubnov; Shlomo,14,0,20,6
1650149832371,ECE 45,A01,083139,Staff,0,13,40,40
1650149838394,ECE 65,A50,083695,Staff,0,4,30,30
1650149844418,ECE 109,A01,091882,Touri; Behrouz,48,0,70,22
1650149850443,ECE 180,A00,083140,Abi Samra; Nicholas Camill,24,0,30,6
1650149850443,ECE 180,B00,083141,Abi Samra; Nicholas Camill,8,0,30,22
1650149856470,MATH 10A,A01,083735,Patchell; Gregory David,12,0,30,18
1650149856470,MATH 10A,A02,083736,Patchell; Gregory David,28,0,30,2
1650149856470,MATH 10A,A03,083737,Patchell; Gregory David,26,0,30,4
1650149862494,MATH 10B,A01,083207,Staff,0,5,30,30
1650149862494,MATH 10B,A02,083208,Staff,0,4,30,30
1650149862494,MATH 10B,B01,083739,Staff,18,0,30,12
1650149862494,MATH 10B,B02,083740,Staff,29,0,30,1
1650149868523,MATH 18,A01,083743,Staff,10,0,30,20
1650149868523,MATH 18,A02,083744,Staff,28,0,30,2
1650149868523,MATH 18,A03,083745,Staff,23,0,30,7
1650149868523,MATH 18,A04,083746,Staff,27,0,30,3
1650149868523,MATH 18,B01,083748,Staff,0,10,30,30
1650149868523,MATH 18,B02,083749,Staff,0,7,30,30
1650149868523,MATH 18,B03,083750,Staff,0,6,30,30
1650149868523,MATH 18,B04,083751,Staff,0,7,30,30
1650149874554,MATH 20A,A01,083754,Staff,26,0,40,14
1650149880587,MATH 20B,A01,083756,Staff,0,5,30,30
1650149880587,MATH 20B,A02,083757,Staff,0,4,30,30
1650149886614,MATH 20C,A01,083760,Staff,0,11,30,30
1650149886614,MATH 20C,A02,083761,Staff,0,12,30,30
1650149886614,MATH 20C,B01,083762,Staff,14,0,30,16
1650149886614,MATH 20C,B02,083763,Staff,28,0,30,2
1650149892646,MATH 20D,A01,083765,Staff,0,2,30,30
1650149892646,MATH 20D,A02,083766,Staff,10,0,30,20
1650149892646,MATH 20D,A03,083767,Staff,28,0,30,2
1650149898678,MATH 20E,A01,083771,Staff,8,0,30,22
1650149898678,MATH 20E,A02,083772,Staff,20,0,30,10
1650149898678,MATH 20E,B01,083773,Staff,0,0,30,30
1650149898678,MATH 20E,B02,083774,Staff,13,0,30,17
1650149904701,MATH 103A,A01,083777,Staff,0,8,30,30
1650149904701,MATH 103A,A02,083778,Staff,0,8,30,30
1650149904701,MATH 103A,B01,083779,Staff,0,9,30,30
1650149904701,MATH 103A,B02,083780,Staff,0,7,30,30
1650149910734,MATH 105,A01,085443,Staff,0,13,30,30
1650149916761,MATH 109,A01,083213,Anzaldo; Leesa B,0,3,30,30
1650149916761,MATH 109,A02,083214,Anzaldo; Leesa B,0,6,30,30
1650149916761,MATH 109,B01,083215,Anzaldo; Leesa B,0,4,30,30
1650149916761,MATH 109,B02,083216,Anzaldo; Leesa B,0,4,30,30
1650149922784,MATH 142A,A01,083219,Chow; Bennett,0,11,30,30
1650149922784,MATH 142A,A02,083220,Chow; Bennett,0,11,30,30
1650149922784,MATH 142A,B01,083221,Chow; Bennett,0,10,30,30
1650149922784,MATH 142A,B02,083222,Chow; Bennett,0,11,30,30
1650149928812,MATH 193A,A01,083224,Staff,0,3,30,30
1650149928812,MATH 193A,A02,083225,Staff,0,4,30,30
1650149928812,MATH 193A,A03,083781,Staff,0,0,30,30
1650149928812,MATH 193A,A04,083782,Staff,0,0,30,30
1650149934836,MATH 197,001,091859,McAuley; Julian John,9998,0,9999,1
1650149940898,COGS 9,A01,083615,Staff,0,14,60,60
1650149946922,COGS 11,A01,083617,Boyle; Mary E. T.,24,0,40,16
1650149952947,COGS 13,A01,083071,Staff,0,29,40,40
1650149958973,COGS 14A,A01,092681,Staff,0,10,100,100
1650149964997,COGS 14B,A01,083073,Cheng; Tzu-Han,0,4,50,50
1650149971024,COGS 17,A01,092677,Staff,34,0,75,41
1650149977048,COGS 100,A01,083619,Staff,0,21,60,60
1650149983078,COGS 101A,A01,083621,Davis; Joshua Daniel,0,20,60,60
1650149989101,COGS 101B,A01,091572,Staff,9,0,60,51
1650149995128,COGS 101C,A01,083625,Delgado; Tania,21,0,30,9
1650150001159,COGS 107A,A01,083627,Boyle; Mary E. T.,0,6,60,60
1650150007189,COGS 118A,A01,083075,Staff,17,0,60,43
1650150013213,CSE 3,A50,083646,Miranda; Gregory Joseph,22,0,38,16
1650150013213,CSE 3,A51,083647,Miranda; Gregory Joseph,37,0,37,0
1650150019311,CSE 8A,A50,083650,Miranda; Gregory Joseph,0,16,40,40
1650150025335,CSE 11,A01,083080,Cao; Yingjun,0,66,40,40
1650150031358,CSE 12,A01,083652,Staff,0,5,100,100
1650150037382,CSE 15L,A01,083654,Staff,0,0,50,50
1650150037382,CSE 15L,A02,083655,Staff,9,0,50,41
1650150043404,CSE 20,A01,083657,Staff,55,0,80,25
1650150049426,CSE 30,A01,083084,Eldon; John,0,64,40,40
1650150055449,CSE 100,A01,083659,Cao; Yingjun,0,61,50,50
1650150061486,CSE 134B,A01,083661,Powell; Thomas Allan,0,27,65,65
1650150067510,CSE 140,A01,083663,Staff,3,0,75,72
1650150073534,CSE 140L,A01,083088,Eldon; John,0,2,75,75
1650150079557,CSE 175,A01,083665,Kumar; Rakesh,8,0,25,17
1650150085586,CSE 190,A00,092507,Dubnov; Shlomo,14,0,20,6
1650150091609,ECE 45,A01,083139,Staff,0,13,40,40
1650150097632,ECE 65,A50,083695,Staff,0,4,30,30
1650150103669,ECE 109,A01,091882,Touri; Behrouz,48,0,70,22
1650150109695,ECE 180,A00,083140,Abi Samra; Nicholas Camill,24,0,30,6
1650150109695,ECE 180,B00,083141,Abi Samra; Nicholas Camill,8,0,30,22
1650150115721,MATH 10A,A01,083735,Patchell; Gregory David,12,0,30,18
1650150115721,MATH 10A,A02,083736,Patchell; Gregory David,28,0,30,2
1650150115721,MATH 10A,A03,083737,Patchell; Gregory David,26,0,30,4
1650150121745,MATH 10B,A01,083207,Staff,0,5,30,30
1650150121745,MATH 10B,A02,083208,Staff,0,4,30,30
1650150121745,MATH 10B,B01,083739,Staff,18,0,30,12
1650150121745,MATH 10B,B02,083740,Staff,29,0,30,1
1650150127770,MATH 18,A01,083743,Staff,10,0,30,20
1650150127770,MATH 18,A02,083744,Staff,28,0,30,2
1650150127770,MATH 18,A03,083745,Staff,23,0,30,7
1650150127770,MATH 18,A04,083746,Staff,27,0,30,3
1650150127770,MATH 18,B01,083748,Staff,0,10,30,30
1650150127770,MATH 18,B02,083749,Staff,0,7,30,30
1650150127770,MATH 18,B03,083750,Staff,0,6,30,30
1650150127770,MATH 18,B04,083751,Staff,0,7,30,30
1650150133795,MATH 20A,A01,083754,Staff,26,0,40,14
1650150139821,MATH 20B,A01,083756,Staff,0,5,30,30
1650150139821,MATH 20B,A02,083757,Staff,0,4,30,30
1650150145848,MATH 20C,A01,083760,Staff,0,11,30,30
1650150145848,MATH 20C,A02,083761,Staff,0,12,30,30
1650150145848,MATH 20C,B01,083762,Staff,14,0,30,16
1650150145848,MATH 20C,B02,083763,Staff,28,0,30,2
1650150151871,MATH 20D,A01,083765,Staff,0,2,30,30
1650150151871,MATH 20D,A02,083766,Staff,10,0,30,20
1650150151871,MATH 20D,A03,083767,Staff,28,0,30,2
1650150157899,MATH 20E,A01,083771,Staff,8,0,30,22
1650150157899,MATH 20E,A02,083772,Staff,20,0,30,10
1650150157899,MATH 20E,B01,083773,Staff,0,0,30,30
1650150157899,MATH 20E,B02,083774,Staff,13,0,30,17
1650150163921,MATH 103A,A01,083777,Staff,0,8,30,30
1650150163921,MATH 103A,A02,083778,Staff,0,8,30,30
1650150163921,MATH 103A,B01,083779,Staff,0,9,30,30
1650150163921,MATH 103A,B02,083780,Staff,0,7,30,30
1650150169944,MATH 105,A01,085443,Staff,0,13,30,30
1650150175972,MATH 109,A01,083213,Anzaldo; Leesa B,0,3,30,30
1650150175972,MATH 109,A02,083214,Anzaldo; Leesa B,0,6,30,30
1650150175972,MATH 109,B01,083215,Anzaldo; Leesa B,0,4,30,30
1650150175972,MATH 109,B02,083216,Anzaldo; Leesa B,0,4,30,30
1650150181996,MATH 142A,A01,083219,Chow; Bennett,0,11,30,30
1650150181996,MATH 142A,A02,083220,Chow; Bennett,0,11,30,30
1650150181996,MATH 142A,B01,083221,Chow; Bennett,0,10,30,30
1650150181996,MATH 142A,B02,083222,Chow; Bennett,0,11,30,30
1650150188022,MATH 193A,A01,083224,Staff,0,3,30,30
1650150188022,MATH 193A,A02,083225,Staff,0,4,30,30
1650150188022,MATH 193A,A03,083781,Staff,0,0,30,30
1650150188022,MATH 193A,A04,083782,Staff,0,0,30,30
1650150194046,MATH 197,001,091859,McAuley; Julian John,9998,0,9999,1
1650150200100,COGS 9,A01,083615,Staff,0,14,60,60
1650150206123,COGS 11,A01,083617,Boyle; Mary E. T.,24,0,40,16
1650150212148,COGS 13,A01,083071,Staff,0,29,40,40
1650150218173,COGS 14A,A01,092681,Staff,0,10,100,100
1650150224199,COGS 14B,A01,083073,Cheng; Tzu-Han,0,4,50,50
1650150237822,COGS 17,A01,092677,Staff,34,0,75,41
1650150243849,COGS 100,A01,083619,Staff,0,21,60,60
1650150249876,COGS 101A,A01,083621,Davis; Joshua Daniel,0,20,60,60
1650150255900,COGS 101B,A01,091572,Staff,9,0,60,51
1650150261923,COGS 101C,A01,083625,Delgado; Tania,21,0,30,9
1650150267947,COGS 107A,A01,083627,Boyle; Mary E. T.,0,6,60,60
1650150273977,COGS 118A,A01,083075,Staff,17,0,60,43
1650150280001,CSE 3,A50,083646,Miranda; Gregory Joseph,22,0,38,16
1650150280001,CSE 3,A51,083647,Miranda; Gregory Joseph,37,0,37,0
1650150286023,CSE 8A,A50,083650,Miranda; Gregory Joseph,0,16,40,40
1650150292048,CSE 11,A01,083080,Cao; Yingjun,0,66,40,40
1650150298071,CSE 12,A01,083652,Staff,0,6,100,100
1650150304096,CSE 15L,A01,083654,Staff,0,0,50,50
1650150304096,CSE 15L,A02,083655,Staff,8,0,50,42
1650150310132,CSE 20,A01,083657,Staff,55,0,80,25
1650150316155,CSE 30,A01,083084,Eldon; John,0,64,40,40
1650150322178,CSE 100,A01,083659,Cao; Yingjun,0,62,50,50
1650150328202,CSE 134B,A01,083661,Powell; Thomas Allan,0,27,65,65
1650150334229,CSE 140,A01,083663,Staff,3,0,75,72
1650150340255,CSE 140L,A01,083088,Eldon; John,0,2,75,75
1650150346279,CSE 175,A01,083665,Kumar; Rakesh,8,0,25,17
1650150352308,CSE 190,A00,092507,Dubnov; Shlomo,14,0,20,6
1650150358333,ECE 45,A01,083139,Staff,0,13,40,40
1650150364358,ECE 65,A50,083695,Staff,0,4,30,30
1650150370383,ECE 109,A01,091882,Touri; Behrouz,48,0,70,22
1650150376408,ECE 180,A00,083140,Abi Samra; Nicholas Camill,24,0,30,6
1650150376408,ECE 180,B00,083141,Abi Samra; Nicholas Camill,8,0,30,22
1650150382436,MATH 10A,A01,083735,Patchell; Gregory David,12,0,30,18
1650150382436,MATH 10A,A02,083736,Patchell; Gregory David,28,0,30,2
1650150382436,MATH 10A,A03,083737,Patchell; Gregory David,26,0,30,4
1650150388459,MATH 10B,A01,083207,Staff,0,5,30,30
1650150388459,MATH 10B,A02,083208,Staff,0,4,30,30
1650150388459,MATH 10B,B01,083739,Staff,18,0,30,12
1650150388459,MATH 10B,B02,083740,Staff,29,0,30,1
1650150394483,MATH 18,A01,083743,Staff,10,0,30,20
1650150394483,MATH 18,A02,083744,Staff,28,0,30,2
1650150394483,MATH 18,A03,083745,Staff,23,0,30,7
1650150394483,MATH 18,A04,083746,Staff,27,0,30,3
1650150394483,MATH 18,B01,083748,Staff,0,10,30,30
1650150394483,MATH 18,B02,083749,Staff,0,7,30,30
1650150394483,MATH 18,B03,083750,Staff,0,6,30,30
1650150394483,MATH 18,B04,083751,Staff,0,7,30,30
1650150400508,MATH 20A,A01,083754,Staff,26,0,40,14
1650150406531,MATH 20B,A01,083756,Staff,0,5,30,30
1650150406531,MATH 20B,A02,083757,Staff,0,4,30,30
1650150412556,MATH 20C,A01,083760,Staff,0,11,30,30
1650150412556,MATH 20C,A02,083761,Staff,0,12,30,30
1650150412556,MATH 20C,B01,083762,Staff,14,0,30,16
1650150412556,MATH 20C,B02,083763,Staff,28,0,30,2
1650150418586,MATH 20D,A01,083765,Staff,0,2,30,30
1650150418586,MATH 20D,A02,083766,Staff,10,0,30,20
1650150418586,MATH 20D,A03,083767,Staff,28,0,30,2
1650150424610,MATH 20E,A01,083771,Staff,8,0,30,22
1650150424610,MATH 20E,A02,083772,Staff,20,0,30,10
1650150424610,MATH 20E,B01,083773,Staff,0,0,30,30
1650150424610,MATH 20E,B02,083774,Staff,13,0,30,17
1650150430635,MATH 103A,A01,083777,Staff,0,8,30,30
1650150430635,MATH 103A,A02,083778,Staff,0,8,30,30
1650150430635,MATH 103A,B01,083779,Staff,0,9,30,30
1650150430635,MATH 103A,B02,083780,Staff,0,7,30,30
1650150436658,MATH 105,A01,085443,Staff,0,13,30,30
1650150442686,MATH 109,A01,083213,Anzaldo; Leesa B,0,3,30,30
1650150442686,MATH 109,A02,083214,Anzaldo; Leesa B,0,6,30,30
1650150442686,MATH 109,B01,083215,Anzaldo; Leesa B,0,4,30,30
1650150442686,MATH 109,B02,083216,Anzaldo; Leesa B,0,4,30,30
1650150448710,MATH 142A,A01,083219,Chow; Bennett,0,11,30,30
1650150448710,MATH 142A,A02,083220,Chow; Bennett,0,11,30,30
1650150448710,MATH 142A,B01,083221,Chow; Bennett,0,10,30,30
1650150448710,MATH 142A,B02,083222,Chow; Bennett,0,11,30,30
1650150454736,MATH 193A,A01,083224,Staff,0,3,30,30
1650150454736,MATH 193A,A02,083225,Staff,0,4,30,30
1650150454736,MATH 193A,A03,083781,Staff,0,0,30,30
1650150454736,MATH 193A,A04,083782,Staff,0,0,30,30
1650150460758,MATH 197,001,091859,McAuley; Julian John,9998,0,9999,1
1650150466809,COGS 9,A01,083615,Staff,0,14,60,60
1650150472832,COGS 11,A01,083617,Boyle; Mary E. T.,24,0,40,16
1650150478855,COGS 13,A01,083071,Staff,0,29,40,40
1650150484880,COGS 14A,A01,092681,Staff,0,10,100,100
1650150490907,COGS 14B,A01,083073,Cheng; Tzu-Han,0,4,50,50
1650150496930,COGS 17,A01,092677,Staff,34,0,75,41
1650150502955,COGS 100,A01,083619,Staff,0,21,60,60
1650150508978,COGS 101A,A01,083621,Davis; Joshua Daniel,0,20,60,60
1650150515005,COGS 101B,A01,091572,Staff,9,0,60,51
1650150521029,COGS 101C,A01,083625,Delgado; Tania,21,0,30,9
1650150527052,COGS 107A,A01,083627,Boyle; Mary E. T.,0,6,60,60
1650150533077,COGS 118A,A01,083075,Staff,17,0,60,43
1650150539107,CSE 3,A50,083646,Miranda; Gregory Joseph,22,0,38,16
1650150539107,CSE 3,A51,083647,Miranda; Gregory Joseph,37,0,37,0
1650150545132,CSE 8A,A50,083650,Miranda; Gregory Joseph,0,16,40,40
1650150551154,CSE 11,A01,083080,Cao; Yingjun,0,66,40,40
1650150557181,CSE 12,A01,083652,Staff,0,5,100,100
1650150563215,CSE 15L,A01,083654,Staff,0,0,50,50
1650150563215,CSE 15L,A02,083655,Staff,8,0,50,42
1650150569241,CSE 20,A01,083657,Staff,54,0,80,26
1650150575266,CSE 30,A01,083084,Eldon; John,0,64,40,40
1650150581288,CSE 100,A01,083659,Cao; Yingjun,0,62,50,50
1650150587313,CSE 134B,A01,083661,Powell; Thomas Allan,0,27,65,65
1650150593335,CSE 140,A01,083663,Staff,3,0,75,72
1650150599360,CSE 140L,A01,083088,Eldon; John,0,2,75,75
1650150605386,CSE 175,A01,083665,Kumar; Rakesh,8,0,25,17
1650150611409,CSE 190,A00,092507,Dubnov; Shlomo,14,0,20,6
1650150617448,ECE 45,A01,083139,Staff,0,13,40,40
1650150623545,ECE 65,A50,083695,Staff,0,4,30,30
1650150629572,ECE 109,A01,091882,Touri; Behrouz,48,0,70,22
1650150635599,ECE 180,A00,083140,Abi Samra; Nicholas Camill,24,0,30,6
1650150635599,ECE 180,B00,083141,Abi Samra; Nicholas Camill,8,0,30,22
1650150641627,MATH 10A,A01,083735,Patchell; Gregory David,12,0,30,18
1650150641627,MATH 10A,A02,083736,Patchell; Gregory David,28,0,30,2
1650150641627,MATH 10A,A03,083737,Patchell; Gregory David,26,0,30,4
1650150647649,MATH 10B,A01,083207,Staff,0,5,30,30
1650150647649,MATH 10B,A02,083208,Staff,0,4,30,30
1650150647649,MATH 10B,B01,083739,Staff,18,0,30,12
1650150647649,MATH 10B,B02,083740,Staff,29,0,30,1
1650150653676,MATH 18,A01,083743,Staff,10,0,30,20
1650150653676,MATH 18,A02,083744,Staff,28,0,30,2
1650150653676,MATH 18,A03,083745,Staff,23,0,30,7
1650150653676,MATH 18,A04,083746,Staff,27,0,30,3
1650150653676,MATH 18,B01,083748,Staff,0,10,30,30
1650150653676,MATH 18,B02,083749,Staff,0,7,30,30
1650150653676,MATH 18,B03,083750,Staff,0,6,30,30
1650150653676,MATH 18,B04,083751,Staff,0,7,30,30
1650150659703,MATH 20A,A01,083754,Staff,26,0,40,14
1650150665728,MATH 20B,A01,083756,Staff,0,5,30,30
1650150665728,MATH 20B,A02,083757,Staff,0,4,30,30
1650150671755,MATH 20C,A01,083760,Staff,0,11,30,30
1650150671755,MATH 20C,A02,083761,Staff,0,12,30,30
1650150671755,MATH 20C,B01,083762,Staff,14,0,30,16
1650150671755,MATH 20C,B02,083763,Staff,28,0,30,2
1650150677778,MATH 20D,A01,083765,Staff,0,2,30,30
1650150677778,MATH 20D,A02,083766,Staff,10,0,30,20
1650150677778,MATH 20D,A03,083767,Staff,28,0,30,2
1650150683802,MATH 20E,A01,083771,Staff,8,0,30,22
1650150683802,MATH 20E,A02,083772,Staff,20,0,30,10
1650150683802,MATH 20E,B01,083773,Staff,0,0,30,30
1650150683802,MATH 20E,B02,083774,Staff,13,0,30,17
1650150689825,MATH 103A,A01,083777,Staff,0,8,30,30
1650150689825,MATH 103A,A02,083778,Staff,0,8,30,30
1650150689825,MATH 103A,B01,083779,Staff,0,9,30,30
1650150689825,MATH 103A,B02,083780,Staff,0,7,30,30
1650150695847,MATH 105,A01,085443,Staff,0,13,30,30
1650150701869,MATH 109,A01,083213,Anzaldo; Leesa B,0,3,30,30
1650150701869,MATH 109,A02,083214,Anzaldo; Leesa B,0,6,30,30
1650150701869,MATH 109,B01,083215,Anzaldo; Leesa B,0,4,30,30
1650150701869,MATH 109,B02,083216,Anzaldo; Leesa B,0,4,30,30
1650150707896,MATH 142A,A01,083219,Chow; Bennett,0,11,30,30
1650150707896,MATH 142A,A02,083220,Chow; Bennett,0,11,30,30
1650150707896,MATH 142A,B01,083221,Chow; Bennett,0,10,30,30
1650150707896,MATH 142A,B02,083222,Chow; Bennett,0,11,30,30
1650150713920,MATH 193A,A01,083224,Staff,0,3,30,30
1650150713920,MATH 193A,A02,083225,Staff,0,4,30,30
1650150713920,MATH 193A,A03,083781,Staff,0,0,30,30
1650150713920,MATH 193A,A04,083782,Staff,0,0,30,30
1650150719943,MATH 197,001,091859,McAuley; Julian John,9998,0,9999,1
1650150725998,COGS 9,A01,083615,Staff,0,14,60,60
1650150732030,COGS 11,A01,083617,Boyle; Mary E. T.,24,0,40,16
1650150738054,COGS 13,A01,083071,Staff,0,29,40,40
1650150744080,COGS 14A,A01,092681,Staff,0,10,100,100
1650150750105,COGS 14B,A01,083073,Cheng; Tzu-Han,0,5,50,50
1650150756127,COGS 17,A01,092677,Staff,34,0,75,41
1650150762152,COGS 100,A01,083619,Staff,0,21,60,60
1650150768183,COGS 101A,A01,083621,Davis; Joshua Daniel,0,20,60,60
1650150774205,COGS 101B,A01,091572,Staff,9,0,60,51
1650150780231,COGS 101C,A01,083625,Delgado; Tania,21,0,30,9
1650150786254,COGS 107A,A01,083627,Boyle; Mary E. T.,0,6,60,60
1650150792280,COGS 118A,A01,083075,Staff,17,0,60,43
1650150798308,CSE 3,A50,083646,Miranda; Gregory Joseph,22,0,38,16
1650150798308,CSE 3,A51,083647,Miranda; Gregory Joseph,37,0,37,0
1650150804330,CSE 8A,A50,083650,Miranda; Gregory Joseph,0,16,40,40
1650150810357,CSE 11,A01,083080,Cao; Yingjun,0,66,40,40
1650150816380,CSE 12,A01,083652,Staff,0,5,100,100
1650150822406,CSE 15L,A01,083654,Staff,0,0,50,50
1650150822406,CSE 15L,A02,083655,Staff,8,0,50,42
1650150828428,CSE 20,A01,083657,Staff,54,0,80,26
1650150834451,CSE 30,A01,083084,Eldon; John,0,64,40,40
1650150840474,CSE 100,A01,083659,Cao; Yingjun,0,62,50,50
1650150846501,CSE 134B,A01,083661,Powell; Thomas Allan,0,27,65,65
1650150852526,CSE 140,A01,083663,Staff,3,0,75,72
1650150858559,CSE 140L,A01,083088,Eldon; John,0,2,75,75
1650150864586,CSE 175,A01,083665,Kumar; Rakesh,8,0,25,17
1650150870610,CSE 190,A00,092507,Dubnov; Shlomo,14,0,20,6
1650150876641,ECE 45,A01,083139,Staff,0,13,40,40
1650150882664,ECE 65,A50,083695,Staff,0,4,30,30
1650150888691,ECE 109,A01,091882,Touri; Behrouz,48,0,70,22
1650150894715,ECE 180,A00,083140,Abi Samra; Nicholas Camill,24,0,30,6
1650150894715,ECE 180,B00,083141,Abi Samra; Nicholas Camill,8,0,30,22
1650150900743,MATH 10A,A01,083735,Patchell; Gregory David,12,0,30,18
1650150900743,MATH 10A,A02,083736,Patchell; Gregory David,28,0,30,2
1650150900743,MATH 10A,A03,083737,Patchell; Gregory David,26,0,30,4
1650150906769,MATH 10B,A01,083207,Staff,0,5,30,30
1650150906769,MATH 10B,A02,083208,Staff,0,4,30,30
1650150906769,MATH 10B,B01,083739,Staff,18,0,30,12
1650150906769,MATH 10B,B02,083740,Staff,29,0,30,1
1650150912800,MATH 18,A01,083743,Staff,10,0,30,20
1650150912800,MATH 18,A02,083744,Staff,28,0,30,2
1650150912800,MATH 18,A03,083745,Staff,23,0,30,7
1650150912800,MATH 18,A04,083746,Staff,27,0,30,3
1650150912800,MATH 18,B01,083748,Staff,0,10,30,30
1650150912800,MATH 18,B02,083749,Staff,0,7,30,30
1650150912800,MATH 18,B03,083750,Staff,0,6,30,30
1650150912800,MATH 18,B04,083751,Staff,0,7,30,30
1650150918822,MATH 20A,A01,083754,Staff,26,0,40,14
1650150924847,MATH 20B,A01,083756,Staff,0,5,30,30
1650150924847,MATH 20B,A02,083757,Staff,0,4,30,30
1650150930871,MATH 20C,A01,083760,Staff,0,11,30,30
1650150930871,MATH 20C,A02,083761,Staff,0,12,30,30
1650150930871,MATH 20C,B01,083762,Staff,14,0,30,16
1650150930871,MATH 20C,B02,083763,Staff,28,0,30,2
1650150936898,MATH 20D,A01,083765,Staff,0,2,30,30
1650150936898,MATH 20D,A02,083766,Staff,10,0,30,20
1650150936898,MATH 20D,A03,083767,Staff,28,0,30,2
1650150942926,MATH 20E,A01,083771,Staff,8,0,30,22
1650150942926,MATH 20E,A02,083772,Staff,20,0,30,10
1650150942926,MATH 20E,B01,083773,Staff,0,0,30,30
1650150942926,MATH 20E,B02,083774,Staff,13,0,30,17
1650150948949,MATH 103A,A01,083777,Staff,0,8,30,30
1650150948949,MATH 103A,A02,083778,Staff,0,8,30,30
1650150948949,MATH 103A,B01,083779,Staff,0,9,30,30
1650150948949,MATH 103A,B02,083780,Staff,0,7,30,30
1650150954973,MATH 105,A01,085443,Staff,0,13,30,30
1650150961003,MATH 109,A01,083213,Anzaldo; Leesa B,0,3,30,30
1650150961003,MATH 109,A02,083214,Anzaldo; Leesa B,0,6,30,30
1650150961003,MATH 109,B01,083215,Anzaldo; Leesa B,0,4,30,30
1650150961003,MATH 109,B02,083216,Anzaldo; Leesa B,0,4,30,30
1650150967027,MATH 142A,A01,083219,Chow; Bennett,0,11,30,30
1650150967027,MATH 142A,A02,083220,Chow; Bennett,0,11,30,30
1650150967027,MATH 142A,B01,083221,Chow; Bennett,0,10,30,30
1650150967027,MATH 142A,B02,083222,Chow; Bennett,0,11,30,30
1650150973060,MATH 193A,A01,083224,Staff,0,3,30,30
1650150973060,MATH 193A,A02,083225,Staff,0,4,30,30
1650150973060,MATH 193A,A03,083781,Staff,0,0,30,30
1650150973060,MATH 193A,A04,083782,Staff,0,0,30,30
1650150979086,MATH 197,001,091859,McAuley; Julian John,9998,0,9999,1
1650150985145,COGS 9,A01,083615,Staff,0,14,60,60
1650150991169,COGS 11,A01,083617,Boyle; Mary E. T.,24,0,40,16
1650150997192,COGS 13,A01,083071,Staff,0,29,40,40
1650151003216,COGS 14A,A01,092681,Staff,0,10,100,100
1650151009242,COGS 14B,A01,083073,Cheng; Tzu-Han,0,5,50,50
1650151015264,COGS 17,A01,092677,Staff,34,0,75,41
1650151021288,COGS 100,A01,083619,Staff,0,21,60,60
1650151027311,COGS 101A,A01,083621,Davis; Joshua Daniel,0,20,60,60
1650151033337,COGS 101B,A01,091572,Staff,9,0,60,51
1650151039365,COGS 101C,A01,083625,Delgado; Tania,21,0,30,9
1650151045394,COGS 107A,A01,083627,Boyle; Mary E. T.,0,6,60,60
1650151051427,COGS 118A,A01,083075,Staff,17,0,60,43
1650151057450,CSE 3,A50,083646,Miranda; Gregory Joseph,22,0,38,16
1650151057450,CSE 3,A51,083647,Miranda; Gregory Joseph,37,0,37,0
1650151063472,CSE 8A,A50,083650,Miranda; Gregory Joseph,0,16,40,40
1650151069493,CSE 11,A01,083080,Cao; Yingjun,0,66,40,40
1650151075516,CSE 12,A01,083652,Staff,0,5,100,100
1650151081542,CSE 15L,A01,083654,Staff,0,0,50,50
1650151081542,CSE 15L,A02,083655,Staff,8,0,50,42
1650151087571,CSE 20,A01,083657,Staff,54,0,80,26
1650151093597,CSE 30,A01,083084,Eldon; John,0,64,40,40
1650151099620,CSE 100,A01,083659,Cao; Yingjun,0,62,50,50
1650151105643,CSE 134B,A01,083661,Powell; Thomas Allan,0,27,65,65
1650151111670,CSE 140,A01,083663,Staff,3,0,75,72
1650151117698,CSE 140L,A01,083088,Eldon; John,0,2,75,75
1650151123724,CSE 175,A01,083665,Kumar; Rakesh,8,0,25,17
1650151129748,CSE 190,A00,092507,Dubnov; Shlomo,14,0,20,6
1650151135779,ECE 45,A01,083139,Staff,0,13,40,40
1650151141802,ECE 65,A50,083695,Staff,0,4,30,30
1650151147826,ECE 109,A01,091882,Touri; Behrouz,48,0,70,22
1650151153853,ECE 180,A00,083140,Abi Samra; Nicholas Camill,24,0,30,6
1650151153853,ECE 180,B00,083141,Abi Samra; Nicholas Camill,8,0,30,22
1650151159881,MATH 10A,A01,083735,Patchell; Gregory David,12,0,30,18
1650151159881,MATH 10A,A02,083736,Patchell; Gregory David,28,0,30,2
1650151159881,MATH 10A,A03,083737,Patchell; Gregory David,26,0,30,4
1650151165906,MATH 10B,A01,083207,Staff,0,5,30,30
1650151165906,MATH 10B,A02,083208,Staff,0,4,30,30
1650151165906,MATH 10B,B01,083739,Staff,18,0,30,12
1650151165906,MATH 10B,B02,083740,Staff,29,0,30,1
1650151171931,MATH 18,A01,083743,Staff,10,0,30,20
1650151171931,MATH 18,A02,083744,Staff,28,0,30,2
1650151171931,MATH 18,A03,083745,Staff,23,0,30,7
1650151171931,MATH 18,A04,083746,Staff,27,0,30,3
1650151171931,MATH 18,B01,083748,Staff,0,10,30,30
1650151171931,MATH 18,B02,083749,Staff,0,7,30,30
1650151171931,MATH 18,B03,083750,Staff,0,6,30,30
1650151171931,MATH 18,B04,083751,Staff,0,7,30,30
1650151177963,MATH 20A,A01,083754,Staff,26,0,40,14
1650151183990,MATH 20B,A01,083756,Staff,0,5,30,30
1650151183990,MATH 20B,A02,083757,Staff,0,4,30,30
1650151190014,MATH 20C,A01,083760,Staff,0,11,30,30
1650151190014,MATH 20C,A02,083761,Staff,0,12,30,30
1650151190014,MATH 20C,B01,083762,Staff,14,0,30,16
1650151190014,MATH 20C,B02,083763,Staff,28,0,30,2
1650151196041,MATH 20D,A01,083765,Staff,0,2,30,30
1650151196041,MATH 20D,A02,083766,Staff,10,0,30,20
1650151196041,MATH 20D,A03,083767,Staff,28,0,30,2
1650151202066,MATH 20E,A01,083771,Staff,8,0,30,22
1650151202066,MATH 20E,A02,083772,Staff,20,0,30,10
1650151202066,MATH 20E,B01,083773,Staff,0,0,30,30
1650151202066,MATH 20E,B02,083774,Staff,13,0,30,17
1650151208094,MATH 103A,A01,083777,Staff,0,8,30,30
1650151208094,MATH 103A,A02,083778,Staff,0,8,30,30
1650151208094,MATH 103A,B01,083779,Staff,0,9,30,30
1650151208094,MATH 103A,B02,083780,Staff,0,7,30,30
1650151214131,MATH 105,A01,085443,Staff,0,13,30,30
1650151220226,MATH 109,A01,083213,Anzaldo; Leesa B,0,3,30,30
1650151220226,MATH 109,A02,083214,Anzaldo; Leesa B,0,6,30,30
1650151220226,MATH 109,B01,083215,Anzaldo; Leesa B,0,4,30,30
1650151220226,MATH 109,B02,083216,Anzaldo; Leesa B,0,4,30,30
1650151226253,MATH 142A,A01,083219,Chow; Bennett,0,11,30,30
1650151226253,MATH 142A,A02,083220,Chow; Bennett,0,11,30,30
1650151226253,MATH 142A,B01,083221,Chow; Bennett,0,10,30,30
1650151226253,MATH 142A,B02,083222,Chow; Bennett,0,11,30,30
1650151232280,MATH 193A,A01,083224,Staff,0,3,30,30
1650151232280,MATH 193A,A02,083225,Staff,0,4,30,30
1650151232280,MATH 193A,A03,083781,Staff,0,0,30,30
1650151232280,MATH 193A,A04,083782,Staff,0,0,30,30
1650151238306,MATH 197,001,091859,McAuley; Julian John,9998,0,9999,1
1650151244356,COGS 9,A01,083615,Staff,0,14,60,60
1650151250383,COGS 11,A01,083617,Boyle; Mary E. T.,24,0,40,16
1650151256405,COGS 13,A01,083071,Staff,0,29,40,40
1650151262429,COGS 14A,A01,092681,Staff,0,10,100,100
1650151268452,COGS 14B,A01,083073,Cheng; Tzu-Han,0,5,50,50
1650151274478,COGS 17,A01,092677,Staff,34,0,75,41
1650151280500,COGS 100,A01,083619,Staff,0,21,60,60
1650151286527,COGS 101A,A01,083621,Davis; Joshua Daniel,0,20,60,60
1650151292551,COGS 101B,A01,091572,Staff,9,0,60,51
1650151298583,COGS 101C,A01,083625,Delgado; Tania,21,0,30,9
1650151304610,COGS 107A,A01,083627,Boyle; Mary E. T.,0,6,60,60
1650151310637,COGS 118A,A01,083075,Staff,17,0,60,43
1650151316661,CSE 3,A50,083646,Miranda; Gregory Joseph,22,0,38,16
1650151316661,CSE 3,A51,083647,Miranda; Gregory Joseph,37,0,37,0
1650151322684,CSE 8A,A50,083650,Miranda; Gregory Joseph,0,16,40,40
1650151328709,CSE 11,A01,083080,Cao; Yingjun,0,66,40,40
1650151334747,CSE 12,A01,083652,Staff,0,5,100,100
1650151340783,CSE 15L,A01,083654,Staff,0,0,50,50
1650151340783,CSE 15L,A02,083655,Staff,8,0,50,42
1650151346806,CSE 20,A01,083657,Staff,54,0,80,26
1650151352846,CSE 30,A01,083084,Eldon; John,0,64,40,40
1650151358869,CSE 100,A01,083659,Cao; Yingjun,0,62,50,50
1650151364895,CSE 134B,A01,083661,Powell; Thomas Allan,0,27,65,65
1650151370917,CSE 140,A01,083663,Staff,3,0,75,72
1650151376943,CSE 140L,A01,083088,Eldon; John,0,2,75,75
1650151382968,CSE 175,A01,083665,Kumar; Rakesh,8,0,25,17
1650151388994,CSE 190,A00,092507,Dubnov; Shlomo,14,0,20,6
1650151395023,ECE 45,A01,083139,Staff,0,13,40,40
1650151401046,ECE 65,A50,083695,Staff,0,4,30,30
1650151407069,ECE 109,A01,091882,Touri; Behrouz,48,0,70,22
1650151413090,ECE 180,A00,083140,Abi Samra; Nicholas Camill,24,0,30,6
1650151413090,ECE 180,B00,083141,Abi Samra; Nicholas Camill,8,0,30,22
1650151419116,MATH 10A,A01,083735,Patchell; Gregory David,12,0,30,18
1650151419116,MATH 10A,A02,083736,Patchell; Gregory David,28,0,30,2
1650151419116,MATH 10A,A03,083737,Patchell; Gregory David,26,0,30,4
1650151425140,MATH 10B,A01,083207,Staff,0,5,30,30
1650151425140,MATH 10B,A02,083208,Staff,0,4,30,30
1650151425140,MATH 10B,B01,083739,Staff,18,0,30,12
1650151425140,MATH 10B,B02,083740,Staff,29,0,30,1
1650151431166,MATH 18,A01,083743,Staff,10,0,30,20
1650151431166,MATH 18,A02,083744,Staff,28,0,30,2
1650151431166,MATH 18,A03,083745,Staff,23,0,30,7
1650151431166,MATH 18,A04,083746,Staff,27,0,30,3
1650151431166,MATH 18,B01,083748,Staff,0,10,30,30
1650151431166,MATH 18,B02,083749,Staff,0,7,30,30
1650151431166,MATH 18,B03,083750,Staff,0,6,30,30
1650151431166,MATH 18,B04,083751,Staff,0,7,30,30
1650151437194,MATH 20A,A01,083754,Staff,26,0,40,14
1650151443221,MATH 20B,A01,083756,Staff,0,5,30,30
1650151443221,MATH 20B,A02,083757,Staff,0,4,30,30
1650151449245,MATH 20C,A01,083760,Staff,0,11,30,30
1650151449245,MATH 20C,A02,083761,Staff,0,12,30,30
1650151449245,MATH 20C,B01,083762,Staff,14,0,30,16
1650151449245,MATH 20C,B02,083763,Staff,28,0,30,2
1650151455272,MATH 20D,A01,083765,Staff,0,2,30,30
1650151455272,MATH 20D,A02,083766,Staff,10,0,30,20
1650151455272,MATH 20D,A03,083767,Staff,28,0,30,2
1650151461299,MATH 20E,A01,083771,Staff,8,0,30,22
1650151461299,MATH 20E,A02,083772,Staff,20,0,30,10
1650151461299,MATH 20E,B01,083773,Staff,0,0,30,30
1650151461299,MATH 20E,B02,083774,Staff,13,0,30,17
1650151467323,MATH 103A,A01,083777,Staff,0,8,30,30
1650151467323,MATH 103A,A02,083778,Staff,0,8,30,30
1650151467323,MATH 103A,B01,083779,Staff,0,9,30,30
1650151467323,MATH 103A,B02,083780,Staff,0,7,30,30
1650151473357,MATH 105,A01,085443,Staff,0,14,30,30
1650151479399,MATH 109,A01,083213,Anzaldo; Leesa B,0,3,30,30
1650151479399,MATH 109,A02,083214,Anzaldo; Leesa B,0,6,30,30
1650151479399,MATH 109,B01,083215,Anzaldo; Leesa B,0,4,30,30
1650151479399,MATH 109,B02,083216,Anzaldo; Leesa B,0,4,30,30
1650151485424,MATH 142A,A01,083219,Chow; Bennett,0,11,30,30
1650151485424,MATH 142A,A02,083220,Chow; Bennett,0,11,30,30
1650151485424,MATH 142A,B01,083221,Chow; Bennett,0,10,30,30
1650151485424,MATH 142A,B02,083222,Chow; Bennett,0,11,30,30
1650151491451,MATH 193A,A01,083224,Staff,0,3,30,30
1650151491451,MATH 193A,A02,083225,Staff,0,4,30,30
1650151491451,MATH 193A,A03,083781,Staff,0,0,30,30
1650151491451,MATH 193A,A04,083782,Staff,0,0,30,30
1650151497482,MATH 197,001,091859,McAuley; Julian John,9998,0,9999,1
1650151503533,COGS 9,A01,083615,Staff,0,14,60,60
1650151509560,COGS 11,A01,083617,Boyle; Mary E. T.,24,0,40,16
1650151515588,COGS 13,A01,083071,Staff,0,29,40,40
1650151521611,COGS 14A,A01,092681,Staff,0,10,100,100
1650151527639,COGS 14B,A01,083073,Cheng; Tzu-Han,0,5,50,50
1650151533662,COGS 17,A01,092677,Staff,34,0,75,41
1650151539690,COGS 100,A01,083619,Staff,0,21,60,60
1650151545722,COGS 101A,A01,083621,Davis; Joshua Daniel,0,20,60,60
1650151551751,COGS 101B,A01,091572,Staff,9,0,60,51
1650151557778,COGS 101C,A01,083625,Delgado; Tania,21,0,30,9
1650151563801,COGS 107A,A01,083627,Boyle; Mary E. T.,0,6,60,60
1650151569824,COGS 118A,A01,083075,Staff,17,0,60,43
1650151575851,CSE 3,A50,083646,Miranda; Gregory Joseph,22,0,38,16
1650151575851,CSE 3,A51,083647,Miranda; Gregory Joseph,37,0,37,0
1650151581880,CSE 8A,A50,083650,Miranda; Gregory Joseph,0,17,40,40
1650151587907,CSE 11,A01,083080,Cao; Yingjun,0,66,40,40
1650151593934,CSE 12,A01,083652,Staff,0,5,100,100
1650151599956,CSE 15L,A01,083654,Staff,0,0,50,50
1650151599956,CSE 15L,A02,083655,Staff,8,0,50,42
1650151605979,CSE 20,A01,083657,Staff,54,0,80,26
1650151612004,CSE 30,A01,083084,Eldon; John,0,64,40,40
1650151618027,CSE 100,A01,083659,Cao; Yingjun,0,62,50,50
1650151624050,CSE 134B,A01,083661,Powell; Thomas Allan,0,27,65,65
1650151630077,CSE 140,A01,083663,Staff,3,0,75,72
1650151636101,CSE 140L,A01,083088,Eldon; John,0,2,75,75
1650151642131,CSE 175,A01,083665,Kumar; Rakesh,8,0,25,17
1650151648156,CSE 190,A00,092507,Dubnov; Shlomo,14,0,20,6
1650151654178,ECE 45,A01,083139,Staff,0,13,40,40
1650151660203,ECE 65,A50,083695,Staff,0,4,30,30
1650151666228,ECE 109,A01,091882,Touri; Behrouz,48,0,70,22
1650151672253,ECE 180,A00,083140,Abi Samra; Nicholas Camill,24,0,30,6
1650151672253,ECE 180,B00,083141,Abi Samra; Nicholas Camill,8,0,30,22
1650151678277,MATH 10A,A01,083735,Patchell; Gregory David,12,0,30,18
1650151678277,MATH 10A,A02,083736,Patchell; Gregory David,28,0,30,2
1650151678277,MATH 10A,A03,083737,Patchell; Gregory David,26,0,30,4
1650151684301,MATH 10B,A01,083207,Staff,0,5,30,30
1650151684301,MATH 10B,A02,083208,Staff,0,4,30,30
1650151684301,MATH 10B,B01,083739,Staff,18,0,30,12
1650151684301,MATH 10B,B02,083740,Staff,29,0,30,1
1650151690329,MATH 18,A01,083743,Staff,10,0,30,20
1650151690329,MATH 18,A02,083744,Staff,28,0,30,2
1650151690329,MATH 18,A03,083745,Staff,23,0,30,7
1650151690329,MATH 18,A04,083746,Staff,27,0,30,3
1650151690329,MATH 18,B01,083748,Staff,0,10,30,30
1650151690329,MATH 18,B02,083749,Staff,0,7,30,30
1650151690329,MATH 18,B03,083750,Staff,0,6,30,30
1650151690329,MATH 18,B04,083751,Staff,0,7,30,30
1650151696356,MATH 20A,A01,083754,Staff,26,0,40,14
1650151702381,MATH 20B,A01,083756,Staff,0,5,30,30
1650151702381,MATH 20B,A02,083757,Staff,0,4,30,30
1650151708405,MATH 20C,A01,083760,Staff,0,11,30,30
1650151708405,MATH 20C,A02,083761,Staff,0,12,30,30
1650151708405,MATH 20C,B01,083762,Staff,14,0,30,16
1650151708405,MATH 20C,B02,083763,Staff,28,0,30,2
1650151714427,MATH 20D,A01,083765,Staff,0,2,30,30
1650151714427,MATH 20D,A02,083766,Staff,10,0,30,20
1650151714427,MATH 20D,A03,083767,Staff,28,0,30,2
1650151720452,MATH 20E,A01,083771,Staff,8,0,30,22
1650151720452,MATH 20E,A02,083772,Staff,20,0,30,10
1650151720452,MATH 20E,B01,083773,Staff,0,0,30,30
1650151720452,MATH 20E,B02,083774,Staff,13,0,30,17
1650151726485,MATH 103A,A01,083777,Staff,0,8,30,30
1650151726485,MATH 103A,A02,083778,Staff,0,8,30,30
1650151726485,MATH 103A,B01,083779,Staff,0,9,30,30
1650151726485,MATH 103A,B02,083780,Staff,0,7,30,30
1650151732512,MATH 105,A01,085443,Staff,0,14,30,30
1650151738550,MATH 109,A01,083213,Anzaldo; Leesa B,0,3,30,30
1650151738550,MATH 109,A02,083214,Anzaldo; Leesa B,0,6,30,30
1650151738550,MATH 109,B01,083215,Anzaldo; Leesa B,0,4,30,30
1650151738550,MATH 109,B02,083216,Anzaldo; Leesa B,0,4,30,30
1650151744579,MATH 142A,A01,083219,Chow; Bennett,0,11,30,30
1650151744579,MATH 142A,A02,083220,Chow; Bennett,0,11,30,30
1650151744579,MATH 142A,B01,083221,Chow; Bennett,0,10,30,30
1650151744579,MATH 142A,B02,083222,Chow; Bennett,0,11,30,30
1650151750603,MATH 193A,A01,083224,Staff,0,3,30,30
1650151750603,MATH 193A,A02,083225,Staff,0,4,30,30
1650151750603,MATH 193A,A03,083781,Staff,0,0,30,30
1650151750603,MATH 193A,A04,083782,Staff,0,0,30,30
1650151756626,MATH 197,001,091859,McAuley; Julian John,9998,0,9999,1
1650151762677,COGS 9,A01,083615,Staff,0,14,60,60
1650151768705,COGS 11,A01,083617,Boyle; Mary E. T.,24,0,40,16
1650151774730,COGS 13,A01,083071,Staff,0,29,40,40
1650151780754,COGS 14A,A01,092681,Staff,0,10,100,100
1650151786781,COGS 14B,A01,083073,Cheng; Tzu-Han,0,5,50,50
1650151792808,COGS 17,A01,092677,Staff,34,0,75,41
1650151798832,COGS 100,A01,083619,Staff,0,21,60,60
1650151804859,COGS 101A,A01,083621,Davis; Joshua Daniel,0,20,60,60
1650151810964,COGS 101B,A01,091572,Staff,9,0,60,51
1650151816988,COGS 101C,A01,083625,Delgado; Tania,21,0,30,9
1650151823012,COGS 107A,A01,083627,Boyle; Mary E. T.,0,6,60,60
1650151829035,COGS 118A,A01,083075,Staff,17,0,60,43
1650151835077,CSE 3,A50,083646,Miranda; Gregory Joseph,22,0,38,16
1650151835077,CSE 3,A51,083647,Miranda; Gregory Joseph,37,0,37,0
1650151841104,CSE 8A,A50,083650,Miranda; Gregory Joseph,0,17,40,40
1650151847139,CSE 11,A01,083080,Cao; Yingjun,0,66,40,40
1650151853162,CSE 12,A01,083652,Staff,0,5,100,100
1650151859189,CSE 15L,A01,083654,Staff,0,0,50,50
1650151859189,CSE 15L,A02,083655,Staff,8,0,50,42
1650151865210,CSE 20,A01,083657,Staff,54,0,80,26
1650151871233,CSE 30,A01,083084,Eldon; John,0,64,40,40
1650151877260,CSE 100,A01,083659,Cao; Yingjun,0,62,50,50
1650151883288,CSE 134B,A01,083661,Powell; Thomas Allan,0,27,65,65
1650151889310,CSE 140,A01,083663,Staff,3,0,75,72
1650151895341,CSE 140L,A01,083088,Eldon; John,0,2,75,75
1650151901365,CSE 175,A01,083665,Kumar; Rakesh,8,0,25,17
1650151907389,CSE 190,A00,092507,Dubnov; Shlomo,14,0,20,6
1650151913416,ECE 45,A01,083139,Staff,0,13,40,40
1650151919438,ECE 65,A50,083695,Staff,0,4,30,30
1650151925461,ECE 109,A01,091882,Touri; Behrouz,48,0,70,22
1650151931484,ECE 180,A00,083140,Abi Samra; Nicholas Camill,24,0,30,6
1650151931484,ECE 180,B00,083141,Abi Samra; Nicholas Camill,8,0,30,22
1650151937508,MATH 10A,A01,083735,Patchell; Gregory David,12,0,30,18
1650151937508,MATH 10A,A02,083736,Patchell; Gregory David,28,0,30,2
1650151937508,MATH 10A,A03,083737,Patchell; Gregory David,26,0,30,4
1650151943533,MATH 10B,A01,083207,Staff,0,5,30,30
1650151943533,MATH 10B,A02,083208,Staff,0,4,30,30
1650151943533,MATH 10B,B01,083739,Staff,18,0,30,12
1650151943533,MATH 10B,B02,083740,Staff,29,0,30,1
1650151949563,MATH 18,A01,083743,Staff,10,0,30,20
1650151949563,MATH 18,A02,083744,Staff,28,0,30,2
1650151949563,MATH 18,A03,083745,Staff,23,0,30,7
1650151949563,MATH 18,A04,083746,Staff,27,0,30,3
1650151949563,MATH 18,B01,083748,Staff,0,10,30,30
1650151949563,MATH 18,B02,083749,Staff,0,7,30,30
1650151949563,MATH 18,B03,083750,Staff,0,6,30,30
1650151949563,MATH 18,B04,083751,Staff,0,7,30,30
1650151955587,MATH 20A,A01,083754,Staff,26,0,40,14
1650151961612,MATH 20B,A01,083756,Staff,0,5,30,30
1650151961612,MATH 20B,A02,083757,Staff,0,4,30,30
1650151967636,MATH 20C,A01,083760,Staff,0,11,30,30
1650151967636,MATH 20C,A02,083761,Staff,0,12,30,30
1650151967636,MATH 20C,B01,083762,Staff,14,0,30,16
1650151967636,MATH 20C,B02,083763,Staff,28,0,30,2
1650151973664,MATH 20D,A01,083765,Staff,0,2,30,30
1650151973664,MATH 20D,A02,083766,Staff,10,0,30,20
1650151973664,MATH 20D,A03,083767,Staff,28,0,30,2
1650151979695,MATH 20E,A01,083771,Staff,8,0,30,22
1650151979695,MATH 20E,A02,083772,Staff,20,0,30,10
1650151979695,MATH 20E,B01,083773,Staff,0,0,30,30
1650151979695,MATH 20E,B02,083774,Staff,13,0,30,17
1650151985718,MATH 103A,A01,083777,Staff,0,8,30,30
1650151985718,MATH 103A,A02,083778,Staff,0,8,30,30
1650151985718,MATH 103A,B01,083779,Staff,0,9,30,30
1650151985718,MATH 103A,B02,083780,Staff,0,7,30,30
1650151991742,MATH 105,A01,085443,Staff,0,14,30,30
1650151997770,MATH 109,A01,083213,Anzaldo; Leesa B,0,3,30,30
1650151997770,MATH 109,A02,083214,Anzaldo; Leesa B,0,6,30,30
1650151997770,MATH 109,B01,083215,Anzaldo; Leesa B,0,4,30,30
1650151997770,MATH 109,B02,083216,Anzaldo; Leesa B,0,4,30,30
1650152003794,MATH 142A,A01,083219,Chow; Bennett,0,11,30,30
1650152003794,MATH 142A,A02,083220,Chow; Bennett,0,11,30,30
1650152003794,MATH 142A,B01,083221,Chow; Bennett,0,10,30,30
1650152003794,MATH 142A,B02,083222,Chow; Bennett,0,11,30,30
1650152009829,MATH 193A,A01,083224,Staff,0,3,30,30
1650152009829,MATH 193A,A02,083225,Staff,0,4,30,30
1650152009829,MATH 193A,A03,083781,Staff,0,0,30,30
1650152009829,MATH 193A,A04,083782,Staff,0,0,30,30
1650152015852,MATH 197,001,091859,McAuley; Julian John,9998,0,9999,1
1650152021912,COGS 9,A01,083615,Staff,0,14,60,60
1650152027939,COGS 11,A01,083617,Boyle; Mary E. T.,24,0,40,16
1650152033965,COGS 13,A01,083071,Staff,0,29,40,40
1650152039999,COGS 14A,A01,092681,Staff,0,10,100,100
1650152046023,COGS 14B,A01,083073,Cheng; Tzu-Han,0,5,50,50
1650152052047,COGS 17,A01,092677,Staff,34,0,75,41
1650152058071,COGS 100,A01,083619,Staff,0,21,60,60
1650152064094,COGS 101A,A01,083621,Davis; Joshua Daniel,0,20,60,60
1650152070122,COGS 101B,A01,091572,Staff,9,0,60,51
1650152076174,COGS 101C,A01,083625,Delgado; Tania,21,0,30,9
1650152082198,COGS 107A,A01,083627,Boyle; Mary E. T.,0,6,60,60
1650152088221,COGS 118A,A01,083075,Staff,17,0,60,43
1650152094249,CSE 3,A50,083646,Miranda; Gregory Joseph,22,0,38,16
1650152094249,CSE 3,A51,083647,Miranda; Gregory Joseph,37,0,37,0
1650152100278,CSE 8A,A50,083650,Miranda; Gregory Joseph,0,17,40,40
1650152106309,CSE 11,A01,083080,Cao; Yingjun,0,66,40,40
1650152112332,CSE 12,A01,083652,Staff,0,5,100,100
1650152118354,CSE 15L,A01,083654,Staff,0,0,50,50
1650152118354,CSE 15L,A02,083655,Staff,8,0,50,42
1650152124378,CSE 20,A01,083657,Staff,54,0,80,26
1650152130406,CSE 30,A01,083084,Eldon; John,0,64,40,40
1650152136433,CSE 100,A01,083659,Cao; Yingjun,0,62,50,50
1650152142460,CSE 134B,A01,083661,Powell; Thomas Allan,0,27,65,65
1650152148484,CSE 140,A01,083663,Staff,3,0,75,72
1650152154507,CSE 140L,A01,083088,Eldon; John,0,2,75,75
1650152160547,CSE 175,A01,083665,Kumar; Rakesh,8,0,25,17
1650152166571,CSE 190,A00,092507,Dubnov; Shlomo,14,0,20,6
1650152172595,ECE 45,A01,083139,Staff,0,13,40,40
1650152178627,ECE 65,A50,083695,Staff,0,4,30,30
1650152184651,ECE 109,A01,091882,Touri; Behrouz,48,0,70,22
1650152190680,ECE 180,A00,083140,Abi Samra; Nicholas Camill,24,0,30,6
1650152190680,ECE 180,B00,083141,Abi Samra; Nicholas Camill,8,0,30,22
1650152196703,MATH 10A,A01,083735,Patchell; Gregory David,12,0,30,18
1650152196703,MATH 10A,A02,083736,Patchell; Gregory David,28,0,30,2
1650152196703,MATH 10A,A03,083737,Patchell; Gregory David,26,0,30,4
1650152202730,MATH 10B,A01,083207,Staff,0,5,30,30
1650152202730,MATH 10B,A02,083208,Staff,0,4,30,30
1650152202730,MATH 10B,B01,083739,Staff,18,0,30,12
1650152202730,MATH 10B,B02,083740,Staff,29,0,30,1
1650152208759,MATH 18,A01,083743,Staff,10,0,30,20
1650152208759,MATH 18,A02,083744,Staff,28,0,30,2
1650152208759,MATH 18,A03,083745,Staff,23,0,30,7
1650152208759,MATH 18,A04,083746,Staff,27,0,30,3
1650152208759,MATH 18,B01,083748,Staff,0,10,30,30
1650152208759,MATH 18,B02,083749,Staff,0,7,30,30
1650152208759,MATH 18,B03,083750,Staff,0,6,30,30
1650152208759,MATH 18,B04,083751,Staff,0,7,30,30
1650152214784,MATH 20A,A01,083754,Staff,26,0,40,14
1650152220816,MATH 20B,A01,083756,Staff,0,5,30,30
1650152220816,MATH 20B,A02,083757,Staff,0,4,30,30
1650152226844,MATH 20C,A01,083760,Staff,0,11,30,30
1650152226844,MATH 20C,A02,083761,Staff,0,12,30,30
1650152226844,MATH 20C,B01,083762,Staff,14,0,30,16
1650152226844,MATH 20C,B02,083763,Staff,28,0,30,2
1650152232867,MATH 20D,A01,083765,Staff,0,2,30,30
1650152232867,MATH 20D,A02,083766,Staff,10,0,30,20
1650152232867,MATH 20D,A03,083767,Staff,28,0,30,2
1650152238892,MATH 20E,A01,083771,Staff,8,0,30,22
1650152238892,MATH 20E,A02,083772,Staff,20,0,30,10
1650152238892,MATH 20E,B01,083773,Staff,0,0,30,30
1650152238892,MATH 20E,B02,083774,Staff,13,0,30,17
1650152244914,MATH 103A,A01,083777,Staff,0,8,30,30
1650152244914,MATH 103A,A02,083778,Staff,0,8,30,30
1650152244914,MATH 103A,B01,083779,Staff,0,9,30,30
1650152244914,MATH 103A,B02,083780,Staff,0,7,30,30
1650152250939,MATH 105,A01,085443,Staff,0,14,30,30
1650152256967,MATH 109,A01,083213,Anzaldo; Leesa B,0,3,30,30
1650152256967,MATH 109,A02,083214,Anzaldo; Leesa B,0,6,30,30
1650152256967,MATH 109,B01,083215,Anzaldo; Leesa B,0,4,30,30
1650152256967,MATH 109,B02,083216,Anzaldo; Leesa B,0,4,30,30
1650152262991,MATH 142A,A01,083219,Chow; Bennett,0,11,30,30
1650152262991,MATH 142A,A02,083220,Chow; Bennett,0,11,30,30
1650152262991,MATH 142A,B01,083221,Chow; Bennett,0,10,30,30
1650152262991,MATH 142A,B02,083222,Chow; Bennett,0,11,30,30
1650152269012,MATH 193A,A01,083224,Staff,0,3,30,30
1650152269012,MATH 193A,A02,083225,Staff,0,4,30,30
1650152269012,MATH 193A,A03,083781,Staff,0,0,30,30
1650152269012,MATH 193A,A04,083782,Staff,0,0,30,30
1650152275034,MATH 197,001,091859,McAuley; Julian John,9998,0,9999,1
1650152281096,COGS 9,A01,083615,Staff,0,14,60,60
1650152287124,COGS 11,A01,083617,Boyle; Mary E. T.,24,0,40,16
1650152293147,COGS 13,A01,083071,Staff,0,29,40,40
1650152299177,COGS 14A,A01,092681,Staff,0,10,100,100
1650152305201,COGS 14B,A01,083073,Cheng; Tzu-Han,0,5,50,50
1650152311228,COGS 17,A01,092677,Staff,34,0,75,41
1650152317253,COGS 100,A01,083619,Staff,0,21,60,60
1650152323275,COGS 101A,A01,083621,Davis; Joshua Daniel,0,20,60,60
1650152329299,COGS 101B,A01,091572,Staff,9,0,60,51
1650152335325,COGS 101C,A01,083625,Delgado; Tania,21,0,30,9
1650152341353,COGS 107A,A01,083627,Boyle; Mary E. T.,0,6,60,60
1650152347376,COGS 118A,A01,083075,Staff,17,0,60,43
1650152353400,CSE 3,A50,083646,Miranda; Gregory Joseph,22,0,38,16
1650152353400,CSE 3,A51,083647,Miranda; Gregory Joseph,37,0,37,0
1650152359425,CSE 8A,A50,083650,Miranda; Gregory Joseph,0,17,40,40
1650152365449,CSE 11,A01,083080,Cao; Yingjun,0,66,40,40
1650152371476,CSE 12,A01,083652,Staff,0,5,100,100
1650152377502,CSE 15L,A01,083654,Staff,0,0,50,50
1650152377502,CSE 15L,A02,083655,Staff,8,0,50,42
1650152383533,CSE 20,A01,083657,Staff,54,0,80,26
1650152389557,CSE 30,A01,083084,Eldon; John,0,64,40,40
1650152395585,CSE 100,A01,083659,Cao; Yingjun,0,62,50,50
1650152401609,CSE 134B,A01,083661,Powell; Thomas Allan,0,27,65,65
1650152407711,CSE 140,A01,083663,Staff,3,0,75,72
1650152413733,CSE 140L,A01,083088,Eldon; John,0,2,75,75
1650152419762,CSE 175,A01,083665,Kumar; Rakesh,8,0,25,17
1650152425788,CSE 190,A00,092507,Dubnov; Shlomo,14,0,20,6
1650152431812,ECE 45,A01,083139,Staff,0,13,40,40
1650152437839,ECE 65,A50,083695,Staff,0,4,30,30
1650152443876,ECE 109,A01,091882,Touri; Behrouz,48,0,70,22
1650152449905,ECE 180,A00,083140,Abi Samra; Nicholas Camill,24,0,30,6
1650152449905,ECE 180,B00,083141,Abi Samra; Nicholas Camill,8,0,30,22
1650152455928,MATH 10A,A01,083735,Patchell; Gregory David,12,0,30,18
1650152455928,MATH 10A,A02,083736,Patchell; Gregory David,28,0,30,2
1650152455928,MATH 10A,A03,083737,Patchell; Gregory David,26,0,30,4
1650152461958,MATH 10B,A01,083207,Staff,0,5,30,30
1650152461958,MATH 10B,A02,083208,Staff,0,4,30,30
1650152461958,MATH 10B,B01,083739,Staff,18,0,30,12
1650152461958,MATH 10B,B02,083740,Staff,29,0,30,1
1650152467988,MATH 18,A01,083743,Staff,10,0,30,20
1650152467988,MATH 18,A02,083744,Staff,28,0,30,2
1650152467988,MATH 18,A03,083745,Staff,23,0,30,7
1650152467988,MATH 18,A04,083746,Staff,27,0,30,3
1650152467988,MATH 18,B01,083748,Staff,0,10,30,30
1650152467988,MATH 18,B02,083749,Staff,0,7,30,30
1650152467988,MATH 18,B03,083750,Staff,0,6,30,30
1650152467988,MATH 18,B04,083751,Staff,0,7,30,30
1650152474014,MATH 20A,A01,083754,Staff,26,0,40,14
1650152480037,MATH 20B,A01,083756,Staff,0,5,30,30
1650152480037,MATH 20B,A02,083757,Staff,0,4,30,30
1650152486062,MATH 20C,A01,083760,Staff,0,11,30,30
1650152486062,MATH 20C,A02,083761,Staff,0,12,30,30
1650152486062,MATH 20C,B01,083762,Staff,14,0,30,16
1650152486062,MATH 20C,B02,083763,Staff,28,0,30,2
1650152492089,MATH 20D,A01,083765,Staff,0,2,30,30
1650152492089,MATH 20D,A02,083766,Staff,10,0,30,20
1650152492089,MATH 20D,A03,083767,Staff,28,0,30,2
1650152498111,MATH 20E,A01,083771,Staff,8,0,30,22
1650152498111,MATH 20E,A02,083772,Staff,20,0,30,10
1650152498111,MATH 20E,B01,083773,Staff,0,0,30,30
1650152498111,MATH 20E,B02,083774,Staff,13,0,30,17
1650152504139,MATH 103A,A01,083777,Staff,0,8,30,30
1650152504139,MATH 103A,A02,083778,Staff,0,8,30,30
1650152504139,MATH 103A,B01,083779,Staff,0,9,30,30
1650152504139,MATH 103A,B02,083780,Staff,0,7,30,30
1650152510166,MATH 105,A01,085443,Staff,0,14,30,30
1650152516189,MATH 109,A01,083213,Anzaldo; Leesa B,0,3,30,30
1650152516189,MATH 109,A02,083214,Anzaldo; Leesa B,0,6,30,30
1650152516189,MATH 109,B01,083215,Anzaldo; Leesa B,0,4,30,30
1650152516189,MATH 109,B02,083216,Anzaldo; Leesa B,0,4,30,30
1650152522211,MATH 142A,A01,083219,Chow; Bennett,0,11,30,30
1650152522211,MATH 142A,A02,083220,Chow; Bennett,0,11,30,30
1650152522211,MATH 142A,B01,083221,Chow; Bennett,0,10,30,30
1650152522211,MATH 142A,B02,083222,Chow; Bennett,0,11,30,30
1650152528234,MATH 193A,A01,083224,Staff,0,3,30,30
1650152528234,MATH 193A,A02,083225,Staff,0,4,30,30
1650152528234,MATH 193A,A03,083781,Staff,0,0,30,30
1650152528234,MATH 193A,A04,083782,Staff,0,0,30,30
1650152534255,MATH 197,001,091859,McAuley; Julian John,9998,0,9999,1
1650152540304,COGS 9,A01,083615,Staff,0,14,60,60
1650152546327,COGS 11,A01,083617,Boyle; Mary E. T.,24,0,40,16
1650152552354,COGS 13,A01,083071,Staff,0,29,40,40
1650152558379,COGS 14A,A01,092681,Staff,0,10,100,100
1650152564403,COGS 14B,A01,083073,Cheng; Tzu-Han,0,5,50,50
1650152570425,COGS 17,A01,092677,Staff,34,0,75,41
1650152576450,COGS 100,A01,083619,Staff,0,21,60,60
1650152582478,COGS 101A,A01,083621,Davis; Joshua Daniel,0,20,60,60
1650152588501,COGS 101B,A01,091572,Staff,9,0,60,51
1650152594537,COGS 101C,A01,083625,Delgado; Tania,21,0,30,9
1650152600561,COGS 107A,A01,083627,Boyle; Mary E. T.,0,6,60,60
1650152606587,COGS 118A,A01,083075,Staff,17,0,60,43
1650152612611,CSE 3,A50,083646,Miranda; Gregory Joseph,22,0,38,16
1650152612611,CSE 3,A51,083647,Miranda; Gregory Joseph,37,0,37,0
1650152618634,CSE 8A,A50,083650,Miranda; Gregory Joseph,0,17,40,40
1650152624660,CSE 11,A01,083080,Cao; Yingjun,0,66,40,40
1650152630684,CSE 12,A01,083652,Staff,0,5,100,100
1650152636710,CSE 15L,A01,083654,Staff,0,0,50,50
1650152636710,CSE 15L,A02,083655,Staff,8,0,50,42
1650152642736,CSE 20,A01,083657,Staff,54,0,80,26
1650152648759,CSE 30,A01,083084,Eldon; John,0,64,40,40
1650152654783,CSE 100,A01,083659,Cao; Yingjun,0,62,50,50
1650152660812,CSE 134B,A01,083661,Powell; Thomas Allan,0,27,65,65
1650152666835,CSE 140,A01,083663,Staff,3,0,75,72
1650152672862,CSE 140L,A01,083088,Eldon; John,0,2,75,75
1650152678887,CSE 175,A01,083665,Kumar; Rakesh,8,0,25,17
1650152684911,CSE 190,A00,092507,Dubnov; Shlomo,14,0,20,6
1650152690935,ECE 45,A01,083139,Staff,0,13,40,40
1650152696957,ECE 65,A50,083695,Staff,0,4,30,30
1650152702983,ECE 109,A01,091882,Touri; Behrouz,48,0,70,22
1650152709006,ECE 180,A00,083140,Abi Samra; Nicholas Camill,24,0,30,6
1650152709006,ECE 180,B00,083141,Abi Samra; Nicholas Camill,8,0,30,22
1650152715036,MATH 10A,A01,083735,Patchell; Gregory David,12,0,30,18
1650152715036,MATH 10A,A02,083736,Patchell; Gregory David,28,0,30,2
1650152715036,MATH 10A,A03,083737,Patchell; Gregory David,26,0,30,4
1650152721064,MATH 10B,A01,083207,Staff,0,5,30,30
1650152721064,MATH 10B,A02,083208,Staff,0,4,30,30
1650152721064,MATH 10B,B01,083739,Staff,18,0,30,12
1650152721064,MATH 10B,B02,083740,Staff,29,0,30,1
1650152727088,MATH 18,A01,083743,Staff,10,0,30,20
1650152727088,MATH 18,A02,083744,Staff,28,0,30,2
1650152727088,MATH 18,A03,083745,Staff,23,0,30,7
1650152727088,MATH 18,A04,083746,Staff,27,0,30,3
1650152727088,MATH 18,B01,083748,Staff,0,10,30,30
1650152727088,MATH 18,B02,083749,Staff,0,7,30,30
1650152727088,MATH 18,B03,083750,Staff,0,6,30,30
1650152727088,MATH 18,B04,083751,Staff,0,7,30,30
1650152733112,MATH 20A,A01,083754,Staff,26,0,40,14
1650152739136,MATH 20B,A01,083756,Staff,0,5,30,30
1650152739136,MATH 20B,A02,083757,Staff,0,4,30,30
1650152745160,MATH 20C,A01,083760,Staff,0,11,30,30
1650152745160,MATH 20C,A02,083761,Staff,0,12,30,30
1650152745160,MATH 20C,B01,083762,Staff,14,0,30,16
1650152745160,MATH 20C,B02,083763,Staff,28,0,30,2
1650152751184,MATH 20D,A01,083765,Staff,0,2,30,30
1650152751184,MATH 20D,A02,083766,Staff,10,0,30,20
1650152751184,MATH 20D,A03,083767,Staff,28,0,30,2
1650152757209,MATH 20E,A01,083771,Staff,8,0,30,22
1650152757209,MATH 20E,A02,083772,Staff,20,0,30,10
1650152757209,MATH 20E,B01,083773,Staff,0,0,30,30
1650152757209,MATH 20E,B02,083774,Staff,13,0,30,17
1650152763231,MATH 103A,A01,083777,Staff,0,8,30,30
1650152763231,MATH 103A,A02,083778,Staff,0,8,30,30
1650152763231,MATH 103A,B01,083779,Staff,0,9,30,30
1650152763231,MATH 103A,B02,083780,Staff,0,7,30,30
1650152769254,MATH 105,A01,085443,Staff,0,14,30,30
1650152775279,MATH 109,A01,083213,Anzaldo; Leesa B,0,3,30,30
1650152775279,MATH 109,A02,083214,Anzaldo; Leesa B,0,6,30,30
1650152775279,MATH 109,B01,083215,Anzaldo; Leesa B,0,4,30,30
1650152775279,MATH 109,B02,083216,Anzaldo; Leesa B,0,4,30,30
1650152781308,MATH 142A,A01,083219,Chow; Bennett,0,11,30,30
1650152781308,MATH 142A,A02,083220,Chow; Bennett,0,11,30,30
1650152781308,MATH 142A,B01,083221,Chow; Bennett,0,10,30,30
1650152781308,MATH 142A,B02,083222,Chow; Bennett,0,11,30,30
1650152787337,MATH 193A,A01,083224,Staff,0,3,30,30
1650152787337,MATH 193A,A02,083225,Staff,0,4,30,30
1650152787337,MATH 193A,A03,083781,Staff,0,0,30,30
1650152787337,MATH 193A,A04,083782,Staff,0,0,30,30
1650152793360,MATH 197,001,091859,McAuley; Julian John,9998,0,9999,1
1650152799408,COGS 9,A01,083615,Staff,0,14,60,60
1650152805432,COGS 11,A01,083617,Boyle; Mary E. T.,24,0,40,16
1650152811455,COGS 13,A01,083071,Staff,0,29,40,40
1650152817478,COGS 14A,A01,092681,Staff,0,10,100,100
1650152823505,COGS 14B,A01,083073,Cheng; Tzu-Han,0,5,50,50
1650152829527,COGS 17,A01,092677,Staff,34,0,75,41
1650152835551,COGS 100,A01,083619,Staff,0,21,60,60
1650152841573,COGS 101A,A01,083621,Davis; Joshua Daniel,0,20,60,60
1650152847600,COGS 101B,A01,091572,Staff,9,0,60,51
1650152853625,COGS 101C,A01,083625,Delgado; Tania,21,0,30,9
1650152859647,COGS 107A,A01,083627,Boyle; Mary E. T.,0,6,60,60
1650152865674,COGS 118A,A01,083075,Staff,17,0,60,43
1650152871700,CSE 3,A50,083646,Miranda; Gregory Joseph,22,0,38,16
1650152871700,CSE 3,A51,083647,Miranda; Gregory Joseph,37,0,37,0
1650152877723,CSE 8A,A50,083650,Miranda; Gregory Joseph,0,17,40,40
1650152883746,CSE 11,A01,083080,Cao; Yingjun,0,66,40,40
1650152889769,CSE 12,A01,083652,Staff,0,5,100,100
1650152895796,CSE 15L,A01,083654,Staff,0,0,50,50
1650152895796,CSE 15L,A02,083655,Staff,8,0,50,42
1650152901825,CSE 20,A01,083657,Staff,54,0,80,26
1650152907851,CSE 30,A01,083084,Eldon; John,0,64,40,40
1650152913874,CSE 100,A01,083659,Cao; Yingjun,0,62,50,50
1650152919897,CSE 134B,A01,083661,Powell; Thomas Allan,0,27,65,65
1650152925918,CSE 140,A01,083663,Staff,3,0,75,72
1650152931941,CSE 140L,A01,083088,Eldon; John,0,2,75,75
1650152937968,CSE 175,A01,083665,Kumar; Rakesh,8,0,25,17
1650152943998,CSE 190,A00,092507,Dubnov; Shlomo,14,0,20,6
1650152950025,ECE 45,A01,083139,Staff,0,13,40,40
1650152956048,ECE 65,A50,083695,Staff,0,4,30,30
1650152962071,ECE 109,A01,091882,Touri; Behrouz,48,0,70,22
1650152968094,ECE 180,A00,083140,Abi Samra; Nicholas Camill,24,0,30,6
1650152968094,ECE 180,B00,083141,Abi Samra; Nicholas Camill,8,0,30,22
1650152974116,MATH 10A,A01,083735,Patchell; Gregory David,12,0,30,18
1650152974116,MATH 10A,A02,083736,Patchell; Gregory David,28,0,30,2
1650152974116,MATH 10A,A03,083737,Patchell; Gregory David,26,0,30,4
1650152980139,MATH 10B,A01,083207,Staff,0,5,30,30
1650152980139,MATH 10B,A02,083208,Staff,0,4,30,30
1650152980139,MATH 10B,B01,083739,Staff,18,0,30,12
1650152980139,MATH 10B,B02,083740,Staff,29,0,30,1
1650152986163,MATH 18,A01,083743,Staff,10,0,30,20
1650152986163,MATH 18,A02,083744,Staff,28,0,30,2
1650152986163,MATH 18,A03,083745,Staff,23,0,30,7
1650152986163,MATH 18,A04,083746,Staff,27,0,30,3
1650152986163,MATH 18,B01,083748,Staff,0,10,30,30
1650152986163,MATH 18,B02,083749,Staff,0,7,30,30
1650152986163,MATH 18,B03,083750,Staff,0,6,30,30
1650152986163,MATH 18,B04,083751,Staff,0,7,30,30
1650152992186,MATH 20A,A01,083754,Staff,26,0,40,14
1650152998210,MATH 20B,A01,083756,Staff,0,5,30,30
1650152998210,MATH 20B,A02,083757,Staff,0,4,30,30
1650153004314,MATH 20C,A01,083760,Staff,0,11,30,30
1650153004314,MATH 20C,A02,083761,Staff,0,12,30,30
1650153004314,MATH 20C,B01,083762,Staff,14,0,30,16
1650153004314,MATH 20C,B02,083763,Staff,28,0,30,2
1650153010341,MATH 20D,A01,083765,Staff,0,2,30,30
1650153010341,MATH 20D,A02,083766,Staff,10,0,30,20
1650153010341,MATH 20D,A03,083767,Staff,28,0,30,2
1650153016367,MATH 20E,A01,083771,Staff,8,0,30,22
1650153016367,MATH 20E,A02,083772,Staff,20,0,30,10
1650153016367,MATH 20E,B01,083773,Staff,0,0,30,30
1650153016367,MATH 20E,B02,083774,Staff,13,0,30,17
1650153022393,MATH 103A,A01,083777,Staff,0,8,30,30
1650153022393,MATH 103A,A02,083778,Staff,0,8,30,30
1650153022393,MATH 103A,B01,083779,Staff,0,9,30,30
1650153022393,MATH 103A,B02,083780,Staff,0,7,30,30
1650153028419,MATH 105,A01,085443,Staff,0,14,30,30
1650153034443,MATH 109,A01,083213,Anzaldo; Leesa B,0,3,30,30
1650153034443,MATH 109,A02,083214,Anzaldo; Leesa B,0,6,30,30
1650153034443,MATH 109,B01,083215,Anzaldo; Leesa B,0,4,30,30
1650153034443,MATH 109,B02,083216,Anzaldo; Leesa B,0,4,30,30
1650153040466,MATH 142A,A01,083219,Chow; Bennett,0,11,30,30
1650153040466,MATH 142A,A02,083220,Chow; Bennett,0,11,30,30
1650153040466,MATH 142A,B01,083221,Chow; Bennett,0,10,30,30
1650153040466,MATH 142A,B02,083222,Chow; Bennett,0,11,30,30
1650153046504,MATH 193A,A01,083224,Staff,0,3,30,30
1650153046504,MATH 193A,A02,083225,Staff,0,4,30,30
1650153046504,MATH 193A,A03,083781,Staff,0,0,30,30
1650153046504,MATH 193A,A04,083782,Staff,0,0,30,30
1650153052531,MATH 197,001,091859,McAuley; Julian John,9998,0,9999,1
1650153058648,COGS 9,A01,083615,Staff,0,14,60,60
1650153064674,COGS 11,A01,083617,Boyle; Mary E. T.,24,0,40,16
1650153070697,COGS 13,A01,083071,Staff,0,29,40,40
1650153076722,COGS 14A,A01,092681,Staff,0,10,100,100
1650153082750,COGS 14B,A01,083073,Cheng; Tzu-Han,0,5,50,50
1650153088773,COGS 17,A01,092677,Staff,34,0,75,41
1650153094797,COGS 100,A01,083619,Staff,0,21,60,60
1650153100821,COGS 101A,A01,083621,Davis; Joshua Daniel,0,20,60,60
1650153106842,COGS 101B,A01,091572,Staff,9,0,60,51
1650153112866,COGS 101C,A01,083625,Delgado; Tania,21,0,30,9
1650153118902,COGS 107A,A01,083627,Boyle; Mary E. T.,0,6,60,60
1650153124924,COGS 118A,A01,083075,Staff,17,0,60,43
1650153130948,CSE 3,A50,083646,Miranda; Gregory Joseph,22,0,38,16
1650153130948,CSE 3,A51,083647,Miranda; Gregory Joseph,37,0,37,0
1650153136972,CSE 8A,A50,083650,Miranda; Gregory Joseph,0,17,40,40
1650153142999,CSE 11,A01,083080,Cao; Yingjun,0,66,40,40
1650153149022,CSE 12,A01,083652,Staff,0,5,100,100
1650153155044,CSE 15L,A01,083654,Staff,0,0,50,50
1650153155044,CSE 15L,A02,083655,Staff,8,0,50,42
1650153161067,CSE 20,A01,083657,Staff,54,0,80,26
1650153167093,CSE 30,A01,083084,Eldon; John,0,64,40,40
1650153173115,CSE 100,A01,083659,Cao; Yingjun,0,62,50,50
1650153179139,CSE 134B,A01,083661,Powell; Thomas Allan,0,27,65,65
1650153185169,CSE 140,A01,083663,Staff,3,0,75,72
1650153191196,CSE 140L,A01,083088,Eldon; John,0,2,75,75
1650153197222,CSE 175,A01,083665,Kumar; Rakesh,8,0,25,17
1650153203244,CSE 190,A00,092507,Dubnov; Shlomo,14,0,20,6
1650153209269,ECE 45,A01,083139,Staff,0,13,40,40
1650153215299,ECE 65,A50,083695,Staff,0,4,30,30
1650153221325,ECE 109,A01,091882,Touri; Behrouz,48,0,70,22
1650153227351,ECE 180,A00,083140,Abi Samra; Nicholas Camill,24,0,30,6
1650153227351,ECE 180,B00,083141,Abi Samra; Nicholas Camill,8,0,30,22
1650153233375,MATH 10A,A01,083735,Patchell; Gregory David,12,0,30,18
1650153233375,MATH 10A,A02,083736,Patchell; Gregory David,28,0,30,2
1650153233375,MATH 10A,A03,083737,Patchell; Gregory David,26,0,30,4
1650153239401,MATH 10B,A01,083207,Staff,0,5,30,30
1650153239401,MATH 10B,A02,083208,Staff,0,4,30,30
1650153239401,MATH 10B,B01,083739,Staff,18,0,30,12
1650153239401,MATH 10B,B02,083740,Staff,29,0,30,1
1650153245426,MATH 18,A01,083743,Staff,10,0,30,20
1650153245426,MATH 18,A02,083744,Staff,28,0,30,2
1650153245426,MATH 18,A03,083745,Staff,23,0,30,7
1650153245426,MATH 18,A04,083746,Staff,27,0,30,3
1650153245426,MATH 18,B01,083748,Staff,0,10,30,30
1650153245426,MATH 18,B02,083749,Staff,0,7,30,30
1650153245426,MATH 18,B03,083750,Staff,0,6,30,30
1650153245426,MATH 18,B04,083751,Staff,0,7,30,30
1650153251451,MATH 20A,A01,083754,Staff,26,0,40,14
1650153257484,MATH 20B,A01,083756,Staff,0,5,30,30
1650153257484,MATH 20B,A02,083757,Staff,0,4,30,30
1650153263511,MATH 20C,A01,083760,Staff,0,11,30,30
1650153263511,MATH 20C,A02,083761,Staff,0,12,30,30
1650153263511,MATH 20C,B01,083762,Staff,14,0,30,16
1650153263511,MATH 20C,B02,083763,Staff,28,0,30,2
1650153269537,MATH 20D,A01,083765,Staff,0,2,30,30
1650153269537,MATH 20D,A02,083766,Staff,10,0,30,20
1650153269537,MATH 20D,A03,083767,Staff,28,0,30,2
1650153275564,MATH 20E,A01,083771,Staff,8,0,30,22
1650153275564,MATH 20E,A02,083772,Staff,20,0,30,10
1650153275564,MATH 20E,B01,083773,Staff,0,0,30,30
1650153275564,MATH 20E,B02,083774,Staff,13,0,30,17
1650153281587,MATH 103A,A01,083777,Staff,0,8,30,30
1650153281587,MATH 103A,A02,083778,Staff,0,8,30,30
1650153281587,MATH 103A,B01,083779,Staff,0,9,30,30
1650153281587,MATH 103A,B02,083780,Staff,0,7,30,30
1650153287612,MATH 105,A01,085443,Staff,0,14,30,30
1650153293635,MATH 109,A01,083213,Anzaldo; Leesa B,0,3,30,30
1650153293635,MATH 109,A02,083214,Anzaldo; Leesa B,0,6,30,30
1650153293635,MATH 109,B01,083215,Anzaldo; Leesa B,0,4,30,30
1650153293635,MATH 109,B02,083216,Anzaldo; Leesa B,0,4,30,30
1650153299659,MATH 142A,A01,083219,Chow; Bennett,0,11,30,30
1650153299659,MATH 142A,A02,083220,Chow; Bennett,0,11,30,30
1650153299659,MATH 142A,B01,083221,Chow; Bennett,0,10,30,30
1650153299659,MATH 142A,B02,083222,Chow; Bennett,0,11,30,30
1650153305687,MATH 193A,A01,083224,Staff,0,3,30,30
1650153305687,MATH 193A,A02,083225,Staff,0,4,30,30
1650153305687,MATH 193A,A03,083781,Staff,0,0,30,30
1650153305687,MATH 193A,A04,083782,Staff,0,0,30,30
1650153311719,MATH 197,001,091859,McAuley; Julian John,9998,0,9999,1
1650153317771,COGS 9,A01,083615,Staff,0,14,60,60
1650153323801,COGS 11,A01,083617,Boyle; Mary E. T.,24,0,40,16
1650153329828,COGS 13,A01,083071,Staff,0,29,40,40
1650153335859,COGS 14A,A01,092681,Staff,0,10,100,100
1650153341885,COGS 14B,A01,083073,Cheng; Tzu-Han,0,5,50,50
1650153347911,COGS 17,A01,092677,Staff,34,0,75,41
1650153353935,COGS 100,A01,083619,Staff,0,21,60,60
1650153359958,COGS 101A,A01,083621,Davis; Joshua Daniel,0,20,60,60
1650153365985,COGS 101B,A01,091572,Staff,9,0,60,51
1650153372012,COGS 101C,A01,083625,Delgado; Tania,21,0,30,9
1650153378046,COGS 107A,A01,083627,Boyle; Mary E. T.,0,6,60,60
1650153384069,COGS 118A,A01,083075,Staff,17,0,60,43
1650153390106,CSE 3,A50,083646,Miranda; Gregory Joseph,22,0,38,16
1650153390106,CSE 3,A51,083647,Miranda; Gregory Joseph,37,0,37,0
1650153396133,CSE 8A,A50,083650,Miranda; Gregory Joseph,0,17,40,40
1650153402162,CSE 11,A01,083080,Cao; Yingjun,0,66,40,40
1650153408190,CSE 12,A01,083652,Staff,0,5,100,100
1650153414215,CSE 15L,A01,083654,Staff,0,0,50,50
1650153414215,CSE 15L,A02,083655,Staff,8,0,50,42
1650153420239,CSE 20,A01,083657,Staff,54,0,80,26
1650153426272,CSE 30,A01,083084,Eldon; John,0,64,40,40
1650153432299,CSE 100,A01,083659,Cao; Yingjun,0,61,50,50
1650153438327,CSE 134B,A01,083661,Powell; Thomas Allan,0,27,65,65
1650153444350,CSE 140,A01,083663,Staff,3,0,75,72
1650153450374,CSE 140L,A01,083088,Eldon; John,0,2,75,75
1650153456399,CSE 175,A01,083665,Kumar; Rakesh,8,0,25,17
1650153462426,CSE 190,A00,092507,Dubnov; Shlomo,14,0,20,6
1650153468449,ECE 45,A01,083139,Staff,0,13,40,40
1650153474476,ECE 65,A50,083695,Staff,0,4,30,30
1650153480499,ECE 109,A01,091882,Touri; Behrouz,48,0,70,22
1650153486524,ECE 180,A00,083140,Abi Samra; Nicholas Camill,24,0,30,6
1650153486524,ECE 180,B00,083141,Abi Samra; Nicholas Camill,8,0,30,22
1650153492548,MATH 10A,A01,083735,Patchell; Gregory David,12,0,30,18
1650153492548,MATH 10A,A02,083736,Patchell; Gregory David,28,0,30,2
1650153492548,MATH 10A,A03,083737,Patchell; Gregory David,26,0,30,4
1650153498572,MATH 10B,A01,083207,Staff,0,5,30,30
1650153498572,MATH 10B,A02,083208,Staff,0,4,30,30
1650153498572,MATH 10B,B01,083739,Staff,18,0,30,12
1650153498572,MATH 10B,B02,083740,Staff,29,0,30,1
1650153504603,MATH 18,A01,083743,Staff,10,0,30,20
1650153504603,MATH 18,A02,083744,Staff,28,0,30,2
1650153504603,MATH 18,A03,083745,Staff,23,0,30,7
1650153504603,MATH 18,A04,083746,Staff,27,0,30,3
1650153504603,MATH 18,B01,083748,Staff,0,10,30,30
1650153504603,MATH 18,B02,083749,Staff,0,7,30,30
1650153504603,MATH 18,B03,083750,Staff,0,6,30,30
1650153504603,MATH 18,B04,083751,Staff,0,7,30,30
1650153510629,MATH 20A,A01,083754,Staff,26,0,40,14
1650153516655,MATH 20B,A01,083756,Staff,0,5,30,30
1650153516655,MATH 20B,A02,083757,Staff,0,4,30,30
1650153522679,MATH 20C,A01,083760,Staff,0,11,30,30
1650153522679,MATH 20C,A02,083761,Staff,0,12,30,30
1650153522679,MATH 20C,B01,083762,Staff,14,0,30,16
1650153522679,MATH 20C,B02,083763,Staff,28,0,30,2
1650153528701,MATH 20D,A01,083765,Staff,0,2,30,30
1650153528701,MATH 20D,A02,083766,Staff,10,0,30,20
1650153528701,MATH 20D,A03,083767,Staff,28,0,30,2
1650153534727,MATH 20E,A01,083771,Staff,8,0,30,22
1650153534727,MATH 20E,A02,083772,Staff,20,0,30,10
1650153534727,MATH 20E,B01,083773,Staff,0,0,30,30
1650153534727,MATH 20E,B02,083774,Staff,13,0,30,17
1650153540756,MATH 103A,A01,083777,Staff,0,8,30,30
1650153540756,MATH 103A,A02,083778,Staff,0,8,30,30
1650153540756,MATH 103A,B01,083779,Staff,0,9,30,30
1650153540756,MATH 103A,B02,083780,Staff,0,7,30,30
1650153546800,MATH 105,A01,085443,Staff,0,14,30,30
1650153552825,MATH 109,A01,083213,Anzaldo; Leesa B,0,3,30,30
1650153552825,MATH 109,A02,083214,Anzaldo; Leesa B,0,6,30,30
1650153552825,MATH 109,B01,083215,Anzaldo; Leesa B,0,4,30,30
1650153552825,MATH 109,B02,083216,Anzaldo; Leesa B,0,4,30,30
1650153558856,MATH 142A,A01,083219,Chow; Bennett,0,11,30,30
1650153558856,MATH 142A,A02,083220,Chow; Bennett,0,11,30,30
1650153558856,MATH 142A,B01,083221,Chow; Bennett,0,11,30,30
1650153558856,MATH 142A,B02,083222,Chow; Bennett,0,11,30,30
1650153564885,MATH 193A,A01,083224,Staff,0,3,30,30
1650153564885,MATH 193A,A02,083225,Staff,0,4,30,30
1650153564885,MATH 193A,A03,083781,Staff,0,0,30,30
1650153564885,MATH 193A,A04,083782,Staff,0,0,30,30
1650153570908,MATH 197,001,091859,McAuley; Julian John,9998,0,9999,1
1650153576978,COGS 9,A01,083615,Staff,0,14,60,60
1650153583002,COGS 11,A01,083617,Boyle; Mary E. T.,24,0,40,16
1650153589025,COGS 13,A01,083071,Staff,0,29,40,40
1650153595147,COGS 14A,A01,092681,Staff,0,10,100,100
1650153601184,COGS 14B,A01,083073,Cheng; Tzu-Han,0,5,50,50
1650153607223,COGS 17,A01,092677,Staff,34,0,75,41
1650153613245,COGS 100,A01,083619,Staff,0,21,60,60
1650153619270,COGS 101A,A01,083621,Davis; Joshua Daniel,0,20,60,60
1650153625296,COGS 101B,A01,091572,Staff,9,0,60,51
1650153631322,COGS 101C,A01,083625,Delgado; Tania,21,0,30,9
1650153637351,COGS 107A,A01,083627,Boyle; Mary E. T.,0,6,60,60
1650153643373,COGS 118A,A01,083075,Staff,17,0,60,43
1650153649401,CSE 3,A50,083646,Miranda; Gregory Joseph,22,0,38,16
1650153649401,CSE 3,A51,083647,Miranda; Gregory Joseph,37,0,37,0
1650153655425,CSE 8A,A50,083650,Miranda; Gregory Joseph,0,17,40,40
1650153661447,CSE 11,A01,083080,Cao; Yingjun,0,66,40,40
1650153667470,CSE 12,A01,083652,Staff,0,5,100,100
1650153673501,CSE 15L,A01,083654,Staff,0,0,50,50
1650153673501,CSE 15L,A02,083655,Staff,8,0,50,42
1650153679526,CSE 20,A01,083657,Staff,54,0,80,26
1650153685549,CSE 30,A01,083084,Eldon; John,0,64,40,40
1650153691576,CSE 100,A01,083659,Cao; Yingjun,0,61,50,50
1650153697597,CSE 134B,A01,083661,Powell; Thomas Allan,0,27,65,65
1650153703619,CSE 140,A01,083663,Staff,3,0,75,72
1650153709646,CSE 140L,A01,083088,Eldon; John,0,2,75,75
1650153715668,CSE 175,A01,083665,Kumar; Rakesh,8,0,25,17
1650153721696,CSE 190,A00,092507,Dubnov; Shlomo,14,0,20,6
1650153727735,ECE 45,A01,083139,Staff,0,13,40,40
1650153733762,ECE 65,A50,083695,Staff,0,4,30,30
1650153739788,ECE 109,A01,091882,Touri; Behrouz,48,0,70,22
1650153745817,ECE 180,A00,083140,Abi Samra; Nicholas Camill,24,0,30,6
1650153745817,ECE 180,B00,083141,Abi Samra; Nicholas Camill,8,0,30,22
1650153751842,MATH 10A,A01,083735,Patchell; Gregory David,12,0,30,18
1650153751842,MATH 10A,A02,083736,Patchell; Gregory David,28,0,30,2
1650153751842,MATH 10A,A03,083737,Patchell; Gregory David,26,0,30,4
1650153757865,MATH 10B,A01,083207,Staff,0,5,30,30
1650153757865,MATH 10B,A02,083208,Staff,0,4,30,30
1650153757865,MATH 10B,B01,083739,Staff,18,0,30,12
1650153757865,MATH 10B,B02,083740,Staff,29,0,30,1
1650153763894,MATH 18,A01,083743,Staff,10,0,30,20
1650153763894,MATH 18,A02,083744,Staff,28,0,30,2
1650153763894,MATH 18,A03,083745,Staff,23,0,30,7
1650153763894,MATH 18,A04,083746,Staff,27,0,30,3
1650153763894,MATH 18,B01,083748,Staff,0,10,30,30
1650153763894,MATH 18,B02,083749,Staff,0,7,30,30
1650153763894,MATH 18,B03,083750,Staff,0,6,30,30
1650153763894,MATH 18,B04,083751,Staff,0,7,30,30
1650153769918,MATH 20A,A01,083754,Staff,26,0,40,14
1650153775944,MATH 20B,A01,083756,Staff,0,5,30,30
1650153775944,MATH 20B,A02,083757,Staff,0,4,30,30
1650153781975,MATH 20C,A01,083760,Staff,0,11,30,30
1650153781975,MATH 20C,A02,083761,Staff,0,12,30,30
1650153781975,MATH 20C,B01,083762,Staff,14,0,30,16
1650153781975,MATH 20C,B02,083763,Staff,28,0,30,2
1650153788003,MATH 20D,A01,083765,Staff,0,2,30,30
1650153788003,MATH 20D,A02,083766,Staff,10,0,30,20
1650153788003,MATH 20D,A03,083767,Staff,28,0,30,2
1650153794030,MATH 20E,A01,083771,Staff,8,0,30,22
1650153794030,MATH 20E,A02,083772,Staff,20,0,30,10
1650153794030,MATH 20E,B01,083773,Staff,0,0,30,30
1650153794030,MATH 20E,B02,083774,Staff,13,0,30,17
1650153800061,MATH 103A,A01,083777,Staff,0,8,30,30
1650153800061,MATH 103A,A02,083778,Staff,0,8,30,30
1650153800061,MATH 103A,B01,083779,Staff,0,9,30,30
1650153800061,MATH 103A,B02,083780,Staff,0,7,30,30
1650153806089,MATH 105,A01,085443,Staff,0,14,30,30
1650153812112,MATH 109,A01,083213,Anzaldo; Leesa B,0,3,30,30
1650153812112,MATH 109,A02,083214,Anzaldo; Leesa B,0,6,30,30
1650153812112,MATH 109,B01,083215,Anzaldo; Leesa B,0,4,30,30
1650153812112,MATH 109,B02,083216,Anzaldo; Leesa B,0,4,30,30
1650153818146,MATH 142A,A01,083219,Chow; Bennett,0,11,30,30
1650153818146,MATH 142A,A02,083220,Chow; Bennett,0,11,30,30
1650153818146,MATH 142A,B01,083221,Chow; Bennett,0,11,30,30
1650153818146,MATH 142A,B02,083222,Chow; Bennett,0,11,30,30
1650153824169,MATH 193A,A01,083224,Staff,0,3,30,30
1650153824169,MATH 193A,A02,083225,Staff,0,4,30,30
1650153824169,MATH 193A,A03,083781,Staff,0,0,30,30
1650153824169,MATH 193A,A04,083782,Staff,0,0,30,30
1650153830194,MATH 197,001,091859,McAuley; Julian John,9998,0,9999,1
1650153836250,COGS 9,A01,083615,Staff,0,14,60,60
1650153842276,COGS 11,A01,083617,Boyle; Mary E. T.,24,0,40,16
1650153848297,COGS 13,A01,083071,Staff,0,29,40,40
1650153854321,COGS 14A,A01,092681,Staff,0,10,100,100
1650153860344,COGS 14B,A01,083073,Cheng; Tzu-Han,0,5,50,50
1650153866367,COGS 17,A01,092677,Staff,34,0,75,41
1650153872394,COGS 100,A01,083619,Staff,0,21,60,60
1650153878419,COGS 101A,A01,083621,Davis; Joshua Daniel,0,20,60,60
1650153884441,COGS 101B,A01,091572,Staff,9,0,60,51
1650153890464,COGS 101C,A01,083625,Delgado; Tania,21,0,30,9
1650153896488,COGS 107A,A01,083627,Boyle; Mary E. T.,0,6,60,60
1650153902516,COGS 118A,A01,083075,Staff,17,0,60,43
1650153908540,CSE 3,A50,083646,Miranda; Gregory Joseph,22,0,38,16
1650153908540,CSE 3,A51,083647,Miranda; Gregory Joseph,37,0,37,0
1650153914563,CSE 8A,A50,083650,Miranda; Gregory Joseph,0,17,40,40
1650153920586,CSE 11,A01,083080,Cao; Yingjun,0,66,40,40
1650153926613,CSE 12,A01,083652,Staff,0,5,100,100
1650153932641,CSE 15L,A01,083654,Staff,0,0,50,50
1650153932641,CSE 15L,A02,083655,Staff,8,0,50,42
1650153938669,CSE 20,A01,083657,Staff,54,0,80,26
1650153944698,CSE 30,A01,083084,Eldon; John,0,64,40,40
1650153950725,CSE 100,A01,083659,Cao; Yingjun,0,61,50,50
1650153956749,CSE 134B,A01,083661,Powell; Thomas Allan,0,27,65,65
1650153962777,CSE 140,A01,083663,Staff,3,0,75,72
1650153968807,CSE 140L,A01,083088,Eldon; John,0,2,75,75
1650153974829,CSE 175,A01,083665,Kumar; Rakesh,8,0,25,17
1650153980858,CSE 190,A00,092507,Dubnov; Shlomo,14,0,20,6
1650153986884,ECE 45,A01,083139,Staff,0,13,40,40
1650153992912,ECE 65,A50,083695,Staff,0,4,30,30
1650153998939,ECE 109,A01,091882,Touri; Behrouz,48,0,70,22
1650154004962,ECE 180,A00,083140,Abi Samra; Nicholas Camill,24,0,30,6
1650154004962,ECE 180,B00,083141,Abi Samra; Nicholas Camill,8,0,30,22
1650154010990,MATH 10A,A01,083735,Patchell; Gregory David,12,0,30,18
1650154010990,MATH 10A,A02,083736,Patchell; Gregory David,28,0,30,2
1650154010990,MATH 10A,A03,083737,Patchell; Gregory David,26,0,30,4
1650154017013,MATH 10B,A01,083207,Staff,0,5,30,30
1650154017013,MATH 10B,A02,083208,Staff,0,4,30,30
1650154017013,MATH 10B,B01,083739,Staff,18,0,30,12
1650154017013,MATH 10B,B02,083740,Staff,29,0,30,1
1650154023038,MATH 18,A01,083743,Staff,10,0,30,20
1650154023038,MATH 18,A02,083744,Staff,28,0,30,2
1650154023038,MATH 18,A03,083745,Staff,23,0,30,7
1650154023038,MATH 18,A04,083746,Staff,27,0,30,3
1650154023038,MATH 18,B01,083748,Staff,0,10,30,30
1650154023038,MATH 18,B02,083749,Staff,0,7,30,30
1650154023038,MATH 18,B03,083750,Staff,0,6,30,30
1650154023038,MATH 18,B04,083751,Staff,0,7,30,30
1650154029061,MATH 20A,A01,083754,Staff,26,0,40,14
1650154035088,MATH 20B,A01,083756,Staff,0,5,30,30
1650154035088,MATH 20B,A02,083757,Staff,0,4,30,30
1650154041125,MATH 20C,A01,083760,Staff,0,11,30,30
1650154041125,MATH 20C,A02,083761,Staff,0,12,30,30
1650154041125,MATH 20C,B01,083762,Staff,14,0,30,16
1650154041125,MATH 20C,B02,083763,Staff,28,0,30,2
1650154047153,MATH 20D,A01,083765,Staff,0,2,30,30
1650154047153,MATH 20D,A02,083766,Staff,10,0,30,20
1650154047153,MATH 20D,A03,083767,Staff,28,0,30,2
1650154053181,MATH 20E,A01,083771,Staff,8,0,30,22
1650154053181,MATH 20E,A02,083772,Staff,20,0,30,10
1650154053181,MATH 20E,B01,083773,Staff,0,0,30,30
1650154053181,MATH 20E,B02,083774,Staff,13,0,30,17
1650154059206,MATH 103A,A01,083777,Staff,0,8,30,30
1650154059206,MATH 103A,A02,083778,Staff,0,8,30,30
1650154059206,MATH 103A,B01,083779,Staff,0,10,30,30
1650154059206,MATH 103A,B02,083780,Staff,0,7,30,30
1650154065229,MATH 105,A01,085443,Staff,0,14,30,30
1650154071256,MATH 109,A01,083213,Anzaldo; Leesa B,0,3,30,30
1650154071256,MATH 109,A02,083214,Anzaldo; Leesa B,0,6,30,30
1650154071256,MATH 109,B01,083215,Anzaldo; Leesa B,0,4,30,30
1650154071256,MATH 109,B02,083216,Anzaldo; Leesa B,0,4,30,30
1650154077285,MATH 142A,A01,083219,Chow; Bennett,0,11,30,30
1650154077285,MATH 142A,A02,083220,Chow; Bennett,0,11,30,30
1650154077285,MATH 142A,B01,083221,Chow; Bennett,0,11,30,30
1650154077285,MATH 142A,B02,083222,Chow; Bennett,0,11,30,30
1650154083313,MATH 193A,A01,083224,Staff,0,3,30,30
1650154083313,MATH 193A,A02,083225,Staff,0,4,30,30
1650154083313,MATH 193A,A03,083781,Staff,0,0,30,30
1650154083313,MATH 193A,A04,083782,Staff,0,0,30,30
1650154089340,MATH 197,001,091859,McAuley; Julian John,9998,0,9999,1
1650154095394,COGS 9,A01,083615,Staff,0,14,60,60
1650154101417,COGS 11,A01,083617,Boyle; Mary E. T.,24,0,40,16
1650154107450,COGS 13,A01,083071,Staff,0,29,40,40
1650154113473,COGS 14A,A01,092681,Staff,0,10,100,100
1650154119502,COGS 14B,A01,083073,Cheng; Tzu-Han,0,5,50,50
1650154125527,COGS 17,A01,092677,Staff,34,0,75,41
1650154131551,COGS 100,A01,083619,Staff,0,21,60,60
1650154137580,COGS 101A,A01,083621,Davis; Joshua Daniel,0,21,60,60
1650154143603,COGS 101B,A01,091572,Staff,9,0,60,51
1650154149631,COGS 101C,A01,083625,Delgado; Tania,21,0,30,9
1650154155653,COGS 107A,A01,083627,Boyle; Mary E. T.,0,6,60,60
1650154161677,COGS 118A,A01,083075,Staff,17,0,60,43
1650154167703,CSE 3,A50,083646,Miranda; Gregory Joseph,22,0,38,16
1650154167703,CSE 3,A51,083647,Miranda; Gregory Joseph,37,0,37,0
1650154173728,CSE 8A,A50,083650,Miranda; Gregory Joseph,0,17,40,40
1650154179755,CSE 11,A01,083080,Cao; Yingjun,0,66,40,40
1650154185780,CSE 12,A01,083652,Staff,0,5,100,100
1650154191884,CSE 15L,A01,083654,Staff,0,0,50,50
1650154191884,CSE 15L,A02,083655,Staff,8,0,50,42
1650154197908,CSE 20,A01,083657,Staff,54,0,80,26
1650154203943,CSE 30,A01,083084,Eldon; John,0,64,40,40
1650154209966,CSE 100,A01,083659,Cao; Yingjun,0,61,50,50
1650154215990,CSE 134B,A01,083661,Powell; Thomas Allan,0,27,65,65
1650154222016,CSE 140,A01,083663,Staff,3,0,75,72
1650154228045,CSE 140L,A01,083088,Eldon; John,0,2,75,75
1650154234069,CSE 175,A01,083665,Kumar; Rakesh,8,0,25,17
1650154240096,CSE 190,A00,092507,Dubnov; Shlomo,14,0,20,6
1650154246126,ECE 45,A01,083139,Staff,0,13,40,40
1650154252149,ECE 65,A50,083695,Staff,0,4,30,30
1650154258175,ECE 109,A01,091882,Touri; Behrouz,48,0,70,22
1650154264198,ECE 180,A00,083140,Abi Samra; Nicholas Camill,24,0,30,6
1650154264198,ECE 180,B00,083141,Abi Samra; Nicholas Camill,8,0,30,22
1650154270222,MATH 10A,A01,083735,Patchell; Gregory David,12,0,30,18
1650154270222,MATH 10A,A02,083736,Patchell; Gregory David,28,0,30,2
1650154270222,MATH 10A,A03,083737,Patchell; Gregory David,26,0,30,4
1650154276249,MATH 10B,A01,083207,Staff,0,5,30,30
1650154276249,MATH 10B,A02,083208,Staff,0,4,30,30
1650154276249,MATH 10B,B01,083739,Staff,18,0,30,12
1650154276249,MATH 10B,B02,083740,Staff,29,0,30,1
1650154282277,MATH 18,A01,083743,Staff,10,0,30,20
1650154282277,MATH 18,A02,083744,Staff,28,0,30,2
1650154282277,MATH 18,A03,083745,Staff,23,0,30,7
1650154282277,MATH 18,A04,083746,Staff,27,0,30,3
1650154282277,MATH 18,B01,083748,Staff,0,10,30,30
1650154282277,MATH 18,B02,083749,Staff,0,7,30,30
1650154282277,MATH 18,B03,083750,Staff,0,6,30,30
1650154282277,MATH 18,B04,083751,Staff,0,7,30,30
1650154288301,MATH 20A,A01,083754,Staff,26,0,40,14
1650154294325,MATH 20B,A01,083756,Staff,0,5,30,30
1650154294325,MATH 20B,A02,083757,Staff,0,4,30,30
1650154300352,MATH 20C,A01,083760,Staff,0,11,30,30
1650154300352,MATH 20C,A02,083761,Staff,0,12,30,30
1650154300352,MATH 20C,B01,083762,Staff,14,0,30,16
1650154300352,MATH 20C,B02,083763,Staff,28,0,30,2
1650154306374,MATH 20D,A01,083765,Staff,0,2,30,30
1650154306374,MATH 20D,A02,083766,Staff,10,0,30,20
1650154306374,MATH 20D,A03,083767,Staff,28,0,30,2
1650154312402,MATH 20E,A01,083771,Staff,8,0,30,22
1650154312402,MATH 20E,A02,083772,Staff,20,0,30,10
1650154312402,MATH 20E,B01,083773,Staff,0,0,30,30
1650154312402,MATH 20E,B02,083774,Staff,13,0,30,17
1650154318429,MATH 103A,A01,083777,Staff,0,8,30,30
1650154318429,MATH 103A,A02,083778,Staff,0,9,30,30
1650154318429,MATH 103A,B01,083779,Staff,0,10,30,30
1650154318429,MATH 103A,B02,083780,Staff,0,7,30,30
1650154324452,MATH 105,A01,085443,Staff,0,14,30,30
1650154330479,MATH 109,A01,083213,Anzaldo; Leesa B,0,3,30,30
1650154330479,MATH 109,A02,083214,Anzaldo; Leesa B,0,6,30,30
1650154330479,MATH 109,B01,083215,Anzaldo; Leesa B,0,4,30,30
1650154330479,MATH 109,B02,083216,Anzaldo; Leesa B,0,4,30,30
1650154336503,MATH 142A,A01,083219,Chow; Bennett,0,11,30,30
1650154336503,MATH 142A,A02,083220,Chow; Bennett,0,11,30,30
1650154336503,MATH 142A,B01,083221,Chow; Bennett,0,11,30,30
1650154336503,MATH 142A,B02,083222,Chow; Bennett,0,11,30,30
1650154342527,MATH 193A,A01,083224,Staff,0,3,30,30
1650154342527,MATH 193A,A02,083225,Staff,0,4,30,30
1650154342527,MATH 193A,A03,083781,Staff,0,0,30,30
1650154342527,MATH 193A,A04,083782,Staff,0,0,30,30
1650154348552,MATH 197,001,091859,McAuley; Julian John,9998,0,9999,1
1650154354604,COGS 9,A01,083615,Staff,0,14,60,60
1650154360627,COGS 11,A01,083617,Boyle; Mary E. T.,24,0,40,16
1650154366654,COGS 13,A01,083071,Staff,0,29,40,40
1650154372679,COGS 14A,A01,092681,Staff,0,10,100,100
1650154378706,COGS 14B,A01,083073,Cheng; Tzu-Han,0,5,50,50
1650154384728,COGS 17,A01,092677,Staff,34,0,75,41
1650154390759,COGS 100,A01,083619,Staff,0,21,60,60
1650154396787,COGS 101A,A01,083621,Davis; Joshua Daniel,0,21,60,60
1650154402811,COGS 101B,A01,091572,Staff,9,0,60,51
1650154408835,COGS 101C,A01,083625,Delgado; Tania,21,0,30,9
1650154414858,COGS 107A,A01,083627,Boyle; Mary E. T.,0,6,60,60
1650154420882,COGS 118A,A01,083075,Staff,17,0,60,43
1650154426906,CSE 3,A50,083646,Miranda; Gregory Joseph,22,0,38,16
1650154426906,CSE 3,A51,083647,Miranda; Gregory Joseph,37,0,37,0
1650154432934,CSE 8A,A50,083650,Miranda; Gregory Joseph,0,17,40,40
1650154438962,CSE 11,A01,083080,Cao; Yingjun,0,66,40,40
1650154444985,CSE 12,A01,083652,Staff,0,5,100,100
1650154451010,CSE 15L,A01,083654,Staff,0,0,50,50
1650154451010,CSE 15L,A02,083655,Staff,8,0,50,42
1650154457033,CSE 20,A01,083657,Staff,54,0,80,26
1650154463056,CSE 30,A01,083084,Eldon; John,0,64,40,40
1650154469080,CSE 100,A01,083659,Cao; Yingjun,0,61,50,50
1650154475105,CSE 134B,A01,083661,Powell; Thomas Allan,0,27,65,65
1650154481130,CSE 140,A01,083663,Staff,3,0,75,72
1650154487154,CSE 140L,A01,083088,Eldon; John,0,2,75,75
1650154493178,CSE 175,A01,083665,Kumar; Rakesh,8,0,25,17
1650154499205,CSE 190,A00,092507,Dubnov; Shlomo,14,0,20,6
1650154505227,ECE 45,A01,083139,Staff,0,13,40,40
1650154511250,ECE 65,A50,083695,Staff,0,4,30,30
1650154517273,ECE 109,A01,091882,Touri; Behrouz,48,0,70,22
1650154523298,ECE 180,A00,083140,Abi Samra; Nicholas Camill,24,0,30,6
1650154523298,ECE 180,B00,083141,Abi Samra; Nicholas Camill,8,0,30,22
1650154529322,MATH 10A,A01,083735,Patchell; Gregory David,12,0,30,18
1650154529322,MATH 10A,A02,083736,Patchell; Gregory David,28,0,30,2
1650154529322,MATH 10A,A03,083737,Patchell; Gregory David,26,0,30,4
1650154535344,MATH 10B,A01,083207,Staff,0,5,30,30
1650154535344,MATH 10B,A02,083208,Staff,0,4,30,30
1650154535344,MATH 10B,B01,083739,Staff,18,0,30,12
1650154535344,MATH 10B,B02,083740,Staff,29,0,30,1
1650154541374,MATH 18,A01,083743,Staff,10,0,30,20
1650154541374,MATH 18,A02,083744,Staff,28,0,30,2
1650154541374,MATH 18,A03,083745,Staff,23,0,30,7
1650154541374,MATH 18,A04,083746,Staff,27,0,30,3
1650154541374,MATH 18,B01,083748,Staff,0,10,30,30
1650154541374,MATH 18,B02,083749,Staff,0,7,30,30
1650154541374,MATH 18,B03,083750,Staff,0,6,30,30
1650154541374,MATH 18,B04,083751,Staff,0,7,30,30
1650154547401,MATH 20A,A01,083754,Staff,26,0,40,14
1650154553424,MATH 20B,A01,083756,Staff,0,5,30,30
1650154553424,MATH 20B,A02,083757,Staff,0,4,30,30
1650154559460,MATH 20C,A01,083760,Staff,0,11,30,30
1650154559460,MATH 20C,A02,083761,Staff,0,12,30,30
1650154559460,MATH 20C,B01,083762,Staff,14,0,30,16
1650154559460,MATH 20C,B02,083763,Staff,28,0,30,2
1650154565486,MATH 20D,A01,083765,Staff,0,2,30,30
1650154565486,MATH 20D,A02,083766,Staff,10,0,30,20
1650154565486,MATH 20D,A03,083767,Staff,28,0,30,2
1650154571510,MATH 20E,A01,083771,Staff,8,0,30,22
1650154571510,MATH 20E,A02,083772,Staff,20,0,30,10
1650154571510,MATH 20E,B01,083773,Staff,0,0,30,30
1650154571510,MATH 20E,B02,083774,Staff,13,0,30,17
1650154577549,MATH 103A,A01,083777,Staff,0,8,30,30
1650154577549,MATH 103A,A02,083778,Staff,0,9,30,30
1650154577549,MATH 103A,B01,083779,Staff,0,10,30,30
1650154577549,MATH 103A,B02,083780,Staff,0,7,30,30
1650154583576,MATH 105,A01,085443,Staff,0,14,30,30
1650154589599,MATH 109,A01,083213,Anzaldo; Leesa B,0,3,30,30
1650154589599,MATH 109,A02,083214,Anzaldo; Leesa B,0,6,30,30
1650154589599,MATH 109,B01,083215,Anzaldo; Leesa B,0,4,30,30
1650154589599,MATH 109,B02,083216,Anzaldo; Leesa B,0,4,30,30
1650154595629,MATH 142A,A01,083219,Chow; Bennett,0,11,30,30
1650154595629,MATH 142A,A02,083220,Chow; Bennett,0,11,30,30
1650154595629,MATH 142A,B01,083221,Chow; Bennett,0,11,30,30
1650154595629,MATH 142A,B02,083222,Chow; Bennett,0,11,30,30
1650154601656,MATH 193A,A01,083224,Staff,0,3,30,30
1650154601656,MATH 193A,A02,083225,Staff,0,4,30,30
1650154601656,MATH 193A,A03,083781,Staff,0,0,30,30
1650154601656,MATH 193A,A04,083782,Staff,0,0,30,30
1650154607678,MATH 197,001,091859,McAuley; Julian John,9998,0,9999,1
1650154613742,COGS 9,A01,083615,Staff,0,14,60,60
1650154619774,COGS 11,A01,083617,Boyle; Mary E. T.,24,0,40,16
1650154625797,COGS 13,A01,083071,Staff,0,29,40,40
1650154631820,COGS 14A,A01,092681,Staff,0,10,100,100
1650154637844,COGS 14B,A01,083073,Cheng; Tzu-Han,0,5,50,50
1650154643868,COGS 17,A01,092677,Staff,34,0,75,41
1650154649892,COGS 100,A01,083619,Staff,0,21,60,60
1650154655920,COGS 101A,A01,083621,Davis; Joshua Daniel,0,21,60,60
1650154661943,COGS 101B,A01,091572,Staff,9,0,60,51
1650154667971,COGS 101C,A01,083625,Delgado; Tania,21,0,30,9
1650154673995,COGS 107A,A01,083627,Boyle; Mary E. T.,0,6,60,60
1650154680016,COGS 118A,A01,083075,Staff,17,0,60,43
1650154686044,CSE 3,A50,083646,Miranda; Gregory Joseph,22,0,38,16
1650154686044,CSE 3,A51,083647,Miranda; Gregory Joseph,37,0,37,0
1650154692075,CSE 8A,A50,083650,Miranda; Gregory Joseph,0,17,40,40
1650154698101,CSE 11,A01,083080,Cao; Yingjun,0,66,40,40
1650154704127,CSE 12,A01,083652,Staff,0,5,100,100
1650154710151,CSE 15L,A01,083654,Staff,0,0,50,50
1650154710151,CSE 15L,A02,083655,Staff,8,0,50,42
1650154716174,CSE 20,A01,083657,Staff,54,0,80,26
1650154722198,CSE 30,A01,083084,Eldon; John,0,64,40,40
1650154728221,CSE 100,A01,083659,Cao; Yingjun,0,61,50,50
1650154734243,CSE 134B,A01,083661,Powell; Thomas Allan,0,27,65,65
1650154740271,CSE 140,A01,083663,Staff,3,0,75,72
1650154746294,CSE 140L,A01,083088,Eldon; John,0,2,75,75
1650154752320,CSE 175,A01,083665,Kumar; Rakesh,8,0,25,17
1650154758347,CSE 190,A00,092507,Dubnov; Shlomo,14,0,20,6
1650154764370,ECE 45,A01,083139,Staff,0,13,40,40
1650154770396,ECE 65,A50,083695,Staff,0,4,30,30
1650154776424,ECE 109,A01,091882,Touri; Behrouz,48,0,70,22
1650154782452,ECE 180,A00,083140,Abi Samra; Nicholas Camill,24,0,30,6
1650154782452,ECE 180,B00,083141,Abi Samra; Nicholas Camill,8,0,30,22
1650154788553,MATH 10A,A01,083735,Patchell; Gregory David,12,0,30,18
1650154788553,MATH 10A,A02,083736,Patchell; Gregory David,28,0,30,2
1650154788553,MATH 10A,A03,083737,Patchell; Gregory David,26,0,30,4
1650154794576,MATH 10B,A01,083207,Staff,0,5,30,30
1650154794576,MATH 10B,A02,083208,Staff,0,4,30,30
1650154794576,MATH 10B,B01,083739,Staff,18,0,30,12
1650154794576,MATH 10B,B02,083740,Staff,29,0,30,1
1650154800607,MATH 18,A01,083743,Staff,10,0,30,20
1650154800607,MATH 18,A02,083744,Staff,28,0,30,2
1650154800607,MATH 18,A03,083745,Staff,23,0,30,7
1650154800607,MATH 18,A04,083746,Staff,27,0,30,3
1650154800607,MATH 18,B01,083748,Staff,0,10,30,30
1650154800607,MATH 18,B02,083749,Staff,0,7,30,30
1650154800607,MATH 18,B03,083750,Staff,0,6,30,30
1650154800607,MATH 18,B04,083751,Staff,0,7,30,30
1650154806631,MATH 20A,A01,083754,Staff,26,0,40,14
1650154812659,MATH 20B,A01,083756,Staff,0,5,30,30
1650154812659,MATH 20B,A02,083757,Staff,0,4,30,30
1650154818689,MATH 20C,A01,083760,Staff,0,11,30,30
1650154818689,MATH 20C,A02,083761,Staff,0,12,30,30
1650154818689,MATH 20C,B01,083762,Staff,14,0,30,16
1650154818689,MATH 20C,B02,083763,Staff,28,0,30,2
1650154824712,MATH 20D,A01,083765,Staff,0,2,30,30
1650154824712,MATH 20D,A02,083766,Staff,10,0,30,20
1650154824712,MATH 20D,A03,083767,Staff,28,0,30,2
1650154830737,MATH 20E,A01,083771,Staff,8,0,30,22
1650154830737,MATH 20E,A02,083772,Staff,20,0,30,10
1650154830737,MATH 20E,B01,083773,Staff,0,0,30,30
1650154830737,MATH 20E,B02,083774,Staff,13,0,30,17
1650154836766,MATH 103A,A01,083777,Staff,0,8,30,30
1650154836766,MATH 103A,A02,083778,Staff,0,9,30,30
1650154836766,MATH 103A,B01,083779,Staff,0,10,30,30
1650154836766,MATH 103A,B02,083780,Staff,0,7,30,30
1650154842790,MATH 105,A01,085443,Staff,0,14,30,30
1650154848824,MATH 109,A01,083213,Anzaldo; Leesa B,0,3,30,30
1650154848824,MATH 109,A02,083214,Anzaldo; Leesa B,0,6,30,30
1650154848824,MATH 109,B01,083215,Anzaldo; Leesa B,0,4,30,30
1650154848824,MATH 109,B02,083216,Anzaldo; Leesa B,0,4,30,30
1650154854853,MATH 142A,A01,083219,Chow; Bennett,0,11,30,30
1650154854853,MATH 142A,A02,083220,Chow; Bennett,0,11,30,30
1650154854853,MATH 142A,B01,083221,Chow; Bennett,0,11,30,30
1650154854853,MATH 142A,B02,083222,Chow; Bennett,0,11,30,30
1650154860879,MATH 193A,A01,083224,Staff,0,3,30,30
1650154860879,MATH 193A,A02,083225,Staff,0,4,30,30
1650154860879,MATH 193A,A03,083781,Staff,0,0,30,30
1650154860879,MATH 193A,A04,083782,Staff,0,0,30,30
1650154866902,MATH 197,001,091859,McAuley; Julian John,9998,0,9999,1
1650154872964,COGS 9,A01,083615,Staff,0,14,60,60
1650154878994,COGS 11,A01,083617,Boyle; Mary E. T.,24,0,40,16
1650154885018,COGS 13,A01,083071,Staff,0,29,40,40
1650154891041,COGS 14A,A01,092681,Staff,0,10,100,100
1650154897062,COGS 14B,A01,083073,Cheng; Tzu-Han,0,5,50,50
1650154903086,COGS 17,A01,092677,Staff,34,0,75,41
1650154909108,COGS 100,A01,083619,Staff,0,21,60,60
1650154915136,COGS 101A,A01,083621,Davis; Joshua Daniel,0,21,60,60
1650154921160,COGS 101B,A01,091572,Staff,9,0,60,51
1650154927183,COGS 101C,A01,083625,Delgado; Tania,21,0,30,9
1650154933207,COGS 107A,A01,083627,Boyle; Mary E. T.,0,6,60,60
1650154939229,COGS 118A,A01,083075,Staff,17,0,60,43
1650154945253,CSE 3,A50,083646,Miranda; Gregory Joseph,22,0,38,16
1650154945253,CSE 3,A51,083647,Miranda; Gregory Joseph,37,0,37,0
1650154951278,CSE 8A,A50,083650,Miranda; Gregory Joseph,0,17,40,40
1650154957302,CSE 11,A01,083080,Cao; Yingjun,0,66,40,40
1650154963325,CSE 12,A01,083652,Staff,0,5,100,100
1650154969350,CSE 15L,A01,083654,Staff,0,0,50,50
1650154969350,CSE 15L,A02,083655,Staff,8,0,50,42
1650154975378,CSE 20,A01,083657,Staff,54,0,80,26
1650154981405,CSE 30,A01,083084,Eldon; John,0,64,40,40
1650154987427,CSE 100,A01,083659,Cao; Yingjun,0,61,50,50
1650154993453,CSE 134B,A01,083661,Powell; Thomas Allan,0,27,65,65
1650154999476,CSE 140,A01,083663,Staff,3,0,75,72
1650155005503,CSE 140L,A01,083088,Eldon; John,0,2,75,75
1650155011528,CSE 175,A01,083665,Kumar; Rakesh,8,0,25,17
1650155017554,CSE 190,A00,092507,Dubnov; Shlomo,14,0,20,6
1650155023585,ECE 45,A01,083139,Staff,0,13,40,40
1650155029612,ECE 65,A50,083695,Staff,0,4,30,30
1650155035635,ECE 109,A01,091882,Touri; Behrouz,48,0,70,22
1650155041661,ECE 180,A00,083140,Abi Samra; Nicholas Camill,24,0,30,6
1650155041661,ECE 180,B00,083141,Abi Samra; Nicholas Camill,8,0,30,22
1650155047687,MATH 10A,A01,083735,Patchell; Gregory David,12,0,30,18
1650155047687,MATH 10A,A02,083736,Patchell; Gregory David,28,0,30,2
1650155047687,MATH 10A,A03,083737,Patchell; Gregory David,26,0,30,4
1650155053721,MATH 10B,A01,083207,Staff,0,5,30,30
1650155053721,MATH 10B,A02,083208,Staff,0,4,30,30
1650155053721,MATH 10B,B01,083739,Staff,18,0,30,12
1650155053721,MATH 10B,B02,083740,Staff,29,0,30,1
1650155059753,MATH 18,A01,083743,Staff,10,0,30,20
1650155059753,MATH 18,A02,083744,Staff,28,0,30,2
1650155059753,MATH 18,A03,083745,Staff,23,0,30,7
1650155059753,MATH 18,A04,083746,Staff,27,0,30,3
1650155059753,MATH 18,B01,083748,Staff,0,10,30,30
1650155059753,MATH 18,B02,083749,Staff,0,7,30,30
1650155059753,MATH 18,B03,083750,Staff,0,6,30,30
1650155059753,MATH 18,B04,083751,Staff,0,7,30,30
1650155065778,MATH 20A,A01,083754,Staff,26,0,40,14
1650155071801,MATH 20B,A01,083756,Staff,0,5,30,30
1650155071801,MATH 20B,A02,083757,Staff,0,4,30,30
1650155077823,MATH 20C,A01,083760,Staff,0,11,30,30
1650155077823,MATH 20C,A02,083761,Staff,0,12,30,30
1650155077823,MATH 20C,B01,083762,Staff,14,0,30,16
1650155077823,MATH 20C,B02,083763,Staff,28,0,30,2
1650155083849,MATH 20D,A01,083765,Staff,0,2,30,30
1650155083849,MATH 20D,A02,083766,Staff,10,0,30,20
1650155083849,MATH 20D,A03,083767,Staff,28,0,30,2
1650155089890,MATH 20E,A01,083771,Staff,8,0,30,22
1650155089890,MATH 20E,A02,083772,Staff,20,0,30,10
1650155089890,MATH 20E,B01,083773,Staff,0,0,30,30
1650155089890,MATH 20E,B02,083774,Staff,13,0,30,17
1650155095919,MATH 103A,A01,083777,Staff,0,8,30,30
1650155095919,MATH 103A,A02,083778,Staff,0,9,30,30
1650155095919,MATH 103A,B01,083779,Staff,0,10,30,30
1650155095919,MATH 103A,B02,083780,Staff,0,7,30,30
1650155101941,MATH 105,A01,085443,Staff,0,14,30,30
1650155107966,MATH 109,A01,083213,Anzaldo; Leesa B,0,3,30,30
1650155107966,MATH 109,A02,083214,Anzaldo; Leesa B,0,6,30,30
1650155107966,MATH 109,B01,083215,Anzaldo; Leesa B,0,4,30,30
1650155107966,MATH 109,B02,083216,Anzaldo; Leesa B,0,4,30,30
1650155113993,MATH 142A,A01,083219,Chow; Bennett,0,11,30,30
1650155113993,MATH 142A,A02,083220,Chow; Bennett,0,11,30,30
1650155113993,MATH 142A,B01,083221,Chow; Bennett,0,11,30,30
1650155113993,MATH 142A,B02,083222,Chow; Bennett,0,11,30,30
1650155120019,MATH 193A,A01,083224,Staff,0,3,30,30
1650155120019,MATH 193A,A02,083225,Staff,0,4,30,30
1650155120019,MATH 193A,A03,083781,Staff,0,0,30,30
1650155120019,MATH 193A,A04,083782,Staff,0,0,30,30
1650155126044,MATH 197,001,091859,McAuley; Julian John,9998,0,9999,1
1650155132107,COGS 9,A01,083615,Staff,0,14,60,60
1650155138132,COGS 11,A01,083617,Boyle; Mary E. T.,24,0,40,16
1650155144156,COGS 13,A01,083071,Staff,0,29,40,40
1650155150179,COGS 14A,A01,092681,Staff,0,10,100,100
1650155156200,COGS 14B,A01,083073,Cheng; Tzu-Han,0,5,50,50
1650155162226,COGS 17,A01,092677,Staff,34,0,75,41
1650155168253,COGS 100,A01,083619,Staff,0,21,60,60
1650155174278,COGS 101A,A01,083621,Davis; Joshua Daniel,0,21,60,60
1650155180300,COGS 101B,A01,091572,Staff,9,0,60,51
1650155186326,COGS 101C,A01,083625,Delgado; Tania,21,0,30,9
1650155192349,COGS 107A,A01,083627,Boyle; Mary E. T.,0,6,60,60
1650155198373,COGS 118A,A01,083075,Staff,17,0,60,43
1650155204397,CSE 3,A50,083646,Miranda; Gregory Joseph,22,0,38,16
1650155204397,CSE 3,A51,083647,Miranda; Gregory Joseph,37,0,37,0
1650155210424,CSE 8A,A50,083650,Miranda; Gregory Joseph,0,17,40,40
1650155216450,CSE 11,A01,083080,Cao; Yingjun,0,66,40,40
1650155222472,CSE 12,A01,083652,Staff,0,5,100,100
1650155228495,CSE 15L,A01,083654,Staff,0,0,50,50
1650155228495,CSE 15L,A02,083655,Staff,8,0,50,42
1650155234529,CSE 20,A01,083657,Staff,54,0,80,26
1650155240554,CSE 30,A01,083084,Eldon; John,0,64,40,40
1650155246582,CSE 100,A01,083659,Cao; Yingjun,0,61,50,50
1650155252606,CSE 134B,A01,083661,Powell; Thomas Allan,0,27,65,65
1650155258630,CSE 140,A01,083663,Staff,3,0,75,72
1650155264654,CSE 140L,A01,083088,Eldon; John,0,2,75,75
1650155270693,CSE 175,A01,083665,Kumar; Rakesh,8,0,25,17
1650155276729,CSE 190,A00,092507,Dubnov; Shlomo,14,0,20,6
1650155282752,ECE 45,A01,083139,Staff,0,13,40,40
1650155288779,ECE 65,A50,083695,Staff,0,4,30,30
1650155294802,ECE 109,A01,091882,Touri; Behrouz,48,0,70,22
1650155300825,ECE 180,A00,083140,Abi Samra; Nicholas Camill,24,0,30,6
1650155300825,ECE 180,B00,083141,Abi Samra; Nicholas Camill,8,0,30,22
1650155306848,MATH 10A,A01,083735,Patchell; Gregory David,12,0,30,18
1650155306848,MATH 10A,A02,083736,Patchell; Gregory David,28,0,30,2
1650155306848,MATH 10A,A03,083737,Patchell; Gregory David,26,0,30,4
1650155312876,MATH 10B,A01,083207,Staff,0,5,30,30
1650155312876,MATH 10B,A02,083208,Staff,0,4,30,30
1650155312876,MATH 10B,B01,083739,Staff,18,0,30,12
1650155312876,MATH 10B,B02,083740,Staff,29,0,30,1
1650155318903,MATH 18,A01,083743,Staff,10,0,30,20
1650155318903,MATH 18,A02,083744,Staff,28,0,30,2
1650155318903,MATH 18,A03,083745,Staff,23,0,30,7
1650155318903,MATH 18,A04,083746,Staff,27,0,30,3
1650155318903,MATH 18,B01,083748,Staff,0,10,30,30
1650155318903,MATH 18,B02,083749,Staff,0,7,30,30
1650155318903,MATH 18,B03,083750,Staff,0,6,30,30
1650155318903,MATH 18,B04,083751,Staff,0,7,30,30
1650155324926,MATH 20A,A01,083754,Staff,26,0,40,14
1650155330961,MATH 20B,A01,083756,Staff,0,5,30,30
1650155330961,MATH 20B,A02,083757,Staff,0,4,30,30
1650155336984,MATH 20C,A01,083760,Staff,0,11,30,30
1650155336984,MATH 20C,A02,083761,Staff,0,12,30,30
1650155336984,MATH 20C,B01,083762,Staff,14,0,30,16
1650155336984,MATH 20C,B02,083763,Staff,28,0,30,2
1650155343012,MATH 20D,A01,083765,Staff,0,2,30,30
1650155343012,MATH 20D,A02,083766,Staff,10,0,30,20
1650155343012,MATH 20D,A03,083767,Staff,28,0,30,2
1650155349043,MATH 20E,A01,083771,Staff,8,0,30,22
1650155349043,MATH 20E,A02,083772,Staff,20,0,30,10
1650155349043,MATH 20E,B01,083773,Staff,0,0,30,30
1650155349043,MATH 20E,B02,083774,Staff,13,0,30,17
1650155355079,MATH 103A,A01,083777,Staff,0,8,30,30
1650155355079,MATH 103A,A02,083778,Staff,0,9,30,30
1650155355079,MATH 103A,B01,083779,Staff,0,10,30,30
1650155355079,MATH 103A,B02,083780,Staff,0,7,30,30
1650155361110,MATH 105,A01,085443,Staff,0,14,30,30
1650155367146,MATH 109,A01,083213,Anzaldo; Leesa B,0,3,30,30
1650155367146,MATH 109,A02,083214,Anzaldo; Leesa B,0,6,30,30
1650155367146,MATH 109,B01,083215,Anzaldo; Leesa B,0,4,30,30
1650155367146,MATH 109,B02,083216,Anzaldo; Leesa B,0,4,30,30
1650155373175,MATH 142A,A01,083219,Chow; Bennett,0,11,30,30
1650155373175,MATH 142A,A02,083220,Chow; Bennett,0,11,30,30
1650155373175,MATH 142A,B01,083221,Chow; Bennett,0,11,30,30
1650155373175,MATH 142A,B02,083222,Chow; Bennett,0,11,30,30
1650155379202,MATH 193A,A01,083224,Staff,0,3,30,30
1650155379202,MATH 193A,A02,083225,Staff,0,4,30,30
1650155379202,MATH 193A,A03,083781,Staff,0,0,30,30
1650155379202,MATH 193A,A04,083782,Staff,0,0,30,30
1650155385305,MATH 197,001,091859,McAuley; Julian John,9998,0,9999,1
1650155391356,COGS 9,A01,083615,Staff,0,14,60,60
1650155397383,COGS 11,A01,083617,Boyle; Mary E. T.,24,0,40,16
1650155403417,COGS 13,A01,083071,Staff,0,29,40,40
1650155409444,COGS 14A,A01,092681,Staff,0,10,100,100
1650155415468,COGS 14B,A01,083073,Cheng; Tzu-Han,0,5,50,50
1650155421511,COGS 17,A01,092677,Staff,34,0,75,41
1650155427543,COGS 100,A01,083619,Staff,0,21,60,60
1650155433572,COGS 101A,A01,083621,Davis; Joshua Daniel,0,21,60,60
1650155439598,COGS 101B,A01,091572,Staff,9,0,60,51
1650155445625,COGS 101C,A01,083625,Delgado; Tania,21,0,30,9
1650155451651,COGS 107A,A01,083627,Boyle; Mary E. T.,0,6,60,60
1650155457675,COGS 118A,A01,083075,Staff,17,0,60,43
1650155463703,CSE 3,A50,083646,Miranda; Gregory Joseph,22,0,38,16
1650155463703,CSE 3,A51,083647,Miranda; Gregory Joseph,37,0,37,0
1650155469731,CSE 8A,A50,083650,Miranda; Gregory Joseph,0,17,40,40
1650155475756,CSE 11,A01,083080,Cao; Yingjun,0,65,40,40
1650155481778,CSE 12,A01,083652,Staff,0,5,100,100
1650155487813,CSE 15L,A01,083654,Staff,0,0,50,50
1650155487813,CSE 15L,A02,083655,Staff,8,0,50,42
1650155493841,CSE 20,A01,083657,Staff,54,0,80,26
1650155499865,CSE 30,A01,083084,Eldon; John,0,64,40,40
1650155505892,CSE 100,A01,083659,Cao; Yingjun,0,61,50,50
1650155511918,CSE 134B,A01,083661,Powell; Thomas Allan,0,27,65,65
1650155517942,CSE 140,A01,083663,Staff,3,0,75,72
1650155523965,CSE 140L,A01,083088,Eldon; John,0,2,75,75
1650155529987,CSE 175,A01,083665,Kumar; Rakesh,8,0,25,17
1650155536010,CSE 190,A00,092507,Dubnov; Shlomo,14,0,20,6
1650155542037,ECE 45,A01,083139,Staff,0,13,40,40
1650155548064,ECE 65,A50,083695,Staff,0,4,30,30
1650155554086,ECE 109,A01,091882,Touri; Behrouz,48,0,70,22
1650155560110,ECE 180,A00,083140,Abi Samra; Nicholas Camill,24,0,30,6
1650155560110,ECE 180,B00,083141,Abi Samra; Nicholas Camill,8,0,30,22
1650155566146,MATH 10A,A01,083735,Patchell; Gregory David,12,0,30,18
1650155566146,MATH 10A,A02,083736,Patchell; Gregory David,28,0,30,2
1650155566146,MATH 10A,A03,083737,Patchell; Gregory David,26,0,30,4
1650155572170,MATH 10B,A01,083207,Staff,0,5,30,30
1650155572170,MATH 10B,A02,083208,Staff,0,4,30,30
1650155572170,MATH 10B,B01,083739,Staff,18,0,30,12
1650155572170,MATH 10B,B02,083740,Staff,29,0,30,1
1650155578204,MATH 18,A01,083743,Staff,10,0,30,20
1650155578204,MATH 18,A02,083744,Staff,28,0,30,2
1650155578204,MATH 18,A03,083745,Staff,23,0,30,7
1650155578204,MATH 18,A04,083746,Staff,27,0,30,3
1650155578204,MATH 18,B01,083748,Staff,0,10,30,30
1650155578204,MATH 18,B02,083749,Staff,0,7,30,30
1650155578204,MATH 18,B03,083750,Staff,0,6,30,30
1650155578204,MATH 18,B04,083751,Staff,0,7,30,30
1650155584227,MATH 20A,A01,083754,Staff,26,0,40,14
1650155590253,MATH 20B,A01,083756,Staff,0,5,30,30
1650155590253,MATH 20B,A02,083757,Staff,0,4,30,30
1650155596275,MATH 20C,A01,083760,Staff,0,11,30,30
1650155596275,MATH 20C,A02,083761,Staff,0,12,30,30
1650155596275,MATH 20C,B01,083762,Staff,14,0,30,16
1650155596275,MATH 20C,B02,083763,Staff,28,0,30,2
1650155602314,MATH 20D,A01,083765,Staff,0,2,30,30
1650155602314,MATH 20D,A02,083766,Staff,10,0,30,20
1650155602314,MATH 20D,A03,083767,Staff,28,0,30,2
1650155608351,MATH 20E,A01,083771,Staff,8,0,30,22
1650155608351,MATH 20E,A02,083772,Staff,20,0,30,10
1650155608351,MATH 20E,B01,083773,Staff,0,0,30,30
1650155608351,MATH 20E,B02,083774,Staff,13,0,30,17
1650155614375,MATH 103A,A01,083777,Staff,0,8,30,30
1650155614375,MATH 103A,A02,083778,Staff,0,9,30,30
1650155614375,MATH 103A,B01,083779,Staff,0,10,30,30
1650155614375,MATH 103A,B02,083780,Staff,0,7,30,30
1650155620401,MATH 105,A01,085443,Staff,0,14,30,30
1650155626425,MATH 109,A01,083213,Anzaldo; Leesa B,0,3,30,30
1650155626425,MATH 109,A02,083214,Anzaldo; Leesa B,0,6,30,30
1650155626425,MATH 109,B01,083215,Anzaldo; Leesa B,0,4,30,30
1650155626425,MATH 109,B02,083216,Anzaldo; Leesa B,0,4,30,30
1650155632450,MATH 142A,A01,083219,Chow; Bennett,0,11,30,30
1650155632450,MATH 142A,A02,083220,Chow; Bennett,0,11,30,30
1650155632450,MATH 142A,B01,083221,Chow; Bennett,0,11,30,30
1650155632450,MATH 142A,B02,083222,Chow; Bennett,0,11,30,30
1650155638473,MATH 193A,A01,083224,Staff,0,3,30,30
1650155638473,MATH 193A,A02,083225,Staff,0,4,30,30
1650155638473,MATH 193A,A03,083781,Staff,0,0,30,30
1650155638473,MATH 193A,A04,083782,Staff,0,0,30,30
1650155644498,MATH 197,001,091859,McAuley; Julian John,9998,0,9999,1
1650155650565,COGS 9,A01,083615,Staff,0,14,60,60
1650155656587,COGS 11,A01,083617,Boyle; Mary E. T.,24,0,40,16
1650155662611,COGS 13,A01,083071,Staff,0,29,40,40
1650155668636,COGS 14A,A01,092681,Staff,0,10,100,100
1650155674663,COGS 14B,A01,083073,Cheng; Tzu-Han,0,5,50,50
1650155680688,COGS 17,A01,092677,Staff,34,0,75,41
1650155686714,COGS 100,A01,083619,Staff,0,21,60,60
1650155692741,COGS 101A,A01,083621,Davis; Joshua Daniel,0,21,60,60
1650155698767,COGS 101B,A01,091572,Staff,9,0,60,51
1650155704791,COGS 101C,A01,083625,Delgado; Tania,21,0,30,9
1650155710833,COGS 107A,A01,083627,Boyle; Mary E. T.,0,6,60,60
1650155716860,COGS 118A,A01,083075,Staff,17,0,60,43
1650155722886,CSE 3,A50,083646,Miranda; Gregory Joseph,22,0,38,16
1650155722886,CSE 3,A51,083647,Miranda; Gregory Joseph,37,0,37,0
1650155728908,CSE 8A,A50,083650,Miranda; Gregory Joseph,0,17,40,40
1650155734935,CSE 11,A01,083080,Cao; Yingjun,0,65,40,40
1650155740959,CSE 12,A01,083652,Staff,0,5,100,100
1650155746983,CSE 15L,A01,083654,Staff,0,0,50,50
1650155746983,CSE 15L,A02,083655,Staff,8,0,50,42
1650155753005,CSE 20,A01,083657,Staff,54,0,80,26
1650155759035,CSE 30,A01,083084,Eldon; John,0,64,40,40
1650155765058,CSE 100,A01,083659,Cao; Yingjun,0,61,50,50
1650155771082,CSE 134B,A01,083661,Powell; Thomas Allan,0,27,65,65
1650155777104,CSE 140,A01,083663,Staff,3,0,75,72
1650155783127,CSE 140L,A01,083088,Eldon; John,0,2,75,75
1650155789153,CSE 175,A01,083665,Kumar; Rakesh,8,0,25,17
1650155795178,CSE 190,A00,092507,Dubnov; Shlomo,14,0,20,6
1650155801200,ECE 45,A01,083139,Staff,0,13,40,40
1650155807223,ECE 65,A50,083695,Staff,0,4,30,30
1650155813246,ECE 109,A01,091882,Touri; Behrouz,48,0,70,22
1650155819268,ECE 180,A00,083140,Abi Samra; Nicholas Camill,24,0,30,6
1650155819268,ECE 180,B00,083141,Abi Samra; Nicholas Camill,8,0,30,22
1650155825294,MATH 10A,A01,083735,Patchell; Gregory David,12,0,30,18
1650155825294,MATH 10A,A02,083736,Patchell; Gregory David,28,0,30,2
1650155825294,MATH 10A,A03,083737,Patchell; Gregory David,26,0,30,4
1650155831327,MATH 10B,A01,083207,Staff,0,5,30,30
1650155831327,MATH 10B,A02,083208,Staff,0,4,30,30
1650155831327,MATH 10B,B01,083739,Staff,18,0,30,12
1650155831327,MATH 10B,B02,083740,Staff,29,0,30,1
1650155837353,MATH 18,A01,083743,Staff,10,0,30,20
1650155837353,MATH 18,A02,083744,Staff,28,0,30,2
1650155837353,MATH 18,A03,083745,Staff,23,0,30,7
1650155837353,MATH 18,A04,083746,Staff,27,0,30,3
1650155837353,MATH 18,B01,083748,Staff,0,10,30,30
1650155837353,MATH 18,B02,083749,Staff,0,7,30,30
1650155837353,MATH 18,B03,083750,Staff,0,6,30,30
1650155837353,MATH 18,B04,083751,Staff,0,7,30,30
1650155843388,MATH 20A,A01,083754,Staff,26,0,40,14
1650155849413,MATH 20B,A01,083756,Staff,0,5,30,30
1650155849413,MATH 20B,A02,083757,Staff,0,4,30,30
1650155855440,MATH 20C,A01,083760,Staff,0,11,30,30
1650155855440,MATH 20C,A02,083761,Staff,0,12,30,30
1650155855440,MATH 20C,B01,083762,Staff,14,0,30,16
1650155855440,MATH 20C,B02,083763,Staff,28,0,30,2
1650155861465,MATH 20D,A01,083765,Staff,0,2,30,30
1650155861465,MATH 20D,A02,083766,Staff,10,0,30,20
1650155861465,MATH 20D,A03,083767,Staff,28,0,30,2
1650155867498,MATH 20E,A01,083771,Staff,8,0,30,22
1650155867498,MATH 20E,A02,083772,Staff,20,0,30,10
1650155867498,MATH 20E,B01,083773,Staff,0,0,30,30
1650155867498,MATH 20E,B02,083774,Staff,13,0,30,17
1650155873525,MATH 103A,A01,083777,Staff,0,8,30,30
1650155873525,MATH 103A,A02,083778,Staff,0,9,30,30
1650155873525,MATH 103A,B01,083779,Staff,0,10,30,30
1650155873525,MATH 103A,B02,083780,Staff,0,7,30,30
1650155879557,MATH 105,A01,085443,Staff,0,14,30,30
1650155885583,MATH 109,A01,083213,Anzaldo; Leesa B,0,3,30,30
1650155885583,MATH 109,A02,083214,Anzaldo; Leesa B,0,6,30,30
1650155885583,MATH 109,B01,083215,Anzaldo; Leesa B,0,4,30,30
1650155885583,MATH 109,B02,083216,Anzaldo; Leesa B,0,4,30,30
1650155891614,MATH 142A,A01,083219,Chow; Bennett,0,11,30,30
1650155891614,MATH 142A,A02,083220,Chow; Bennett,0,11,30,30
1650155891614,MATH 142A,B01,083221,Chow; Bennett,0,11,30,30
1650155891614,MATH 142A,B02,083222,Chow; Bennett,0,11,30,30
1650155897640,MATH 193A,A01,083224,Staff,0,3,30,30
1650155897640,MATH 193A,A02,083225,Staff,0,4,30,30
1650155897640,MATH 193A,A03,083781,Staff,0,0,30,30
1650155897640,MATH 193A,A04,083782,Staff,0,0,30,30
1650155903662,MATH 197,001,091859,McAuley; Julian John,9998,0,9999,1
1650155909714,COGS 9,A01,083615,Staff,0,14,60,60
1650155915746,COGS 11,A01,083617,Boyle; Mary E. T.,24,0,40,16
1650155921773,COGS 13,A01,083071,Staff,0,29,40,40
1650155927797,COGS 14A,A01,092681,Staff,0,10,100,100
1650155933821,COGS 14B,A01,083073,Cheng; Tzu-Han,0,5,50,50
1650155939846,COGS 17,A01,092677,Staff,34,0,75,41
1650155945876,COGS 100,A01,083619,Staff,0,21,60,60
1650155951904,COGS 101A,A01,083621,Davis; Joshua Daniel,0,21,60,60
1650155957931,COGS 101B,A01,091572,Staff,9,0,60,51
1650155963953,COGS 101C,A01,083625,Delgado; Tania,21,0,30,9
1650155969975,COGS 107A,A01,083627,Boyle; Mary E. T.,0,6,60,60
1650155976076,COGS 118A,A01,083075,Staff,17,0,60,43
1650155982104,CSE 3,A50,083646,Miranda; Gregory Joseph,22,0,38,16
1650155982104,CSE 3,A51,083647,Miranda; Gregory Joseph,37,0,37,0
1650155988132,CSE 8A,A50,083650,Miranda; Gregory Joseph,0,17,40,40
1650155994159,CSE 11,A01,083080,Cao; Yingjun,0,65,40,40
1650156000191,CSE 12,A01,083652,Staff,0,5,100,100
1650156006219,CSE 15L,A01,083654,Staff,0,0,50,50
1650156006219,CSE 15L,A02,083655,Staff,8,0,50,42
1650156012246,CSE 20,A01,083657,Staff,54,0,80,26
1650156018272,CSE 30,A01,083084,Eldon; John,0,64,40,40
1650156024296,CSE 100,A01,083659,Cao; Yingjun,0,61,50,50
1650156030324,CSE 134B,A01,083661,Powell; Thomas Allan,0,27,65,65
1650156036361,CSE 140,A01,083663,Staff,3,0,75,72
1650156042389,CSE 140L,A01,083088,Eldon; John,0,2,75,75
1650156048413,CSE 175,A01,083665,Kumar; Rakesh,8,0,25,17
1650156054436,CSE 190,A00,092507,Dubnov; Shlomo,14,0,20,6
1650156060460,ECE 45,A01,083139,Staff,0,14,40,40
1650156066483,ECE 65,A50,083695,Staff,0,4,30,30
1650156072508,ECE 109,A01,091882,Touri; Behrouz,48,0,70,22
1650156078539,ECE 180,A00,083140,Abi Samra; Nicholas Camill,24,0,30,6
1650156078539,ECE 180,B00,083141,Abi Samra; Nicholas Camill,8,0,30,22
1650156084563,MATH 10A,A01,083735,Patchell; Gregory David,12,0,30,18
1650156084563,MATH 10A,A02,083736,Patchell; Gregory David,28,0,30,2
1650156084563,MATH 10A,A03,083737,Patchell; Gregory David,26,0,30,4
1650156090590,MATH 10B,A01,083207,Staff,0,5,30,30
1650156090590,MATH 10B,A02,083208,Staff,0,4,30,30
1650156090590,MATH 10B,B01,083739,Staff,18,0,30,12
1650156090590,MATH 10B,B02,083740,Staff,29,0,30,1
1650156096617,MATH 18,A01,083743,Staff,10,0,30,20
1650156096617,MATH 18,A02,083744,Staff,28,0,30,2
1650156096617,MATH 18,A03,083745,Staff,23,0,30,7
1650156096617,MATH 18,A04,083746,Staff,27,0,30,3
1650156096617,MATH 18,B01,083748,Staff,0,10,30,30
1650156096617,MATH 18,B02,083749,Staff,0,7,30,30
1650156096617,MATH 18,B03,083750,Staff,0,6,30,30
1650156096617,MATH 18,B04,083751,Staff,0,7,30,30
1650156102640,MATH 20A,A01,083754,Staff,26,0,40,14
1650156108665,MATH 20B,A01,083756,Staff,0,5,30,30
1650156108665,MATH 20B,A02,083757,Staff,0,4,30,30
1650156114688,MATH 20C,A01,083760,Staff,0,11,30,30
1650156114688,MATH 20C,A02,083761,Staff,0,12,30,30
1650156114688,MATH 20C,B01,083762,Staff,14,0,30,16
1650156114688,MATH 20C,B02,083763,Staff,28,0,30,2
1650156120715,MATH 20D,A01,083765,Staff,0,2,30,30
1650156120715,MATH 20D,A02,083766,Staff,10,0,30,20
1650156120715,MATH 20D,A03,083767,Staff,28,0,30,2
1650156126745,MATH 20E,A01,083771,Staff,8,0,30,22
1650156126745,MATH 20E,A02,083772,Staff,20,0,30,10
1650156126745,MATH 20E,B01,083773,Staff,0,0,30,30
1650156126745,MATH 20E,B02,083774,Staff,13,0,30,17
1650156132769,MATH 103A,A01,083777,Staff,0,8,30,30
1650156132769,MATH 103A,A02,083778,Staff,0,9,30,30
1650156132769,MATH 103A,B01,083779,Staff,0,10,30,30
1650156132769,MATH 103A,B02,083780,Staff,0,7,30,30
1650156138804,MATH 105,A01,085443,Staff,0,14,30,30
1650156144831,MATH 109,A01,083213,Anzaldo; Leesa B,0,3,30,30
1650156144831,MATH 109,A02,083214,Anzaldo; Leesa B,0,6,30,30
1650156144831,MATH 109,B01,083215,Anzaldo; Leesa B,0,4,30,30
1650156144831,MATH 109,B02,083216,Anzaldo; Leesa B,0,4,30,30
1650156150859,MATH 142A,A01,083219,Chow; Bennett,0,11,30,30
1650156150859,MATH 142A,A02,083220,Chow; Bennett,0,11,30,30
1650156150859,MATH 142A,B01,083221,Chow; Bennett,0,11,30,30
1650156150859,MATH 142A,B02,083222,Chow; Bennett,0,11,30,30
1650156156882,MATH 193A,A01,083224,Staff,0,3,30,30
1650156156882,MATH 193A,A02,083225,Staff,0,4,30,30
1650156156882,MATH 193A,A03,083781,Staff,0,0,30,30
1650156156882,MATH 193A,A04,083782,Staff,0,0,30,30
1650156162908,MATH 197,001,091859,McAuley; Julian John,9998,0,9999,1
1650156168968,COGS 9,A01,083615,Staff,0,14,60,60
1650156174995,COGS 11,A01,083617,Boyle; Mary E. T.,24,0,40,16
1650156181018,COGS 13,A01,083071,Staff,0,29,40,40
1650156187043,COGS 14A,A01,092681,Staff,0,10,100,100
1650156193066,COGS 14B,A01,083073,Cheng; Tzu-Han,0,5,50,50
1650156199091,COGS 17,A01,092677,Staff,34,0,75,41
1650156205118,COGS 100,A01,083619,Staff,0,21,60,60
1650156211145,COGS 101A,A01,083621,Davis; Joshua Daniel,0,21,60,60
1650156217170,COGS 101B,A01,091572,Staff,9,0,60,51
1650156223194,COGS 101C,A01,083625,Delgado; Tania,21,0,30,9
1650156229218,COGS 107A,A01,083627,Boyle; Mary E. T.,0,6,60,60
1650156235242,COGS 118A,A01,083075,Staff,17,0,60,43
1650156241265,CSE 3,A50,083646,Miranda; Gregory Joseph,22,0,38,16
1650156241265,CSE 3,A51,083647,Miranda; Gregory Joseph,37,0,37,0
1650156247293,CSE 8A,A50,083650,Miranda; Gregory Joseph,0,17,40,40
1650156253317,CSE 11,A01,083080,Cao; Yingjun,0,65,40,40
1650156259346,CSE 12,A01,083652,Staff,0,5,100,100
1650156265368,CSE 15L,A01,083654,Staff,0,0,50,50
1650156265368,CSE 15L,A02,083655,Staff,8,0,50,42
1650156271395,CSE 20,A01,083657,Staff,54,0,80,26
1650156277422,CSE 30,A01,083084,Eldon; John,0,65,40,40
1650156283445,CSE 100,A01,083659,Cao; Yingjun,0,61,50,50
1650156289469,CSE 134B,A01,083661,Powell; Thomas Allan,0,27,65,65
1650156295493,CSE 140,A01,083663,Staff,3,0,75,72
1650156301519,CSE 140L,A01,083088,Eldon; John,0,2,75,75
1650156307544,CSE 175,A01,083665,Kumar; Rakesh,8,0,25,17
1650156313568,CSE 190,A00,092507,Dubnov; Shlomo,14,0,20,6
1650156319597,ECE 45,A01,083139,Staff,0,14,40,40
1650156325631,ECE 65,A50,083695,Staff,0,4,30,30
1650156331655,ECE 109,A01,091882,Touri; Behrouz,47,0,70,23
1650156337681,ECE 180,A00,083140,Abi Samra; Nicholas Camill,24,0,30,6
1650156337681,ECE 180,B00,083141,Abi Samra; Nicholas Camill,8,0,30,22
1650156343705,MATH 10A,A01,083735,Patchell; Gregory David,12,0,30,18
1650156343705,MATH 10A,A02,083736,Patchell; Gregory David,28,0,30,2
1650156343705,MATH 10A,A03,083737,Patchell; Gregory David,26,0,30,4
1650156349730,MATH 10B,A01,083207,Staff,0,5,30,30
1650156349730,MATH 10B,A02,083208,Staff,0,4,30,30
1650156349730,MATH 10B,B01,083739,Staff,18,0,30,12
1650156349730,MATH 10B,B02,083740,Staff,29,0,30,1
1650156355759,MATH 18,A01,083743,Staff,10,0,30,20
1650156355759,MATH 18,A02,083744,Staff,28,0,30,2
1650156355759,MATH 18,A03,083745,Staff,23,0,30,7
1650156355759,MATH 18,A04,083746,Staff,27,0,30,3
1650156355759,MATH 18,B01,083748,Staff,0,10,30,30
1650156355759,MATH 18,B02,083749,Staff,0,7,30,30
1650156355759,MATH 18,B03,083750,Staff,0,6,30,30
1650156355759,MATH 18,B04,083751,Staff,0,7,30,30
1650156361786,MATH 20A,A01,083754,Staff,26,0,40,14
1650156367813,MATH 20B,A01,083756,Staff,0,5,30,30
1650156367813,MATH 20B,A02,083757,Staff,0,4,30,30
1650156373838,MATH 20C,A01,083760,Staff,0,11,30,30
1650156373838,MATH 20C,A02,083761,Staff,0,12,30,30
1650156373838,MATH 20C,B01,083762,Staff,14,0,30,16
1650156373838,MATH 20C,B02,083763,Staff,28,0,30,2
1650156379861,MATH 20D,A01,083765,Staff,0,2,30,30
1650156379861,MATH 20D,A02,083766,Staff,10,0,30,20
1650156379861,MATH 20D,A03,083767,Staff,28,0,30,2
1650156385885,MATH 20E,A01,083771,Staff,8,0,30,22
1650156385885,MATH 20E,A02,083772,Staff,20,0,30,10
1650156385885,MATH 20E,B01,083773,Staff,0,0,30,30
1650156385885,MATH 20E,B02,083774,Staff,13,0,30,17
1650156391914,MATH 103A,A01,083777,Staff,0,8,30,30
1650156391914,MATH 103A,A02,083778,Staff,0,9,30,30
1650156391914,MATH 103A,B01,083779,Staff,1,10,30,29
1650156391914,MATH 103A,B02,083780,Staff,0,7,30,30
1650156397938,MATH 105,A01,085443,Staff,0,15,30,30
1650156403965,MATH 109,A01,083213,Anzaldo; Leesa B,0,3,30,30
1650156403965,MATH 109,A02,083214,Anzaldo; Leesa B,0,6,30,30
1650156403965,MATH 109,B01,083215,Anzaldo; Leesa B,0,4,30,30
1650156403965,MATH 109,B02,083216,Anzaldo; Leesa B,0,4,30,30
1650156409988,MATH 142A,A01,083219,Chow; Bennett,0,11,30,30
1650156409988,MATH 142A,A02,083220,Chow; Bennett,0,11,30,30
1650156409988,MATH 142A,B01,083221,Chow; Bennett,0,11,30,30
1650156409988,MATH 142A,B02,083222,Chow; Bennett,0,11,30,30
1650156416016,MATH 193A,A01,083224,Staff,0,3,30,30
1650156416016,MATH 193A,A02,083225,Staff,0,4,30,30
1650156416016,MATH 193A,A03,083781,Staff,0,0,30,30
1650156416016,MATH 193A,A04,083782,Staff,0,0,30,30
1650156422042,MATH 197,001,091859,McAuley; Julian John,9998,0,9999,1
1650156428094,COGS 9,A01,083615,Staff,0,14,60,60
1650156434120,COGS 11,A01,083617,Boyle; Mary E. T.,24,0,40,16
1650156440146,COGS 13,A01,083071,Staff,0,29,40,40
1650156446170,COGS 14A,A01,092681,Staff,0,10,100,100
1650156452199,COGS 14B,A01,083073,Cheng; Tzu-Han,0,5,50,50
1650156458223,COGS 17,A01,092677,Staff,34,0,75,41
1650156464250,COGS 100,A01,083619,Staff,0,21,60,60
1650156470276,COGS 101A,A01,083621,Davis; Joshua Daniel,0,21,60,60
1650156476302,COGS 101B,A01,091572,Staff,9,0,60,51
1650156482338,COGS 101C,A01,083625,Delgado; Tania,21,0,30,9
1650156488365,COGS 107A,A01,083627,Boyle; Mary E. T.,0,6,60,60
1650156494388,COGS 118A,A01,083075,Staff,17,0,60,43
1650156500422,CSE 3,A50,083646,Miranda; Gregory Joseph,22,0,38,16
1650156500422,CSE 3,A51,083647,Miranda; Gregory Joseph,37,0,37,0
1650156506446,CSE 8A,A50,083650,Miranda; Gregory Joseph,0,17,40,40
1650156512469,CSE 11,A01,083080,Cao; Yingjun,0,65,40,40
1650156518498,CSE 12,A01,083652,Staff,0,5,100,100
1650156524524,CSE 15L,A01,083654,Staff,0,0,50,50
1650156524524,CSE 15L,A02,083655,Staff,8,0,50,42
1650156530555,CSE 20,A01,083657,Staff,54,0,80,26
1650156536578,CSE 30,A01,083084,Eldon; John,0,65,40,40
1650156542602,CSE 100,A01,083659,Cao; Yingjun,0,61,50,50
1650156548627,CSE 134B,A01,083661,Powell; Thomas Allan,0,27,65,65
1650156554650,CSE 140,A01,083663,Staff,3,0,75,72
1650156560673,CSE 140L,A01,083088,Eldon; John,0,2,75,75
1650156566702,CSE 175,A01,083665,Kumar; Rakesh,8,0,25,17
1650156572799,CSE 190,A00,092507,Dubnov; Shlomo,14,0,20,6
1650156578822,ECE 45,A01,083139,Staff,0,14,40,40
1650156584849,ECE 65,A50,083695,Staff,0,4,30,30
1650156590877,ECE 109,A01,091882,Touri; Behrouz,47,0,70,23
1650156596905,ECE 180,A00,083140,Abi Samra; Nicholas Camill,24,0,30,6
1650156596905,ECE 180,B00,083141,Abi Samra; Nicholas Camill,8,0,30,22
1650156602932,MATH 10A,A01,083735,Patchell; Gregory David,12,0,30,18
1650156602932,MATH 10A,A02,083736,Patchell; Gregory David,28,0,30,2
1650156602932,MATH 10A,A03,083737,Patchell; Gregory David,26,0,30,4
1650156608957,MATH 10B,A01,083207,Staff,0,5,30,30
1650156608957,MATH 10B,A02,083208,Staff,0,4,30,30
1650156608957,MATH 10B,B01,083739,Staff,18,0,30,12
1650156608957,MATH 10B,B02,083740,Staff,29,0,30,1
1650156614981,MATH 18,A01,083743,Staff,10,0,30,20
1650156614981,MATH 18,A02,083744,Staff,28,0,30,2
1650156614981,MATH 18,A03,083745,Staff,23,0,30,7
1650156614981,MATH 18,A04,083746,Staff,27,0,30,3
1650156614981,MATH 18,B01,083748,Staff,0,10,30,30
1650156614981,MATH 18,B02,083749,Staff,0,7,30,30
1650156614981,MATH 18,B03,083750,Staff,0,6,30,30
1650156614981,MATH 18,B04,083751,Staff,0,7,30,30
1650156621004,MATH 20A,A01,083754,Staff,26,0,40,14
1650156627027,MATH 20B,A01,083756,Staff,0,5,30,30
1650156627027,MATH 20B,A02,083757,Staff,0,4,30,30
1650156633051,MATH 20C,A01,083760,Staff,0,12,30,30
1650156633051,MATH 20C,A02,083761,Staff,0,12,30,30
1650156633051,MATH 20C,B01,083762,Staff,14,0,30,16
1650156633051,MATH 20C,B02,083763,Staff,28,0,30,2
1650156639077,MATH 20D,A01,083765,Staff,0,2,30,30
1650156639077,MATH 20D,A02,083766,Staff,10,0,30,20
1650156639077,MATH 20D,A03,083767,Staff,28,0,30,2
1650156645102,MATH 20E,A01,083771,Staff,8,0,30,22
1650156645102,MATH 20E,A02,083772,Staff,20,0,30,10
1650156645102,MATH 20E,B01,083773,Staff,0,0,30,30
1650156645102,MATH 20E,B02,083774,Staff,13,0,30,17
1650156651135,MATH 103A,A01,083777,Staff,0,8,30,30
1650156651135,MATH 103A,A02,083778,Staff,0,9,30,30
1650156651135,MATH 103A,B01,083779,Staff,1,10,30,29
1650156651135,MATH 103A,B02,083780,Staff,0,7,30,30
1650156657159,MATH 105,A01,085443,Staff,0,15,30,30
1650156663182,MATH 109,A01,083213,Anzaldo; Leesa B,0,3,30,30
1650156663182,MATH 109,A02,083214,Anzaldo; Leesa B,0,6,30,30
1650156663182,MATH 109,B01,083215,Anzaldo; Leesa B,0,4,30,30
1650156663182,MATH 109,B02,083216,Anzaldo; Leesa B,0,4,30,30
1650156669210,MATH 142A,A01,083219,Chow; Bennett,0,11,30,30
1650156669210,MATH 142A,A02,083220,Chow; Bennett,0,11,30,30
1650156669210,MATH 142A,B01,083221,Chow; Bennett,0,11,30,30
1650156669210,MATH 142A,B02,083222,Chow; Bennett,0,11,30,30
1650156675236,MATH 193A,A01,083224,Staff,0,3,30,30
1650156675236,MATH 193A,A02,083225,Staff,0,4,30,30
1650156675236,MATH 193A,A03,083781,Staff,0,0,30,30
1650156675236,MATH 193A,A04,083782,Staff,0,0,30,30
1650156681262,MATH 197,001,091859,McAuley; Julian John,9998,0,9999,1
1650156687339,COGS 9,A01,083615,Staff,0,14,60,60
1650156693364,COGS 11,A01,083617,Boyle; Mary E. T.,24,0,40,16
1650156699388,COGS 13,A01,083071,Staff,0,29,40,40
1650156705423,COGS 14A,A01,092681,Staff,0,10,100,100
1650156711463,COGS 14B,A01,083073,Cheng; Tzu-Han,0,5,50,50
1650156717486,COGS 17,A01,092677,Staff,34,0,75,41
1650156723510,COGS 100,A01,083619,Staff,0,21,60,60
1650156729532,COGS 101A,A01,083621,Davis; Joshua Daniel,0,21,60,60
1650156735555,COGS 101B,A01,091572,Staff,9,0,60,51
1650156741581,COGS 101C,A01,083625,Delgado; Tania,21,0,30,9
1650156747608,COGS 107A,A01,083627,Boyle; Mary E. T.,0,6,60,60
1650156753638,COGS 118A,A01,083075,Staff,17,0,60,43
1650156759661,CSE 3,A50,083646,Miranda; Gregory Joseph,22,0,38,16
1650156759661,CSE 3,A51,083647,Miranda; Gregory Joseph,37,0,37,0
1650156765685,CSE 8A,A50,083650,Miranda; Gregory Joseph,0,17,40,40
1650156771712,CSE 11,A01,083080,Cao; Yingjun,0,65,40,40
1650156777739,CSE 12,A01,083652,Staff,0,5,100,100
1650156783769,CSE 15L,A01,083654,Staff,0,0,50,50
1650156783769,CSE 15L,A02,083655,Staff,8,0,50,42
1650156789792,CSE 20,A01,083657,Staff,54,0,80,26
1650156795818,CSE 30,A01,083084,Eldon; John,0,65,40,40
1650156801840,CSE 100,A01,083659,Cao; Yingjun,0,61,50,50
1650156807867,CSE 134B,A01,083661,Powell; Thomas Allan,0,27,65,65
1650156813891,CSE 140,A01,083663,Staff,3,0,75,72
1650156819914,CSE 140L,A01,083088,Eldon; John,0,2,75,75
1650156825942,CSE 175,A01,083665,Kumar; Rakesh,8,0,25,17
1650156831965,CSE 190,A00,092507,Dubnov; Shlomo,14,0,20,6
1650156837989,ECE 45,A01,083139,Staff,0,14,40,40
1650156844015,ECE 65,A50,083695,Staff,0,4,30,30
1650156850047,ECE 109,A01,091882,Touri; Behrouz,47,0,70,23
1650156856075,ECE 180,A00,083140,Abi Samra; Nicholas Camill,24,0,30,6
1650156856075,ECE 180,B00,083141,Abi Samra; Nicholas Camill,8,0,30,22
1650156862111,MATH 10A,A01,083735,Patchell; Gregory David,12,0,30,18
1650156862111,MATH 10A,A02,083736,Patchell; Gregory David,28,0,30,2
1650156862111,MATH 10A,A03,083737,Patchell; Gregory David,26,0,30,4
1650156868141,MATH 10B,A01,083207,Staff,0,5,30,30
1650156868141,MATH 10B,A02,083208,Staff,0,4,30,30
1650156868141,MATH 10B,B01,083739,Staff,18,0,30,12
1650156868141,MATH 10B,B02,083740,Staff,29,0,30,1
1650156874170,MATH 18,A01,083743,Staff,10,0,30,20
1650156874170,MATH 18,A02,083744,Staff,28,0,30,2
1650156874170,MATH 18,A03,083745,Staff,23,0,30,7
1650156874170,MATH 18,A04,083746,Staff,27,0,30,3
1650156874170,MATH 18,B01,083748,Staff,0,10,30,30
1650156874170,MATH 18,B02,083749,Staff,0,7,30,30
1650156874170,MATH 18,B03,083750,Staff,0,6,30,30
1650156874170,MATH 18,B04,083751,Staff,0,7,30,30
1650156880194,MATH 20A,A01,083754,Staff,26,0,40,14
1650156886221,MATH 20B,A01,083756,Staff,0,5,30,30
1650156886221,MATH 20B,A02,083757,Staff,0,4,30,30
1650156892245,MATH 20C,A01,083760,Staff,0,12,30,30
1650156892245,MATH 20C,A02,083761,Staff,0,12,30,30
1650156892245,MATH 20C,B01,083762,Staff,14,0,30,16
1650156892245,MATH 20C,B02,083763,Staff,28,0,30,2
1650156898269,MATH 20D,A01,083765,Staff,0,2,30,30
1650156898269,MATH 20D,A02,083766,Staff,10,0,30,20
1650156898269,MATH 20D,A03,083767,Staff,28,0,30,2
1650156904295,MATH 20E,A01,083771,Staff,8,0,30,22
1650156904295,MATH 20E,A02,083772,Staff,20,0,30,10
1650156904295,MATH 20E,B01,083773,Staff,0,0,30,30
1650156904295,MATH 20E,B02,083774,Staff,13,0,30,17
1650156910320,MATH 103A,A01,083777,Staff,0,8,30,30
1650156910320,MATH 103A,A02,083778,Staff,0,9,30,30
1650156910320,MATH 103A,B01,083779,Staff,1,10,30,29
1650156910320,MATH 103A,B02,083780,Staff,0,7,30,30
1650156916342,MATH 105,A01,085443,Staff,0,15,30,30
1650156922365,MATH 109,A01,083213,Anzaldo; Leesa B,0,3,30,30
1650156922365,MATH 109,A02,083214,Anzaldo; Leesa B,0,6,30,30
1650156922365,MATH 109,B01,083215,Anzaldo; Leesa B,0,4,30,30
1650156922365,MATH 109,B02,083216,Anzaldo; Leesa B,0,4,30,30
1650156928395,MATH 142A,A01,083219,Chow; Bennett,0,11,30,30
1650156928395,MATH 142A,A02,083220,Chow; Bennett,0,11,30,30
1650156928395,MATH 142A,B01,083221,Chow; Bennett,0,11,30,30
1650156928395,MATH 142A,B02,083222,Chow; Bennett,0,11,30,30
1650156934420,MATH 193A,A01,083224,Staff,0,3,30,30
1650156934420,MATH 193A,A02,083225,Staff,0,4,30,30
1650156934420,MATH 193A,A03,083781,Staff,0,0,30,30
1650156934420,MATH 193A,A04,083782,Staff,0,0,30,30
1650156940443,MATH 197,001,091859,McAuley; Julian John,9998,0,9999,1
1650156946500,COGS 9,A01,083615,Staff,0,14,60,60
1650156952523,COGS 11,A01,083617,Boyle; Mary E. T.,24,0,40,16
1650156958546,COGS 13,A01,083071,Staff,0,29,40,40
1650156964572,COGS 14A,A01,092681,Staff,0,10,100,100
1650156970596,COGS 14B,A01,083073,Cheng; Tzu-Han,0,5,50,50
1650156976618,COGS 17,A01,092677,Staff,34,0,75,41
1650156982641,COGS 100,A01,083619,Staff,0,21,60,60
1650156988669,COGS 101A,A01,083621,Davis; Joshua Daniel,0,21,60,60
1650156994692,COGS 101B,A01,091572,Staff,9,0,60,51
1650157000714,COGS 101C,A01,083625,Delgado; Tania,21,0,30,9
1650157006740,COGS 107A,A01,083627,Boyle; Mary E. T.,0,6,60,60
1650157012767,COGS 118A,A01,083075,Staff,17,0,60,43
1650157018793,CSE 3,A50,083646,Miranda; Gregory Joseph,22,0,38,16
1650157018793,CSE 3,A51,083647,Miranda; Gregory Joseph,37,0,37,0
1650157024815,CSE 8A,A50,083650,Miranda; Gregory Joseph,0,17,40,40
1650157030839,CSE 11,A01,083080,Cao; Yingjun,0,65,40,40
1650157036864,CSE 12,A01,083652,Staff,0,5,100,100
1650157042890,CSE 15L,A01,083654,Staff,0,0,50,50
1650157042890,CSE 15L,A02,083655,Staff,8,0,50,42
1650157048914,CSE 20,A01,083657,Staff,54,0,80,26
1650157054944,CSE 30,A01,083084,Eldon; John,0,65,40,40
1650157060971,CSE 100,A01,083659,Cao; Yingjun,0,61,50,50
1650157066998,CSE 134B,A01,083661,Powell; Thomas Allan,0,27,65,65
1650157073021,CSE 140,A01,083663,Staff,3,0,75,72
1650157079045,CSE 140L,A01,083088,Eldon; John,0,2,75,75
1650157085070,CSE 175,A01,083665,Kumar; Rakesh,8,0,25,17
1650157091093,CSE 190,A00,092507,Dubnov; Shlomo,14,0,20,6
1650157097117,ECE 45,A01,083139,Staff,0,14,40,40
1650157103149,ECE 65,A50,083695,Staff,0,4,30,30
1650157109175,ECE 109,A01,091882,Touri; Behrouz,47,0,70,23
1650157115199,ECE 180,A00,083140,Abi Samra; Nicholas Camill,24,0,30,6
1650157115199,ECE 180,B00,083141,Abi Samra; Nicholas Camill,8,0,30,22
1650157121222,MATH 10A,A01,083735,Patchell; Gregory David,12,0,30,18
1650157121222,MATH 10A,A02,083736,Patchell; Gregory David,28,0,30,2
1650157121222,MATH 10A,A03,083737,Patchell; Gregory David,26,0,30,4
1650157127245,MATH 10B,A01,083207,Staff,0,5,30,30
1650157127245,MATH 10B,A02,083208,Staff,0,4,30,30
1650157127245,MATH 10B,B01,083739,Staff,18,0,30,12
1650157127245,MATH 10B,B02,083740,Staff,29,0,30,1
1650157133271,MATH 18,A01,083743,Staff,10,0,30,20
1650157133271,MATH 18,A02,083744,Staff,28,0,30,2
1650157133271,MATH 18,A03,083745,Staff,23,0,30,7
1650157133271,MATH 18,A04,083746,Staff,27,0,30,3
1650157133271,MATH 18,B01,083748,Staff,0,10,30,30
1650157133271,MATH 18,B02,083749,Staff,0,7,30,30
1650157133271,MATH 18,B03,083750,Staff,0,6,30,30
1650157133271,MATH 18,B04,083751,Staff,0,7,30,30
1650157139292,MATH 20A,A01,083754,Staff,26,0,40,14
1650157145317,MATH 20B,A01,083756,Staff,0,5,30,30
1650157145317,MATH 20B,A02,083757,Staff,0,4,30,30
1650157151347,MATH 20C,A01,083760,Staff,0,12,30,30
1650157151347,MATH 20C,A02,083761,Staff,0,12,30,30
1650157151347,MATH 20C,B01,083762,Staff,14,0,30,16
1650157151347,MATH 20C,B02,083763,Staff,28,0,30,2
1650157157371,MATH 20D,A01,083765,Staff,0,2,30,30
1650157157371,MATH 20D,A02,083766,Staff,10,0,30,20
1650157157371,MATH 20D,A03,083767,Staff,28,0,30,2
1650157163394,MATH 20E,A01,083771,Staff,8,0,30,22
1650157163394,MATH 20E,A02,083772,Staff,20,0,30,10
1650157163394,MATH 20E,B01,083773,Staff,0,0,30,30
1650157163394,MATH 20E,B02,083774,Staff,13,0,30,17
1650157169489,MATH 103A,A01,083777,Staff,0,8,30,30
1650157169489,MATH 103A,A02,083778,Staff,0,9,30,30
1650157169489,MATH 103A,B01,083779,Staff,1,10,30,29
1650157169489,MATH 103A,B02,083780,Staff,0,7,30,30
1650157175513,MATH 105,A01,085443,Staff,0,15,30,30
1650157181542,MATH 109,A01,083213,Anzaldo; Leesa B,0,3,30,30
1650157181542,MATH 109,A02,083214,Anzaldo; Leesa B,0,6,30,30
1650157181542,MATH 109,B01,083215,Anzaldo; Leesa B,0,4,30,30
1650157181542,MATH 109,B02,083216,Anzaldo; Leesa B,0,4,30,30
1650157187570,MATH 142A,A01,083219,Chow; Bennett,0,11,30,30
1650157187570,MATH 142A,A02,083220,Chow; Bennett,0,11,30,30
1650157187570,MATH 142A,B01,083221,Chow; Bennett,0,11,30,30
1650157187570,MATH 142A,B02,083222,Chow; Bennett,0,11,30,30
1650157193603,MATH 193A,A01,083224,Staff,0,3,30,30
1650157193603,MATH 193A,A02,083225,Staff,0,4,30,30
1650157193603,MATH 193A,A03,083781,Staff,0,0,30,30
1650157193603,MATH 193A,A04,083782,Staff,0,0,30,30
1650157199626,MATH 197,001,091859,McAuley; Julian John,9998,0,9999,1
1650157205686,COGS 9,A01,083615,Staff,0,14,60,60
1650157211721,COGS 11,A01,083617,Boyle; Mary E. T.,24,0,40,16
1650157217747,COGS 13,A01,083071,Staff,0,29,40,40
1650157223775,COGS 14A,A01,092681,Staff,0,10,100,100
1650157229800,COGS 14B,A01,083073,Cheng; Tzu-Han,0,5,50,50
1650157235827,COGS 17,A01,092677,Staff,34,0,75,41
1650157241851,COGS 100,A01,083619,Staff,0,21,60,60
1650157247875,COGS 101A,A01,083621,Davis; Joshua Daniel,0,21,60,60
1650157253898,COGS 101B,A01,091572,Staff,9,0,60,51
1650157259922,COGS 101C,A01,083625,Delgado; Tania,21,0,30,9
1650157265946,COGS 107A,A01,083627,Boyle; Mary E. T.,0,6,60,60
1650157271970,COGS 118A,A01,083075,Staff,17,0,60,43
1650157277999,CSE 3,A50,083646,Miranda; Gregory Joseph,22,0,38,16
1650157277999,CSE 3,A51,083647,Miranda; Gregory Joseph,37,0,37,0
1650157284024,CSE 8A,A50,083650,Miranda; Gregory Joseph,0,17,40,40
1650157290048,CSE 11,A01,083080,Cao; Yingjun,0,65,40,40
1650157296077,CSE 12,A01,083652,Staff,0,5,100,100
1650157302100,CSE 15L,A01,083654,Staff,0,0,50,50
1650157302100,CSE 15L,A02,083655,Staff,8,0,50,42
1650157308123,CSE 20,A01,083657,Staff,54,0,80,26
1650157314153,CSE 30,A01,083084,Eldon; John,0,65,40,40
1650157320185,CSE 100,A01,083659,Cao; Yingjun,0,61,50,50
1650157326218,CSE 134B,A01,083661,Powell; Thomas Allan,0,27,65,65
1650157332251,CSE 140,A01,083663,Staff,3,0,75,72
1650157338274,CSE 140L,A01,083088,Eldon; John,0,2,75,75
1650157344304,CSE 175,A01,083665,Kumar; Rakesh,8,0,25,17
1650157350331,CSE 190,A00,092507,Dubnov; Shlomo,14,0,20,6
1650157356354,ECE 45,A01,083139,Staff,0,14,40,40
1650157362384,ECE 65,A50,083695,Staff,0,4,30,30
1650157368407,ECE 109,A01,091882,Touri; Behrouz,47,0,70,23
1650157374444,ECE 180,A00,083140,Abi Samra; Nicholas Camill,24,0,30,6
1650157374444,ECE 180,B00,083141,Abi Samra; Nicholas Camill,8,0,30,22
1650157380478,MATH 10A,A01,083735,Patchell; Gregory David,12,0,30,18
1650157380478,MATH 10A,A02,083736,Patchell; Gregory David,28,0,30,2
1650157380478,MATH 10A,A03,083737,Patchell; Gregory David,26,0,30,4
1650157386517,MATH 10B,A01,083207,Staff,0,5,30,30
1650157386517,MATH 10B,A02,083208,Staff,0,4,30,30
1650157386517,MATH 10B,B01,083739,Staff,18,0,30,12
1650157386517,MATH 10B,B02,083740,Staff,29,0,30,1
1650157392547,MATH 18,A01,083743,Staff,10,0,30,20
1650157392547,MATH 18,A02,083744,Staff,28,0,30,2
1650157392547,MATH 18,A03,083745,Staff,23,0,30,7
1650157392547,MATH 18,A04,083746,Staff,27,0,30,3
1650157392547,MATH 18,B01,083748,Staff,0,10,30,30
1650157392547,MATH 18,B02,083749,Staff,0,7,30,30
1650157392547,MATH 18,B03,083750,Staff,0,6,30,30
1650157392547,MATH 18,B04,083751,Staff,0,7,30,30
1650157398582,MATH 20A,A01,083754,Staff,26,0,40,14
1650157404609,MATH 20B,A01,083756,Staff,0,5,30,30
1650157404609,MATH 20B,A02,083757,Staff,0,4,30,30
1650157410633,MATH 20C,A01,083760,Staff,0,12,30,30
1650157410633,MATH 20C,A02,083761,Staff,0,12,30,30
1650157410633,MATH 20C,B01,083762,Staff,14,0,30,16
1650157410633,MATH 20C,B02,083763,Staff,28,0,30,2
1650157416663,MATH 20D,A01,083765,Staff,0,2,30,30
1650157416663,MATH 20D,A02,083766,Staff,10,0,30,20
1650157416663,MATH 20D,A03,083767,Staff,28,0,30,2
1650157422691,MATH 20E,A01,083771,Staff,8,0,30,22
1650157422691,MATH 20E,A02,083772,Staff,20,0,30,10
1650157422691,MATH 20E,B01,083773,Staff,0,0,30,30
1650157422691,MATH 20E,B02,083774,Staff,13,0,30,17
1650157428716,MATH 103A,A01,083777,Staff,0,8,30,30
1650157428716,MATH 103A,A02,083778,Staff,0,9,30,30
1650157428716,MATH 103A,B01,083779,Staff,1,10,30,29
1650157428716,MATH 103A,B02,083780,Staff,0,7,30,30
1650157434744,MATH 105,A01,085443,Staff,0,15,30,30
1650157440773,MATH 109,A01,083213,Anzaldo; Leesa B,0,3,30,30
1650157440773,MATH 109,A02,083214,Anzaldo; Leesa B,0,6,30,30
1650157440773,MATH 109,B01,083215,Anzaldo; Leesa B,0,4,30,30
1650157440773,MATH 109,B02,083216,Anzaldo; Leesa B,0,4,30,30
1650157446799,MATH 142A,A01,083219,Chow; Bennett,0,11,30,30
1650157446799,MATH 142A,A02,083220,Chow; Bennett,0,11,30,30
1650157446799,MATH 142A,B01,083221,Chow; Bennett,0,11,30,30
1650157446799,MATH 142A,B02,083222,Chow; Bennett,0,11,30,30
1650157452823,MATH 193A,A01,083224,Staff,0,3,30,30
1650157452823,MATH 193A,A02,083225,Staff,0,4,30,30
1650157452823,MATH 193A,A03,083781,Staff,0,0,30,30
1650157452823,MATH 193A,A04,083782,Staff,0,0,30,30
1650157458855,MATH 197,001,091859,McAuley; Julian John,9998,0,9999,1
1650157464917,COGS 9,A01,083615,Staff,0,14,60,60
1650157470944,COGS 11,A01,083617,Boyle; Mary E. T.,24,0,40,16
1650157476968,COGS 13,A01,083071,Staff,0,29,40,40
1650157482993,COGS 14A,A01,092681,Staff,0,10,100,100
1650157489016,COGS 14B,A01,083073,Cheng; Tzu-Han,0,5,50,50
1650157495042,COGS 17,A01,092677,Staff,34,0,75,41
1650157501069,COGS 100,A01,083619,Staff,0,21,60,60
1650157507097,COGS 101A,A01,083621,Davis; Joshua Daniel,0,21,60,60
1650157513123,COGS 101B,A01,091572,Staff,9,0,60,51
1650157519149,COGS 101C,A01,083625,Delgado; Tania,21,0,30,9
1650157525177,COGS 107A,A01,083627,Boyle; Mary E. T.,0,6,60,60
1650157531204,COGS 118A,A01,083075,Staff,17,0,60,43
1650157537232,CSE 3,A50,083646,Miranda; Gregory Joseph,22,0,38,16
1650157537232,CSE 3,A51,083647,Miranda; Gregory Joseph,37,0,37,0
1650157543272,CSE 8A,A50,083650,Miranda; Gregory Joseph,0,17,40,40
1650157549295,CSE 11,A01,083080,Cao; Yingjun,0,65,40,40
1650157555322,CSE 12,A01,083652,Staff,0,5,100,100
1650157561350,CSE 15L,A01,083654,Staff,0,0,50,50
1650157561350,CSE 15L,A02,083655,Staff,8,0,50,42
1650157567378,CSE 20,A01,083657,Staff,54,0,80,26
1650157573402,CSE 30,A01,083084,Eldon; John,0,65,40,40
1650157579430,CSE 100,A01,083659,Cao; Yingjun,0,61,50,50
1650157585455,CSE 134B,A01,083661,Powell; Thomas Allan,0,27,65,65
1650157591478,CSE 140,A01,083663,Staff,3,0,75,72
1650157597503,CSE 140L,A01,083088,Eldon; John,0,2,75,75
1650157603529,CSE 175,A01,083665,Kumar; Rakesh,8,0,25,17
1650157609555,CSE 190,A00,092507,Dubnov; Shlomo,14,0,20,6
1650157615582,ECE 45,A01,083139,Staff,0,14,40,40
1650157621606,ECE 65,A50,083695,Staff,0,4,30,30
1650157627628,ECE 109,A01,091882,Touri; Behrouz,47,0,70,23
1650157633651,ECE 180,A00,083140,Abi Samra; Nicholas Camill,24,0,30,6
1650157633651,ECE 180,B00,083141,Abi Samra; Nicholas Camill,8,0,30,22
1650157639676,MATH 10A,A01,083735,Patchell; Gregory David,12,0,30,18
1650157639676,MATH 10A,A02,083736,Patchell; Gregory David,28,0,30,2
1650157639676,MATH 10A,A03,083737,Patchell; Gregory David,26,0,30,4
1650157645700,MATH 10B,A01,083207,Staff,0,5,30,30
1650157645700,MATH 10B,A02,083208,Staff,0,4,30,30
1650157645700,MATH 10B,B01,083739,Staff,18,0,30,12
1650157645700,MATH 10B,B02,083740,Staff,29,0,30,1
1650157651724,MATH 18,A01,083743,Staff,10,0,30,20
1650157651724,MATH 18,A02,083744,Staff,28,0,30,2
1650157651724,MATH 18,A03,083745,Staff,23,0,30,7
1650157651724,MATH 18,A04,083746,Staff,27,0,30,3
1650157651724,MATH 18,B01,083748,Staff,0,10,30,30
1650157651724,MATH 18,B02,083749,Staff,0,7,30,30
1650157651724,MATH 18,B03,083750,Staff,0,6,30,30
1650157651724,MATH 18,B04,083751,Staff,0,7,30,30
1650157657747,MATH 20A,A01,083754,Staff,26,0,40,14
1650157663775,MATH 20B,A01,083756,Staff,0,5,30,30
1650157663775,MATH 20B,A02,083757,Staff,0,4,30,30
1650157669799,MATH 20C,A01,083760,Staff,0,12,30,30
1650157669799,MATH 20C,A02,083761,Staff,0,12,30,30
1650157669799,MATH 20C,B01,083762,Staff,14,0,30,16
1650157669799,MATH 20C,B02,083763,Staff,28,0,30,2
1650157675824,MATH 20D,A01,083765,Staff,0,2,30,30
1650157675824,MATH 20D,A02,083766,Staff,10,0,30,20
1650157675824,MATH 20D,A03,083767,Staff,28,0,30,2
1650157681846,MATH 20E,A01,083771,Staff,8,0,30,22
1650157681846,MATH 20E,A02,083772,Staff,20,0,30,10
1650157681846,MATH 20E,B01,083773,Staff,0,0,30,30
1650157681846,MATH 20E,B02,083774,Staff,13,0,30,17
1650157687869,MATH 103A,A01,083777,Staff,0,8,30,30
1650157687869,MATH 103A,A02,083778,Staff,0,9,30,30
1650157687869,MATH 103A,B01,083779,Staff,1,10,30,29
1650157687869,MATH 103A,B02,083780,Staff,0,7,30,30
1650157693891,MATH 105,A01,085443,Staff,0,15,30,30
1650157699915,MATH 109,A01,083213,Anzaldo; Leesa B,0,3,30,30
1650157699915,MATH 109,A02,083214,Anzaldo; Leesa B,0,6,30,30
1650157699915,MATH 109,B01,083215,Anzaldo; Leesa B,0,4,30,30
1650157699915,MATH 109,B02,083216,Anzaldo; Leesa B,0,4,30,30
1650157705938,MATH 142A,A01,083219,Chow; Bennett,0,11,30,30
1650157705938,MATH 142A,A02,083220,Chow; Bennett,0,11,30,30
1650157705938,MATH 142A,B01,083221,Chow; Bennett,0,11,30,30
1650157705938,MATH 142A,B02,083222,Chow; Bennett,0,11,30,30
1650157711961,MATH 193A,A01,083224,Staff,0,3,30,30
1650157711961,MATH 193A,A02,083225,Staff,0,4,30,30
1650157711961,MATH 193A,A03,083781,Staff,0,0,30,30
1650157711961,MATH 193A,A04,083782,Staff,0,0,30,30
1650157717987,MATH 197,001,091859,McAuley; Julian John,9998,0,9999,1
1650157724038,COGS 9,A01,083615,Staff,0,14,60,60
1650157730062,COGS 11,A01,083617,Boyle; Mary E. T.,24,0,40,16
1650157736085,COGS 13,A01,083071,Staff,0,29,40,40
1650157742123,COGS 14A,A01,092681,Staff,0,10,100,100
1650157748146,COGS 14B,A01,083073,Cheng; Tzu-Han,0,5,50,50
1650157754173,COGS 17,A01,092677,Staff,34,0,75,41
1650157760274,COGS 100,A01,083619,Staff,0,21,60,60
1650157766298,COGS 101A,A01,083621,Davis; Joshua Daniel,0,21,60,60
1650157772321,COGS 101B,A01,091572,Staff,9,0,60,51
1650157778347,COGS 101C,A01,083625,Delgado; Tania,21,0,30,9
1650157784376,COGS 107A,A01,083627,Boyle; Mary E. T.,0,7,60,60
1650157790400,COGS 118A,A01,083075,Staff,17,0,60,43
1650157796429,CSE 3,A50,083646,Miranda; Gregory Joseph,22,0,38,16
1650157796429,CSE 3,A51,083647,Miranda; Gregory Joseph,37,0,37,0
1650157802457,CSE 8A,A50,083650,Miranda; Gregory Joseph,0,17,40,40
1650157808481,CSE 11,A01,083080,Cao; Yingjun,0,65,40,40
1650157814503,CSE 12,A01,083652,Staff,0,5,100,100
1650157820526,CSE 15L,A01,083654,Staff,0,0,50,50
1650157820526,CSE 15L,A02,083655,Staff,8,0,50,42
1650157826549,CSE 20,A01,083657,Staff,54,0,80,26
1650157832575,CSE 30,A01,083084,Eldon; John,0,65,40,40
1650157838602,CSE 100,A01,083659,Cao; Yingjun,0,61,50,50
1650157844627,CSE 134B,A01,083661,Powell; Thomas Allan,0,27,65,65
1650157850653,CSE 140,A01,083663,Staff,3,0,75,72
1650157856677,CSE 140L,A01,083088,Eldon; John,0,2,75,75
1650157862699,CSE 175,A01,083665,Kumar; Rakesh,8,0,25,17
1650157868723,CSE 190,A00,092507,Dubnov; Shlomo,14,0,20,6
1650157874747,ECE 45,A01,083139,Staff,0,14,40,40
1650157880780,ECE 65,A50,083695,Staff,0,4,30,30
1650157886806,ECE 109,A01,091882,Touri; Behrouz,47,0,70,23
1650157892829,ECE 180,A00,083140,Abi Samra; Nicholas Camill,24,0,30,6
1650157892829,ECE 180,B00,083141,Abi Samra; Nicholas Camill,8,0,30,22
1650157898853,MATH 10A,A01,083735,Patchell; Gregory David,12,0,30,18
1650157898853,MATH 10A,A02,083736,Patchell; Gregory David,28,0,30,2
1650157898853,MATH 10A,A03,083737,Patchell; Gregory David,26,0,30,4
1650157904889,MATH 10B,A01,083207,Staff,0,5,30,30
1650157904889,MATH 10B,A02,083208,Staff,0,4,30,30
1650157904889,MATH 10B,B01,083739,Staff,17,0,30,13
1650157904889,MATH 10B,B02,083740,Staff,29,0,30,1
1650157910923,MATH 18,A01,083743,Staff,10,0,30,20
1650157910923,MATH 18,A02,083744,Staff,28,0,30,2
1650157910923,MATH 18,A03,083745,Staff,23,0,30,7
1650157910923,MATH 18,A04,083746,Staff,27,0,30,3
1650157910923,MATH 18,B01,083748,Staff,0,10,30,30
1650157910923,MATH 18,B02,083749,Staff,0,7,30,30
1650157910923,MATH 18,B03,083750,Staff,0,6,30,30
1650157910923,MATH 18,B04,083751,Staff,0,7,30,30
1650157916946,MATH 20A,A01,083754,Staff,26,0,40,14
1650157922974,MATH 20B,A01,083756,Staff,0,5,30,30
1650157922974,MATH 20B,A02,083757,Staff,0,4,30,30
1650157928999,MATH 20C,A01,083760,Staff,0,12,30,30
1650157928999,MATH 20C,A02,083761,Staff,0,12,30,30
1650157928999,MATH 20C,B01,083762,Staff,14,0,30,16
1650157928999,MATH 20C,B02,083763,Staff,28,0,30,2
1650157935028,MATH 20D,A01,083765,Staff,0,2,30,30
1650157935028,MATH 20D,A02,083766,Staff,10,0,30,20
1650157935028,MATH 20D,A03,083767,Staff,28,0,30,2
1650157941053,MATH 20E,A01,083771,Staff,8,0,30,22
1650157941053,MATH 20E,A02,083772,Staff,20,0,30,10
1650157941053,MATH 20E,B01,083773,Staff,0,0,30,30
1650157941053,MATH 20E,B02,083774,Staff,13,0,30,17
1650157947077,MATH 103A,A01,083777,Staff,0,8,30,30
1650157947077,MATH 103A,A02,083778,Staff,0,9,30,30
1650157947077,MATH 103A,B01,083779,Staff,1,10,30,29
1650157947077,MATH 103A,B02,083780,Staff,0,7,30,30
1650157953100,MATH 105,A01,085443,Staff,0,16,30,30
1650157959125,MATH 109,A01,083213,Anzaldo; Leesa B,0,3,30,30
1650157959125,MATH 109,A02,083214,Anzaldo; Leesa B,0,6,30,30
1650157959125,MATH 109,B01,083215,Anzaldo; Leesa B,0,4,30,30
1650157959125,MATH 109,B02,083216,Anzaldo; Leesa B,0,4,30,30
1650157965152,MATH 142A,A01,083219,Chow; Bennett,0,11,30,30
1650157965152,MATH 142A,A02,083220,Chow; Bennett,0,11,30,30
1650157965152,MATH 142A,B01,083221,Chow; Bennett,0,11,30,30
1650157965152,MATH 142A,B02,083222,Chow; Bennett,0,11,30,30
1650157971176,MATH 193A,A01,083224,Staff,0,3,30,30
1650157971176,MATH 193A,A02,083225,Staff,0,4,30,30
1650157971176,MATH 193A,A03,083781,Staff,0,0,30,30
1650157971176,MATH 193A,A04,083782,Staff,0,0,30,30
1650157977198,MATH 197,001,091859,McAuley; Julian John,9998,0,9999,1
1650157983251,COGS 9,A01,083615,Staff,0,14,60,60
1650157989275,COGS 11,A01,083617,Boyle; Mary E. T.,24,0,40,16
1650157995298,COGS 13,A01,083071,Staff,0,29,40,40
1650158001324,COGS 14A,A01,092681,Staff,0,10,100,100
1650158007348,COGS 14B,A01,083073,Cheng; Tzu-Han,0,5,50,50
1650158013372,COGS 17,A01,092677,Staff,34,0,75,41
1650158019395,COGS 100,A01,083619,Staff,0,21,60,60
1650158025422,COGS 101A,A01,083621,Davis; Joshua Daniel,0,21,60,60
1650158031445,COGS 101B,A01,091572,Staff,9,0,60,51
1650158037468,COGS 101C,A01,083625,Delgado; Tania,21,0,30,9
1650158043493,COGS 107A,A01,083627,Boyle; Mary E. T.,0,7,60,60
1650158049517,COGS 118A,A01,083075,Staff,17,0,60,43
1650158055541,CSE 3,A50,083646,Miranda; Gregory Joseph,22,0,38,16
1650158055541,CSE 3,A51,083647,Miranda; Gregory Joseph,37,0,37,0
1650158061565,CSE 8A,A50,083650,Miranda; Gregory Joseph,0,17,40,40
1650158067588,CSE 11,A01,083080,Cao; Yingjun,0,65,40,40
1650158073611,CSE 12,A01,083652,Staff,0,5,100,100
1650158079638,CSE 15L,A01,083654,Staff,0,0,50,50
1650158079638,CSE 15L,A02,083655,Staff,8,0,50,42
1650158085665,CSE 20,A01,083657,Staff,54,0,80,26
1650158091695,CSE 30,A01,083084,Eldon; John,0,65,40,40
1650158097719,CSE 100,A01,083659,Cao; Yingjun,0,61,50,50
1650158103742,CSE 134B,A01,083661,Powell; Thomas Allan,0,27,65,65
1650158109765,CSE 140,A01,083663,Staff,3,0,75,72
1650158115797,CSE 140L,A01,083088,Eldon; John,0,2,75,75
1650158121820,CSE 175,A01,083665,Kumar; Rakesh,8,0,25,17
1650158127844,CSE 190,A00,092507,Dubnov; Shlomo,14,0,20,6
1650158133868,ECE 45,A01,083139,Staff,0,14,40,40
1650158139895,ECE 65,A50,083695,Staff,0,4,30,30
1650158145923,ECE 109,A01,091882,Touri; Behrouz,47,0,70,23
1650158151948,ECE 180,A00,083140,Abi Samra; Nicholas Camill,24,0,30,6
1650158151948,ECE 180,B00,083141,Abi Samra; Nicholas Camill,8,0,30,22
1650158157971,MATH 10A,A01,083735,Patchell; Gregory David,12,0,30,18
1650158157971,MATH 10A,A02,083736,Patchell; Gregory David,28,0,30,2
1650158157971,MATH 10A,A03,083737,Patchell; Gregory David,26,0,30,4
1650158164000,MATH 10B,A01,083207,Staff,0,5,30,30
1650158164000,MATH 10B,A02,083208,Staff,0,4,30,30
1650158164000,MATH 10B,B01,083739,Staff,17,0,30,13
1650158164000,MATH 10B,B02,083740,Staff,29,0,30,1
1650158170030,MATH 18,A01,083743,Staff,10,0,30,20
1650158170030,MATH 18,A02,083744,Staff,28,0,30,2
1650158170030,MATH 18,A03,083745,Staff,23,0,30,7
1650158170030,MATH 18,A04,083746,Staff,27,0,30,3
1650158170030,MATH 18,B01,083748,Staff,0,10,30,30
1650158170030,MATH 18,B02,083749,Staff,0,7,30,30
1650158170030,MATH 18,B03,083750,Staff,0,6,30,30
1650158170030,MATH 18,B04,083751,Staff,0,7,30,30
1650158176055,MATH 20A,A01,083754,Staff,26,0,40,14
1650158182079,MATH 20B,A01,083756,Staff,0,5,30,30
1650158182079,MATH 20B,A02,083757,Staff,0,4,30,30
1650158188103,MATH 20C,A01,083760,Staff,0,12,30,30
1650158188103,MATH 20C,A02,083761,Staff,0,12,30,30
1650158188103,MATH 20C,B01,083762,Staff,14,0,30,16
1650158188103,MATH 20C,B02,083763,Staff,28,0,30,2
1650158194136,MATH 20D,A01,083765,Staff,0,2,30,30
1650158194136,MATH 20D,A02,083766,Staff,10,0,30,20
1650158194136,MATH 20D,A03,083767,Staff,28,0,30,2
1650158200160,MATH 20E,A01,083771,Staff,8,0,30,22
1650158200160,MATH 20E,A02,083772,Staff,20,0,30,10
1650158200160,MATH 20E,B01,083773,Staff,0,0,30,30
1650158200160,MATH 20E,B02,083774,Staff,13,0,30,17
1650158206189,MATH 103A,A01,083777,Staff,0,8,30,30
1650158206189,MATH 103A,A02,083778,Staff,0,9,30,30
1650158206189,MATH 103A,B01,083779,Staff,1,10,30,29
1650158206189,MATH 103A,B02,083780,Staff,0,7,30,30
1650158212219,MATH 105,A01,085443,Staff,0,16,30,30
1650158218242,MATH 109,A01,083213,Anzaldo; Leesa B,0,3,30,30
1650158218242,MATH 109,A02,083214,Anzaldo; Leesa B,0,6,30,30
1650158218242,MATH 109,B01,083215,Anzaldo; Leesa B,0,4,30,30
1650158218242,MATH 109,B02,083216,Anzaldo; Leesa B,0,4,30,30
1650158224268,MATH 142A,A01,083219,Chow; Bennett,0,11,30,30
1650158224268,MATH 142A,A02,083220,Chow; Bennett,0,11,30,30
1650158224268,MATH 142A,B01,083221,Chow; Bennett,0,11,30,30
1650158224268,MATH 142A,B02,083222,Chow; Bennett,0,11,30,30
1650158230296,MATH 193A,A01,083224,Staff,0,3,30,30
1650158230296,MATH 193A,A02,083225,Staff,0,4,30,30
1650158230296,MATH 193A,A03,083781,Staff,0,0,30,30
1650158230296,MATH 193A,A04,083782,Staff,0,0,30,30
1650158236339,MATH 197,001,091859,McAuley; Julian John,9998,0,9999,1
1650158242400,COGS 9,A01,083615,Staff,0,14,60,60
1650158248427,COGS 11,A01,083617,Boyle; Mary E. T.,24,0,40,16
1650158254449,COGS 13,A01,083071,Staff,0,29,40,40
1650158260474,COGS 14A,A01,092681,Staff,0,10,100,100
1650158266519,COGS 14B,A01,083073,Cheng; Tzu-Han,0,5,50,50
1650158272548,COGS 17,A01,092677,Staff,34,0,75,41
1650158278571,COGS 100,A01,083619,Staff,0,21,60,60
1650158284595,COGS 101A,A01,083621,Davis; Joshua Daniel,0,21,60,60
1650158290618,COGS 101B,A01,091572,Staff,9,0,60,51
1650158296642,COGS 101C,A01,083625,Delgado; Tania,21,0,30,9
1650158302666,COGS 107A,A01,083627,Boyle; Mary E. T.,0,7,60,60
1650158308689,COGS 118A,A01,083075,Staff,17,0,60,43
1650158314720,CSE 3,A50,083646,Miranda; Gregory Joseph,22,0,38,16
1650158314720,CSE 3,A51,083647,Miranda; Gregory Joseph,37,0,37,0
1650158320747,CSE 8A,A50,083650,Miranda; Gregory Joseph,0,17,40,40
1650158326769,CSE 11,A01,083080,Cao; Yingjun,0,65,40,40
1650158332804,CSE 12,A01,083652,Staff,0,5,100,100
1650158338837,CSE 15L,A01,083654,Staff,0,0,50,50
1650158338837,CSE 15L,A02,083655,Staff,8,0,50,42
1650158344863,CSE 20,A01,083657,Staff,54,0,80,26
1650158350888,CSE 30,A01,083084,Eldon; John,0,65,40,40
1650158356987,CSE 100,A01,083659,Cao; Yingjun,0,61,50,50
1650158363014,CSE 134B,A01,083661,Powell; Thomas Allan,0,27,65,65
1650158369037,CSE 140,A01,083663,Staff,3,0,75,72
1650158375060,CSE 140L,A01,083088,Eldon; John,0,2,75,75
1650158381084,CSE 175,A01,083665,Kumar; Rakesh,8,0,25,17
1650158387110,CSE 190,A00,092507,Dubnov; Shlomo,14,0,20,6
1650158393133,ECE 45,A01,083139,Staff,0,14,40,40
1650158399160,ECE 65,A50,083695,Staff,0,4,30,30
1650158405186,ECE 109,A01,091882,Touri; Behrouz,47,0,70,23
1650158411213,ECE 180,A00,083140,Abi Samra; Nicholas Camill,24,0,30,6
1650158411213,ECE 180,B00,083141,Abi Samra; Nicholas Camill,8,0,30,22
1650158417237,MATH 10A,A01,083735,Patchell; Gregory David,12,0,30,18
1650158417237,MATH 10A,A02,083736,Patchell; Gregory David,28,0,30,2
1650158417237,MATH 10A,A03,083737,Patchell; Gregory David,26,0,30,4
1650158423263,MATH 10B,A01,083207,Staff,0,5,30,30
1650158423263,MATH 10B,A02,083208,Staff,0,4,30,30
1650158423263,MATH 10B,B01,083739,Staff,17,0,30,13
1650158423263,MATH 10B,B02,083740,Staff,29,0,30,1
1650158429294,MATH 18,A01,083743,Staff,10,0,30,20
1650158429294,MATH 18,A02,083744,Staff,28,0,30,2
1650158429294,MATH 18,A03,083745,Staff,23,0,30,7
1650158429294,MATH 18,A04,083746,Staff,27,0,30,3
1650158429294,MATH 18,B01,083748,Staff,0,10,30,30
1650158429294,MATH 18,B02,083749,Staff,0,7,30,30
1650158429294,MATH 18,B03,083750,Staff,0,6,30,30
1650158429294,MATH 18,B04,083751,Staff,0,7,30,30
1650158435317,MATH 20A,A01,083754,Staff,26,0,40,14
1650158441341,MATH 20B,A01,083756,Staff,0,5,30,30
1650158441341,MATH 20B,A02,083757,Staff,0,4,30,30
1650158447366,MATH 20C,A01,083760,Staff,0,12,30,30
1650158447366,MATH 20C,A02,083761,Staff,0,12,30,30
1650158447366,MATH 20C,B01,083762,Staff,14,0,30,16
1650158447366,MATH 20C,B02,083763,Staff,28,0,30,2
1650158453398,MATH 20D,A01,083765,Staff,0,2,30,30
1650158453398,MATH 20D,A02,083766,Staff,10,0,30,20
1650158453398,MATH 20D,A03,083767,Staff,28,0,30,2
1650158459423,MATH 20E,A01,083771,Staff,8,0,30,22
1650158459423,MATH 20E,A02,083772,Staff,20,0,30,10
1650158459423,MATH 20E,B01,083773,Staff,0,0,30,30
1650158459423,MATH 20E,B02,083774,Staff,13,0,30,17
1650158465449,MATH 103A,A01,083777,Staff,0,8,30,30
1650158465449,MATH 103A,A02,083778,Staff,0,9,30,30
1650158465449,MATH 103A,B01,083779,Staff,1,10,30,29
1650158465449,MATH 103A,B02,083780,Staff,0,7,30,30
1650158471476,MATH 105,A01,085443,Staff,0,16,30,30
1650158477507,MATH 109,A01,083213,Anzaldo; Leesa B,0,3,30,30
1650158477507,MATH 109,A02,083214,Anzaldo; Leesa B,0,6,30,30
1650158477507,MATH 109,B01,083215,Anzaldo; Leesa B,0,4,30,30
1650158477507,MATH 109,B02,083216,Anzaldo; Leesa B,0,4,30,30
1650158483536,MATH 142A,A01,083219,Chow; Bennett,0,11,30,30
1650158483536,MATH 142A,A02,083220,Chow; Bennett,0,11,30,30
1650158483536,MATH 142A,B01,083221,Chow; Bennett,0,11,30,30
1650158483536,MATH 142A,B02,083222,Chow; Bennett,0,11,30,30
1650158489567,MATH 193A,A01,083224,Staff,0,3,30,30
1650158489567,MATH 193A,A02,083225,Staff,0,4,30,30
1650158489567,MATH 193A,A03,083781,Staff,0,0,30,30
1650158489567,MATH 193A,A04,083782,Staff,0,0,30,30
1650158495595,MATH 197,001,091859,McAuley; Julian John,9998,0,9999,1
1650158501649,COGS 9,A01,083615,Staff,0,14,60,60
1650158507677,COGS 11,A01,083617,Boyle; Mary E. T.,24,0,40,16
1650158513702,COGS 13,A01,083071,Staff,0,29,40,40
1650158519730,COGS 14A,A01,092681,Staff,0,11,100,100
1650158525758,COGS 14B,A01,083073,Cheng; Tzu-Han,0,5,50,50
1650158531780,COGS 17,A01,092677,Staff,34,0,75,41
1650158537805,COGS 100,A01,083619,Staff,0,21,60,60
1650158543832,COGS 101A,A01,083621,Davis; Joshua Daniel,0,21,60,60
1650158549857,COGS 101B,A01,091572,Staff,9,0,60,51
1650158555885,COGS 101C,A01,083625,Delgado; Tania,21,0,30,9
1650158561917,COGS 107A,A01,083627,Boyle; Mary E. T.,0,7,60,60
1650158567943,COGS 118A,A01,083075,Staff,17,0,60,43
1650158573967,CSE 3,A50,083646,Miranda; Gregory Joseph,22,0,38,16
1650158573967,CSE 3,A51,083647,Miranda; Gregory Joseph,37,0,37,0
1650158579990,CSE 8A,A50,083650,Miranda; Gregory Joseph,0,17,40,40
1650158586018,CSE 11,A01,083080,Cao; Yingjun,0,65,40,40
1650158592055,CSE 12,A01,083652,Staff,0,5,100,100
1650158598084,CSE 15L,A01,083654,Staff,0,0,50,50
1650158598084,CSE 15L,A02,083655,Staff,8,0,50,42
1650158604114,CSE 20,A01,083657,Staff,54,0,80,26
1650158610138,CSE 30,A01,083084,Eldon; John,0,65,40,40
1650158616163,CSE 100,A01,083659,Cao; Yingjun,0,61,50,50
1650158622187,CSE 134B,A01,083661,Powell; Thomas Allan,0,27,65,65
1650158628213,CSE 140,A01,083663,Staff,3,0,75,72
1650158634237,CSE 140L,A01,083088,Eldon; John,0,2,75,75
1650158640262,CSE 175,A01,083665,Kumar; Rakesh,8,0,25,17
1650158646285,CSE 190,A00,092507,Dubnov; Shlomo,14,0,20,6
1650158652310,ECE 45,A01,083139,Staff,0,14,40,40
1650158658333,ECE 65,A50,083695,Staff,0,4,30,30
1650158664357,ECE 109,A01,091882,Touri; Behrouz,47,0,70,23
1650158670383,ECE 180,A00,083140,Abi Samra; Nicholas Camill,24,0,30,6
1650158670383,ECE 180,B00,083141,Abi Samra; Nicholas Camill,8,0,30,22
1650158676411,MATH 10A,A01,083735,Patchell; Gregory David,12,0,30,18
1650158676411,MATH 10A,A02,083736,Patchell; Gregory David,28,0,30,2
1650158676411,MATH 10A,A03,083737,Patchell; Gregory David,26,0,30,4
1650158682435,MATH 10B,A01,083207,Staff,0,5,30,30
1650158682435,MATH 10B,A02,083208,Staff,0,4,30,30
1650158682435,MATH 10B,B01,083739,Staff,17,0,30,13
1650158682435,MATH 10B,B02,083740,Staff,29,0,30,1
1650158688461,MATH 18,A01,083743,Staff,10,0,30,20
1650158688461,MATH 18,A02,083744,Staff,28,0,30,2
1650158688461,MATH 18,A03,083745,Staff,23,0,30,7
1650158688461,MATH 18,A04,083746,Staff,27,0,30,3
1650158688461,MATH 18,B01,083748,Staff,0,10,30,30
1650158688461,MATH 18,B02,083749,Staff,0,7,30,30
1650158688461,MATH 18,B03,083750,Staff,0,7,30,30
1650158688461,MATH 18,B04,083751,Staff,0,7,30,30
1650158694487,MATH 20A,A01,083754,Staff,26,0,40,14
1650158700515,MATH 20B,A01,083756,Staff,0,5,30,30
1650158700515,MATH 20B,A02,083757,Staff,0,4,30,30
1650158706539,MATH 20C,A01,083760,Staff,0,12,30,30
1650158706539,MATH 20C,A02,083761,Staff,0,12,30,30
1650158706539,MATH 20C,B01,083762,Staff,14,0,30,16
1650158706539,MATH 20C,B02,083763,Staff,28,0,30,2
1650158712564,MATH 20D,A01,083765,Staff,0,2,30,30
1650158712564,MATH 20D,A02,083766,Staff,10,0,30,20
1650158712564,MATH 20D,A03,083767,Staff,28,0,30,2
1650158718592,MATH 20E,A01,083771,Staff,8,0,30,22
1650158718592,MATH 20E,A02,083772,Staff,20,0,30,10
1650158718592,MATH 20E,B01,083773,Staff,0,0,30,30
1650158718592,MATH 20E,B02,083774,Staff,13,0,30,17
1650158724616,MATH 103A,A01,083777,Staff,0,8,30,30
1650158724616,MATH 103A,A02,083778,Staff,0,9,30,30
1650158724616,MATH 103A,B01,083779,Staff,1,10,30,29
1650158724616,MATH 103A,B02,083780,Staff,0,7,30,30
1650158730643,MATH 105,A01,085443,Staff,0,16,30,30
1650158736667,MATH 109,A01,083213,Anzaldo; Leesa B,0,3,30,30
1650158736667,MATH 109,A02,083214,Anzaldo; Leesa B,0,6,30,30
1650158736667,MATH 109,B01,083215,Anzaldo; Leesa B,0,4,30,30
1650158736667,MATH 109,B02,083216,Anzaldo; Leesa B,0,4,30,30
1650158742693,MATH 142A,A01,083219,Chow; Bennett,0,11,30,30
1650158742693,MATH 142A,A02,083220,Chow; Bennett,0,11,30,30
1650158742693,MATH 142A,B01,083221,Chow; Bennett,0,11,30,30
1650158742693,MATH 142A,B02,083222,Chow; Bennett,0,11,30,30
1650158748717,MATH 193A,A01,083224,Staff,0,3,30,30
1650158748717,MATH 193A,A02,083225,Staff,0,4,30,30
1650158748717,MATH 193A,A03,083781,Staff,0,0,30,30
1650158748717,MATH 193A,A04,083782,Staff,0,0,30,30
1650158754744,MATH 197,001,091859,McAuley; Julian John,9998,0,9999,1
1650158760794,COGS 9,A01,083615,Staff,0,14,60,60
1650158766817,COGS 11,A01,083617,Boyle; Mary E. T.,24,0,40,16
1650158772845,COGS 13,A01,083071,Staff,0,29,40,40
1650158778870,COGS 14A,A01,092681,Staff,0,11,100,100
1650158784903,COGS 14B,A01,083073,Cheng; Tzu-Han,0,6,50,50
1650158790926,COGS 17,A01,092677,Staff,34,0,75,41
1650158796952,COGS 100,A01,083619,Staff,0,21,60,60
1650158802975,COGS 101A,A01,083621,Davis; Joshua Daniel,0,21,60,60
1650158809009,COGS 101B,A01,091572,Staff,8,0,60,52
1650158815038,COGS 101C,A01,083625,Delgado; Tania,21,0,30,9
1650158821070,COGS 107A,A01,083627,Boyle; Mary E. T.,0,8,60,60
1650158827097,COGS 118A,A01,083075,Staff,17,0,60,43
1650158833120,CSE 3,A50,083646,Miranda; Gregory Joseph,22,0,38,16
1650158833120,CSE 3,A51,083647,Miranda; Gregory Joseph,37,0,37,0
1650158839149,CSE 8A,A50,083650,Miranda; Gregory Joseph,0,17,40,40
1650158845170,CSE 11,A01,083080,Cao; Yingjun,0,65,40,40
1650158851194,CSE 12,A01,083652,Staff,0,5,100,100
1650158857220,CSE 15L,A01,083654,Staff,0,0,50,50
1650158857220,CSE 15L,A02,083655,Staff,8,0,50,42
1650158863243,CSE 20,A01,083657,Staff,54,0,80,26
1650158869275,CSE 30,A01,083084,Eldon; John,0,65,40,40
1650158875299,CSE 100,A01,083659,Cao; Yingjun,0,62,50,50
1650158881327,CSE 134B,A01,083661,Powell; Thomas Allan,0,27,65,65
1650158887350,CSE 140,A01,083663,Staff,2,0,75,73
1650158893374,CSE 140L,A01,083088,Eldon; John,0,3,75,75
1650158899397,CSE 175,A01,083665,Kumar; Rakesh,8,0,25,17
1650158905421,CSE 190,A00,092507,Dubnov; Shlomo,14,0,20,6
1650158911444,ECE 45,A01,083139,Staff,0,14,40,40
1650158917467,ECE 65,A50,083695,Staff,0,4,30,30
1650158923498,ECE 109,A01,091882,Touri; Behrouz,47,0,70,23
1650158929521,ECE 180,A00,083140,Abi Samra; Nicholas Camill,24,0,30,6
1650158929521,ECE 180,B00,083141,Abi Samra; Nicholas Camill,8,0,30,22
1650158935545,MATH 10A,A01,083735,Patchell; Gregory David,12,0,30,18
1650158935545,MATH 10A,A02,083736,Patchell; Gregory David,28,0,30,2
1650158935545,MATH 10A,A03,083737,Patchell; Gregory David,26,0,30,4
1650158941581,MATH 10B,A01,083207,Staff,0,5,30,30
1650158941581,MATH 10B,A02,083208,Staff,0,4,30,30
1650158941581,MATH 10B,B01,083739,Staff,17,0,30,13
1650158941581,MATH 10B,B02,083740,Staff,29,0,30,1
1650158947609,MATH 18,A01,083743,Staff,10,0,30,20
1650158947609,MATH 18,A02,083744,Staff,28,0,30,2
1650158947609,MATH 18,A03,083745,Staff,23,0,30,7
1650158947609,MATH 18,A04,083746,Staff,27,0,30,3
1650158947609,MATH 18,B01,083748,Staff,0,10,30,30
1650158947609,MATH 18,B02,083749,Staff,0,7,30,30
1650158947609,MATH 18,B03,083750,Staff,0,7,30,30
1650158947609,MATH 18,B04,083751,Staff,0,7,30,30
1650158953705,MATH 20A,A01,083754,Staff,26,0,40,14
1650158959732,MATH 20B,A01,083756,Staff,0,5,30,30
1650158959732,MATH 20B,A02,083757,Staff,0,4,30,30
1650158965755,MATH 20C,A01,083760,Staff,0,12,30,30
1650158965755,MATH 20C,A02,083761,Staff,0,12,30,30
1650158965755,MATH 20C,B01,083762,Staff,14,0,30,16
1650158965755,MATH 20C,B02,083763,Staff,28,0,30,2
1650158971780,MATH 20D,A01,083765,Staff,0,2,30,30
1650158971780,MATH 20D,A02,083766,Staff,10,0,30,20
1650158971780,MATH 20D,A03,083767,Staff,28,0,30,2
1650158977810,MATH 20E,A01,083771,Staff,8,0,30,22
1650158977810,MATH 20E,A02,083772,Staff,20,0,30,10
1650158977810,MATH 20E,B01,083773,Staff,0,0,30,30
1650158977810,MATH 20E,B02,083774,Staff,13,0,30,17
1650158983834,MATH 103A,A01,083777,Staff,0,8,30,30
1650158983834,MATH 103A,A02,083778,Staff,0,9,30,30
1650158983834,MATH 103A,B01,083779,Staff,1,10,30,29
1650158983834,MATH 103A,B02,083780,Staff,0,7,30,30
1650158989857,MATH 105,A01,085443,Staff,0,16,30,30
1650158995885,MATH 109,A01,083213,Anzaldo; Leesa B,0,3,30,30
1650158995885,MATH 109,A02,083214,Anzaldo; Leesa B,0,6,30,30
1650158995885,MATH 109,B01,083215,Anzaldo; Leesa B,0,4,30,30
1650158995885,MATH 109,B02,083216,Anzaldo; Leesa B,0,4,30,30
1650159001919,MATH 142A,A01,083219,Chow; Bennett,0,11,30,30
1650159001919,MATH 142A,A02,083220,Chow; Bennett,0,11,30,30
1650159001919,MATH 142A,B01,083221,Chow; Bennett,0,11,30,30
1650159001919,MATH 142A,B02,083222,Chow; Bennett,0,11,30,30
1650159007947,MATH 193A,A01,083224,Staff,0,3,30,30
1650159007947,MATH 193A,A02,083225,Staff,0,4,30,30
1650159007947,MATH 193A,A03,083781,Staff,0,0,30,30
1650159007947,MATH 193A,A04,083782,Staff,0,0,30,30
1650159013969,MATH 197,001,091859,McAuley; Julian John,9998,0,9999,1
1650159020025,COGS 9,A01,083615,Staff,0,14,60,60
1650159026048,COGS 11,A01,083617,Boyle; Mary E. T.,24,0,40,16
1650159032077,COGS 13,A01,083071,Staff,0,29,40,40
1650159038104,COGS 14A,A01,092681,Staff,0,11,100,100
1650159044128,COGS 14B,A01,083073,Cheng; Tzu-Han,0,6,50,50
1650159050157,COGS 17,A01,092677,Staff,34,0,75,41
1650159056181,COGS 100,A01,083619,Staff,0,21,60,60
1650159062206,COGS 101A,A01,083621,Davis; Joshua Daniel,0,21,60,60
1650159068229,COGS 101B,A01,091572,Staff,8,0,60,52
1650159074251,COGS 101C,A01,083625,Delgado; Tania,20,0,30,10
1650159080278,COGS 107A,A01,083627,Boyle; Mary E. T.,0,7,60,60
1650159086305,COGS 118A,A01,083075,Staff,17,0,60,43
1650159092327,CSE 3,A50,083646,Miranda; Gregory Joseph,22,0,38,16
1650159092327,CSE 3,A51,083647,Miranda; Gregory Joseph,37,0,37,0
1650159098359,CSE 8A,A50,083650,Miranda; Gregory Joseph,0,17,40,40
1650159104382,CSE 11,A01,083080,Cao; Yingjun,0,65,40,40
1650159110404,CSE 12,A01,083652,Staff,0,5,100,100
1650159116438,CSE 15L,A01,083654,Staff,0,0,50,50
1650159116438,CSE 15L,A02,083655,Staff,8,0,50,42
1650159122463,CSE 20,A01,083657,Staff,54,0,80,26
1650159128486,CSE 30,A01,083084,Eldon; John,0,65,40,40
1650159134514,CSE 100,A01,083659,Cao; Yingjun,0,62,50,50
1650159140538,CSE 134B,A01,083661,Powell; Thomas Allan,0,27,65,65
1650159146563,CSE 140,A01,083663,Staff,2,0,75,73
1650159152589,CSE 140L,A01,083088,Eldon; John,0,3,75,75
1650159158613,CSE 175,A01,083665,Kumar; Rakesh,8,0,25,17
1650159164639,CSE 190,A00,092507,Dubnov; Shlomo,14,0,20,6
1650159170666,ECE 45,A01,083139,Staff,0,14,40,40
1650159176689,ECE 65,A50,083695,Staff,0,4,30,30
1650159182712,ECE 109,A01,091882,Touri; Behrouz,47,0,70,23
1650159188740,ECE 180,A00,083140,Abi Samra; Nicholas Camill,24,0,30,6
1650159188740,ECE 180,B00,083141,Abi Samra; Nicholas Camill,8,0,30,22
1650159194762,MATH 10A,A01,083735,Patchell; Gregory David,12,0,30,18
1650159194762,MATH 10A,A02,083736,Patchell; Gregory David,28,0,30,2
1650159194762,MATH 10A,A03,083737,Patchell; Gregory David,26,0,30,4
1650159200788,MATH 10B,A01,083207,Staff,0,5,30,30
1650159200788,MATH 10B,A02,083208,Staff,0,4,30,30
1650159200788,MATH 10B,B01,083739,Staff,17,0,30,13
1650159200788,MATH 10B,B02,083740,Staff,29,0,30,1
1650159206818,MATH 18,A01,083743,Staff,10,0,30,20
1650159206818,MATH 18,A02,083744,Staff,28,0,30,2
1650159206818,MATH 18,A03,083745,Staff,23,0,30,7
1650159206818,MATH 18,A04,083746,Staff,27,0,30,3
1650159206818,MATH 18,B01,083748,Staff,0,10,30,30
1650159206818,MATH 18,B02,083749,Staff,0,7,30,30
1650159206818,MATH 18,B03,083750,Staff,0,7,30,30
1650159206818,MATH 18,B04,083751,Staff,0,7,30,30
1650159212851,MATH 20A,A01,083754,Staff,26,0,40,14
1650159218889,MATH 20B,A01,083756,Staff,0,5,30,30
1650159218889,MATH 20B,A02,083757,Staff,0,4,30,30
1650159224913,MATH 20C,A01,083760,Staff,0,12,30,30
1650159224913,MATH 20C,A02,083761,Staff,0,12,30,30
1650159224913,MATH 20C,B01,083762,Staff,14,0,30,16
1650159224913,MATH 20C,B02,083763,Staff,28,0,30,2
1650159230941,MATH 20D,A01,083765,Staff,0,2,30,30
1650159230941,MATH 20D,A02,083766,Staff,10,0,30,20
1650159230941,MATH 20D,A03,083767,Staff,28,0,30,2
1650159236971,MATH 20E,A01,083771,Staff,8,0,30,22
1650159236971,MATH 20E,A02,083772,Staff,20,0,30,10
1650159236971,MATH 20E,B01,083773,Staff,0,0,30,30
1650159236971,MATH 20E,B02,083774,Staff,13,0,30,17
1650159242995,MATH 103A,A01,083777,Staff,0,8,30,30
1650159242995,MATH 103A,A02,083778,Staff,0,9,30,30
1650159242995,MATH 103A,B01,083779,Staff,1,10,30,29
1650159242995,MATH 103A,B02,083780,Staff,0,7,30,30
1650159249019,MATH 105,A01,085443,Staff,0,16,30,30
1650159255044,MATH 109,A01,083213,Anzaldo; Leesa B,0,3,30,30
1650159255044,MATH 109,A02,083214,Anzaldo; Leesa B,0,6,30,30
1650159255044,MATH 109,B01,083215,Anzaldo; Leesa B,0,4,30,30
1650159255044,MATH 109,B02,083216,Anzaldo; Leesa B,0,4,30,30
1650159261068,MATH 142A,A01,083219,Chow; Bennett,0,11,30,30
1650159261068,MATH 142A,A02,083220,Chow; Bennett,0,11,30,30
1650159261068,MATH 142A,B01,083221,Chow; Bennett,0,11,30,30
1650159261068,MATH 142A,B02,083222,Chow; Bennett,0,11,30,30
1650159267092,MATH 193A,A01,083224,Staff,0,3,30,30
1650159267092,MATH 193A,A02,083225,Staff,0,4,30,30
1650159267092,MATH 193A,A03,083781,Staff,0,0,30,30
1650159267092,MATH 193A,A04,083782,Staff,0,0,30,30
1650159273118,MATH 197,001,091859,McAuley; Julian John,9998,0,9999,1
1650159279172,COGS 9,A01,083615,Staff,0,14,60,60
1650159285203,COGS 11,A01,083617,Boyle; Mary E. T.,24,0,40,16
1650159291229,COGS 13,A01,083071,Staff,0,29,40,40
1650159297254,COGS 14A,A01,092681,Staff,0,11,100,100
1650159303278,COGS 14B,A01,083073,Cheng; Tzu-Han,0,6,50,50
1650159309311,COGS 17,A01,092677,Staff,34,0,75,41
1650159315343,COGS 100,A01,083619,Staff,0,21,60,60
1650159321366,COGS 101A,A01,083621,Davis; Joshua Daniel,0,21,60,60
1650159327390,COGS 101B,A01,091572,Staff,8,0,60,52
1650159333415,COGS 101C,A01,083625,Delgado; Tania,20,0,30,10
1650159339439,COGS 107A,A01,083627,Boyle; Mary E. T.,0,7,60,60
1650159345463,COGS 118A,A01,083075,Staff,17,0,60,43
1650159351487,CSE 3,A50,083646,Miranda; Gregory Joseph,22,0,38,16
1650159351487,CSE 3,A51,083647,Miranda; Gregory Joseph,37,0,37,0
1650159357515,CSE 8A,A50,083650,Miranda; Gregory Joseph,0,17,40,40
1650159363541,CSE 11,A01,083080,Cao; Yingjun,0,65,40,40
1650159369564,CSE 12,A01,083652,Staff,0,5,100,100
1650159375588,CSE 15L,A01,083654,Staff,0,0,50,50
1650159375588,CSE 15L,A02,083655,Staff,8,0,50,42
1650159381617,CSE 20,A01,083657,Staff,54,0,80,26
1650159387639,CSE 30,A01,083084,Eldon; John,0,65,40,40
1650159393663,CSE 100,A01,083659,Cao; Yingjun,0,62,50,50
1650159399686,CSE 134B,A01,083661,Powell; Thomas Allan,0,27,65,65
1650159405718,CSE 140,A01,083663,Staff,2,0,75,73
1650159411747,CSE 140L,A01,083088,Eldon; John,0,3,75,75
1650159417777,CSE 175,A01,083665,Kumar; Rakesh,8,0,25,17
1650159423803,CSE 190,A00,092507,Dubnov; Shlomo,14,0,20,6
1650159429835,ECE 45,A01,083139,Staff,0,14,40,40
1650159435859,ECE 65,A50,083695,Staff,0,4,30,30
1650159441886,ECE 109,A01,091882,Touri; Behrouz,47,0,70,23
1650159447922,ECE 180,A00,083140,Abi Samra; Nicholas Camill,24,0,30,6
1650159447922,ECE 180,B00,083141,Abi Samra; Nicholas Camill,8,0,30,22
1650159453945,MATH 10A,A01,083735,Patchell; Gregory David,12,0,30,18
1650159453945,MATH 10A,A02,083736,Patchell; Gregory David,28,0,30,2
1650159453945,MATH 10A,A03,083737,Patchell; Gregory David,26,0,30,4
1650159459969,MATH 10B,A01,083207,Staff,0,5,30,30
1650159459969,MATH 10B,A02,083208,Staff,0,4,30,30
1650159459969,MATH 10B,B01,083739,Staff,17,0,30,13
1650159459969,MATH 10B,B02,083740,Staff,29,0,30,1
1650159466001,MATH 18,A01,083743,Staff,10,0,30,20
1650159466001,MATH 18,A02,083744,Staff,28,0,30,2
1650159466001,MATH 18,A03,083745,Staff,23,0,30,7
1650159466001,MATH 18,A04,083746,Staff,27,0,30,3
1650159466001,MATH 18,B01,083748,Staff,0,10,30,30
1650159466001,MATH 18,B02,083749,Staff,0,7,30,30
1650159466001,MATH 18,B03,083750,Staff,0,7,30,30
1650159466001,MATH 18,B04,083751,Staff,0,7,30,30
1650159472023,MATH 20A,A01,083754,Staff,26,0,40,14
1650159478048,MATH 20B,A01,083756,Staff,0,5,30,30
1650159478048,MATH 20B,A02,083757,Staff,0,4,30,30
1650159484071,MATH 20C,A01,083760,Staff,0,12,30,30
1650159484071,MATH 20C,A02,083761,Staff,0,12,30,30
1650159484071,MATH 20C,B01,083762,Staff,14,0,30,16
1650159484071,MATH 20C,B02,083763,Staff,28,0,30,2
1650159490094,MATH 20D,A01,083765,Staff,0,2,30,30
1650159490094,MATH 20D,A02,083766,Staff,10,0,30,20
1650159490094,MATH 20D,A03,083767,Staff,28,0,30,2
1650159496123,MATH 20E,A01,083771,Staff,8,0,30,22
1650159496123,MATH 20E,A02,083772,Staff,20,0,30,10
1650159496123,MATH 20E,B01,083773,Staff,0,0,30,30
1650159496123,MATH 20E,B02,083774,Staff,13,0,30,17
1650159502147,MATH 103A,A01,083777,Staff,0,8,30,30
1650159502147,MATH 103A,A02,083778,Staff,0,9,30,30
1650159502147,MATH 103A,B01,083779,Staff,1,10,30,29
1650159502147,MATH 103A,B02,083780,Staff,0,7,30,30
1650159508170,MATH 105,A01,085443,Staff,0,16,30,30
1650159514203,MATH 109,A01,083213,Anzaldo; Leesa B,0,3,30,30
1650159514203,MATH 109,A02,083214,Anzaldo; Leesa B,0,6,30,30
1650159514203,MATH 109,B01,083215,Anzaldo; Leesa B,0,4,30,30
1650159514203,MATH 109,B02,083216,Anzaldo; Leesa B,0,4,30,30
1650159520227,MATH 142A,A01,083219,Chow; Bennett,0,11,30,30
1650159520227,MATH 142A,A02,083220,Chow; Bennett,0,11,30,30
1650159520227,MATH 142A,B01,083221,Chow; Bennett,0,11,30,30
1650159520227,MATH 142A,B02,083222,Chow; Bennett,0,11,30,30
1650159526250,MATH 193A,A01,083224,Staff,0,3,30,30
1650159526250,MATH 193A,A02,083225,Staff,0,4,30,30
1650159526250,MATH 193A,A03,083781,Staff,0,0,30,30
1650159526250,MATH 193A,A04,083782,Staff,0,0,30,30
1650159532275,MATH 197,001,091859,McAuley; Julian John,9998,0,9999,1
1650159538325,COGS 9,A01,083615,Staff,0,14,60,60
1650159544424,COGS 11,A01,083617,Boyle; Mary E. T.,24,0,40,16
1650159550452,COGS 13,A01,083071,Staff,0,29,40,40
1650159556485,COGS 14A,A01,092681,Staff,0,11,100,100
1650159562513,COGS 14B,A01,083073,Cheng; Tzu-Han,0,6,50,50
1650159568540,COGS 17,A01,092677,Staff,34,0,75,41
1650159574564,COGS 100,A01,083619,Staff,0,21,60,60
1650159580588,COGS 101A,A01,083621,Davis; Joshua Daniel,0,21,60,60
1650159586610,COGS 101B,A01,091572,Staff,8,0,60,52
1650159592636,COGS 101C,A01,083625,Delgado; Tania,20,0,30,10
1650159598660,COGS 107A,A01,083627,Boyle; Mary E. T.,0,7,60,60
1650159604698,COGS 118A,A01,083075,Staff,17,0,60,43
1650159610722,CSE 3,A50,083646,Miranda; Gregory Joseph,22,0,38,16
1650159610722,CSE 3,A51,083647,Miranda; Gregory Joseph,37,0,37,0
1650159616755,CSE 8A,A50,083650,Miranda; Gregory Joseph,0,17,40,40
1650159622790,CSE 11,A01,083080,Cao; Yingjun,0,65,40,40
1650159628819,CSE 12,A01,083652,Staff,0,5,100,100
1650159634842,CSE 15L,A01,083654,Staff,0,0,50,50
1650159634842,CSE 15L,A02,083655,Staff,8,0,50,42
1650159640867,CSE 20,A01,083657,Staff,54,0,80,26
1650159646894,CSE 30,A01,083084,Eldon; John,0,65,40,40
1650159652929,CSE 100,A01,083659,Cao; Yingjun,0,62,50,50
1650159658954,CSE 134B,A01,083661,Powell; Thomas Allan,0,27,65,65
1650159664984,CSE 140,A01,083663,Staff,2,0,75,73
1650159671015,CSE 140L,A01,083088,Eldon; John,0,3,75,75
1650159677042,CSE 175,A01,083665,Kumar; Rakesh,8,0,25,17
1650159683065,CSE 190,A00,092507,Dubnov; Shlomo,14,0,20,6
1650159689093,ECE 45,A01,083139,Staff,0,14,40,40
1650159695115,ECE 65,A50,083695,Staff,0,4,30,30
1650159701138,ECE 109,A01,091882,Touri; Behrouz,47,0,70,23
1650159707161,ECE 180,A00,083140,Abi Samra; Nicholas Camill,24,0,30,6
1650159707161,ECE 180,B00,083141,Abi Samra; Nicholas Camill,8,0,30,22
1650159713184,MATH 10A,A01,083735,Patchell; Gregory David,12,0,30,18
1650159713184,MATH 10A,A02,083736,Patchell; Gregory David,28,0,30,2
1650159713184,MATH 10A,A03,083737,Patchell; Gregory David,26,0,30,4
1650159719217,MATH 10B,A01,083207,Staff,0,5,30,30
1650159719217,MATH 10B,A02,083208,Staff,0,4,30,30
1650159719217,MATH 10B,B01,083739,Staff,17,0,30,13
1650159719217,MATH 10B,B02,083740,Staff,29,0,30,1
1650159725240,MATH 18,A01,083743,Staff,10,0,30,20
1650159725240,MATH 18,A02,083744,Staff,28,0,30,2
1650159725240,MATH 18,A03,083745,Staff,23,0,30,7
1650159725240,MATH 18,A04,083746,Staff,27,0,30,3
1650159725240,MATH 18,B01,083748,Staff,0,10,30,30
1650159725240,MATH 18,B02,083749,Staff,0,7,30,30
1650159725240,MATH 18,B03,083750,Staff,0,7,30,30
1650159725240,MATH 18,B04,083751,Staff,0,7,30,30
1650159731264,MATH 20A,A01,083754,Staff,26,0,40,14
1650159737286,MATH 20B,A01,083756,Staff,0,5,30,30
1650159737286,MATH 20B,A02,083757,Staff,0,4,30,30
1650159743318,MATH 20C,A01,083760,Staff,0,12,30,30
1650159743318,MATH 20C,A02,083761,Staff,0,12,30,30
1650159743318,MATH 20C,B01,083762,Staff,14,0,30,16
1650159743318,MATH 20C,B02,083763,Staff,28,0,30,2
1650159749341,MATH 20D,A01,083765,Staff,0,2,30,30
1650159749341,MATH 20D,A02,083766,Staff,10,0,30,20
1650159749341,MATH 20D,A03,083767,Staff,28,0,30,2
1650159755376,MATH 20E,A01,083771,Staff,8,0,30,22
1650159755376,MATH 20E,A02,083772,Staff,20,0,30,10
1650159755376,MATH 20E,B01,083773,Staff,0,0,30,30
1650159755376,MATH 20E,B02,083774,Staff,13,0,30,17
1650159761405,MATH 103A,A01,083777,Staff,0,8,30,30
1650159761405,MATH 103A,A02,083778,Staff,0,9,30,30
1650159761405,MATH 103A,B01,083779,Staff,1,10,30,29
1650159761405,MATH 103A,B02,083780,Staff,0,7,30,30
1650159767433,MATH 105,A01,085443,Staff,0,16,30,30
1650159773456,MATH 109,A01,083213,Anzaldo; Leesa B,0,3,30,30
1650159773456,MATH 109,A02,083214,Anzaldo; Leesa B,0,6,30,30
1650159773456,MATH 109,B01,083215,Anzaldo; Leesa B,0,4,30,30
1650159773456,MATH 109,B02,083216,Anzaldo; Leesa B,0,4,30,30
1650159779478,MATH 142A,A01,083219,Chow; Bennett,0,11,30,30
1650159779478,MATH 142A,A02,083220,Chow; Bennett,0,11,30,30
1650159779478,MATH 142A,B01,083221,Chow; Bennett,0,11,30,30
1650159779478,MATH 142A,B02,083222,Chow; Bennett,0,11,30,30
1650159785514,MATH 193A,A01,083224,Staff,0,3,30,30
1650159785514,MATH 193A,A02,083225,Staff,0,4,30,30
1650159785514,MATH 193A,A03,083781,Staff,0,0,30,30
1650159785514,MATH 193A,A04,083782,Staff,0,0,30,30
1650159791539,MATH 197,001,091859,McAuley; Julian John,9998,0,9999,1
1650159797599,COGS 9,A01,083615,Staff,0,14,60,60
1650159803621,COGS 11,A01,083617,Boyle; Mary E. T.,24,0,40,16
1650159809646,COGS 13,A01,083071,Staff,0,29,40,40
1650159815682,COGS 14A,A01,092681,Staff,0,11,100,100
1650159821708,COGS 14B,A01,083073,Cheng; Tzu-Han,0,7,50,50
1650159827730,COGS 17,A01,092677,Staff,34,0,75,41
1650159833754,COGS 100,A01,083619,Staff,0,21,60,60
1650159839776,COGS 101A,A01,083621,Davis; Joshua Daniel,0,21,60,60
1650159845798,COGS 101B,A01,091572,Staff,8,0,60,52
1650159851822,COGS 101C,A01,083625,Delgado; Tania,20,0,30,10
1650159857846,COGS 107A,A01,083627,Boyle; Mary E. T.,0,7,60,60
1650159863873,COGS 118A,A01,083075,Staff,17,0,60,43
1650159869902,CSE 3,A50,083646,Miranda; Gregory Joseph,22,0,38,16
1650159869902,CSE 3,A51,083647,Miranda; Gregory Joseph,37,0,37,0
1650159875930,CSE 8A,A50,083650,Miranda; Gregory Joseph,0,17,40,40
1650159881966,CSE 11,A01,083080,Cao; Yingjun,0,65,40,40
1650159887991,CSE 12,A01,083652,Staff,0,5,100,100
1650159894017,CSE 15L,A01,083654,Staff,0,0,50,50
1650159894017,CSE 15L,A02,083655,Staff,8,0,50,42
1650159900053,CSE 20,A01,083657,Staff,54,0,80,26
1650159906085,CSE 30,A01,083084,Eldon; John,0,65,40,40
1650159912108,CSE 100,A01,083659,Cao; Yingjun,0,62,50,50
1650159918131,CSE 134B,A01,083661,Powell; Thomas Allan,0,27,65,65
1650159924154,CSE 140,A01,083663,Staff,2,0,75,73
1650159930178,CSE 140L,A01,083088,Eldon; John,0,3,75,75
1650159936205,CSE 175,A01,083665,Kumar; Rakesh,8,0,25,17
1650159942228,CSE 190,A00,092507,Dubnov; Shlomo,14,0,20,6
1650159948254,ECE 45,A01,083139,Staff,0,14,40,40
1650159954277,ECE 65,A50,083695,Staff,0,4,30,30
1650159960304,ECE 109,A01,091882,Touri; Behrouz,47,0,70,23
1650159966328,ECE 180,A00,083140,Abi Samra; Nicholas Camill,24,0,30,6
1650159966328,ECE 180,B00,083141,Abi Samra; Nicholas Camill,8,0,30,22
1650159972356,MATH 10A,A01,083735,Patchell; Gregory David,12,0,30,18
1650159972356,MATH 10A,A02,083736,Patchell; Gregory David,28,0,30,2
1650159972356,MATH 10A,A03,083737,Patchell; Gregory David,26,0,30,4
1650159978385,MATH 10B,A01,083207,Staff,0,5,30,30
1650159978385,MATH 10B,A02,083208,Staff,0,4,30,30
1650159978385,MATH 10B,B01,083739,Staff,17,0,30,13
1650159978385,MATH 10B,B02,083740,Staff,29,0,30,1
1650159984415,MATH 18,A01,083743,Staff,10,0,30,20
1650159984415,MATH 18,A02,083744,Staff,28,0,30,2
1650159984415,MATH 18,A03,083745,Staff,23,0,30,7
1650159984415,MATH 18,A04,083746,Staff,27,0,30,3
1650159984415,MATH 18,B01,083748,Staff,0,10,30,30
1650159984415,MATH 18,B02,083749,Staff,0,7,30,30
1650159984415,MATH 18,B03,083750,Staff,0,7,30,30
1650159984415,MATH 18,B04,083751,Staff,0,7,30,30
1650159990438,MATH 20A,A01,083754,Staff,26,0,40,14
1650159996467,MATH 20B,A01,083756,Staff,0,5,30,30
1650159996467,MATH 20B,A02,083757,Staff,0,4,30,30
1650160002491,MATH 20C,A01,083760,Staff,0,12,30,30
1650160002491,MATH 20C,A02,083761,Staff,0,12,30,30
1650160002491,MATH 20C,B01,083762,Staff,14,0,30,16
1650160002491,MATH 20C,B02,083763,Staff,28,0,30,2
1650160008518,MATH 20D,A01,083765,Staff,0,2,30,30
1650160008518,MATH 20D,A02,083766,Staff,10,0,30,20
1650160008518,MATH 20D,A03,083767,Staff,28,0,30,2
1650160014541,MATH 20E,A01,083771,Staff,8,0,30,22
1650160014541,MATH 20E,A02,083772,Staff,20,0,30,10
1650160014541,MATH 20E,B01,083773,Staff,0,0,30,30
1650160014541,MATH 20E,B02,083774,Staff,13,0,30,17
1650160020579,MATH 103A,A01,083777,Staff,0,8,30,30
1650160020579,MATH 103A,A02,083778,Staff,0,9,30,30
1650160020579,MATH 103A,B01,083779,Staff,1,10,30,29
1650160020579,MATH 103A,B02,083780,Staff,0,7,30,30
1650160026602,MATH 105,A01,085443,Staff,0,16,30,30
1650160032632,MATH 109,A01,083213,Anzaldo; Leesa B,0,3,30,30
1650160032632,MATH 109,A02,083214,Anzaldo; Leesa B,0,6,30,30
1650160032632,MATH 109,B01,083215,Anzaldo; Leesa B,0,4,30,30
1650160032632,MATH 109,B02,083216,Anzaldo; Leesa B,0,4,30,30
1650160038662,MATH 142A,A01,083219,Chow; Bennett,0,11,30,30
1650160038662,MATH 142A,A02,083220,Chow; Bennett,0,11,30,30
1650160038662,MATH 142A,B01,083221,Chow; Bennett,0,11,30,30
1650160038662,MATH 142A,B02,083222,Chow; Bennett,0,11,30,30
1650160044691,MATH 193A,A01,083224,Staff,0,3,30,30
1650160044691,MATH 193A,A02,083225,Staff,0,4,30,30
1650160044691,MATH 193A,A03,083781,Staff,0,0,30,30
1650160044691,MATH 193A,A04,083782,Staff,0,0,30,30
1650160050718,MATH 197,001,091859,McAuley; Julian John,9998,0,9999,1
1650160056771,COGS 9,A01,083615,Staff,0,14,60,60
1650160062796,COGS 11,A01,083617,Boyle; Mary E. T.,24,0,40,16
1650160068820,COGS 13,A01,083071,Staff,0,29,40,40
1650160074848,COGS 14A,A01,092681,Staff,0,11,100,100
1650160080871,COGS 14B,A01,083073,Cheng; Tzu-Han,0,7,50,50
1650160086894,COGS 17,A01,092677,Staff,34,0,75,41
1650160092921,COGS 100,A01,083619,Staff,0,21,60,60
1650160098958,COGS 101A,A01,083621,Davis; Joshua Daniel,0,21,60,60
1650160104982,COGS 101B,A01,091572,Staff,8,0,60,52
1650160111009,COGS 101C,A01,083625,Delgado; Tania,20,0,30,10
1650160117030,COGS 107A,A01,083627,Boyle; Mary E. T.,0,7,60,60
1650160123055,COGS 118A,A01,083075,Staff,17,0,60,43
1650160129078,CSE 3,A50,083646,Miranda; Gregory Joseph,22,0,38,16
1650160129078,CSE 3,A51,083647,Miranda; Gregory Joseph,37,0,37,0
1650160135104,CSE 8A,A50,083650,Miranda; Gregory Joseph,0,17,40,40
1650160141206,CSE 11,A01,083080,Cao; Yingjun,0,65,40,40
1650160147229,CSE 12,A01,083652,Staff,0,5,100,100
1650160153254,CSE 15L,A01,083654,Staff,0,0,50,50
1650160153254,CSE 15L,A02,083655,Staff,8,0,50,42
1650160159277,CSE 20,A01,083657,Staff,54,0,80,26
1650160165303,CSE 30,A01,083084,Eldon; John,0,65,40,40
1650160171327,CSE 100,A01,083659,Cao; Yingjun,0,62,50,50
1650160177351,CSE 134B,A01,083661,Powell; Thomas Allan,0,27,65,65
1650160183377,CSE 140,A01,083663,Staff,2,0,75,73
1650160189402,CSE 140L,A01,083088,Eldon; John,0,3,75,75
1650160195425,CSE 175,A01,083665,Kumar; Rakesh,8,0,25,17
1650160201461,CSE 190,A00,092507,Dubnov; Shlomo,14,0,20,6
1650160207484,ECE 45,A01,083139,Staff,0,14,40,40
1650160213509,ECE 65,A50,083695,Staff,0,4,30,30
1650160219532,ECE 109,A01,091882,Touri; Behrouz,47,0,70,23
1650160225556,ECE 180,A00,083140,Abi Samra; Nicholas Camill,24,0,30,6
1650160225556,ECE 180,B00,083141,Abi Samra; Nicholas Camill,8,0,30,22
1650160231592,MATH 10A,A01,083735,Patchell; Gregory David,12,0,30,18
1650160231592,MATH 10A,A02,083736,Patchell; Gregory David,28,0,30,2
1650160231592,MATH 10A,A03,083737,Patchell; Gregory David,26,0,30,4
1650160237619,MATH 10B,A01,083207,Staff,0,5,30,30
1650160237619,MATH 10B,A02,083208,Staff,0,4,30,30
1650160237619,MATH 10B,B01,083739,Staff,17,0,30,13
1650160237619,MATH 10B,B02,083740,Staff,29,0,30,1
1650160243654,MATH 18,A01,083743,Staff,10,0,30,20
1650160243654,MATH 18,A02,083744,Staff,28,0,30,2
1650160243654,MATH 18,A03,083745,Staff,23,0,30,7
1650160243654,MATH 18,A04,083746,Staff,27,0,30,3
1650160243654,MATH 18,B01,083748,Staff,0,10,30,30
1650160243654,MATH 18,B02,083749,Staff,0,7,30,30
1650160243654,MATH 18,B03,083750,Staff,0,7,30,30
1650160243654,MATH 18,B04,083751,Staff,0,7,30,30
1650160249680,MATH 20A,A01,083754,Staff,26,0,40,14
1650160255708,MATH 20B,A01,083756,Staff,0,5,30,30
1650160255708,MATH 20B,A02,083757,Staff,0,4,30,30
1650160261736,MATH 20C,A01,083760,Staff,0,12,30,30
1650160261736,MATH 20C,A02,083761,Staff,0,12,30,30
1650160261736,MATH 20C,B01,083762,Staff,14,0,30,16
1650160261736,MATH 20C,B02,083763,Staff,28,0,30,2
1650160267762,MATH 20D,A01,083765,Staff,0,2,30,30
1650160267762,MATH 20D,A02,083766,Staff,10,0,30,20
1650160267762,MATH 20D,A03,083767,Staff,28,0,30,2
1650160273786,MATH 20E,A01,083771,Staff,8,0,30,22
1650160273786,MATH 20E,A02,083772,Staff,20,0,30,10
1650160273786,MATH 20E,B01,083773,Staff,0,0,30,30
1650160273786,MATH 20E,B02,083774,Staff,13,0,30,17
1650160279812,MATH 103A,A01,083777,Staff,0,8,30,30
1650160279812,MATH 103A,A02,083778,Staff,0,9,30,30
1650160279812,MATH 103A,B01,083779,Staff,1,10,30,29
1650160279812,MATH 103A,B02,083780,Staff,0,7,30,30
1650160285834,MATH 105,A01,085443,Staff,0,16,30,30
1650160291858,MATH 109,A01,083213,Anzaldo; Leesa B,0,3,30,30
1650160291858,MATH 109,A02,083214,Anzaldo; Leesa B,0,6,30,30
1650160291858,MATH 109,B01,083215,Anzaldo; Leesa B,0,4,30,30
1650160291858,MATH 109,B02,083216,Anzaldo; Leesa B,0,4,30,30
1650160297881,MATH 142A,A01,083219,Chow; Bennett,0,11,30,30
1650160297881,MATH 142A,A02,083220,Chow; Bennett,0,11,30,30
1650160297881,MATH 142A,B01,083221,Chow; Bennett,0,11,30,30
1650160297881,MATH 142A,B02,083222,Chow; Bennett,0,11,30,30
1650160303909,MATH 193A,A01,083224,Staff,0,3,30,30
1650160303909,MATH 193A,A02,083225,Staff,0,4,30,30
1650160303909,MATH 193A,A03,083781,Staff,0,0,30,30
1650160303909,MATH 193A,A04,083782,Staff,0,0,30,30
1650160309933,MATH 197,001,091859,McAuley; Julian John,9998,0,9999,1
1650160315985,COGS 9,A01,083615,Staff,0,14,60,60
1650160322014,COGS 11,A01,083617,Boyle; Mary E. T.,24,0,40,16
1650160328043,COGS 13,A01,083071,Staff,0,29,40,40
1650160334068,COGS 14A,A01,092681,Staff,0,11,100,100
1650160340094,COGS 14B,A01,083073,Cheng; Tzu-Han,0,7,50,50
1650160346120,COGS 17,A01,092677,Staff,34,0,75,41
1650160352147,COGS 100,A01,083619,Staff,0,21,60,60
1650160358174,COGS 101A,A01,083621,Davis; Joshua Daniel,0,21,60,60
1650160364201,COGS 101B,A01,091572,Staff,8,0,60,52
1650160370225,COGS 101C,A01,083625,Delgado; Tania,20,0,30,10
1650160376254,COGS 107A,A01,083627,Boyle; Mary E. T.,0,7,60,60
1650160382279,COGS 118A,A01,083075,Staff,17,0,60,43
1650160388308,CSE 3,A50,083646,Miranda; Gregory Joseph,22,0,38,16
1650160388308,CSE 3,A51,083647,Miranda; Gregory Joseph,37,0,37,0
1650160394330,CSE 8A,A50,083650,Miranda; Gregory Joseph,0,17,40,40
1650160400352,CSE 11,A01,083080,Cao; Yingjun,0,65,40,40
1650160406378,CSE 12,A01,083652,Staff,0,5,100,100
1650160412402,CSE 15L,A01,083654,Staff,0,0,50,50
1650160412402,CSE 15L,A02,083655,Staff,8,0,50,42
1650160418427,CSE 20,A01,083657,Staff,54,0,80,26
1650160424451,CSE 30,A01,083084,Eldon; John,0,65,40,40
1650160430477,CSE 100,A01,083659,Cao; Yingjun,0,62,50,50
1650160436499,CSE 134B,A01,083661,Powell; Thomas Allan,0,27,65,65
1650160442523,CSE 140,A01,083663,Staff,2,0,75,73
1650160448551,CSE 140L,A01,083088,Eldon; John,0,3,75,75
1650160454574,CSE 175,A01,083665,Kumar; Rakesh,8,0,25,17
1650160460597,CSE 190,A00,092507,Dubnov; Shlomo,14,0,20,6
1650160466621,ECE 45,A01,083139,Staff,0,14,40,40
1650160472652,ECE 65,A50,083695,Staff,0,4,30,30
1650160478676,ECE 109,A01,091882,Touri; Behrouz,47,0,70,23
1650160484700,ECE 180,A00,083140,Abi Samra; Nicholas Camill,24,0,30,6
1650160484700,ECE 180,B00,083141,Abi Samra; Nicholas Camill,8,0,30,22
1650160490725,MATH 10A,A01,083735,Patchell; Gregory David,12,0,30,18
1650160490725,MATH 10A,A02,083736,Patchell; Gregory David,28,0,30,2
1650160490725,MATH 10A,A03,083737,Patchell; Gregory David,26,0,30,4
1650160496752,MATH 10B,A01,083207,Staff,0,5,30,30
1650160496752,MATH 10B,A02,083208,Staff,0,4,30,30
1650160496752,MATH 10B,B01,083739,Staff,17,0,30,13
1650160496752,MATH 10B,B02,083740,Staff,29,0,30,1
1650160502784,MATH 18,A01,083743,Staff,10,0,30,20
1650160502784,MATH 18,A02,083744,Staff,28,0,30,2
1650160502784,MATH 18,A03,083745,Staff,23,0,30,7
1650160502784,MATH 18,A04,083746,Staff,27,0,30,3
1650160502784,MATH 18,B01,083748,Staff,0,10,30,30
1650160502784,MATH 18,B02,083749,Staff,0,7,30,30
1650160502784,MATH 18,B03,083750,Staff,0,7,30,30
1650160502784,MATH 18,B04,083751,Staff,0,7,30,30
1650160508811,MATH 20A,A01,083754,Staff,26,0,40,14
1650160514839,MATH 20B,A01,083756,Staff,0,5,30,30
1650160514839,MATH 20B,A02,083757,Staff,0,4,30,30
1650160520868,MATH 20C,A01,083760,Staff,0,12,30,30
1650160520868,MATH 20C,A02,083761,Staff,0,12,30,30
1650160520868,MATH 20C,B01,083762,Staff,14,0,30,16
1650160520868,MATH 20C,B02,083763,Staff,28,0,30,2
1650160526899,MATH 20D,A01,083765,Staff,0,2,30,30
1650160526899,MATH 20D,A02,083766,Staff,10,0,30,20
1650160526899,MATH 20D,A03,083767,Staff,28,0,30,2
1650160532926,MATH 20E,A01,083771,Staff,8,0,30,22
1650160532926,MATH 20E,A02,083772,Staff,20,0,30,10
1650160532926,MATH 20E,B01,083773,Staff,0,0,30,30
1650160532926,MATH 20E,B02,083774,Staff,13,0,30,17
1650160538953,MATH 103A,A01,083777,Staff,0,8,30,30
1650160538953,MATH 103A,A02,083778,Staff,0,9,30,30
1650160538953,MATH 103A,B01,083779,Staff,1,10,30,29
1650160538953,MATH 103A,B02,083780,Staff,0,7,30,30
1650160544975,MATH 105,A01,085443,Staff,0,16,30,30
1650160551004,MATH 109,A01,083213,Anzaldo; Leesa B,0,3,30,30
1650160551004,MATH 109,A02,083214,Anzaldo; Leesa B,0,6,30,30
1650160551004,MATH 109,B01,083215,Anzaldo; Leesa B,0,4,30,30
1650160551004,MATH 109,B02,083216,Anzaldo; Leesa B,0,4,30,30
1650160557027,MATH 142A,A01,083219,Chow; Bennett,0,11,30,30
1650160557027,MATH 142A,A02,083220,Chow; Bennett,0,11,30,30
1650160557027,MATH 142A,B01,083221,Chow; Bennett,0,11,30,30
1650160557027,MATH 142A,B02,083222,Chow; Bennett,0,11,30,30
1650160563054,MATH 193A,A01,083224,Staff,0,3,30,30
1650160563054,MATH 193A,A02,083225,Staff,0,4,30,30
1650160563054,MATH 193A,A03,083781,Staff,0,0,30,30
1650160563054,MATH 193A,A04,083782,Staff,0,0,30,30
1650160569077,MATH 197,001,091859,McAuley; Julian John,9998,0,9999,1
1650160575129,COGS 9,A01,083615,Staff,0,14,60,60
1650160581153,COGS 11,A01,083617,Boyle; Mary E. T.,24,0,40,16
1650160587175,COGS 13,A01,083071,Staff,0,29,40,40
1650160593203,COGS 14A,A01,092681,Staff,0,11,100,100
1650160599227,COGS 14B,A01,083073,Cheng; Tzu-Han,0,7,50,50
1650160605250,COGS 17,A01,092677,Staff,34,0,75,41
1650160611281,COGS 100,A01,083619,Staff,0,21,60,60
1650160617306,COGS 101A,A01,083621,Davis; Joshua Daniel,0,21,60,60
1650160623341,COGS 101B,A01,091572,Staff,8,0,60,52
1650160629368,COGS 101C,A01,083625,Delgado; Tania,20,0,30,10
1650160635395,COGS 107A,A01,083627,Boyle; Mary E. T.,0,7,60,60
1650160641423,COGS 118A,A01,083075,Staff,17,0,60,43
1650160647452,CSE 3,A50,083646,Miranda; Gregory Joseph,22,0,38,16
1650160647452,CSE 3,A51,083647,Miranda; Gregory Joseph,37,0,37,0
1650160653480,CSE 8A,A50,083650,Miranda; Gregory Joseph,0,17,40,40
1650160659507,CSE 11,A01,083080,Cao; Yingjun,0,65,40,40
1650160665529,CSE 12,A01,083652,Staff,0,5,100,100
1650160671556,CSE 15L,A01,083654,Staff,0,0,50,50
1650160671556,CSE 15L,A02,083655,Staff,8,0,50,42
1650160677580,CSE 20,A01,083657,Staff,54,0,80,26
1650160683611,CSE 30,A01,083084,Eldon; John,0,65,40,40
1650160689642,CSE 100,A01,083659,Cao; Yingjun,0,62,50,50
1650160695666,CSE 134B,A01,083661,Powell; Thomas Allan,0,27,65,65
1650160701690,CSE 140,A01,083663,Staff,2,0,75,73
1650160707713,CSE 140L,A01,083088,Eldon; John,0,3,75,75
1650160713737,CSE 175,A01,083665,Kumar; Rakesh,8,0,25,17
1650160719770,CSE 190,A00,092507,Dubnov; Shlomo,14,0,20,6
1650160725794,ECE 45,A01,083139,Staff,0,14,40,40
1650160731818,ECE 65,A50,083695,Staff,0,4,30,30
1650160737918,ECE 109,A01,091882,Touri; Behrouz,47,0,70,23
1650160743945,ECE 180,A00,083140,Abi Samra; Nicholas Camill,24,0,30,6
1650160743945,ECE 180,B00,083141,Abi Samra; Nicholas Camill,8,0,30,22
1650160749973,MATH 10A,A01,083735,Patchell; Gregory David,12,0,30,18
1650160749973,MATH 10A,A02,083736,Patchell; Gregory David,28,0,30,2
1650160749973,MATH 10A,A03,083737,Patchell; Gregory David,26,0,30,4
1650160756003,MATH 10B,A01,083207,Staff,0,5,30,30
1650160756003,MATH 10B,A02,083208,Staff,0,4,30,30
1650160756003,MATH 10B,B01,083739,Staff,17,0,30,13
1650160756003,MATH 10B,B02,083740,Staff,29,0,30,1
1650160762035,MATH 18,A01,083743,Staff,10,0,30,20
1650160762035,MATH 18,A02,083744,Staff,28,0,30,2
1650160762035,MATH 18,A03,083745,Staff,23,0,30,7
1650160762035,MATH 18,A04,083746,Staff,27,0,30,3
1650160762035,MATH 18,B01,083748,Staff,0,10,30,30
1650160762035,MATH 18,B02,083749,Staff,0,7,30,30
1650160762035,MATH 18,B03,083750,Staff,0,7,30,30
1650160762035,MATH 18,B04,083751,Staff,0,7,30,30
1650160768078,MATH 20A,A01,083754,Staff,26,0,40,14
1650160774102,MATH 20B,A01,083756,Staff,0,5,30,30
1650160774102,MATH 20B,A02,083757,Staff,0,4,30,30
1650160780127,MATH 20C,A01,083760,Staff,0,12,30,30
1650160780127,MATH 20C,A02,083761,Staff,0,12,30,30
1650160780127,MATH 20C,B01,083762,Staff,14,0,30,16
1650160780127,MATH 20C,B02,083763,Staff,28,0,30,2
1650160786151,MATH 20D,A01,083765,Staff,0,2,30,30
1650160786151,MATH 20D,A02,083766,Staff,10,0,30,20
1650160786151,MATH 20D,A03,083767,Staff,28,0,30,2
1650160792176,MATH 20E,A01,083771,Staff,8,0,30,22
1650160792176,MATH 20E,A02,083772,Staff,20,0,30,10
1650160792176,MATH 20E,B01,083773,Staff,0,0,30,30
1650160792176,MATH 20E,B02,083774,Staff,13,0,30,17
1650160798204,MATH 103A,A01,083777,Staff,0,8,30,30
1650160798204,MATH 103A,A02,083778,Staff,0,9,30,30
1650160798204,MATH 103A,B01,083779,Staff,1,10,30,29
1650160798204,MATH 103A,B02,083780,Staff,0,7,30,30
1650160804227,MATH 105,A01,085443,Staff,0,16,30,30
1650160810255,MATH 109,A01,083213,Anzaldo; Leesa B,0,3,30,30
1650160810255,MATH 109,A02,083214,Anzaldo; Leesa B,0,6,30,30
1650160810255,MATH 109,B01,083215,Anzaldo; Leesa B,0,4,30,30
1650160810255,MATH 109,B02,083216,Anzaldo; Leesa B,0,4,30,30
1650160816278,MATH 142A,A01,083219,Chow; Bennett,0,11,30,30
1650160816278,MATH 142A,A02,083220,Chow; Bennett,0,11,30,30
1650160816278,MATH 142A,B01,083221,Chow; Bennett,0,11,30,30
1650160816278,MATH 142A,B02,083222,Chow; Bennett,0,11,30,30
1650160822306,MATH 193A,A01,083224,Staff,0,3,30,30
1650160822306,MATH 193A,A02,083225,Staff,0,4,30,30
1650160822306,MATH 193A,A03,083781,Staff,0,0,30,30
1650160822306,MATH 193A,A04,083782,Staff,0,0,30,30
1650160828332,MATH 197,001,091859,McAuley; Julian John,9998,0,9999,1
1650160834397,COGS 9,A01,083615,Staff,0,14,60,60
1650160840421,COGS 11,A01,083617,Boyle; Mary E. T.,24,0,40,16
1650160846445,COGS 13,A01,083071,Staff,0,29,40,40
1650160852486,COGS 14A,A01,092681,Staff,0,11,100,100
1650160858510,COGS 14B,A01,083073,Cheng; Tzu-Han,0,7,50,50
1650160864534,COGS 17,A01,092677,Staff,34,0,75,41
1650160870562,COGS 100,A01,083619,Staff,0,21,60,60
1650160876588,COGS 101A,A01,083621,Davis; Joshua Daniel,0,21,60,60
1650160882613,COGS 101B,A01,091572,Staff,8,0,60,52
1650160888637,COGS 101C,A01,083625,Delgado; Tania,20,0,30,10
1650160894661,COGS 107A,A01,083627,Boyle; Mary E. T.,0,7,60,60
1650160900685,COGS 118A,A01,083075,Staff,17,0,60,43
1650160906713,CSE 3,A50,083646,Miranda; Gregory Joseph,22,0,38,16
1650160906713,CSE 3,A51,083647,Miranda; Gregory Joseph,37,0,37,0
1650160912737,CSE 8A,A50,083650,Miranda; Gregory Joseph,0,17,40,40
1650160918761,CSE 11,A01,083080,Cao; Yingjun,0,65,40,40
1650160924785,CSE 12,A01,083652,Staff,0,5,100,100
1650160930819,CSE 15L,A01,083654,Staff,0,0,50,50
1650160930819,CSE 15L,A02,083655,Staff,8,0,50,42
1650160936853,CSE 20,A01,083657,Staff,54,0,80,26
1650160942876,CSE 30,A01,083084,Eldon; John,0,66,40,40
1650160948900,CSE 100,A01,083659,Cao; Yingjun,0,62,50,50
1650160954924,CSE 134B,A01,083661,Powell; Thomas Allan,0,27,65,65
1650160960959,CSE 140,A01,083663,Staff,2,0,75,73
1650160966988,CSE 140L,A01,083088,Eldon; John,0,3,75,75
1650160973012,CSE 175,A01,083665,Kumar; Rakesh,8,0,25,17
1650160979039,CSE 190,A00,092507,Dubnov; Shlomo,14,0,20,6
1650160985063,ECE 45,A01,083139,Staff,0,14,40,40
1650160991090,ECE 65,A50,083695,Staff,0,4,30,30
1650160997121,ECE 109,A01,091882,Touri; Behrouz,47,0,70,23
1650161003146,ECE 180,A00,083140,Abi Samra; Nicholas Camill,24,0,30,6
1650161003146,ECE 180,B00,083141,Abi Samra; Nicholas Camill,8,0,30,22
1650161009183,MATH 10A,A01,083735,Patchell; Gregory David,12,0,30,18
1650161009183,MATH 10A,A02,083736,Patchell; Gregory David,28,0,30,2
1650161009183,MATH 10A,A03,083737,Patchell; Gregory David,26,0,30,4
1650161015210,MATH 10B,A01,083207,Staff,0,5,30,30
1650161015210,MATH 10B,A02,083208,Staff,0,4,30,30
1650161015210,MATH 10B,B01,083739,Staff,17,0,30,13
1650161015210,MATH 10B,B02,083740,Staff,29,0,30,1
1650161021236,MATH 18,A01,083743,Staff,10,0,30,20
1650161021236,MATH 18,A02,083744,Staff,28,0,30,2
1650161021236,MATH 18,A03,083745,Staff,23,0,30,7
1650161021236,MATH 18,A04,083746,Staff,27,0,30,3
1650161021236,MATH 18,B01,083748,Staff,0,10,30,30
1650161021236,MATH 18,B02,083749,Staff,0,7,30,30
1650161021236,MATH 18,B03,083750,Staff,0,7,30,30
1650161021236,MATH 18,B04,083751,Staff,0,7,30,30
1650161027265,MATH 20A,A01,083754,Staff,26,0,40,14
1650161033290,MATH 20B,A01,083756,Staff,0,5,30,30
1650161033290,MATH 20B,A02,083757,Staff,0,4,30,30
1650161039316,MATH 20C,A01,083760,Staff,0,12,30,30
1650161039316,MATH 20C,A02,083761,Staff,0,12,30,30
1650161039316,MATH 20C,B01,083762,Staff,14,0,30,16
1650161039316,MATH 20C,B02,083763,Staff,28,0,30,2
1650161045342,MATH 20D,A01,083765,Staff,0,2,30,30
1650161045342,MATH 20D,A02,083766,Staff,10,0,30,20
1650161045342,MATH 20D,A03,083767,Staff,28,0,30,2
1650161051368,MATH 20E,A01,083771,Staff,8,0,30,22
1650161051368,MATH 20E,A02,083772,Staff,20,0,30,10
1650161051368,MATH 20E,B01,083773,Staff,0,0,30,30
1650161051368,MATH 20E,B02,083774,Staff,13,0,30,17
1650161057397,MATH 103A,A01,083777,Staff,0,8,30,30
1650161057397,MATH 103A,A02,083778,Staff,0,10,30,30
1650161057397,MATH 103A,B01,083779,Staff,1,10,30,29
1650161057397,MATH 103A,B02,083780,Staff,0,7,30,30
1650161063421,MATH 105,A01,085443,Staff,0,16,30,30
1650161069445,MATH 109,A01,083213,Anzaldo; Leesa B,0,3,30,30
1650161069445,MATH 109,A02,083214,Anzaldo; Leesa B,0,6,30,30
1650161069445,MATH 109,B01,083215,Anzaldo; Leesa B,0,4,30,30
1650161069445,MATH 109,B02,083216,Anzaldo; Leesa B,0,4,30,30
1650161075473,MATH 142A,A01,083219,Chow; Bennett,0,11,30,30
1650161075473,MATH 142A,A02,083220,Chow; Bennett,0,11,30,30
1650161075473,MATH 142A,B01,083221,Chow; Bennett,0,11,30,30
1650161075473,MATH 142A,B02,083222,Chow; Bennett,0,11,30,30
1650161081499,MATH 193A,A01,083224,Staff,0,3,30,30
1650161081499,MATH 193A,A02,083225,Staff,0,4,30,30
1650161081499,MATH 193A,A03,083781,Staff,0,0,30,30
1650161081499,MATH 193A,A04,083782,Staff,0,0,30,30
1650161087526,MATH 197,001,091859,McAuley; Julian John,9998,0,9999,1
1650161093580,COGS 9,A01,083615,Staff,0,14,60,60
1650161099611,COGS 11,A01,083617,Boyle; Mary E. T.,24,0,40,16
1650161105638,COGS 13,A01,083071,Staff,0,29,40,40
1650161111661,COGS 14A,A01,092681,Staff,0,11,100,100
1650161117689,COGS 14B,A01,083073,Cheng; Tzu-Han,0,7,50,50
1650161123716,COGS 17,A01,092677,Staff,34,0,75,41
1650161129742,COGS 100,A01,083619,Staff,0,21,60,60
1650161135794,COGS 101A,A01,083621,Davis; Joshua Daniel,0,21,60,60
1650161141818,COGS 101B,A01,091572,Staff,8,0,60,52
1650161147853,COGS 101C,A01,083625,Delgado; Tania,20,0,30,10
1650161153876,COGS 107A,A01,083627,Boyle; Mary E. T.,0,7,60,60
1650161159903,COGS 118A,A01,083075,Staff,17,0,60,43
1650161165929,CSE 3,A50,083646,Miranda; Gregory Joseph,22,0,38,16
1650161165929,CSE 3,A51,083647,Miranda; Gregory Joseph,37,0,37,0
1650161171956,CSE 8A,A50,083650,Miranda; Gregory Joseph,0,17,40,40
1650161177996,CSE 11,A01,083080,Cao; Yingjun,0,65,40,40
1650161184018,CSE 12,A01,083652,Staff,0,5,100,100
1650161190043,CSE 15L,A01,083654,Staff,0,0,50,50
1650161190043,CSE 15L,A02,083655,Staff,8,0,50,42
1650161196070,CSE 20,A01,083657,Staff,54,0,80,26
1650161202094,CSE 30,A01,083084,Eldon; John,0,66,40,40
1650161208115,CSE 100,A01,083659,Cao; Yingjun,0,62,50,50
1650161214139,CSE 134B,A01,083661,Powell; Thomas Allan,0,27,65,65
1650161220163,CSE 140,A01,083663,Staff,2,0,75,73
1650161226187,CSE 140L,A01,083088,Eldon; John,0,3,75,75
1650161232225,CSE 175,A01,083665,Kumar; Rakesh,8,0,25,17
1650161238258,CSE 190,A00,092507,Dubnov; Shlomo,14,0,20,6
1650161244282,ECE 45,A01,083139,Staff,0,14,40,40
1650161250322,ECE 65,A50,083695,Staff,0,4,30,30
1650161256348,ECE 109,A01,091882,Touri; Behrouz,47,0,70,23
1650161262375,ECE 180,A00,083140,Abi Samra; Nicholas Camill,24,0,30,6
1650161262375,ECE 180,B00,083141,Abi Samra; Nicholas Camill,8,0,30,22
1650161268397,MATH 10A,A01,083735,Patchell; Gregory David,12,0,30,18
1650161268397,MATH 10A,A02,083736,Patchell; Gregory David,28,0,30,2
1650161268397,MATH 10A,A03,083737,Patchell; Gregory David,26,0,30,4
1650161274424,MATH 10B,A01,083207,Staff,0,5,30,30
1650161274424,MATH 10B,A02,083208,Staff,0,4,30,30
1650161274424,MATH 10B,B01,083739,Staff,17,0,30,13
1650161274424,MATH 10B,B02,083740,Staff,29,0,30,1
1650161280455,MATH 18,A01,083743,Staff,10,0,30,20
1650161280455,MATH 18,A02,083744,Staff,28,0,30,2
1650161280455,MATH 18,A03,083745,Staff,23,0,30,7
1650161280455,MATH 18,A04,083746,Staff,27,0,30,3
1650161280455,MATH 18,B01,083748,Staff,0,10,30,30
1650161280455,MATH 18,B02,083749,Staff,0,7,30,30
1650161280455,MATH 18,B03,083750,Staff,0,7,30,30
1650161280455,MATH 18,B04,083751,Staff,0,7,30,30
1650161286491,MATH 20A,A01,083754,Staff,26,0,40,14
1650161292523,MATH 20B,A01,083756,Staff,0,5,30,30
1650161292523,MATH 20B,A02,083757,Staff,0,4,30,30
1650161298555,MATH 20C,A01,083760,Staff,0,12,30,30
1650161298555,MATH 20C,A02,083761,Staff,0,12,30,30
1650161298555,MATH 20C,B01,083762,Staff,14,0,30,16
1650161298555,MATH 20C,B02,083763,Staff,28,0,30,2
1650161304581,MATH 20D,A01,083765,Staff,0,2,30,30
1650161304581,MATH 20D,A02,083766,Staff,10,0,30,20
1650161304581,MATH 20D,A03,083767,Staff,28,0,30,2
1650161310610,MATH 20E,A01,083771,Staff,8,0,30,22
1650161310610,MATH 20E,A02,083772,Staff,20,0,30,10
1650161310610,MATH 20E,B01,083773,Staff,0,0,30,30
1650161310610,MATH 20E,B02,083774,Staff,13,0,30,17
1650161316637,MATH 103A,A01,083777,Staff,0,8,30,30
1650161316637,MATH 103A,A02,083778,Staff,0,10,30,30
1650161316637,MATH 103A,B01,083779,Staff,1,10,30,29
1650161316637,MATH 103A,B02,083780,Staff,0,7,30,30
1650161322661,MATH 105,A01,085443,Staff,0,16,30,30
1650161328683,MATH 109,A01,083213,Anzaldo; Leesa B,0,3,30,30
1650161328683,MATH 109,A02,083214,Anzaldo; Leesa B,0,6,30,30
1650161328683,MATH 109,B01,083215,Anzaldo; Leesa B,0,4,30,30
1650161328683,MATH 109,B02,083216,Anzaldo; Leesa B,0,4,30,30
1650161334802,MATH 142A,A01,083219,Chow; Bennett,0,11,30,30
1650161334802,MATH 142A,A02,083220,Chow; Bennett,0,11,30,30
1650161334802,MATH 142A,B01,083221,Chow; Bennett,0,11,30,30
1650161334802,MATH 142A,B02,083222,Chow; Bennett,0,11,30,30
1650161340839,MATH 193A,A01,083224,Staff,0,3,30,30
1650161340839,MATH 193A,A02,083225,Staff,0,4,30,30
1650161340839,MATH 193A,A03,083781,Staff,0,0,30,30
1650161340839,MATH 193A,A04,083782,Staff,0,0,30,30
1650161346866,MATH 197,001,091859,McAuley; Julian John,9998,0,9999,1
1650161352930,COGS 9,A01,083615,Staff,0,14,60,60
1650161358956,COGS 11,A01,083617,Boyle; Mary E. T.,24,0,40,16
1650161364989,COGS 13,A01,083071,Staff,0,29,40,40
1650161371013,COGS 14A,A01,092681,Staff,0,11,100,100
1650161377036,COGS 14B,A01,083073,Cheng; Tzu-Han,0,7,50,50
1650161383061,COGS 17,A01,092677,Staff,34,0,75,41
1650161389089,COGS 100,A01,083619,Staff,0,21,60,60
1650161395112,COGS 101A,A01,083621,Davis; Joshua Daniel,0,21,60,60
1650161401136,COGS 101B,A01,091572,Staff,8,0,60,52
1650161407164,COGS 101C,A01,083625,Delgado; Tania,20,0,30,10
1650161413189,COGS 107A,A01,083627,Boyle; Mary E. T.,0,7,60,60
1650161419216,COGS 118A,A01,083075,Staff,17,0,60,43
1650161425243,CSE 3,A50,083646,Miranda; Gregory Joseph,22,0,38,16
1650161425243,CSE 3,A51,083647,Miranda; Gregory Joseph,37,0,37,0
1650161431269,CSE 8A,A50,083650,Miranda; Gregory Joseph,0,17,40,40
1650161437292,CSE 11,A01,083080,Cao; Yingjun,0,65,40,40
1650161443317,CSE 12,A01,083652,Staff,0,5,100,100
1650161449340,CSE 15L,A01,083654,Staff,0,0,50,50
1650161449340,CSE 15L,A02,083655,Staff,8,0,50,42
1650161455372,CSE 20,A01,083657,Staff,54,0,80,26
1650161461409,CSE 30,A01,083084,Eldon; John,0,66,40,40
1650161467436,CSE 100,A01,083659,Cao; Yingjun,0,62,50,50
1650161473474,CSE 134B,A01,083661,Powell; Thomas Allan,0,27,65,65
1650161479502,CSE 140,A01,083663,Staff,2,0,75,73
1650161485526,CSE 140L,A01,083088,Eldon; John,0,3,75,75
1650161491550,CSE 175,A01,083665,Kumar; Rakesh,8,0,25,17
1650161497579,CSE 190,A00,092507,Dubnov; Shlomo,14,0,20,6
1650161503607,ECE 45,A01,083139,Staff,0,14,40,40
1650161509632,ECE 65,A50,083695,Staff,0,4,30,30
1650161515660,ECE 109,A01,091882,Touri; Behrouz,47,0,70,23
1650161521686,ECE 180,A00,083140,Abi Samra; Nicholas Camill,24,0,30,6
1650161521686,ECE 180,B00,083141,Abi Samra; Nicholas Camill,8,0,30,22
1650161527713,MATH 10A,A01,083735,Patchell; Gregory David,12,0,30,18
1650161527713,MATH 10A,A02,083736,Patchell; Gregory David,28,0,30,2
1650161527713,MATH 10A,A03,083737,Patchell; Gregory David,26,0,30,4
1650161533743,MATH 10B,A01,083207,Staff,0,5,30,30
1650161533743,MATH 10B,A02,083208,Staff,0,4,30,30
1650161533743,MATH 10B,B01,083739,Staff,17,0,30,13
1650161533743,MATH 10B,B02,083740,Staff,29,0,30,1
1650161539774,MATH 18,A01,083743,Staff,10,0,30,20
1650161539774,MATH 18,A02,083744,Staff,28,0,30,2
1650161539774,MATH 18,A03,083745,Staff,23,0,30,7
1650161539774,MATH 18,A04,083746,Staff,27,0,30,3
1650161539774,MATH 18,B01,083748,Staff,0,10,30,30
1650161539774,MATH 18,B02,083749,Staff,0,7,30,30
1650161539774,MATH 18,B03,083750,Staff,0,7,30,30
1650161539774,MATH 18,B04,083751,Staff,0,7,30,30
1650161545802,MATH 20A,A01,083754,Staff,26,0,40,14
1650161551833,MATH 20B,A01,083756,Staff,0,5,30,30
1650161551833,MATH 20B,A02,083757,Staff,0,4,30,30
1650161557856,MATH 20C,A01,083760,Staff,0,12,30,30
1650161557856,MATH 20C,A02,083761,Staff,0,12,30,30
1650161557856,MATH 20C,B01,083762,Staff,14,0,30,16
1650161557856,MATH 20C,B02,083763,Staff,28,0,30,2
1650161563881,MATH 20D,A01,083765,Staff,0,2,30,30
1650161563881,MATH 20D,A02,083766,Staff,10,0,30,20
1650161563881,MATH 20D,A03,083767,Staff,28,0,30,2
1650161569921,MATH 20E,A01,083771,Staff,8,0,30,22
1650161569921,MATH 20E,A02,083772,Staff,20,0,30,10
1650161569921,MATH 20E,B01,083773,Staff,0,0,30,30
1650161569921,MATH 20E,B02,083774,Staff,13,0,30,17
1650161575951,MATH 103A,A01,083777,Staff,0,8,30,30
1650161575951,MATH 103A,A02,083778,Staff,0,10,30,30
1650161575951,MATH 103A,B01,083779,Staff,1,10,30,29
1650161575951,MATH 103A,B02,083780,Staff,0,7,30,30
1650161581985,MATH 105,A01,085443,Staff,0,16,30,30
1650161588010,MATH 109,A01,083213,Anzaldo; Leesa B,0,3,30,30
1650161588010,MATH 109,A02,083214,Anzaldo; Leesa B,0,6,30,30
1650161588010,MATH 109,B01,083215,Anzaldo; Leesa B,0,4,30,30
1650161588010,MATH 109,B02,083216,Anzaldo; Leesa B,0,4,30,30
1650161594038,MATH 142A,A01,083219,Chow; Bennett,0,11,30,30
1650161594038,MATH 142A,A02,083220,Chow; Bennett,0,11,30,30
1650161594038,MATH 142A,B01,083221,Chow; Bennett,0,11,30,30
1650161594038,MATH 142A,B02,083222,Chow; Bennett,0,11,30,30
1650161600065,MATH 193A,A01,083224,Staff,0,3,30,30
1650161600065,MATH 193A,A02,083225,Staff,0,4,30,30
1650161600065,MATH 193A,A03,083781,Staff,0,0,30,30
1650161600065,MATH 193A,A04,083782,Staff,0,0,30,30
1650161606088,MATH 197,001,091859,McAuley; Julian John,9998,0,9999,1
1650161612145,COGS 9,A01,083615,Staff,0,14,60,60
1650161618181,COGS 11,A01,083617,Boyle; Mary E. T.,24,0,40,16
1650161624211,COGS 13,A01,083071,Staff,0,29,40,40
1650161630233,COGS 14A,A01,092681,Staff,0,11,100,100
1650161636256,COGS 14B,A01,083073,Cheng; Tzu-Han,0,7,50,50
1650161642294,COGS 17,A01,092677,Staff,34,0,75,41
1650161648320,COGS 100,A01,083619,Staff,0,21,60,60
1650161654351,COGS 101A,A01,083621,Davis; Joshua Daniel,0,21,60,60
1650161660374,COGS 101B,A01,091572,Staff,8,0,60,52
1650161666400,COGS 101C,A01,083625,Delgado; Tania,20,0,30,10
1650161672425,COGS 107A,A01,083627,Boyle; Mary E. T.,0,7,60,60
1650161678453,COGS 118A,A01,083075,Staff,17,0,60,43
1650161684478,CSE 3,A50,083646,Miranda; Gregory Joseph,22,0,38,16
1650161684478,CSE 3,A51,083647,Miranda; Gregory Joseph,37,0,37,0
1650161690514,CSE 8A,A50,083650,Miranda; Gregory Joseph,0,17,40,40
1650161696538,CSE 11,A01,083080,Cao; Yingjun,0,65,40,40
1650161702561,CSE 12,A01,083652,Staff,0,5,100,100
1650161708582,CSE 15L,A01,083654,Staff,0,0,50,50
1650161708582,CSE 15L,A02,083655,Staff,8,0,50,42
1650161714620,CSE 20,A01,083657,Staff,54,0,80,26
1650161720644,CSE 30,A01,083084,Eldon; John,0,66,40,40
1650161726670,CSE 100,A01,083659,Cao; Yingjun,0,62,50,50
1650161732700,CSE 134B,A01,083661,Powell; Thomas Allan,0,27,65,65
1650161738724,CSE 140,A01,083663,Staff,2,0,75,73
1650161744749,CSE 140L,A01,083088,Eldon; John,0,3,75,75
1650161750777,CSE 175,A01,083665,Kumar; Rakesh,8,0,25,17
1650161756801,CSE 190,A00,092507,Dubnov; Shlomo,14,0,20,6
1650161762834,ECE 45,A01,083139,Staff,0,14,40,40
1650161768858,ECE 65,A50,083695,Staff,0,4,30,30
1650161774882,ECE 109,A01,091882,Touri; Behrouz,47,0,70,23
1650161780910,ECE 180,A00,083140,Abi Samra; Nicholas Camill,24,0,30,6
1650161780910,ECE 180,B00,083141,Abi Samra; Nicholas Camill,8,0,30,22
1650161786943,MATH 10A,A01,083735,Patchell; Gregory David,12,0,30,18
1650161786943,MATH 10A,A02,083736,Patchell; Gregory David,28,0,30,2
1650161786943,MATH 10A,A03,083737,Patchell; Gregory David,26,0,30,4
1650161792971,MATH 10B,A01,083207,Staff,0,5,30,30
1650161792971,MATH 10B,A02,083208,Staff,0,4,30,30
1650161792971,MATH 10B,B01,083739,Staff,17,0,30,13
1650161792971,MATH 10B,B02,083740,Staff,29,0,30,1
1650161799009,MATH 18,A01,083743,Staff,10,0,30,20
1650161799009,MATH 18,A02,083744,Staff,28,0,30,2
1650161799009,MATH 18,A03,083745,Staff,23,0,30,7
1650161799009,MATH 18,A04,083746,Staff,27,0,30,3
1650161799009,MATH 18,B01,083748,Staff,0,10,30,30
1650161799009,MATH 18,B02,083749,Staff,0,7,30,30
1650161799009,MATH 18,B03,083750,Staff,0,7,30,30
1650161799009,MATH 18,B04,083751,Staff,0,7,30,30
1650161805036,MATH 20A,A01,083754,Staff,26,0,40,14
1650161811060,MATH 20B,A01,083756,Staff,0,5,30,30
1650161811060,MATH 20B,A02,083757,Staff,0,4,30,30
1650161817084,MATH 20C,A01,083760,Staff,0,12,30,30
1650161817084,MATH 20C,A02,083761,Staff,0,12,30,30
1650161817084,MATH 20C,B01,083762,Staff,14,0,30,16
1650161817084,MATH 20C,B02,083763,Staff,28,0,30,2
1650161823117,MATH 20D,A01,083765,Staff,0,2,30,30
1650161823117,MATH 20D,A02,083766,Staff,10,0,30,20
1650161823117,MATH 20D,A03,083767,Staff,28,0,30,2
1650161829154,MATH 20E,A01,083771,Staff,8,0,30,22
1650161829154,MATH 20E,A02,083772,Staff,20,0,30,10
1650161829154,MATH 20E,B01,083773,Staff,0,0,30,30
1650161829154,MATH 20E,B02,083774,Staff,13,0,30,17
1650161835177,MATH 103A,A01,083777,Staff,0,8,30,30
1650161835177,MATH 103A,A02,083778,Staff,0,10,30,30
1650161835177,MATH 103A,B01,083779,Staff,1,10,30,29
1650161835177,MATH 103A,B02,083780,Staff,0,7,30,30
1650161841200,MATH 105,A01,085443,Staff,0,16,30,30
1650161847229,MATH 109,A01,083213,Anzaldo; Leesa B,0,3,30,30
1650161847229,MATH 109,A02,083214,Anzaldo; Leesa B,0,6,30,30
1650161847229,MATH 109,B01,083215,Anzaldo; Leesa B,0,4,30,30
1650161847229,MATH 109,B02,083216,Anzaldo; Leesa B,0,4,30,30
1650161853258,MATH 142A,A01,083219,Chow; Bennett,0,11,30,30
1650161853258,MATH 142A,A02,083220,Chow; Bennett,0,11,30,30
1650161853258,MATH 142A,B01,083221,Chow; Bennett,0,11,30,30
1650161853258,MATH 142A,B02,083222,Chow; Bennett,0,11,30,30
1650161859286,MATH 193A,A01,083224,Staff,0,3,30,30
1650161859286,MATH 193A,A02,083225,Staff,0,4,30,30
1650161859286,MATH 193A,A03,083781,Staff,0,0,30,30
1650161859286,MATH 193A,A04,083782,Staff,0,0,30,30
1650161865310,MATH 197,001,091859,McAuley; Julian John,9998,0,9999,1
1650161871372,COGS 9,A01,083615,Staff,0,14,60,60
1650161877399,COGS 11,A01,083617,Boyle; Mary E. T.,24,0,40,16
1650161883423,COGS 13,A01,083071,Staff,0,29,40,40
1650161889447,COGS 14A,A01,092681,Staff,0,11,100,100
1650161895480,COGS 14B,A01,083073,Cheng; Tzu-Han,0,7,50,50
1650161901506,COGS 17,A01,092677,Staff,34,0,75,41
1650161907531,COGS 100,A01,083619,Staff,0,21,60,60
1650161913556,COGS 101A,A01,083621,Davis; Joshua Daniel,0,21,60,60
1650161919584,COGS 101B,A01,091572,Staff,8,0,60,52
1650161925679,COGS 101C,A01,083625,Delgado; Tania,20,0,30,10
1650161931706,COGS 107A,A01,083627,Boyle; Mary E. T.,0,7,60,60
1650161937730,COGS 118A,A01,083075,Staff,17,0,60,43
1650161943765,CSE 3,A50,083646,Miranda; Gregory Joseph,22,0,38,16
1650161943765,CSE 3,A51,083647,Miranda; Gregory Joseph,37,0,37,0
1650161949796,CSE 8A,A50,083650,Miranda; Gregory Joseph,0,17,40,40
1650161955825,CSE 11,A01,083080,Cao; Yingjun,0,65,40,40
1650161961853,CSE 12,A01,083652,Staff,0,5,100,100
1650161967883,CSE 15L,A01,083654,Staff,0,0,50,50
1650161967883,CSE 15L,A02,083655,Staff,8,0,50,42
1650161973907,CSE 20,A01,083657,Staff,54,0,80,26
1650161979934,CSE 30,A01,083084,Eldon; John,0,67,40,40
1650161985971,CSE 100,A01,083659,Cao; Yingjun,0,62,50,50
1650161991995,CSE 134B,A01,083661,Powell; Thomas Allan,0,27,65,65
1650161998020,CSE 140,A01,083663,Staff,2,0,75,73
1650162004046,CSE 140L,A01,083088,Eldon; John,0,3,75,75
1650162010072,CSE 175,A01,083665,Kumar; Rakesh,8,0,25,17
1650162016096,CSE 190,A00,092507,Dubnov; Shlomo,14,0,20,6
1650162022137,ECE 45,A01,083139,Staff,0,14,40,40
1650162028164,ECE 65,A50,083695,Staff,0,4,30,30
1650162034191,ECE 109,A01,091882,Touri; Behrouz,47,0,70,23
1650162040220,ECE 180,A00,083140,Abi Samra; Nicholas Camill,24,0,30,6
1650162040220,ECE 180,B00,083141,Abi Samra; Nicholas Camill,8,0,30,22
1650162046247,MATH 10A,A01,083735,Patchell; Gregory David,12,0,30,18
1650162046247,MATH 10A,A02,083736,Patchell; Gregory David,28,0,30,2
1650162046247,MATH 10A,A03,083737,Patchell; Gregory David,26,0,30,4
1650162052282,MATH 10B,A01,083207,Staff,0,5,30,30
1650162052282,MATH 10B,A02,083208,Staff,0,4,30,30
1650162052282,MATH 10B,B01,083739,Staff,17,0,30,13
1650162052282,MATH 10B,B02,083740,Staff,29,0,30,1
1650162058313,MATH 18,A01,083743,Staff,10,0,30,20
1650162058313,MATH 18,A02,083744,Staff,28,0,30,2
1650162058313,MATH 18,A03,083745,Staff,23,0,30,7
1650162058313,MATH 18,A04,083746,Staff,27,0,30,3
1650162058313,MATH 18,B01,083748,Staff,0,10,30,30
1650162058313,MATH 18,B02,083749,Staff,0,7,30,30
1650162058313,MATH 18,B03,083750,Staff,0,7,30,30
1650162058313,MATH 18,B04,083751,Staff,0,7,30,30
1650162064342,MATH 20A,A01,083754,Staff,26,0,40,14
1650162070366,MATH 20B,A01,083756,Staff,0,5,30,30
1650162070366,MATH 20B,A02,083757,Staff,0,4,30,30
1650162076391,MATH 20C,A01,083760,Staff,0,12,30,30
1650162076391,MATH 20C,A02,083761,Staff,0,12,30,30
1650162076391,MATH 20C,B01,083762,Staff,14,0,30,16
1650162076391,MATH 20C,B02,083763,Staff,28,0,30,2
1650162082417,MATH 20D,A01,083765,Staff,0,2,30,30
1650162082417,MATH 20D,A02,083766,Staff,10,0,30,20
1650162082417,MATH 20D,A03,083767,Staff,28,0,30,2
1650162088456,MATH 20E,A01,083771,Staff,8,0,30,22
1650162088456,MATH 20E,A02,083772,Staff,20,0,30,10
1650162088456,MATH 20E,B01,083773,Staff,0,0,30,30
1650162088456,MATH 20E,B02,083774,Staff,13,0,30,17
1650162094484,MATH 103A,A01,083777,Staff,0,8,30,30
1650162094484,MATH 103A,A02,083778,Staff,0,10,30,30
1650162094484,MATH 103A,B01,083779,Staff,1,10,30,29
1650162094484,MATH 103A,B02,083780,Staff,0,8,30,30
1650162100527,MATH 105,A01,085443,Staff,0,16,30,30
1650162106551,MATH 109,A01,083213,Anzaldo; Leesa B,0,3,30,30
1650162106551,MATH 109,A02,083214,Anzaldo; Leesa B,0,6,30,30
1650162106551,MATH 109,B01,083215,Anzaldo; Leesa B,0,4,30,30
1650162106551,MATH 109,B02,083216,Anzaldo; Leesa B,0,4,30,30
1650162112575,MATH 142A,A01,083219,Chow; Bennett,0,11,30,30
1650162112575,MATH 142A,A02,083220,Chow; Bennett,0,11,30,30
1650162112575,MATH 142A,B01,083221,Chow; Bennett,0,11,30,30
1650162112575,MATH 142A,B02,083222,Chow; Bennett,0,11,30,30
1650162118604,MATH 193A,A01,083224,Staff,0,3,30,30
1650162118604,MATH 193A,A02,083225,Staff,0,4,30,30
1650162118604,MATH 193A,A03,083781,Staff,0,0,30,30
1650162118604,MATH 193A,A04,083782,Staff,0,0,30,30
1650162124630,MATH 197,001,091859,McAuley; Julian John,9998,0,9999,1
1650162130691,COGS 9,A01,083615,Staff,0,14,60,60
1650162136718,COGS 11,A01,083617,Boyle; Mary E. T.,24,0,40,16
1650162142742,COGS 13,A01,083071,Staff,0,30,40,40
1650162148766,COGS 14A,A01,092681,Staff,0,11,100,100
1650162154791,COGS 14B,A01,083073,Cheng; Tzu-Han,0,7,50,50
1650162160815,COGS 17,A01,092677,Staff,34,0,75,41
1650162166847,COGS 100,A01,083619,Staff,0,21,60,60
1650162172871,COGS 101A,A01,083621,Davis; Joshua Daniel,0,21,60,60
1650162178895,COGS 101B,A01,091572,Staff,8,0,60,52
1650162184923,COGS 101C,A01,083625,Delgado; Tania,20,0,30,10
1650162190958,COGS 107A,A01,083627,Boyle; Mary E. T.,0,7,60,60
1650162196984,COGS 118A,A01,083075,Staff,17,0,60,43
1650162203009,CSE 3,A50,083646,Miranda; Gregory Joseph,22,0,38,16
1650162203009,CSE 3,A51,083647,Miranda; Gregory Joseph,37,0,37,0
1650162209035,CSE 8A,A50,083650,Miranda; Gregory Joseph,0,17,40,40
1650162215058,CSE 11,A01,083080,Cao; Yingjun,0,65,40,40
1650162221083,CSE 12,A01,083652,Staff,0,5,100,100
1650162227108,CSE 15L,A01,083654,Staff,0,0,50,50
1650162227108,CSE 15L,A02,083655,Staff,8,0,50,42
1650162233142,CSE 20,A01,083657,Staff,54,0,80,26
1650162239169,CSE 30,A01,083084,Eldon; John,0,67,40,40
1650162245195,CSE 100,A01,083659,Cao; Yingjun,0,62,50,50
1650162251222,CSE 134B,A01,083661,Powell; Thomas Allan,0,27,65,65
1650162257246,CSE 140,A01,083663,Staff,2,0,75,73
1650162263275,CSE 140L,A01,083088,Eldon; John,0,3,75,75
1650162269301,CSE 175,A01,083665,Kumar; Rakesh,8,0,25,17
1650162275348,CSE 190,A00,092507,Dubnov; Shlomo,14,0,20,6
1650162281375,ECE 45,A01,083139,Staff,0,14,40,40
1650162287399,ECE 65,A50,083695,Staff,0,4,30,30
1650162293425,ECE 109,A01,091882,Touri; Behrouz,47,0,70,23
1650162299452,ECE 180,A00,083140,Abi Samra; Nicholas Camill,24,0,30,6
1650162299452,ECE 180,B00,083141,Abi Samra; Nicholas Camill,8,0,30,22
1650162305475,MATH 10A,A01,083735,Patchell; Gregory David,12,0,30,18
1650162305475,MATH 10A,A02,083736,Patchell; Gregory David,28,0,30,2
1650162305475,MATH 10A,A03,083737,Patchell; Gregory David,26,0,30,4
1650162311499,MATH 10B,A01,083207,Staff,0,5,30,30
1650162311499,MATH 10B,A02,083208,Staff,0,5,30,30
1650162311499,MATH 10B,B01,083739,Staff,17,0,30,13
1650162311499,MATH 10B,B02,083740,Staff,29,0,30,1
1650162317523,MATH 18,A01,083743,Staff,10,0,30,20
1650162317523,MATH 18,A02,083744,Staff,28,0,30,2
1650162317523,MATH 18,A03,083745,Staff,23,0,30,7
1650162317523,MATH 18,A04,083746,Staff,27,0,30,3
1650162317523,MATH 18,B01,083748,Staff,0,10,30,30
1650162317523,MATH 18,B02,083749,Staff,0,7,30,30
1650162317523,MATH 18,B03,083750,Staff,0,7,30,30
1650162317523,MATH 18,B04,083751,Staff,0,7,30,30
1650162323550,MATH 20A,A01,083754,Staff,26,0,40,14
1650162329575,MATH 20B,A01,083756,Staff,0,5,30,30
1650162329575,MATH 20B,A02,083757,Staff,0,4,30,30
1650162335599,MATH 20C,A01,083760,Staff,0,12,30,30
1650162335599,MATH 20C,A02,083761,Staff,0,12,30,30
1650162335599,MATH 20C,B01,083762,Staff,14,0,30,16
1650162335599,MATH 20C,B02,083763,Staff,28,0,30,2
1650162341623,MATH 20D,A01,083765,Staff,0,2,30,30
1650162341623,MATH 20D,A02,083766,Staff,10,0,30,20
1650162341623,MATH 20D,A03,083767,Staff,28,0,30,2
1650162347648,MATH 20E,A01,083771,Staff,8,0,30,22
1650162347648,MATH 20E,A02,083772,Staff,20,0,30,10
1650162347648,MATH 20E,B01,083773,Staff,0,0,30,30
1650162347648,MATH 20E,B02,083774,Staff,13,0,30,17
1650162353672,MATH 103A,A01,083777,Staff,0,8,30,30
1650162353672,MATH 103A,A02,083778,Staff,0,10,30,30
1650162353672,MATH 103A,B01,083779,Staff,1,10,30,29
1650162353672,MATH 103A,B02,083780,Staff,0,8,30,30
1650162359694,MATH 105,A01,085443,Staff,0,16,30,30
1650162365718,MATH 109,A01,083213,Anzaldo; Leesa B,0,3,30,30
1650162365718,MATH 109,A02,083214,Anzaldo; Leesa B,0,6,30,30
1650162365718,MATH 109,B01,083215,Anzaldo; Leesa B,0,4,30,30
1650162365718,MATH 109,B02,083216,Anzaldo; Leesa B,0,4,30,30
1650162371743,MATH 142A,A01,083219,Chow; Bennett,0,11,30,30
1650162371743,MATH 142A,A02,083220,Chow; Bennett,0,11,30,30
1650162371743,MATH 142A,B01,083221,Chow; Bennett,0,11,30,30
1650162371743,MATH 142A,B02,083222,Chow; Bennett,0,11,30,30
1650162377766,MATH 193A,A01,083224,Staff,0,3,30,30
1650162377766,MATH 193A,A02,083225,Staff,0,4,30,30
1650162377766,MATH 193A,A03,083781,Staff,0,0,30,30
1650162377766,MATH 193A,A04,083782,Staff,0,0,30,30
1650162383790,MATH 197,001,091859,McAuley; Julian John,9998,0,9999,1
1650162389855,COGS 9,A01,083615,Staff,0,14,60,60
1650162395884,COGS 11,A01,083617,Boyle; Mary E. T.,24,0,40,16
1650162401911,COGS 13,A01,083071,Staff,0,30,40,40
1650162407935,COGS 14A,A01,092681,Staff,0,11,100,100
1650162413958,COGS 14B,A01,083073,Cheng; Tzu-Han,0,7,50,50
1650162419996,COGS 17,A01,092677,Staff,34,0,75,41
1650162426024,COGS 100,A01,083619,Staff,0,21,60,60
1650162432047,COGS 101A,A01,083621,Davis; Joshua Daniel,0,21,60,60
1650162438070,COGS 101B,A01,091572,Staff,8,0,60,52
1650162444099,COGS 101C,A01,083625,Delgado; Tania,20,0,30,10
1650162450124,COGS 107A,A01,083627,Boyle; Mary E. T.,0,7,60,60
1650162456150,COGS 118A,A01,083075,Staff,17,0,60,43
1650162462174,CSE 3,A50,083646,Miranda; Gregory Joseph,22,0,38,16
1650162462174,CSE 3,A51,083647,Miranda; Gregory Joseph,37,0,37,0
1650162468200,CSE 8A,A50,083650,Miranda; Gregory Joseph,0,17,40,40
1650162474226,CSE 11,A01,083080,Cao; Yingjun,0,65,40,40
1650162480255,CSE 12,A01,083652,Staff,0,5,100,100
1650162486286,CSE 15L,A01,083654,Staff,0,0,50,50
1650162486286,CSE 15L,A02,083655,Staff,8,0,50,42
1650162492313,CSE 20,A01,083657,Staff,54,0,80,26
1650162498336,CSE 30,A01,083084,Eldon; John,0,67,40,40
1650162504360,CSE 100,A01,083659,Cao; Yingjun,0,62,50,50
1650162510384,CSE 134B,A01,083661,Powell; Thomas Allan,0,27,65,65
1650162516414,CSE 140,A01,083663,Staff,2,0,75,73
1650162522510,CSE 140L,A01,083088,Eldon; John,0,3,75,75
1650162528533,CSE 175,A01,083665,Kumar; Rakesh,8,0,25,17
1650162534556,CSE 190,A00,092507,Dubnov; Shlomo,14,0,20,6
1650162540580,ECE 45,A01,083139,Staff,0,14,40,40
1650162546608,ECE 65,A50,083695,Staff,0,4,30,30
1650162552631,ECE 109,A01,091882,Touri; Behrouz,47,0,70,23
1650162558658,ECE 180,A00,083140,Abi Samra; Nicholas Camill,24,0,30,6
1650162558658,ECE 180,B00,083141,Abi Samra; Nicholas Camill,8,0,30,22
1650162564690,MATH 10A,A01,083735,Patchell; Gregory David,12,0,30,18
1650162564690,MATH 10A,A02,083736,Patchell; Gregory David,28,0,30,2
1650162564690,MATH 10A,A03,083737,Patchell; Gregory David,26,0,30,4
1650162570730,MATH 10B,A01,083207,Staff,0,5,30,30
1650162570730,MATH 10B,A02,083208,Staff,0,5,30,30
1650162570730,MATH 10B,B01,083739,Staff,17,0,30,13
1650162570730,MATH 10B,B02,083740,Staff,29,0,30,1
1650162576778,MATH 18,A01,083743,Staff,10,0,30,20
1650162576778,MATH 18,A02,083744,Staff,28,0,30,2
1650162576778,MATH 18,A03,083745,Staff,23,0,30,7
1650162576778,MATH 18,A04,083746,Staff,27,0,30,3
1650162576778,MATH 18,B01,083748,Staff,0,10,30,30
1650162576778,MATH 18,B02,083749,Staff,0,7,30,30
1650162576778,MATH 18,B03,083750,Staff,0,7,30,30
1650162576778,MATH 18,B04,083751,Staff,0,7,30,30
1650162582807,MATH 20A,A01,083754,Staff,26,0,40,14
1650162588834,MATH 20B,A01,083756,Staff,0,5,30,30
1650162588834,MATH 20B,A02,083757,Staff,0,4,30,30
1650162594869,MATH 20C,A01,083760,Staff,0,12,30,30
1650162594869,MATH 20C,A02,083761,Staff,0,12,30,30
1650162594869,MATH 20C,B01,083762,Staff,14,0,30,16
1650162594869,MATH 20C,B02,083763,Staff,28,0,30,2
1650162600893,MATH 20D,A01,083765,Staff,0,2,30,30
1650162600893,MATH 20D,A02,083766,Staff,10,0,30,20
1650162600893,MATH 20D,A03,083767,Staff,28,0,30,2
1650162606922,MATH 20E,A01,083771,Staff,8,0,30,22
1650162606922,MATH 20E,A02,083772,Staff,20,0,30,10
1650162606922,MATH 20E,B01,083773,Staff,0,0,30,30
1650162606922,MATH 20E,B02,083774,Staff,13,0,30,17
1650162612950,MATH 103A,A01,083777,Staff,0,8,30,30
1650162612950,MATH 103A,A02,083778,Staff,0,10,30,30
1650162612950,MATH 103A,B01,083779,Staff,1,10,30,29
1650162612950,MATH 103A,B02,083780,Staff,0,8,30,30
1650162618974,MATH 105,A01,085443,Staff,0,16,30,30
1650162625003,MATH 109,A01,083213,Anzaldo; Leesa B,0,3,30,30
1650162625003,MATH 109,A02,083214,Anzaldo; Leesa B,0,6,30,30
1650162625003,MATH 109,B01,083215,Anzaldo; Leesa B,0,4,30,30
1650162625003,MATH 109,B02,083216,Anzaldo; Leesa B,0,4,30,30
1650162631029,MATH 142A,A01,083219,Chow; Bennett,0,11,30,30
1650162631029,MATH 142A,A02,083220,Chow; Bennett,0,11,30,30
1650162631029,MATH 142A,B01,083221,Chow; Bennett,0,11,30,30
1650162631029,MATH 142A,B02,083222,Chow; Bennett,0,11,30,30
1650162637054,MATH 193A,A01,083224,Staff,0,3,30,30
1650162637054,MATH 193A,A02,083225,Staff,0,4,30,30
1650162637054,MATH 193A,A03,083781,Staff,0,0,30,30
1650162637054,MATH 193A,A04,083782,Staff,0,0,30,30
1650162643077,MATH 197,001,091859,McAuley; Julian John,9998,0,9999,1
1650162649140,COGS 9,A01,083615,Staff,0,14,60,60
1650162655167,COGS 11,A01,083617,Boyle; Mary E. T.,24,0,40,16
1650162661195,COGS 13,A01,083071,Staff,0,30,40,40
1650162667220,COGS 14A,A01,092681,Staff,0,11,100,100
1650162673247,COGS 14B,A01,083073,Cheng; Tzu-Han,0,7,50,50
1650162679274,COGS 17,A01,092677,Staff,34,0,75,41
1650162685301,COGS 100,A01,083619,Staff,0,21,60,60
1650162691333,COGS 101A,A01,083621,Davis; Joshua Daniel,0,21,60,60
1650162697361,COGS 101B,A01,091572,Staff,8,0,60,52
1650162703386,COGS 101C,A01,083625,Delgado; Tania,20,0,30,10
1650162709409,COGS 107A,A01,083627,Boyle; Mary E. T.,0,7,60,60
1650162715446,COGS 118A,A01,083075,Staff,17,0,60,43
1650162721476,CSE 3,A50,083646,Miranda; Gregory Joseph,22,0,38,16
1650162721476,CSE 3,A51,083647,Miranda; Gregory Joseph,37,0,37,0
1650162727497,CSE 8A,A50,083650,Miranda; Gregory Joseph,0,17,40,40
1650162733535,CSE 11,A01,083080,Cao; Yingjun,0,65,40,40
1650162739559,CSE 12,A01,083652,Staff,0,5,100,100
1650162745583,CSE 15L,A01,083654,Staff,0,0,50,50
1650162745583,CSE 15L,A02,083655,Staff,8,0,50,42
1650162751609,CSE 20,A01,083657,Staff,54,0,80,26
1650162757634,CSE 30,A01,083084,Eldon; John,0,67,40,40
1650162763661,CSE 100,A01,083659,Cao; Yingjun,0,62,50,50
1650162769684,CSE 134B,A01,083661,Powell; Thomas Allan,0,27,65,65
1650162775713,CSE 140,A01,083663,Staff,2,0,75,73
1650162781741,CSE 140L,A01,083088,Eldon; John,0,3,75,75
1650162787765,CSE 175,A01,083665,Kumar; Rakesh,8,0,25,17
1650162793804,CSE 190,A00,092507,Dubnov; Shlomo,14,0,20,6
1650162799832,ECE 45,A01,083139,Staff,0,14,40,40
1650162805864,ECE 65,A50,083695,Staff,0,4,30,30
1650162811887,ECE 109,A01,091882,Touri; Behrouz,47,0,70,23
1650162817933,ECE 180,A00,083140,Abi Samra; Nicholas Camill,24,0,30,6
1650162817933,ECE 180,B00,083141,Abi Samra; Nicholas Camill,8,0,30,22
1650162823957,MATH 10A,A01,083735,Patchell; Gregory David,12,0,30,18
1650162823957,MATH 10A,A02,083736,Patchell; Gregory David,28,0,30,2
1650162823957,MATH 10A,A03,083737,Patchell; Gregory David,26,0,30,4
1650162829981,MATH 10B,A01,083207,Staff,0,5,30,30
1650162829981,MATH 10B,A02,083208,Staff,0,5,30,30
1650162829981,MATH 10B,B01,083739,Staff,17,0,30,13
1650162829981,MATH 10B,B02,083740,Staff,29,0,30,1
1650162836016,MATH 18,A01,083743,Staff,10,0,30,20
1650162836016,MATH 18,A02,083744,Staff,28,0,30,2
1650162836016,MATH 18,A03,083745,Staff,23,0,30,7
1650162836016,MATH 18,A04,083746,Staff,27,0,30,3
1650162836016,MATH 18,B01,083748,Staff,0,10,30,30
1650162836016,MATH 18,B02,083749,Staff,0,7,30,30
1650162836016,MATH 18,B03,083750,Staff,0,7,30,30
1650162836016,MATH 18,B04,083751,Staff,0,7,30,30
1650162842042,MATH 20A,A01,083754,Staff,26,0,40,14
1650162848069,MATH 20B,A01,083756,Staff,0,5,30,30
1650162848069,MATH 20B,A02,083757,Staff,0,4,30,30
1650162854094,MATH 20C,A01,083760,Staff,0,12,30,30
1650162854094,MATH 20C,A02,083761,Staff,0,12,30,30
1650162854094,MATH 20C,B01,083762,Staff,14,0,30,16
1650162854094,MATH 20C,B02,083763,Staff,28,0,30,2
1650162860115,MATH 20D,A01,083765,Staff,0,2,30,30
1650162860115,MATH 20D,A02,083766,Staff,10,0,30,20
1650162860115,MATH 20D,A03,083767,Staff,28,0,30,2
1650162866142,MATH 20E,A01,083771,Staff,8,0,30,22
1650162866142,MATH 20E,A02,083772,Staff,20,0,30,10
1650162866142,MATH 20E,B01,083773,Staff,0,0,30,30
1650162866142,MATH 20E,B02,083774,Staff,13,0,30,17
1650162872170,MATH 103A,A01,083777,Staff,0,8,30,30
1650162872170,MATH 103A,A02,083778,Staff,0,10,30,30
1650162872170,MATH 103A,B01,083779,Staff,1,10,30,29
1650162872170,MATH 103A,B02,083780,Staff,0,8,30,30
1650162878194,MATH 105,A01,085443,Staff,0,16,30,30
1650162884248,MATH 109,A01,083213,Anzaldo; Leesa B,0,3,30,30
1650162884248,MATH 109,A02,083214,Anzaldo; Leesa B,0,6,30,30
1650162884248,MATH 109,B01,083215,Anzaldo; Leesa B,0,4,30,30
1650162884248,MATH 109,B02,083216,Anzaldo; Leesa B,0,4,30,30
1650162890277,MATH 142A,A01,083219,Chow; Bennett,0,11,30,30
1650162890277,MATH 142A,A02,083220,Chow; Bennett,0,11,30,30
1650162890277,MATH 142A,B01,083221,Chow; Bennett,0,11,30,30
1650162890277,MATH 142A,B02,083222,Chow; Bennett,0,11,30,30
1650162896300,MATH 193A,A01,083224,Staff,0,3,30,30
1650162896300,MATH 193A,A02,083225,Staff,0,4,30,30
1650162896300,MATH 193A,A03,083781,Staff,0,0,30,30
1650162896300,MATH 193A,A04,083782,Staff,0,0,30,30
1650162902325,MATH 197,001,091859,McAuley; Julian John,9998,0,9999,1
1650162908375,COGS 9,A01,083615,Staff,0,14,60,60
1650162914400,COGS 11,A01,083617,Boyle; Mary E. T.,24,0,40,16
1650162920426,COGS 13,A01,083071,Staff,0,30,40,40
1650162926453,COGS 14A,A01,092681,Staff,0,11,100,100
1650162932488,COGS 14B,A01,083073,Cheng; Tzu-Han,0,7,50,50
1650162938518,COGS 17,A01,092677,Staff,34,0,75,41
1650162944545,COGS 100,A01,083619,Staff,0,21,60,60
1650162950579,COGS 101A,A01,083621,Davis; Joshua Daniel,0,21,60,60
1650162956602,COGS 101B,A01,091572,Staff,8,0,60,52
1650162962626,COGS 101C,A01,083625,Delgado; Tania,20,0,30,10
1650162968651,COGS 107A,A01,083627,Boyle; Mary E. T.,0,7,60,60
1650162974679,COGS 118A,A01,083075,Staff,17,0,60,43
1650162980704,CSE 3,A50,083646,Miranda; Gregory Joseph,22,0,38,16
1650162980704,CSE 3,A51,083647,Miranda; Gregory Joseph,37,0,37,0
1650162986729,CSE 8A,A50,083650,Miranda; Gregory Joseph,0,17,40,40
1650162992757,CSE 11,A01,083080,Cao; Yingjun,0,65,40,40
1650162998783,CSE 12,A01,083652,Staff,0,5,100,100
1650163004817,CSE 15L,A01,083654,Staff,0,0,50,50
1650163004817,CSE 15L,A02,083655,Staff,8,0,50,42
1650163010840,CSE 20,A01,083657,Staff,54,0,80,26
1650163016873,CSE 30,A01,083084,Eldon; John,0,67,40,40
1650163029844,CSE 100,A01,083659,Cao; Yingjun,0,62,50,50
1650163035869,CSE 134B,A01,083661,Powell; Thomas Allan,0,27,65,65
1650163041894,CSE 140,A01,083663,Staff,2,0,75,73
1650163047917,CSE 140L,A01,083088,Eldon; John,0,3,75,75
1650163053947,CSE 175,A01,083665,Kumar; Rakesh,8,0,25,17
1650163059970,CSE 190,A00,092507,Dubnov; Shlomo,14,0,20,6
1650163065999,ECE 45,A01,083139,Staff,0,14,40,40
1650163072023,ECE 65,A50,083695,Staff,0,4,30,30
1650163078050,ECE 109,A01,091882,Touri; Behrouz,47,0,70,23
1650163084073,ECE 180,A00,083140,Abi Samra; Nicholas Camill,24,0,30,6
1650163084073,ECE 180,B00,083141,Abi Samra; Nicholas Camill,8,0,30,22
1650163090101,MATH 10A,A01,083735,Patchell; Gregory David,12,0,30,18
1650163090101,MATH 10A,A02,083736,Patchell; Gregory David,28,0,30,2
1650163090101,MATH 10A,A03,083737,Patchell; Gregory David,26,0,30,4
1650163096137,MATH 10B,A01,083207,Staff,0,5,30,30
1650163096137,MATH 10B,A02,083208,Staff,0,5,30,30
1650163096137,MATH 10B,B01,083739,Staff,17,0,30,13
1650163096137,MATH 10B,B02,083740,Staff,29,0,30,1
1650163102171,MATH 18,A01,083743,Staff,10,0,30,20
1650163102171,MATH 18,A02,083744,Staff,28,0,30,2
1650163102171,MATH 18,A03,083745,Staff,23,0,30,7
1650163102171,MATH 18,A04,083746,Staff,27,0,30,3
1650163102171,MATH 18,B01,083748,Staff,0,10,30,30
1650163102171,MATH 18,B02,083749,Staff,0,7,30,30
1650163102171,MATH 18,B03,083750,Staff,0,7,30,30
1650163102171,MATH 18,B04,083751,Staff,0,7,30,30
1650163108194,MATH 20A,A01,083754,Staff,26,0,40,14
1650163114217,MATH 20B,A01,083756,Staff,0,5,30,30
1650163114217,MATH 20B,A02,083757,Staff,0,4,30,30
1650163120241,MATH 20C,A01,083760,Staff,0,12,30,30
1650163120241,MATH 20C,A02,083761,Staff,0,12,30,30
1650163120241,MATH 20C,B01,083762,Staff,14,0,30,16
1650163120241,MATH 20C,B02,083763,Staff,28,0,30,2
1650163126348,MATH 20D,A01,083765,Staff,0,2,30,30
1650163126348,MATH 20D,A02,083766,Staff,10,0,30,20
1650163126348,MATH 20D,A03,083767,Staff,28,0,30,2
1650163132385,MATH 20E,A01,083771,Staff,8,0,30,22
1650163132385,MATH 20E,A02,083772,Staff,20,0,30,10
1650163132385,MATH 20E,B01,083773,Staff,0,0,30,30
1650163132385,MATH 20E,B02,083774,Staff,13,0,30,17
1650163138410,MATH 103A,A01,083777,Staff,0,8,30,30
1650163138410,MATH 103A,A02,083778,Staff,0,10,30,30
1650163138410,MATH 103A,B01,083779,Staff,1,10,30,29
1650163138410,MATH 103A,B02,083780,Staff,0,8,30,30
1650163144437,MATH 105,A01,085443,Staff,0,16,30,30
1650163150481,MATH 109,A01,083213,Anzaldo; Leesa B,0,3,30,30
1650163150481,MATH 109,A02,083214,Anzaldo; Leesa B,0,6,30,30
1650163150481,MATH 109,B01,083215,Anzaldo; Leesa B,0,4,30,30
1650163150481,MATH 109,B02,083216,Anzaldo; Leesa B,0,4,30,30
1650163156512,MATH 142A,A01,083219,Chow; Bennett,0,11,30,30
1650163156512,MATH 142A,A02,083220,Chow; Bennett,0,11,30,30
1650163156512,MATH 142A,B01,083221,Chow; Bennett,0,11,30,30
1650163156512,MATH 142A,B02,083222,Chow; Bennett,0,11,30,30
1650163162543,MATH 193A,A01,083224,Staff,0,3,30,30
1650163162543,MATH 193A,A02,083225,Staff,0,4,30,30
1650163162543,MATH 193A,A03,083781,Staff,0,0,30,30
1650163162543,MATH 193A,A04,083782,Staff,0,0,30,30
1650163168567,MATH 197,001,091859,McAuley; Julian John,9998,0,9999,1
1650163174628,COGS 9,A01,083615,Staff,0,14,60,60
1650163180653,COGS 11,A01,083617,Boyle; Mary E. T.,24,0,40,16
1650163186676,COGS 13,A01,083071,Staff,0,30,40,40
1650163192713,COGS 14A,A01,092681,Staff,0,11,100,100
1650163198741,COGS 14B,A01,083073,Cheng; Tzu-Han,0,7,50,50
1650163204768,COGS 17,A01,092677,Staff,34,0,75,41
1650163210795,COGS 100,A01,083619,Staff,0,21,60,60
1650163216820,COGS 101A,A01,083621,Davis; Joshua Daniel,0,21,60,60
1650163222844,COGS 101B,A01,091572,Staff,8,0,60,52
1650163228867,COGS 101C,A01,083625,Delgado; Tania,20,0,30,10
1650163234891,COGS 107A,A01,083627,Boyle; Mary E. T.,0,7,60,60
1650163240918,COGS 118A,A01,083075,Staff,17,0,60,43
1650163246945,CSE 3,A50,083646,Miranda; Gregory Joseph,22,0,38,16
1650163246945,CSE 3,A51,083647,Miranda; Gregory Joseph,37,0,37,0
1650163252972,CSE 8A,A50,083650,Miranda; Gregory Joseph,0,17,40,40
1650163259006,CSE 11,A01,083080,Cao; Yingjun,0,65,40,40
1650163265040,CSE 12,A01,083652,Staff,0,5,100,100
1650163271066,CSE 15L,A01,083654,Staff,0,0,50,50
1650163271066,CSE 15L,A02,083655,Staff,8,0,50,42
1650163277094,CSE 20,A01,083657,Staff,54,0,80,26
1650163283117,CSE 30,A01,083084,Eldon; John,0,67,40,40
1650163289140,CSE 100,A01,083659,Cao; Yingjun,0,62,50,50
1650163295169,CSE 134B,A01,083661,Powell; Thomas Allan,0,27,65,65
1650163301193,CSE 140,A01,083663,Staff,2,0,75,73
1650163307220,CSE 140L,A01,083088,Eldon; John,0,3,75,75
1650163313243,CSE 175,A01,083665,Kumar; Rakesh,8,0,25,17
1650163319267,CSE 190,A00,092507,Dubnov; Shlomo,14,0,20,6
1650163325292,ECE 45,A01,083139,Staff,0,14,40,40
1650163331318,ECE 65,A50,083695,Staff,0,4,30,30
1650163337342,ECE 109,A01,091882,Touri; Behrouz,47,0,70,23
1650163343368,ECE 180,A00,083140,Abi Samra; Nicholas Camill,24,0,30,6
1650163343368,ECE 180,B00,083141,Abi Samra; Nicholas Camill,8,0,30,22
1650163349391,MATH 10A,A01,083735,Patchell; Gregory David,12,0,30,18
1650163349391,MATH 10A,A02,083736,Patchell; Gregory David,28,0,30,2
1650163349391,MATH 10A,A03,083737,Patchell; Gregory David,26,0,30,4
1650163355415,MATH 10B,A01,083207,Staff,0,5,30,30
1650163355415,MATH 10B,A02,083208,Staff,0,5,30,30
1650163355415,MATH 10B,B01,083739,Staff,17,0,30,13
1650163355415,MATH 10B,B02,083740,Staff,29,0,30,1
1650163361440,MATH 18,A01,083743,Staff,10,0,30,20
1650163361440,MATH 18,A02,083744,Staff,28,0,30,2
1650163361440,MATH 18,A03,083745,Staff,23,0,30,7
1650163361440,MATH 18,A04,083746,Staff,27,0,30,3
1650163361440,MATH 18,B01,083748,Staff,0,10,30,30
1650163361440,MATH 18,B02,083749,Staff,0,7,30,30
1650163361440,MATH 18,B03,083750,Staff,0,7,30,30
1650163361440,MATH 18,B04,083751,Staff,0,7,30,30
1650163367463,MATH 20A,A01,083754,Staff,26,0,40,14
1650163373493,MATH 20B,A01,083756,Staff,0,5,30,30
1650163373493,MATH 20B,A02,083757,Staff,0,4,30,30
1650163379517,MATH 20C,A01,083760,Staff,0,12,30,30
1650163379517,MATH 20C,A02,083761,Staff,0,12,30,30
1650163379517,MATH 20C,B01,083762,Staff,14,0,30,16
1650163379517,MATH 20C,B02,083763,Staff,28,0,30,2
1650163385552,MATH 20D,A01,083765,Staff,0,2,30,30
1650163385552,MATH 20D,A02,083766,Staff,10,0,30,20
1650163385552,MATH 20D,A03,083767,Staff,28,0,30,2
1650163391577,MATH 20E,A01,083771,Staff,8,0,30,22
1650163391577,MATH 20E,A02,083772,Staff,20,0,30,10
1650163391577,MATH 20E,B01,083773,Staff,0,0,30,30
1650163391577,MATH 20E,B02,083774,Staff,13,0,30,17
1650163397606,MATH 103A,A01,083777,Staff,0,8,30,30
1650163397606,MATH 103A,A02,083778,Staff,0,10,30,30
1650163397606,MATH 103A,B01,083779,Staff,1,10,30,29
1650163397606,MATH 103A,B02,083780,Staff,0,8,30,30
1650163403633,MATH 105,A01,085443,Staff,0,16,30,30
1650163409658,MATH 109,A01,083213,Anzaldo; Leesa B,0,3,30,30
1650163409658,MATH 109,A02,083214,Anzaldo; Leesa B,0,6,30,30
1650163409658,MATH 109,B01,083215,Anzaldo; Leesa B,0,4,30,30
1650163409658,MATH 109,B02,083216,Anzaldo; Leesa B,0,4,30,30
1650163415686,MATH 142A,A01,083219,Chow; Bennett,0,11,30,30
1650163415686,MATH 142A,A02,083220,Chow; Bennett,0,11,30,30
1650163415686,MATH 142A,B01,083221,Chow; Bennett,0,11,30,30
1650163415686,MATH 142A,B02,083222,Chow; Bennett,0,11,30,30
1650163421711,MATH 193A,A01,083224,Staff,0,3,30,30
1650163421711,MATH 193A,A02,083225,Staff,0,4,30,30
1650163421711,MATH 193A,A03,083781,Staff,0,0,30,30
1650163421711,MATH 193A,A04,083782,Staff,0,0,30,30
1650163427735,MATH 197,001,091859,McAuley; Julian John,9998,0,9999,1
1650163433788,COGS 9,A01,083615,Staff,0,14,60,60
1650163439812,COGS 11,A01,083617,Boyle; Mary E. T.,24,0,40,16
1650163445838,COGS 13,A01,083071,Staff,0,30,40,40
1650163451879,COGS 14A,A01,092681,Staff,0,12,100,100
1650163457903,COGS 14B,A01,083073,Cheng; Tzu-Han,0,7,50,50
1650163463927,COGS 17,A01,092677,Staff,34,0,75,41
1650163469954,COGS 100,A01,083619,Staff,0,21,60,60
1650163475977,COGS 101A,A01,083621,Davis; Joshua Daniel,0,21,60,60
1650163482005,COGS 101B,A01,091572,Staff,8,0,60,52
1650163488028,COGS 101C,A01,083625,Delgado; Tania,20,0,30,10
1650163494052,COGS 107A,A01,083627,Boyle; Mary E. T.,0,7,60,60
1650163500076,COGS 118A,A01,083075,Staff,17,0,60,43
1650163506104,CSE 3,A50,083646,Miranda; Gregory Joseph,22,0,38,16
1650163506104,CSE 3,A51,083647,Miranda; Gregory Joseph,37,0,37,0
1650163512146,CSE 8A,A50,083650,Miranda; Gregory Joseph,0,17,40,40
1650163518173,CSE 11,A01,083080,Cao; Yingjun,0,65,40,40
1650163524198,CSE 12,A01,083652,Staff,0,5,100,100
1650163530236,CSE 15L,A01,083654,Staff,0,0,50,50
1650163530236,CSE 15L,A02,083655,Staff,8,0,50,42
1650163536273,CSE 20,A01,083657,Staff,54,0,80,26
1650163542297,CSE 30,A01,083084,Eldon; John,0,67,40,40
1650163548334,CSE 100,A01,083659,Cao; Yingjun,0,61,50,50
1650163554362,CSE 134B,A01,083661,Powell; Thomas Allan,0,27,65,65
1650163560386,CSE 140,A01,083663,Staff,2,0,75,73
1650163566412,CSE 140L,A01,083088,Eldon; John,0,3,75,75
1650163572439,CSE 175,A01,083665,Kumar; Rakesh,8,0,25,17
1650163578469,CSE 190,A00,092507,Dubnov; Shlomo,14,0,20,6
1650163584497,ECE 45,A01,083139,Staff,0,14,40,40
1650163590524,ECE 65,A50,083695,Staff,0,4,30,30
1650163596548,ECE 109,A01,091882,Touri; Behrouz,47,0,70,23
1650163602575,ECE 180,A00,083140,Abi Samra; Nicholas Camill,24,0,30,6
1650163602575,ECE 180,B00,083141,Abi Samra; Nicholas Camill,8,0,30,22
1650163608599,MATH 10A,A01,083735,Patchell; Gregory David,12,0,30,18
1650163608599,MATH 10A,A02,083736,Patchell; Gregory David,28,0,30,2
1650163608599,MATH 10A,A03,083737,Patchell; Gregory David,26,0,30,4
1650163614624,MATH 10B,A01,083207,Staff,0,5,30,30
1650163614624,MATH 10B,A02,083208,Staff,0,5,30,30
1650163614624,MATH 10B,B01,083739,Staff,17,0,30,13
1650163614624,MATH 10B,B02,083740,Staff,29,0,30,1
1650163620651,MATH 18,A01,083743,Staff,10,0,30,20
1650163620651,MATH 18,A02,083744,Staff,28,0,30,2
1650163620651,MATH 18,A03,083745,Staff,23,0,30,7
1650163620651,MATH 18,A04,083746,Staff,27,0,30,3
1650163620651,MATH 18,B01,083748,Staff,0,10,30,30
1650163620651,MATH 18,B02,083749,Staff,0,7,30,30
1650163620651,MATH 18,B03,083750,Staff,0,7,30,30
1650163620651,MATH 18,B04,083751,Staff,0,7,30,30
1650163626691,MATH 20A,A01,083754,Staff,26,0,40,14
1650163632716,MATH 20B,A01,083756,Staff,0,5,30,30
1650163632716,MATH 20B,A02,083757,Staff,0,4,30,30
1650163638745,MATH 20C,A01,083760,Staff,0,12,30,30
1650163638745,MATH 20C,A02,083761,Staff,0,12,30,30
1650163638745,MATH 20C,B01,083762,Staff,14,0,30,16
1650163638745,MATH 20C,B02,083763,Staff,28,0,30,2
1650163644773,MATH 20D,A01,083765,Staff,0,2,30,30
1650163644773,MATH 20D,A02,083766,Staff,10,0,30,20
1650163644773,MATH 20D,A03,083767,Staff,28,0,30,2
1650163650801,MATH 20E,A01,083771,Staff,8,0,30,22
1650163650801,MATH 20E,A02,083772,Staff,20,0,30,10
1650163650801,MATH 20E,B01,083773,Staff,0,0,30,30
1650163650801,MATH 20E,B02,083774,Staff,13,0,30,17
1650163656824,MATH 103A,A01,083777,Staff,0,8,30,30
1650163656824,MATH 103A,A02,083778,Staff,0,10,30,30
1650163656824,MATH 103A,B01,083779,Staff,1,10,30,29
1650163656824,MATH 103A,B02,083780,Staff,0,8,30,30
1650163662847,MATH 105,A01,085443,Staff,0,16,30,30
1650163668876,MATH 109,A01,083213,Anzaldo; Leesa B,0,3,30,30
1650163668876,MATH 109,A02,083214,Anzaldo; Leesa B,0,6,30,30
1650163668876,MATH 109,B01,083215,Anzaldo; Leesa B,0,4,30,30
1650163668876,MATH 109,B02,083216,Anzaldo; Leesa B,0,4,30,30
1650163674914,MATH 142A,A01,083219,Chow; Bennett,0,11,30,30
1650163674914,MATH 142A,A02,083220,Chow; Bennett,0,11,30,30
1650163674914,MATH 142A,B01,083221,Chow; Bennett,0,11,30,30
1650163674914,MATH 142A,B02,083222,Chow; Bennett,0,11,30,30
1650163680937,MATH 193A,A01,083224,Staff,0,3,30,30
1650163680937,MATH 193A,A02,083225,Staff,0,4,30,30
1650163680937,MATH 193A,A03,083781,Staff,0,0,30,30
1650163680937,MATH 193A,A04,083782,Staff,0,0,30,30
1650163686960,MATH 197,001,091859,McAuley; Julian John,9998,0,9999,1
1650163693015,COGS 9,A01,083615,Staff,0,14,60,60
1650163699042,COGS 11,A01,083617,Boyle; Mary E. T.,24,0,40,16
1650163705069,COGS 13,A01,083071,Staff,0,30,40,40
1650163711096,COGS 14A,A01,092681,Staff,0,12,100,100
1650163717197,COGS 14B,A01,083073,Cheng; Tzu-Han,0,7,50,50
1650163723221,COGS 17,A01,092677,Staff,34,0,75,41
1650163729246,COGS 100,A01,083619,Staff,0,21,60,60
1650163735269,COGS 101A,A01,083621,Davis; Joshua Daniel,0,21,60,60
1650163741295,COGS 101B,A01,091572,Staff,8,0,60,52
1650163747318,COGS 101C,A01,083625,Delgado; Tania,20,0,30,10
1650163753345,COGS 107A,A01,083627,Boyle; Mary E. T.,0,7,60,60
1650163759369,COGS 118A,A01,083075,Staff,17,0,60,43
1650163765393,CSE 3,A50,083646,Miranda; Gregory Joseph,22,0,38,16
1650163765393,CSE 3,A51,083647,Miranda; Gregory Joseph,37,0,37,0
1650163771417,CSE 8A,A50,083650,Miranda; Gregory Joseph,0,17,40,40
1650163777452,CSE 11,A01,083080,Cao; Yingjun,0,65,40,40
1650163783476,CSE 12,A01,083652,Staff,0,5,100,100
1650163789499,CSE 15L,A01,083654,Staff,0,0,50,50
1650163789499,CSE 15L,A02,083655,Staff,8,0,50,42
1650163795530,CSE 20,A01,083657,Staff,54,0,80,26
1650163801558,CSE 30,A01,083084,Eldon; John,0,67,40,40
1650163807585,CSE 100,A01,083659,Cao; Yingjun,0,61,50,50
1650163813612,CSE 134B,A01,083661,Powell; Thomas Allan,0,27,65,65
1650163819639,CSE 140,A01,083663,Staff,2,0,75,73
1650163825668,CSE 140L,A01,083088,Eldon; John,0,3,75,75
1650163831694,CSE 175,A01,083665,Kumar; Rakesh,8,0,25,17
1650163837721,CSE 190,A00,092507,Dubnov; Shlomo,14,0,20,6
1650163843745,ECE 45,A01,083139,Staff,0,14,40,40
1650163849776,ECE 65,A50,083695,Staff,0,4,30,30
1650163855802,ECE 109,A01,091882,Touri; Behrouz,47,0,70,23
1650163861830,ECE 180,A00,083140,Abi Samra; Nicholas Camill,24,0,30,6
1650163861830,ECE 180,B00,083141,Abi Samra; Nicholas Camill,8,0,30,22
1650163867852,MATH 10A,A01,083735,Patchell; Gregory David,12,0,30,18
1650163867852,MATH 10A,A02,083736,Patchell; Gregory David,28,0,30,2
1650163867852,MATH 10A,A03,083737,Patchell; Gregory David,26,0,30,4
1650163873882,MATH 10B,A01,083207,Staff,0,5,30,30
1650163873882,MATH 10B,A02,083208,Staff,0,5,30,30
1650163873882,MATH 10B,B01,083739,Staff,17,0,30,13
1650163873882,MATH 10B,B02,083740,Staff,29,0,30,1
1650163879909,MATH 18,A01,083743,Staff,10,0,30,20
1650163879909,MATH 18,A02,083744,Staff,28,0,30,2
1650163879909,MATH 18,A03,083745,Staff,23,0,30,7
1650163879909,MATH 18,A04,083746,Staff,27,0,30,3
1650163879909,MATH 18,B01,083748,Staff,0,10,30,30
1650163879909,MATH 18,B02,083749,Staff,0,7,30,30
1650163879909,MATH 18,B03,083750,Staff,0,7,30,30
1650163879909,MATH 18,B04,083751,Staff,0,7,30,30
1650163885930,MATH 20A,A01,083754,Staff,26,0,40,14
1650163891957,MATH 20B,A01,083756,Staff,0,5,30,30
1650163891957,MATH 20B,A02,083757,Staff,0,4,30,30
1650163897981,MATH 20C,A01,083760,Staff,0,12,30,30
1650163897981,MATH 20C,A02,083761,Staff,0,12,30,30
1650163897981,MATH 20C,B01,083762,Staff,14,0,30,16
1650163897981,MATH 20C,B02,083763,Staff,28,0,30,2
1650163904004,MATH 20D,A01,083765,Staff,0,2,30,30
1650163904004,MATH 20D,A02,083766,Staff,10,0,30,20
1650163904004,MATH 20D,A03,083767,Staff,28,0,30,2
1650163910032,MATH 20E,A01,083771,Staff,8,0,30,22
1650163910032,MATH 20E,A02,083772,Staff,20,0,30,10
1650163910032,MATH 20E,B01,083773,Staff,0,0,30,30
1650163910032,MATH 20E,B02,083774,Staff,13,0,30,17
1650163916060,MATH 103A,A01,083777,Staff,0,8,30,30
1650163916060,MATH 103A,A02,083778,Staff,0,10,30,30
1650163916060,MATH 103A,B01,083779,Staff,1,10,30,29
1650163916060,MATH 103A,B02,083780,Staff,0,8,30,30
1650163922088,MATH 105,A01,085443,Staff,0,16,30,30
1650163928112,MATH 109,A01,083213,Anzaldo; Leesa B,0,3,30,30
1650163928112,MATH 109,A02,083214,Anzaldo; Leesa B,0,6,30,30
1650163928112,MATH 109,B01,083215,Anzaldo; Leesa B,0,4,30,30
1650163928112,MATH 109,B02,083216,Anzaldo; Leesa B,0,4,30,30
1650163934137,MATH 142A,A01,083219,Chow; Bennett,0,11,30,30
1650163934137,MATH 142A,A02,083220,Chow; Bennett,0,11,30,30
1650163934137,MATH 142A,B01,083221,Chow; Bennett,0,11,30,30
1650163934137,MATH 142A,B02,083222,Chow; Bennett,0,11,30,30
1650163940161,MATH 193A,A01,083224,Staff,0,3,30,30
1650163940161,MATH 193A,A02,083225,Staff,0,4,30,30
1650163940161,MATH 193A,A03,083781,Staff,0,0,30,30
1650163940161,MATH 193A,A04,083782,Staff,0,0,30,30
1650163946187,MATH 197,001,091859,McAuley; Julian John,9998,0,9999,1
1650163952239,COGS 9,A01,083615,Staff,0,14,60,60
1650163958265,COGS 11,A01,083617,Boyle; Mary E. T.,24,0,40,16
1650163964291,COGS 13,A01,083071,Staff,0,30,40,40
1650163970313,COGS 14A,A01,092681,Staff,0,12,100,100
1650163976339,COGS 14B,A01,083073,Cheng; Tzu-Han,0,7,50,50
1650163982363,COGS 17,A01,092677,Staff,34,0,75,41
1650163988387,COGS 100,A01,083619,Staff,0,21,60,60
1650163994409,COGS 101A,A01,083621,Davis; Joshua Daniel,0,21,60,60
1650164000432,COGS 101B,A01,091572,Staff,8,0,60,52
1650164006458,COGS 101C,A01,083625,Delgado; Tania,20,0,30,10
1650164012484,COGS 107A,A01,083627,Boyle; Mary E. T.,0,7,60,60
1650164018511,COGS 118A,A01,083075,Staff,17,0,60,43
1650164024538,CSE 3,A50,083646,Miranda; Gregory Joseph,22,0,38,16
1650164024538,CSE 3,A51,083647,Miranda; Gregory Joseph,37,0,37,0
1650164030565,CSE 8A,A50,083650,Miranda; Gregory Joseph,0,17,40,40
1650164036603,CSE 11,A01,083080,Cao; Yingjun,0,65,40,40
1650164042630,CSE 12,A01,083652,Staff,0,5,100,100
1650164048653,CSE 15L,A01,083654,Staff,0,0,50,50
1650164048653,CSE 15L,A02,083655,Staff,8,0,50,42
1650164054684,CSE 20,A01,083657,Staff,54,0,80,26
1650164060718,CSE 30,A01,083084,Eldon; John,0,67,40,40
1650164066742,CSE 100,A01,083659,Cao; Yingjun,0,61,50,50
1650164072766,CSE 134B,A01,083661,Powell; Thomas Allan,0,27,65,65
1650164078792,CSE 140,A01,083663,Staff,2,0,75,73
1650164084820,CSE 140L,A01,083088,Eldon; John,0,3,75,75
1650164090842,CSE 175,A01,083665,Kumar; Rakesh,8,0,25,17
1650164096866,CSE 190,A00,092507,Dubnov; Shlomo,14,0,20,6
1650164102890,ECE 45,A01,083139,Staff,0,14,40,40
1650164108919,ECE 65,A50,083695,Staff,0,4,30,30
1650164114944,ECE 109,A01,091882,Touri; Behrouz,47,0,70,23
1650164120979,ECE 180,A00,083140,Abi Samra; Nicholas Camill,24,0,30,6
1650164120979,ECE 180,B00,083141,Abi Samra; Nicholas Camill,8,0,30,22
1650164127003,MATH 10A,A01,083735,Patchell; Gregory David,12,0,30,18
1650164127003,MATH 10A,A02,083736,Patchell; Gregory David,28,0,30,2
1650164127003,MATH 10A,A03,083737,Patchell; Gregory David,26,0,30,4
1650164133032,MATH 10B,A01,083207,Staff,0,5,30,30
1650164133032,MATH 10B,A02,083208,Staff,0,5,30,30
1650164133032,MATH 10B,B01,083739,Staff,17,0,30,13
1650164133032,MATH 10B,B02,083740,Staff,29,0,30,1
1650164139062,MATH 18,A01,083743,Staff,10,0,30,20
1650164139062,MATH 18,A02,083744,Staff,28,0,30,2
1650164139062,MATH 18,A03,083745,Staff,23,0,30,7
1650164139062,MATH 18,A04,083746,Staff,27,0,30,3
1650164139062,MATH 18,B01,083748,Staff,0,10,30,30
1650164139062,MATH 18,B02,083749,Staff,0,7,30,30
1650164139062,MATH 18,B03,083750,Staff,0,7,30,30
1650164139062,MATH 18,B04,083751,Staff,0,7,30,30
1650164145086,MATH 20A,A01,083754,Staff,26,0,40,14
1650164151110,MATH 20B,A01,083756,Staff,0,5,30,30
1650164151110,MATH 20B,A02,083757,Staff,0,4,30,30
1650164157135,MATH 20C,A01,083760,Staff,0,12,30,30
1650164157135,MATH 20C,A02,083761,Staff,0,12,30,30
1650164157135,MATH 20C,B01,083762,Staff,14,0,30,16
1650164157135,MATH 20C,B02,083763,Staff,28,0,30,2
1650164163163,MATH 20D,A01,083765,Staff,0,2,30,30
1650164163163,MATH 20D,A02,083766,Staff,10,0,30,20
1650164163163,MATH 20D,A03,083767,Staff,28,0,30,2
1650164169198,MATH 20E,A01,083771,Staff,8,0,30,22
1650164169198,MATH 20E,A02,083772,Staff,20,0,30,10
1650164169198,MATH 20E,B01,083773,Staff,0,0,30,30
1650164169198,MATH 20E,B02,083774,Staff,13,0,30,17
1650164175223,MATH 103A,A01,083777,Staff,0,8,30,30
1650164175223,MATH 103A,A02,083778,Staff,0,10,30,30
1650164175223,MATH 103A,B01,083779,Staff,1,10,30,29
1650164175223,MATH 103A,B02,083780,Staff,0,8,30,30
1650164181246,MATH 105,A01,085443,Staff,0,16,30,30
1650164187274,MATH 109,A01,083213,Anzaldo; Leesa B,0,3,30,30
1650164187274,MATH 109,A02,083214,Anzaldo; Leesa B,0,6,30,30
1650164187274,MATH 109,B01,083215,Anzaldo; Leesa B,0,4,30,30
1650164187274,MATH 109,B02,083216,Anzaldo; Leesa B,0,4,30,30
1650164193299,MATH 142A,A01,083219,Chow; Bennett,0,11,30,30
1650164193299,MATH 142A,A02,083220,Chow; Bennett,0,11,30,30
1650164193299,MATH 142A,B01,083221,Chow; Bennett,0,11,30,30
1650164193299,MATH 142A,B02,083222,Chow; Bennett,0,11,30,30
1650164199342,MATH 193A,A01,083224,Staff,0,3,30,30
1650164199342,MATH 193A,A02,083225,Staff,0,4,30,30
1650164199342,MATH 193A,A03,083781,Staff,0,0,30,30
1650164199342,MATH 193A,A04,083782,Staff,0,0,30,30
1650164205366,MATH 197,001,091859,McAuley; Julian John,9998,0,9999,1
1650164211435,COGS 9,A01,083615,Staff,0,14,60,60
1650164217464,COGS 11,A01,083617,Boyle; Mary E. T.,24,0,40,16
1650164223488,COGS 13,A01,083071,Staff,0,30,40,40
1650164229510,COGS 14A,A01,092681,Staff,0,12,100,100
1650164235537,COGS 14B,A01,083073,Cheng; Tzu-Han,0,7,50,50
1650164241563,COGS 17,A01,092677,Staff,34,0,75,41
1650164247590,COGS 100,A01,083619,Staff,0,21,60,60
1650164253628,COGS 101A,A01,083621,Davis; Joshua Daniel,0,21,60,60
1650164259651,COGS 101B,A01,091572,Staff,8,0,60,52
1650164265676,COGS 101C,A01,083625,Delgado; Tania,20,0,30,10
1650164271700,COGS 107A,A01,083627,Boyle; Mary E. T.,0,7,60,60
1650164277725,COGS 118A,A01,083075,Staff,17,0,60,43
1650164283749,CSE 3,A50,083646,Miranda; Gregory Joseph,22,0,38,16
1650164283749,CSE 3,A51,083647,Miranda; Gregory Joseph,37,0,37,0
1650164289773,CSE 8A,A50,083650,Miranda; Gregory Joseph,0,17,40,40
1650164295796,CSE 11,A01,083080,Cao; Yingjun,0,65,40,40
1650164301820,CSE 12,A01,083652,Staff,0,5,100,100
1650164307847,CSE 15L,A01,083654,Staff,0,0,50,50
1650164307847,CSE 15L,A02,083655,Staff,8,0,50,42
1650164313946,CSE 20,A01,083657,Staff,54,0,80,26
1650164319975,CSE 30,A01,083084,Eldon; John,0,67,40,40
1650164326002,CSE 100,A01,083659,Cao; Yingjun,0,61,50,50
1650164332024,CSE 134B,A01,083661,Powell; Thomas Allan,0,27,65,65
1650164338048,CSE 140,A01,083663,Staff,2,0,75,73
1650164344072,CSE 140L,A01,083088,Eldon; John,0,3,75,75
1650164350096,CSE 175,A01,083665,Kumar; Rakesh,8,0,25,17
1650164356119,CSE 190,A00,092507,Dubnov; Shlomo,14,0,20,6
1650164362154,ECE 45,A01,083139,Staff,0,14,40,40
1650164368178,ECE 65,A50,083695,Staff,0,4,30,30
1650164374201,ECE 109,A01,091882,Touri; Behrouz,47,0,70,23
1650164380225,ECE 180,A00,083140,Abi Samra; Nicholas Camill,24,0,30,6
1650164380225,ECE 180,B00,083141,Abi Samra; Nicholas Camill,8,0,30,22
1650164386249,MATH 10A,A01,083735,Patchell; Gregory David,12,0,30,18
1650164386249,MATH 10A,A02,083736,Patchell; Gregory David,28,0,30,2
1650164386249,MATH 10A,A03,083737,Patchell; Gregory David,26,0,30,4
1650164392273,MATH 10B,A01,083207,Staff,0,5,30,30
1650164392273,MATH 10B,A02,083208,Staff,0,5,30,30
1650164392273,MATH 10B,B01,083739,Staff,17,0,30,13
1650164392273,MATH 10B,B02,083740,Staff,29,0,30,1
1650164398300,MATH 18,A01,083743,Staff,10,0,30,20
1650164398300,MATH 18,A02,083744,Staff,28,0,30,2
1650164398300,MATH 18,A03,083745,Staff,23,0,30,7
1650164398300,MATH 18,A04,083746,Staff,27,0,30,3
1650164398300,MATH 18,B01,083748,Staff,0,10,30,30
1650164398300,MATH 18,B02,083749,Staff,0,7,30,30
1650164398300,MATH 18,B03,083750,Staff,0,7,30,30
1650164398300,MATH 18,B04,083751,Staff,0,7,30,30
1650164404324,MATH 20A,A01,083754,Staff,26,0,40,14
1650164410347,MATH 20B,A01,083756,Staff,0,5,30,30
1650164410347,MATH 20B,A02,083757,Staff,0,4,30,30
1650164416372,MATH 20C,A01,083760,Staff,0,12,30,30
1650164416372,MATH 20C,A02,083761,Staff,0,12,30,30
1650164416372,MATH 20C,B01,083762,Staff,14,0,30,16
1650164416372,MATH 20C,B02,083763,Staff,28,0,30,2
1650164422396,MATH 20D,A01,083765,Staff,0,2,30,30
1650164422396,MATH 20D,A02,083766,Staff,10,0,30,20
1650164422396,MATH 20D,A03,083767,Staff,28,0,30,2
1650164428424,MATH 20E,A01,083771,Staff,8,0,30,22
1650164428424,MATH 20E,A02,083772,Staff,20,0,30,10
1650164428424,MATH 20E,B01,083773,Staff,0,0,30,30
1650164428424,MATH 20E,B02,083774,Staff,13,0,30,17
1650164434449,MATH 103A,A01,083777,Staff,0,8,30,30
1650164434449,MATH 103A,A02,083778,Staff,0,10,30,30
1650164434449,MATH 103A,B01,083779,Staff,1,10,30,29
1650164434449,MATH 103A,B02,083780,Staff,0,8,30,30
1650164440473,MATH 105,A01,085443,Staff,0,16,30,30
1650164446497,MATH 109,A01,083213,Anzaldo; Leesa B,0,3,30,30
1650164446497,MATH 109,A02,083214,Anzaldo; Leesa B,0,6,30,30
1650164446497,MATH 109,B01,083215,Anzaldo; Leesa B,0,4,30,30
1650164446497,MATH 109,B02,083216,Anzaldo; Leesa B,0,4,30,30
1650164452526,MATH 142A,A01,083219,Chow; Bennett,0,11,30,30
1650164452526,MATH 142A,A02,083220,Chow; Bennett,0,11,30,30
1650164452526,MATH 142A,B01,083221,Chow; Bennett,0,11,30,30
1650164452526,MATH 142A,B02,083222,Chow; Bennett,0,11,30,30
1650164458550,MATH 193A,A01,083224,Staff,0,3,30,30
1650164458550,MATH 193A,A02,083225,Staff,0,4,30,30
1650164458550,MATH 193A,A03,083781,Staff,0,0,30,30
1650164458550,MATH 193A,A04,083782,Staff,0,0,30,30
1650164464580,MATH 197,001,091859,McAuley; Julian John,9998,0,9999,1
1650164470636,COGS 9,A01,083615,Staff,0,14,60,60
1650164476665,COGS 11,A01,083617,Boyle; Mary E. T.,24,0,40,16
1650164482689,COGS 13,A01,083071,Staff,0,30,40,40
1650164488724,COGS 14A,A01,092681,Staff,0,12,100,100
1650164494751,COGS 14B,A01,083073,Cheng; Tzu-Han,0,7,50,50
1650164500777,COGS 17,A01,092677,Staff,34,0,75,41
1650164506804,COGS 100,A01,083619,Staff,0,21,60,60
1650164512838,COGS 101A,A01,083621,Davis; Joshua Daniel,0,21,60,60
1650164518861,COGS 101B,A01,091572,Staff,8,0,60,52
1650164524890,COGS 101C,A01,083625,Delgado; Tania,20,0,30,10
1650164530914,COGS 107A,A01,083627,Boyle; Mary E. T.,0,7,60,60
1650164536937,COGS 118A,A01,083075,Staff,17,0,60,43
1650164542966,CSE 3,A50,083646,Miranda; Gregory Joseph,22,0,38,16
1650164542966,CSE 3,A51,083647,Miranda; Gregory Joseph,37,0,37,0
1650164548989,CSE 8A,A50,083650,Miranda; Gregory Joseph,0,17,40,40
1650164555013,CSE 11,A01,083080,Cao; Yingjun,0,65,40,40
1650164561037,CSE 12,A01,083652,Staff,0,5,100,100
1650164567070,CSE 15L,A01,083654,Staff,0,0,50,50
1650164567070,CSE 15L,A02,083655,Staff,8,0,50,42
1650164573096,CSE 20,A01,083657,Staff,54,0,80,26
1650164579119,CSE 30,A01,083084,Eldon; John,0,67,40,40
1650164585140,CSE 100,A01,083659,Cao; Yingjun,0,61,50,50
1650164591169,CSE 134B,A01,083661,Powell; Thomas Allan,0,27,65,65
1650164597192,CSE 140,A01,083663,Staff,2,0,75,73
1650164603216,CSE 140L,A01,083088,Eldon; John,0,3,75,75
1650164609245,CSE 175,A01,083665,Kumar; Rakesh,8,0,25,17
1650164615268,CSE 190,A00,092507,Dubnov; Shlomo,14,0,20,6
1650164621291,ECE 45,A01,083139,Staff,0,14,40,40
1650164627314,ECE 65,A50,083695,Staff,0,4,30,30
1650164633340,ECE 109,A01,091882,Touri; Behrouz,47,0,70,23
1650164639367,ECE 180,A00,083140,Abi Samra; Nicholas Camill,24,0,30,6
1650164639367,ECE 180,B00,083141,Abi Samra; Nicholas Camill,8,0,30,22
1650164645395,MATH 10A,A01,083735,Patchell; Gregory David,12,0,30,18
1650164645395,MATH 10A,A02,083736,Patchell; Gregory David,28,0,30,2
1650164645395,MATH 10A,A03,083737,Patchell; Gregory David,26,0,30,4
1650164651423,MATH 10B,A01,083207,Staff,0,5,30,30
1650164651423,MATH 10B,A02,083208,Staff,0,5,30,30
1650164651423,MATH 10B,B01,083739,Staff,17,0,30,13
1650164651423,MATH 10B,B02,083740,Staff,29,0,30,1
1650164657450,MATH 18,A01,083743,Staff,10,0,30,20
1650164657450,MATH 18,A02,083744,Staff,28,0,30,2
1650164657450,MATH 18,A03,083745,Staff,23,0,30,7
1650164657450,MATH 18,A04,083746,Staff,27,0,30,3
1650164657450,MATH 18,B01,083748,Staff,0,10,30,30
1650164657450,MATH 18,B02,083749,Staff,0,7,30,30
1650164657450,MATH 18,B03,083750,Staff,0,7,30,30
1650164657450,MATH 18,B04,083751,Staff,0,7,30,30
1650164663476,MATH 20A,A01,083754,Staff,26,0,40,14
1650164669501,MATH 20B,A01,083756,Staff,0,5,30,30
1650164669501,MATH 20B,A02,083757,Staff,0,4,30,30
1650164675529,MATH 20C,A01,083760,Staff,0,12,30,30
1650164675529,MATH 20C,A02,083761,Staff,0,12,30,30
1650164675529,MATH 20C,B01,083762,Staff,14,0,30,16
1650164675529,MATH 20C,B02,083763,Staff,28,0,30,2
1650164681555,MATH 20D,A01,083765,Staff,0,2,30,30
1650164681555,MATH 20D,A02,083766,Staff,10,0,30,20
1650164681555,MATH 20D,A03,083767,Staff,28,0,30,2
1650164687579,MATH 20E,A01,083771,Staff,8,0,30,22
1650164687579,MATH 20E,A02,083772,Staff,20,0,30,10
1650164687579,MATH 20E,B01,083773,Staff,0,0,30,30
1650164687579,MATH 20E,B02,083774,Staff,13,0,30,17
1650164693608,MATH 103A,A01,083777,Staff,0,8,30,30
1650164693608,MATH 103A,A02,083778,Staff,0,10,30,30
1650164693608,MATH 103A,B01,083779,Staff,1,10,30,29
1650164693608,MATH 103A,B02,083780,Staff,0,8,30,30
1650164699635,MATH 105,A01,085443,Staff,0,16,30,30
1650164705659,MATH 109,A01,083213,Anzaldo; Leesa B,0,3,30,30
1650164705659,MATH 109,A02,083214,Anzaldo; Leesa B,0,6,30,30
1650164705659,MATH 109,B01,083215,Anzaldo; Leesa B,0,4,30,30
1650164705659,MATH 109,B02,083216,Anzaldo; Leesa B,0,4,30,30
1650164711692,MATH 142A,A01,083219,Chow; Bennett,0,11,30,30
1650164711692,MATH 142A,A02,083220,Chow; Bennett,0,11,30,30
1650164711692,MATH 142A,B01,083221,Chow; Bennett,0,11,30,30
1650164711692,MATH 142A,B02,083222,Chow; Bennett,0,11,30,30
1650164717718,MATH 193A,A01,083224,Staff,0,3,30,30
1650164717718,MATH 193A,A02,083225,Staff,0,4,30,30
1650164717718,MATH 193A,A03,083781,Staff,0,0,30,30
1650164717718,MATH 193A,A04,083782,Staff,0,0,30,30
1650164723760,MATH 197,001,091859,McAuley; Julian John,9998,0,9999,1
1650164729826,COGS 9,A01,083615,Staff,0,14,60,60
1650164735850,COGS 11,A01,083617,Boyle; Mary E. T.,24,0,40,16
1650164741878,COGS 13,A01,083071,Staff,0,30,40,40
1650164747905,COGS 14A,A01,092681,Staff,0,12,100,100
1650164753936,COGS 14B,A01,083073,Cheng; Tzu-Han,0,7,50,50
1650164759962,COGS 17,A01,092677,Staff,34,0,75,41
1650164765986,COGS 100,A01,083619,Staff,0,21,60,60
1650164772022,COGS 101A,A01,083621,Davis; Joshua Daniel,0,21,60,60
1650164778046,COGS 101B,A01,091572,Staff,8,0,60,52
1650164784070,COGS 101C,A01,083625,Delgado; Tania,20,0,30,10
1650164790095,COGS 107A,A01,083627,Boyle; Mary E. T.,0,7,60,60
1650164796125,COGS 118A,A01,083075,Staff,17,0,60,43
1650164802148,CSE 3,A50,083646,Miranda; Gregory Joseph,22,0,38,16
1650164802148,CSE 3,A51,083647,Miranda; Gregory Joseph,37,0,37,0
1650164808172,CSE 8A,A50,083650,Miranda; Gregory Joseph,0,17,40,40
1650164814196,CSE 11,A01,083080,Cao; Yingjun,0,65,40,40
1650164820229,CSE 12,A01,083652,Staff,0,5,100,100
1650164826257,CSE 15L,A01,083654,Staff,0,0,50,50
1650164826257,CSE 15L,A02,083655,Staff,8,0,50,42
1650164832281,CSE 20,A01,083657,Staff,54,0,80,26
1650164838305,CSE 30,A01,083084,Eldon; John,0,67,40,40
1650164844342,CSE 100,A01,083659,Cao; Yingjun,0,61,50,50
1650164850368,CSE 134B,A01,083661,Powell; Thomas Allan,0,27,65,65
1650164856403,CSE 140,A01,083663,Staff,2,0,75,73
1650164862428,CSE 140L,A01,083088,Eldon; John,0,3,75,75
1650164868461,CSE 175,A01,083665,Kumar; Rakesh,8,0,25,17
1650164874487,CSE 190,A00,092507,Dubnov; Shlomo,14,0,20,6
1650164880513,ECE 45,A01,083139,Staff,0,14,40,40
1650164886542,ECE 65,A50,083695,Staff,0,4,30,30
1650164892565,ECE 109,A01,091882,Touri; Behrouz,47,0,70,23
1650164898590,ECE 180,A00,083140,Abi Samra; Nicholas Camill,24,0,30,6
1650164898590,ECE 180,B00,083141,Abi Samra; Nicholas Camill,8,0,30,22
1650164904614,MATH 10A,A01,083735,Patchell; Gregory David,12,0,30,18
1650164904614,MATH 10A,A02,083736,Patchell; Gregory David,28,0,30,2
1650164904614,MATH 10A,A03,083737,Patchell; Gregory David,26,0,30,4
1650164910729,MATH 10B,A01,083207,Staff,0,5,30,30
1650164910729,MATH 10B,A02,083208,Staff,0,5,30,30
1650164910729,MATH 10B,B01,083739,Staff,17,0,30,13
1650164910729,MATH 10B,B02,083740,Staff,29,0,30,1
1650164916755,MATH 18,A01,083743,Staff,10,0,30,20
1650164916755,MATH 18,A02,083744,Staff,28,0,30,2
1650164916755,MATH 18,A03,083745,Staff,23,0,30,7
1650164916755,MATH 18,A04,083746,Staff,27,0,30,3
1650164916755,MATH 18,B01,083748,Staff,0,10,30,30
1650164916755,MATH 18,B02,083749,Staff,0,7,30,30
1650164916755,MATH 18,B03,083750,Staff,0,7,30,30
1650164916755,MATH 18,B04,083751,Staff,0,7,30,30
1650164922781,MATH 20A,A01,083754,Staff,26,0,40,14
1650164928806,MATH 20B,A01,083756,Staff,0,5,30,30
1650164928806,MATH 20B,A02,083757,Staff,0,4,30,30
1650164934838,MATH 20C,A01,083760,Staff,0,12,30,30
1650164934838,MATH 20C,A02,083761,Staff,0,12,30,30
1650164934838,MATH 20C,B01,083762,Staff,14,0,30,16
1650164934838,MATH 20C,B02,083763,Staff,28,0,30,2
1650164940863,MATH 20D,A01,083765,Staff,0,2,30,30
1650164940863,MATH 20D,A02,083766,Staff,10,0,30,20
1650164940863,MATH 20D,A03,083767,Staff,28,0,30,2
1650164946902,MATH 20E,A01,083771,Staff,8,0,30,22
1650164946902,MATH 20E,A02,083772,Staff,20,0,30,10
1650164946902,MATH 20E,B01,083773,Staff,0,0,30,30
1650164946902,MATH 20E,B02,083774,Staff,13,0,30,17
1650164952930,MATH 103A,A01,083777,Staff,0,8,30,30
1650164952930,MATH 103A,A02,083778,Staff,0,10,30,30
1650164952930,MATH 103A,B01,083779,Staff,1,10,30,29
1650164952930,MATH 103A,B02,083780,Staff,0,8,30,30
1650164958958,MATH 105,A01,085443,Staff,0,16,30,30
1650164964985,MATH 109,A01,083213,Anzaldo; Leesa B,0,3,30,30
1650164964985,MATH 109,A02,083214,Anzaldo; Leesa B,0,6,30,30
1650164964985,MATH 109,B01,083215,Anzaldo; Leesa B,0,4,30,30
1650164964985,MATH 109,B02,083216,Anzaldo; Leesa B,0,4,30,30
1650164971014,MATH 142A,A01,083219,Chow; Bennett,0,11,30,30
1650164971014,MATH 142A,A02,083220,Chow; Bennett,0,11,30,30
1650164971014,MATH 142A,B01,083221,Chow; Bennett,0,11,30,30
1650164971014,MATH 142A,B02,083222,Chow; Bennett,0,11,30,30
1650164977038,MATH 193A,A01,083224,Staff,0,3,30,30
1650164977038,MATH 193A,A02,083225,Staff,0,4,30,30
1650164977038,MATH 193A,A03,083781,Staff,0,0,30,30
1650164977038,MATH 193A,A04,083782,Staff,0,0,30,30
1650164983065,MATH 197,001,091859,McAuley; Julian John,9998,0,9999,1
1650164989119,COGS 9,A01,083615,Staff,0,14,60,60
1650164995160,COGS 11,A01,083617,Boyle; Mary E. T.,24,0,40,16
1650165001184,COGS 13,A01,083071,Staff,0,30,40,40
1650165007209,COGS 14A,A01,092681,Staff,0,12,100,100
1650165013242,COGS 14B,A01,083073,Cheng; Tzu-Han,0,7,50,50
1650165019269,COGS 17,A01,092677,Staff,34,0,75,41
1650165025293,COGS 100,A01,083619,Staff,0,21,60,60
1650165031316,COGS 101A,A01,083621,Davis; Joshua Daniel,0,21,60,60
1650165037340,COGS 101B,A01,091572,Staff,8,0,60,52
1650165043364,COGS 101C,A01,083625,Delgado; Tania,20,0,30,10
1650165049393,COGS 107A,A01,083627,Boyle; Mary E. T.,0,7,60,60
1650165055417,COGS 118A,A01,083075,Staff,17,0,60,43
1650165061445,CSE 3,A50,083646,Miranda; Gregory Joseph,22,0,38,16
1650165061445,CSE 3,A51,083647,Miranda; Gregory Joseph,37,0,37,0
1650165067474,CSE 8A,A50,083650,Miranda; Gregory Joseph,0,17,40,40
1650165073509,CSE 11,A01,083080,Cao; Yingjun,0,65,40,40
1650165079554,CSE 12,A01,083652,Staff,0,5,100,100
1650165085577,CSE 15L,A01,083654,Staff,0,0,50,50
1650165085577,CSE 15L,A02,083655,Staff,8,0,50,42
1650165091605,CSE 20,A01,083657,Staff,54,0,80,26
1650165097632,CSE 30,A01,083084,Eldon; John,0,67,40,40
1650165103655,CSE 100,A01,083659,Cao; Yingjun,0,61,50,50
1650165109682,CSE 134B,A01,083661,Powell; Thomas Allan,0,27,65,65
1650165115709,CSE 140,A01,083663,Staff,2,0,75,73
1650165121732,CSE 140L,A01,083088,Eldon; John,0,3,75,75
1650165127756,CSE 175,A01,083665,Kumar; Rakesh,8,0,25,17
1650165133784,CSE 190,A00,092507,Dubnov; Shlomo,14,0,20,6
1650165139808,ECE 45,A01,083139,Staff,0,14,40,40
1650165145833,ECE 65,A50,083695,Staff,0,4,30,30
1650165151861,ECE 109,A01,091882,Touri; Behrouz,47,0,70,23
1650165157885,ECE 180,A00,083140,Abi Samra; Nicholas Camill,24,0,30,6
1650165157885,ECE 180,B00,083141,Abi Samra; Nicholas Camill,8,0,30,22
1650165163909,MATH 10A,A01,083735,Patchell; Gregory David,12,0,30,18
1650165163909,MATH 10A,A02,083736,Patchell; Gregory David,28,0,30,2
1650165163909,MATH 10A,A03,083737,Patchell; Gregory David,26,0,30,4
1650165169934,MATH 10B,A01,083207,Staff,0,5,30,30
1650165169934,MATH 10B,A02,083208,Staff,0,5,30,30
1650165169934,MATH 10B,B01,083739,Staff,17,0,30,13
1650165169934,MATH 10B,B02,083740,Staff,29,0,30,1
1650165175964,MATH 18,A01,083743,Staff,10,0,30,20
1650165175964,MATH 18,A02,083744,Staff,28,0,30,2
1650165175964,MATH 18,A03,083745,Staff,23,0,30,7
1650165175964,MATH 18,A04,083746,Staff,27,0,30,3
1650165175964,MATH 18,B01,083748,Staff,0,10,30,30
1650165175964,MATH 18,B02,083749,Staff,0,7,30,30
1650165175964,MATH 18,B03,083750,Staff,0,7,30,30
1650165175964,MATH 18,B04,083751,Staff,0,7,30,30
1650165181993,MATH 20A,A01,083754,Staff,26,0,40,14
1650165188017,MATH 20B,A01,083756,Staff,0,5,30,30
1650165188017,MATH 20B,A02,083757,Staff,0,4,30,30
1650165194040,MATH 20C,A01,083760,Staff,0,12,30,30
1650165194040,MATH 20C,A02,083761,Staff,0,12,30,30
1650165194040,MATH 20C,B01,083762,Staff,14,0,30,16
1650165194040,MATH 20C,B02,083763,Staff,28,0,30,2
1650165200068,MATH 20D,A01,083765,Staff,0,2,30,30
1650165200068,MATH 20D,A02,083766,Staff,10,0,30,20
1650165200068,MATH 20D,A03,083767,Staff,28,0,30,2
1650165206097,MATH 20E,A01,083771,Staff,8,0,30,22
1650165206097,MATH 20E,A02,083772,Staff,20,0,30,10
1650165206097,MATH 20E,B01,083773,Staff,0,0,30,30
1650165206097,MATH 20E,B02,083774,Staff,13,0,30,17
1650165212122,MATH 103A,A01,083777,Staff,0,8,30,30
1650165212122,MATH 103A,A02,083778,Staff,0,10,30,30
1650165212122,MATH 103A,B01,083779,Staff,1,10,30,29
1650165212122,MATH 103A,B02,083780,Staff,0,8,30,30
1650165218145,MATH 105,A01,085443,Staff,0,16,30,30
1650165224171,MATH 109,A01,083213,Anzaldo; Leesa B,0,3,30,30
1650165224171,MATH 109,A02,083214,Anzaldo; Leesa B,0,6,30,30
1650165224171,MATH 109,B01,083215,Anzaldo; Leesa B,0,4,30,30
1650165224171,MATH 109,B02,083216,Anzaldo; Leesa B,0,4,30,30
1650165230196,MATH 142A,A01,083219,Chow; Bennett,0,11,30,30
1650165230196,MATH 142A,A02,083220,Chow; Bennett,0,11,30,30
1650165230196,MATH 142A,B01,083221,Chow; Bennett,0,11,30,30
1650165230196,MATH 142A,B02,083222,Chow; Bennett,0,11,30,30
1650165236220,MATH 193A,A01,083224,Staff,0,3,30,30
1650165236220,MATH 193A,A02,083225,Staff,0,4,30,30
1650165236220,MATH 193A,A03,083781,Staff,0,0,30,30
1650165236220,MATH 193A,A04,083782,Staff,0,0,30,30
1650165242246,MATH 197,001,091859,McAuley; Julian John,9998,0,9999,1
1650165248302,COGS 9,A01,083615,Staff,0,14,60,60
1650165254324,COGS 11,A01,083617,Boyle; Mary E. T.,24,0,40,16
1650165260354,COGS 13,A01,083071,Staff,0,30,40,40
1650165266380,COGS 14A,A01,092681,Staff,0,12,100,100
1650165272403,COGS 14B,A01,083073,Cheng; Tzu-Han,0,7,50,50
1650165278428,COGS 17,A01,092677,Staff,34,0,75,41
1650165284464,COGS 100,A01,083619,Staff,0,21,60,60
1650165290491,COGS 101A,A01,083621,Davis; Joshua Daniel,0,21,60,60
1650165296514,COGS 101B,A01,091572,Staff,8,0,60,52
1650165302538,COGS 101C,A01,083625,Delgado; Tania,20,0,30,10
1650165308571,COGS 107A,A01,083627,Boyle; Mary E. T.,0,7,60,60
1650165314598,COGS 118A,A01,083075,Staff,17,0,60,43
1650165320625,CSE 3,A50,083646,Miranda; Gregory Joseph,22,0,38,16
1650165320625,CSE 3,A51,083647,Miranda; Gregory Joseph,37,0,37,0
1650165326650,CSE 8A,A50,083650,Miranda; Gregory Joseph,0,17,40,40
1650165332677,CSE 11,A01,083080,Cao; Yingjun,0,65,40,40
1650165338701,CSE 12,A01,083652,Staff,0,5,100,100
1650165344727,CSE 15L,A01,083654,Staff,0,0,50,50
1650165344727,CSE 15L,A02,083655,Staff,8,0,50,42
1650165350754,CSE 20,A01,083657,Staff,54,0,80,26
1650165356781,CSE 30,A01,083084,Eldon; John,0,67,40,40
1650165362858,CSE 100,A01,083659,Cao; Yingjun,0,61,50,50
1650165368886,CSE 134B,A01,083661,Powell; Thomas Allan,0,27,65,65
1650165374913,CSE 140,A01,083663,Staff,2,0,75,73
1650165380939,CSE 140L,A01,083088,Eldon; John,0,3,75,75
1650165386967,CSE 175,A01,083665,Kumar; Rakesh,8,0,25,17
1650165392994,CSE 190,A00,092507,Dubnov; Shlomo,14,0,20,6
1650165399021,ECE 45,A01,083139,Staff,0,14,40,40
1650165405049,ECE 65,A50,083695,Staff,0,4,30,30
1650165411073,ECE 109,A01,091882,Touri; Behrouz,47,0,70,23
1650165417099,ECE 180,A00,083140,Abi Samra; Nicholas Camill,24,0,30,6
1650165417099,ECE 180,B00,083141,Abi Samra; Nicholas Camill,8,0,30,22
1650165423132,MATH 10A,A01,083735,Patchell; Gregory David,12,0,30,18
1650165423132,MATH 10A,A02,083736,Patchell; Gregory David,28,0,30,2
1650165423132,MATH 10A,A03,083737,Patchell; Gregory David,26,0,30,4
1650165429157,MATH 10B,A01,083207,Staff,0,5,30,30
1650165429157,MATH 10B,A02,083208,Staff,0,5,30,30
1650165429157,MATH 10B,B01,083739,Staff,17,0,30,13
1650165429157,MATH 10B,B02,083740,Staff,29,0,30,1
1650165435184,MATH 18,A01,083743,Staff,10,0,30,20
1650165435184,MATH 18,A02,083744,Staff,28,0,30,2
1650165435184,MATH 18,A03,083745,Staff,23,0,30,7
1650165435184,MATH 18,A04,083746,Staff,27,0,30,3
1650165435184,MATH 18,B01,083748,Staff,0,10,30,30
1650165435184,MATH 18,B02,083749,Staff,0,7,30,30
1650165435184,MATH 18,B03,083750,Staff,0,7,30,30
1650165435184,MATH 18,B04,083751,Staff,0,7,30,30
1650165441209,MATH 20A,A01,083754,Staff,26,0,40,14
1650165447233,MATH 20B,A01,083756,Staff,0,5,30,30
1650165447233,MATH 20B,A02,083757,Staff,0,4,30,30
1650165453259,MATH 20C,A01,083760,Staff,0,12,30,30
1650165453259,MATH 20C,A02,083761,Staff,0,12,30,30
1650165453259,MATH 20C,B01,083762,Staff,14,0,30,16
1650165453259,MATH 20C,B02,083763,Staff,28,0,30,2
1650165459287,MATH 20D,A01,083765,Staff,0,2,30,30
1650165459287,MATH 20D,A02,083766,Staff,10,0,30,20
1650165459287,MATH 20D,A03,083767,Staff,28,0,30,2
1650165465312,MATH 20E,A01,083771,Staff,8,0,30,22
1650165465312,MATH 20E,A02,083772,Staff,20,0,30,10
1650165465312,MATH 20E,B01,083773,Staff,0,0,30,30
1650165465312,MATH 20E,B02,083774,Staff,13,0,30,17
1650165471341,MATH 103A,A01,083777,Staff,0,8,30,30
1650165471341,MATH 103A,A02,083778,Staff,0,10,30,30
1650165471341,MATH 103A,B01,083779,Staff,1,10,30,29
1650165471341,MATH 103A,B02,083780,Staff,0,8,30,30
1650165477365,MATH 105,A01,085443,Staff,0,16,30,30
1650165483388,MATH 109,A01,083213,Anzaldo; Leesa B,0,3,30,30
1650165483388,MATH 109,A02,083214,Anzaldo; Leesa B,0,6,30,30
1650165483388,MATH 109,B01,083215,Anzaldo; Leesa B,0,4,30,30
1650165483388,MATH 109,B02,083216,Anzaldo; Leesa B,0,4,30,30
1650165489413,MATH 142A,A01,083219,Chow; Bennett,0,11,30,30
1650165489413,MATH 142A,A02,083220,Chow; Bennett,0,11,30,30
1650165489413,MATH 142A,B01,083221,Chow; Bennett,0,11,30,30
1650165489413,MATH 142A,B02,083222,Chow; Bennett,0,11,30,30
1650165495441,MATH 193A,A01,083224,Staff,0,3,30,30
1650165495441,MATH 193A,A02,083225,Staff,0,4,30,30
1650165495441,MATH 193A,A03,083781,Staff,0,0,30,30
1650165495441,MATH 193A,A04,083782,Staff,0,0,30,30
1650165501464,MATH 197,001,091859,McAuley; Julian John,9998,0,9999,1
1650165507597,COGS 9,A01,083615,Staff,0,14,60,60
1650165513629,COGS 11,A01,083617,Boyle; Mary E. T.,24,0,40,16
1650165519652,COGS 13,A01,083071,Staff,0,30,40,40
1650165525676,COGS 14A,A01,092681,Staff,0,12,100,100
1650165531703,COGS 14B,A01,083073,Cheng; Tzu-Han,0,7,50,50
1650165537730,COGS 17,A01,092677,Staff,34,0,75,41
1650165543754,COGS 100,A01,083619,Staff,0,21,60,60
1650165549778,COGS 101A,A01,083621,Davis; Joshua Daniel,0,21,60,60
1650165555801,COGS 101B,A01,091572,Staff,8,0,60,52
1650165561823,COGS 101C,A01,083625,Delgado; Tania,20,0,30,10
1650165567851,COGS 107A,A01,083627,Boyle; Mary E. T.,0,7,60,60
1650165573879,COGS 118A,A01,083075,Staff,17,0,60,43
1650165579903,CSE 3,A50,083646,Miranda; Gregory Joseph,22,0,38,16
1650165579903,CSE 3,A51,083647,Miranda; Gregory Joseph,37,0,37,0
1650165585927,CSE 8A,A50,083650,Miranda; Gregory Joseph,0,17,40,40
1650165591949,CSE 11,A01,083080,Cao; Yingjun,0,65,40,40
1650165597974,CSE 12,A01,083652,Staff,0,5,100,100
1650165603997,CSE 15L,A01,083654,Staff,0,0,50,50
1650165603997,CSE 15L,A02,083655,Staff,8,0,50,42
1650165610033,CSE 20,A01,083657,Staff,54,0,80,26
1650165616059,CSE 30,A01,083084,Eldon; John,0,67,40,40
1650165622085,CSE 100,A01,083659,Cao; Yingjun,0,61,50,50
1650165628109,CSE 134B,A01,083661,Powell; Thomas Allan,0,27,65,65
1650165634133,CSE 140,A01,083663,Staff,2,0,75,73
1650165640158,CSE 140L,A01,083088,Eldon; John,0,3,75,75
1650165646184,CSE 175,A01,083665,Kumar; Rakesh,8,0,25,17
1650165652211,CSE 190,A00,092507,Dubnov; Shlomo,14,0,20,6
1650165658234,ECE 45,A01,083139,Staff,0,14,40,40
1650165664258,ECE 65,A50,083695,Staff,0,4,30,30
1650165670284,ECE 109,A01,091882,Touri; Behrouz,47,0,70,23
1650165676308,ECE 180,A00,083140,Abi Samra; Nicholas Camill,24,0,30,6
1650165676308,ECE 180,B00,083141,Abi Samra; Nicholas Camill,8,0,30,22
1650165682332,MATH 10A,A01,083735,Patchell; Gregory David,12,0,30,18
1650165682332,MATH 10A,A02,083736,Patchell; Gregory David,28,0,30,2
1650165682332,MATH 10A,A03,083737,Patchell; Gregory David,26,0,30,4
1650165688359,MATH 10B,A01,083207,Staff,0,5,30,30
1650165688359,MATH 10B,A02,083208,Staff,0,5,30,30
1650165688359,MATH 10B,B01,083739,Staff,17,0,30,13
1650165688359,MATH 10B,B02,083740,Staff,29,0,30,1
1650165694391,MATH 18,A01,083743,Staff,10,0,30,20
1650165694391,MATH 18,A02,083744,Staff,28,0,30,2
1650165694391,MATH 18,A03,083745,Staff,23,0,30,7
1650165694391,MATH 18,A04,083746,Staff,27,0,30,3
1650165694391,MATH 18,B01,083748,Staff,0,10,30,30
1650165694391,MATH 18,B02,083749,Staff,0,7,30,30
1650165694391,MATH 18,B03,083750,Staff,0,7,30,30
1650165694391,MATH 18,B04,083751,Staff,0,7,30,30
1650165700416,MATH 20A,A01,083754,Staff,26,0,40,14
1650165706453,MATH 20B,A01,083756,Staff,0,5,30,30
1650165706453,MATH 20B,A02,083757,Staff,0,4,30,30
1650165712476,MATH 20C,A01,083760,Staff,0,12,30,30
1650165712476,MATH 20C,A02,083761,Staff,0,12,30,30
1650165712476,MATH 20C,B01,083762,Staff,14,0,30,16
1650165712476,MATH 20C,B02,083763,Staff,28,0,30,2
1650165718509,MATH 20D,A01,083765,Staff,0,2,30,30
1650165718509,MATH 20D,A02,083766,Staff,10,0,30,20
1650165718509,MATH 20D,A03,083767,Staff,28,0,30,2
1650165724533,MATH 20E,A01,083771,Staff,8,0,30,22
1650165724533,MATH 20E,A02,083772,Staff,20,0,30,10
1650165724533,MATH 20E,B01,083773,Staff,0,0,30,30
1650165724533,MATH 20E,B02,083774,Staff,13,0,30,17
1650165730564,MATH 103A,A01,083777,Staff,0,8,30,30
1650165730564,MATH 103A,A02,083778,Staff,0,10,30,30
1650165730564,MATH 103A,B01,083779,Staff,1,10,30,29
1650165730564,MATH 103A,B02,083780,Staff,0,8,30,30
1650165736591,MATH 105,A01,085443,Staff,0,16,30,30
1650165742620,MATH 109,A01,083213,Anzaldo; Leesa B,0,3,30,30
1650165742620,MATH 109,A02,083214,Anzaldo; Leesa B,0,6,30,30
1650165742620,MATH 109,B01,083215,Anzaldo; Leesa B,0,4,30,30
1650165742620,MATH 109,B02,083216,Anzaldo; Leesa B,0,4,30,30
1650165748643,MATH 142A,A01,083219,Chow; Bennett,0,11,30,30
1650165748643,MATH 142A,A02,083220,Chow; Bennett,0,11,30,30
1650165748643,MATH 142A,B01,083221,Chow; Bennett,0,11,30,30
1650165748643,MATH 142A,B02,083222,Chow; Bennett,0,11,30,30
1650165754677,MATH 193A,A01,083224,Staff,0,3,30,30
1650165754677,MATH 193A,A02,083225,Staff,0,4,30,30
1650165754677,MATH 193A,A03,083781,Staff,0,1,30,30
1650165754677,MATH 193A,A04,083782,Staff,0,0,30,30
1650165760708,MATH 197,001,091859,McAuley; Julian John,9998,0,9999,1
1650165766759,COGS 9,A01,083615,Staff,0,14,60,60
1650165772786,COGS 11,A01,083617,Boyle; Mary E. T.,24,0,40,16
1650165778811,COGS 13,A01,083071,Staff,0,30,40,40
1650165784835,COGS 14A,A01,092681,Staff,0,12,100,100
1650165790862,COGS 14B,A01,083073,Cheng; Tzu-Han,0,7,50,50
1650165796885,COGS 17,A01,092677,Staff,34,0,75,41
1650165802913,COGS 100,A01,083619,Staff,0,21,60,60
1650165808937,COGS 101A,A01,083621,Davis; Joshua Daniel,0,21,60,60
1650165814964,COGS 101B,A01,091572,Staff,8,0,60,52
1650165820992,COGS 101C,A01,083625,Delgado; Tania,20,0,30,10
1650165827015,COGS 107A,A01,083627,Boyle; Mary E. T.,0,7,60,60
1650165833039,COGS 118A,A01,083075,Staff,17,0,60,43
1650165839063,CSE 3,A50,083646,Miranda; Gregory Joseph,22,0,38,16
1650165839063,CSE 3,A51,083647,Miranda; Gregory Joseph,37,0,37,0
1650165845090,CSE 8A,A50,083650,Miranda; Gregory Joseph,0,17,40,40
1650165851113,CSE 11,A01,083080,Cao; Yingjun,0,65,40,40
1650165857143,CSE 12,A01,083652,Staff,0,5,100,100
1650165863167,CSE 15L,A01,083654,Staff,0,0,50,50
1650165863167,CSE 15L,A02,083655,Staff,8,0,50,42
1650165869193,CSE 20,A01,083657,Staff,54,0,80,26
1650165875216,CSE 30,A01,083084,Eldon; John,0,67,40,40
1650165881238,CSE 100,A01,083659,Cao; Yingjun,0,61,50,50
1650165887262,CSE 134B,A01,083661,Powell; Thomas Allan,0,27,65,65
1650165893285,CSE 140,A01,083663,Staff,2,0,75,73
1650165899314,CSE 140L,A01,083088,Eldon; John,0,3,75,75
1650165905338,CSE 175,A01,083665,Kumar; Rakesh,8,0,25,17
1650165911359,CSE 190,A00,092507,Dubnov; Shlomo,14,0,20,6
1650165917392,ECE 45,A01,083139,Staff,0,14,40,40
1650165923415,ECE 65,A50,083695,Staff,0,4,30,30
1650165929440,ECE 109,A01,091882,Touri; Behrouz,47,0,70,23
1650165935468,ECE 180,A00,083140,Abi Samra; Nicholas Camill,24,0,30,6
1650165935468,ECE 180,B00,083141,Abi Samra; Nicholas Camill,8,0,30,22
1650165941491,MATH 10A,A01,083735,Patchell; Gregory David,12,0,30,18
1650165941491,MATH 10A,A02,083736,Patchell; Gregory David,28,0,30,2
1650165941491,MATH 10A,A03,083737,Patchell; Gregory David,26,0,30,4
1650165947516,MATH 10B,A01,083207,Staff,0,5,30,30
1650165947516,MATH 10B,A02,083208,Staff,0,5,30,30
1650165947516,MATH 10B,B01,083739,Staff,17,0,30,13
1650165947516,MATH 10B,B02,083740,Staff,29,0,30,1
1650165953545,MATH 18,A01,083743,Staff,10,0,30,20
1650165953545,MATH 18,A02,083744,Staff,28,0,30,2
1650165953545,MATH 18,A03,083745,Staff,23,0,30,7
1650165953545,MATH 18,A04,083746,Staff,27,0,30,3
1650165953545,MATH 18,B01,083748,Staff,0,10,30,30
1650165953545,MATH 18,B02,083749,Staff,0,7,30,30
1650165953545,MATH 18,B03,083750,Staff,0,7,30,30
1650165953545,MATH 18,B04,083751,Staff,0,7,30,30
1650165959586,MATH 20A,A01,083754,Staff,26,0,40,14
1650165965616,MATH 20B,A01,083756,Staff,0,5,30,30
1650165965616,MATH 20B,A02,083757,Staff,0,4,30,30
1650165971648,MATH 20C,A01,083760,Staff,0,12,30,30
1650165971648,MATH 20C,A02,083761,Staff,0,12,30,30
1650165971648,MATH 20C,B01,083762,Staff,14,0,30,16
1650165971648,MATH 20C,B02,083763,Staff,28,0,30,2
1650165977672,MATH 20D,A01,083765,Staff,0,2,30,30
1650165977672,MATH 20D,A02,083766,Staff,10,0,30,20
1650165977672,MATH 20D,A03,083767,Staff,28,0,30,2
1650165983706,MATH 20E,A01,083771,Staff,8,0,30,22
1650165983706,MATH 20E,A02,083772,Staff,20,0,30,10
1650165983706,MATH 20E,B01,083773,Staff,0,0,30,30
1650165983706,MATH 20E,B02,083774,Staff,13,0,30,17
1650165989730,MATH 103A,A01,083777,Staff,0,8,30,30
1650165989730,MATH 103A,A02,083778,Staff,0,10,30,30
1650165989730,MATH 103A,B01,083779,Staff,1,10,30,29
1650165989730,MATH 103A,B02,083780,Staff,0,9,30,30
1650165995766,MATH 105,A01,085443,Staff,0,17,30,30
1650166001790,MATH 109,A01,083213,Anzaldo; Leesa B,0,3,30,30
1650166001790,MATH 109,A02,083214,Anzaldo; Leesa B,0,6,30,30
1650166001790,MATH 109,B01,083215,Anzaldo; Leesa B,0,4,30,30
1650166001790,MATH 109,B02,083216,Anzaldo; Leesa B,0,4,30,30
1650166007813,MATH 142A,A01,083219,Chow; Bennett,0,11,30,30
1650166007813,MATH 142A,A02,083220,Chow; Bennett,0,11,30,30
1650166007813,MATH 142A,B01,083221,Chow; Bennett,0,11,30,30
1650166007813,MATH 142A,B02,083222,Chow; Bennett,0,11,30,30
1650166013836,MATH 193A,A01,083224,Staff,0,3,30,30
1650166013836,MATH 193A,A02,083225,Staff,0,4,30,30
1650166013836,MATH 193A,A03,083781,Staff,0,1,30,30
1650166013836,MATH 193A,A04,083782,Staff,0,0,30,30
1650166019873,MATH 197,001,091859,McAuley; Julian John,9998,0,9999,1
1650166025935,COGS 9,A01,083615,Staff,0,14,60,60
1650166031965,COGS 11,A01,083617,Boyle; Mary E. T.,24,0,40,16
1650166037992,COGS 13,A01,083071,Staff,0,30,40,40
1650166044015,COGS 14A,A01,092681,Staff,0,12,100,100
1650166050039,COGS 14B,A01,083073,Cheng; Tzu-Han,0,7,50,50
1650166056062,COGS 17,A01,092677,Staff,34,0,75,41
1650166062086,COGS 100,A01,083619,Staff,0,21,60,60
1650166068110,COGS 101A,A01,083621,Davis; Joshua Daniel,0,21,60,60
1650166074137,COGS 101B,A01,091572,Staff,8,0,60,52
1650166080162,COGS 101C,A01,083625,Delgado; Tania,20,0,30,10
1650166086187,COGS 107A,A01,083627,Boyle; Mary E. T.,0,7,60,60
1650166092214,COGS 118A,A01,083075,Staff,17,0,60,43
1650166098311,CSE 3,A50,083646,Miranda; Gregory Joseph,22,0,38,16
1650166098311,CSE 3,A51,083647,Miranda; Gregory Joseph,37,0,37,0
1650166104335,CSE 8A,A50,083650,Miranda; Gregory Joseph,0,17,40,40
1650166110362,CSE 11,A01,083080,Cao; Yingjun,0,65,40,40
1650166116390,CSE 12,A01,083652,Staff,0,5,100,100
1650166122413,CSE 15L,A01,083654,Staff,0,0,50,50
1650166122413,CSE 15L,A02,083655,Staff,8,0,50,42
1650166128440,CSE 20,A01,083657,Staff,54,0,80,26
1650166134463,CSE 30,A01,083084,Eldon; John,0,67,40,40
1650166140490,CSE 100,A01,083659,Cao; Yingjun,0,61,50,50
1650166146516,CSE 134B,A01,083661,Powell; Thomas Allan,0,27,65,65
1650166152540,CSE 140,A01,083663,Staff,2,0,75,73
1650166158564,CSE 140L,A01,083088,Eldon; John,0,3,75,75
1650166164591,CSE 175,A01,083665,Kumar; Rakesh,8,0,25,17
1650166170624,CSE 190,A00,092507,Dubnov; Shlomo,14,0,20,6
1650166176652,ECE 45,A01,083139,Staff,0,14,40,40
1650166182678,ECE 65,A50,083695,Staff,0,4,30,30
1650166188702,ECE 109,A01,091882,Touri; Behrouz,47,0,70,23
1650166194726,ECE 180,A00,083140,Abi Samra; Nicholas Camill,24,0,30,6
1650166194726,ECE 180,B00,083141,Abi Samra; Nicholas Camill,8,0,30,22
1650166200755,MATH 10A,A01,083735,Patchell; Gregory David,12,0,30,18
1650166200755,MATH 10A,A02,083736,Patchell; Gregory David,28,0,30,2
1650166200755,MATH 10A,A03,083737,Patchell; Gregory David,26,0,30,4
1650166206779,MATH 10B,A01,083207,Staff,0,5,30,30
1650166206779,MATH 10B,A02,083208,Staff,0,5,30,30
1650166206779,MATH 10B,B01,083739,Staff,17,0,30,13
1650166206779,MATH 10B,B02,083740,Staff,29,0,30,1
1650166212808,MATH 18,A01,083743,Staff,10,0,30,20
1650166212808,MATH 18,A02,083744,Staff,28,0,30,2
1650166212808,MATH 18,A03,083745,Staff,23,0,30,7
1650166212808,MATH 18,A04,083746,Staff,27,0,30,3
1650166212808,MATH 18,B01,083748,Staff,0,10,30,30
1650166212808,MATH 18,B02,083749,Staff,0,7,30,30
1650166212808,MATH 18,B03,083750,Staff,0,7,30,30
1650166212808,MATH 18,B04,083751,Staff,0,7,30,30
1650166218834,MATH 20A,A01,083754,Staff,26,0,40,14
1650166224859,MATH 20B,A01,083756,Staff,0,5,30,30
1650166224859,MATH 20B,A02,083757,Staff,0,4,30,30
1650166230883,MATH 20C,A01,083760,Staff,0,12,30,30
1650166230883,MATH 20C,A02,083761,Staff,0,12,30,30
1650166230883,MATH 20C,B01,083762,Staff,14,0,30,16
1650166230883,MATH 20C,B02,083763,Staff,28,0,30,2
1650166236913,MATH 20D,A01,083765,Staff,0,2,30,30
1650166236913,MATH 20D,A02,083766,Staff,10,0,30,20
1650166236913,MATH 20D,A03,083767,Staff,28,0,30,2
1650166242937,MATH 20E,A01,083771,Staff,8,0,30,22
1650166242937,MATH 20E,A02,083772,Staff,20,0,30,10
1650166242937,MATH 20E,B01,083773,Staff,0,0,30,30
1650166242937,MATH 20E,B02,083774,Staff,13,0,30,17
1650166248960,MATH 103A,A01,083777,Staff,0,8,30,30
1650166248960,MATH 103A,A02,083778,Staff,0,10,30,30
1650166248960,MATH 103A,B01,083779,Staff,1,10,30,29
1650166248960,MATH 103A,B02,083780,Staff,0,9,30,30
1650166254984,MATH 105,A01,085443,Staff,0,17,30,30
1650166261008,MATH 109,A01,083213,Anzaldo; Leesa B,0,3,30,30
1650166261008,MATH 109,A02,083214,Anzaldo; Leesa B,0,6,30,30
1650166261008,MATH 109,B01,083215,Anzaldo; Leesa B,0,4,30,30
1650166261008,MATH 109,B02,083216,Anzaldo; Leesa B,0,4,30,30
1650166267037,MATH 142A,A01,083219,Chow; Bennett,0,11,30,30
1650166267037,MATH 142A,A02,083220,Chow; Bennett,0,11,30,30
1650166267037,MATH 142A,B01,083221,Chow; Bennett,0,11,30,30
1650166267037,MATH 142A,B02,083222,Chow; Bennett,0,11,30,30
1650166273063,MATH 193A,A01,083224,Staff,0,3,30,30
1650166273063,MATH 193A,A02,083225,Staff,0,4,30,30
1650166273063,MATH 193A,A03,083781,Staff,0,1,30,30
1650166273063,MATH 193A,A04,083782,Staff,0,0,30,30
1650166279090,MATH 197,001,091859,McAuley; Julian John,9998,0,9999,1
1650166285152,COGS 9,A01,083615,Staff,0,14,60,60
1650166291176,COGS 11,A01,083617,Boyle; Mary E. T.,24,0,40,16
1650166297206,COGS 13,A01,083071,Staff,0,30,40,40
1650166303236,COGS 14A,A01,092681,Staff,0,12,100,100
1650166309264,COGS 14B,A01,083073,Cheng; Tzu-Han,0,7,50,50
1650166315295,COGS 17,A01,092677,Staff,34,0,75,41
1650166321320,COGS 100,A01,083619,Staff,0,21,60,60
1650166327347,COGS 101A,A01,083621,Davis; Joshua Daniel,0,21,60,60
1650166333371,COGS 101B,A01,091572,Staff,8,0,60,52
1650166339394,COGS 101C,A01,083625,Delgado; Tania,20,0,30,10
1650166345418,COGS 107A,A01,083627,Boyle; Mary E. T.,0,7,60,60
1650166351441,COGS 118A,A01,083075,Staff,17,0,60,43
1650166357469,CSE 3,A50,083646,Miranda; Gregory Joseph,22,0,38,16
1650166357469,CSE 3,A51,083647,Miranda; Gregory Joseph,37,0,37,0
1650166363494,CSE 8A,A50,083650,Miranda; Gregory Joseph,0,17,40,40
1650166369522,CSE 11,A01,083080,Cao; Yingjun,0,65,40,40
1650166375547,CSE 12,A01,083652,Staff,0,5,100,100
1650166381572,CSE 15L,A01,083654,Staff,0,0,50,50
1650166381572,CSE 15L,A02,083655,Staff,8,0,50,42
1650166387595,CSE 20,A01,083657,Staff,54,0,80,26
1650166393619,CSE 30,A01,083084,Eldon; John,0,67,40,40
1650166399643,CSE 100,A01,083659,Cao; Yingjun,0,61,50,50
1650166405674,CSE 134B,A01,083661,Powell; Thomas Allan,0,27,65,65
1650166411698,CSE 140,A01,083663,Staff,2,0,75,73
1650166417725,CSE 140L,A01,083088,Eldon; John,0,3,75,75
1650166423749,CSE 175,A01,083665,Kumar; Rakesh,8,0,25,17
1650166429776,CSE 190,A00,092507,Dubnov; Shlomo,14,0,20,6
1650166435800,ECE 45,A01,083139,Staff,0,14,40,40
1650166441823,ECE 65,A50,083695,Staff,0,4,30,30
1650166447850,ECE 109,A01,091882,Touri; Behrouz,47,0,70,23
1650166453878,ECE 180,A00,083140,Abi Samra; Nicholas Camill,24,0,30,6
1650166453878,ECE 180,B00,083141,Abi Samra; Nicholas Camill,8,0,30,22
1650166459902,MATH 10A,A01,083735,Patchell; Gregory David,12,0,30,18
1650166459902,MATH 10A,A02,083736,Patchell; Gregory David,28,0,30,2
1650166459902,MATH 10A,A03,083737,Patchell; Gregory David,26,0,30,4
1650166465937,MATH 10B,A01,083207,Staff,0,5,30,30
1650166465937,MATH 10B,A02,083208,Staff,0,5,30,30
1650166465937,MATH 10B,B01,083739,Staff,17,0,30,13
1650166465937,MATH 10B,B02,083740,Staff,29,0,30,1
1650166471968,MATH 18,A01,083743,Staff,10,0,30,20
1650166471968,MATH 18,A02,083744,Staff,28,0,30,2
1650166471968,MATH 18,A03,083745,Staff,23,0,30,7
1650166471968,MATH 18,A04,083746,Staff,27,0,30,3
1650166471968,MATH 18,B01,083748,Staff,0,10,30,30
1650166471968,MATH 18,B02,083749,Staff,0,7,30,30
1650166471968,MATH 18,B03,083750,Staff,0,7,30,30
1650166471968,MATH 18,B04,083751,Staff,0,7,30,30
1650166477993,MATH 20A,A01,083754,Staff,26,0,40,14
1650166484020,MATH 20B,A01,083756,Staff,0,5,30,30
1650166484020,MATH 20B,A02,083757,Staff,0,4,30,30
1650166490048,MATH 20C,A01,083760,Staff,0,12,30,30
1650166490048,MATH 20C,A02,083761,Staff,0,12,30,30
1650166490048,MATH 20C,B01,083762,Staff,14,0,30,16
1650166490048,MATH 20C,B02,083763,Staff,28,0,30,2
1650166496075,MATH 20D,A01,083765,Staff,0,2,30,30
1650166496075,MATH 20D,A02,083766,Staff,10,0,30,20
1650166496075,MATH 20D,A03,083767,Staff,28,0,30,2
1650166502100,MATH 20E,A01,083771,Staff,8,0,30,22
1650166502100,MATH 20E,A02,083772,Staff,20,0,30,10
1650166502100,MATH 20E,B01,083773,Staff,0,0,30,30
1650166502100,MATH 20E,B02,083774,Staff,13,0,30,17
1650166508124,MATH 103A,A01,083777,Staff,0,8,30,30
1650166508124,MATH 103A,A02,083778,Staff,0,10,30,30
1650166508124,MATH 103A,B01,083779,Staff,1,10,30,29
1650166508124,MATH 103A,B02,083780,Staff,0,9,30,30
1650166514148,MATH 105,A01,085443,Staff,0,17,30,30
1650166520180,MATH 109,A01,083213,Anzaldo; Leesa B,0,3,30,30
1650166520180,MATH 109,A02,083214,Anzaldo; Leesa B,0,6,30,30
1650166520180,MATH 109,B01,083215,Anzaldo; Leesa B,0,4,30,30
1650166520180,MATH 109,B02,083216,Anzaldo; Leesa B,0,4,30,30
1650166526209,MATH 142A,A01,083219,Chow; Bennett,0,11,30,30
1650166526209,MATH 142A,A02,083220,Chow; Bennett,0,11,30,30
1650166526209,MATH 142A,B01,083221,Chow; Bennett,0,11,30,30
1650166526209,MATH 142A,B02,083222,Chow; Bennett,0,11,30,30
1650166532236,MATH 193A,A01,083224,Staff,0,3,30,30
1650166532236,MATH 193A,A02,083225,Staff,0,4,30,30
1650166532236,MATH 193A,A03,083781,Staff,0,1,30,30
1650166532236,MATH 193A,A04,083782,Staff,0,0,30,30
1650166538261,MATH 197,001,091859,McAuley; Julian John,9998,0,9999,1
1650166544330,COGS 9,A01,083615,Staff,0,14,60,60
1650166550354,COGS 11,A01,083617,Boyle; Mary E. T.,24,0,40,16
1650166556377,COGS 13,A01,083071,Staff,0,30,40,40
1650166562400,COGS 14A,A01,092681,Staff,0,12,100,100
1650166568425,COGS 14B,A01,083073,Cheng; Tzu-Han,0,7,50,50
1650166574448,COGS 17,A01,092677,Staff,34,0,75,41
1650166580471,COGS 100,A01,083619,Staff,0,21,60,60
1650166586504,COGS 101A,A01,083621,Davis; Joshua Daniel,0,21,60,60
1650166592536,COGS 101B,A01,091572,Staff,8,0,60,52
1650166598573,COGS 101C,A01,083625,Delgado; Tania,20,0,30,10
1650166604596,COGS 107A,A01,083627,Boyle; Mary E. T.,0,7,60,60
1650166610619,COGS 118A,A01,083075,Staff,17,0,60,43
1650166616647,CSE 3,A50,083646,Miranda; Gregory Joseph,22,0,38,16
1650166616647,CSE 3,A51,083647,Miranda; Gregory Joseph,37,0,37,0
1650166622673,CSE 8A,A50,083650,Miranda; Gregory Joseph,0,17,40,40
1650166628698,CSE 11,A01,083080,Cao; Yingjun,0,65,40,40
1650166634725,CSE 12,A01,083652,Staff,0,5,100,100
1650166640748,CSE 15L,A01,083654,Staff,0,0,50,50
1650166640748,CSE 15L,A02,083655,Staff,8,0,50,42
1650166646772,CSE 20,A01,083657,Staff,54,0,80,26
1650166652802,CSE 30,A01,083084,Eldon; John,0,67,40,40
1650166658832,CSE 100,A01,083659,Cao; Yingjun,0,61,50,50
1650166664859,CSE 134B,A01,083661,Powell; Thomas Allan,0,27,65,65
1650166670882,CSE 140,A01,083663,Staff,2,0,75,73
1650166676905,CSE 140L,A01,083088,Eldon; John,0,3,75,75
1650166682929,CSE 175,A01,083665,Kumar; Rakesh,8,0,25,17
1650166688952,CSE 190,A00,092507,Dubnov; Shlomo,14,0,20,6
1650166695050,ECE 45,A01,083139,Staff,0,13,40,40
1650166701077,ECE 65,A50,083695,Staff,0,4,30,30
1650166707106,ECE 109,A01,091882,Touri; Behrouz,47,0,70,23
1650166713130,ECE 180,A00,083140,Abi Samra; Nicholas Camill,24,0,30,6
1650166713130,ECE 180,B00,083141,Abi Samra; Nicholas Camill,8,0,30,22
1650166719158,MATH 10A,A01,083735,Patchell; Gregory David,12,0,30,18
1650166719158,MATH 10A,A02,083736,Patchell; Gregory David,28,0,30,2
1650166719158,MATH 10A,A03,083737,Patchell; Gregory David,26,0,30,4
1650166725181,MATH 10B,A01,083207,Staff,0,5,30,30
1650166725181,MATH 10B,A02,083208,Staff,0,5,30,30
1650166725181,MATH 10B,B01,083739,Staff,17,0,30,13
1650166725181,MATH 10B,B02,083740,Staff,29,0,30,1
1650166731205,MATH 18,A01,083743,Staff,10,0,30,20
1650166731205,MATH 18,A02,083744,Staff,28,0,30,2
1650166731205,MATH 18,A03,083745,Staff,23,0,30,7
1650166731205,MATH 18,A04,083746,Staff,27,0,30,3
1650166731205,MATH 18,B01,083748,Staff,0,10,30,30
1650166731205,MATH 18,B02,083749,Staff,0,7,30,30
1650166731205,MATH 18,B03,083750,Staff,0,7,30,30
1650166731205,MATH 18,B04,083751,Staff,0,7,30,30
1650166737228,MATH 20A,A01,083754,Staff,26,0,40,14
1650166743256,MATH 20B,A01,083756,Staff,0,5,30,30
1650166743256,MATH 20B,A02,083757,Staff,0,4,30,30
1650166749281,MATH 20C,A01,083760,Staff,0,12,30,30
1650166749281,MATH 20C,A02,083761,Staff,0,12,30,30
1650166749281,MATH 20C,B01,083762,Staff,14,0,30,16
1650166749281,MATH 20C,B02,083763,Staff,28,0,30,2
1650166755318,MATH 20D,A01,083765,Staff,0,2,30,30
1650166755318,MATH 20D,A02,083766,Staff,10,0,30,20
1650166755318,MATH 20D,A03,083767,Staff,28,0,30,2
1650166761346,MATH 20E,A01,083771,Staff,8,0,30,22
1650166761346,MATH 20E,A02,083772,Staff,20,0,30,10
1650166761346,MATH 20E,B01,083773,Staff,0,0,30,30
1650166761346,MATH 20E,B02,083774,Staff,13,0,30,17
1650166767369,MATH 103A,A01,083777,Staff,0,8,30,30
1650166767369,MATH 103A,A02,083778,Staff,0,10,30,30
1650166767369,MATH 103A,B01,083779,Staff,1,10,30,29
1650166767369,MATH 103A,B02,083780,Staff,0,9,30,30
1650166773393,MATH 105,A01,085443,Staff,0,17,30,30
1650166779418,MATH 109,A01,083213,Anzaldo; Leesa B,0,3,30,30
1650166779418,MATH 109,A02,083214,Anzaldo; Leesa B,0,6,30,30
1650166779418,MATH 109,B01,083215,Anzaldo; Leesa B,0,4,30,30
1650166779418,MATH 109,B02,083216,Anzaldo; Leesa B,0,4,30,30
1650166785446,MATH 142A,A01,083219,Chow; Bennett,0,11,30,30
1650166785446,MATH 142A,A02,083220,Chow; Bennett,0,11,30,30
1650166785446,MATH 142A,B01,083221,Chow; Bennett,0,11,30,30
1650166785446,MATH 142A,B02,083222,Chow; Bennett,0,11,30,30
1650166791471,MATH 193A,A01,083224,Staff,0,3,30,30
1650166791471,MATH 193A,A02,083225,Staff,0,4,30,30
1650166791471,MATH 193A,A03,083781,Staff,0,1,30,30
1650166791471,MATH 193A,A04,083782,Staff,0,0,30,30
1650166797493,MATH 197,001,091859,McAuley; Julian John,9998,0,9999,1
1650166803549,COGS 9,A01,083615,Staff,0,14,60,60
1650166809578,COGS 11,A01,083617,Boyle; Mary E. T.,24,0,40,16
1650166815605,COGS 13,A01,083071,Staff,0,30,40,40
1650166821628,COGS 14A,A01,092681,Staff,0,12,100,100
1650166827657,COGS 14B,A01,083073,Cheng; Tzu-Han,0,7,50,50
1650166833683,COGS 17,A01,092677,Staff,34,0,75,41
1650166839707,COGS 100,A01,083619,Staff,0,21,60,60
1650166845747,COGS 101A,A01,083621,Davis; Joshua Daniel,0,21,60,60
1650166851770,COGS 101B,A01,091572,Staff,8,0,60,52
1650166857796,COGS 101C,A01,083625,Delgado; Tania,20,0,30,10
1650166863835,COGS 107A,A01,083627,Boyle; Mary E. T.,0,7,60,60
1650166869875,COGS 118A,A01,083075,Staff,17,0,60,43
1650166875902,CSE 3,A50,083646,Miranda; Gregory Joseph,22,0,38,16
1650166875902,CSE 3,A51,083647,Miranda; Gregory Joseph,37,0,37,0
1650166881927,CSE 8A,A50,083650,Miranda; Gregory Joseph,0,17,40,40
1650166887951,CSE 11,A01,083080,Cao; Yingjun,0,65,40,40
1650166893974,CSE 12,A01,083652,Staff,0,5,100,100
1650166900000,CSE 15L,A01,083654,Staff,0,0,50,50
1650166900000,CSE 15L,A02,083655,Staff,8,0,50,42
1650166906027,CSE 20,A01,083657,Staff,54,0,80,26
1650166912049,CSE 30,A01,083084,Eldon; John,0,67,40,40
1650166918072,CSE 100,A01,083659,Cao; Yingjun,0,61,50,50
1650166924100,CSE 134B,A01,083661,Powell; Thomas Allan,0,27,65,65
1650166930124,CSE 140,A01,083663,Staff,2,0,75,73
1650166936151,CSE 140L,A01,083088,Eldon; John,0,3,75,75
1650166942178,CSE 175,A01,083665,Kumar; Rakesh,8,0,25,17
1650166948205,CSE 190,A00,092507,Dubnov; Shlomo,14,0,20,6
1650166954231,ECE 45,A01,083139,Staff,0,13,40,40
1650166960255,ECE 65,A50,083695,Staff,0,4,30,30
1650166966279,ECE 109,A01,091882,Touri; Behrouz,47,0,70,23
1650166972303,ECE 180,A00,083140,Abi Samra; Nicholas Camill,24,0,30,6
1650166972303,ECE 180,B00,083141,Abi Samra; Nicholas Camill,8,0,30,22
1650166978334,MATH 10A,A01,083735,Patchell; Gregory David,12,0,30,18
1650166978334,MATH 10A,A02,083736,Patchell; Gregory David,28,0,30,2
1650166978334,MATH 10A,A03,083737,Patchell; Gregory David,26,0,30,4
1650166984363,MATH 10B,A01,083207,Staff,0,5,30,30
1650166984363,MATH 10B,A02,083208,Staff,0,5,30,30
1650166984363,MATH 10B,B01,083739,Staff,17,0,30,13
1650166984363,MATH 10B,B02,083740,Staff,29,0,30,1
1650166990398,MATH 18,A01,083743,Staff,10,0,30,20
1650166990398,MATH 18,A02,083744,Staff,28,0,30,2
1650166990398,MATH 18,A03,083745,Staff,23,0,30,7
1650166990398,MATH 18,A04,083746,Staff,27,0,30,3
1650166990398,MATH 18,B01,083748,Staff,0,10,30,30
1650166990398,MATH 18,B02,083749,Staff,0,7,30,30
1650166990398,MATH 18,B03,083750,Staff,0,7,30,30
1650166990398,MATH 18,B04,083751,Staff,0,7,30,30
1650166996426,MATH 20A,A01,083754,Staff,26,0,40,14
1650167002461,MATH 20B,A01,083756,Staff,0,5,30,30
1650167002461,MATH 20B,A02,083757,Staff,0,4,30,30
1650167008489,MATH 20C,A01,083760,Staff,0,12,30,30
1650167008489,MATH 20C,A02,083761,Staff,0,12,30,30
1650167008489,MATH 20C,B01,083762,Staff,14,0,30,16
1650167008489,MATH 20C,B02,083763,Staff,28,0,30,2
1650167014516,MATH 20D,A01,083765,Staff,0,2,30,30
1650167014516,MATH 20D,A02,083766,Staff,10,0,30,20
1650167014516,MATH 20D,A03,083767,Staff,28,0,30,2
1650167020544,MATH 20E,A01,083771,Staff,8,0,30,22
1650167020544,MATH 20E,A02,083772,Staff,20,0,30,10
1650167020544,MATH 20E,B01,083773,Staff,0,0,30,30
1650167020544,MATH 20E,B02,083774,Staff,13,0,30,17
1650167026567,MATH 103A,A01,083777,Staff,0,8,30,30
1650167026567,MATH 103A,A02,083778,Staff,0,10,30,30
1650167026567,MATH 103A,B01,083779,Staff,1,10,30,29
1650167026567,MATH 103A,B02,083780,Staff,0,9,30,30
1650167032591,MATH 105,A01,085443,Staff,0,17,30,30
1650167038619,MATH 109,A01,083213,Anzaldo; Leesa B,0,3,30,30
1650167038619,MATH 109,A02,083214,Anzaldo; Leesa B,0,6,30,30
1650167038619,MATH 109,B01,083215,Anzaldo; Leesa B,0,4,30,30
1650167038619,MATH 109,B02,083216,Anzaldo; Leesa B,0,4,30,30
1650167044644,MATH 142A,A01,083219,Chow; Bennett,0,11,30,30
1650167044644,MATH 142A,A02,083220,Chow; Bennett,0,11,30,30
1650167044644,MATH 142A,B01,083221,Chow; Bennett,0,11,30,30
1650167044644,MATH 142A,B02,083222,Chow; Bennett,0,11,30,30
1650167050668,MATH 193A,A01,083224,Staff,0,3,30,30
1650167050668,MATH 193A,A02,083225,Staff,0,4,30,30
1650167050668,MATH 193A,A03,083781,Staff,0,1,30,30
1650167050668,MATH 193A,A04,083782,Staff,0,0,30,30
1650167056694,MATH 197,001,091859,McAuley; Julian John,9998,0,9999,1
1650167062773,COGS 9,A01,083615,Staff,0,14,60,60
1650167068807,COGS 11,A01,083617,Boyle; Mary E. T.,24,0,40,16
1650167074834,COGS 13,A01,083071,Staff,0,30,40,40
1650167080869,COGS 14A,A01,092681,Staff,0,12,100,100
1650167086893,COGS 14B,A01,083073,Cheng; Tzu-Han,0,7,50,50
1650167092919,COGS 17,A01,092677,Staff,34,0,75,41
1650167098945,COGS 100,A01,083619,Staff,0,21,60,60
1650167104974,COGS 101A,A01,083621,Davis; Joshua Daniel,0,21,60,60
1650167111001,COGS 101B,A01,091572,Staff,8,0,60,52
1650167117029,COGS 101C,A01,083625,Delgado; Tania,20,0,30,10
1650167123054,COGS 107A,A01,083627,Boyle; Mary E. T.,0,7,60,60
1650167129078,COGS 118A,A01,083075,Staff,17,0,60,43
1650167135102,CSE 3,A50,083646,Miranda; Gregory Joseph,22,0,38,16
1650167135102,CSE 3,A51,083647,Miranda; Gregory Joseph,37,0,37,0
1650167141143,CSE 8A,A50,083650,Miranda; Gregory Joseph,0,17,40,40
1650167147170,CSE 11,A01,083080,Cao; Yingjun,0,65,40,40
1650167153197,CSE 12,A01,083652,Staff,0,5,100,100
1650167159222,CSE 15L,A01,083654,Staff,0,0,50,50
1650167159222,CSE 15L,A02,083655,Staff,8,0,50,42
1650167165263,CSE 20,A01,083657,Staff,54,0,80,26
1650167171287,CSE 30,A01,083084,Eldon; John,0,67,40,40
1650167177310,CSE 100,A01,083659,Cao; Yingjun,0,61,50,50
1650167183333,CSE 134B,A01,083661,Powell; Thomas Allan,0,27,65,65
1650167189356,CSE 140,A01,083663,Staff,2,0,75,73
1650167195382,CSE 140L,A01,083088,Eldon; John,0,3,75,75
1650167201414,CSE 175,A01,083665,Kumar; Rakesh,8,0,25,17
1650167207437,CSE 190,A00,092507,Dubnov; Shlomo,14,0,20,6
1650167213460,ECE 45,A01,083139,Staff,0,13,40,40
1650167219484,ECE 65,A50,083695,Staff,0,4,30,30
1650167225511,ECE 109,A01,091882,Touri; Behrouz,47,0,70,23
1650167231533,ECE 180,A00,083140,Abi Samra; Nicholas Camill,24,0,30,6
1650167231533,ECE 180,B00,083141,Abi Samra; Nicholas Camill,8,0,30,22
1650167237557,MATH 10A,A01,083735,Patchell; Gregory David,12,0,30,18
1650167237557,MATH 10A,A02,083736,Patchell; Gregory David,28,0,30,2
1650167237557,MATH 10A,A03,083737,Patchell; Gregory David,26,0,30,4
1650167243581,MATH 10B,A01,083207,Staff,0,5,30,30
1650167243581,MATH 10B,A02,083208,Staff,0,5,30,30
1650167243581,MATH 10B,B01,083739,Staff,17,0,30,13
1650167243581,MATH 10B,B02,083740,Staff,29,0,30,1
1650167249607,MATH 18,A01,083743,Staff,10,0,30,20
1650167249607,MATH 18,A02,083744,Staff,28,0,30,2
1650167249607,MATH 18,A03,083745,Staff,23,0,30,7
1650167249607,MATH 18,A04,083746,Staff,27,0,30,3
1650167249607,MATH 18,B01,083748,Staff,0,10,30,30
1650167249607,MATH 18,B02,083749,Staff,0,7,30,30
1650167249607,MATH 18,B03,083750,Staff,0,7,30,30
1650167249607,MATH 18,B04,083751,Staff,0,7,30,30
1650167255632,MATH 20A,A01,083754,Staff,26,0,40,14
1650167261660,MATH 20B,A01,083756,Staff,0,5,30,30
1650167261660,MATH 20B,A02,083757,Staff,0,4,30,30
1650167267710,MATH 20C,A01,083760,Staff,0,12,30,30
1650167267710,MATH 20C,A02,083761,Staff,0,12,30,30
1650167267710,MATH 20C,B01,083762,Staff,14,0,30,16
1650167267710,MATH 20C,B02,083763,Staff,28,0,30,2
1650167273736,MATH 20D,A01,083765,Staff,0,2,30,30
1650167273736,MATH 20D,A02,083766,Staff,10,0,30,20
1650167273736,MATH 20D,A03,083767,Staff,28,0,30,2
1650167279760,MATH 20E,A01,083771,Staff,8,0,30,22
1650167279760,MATH 20E,A02,083772,Staff,20,0,30,10
1650167279760,MATH 20E,B01,083773,Staff,0,0,30,30
1650167279760,MATH 20E,B02,083774,Staff,13,0,30,17
1650167285785,MATH 103A,A01,083777,Staff,0,8,30,30
1650167285785,MATH 103A,A02,083778,Staff,0,10,30,30
1650167285785,MATH 103A,B01,083779,Staff,1,10,30,29
1650167285785,MATH 103A,B02,083780,Staff,0,9,30,30
1650167291882,MATH 105,A01,085443,Staff,0,17,30,30
1650167297912,MATH 109,A01,083213,Anzaldo; Leesa B,0,3,30,30
1650167297912,MATH 109,A02,083214,Anzaldo; Leesa B,0,6,30,30
1650167297912,MATH 109,B01,083215,Anzaldo; Leesa B,0,4,30,30
1650167297912,MATH 109,B02,083216,Anzaldo; Leesa B,0,4,30,30
1650167303937,MATH 142A,A01,083219,Chow; Bennett,0,11,30,30
1650167303937,MATH 142A,A02,083220,Chow; Bennett,0,11,30,30
1650167303937,MATH 142A,B01,083221,Chow; Bennett,0,11,30,30
1650167303937,MATH 142A,B02,083222,Chow; Bennett,0,11,30,30
1650167309961,MATH 193A,A01,083224,Staff,0,3,30,30
1650167309961,MATH 193A,A02,083225,Staff,0,4,30,30
1650167309961,MATH 193A,A03,083781,Staff,0,1,30,30
1650167309961,MATH 193A,A04,083782,Staff,0,0,30,30
1650167315992,MATH 197,001,091859,McAuley; Julian John,9998,0,9999,1
1650167322045,COGS 9,A01,083615,Staff,0,14,60,60
1650167328072,COGS 11,A01,083617,Boyle; Mary E. T.,24,0,40,16
1650167334099,COGS 13,A01,083071,Staff,0,30,40,40
1650167340144,COGS 14A,A01,092681,Staff,0,12,100,100
1650167346171,COGS 14B,A01,083073,Cheng; Tzu-Han,0,7,50,50
1650167352194,COGS 17,A01,092677,Staff,34,0,75,41
1650167358220,COGS 100,A01,083619,Staff,0,21,60,60
1650167364245,COGS 101A,A01,083621,Davis; Joshua Daniel,0,21,60,60
1650167370269,COGS 101B,A01,091572,Staff,8,0,60,52
1650167376298,COGS 101C,A01,083625,Delgado; Tania,20,0,30,10
1650167382323,COGS 107A,A01,083627,Boyle; Mary E. T.,0,7,60,60
1650167388346,COGS 118A,A01,083075,Staff,17,0,60,43
1650167394376,CSE 3,A50,083646,Miranda; Gregory Joseph,22,0,38,16
1650167394376,CSE 3,A51,083647,Miranda; Gregory Joseph,37,0,37,0
1650167400399,CSE 8A,A50,083650,Miranda; Gregory Joseph,0,17,40,40
1650167406424,CSE 11,A01,083080,Cao; Yingjun,0,65,40,40
1650167412451,CSE 12,A01,083652,Staff,0,5,100,100
1650167418475,CSE 15L,A01,083654,Staff,0,0,50,50
1650167418475,CSE 15L,A02,083655,Staff,8,0,50,42
1650167424498,CSE 20,A01,083657,Staff,54,0,80,26
1650167430522,CSE 30,A01,083084,Eldon; John,0,67,40,40
1650167436549,CSE 100,A01,083659,Cao; Yingjun,0,61,50,50
1650167442577,CSE 134B,A01,083661,Powell; Thomas Allan,0,27,65,65
1650167448604,CSE 140,A01,083663,Staff,2,0,75,73
1650167454629,CSE 140L,A01,083088,Eldon; John,0,3,75,75
1650167460653,CSE 175,A01,083665,Kumar; Rakesh,8,0,25,17
1650167466684,CSE 190,A00,092507,Dubnov; Shlomo,14,0,20,6
1650167472711,ECE 45,A01,083139,Staff,0,13,40,40
1650167478735,ECE 65,A50,083695,Staff,0,4,30,30
1650167484762,ECE 109,A01,091882,Touri; Behrouz,47,0,70,23
1650167490787,ECE 180,A00,083140,Abi Samra; Nicholas Camill,24,0,30,6
1650167490787,ECE 180,B00,083141,Abi Samra; Nicholas Camill,8,0,30,22
1650167496810,MATH 10A,A01,083735,Patchell; Gregory David,12,0,30,18
1650167496810,MATH 10A,A02,083736,Patchell; Gregory David,28,0,30,2
1650167496810,MATH 10A,A03,083737,Patchell; Gregory David,26,0,30,4
1650167502839,MATH 10B,A01,083207,Staff,0,5,30,30
1650167502839,MATH 10B,A02,083208,Staff,0,5,30,30
1650167502839,MATH 10B,B01,083739,Staff,17,0,30,13
1650167502839,MATH 10B,B02,083740,Staff,29,0,30,1
1650167508867,MATH 18,A01,083743,Staff,10,0,30,20
1650167508867,MATH 18,A02,083744,Staff,28,0,30,2
1650167508867,MATH 18,A03,083745,Staff,23,0,30,7
1650167508867,MATH 18,A04,083746,Staff,27,0,30,3
1650167508867,MATH 18,B01,083748,Staff,0,10,30,30
1650167508867,MATH 18,B02,083749,Staff,0,7,30,30
1650167508867,MATH 18,B03,083750,Staff,0,7,30,30
1650167508867,MATH 18,B04,083751,Staff,0,7,30,30
1650167514891,MATH 20A,A01,083754,Staff,26,0,40,14
1650167520922,MATH 20B,A01,083756,Staff,0,5,30,30
1650167520922,MATH 20B,A02,083757,Staff,0,4,30,30
1650167526947,MATH 20C,A01,083760,Staff,0,12,30,30
1650167526947,MATH 20C,A02,083761,Staff,0,12,30,30
1650167526947,MATH 20C,B01,083762,Staff,14,0,30,16
1650167526947,MATH 20C,B02,083763,Staff,28,0,30,2
1650167532970,MATH 20D,A01,083765,Staff,0,2,30,30
1650167532970,MATH 20D,A02,083766,Staff,10,0,30,20
1650167532970,MATH 20D,A03,083767,Staff,28,0,30,2
1650167538995,MATH 20E,A01,083771,Staff,8,0,30,22
1650167538995,MATH 20E,A02,083772,Staff,20,0,30,10
1650167538995,MATH 20E,B01,083773,Staff,0,0,30,30
1650167538995,MATH 20E,B02,083774,Staff,13,0,30,17
1650167545020,MATH 103A,A01,083777,Staff,0,8,30,30
1650167545020,MATH 103A,A02,083778,Staff,0,10,30,30
1650167545020,MATH 103A,B01,083779,Staff,1,10,30,29
1650167545020,MATH 103A,B02,083780,Staff,0,9,30,30
1650167551045,MATH 105,A01,085443,Staff,0,17,30,30
1650167557074,MATH 109,A01,083213,Anzaldo; Leesa B,0,3,30,30
1650167557074,MATH 109,A02,083214,Anzaldo; Leesa B,0,6,30,30
1650167557074,MATH 109,B01,083215,Anzaldo; Leesa B,0,4,30,30
1650167557074,MATH 109,B02,083216,Anzaldo; Leesa B,0,4,30,30
1650167563103,MATH 142A,A01,083219,Chow; Bennett,0,11,30,30
1650167563103,MATH 142A,A02,083220,Chow; Bennett,0,11,30,30
1650167563103,MATH 142A,B01,083221,Chow; Bennett,0,11,30,30
1650167563103,MATH 142A,B02,083222,Chow; Bennett,0,11,30,30
1650167569130,MATH 193A,A01,083224,Staff,0,3,30,30
1650167569130,MATH 193A,A02,083225,Staff,0,4,30,30
1650167569130,MATH 193A,A03,083781,Staff,0,1,30,30
1650167569130,MATH 193A,A04,083782,Staff,0,0,30,30
1650167575153,MATH 197,001,091859,McAuley; Julian John,9998,0,9999,1
1650167581205,COGS 9,A01,083615,Staff,0,14,60,60
1650167587229,COGS 11,A01,083617,Boyle; Mary E. T.,24,0,40,16
1650167593257,COGS 13,A01,083071,Staff,0,30,40,40
1650167599281,COGS 14A,A01,092681,Staff,0,12,100,100
1650167605309,COGS 14B,A01,083073,Cheng; Tzu-Han,0,7,50,50
1650167611332,COGS 17,A01,092677,Staff,34,0,75,41
1650167617359,COGS 100,A01,083619,Staff,0,21,60,60
1650167623393,COGS 101A,A01,083621,Davis; Joshua Daniel,0,21,60,60
1650167629419,COGS 101B,A01,091572,Staff,8,0,60,52
1650167635443,COGS 101C,A01,083625,Delgado; Tania,20,0,30,10
1650167641466,COGS 107A,A01,083627,Boyle; Mary E. T.,0,7,60,60
1650167647493,COGS 118A,A01,083075,Staff,17,0,60,43
1650167653528,CSE 3,A50,083646,Miranda; Gregory Joseph,22,0,38,16
1650167653528,CSE 3,A51,083647,Miranda; Gregory Joseph,37,0,37,0
1650167659552,CSE 8A,A50,083650,Miranda; Gregory Joseph,0,17,40,40
1650167665583,CSE 11,A01,083080,Cao; Yingjun,0,65,40,40
1650167671607,CSE 12,A01,083652,Staff,0,5,100,100
1650167677632,CSE 15L,A01,083654,Staff,0,0,50,50
1650167677632,CSE 15L,A02,083655,Staff,8,0,50,42
1650167683655,CSE 20,A01,083657,Staff,54,0,80,26
1650167689679,CSE 30,A01,083084,Eldon; John,0,67,40,40
1650167695701,CSE 100,A01,083659,Cao; Yingjun,0,61,50,50
1650167701727,CSE 134B,A01,083661,Powell; Thomas Allan,0,27,65,65
1650167707761,CSE 140,A01,083663,Staff,2,0,75,73
1650167713784,CSE 140L,A01,083088,Eldon; John,0,3,75,75
1650167719811,CSE 175,A01,083665,Kumar; Rakesh,8,0,25,17
1650167725843,CSE 190,A00,092507,Dubnov; Shlomo,14,0,20,6
1650167731869,ECE 45,A01,083139,Staff,0,13,40,40
1650167737894,ECE 65,A50,083695,Staff,0,4,30,30
1650167743919,ECE 109,A01,091882,Touri; Behrouz,47,0,70,23
1650167749943,ECE 180,A00,083140,Abi Samra; Nicholas Camill,24,0,30,6
1650167749943,ECE 180,B00,083141,Abi Samra; Nicholas Camill,8,0,30,22
1650167755967,MATH 10A,A01,083735,Patchell; Gregory David,12,0,30,18
1650167755967,MATH 10A,A02,083736,Patchell; Gregory David,28,0,30,2
1650167755967,MATH 10A,A03,083737,Patchell; Gregory David,26,0,30,4
1650167761995,MATH 10B,A01,083207,Staff,0,5,30,30
1650167761995,MATH 10B,A02,083208,Staff,0,5,30,30
1650167761995,MATH 10B,B01,083739,Staff,17,0,30,13
1650167761995,MATH 10B,B02,083740,Staff,29,0,30,1
1650167768017,MATH 18,A01,083743,Staff,10,0,30,20
1650167768017,MATH 18,A02,083744,Staff,28,0,30,2
1650167768017,MATH 18,A03,083745,Staff,23,0,30,7
1650167768017,MATH 18,A04,083746,Staff,27,0,30,3
1650167768017,MATH 18,B01,083748,Staff,0,10,30,30
1650167768017,MATH 18,B02,083749,Staff,0,7,30,30
1650167768017,MATH 18,B03,083750,Staff,0,7,30,30
1650167768017,MATH 18,B04,083751,Staff,0,7,30,30
1650167774053,MATH 20A,A01,083754,Staff,26,0,40,14
1650167780076,MATH 20B,A01,083756,Staff,0,5,30,30
1650167780076,MATH 20B,A02,083757,Staff,0,4,30,30
1650167786098,MATH 20C,A01,083760,Staff,0,12,30,30
1650167786098,MATH 20C,A02,083761,Staff,0,12,30,30
1650167786098,MATH 20C,B01,083762,Staff,14,0,30,16
1650167786098,MATH 20C,B02,083763,Staff,28,0,30,2
1650167792122,MATH 20D,A01,083765,Staff,0,2,30,30
1650167792122,MATH 20D,A02,083766,Staff,10,0,30,20
1650167792122,MATH 20D,A03,083767,Staff,28,0,30,2
1650167798145,MATH 20E,A01,083771,Staff,8,0,30,22
1650167798145,MATH 20E,A02,083772,Staff,20,0,30,10
1650167798145,MATH 20E,B01,083773,Staff,0,0,30,30
1650167798145,MATH 20E,B02,083774,Staff,13,0,30,17
1650167804173,MATH 103A,A01,083777,Staff,0,8,30,30
1650167804173,MATH 103A,A02,083778,Staff,0,10,30,30
1650167804173,MATH 103A,B01,083779,Staff,1,10,30,29
1650167804173,MATH 103A,B02,083780,Staff,0,9,30,30
1650167810196,MATH 105,A01,085443,Staff,0,17,30,30
1650167816224,MATH 109,A01,083213,Anzaldo; Leesa B,0,3,30,30
1650167816224,MATH 109,A02,083214,Anzaldo; Leesa B,0,6,30,30
1650167816224,MATH 109,B01,083215,Anzaldo; Leesa B,0,4,30,30
1650167816224,MATH 109,B02,083216,Anzaldo; Leesa B,0,4,30,30
1650167822248,MATH 142A,A01,083219,Chow; Bennett,0,11,30,30
1650167822248,MATH 142A,A02,083220,Chow; Bennett,0,11,30,30
1650167822248,MATH 142A,B01,083221,Chow; Bennett,0,11,30,30
1650167822248,MATH 142A,B02,083222,Chow; Bennett,0,11,30,30
1650167828271,MATH 193A,A01,083224,Staff,0,3,30,30
1650167828271,MATH 193A,A02,083225,Staff,0,4,30,30
1650167828271,MATH 193A,A03,083781,Staff,0,1,30,30
1650167828271,MATH 193A,A04,083782,Staff,0,0,30,30
1650167834293,MATH 197,001,091859,McAuley; Julian John,9998,0,9999,1
1650167840345,COGS 9,A01,083615,Staff,0,14,60,60
1650167846368,COGS 11,A01,083617,Boyle; Mary E. T.,24,0,40,16
1650167852392,COGS 13,A01,083071,Staff,0,30,40,40
1650167858416,COGS 14A,A01,092681,Staff,0,12,100,100
1650167864443,COGS 14B,A01,083073,Cheng; Tzu-Han,0,7,50,50
1650167870470,COGS 17,A01,092677,Staff,34,0,75,41
1650167876493,COGS 100,A01,083619,Staff,0,21,60,60
1650167882590,COGS 101A,A01,083621,Davis; Joshua Daniel,0,21,60,60
1650167888614,COGS 101B,A01,091572,Staff,8,0,60,52
1650167894638,COGS 101C,A01,083625,Delgado; Tania,20,0,30,10
1650167900662,COGS 107A,A01,083627,Boyle; Mary E. T.,0,7,60,60
1650167906690,COGS 118A,A01,083075,Staff,17,0,60,43
1650167912714,CSE 3,A50,083646,Miranda; Gregory Joseph,22,0,38,16
1650167912714,CSE 3,A51,083647,Miranda; Gregory Joseph,37,0,37,0
1650167918742,CSE 8A,A50,083650,Miranda; Gregory Joseph,0,17,40,40
1650167924773,CSE 11,A01,083080,Cao; Yingjun,0,65,40,40
1650167930797,CSE 12,A01,083652,Staff,0,5,100,100
1650167936820,CSE 15L,A01,083654,Staff,0,0,50,50
1650167936820,CSE 15L,A02,083655,Staff,8,0,50,42
1650167942845,CSE 20,A01,083657,Staff,54,0,80,26
1650167948872,CSE 30,A01,083084,Eldon; John,0,67,40,40
1650167954899,CSE 100,A01,083659,Cao; Yingjun,0,61,50,50
1650167960927,CSE 134B,A01,083661,Powell; Thomas Allan,0,27,65,65
1650167966951,CSE 140,A01,083663,Staff,2,0,75,73
1650167972981,CSE 140L,A01,083088,Eldon; John,0,3,75,75
1650167979004,CSE 175,A01,083665,Kumar; Rakesh,8,0,25,17
1650167985028,CSE 190,A00,092507,Dubnov; Shlomo,14,0,20,6
1650167991066,ECE 45,A01,083139,Staff,0,13,40,40
1650167997094,ECE 65,A50,083695,Staff,0,4,30,30
1650168003117,ECE 109,A01,091882,Touri; Behrouz,47,0,70,23
1650168009142,ECE 180,A00,083140,Abi Samra; Nicholas Camill,24,0,30,6
1650168009142,ECE 180,B00,083141,Abi Samra; Nicholas Camill,8,0,30,22
1650168015165,MATH 10A,A01,083735,Patchell; Gregory David,12,0,30,18
1650168015165,MATH 10A,A02,083736,Patchell; Gregory David,28,0,30,2
1650168015165,MATH 10A,A03,083737,Patchell; Gregory David,26,0,30,4
1650168021193,MATH 10B,A01,083207,Staff,0,5,30,30
1650168021193,MATH 10B,A02,083208,Staff,0,5,30,30
1650168021193,MATH 10B,B01,083739,Staff,17,0,30,13
1650168021193,MATH 10B,B02,083740,Staff,29,0,30,1
1650168027217,MATH 18,A01,083743,Staff,10,0,30,20
1650168027217,MATH 18,A02,083744,Staff,28,0,30,2
1650168027217,MATH 18,A03,083745,Staff,23,0,30,7
1650168027217,MATH 18,A04,083746,Staff,27,0,30,3
1650168027217,MATH 18,B01,083748,Staff,0,10,30,30
1650168027217,MATH 18,B02,083749,Staff,0,7,30,30
1650168027217,MATH 18,B03,083750,Staff,0,7,30,30
1650168027217,MATH 18,B04,083751,Staff,0,7,30,30
1650168033244,MATH 20A,A01,083754,Staff,26,0,40,14
1650168039267,MATH 20B,A01,083756,Staff,0,5,30,30
1650168039267,MATH 20B,A02,083757,Staff,0,4,30,30
1650168045291,MATH 20C,A01,083760,Staff,0,12,30,30
1650168045291,MATH 20C,A02,083761,Staff,0,12,30,30
1650168045291,MATH 20C,B01,083762,Staff,14,0,30,16
1650168045291,MATH 20C,B02,083763,Staff,28,0,30,2
1650168051318,MATH 20D,A01,083765,Staff,0,2,30,30
1650168051318,MATH 20D,A02,083766,Staff,10,0,30,20
1650168051318,MATH 20D,A03,083767,Staff,28,0,30,2
1650168057347,MATH 20E,A01,083771,Staff,8,0,30,22
1650168057347,MATH 20E,A02,083772,Staff,20,0,30,10
1650168057347,MATH 20E,B01,083773,Staff,0,0,30,30
1650168057347,MATH 20E,B02,083774,Staff,13,0,30,17
1650168063379,MATH 103A,A01,083777,Staff,0,8,30,30
1650168063379,MATH 103A,A02,083778,Staff,0,10,30,30
1650168063379,MATH 103A,B01,083779,Staff,1,10,30,29
1650168063379,MATH 103A,B02,083780,Staff,0,9,30,30
1650168069406,MATH 105,A01,085443,Staff,0,17,30,30
1650168075432,MATH 109,A01,083213,Anzaldo; Leesa B,0,3,30,30
1650168075432,MATH 109,A02,083214,Anzaldo; Leesa B,0,6,30,30
1650168075432,MATH 109,B01,083215,Anzaldo; Leesa B,0,4,30,30
1650168075432,MATH 109,B02,083216,Anzaldo; Leesa B,0,4,30,30
1650168081458,MATH 142A,A01,083219,Chow; Bennett,0,11,30,30
1650168081458,MATH 142A,A02,083220,Chow; Bennett,0,11,30,30
1650168081458,MATH 142A,B01,083221,Chow; Bennett,0,11,30,30
1650168081458,MATH 142A,B02,083222,Chow; Bennett,0,11,30,30
1650168087481,MATH 193A,A01,083224,Staff,0,3,30,30
1650168087481,MATH 193A,A02,083225,Staff,0,4,30,30
1650168087481,MATH 193A,A03,083781,Staff,0,1,30,30
1650168087481,MATH 193A,A04,083782,Staff,0,0,30,30
1650168093509,MATH 197,001,091859,McAuley; Julian John,9998,0,9999,1
1650168099560,COGS 9,A01,083615,Staff,0,14,60,60
1650168105595,COGS 11,A01,083617,Boyle; Mary E. T.,24,0,40,16
1650168111619,COGS 13,A01,083071,Staff,0,30,40,40
1650168117646,COGS 14A,A01,092681,Staff,0,12,100,100
1650168123675,COGS 14B,A01,083073,Cheng; Tzu-Han,0,7,50,50
1650168129703,COGS 17,A01,092677,Staff,34,0,75,41
1650168135728,COGS 100,A01,083619,Staff,0,21,60,60
1650168141755,COGS 101A,A01,083621,Davis; Joshua Daniel,0,21,60,60
1650168147783,COGS 101B,A01,091572,Staff,8,0,60,52
1650168153807,COGS 101C,A01,083625,Delgado; Tania,20,0,30,10
1650168159835,COGS 107A,A01,083627,Boyle; Mary E. T.,0,7,60,60
1650168165858,COGS 118A,A01,083075,Staff,17,0,60,43
1650168171883,CSE 3,A50,083646,Miranda; Gregory Joseph,22,0,38,16
1650168171883,CSE 3,A51,083647,Miranda; Gregory Joseph,37,0,37,0
1650168177906,CSE 8A,A50,083650,Miranda; Gregory Joseph,0,17,40,40
1650168183932,CSE 11,A01,083080,Cao; Yingjun,0,65,40,40
1650168189956,CSE 12,A01,083652,Staff,0,5,100,100
1650168195978,CSE 15L,A01,083654,Staff,0,0,50,50
1650168195978,CSE 15L,A02,083655,Staff,8,0,50,42
1650168202002,CSE 20,A01,083657,Staff,54,0,80,26
1650168208030,CSE 30,A01,083084,Eldon; John,0,67,40,40
1650168214058,CSE 100,A01,083659,Cao; Yingjun,0,61,50,50
1650168220083,CSE 134B,A01,083661,Powell; Thomas Allan,0,27,65,65
1650168226112,CSE 140,A01,083663,Staff,2,0,75,73
1650168232140,CSE 140L,A01,083088,Eldon; John,0,3,75,75
1650168238163,CSE 175,A01,083665,Kumar; Rakesh,8,0,25,17
1650168244186,CSE 190,A00,092507,Dubnov; Shlomo,14,0,20,6
1650168250214,ECE 45,A01,083139,Staff,0,13,40,40
1650168256242,ECE 65,A50,083695,Staff,0,4,30,30
1650168262268,ECE 109,A01,091882,Touri; Behrouz,47,0,70,23
1650168268296,ECE 180,A00,083140,Abi Samra; Nicholas Camill,24,0,30,6
1650168268296,ECE 180,B00,083141,Abi Samra; Nicholas Camill,8,0,30,22
1650168274333,MATH 10A,A01,083735,Patchell; Gregory David,12,0,30,18
1650168274333,MATH 10A,A02,083736,Patchell; Gregory David,28,0,30,2
1650168274333,MATH 10A,A03,083737,Patchell; Gregory David,26,0,30,4
1650168280358,MATH 10B,A01,083207,Staff,0,5,30,30
1650168280358,MATH 10B,A02,083208,Staff,0,5,30,30
1650168280358,MATH 10B,B01,083739,Staff,17,0,30,13
1650168280358,MATH 10B,B02,083740,Staff,29,0,30,1
1650168286384,MATH 18,A01,083743,Staff,10,0,30,20
1650168286384,MATH 18,A02,083744,Staff,28,0,30,2
1650168286384,MATH 18,A03,083745,Staff,23,0,30,7
1650168286384,MATH 18,A04,083746,Staff,27,0,30,3
1650168286384,MATH 18,B01,083748,Staff,0,10,30,30
1650168286384,MATH 18,B02,083749,Staff,0,7,30,30
1650168286384,MATH 18,B03,083750,Staff,0,7,30,30
1650168286384,MATH 18,B04,083751,Staff,0,7,30,30
1650168292411,MATH 20A,A01,083754,Staff,26,0,40,14
1650168298435,MATH 20B,A01,083756,Staff,0,5,30,30
1650168298435,MATH 20B,A02,083757,Staff,0,4,30,30
1650168304462,MATH 20C,A01,083760,Staff,0,12,30,30
1650168304462,MATH 20C,A02,083761,Staff,0,12,30,30
1650168304462,MATH 20C,B01,083762,Staff,14,0,30,16
1650168304462,MATH 20C,B02,083763,Staff,28,0,30,2
1650168310485,MATH 20D,A01,083765,Staff,0,2,30,30
1650168310485,MATH 20D,A02,083766,Staff,10,0,30,20
1650168310485,MATH 20D,A03,083767,Staff,28,0,30,2
1650168316509,MATH 20E,A01,083771,Staff,8,0,30,22
1650168316509,MATH 20E,A02,083772,Staff,20,0,30,10
1650168316509,MATH 20E,B01,083773,Staff,0,0,30,30
1650168316509,MATH 20E,B02,083774,Staff,13,0,30,17
1650168322534,MATH 103A,A01,083777,Staff,0,8,30,30
1650168322534,MATH 103A,A02,083778,Staff,0,10,30,30
1650168322534,MATH 103A,B01,083779,Staff,1,10,30,29
1650168322534,MATH 103A,B02,083780,Staff,0,9,30,30
1650168328559,MATH 105,A01,085443,Staff,0,17,30,30
1650168334590,MATH 109,A01,083213,Anzaldo; Leesa B,0,3,30,30
1650168334590,MATH 109,A02,083214,Anzaldo; Leesa B,0,6,30,30
1650168334590,MATH 109,B01,083215,Anzaldo; Leesa B,0,4,30,30
1650168334590,MATH 109,B02,083216,Anzaldo; Leesa B,0,4,30,30
1650168340615,MATH 142A,A01,083219,Chow; Bennett,0,11,30,30
1650168340615,MATH 142A,A02,083220,Chow; Bennett,0,11,30,30
1650168340615,MATH 142A,B01,083221,Chow; Bennett,0,11,30,30
1650168340615,MATH 142A,B02,083222,Chow; Bennett,0,11,30,30
1650168346641,MATH 193A,A01,083224,Staff,0,3,30,30
1650168346641,MATH 193A,A02,083225,Staff,0,4,30,30
1650168346641,MATH 193A,A03,083781,Staff,0,1,30,30
1650168346641,MATH 193A,A04,083782,Staff,0,0,30,30
1650168352669,MATH 197,001,091859,McAuley; Julian John,9998,0,9999,1
1650168358728,COGS 9,A01,083615,Staff,0,14,60,60
1650168364755,COGS 11,A01,083617,Boyle; Mary E. T.,24,0,40,16
1650168370778,COGS 13,A01,083071,Staff,0,30,40,40
1650168376804,COGS 14A,A01,092681,Staff,0,12,100,100
1650168382826,COGS 14B,A01,083073,Cheng; Tzu-Han,0,7,50,50
1650168388856,COGS 17,A01,092677,Staff,34,0,75,41
1650168394883,COGS 100,A01,083619,Staff,0,21,60,60
1650168400910,COGS 101A,A01,083621,Davis; Joshua Daniel,0,21,60,60
1650168406934,COGS 101B,A01,091572,Staff,8,0,60,52
1650168412959,COGS 101C,A01,083625,Delgado; Tania,20,0,30,10
1650168418982,COGS 107A,A01,083627,Boyle; Mary E. T.,0,7,60,60
1650168425009,COGS 118A,A01,083075,Staff,17,0,60,43
1650168431037,CSE 3,A50,083646,Miranda; Gregory Joseph,22,0,38,16
1650168431037,CSE 3,A51,083647,Miranda; Gregory Joseph,37,0,37,0
1650168437060,CSE 8A,A50,083650,Miranda; Gregory Joseph,1,17,40,39
1650168443087,CSE 11,A01,083080,Cao; Yingjun,0,66,40,40
1650168449111,CSE 12,A01,083652,Staff,0,5,100,100
1650168455137,CSE 15L,A01,083654,Staff,0,0,50,50
1650168455137,CSE 15L,A02,083655,Staff,8,0,50,42
1650168461166,CSE 20,A01,083657,Staff,54,0,80,26
1650168467191,CSE 30,A01,083084,Eldon; John,0,67,40,40
1650168473215,CSE 100,A01,083659,Cao; Yingjun,0,61,50,50
1650168479326,CSE 134B,A01,083661,Powell; Thomas Allan,0,27,65,65
1650168485353,CSE 140,A01,083663,Staff,2,0,75,73
1650168491382,CSE 140L,A01,083088,Eldon; John,0,3,75,75
1650168497414,CSE 175,A01,083665,Kumar; Rakesh,8,0,25,17
1650168503447,CSE 190,A00,092507,Dubnov; Shlomo,14,0,20,6
1650168509470,ECE 45,A01,083139,Staff,0,13,40,40
1650168515493,ECE 65,A50,083695,Staff,0,4,30,30
1650168521517,ECE 109,A01,091882,Touri; Behrouz,47,0,70,23
1650168527545,ECE 180,A00,083140,Abi Samra; Nicholas Camill,24,0,30,6
1650168527545,ECE 180,B00,083141,Abi Samra; Nicholas Camill,8,0,30,22
1650168533569,MATH 10A,A01,083735,Patchell; Gregory David,12,0,30,18
1650168533569,MATH 10A,A02,083736,Patchell; Gregory David,28,0,30,2
1650168533569,MATH 10A,A03,083737,Patchell; Gregory David,26,0,30,4
1650168539594,MATH 10B,A01,083207,Staff,0,5,30,30
1650168539594,MATH 10B,A02,083208,Staff,0,5,30,30
1650168539594,MATH 10B,B01,083739,Staff,17,0,30,13
1650168539594,MATH 10B,B02,083740,Staff,29,0,30,1
1650168545620,MATH 18,A01,083743,Staff,10,0,30,20
1650168545620,MATH 18,A02,083744,Staff,28,0,30,2
1650168545620,MATH 18,A03,083745,Staff,23,0,30,7
1650168545620,MATH 18,A04,083746,Staff,27,0,30,3
1650168545620,MATH 18,B01,083748,Staff,0,10,30,30
1650168545620,MATH 18,B02,083749,Staff,0,7,30,30
1650168545620,MATH 18,B03,083750,Staff,0,7,30,30
1650168545620,MATH 18,B04,083751,Staff,0,7,30,30
1650168551643,MATH 20A,A01,083754,Staff,26,0,40,14
1650168557678,MATH 20B,A01,083756,Staff,0,5,30,30
1650168557678,MATH 20B,A02,083757,Staff,0,4,30,30
1650168563701,MATH 20C,A01,083760,Staff,0,12,30,30
1650168563701,MATH 20C,A02,083761,Staff,0,12,30,30
1650168563701,MATH 20C,B01,083762,Staff,14,0,30,16
1650168563701,MATH 20C,B02,083763,Staff,28,0,30,2
1650168569724,MATH 20D,A01,083765,Staff,0,2,30,30
1650168569724,MATH 20D,A02,083766,Staff,10,0,30,20
1650168569724,MATH 20D,A03,083767,Staff,28,0,30,2
1650168575751,MATH 20E,A01,083771,Staff,8,0,30,22
1650168575751,MATH 20E,A02,083772,Staff,20,0,30,10
1650168575751,MATH 20E,B01,083773,Staff,0,0,30,30
1650168575751,MATH 20E,B02,083774,Staff,13,0,30,17
1650168581775,MATH 103A,A01,083777,Staff,0,8,30,30
1650168581775,MATH 103A,A02,083778,Staff,0,10,30,30
1650168581775,MATH 103A,B01,083779,Staff,1,10,30,29
1650168581775,MATH 103A,B02,083780,Staff,0,9,30,30
1650168587798,MATH 105,A01,085443,Staff,0,17,30,30
1650168593821,MATH 109,A01,083213,Anzaldo; Leesa B,0,3,30,30
1650168593821,MATH 109,A02,083214,Anzaldo; Leesa B,0,6,30,30
1650168593821,MATH 109,B01,083215,Anzaldo; Leesa B,0,4,30,30
1650168593821,MATH 109,B02,083216,Anzaldo; Leesa B,0,4,30,30
1650168599845,MATH 142A,A01,083219,Chow; Bennett,0,11,30,30
1650168599845,MATH 142A,A02,083220,Chow; Bennett,0,11,30,30
1650168599845,MATH 142A,B01,083221,Chow; Bennett,0,11,30,30
1650168599845,MATH 142A,B02,083222,Chow; Bennett,0,11,30,30
1650168605873,MATH 193A,A01,083224,Staff,0,3,30,30
1650168605873,MATH 193A,A02,083225,Staff,0,4,30,30
1650168605873,MATH 193A,A03,083781,Staff,0,1,30,30
1650168605873,MATH 193A,A04,083782,Staff,0,0,30,30
1650168611896,MATH 197,001,091859,McAuley; Julian John,9998,0,9999,1
1650168617963,COGS 9,A01,083615,Staff,0,14,60,60
1650168623988,COGS 11,A01,083617,Boyle; Mary E. T.,24,0,40,16
1650168630024,COGS 13,A01,083071,Staff,0,30,40,40
1650168636050,COGS 14A,A01,092681,Staff,0,12,100,100
1650168642074,COGS 14B,A01,083073,Cheng; Tzu-Han,0,7,50,50
1650168648109,COGS 17,A01,092677,Staff,34,0,75,41
1650168654134,COGS 100,A01,083619,Staff,0,21,60,60
1650168660162,COGS 101A,A01,083621,Davis; Joshua Daniel,0,21,60,60
1650168666189,COGS 101B,A01,091572,Staff,8,0,60,52
1650168672212,COGS 101C,A01,083625,Delgado; Tania,20,0,30,10
1650168678237,COGS 107A,A01,083627,Boyle; Mary E. T.,0,7,60,60
1650168684259,COGS 118A,A01,083075,Staff,17,0,60,43
1650168690282,CSE 3,A50,083646,Miranda; Gregory Joseph,22,0,38,16
1650168690282,CSE 3,A51,083647,Miranda; Gregory Joseph,37,0,37,0
1650168696307,CSE 8A,A50,083650,Miranda; Gregory Joseph,1,17,40,39
1650168702331,CSE 11,A01,083080,Cao; Yingjun,0,66,40,40
1650168708357,CSE 12,A01,083652,Staff,0,5,100,100
1650168714380,CSE 15L,A01,083654,Staff,0,0,50,50
1650168714380,CSE 15L,A02,083655,Staff,8,0,50,42
1650168720406,CSE 20,A01,083657,Staff,54,0,80,26
1650168726434,CSE 30,A01,083084,Eldon; John,0,67,40,40
1650168732458,CSE 100,A01,083659,Cao; Yingjun,0,61,50,50
1650168738482,CSE 134B,A01,083661,Powell; Thomas Allan,0,27,65,65
1650168744505,CSE 140,A01,083663,Staff,2,0,75,73
1650168750532,CSE 140L,A01,083088,Eldon; John,0,3,75,75
1650168756556,CSE 175,A01,083665,Kumar; Rakesh,8,0,25,17
1650168762589,CSE 190,A00,092507,Dubnov; Shlomo,14,0,20,6
1650168768615,ECE 45,A01,083139,Staff,0,13,40,40
1650168774639,ECE 65,A50,083695,Staff,0,4,30,30
1650168780667,ECE 109,A01,091882,Touri; Behrouz,47,0,70,23
1650168786696,ECE 180,A00,083140,Abi Samra; Nicholas Camill,24,0,30,6
1650168786696,ECE 180,B00,083141,Abi Samra; Nicholas Camill,8,0,30,22
1650168792720,MATH 10A,A01,083735,Patchell; Gregory David,12,0,30,18
1650168792720,MATH 10A,A02,083736,Patchell; Gregory David,28,0,30,2
1650168792720,MATH 10A,A03,083737,Patchell; Gregory David,26,0,30,4
1650168798743,MATH 10B,A01,083207,Staff,0,5,30,30
1650168798743,MATH 10B,A02,083208,Staff,0,5,30,30
1650168798743,MATH 10B,B01,083739,Staff,17,0,30,13
1650168798743,MATH 10B,B02,083740,Staff,29,0,30,1
1650168804774,MATH 18,A01,083743,Staff,10,0,30,20
1650168804774,MATH 18,A02,083744,Staff,28,0,30,2
1650168804774,MATH 18,A03,083745,Staff,23,0,30,7
1650168804774,MATH 18,A04,083746,Staff,27,0,30,3
1650168804774,MATH 18,B01,083748,Staff,0,10,30,30
1650168804774,MATH 18,B02,083749,Staff,0,7,30,30
1650168804774,MATH 18,B03,083750,Staff,0,7,30,30
1650168804774,MATH 18,B04,083751,Staff,0,7,30,30
1650168810795,MATH 20A,A01,083754,Staff,26,0,40,14
1650168816823,MATH 20B,A01,083756,Staff,0,5,30,30
1650168816823,MATH 20B,A02,083757,Staff,0,4,30,30
1650168822856,MATH 20C,A01,083760,Staff,0,12,30,30
1650168822856,MATH 20C,A02,083761,Staff,0,12,30,30
1650168822856,MATH 20C,B01,083762,Staff,14,0,30,16
1650168822856,MATH 20C,B02,083763,Staff,28,0,30,2
1650168828878,MATH 20D,A01,083765,Staff,0,2,30,30
1650168828878,MATH 20D,A02,083766,Staff,10,0,30,20
1650168828878,MATH 20D,A03,083767,Staff,28,0,30,2
1650168834909,MATH 20E,A01,083771,Staff,8,0,30,22
1650168834909,MATH 20E,A02,083772,Staff,20,0,30,10
1650168834909,MATH 20E,B01,083773,Staff,0,0,30,30
1650168834909,MATH 20E,B02,083774,Staff,13,0,30,17
1650168840947,MATH 103A,A01,083777,Staff,0,9,30,30
1650168840947,MATH 103A,A02,083778,Staff,0,10,30,30
1650168840947,MATH 103A,B01,083779,Staff,1,10,30,29
1650168840947,MATH 103A,B02,083780,Staff,0,9,30,30
1650168846973,MATH 105,A01,085443,Staff,0,17,30,30
1650168852998,MATH 109,A01,083213,Anzaldo; Leesa B,0,3,30,30
1650168852998,MATH 109,A02,083214,Anzaldo; Leesa B,0,6,30,30
1650168852998,MATH 109,B01,083215,Anzaldo; Leesa B,0,4,30,30
1650168852998,MATH 109,B02,083216,Anzaldo; Leesa B,0,4,30,30
1650168859022,MATH 142A,A01,083219,Chow; Bennett,0,11,30,30
1650168859022,MATH 142A,A02,083220,Chow; Bennett,0,11,30,30
1650168859022,MATH 142A,B01,083221,Chow; Bennett,0,11,30,30
1650168859022,MATH 142A,B02,083222,Chow; Bennett,0,12,30,30
1650168865049,MATH 193A,A01,083224,Staff,0,3,30,30
1650168865049,MATH 193A,A02,083225,Staff,0,4,30,30
1650168865049,MATH 193A,A03,083781,Staff,0,1,30,30
1650168865049,MATH 193A,A04,083782,Staff,0,0,30,30
1650168871073,MATH 197,001,091859,McAuley; Julian John,9998,0,9999,1
1650168877136,COGS 9,A01,083615,Staff,0,14,60,60
1650168883160,COGS 11,A01,083617,Boyle; Mary E. T.,24,0,40,16
1650168889186,COGS 13,A01,083071,Staff,0,30,40,40
1650168895212,COGS 14A,A01,092681,Staff,0,12,100,100
1650168901238,COGS 14B,A01,083073,Cheng; Tzu-Han,0,7,50,50
1650168907261,COGS 17,A01,092677,Staff,34,0,75,41
1650168913286,COGS 100,A01,083619,Staff,0,21,60,60
1650168919318,COGS 101A,A01,083621,Davis; Joshua Daniel,0,21,60,60
1650168925342,COGS 101B,A01,091572,Staff,8,0,60,52
1650168931381,COGS 101C,A01,083625,Delgado; Tania,20,0,30,10
1650168937406,COGS 107A,A01,083627,Boyle; Mary E. T.,0,7,60,60
1650168943429,COGS 118A,A01,083075,Staff,17,0,60,43
1650168949459,CSE 3,A50,083646,Miranda; Gregory Joseph,22,0,38,16
1650168949459,CSE 3,A51,083647,Miranda; Gregory Joseph,37,0,37,0
1650168955482,CSE 8A,A50,083650,Miranda; Gregory Joseph,1,17,40,39
1650168961509,CSE 11,A01,083080,Cao; Yingjun,0,66,40,40
1650168967539,CSE 12,A01,083652,Staff,0,5,100,100
1650168973565,CSE 15L,A01,083654,Staff,0,0,50,50
1650168973565,CSE 15L,A02,083655,Staff,8,0,50,42
1650168979588,CSE 20,A01,083657,Staff,54,0,80,26
1650168985615,CSE 30,A01,083084,Eldon; John,0,67,40,40
1650168991637,CSE 100,A01,083659,Cao; Yingjun,0,61,50,50
1650168997674,CSE 134B,A01,083661,Powell; Thomas Allan,0,27,65,65
1650169003699,CSE 140,A01,083663,Staff,2,0,75,73
1650169009724,CSE 140L,A01,083088,Eldon; John,0,3,75,75
1650169015750,CSE 175,A01,083665,Kumar; Rakesh,8,0,25,17
1650169021781,CSE 190,A00,092507,Dubnov; Shlomo,14,0,20,6
1650169027804,ECE 45,A01,083139,Staff,0,13,40,40
1650169033832,ECE 65,A50,083695,Staff,0,4,30,30
1650169039855,ECE 109,A01,091882,Touri; Behrouz,47,0,70,23
1650169045880,ECE 180,A00,083140,Abi Samra; Nicholas Camill,24,0,30,6
1650169045880,ECE 180,B00,083141,Abi Samra; Nicholas Camill,8,0,30,22
1650169051908,MATH 10A,A01,083735,Patchell; Gregory David,12,0,30,18
1650169051908,MATH 10A,A02,083736,Patchell; Gregory David,28,0,30,2
1650169051908,MATH 10A,A03,083737,Patchell; Gregory David,26,0,30,4
1650169057931,MATH 10B,A01,083207,Staff,0,5,30,30
1650169057931,MATH 10B,A02,083208,Staff,0,5,30,30
1650169057931,MATH 10B,B01,083739,Staff,17,0,30,13
1650169057931,MATH 10B,B02,083740,Staff,29,0,30,1
1650169063960,MATH 18,A01,083743,Staff,10,0,30,20
1650169063960,MATH 18,A02,083744,Staff,28,0,30,2
1650169063960,MATH 18,A03,083745,Staff,23,0,30,7
1650169063960,MATH 18,A04,083746,Staff,27,0,30,3
1650169063960,MATH 18,B01,083748,Staff,0,10,30,30
1650169063960,MATH 18,B02,083749,Staff,0,7,30,30
1650169063960,MATH 18,B03,083750,Staff,0,7,30,30
1650169063960,MATH 18,B04,083751,Staff,0,7,30,30
1650169069984,MATH 20A,A01,083754,Staff,26,0,40,14
1650169076081,MATH 20B,A01,083756,Staff,0,5,30,30
1650169076081,MATH 20B,A02,083757,Staff,0,4,30,30
1650169082115,MATH 20C,A01,083760,Staff,0,12,30,30
1650169082115,MATH 20C,A02,083761,Staff,0,12,30,30
1650169082115,MATH 20C,B01,083762,Staff,14,0,30,16
1650169082115,MATH 20C,B02,083763,Staff,28,0,30,2
1650169088136,MATH 20D,A01,083765,Staff,0,2,30,30
1650169088136,MATH 20D,A02,083766,Staff,10,0,30,20
1650169088136,MATH 20D,A03,083767,Staff,28,0,30,2
1650169094164,MATH 20E,A01,083771,Staff,8,0,30,22
1650169094164,MATH 20E,A02,083772,Staff,20,0,30,10
1650169094164,MATH 20E,B01,083773,Staff,0,0,30,30
1650169094164,MATH 20E,B02,083774,Staff,13,0,30,17
1650169100190,MATH 103A,A01,083777,Staff,0,9,30,30
1650169100190,MATH 103A,A02,083778,Staff,0,10,30,30
1650169100190,MATH 103A,B01,083779,Staff,1,10,30,29
1650169100190,MATH 103A,B02,083780,Staff,0,9,30,30
1650169106224,MATH 105,A01,085443,Staff,0,17,30,30
1650169112247,MATH 109,A01,083213,Anzaldo; Leesa B,0,3,30,30
1650169112247,MATH 109,A02,083214,Anzaldo; Leesa B,0,6,30,30
1650169112247,MATH 109,B01,083215,Anzaldo; Leesa B,0,4,30,30
1650169112247,MATH 109,B02,083216,Anzaldo; Leesa B,0,4,30,30
1650169118273,MATH 142A,A01,083219,Chow; Bennett,0,11,30,30
1650169118273,MATH 142A,A02,083220,Chow; Bennett,0,11,30,30
1650169118273,MATH 142A,B01,083221,Chow; Bennett,0,11,30,30
1650169118273,MATH 142A,B02,083222,Chow; Bennett,0,12,30,30
1650169124300,MATH 193A,A01,083224,Staff,0,3,30,30
1650169124300,MATH 193A,A02,083225,Staff,0,4,30,30
1650169124300,MATH 193A,A03,083781,Staff,0,1,30,30
1650169124300,MATH 193A,A04,083782,Staff,0,1,30,30
1650169130342,MATH 197,001,091859,McAuley; Julian John,9998,0,9999,1
1650169136394,COGS 9,A01,083615,Staff,0,14,60,60
1650169142418,COGS 11,A01,083617,Boyle; Mary E. T.,24,0,40,16
1650169148441,COGS 13,A01,083071,Staff,0,30,40,40
1650169154466,COGS 14A,A01,092681,Staff,0,12,100,100
1650169160488,COGS 14B,A01,083073,Cheng; Tzu-Han,0,7,50,50
1650169166511,COGS 17,A01,092677,Staff,34,0,75,41
1650169172534,COGS 100,A01,083619,Staff,0,21,60,60
1650169178558,COGS 101A,A01,083621,Davis; Joshua Daniel,0,21,60,60
1650169184590,COGS 101B,A01,091572,Staff,8,0,60,52
1650169190613,COGS 101C,A01,083625,Delgado; Tania,20,0,30,10
1650169196637,COGS 107A,A01,083627,Boyle; Mary E. T.,0,7,60,60
1650169202673,COGS 118A,A01,083075,Staff,17,0,60,43
1650169208707,CSE 3,A50,083646,Miranda; Gregory Joseph,22,0,38,16
1650169208707,CSE 3,A51,083647,Miranda; Gregory Joseph,37,0,37,0
1650169214740,CSE 8A,A50,083650,Miranda; Gregory Joseph,1,17,40,39
1650169220764,CSE 11,A01,083080,Cao; Yingjun,0,66,40,40
1650169226792,CSE 12,A01,083652,Staff,0,5,100,100
1650169232822,CSE 15L,A01,083654,Staff,0,0,50,50
1650169232822,CSE 15L,A02,083655,Staff,8,0,50,42
1650169238846,CSE 20,A01,083657,Staff,54,0,80,26
1650169244872,CSE 30,A01,083084,Eldon; John,0,67,40,40
1650169250896,CSE 100,A01,083659,Cao; Yingjun,0,61,50,50
1650169256920,CSE 134B,A01,083661,Powell; Thomas Allan,0,27,65,65
1650169262945,CSE 140,A01,083663,Staff,2,0,75,73
1650169268969,CSE 140L,A01,083088,Eldon; John,0,3,75,75
1650169275008,CSE 175,A01,083665,Kumar; Rakesh,8,0,25,17
1650169281042,CSE 190,A00,092507,Dubnov; Shlomo,14,0,20,6
1650169287066,ECE 45,A01,083139,Staff,0,13,40,40
1650169293092,ECE 65,A50,083695,Staff,0,4,30,30
1650169299122,ECE 109,A01,091882,Touri; Behrouz,47,0,70,23
1650169305147,ECE 180,A00,083140,Abi Samra; Nicholas Camill,24,0,30,6
1650169305147,ECE 180,B00,083141,Abi Samra; Nicholas Camill,8,0,30,22
1650169311173,MATH 10A,A01,083735,Patchell; Gregory David,12,0,30,18
1650169311173,MATH 10A,A02,083736,Patchell; Gregory David,28,0,30,2
1650169311173,MATH 10A,A03,083737,Patchell; Gregory David,26,0,30,4
1650169317195,MATH 10B,A01,083207,Staff,0,5,30,30
1650169317195,MATH 10B,A02,083208,Staff,0,5,30,30
1650169317195,MATH 10B,B01,083739,Staff,17,0,30,13
1650169317195,MATH 10B,B02,083740,Staff,29,0,30,1
1650169323228,MATH 18,A01,083743,Staff,10,0,30,20
1650169323228,MATH 18,A02,083744,Staff,28,0,30,2
1650169323228,MATH 18,A03,083745,Staff,23,0,30,7
1650169323228,MATH 18,A04,083746,Staff,27,0,30,3
1650169323228,MATH 18,B01,083748,Staff,0,10,30,30
1650169323228,MATH 18,B02,083749,Staff,0,7,30,30
1650169323228,MATH 18,B03,083750,Staff,0,7,30,30
1650169323228,MATH 18,B04,083751,Staff,0,7,30,30
1650169329263,MATH 20A,A01,083754,Staff,26,0,40,14
1650169335292,MATH 20B,A01,083756,Staff,0,5,30,30
1650169335292,MATH 20B,A02,083757,Staff,0,4,30,30
1650169341328,MATH 20C,A01,083760,Staff,0,12,30,30
1650169341328,MATH 20C,A02,083761,Staff,0,12,30,30
1650169341328,MATH 20C,B01,083762,Staff,14,0,30,16
1650169341328,MATH 20C,B02,083763,Staff,28,0,30,2
1650169347354,MATH 20D,A01,083765,Staff,0,2,30,30
1650169347354,MATH 20D,A02,083766,Staff,10,0,30,20
1650169347354,MATH 20D,A03,083767,Staff,28,0,30,2
1650169353390,MATH 20E,A01,083771,Staff,8,0,30,22
1650169353390,MATH 20E,A02,083772,Staff,20,0,30,10
1650169353390,MATH 20E,B01,083773,Staff,0,0,30,30
1650169353390,MATH 20E,B02,083774,Staff,13,0,30,17
1650169359413,MATH 103A,A01,083777,Staff,0,9,30,30
1650169359413,MATH 103A,A02,083778,Staff,0,10,30,30
1650169359413,MATH 103A,B01,083779,Staff,1,10,30,29
1650169359413,MATH 103A,B02,083780,Staff,0,9,30,30
1650169365437,MATH 105,A01,085443,Staff,0,17,30,30
1650169371464,MATH 109,A01,083213,Anzaldo; Leesa B,0,3,30,30
1650169371464,MATH 109,A02,083214,Anzaldo; Leesa B,0,6,30,30
1650169371464,MATH 109,B01,083215,Anzaldo; Leesa B,0,4,30,30
1650169371464,MATH 109,B02,083216,Anzaldo; Leesa B,0,4,30,30
1650169377495,MATH 142A,A01,083219,Chow; Bennett,0,11,30,30
1650169377495,MATH 142A,A02,083220,Chow; Bennett,0,11,30,30
1650169377495,MATH 142A,B01,083221,Chow; Bennett,0,11,30,30
1650169377495,MATH 142A,B02,083222,Chow; Bennett,0,12,30,30
1650169383520,MATH 193A,A01,083224,Staff,0,3,30,30
1650169383520,MATH 193A,A02,083225,Staff,0,4,30,30
1650169383520,MATH 193A,A03,083781,Staff,0,1,30,30
1650169383520,MATH 193A,A04,083782,Staff,0,1,30,30
1650169389547,MATH 197,001,091859,McAuley; Julian John,9998,0,9999,1
1650169395598,COGS 9,A01,083615,Staff,0,14,60,60
1650169401623,COGS 11,A01,083617,Boyle; Mary E. T.,24,0,40,16
1650169407650,COGS 13,A01,083071,Staff,0,30,40,40
1650169413683,COGS 14A,A01,092681,Staff,0,12,100,100
1650169419706,COGS 14B,A01,083073,Cheng; Tzu-Han,0,7,50,50
1650169425730,COGS 17,A01,092677,Staff,34,0,75,41
1650169431757,COGS 100,A01,083619,Staff,0,21,60,60
1650169437779,COGS 101A,A01,083621,Davis; Joshua Daniel,0,21,60,60
1650169443811,COGS 101B,A01,091572,Staff,8,0,60,52
1650169449835,COGS 101C,A01,083625,Delgado; Tania,20,0,30,10
1650169455863,COGS 107A,A01,083627,Boyle; Mary E. T.,0,7,60,60
1650169461885,COGS 118A,A01,083075,Staff,17,0,60,43
1650169467919,CSE 3,A50,083646,Miranda; Gregory Joseph,22,0,38,16
1650169467919,CSE 3,A51,083647,Miranda; Gregory Joseph,37,0,37,0
1650169473947,CSE 8A,A50,083650,Miranda; Gregory Joseph,1,17,40,39
1650169479974,CSE 11,A01,083080,Cao; Yingjun,0,66,40,40
1650169486001,CSE 12,A01,083652,Staff,0,5,100,100
1650169492024,CSE 15L,A01,083654,Staff,0,0,50,50
1650169492024,CSE 15L,A02,083655,Staff,8,0,50,42
1650169498046,CSE 20,A01,083657,Staff,54,0,80,26
1650169504074,CSE 30,A01,083084,Eldon; John,0,67,40,40
1650169510096,CSE 100,A01,083659,Cao; Yingjun,0,61,50,50
1650169516125,CSE 134B,A01,083661,Powell; Thomas Allan,0,27,65,65
1650169522153,CSE 140,A01,083663,Staff,2,0,75,73
1650169528189,CSE 140L,A01,083088,Eldon; John,0,3,75,75
1650169534218,CSE 175,A01,083665,Kumar; Rakesh,8,0,25,17
1650169540242,CSE 190,A00,092507,Dubnov; Shlomo,14,0,20,6
1650169546270,ECE 45,A01,083139,Staff,0,13,40,40
1650169552300,ECE 65,A50,083695,Staff,0,4,30,30
1650169558322,ECE 109,A01,091882,Touri; Behrouz,47,0,70,23
1650169564356,ECE 180,A00,083140,Abi Samra; Nicholas Camill,24,0,30,6
1650169564356,ECE 180,B00,083141,Abi Samra; Nicholas Camill,8,0,30,22
1650169570384,MATH 10A,A01,083735,Patchell; Gregory David,12,0,30,18
1650169570384,MATH 10A,A02,083736,Patchell; Gregory David,28,0,30,2
1650169570384,MATH 10A,A03,083737,Patchell; Gregory David,26,0,30,4
1650169576408,MATH 10B,A01,083207,Staff,0,5,30,30
1650169576408,MATH 10B,A02,083208,Staff,0,5,30,30
1650169576408,MATH 10B,B01,083739,Staff,17,0,30,13
1650169576408,MATH 10B,B02,083740,Staff,29,0,30,1
1650169582439,MATH 18,A01,083743,Staff,10,0,30,20
1650169582439,MATH 18,A02,083744,Staff,28,0,30,2
1650169582439,MATH 18,A03,083745,Staff,23,0,30,7
1650169582439,MATH 18,A04,083746,Staff,27,0,30,3
1650169582439,MATH 18,B01,083748,Staff,0,10,30,30
1650169582439,MATH 18,B02,083749,Staff,0,7,30,30
1650169582439,MATH 18,B03,083750,Staff,0,7,30,30
1650169582439,MATH 18,B04,083751,Staff,0,7,30,30
1650169588470,MATH 20A,A01,083754,Staff,26,0,40,14
1650169594496,MATH 20B,A01,083756,Staff,0,5,30,30
1650169594496,MATH 20B,A02,083757,Staff,0,4,30,30
1650169600525,MATH 20C,A01,083760,Staff,0,12,30,30
1650169600525,MATH 20C,A02,083761,Staff,0,12,30,30
1650169600525,MATH 20C,B01,083762,Staff,14,0,30,16
1650169600525,MATH 20C,B02,083763,Staff,28,0,30,2
1650169606559,MATH 20D,A01,083765,Staff,0,2,30,30
1650169606559,MATH 20D,A02,083766,Staff,10,0,30,20
1650169606559,MATH 20D,A03,083767,Staff,28,0,30,2
1650169612584,MATH 20E,A01,083771,Staff,8,0,30,22
1650169612584,MATH 20E,A02,083772,Staff,20,0,30,10
1650169612584,MATH 20E,B01,083773,Staff,0,0,30,30
1650169612584,MATH 20E,B02,083774,Staff,13,0,30,17
1650169618612,MATH 103A,A01,083777,Staff,0,9,30,30
1650169618612,MATH 103A,A02,083778,Staff,0,10,30,30
1650169618612,MATH 103A,B01,083779,Staff,1,10,30,29
1650169618612,MATH 103A,B02,083780,Staff,0,9,30,30
1650169624640,MATH 105,A01,085443,Staff,0,17,30,30
1650169630668,MATH 109,A01,083213,Anzaldo; Leesa B,0,3,30,30
1650169630668,MATH 109,A02,083214,Anzaldo; Leesa B,0,6,30,30
1650169630668,MATH 109,B01,083215,Anzaldo; Leesa B,0,4,30,30
1650169630668,MATH 109,B02,083216,Anzaldo; Leesa B,0,4,30,30
1650169636691,MATH 142A,A01,083219,Chow; Bennett,0,11,30,30
1650169636691,MATH 142A,A02,083220,Chow; Bennett,0,11,30,30
1650169636691,MATH 142A,B01,083221,Chow; Bennett,0,11,30,30
1650169636691,MATH 142A,B02,083222,Chow; Bennett,0,12,30,30
1650169642715,MATH 193A,A01,083224,Staff,0,3,30,30
1650169642715,MATH 193A,A02,083225,Staff,0,4,30,30
1650169642715,MATH 193A,A03,083781,Staff,0,1,30,30
1650169642715,MATH 193A,A04,083782,Staff,0,1,30,30
1650169648738,MATH 197,001,091859,McAuley; Julian John,9998,0,9999,1
1650169654824,COGS 9,A01,083615,Staff,0,14,60,60
1650169660847,COGS 11,A01,083617,Boyle; Mary E. T.,24,0,40,16
1650169666943,COGS 13,A01,083071,Staff,0,30,40,40
1650169672970,COGS 14A,A01,092681,Staff,0,12,100,100
1650169678997,COGS 14B,A01,083073,Cheng; Tzu-Han,0,7,50,50
1650169685020,COGS 17,A01,092677,Staff,34,0,75,41
1650169691047,COGS 100,A01,083619,Staff,0,21,60,60
1650169697084,COGS 101A,A01,083621,Davis; Joshua Daniel,0,21,60,60
1650169703110,COGS 101B,A01,091572,Staff,8,0,60,52
1650169709132,COGS 101C,A01,083625,Delgado; Tania,20,0,30,10
1650169715156,COGS 107A,A01,083627,Boyle; Mary E. T.,0,7,60,60
1650169721179,COGS 118A,A01,083075,Staff,17,0,60,43
1650169727204,CSE 3,A50,083646,Miranda; Gregory Joseph,22,0,38,16
1650169727204,CSE 3,A51,083647,Miranda; Gregory Joseph,37,0,37,0
1650169733235,CSE 8A,A50,083650,Miranda; Gregory Joseph,1,17,40,39
1650169739258,CSE 11,A01,083080,Cao; Yingjun,0,66,40,40
1650169745279,CSE 12,A01,083652,Staff,0,5,100,100
1650169751302,CSE 15L,A01,083654,Staff,0,0,50,50
1650169751302,CSE 15L,A02,083655,Staff,8,0,50,42
1650169757325,CSE 20,A01,083657,Staff,54,0,80,26
1650169763352,CSE 30,A01,083084,Eldon; John,0,67,40,40
1650169769378,CSE 100,A01,083659,Cao; Yingjun,0,61,50,50
1650169775400,CSE 134B,A01,083661,Powell; Thomas Allan,0,27,65,65
1650169781422,CSE 140,A01,083663,Staff,2,0,75,73
1650169787450,CSE 140L,A01,083088,Eldon; John,0,3,75,75
1650169793474,CSE 175,A01,083665,Kumar; Rakesh,8,0,25,17
1650169799497,CSE 190,A00,092507,Dubnov; Shlomo,14,0,20,6
1650169805521,ECE 45,A01,083139,Staff,0,13,40,40
1650169811548,ECE 65,A50,083695,Staff,0,4,30,30
1650169817571,ECE 109,A01,091882,Touri; Behrouz,47,0,70,23
1650169823595,ECE 180,A00,083140,Abi Samra; Nicholas Camill,24,0,30,6
1650169823595,ECE 180,B00,083141,Abi Samra; Nicholas Camill,8,0,30,22
1650169829622,MATH 10A,A01,083735,Patchell; Gregory David,12,0,30,18
1650169829622,MATH 10A,A02,083736,Patchell; Gregory David,28,0,30,2
1650169829622,MATH 10A,A03,083737,Patchell; Gregory David,26,0,30,4
1650169835647,MATH 10B,A01,083207,Staff,0,5,30,30
1650169835647,MATH 10B,A02,083208,Staff,0,5,30,30
1650169835647,MATH 10B,B01,083739,Staff,17,0,30,13
1650169835647,MATH 10B,B02,083740,Staff,29,0,30,1
1650169841679,MATH 18,A01,083743,Staff,10,0,30,20
1650169841679,MATH 18,A02,083744,Staff,28,0,30,2
1650169841679,MATH 18,A03,083745,Staff,23,0,30,7
1650169841679,MATH 18,A04,083746,Staff,27,0,30,3
1650169841679,MATH 18,B01,083748,Staff,0,10,30,30
1650169841679,MATH 18,B02,083749,Staff,0,7,30,30
1650169841679,MATH 18,B03,083750,Staff,0,7,30,30
1650169841679,MATH 18,B04,083751,Staff,0,7,30,30
1650169847706,MATH 20A,A01,083754,Staff,26,0,40,14
1650169853730,MATH 20B,A01,083756,Staff,0,5,30,30
1650169853730,MATH 20B,A02,083757,Staff,0,4,30,30
1650169859754,MATH 20C,A01,083760,Staff,0,12,30,30
1650169859754,MATH 20C,A02,083761,Staff,0,12,30,30
1650169859754,MATH 20C,B01,083762,Staff,14,0,30,16
1650169859754,MATH 20C,B02,083763,Staff,28,0,30,2
1650169865777,MATH 20D,A01,083765,Staff,0,2,30,30
1650169865777,MATH 20D,A02,083766,Staff,10,0,30,20
1650169865777,MATH 20D,A03,083767,Staff,28,0,30,2
1650169871802,MATH 20E,A01,083771,Staff,8,0,30,22
1650169871802,MATH 20E,A02,083772,Staff,20,0,30,10
1650169871802,MATH 20E,B01,083773,Staff,0,0,30,30
1650169871802,MATH 20E,B02,083774,Staff,13,0,30,17
1650169877841,MATH 103A,A01,083777,Staff,0,9,30,30
1650169877841,MATH 103A,A02,083778,Staff,0,10,30,30
1650169877841,MATH 103A,B01,083779,Staff,1,10,30,29
1650169877841,MATH 103A,B02,083780,Staff,0,9,30,30
1650169883865,MATH 105,A01,085443,Staff,0,17,30,30
1650169889894,MATH 109,A01,083213,Anzaldo; Leesa B,0,3,30,30
1650169889894,MATH 109,A02,083214,Anzaldo; Leesa B,0,6,30,30
1650169889894,MATH 109,B01,083215,Anzaldo; Leesa B,0,4,30,30
1650169889894,MATH 109,B02,083216,Anzaldo; Leesa B,0,4,30,30
1650169895922,MATH 142A,A01,083219,Chow; Bennett,0,11,30,30
1650169895922,MATH 142A,A02,083220,Chow; Bennett,0,11,30,30
1650169895922,MATH 142A,B01,083221,Chow; Bennett,0,11,30,30
1650169895922,MATH 142A,B02,083222,Chow; Bennett,0,12,30,30
1650169901954,MATH 193A,A01,083224,Staff,0,3,30,30
1650169901954,MATH 193A,A02,083225,Staff,0,4,30,30
1650169901954,MATH 193A,A03,083781,Staff,0,1,30,30
1650169901954,MATH 193A,A04,083782,Staff,0,1,30,30
1650169907978,MATH 197,001,091859,McAuley; Julian John,9998,0,9999,1
1650169914038,COGS 9,A01,083615,Staff,0,14,60,60
1650169920062,COGS 11,A01,083617,Boyle; Mary E. T.,24,0,40,16
1650169926084,COGS 13,A01,083071,Staff,0,30,40,40
1650169932108,COGS 14A,A01,092681,Staff,0,12,100,100
1650169938136,COGS 14B,A01,083073,Cheng; Tzu-Han,0,7,50,50
1650169944160,COGS 17,A01,092677,Staff,34,0,75,41
1650169950187,COGS 100,A01,083619,Staff,0,21,60,60
1650169956212,COGS 101A,A01,083621,Davis; Joshua Daniel,0,21,60,60
1650169962233,COGS 101B,A01,091572,Staff,8,0,60,52
1650169968256,COGS 101C,A01,083625,Delgado; Tania,20,0,30,10
1650169974280,COGS 107A,A01,083627,Boyle; Mary E. T.,0,7,60,60
1650169980304,COGS 118A,A01,083075,Staff,17,0,60,43
1650169986332,CSE 3,A50,083646,Miranda; Gregory Joseph,22,0,38,16
1650169986332,CSE 3,A51,083647,Miranda; Gregory Joseph,37,0,37,0
1650169992364,CSE 8A,A50,083650,Miranda; Gregory Joseph,1,17,40,39
1650169998387,CSE 11,A01,083080,Cao; Yingjun,0,66,40,40
1650170004415,CSE 12,A01,083652,Staff,0,5,100,100
1650170010439,CSE 15L,A01,083654,Staff,0,0,50,50
1650170010439,CSE 15L,A02,083655,Staff,8,0,50,42
1650170016462,CSE 20,A01,083657,Staff,54,0,80,26
1650170022485,CSE 30,A01,083084,Eldon; John,0,67,40,40
1650170028508,CSE 100,A01,083659,Cao; Yingjun,0,61,50,50
1650170034535,CSE 134B,A01,083661,Powell; Thomas Allan,0,27,65,65
1650170040567,CSE 140,A01,083663,Staff,2,0,75,73
1650170046590,CSE 140L,A01,083088,Eldon; John,0,3,75,75
1650170052621,CSE 175,A01,083665,Kumar; Rakesh,8,0,25,17
1650170058644,CSE 190,A00,092507,Dubnov; Shlomo,14,0,20,6
1650170064668,ECE 45,A01,083139,Staff,0,13,40,40
1650170070691,ECE 65,A50,083695,Staff,0,4,30,30
1650170076716,ECE 109,A01,091882,Touri; Behrouz,47,0,70,23
1650170082743,ECE 180,A00,083140,Abi Samra; Nicholas Camill,24,0,30,6
1650170082743,ECE 180,B00,083141,Abi Samra; Nicholas Camill,8,0,30,22
1650170088764,MATH 10A,A01,083735,Patchell; Gregory David,12,0,30,18
1650170088764,MATH 10A,A02,083736,Patchell; Gregory David,28,0,30,2
1650170088764,MATH 10A,A03,083737,Patchell; Gregory David,26,0,30,4
1650170094788,MATH 10B,A01,083207,Staff,0,5,30,30
1650170094788,MATH 10B,A02,083208,Staff,0,5,30,30
1650170094788,MATH 10B,B01,083739,Staff,17,0,30,13
1650170094788,MATH 10B,B02,083740,Staff,29,0,30,1
1650170100824,MATH 18,A01,083743,Staff,10,0,30,20
1650170100824,MATH 18,A02,083744,Staff,28,0,30,2
1650170100824,MATH 18,A03,083745,Staff,23,0,30,7
1650170100824,MATH 18,A04,083746,Staff,27,0,30,3
1650170100824,MATH 18,B01,083748,Staff,0,10,30,30
1650170100824,MATH 18,B02,083749,Staff,0,7,30,30
1650170100824,MATH 18,B03,083750,Staff,0,7,30,30
1650170100824,MATH 18,B04,083751,Staff,0,7,30,30
1650170106850,MATH 20A,A01,083754,Staff,26,0,40,14
1650170112878,MATH 20B,A01,083756,Staff,0,5,30,30
1650170112878,MATH 20B,A02,083757,Staff,0,4,30,30
1650170118902,MATH 20C,A01,083760,Staff,0,12,30,30
1650170118902,MATH 20C,A02,083761,Staff,0,12,30,30
1650170118902,MATH 20C,B01,083762,Staff,14,0,30,16
1650170118902,MATH 20C,B02,083763,Staff,28,0,30,2
1650170124927,MATH 20D,A01,083765,Staff,0,2,30,30
1650170124927,MATH 20D,A02,083766,Staff,10,0,30,20
1650170124927,MATH 20D,A03,083767,Staff,28,0,30,2
1650170130951,MATH 20E,A01,083771,Staff,8,0,30,22
1650170130951,MATH 20E,A02,083772,Staff,20,0,30,10
1650170130951,MATH 20E,B01,083773,Staff,0,0,30,30
1650170130951,MATH 20E,B02,083774,Staff,13,0,30,17
1650170136978,MATH 103A,A01,083777,Staff,0,9,30,30
1650170136978,MATH 103A,A02,083778,Staff,0,10,30,30
1650170136978,MATH 103A,B01,083779,Staff,1,10,30,29
1650170136978,MATH 103A,B02,083780,Staff,0,9,30,30
1650170143006,MATH 105,A01,085443,Staff,0,17,30,30
1650170149030,MATH 109,A01,083213,Anzaldo; Leesa B,0,3,30,30
1650170149030,MATH 109,A02,083214,Anzaldo; Leesa B,0,6,30,30
1650170149030,MATH 109,B01,083215,Anzaldo; Leesa B,0,4,30,30
1650170149030,MATH 109,B02,083216,Anzaldo; Leesa B,0,4,30,30
1650170155054,MATH 142A,A01,083219,Chow; Bennett,0,11,30,30
1650170155054,MATH 142A,A02,083220,Chow; Bennett,0,11,30,30
1650170155054,MATH 142A,B01,083221,Chow; Bennett,0,11,30,30
1650170155054,MATH 142A,B02,083222,Chow; Bennett,0,12,30,30
1650170161078,MATH 193A,A01,083224,Staff,0,3,30,30
1650170161078,MATH 193A,A02,083225,Staff,0,4,30,30
1650170161078,MATH 193A,A03,083781,Staff,0,1,30,30
1650170161078,MATH 193A,A04,083782,Staff,0,1,30,30
1650170167103,MATH 197,001,091859,McAuley; Julian John,9998,0,9999,1
1650170173155,COGS 9,A01,083615,Staff,0,14,60,60
1650170179182,COGS 11,A01,083617,Boyle; Mary E. T.,24,0,40,16
1650170185209,COGS 13,A01,083071,Staff,0,30,40,40
1650170191233,COGS 14A,A01,092681,Staff,0,12,100,100
1650170197255,COGS 14B,A01,083073,Cheng; Tzu-Han,0,7,50,50
1650170203285,COGS 17,A01,092677,Staff,34,0,75,41
1650170209310,COGS 100,A01,083619,Staff,0,21,60,60
1650170215334,COGS 101A,A01,083621,Davis; Joshua Daniel,0,21,60,60
1650170221359,COGS 101B,A01,091572,Staff,8,0,60,52
1650170227387,COGS 101C,A01,083625,Delgado; Tania,20,0,30,10
1650170233425,COGS 107A,A01,083627,Boyle; Mary E. T.,0,7,60,60
1650170239455,COGS 118A,A01,083075,Staff,17,0,60,43
1650170245482,CSE 3,A50,083646,Miranda; Gregory Joseph,22,0,38,16
1650170245482,CSE 3,A51,083647,Miranda; Gregory Joseph,37,0,37,0
1650170251507,CSE 8A,A50,083650,Miranda; Gregory Joseph,1,17,40,39
1650170257529,CSE 11,A01,083080,Cao; Yingjun,0,66,40,40
1650170263652,CSE 12,A01,083652,Staff,0,5,100,100
1650170269680,CSE 15L,A01,083654,Staff,0,0,50,50
1650170269680,CSE 15L,A02,083655,Staff,8,0,50,42
1650170275704,CSE 20,A01,083657,Staff,54,0,80,26
1650170281736,CSE 30,A01,083084,Eldon; John,0,67,40,40
1650170287761,CSE 100,A01,083659,Cao; Yingjun,0,61,50,50
1650170293792,CSE 134B,A01,083661,Powell; Thomas Allan,0,27,65,65
1650170299826,CSE 140,A01,083663,Staff,1,0,75,74
1650170305853,CSE 140L,A01,083088,Eldon; John,0,4,75,75
1650170311879,CSE 175,A01,083665,Kumar; Rakesh,8,0,25,17
1650170317905,CSE 190,A00,092507,Dubnov; Shlomo,14,0,20,6
1650170323933,ECE 45,A01,083139,Staff,0,13,40,40
1650170329959,ECE 65,A50,083695,Staff,0,5,30,30
1650170335983,ECE 109,A01,091882,Touri; Behrouz,47,0,70,23
1650170342007,ECE 180,A00,083140,Abi Samra; Nicholas Camill,24,0,30,6
1650170342007,ECE 180,B00,083141,Abi Samra; Nicholas Camill,8,0,30,22
1650170348030,MATH 10A,A01,083735,Patchell; Gregory David,12,0,30,18
1650170348030,MATH 10A,A02,083736,Patchell; Gregory David,28,0,30,2
1650170348030,MATH 10A,A03,083737,Patchell; Gregory David,26,0,30,4
1650170354054,MATH 10B,A01,083207,Staff,0,5,30,30
1650170354054,MATH 10B,A02,083208,Staff,0,5,30,30
1650170354054,MATH 10B,B01,083739,Staff,17,0,30,13
1650170354054,MATH 10B,B02,083740,Staff,29,0,30,1
1650170360080,MATH 18,A01,083743,Staff,10,0,30,20
1650170360080,MATH 18,A02,083744,Staff,28,0,30,2
1650170360080,MATH 18,A03,083745,Staff,23,0,30,7
1650170360080,MATH 18,A04,083746,Staff,27,0,30,3
1650170360080,MATH 18,B01,083748,Staff,0,10,30,30
1650170360080,MATH 18,B02,083749,Staff,0,7,30,30
1650170360080,MATH 18,B03,083750,Staff,0,7,30,30
1650170360080,MATH 18,B04,083751,Staff,0,7,30,30
1650170366103,MATH 20A,A01,083754,Staff,26,0,40,14
1650170372123,MATH 20B,A01,083756,Staff,0,5,30,30
1650170372123,MATH 20B,A02,083757,Staff,0,4,30,30
1650170378152,MATH 20C,A01,083760,Staff,0,12,30,30
1650170378152,MATH 20C,A02,083761,Staff,0,12,30,30
1650170378152,MATH 20C,B01,083762,Staff,14,0,30,16
1650170378152,MATH 20C,B02,083763,Staff,28,0,30,2
1650170384180,MATH 20D,A01,083765,Staff,0,2,30,30
1650170384180,MATH 20D,A02,083766,Staff,10,0,30,20
1650170384180,MATH 20D,A03,083767,Staff,28,0,30,2
1650170390208,MATH 20E,A01,083771,Staff,8,0,30,22
1650170390208,MATH 20E,A02,083772,Staff,20,0,30,10
1650170390208,MATH 20E,B01,083773,Staff,0,0,30,30
1650170390208,MATH 20E,B02,083774,Staff,13,0,30,17
1650170396233,MATH 103A,A01,083777,Staff,0,9,30,30
1650170396233,MATH 103A,A02,083778,Staff,0,10,30,30
1650170396233,MATH 103A,B01,083779,Staff,1,10,30,29
1650170396233,MATH 103A,B02,083780,Staff,0,9,30,30
1650170402256,MATH 105,A01,085443,Staff,0,17,30,30
1650170408287,MATH 109,A01,083213,Anzaldo; Leesa B,0,3,30,30
1650170408287,MATH 109,A02,083214,Anzaldo; Leesa B,0,6,30,30
1650170408287,MATH 109,B01,083215,Anzaldo; Leesa B,0,4,30,30
1650170408287,MATH 109,B02,083216,Anzaldo; Leesa B,0,4,30,30
1650170414312,MATH 142A,A01,083219,Chow; Bennett,0,11,30,30
1650170414312,MATH 142A,A02,083220,Chow; Bennett,0,11,30,30
1650170414312,MATH 142A,B01,083221,Chow; Bennett,0,11,30,30
1650170414312,MATH 142A,B02,083222,Chow; Bennett,0,12,30,30
1650170420345,MATH 193A,A01,083224,Staff,0,3,30,30
1650170420345,MATH 193A,A02,083225,Staff,0,4,30,30
1650170420345,MATH 193A,A03,083781,Staff,0,1,30,30
1650170420345,MATH 193A,A04,083782,Staff,0,1,30,30
1650170426379,MATH 197,001,091859,McAuley; Julian John,9998,0,9999,1
1650170432437,COGS 9,A01,083615,Staff,0,14,60,60
1650170438461,COGS 11,A01,083617,Boyle; Mary E. T.,24,0,40,16
1650170444486,COGS 13,A01,083071,Staff,0,30,40,40
1650170450510,COGS 14A,A01,092681,Staff,0,12,100,100
1650170456534,COGS 14B,A01,083073,Cheng; Tzu-Han,0,7,50,50
1650170462567,COGS 17,A01,092677,Staff,34,0,75,41
1650170468594,COGS 100,A01,083619,Staff,0,21,60,60
1650170474618,COGS 101A,A01,083621,Davis; Joshua Daniel,0,21,60,60
1650170480653,COGS 101B,A01,091572,Staff,8,0,60,52
1650170486677,COGS 101C,A01,083625,Delgado; Tania,20,0,30,10
1650170492701,COGS 107A,A01,083627,Boyle; Mary E. T.,0,7,60,60
1650170498725,COGS 118A,A01,083075,Staff,17,0,60,43
1650170504750,CSE 3,A50,083646,Miranda; Gregory Joseph,22,0,38,16
1650170504750,CSE 3,A51,083647,Miranda; Gregory Joseph,37,0,37,0
1650170510775,CSE 8A,A50,083650,Miranda; Gregory Joseph,1,17,40,39
1650170516802,CSE 11,A01,083080,Cao; Yingjun,0,66,40,40
1650170522830,CSE 12,A01,083652,Staff,0,5,100,100
1650170528855,CSE 15L,A01,083654,Staff,0,0,50,50
1650170528855,CSE 15L,A02,083655,Staff,8,0,50,42
1650170534879,CSE 20,A01,083657,Staff,54,0,80,26
1650170540907,CSE 30,A01,083084,Eldon; John,0,67,40,40
1650170546933,CSE 100,A01,083659,Cao; Yingjun,0,61,50,50
1650170552960,CSE 134B,A01,083661,Powell; Thomas Allan,0,27,65,65
1650170559040,CSE 140,A01,083663,Staff,1,0,75,74
1650170565062,CSE 140L,A01,083088,Eldon; John,0,4,75,75
1650170571085,CSE 175,A01,083665,Kumar; Rakesh,8,0,25,17
1650170577109,CSE 190,A00,092507,Dubnov; Shlomo,14,0,20,6
1650170583135,ECE 45,A01,083139,Staff,0,13,40,40
1650170589162,ECE 65,A50,083695,Staff,0,5,30,30
1650170595186,ECE 109,A01,091882,Touri; Behrouz,47,0,70,23
1650170601210,ECE 180,A00,083140,Abi Samra; Nicholas Camill,24,0,30,6
1650170601210,ECE 180,B00,083141,Abi Samra; Nicholas Camill,8,0,30,22
1650170607237,MATH 10A,A01,083735,Patchell; Gregory David,12,0,30,18
1650170607237,MATH 10A,A02,083736,Patchell; Gregory David,28,0,30,2
1650170607237,MATH 10A,A03,083737,Patchell; Gregory David,26,0,30,4
1650170613263,MATH 10B,A01,083207,Staff,0,5,30,30
1650170613263,MATH 10B,A02,083208,Staff,0,5,30,30
1650170613263,MATH 10B,B01,083739,Staff,17,0,30,13
1650170613263,MATH 10B,B02,083740,Staff,29,0,30,1
1650170619290,MATH 18,A01,083743,Staff,10,0,30,20
1650170619290,MATH 18,A02,083744,Staff,28,0,30,2
1650170619290,MATH 18,A03,083745,Staff,23,0,30,7
1650170619290,MATH 18,A04,083746,Staff,27,0,30,3
1650170619290,MATH 18,B01,083748,Staff,0,10,30,30
1650170619290,MATH 18,B02,083749,Staff,0,7,30,30
1650170619290,MATH 18,B03,083750,Staff,0,7,30,30
1650170619290,MATH 18,B04,083751,Staff,0,7,30,30
1650170625314,MATH 20A,A01,083754,Staff,26,0,40,14
1650170631345,MATH 20B,A01,083756,Staff,0,5,30,30
1650170631345,MATH 20B,A02,083757,Staff,0,4,30,30
1650170637376,MATH 20C,A01,083760,Staff,0,12,30,30
1650170637376,MATH 20C,A02,083761,Staff,0,12,30,30
1650170637376,MATH 20C,B01,083762,Staff,14,0,30,16
1650170637376,MATH 20C,B02,083763,Staff,28,0,30,2
1650170643404,MATH 20D,A01,083765,Staff,0,2,30,30
1650170643404,MATH 20D,A02,083766,Staff,10,0,30,20
1650170643404,MATH 20D,A03,083767,Staff,28,0,30,2
1650170649432,MATH 20E,A01,083771,Staff,8,0,30,22
1650170649432,MATH 20E,A02,083772,Staff,20,0,30,10
1650170649432,MATH 20E,B01,083773,Staff,0,0,30,30
1650170649432,MATH 20E,B02,083774,Staff,13,0,30,17
1650170655457,MATH 103A,A01,083777,Staff,0,9,30,30
1650170655457,MATH 103A,A02,083778,Staff,0,10,30,30
1650170655457,MATH 103A,B01,083779,Staff,1,10,30,29
1650170655457,MATH 103A,B02,083780,Staff,0,9,30,30
1650170661480,MATH 105,A01,085443,Staff,0,17,30,30
1650170667507,MATH 109,A01,083213,Anzaldo; Leesa B,0,3,30,30
1650170667507,MATH 109,A02,083214,Anzaldo; Leesa B,0,6,30,30
1650170667507,MATH 109,B01,083215,Anzaldo; Leesa B,0,4,30,30
1650170667507,MATH 109,B02,083216,Anzaldo; Leesa B,0,4,30,30
1650170673532,MATH 142A,A01,083219,Chow; Bennett,0,11,30,30
1650170673532,MATH 142A,A02,083220,Chow; Bennett,0,11,30,30
1650170673532,MATH 142A,B01,083221,Chow; Bennett,0,11,30,30
1650170673532,MATH 142A,B02,083222,Chow; Bennett,0,12,30,30
1650170679555,MATH 193A,A01,083224,Staff,0,3,30,30
1650170679555,MATH 193A,A02,083225,Staff,0,4,30,30
1650170679555,MATH 193A,A03,083781,Staff,0,1,30,30
1650170679555,MATH 193A,A04,083782,Staff,0,1,30,30
1650170685581,MATH 197,001,091859,McAuley; Julian John,9998,0,9999,1
1650170691640,COGS 9,A01,083615,Staff,0,14,60,60
1650170697663,COGS 11,A01,083617,Boyle; Mary E. T.,24,0,40,16
1650170703690,COGS 13,A01,083071,Staff,0,30,40,40
1650170709714,COGS 14A,A01,092681,Staff,0,12,100,100
1650170715757,COGS 14B,A01,083073,Cheng; Tzu-Han,0,7,50,50
1650170721781,COGS 17,A01,092677,Staff,34,0,75,41
1650170727808,COGS 100,A01,083619,Staff,0,21,60,60
1650170733832,COGS 101A,A01,083621,Davis; Joshua Daniel,0,21,60,60
1650170739855,COGS 101B,A01,091572,Staff,8,0,60,52
1650170745879,COGS 101C,A01,083625,Delgado; Tania,20,0,30,10
1650170751904,COGS 107A,A01,083627,Boyle; Mary E. T.,0,7,60,60
1650170757926,COGS 118A,A01,083075,Staff,17,0,60,43
1650170763954,CSE 3,A50,083646,Miranda; Gregory Joseph,22,0,38,16
1650170763954,CSE 3,A51,083647,Miranda; Gregory Joseph,37,0,37,0
1650170769981,CSE 8A,A50,083650,Miranda; Gregory Joseph,1,17,40,39
1650170776005,CSE 11,A01,083080,Cao; Yingjun,0,66,40,40
1650170782033,CSE 12,A01,083652,Staff,0,5,100,100
1650170788057,CSE 15L,A01,083654,Staff,0,0,50,50
1650170788057,CSE 15L,A02,083655,Staff,8,0,50,42
1650170794082,CSE 20,A01,083657,Staff,54,0,80,26
1650170800110,CSE 30,A01,083084,Eldon; John,0,67,40,40
1650170806138,CSE 100,A01,083659,Cao; Yingjun,0,61,50,50
1650170812169,CSE 134B,A01,083661,Powell; Thomas Allan,0,27,65,65
1650170818193,CSE 140,A01,083663,Staff,1,0,75,74
1650170824216,CSE 140L,A01,083088,Eldon; John,0,4,75,75
1650170830240,CSE 175,A01,083665,Kumar; Rakesh,8,0,25,17
1650170836267,CSE 190,A00,092507,Dubnov; Shlomo,14,0,20,6
1650170842290,ECE 45,A01,083139,Staff,0,13,40,40
1650170848319,ECE 65,A50,083695,Staff,0,5,30,30
1650170854342,ECE 109,A01,091882,Touri; Behrouz,47,0,70,23
1650170860437,ECE 180,A00,083140,Abi Samra; Nicholas Camill,24,0,30,6
1650170860437,ECE 180,B00,083141,Abi Samra; Nicholas Camill,8,0,30,22
1650170866471,MATH 10A,A01,083735,Patchell; Gregory David,12,0,30,18
1650170866471,MATH 10A,A02,083736,Patchell; Gregory David,28,0,30,2
1650170866471,MATH 10A,A03,083737,Patchell; Gregory David,26,0,30,4
1650170872497,MATH 10B,A01,083207,Staff,0,5,30,30
1650170872497,MATH 10B,A02,083208,Staff,0,5,30,30
1650170872497,MATH 10B,B01,083739,Staff,17,0,30,13
1650170872497,MATH 10B,B02,083740,Staff,29,0,30,1
1650170878528,MATH 18,A01,083743,Staff,10,0,30,20
1650170878528,MATH 18,A02,083744,Staff,28,0,30,2
1650170878528,MATH 18,A03,083745,Staff,23,0,30,7
1650170878528,MATH 18,A04,083746,Staff,27,0,30,3
1650170878528,MATH 18,B01,083748,Staff,0,10,30,30
1650170878528,MATH 18,B02,083749,Staff,0,7,30,30
1650170878528,MATH 18,B03,083750,Staff,0,7,30,30
1650170878528,MATH 18,B04,083751,Staff,0,7,30,30
1650170884560,MATH 20A,A01,083754,Staff,26,0,40,14
1650170890587,MATH 20B,A01,083756,Staff,0,5,30,30
1650170890587,MATH 20B,A02,083757,Staff,0,4,30,30
1650170896611,MATH 20C,A01,083760,Staff,0,12,30,30
1650170896611,MATH 20C,A02,083761,Staff,0,12,30,30
1650170896611,MATH 20C,B01,083762,Staff,14,0,30,16
1650170896611,MATH 20C,B02,083763,Staff,28,0,30,2
1650170902635,MATH 20D,A01,083765,Staff,0,2,30,30
1650170902635,MATH 20D,A02,083766,Staff,10,0,30,20
1650170902635,MATH 20D,A03,083767,Staff,28,0,30,2
1650170908662,MATH 20E,A01,083771,Staff,8,0,30,22
1650170908662,MATH 20E,A02,083772,Staff,20,0,30,10
1650170908662,MATH 20E,B01,083773,Staff,0,0,30,30
1650170908662,MATH 20E,B02,083774,Staff,13,0,30,17
1650170914686,MATH 103A,A01,083777,Staff,0,9,30,30
1650170914686,MATH 103A,A02,083778,Staff,0,10,30,30
1650170914686,MATH 103A,B01,083779,Staff,1,10,30,29
1650170914686,MATH 103A,B02,083780,Staff,0,9,30,30
1650170920709,MATH 105,A01,085443,Staff,0,17,30,30
1650170926738,MATH 109,A01,083213,Anzaldo; Leesa B,0,3,30,30
1650170926738,MATH 109,A02,083214,Anzaldo; Leesa B,0,6,30,30
1650170926738,MATH 109,B01,083215,Anzaldo; Leesa B,0,4,30,30
1650170926738,MATH 109,B02,083216,Anzaldo; Leesa B,0,4,30,30
1650170932764,MATH 142A,A01,083219,Chow; Bennett,0,11,30,30
1650170932764,MATH 142A,A02,083220,Chow; Bennett,0,11,30,30
1650170932764,MATH 142A,B01,083221,Chow; Bennett,0,11,30,30
1650170932764,MATH 142A,B02,083222,Chow; Bennett,0,12,30,30
1650170938791,MATH 193A,A01,083224,Staff,0,3,30,30
1650170938791,MATH 193A,A02,083225,Staff,0,4,30,30
1650170938791,MATH 193A,A03,083781,Staff,0,1,30,30
1650170938791,MATH 193A,A04,083782,Staff,0,1,30,30
1650170944815,MATH 197,001,091859,McAuley; Julian John,9998,0,9999,1
1650170950868,COGS 9,A01,083615,Staff,0,14,60,60
1650170956892,COGS 11,A01,083617,Boyle; Mary E. T.,24,0,40,16
1650170962916,COGS 13,A01,083071,Staff,0,30,40,40
1650170968943,COGS 14A,A01,092681,Staff,0,12,100,100
1650170974970,COGS 14B,A01,083073,Cheng; Tzu-Han,0,7,50,50
1650170980997,COGS 17,A01,092677,Staff,34,0,75,41
1650170987020,COGS 100,A01,083619,Staff,0,21,60,60
1650170993048,COGS 101A,A01,083621,Davis; Joshua Daniel,0,21,60,60
1650170999074,COGS 101B,A01,091572,Staff,7,0,60,53
1650171005103,COGS 101C,A01,083625,Delgado; Tania,20,0,30,10
1650171011130,COGS 107A,A01,083627,Boyle; Mary E. T.,0,7,60,60
1650171017158,COGS 118A,A01,083075,Staff,17,0,60,43
1650171023185,CSE 3,A50,083646,Miranda; Gregory Joseph,22,0,38,16
1650171023185,CSE 3,A51,083647,Miranda; Gregory Joseph,37,0,37,0
1650171029208,CSE 8A,A50,083650,Miranda; Gregory Joseph,1,17,40,39
1650171035230,CSE 11,A01,083080,Cao; Yingjun,0,66,40,40
1650171041256,CSE 12,A01,083652,Staff,0,5,100,100
1650171047281,CSE 15L,A01,083654,Staff,0,0,50,50
1650171047281,CSE 15L,A02,083655,Staff,8,0,50,42
1650171053306,CSE 20,A01,083657,Staff,54,0,80,26
1650171059329,CSE 30,A01,083084,Eldon; John,0,67,40,40
1650171065351,CSE 100,A01,083659,Cao; Yingjun,0,61,50,50
1650171071375,CSE 134B,A01,083661,Powell; Thomas Allan,0,27,65,65
1650171077399,CSE 140,A01,083663,Staff,1,0,75,74
1650171083423,CSE 140L,A01,083088,Eldon; John,0,4,75,75
1650171089459,CSE 175,A01,083665,Kumar; Rakesh,8,0,25,17
1650171095486,CSE 190,A00,092507,Dubnov; Shlomo,14,0,20,6
1650171101510,ECE 45,A01,083139,Staff,0,13,40,40
1650171107544,ECE 65,A50,083695,Staff,0,5,30,30
1650171113569,ECE 109,A01,091882,Touri; Behrouz,47,0,70,23
1650171119595,ECE 180,A00,083140,Abi Samra; Nicholas Camill,24,0,30,6
1650171119595,ECE 180,B00,083141,Abi Samra; Nicholas Camill,8,0,30,22
1650171125619,MATH 10A,A01,083735,Patchell; Gregory David,12,0,30,18
1650171125619,MATH 10A,A02,083736,Patchell; Gregory David,28,0,30,2
1650171125619,MATH 10A,A03,083737,Patchell; Gregory David,26,0,30,4
1650171131643,MATH 10B,A01,083207,Staff,0,5,30,30
1650171131643,MATH 10B,A02,083208,Staff,0,5,30,30
1650171131643,MATH 10B,B01,083739,Staff,17,0,30,13
1650171131643,MATH 10B,B02,083740,Staff,29,0,30,1
1650171137673,MATH 18,A01,083743,Staff,10,0,30,20
1650171137673,MATH 18,A02,083744,Staff,28,0,30,2
1650171137673,MATH 18,A03,083745,Staff,23,0,30,7
1650171137673,MATH 18,A04,083746,Staff,27,0,30,3
1650171137673,MATH 18,B01,083748,Staff,0,10,30,30
1650171137673,MATH 18,B02,083749,Staff,0,7,30,30
1650171137673,MATH 18,B03,083750,Staff,0,7,30,30
1650171137673,MATH 18,B04,083751,Staff,0,7,30,30
1650171143701,MATH 20A,A01,083754,Staff,26,0,40,14
1650171149723,MATH 20B,A01,083756,Staff,0,5,30,30
1650171149723,MATH 20B,A02,083757,Staff,0,4,30,30
1650171155750,MATH 20C,A01,083760,Staff,0,12,30,30
1650171155750,MATH 20C,A02,083761,Staff,0,12,30,30
1650171155750,MATH 20C,B01,083762,Staff,14,0,30,16
1650171155750,MATH 20C,B02,083763,Staff,28,0,30,2
1650171161776,MATH 20D,A01,083765,Staff,0,2,30,30
1650171161776,MATH 20D,A02,083766,Staff,10,0,30,20
1650171161776,MATH 20D,A03,083767,Staff,28,0,30,2
1650171167804,MATH 20E,A01,083771,Staff,8,0,30,22
1650171167804,MATH 20E,A02,083772,Staff,20,0,30,10
1650171167804,MATH 20E,B01,083773,Staff,0,0,30,30
1650171167804,MATH 20E,B02,083774,Staff,13,0,30,17
1650171173832,MATH 103A,A01,083777,Staff,0,9,30,30
1650171173832,MATH 103A,A02,083778,Staff,0,10,30,30
1650171173832,MATH 103A,B01,083779,Staff,1,10,30,29
1650171173832,MATH 103A,B02,083780,Staff,0,9,30,30
1650171179856,MATH 105,A01,085443,Staff,0,17,30,30
1650171185884,MATH 109,A01,083213,Anzaldo; Leesa B,0,3,30,30
1650171185884,MATH 109,A02,083214,Anzaldo; Leesa B,0,6,30,30
1650171185884,MATH 109,B01,083215,Anzaldo; Leesa B,0,4,30,30
1650171185884,MATH 109,B02,083216,Anzaldo; Leesa B,0,4,30,30
1650171191912,MATH 142A,A01,083219,Chow; Bennett,0,11,30,30
1650171191912,MATH 142A,A02,083220,Chow; Bennett,0,11,30,30
1650171191912,MATH 142A,B01,083221,Chow; Bennett,0,11,30,30
1650171191912,MATH 142A,B02,083222,Chow; Bennett,0,12,30,30
1650171197939,MATH 193A,A01,083224,Staff,0,3,30,30
1650171197939,MATH 193A,A02,083225,Staff,0,4,30,30
1650171197939,MATH 193A,A03,083781,Staff,0,1,30,30
1650171197939,MATH 193A,A04,083782,Staff,0,1,30,30
1650171203963,MATH 197,001,091859,McAuley; Julian John,9998,0,9999,1
1650171210019,COGS 9,A01,083615,Staff,0,14,60,60
1650171216042,COGS 11,A01,083617,Boyle; Mary E. T.,24,0,40,16
1650171222064,COGS 13,A01,083071,Staff,0,30,40,40
1650171228088,COGS 14A,A01,092681,Staff,0,12,100,100
1650171234115,COGS 14B,A01,083073,Cheng; Tzu-Han,0,7,50,50
1650171240141,COGS 17,A01,092677,Staff,34,0,75,41
1650171246165,COGS 100,A01,083619,Staff,0,21,60,60
1650171252189,COGS 101A,A01,083621,Davis; Joshua Daniel,0,21,60,60
1650171258213,COGS 101B,A01,091572,Staff,7,0,60,53
1650171264236,COGS 101C,A01,083625,Delgado; Tania,20,0,30,10
1650171270260,COGS 107A,A01,083627,Boyle; Mary E. T.,0,7,60,60
1650171276282,COGS 118A,A01,083075,Staff,17,0,60,43
1650171282310,CSE 3,A50,083646,Miranda; Gregory Joseph,22,0,38,16
1650171282310,CSE 3,A51,083647,Miranda; Gregory Joseph,37,0,37,0
1650171288335,CSE 8A,A50,083650,Miranda; Gregory Joseph,1,17,40,39
1650171294369,CSE 11,A01,083080,Cao; Yingjun,0,66,40,40
1650171300393,CSE 12,A01,083652,Staff,0,5,100,100
1650171306428,CSE 15L,A01,083654,Staff,0,0,50,50
1650171306428,CSE 15L,A02,083655,Staff,8,0,50,42
1650171312454,CSE 20,A01,083657,Staff,54,0,80,26
1650171318478,CSE 30,A01,083084,Eldon; John,0,67,40,40
1650171324502,CSE 100,A01,083659,Cao; Yingjun,0,61,50,50
1650171330529,CSE 134B,A01,083661,Powell; Thomas Allan,0,27,65,65
1650171336558,CSE 140,A01,083663,Staff,1,0,75,74
1650171342586,CSE 140L,A01,083088,Eldon; John,0,4,75,75
1650171348616,CSE 175,A01,083665,Kumar; Rakesh,8,0,25,17
1650171354642,CSE 190,A00,092507,Dubnov; Shlomo,14,0,20,6
1650171360668,ECE 45,A01,083139,Staff,0,13,40,40
1650171366691,ECE 65,A50,083695,Staff,0,5,30,30
1650171372722,ECE 109,A01,091882,Touri; Behrouz,47,0,70,23
1650171378748,ECE 180,A00,083140,Abi Samra; Nicholas Camill,24,0,30,6
1650171378748,ECE 180,B00,083141,Abi Samra; Nicholas Camill,8,0,30,22
1650171384769,MATH 10A,A01,083735,Patchell; Gregory David,12,0,30,18
1650171384769,MATH 10A,A02,083736,Patchell; Gregory David,28,0,30,2
1650171384769,MATH 10A,A03,083737,Patchell; Gregory David,26,0,30,4
1650171390796,MATH 10B,A01,083207,Staff,0,5,30,30
1650171390796,MATH 10B,A02,083208,Staff,0,5,30,30
1650171390796,MATH 10B,B01,083739,Staff,17,0,30,13
1650171390796,MATH 10B,B02,083740,Staff,29,0,30,1
1650171396825,MATH 18,A01,083743,Staff,10,0,30,20
1650171396825,MATH 18,A02,083744,Staff,28,0,30,2
1650171396825,MATH 18,A03,083745,Staff,23,0,30,7
1650171396825,MATH 18,A04,083746,Staff,27,0,30,3
1650171396825,MATH 18,B01,083748,Staff,0,10,30,30
1650171396825,MATH 18,B02,083749,Staff,0,7,30,30
1650171396825,MATH 18,B03,083750,Staff,0,7,30,30
1650171396825,MATH 18,B04,083751,Staff,0,7,30,30
1650171402849,MATH 20A,A01,083754,Staff,26,0,40,14
1650171408877,MATH 20B,A01,083756,Staff,0,5,30,30
1650171408877,MATH 20B,A02,083757,Staff,0,4,30,30
1650171414900,MATH 20C,A01,083760,Staff,0,12,30,30
1650171414900,MATH 20C,A02,083761,Staff,0,12,30,30
1650171414900,MATH 20C,B01,083762,Staff,14,0,30,16
1650171414900,MATH 20C,B02,083763,Staff,28,0,30,2
1650171420929,MATH 20D,A01,083765,Staff,0,2,30,30
1650171420929,MATH 20D,A02,083766,Staff,10,0,30,20
1650171420929,MATH 20D,A03,083767,Staff,28,0,30,2
1650171426950,MATH 20E,A01,083771,Staff,8,0,30,22
1650171426950,MATH 20E,A02,083772,Staff,20,0,30,10
1650171426950,MATH 20E,B01,083773,Staff,0,0,30,30
1650171426950,MATH 20E,B02,083774,Staff,13,0,30,17
1650171432974,MATH 103A,A01,083777,Staff,0,9,30,30
1650171432974,MATH 103A,A02,083778,Staff,0,10,30,30
1650171432974,MATH 103A,B01,083779,Staff,1,10,30,29
1650171432974,MATH 103A,B02,083780,Staff,0,9,30,30
1650171438998,MATH 105,A01,085443,Staff,0,17,30,30
1650171445027,MATH 109,A01,083213,Anzaldo; Leesa B,0,3,30,30
1650171445027,MATH 109,A02,083214,Anzaldo; Leesa B,0,6,30,30
1650171445027,MATH 109,B01,083215,Anzaldo; Leesa B,0,4,30,30
1650171445027,MATH 109,B02,083216,Anzaldo; Leesa B,0,4,30,30
1650171451051,MATH 142A,A01,083219,Chow; Bennett,0,11,30,30
1650171451051,MATH 142A,A02,083220,Chow; Bennett,0,11,30,30
1650171451051,MATH 142A,B01,083221,Chow; Bennett,0,11,30,30
1650171451051,MATH 142A,B02,083222,Chow; Bennett,0,12,30,30
1650171457160,MATH 193A,A01,083224,Staff,0,3,30,30
1650171457160,MATH 193A,A02,083225,Staff,0,4,30,30
1650171457160,MATH 193A,A03,083781,Staff,0,1,30,30
1650171457160,MATH 193A,A04,083782,Staff,0,1,30,30
1650171463185,MATH 197,001,091859,McAuley; Julian John,9998,0,9999,1
1650171469243,COGS 9,A01,083615,Staff,0,14,60,60
1650171475269,COGS 11,A01,083617,Boyle; Mary E. T.,24,0,40,16
1650171481293,COGS 13,A01,083071,Staff,0,30,40,40
1650171487316,COGS 14A,A01,092681,Staff,0,12,100,100
1650171493342,COGS 14B,A01,083073,Cheng; Tzu-Han,0,7,50,50
1650171499368,COGS 17,A01,092677,Staff,34,0,75,41
1650171505390,COGS 100,A01,083619,Staff,0,21,60,60
1650171511417,COGS 101A,A01,083621,Davis; Joshua Daniel,0,21,60,60
1650171517439,COGS 101B,A01,091572,Staff,7,0,60,53
1650171523463,COGS 101C,A01,083625,Delgado; Tania,20,0,30,10
1650171529487,COGS 107A,A01,083627,Boyle; Mary E. T.,0,7,60,60
1650171535516,COGS 118A,A01,083075,Staff,17,0,60,43
1650171541543,CSE 3,A50,083646,Miranda; Gregory Joseph,22,0,38,16
1650171541543,CSE 3,A51,083647,Miranda; Gregory Joseph,37,0,37,0
1650171547568,CSE 8A,A50,083650,Miranda; Gregory Joseph,1,17,40,39
1650171553591,CSE 11,A01,083080,Cao; Yingjun,0,66,40,40
1650171559615,CSE 12,A01,083652,Staff,0,5,100,100
1650171565638,CSE 15L,A01,083654,Staff,0,0,50,50
1650171565638,CSE 15L,A02,083655,Staff,8,0,50,42
1650171571661,CSE 20,A01,083657,Staff,54,0,80,26
1650171577685,CSE 30,A01,083084,Eldon; John,0,67,40,40
1650171583707,CSE 100,A01,083659,Cao; Yingjun,0,61,50,50
1650171589736,CSE 134B,A01,083661,Powell; Thomas Allan,0,27,65,65
1650171595758,CSE 140,A01,083663,Staff,1,0,75,74
1650171601792,CSE 140L,A01,083088,Eldon; John,0,4,75,75
1650171607814,CSE 175,A01,083665,Kumar; Rakesh,8,0,25,17
1650171613839,CSE 190,A00,092507,Dubnov; Shlomo,14,0,20,6
1650171619862,ECE 45,A01,083139,Staff,0,13,40,40
1650171625891,ECE 65,A50,083695,Staff,0,5,30,30
1650171631915,ECE 109,A01,091882,Touri; Behrouz,47,0,70,23
1650171637938,ECE 180,A00,083140,Abi Samra; Nicholas Camill,24,0,30,6
1650171637938,ECE 180,B00,083141,Abi Samra; Nicholas Camill,8,0,30,22
1650171643966,MATH 10A,A01,083735,Patchell; Gregory David,12,0,30,18
1650171643966,MATH 10A,A02,083736,Patchell; Gregory David,28,0,30,2
1650171643966,MATH 10A,A03,083737,Patchell; Gregory David,26,0,30,4
1650171649990,MATH 10B,A01,083207,Staff,0,5,30,30
1650171649990,MATH 10B,A02,083208,Staff,0,5,30,30
1650171649990,MATH 10B,B01,083739,Staff,17,0,30,13
1650171649990,MATH 10B,B02,083740,Staff,29,0,30,1
1650171656020,MATH 18,A01,083743,Staff,10,0,30,20
1650171656020,MATH 18,A02,083744,Staff,28,0,30,2
1650171656020,MATH 18,A03,083745,Staff,23,0,30,7
1650171656020,MATH 18,A04,083746,Staff,27,0,30,3
1650171656020,MATH 18,B01,083748,Staff,0,10,30,30
1650171656020,MATH 18,B02,083749,Staff,0,7,30,30
1650171656020,MATH 18,B03,083750,Staff,0,7,30,30
1650171656020,MATH 18,B04,083751,Staff,0,7,30,30
1650171662044,MATH 20A,A01,083754,Staff,26,0,40,14
1650171668080,MATH 20B,A01,083756,Staff,0,5,30,30
1650171668080,MATH 20B,A02,083757,Staff,0,4,30,30
1650171674108,MATH 20C,A01,083760,Staff,0,12,30,30
1650171674108,MATH 20C,A02,083761,Staff,0,12,30,30
1650171674108,MATH 20C,B01,083762,Staff,14,0,30,16
1650171674108,MATH 20C,B02,083763,Staff,28,0,30,2
1650171680133,MATH 20D,A01,083765,Staff,0,2,30,30
1650171680133,MATH 20D,A02,083766,Staff,10,0,30,20
1650171680133,MATH 20D,A03,083767,Staff,28,0,30,2
1650171686167,MATH 20E,A01,083771,Staff,8,0,30,22
1650171686167,MATH 20E,A02,083772,Staff,20,0,30,10
1650171686167,MATH 20E,B01,083773,Staff,0,0,30,30
1650171686167,MATH 20E,B02,083774,Staff,13,0,30,17
1650171692195,MATH 103A,A01,083777,Staff,0,9,30,30
1650171692195,MATH 103A,A02,083778,Staff,0,10,30,30
1650171692195,MATH 103A,B01,083779,Staff,1,10,30,29
1650171692195,MATH 103A,B02,083780,Staff,0,9,30,30
1650171698217,MATH 105,A01,085443,Staff,0,17,30,30
1650171704239,MATH 109,A01,083213,Anzaldo; Leesa B,0,3,30,30
1650171704239,MATH 109,A02,083214,Anzaldo; Leesa B,0,6,30,30
1650171704239,MATH 109,B01,083215,Anzaldo; Leesa B,0,4,30,30
1650171704239,MATH 109,B02,083216,Anzaldo; Leesa B,0,4,30,30
1650171710267,MATH 142A,A01,083219,Chow; Bennett,0,12,30,30
1650171710267,MATH 142A,A02,083220,Chow; Bennett,0,11,30,30
1650171710267,MATH 142A,B01,083221,Chow; Bennett,0,11,30,30
1650171710267,MATH 142A,B02,083222,Chow; Bennett,0,12,30,30
1650171716290,MATH 193A,A01,083224,Staff,0,3,30,30
1650171716290,MATH 193A,A02,083225,Staff,0,4,30,30
1650171716290,MATH 193A,A03,083781,Staff,0,1,30,30
1650171716290,MATH 193A,A04,083782,Staff,0,1,30,30
1650171722315,MATH 197,001,091859,McAuley; Julian John,9998,0,9999,1
1650171728371,COGS 9,A01,083615,Staff,0,14,60,60
1650171734402,COGS 11,A01,083617,Boyle; Mary E. T.,24,0,40,16
1650171740427,COGS 13,A01,083071,Staff,0,30,40,40
1650171746453,COGS 14A,A01,092681,Staff,0,12,100,100
1650171752478,COGS 14B,A01,083073,Cheng; Tzu-Han,0,7,50,50
1650171758502,COGS 17,A01,092677,Staff,34,0,75,41
1650171764526,COGS 100,A01,083619,Staff,0,21,60,60
1650171770549,COGS 101A,A01,083621,Davis; Joshua Daniel,0,21,60,60
1650171776573,COGS 101B,A01,091572,Staff,6,0,60,54
1650171782600,COGS 101C,A01,083625,Delgado; Tania,20,0,30,10
1650171788625,COGS 107A,A01,083627,Boyle; Mary E. T.,0,7,60,60
1650171794648,COGS 118A,A01,083075,Staff,17,0,60,43
1650171800671,CSE 3,A50,083646,Miranda; Gregory Joseph,22,0,38,16
1650171800671,CSE 3,A51,083647,Miranda; Gregory Joseph,37,0,37,0
1650171806696,CSE 8A,A50,083650,Miranda; Gregory Joseph,1,17,40,39
1650171812723,CSE 11,A01,083080,Cao; Yingjun,0,66,40,40
1650171818751,CSE 12,A01,083652,Staff,0,5,100,100
1650171824773,CSE 15L,A01,083654,Staff,0,0,50,50
1650171824773,CSE 15L,A02,083655,Staff,8,0,50,42
1650171830803,CSE 20,A01,083657,Staff,54,0,80,26
1650171836828,CSE 30,A01,083084,Eldon; John,0,67,40,40
1650171842851,CSE 100,A01,083659,Cao; Yingjun,0,61,50,50
1650171848889,CSE 134B,A01,083661,Powell; Thomas Allan,0,27,65,65
1650171854913,CSE 140,A01,083663,Staff,1,0,75,74
1650171860937,CSE 140L,A01,083088,Eldon; John,0,4,75,75
1650171866962,CSE 175,A01,083665,Kumar; Rakesh,8,0,25,17
1650171872985,CSE 190,A00,092507,Dubnov; Shlomo,14,0,20,6
1650171879009,ECE 45,A01,083139,Staff,0,13,40,40
1650171885031,ECE 65,A50,083695,Staff,0,5,30,30
1650171891054,ECE 109,A01,091882,Touri; Behrouz,47,0,70,23
1650171897078,ECE 180,A00,083140,Abi Samra; Nicholas Camill,24,0,30,6
1650171897078,ECE 180,B00,083141,Abi Samra; Nicholas Camill,8,0,30,22
1650171903109,MATH 10A,A01,083735,Patchell; Gregory David,12,0,30,18
1650171903109,MATH 10A,A02,083736,Patchell; Gregory David,28,0,30,2
1650171903109,MATH 10A,A03,083737,Patchell; Gregory David,26,0,30,4
1650171909137,MATH 10B,A01,083207,Staff,0,5,30,30
1650171909137,MATH 10B,A02,083208,Staff,0,5,30,30
1650171909137,MATH 10B,B01,083739,Staff,17,0,30,13
1650171909137,MATH 10B,B02,083740,Staff,29,0,30,1
1650171915163,MATH 18,A01,083743,Staff,10,0,30,20
1650171915163,MATH 18,A02,083744,Staff,28,0,30,2
1650171915163,MATH 18,A03,083745,Staff,23,0,30,7
1650171915163,MATH 18,A04,083746,Staff,27,0,30,3
1650171915163,MATH 18,B01,083748,Staff,0,10,30,30
1650171915163,MATH 18,B02,083749,Staff,0,7,30,30
1650171915163,MATH 18,B03,083750,Staff,0,7,30,30
1650171915163,MATH 18,B04,083751,Staff,0,7,30,30
1650171921198,MATH 20A,A01,083754,Staff,26,0,40,14
1650171927221,MATH 20B,A01,083756,Staff,0,5,30,30
1650171927221,MATH 20B,A02,083757,Staff,0,4,30,30
1650171933253,MATH 20C,A01,083760,Staff,0,12,30,30
1650171933253,MATH 20C,A02,083761,Staff,0,12,30,30
1650171933253,MATH 20C,B01,083762,Staff,14,0,30,16
1650171933253,MATH 20C,B02,083763,Staff,28,0,30,2
1650171939278,MATH 20D,A01,083765,Staff,0,2,30,30
1650171939278,MATH 20D,A02,083766,Staff,10,0,30,20
1650171939278,MATH 20D,A03,083767,Staff,28,0,30,2
1650171945306,MATH 20E,A01,083771,Staff,8,0,30,22
1650171945306,MATH 20E,A02,083772,Staff,20,0,30,10
1650171945306,MATH 20E,B01,083773,Staff,0,0,30,30
1650171945306,MATH 20E,B02,083774,Staff,13,0,30,17
1650171951334,MATH 103A,A01,083777,Staff,0,9,30,30
1650171951334,MATH 103A,A02,083778,Staff,0,10,30,30
1650171951334,MATH 103A,B01,083779,Staff,1,10,30,29
1650171951334,MATH 103A,B02,083780,Staff,0,9,30,30
1650171957358,MATH 105,A01,085443,Staff,0,17,30,30
1650171963392,MATH 109,A01,083213,Anzaldo; Leesa B,0,3,30,30
1650171963392,MATH 109,A02,083214,Anzaldo; Leesa B,0,6,30,30
1650171963392,MATH 109,B01,083215,Anzaldo; Leesa B,0,4,30,30
1650171963392,MATH 109,B02,083216,Anzaldo; Leesa B,0,4,30,30
1650171969417,MATH 142A,A01,083219,Chow; Bennett,0,12,30,30
1650171969417,MATH 142A,A02,083220,Chow; Bennett,0,11,30,30
1650171969417,MATH 142A,B01,083221,Chow; Bennett,0,11,30,30
1650171969417,MATH 142A,B02,083222,Chow; Bennett,0,12,30,30
1650171975450,MATH 193A,A01,083224,Staff,0,3,30,30
1650171975450,MATH 193A,A02,083225,Staff,0,4,30,30
1650171975450,MATH 193A,A03,083781,Staff,0,1,30,30
1650171975450,MATH 193A,A04,083782,Staff,0,1,30,30
1650171981473,MATH 197,001,091859,McAuley; Julian John,9998,0,9999,1
1650171987542,COGS 9,A01,083615,Staff,0,14,60,60
1650171993567,COGS 11,A01,083617,Boyle; Mary E. T.,24,0,40,16
1650171999592,COGS 13,A01,083071,Staff,0,30,40,40
1650172005616,COGS 14A,A01,092681,Staff,0,12,100,100
1650172011638,COGS 14B,A01,083073,Cheng; Tzu-Han,0,7,50,50
1650172017662,COGS 17,A01,092677,Staff,34,0,75,41
1650172023697,COGS 100,A01,083619,Staff,0,21,60,60
1650172029724,COGS 101A,A01,083621,Davis; Joshua Daniel,0,21,60,60
1650172035747,COGS 101B,A01,091572,Staff,6,0,60,54
1650172041777,COGS 101C,A01,083625,Delgado; Tania,20,0,30,10
1650172047871,COGS 107A,A01,083627,Boyle; Mary E. T.,0,7,60,60
1650172053903,COGS 118A,A01,083075,Staff,17,0,60,43
1650172059927,CSE 3,A50,083646,Miranda; Gregory Joseph,22,0,38,16
1650172059927,CSE 3,A51,083647,Miranda; Gregory Joseph,37,0,37,0
1650172065955,CSE 8A,A50,083650,Miranda; Gregory Joseph,1,17,40,39
1650172071984,CSE 11,A01,083080,Cao; Yingjun,0,66,40,40
1650172078014,CSE 12,A01,083652,Staff,0,5,100,100
1650172084041,CSE 15L,A01,083654,Staff,0,0,50,50
1650172084041,CSE 15L,A02,083655,Staff,8,0,50,42
1650172090075,CSE 20,A01,083657,Staff,54,0,80,26
1650172096100,CSE 30,A01,083084,Eldon; John,0,67,40,40
1650172102124,CSE 100,A01,083659,Cao; Yingjun,0,61,50,50
1650172108152,CSE 134B,A01,083661,Powell; Thomas Allan,0,27,65,65
1650172114197,CSE 140,A01,083663,Staff,1,0,75,74
1650172120226,CSE 140L,A01,083088,Eldon; John,0,4,75,75
1650172126252,CSE 175,A01,083665,Kumar; Rakesh,8,0,25,17
1650172132277,CSE 190,A00,092507,Dubnov; Shlomo,14,0,20,6
1650172138323,ECE 45,A01,083139,Staff,0,13,40,40
1650172144352,ECE 65,A50,083695,Staff,0,5,30,30
1650172150431,ECE 109,A01,091882,Touri; Behrouz,47,0,70,23
1650172156466,ECE 180,A00,083140,Abi Samra; Nicholas Camill,24,0,30,6
1650172156466,ECE 180,B00,083141,Abi Samra; Nicholas Camill,8,0,30,22
1650172162490,MATH 10A,A01,083735,Patchell; Gregory David,12,0,30,18
1650172162490,MATH 10A,A02,083736,Patchell; Gregory David,28,0,30,2
1650172162490,MATH 10A,A03,083737,Patchell; Gregory David,26,0,30,4
1650172168523,MATH 10B,A01,083207,Staff,0,5,30,30
1650172168523,MATH 10B,A02,083208,Staff,0,5,30,30
1650172168523,MATH 10B,B01,083739,Staff,17,0,30,13
1650172168523,MATH 10B,B02,083740,Staff,29,0,30,1
1650172174553,MATH 18,A01,083743,Staff,10,0,30,20
1650172174553,MATH 18,A02,083744,Staff,28,0,30,2
1650172174553,MATH 18,A03,083745,Staff,23,0,30,7
1650172174553,MATH 18,A04,083746,Staff,27,0,30,3
1650172174553,MATH 18,B01,083748,Staff,0,10,30,30
1650172174553,MATH 18,B02,083749,Staff,0,7,30,30
1650172174553,MATH 18,B03,083750,Staff,0,7,30,30
1650172174553,MATH 18,B04,083751,Staff,0,7,30,30
1650172180583,MATH 20A,A01,083754,Staff,26,0,40,14
1650172186610,MATH 20B,A01,083756,Staff,0,5,30,30
1650172186610,MATH 20B,A02,083757,Staff,0,4,30,30
1650172192634,MATH 20C,A01,083760,Staff,0,12,30,30
1650172192634,MATH 20C,A02,083761,Staff,0,12,30,30
1650172192634,MATH 20C,B01,083762,Staff,14,0,30,16
1650172192634,MATH 20C,B02,083763,Staff,28,0,30,2
1650172198661,MATH 20D,A01,083765,Staff,0,2,30,30
1650172198661,MATH 20D,A02,083766,Staff,10,0,30,20
1650172198661,MATH 20D,A03,083767,Staff,28,0,30,2
1650172204690,MATH 20E,A01,083771,Staff,8,0,30,22
1650172204690,MATH 20E,A02,083772,Staff,20,0,30,10
1650172204690,MATH 20E,B01,083773,Staff,0,0,30,30
1650172204690,MATH 20E,B02,083774,Staff,13,0,30,17
1650172210719,MATH 103A,A01,083777,Staff,0,9,30,30
1650172210719,MATH 103A,A02,083778,Staff,0,10,30,30
1650172210719,MATH 103A,B01,083779,Staff,1,10,30,29
1650172210719,MATH 103A,B02,083780,Staff,0,9,30,30
1650172216751,MATH 105,A01,085443,Staff,0,17,30,30
1650172222775,MATH 109,A01,083213,Anzaldo; Leesa B,0,3,30,30
1650172222775,MATH 109,A02,083214,Anzaldo; Leesa B,0,6,30,30
1650172222775,MATH 109,B01,083215,Anzaldo; Leesa B,0,4,30,30
1650172222775,MATH 109,B02,083216,Anzaldo; Leesa B,0,4,30,30
1650172228799,MATH 142A,A01,083219,Chow; Bennett,0,12,30,30
1650172228799,MATH 142A,A02,083220,Chow; Bennett,0,11,30,30
1650172228799,MATH 142A,B01,083221,Chow; Bennett,0,11,30,30
1650172228799,MATH 142A,B02,083222,Chow; Bennett,0,12,30,30
1650172234823,MATH 193A,A01,083224,Staff,0,3,30,30
1650172234823,MATH 193A,A02,083225,Staff,0,4,30,30
1650172234823,MATH 193A,A03,083781,Staff,0,1,30,30
1650172234823,MATH 193A,A04,083782,Staff,0,1,30,30
1650172240845,MATH 197,001,091859,McAuley; Julian John,9998,0,9999,1
1650172246893,COGS 9,A01,083615,Staff,0,14,60,60
1650172252917,COGS 11,A01,083617,Boyle; Mary E. T.,24,0,40,16
1650172258941,COGS 13,A01,083071,Staff,0,30,40,40
1650172264966,COGS 14A,A01,092681,Staff,0,12,100,100
1650172270989,COGS 14B,A01,083073,Cheng; Tzu-Han,0,7,50,50
1650172277016,COGS 17,A01,092677,Staff,34,0,75,41
1650172283044,COGS 100,A01,083619,Staff,0,21,60,60
1650172289072,COGS 101A,A01,083621,Davis; Joshua Daniel,0,21,60,60
1650172295096,COGS 101B,A01,091572,Staff,6,0,60,54
1650172301122,COGS 101C,A01,083625,Delgado; Tania,20,0,30,10
1650172307150,COGS 107A,A01,083627,Boyle; Mary E. T.,0,7,60,60
1650172313175,COGS 118A,A01,083075,Staff,17,0,60,43
1650172319199,CSE 3,A50,083646,Miranda; Gregory Joseph,22,0,38,16
1650172319199,CSE 3,A51,083647,Miranda; Gregory Joseph,37,0,37,0
1650172325228,CSE 8A,A50,083650,Miranda; Gregory Joseph,1,17,40,39
1650172331252,CSE 11,A01,083080,Cao; Yingjun,0,66,40,40
1650172337279,CSE 12,A01,083652,Staff,0,5,100,100
1650172343302,CSE 15L,A01,083654,Staff,0,0,50,50
1650172343302,CSE 15L,A02,083655,Staff,8,0,50,42
1650172349329,CSE 20,A01,083657,Staff,54,0,80,26
1650172355350,CSE 30,A01,083084,Eldon; John,0,67,40,40
1650172361374,CSE 100,A01,083659,Cao; Yingjun,0,61,50,50
1650172367397,CSE 134B,A01,083661,Powell; Thomas Allan,0,27,65,65
1650172373422,CSE 140,A01,083663,Staff,1,0,75,74
1650172379453,CSE 140L,A01,083088,Eldon; John,0,4,75,75
1650172385477,CSE 175,A01,083665,Kumar; Rakesh,8,0,25,17
1650172391508,CSE 190,A00,092507,Dubnov; Shlomo,14,0,20,6
1650172397531,ECE 45,A01,083139,Staff,0,13,40,40
1650172403585,ECE 65,A50,083695,Staff,0,5,30,30
1650172409621,ECE 109,A01,091882,Touri; Behrouz,47,0,70,23
1650172415644,ECE 180,A00,083140,Abi Samra; Nicholas Camill,24,0,30,6
1650172415644,ECE 180,B00,083141,Abi Samra; Nicholas Camill,8,0,30,22
1650172421673,MATH 10A,A01,083735,Patchell; Gregory David,12,0,30,18
1650172421673,MATH 10A,A02,083736,Patchell; Gregory David,28,0,30,2
1650172421673,MATH 10A,A03,083737,Patchell; Gregory David,26,0,30,4
1650172427698,MATH 10B,A01,083207,Staff,0,5,30,30
1650172427698,MATH 10B,A02,083208,Staff,0,5,30,30
1650172427698,MATH 10B,B01,083739,Staff,17,0,30,13
1650172427698,MATH 10B,B02,083740,Staff,29,0,30,1
1650172433724,MATH 18,A01,083743,Staff,10,0,30,20
1650172433724,MATH 18,A02,083744,Staff,28,0,30,2
1650172433724,MATH 18,A03,083745,Staff,23,0,30,7
1650172433724,MATH 18,A04,083746,Staff,27,0,30,3
1650172433724,MATH 18,B01,083748,Staff,0,10,30,30
1650172433724,MATH 18,B02,083749,Staff,0,7,30,30
1650172433724,MATH 18,B03,083750,Staff,0,7,30,30
1650172433724,MATH 18,B04,083751,Staff,0,7,30,30
1650172439755,MATH 20A,A01,083754,Staff,26,0,40,14
1650172445778,MATH 20B,A01,083756,Staff,0,5,30,30
1650172445778,MATH 20B,A02,083757,Staff,0,4,30,30
1650172451804,MATH 20C,A01,083760,Staff,0,12,30,30
1650172451804,MATH 20C,A02,083761,Staff,0,12,30,30
1650172451804,MATH 20C,B01,083762,Staff,14,0,30,16
1650172451804,MATH 20C,B02,083763,Staff,28,0,30,2
1650172457827,MATH 20D,A01,083765,Staff,0,2,30,30
1650172457827,MATH 20D,A02,083766,Staff,10,0,30,20
1650172457827,MATH 20D,A03,083767,Staff,28,0,30,2
1650172463855,MATH 20E,A01,083771,Staff,8,0,30,22
1650172463855,MATH 20E,A02,083772,Staff,20,0,30,10
1650172463855,MATH 20E,B01,083773,Staff,0,0,30,30
1650172463855,MATH 20E,B02,083774,Staff,13,0,30,17
1650172469884,MATH 103A,A01,083777,Staff,0,9,30,30
1650172469884,MATH 103A,A02,083778,Staff,0,10,30,30
1650172469884,MATH 103A,B01,083779,Staff,1,10,30,29
1650172469884,MATH 103A,B02,083780,Staff,0,9,30,30
1650172475907,MATH 105,A01,085443,Staff,0,17,30,30
1650172481935,MATH 109,A01,083213,Anzaldo; Leesa B,0,3,30,30
1650172481935,MATH 109,A02,083214,Anzaldo; Leesa B,0,6,30,30
1650172481935,MATH 109,B01,083215,Anzaldo; Leesa B,0,4,30,30
1650172481935,MATH 109,B02,083216,Anzaldo; Leesa B,0,4,30,30
1650172487963,MATH 142A,A01,083219,Chow; Bennett,0,12,30,30
1650172487963,MATH 142A,A02,083220,Chow; Bennett,0,11,30,30
1650172487963,MATH 142A,B01,083221,Chow; Bennett,0,11,30,30
1650172487963,MATH 142A,B02,083222,Chow; Bennett,0,12,30,30
1650172493987,MATH 193A,A01,083224,Staff,0,3,30,30
1650172493987,MATH 193A,A02,083225,Staff,0,4,30,30
1650172493987,MATH 193A,A03,083781,Staff,0,1,30,30
1650172493987,MATH 193A,A04,083782,Staff,0,1,30,30
1650172500015,MATH 197,001,091859,McAuley; Julian John,9998,0,9999,1
1650172506079,COGS 9,A01,083615,Staff,0,14,60,60
1650172512105,COGS 11,A01,083617,Boyle; Mary E. T.,24,0,40,16
1650172518128,COGS 13,A01,083071,Staff,0,30,40,40
1650172524152,COGS 14A,A01,092681,Staff,0,12,100,100
1650172530182,COGS 14B,A01,083073,Cheng; Tzu-Han,0,7,50,50
1650172536206,COGS 17,A01,092677,Staff,34,0,75,41
1650172542233,COGS 100,A01,083619,Staff,0,21,60,60
1650172548256,COGS 101A,A01,083621,Davis; Joshua Daniel,0,21,60,60
1650172554299,COGS 101B,A01,091572,Staff,6,0,60,54
1650172560327,COGS 101C,A01,083625,Delgado; Tania,20,0,30,10
1650172566351,COGS 107A,A01,083627,Boyle; Mary E. T.,0,7,60,60
1650172572392,COGS 118A,A01,083075,Staff,17,0,60,43
1650172578416,CSE 3,A50,083646,Miranda; Gregory Joseph,22,0,38,16
1650172578416,CSE 3,A51,083647,Miranda; Gregory Joseph,37,0,37,0
1650172584440,CSE 8A,A50,083650,Miranda; Gregory Joseph,1,17,40,39
1650172590465,CSE 11,A01,083080,Cao; Yingjun,0,66,40,40
1650172596487,CSE 12,A01,083652,Staff,0,5,100,100
1650172602511,CSE 15L,A01,083654,Staff,0,0,50,50
1650172602511,CSE 15L,A02,083655,Staff,8,0,50,42
1650172608535,CSE 20,A01,083657,Staff,54,0,80,26
1650172614560,CSE 30,A01,083084,Eldon; John,0,67,40,40
1650172620591,CSE 100,A01,083659,Cao; Yingjun,0,61,50,50
1650172626614,CSE 134B,A01,083661,Powell; Thomas Allan,0,27,65,65
1650172632637,CSE 140,A01,083663,Staff,1,0,75,74
1650172638665,CSE 140L,A01,083088,Eldon; John,0,4,75,75
1650172644766,CSE 175,A01,083665,Kumar; Rakesh,8,0,25,17
1650172650793,CSE 190,A00,092507,Dubnov; Shlomo,14,0,20,6
1650172656819,ECE 45,A01,083139,Staff,0,13,40,40
1650172662850,ECE 65,A50,083695,Staff,0,5,30,30
1650172668876,ECE 109,A01,091882,Touri; Behrouz,47,0,70,23
1650172674900,ECE 180,A00,083140,Abi Samra; Nicholas Camill,24,0,30,6
1650172674900,ECE 180,B00,083141,Abi Samra; Nicholas Camill,8,0,30,22
1650172680928,MATH 10A,A01,083735,Patchell; Gregory David,12,0,30,18
1650172680928,MATH 10A,A02,083736,Patchell; Gregory David,28,0,30,2
1650172680928,MATH 10A,A03,083737,Patchell; Gregory David,26,0,30,4
1650172686954,MATH 10B,A01,083207,Staff,0,5,30,30
1650172686954,MATH 10B,A02,083208,Staff,0,5,30,30
1650172686954,MATH 10B,B01,083739,Staff,17,0,30,13
1650172686954,MATH 10B,B02,083740,Staff,29,0,30,1
1650172692978,MATH 18,A01,083743,Staff,10,0,30,20
1650172692978,MATH 18,A02,083744,Staff,28,0,30,2
1650172692978,MATH 18,A03,083745,Staff,23,0,30,7
1650172692978,MATH 18,A04,083746,Staff,27,0,30,3
1650172692978,MATH 18,B01,083748,Staff,0,10,30,30
1650172692978,MATH 18,B02,083749,Staff,0,7,30,30
1650172692978,MATH 18,B03,083750,Staff,0,7,30,30
1650172692978,MATH 18,B04,083751,Staff,0,7,30,30
1650172699002,MATH 20A,A01,083754,Staff,26,0,40,14
1650172705024,MATH 20B,A01,083756,Staff,0,5,30,30
1650172705024,MATH 20B,A02,083757,Staff,0,4,30,30
1650172711052,MATH 20C,A01,083760,Staff,0,12,30,30
1650172711052,MATH 20C,A02,083761,Staff,0,12,30,30
1650172711052,MATH 20C,B01,083762,Staff,14,0,30,16
1650172711052,MATH 20C,B02,083763,Staff,28,0,30,2
1650172717075,MATH 20D,A01,083765,Staff,0,2,30,30
1650172717075,MATH 20D,A02,083766,Staff,10,0,30,20
1650172717075,MATH 20D,A03,083767,Staff,28,0,30,2
1650172723096,MATH 20E,A01,083771,Staff,8,0,30,22
1650172723096,MATH 20E,A02,083772,Staff,20,0,30,10
1650172723096,MATH 20E,B01,083773,Staff,0,0,30,30
1650172723096,MATH 20E,B02,083774,Staff,13,0,30,17
1650172729120,MATH 103A,A01,083777,Staff,0,9,30,30
1650172729120,MATH 103A,A02,083778,Staff,0,10,30,30
1650172729120,MATH 103A,B01,083779,Staff,1,10,30,29
1650172729120,MATH 103A,B02,083780,Staff,0,9,30,30
1650172735144,MATH 105,A01,085443,Staff,0,17,30,30
1650172741169,MATH 109,A01,083213,Anzaldo; Leesa B,0,3,30,30
1650172741169,MATH 109,A02,083214,Anzaldo; Leesa B,0,6,30,30
1650172741169,MATH 109,B01,083215,Anzaldo; Leesa B,0,4,30,30
1650172741169,MATH 109,B02,083216,Anzaldo; Leesa B,0,4,30,30
1650172747193,MATH 142A,A01,083219,Chow; Bennett,0,12,30,30
1650172747193,MATH 142A,A02,083220,Chow; Bennett,0,11,30,30
1650172747193,MATH 142A,B01,083221,Chow; Bennett,0,11,30,30
1650172747193,MATH 142A,B02,083222,Chow; Bennett,0,12,30,30
1650172753220,MATH 193A,A01,083224,Staff,0,3,30,30
1650172753220,MATH 193A,A02,083225,Staff,0,4,30,30
1650172753220,MATH 193A,A03,083781,Staff,0,1,30,30
1650172753220,MATH 193A,A04,083782,Staff,0,1,30,30
1650172759246,MATH 197,001,091859,McAuley; Julian John,9998,0,9999,1
1650172765297,COGS 9,A01,083615,Staff,0,14,60,60
1650172771320,COGS 11,A01,083617,Boyle; Mary E. T.,24,0,40,16
1650172777344,COGS 13,A01,083071,Staff,0,30,40,40
1650172783378,COGS 14A,A01,092681,Staff,0,12,100,100
1650172789407,COGS 14B,A01,083073,Cheng; Tzu-Han,0,7,50,50
1650172795433,COGS 17,A01,092677,Staff,34,0,75,41
1650172801460,COGS 100,A01,083619,Staff,0,21,60,60
1650172807489,COGS 101A,A01,083621,Davis; Joshua Daniel,0,21,60,60
1650172813518,COGS 101B,A01,091572,Staff,6,0,60,54
1650172819546,COGS 101C,A01,083625,Delgado; Tania,20,0,30,10
1650172825571,COGS 107A,A01,083627,Boyle; Mary E. T.,0,7,60,60
1650172831606,COGS 118A,A01,083075,Staff,17,0,60,43
1650172837635,CSE 3,A50,083646,Miranda; Gregory Joseph,22,0,38,16
1650172837635,CSE 3,A51,083647,Miranda; Gregory Joseph,37,0,37,0
1650172843663,CSE 8A,A50,083650,Miranda; Gregory Joseph,1,18,40,39
1650172849687,CSE 11,A01,083080,Cao; Yingjun,0,66,40,40
1650172855714,CSE 12,A01,083652,Staff,0,5,100,100
1650172861741,CSE 15L,A01,083654,Staff,0,0,50,50
1650172861741,CSE 15L,A02,083655,Staff,8,0,50,42
1650172867773,CSE 20,A01,083657,Staff,54,0,80,26
1650172873804,CSE 30,A01,083084,Eldon; John,0,67,40,40
1650172879830,CSE 100,A01,083659,Cao; Yingjun,0,61,50,50
1650172885853,CSE 134B,A01,083661,Powell; Thomas Allan,0,27,65,65
1650172891880,CSE 140,A01,083663,Staff,1,0,75,74
1650172897907,CSE 140L,A01,083088,Eldon; John,0,4,75,75
1650172903934,CSE 175,A01,083665,Kumar; Rakesh,8,0,25,17
1650172909956,CSE 190,A00,092507,Dubnov; Shlomo,14,0,20,6
1650172915981,ECE 45,A01,083139,Staff,0,13,40,40
1650172922004,ECE 65,A50,083695,Staff,0,5,30,30
1650172928036,ECE 109,A01,091882,Touri; Behrouz,47,0,70,23
1650172934064,ECE 180,A00,083140,Abi Samra; Nicholas Camill,24,0,30,6
1650172934064,ECE 180,B00,083141,Abi Samra; Nicholas Camill,8,0,30,22
1650172940088,MATH 10A,A01,083735,Patchell; Gregory David,12,0,30,18
1650172940088,MATH 10A,A02,083736,Patchell; Gregory David,28,0,30,2
1650172940088,MATH 10A,A03,083737,Patchell; Gregory David,26,0,30,4
1650172946113,MATH 10B,A01,083207,Staff,0,5,30,30
1650172946113,MATH 10B,A02,083208,Staff,0,5,30,30
1650172946113,MATH 10B,B01,083739,Staff,17,0,30,13
1650172946113,MATH 10B,B02,083740,Staff,29,0,30,1
1650172952136,MATH 18,A01,083743,Staff,10,0,30,20
1650172952136,MATH 18,A02,083744,Staff,28,0,30,2
1650172952136,MATH 18,A03,083745,Staff,23,0,30,7
1650172952136,MATH 18,A04,083746,Staff,27,0,30,3
1650172952136,MATH 18,B01,083748,Staff,0,10,30,30
1650172952136,MATH 18,B02,083749,Staff,0,7,30,30
1650172952136,MATH 18,B03,083750,Staff,0,7,30,30
1650172952136,MATH 18,B04,083751,Staff,0,7,30,30
1650172958160,MATH 20A,A01,083754,Staff,26,0,40,14
1650172964185,MATH 20B,A01,083756,Staff,0,5,30,30
1650172964185,MATH 20B,A02,083757,Staff,0,4,30,30
1650172970211,MATH 20C,A01,083760,Staff,0,12,30,30
1650172970211,MATH 20C,A02,083761,Staff,0,12,30,30
1650172970211,MATH 20C,B01,083762,Staff,14,0,30,16
1650172970211,MATH 20C,B02,083763,Staff,28,0,30,2
1650172976235,MATH 20D,A01,083765,Staff,0,2,30,30
1650172976235,MATH 20D,A02,083766,Staff,10,0,30,20
1650172976235,MATH 20D,A03,083767,Staff,28,0,30,2
1650172982257,MATH 20E,A01,083771,Staff,8,0,30,22
1650172982257,MATH 20E,A02,083772,Staff,20,0,30,10
1650172982257,MATH 20E,B01,083773,Staff,0,0,30,30
1650172982257,MATH 20E,B02,083774,Staff,13,0,30,17
1650172988284,MATH 103A,A01,083777,Staff,0,9,30,30
1650172988284,MATH 103A,A02,083778,Staff,0,10,30,30
1650172988284,MATH 103A,B01,083779,Staff,1,10,30,29
1650172988284,MATH 103A,B02,083780,Staff,0,9,30,30
1650172994306,MATH 105,A01,085443,Staff,0,17,30,30
1650173000330,MATH 109,A01,083213,Anzaldo; Leesa B,0,3,30,30
1650173000330,MATH 109,A02,083214,Anzaldo; Leesa B,0,6,30,30
1650173000330,MATH 109,B01,083215,Anzaldo; Leesa B,0,4,30,30
1650173000330,MATH 109,B02,083216,Anzaldo; Leesa B,0,4,30,30
1650173006353,MATH 142A,A01,083219,Chow; Bennett,0,12,30,30
1650173006353,MATH 142A,A02,083220,Chow; Bennett,0,11,30,30
1650173006353,MATH 142A,B01,083221,Chow; Bennett,0,11,30,30
1650173006353,MATH 142A,B02,083222,Chow; Bennett,0,12,30,30
1650173012377,MATH 193A,A01,083224,Staff,0,3,30,30
1650173012377,MATH 193A,A02,083225,Staff,0,4,30,30
1650173012377,MATH 193A,A03,083781,Staff,0,1,30,30
1650173012377,MATH 193A,A04,083782,Staff,0,1,30,30
1650173018400,MATH 197,001,091859,McAuley; Julian John,9998,0,9999,1
1650173024453,COGS 9,A01,083615,Staff,0,14,60,60
1650173030476,COGS 11,A01,083617,Boyle; Mary E. T.,24,0,40,16
1650173036498,COGS 13,A01,083071,Staff,0,30,40,40
1650173042522,COGS 14A,A01,092681,Staff,0,12,100,100
1650173048549,COGS 14B,A01,083073,Cheng; Tzu-Han,0,7,50,50
1650173054576,COGS 17,A01,092677,Staff,34,0,75,41
1650173060613,COGS 100,A01,083619,Staff,0,21,60,60
1650173066642,COGS 101A,A01,083621,Davis; Joshua Daniel,0,21,60,60
1650173072667,COGS 101B,A01,091572,Staff,6,0,60,54
1650173078691,COGS 101C,A01,083625,Delgado; Tania,20,0,30,10
1650173084716,COGS 107A,A01,083627,Boyle; Mary E. T.,0,7,60,60
1650173090741,COGS 118A,A01,083075,Staff,17,0,60,43
1650173096768,CSE 3,A50,083646,Miranda; Gregory Joseph,22,0,38,16
1650173096768,CSE 3,A51,083647,Miranda; Gregory Joseph,37,0,37,0
1650173102793,CSE 8A,A50,083650,Miranda; Gregory Joseph,1,18,40,39
1650173108816,CSE 11,A01,083080,Cao; Yingjun,0,66,40,40
1650173114849,CSE 12,A01,083652,Staff,0,5,100,100
1650173120873,CSE 15L,A01,083654,Staff,0,0,50,50
1650173120873,CSE 15L,A02,083655,Staff,8,0,50,42
1650173126897,CSE 20,A01,083657,Staff,54,0,80,26
1650173132921,CSE 30,A01,083084,Eldon; John,0,67,40,40
1650173138945,CSE 100,A01,083659,Cao; Yingjun,0,61,50,50
1650173144969,CSE 134B,A01,083661,Powell; Thomas Allan,0,27,65,65
1650173150996,CSE 140,A01,083663,Staff,1,0,75,74
1650173157039,CSE 140L,A01,083088,Eldon; John,0,4,75,75
1650173163072,CSE 175,A01,083665,Kumar; Rakesh,8,0,25,17
1650173169096,CSE 190,A00,092507,Dubnov; Shlomo,14,0,20,6
1650173175121,ECE 45,A01,083139,Staff,0,13,40,40
1650173181145,ECE 65,A50,083695,Staff,0,5,30,30
1650173187173,ECE 109,A01,091882,Touri; Behrouz,47,0,70,23
1650173193198,ECE 180,A00,083140,Abi Samra; Nicholas Camill,24,0,30,6
1650173193198,ECE 180,B00,083141,Abi Samra; Nicholas Camill,8,0,30,22
1650173199222,MATH 10A,A01,083735,Patchell; Gregory David,12,0,30,18
1650173199222,MATH 10A,A02,083736,Patchell; Gregory David,28,0,30,2
1650173199222,MATH 10A,A03,083737,Patchell; Gregory David,26,0,30,4
1650173205247,MATH 10B,A01,083207,Staff,0,5,30,30
1650173205247,MATH 10B,A02,083208,Staff,0,5,30,30
1650173205247,MATH 10B,B01,083739,Staff,17,0,30,13
1650173205247,MATH 10B,B02,083740,Staff,29,0,30,1
1650173211278,MATH 18,A01,083743,Staff,10,0,30,20
1650173211278,MATH 18,A02,083744,Staff,28,0,30,2
1650173211278,MATH 18,A03,083745,Staff,23,0,30,7
1650173211278,MATH 18,A04,083746,Staff,27,0,30,3
1650173211278,MATH 18,B01,083748,Staff,0,10,30,30
1650173211278,MATH 18,B02,083749,Staff,0,7,30,30
1650173211278,MATH 18,B03,083750,Staff,0,7,30,30
1650173211278,MATH 18,B04,083751,Staff,0,7,30,30
1650173217303,MATH 20A,A01,083754,Staff,26,0,40,14
1650173223330,MATH 20B,A01,083756,Staff,0,5,30,30
1650173223330,MATH 20B,A02,083757,Staff,0,4,30,30
1650173229355,MATH 20C,A01,083760,Staff,0,12,30,30
1650173229355,MATH 20C,A02,083761,Staff,0,12,30,30
1650173229355,MATH 20C,B01,083762,Staff,14,0,30,16
1650173229355,MATH 20C,B02,083763,Staff,28,0,30,2
1650173235384,MATH 20D,A01,083765,Staff,0,2,30,30
1650173235384,MATH 20D,A02,083766,Staff,10,0,30,20
1650173235384,MATH 20D,A03,083767,Staff,28,0,30,2
1650173241488,MATH 20E,A01,083771,Staff,8,0,30,22
1650173241488,MATH 20E,A02,083772,Staff,20,0,30,10
1650173241488,MATH 20E,B01,083773,Staff,0,0,30,30
1650173241488,MATH 20E,B02,083774,Staff,13,0,30,17
1650173247518,MATH 103A,A01,083777,Staff,0,9,30,30
1650173247518,MATH 103A,A02,083778,Staff,0,10,30,30
1650173247518,MATH 103A,B01,083779,Staff,0,9,30,30
1650173247518,MATH 103A,B02,083780,Staff,0,9,30,30
1650173253541,MATH 105,A01,085443,Staff,0,17,30,30
1650173259569,MATH 109,A01,083213,Anzaldo; Leesa B,0,3,30,30
1650173259569,MATH 109,A02,083214,Anzaldo; Leesa B,0,6,30,30
1650173259569,MATH 109,B01,083215,Anzaldo; Leesa B,0,4,30,30
1650173259569,MATH 109,B02,083216,Anzaldo; Leesa B,0,4,30,30
1650173265596,MATH 142A,A01,083219,Chow; Bennett,0,12,30,30
1650173265596,MATH 142A,A02,083220,Chow; Bennett,0,11,30,30
1650173265596,MATH 142A,B01,083221,Chow; Bennett,0,11,30,30
1650173265596,MATH 142A,B02,083222,Chow; Bennett,0,12,30,30
1650173271619,MATH 193A,A01,083224,Staff,0,3,30,30
1650173271619,MATH 193A,A02,083225,Staff,0,4,30,30
1650173271619,MATH 193A,A03,083781,Staff,0,1,30,30
1650173271619,MATH 193A,A04,083782,Staff,0,1,30,30
1650173277643,MATH 197,001,091859,McAuley; Julian John,9998,0,9999,1
1650173283698,COGS 9,A01,083615,Staff,0,14,60,60
1650173289725,COGS 11,A01,083617,Boyle; Mary E. T.,24,0,40,16
1650173295757,COGS 13,A01,083071,Staff,0,30,40,40
1650173301781,COGS 14A,A01,092681,Staff,0,12,100,100
1650173307806,COGS 14B,A01,083073,Cheng; Tzu-Han,0,7,50,50
1650173313835,COGS 17,A01,092677,Staff,34,0,75,41
1650173319858,COGS 100,A01,083619,Staff,0,21,60,60
1650173325884,COGS 101A,A01,083621,Davis; Joshua Daniel,0,21,60,60
1650173331911,COGS 101B,A01,091572,Staff,6,0,60,54
1650173337934,COGS 101C,A01,083625,Delgado; Tania,20,0,30,10
1650173343958,COGS 107A,A01,083627,Boyle; Mary E. T.,0,7,60,60
1650173349981,COGS 118A,A01,083075,Staff,17,0,60,43
1650173356010,CSE 3,A50,083646,Miranda; Gregory Joseph,22,0,38,16
1650173356010,CSE 3,A51,083647,Miranda; Gregory Joseph,37,0,37,0
1650173362036,CSE 8A,A50,083650,Miranda; Gregory Joseph,0,17,40,40
1650173368063,CSE 11,A01,083080,Cao; Yingjun,0,66,40,40
1650173374094,CSE 12,A01,083652,Staff,0,5,100,100
1650173380117,CSE 15L,A01,083654,Staff,0,0,50,50
1650173380117,CSE 15L,A02,083655,Staff,8,0,50,42
1650173386141,CSE 20,A01,083657,Staff,54,0,80,26
1650173392163,CSE 30,A01,083084,Eldon; John,0,67,40,40
1650173398189,CSE 100,A01,083659,Cao; Yingjun,0,61,50,50
1650173404212,CSE 134B,A01,083661,Powell; Thomas Allan,0,27,65,65
1650173410238,CSE 140,A01,083663,Staff,1,0,75,74
1650173416264,CSE 140L,A01,083088,Eldon; John,0,4,75,75
1650173422286,CSE 175,A01,083665,Kumar; Rakesh,8,0,25,17
1650173428309,CSE 190,A00,092507,Dubnov; Shlomo,14,0,20,6
1650173434333,ECE 45,A01,083139,Staff,0,13,40,40
1650173440357,ECE 65,A50,083695,Staff,0,5,30,30
1650173446380,ECE 109,A01,091882,Touri; Behrouz,47,0,70,23
1650173452402,ECE 180,A00,083140,Abi Samra; Nicholas Camill,24,0,30,6
1650173452402,ECE 180,B00,083141,Abi Samra; Nicholas Camill,8,0,30,22
1650173458433,MATH 10A,A01,083735,Patchell; Gregory David,12,0,30,18
1650173458433,MATH 10A,A02,083736,Patchell; Gregory David,28,0,30,2
1650173458433,MATH 10A,A03,083737,Patchell; Gregory David,26,0,30,4
1650173464466,MATH 10B,A01,083207,Staff,0,5,30,30
1650173464466,MATH 10B,A02,083208,Staff,0,5,30,30
1650173464466,MATH 10B,B01,083739,Staff,17,0,30,13
1650173464466,MATH 10B,B02,083740,Staff,29,0,30,1
1650173470499,MATH 18,A01,083743,Staff,10,0,30,20
1650173470499,MATH 18,A02,083744,Staff,28,0,30,2
1650173470499,MATH 18,A03,083745,Staff,23,0,30,7
1650173470499,MATH 18,A04,083746,Staff,27,0,30,3
1650173470499,MATH 18,B01,083748,Staff,0,10,30,30
1650173470499,MATH 18,B02,083749,Staff,0,7,30,30
1650173470499,MATH 18,B03,083750,Staff,0,7,30,30
1650173470499,MATH 18,B04,083751,Staff,0,7,30,30
1650173476523,MATH 20A,A01,083754,Staff,26,0,40,14
1650173482546,MATH 20B,A01,083756,Staff,0,5,30,30
1650173482546,MATH 20B,A02,083757,Staff,0,4,30,30
1650173488573,MATH 20C,A01,083760,Staff,0,12,30,30
1650173488573,MATH 20C,A02,083761,Staff,0,12,30,30
1650173488573,MATH 20C,B01,083762,Staff,14,0,30,16
1650173488573,MATH 20C,B02,083763,Staff,28,0,30,2
1650173494599,MATH 20D,A01,083765,Staff,0,2,30,30
1650173494599,MATH 20D,A02,083766,Staff,10,0,30,20
1650173494599,MATH 20D,A03,083767,Staff,28,0,30,2
1650173500626,MATH 20E,A01,083771,Staff,8,0,30,22
1650173500626,MATH 20E,A02,083772,Staff,20,0,30,10
1650173500626,MATH 20E,B01,083773,Staff,0,0,30,30
1650173500626,MATH 20E,B02,083774,Staff,13,0,30,17
1650173506649,MATH 103A,A01,083777,Staff,0,9,30,30
1650173506649,MATH 103A,A02,083778,Staff,0,10,30,30
1650173506649,MATH 103A,B01,083779,Staff,0,9,30,30
1650173506649,MATH 103A,B02,083780,Staff,0,9,30,30
1650173512671,MATH 105,A01,085443,Staff,0,17,30,30
1650173518712,MATH 109,A01,083213,Anzaldo; Leesa B,0,3,30,30
1650173518712,MATH 109,A02,083214,Anzaldo; Leesa B,0,6,30,30
1650173518712,MATH 109,B01,083215,Anzaldo; Leesa B,0,4,30,30
1650173518712,MATH 109,B02,083216,Anzaldo; Leesa B,0,4,30,30
1650173524741,MATH 142A,A01,083219,Chow; Bennett,0,12,30,30
1650173524741,MATH 142A,A02,083220,Chow; Bennett,0,11,30,30
1650173524741,MATH 142A,B01,083221,Chow; Bennett,0,11,30,30
1650173524741,MATH 142A,B02,083222,Chow; Bennett,0,12,30,30
1650173530765,MATH 193A,A01,083224,Staff,0,3,30,30
1650173530765,MATH 193A,A02,083225,Staff,0,4,30,30
1650173530765,MATH 193A,A03,083781,Staff,0,1,30,30
1650173530765,MATH 193A,A04,083782,Staff,0,1,30,30
1650173536787,MATH 197,001,091859,McAuley; Julian John,9998,0,9999,1
1650173542845,COGS 9,A01,083615,Staff,0,14,60,60
1650173548894,COGS 11,A01,083617,Boyle; Mary E. T.,24,0,40,16
1650173554919,COGS 13,A01,083071,Staff,0,30,40,40
1650173560950,COGS 14A,A01,092681,Staff,0,12,100,100
1650173566974,COGS 14B,A01,083073,Cheng; Tzu-Han,0,7,50,50
1650173572997,COGS 17,A01,092677,Staff,34,0,75,41
1650173579024,COGS 100,A01,083619,Staff,0,21,60,60
1650173585047,COGS 101A,A01,083621,Davis; Joshua Daniel,0,21,60,60
1650173591076,COGS 101B,A01,091572,Staff,6,0,60,54
1650173597105,COGS 101C,A01,083625,Delgado; Tania,20,0,30,10
1650173603132,COGS 107A,A01,083627,Boyle; Mary E. T.,0,7,60,60
1650173609158,COGS 118A,A01,083075,Staff,17,0,60,43
1650173615184,CSE 3,A50,083646,Miranda; Gregory Joseph,22,0,38,16
1650173615184,CSE 3,A51,083647,Miranda; Gregory Joseph,37,0,37,0
1650173621212,CSE 8A,A50,083650,Miranda; Gregory Joseph,0,17,40,40
1650173627234,CSE 11,A01,083080,Cao; Yingjun,0,66,40,40
1650173633256,CSE 12,A01,083652,Staff,0,5,100,100
1650173639278,CSE 15L,A01,083654,Staff,0,0,50,50
1650173639278,CSE 15L,A02,083655,Staff,8,0,50,42
1650173645300,CSE 20,A01,083657,Staff,54,0,80,26
1650173651325,CSE 30,A01,083084,Eldon; John,0,67,40,40
1650173657348,CSE 100,A01,083659,Cao; Yingjun,0,61,50,50
1650173663388,CSE 134B,A01,083661,Powell; Thomas Allan,0,27,65,65
1650173669409,CSE 140,A01,083663,Staff,1,0,75,74
1650173675431,CSE 140L,A01,083088,Eldon; John,0,4,75,75
1650173681457,CSE 175,A01,083665,Kumar; Rakesh,8,0,25,17
1650173687479,CSE 190,A00,092507,Dubnov; Shlomo,14,0,20,6
1650173693513,ECE 45,A01,083139,Staff,0,13,40,40
1650173699535,ECE 65,A50,083695,Staff,0,5,30,30
1650173705559,ECE 109,A01,091882,Touri; Behrouz,47,0,70,23
1650173711580,ECE 180,A00,083140,Abi Samra; Nicholas Camill,24,0,30,6
1650173711580,ECE 180,B00,083141,Abi Samra; Nicholas Camill,8,0,30,22
1650173717607,MATH 10A,A01,083735,Patchell; Gregory David,12,0,30,18
1650173717607,MATH 10A,A02,083736,Patchell; Gregory David,28,0,30,2
1650173717607,MATH 10A,A03,083737,Patchell; Gregory David,26,0,30,4
1650173723632,MATH 10B,A01,083207,Staff,0,5,30,30
1650173723632,MATH 10B,A02,083208,Staff,0,5,30,30
1650173723632,MATH 10B,B01,083739,Staff,17,0,30,13
1650173723632,MATH 10B,B02,083740,Staff,29,0,30,1
1650173729663,MATH 18,A01,083743,Staff,10,0,30,20
1650173729663,MATH 18,A02,083744,Staff,28,0,30,2
1650173729663,MATH 18,A03,083745,Staff,23,0,30,7
1650173729663,MATH 18,A04,083746,Staff,27,0,30,3
1650173729663,MATH 18,B01,083748,Staff,0,10,30,30
1650173729663,MATH 18,B02,083749,Staff,0,7,30,30
1650173729663,MATH 18,B03,083750,Staff,0,7,30,30
1650173729663,MATH 18,B04,083751,Staff,0,7,30,30
1650173735690,MATH 20A,A01,083754,Staff,26,0,40,14
1650173741716,MATH 20B,A01,083756,Staff,0,5,30,30
1650173741716,MATH 20B,A02,083757,Staff,0,4,30,30
1650173747748,MATH 20C,A01,083760,Staff,0,12,30,30
1650173747748,MATH 20C,A02,083761,Staff,0,12,30,30
1650173747748,MATH 20C,B01,083762,Staff,14,0,30,16
1650173747748,MATH 20C,B02,083763,Staff,28,0,30,2
1650173753775,MATH 20D,A01,083765,Staff,0,2,30,30
1650173753775,MATH 20D,A02,083766,Staff,10,0,30,20
1650173753775,MATH 20D,A03,083767,Staff,28,0,30,2
1650173759798,MATH 20E,A01,083771,Staff,8,0,30,22
1650173759798,MATH 20E,A02,083772,Staff,20,0,30,10
1650173759798,MATH 20E,B01,083773,Staff,0,0,30,30
1650173759798,MATH 20E,B02,083774,Staff,13,0,30,17
1650173765820,MATH 103A,A01,083777,Staff,0,9,30,30
1650173765820,MATH 103A,A02,083778,Staff,0,10,30,30
1650173765820,MATH 103A,B01,083779,Staff,0,9,30,30
1650173765820,MATH 103A,B02,083780,Staff,0,9,30,30
1650173771850,MATH 105,A01,085443,Staff,0,17,30,30
1650173777878,MATH 109,A01,083213,Anzaldo; Leesa B,0,3,30,30
1650173777878,MATH 109,A02,083214,Anzaldo; Leesa B,0,6,30,30
1650173777878,MATH 109,B01,083215,Anzaldo; Leesa B,0,4,30,30
1650173777878,MATH 109,B02,083216,Anzaldo; Leesa B,0,4,30,30
1650173783901,MATH 142A,A01,083219,Chow; Bennett,0,12,30,30
1650173783901,MATH 142A,A02,083220,Chow; Bennett,0,11,30,30
1650173783901,MATH 142A,B01,083221,Chow; Bennett,0,11,30,30
1650173783901,MATH 142A,B02,083222,Chow; Bennett,0,12,30,30
1650173789923,MATH 193A,A01,083224,Staff,0,4,30,30
1650173789923,MATH 193A,A02,083225,Staff,0,4,30,30
1650173789923,MATH 193A,A03,083781,Staff,0,1,30,30
1650173789923,MATH 193A,A04,083782,Staff,0,1,30,30
1650173795948,MATH 197,001,091859,McAuley; Julian John,9998,0,9999,1
1650173802001,COGS 9,A01,083615,Staff,0,14,60,60
1650173808023,COGS 11,A01,083617,Boyle; Mary E. T.,24,0,40,16
1650173814047,COGS 13,A01,083071,Staff,0,30,40,40
1650173820076,COGS 14A,A01,092681,Staff,0,12,100,100
1650173826101,COGS 14B,A01,083073,Cheng; Tzu-Han,0,7,50,50
1650173832195,COGS 17,A01,092677,Staff,34,0,75,41
1650173838220,COGS 100,A01,083619,Staff,0,21,60,60
1650173844244,COGS 101A,A01,083621,Davis; Joshua Daniel,0,21,60,60
1650173850270,COGS 101B,A01,091572,Staff,6,0,60,54
1650173856297,COGS 101C,A01,083625,Delgado; Tania,20,0,30,10
1650173862321,COGS 107A,A01,083627,Boyle; Mary E. T.,0,7,60,60
1650173868345,COGS 118A,A01,083075,Staff,17,0,60,43
1650173874369,CSE 3,A50,083646,Miranda; Gregory Joseph,22,0,38,16
1650173874369,CSE 3,A51,083647,Miranda; Gregory Joseph,37,0,37,0
1650173880394,CSE 8A,A50,083650,Miranda; Gregory Joseph,0,17,40,40
1650173886418,CSE 11,A01,083080,Cao; Yingjun,0,66,40,40
1650173892446,CSE 12,A01,083652,Staff,0,5,100,100
1650173898471,CSE 15L,A01,083654,Staff,0,0,50,50
1650173898471,CSE 15L,A02,083655,Staff,8,0,50,42
1650173904496,CSE 20,A01,083657,Staff,54,0,80,26
1650173910522,CSE 30,A01,083084,Eldon; John,0,67,40,40
1650173916549,CSE 100,A01,083659,Cao; Yingjun,0,61,50,50
1650173922574,CSE 134B,A01,083661,Powell; Thomas Allan,0,27,65,65
1650173928600,CSE 140,A01,083663,Staff,1,0,75,74
1650173934624,CSE 140L,A01,083088,Eldon; John,0,4,75,75
1650173940652,CSE 175,A01,083665,Kumar; Rakesh,8,0,25,17
1650173946675,CSE 190,A00,092507,Dubnov; Shlomo,14,0,20,6
1650173952703,ECE 45,A01,083139,Staff,0,13,40,40
1650173958741,ECE 65,A50,083695,Staff,0,5,30,30
1650173964765,ECE 109,A01,091882,Touri; Behrouz,47,0,70,23
1650173970787,ECE 180,A00,083140,Abi Samra; Nicholas Camill,24,0,30,6
1650173970787,ECE 180,B00,083141,Abi Samra; Nicholas Camill,8,0,30,22
1650173976811,MATH 10A,A01,083735,Patchell; Gregory David,12,0,30,18
1650173976811,MATH 10A,A02,083736,Patchell; Gregory David,28,0,30,2
1650173976811,MATH 10A,A03,083737,Patchell; Gregory David,26,0,30,4
1650173982839,MATH 10B,A01,083207,Staff,0,5,30,30
1650173982839,MATH 10B,A02,083208,Staff,0,5,30,30
1650173982839,MATH 10B,B01,083739,Staff,17,0,30,13
1650173982839,MATH 10B,B02,083740,Staff,29,0,30,1
1650173988864,MATH 18,A01,083743,Staff,10,0,30,20
1650173988864,MATH 18,A02,083744,Staff,28,0,30,2
1650173988864,MATH 18,A03,083745,Staff,23,0,30,7
1650173988864,MATH 18,A04,083746,Staff,27,0,30,3
1650173988864,MATH 18,B01,083748,Staff,0,10,30,30
1650173988864,MATH 18,B02,083749,Staff,0,7,30,30
1650173988864,MATH 18,B03,083750,Staff,0,7,30,30
1650173988864,MATH 18,B04,083751,Staff,0,7,30,30
1650173994891,MATH 20A,A01,083754,Staff,26,0,40,14
1650174000915,MATH 20B,A01,083756,Staff,0,5,30,30
1650174000915,MATH 20B,A02,083757,Staff,0,5,30,30
1650174006947,MATH 20C,A01,083760,Staff,0,12,30,30
1650174006947,MATH 20C,A02,083761,Staff,0,12,30,30
1650174006947,MATH 20C,B01,083762,Staff,14,0,30,16
1650174006947,MATH 20C,B02,083763,Staff,28,0,30,2
1650174012972,MATH 20D,A01,083765,Staff,0,2,30,30
1650174012972,MATH 20D,A02,083766,Staff,10,0,30,20
1650174012972,MATH 20D,A03,083767,Staff,28,0,30,2
1650174018999,MATH 20E,A01,083771,Staff,8,0,30,22
1650174018999,MATH 20E,A02,083772,Staff,20,0,30,10
1650174018999,MATH 20E,B01,083773,Staff,0,0,30,30
1650174018999,MATH 20E,B02,083774,Staff,13,0,30,17
1650174025023,MATH 103A,A01,083777,Staff,0,9,30,30
1650174025023,MATH 103A,A02,083778,Staff,0,10,30,30
1650174025023,MATH 103A,B01,083779,Staff,0,9,30,30
1650174025023,MATH 103A,B02,083780,Staff,0,9,30,30
1650174031047,MATH 105,A01,085443,Staff,0,17,30,30
1650174037072,MATH 109,A01,083213,Anzaldo; Leesa B,0,3,30,30
1650174037072,MATH 109,A02,083214,Anzaldo; Leesa B,0,6,30,30
1650174037072,MATH 109,B01,083215,Anzaldo; Leesa B,0,4,30,30
1650174037072,MATH 109,B02,083216,Anzaldo; Leesa B,0,4,30,30
1650174043096,MATH 142A,A01,083219,Chow; Bennett,0,12,30,30
1650174043096,MATH 142A,A02,083220,Chow; Bennett,0,11,30,30
1650174043096,MATH 142A,B01,083221,Chow; Bennett,0,11,30,30
1650174043096,MATH 142A,B02,083222,Chow; Bennett,0,12,30,30
1650174049128,MATH 193A,A01,083224,Staff,0,4,30,30
1650174049128,MATH 193A,A02,083225,Staff,0,4,30,30
1650174049128,MATH 193A,A03,083781,Staff,0,1,30,30
1650174049128,MATH 193A,A04,083782,Staff,0,1,30,30
1650174055152,MATH 197,001,091859,McAuley; Julian John,9998,0,9999,1
1650174061214,COGS 9,A01,083615,Staff,0,14,60,60
1650174067244,COGS 11,A01,083617,Boyle; Mary E. T.,24,0,40,16
1650174073269,COGS 13,A01,083071,Staff,0,30,40,40
1650174079304,COGS 14A,A01,092681,Staff,0,12,100,100
1650174085328,COGS 14B,A01,083073,Cheng; Tzu-Han,0,7,50,50
1650174091352,COGS 17,A01,092677,Staff,34,0,75,41
1650174097374,COGS 100,A01,083619,Staff,0,21,60,60
1650174103399,COGS 101A,A01,083621,Davis; Joshua Daniel,0,21,60,60
1650174109424,COGS 101B,A01,091572,Staff,6,0,60,54
1650174115451,COGS 101C,A01,083625,Delgado; Tania,20,0,30,10
1650174121486,COGS 107A,A01,083627,Boyle; Mary E. T.,0,7,60,60
1650174127508,COGS 118A,A01,083075,Staff,17,0,60,43
1650174133530,CSE 3,A50,083646,Miranda; Gregory Joseph,22,0,38,16
1650174133530,CSE 3,A51,083647,Miranda; Gregory Joseph,37,0,37,0
1650174139554,CSE 8A,A50,083650,Miranda; Gregory Joseph,0,17,40,40
1650174145587,CSE 11,A01,083080,Cao; Yingjun,0,66,40,40
1650174151611,CSE 12,A01,083652,Staff,0,5,100,100
1650174157636,CSE 15L,A01,083654,Staff,0,0,50,50
1650174157636,CSE 15L,A02,083655,Staff,8,0,50,42
1650174163665,CSE 20,A01,083657,Staff,54,0,80,26
1650174169689,CSE 30,A01,083084,Eldon; John,0,67,40,40
1650174175724,CSE 100,A01,083659,Cao; Yingjun,0,61,50,50
1650174181752,CSE 134B,A01,083661,Powell; Thomas Allan,0,27,65,65
1650174187773,CSE 140,A01,083663,Staff,1,0,75,74
1650174193796,CSE 140L,A01,083088,Eldon; John,0,4,75,75
1650174199827,CSE 175,A01,083665,Kumar; Rakesh,8,0,25,17
1650174205850,CSE 190,A00,092507,Dubnov; Shlomo,14,0,20,6
1650174211881,ECE 45,A01,083139,Staff,0,13,40,40
1650174217904,ECE 65,A50,083695,Staff,0,5,30,30
1650174223929,ECE 109,A01,091882,Touri; Behrouz,47,0,70,23
1650174229956,ECE 180,A00,083140,Abi Samra; Nicholas Camill,24,0,30,6
1650174229956,ECE 180,B00,083141,Abi Samra; Nicholas Camill,8,0,30,22
1650174235980,MATH 10A,A01,083735,Patchell; Gregory David,12,0,30,18
1650174235980,MATH 10A,A02,083736,Patchell; Gregory David,28,0,30,2
1650174235980,MATH 10A,A03,083737,Patchell; Gregory David,26,0,30,4
1650174242004,MATH 10B,A01,083207,Staff,0,5,30,30
1650174242004,MATH 10B,A02,083208,Staff,0,5,30,30
1650174242004,MATH 10B,B01,083739,Staff,17,0,30,13
1650174242004,MATH 10B,B02,083740,Staff,29,0,30,1
1650174248029,MATH 18,A01,083743,Staff,10,0,30,20
1650174248029,MATH 18,A02,083744,Staff,28,0,30,2
1650174248029,MATH 18,A03,083745,Staff,23,0,30,7
1650174248029,MATH 18,A04,083746,Staff,27,0,30,3
1650174248029,MATH 18,B01,083748,Staff,0,10,30,30
1650174248029,MATH 18,B02,083749,Staff,0,7,30,30
1650174248029,MATH 18,B03,083750,Staff,0,7,30,30
1650174248029,MATH 18,B04,083751,Staff,0,7,30,30
1650174254053,MATH 20A,A01,083754,Staff,26,0,40,14
1650174260077,MATH 20B,A01,083756,Staff,0,5,30,30
1650174260077,MATH 20B,A02,083757,Staff,0,5,30,30
1650174266104,MATH 20C,A01,083760,Staff,0,12,30,30
1650174266104,MATH 20C,A02,083761,Staff,0,12,30,30
1650174266104,MATH 20C,B01,083762,Staff,14,0,30,16
1650174266104,MATH 20C,B02,083763,Staff,28,0,30,2
1650174272130,MATH 20D,A01,083765,Staff,0,2,30,30
1650174272130,MATH 20D,A02,083766,Staff,10,0,30,20
1650174272130,MATH 20D,A03,083767,Staff,28,0,30,2
1650174278156,MATH 20E,A01,083771,Staff,8,0,30,22
1650174278156,MATH 20E,A02,083772,Staff,20,0,30,10
1650174278156,MATH 20E,B01,083773,Staff,0,0,30,30
1650174278156,MATH 20E,B02,083774,Staff,13,0,30,17
1650174284184,MATH 103A,A01,083777,Staff,0,9,30,30
1650174284184,MATH 103A,A02,083778,Staff,0,10,30,30
1650174284184,MATH 103A,B01,083779,Staff,0,9,30,30
1650174284184,MATH 103A,B02,083780,Staff,0,9,30,30
1650174290209,MATH 105,A01,085443,Staff,0,17,30,30
1650174296235,MATH 109,A01,083213,Anzaldo; Leesa B,0,3,30,30
1650174296235,MATH 109,A02,083214,Anzaldo; Leesa B,0,6,30,30
1650174296235,MATH 109,B01,083215,Anzaldo; Leesa B,0,4,30,30
1650174296235,MATH 109,B02,083216,Anzaldo; Leesa B,0,4,30,30
1650174302262,MATH 142A,A01,083219,Chow; Bennett,0,12,30,30
1650174302262,MATH 142A,A02,083220,Chow; Bennett,0,11,30,30
1650174302262,MATH 142A,B01,083221,Chow; Bennett,0,11,30,30
1650174302262,MATH 142A,B02,083222,Chow; Bennett,0,12,30,30
1650174308291,MATH 193A,A01,083224,Staff,0,4,30,30
1650174308291,MATH 193A,A02,083225,Staff,0,4,30,30
1650174308291,MATH 193A,A03,083781,Staff,0,1,30,30
1650174308291,MATH 193A,A04,083782,Staff,0,1,30,30
1650174314317,MATH 197,001,091859,McAuley; Julian John,9998,0,9999,1
1650174320365,COGS 9,A01,083615,Staff,0,14,60,60
1650174326390,COGS 11,A01,083617,Boyle; Mary E. T.,24,0,40,16
1650174332417,COGS 13,A01,083071,Staff,0,30,40,40
1650174338442,COGS 14A,A01,092681,Staff,0,12,100,100
1650174344468,COGS 14B,A01,083073,Cheng; Tzu-Han,0,7,50,50
1650174350494,COGS 17,A01,092677,Staff,34,0,75,41
1650174356519,COGS 100,A01,083619,Staff,0,21,60,60
1650174362546,COGS 101A,A01,083621,Davis; Joshua Daniel,0,21,60,60
1650174368573,COGS 101B,A01,091572,Staff,6,0,60,54
1650174374596,COGS 101C,A01,083625,Delgado; Tania,20,0,30,10
1650174380620,COGS 107A,A01,083627,Boyle; Mary E. T.,0,7,60,60
1650174386643,COGS 118A,A01,083075,Staff,17,0,60,43
1650174392678,CSE 3,A50,083646,Miranda; Gregory Joseph,22,0,38,16
1650174392678,CSE 3,A51,083647,Miranda; Gregory Joseph,37,0,37,0
1650174398706,CSE 8A,A50,083650,Miranda; Gregory Joseph,0,17,40,40
1650174404744,CSE 11,A01,083080,Cao; Yingjun,0,66,40,40
1650174410771,CSE 12,A01,083652,Staff,0,5,100,100
1650174416794,CSE 15L,A01,083654,Staff,0,0,50,50
1650174416794,CSE 15L,A02,083655,Staff,8,0,50,42
1650174422820,CSE 20,A01,083657,Staff,54,0,80,26
1650174428924,CSE 30,A01,083084,Eldon; John,0,67,40,40
1650174434946,CSE 100,A01,083659,Cao; Yingjun,0,61,50,50
1650174440970,CSE 134B,A01,083661,Powell; Thomas Allan,0,27,65,65
1650174446993,CSE 140,A01,083663,Staff,1,0,75,74
1650174453023,CSE 140L,A01,083088,Eldon; John,0,4,75,75
1650174459046,CSE 175,A01,083665,Kumar; Rakesh,8,0,25,17
1650174465069,CSE 190,A00,092507,Dubnov; Shlomo,14,0,20,6
1650174471093,ECE 45,A01,083139,Staff,0,13,40,40
1650174477117,ECE 65,A50,083695,Staff,0,5,30,30
1650174483139,ECE 109,A01,091882,Touri; Behrouz,47,0,70,23
1650174489165,ECE 180,A00,083140,Abi Samra; Nicholas Camill,24,0,30,6
1650174489165,ECE 180,B00,083141,Abi Samra; Nicholas Camill,8,0,30,22
1650174495194,MATH 10A,A01,083735,Patchell; Gregory David,12,0,30,18
1650174495194,MATH 10A,A02,083736,Patchell; Gregory David,28,0,30,2
1650174495194,MATH 10A,A03,083737,Patchell; Gregory David,26,0,30,4
1650174501229,MATH 10B,A01,083207,Staff,0,5,30,30
1650174501229,MATH 10B,A02,083208,Staff,0,5,30,30
1650174501229,MATH 10B,B01,083739,Staff,17,0,30,13
1650174501229,MATH 10B,B02,083740,Staff,29,0,30,1
1650174507257,MATH 18,A01,083743,Staff,10,0,30,20
1650174507257,MATH 18,A02,083744,Staff,28,0,30,2
1650174507257,MATH 18,A03,083745,Staff,23,0,30,7
1650174507257,MATH 18,A04,083746,Staff,27,0,30,3
1650174507257,MATH 18,B01,083748,Staff,0,10,30,30
1650174507257,MATH 18,B02,083749,Staff,0,7,30,30
1650174507257,MATH 18,B03,083750,Staff,0,7,30,30
1650174507257,MATH 18,B04,083751,Staff,0,7,30,30
1650174513280,MATH 20A,A01,083754,Staff,26,0,40,14
1650174519304,MATH 20B,A01,083756,Staff,0,5,30,30
1650174519304,MATH 20B,A02,083757,Staff,0,5,30,30
1650174525331,MATH 20C,A01,083760,Staff,0,12,30,30
1650174525331,MATH 20C,A02,083761,Staff,0,12,30,30
1650174525331,MATH 20C,B01,083762,Staff,14,0,30,16
1650174525331,MATH 20C,B02,083763,Staff,28,0,30,2
1650174531364,MATH 20D,A01,083765,Staff,0,2,30,30
1650174531364,MATH 20D,A02,083766,Staff,10,0,30,20
1650174531364,MATH 20D,A03,083767,Staff,28,0,30,2
1650174537388,MATH 20E,A01,083771,Staff,8,0,30,22
1650174537388,MATH 20E,A02,083772,Staff,20,0,30,10
1650174537388,MATH 20E,B01,083773,Staff,0,0,30,30
1650174537388,MATH 20E,B02,083774,Staff,13,0,30,17
1650174543411,MATH 103A,A01,083777,Staff,0,9,30,30
1650174543411,MATH 103A,A02,083778,Staff,0,10,30,30
1650174543411,MATH 103A,B01,083779,Staff,0,9,30,30
1650174543411,MATH 103A,B02,083780,Staff,0,9,30,30
1650174549435,MATH 105,A01,085443,Staff,0,17,30,30
1650174555459,MATH 109,A01,083213,Anzaldo; Leesa B,0,3,30,30
1650174555459,MATH 109,A02,083214,Anzaldo; Leesa B,0,6,30,30
1650174555459,MATH 109,B01,083215,Anzaldo; Leesa B,0,4,30,30
1650174555459,MATH 109,B02,083216,Anzaldo; Leesa B,0,4,30,30
1650174561484,MATH 142A,A01,083219,Chow; Bennett,0,12,30,30
1650174561484,MATH 142A,A02,083220,Chow; Bennett,0,11,30,30
1650174561484,MATH 142A,B01,083221,Chow; Bennett,0,11,30,30
1650174561484,MATH 142A,B02,083222,Chow; Bennett,0,12,30,30
1650174567510,MATH 193A,A01,083224,Staff,0,4,30,30
1650174567510,MATH 193A,A02,083225,Staff,0,4,30,30
1650174567510,MATH 193A,A03,083781,Staff,0,1,30,30
1650174567510,MATH 193A,A04,083782,Staff,0,1,30,30
1650174573541,MATH 197,001,091859,McAuley; Julian John,9998,0,9999,1
1650174579592,COGS 9,A01,083615,Staff,0,14,60,60
1650174585615,COGS 11,A01,083617,Boyle; Mary E. T.,24,0,40,16
1650174591642,COGS 13,A01,083071,Staff,0,30,40,40
1650174597669,COGS 14A,A01,092681,Staff,0,12,100,100
1650174603695,COGS 14B,A01,083073,Cheng; Tzu-Han,0,7,50,50
1650174609719,COGS 17,A01,092677,Staff,34,0,75,41
1650174615745,COGS 100,A01,083619,Staff,0,21,60,60
1650174621772,COGS 101A,A01,083621,Davis; Joshua Daniel,0,21,60,60
1650174627798,COGS 101B,A01,091572,Staff,6,0,60,54
1650174633833,COGS 101C,A01,083625,Delgado; Tania,20,0,30,10
1650174639857,COGS 107A,A01,083627,Boyle; Mary E. T.,0,7,60,60
1650174645886,COGS 118A,A01,083075,Staff,17,0,60,43
1650174651914,CSE 3,A50,083646,Miranda; Gregory Joseph,22,0,38,16
1650174651914,CSE 3,A51,083647,Miranda; Gregory Joseph,37,0,37,0
1650174657942,CSE 8A,A50,083650,Miranda; Gregory Joseph,0,17,40,40
1650174663971,CSE 11,A01,083080,Cao; Yingjun,0,66,40,40
1650174669995,CSE 12,A01,083652,Staff,0,5,100,100
1650174676021,CSE 15L,A01,083654,Staff,0,0,50,50
1650174676021,CSE 15L,A02,083655,Staff,8,0,50,42
1650174682047,CSE 20,A01,083657,Staff,54,0,80,26
1650174688084,CSE 30,A01,083084,Eldon; John,0,67,40,40
1650174694113,CSE 100,A01,083659,Cao; Yingjun,0,61,50,50
1650174700136,CSE 134B,A01,083661,Powell; Thomas Allan,0,27,65,65
1650174706159,CSE 140,A01,083663,Staff,1,0,75,74
1650174712183,CSE 140L,A01,083088,Eldon; John,0,4,75,75
1650174718206,CSE 175,A01,083665,Kumar; Rakesh,8,0,25,17
1650174724238,CSE 190,A00,092507,Dubnov; Shlomo,14,0,20,6
1650174730260,ECE 45,A01,083139,Staff,0,13,40,40
1650174736284,ECE 65,A50,083695,Staff,0,5,30,30
1650174742309,ECE 109,A01,091882,Touri; Behrouz,47,0,70,23
1650174748340,ECE 180,A00,083140,Abi Samra; Nicholas Camill,24,0,30,6
1650174748340,ECE 180,B00,083141,Abi Samra; Nicholas Camill,8,0,30,22
1650174754368,MATH 10A,A01,083735,Patchell; Gregory David,12,0,30,18
1650174754368,MATH 10A,A02,083736,Patchell; Gregory David,28,0,30,2
1650174754368,MATH 10A,A03,083737,Patchell; Gregory David,26,0,30,4
1650174760396,MATH 10B,A01,083207,Staff,0,5,30,30
1650174760396,MATH 10B,A02,083208,Staff,0,5,30,30
1650174760396,MATH 10B,B01,083739,Staff,17,0,30,13
1650174760396,MATH 10B,B02,083740,Staff,29,0,30,1
1650174766421,MATH 18,A01,083743,Staff,10,0,30,20
1650174766421,MATH 18,A02,083744,Staff,28,0,30,2
1650174766421,MATH 18,A03,083745,Staff,23,0,30,7
1650174766421,MATH 18,A04,083746,Staff,27,0,30,3
1650174766421,MATH 18,B01,083748,Staff,0,10,30,30
1650174766421,MATH 18,B02,083749,Staff,0,7,30,30
1650174766421,MATH 18,B03,083750,Staff,0,7,30,30
1650174766421,MATH 18,B04,083751,Staff,0,7,30,30
1650174772443,MATH 20A,A01,083754,Staff,26,0,40,14
1650174778467,MATH 20B,A01,083756,Staff,0,5,30,30
1650174778467,MATH 20B,A02,083757,Staff,0,5,30,30
1650174784495,MATH 20C,A01,083760,Staff,0,12,30,30
1650174784495,MATH 20C,A02,083761,Staff,0,12,30,30
1650174784495,MATH 20C,B01,083762,Staff,14,0,30,16
1650174784495,MATH 20C,B02,083763,Staff,28,0,30,2
1650174790522,MATH 20D,A01,083765,Staff,0,2,30,30
1650174790522,MATH 20D,A02,083766,Staff,10,0,30,20
1650174790522,MATH 20D,A03,083767,Staff,28,0,30,2
1650174796546,MATH 20E,A01,083771,Staff,8,0,30,22
1650174796546,MATH 20E,A02,083772,Staff,20,0,30,10
1650174796546,MATH 20E,B01,083773,Staff,0,0,30,30
1650174796546,MATH 20E,B02,083774,Staff,13,0,30,17
1650174802569,MATH 103A,A01,083777,Staff,0,9,30,30
1650174802569,MATH 103A,A02,083778,Staff,0,10,30,30
1650174802569,MATH 103A,B01,083779,Staff,0,9,30,30
1650174802569,MATH 103A,B02,083780,Staff,0,9,30,30
1650174808599,MATH 105,A01,085443,Staff,0,17,30,30
1650174814625,MATH 109,A01,083213,Anzaldo; Leesa B,0,3,30,30
1650174814625,MATH 109,A02,083214,Anzaldo; Leesa B,0,6,30,30
1650174814625,MATH 109,B01,083215,Anzaldo; Leesa B,0,4,30,30
1650174814625,MATH 109,B02,083216,Anzaldo; Leesa B,0,4,30,30
1650174820649,MATH 142A,A01,083219,Chow; Bennett,0,12,30,30
1650174820649,MATH 142A,A02,083220,Chow; Bennett,0,11,30,30
1650174820649,MATH 142A,B01,083221,Chow; Bennett,0,11,30,30
1650174820649,MATH 142A,B02,083222,Chow; Bennett,0,12,30,30
1650174826673,MATH 193A,A01,083224,Staff,0,4,30,30
1650174826673,MATH 193A,A02,083225,Staff,0,4,30,30
1650174826673,MATH 193A,A03,083781,Staff,0,1,30,30
1650174826673,MATH 193A,A04,083782,Staff,0,1,30,30
1650174832698,MATH 197,001,091859,McAuley; Julian John,9998,0,9999,1
1650174838751,COGS 9,A01,083615,Staff,0,14,60,60
1650174844774,COGS 11,A01,083617,Boyle; Mary E. T.,24,0,40,16
1650174850798,COGS 13,A01,083071,Staff,0,30,40,40
1650174856824,COGS 14A,A01,092681,Staff,0,12,100,100
1650174862848,COGS 14B,A01,083073,Cheng; Tzu-Han,0,7,50,50
1650174868875,COGS 17,A01,092677,Staff,34,0,75,41
1650174874899,COGS 100,A01,083619,Staff,0,21,60,60
1650174880925,COGS 101A,A01,083621,Davis; Joshua Daniel,0,21,60,60
1650174886950,COGS 101B,A01,091572,Staff,6,0,60,54
1650174892974,COGS 101C,A01,083625,Delgado; Tania,20,0,30,10
1650174898998,COGS 107A,A01,083627,Boyle; Mary E. T.,0,7,60,60
1650174905025,COGS 118A,A01,083075,Staff,17,0,60,43
1650174911052,CSE 3,A50,083646,Miranda; Gregory Joseph,22,0,38,16
1650174911052,CSE 3,A51,083647,Miranda; Gregory Joseph,37,0,37,0
1650174917076,CSE 8A,A50,083650,Miranda; Gregory Joseph,0,17,40,40
1650174923100,CSE 11,A01,083080,Cao; Yingjun,0,66,40,40
1650174929126,CSE 12,A01,083652,Staff,0,5,100,100
1650174935151,CSE 15L,A01,083654,Staff,0,0,50,50
1650174935151,CSE 15L,A02,083655,Staff,8,0,50,42
1650174941179,CSE 20,A01,083657,Staff,54,0,80,26
1650174947203,CSE 30,A01,083084,Eldon; John,0,67,40,40
1650174953231,CSE 100,A01,083659,Cao; Yingjun,0,61,50,50
1650174959256,CSE 134B,A01,083661,Powell; Thomas Allan,0,27,65,65
1650174965278,CSE 140,A01,083663,Staff,1,0,75,74
1650174971304,CSE 140L,A01,083088,Eldon; John,0,4,75,75
1650174977326,CSE 175,A01,083665,Kumar; Rakesh,8,0,25,17
1650174983347,CSE 190,A00,092507,Dubnov; Shlomo,14,0,20,6
1650174989371,ECE 45,A01,083139,Staff,0,13,40,40
1650174995395,ECE 65,A50,083695,Staff,0,5,30,30
1650175001425,ECE 109,A01,091882,Touri; Behrouz,47,0,70,23
1650175007449,ECE 180,A00,083140,Abi Samra; Nicholas Camill,24,0,30,6
1650175007449,ECE 180,B00,083141,Abi Samra; Nicholas Camill,8,0,30,22
1650175013485,MATH 10A,A01,083735,Patchell; Gregory David,12,0,30,18
1650175013485,MATH 10A,A02,083736,Patchell; Gregory David,28,0,30,2
1650175013485,MATH 10A,A03,083737,Patchell; Gregory David,26,0,30,4
1650175019521,MATH 10B,A01,083207,Staff,0,5,30,30
1650175019521,MATH 10B,A02,083208,Staff,0,5,30,30
1650175019521,MATH 10B,B01,083739,Staff,17,0,30,13
1650175019521,MATH 10B,B02,083740,Staff,29,0,30,1
1650175025633,MATH 18,A01,083743,Staff,10,0,30,20
1650175025633,MATH 18,A02,083744,Staff,28,0,30,2
1650175025633,MATH 18,A03,083745,Staff,23,0,30,7
1650175025633,MATH 18,A04,083746,Staff,27,0,30,3
1650175025633,MATH 18,B01,083748,Staff,0,10,30,30
1650175025633,MATH 18,B02,083749,Staff,0,7,30,30
1650175025633,MATH 18,B03,083750,Staff,0,7,30,30
1650175025633,MATH 18,B04,083751,Staff,0,7,30,30
1650175031656,MATH 20A,A01,083754,Staff,26,0,40,14
1650175037692,MATH 20B,A01,083756,Staff,0,5,30,30
1650175037692,MATH 20B,A02,083757,Staff,0,5,30,30
1650175043716,MATH 20C,A01,083760,Staff,0,12,30,30
1650175043716,MATH 20C,A02,083761,Staff,0,12,30,30
1650175043716,MATH 20C,B01,083762,Staff,14,0,30,16
1650175043716,MATH 20C,B02,083763,Staff,28,0,30,2
1650175049743,MATH 20D,A01,083765,Staff,0,2,30,30
1650175049743,MATH 20D,A02,083766,Staff,10,0,30,20
1650175049743,MATH 20D,A03,083767,Staff,28,0,30,2
1650175055767,MATH 20E,A01,083771,Staff,8,0,30,22
1650175055767,MATH 20E,A02,083772,Staff,20,0,30,10
1650175055767,MATH 20E,B01,083773,Staff,0,0,30,30
1650175055767,MATH 20E,B02,083774,Staff,13,0,30,17
1650175061794,MATH 103A,A01,083777,Staff,0,9,30,30
1650175061794,MATH 103A,A02,083778,Staff,0,10,30,30
1650175061794,MATH 103A,B01,083779,Staff,0,9,30,30
1650175061794,MATH 103A,B02,083780,Staff,0,9,30,30
1650175067818,MATH 105,A01,085443,Staff,0,17,30,30
1650175073841,MATH 109,A01,083213,Anzaldo; Leesa B,0,3,30,30
1650175073841,MATH 109,A02,083214,Anzaldo; Leesa B,0,6,30,30
1650175073841,MATH 109,B01,083215,Anzaldo; Leesa B,0,4,30,30
1650175073841,MATH 109,B02,083216,Anzaldo; Leesa B,0,4,30,30
1650175079868,MATH 142A,A01,083219,Chow; Bennett,0,12,30,30
1650175079868,MATH 142A,A02,083220,Chow; Bennett,0,11,30,30
1650175079868,MATH 142A,B01,083221,Chow; Bennett,0,11,30,30
1650175079868,MATH 142A,B02,083222,Chow; Bennett,0,12,30,30
1650175085910,MATH 193A,A01,083224,Staff,0,4,30,30
1650175085910,MATH 193A,A02,083225,Staff,0,4,30,30
1650175085910,MATH 193A,A03,083781,Staff,0,1,30,30
1650175085910,MATH 193A,A04,083782,Staff,0,1,30,30
1650175091934,MATH 197,001,091859,McAuley; Julian John,9998,0,9999,1
1650175097984,COGS 9,A01,083615,Staff,0,14,60,60
1650175104017,COGS 11,A01,083617,Boyle; Mary E. T.,24,0,40,16
1650175110043,COGS 13,A01,083071,Staff,0,30,40,40
1650175116066,COGS 14A,A01,092681,Staff,0,12,100,100
1650175122089,COGS 14B,A01,083073,Cheng; Tzu-Han,0,7,50,50
1650175128112,COGS 17,A01,092677,Staff,34,0,75,41
1650175134136,COGS 100,A01,083619,Staff,0,21,60,60
1650175140169,COGS 101A,A01,083621,Davis; Joshua Daniel,0,21,60,60
1650175146199,COGS 101B,A01,091572,Staff,6,0,60,54
1650175152237,COGS 101C,A01,083625,Delgado; Tania,20,0,30,10
1650175158270,COGS 107A,A01,083627,Boyle; Mary E. T.,0,7,60,60
1650175164295,COGS 118A,A01,083075,Staff,17,0,60,43
1650175170318,CSE 3,A50,083646,Miranda; Gregory Joseph,22,0,38,16
1650175170318,CSE 3,A51,083647,Miranda; Gregory Joseph,37,0,37,0
1650175176346,CSE 8A,A50,083650,Miranda; Gregory Joseph,0,17,40,40
1650175182373,CSE 11,A01,083080,Cao; Yingjun,0,66,40,40
1650175188398,CSE 12,A01,083652,Staff,0,5,100,100
1650175194422,CSE 15L,A01,083654,Staff,0,0,50,50
1650175194422,CSE 15L,A02,083655,Staff,8,0,50,42
1650175200444,CSE 20,A01,083657,Staff,54,0,80,26
1650175206479,CSE 30,A01,083084,Eldon; John,0,67,40,40
1650175212501,CSE 100,A01,083659,Cao; Yingjun,0,61,50,50
1650175218525,CSE 134B,A01,083661,Powell; Thomas Allan,0,27,65,65
1650175224554,CSE 140,A01,083663,Staff,1,0,75,74
1650175230578,CSE 140L,A01,083088,Eldon; John,0,4,75,75
1650175236602,CSE 175,A01,083665,Kumar; Rakesh,8,0,25,17
1650175242629,CSE 190,A00,092507,Dubnov; Shlomo,14,0,20,6
1650175248655,ECE 45,A01,083139,Staff,0,13,40,40
1650175254681,ECE 65,A50,083695,Staff,0,5,30,30
1650175260705,ECE 109,A01,091882,Touri; Behrouz,47,0,70,23
1650175266730,ECE 180,A00,083140,Abi Samra; Nicholas Camill,24,0,30,6
1650175266730,ECE 180,B00,083141,Abi Samra; Nicholas Camill,8,0,30,22
1650175272765,MATH 10A,A01,083735,Patchell; Gregory David,12,0,30,18
1650175272765,MATH 10A,A02,083736,Patchell; Gregory David,28,0,30,2
1650175272765,MATH 10A,A03,083737,Patchell; Gregory David,26,0,30,4
1650175278794,MATH 10B,A01,083207,Staff,0,5,30,30
1650175278794,MATH 10B,A02,083208,Staff,0,5,30,30
1650175278794,MATH 10B,B01,083739,Staff,17,0,30,13
1650175278794,MATH 10B,B02,083740,Staff,29,0,30,1
1650175284826,MATH 18,A01,083743,Staff,10,0,30,20
1650175284826,MATH 18,A02,083744,Staff,28,0,30,2
1650175284826,MATH 18,A03,083745,Staff,23,0,30,7
1650175284826,MATH 18,A04,083746,Staff,27,0,30,3
1650175284826,MATH 18,B01,083748,Staff,0,10,30,30
1650175284826,MATH 18,B02,083749,Staff,0,7,30,30
1650175284826,MATH 18,B03,083750,Staff,0,7,30,30
1650175284826,MATH 18,B04,083751,Staff,0,7,30,30
1650175290853,MATH 20A,A01,083754,Staff,26,0,40,14
1650175296880,MATH 20B,A01,083756,Staff,0,5,30,30
1650175296880,MATH 20B,A02,083757,Staff,0,5,30,30
1650175302904,MATH 20C,A01,083760,Staff,0,12,30,30
1650175302904,MATH 20C,A02,083761,Staff,0,12,30,30
1650175302904,MATH 20C,B01,083762,Staff,14,0,30,16
1650175302904,MATH 20C,B02,083763,Staff,28,0,30,2
1650175308928,MATH 20D,A01,083765,Staff,0,2,30,30
1650175308928,MATH 20D,A02,083766,Staff,10,0,30,20
1650175308928,MATH 20D,A03,083767,Staff,28,0,30,2
1650175314958,MATH 20E,A01,083771,Staff,8,0,30,22
1650175314958,MATH 20E,A02,083772,Staff,20,0,30,10
1650175314958,MATH 20E,B01,083773,Staff,0,0,30,30
1650175314958,MATH 20E,B02,083774,Staff,13,0,30,17
1650175320982,MATH 103A,A01,083777,Staff,0,9,30,30
1650175320982,MATH 103A,A02,083778,Staff,0,10,30,30
1650175320982,MATH 103A,B01,083779,Staff,0,9,30,30
1650175320982,MATH 103A,B02,083780,Staff,0,9,30,30
1650175327016,MATH 105,A01,085443,Staff,0,17,30,30
1650175333039,MATH 109,A01,083213,Anzaldo; Leesa B,0,3,30,30
1650175333039,MATH 109,A02,083214,Anzaldo; Leesa B,0,6,30,30
1650175333039,MATH 109,B01,083215,Anzaldo; Leesa B,0,4,30,30
1650175333039,MATH 109,B02,083216,Anzaldo; Leesa B,0,4,30,30
1650175339063,MATH 142A,A01,083219,Chow; Bennett,0,12,30,30
1650175339063,MATH 142A,A02,083220,Chow; Bennett,0,11,30,30
1650175339063,MATH 142A,B01,083221,Chow; Bennett,0,11,30,30
1650175339063,MATH 142A,B02,083222,Chow; Bennett,0,12,30,30
1650175345100,MATH 193A,A01,083224,Staff,0,4,30,30
1650175345100,MATH 193A,A02,083225,Staff,0,4,30,30
1650175345100,MATH 193A,A03,083781,Staff,0,1,30,30
1650175345100,MATH 193A,A04,083782,Staff,0,1,30,30
1650175351131,MATH 197,001,091859,McAuley; Julian John,9998,0,9999,1
1650175357223,COGS 9,A01,083615,Staff,0,14,60,60
1650175363246,COGS 11,A01,083617,Boyle; Mary E. T.,24,0,40,16
1650175369270,COGS 13,A01,083071,Staff,0,30,40,40
1650175375298,COGS 14A,A01,092681,Staff,0,12,100,100
1650175381328,COGS 14B,A01,083073,Cheng; Tzu-Han,0,7,50,50
1650175387351,COGS 17,A01,092677,Staff,34,0,75,41
1650175393378,COGS 100,A01,083619,Staff,0,20,60,60
1650175399408,COGS 101A,A01,083621,Davis; Joshua Daniel,0,21,60,60
1650175405431,COGS 101B,A01,091572,Staff,6,0,60,54
1650175411465,COGS 101C,A01,083625,Delgado; Tania,20,0,30,10
1650175417494,COGS 107A,A01,083627,Boyle; Mary E. T.,0,7,60,60
1650175423518,COGS 118A,A01,083075,Staff,17,0,60,43
1650175429544,CSE 3,A50,083646,Miranda; Gregory Joseph,22,0,38,16
1650175429544,CSE 3,A51,083647,Miranda; Gregory Joseph,37,0,37,0
1650175435571,CSE 8A,A50,083650,Miranda; Gregory Joseph,0,17,40,40
1650175441596,CSE 11,A01,083080,Cao; Yingjun,0,66,40,40
1650175447624,CSE 12,A01,083652,Staff,0,5,100,100
1650175453653,CSE 15L,A01,083654,Staff,0,0,50,50
1650175453653,CSE 15L,A02,083655,Staff,8,0,50,42
1650175459677,CSE 20,A01,083657,Staff,54,0,80,26
1650175465713,CSE 30,A01,083084,Eldon; John,0,67,40,40
1650175471741,CSE 100,A01,083659,Cao; Yingjun,0,61,50,50
1650175477766,CSE 134B,A01,083661,Powell; Thomas Allan,0,27,65,65
1650175483800,CSE 140,A01,083663,Staff,1,0,75,74
1650175489828,CSE 140L,A01,083088,Eldon; John,0,4,75,75
1650175495865,CSE 175,A01,083665,Kumar; Rakesh,8,0,25,17
1650175501894,CSE 190,A00,092507,Dubnov; Shlomo,14,0,20,6
1650175507916,ECE 45,A01,083139,Staff,0,13,40,40
1650175513943,ECE 65,A50,083695,Staff,0,5,30,30
1650175519974,ECE 109,A01,091882,Touri; Behrouz,47,0,70,23
1650175526004,ECE 180,A00,083140,Abi Samra; Nicholas Camill,24,0,30,6
1650175526004,ECE 180,B00,083141,Abi Samra; Nicholas Camill,8,0,30,22
1650175532029,MATH 10A,A01,083735,Patchell; Gregory David,12,0,30,18
1650175532029,MATH 10A,A02,083736,Patchell; Gregory David,28,0,30,2
1650175532029,MATH 10A,A03,083737,Patchell; Gregory David,26,0,30,4
1650175538057,MATH 10B,A01,083207,Staff,0,5,30,30
1650175538057,MATH 10B,A02,083208,Staff,0,5,30,30
1650175538057,MATH 10B,B01,083739,Staff,17,0,30,13
1650175538057,MATH 10B,B02,083740,Staff,29,0,30,1
1650175544090,MATH 18,A01,083743,Staff,10,0,30,20
1650175544090,MATH 18,A02,083744,Staff,28,0,30,2
1650175544090,MATH 18,A03,083745,Staff,23,0,30,7
1650175544090,MATH 18,A04,083746,Staff,27,0,30,3
1650175544090,MATH 18,B01,083748,Staff,0,10,30,30
1650175544090,MATH 18,B02,083749,Staff,0,7,30,30
1650175544090,MATH 18,B03,083750,Staff,0,7,30,30
1650175544090,MATH 18,B04,083751,Staff,0,7,30,30
1650175550117,MATH 20A,A01,083754,Staff,26,0,40,14
1650175556151,MATH 20B,A01,083756,Staff,0,5,30,30
1650175556151,MATH 20B,A02,083757,Staff,0,5,30,30
1650175562180,MATH 20C,A01,083760,Staff,0,12,30,30
1650175562180,MATH 20C,A02,083761,Staff,0,12,30,30
1650175562180,MATH 20C,B01,083762,Staff,14,0,30,16
1650175562180,MATH 20C,B02,083763,Staff,28,0,30,2
1650175568202,MATH 20D,A01,083765,Staff,0,2,30,30
1650175568202,MATH 20D,A02,083766,Staff,10,0,30,20
1650175568202,MATH 20D,A03,083767,Staff,28,0,30,2
1650175574231,MATH 20E,A01,083771,Staff,8,0,30,22
1650175574231,MATH 20E,A02,083772,Staff,20,0,30,10
1650175574231,MATH 20E,B01,083773,Staff,0,0,30,30
1650175574231,MATH 20E,B02,083774,Staff,13,0,30,17
1650175580259,MATH 103A,A01,083777,Staff,0,9,30,30
1650175580259,MATH 103A,A02,083778,Staff,0,10,30,30
1650175580259,MATH 103A,B01,083779,Staff,0,9,30,30
1650175580259,MATH 103A,B02,083780,Staff,0,9,30,30
1650175586285,MATH 105,A01,085443,Staff,0,17,30,30
1650175592314,MATH 109,A01,083213,Anzaldo; Leesa B,0,3,30,30
1650175592314,MATH 109,A02,083214,Anzaldo; Leesa B,0,6,30,30
1650175592314,MATH 109,B01,083215,Anzaldo; Leesa B,0,4,30,30
1650175592314,MATH 109,B02,083216,Anzaldo; Leesa B,0,4,30,30
1650175598340,MATH 142A,A01,083219,Chow; Bennett,0,12,30,30
1650175598340,MATH 142A,A02,083220,Chow; Bennett,0,11,30,30
1650175598340,MATH 142A,B01,083221,Chow; Bennett,0,11,30,30
1650175598340,MATH 142A,B02,083222,Chow; Bennett,0,12,30,30
1650175604370,MATH 193A,A01,083224,Staff,0,4,30,30
1650175604370,MATH 193A,A02,083225,Staff,0,4,30,30
1650175604370,MATH 193A,A03,083781,Staff,0,1,30,30
1650175604370,MATH 193A,A04,083782,Staff,0,1,30,30
1650175610395,MATH 197,001,091859,McAuley; Julian John,9998,0,9999,1
1650175616529,COGS 9,A01,083615,Staff,0,14,60,60
1650175622553,COGS 11,A01,083617,Boyle; Mary E. T.,24,0,40,16
1650175628581,COGS 13,A01,083071,Staff,0,30,40,40
1650175634608,COGS 14A,A01,092681,Staff,0,12,100,100
1650175640634,COGS 14B,A01,083073,Cheng; Tzu-Han,0,7,50,50
1650175646660,COGS 17,A01,092677,Staff,34,0,75,41
1650175652685,COGS 100,A01,083619,Staff,0,20,60,60
1650175658709,COGS 101A,A01,083621,Davis; Joshua Daniel,0,21,60,60
1650175664741,COGS 101B,A01,091572,Staff,6,0,60,54
1650175670764,COGS 101C,A01,083625,Delgado; Tania,20,0,30,10
1650175676787,COGS 107A,A01,083627,Boyle; Mary E. T.,0,7,60,60
1650175682810,COGS 118A,A01,083075,Staff,17,0,60,43
1650175688838,CSE 3,A50,083646,Miranda; Gregory Joseph,22,0,38,16
1650175688838,CSE 3,A51,083647,Miranda; Gregory Joseph,37,0,37,0
1650175694864,CSE 8A,A50,083650,Miranda; Gregory Joseph,0,17,40,40
1650175700889,CSE 11,A01,083080,Cao; Yingjun,0,66,40,40
1650175706915,CSE 12,A01,083652,Staff,0,5,100,100
1650175712939,CSE 15L,A01,083654,Staff,0,0,50,50
1650175712939,CSE 15L,A02,083655,Staff,8,0,50,42
1650175718964,CSE 20,A01,083657,Staff,54,0,80,26
1650175724988,CSE 30,A01,083084,Eldon; John,0,67,40,40
1650175731012,CSE 100,A01,083659,Cao; Yingjun,0,61,50,50
1650175737036,CSE 134B,A01,083661,Powell; Thomas Allan,0,27,65,65
1650175743064,CSE 140,A01,083663,Staff,1,0,75,74
1650175749091,CSE 140L,A01,083088,Eldon; John,0,4,75,75
1650175755116,CSE 175,A01,083665,Kumar; Rakesh,8,0,25,17
1650175761143,CSE 190,A00,092507,Dubnov; Shlomo,14,0,20,6
1650175767173,ECE 45,A01,083139,Staff,0,13,40,40
1650175773198,ECE 65,A50,083695,Staff,0,5,30,30
1650175779220,ECE 109,A01,091882,Touri; Behrouz,47,0,70,23
1650175785243,ECE 180,A00,083140,Abi Samra; Nicholas Camill,24,0,30,6
1650175785243,ECE 180,B00,083141,Abi Samra; Nicholas Camill,8,0,30,22
1650175791267,MATH 10A,A01,083735,Patchell; Gregory David,12,0,30,18
1650175791267,MATH 10A,A02,083736,Patchell; Gregory David,28,0,30,2
1650175791267,MATH 10A,A03,083737,Patchell; Gregory David,26,0,30,4
1650175797296,MATH 10B,A01,083207,Staff,0,5,30,30
1650175797296,MATH 10B,A02,083208,Staff,0,5,30,30
1650175797296,MATH 10B,B01,083739,Staff,17,0,30,13
1650175797296,MATH 10B,B02,083740,Staff,29,0,30,1
1650175803321,MATH 18,A01,083743,Staff,10,0,30,20
1650175803321,MATH 18,A02,083744,Staff,28,0,30,2
1650175803321,MATH 18,A03,083745,Staff,23,0,30,7
1650175803321,MATH 18,A04,083746,Staff,27,0,30,3
1650175803321,MATH 18,B01,083748,Staff,0,10,30,30
1650175803321,MATH 18,B02,083749,Staff,0,7,30,30
1650175803321,MATH 18,B03,083750,Staff,0,7,30,30
1650175803321,MATH 18,B04,083751,Staff,0,7,30,30
1650175809348,MATH 20A,A01,083754,Staff,26,0,40,14
1650175815371,MATH 20B,A01,083756,Staff,0,5,30,30
1650175815371,MATH 20B,A02,083757,Staff,0,5,30,30
1650175821400,MATH 20C,A01,083760,Staff,0,12,30,30
1650175821400,MATH 20C,A02,083761,Staff,0,12,30,30
1650175821400,MATH 20C,B01,083762,Staff,14,0,30,16
1650175821400,MATH 20C,B02,083763,Staff,28,0,30,2
1650175827424,MATH 20D,A01,083765,Staff,0,2,30,30
1650175827424,MATH 20D,A02,083766,Staff,10,0,30,20
1650175827424,MATH 20D,A03,083767,Staff,28,0,30,2
1650175833448,MATH 20E,A01,083771,Staff,8,0,30,22
1650175833448,MATH 20E,A02,083772,Staff,20,0,30,10
1650175833448,MATH 20E,B01,083773,Staff,0,0,30,30
1650175833448,MATH 20E,B02,083774,Staff,13,0,30,17
1650175839473,MATH 103A,A01,083777,Staff,0,9,30,30
1650175839473,MATH 103A,A02,083778,Staff,0,10,30,30
1650175839473,MATH 103A,B01,083779,Staff,0,9,30,30
1650175839473,MATH 103A,B02,083780,Staff,0,9,30,30
1650175845500,MATH 105,A01,085443,Staff,0,17,30,30
1650175851524,MATH 109,A01,083213,Anzaldo; Leesa B,0,3,30,30
1650175851524,MATH 109,A02,083214,Anzaldo; Leesa B,0,6,30,30
1650175851524,MATH 109,B01,083215,Anzaldo; Leesa B,0,4,30,30
1650175851524,MATH 109,B02,083216,Anzaldo; Leesa B,0,4,30,30
1650175857553,MATH 142A,A01,083219,Chow; Bennett,0,12,30,30
1650175857553,MATH 142A,A02,083220,Chow; Bennett,0,11,30,30
1650175857553,MATH 142A,B01,083221,Chow; Bennett,0,11,30,30
1650175857553,MATH 142A,B02,083222,Chow; Bennett,0,12,30,30
1650175863582,MATH 193A,A01,083224,Staff,0,4,30,30
1650175863582,MATH 193A,A02,083225,Staff,0,4,30,30
1650175863582,MATH 193A,A03,083781,Staff,0,1,30,30
1650175863582,MATH 193A,A04,083782,Staff,0,1,30,30
1650175869603,MATH 197,001,091859,McAuley; Julian John,9998,0,9999,1
1650175875657,COGS 9,A01,083615,Staff,0,14,60,60
1650175881679,COGS 11,A01,083617,Boyle; Mary E. T.,24,0,40,16
1650175887703,COGS 13,A01,083071,Staff,0,30,40,40
1650175893726,COGS 14A,A01,092681,Staff,0,12,100,100
1650175899749,COGS 14B,A01,083073,Cheng; Tzu-Han,0,7,50,50
1650175905772,COGS 17,A01,092677,Staff,34,0,75,41
1650175911799,COGS 100,A01,083619,Staff,0,20,60,60
1650175917825,COGS 101A,A01,083621,Davis; Joshua Daniel,0,21,60,60
1650175923852,COGS 101B,A01,091572,Staff,6,0,60,54
1650175929877,COGS 101C,A01,083625,Delgado; Tania,20,0,30,10
1650175935902,COGS 107A,A01,083627,Boyle; Mary E. T.,0,7,60,60
1650175941927,COGS 118A,A01,083075,Staff,17,0,60,43
1650175947963,CSE 3,A50,083646,Miranda; Gregory Joseph,22,0,38,16
1650175947963,CSE 3,A51,083647,Miranda; Gregory Joseph,37,0,37,0
1650175953987,CSE 8A,A50,083650,Miranda; Gregory Joseph,0,17,40,40
1650175960011,CSE 11,A01,083080,Cao; Yingjun,0,66,40,40
1650175966039,CSE 12,A01,083652,Staff,0,5,100,100
1650175972061,CSE 15L,A01,083654,Staff,0,0,50,50
1650175972061,CSE 15L,A02,083655,Staff,8,0,50,42
1650175978086,CSE 20,A01,083657,Staff,54,0,80,26
1650175984112,CSE 30,A01,083084,Eldon; John,0,67,40,40
1650175990139,CSE 100,A01,083659,Cao; Yingjun,0,61,50,50
1650175996175,CSE 134B,A01,083661,Powell; Thomas Allan,0,27,65,65
1650176002202,CSE 140,A01,083663,Staff,1,0,75,74
1650176008225,CSE 140L,A01,083088,Eldon; John,0,4,75,75
1650176014249,CSE 175,A01,083665,Kumar; Rakesh,8,0,25,17
1650176020286,CSE 190,A00,092507,Dubnov; Shlomo,14,0,20,6
1650176026313,ECE 45,A01,083139,Staff,0,13,40,40
1650176032343,ECE 65,A50,083695,Staff,0,5,30,30
1650176038367,ECE 109,A01,091882,Touri; Behrouz,47,0,70,23
1650176044395,ECE 180,A00,083140,Abi Samra; Nicholas Camill,24,0,30,6
1650176044395,ECE 180,B00,083141,Abi Samra; Nicholas Camill,8,0,30,22
1650176050433,MATH 10A,A01,083735,Patchell; Gregory David,12,0,30,18
1650176050433,MATH 10A,A02,083736,Patchell; Gregory David,28,0,30,2
1650176050433,MATH 10A,A03,083737,Patchell; Gregory David,26,0,30,4
1650176056468,MATH 10B,A01,083207,Staff,0,5,30,30
1650176056468,MATH 10B,A02,083208,Staff,0,5,30,30
1650176056468,MATH 10B,B01,083739,Staff,17,0,30,13
1650176056468,MATH 10B,B02,083740,Staff,29,0,30,1
1650176062493,MATH 18,A01,083743,Staff,10,0,30,20
1650176062493,MATH 18,A02,083744,Staff,28,0,30,2
1650176062493,MATH 18,A03,083745,Staff,23,0,30,7
1650176062493,MATH 18,A04,083746,Staff,27,0,30,3
1650176062493,MATH 18,B01,083748,Staff,0,10,30,30
1650176062493,MATH 18,B02,083749,Staff,0,7,30,30
1650176062493,MATH 18,B03,083750,Staff,0,7,30,30
1650176062493,MATH 18,B04,083751,Staff,0,7,30,30
1650176068520,MATH 20A,A01,083754,Staff,26,0,40,14
1650176074544,MATH 20B,A01,083756,Staff,0,5,30,30
1650176074544,MATH 20B,A02,083757,Staff,0,5,30,30
1650176080568,MATH 20C,A01,083760,Staff,0,12,30,30
1650176080568,MATH 20C,A02,083761,Staff,0,12,30,30
1650176080568,MATH 20C,B01,083762,Staff,14,0,30,16
1650176080568,MATH 20C,B02,083763,Staff,28,0,30,2
1650176086592,MATH 20D,A01,083765,Staff,0,2,30,30
1650176086592,MATH 20D,A02,083766,Staff,10,0,30,20
1650176086592,MATH 20D,A03,083767,Staff,28,0,30,2
1650176092617,MATH 20E,A01,083771,Staff,8,0,30,22
1650176092617,MATH 20E,A02,083772,Staff,20,0,30,10
1650176092617,MATH 20E,B01,083773,Staff,0,0,30,30
1650176092617,MATH 20E,B02,083774,Staff,13,0,30,17
1650176098645,MATH 103A,A01,083777,Staff,0,9,30,30
1650176098645,MATH 103A,A02,083778,Staff,0,10,30,30
1650176098645,MATH 103A,B01,083779,Staff,0,9,30,30
1650176098645,MATH 103A,B02,083780,Staff,0,9,30,30
1650176104675,MATH 105,A01,085443,Staff,0,17,30,30
1650176110704,MATH 109,A01,083213,Anzaldo; Leesa B,0,3,30,30
1650176110704,MATH 109,A02,083214,Anzaldo; Leesa B,0,6,30,30
1650176110704,MATH 109,B01,083215,Anzaldo; Leesa B,0,4,30,30
1650176110704,MATH 109,B02,083216,Anzaldo; Leesa B,0,4,30,30
1650176116734,MATH 142A,A01,083219,Chow; Bennett,0,12,30,30
1650176116734,MATH 142A,A02,083220,Chow; Bennett,0,11,30,30
1650176116734,MATH 142A,B01,083221,Chow; Bennett,0,11,30,30
1650176116734,MATH 142A,B02,083222,Chow; Bennett,0,12,30,30
1650176122758,MATH 193A,A01,083224,Staff,0,4,30,30
1650176122758,MATH 193A,A02,083225,Staff,0,4,30,30
1650176122758,MATH 193A,A03,083781,Staff,0,1,30,30
1650176122758,MATH 193A,A04,083782,Staff,0,1,30,30
1650176128784,MATH 197,001,091859,McAuley; Julian John,9998,0,9999,1
1650176134835,COGS 9,A01,083615,Staff,0,14,60,60
1650176140862,COGS 11,A01,083617,Boyle; Mary E. T.,24,0,40,16
1650176146888,COGS 13,A01,083071,Staff,0,30,40,40
1650176152915,COGS 14A,A01,092681,Staff,0,12,100,100
1650176158937,COGS 14B,A01,083073,Cheng; Tzu-Han,0,7,50,50
1650176164964,COGS 17,A01,092677,Staff,34,0,75,41
1650176170994,COGS 100,A01,083619,Staff,0,20,60,60
1650176177029,COGS 101A,A01,083621,Davis; Joshua Daniel,0,21,60,60
1650176183053,COGS 101B,A01,091572,Staff,6,0,60,54
1650176189080,COGS 101C,A01,083625,Delgado; Tania,20,0,30,10
1650176195113,COGS 107A,A01,083627,Boyle; Mary E. T.,0,7,60,60
1650176201138,COGS 118A,A01,083075,Staff,17,0,60,43
1650176207165,CSE 3,A50,083646,Miranda; Gregory Joseph,22,0,38,16
1650176207165,CSE 3,A51,083647,Miranda; Gregory Joseph,37,0,37,0
1650176213262,CSE 8A,A50,083650,Miranda; Gregory Joseph,0,17,40,40
1650176219286,CSE 11,A01,083080,Cao; Yingjun,0,66,40,40
1650176225324,CSE 12,A01,083652,Staff,0,5,100,100
1650176231347,CSE 15L,A01,083654,Staff,0,0,50,50
1650176231347,CSE 15L,A02,083655,Staff,8,0,50,42
1650176237378,CSE 20,A01,083657,Staff,54,0,80,26
1650176243402,CSE 30,A01,083084,Eldon; John,0,67,40,40
1650176249428,CSE 100,A01,083659,Cao; Yingjun,0,61,50,50
1650176255451,CSE 134B,A01,083661,Powell; Thomas Allan,0,27,65,65
1650176261478,CSE 140,A01,083663,Staff,1,0,75,74
1650176267503,CSE 140L,A01,083088,Eldon; John,0,4,75,75
1650176273529,CSE 175,A01,083665,Kumar; Rakesh,8,0,25,17
1650176279562,CSE 190,A00,092507,Dubnov; Shlomo,14,0,20,6
1650176285584,ECE 45,A01,083139,Staff,0,13,40,40
1650176291608,ECE 65,A50,083695,Staff,0,5,30,30
1650176297631,ECE 109,A01,091882,Touri; Behrouz,47,0,70,23
1650176303668,ECE 180,A00,083140,Abi Samra; Nicholas Camill,24,0,30,6
1650176303668,ECE 180,B00,083141,Abi Samra; Nicholas Camill,8,0,30,22
1650176309701,MATH 10A,A01,083735,Patchell; Gregory David,12,0,30,18
1650176309701,MATH 10A,A02,083736,Patchell; Gregory David,28,0,30,2
1650176309701,MATH 10A,A03,083737,Patchell; Gregory David,26,0,30,4
1650176315728,MATH 10B,A01,083207,Staff,0,5,30,30
1650176315728,MATH 10B,A02,083208,Staff,0,5,30,30
1650176315728,MATH 10B,B01,083739,Staff,16,0,30,14
1650176315728,MATH 10B,B02,083740,Staff,29,0,30,1
1650176321758,MATH 18,A01,083743,Staff,10,0,30,20
1650176321758,MATH 18,A02,083744,Staff,28,0,30,2
1650176321758,MATH 18,A03,083745,Staff,23,0,30,7
1650176321758,MATH 18,A04,083746,Staff,27,0,30,3
1650176321758,MATH 18,B01,083748,Staff,0,10,30,30
1650176321758,MATH 18,B02,083749,Staff,0,7,30,30
1650176321758,MATH 18,B03,083750,Staff,0,7,30,30
1650176321758,MATH 18,B04,083751,Staff,0,7,30,30
1650176327785,MATH 20A,A01,083754,Staff,26,0,40,14
1650176333814,MATH 20B,A01,083756,Staff,0,5,30,30
1650176333814,MATH 20B,A02,083757,Staff,0,5,30,30
1650176339841,MATH 20C,A01,083760,Staff,0,12,30,30
1650176339841,MATH 20C,A02,083761,Staff,0,12,30,30
1650176339841,MATH 20C,B01,083762,Staff,14,0,30,16
1650176339841,MATH 20C,B02,083763,Staff,28,0,30,2
1650176345872,MATH 20D,A01,083765,Staff,0,2,30,30
1650176345872,MATH 20D,A02,083766,Staff,10,0,30,20
1650176345872,MATH 20D,A03,083767,Staff,28,0,30,2
1650176351901,MATH 20E,A01,083771,Staff,8,0,30,22
1650176351901,MATH 20E,A02,083772,Staff,20,0,30,10
1650176351901,MATH 20E,B01,083773,Staff,0,0,30,30
1650176351901,MATH 20E,B02,083774,Staff,13,0,30,17
1650176357926,MATH 103A,A01,083777,Staff,0,9,30,30
1650176357926,MATH 103A,A02,083778,Staff,0,10,30,30
1650176357926,MATH 103A,B01,083779,Staff,0,9,30,30
1650176357926,MATH 103A,B02,083780,Staff,0,9,30,30
1650176363950,MATH 105,A01,085443,Staff,0,17,30,30
1650176369973,MATH 109,A01,083213,Anzaldo; Leesa B,0,3,30,30
1650176369973,MATH 109,A02,083214,Anzaldo; Leesa B,0,6,30,30
1650176369973,MATH 109,B01,083215,Anzaldo; Leesa B,0,4,30,30
1650176369973,MATH 109,B02,083216,Anzaldo; Leesa B,0,4,30,30
1650176375998,MATH 142A,A01,083219,Chow; Bennett,0,12,30,30
1650176375998,MATH 142A,A02,083220,Chow; Bennett,0,11,30,30
1650176375998,MATH 142A,B01,083221,Chow; Bennett,0,11,30,30
1650176375998,MATH 142A,B02,083222,Chow; Bennett,0,12,30,30
1650176382021,MATH 193A,A01,083224,Staff,0,4,30,30
1650176382021,MATH 193A,A02,083225,Staff,0,4,30,30
1650176382021,MATH 193A,A03,083781,Staff,0,1,30,30
1650176382021,MATH 193A,A04,083782,Staff,0,1,30,30
1650176388044,MATH 197,001,091859,McAuley; Julian John,9998,0,9999,1
1650176394097,COGS 9,A01,083615,Staff,0,14,60,60
1650176400122,COGS 11,A01,083617,Boyle; Mary E. T.,24,0,40,16
1650176406146,COGS 13,A01,083071,Staff,0,30,40,40
1650176412176,COGS 14A,A01,092681,Staff,0,12,100,100
1650176418199,COGS 14B,A01,083073,Cheng; Tzu-Han,0,7,50,50
1650176424222,COGS 17,A01,092677,Staff,34,0,75,41
1650176430246,COGS 100,A01,083619,Staff,0,20,60,60
1650176436269,COGS 101A,A01,083621,Davis; Joshua Daniel,0,21,60,60
1650176442296,COGS 101B,A01,091572,Staff,6,0,60,54
1650176448322,COGS 101C,A01,083625,Delgado; Tania,20,0,30,10
1650176454346,COGS 107A,A01,083627,Boyle; Mary E. T.,0,7,60,60
1650176460374,COGS 118A,A01,083075,Staff,17,0,60,43
1650176466405,CSE 3,A50,083646,Miranda; Gregory Joseph,22,0,38,16
1650176466405,CSE 3,A51,083647,Miranda; Gregory Joseph,37,0,37,0
1650176472436,CSE 8A,A50,083650,Miranda; Gregory Joseph,0,17,40,40
1650176478460,CSE 11,A01,083080,Cao; Yingjun,0,66,40,40
1650176484485,CSE 12,A01,083652,Staff,0,5,100,100
1650176490517,CSE 15L,A01,083654,Staff,0,0,50,50
1650176490517,CSE 15L,A02,083655,Staff,8,0,50,42
1650176496544,CSE 20,A01,083657,Staff,54,0,80,26
1650176502571,CSE 30,A01,083084,Eldon; John,0,67,40,40
1650176508594,CSE 100,A01,083659,Cao; Yingjun,0,61,50,50
1650176514617,CSE 134B,A01,083661,Powell; Thomas Allan,0,27,65,65
1650176520640,CSE 140,A01,083663,Staff,1,0,75,74
1650176526662,CSE 140L,A01,083088,Eldon; John,0,4,75,75
1650176532691,CSE 175,A01,083665,Kumar; Rakesh,8,0,25,17
1650176538715,CSE 190,A00,092507,Dubnov; Shlomo,14,0,20,6
1650176544743,ECE 45,A01,083139,Staff,0,13,40,40
1650176550769,ECE 65,A50,083695,Staff,0,5,30,30
1650176556793,ECE 109,A01,091882,Touri; Behrouz,47,0,70,23
1650176562821,ECE 180,A00,083140,Abi Samra; Nicholas Camill,24,0,30,6
1650176562821,ECE 180,B00,083141,Abi Samra; Nicholas Camill,8,0,30,22
1650176568847,MATH 10A,A01,083735,Patchell; Gregory David,12,0,30,18
1650176568847,MATH 10A,A02,083736,Patchell; Gregory David,28,0,30,2
1650176568847,MATH 10A,A03,083737,Patchell; Gregory David,26,0,30,4
1650176574874,MATH 10B,A01,083207,Staff,0,5,30,30
1650176574874,MATH 10B,A02,083208,Staff,0,5,30,30
1650176574874,MATH 10B,B01,083739,Staff,17,0,30,13
1650176574874,MATH 10B,B02,083740,Staff,29,0,30,1
1650176580906,MATH 18,A01,083743,Staff,10,0,30,20
1650176580906,MATH 18,A02,083744,Staff,28,0,30,2
1650176580906,MATH 18,A03,083745,Staff,23,0,30,7
1650176580906,MATH 18,A04,083746,Staff,27,0,30,3
1650176580906,MATH 18,B01,083748,Staff,0,10,30,30
1650176580906,MATH 18,B02,083749,Staff,0,7,30,30
1650176580906,MATH 18,B03,083750,Staff,0,7,30,30
1650176580906,MATH 18,B04,083751,Staff,0,7,30,30
1650176586929,MATH 20A,A01,083754,Staff,26,0,40,14
1650176592953,MATH 20B,A01,083756,Staff,0,5,30,30
1650176592953,MATH 20B,A02,083757,Staff,0,5,30,30
1650176598977,MATH 20C,A01,083760,Staff,0,12,30,30
1650176598977,MATH 20C,A02,083761,Staff,0,12,30,30
1650176598977,MATH 20C,B01,083762,Staff,14,0,30,16
1650176598977,MATH 20C,B02,083763,Staff,28,0,30,2
1650176605005,MATH 20D,A01,083765,Staff,0,2,30,30
1650176605005,MATH 20D,A02,083766,Staff,10,0,30,20
1650176605005,MATH 20D,A03,083767,Staff,28,0,30,2
1650176611029,MATH 20E,A01,083771,Staff,8,0,30,22
1650176611029,MATH 20E,A02,083772,Staff,20,0,30,10
1650176611029,MATH 20E,B01,083773,Staff,0,0,30,30
1650176611029,MATH 20E,B02,083774,Staff,13,0,30,17
1650176617054,MATH 103A,A01,083777,Staff,0,9,30,30
1650176617054,MATH 103A,A02,083778,Staff,0,10,30,30
1650176617054,MATH 103A,B01,083779,Staff,0,9,30,30
1650176617054,MATH 103A,B02,083780,Staff,0,9,30,30
1650176623077,MATH 105,A01,085443,Staff,0,17,30,30
1650176629103,MATH 109,A01,083213,Anzaldo; Leesa B,0,3,30,30
1650176629103,MATH 109,A02,083214,Anzaldo; Leesa B,0,6,30,30
1650176629103,MATH 109,B01,083215,Anzaldo; Leesa B,0,4,30,30
1650176629103,MATH 109,B02,083216,Anzaldo; Leesa B,0,4,30,30
1650176635127,MATH 142A,A01,083219,Chow; Bennett,0,12,30,30
1650176635127,MATH 142A,A02,083220,Chow; Bennett,0,11,30,30
1650176635127,MATH 142A,B01,083221,Chow; Bennett,0,11,30,30
1650176635127,MATH 142A,B02,083222,Chow; Bennett,0,12,30,30
1650176641151,MATH 193A,A01,083224,Staff,0,4,30,30
1650176641151,MATH 193A,A02,083225,Staff,0,4,30,30
1650176641151,MATH 193A,A03,083781,Staff,0,1,30,30
1650176641151,MATH 193A,A04,083782,Staff,0,1,30,30
1650176647176,MATH 197,001,091859,McAuley; Julian John,9998,0,9999,1
1650176653227,COGS 9,A01,083615,Staff,0,14,60,60
1650176659255,COGS 11,A01,083617,Boyle; Mary E. T.,24,0,40,16
1650176665278,COGS 13,A01,083071,Staff,0,30,40,40
1650176671301,COGS 14A,A01,092681,Staff,0,12,100,100
1650176677324,COGS 14B,A01,083073,Cheng; Tzu-Han,0,7,50,50
1650176683348,COGS 17,A01,092677,Staff,34,0,75,41
1650176689376,COGS 100,A01,083619,Staff,0,20,60,60
1650176695400,COGS 101A,A01,083621,Davis; Joshua Daniel,0,21,60,60
1650176701425,COGS 101B,A01,091572,Staff,6,0,60,54
1650176707449,COGS 101C,A01,083625,Delgado; Tania,20,0,30,10
1650176713475,COGS 107A,A01,083627,Boyle; Mary E. T.,0,7,60,60
1650176719500,COGS 118A,A01,083075,Staff,17,0,60,43
1650176725527,CSE 3,A50,083646,Miranda; Gregory Joseph,22,0,38,16
1650176725527,CSE 3,A51,083647,Miranda; Gregory Joseph,37,0,37,0
1650176731550,CSE 8A,A50,083650,Miranda; Gregory Joseph,0,17,40,40
1650176737576,CSE 11,A01,083080,Cao; Yingjun,0,66,40,40
1650176743600,CSE 12,A01,083652,Staff,0,5,100,100
1650176749628,CSE 15L,A01,083654,Staff,0,0,50,50
1650176749628,CSE 15L,A02,083655,Staff,8,0,50,42
1650176755653,CSE 20,A01,083657,Staff,54,0,80,26
1650176761681,CSE 30,A01,083084,Eldon; John,0,67,40,40
1650176767705,CSE 100,A01,083659,Cao; Yingjun,0,61,50,50
1650176773728,CSE 134B,A01,083661,Powell; Thomas Allan,0,27,65,65
1650176779756,CSE 140,A01,083663,Staff,1,0,75,74
1650176785783,CSE 140L,A01,083088,Eldon; John,0,4,75,75
1650176791806,CSE 175,A01,083665,Kumar; Rakesh,8,0,25,17
1650176797828,CSE 190,A00,092507,Dubnov; Shlomo,14,0,20,6
1650176803856,ECE 45,A01,083139,Staff,0,13,40,40
1650176809951,ECE 65,A50,083695,Staff,0,5,30,30
1650176815976,ECE 109,A01,091882,Touri; Behrouz,47,0,70,23
1650176821998,ECE 180,A00,083140,Abi Samra; Nicholas Camill,24,0,30,6
1650176821998,ECE 180,B00,083141,Abi Samra; Nicholas Camill,8,0,30,22
1650176828025,MATH 10A,A01,083735,Patchell; Gregory David,12,0,30,18
1650176828025,MATH 10A,A02,083736,Patchell; Gregory David,28,0,30,2
1650176828025,MATH 10A,A03,083737,Patchell; Gregory David,26,0,30,4
1650176834049,MATH 10B,A01,083207,Staff,0,5,30,30
1650176834049,MATH 10B,A02,083208,Staff,0,5,30,30
1650176834049,MATH 10B,B01,083739,Staff,17,0,30,13
1650176834049,MATH 10B,B02,083740,Staff,29,0,30,1
1650176840075,MATH 18,A01,083743,Staff,10,0,30,20
1650176840075,MATH 18,A02,083744,Staff,28,0,30,2
1650176840075,MATH 18,A03,083745,Staff,23,0,30,7
1650176840075,MATH 18,A04,083746,Staff,27,0,30,3
1650176840075,MATH 18,B01,083748,Staff,0,10,30,30
1650176840075,MATH 18,B02,083749,Staff,0,7,30,30
1650176840075,MATH 18,B03,083750,Staff,0,7,30,30
1650176840075,MATH 18,B04,083751,Staff,0,7,30,30
1650176846101,MATH 20A,A01,083754,Staff,26,0,40,14
1650176852123,MATH 20B,A01,083756,Staff,0,5,30,30
1650176852123,MATH 20B,A02,083757,Staff,0,5,30,30
1650176858146,MATH 20C,A01,083760,Staff,0,12,30,30
1650176858146,MATH 20C,A02,083761,Staff,0,12,30,30
1650176858146,MATH 20C,B01,083762,Staff,14,0,30,16
1650176858146,MATH 20C,B02,083763,Staff,28,0,30,2
1650176864170,MATH 20D,A01,083765,Staff,0,2,30,30
1650176864170,MATH 20D,A02,083766,Staff,10,0,30,20
1650176864170,MATH 20D,A03,083767,Staff,28,0,30,2
1650176870192,MATH 20E,A01,083771,Staff,8,0,30,22
1650176870192,MATH 20E,A02,083772,Staff,20,0,30,10
1650176870192,MATH 20E,B01,083773,Staff,0,0,30,30
1650176870192,MATH 20E,B02,083774,Staff,13,0,30,17
1650176876216,MATH 103A,A01,083777,Staff,0,9,30,30
1650176876216,MATH 103A,A02,083778,Staff,0,10,30,30
1650176876216,MATH 103A,B01,083779,Staff,0,9,30,30
1650176876216,MATH 103A,B02,083780,Staff,0,9,30,30
1650176882242,MATH 105,A01,085443,Staff,0,17,30,30
1650176888269,MATH 109,A01,083213,Anzaldo; Leesa B,0,3,30,30
1650176888269,MATH 109,A02,083214,Anzaldo; Leesa B,0,6,30,30
1650176888269,MATH 109,B01,083215,Anzaldo; Leesa B,0,4,30,30
1650176888269,MATH 109,B02,083216,Anzaldo; Leesa B,0,4,30,30
1650176894295,MATH 142A,A01,083219,Chow; Bennett,0,12,30,30
1650176894295,MATH 142A,A02,083220,Chow; Bennett,0,11,30,30
1650176894295,MATH 142A,B01,083221,Chow; Bennett,0,11,30,30
1650176894295,MATH 142A,B02,083222,Chow; Bennett,0,12,30,30
1650176900318,MATH 193A,A01,083224,Staff,0,4,30,30
1650176900318,MATH 193A,A02,083225,Staff,0,4,30,30
1650176900318,MATH 193A,A03,083781,Staff,0,1,30,30
1650176900318,MATH 193A,A04,083782,Staff,0,1,30,30
1650176906346,MATH 197,001,091859,McAuley; Julian John,9998,0,9999,1
1650176912420,COGS 9,A01,083615,Staff,0,14,60,60
1650176918449,COGS 11,A01,083617,Boyle; Mary E. T.,24,0,40,16
1650176924475,COGS 13,A01,083071,Staff,0,30,40,40
1650176930502,COGS 14A,A01,092681,Staff,0,12,100,100
1650176936526,COGS 14B,A01,083073,Cheng; Tzu-Han,0,7,50,50
1650176942554,COGS 17,A01,092677,Staff,34,0,75,41
1650176948578,COGS 100,A01,083619,Staff,0,20,60,60
1650176954605,COGS 101A,A01,083621,Davis; Joshua Daniel,0,21,60,60
1650176960630,COGS 101B,A01,091572,Staff,6,0,60,54
1650176966656,COGS 101C,A01,083625,Delgado; Tania,20,0,30,10
1650176972691,COGS 107A,A01,083627,Boyle; Mary E. T.,0,7,60,60
1650176978724,COGS 118A,A01,083075,Staff,17,0,60,43
1650176984748,CSE 3,A50,083646,Miranda; Gregory Joseph,22,0,38,16
1650176984748,CSE 3,A51,083647,Miranda; Gregory Joseph,37,0,37,0
1650176990778,CSE 8A,A50,083650,Miranda; Gregory Joseph,0,17,40,40
1650176996801,CSE 11,A01,083080,Cao; Yingjun,0,66,40,40
1650177002829,CSE 12,A01,083652,Staff,0,5,100,100
1650177008856,CSE 15L,A01,083654,Staff,0,0,50,50
1650177008856,CSE 15L,A02,083655,Staff,8,0,50,42
1650177014882,CSE 20,A01,083657,Staff,54,0,80,26
1650177020910,CSE 30,A01,083084,Eldon; John,0,67,40,40
1650177026934,CSE 100,A01,083659,Cao; Yingjun,0,61,50,50
1650177032958,CSE 134B,A01,083661,Powell; Thomas Allan,0,27,65,65
1650177038985,CSE 140,A01,083663,Staff,1,0,75,74
1650177045008,CSE 140L,A01,083088,Eldon; John,0,4,75,75
1650177051035,CSE 175,A01,083665,Kumar; Rakesh,8,0,25,17
1650177057061,CSE 190,A00,092507,Dubnov; Shlomo,14,0,20,6
1650177063087,ECE 45,A01,083139,Staff,0,13,40,40
1650177069111,ECE 65,A50,083695,Staff,0,5,30,30
1650177075134,ECE 109,A01,091882,Touri; Behrouz,47,0,70,23
1650177081157,ECE 180,A00,083140,Abi Samra; Nicholas Camill,24,0,30,6
1650177081157,ECE 180,B00,083141,Abi Samra; Nicholas Camill,8,0,30,22
1650177087184,MATH 10A,A01,083735,Patchell; Gregory David,12,0,30,18
1650177087184,MATH 10A,A02,083736,Patchell; Gregory David,28,0,30,2
1650177087184,MATH 10A,A03,083737,Patchell; Gregory David,26,0,30,4
1650177093207,MATH 10B,A01,083207,Staff,0,5,30,30
1650177093207,MATH 10B,A02,083208,Staff,0,5,30,30
1650177093207,MATH 10B,B01,083739,Staff,17,0,30,13
1650177093207,MATH 10B,B02,083740,Staff,29,0,30,1
1650177099232,MATH 18,A01,083743,Staff,10,0,30,20
1650177099232,MATH 18,A02,083744,Staff,28,0,30,2
1650177099232,MATH 18,A03,083745,Staff,23,0,30,7
1650177099232,MATH 18,A04,083746,Staff,27,0,30,3
1650177099232,MATH 18,B01,083748,Staff,0,10,30,30
1650177099232,MATH 18,B02,083749,Staff,0,7,30,30
1650177099232,MATH 18,B03,083750,Staff,0,7,30,30
1650177099232,MATH 18,B04,083751,Staff,0,7,30,30
1650177105255,MATH 20A,A01,083754,Staff,26,0,40,14
1650177111282,MATH 20B,A01,083756,Staff,0,6,30,30
1650177111282,MATH 20B,A02,083757,Staff,0,5,30,30
1650177117306,MATH 20C,A01,083760,Staff,0,12,30,30
1650177117306,MATH 20C,A02,083761,Staff,0,12,30,30
1650177117306,MATH 20C,B01,083762,Staff,14,0,30,16
1650177117306,MATH 20C,B02,083763,Staff,28,0,30,2
1650177123330,MATH 20D,A01,083765,Staff,0,2,30,30
1650177123330,MATH 20D,A02,083766,Staff,10,0,30,20
1650177123330,MATH 20D,A03,083767,Staff,28,0,30,2
1650177129358,MATH 20E,A01,083771,Staff,8,0,30,22
1650177129358,MATH 20E,A02,083772,Staff,20,0,30,10
1650177129358,MATH 20E,B01,083773,Staff,0,0,30,30
1650177129358,MATH 20E,B02,083774,Staff,13,0,30,17
1650177135385,MATH 103A,A01,083777,Staff,0,9,30,30
1650177135385,MATH 103A,A02,083778,Staff,0,10,30,30
1650177135385,MATH 103A,B01,083779,Staff,0,9,30,30
1650177135385,MATH 103A,B02,083780,Staff,0,9,30,30
1650177141416,MATH 105,A01,085443,Staff,0,17,30,30
1650177147441,MATH 109,A01,083213,Anzaldo; Leesa B,0,3,30,30
1650177147441,MATH 109,A02,083214,Anzaldo; Leesa B,0,6,30,30
1650177147441,MATH 109,B01,083215,Anzaldo; Leesa B,0,4,30,30
1650177147441,MATH 109,B02,083216,Anzaldo; Leesa B,0,4,30,30
1650177153467,MATH 142A,A01,083219,Chow; Bennett,0,12,30,30
1650177153467,MATH 142A,A02,083220,Chow; Bennett,0,11,30,30
1650177153467,MATH 142A,B01,083221,Chow; Bennett,0,11,30,30
1650177153467,MATH 142A,B02,083222,Chow; Bennett,0,12,30,30
1650177159496,MATH 193A,A01,083224,Staff,0,4,30,30
1650177159496,MATH 193A,A02,083225,Staff,0,4,30,30
1650177159496,MATH 193A,A03,083781,Staff,0,1,30,30
1650177159496,MATH 193A,A04,083782,Staff,0,1,30,30
1650177165519,MATH 197,001,091859,McAuley; Julian John,9998,0,9999,1
1650177171580,COGS 9,A01,083615,Staff,0,14,60,60
1650177177604,COGS 11,A01,083617,Boyle; Mary E. T.,24,0,40,16
1650177183635,COGS 13,A01,083071,Staff,0,30,40,40
1650177189657,COGS 14A,A01,092681,Staff,0,12,100,100
1650177195681,COGS 14B,A01,083073,Cheng; Tzu-Han,0,7,50,50
1650177201706,COGS 17,A01,092677,Staff,34,0,75,41
1650177207729,COGS 100,A01,083619,Staff,0,20,60,60
1650177213753,COGS 101A,A01,083621,Davis; Joshua Daniel,0,21,60,60
1650177219777,COGS 101B,A01,091572,Staff,6,0,60,54
1650177225810,COGS 101C,A01,083625,Delgado; Tania,20,0,30,10
1650177231833,COGS 107A,A01,083627,Boyle; Mary E. T.,0,7,60,60
1650177237860,COGS 118A,A01,083075,Staff,17,0,60,43
1650177243885,CSE 3,A50,083646,Miranda; Gregory Joseph,22,0,38,16
1650177243885,CSE 3,A51,083647,Miranda; Gregory Joseph,37,0,37,0
1650177249910,CSE 8A,A50,083650,Miranda; Gregory Joseph,0,17,40,40
1650177255943,CSE 11,A01,083080,Cao; Yingjun,0,66,40,40
1650177261969,CSE 12,A01,083652,Staff,0,5,100,100
1650177267992,CSE 15L,A01,083654,Staff,0,0,50,50
1650177267992,CSE 15L,A02,083655,Staff,8,0,50,42
1650177274017,CSE 20,A01,083657,Staff,54,0,80,26
1650177280044,CSE 30,A01,083084,Eldon; John,0,67,40,40
1650177286074,CSE 100,A01,083659,Cao; Yingjun,0,61,50,50
1650177292103,CSE 134B,A01,083661,Powell; Thomas Allan,0,27,65,65
1650177298126,CSE 140,A01,083663,Staff,1,0,75,74
1650177304151,CSE 140L,A01,083088,Eldon; John,0,4,75,75
1650177310179,CSE 175,A01,083665,Kumar; Rakesh,8,0,25,17
1650177316206,CSE 190,A00,092507,Dubnov; Shlomo,14,0,20,6
1650177322230,ECE 45,A01,083139,Staff,0,13,40,40
1650177328257,ECE 65,A50,083695,Staff,0,5,30,30
1650177334284,ECE 109,A01,091882,Touri; Behrouz,47,0,70,23
1650177340310,ECE 180,A00,083140,Abi Samra; Nicholas Camill,24,0,30,6
1650177340310,ECE 180,B00,083141,Abi Samra; Nicholas Camill,8,0,30,22
1650177346343,MATH 10A,A01,083735,Patchell; Gregory David,12,0,30,18
1650177346343,MATH 10A,A02,083736,Patchell; Gregory David,28,0,30,2
1650177346343,MATH 10A,A03,083737,Patchell; Gregory David,26,0,30,4
1650177352368,MATH 10B,A01,083207,Staff,0,5,30,30
1650177352368,MATH 10B,A02,083208,Staff,0,5,30,30
1650177352368,MATH 10B,B01,083739,Staff,17,0,30,13
1650177352368,MATH 10B,B02,083740,Staff,29,0,30,1
1650177358391,MATH 18,A01,083743,Staff,10,0,30,20
1650177358391,MATH 18,A02,083744,Staff,28,0,30,2
1650177358391,MATH 18,A03,083745,Staff,23,0,30,7
1650177358391,MATH 18,A04,083746,Staff,27,0,30,3
1650177358391,MATH 18,B01,083748,Staff,0,10,30,30
1650177358391,MATH 18,B02,083749,Staff,0,7,30,30
1650177358391,MATH 18,B03,083750,Staff,0,7,30,30
1650177358391,MATH 18,B04,083751,Staff,0,7,30,30
1650177364414,MATH 20A,A01,083754,Staff,26,0,40,14
1650177370438,MATH 20B,A01,083756,Staff,0,6,30,30
1650177370438,MATH 20B,A02,083757,Staff,0,5,30,30
1650177376473,MATH 20C,A01,083760,Staff,0,12,30,30
1650177376473,MATH 20C,A02,083761,Staff,0,12,30,30
1650177376473,MATH 20C,B01,083762,Staff,14,0,30,16
1650177376473,MATH 20C,B02,083763,Staff,28,0,30,2
1650177382498,MATH 20D,A01,083765,Staff,0,2,30,30
1650177382498,MATH 20D,A02,083766,Staff,10,0,30,20
1650177382498,MATH 20D,A03,083767,Staff,28,0,30,2
1650177388543,MATH 20E,A01,083771,Staff,8,0,30,22
1650177388543,MATH 20E,A02,083772,Staff,20,0,30,10
1650177388543,MATH 20E,B01,083773,Staff,0,0,30,30
1650177388543,MATH 20E,B02,083774,Staff,13,0,30,17
1650177394568,MATH 103A,A01,083777,Staff,0,9,30,30
1650177394568,MATH 103A,A02,083778,Staff,0,10,30,30
1650177394568,MATH 103A,B01,083779,Staff,0,9,30,30
1650177394568,MATH 103A,B02,083780,Staff,0,9,30,30
1650177400595,MATH 105,A01,085443,Staff,0,17,30,30
1650177406690,MATH 109,A01,083213,Anzaldo; Leesa B,0,3,30,30
1650177406690,MATH 109,A02,083214,Anzaldo; Leesa B,0,6,30,30
1650177406690,MATH 109,B01,083215,Anzaldo; Leesa B,0,4,30,30
1650177406690,MATH 109,B02,083216,Anzaldo; Leesa B,0,4,30,30
1650177412714,MATH 142A,A01,083219,Chow; Bennett,0,12,30,30
1650177412714,MATH 142A,A02,083220,Chow; Bennett,0,11,30,30
1650177412714,MATH 142A,B01,083221,Chow; Bennett,0,11,30,30
1650177412714,MATH 142A,B02,083222,Chow; Bennett,0,12,30,30
1650177418738,MATH 193A,A01,083224,Staff,0,4,30,30
1650177418738,MATH 193A,A02,083225,Staff,0,4,30,30
1650177418738,MATH 193A,A03,083781,Staff,0,1,30,30
1650177418738,MATH 193A,A04,083782,Staff,0,1,30,30
1650177424762,MATH 197,001,091859,McAuley; Julian John,9998,0,9999,1
1650177430816,COGS 9,A01,083615,Staff,0,14,60,60
1650177436844,COGS 11,A01,083617,Boyle; Mary E. T.,24,0,40,16
1650177442870,COGS 13,A01,083071,Staff,0,30,40,40
1650177448894,COGS 14A,A01,092681,Staff,0,12,100,100
1650177454918,COGS 14B,A01,083073,Cheng; Tzu-Han,0,7,50,50
1650177460950,COGS 17,A01,092677,Staff,34,0,75,41
1650177466974,COGS 100,A01,083619,Staff,0,20,60,60
1650177473001,COGS 101A,A01,083621,Davis; Joshua Daniel,0,21,60,60
1650177479029,COGS 101B,A01,091572,Staff,6,0,60,54
1650177485069,COGS 101C,A01,083625,Delgado; Tania,20,0,30,10
1650177491093,COGS 107A,A01,083627,Boyle; Mary E. T.,0,7,60,60
1650177497120,COGS 118A,A01,083075,Staff,17,0,60,43
1650177503147,CSE 3,A50,083646,Miranda; Gregory Joseph,22,0,38,16
1650177503147,CSE 3,A51,083647,Miranda; Gregory Joseph,37,0,37,0
1650177509170,CSE 8A,A50,083650,Miranda; Gregory Joseph,0,17,40,40
1650177515192,CSE 11,A01,083080,Cao; Yingjun,0,66,40,40
1650177521217,CSE 12,A01,083652,Staff,0,5,100,100
1650177527243,CSE 15L,A01,083654,Staff,0,0,50,50
1650177527243,CSE 15L,A02,083655,Staff,8,0,50,42
1650177533265,CSE 20,A01,083657,Staff,54,0,80,26
1650177539288,CSE 30,A01,083084,Eldon; John,0,67,40,40
1650177545309,CSE 100,A01,083659,Cao; Yingjun,0,62,50,50
1650177551336,CSE 134B,A01,083661,Powell; Thomas Allan,0,27,65,65
1650177557364,CSE 140,A01,083663,Staff,1,0,75,74
1650177563391,CSE 140L,A01,083088,Eldon; John,0,4,75,75
1650177569431,CSE 175,A01,083665,Kumar; Rakesh,8,0,25,17
1650177575454,CSE 190,A00,092507,Dubnov; Shlomo,14,0,20,6
1650177581483,ECE 45,A01,083139,Staff,0,13,40,40
1650177587507,ECE 65,A50,083695,Staff,0,5,30,30
1650177593534,ECE 109,A01,091882,Touri; Behrouz,47,0,70,23
1650177599561,ECE 180,A00,083140,Abi Samra; Nicholas Camill,24,0,30,6
1650177599561,ECE 180,B00,083141,Abi Samra; Nicholas Camill,8,0,30,22
1650177605589,MATH 10A,A01,083735,Patchell; Gregory David,12,0,30,18
1650177605589,MATH 10A,A02,083736,Patchell; Gregory David,28,0,30,2
1650177605589,MATH 10A,A03,083737,Patchell; Gregory David,26,0,30,4
1650177611618,MATH 10B,A01,083207,Staff,0,5,30,30
1650177611618,MATH 10B,A02,083208,Staff,0,5,30,30
1650177611618,MATH 10B,B01,083739,Staff,17,0,30,13
1650177611618,MATH 10B,B02,083740,Staff,29,0,30,1
1650177617650,MATH 18,A01,083743,Staff,10,0,30,20
1650177617650,MATH 18,A02,083744,Staff,28,0,30,2
1650177617650,MATH 18,A03,083745,Staff,23,0,30,7
1650177617650,MATH 18,A04,083746,Staff,27,0,30,3
1650177617650,MATH 18,B01,083748,Staff,0,10,30,30
1650177617650,MATH 18,B02,083749,Staff,0,7,30,30
1650177617650,MATH 18,B03,083750,Staff,0,7,30,30
1650177617650,MATH 18,B04,083751,Staff,0,7,30,30
1650177623673,MATH 20A,A01,083754,Staff,26,0,40,14
1650177629698,MATH 20B,A01,083756,Staff,0,6,30,30
1650177629698,MATH 20B,A02,083757,Staff,0,5,30,30
1650177635727,MATH 20C,A01,083760,Staff,0,12,30,30
1650177635727,MATH 20C,A02,083761,Staff,0,12,30,30
1650177635727,MATH 20C,B01,083762,Staff,14,0,30,16
1650177635727,MATH 20C,B02,083763,Staff,28,0,30,2
1650177641754,MATH 20D,A01,083765,Staff,0,2,30,30
1650177641754,MATH 20D,A02,083766,Staff,10,0,30,20
1650177641754,MATH 20D,A03,083767,Staff,28,0,30,2
1650177647782,MATH 20E,A01,083771,Staff,8,0,30,22
1650177647782,MATH 20E,A02,083772,Staff,20,0,30,10
1650177647782,MATH 20E,B01,083773,Staff,0,0,30,30
1650177647782,MATH 20E,B02,083774,Staff,13,0,30,17
1650177653805,MATH 103A,A01,083777,Staff,0,9,30,30
1650177653805,MATH 103A,A02,083778,Staff,0,10,30,30
1650177653805,MATH 103A,B01,083779,Staff,0,9,30,30
1650177653805,MATH 103A,B02,083780,Staff,0,9,30,30
1650177659837,MATH 105,A01,085443,Staff,0,17,30,30
1650177665862,MATH 109,A01,083213,Anzaldo; Leesa B,0,3,30,30
1650177665862,MATH 109,A02,083214,Anzaldo; Leesa B,0,6,30,30
1650177665862,MATH 109,B01,083215,Anzaldo; Leesa B,0,4,30,30
1650177665862,MATH 109,B02,083216,Anzaldo; Leesa B,0,4,30,30
1650177671890,MATH 142A,A01,083219,Chow; Bennett,0,12,30,30
1650177671890,MATH 142A,A02,083220,Chow; Bennett,0,11,30,30
1650177671890,MATH 142A,B01,083221,Chow; Bennett,0,11,30,30
1650177671890,MATH 142A,B02,083222,Chow; Bennett,0,12,30,30
1650177677915,MATH 193A,A01,083224,Staff,0,4,30,30
1650177677915,MATH 193A,A02,083225,Staff,0,4,30,30
1650177677915,MATH 193A,A03,083781,Staff,0,1,30,30
1650177677915,MATH 193A,A04,083782,Staff,0,1,30,30
1650177683941,MATH 197,001,091859,McAuley; Julian John,9998,0,9999,1
1650177689990,COGS 9,A01,083615,Staff,0,14,60,60
1650177696022,COGS 11,A01,083617,Boyle; Mary E. T.,24,0,40,16
1650177702046,COGS 13,A01,083071,Staff,0,30,40,40
1650177708071,COGS 14A,A01,092681,Staff,0,12,100,100
1650177714099,COGS 14B,A01,083073,Cheng; Tzu-Han,0,7,50,50
1650177720126,COGS 17,A01,092677,Staff,34,0,75,41
1650177726154,COGS 100,A01,083619,Staff,0,20,60,60
1650177732178,COGS 101A,A01,083621,Davis; Joshua Daniel,0,21,60,60
1650177738203,COGS 101B,A01,091572,Staff,6,0,60,54
1650177744231,COGS 101C,A01,083625,Delgado; Tania,20,0,30,10
1650177750269,COGS 107A,A01,083627,Boyle; Mary E. T.,0,7,60,60
1650177756295,COGS 118A,A01,083075,Staff,17,0,60,43
1650177762323,CSE 3,A50,083646,Miranda; Gregory Joseph,22,0,38,16
1650177762323,CSE 3,A51,083647,Miranda; Gregory Joseph,37,0,37,0
1650177768350,CSE 8A,A50,083650,Miranda; Gregory Joseph,0,17,40,40
1650177774379,CSE 11,A01,083080,Cao; Yingjun,0,66,40,40
1650177780411,CSE 12,A01,083652,Staff,0,5,100,100
1650177786436,CSE 15L,A01,083654,Staff,0,0,50,50
1650177786436,CSE 15L,A02,083655,Staff,8,0,50,42
1650177792462,CSE 20,A01,083657,Staff,54,0,80,26
1650177798487,CSE 30,A01,083084,Eldon; John,0,67,40,40
1650177804514,CSE 100,A01,083659,Cao; Yingjun,0,62,50,50
1650177810543,CSE 134B,A01,083661,Powell; Thomas Allan,0,27,65,65
1650177816571,CSE 140,A01,083663,Staff,1,0,75,74
1650177822594,CSE 140L,A01,083088,Eldon; John,0,4,75,75
1650177828622,CSE 175,A01,083665,Kumar; Rakesh,8,0,25,17
1650177834656,CSE 190,A00,092507,Dubnov; Shlomo,14,0,20,6
1650177840679,ECE 45,A01,083139,Staff,0,13,40,40
1650177846707,ECE 65,A50,083695,Staff,0,5,30,30
1650177852732,ECE 109,A01,091882,Touri; Behrouz,47,0,70,23
1650177858755,ECE 180,A00,083140,Abi Samra; Nicholas Camill,24,0,30,6
1650177858755,ECE 180,B00,083141,Abi Samra; Nicholas Camill,8,0,30,22
1650177864779,MATH 10A,A01,083735,Patchell; Gregory David,12,0,30,18
1650177864779,MATH 10A,A02,083736,Patchell; Gregory David,28,0,30,2
1650177864779,MATH 10A,A03,083737,Patchell; Gregory David,26,0,30,4
1650177870807,MATH 10B,A01,083207,Staff,0,5,30,30
1650177870807,MATH 10B,A02,083208,Staff,0,5,30,30
1650177870807,MATH 10B,B01,083739,Staff,17,0,30,13
1650177870807,MATH 10B,B02,083740,Staff,29,0,30,1
1650177876835,MATH 18,A01,083743,Staff,10,0,30,20
1650177876835,MATH 18,A02,083744,Staff,28,0,30,2
1650177876835,MATH 18,A03,083745,Staff,23,0,30,7
1650177876835,MATH 18,A04,083746,Staff,27,0,30,3
1650177876835,MATH 18,B01,083748,Staff,0,10,30,30
1650177876835,MATH 18,B02,083749,Staff,0,7,30,30
1650177876835,MATH 18,B03,083750,Staff,0,7,30,30
1650177876835,MATH 18,B04,083751,Staff,0,7,30,30
1650177882862,MATH 20A,A01,083754,Staff,26,0,40,14
1650177888885,MATH 20B,A01,083756,Staff,0,6,30,30
1650177888885,MATH 20B,A02,083757,Staff,0,5,30,30
1650177894923,MATH 20C,A01,083760,Staff,0,12,30,30
1650177894923,MATH 20C,A02,083761,Staff,0,12,30,30
1650177894923,MATH 20C,B01,083762,Staff,14,0,30,16
1650177894923,MATH 20C,B02,083763,Staff,28,0,30,2
1650177900948,MATH 20D,A01,083765,Staff,0,2,30,30
1650177900948,MATH 20D,A02,083766,Staff,10,0,30,20
1650177900948,MATH 20D,A03,083767,Staff,28,0,30,2
1650177906973,MATH 20E,A01,083771,Staff,8,0,30,22
1650177906973,MATH 20E,A02,083772,Staff,20,0,30,10
1650177906973,MATH 20E,B01,083773,Staff,0,0,30,30
1650177906973,MATH 20E,B02,083774,Staff,13,0,30,17
1650177912998,MATH 103A,A01,083777,Staff,0,9,30,30
1650177912998,MATH 103A,A02,083778,Staff,0,10,30,30
1650177912998,MATH 103A,B01,083779,Staff,0,9,30,30
1650177912998,MATH 103A,B02,083780,Staff,0,9,30,30
1650177919026,MATH 105,A01,085443,Staff,0,17,30,30
1650177925051,MATH 109,A01,083213,Anzaldo; Leesa B,0,3,30,30
1650177925051,MATH 109,A02,083214,Anzaldo; Leesa B,0,6,30,30
1650177925051,MATH 109,B01,083215,Anzaldo; Leesa B,0,4,30,30
1650177925051,MATH 109,B02,083216,Anzaldo; Leesa B,0,4,30,30
1650177931076,MATH 142A,A01,083219,Chow; Bennett,0,12,30,30
1650177931076,MATH 142A,A02,083220,Chow; Bennett,0,11,30,30
1650177931076,MATH 142A,B01,083221,Chow; Bennett,0,11,30,30
1650177931076,MATH 142A,B02,083222,Chow; Bennett,0,12,30,30
1650177937112,MATH 193A,A01,083224,Staff,0,4,30,30
1650177937112,MATH 193A,A02,083225,Staff,0,4,30,30
1650177937112,MATH 193A,A03,083781,Staff,0,1,30,30
1650177937112,MATH 193A,A04,083782,Staff,0,1,30,30
1650177943140,MATH 197,001,091859,McAuley; Julian John,9998,0,9999,1
1650177949195,COGS 9,A01,083615,Staff,0,14,60,60
1650177955222,COGS 11,A01,083617,Boyle; Mary E. T.,24,0,40,16
1650177961249,COGS 13,A01,083071,Staff,0,30,40,40
1650177967277,COGS 14A,A01,092681,Staff,0,12,100,100
1650177973305,COGS 14B,A01,083073,Cheng; Tzu-Han,0,7,50,50
1650177979328,COGS 17,A01,092677,Staff,34,0,75,41
1650177985350,COGS 100,A01,083619,Staff,0,20,60,60
1650177991375,COGS 101A,A01,083621,Davis; Joshua Daniel,0,21,60,60
1650177997470,COGS 101B,A01,091572,Staff,6,0,60,54
1650178003493,COGS 101C,A01,083625,Delgado; Tania,20,0,30,10
1650178009520,COGS 107A,A01,083627,Boyle; Mary E. T.,0,7,60,60
1650178015544,COGS 118A,A01,083075,Staff,17,0,60,43
1650178021572,CSE 3,A50,083646,Miranda; Gregory Joseph,22,0,38,16
1650178021572,CSE 3,A51,083647,Miranda; Gregory Joseph,37,0,37,0
1650178027599,CSE 8A,A50,083650,Miranda; Gregory Joseph,0,17,40,40
1650178033623,CSE 11,A01,083080,Cao; Yingjun,0,66,40,40
1650178039647,CSE 12,A01,083652,Staff,0,5,100,100
1650178045672,CSE 15L,A01,083654,Staff,0,0,50,50
1650178045672,CSE 15L,A02,083655,Staff,8,0,50,42
1650178051696,CSE 20,A01,083657,Staff,54,0,80,26
1650178057719,CSE 30,A01,083084,Eldon; John,0,67,40,40
1650178063744,CSE 100,A01,083659,Cao; Yingjun,0,62,50,50
1650178069780,CSE 134B,A01,083661,Powell; Thomas Allan,0,27,65,65
1650178075803,CSE 140,A01,083663,Staff,1,0,75,74
1650178081826,CSE 140L,A01,083088,Eldon; John,0,4,75,75
1650178087853,CSE 175,A01,083665,Kumar; Rakesh,8,0,25,17
1650178093881,CSE 190,A00,092507,Dubnov; Shlomo,14,0,20,6
1650178099904,ECE 45,A01,083139,Staff,0,13,40,40
1650178105929,ECE 65,A50,083695,Staff,0,5,30,30
1650178111953,ECE 109,A01,091882,Touri; Behrouz,47,0,70,23
1650178117980,ECE 180,A00,083140,Abi Samra; Nicholas Camill,24,0,30,6
1650178117980,ECE 180,B00,083141,Abi Samra; Nicholas Camill,8,0,30,22
1650178124005,MATH 10A,A01,083735,Patchell; Gregory David,12,0,30,18
1650178124005,MATH 10A,A02,083736,Patchell; Gregory David,28,0,30,2
1650178124005,MATH 10A,A03,083737,Patchell; Gregory David,26,0,30,4
1650178130034,MATH 10B,A01,083207,Staff,0,5,30,30
1650178130034,MATH 10B,A02,083208,Staff,0,5,30,30
1650178130034,MATH 10B,B01,083739,Staff,17,0,30,13
1650178130034,MATH 10B,B02,083740,Staff,29,0,30,1
1650178136060,MATH 18,A01,083743,Staff,10,0,30,20
1650178136060,MATH 18,A02,083744,Staff,28,0,30,2
1650178136060,MATH 18,A03,083745,Staff,23,0,30,7
1650178136060,MATH 18,A04,083746,Staff,27,0,30,3
1650178136060,MATH 18,B01,083748,Staff,0,10,30,30
1650178136060,MATH 18,B02,083749,Staff,0,7,30,30
1650178136060,MATH 18,B03,083750,Staff,0,7,30,30
1650178136060,MATH 18,B04,083751,Staff,0,7,30,30
1650178142083,MATH 20A,A01,083754,Staff,26,0,40,14
1650178148116,MATH 20B,A01,083756,Staff,0,6,30,30
1650178148116,MATH 20B,A02,083757,Staff,0,5,30,30
1650178154141,MATH 20C,A01,083760,Staff,0,12,30,30
1650178154141,MATH 20C,A02,083761,Staff,0,12,30,30
1650178154141,MATH 20C,B01,083762,Staff,14,0,30,16
1650178154141,MATH 20C,B02,083763,Staff,28,0,30,2
1650178160168,MATH 20D,A01,083765,Staff,0,2,30,30
1650178160168,MATH 20D,A02,083766,Staff,10,0,30,20
1650178160168,MATH 20D,A03,083767,Staff,28,0,30,2
1650178166196,MATH 20E,A01,083771,Staff,8,0,30,22
1650178166196,MATH 20E,A02,083772,Staff,20,0,30,10
1650178166196,MATH 20E,B01,083773,Staff,0,0,30,30
1650178166196,MATH 20E,B02,083774,Staff,13,0,30,17
1650178172221,MATH 103A,A01,083777,Staff,0,9,30,30
1650178172221,MATH 103A,A02,083778,Staff,0,10,30,30
1650178172221,MATH 103A,B01,083779,Staff,0,9,30,30
1650178172221,MATH 103A,B02,083780,Staff,0,9,30,30
1650178178244,MATH 105,A01,085443,Staff,0,17,30,30
1650178184273,MATH 109,A01,083213,Anzaldo; Leesa B,0,3,30,30
1650178184273,MATH 109,A02,083214,Anzaldo; Leesa B,0,6,30,30
1650178184273,MATH 109,B01,083215,Anzaldo; Leesa B,0,4,30,30
1650178184273,MATH 109,B02,083216,Anzaldo; Leesa B,0,4,30,30
1650178190299,MATH 142A,A01,083219,Chow; Bennett,0,12,30,30
1650178190299,MATH 142A,A02,083220,Chow; Bennett,0,11,30,30
1650178190299,MATH 142A,B01,083221,Chow; Bennett,0,11,30,30
1650178190299,MATH 142A,B02,083222,Chow; Bennett,0,12,30,30
1650178196324,MATH 193A,A01,083224,Staff,0,4,30,30
1650178196324,MATH 193A,A02,083225,Staff,0,4,30,30
1650178196324,MATH 193A,A03,083781,Staff,0,1,30,30
1650178196324,MATH 193A,A04,083782,Staff,0,1,30,30
1650178202352,MATH 197,001,091859,McAuley; Julian John,9998,0,9999,1
1650178208400,COGS 9,A01,083615,Staff,0,14,60,60
1650178214423,COGS 11,A01,083617,Boyle; Mary E. T.,24,0,40,16
1650178220447,COGS 13,A01,083071,Staff,0,30,40,40
1650178226473,COGS 14A,A01,092681,Staff,0,12,100,100
1650178232500,COGS 14B,A01,083073,Cheng; Tzu-Han,0,7,50,50
1650178238527,COGS 17,A01,092677,Staff,34,0,75,41
1650178244557,COGS 100,A01,083619,Staff,0,20,60,60
1650178250581,COGS 101A,A01,083621,Davis; Joshua Daniel,0,21,60,60
1650178256605,COGS 101B,A01,091572,Staff,6,0,60,54
1650178262631,COGS 101C,A01,083625,Delgado; Tania,20,0,30,10
1650178268654,COGS 107A,A01,083627,Boyle; Mary E. T.,0,7,60,60
1650178274682,COGS 118A,A01,083075,Staff,17,0,60,43
1650178280706,CSE 3,A50,083646,Miranda; Gregory Joseph,22,0,38,16
1650178280706,CSE 3,A51,083647,Miranda; Gregory Joseph,37,0,37,0
1650178286735,CSE 8A,A50,083650,Miranda; Gregory Joseph,0,17,40,40
1650178292761,CSE 11,A01,083080,Cao; Yingjun,0,67,40,40
1650178298784,CSE 12,A01,083652,Staff,0,5,100,100
1650178304833,CSE 15L,A01,083654,Staff,0,0,50,50
1650178304833,CSE 15L,A02,083655,Staff,8,0,50,42
1650178310866,CSE 20,A01,083657,Staff,54,0,80,26
1650178316891,CSE 30,A01,083084,Eldon; John,0,67,40,40
1650178322915,CSE 100,A01,083659,Cao; Yingjun,0,62,50,50
1650178328943,CSE 134B,A01,083661,Powell; Thomas Allan,0,27,65,65
1650178334966,CSE 140,A01,083663,Staff,1,0,75,74
1650178340992,CSE 140L,A01,083088,Eldon; John,0,4,75,75
1650178347016,CSE 175,A01,083665,Kumar; Rakesh,8,0,25,17
1650178353041,CSE 190,A00,092507,Dubnov; Shlomo,14,0,20,6
1650178359064,ECE 45,A01,083139,Staff,0,13,40,40
1650178365089,ECE 65,A50,083695,Staff,0,5,30,30
1650178371116,ECE 109,A01,091882,Touri; Behrouz,47,0,70,23
1650178377144,ECE 180,A00,083140,Abi Samra; Nicholas Camill,24,0,30,6
1650178377144,ECE 180,B00,083141,Abi Samra; Nicholas Camill,8,0,30,22
1650178383169,MATH 10A,A01,083735,Patchell; Gregory David,12,0,30,18
1650178383169,MATH 10A,A02,083736,Patchell; Gregory David,28,0,30,2
1650178383169,MATH 10A,A03,083737,Patchell; Gregory David,26,0,30,4
1650178389194,MATH 10B,A01,083207,Staff,0,5,30,30
1650178389194,MATH 10B,A02,083208,Staff,0,5,30,30
1650178389194,MATH 10B,B01,083739,Staff,17,0,30,13
1650178389194,MATH 10B,B02,083740,Staff,29,0,30,1
1650178395219,MATH 18,A01,083743,Staff,10,0,30,20
1650178395219,MATH 18,A02,083744,Staff,28,0,30,2
1650178395219,MATH 18,A03,083745,Staff,23,0,30,7
1650178395219,MATH 18,A04,083746,Staff,27,0,30,3
1650178395219,MATH 18,B01,083748,Staff,0,10,30,30
1650178395219,MATH 18,B02,083749,Staff,0,7,30,30
1650178395219,MATH 18,B03,083750,Staff,0,7,30,30
1650178395219,MATH 18,B04,083751,Staff,0,7,30,30
1650178401242,MATH 20A,A01,083754,Staff,26,0,40,14
1650178407266,MATH 20B,A01,083756,Staff,0,6,30,30
1650178407266,MATH 20B,A02,083757,Staff,0,5,30,30
1650178413293,MATH 20C,A01,083760,Staff,0,12,30,30
1650178413293,MATH 20C,A02,083761,Staff,0,12,30,30
1650178413293,MATH 20C,B01,083762,Staff,14,0,30,16
1650178413293,MATH 20C,B02,083763,Staff,28,0,30,2
1650178419320,MATH 20D,A01,083765,Staff,0,2,30,30
1650178419320,MATH 20D,A02,083766,Staff,10,0,30,20
1650178419320,MATH 20D,A03,083767,Staff,28,0,30,2
1650178425356,MATH 20E,A01,083771,Staff,8,0,30,22
1650178425356,MATH 20E,A02,083772,Staff,20,0,30,10
1650178425356,MATH 20E,B01,083773,Staff,0,0,30,30
1650178425356,MATH 20E,B02,083774,Staff,13,0,30,17
1650178431385,MATH 103A,A01,083777,Staff,0,9,30,30
1650178431385,MATH 103A,A02,083778,Staff,0,10,30,30
1650178431385,MATH 103A,B01,083779,Staff,0,9,30,30
1650178431385,MATH 103A,B02,083780,Staff,0,9,30,30
1650178437411,MATH 105,A01,085443,Staff,0,17,30,30
1650178443434,MATH 109,A01,083213,Anzaldo; Leesa B,0,3,30,30
1650178443434,MATH 109,A02,083214,Anzaldo; Leesa B,0,6,30,30
1650178443434,MATH 109,B01,083215,Anzaldo; Leesa B,0,4,30,30
1650178443434,MATH 109,B02,083216,Anzaldo; Leesa B,0,4,30,30
1650178449462,MATH 142A,A01,083219,Chow; Bennett,0,12,30,30
1650178449462,MATH 142A,A02,083220,Chow; Bennett,0,11,30,30
1650178449462,MATH 142A,B01,083221,Chow; Bennett,0,11,30,30
1650178449462,MATH 142A,B02,083222,Chow; Bennett,0,12,30,30
1650178455488,MATH 193A,A01,083224,Staff,0,4,30,30
1650178455488,MATH 193A,A02,083225,Staff,0,4,30,30
1650178455488,MATH 193A,A03,083781,Staff,0,1,30,30
1650178455488,MATH 193A,A04,083782,Staff,0,1,30,30
1650178461513,MATH 197,001,091859,McAuley; Julian John,9998,0,9999,1
1650178467566,COGS 9,A01,083615,Staff,0,14,60,60
1650178473590,COGS 11,A01,083617,Boyle; Mary E. T.,24,0,40,16
1650178479613,COGS 13,A01,083071,Staff,0,30,40,40
1650178485641,COGS 14A,A01,092681,Staff,0,12,100,100
1650178491670,COGS 14B,A01,083073,Cheng; Tzu-Han,0,7,50,50
1650178497695,COGS 17,A01,092677,Staff,34,0,75,41
1650178503720,COGS 100,A01,083619,Staff,0,20,60,60
1650178509744,COGS 101A,A01,083621,Davis; Joshua Daniel,0,21,60,60
1650178515773,COGS 101B,A01,091572,Staff,6,0,60,54
1650178521806,COGS 101C,A01,083625,Delgado; Tania,20,0,30,10
1650178527830,COGS 107A,A01,083627,Boyle; Mary E. T.,0,7,60,60
1650178533854,COGS 118A,A01,083075,Staff,17,0,60,43
1650178539886,CSE 3,A50,083646,Miranda; Gregory Joseph,22,0,38,16
1650178539886,CSE 3,A51,083647,Miranda; Gregory Joseph,37,0,37,0
1650178545913,CSE 8A,A50,083650,Miranda; Gregory Joseph,0,17,40,40
1650178551940,CSE 11,A01,083080,Cao; Yingjun,0,67,40,40
1650178557962,CSE 12,A01,083652,Staff,0,5,100,100
1650178563987,CSE 15L,A01,083654,Staff,0,0,50,50
1650178563987,CSE 15L,A02,083655,Staff,8,0,50,42
1650178570012,CSE 20,A01,083657,Staff,54,0,80,26
1650178576036,CSE 30,A01,083084,Eldon; John,0,67,40,40
1650178582060,CSE 100,A01,083659,Cao; Yingjun,0,63,50,50
1650178588088,CSE 134B,A01,083661,Powell; Thomas Allan,0,27,65,65
1650178594188,CSE 140,A01,083663,Staff,1,0,75,74
1650178600215,CSE 140L,A01,083088,Eldon; John,0,4,75,75
1650178606239,CSE 175,A01,083665,Kumar; Rakesh,8,0,25,17
1650178612263,CSE 190,A00,092507,Dubnov; Shlomo,14,0,20,6
1650178618291,ECE 45,A01,083139,Staff,0,13,40,40
1650178624321,ECE 65,A50,083695,Staff,0,5,30,30
1650178630349,ECE 109,A01,091882,Touri; Behrouz,47,0,70,23
1650178636374,ECE 180,A00,083140,Abi Samra; Nicholas Camill,24,0,30,6
1650178636374,ECE 180,B00,083141,Abi Samra; Nicholas Camill,8,0,30,22
1650178642398,MATH 10A,A01,083735,Patchell; Gregory David,11,0,30,19
1650178642398,MATH 10A,A02,083736,Patchell; Gregory David,28,0,30,2
1650178642398,MATH 10A,A03,083737,Patchell; Gregory David,26,0,30,4
1650178648425,MATH 10B,A01,083207,Staff,0,5,30,30
1650178648425,MATH 10B,A02,083208,Staff,0,5,30,30
1650178648425,MATH 10B,B01,083739,Staff,17,0,30,13
1650178648425,MATH 10B,B02,083740,Staff,29,0,30,1
1650178654452,MATH 18,A01,083743,Staff,10,0,30,20
1650178654452,MATH 18,A02,083744,Staff,28,0,30,2
1650178654452,MATH 18,A03,083745,Staff,23,0,30,7
1650178654452,MATH 18,A04,083746,Staff,27,0,30,3
1650178654452,MATH 18,B01,083748,Staff,0,10,30,30
1650178654452,MATH 18,B02,083749,Staff,0,7,30,30
1650178654452,MATH 18,B03,083750,Staff,0,7,30,30
1650178654452,MATH 18,B04,083751,Staff,0,7,30,30
1650178660475,MATH 20A,A01,083754,Staff,26,0,40,14
1650178666503,MATH 20B,A01,083756,Staff,0,6,30,30
1650178666503,MATH 20B,A02,083757,Staff,0,5,30,30
1650178672533,MATH 20C,A01,083760,Staff,0,12,30,30
1650178672533,MATH 20C,A02,083761,Staff,0,12,30,30
1650178672533,MATH 20C,B01,083762,Staff,14,0,30,16
1650178672533,MATH 20C,B02,083763,Staff,28,0,30,2
1650178678561,MATH 20D,A01,083765,Staff,0,2,30,30
1650178678561,MATH 20D,A02,083766,Staff,10,0,30,20
1650178678561,MATH 20D,A03,083767,Staff,28,0,30,2
1650178684586,MATH 20E,A01,083771,Staff,8,0,30,22
1650178684586,MATH 20E,A02,083772,Staff,20,0,30,10
1650178684586,MATH 20E,B01,083773,Staff,0,0,30,30
1650178684586,MATH 20E,B02,083774,Staff,13,0,30,17
1650178690615,MATH 103A,A01,083777,Staff,0,9,30,30
1650178690615,MATH 103A,A02,083778,Staff,0,10,30,30
1650178690615,MATH 103A,B01,083779,Staff,0,9,30,30
1650178690615,MATH 103A,B02,083780,Staff,0,9,30,30
1650178696643,MATH 105,A01,085443,Staff,0,17,30,30
1650178702671,MATH 109,A01,083213,Anzaldo; Leesa B,0,3,30,30
1650178702671,MATH 109,A02,083214,Anzaldo; Leesa B,0,6,30,30
1650178702671,MATH 109,B01,083215,Anzaldo; Leesa B,0,4,30,30
1650178702671,MATH 109,B02,083216,Anzaldo; Leesa B,0,4,30,30
1650178708699,MATH 142A,A01,083219,Chow; Bennett,0,12,30,30
1650178708699,MATH 142A,A02,083220,Chow; Bennett,0,11,30,30
1650178708699,MATH 142A,B01,083221,Chow; Bennett,0,11,30,30
1650178708699,MATH 142A,B02,083222,Chow; Bennett,0,12,30,30
1650178714727,MATH 193A,A01,083224,Staff,0,4,30,30
1650178714727,MATH 193A,A02,083225,Staff,0,4,30,30
1650178714727,MATH 193A,A03,083781,Staff,0,1,30,30
1650178714727,MATH 193A,A04,083782,Staff,0,1,30,30
1650178720754,MATH 197,001,091859,McAuley; Julian John,9998,0,9999,1
1650178726811,COGS 9,A01,083615,Staff,0,14,60,60
1650178732835,COGS 11,A01,083617,Boyle; Mary E. T.,24,0,40,16
1650178738863,COGS 13,A01,083071,Staff,0,30,40,40
1650178744887,COGS 14A,A01,092681,Staff,0,12,100,100
1650178750911,COGS 14B,A01,083073,Cheng; Tzu-Han,0,7,50,50
1650178756938,COGS 17,A01,092677,Staff,34,0,75,41
1650178762962,COGS 100,A01,083619,Staff,0,20,60,60
1650178768986,COGS 101A,A01,083621,Davis; Joshua Daniel,0,21,60,60
1650178775010,COGS 101B,A01,091572,Staff,6,0,60,54
1650178781032,COGS 101C,A01,083625,Delgado; Tania,20,0,30,10
1650178787059,COGS 107A,A01,083627,Boyle; Mary E. T.,0,7,60,60
1650178793088,COGS 118A,A01,083075,Staff,17,0,60,43
1650178799115,CSE 3,A50,083646,Miranda; Gregory Joseph,22,0,38,16
1650178799115,CSE 3,A51,083647,Miranda; Gregory Joseph,37,0,37,0
1650178805137,CSE 8A,A50,083650,Miranda; Gregory Joseph,0,17,40,40
1650178811161,CSE 11,A01,083080,Cao; Yingjun,0,67,40,40
1650178817189,CSE 12,A01,083652,Staff,0,5,100,100
1650178823212,CSE 15L,A01,083654,Staff,0,0,50,50
1650178823212,CSE 15L,A02,083655,Staff,8,0,50,42
1650178829236,CSE 20,A01,083657,Staff,54,0,80,26
1650178835258,CSE 30,A01,083084,Eldon; John,0,67,40,40
1650178841282,CSE 100,A01,083659,Cao; Yingjun,0,63,50,50
1650178847305,CSE 134B,A01,083661,Powell; Thomas Allan,0,27,65,65
1650178853330,CSE 140,A01,083663,Staff,1,0,75,74
1650178859361,CSE 140L,A01,083088,Eldon; John,0,4,75,75
1650178865391,CSE 175,A01,083665,Kumar; Rakesh,8,0,25,17
1650178871419,CSE 190,A00,092507,Dubnov; Shlomo,14,0,20,6
1650178877446,ECE 45,A01,083139,Staff,0,13,40,40
1650178883470,ECE 65,A50,083695,Staff,0,5,30,30
1650178889494,ECE 109,A01,091882,Touri; Behrouz,47,0,70,23
1650178895518,ECE 180,A00,083140,Abi Samra; Nicholas Camill,24,0,30,6
1650178895518,ECE 180,B00,083141,Abi Samra; Nicholas Camill,8,0,30,22
1650178901545,MATH 10A,A01,083735,Patchell; Gregory David,11,0,30,19
1650178901545,MATH 10A,A02,083736,Patchell; Gregory David,28,0,30,2
1650178901545,MATH 10A,A03,083737,Patchell; Gregory David,26,0,30,4
1650178907572,MATH 10B,A01,083207,Staff,0,5,30,30
1650178907572,MATH 10B,A02,083208,Staff,0,5,30,30
1650178907572,MATH 10B,B01,083739,Staff,17,0,30,13
1650178907572,MATH 10B,B02,083740,Staff,29,0,30,1
1650178913604,MATH 18,A01,083743,Staff,10,0,30,20
1650178913604,MATH 18,A02,083744,Staff,28,0,30,2
1650178913604,MATH 18,A03,083745,Staff,23,0,30,7
1650178913604,MATH 18,A04,083746,Staff,27,0,30,3
1650178913604,MATH 18,B01,083748,Staff,0,10,30,30
1650178913604,MATH 18,B02,083749,Staff,0,7,30,30
1650178913604,MATH 18,B03,083750,Staff,0,7,30,30
1650178913604,MATH 18,B04,083751,Staff,0,7,30,30
1650178919643,MATH 20A,A01,083754,Staff,26,0,40,14
1650178925668,MATH 20B,A01,083756,Staff,0,6,30,30
1650178925668,MATH 20B,A02,083757,Staff,0,5,30,30
1650178931693,MATH 20C,A01,083760,Staff,0,12,30,30
1650178931693,MATH 20C,A02,083761,Staff,0,12,30,30
1650178931693,MATH 20C,B01,083762,Staff,14,0,30,16
1650178931693,MATH 20C,B02,083763,Staff,28,0,30,2
1650178937730,MATH 20D,A01,083765,Staff,0,2,30,30
1650178937730,MATH 20D,A02,083766,Staff,10,0,30,20
1650178937730,MATH 20D,A03,083767,Staff,28,0,30,2
1650178943756,MATH 20E,A01,083771,Staff,8,0,30,22
1650178943756,MATH 20E,A02,083772,Staff,20,0,30,10
1650178943756,MATH 20E,B01,083773,Staff,0,0,30,30
1650178943756,MATH 20E,B02,083774,Staff,13,0,30,17
1650178949786,MATH 103A,A01,083777,Staff,0,9,30,30
1650178949786,MATH 103A,A02,083778,Staff,0,10,30,30
1650178949786,MATH 103A,B01,083779,Staff,0,9,30,30
1650178949786,MATH 103A,B02,083780,Staff,0,9,30,30
1650178955810,MATH 105,A01,085443,Staff,0,17,30,30
1650178961833,MATH 109,A01,083213,Anzaldo; Leesa B,0,3,30,30
1650178961833,MATH 109,A02,083214,Anzaldo; Leesa B,0,6,30,30
1650178961833,MATH 109,B01,083215,Anzaldo; Leesa B,0,4,30,30
1650178961833,MATH 109,B02,083216,Anzaldo; Leesa B,0,4,30,30
1650178967863,MATH 142A,A01,083219,Chow; Bennett,0,12,30,30
1650178967863,MATH 142A,A02,083220,Chow; Bennett,0,11,30,30
1650178967863,MATH 142A,B01,083221,Chow; Bennett,0,11,30,30
1650178967863,MATH 142A,B02,083222,Chow; Bennett,0,12,30,30
1650178973887,MATH 193A,A01,083224,Staff,0,4,30,30
1650178973887,MATH 193A,A02,083225,Staff,0,4,30,30
1650178973887,MATH 193A,A03,083781,Staff,0,1,30,30
1650178973887,MATH 193A,A04,083782,Staff,0,1,30,30
1650178979910,MATH 197,001,091859,McAuley; Julian John,9998,0,9999,1
1650178985962,COGS 9,A01,083615,Staff,0,14,60,60
1650178991986,COGS 11,A01,083617,Boyle; Mary E. T.,24,0,40,16
1650178998018,COGS 13,A01,083071,Staff,0,30,40,40
1650179004045,COGS 14A,A01,092681,Staff,0,12,100,100
1650179010071,COGS 14B,A01,083073,Cheng; Tzu-Han,0,7,50,50
1650179016099,COGS 17,A01,092677,Staff,34,0,75,41
1650179022126,COGS 100,A01,083619,Staff,0,20,60,60
1650179028157,COGS 101A,A01,083621,Davis; Joshua Daniel,0,21,60,60
1650179034184,COGS 101B,A01,091572,Staff,6,0,60,54
1650179040210,COGS 101C,A01,083625,Delgado; Tania,20,0,30,10
1650179046238,COGS 107A,A01,083627,Boyle; Mary E. T.,0,7,60,60
1650179052265,COGS 118A,A01,083075,Staff,17,0,60,43
1650179058294,CSE 3,A50,083646,Miranda; Gregory Joseph,22,0,38,16
1650179058294,CSE 3,A51,083647,Miranda; Gregory Joseph,37,0,37,0
1650179064319,CSE 8A,A50,083650,Miranda; Gregory Joseph,0,17,40,40
1650179070357,CSE 11,A01,083080,Cao; Yingjun,0,67,40,40
1650179076382,CSE 12,A01,083652,Staff,0,5,100,100
1650179082408,CSE 15L,A01,083654,Staff,0,0,50,50
1650179082408,CSE 15L,A02,083655,Staff,8,0,50,42
1650179088436,CSE 20,A01,083657,Staff,54,0,80,26
1650179094460,CSE 30,A01,083084,Eldon; John,0,67,40,40
1650179100488,CSE 100,A01,083659,Cao; Yingjun,0,63,50,50
1650179106519,CSE 134B,A01,083661,Powell; Thomas Allan,0,27,65,65
1650179112543,CSE 140,A01,083663,Staff,1,0,75,74
1650179118572,CSE 140L,A01,083088,Eldon; John,0,4,75,75
1650179124599,CSE 175,A01,083665,Kumar; Rakesh,8,0,25,17
1650179130627,CSE 190,A00,092507,Dubnov; Shlomo,14,0,20,6
1650179136651,ECE 45,A01,083139,Staff,0,13,40,40
1650179142688,ECE 65,A50,083695,Staff,0,5,30,30
1650179148713,ECE 109,A01,091882,Touri; Behrouz,47,0,70,23
1650179154744,ECE 180,A00,083140,Abi Samra; Nicholas Camill,24,0,30,6
1650179154744,ECE 180,B00,083141,Abi Samra; Nicholas Camill,8,0,30,22
1650179160778,MATH 10A,A01,083735,Patchell; Gregory David,11,0,30,19
1650179160778,MATH 10A,A02,083736,Patchell; Gregory David,28,0,30,2
1650179160778,MATH 10A,A03,083737,Patchell; Gregory David,26,0,30,4
1650179166802,MATH 10B,A01,083207,Staff,0,5,30,30
1650179166802,MATH 10B,A02,083208,Staff,0,5,30,30
1650179166802,MATH 10B,B01,083739,Staff,17,0,30,13
1650179166802,MATH 10B,B02,083740,Staff,29,0,30,1
1650179172852,MATH 18,A01,083743,Staff,10,0,30,20
1650179172852,MATH 18,A02,083744,Staff,28,0,30,2
1650179172852,MATH 18,A03,083745,Staff,23,0,30,7
1650179172852,MATH 18,A04,083746,Staff,27,0,30,3
1650179172852,MATH 18,B01,083748,Staff,0,10,30,30
1650179172852,MATH 18,B02,083749,Staff,0,7,30,30
1650179172852,MATH 18,B03,083750,Staff,0,7,30,30
1650179172852,MATH 18,B04,083751,Staff,0,7,30,30
1650179178881,MATH 20A,A01,083754,Staff,26,0,40,14
1650179184905,MATH 20B,A01,083756,Staff,0,6,30,30
1650179184905,MATH 20B,A02,083757,Staff,0,5,30,30
1650179191003,MATH 20C,A01,083760,Staff,0,12,30,30
1650179191003,MATH 20C,A02,083761,Staff,0,12,30,30
1650179191003,MATH 20C,B01,083762,Staff,14,0,30,16
1650179191003,MATH 20C,B02,083763,Staff,28,0,30,2
1650179197027,MATH 20D,A01,083765,Staff,0,2,30,30
1650179197027,MATH 20D,A02,083766,Staff,10,0,30,20
1650179197027,MATH 20D,A03,083767,Staff,28,0,30,2
1650179203056,MATH 20E,A01,083771,Staff,8,0,30,22
1650179203056,MATH 20E,A02,083772,Staff,20,0,30,10
1650179203056,MATH 20E,B01,083773,Staff,0,0,30,30
1650179203056,MATH 20E,B02,083774,Staff,13,0,30,17
1650179209088,MATH 103A,A01,083777,Staff,0,9,30,30
1650179209088,MATH 103A,A02,083778,Staff,0,10,30,30
1650179209088,MATH 103A,B01,083779,Staff,0,9,30,30
1650179209088,MATH 103A,B02,083780,Staff,0,9,30,30
1650179215126,MATH 105,A01,085443,Staff,0,17,30,30
1650179221151,MATH 109,A01,083213,Anzaldo; Leesa B,0,3,30,30
1650179221151,MATH 109,A02,083214,Anzaldo; Leesa B,0,6,30,30
1650179221151,MATH 109,B01,083215,Anzaldo; Leesa B,0,4,30,30
1650179221151,MATH 109,B02,083216,Anzaldo; Leesa B,0,4,30,30
1650179227177,MATH 142A,A01,083219,Chow; Bennett,0,12,30,30
1650179227177,MATH 142A,A02,083220,Chow; Bennett,0,11,30,30
1650179227177,MATH 142A,B01,083221,Chow; Bennett,0,11,30,30
1650179227177,MATH 142A,B02,083222,Chow; Bennett,0,12,30,30
1650179233206,MATH 193A,A01,083224,Staff,0,4,30,30
1650179233206,MATH 193A,A02,083225,Staff,0,4,30,30
1650179233206,MATH 193A,A03,083781,Staff,0,1,30,30
1650179233206,MATH 193A,A04,083782,Staff,0,1,30,30
1650179239230,MATH 197,001,091859,McAuley; Julian John,9998,0,9999,1
1650179245286,COGS 9,A01,083615,Staff,0,14,60,60
1650179251311,COGS 11,A01,083617,Boyle; Mary E. T.,24,0,40,16
1650179257342,COGS 13,A01,083071,Staff,0,30,40,40
1650179263366,COGS 14A,A01,092681,Staff,0,12,100,100
1650179269390,COGS 14B,A01,083073,Cheng; Tzu-Han,0,7,50,50
1650179275418,COGS 17,A01,092677,Staff,34,0,75,41
1650179281442,COGS 100,A01,083619,Staff,0,20,60,60
1650179287466,COGS 101A,A01,083621,Davis; Joshua Daniel,0,21,60,60
1650179293493,COGS 101B,A01,091572,Staff,6,0,60,54
1650179299517,COGS 101C,A01,083625,Delgado; Tania,20,0,30,10
1650179305543,COGS 107A,A01,083627,Boyle; Mary E. T.,0,7,60,60
1650179311568,COGS 118A,A01,083075,Staff,17,0,60,43
1650179317592,CSE 3,A50,083646,Miranda; Gregory Joseph,22,0,38,16
1650179317592,CSE 3,A51,083647,Miranda; Gregory Joseph,37,0,37,0
1650179323616,CSE 8A,A50,083650,Miranda; Gregory Joseph,0,17,40,40
1650179329644,CSE 11,A01,083080,Cao; Yingjun,0,67,40,40
1650179335668,CSE 12,A01,083652,Staff,0,5,100,100
1650179341693,CSE 15L,A01,083654,Staff,0,0,50,50
1650179341693,CSE 15L,A02,083655,Staff,8,0,50,42
1650179347718,CSE 20,A01,083657,Staff,54,0,80,26
1650179361817,CSE 30,A01,083084,Eldon; John,0,67,40,40
1650179367842,CSE 100,A01,083659,Cao; Yingjun,0,63,50,50
1650179373866,CSE 134B,A01,083661,Powell; Thomas Allan,0,27,65,65
1650179379890,CSE 140,A01,083663,Staff,1,0,75,74
1650179385919,CSE 140L,A01,083088,Eldon; John,0,4,75,75
1650179391943,CSE 175,A01,083665,Kumar; Rakesh,8,0,25,17
1650179397965,CSE 190,A00,092507,Dubnov; Shlomo,14,0,20,6
1650179403990,ECE 45,A01,083139,Staff,0,13,40,40
1650179410019,ECE 65,A50,083695,Staff,0,5,30,30
1650179416046,ECE 109,A01,091882,Touri; Behrouz,47,0,70,23
1650179422071,ECE 180,A00,083140,Abi Samra; Nicholas Camill,24,0,30,6
1650179422071,ECE 180,B00,083141,Abi Samra; Nicholas Camill,8,0,30,22
1650179428102,MATH 10A,A01,083735,Patchell; Gregory David,11,0,30,19
1650179428102,MATH 10A,A02,083736,Patchell; Gregory David,28,0,30,2
1650179428102,MATH 10A,A03,083737,Patchell; Gregory David,26,0,30,4
1650179434131,MATH 10B,A01,083207,Staff,0,5,30,30
1650179434131,MATH 10B,A02,083208,Staff,0,5,30,30
1650179434131,MATH 10B,B01,083739,Staff,17,0,30,13
1650179434131,MATH 10B,B02,083740,Staff,29,0,30,1
1650179440163,MATH 18,A01,083743,Staff,10,0,30,20
1650179440163,MATH 18,A02,083744,Staff,28,0,30,2
1650179440163,MATH 18,A03,083745,Staff,23,0,30,7
1650179440163,MATH 18,A04,083746,Staff,27,0,30,3
1650179440163,MATH 18,B01,083748,Staff,0,10,30,30
1650179440163,MATH 18,B02,083749,Staff,0,7,30,30
1650179440163,MATH 18,B03,083750,Staff,0,7,30,30
1650179440163,MATH 18,B04,083751,Staff,0,7,30,30
1650179446194,MATH 20A,A01,083754,Staff,26,0,40,14
1650179452223,MATH 20B,A01,083756,Staff,0,6,30,30
1650179452223,MATH 20B,A02,083757,Staff,0,5,30,30
1650179458246,MATH 20C,A01,083760,Staff,0,12,30,30
1650179458246,MATH 20C,A02,083761,Staff,0,12,30,30
1650179458246,MATH 20C,B01,083762,Staff,14,0,30,16
1650179458246,MATH 20C,B02,083763,Staff,28,0,30,2
1650179464270,MATH 20D,A01,083765,Staff,0,2,30,30
1650179464270,MATH 20D,A02,083766,Staff,10,0,30,20
1650179464270,MATH 20D,A03,083767,Staff,28,0,30,2
1650179470294,MATH 20E,A01,083771,Staff,8,0,30,22
1650179470294,MATH 20E,A02,083772,Staff,20,0,30,10
1650179470294,MATH 20E,B01,083773,Staff,0,0,30,30
1650179470294,MATH 20E,B02,083774,Staff,13,0,30,17
1650179476319,MATH 103A,A01,083777,Staff,0,9,30,30
1650179476319,MATH 103A,A02,083778,Staff,0,10,30,30
1650179476319,MATH 103A,B01,083779,Staff,0,9,30,30
1650179476319,MATH 103A,B02,083780,Staff,0,9,30,30
1650179482352,MATH 105,A01,085443,Staff,0,17,30,30
1650179488377,MATH 109,A01,083213,Anzaldo; Leesa B,0,3,30,30
1650179488377,MATH 109,A02,083214,Anzaldo; Leesa B,0,6,30,30
1650179488377,MATH 109,B01,083215,Anzaldo; Leesa B,0,4,30,30
1650179488377,MATH 109,B02,083216,Anzaldo; Leesa B,0,4,30,30
1650179494403,MATH 142A,A01,083219,Chow; Bennett,0,12,30,30
1650179494403,MATH 142A,A02,083220,Chow; Bennett,0,11,30,30
1650179494403,MATH 142A,B01,083221,Chow; Bennett,0,11,30,30
1650179494403,MATH 142A,B02,083222,Chow; Bennett,0,12,30,30
1650179500427,MATH 193A,A01,083224,Staff,0,4,30,30
1650179500427,MATH 193A,A02,083225,Staff,0,4,30,30
1650179500427,MATH 193A,A03,083781,Staff,0,1,30,30
1650179500427,MATH 193A,A04,083782,Staff,0,1,30,30
1650179506452,MATH 197,001,091859,McAuley; Julian John,9998,0,9999,1
1650179512508,COGS 9,A01,083615,Staff,0,14,60,60
1650179518537,COGS 11,A01,083617,Boyle; Mary E. T.,24,0,40,16
1650179524571,COGS 13,A01,083071,Staff,0,30,40,40
1650179530605,COGS 14A,A01,092681,Staff,0,12,100,100
1650179536634,COGS 14B,A01,083073,Cheng; Tzu-Han,0,7,50,50
1650179542659,COGS 17,A01,092677,Staff,34,0,75,41
1650179548684,COGS 100,A01,083619,Staff,0,20,60,60
1650179554712,COGS 101A,A01,083621,Davis; Joshua Daniel,0,21,60,60
1650179560739,COGS 101B,A01,091572,Staff,6,0,60,54
1650179566764,COGS 101C,A01,083625,Delgado; Tania,20,0,30,10
1650179572787,COGS 107A,A01,083627,Boyle; Mary E. T.,0,7,60,60
1650179578815,COGS 118A,A01,083075,Staff,17,0,60,43
1650179584840,CSE 3,A50,083646,Miranda; Gregory Joseph,22,0,38,16
1650179584840,CSE 3,A51,083647,Miranda; Gregory Joseph,37,0,37,0
1650179590865,CSE 8A,A50,083650,Miranda; Gregory Joseph,0,17,40,40
1650179596889,CSE 11,A01,083080,Cao; Yingjun,0,67,40,40
1650179602911,CSE 12,A01,083652,Staff,0,5,100,100
1650179608940,CSE 15L,A01,083654,Staff,0,0,50,50
1650179608940,CSE 15L,A02,083655,Staff,8,0,50,42
1650179614969,CSE 20,A01,083657,Staff,54,0,80,26
1650179620996,CSE 30,A01,083084,Eldon; John,0,67,40,40
1650179627023,CSE 100,A01,083659,Cao; Yingjun,0,63,50,50
1650179633046,CSE 134B,A01,083661,Powell; Thomas Allan,0,27,65,65
1650179639074,CSE 140,A01,083663,Staff,1,0,75,74
1650179645101,CSE 140L,A01,083088,Eldon; John,0,4,75,75
1650179651126,CSE 175,A01,083665,Kumar; Rakesh,8,0,25,17
1650179657156,CSE 190,A00,092507,Dubnov; Shlomo,14,0,20,6
1650179663178,ECE 45,A01,083139,Staff,0,13,40,40
1650179669208,ECE 65,A50,083695,Staff,0,5,30,30
1650179675230,ECE 109,A01,091882,Touri; Behrouz,47,0,70,23
1650179681263,ECE 180,A00,083140,Abi Samra; Nicholas Camill,24,0,30,6
1650179681263,ECE 180,B00,083141,Abi Samra; Nicholas Camill,8,0,30,22
1650179687286,MATH 10A,A01,083735,Patchell; Gregory David,11,0,30,19
1650179687286,MATH 10A,A02,083736,Patchell; Gregory David,28,0,30,2
1650179687286,MATH 10A,A03,083737,Patchell; Gregory David,26,0,30,4
1650179693309,MATH 10B,A01,083207,Staff,0,5,30,30
1650179693309,MATH 10B,A02,083208,Staff,0,5,30,30
1650179693309,MATH 10B,B01,083739,Staff,17,0,30,13
1650179693309,MATH 10B,B02,083740,Staff,29,0,30,1
1650179699335,MATH 18,A01,083743,Staff,10,0,30,20
1650179699335,MATH 18,A02,083744,Staff,28,0,30,2
1650179699335,MATH 18,A03,083745,Staff,23,0,30,7
1650179699335,MATH 18,A04,083746,Staff,27,0,30,3
1650179699335,MATH 18,B01,083748,Staff,0,10,30,30
1650179699335,MATH 18,B02,083749,Staff,0,7,30,30
1650179699335,MATH 18,B03,083750,Staff,0,7,30,30
1650179699335,MATH 18,B04,083751,Staff,0,7,30,30
1650179705361,MATH 20A,A01,083754,Staff,26,0,40,14
1650179711383,MATH 20B,A01,083756,Staff,0,6,30,30
1650179711383,MATH 20B,A02,083757,Staff,0,5,30,30
1650179717411,MATH 20C,A01,083760,Staff,0,12,30,30
1650179717411,MATH 20C,A02,083761,Staff,0,12,30,30
1650179717411,MATH 20C,B01,083762,Staff,14,0,30,16
1650179717411,MATH 20C,B02,083763,Staff,28,0,30,2
1650179723436,MATH 20D,A01,083765,Staff,0,2,30,30
1650179723436,MATH 20D,A02,083766,Staff,10,0,30,20
1650179723436,MATH 20D,A03,083767,Staff,28,0,30,2
1650179729458,MATH 20E,A01,083771,Staff,8,0,30,22
1650179729458,MATH 20E,A02,083772,Staff,20,0,30,10
1650179729458,MATH 20E,B01,083773,Staff,0,0,30,30
1650179729458,MATH 20E,B02,083774,Staff,13,0,30,17
1650179735486,MATH 103A,A01,083777,Staff,0,9,30,30
1650179735486,MATH 103A,A02,083778,Staff,0,10,30,30
1650179735486,MATH 103A,B01,083779,Staff,0,9,30,30
1650179735486,MATH 103A,B02,083780,Staff,0,9,30,30
1650179741512,MATH 105,A01,085443,Staff,0,17,30,30
1650179747536,MATH 109,A01,083213,Anzaldo; Leesa B,0,3,30,30
1650179747536,MATH 109,A02,083214,Anzaldo; Leesa B,0,6,30,30
1650179747536,MATH 109,B01,083215,Anzaldo; Leesa B,0,4,30,30
1650179747536,MATH 109,B02,083216,Anzaldo; Leesa B,0,4,30,30
1650179753559,MATH 142A,A01,083219,Chow; Bennett,0,12,30,30
1650179753559,MATH 142A,A02,083220,Chow; Bennett,0,11,30,30
1650179753559,MATH 142A,B01,083221,Chow; Bennett,0,11,30,30
1650179753559,MATH 142A,B02,083222,Chow; Bennett,0,12,30,30
1650179759582,MATH 193A,A01,083224,Staff,0,4,30,30
1650179759582,MATH 193A,A02,083225,Staff,0,4,30,30
1650179759582,MATH 193A,A03,083781,Staff,0,1,30,30
1650179759582,MATH 193A,A04,083782,Staff,0,1,30,30
1650179765607,MATH 197,001,091859,McAuley; Julian John,9998,0,9999,1
1650179771664,COGS 9,A01,083615,Staff,0,14,60,60
1650179777689,COGS 11,A01,083617,Boyle; Mary E. T.,24,0,40,16
1650179783719,COGS 13,A01,083071,Staff,0,30,40,40
1650179789814,COGS 14A,A01,092681,Staff,0,12,100,100
1650179795836,COGS 14B,A01,083073,Cheng; Tzu-Han,0,7,50,50
1650179801860,COGS 17,A01,092677,Staff,34,0,75,41
1650179807882,COGS 100,A01,083619,Staff,0,20,60,60
1650179813910,COGS 101A,A01,083621,Davis; Joshua Daniel,0,21,60,60
1650179819934,COGS 101B,A01,091572,Staff,6,0,60,54
1650179825957,COGS 101C,A01,083625,Delgado; Tania,20,0,30,10
1650179831982,COGS 107A,A01,083627,Boyle; Mary E. T.,0,7,60,60
1650179838015,COGS 118A,A01,083075,Staff,17,0,60,43
1650179844042,CSE 3,A50,083646,Miranda; Gregory Joseph,22,0,38,16
1650179844042,CSE 3,A51,083647,Miranda; Gregory Joseph,37,0,37,0
1650179850069,CSE 8A,A50,083650,Miranda; Gregory Joseph,0,17,40,40
1650179856096,CSE 11,A01,083080,Cao; Yingjun,0,67,40,40
1650179862120,CSE 12,A01,083652,Staff,0,5,100,100
1650179868144,CSE 15L,A01,083654,Staff,0,0,50,50
1650179868144,CSE 15L,A02,083655,Staff,8,0,50,42
1650179874168,CSE 20,A01,083657,Staff,54,0,80,26
1650179880194,CSE 30,A01,083084,Eldon; John,0,67,40,40
1650179886218,CSE 100,A01,083659,Cao; Yingjun,0,63,50,50
1650179892241,CSE 134B,A01,083661,Powell; Thomas Allan,0,27,65,65
1650179898266,CSE 140,A01,083663,Staff,1,0,75,74
1650179904293,CSE 140L,A01,083088,Eldon; John,0,4,75,75
1650179910318,CSE 175,A01,083665,Kumar; Rakesh,8,0,25,17
1650179916342,CSE 190,A00,092507,Dubnov; Shlomo,14,0,20,6
1650179922366,ECE 45,A01,083139,Staff,0,13,40,40
1650179928394,ECE 65,A50,083695,Staff,0,5,30,30
1650179934419,ECE 109,A01,091882,Touri; Behrouz,47,0,70,23
1650179940444,ECE 180,A00,083140,Abi Samra; Nicholas Camill,24,0,30,6
1650179940444,ECE 180,B00,083141,Abi Samra; Nicholas Camill,8,0,30,22
1650179946467,MATH 10A,A01,083735,Patchell; Gregory David,11,0,30,19
1650179946467,MATH 10A,A02,083736,Patchell; Gregory David,28,0,30,2
1650179946467,MATH 10A,A03,083737,Patchell; Gregory David,26,0,30,4
1650179952497,MATH 10B,A01,083207,Staff,0,5,30,30
1650179952497,MATH 10B,A02,083208,Staff,0,5,30,30
1650179952497,MATH 10B,B01,083739,Staff,17,0,30,13
1650179952497,MATH 10B,B02,083740,Staff,29,0,30,1
1650179958523,MATH 18,A01,083743,Staff,10,0,30,20
1650179958523,MATH 18,A02,083744,Staff,28,0,30,2
1650179958523,MATH 18,A03,083745,Staff,23,0,30,7
1650179958523,MATH 18,A04,083746,Staff,27,0,30,3
1650179958523,MATH 18,B01,083748,Staff,0,10,30,30
1650179958523,MATH 18,B02,083749,Staff,0,7,30,30
1650179958523,MATH 18,B03,083750,Staff,0,7,30,30
1650179958523,MATH 18,B04,083751,Staff,0,7,30,30
1650179964547,MATH 20A,A01,083754,Staff,26,0,40,14
1650179970575,MATH 20B,A01,083756,Staff,0,6,30,30
1650179970575,MATH 20B,A02,083757,Staff,0,5,30,30
1650179976602,MATH 20C,A01,083760,Staff,0,12,30,30
1650179976602,MATH 20C,A02,083761,Staff,0,12,30,30
1650179976602,MATH 20C,B01,083762,Staff,14,0,30,16
1650179976602,MATH 20C,B02,083763,Staff,28,0,30,2
1650179982637,MATH 20D,A01,083765,Staff,0,2,30,30
1650179982637,MATH 20D,A02,083766,Staff,10,0,30,20
1650179982637,MATH 20D,A03,083767,Staff,28,0,30,2
1650179988661,MATH 20E,A01,083771,Staff,8,0,30,22
1650179988661,MATH 20E,A02,083772,Staff,20,0,30,10
1650179988661,MATH 20E,B01,083773,Staff,0,0,30,30
1650179988661,MATH 20E,B02,083774,Staff,13,0,30,17
1650179994691,MATH 103A,A01,083777,Staff,0,9,30,30
1650179994691,MATH 103A,A02,083778,Staff,0,10,30,30
1650179994691,MATH 103A,B01,083779,Staff,0,9,30,30
1650179994691,MATH 103A,B02,083780,Staff,0,9,30,30
1650180000721,MATH 105,A01,085443,Staff,0,17,30,30
1650180006748,MATH 109,A01,083213,Anzaldo; Leesa B,0,3,30,30
1650180006748,MATH 109,A02,083214,Anzaldo; Leesa B,0,6,30,30
1650180006748,MATH 109,B01,083215,Anzaldo; Leesa B,0,4,30,30
1650180006748,MATH 109,B02,083216,Anzaldo; Leesa B,0,4,30,30
1650180012773,MATH 142A,A01,083219,Chow; Bennett,0,12,30,30
1650180012773,MATH 142A,A02,083220,Chow; Bennett,0,11,30,30
1650180012773,MATH 142A,B01,083221,Chow; Bennett,0,11,30,30
1650180012773,MATH 142A,B02,083222,Chow; Bennett,0,12,30,30
1650180018802,MATH 193A,A01,083224,Staff,0,4,30,30
1650180018802,MATH 193A,A02,083225,Staff,0,4,30,30
1650180018802,MATH 193A,A03,083781,Staff,0,1,30,30
1650180018802,MATH 193A,A04,083782,Staff,0,1,30,30
1650180024826,MATH 197,001,091859,McAuley; Julian John,9998,0,9999,1
1650180030881,COGS 9,A01,083615,Staff,0,14,60,60
1650180036905,COGS 11,A01,083617,Boyle; Mary E. T.,24,0,40,16
1650180042932,COGS 13,A01,083071,Staff,0,30,40,40
1650180048954,COGS 14A,A01,092681,Staff,0,12,100,100
1650180054978,COGS 14B,A01,083073,Cheng; Tzu-Han,0,7,50,50
1650180061003,COGS 17,A01,092677,Staff,34,0,75,41
1650180067026,COGS 100,A01,083619,Staff,0,20,60,60
1650180073051,COGS 101A,A01,083621,Davis; Joshua Daniel,0,21,60,60
1650180079078,COGS 101B,A01,091572,Staff,6,0,60,54
1650180085101,COGS 101C,A01,083625,Delgado; Tania,20,0,30,10
1650180091128,COGS 107A,A01,083627,Boyle; Mary E. T.,0,7,60,60
1650180097149,COGS 118A,A01,083075,Staff,17,0,60,43
1650180103173,CSE 3,A50,083646,Miranda; Gregory Joseph,22,0,38,16
1650180103173,CSE 3,A51,083647,Miranda; Gregory Joseph,37,0,37,0
1650180109212,CSE 8A,A50,083650,Miranda; Gregory Joseph,0,17,40,40
1650180115234,CSE 11,A01,083080,Cao; Yingjun,0,67,40,40
1650180121258,CSE 12,A01,083652,Staff,0,5,100,100
1650180127285,CSE 15L,A01,083654,Staff,0,0,50,50
1650180127285,CSE 15L,A02,083655,Staff,8,0,50,42
1650180133313,CSE 20,A01,083657,Staff,54,0,80,26
1650180139345,CSE 30,A01,083084,Eldon; John,0,67,40,40
1650180145370,CSE 100,A01,083659,Cao; Yingjun,0,63,50,50
1650180151400,CSE 134B,A01,083661,Powell; Thomas Allan,0,27,65,65
1650180157425,CSE 140,A01,083663,Staff,1,0,75,74
1650180163449,CSE 140L,A01,083088,Eldon; John,0,4,75,75
1650180169475,CSE 175,A01,083665,Kumar; Rakesh,8,0,25,17
1650180175508,CSE 190,A00,092507,Dubnov; Shlomo,14,0,20,6
1650180181535,ECE 45,A01,083139,Staff,0,13,40,40
1650180187563,ECE 65,A50,083695,Staff,0,5,30,30
1650180193590,ECE 109,A01,091882,Touri; Behrouz,47,0,70,23
1650180199614,ECE 180,A00,083140,Abi Samra; Nicholas Camill,24,0,30,6
1650180199614,ECE 180,B00,083141,Abi Samra; Nicholas Camill,8,0,30,22
1650180205637,MATH 10A,A01,083735,Patchell; Gregory David,11,0,30,19
1650180205637,MATH 10A,A02,083736,Patchell; Gregory David,28,0,30,2
1650180205637,MATH 10A,A03,083737,Patchell; Gregory David,26,0,30,4
1650180211667,MATH 10B,A01,083207,Staff,0,5,30,30
1650180211667,MATH 10B,A02,083208,Staff,0,5,30,30
1650180211667,MATH 10B,B01,083739,Staff,17,0,30,13
1650180211667,MATH 10B,B02,083740,Staff,29,0,30,1
1650180217693,MATH 18,A01,083743,Staff,10,0,30,20
1650180217693,MATH 18,A02,083744,Staff,28,0,30,2
1650180217693,MATH 18,A03,083745,Staff,23,0,30,7
1650180217693,MATH 18,A04,083746,Staff,27,0,30,3
1650180217693,MATH 18,B01,083748,Staff,0,10,30,30
1650180217693,MATH 18,B02,083749,Staff,0,7,30,30
1650180217693,MATH 18,B03,083750,Staff,0,7,30,30
1650180217693,MATH 18,B04,083751,Staff,0,7,30,30
1650180223720,MATH 20A,A01,083754,Staff,26,0,40,14
1650180229743,MATH 20B,A01,083756,Staff,0,6,30,30
1650180229743,MATH 20B,A02,083757,Staff,0,5,30,30
1650180235768,MATH 20C,A01,083760,Staff,0,12,30,30
1650180235768,MATH 20C,A02,083761,Staff,0,12,30,30
1650180235768,MATH 20C,B01,083762,Staff,14,0,30,16
1650180235768,MATH 20C,B02,083763,Staff,28,0,30,2
1650180241794,MATH 20D,A01,083765,Staff,0,2,30,30
1650180241794,MATH 20D,A02,083766,Staff,10,0,30,20
1650180241794,MATH 20D,A03,083767,Staff,28,0,30,2
1650180247822,MATH 20E,A01,083771,Staff,8,0,30,22
1650180247822,MATH 20E,A02,083772,Staff,20,0,30,10
1650180247822,MATH 20E,B01,083773,Staff,0,0,30,30
1650180247822,MATH 20E,B02,083774,Staff,13,0,30,17
1650180253846,MATH 103A,A01,083777,Staff,0,9,30,30
1650180253846,MATH 103A,A02,083778,Staff,0,10,30,30
1650180253846,MATH 103A,B01,083779,Staff,0,9,30,30
1650180253846,MATH 103A,B02,083780,Staff,0,9,30,30
1650180259874,MATH 105,A01,085443,Staff,0,17,30,30
1650180265903,MATH 109,A01,083213,Anzaldo; Leesa B,0,3,30,30
1650180265903,MATH 109,A02,083214,Anzaldo; Leesa B,0,6,30,30
1650180265903,MATH 109,B01,083215,Anzaldo; Leesa B,0,4,30,30
1650180265903,MATH 109,B02,083216,Anzaldo; Leesa B,0,4,30,30
1650180271927,MATH 142A,A01,083219,Chow; Bennett,0,12,30,30
1650180271927,MATH 142A,A02,083220,Chow; Bennett,0,11,30,30
1650180271927,MATH 142A,B01,083221,Chow; Bennett,0,11,30,30
1650180271927,MATH 142A,B02,083222,Chow; Bennett,0,12,30,30
1650180277950,MATH 193A,A01,083224,Staff,0,4,30,30
1650180277950,MATH 193A,A02,083225,Staff,0,4,30,30
1650180277950,MATH 193A,A03,083781,Staff,0,1,30,30
1650180277950,MATH 193A,A04,083782,Staff,0,1,30,30
1650180283974,MATH 197,001,091859,McAuley; Julian John,9998,0,9999,1
1650180290025,COGS 9,A01,083615,Staff,0,14,60,60
1650180296058,COGS 11,A01,083617,Boyle; Mary E. T.,24,0,40,16
1650180302083,COGS 13,A01,083071,Staff,0,30,40,40
1650180308115,COGS 14A,A01,092681,Staff,0,12,100,100
1650180314141,COGS 14B,A01,083073,Cheng; Tzu-Han,0,7,50,50
1650180320168,COGS 17,A01,092677,Staff,34,0,75,41
1650180326193,COGS 100,A01,083619,Staff,0,20,60,60
1650180332215,COGS 101A,A01,083621,Davis; Joshua Daniel,0,21,60,60
1650180338242,COGS 101B,A01,091572,Staff,6,0,60,54
1650180344263,COGS 101C,A01,083625,Delgado; Tania,20,0,30,10
1650180350287,COGS 107A,A01,083627,Boyle; Mary E. T.,0,7,60,60
1650180356310,COGS 118A,A01,083075,Staff,17,0,60,43
1650180362333,CSE 3,A50,083646,Miranda; Gregory Joseph,22,0,38,16
1650180362333,CSE 3,A51,083647,Miranda; Gregory Joseph,37,0,37,0
1650180368356,CSE 8A,A50,083650,Miranda; Gregory Joseph,0,17,40,40
1650180374387,CSE 11,A01,083080,Cao; Yingjun,0,67,40,40
1650180380418,CSE 12,A01,083652,Staff,0,5,100,100
1650180386524,CSE 15L,A01,083654,Staff,0,0,50,50
1650180386524,CSE 15L,A02,083655,Staff,8,0,50,42
1650180392548,CSE 20,A01,083657,Staff,54,0,80,26
1650180398575,CSE 30,A01,083084,Eldon; John,0,67,40,40
1650180404597,CSE 100,A01,083659,Cao; Yingjun,0,63,50,50
1650180410620,CSE 134B,A01,083661,Powell; Thomas Allan,0,27,65,65
1650180416642,CSE 140,A01,083663,Staff,1,0,75,74
1650180422668,CSE 140L,A01,083088,Eldon; John,0,4,75,75
1650180428693,CSE 175,A01,083665,Kumar; Rakesh,8,0,25,17
1650180434715,CSE 190,A00,092507,Dubnov; Shlomo,14,0,20,6
1650180440752,ECE 45,A01,083139,Staff,0,13,40,40
1650180446779,ECE 65,A50,083695,Staff,0,5,30,30
1650180452808,ECE 109,A01,091882,Touri; Behrouz,47,0,70,23
1650180458831,ECE 180,A00,083140,Abi Samra; Nicholas Camill,24,0,30,6
1650180458831,ECE 180,B00,083141,Abi Samra; Nicholas Camill,8,0,30,22
1650180464854,MATH 10A,A01,083735,Patchell; Gregory David,11,0,30,19
1650180464854,MATH 10A,A02,083736,Patchell; Gregory David,28,0,30,2
1650180464854,MATH 10A,A03,083737,Patchell; Gregory David,26,0,30,4
1650180470877,MATH 10B,A01,083207,Staff,0,5,30,30
1650180470877,MATH 10B,A02,083208,Staff,0,5,30,30
1650180470877,MATH 10B,B01,083739,Staff,17,0,30,13
1650180470877,MATH 10B,B02,083740,Staff,29,0,30,1
1650180476908,MATH 18,A01,083743,Staff,10,0,30,20
1650180476908,MATH 18,A02,083744,Staff,28,0,30,2
1650180476908,MATH 18,A03,083745,Staff,23,0,30,7
1650180476908,MATH 18,A04,083746,Staff,27,0,30,3
1650180476908,MATH 18,B01,083748,Staff,0,10,30,30
1650180476908,MATH 18,B02,083749,Staff,0,7,30,30
1650180476908,MATH 18,B03,083750,Staff,0,7,30,30
1650180476908,MATH 18,B04,083751,Staff,0,7,30,30
1650180482930,MATH 20A,A01,083754,Staff,26,0,40,14
1650180488958,MATH 20B,A01,083756,Staff,0,6,30,30
1650180488958,MATH 20B,A02,083757,Staff,0,5,30,30
1650180494994,MATH 20C,A01,083760,Staff,0,12,30,30
1650180494994,MATH 20C,A02,083761,Staff,0,12,30,30
1650180494994,MATH 20C,B01,083762,Staff,14,0,30,16
1650180494994,MATH 20C,B02,083763,Staff,28,0,30,2
1650180501018,MATH 20D,A01,083765,Staff,0,2,30,30
1650180501018,MATH 20D,A02,083766,Staff,10,0,30,20
1650180501018,MATH 20D,A03,083767,Staff,28,0,30,2
1650180507045,MATH 20E,A01,083771,Staff,8,0,30,22
1650180507045,MATH 20E,A02,083772,Staff,20,0,30,10
1650180507045,MATH 20E,B01,083773,Staff,0,0,30,30
1650180507045,MATH 20E,B02,083774,Staff,13,0,30,17
1650180513073,MATH 103A,A01,083777,Staff,0,9,30,30
1650180513073,MATH 103A,A02,083778,Staff,0,10,30,30
1650180513073,MATH 103A,B01,083779,Staff,0,9,30,30
1650180513073,MATH 103A,B02,083780,Staff,0,9,30,30
1650180519101,MATH 105,A01,085443,Staff,0,17,30,30
1650180525127,MATH 109,A01,083213,Anzaldo; Leesa B,0,3,30,30
1650180525127,MATH 109,A02,083214,Anzaldo; Leesa B,0,6,30,30
1650180525127,MATH 109,B01,083215,Anzaldo; Leesa B,0,4,30,30
1650180525127,MATH 109,B02,083216,Anzaldo; Leesa B,0,4,30,30
1650180531152,MATH 142A,A01,083219,Chow; Bennett,0,12,30,30
1650180531152,MATH 142A,A02,083220,Chow; Bennett,0,11,30,30
1650180531152,MATH 142A,B01,083221,Chow; Bennett,0,11,30,30
1650180531152,MATH 142A,B02,083222,Chow; Bennett,0,12,30,30
1650180537176,MATH 193A,A01,083224,Staff,0,4,30,30
1650180537176,MATH 193A,A02,083225,Staff,0,4,30,30
1650180537176,MATH 193A,A03,083781,Staff,0,1,30,30
1650180537176,MATH 193A,A04,083782,Staff,0,1,30,30
1650180543204,MATH 197,001,091859,McAuley; Julian John,9998,0,9999,1
1650180549256,COGS 9,A01,083615,Staff,0,14,60,60
1650180555283,COGS 11,A01,083617,Boyle; Mary E. T.,24,0,40,16
1650180561308,COGS 13,A01,083071,Staff,0,30,40,40
1650180567331,COGS 14A,A01,092681,Staff,0,12,100,100
1650180573362,COGS 14B,A01,083073,Cheng; Tzu-Han,0,7,50,50
1650180579389,COGS 17,A01,092677,Staff,34,0,75,41
1650180585415,COGS 100,A01,083619,Staff,0,20,60,60
1650180591449,COGS 101A,A01,083621,Davis; Joshua Daniel,0,21,60,60
1650180597474,COGS 101B,A01,091572,Staff,6,0,60,54
1650180603510,COGS 101C,A01,083625,Delgado; Tania,20,0,30,10
1650180609548,COGS 107A,A01,083627,Boyle; Mary E. T.,0,7,60,60
1650180615575,COGS 118A,A01,083075,Staff,16,0,60,44
1650180621603,CSE 3,A50,083646,Miranda; Gregory Joseph,22,0,38,16
1650180621603,CSE 3,A51,083647,Miranda; Gregory Joseph,37,0,37,0
1650180627626,CSE 8A,A50,083650,Miranda; Gregory Joseph,0,17,40,40
1650180633654,CSE 11,A01,083080,Cao; Yingjun,0,68,40,40
1650180639680,CSE 12,A01,083652,Staff,0,5,100,100
1650180645703,CSE 15L,A01,083654,Staff,0,0,50,50
1650180645703,CSE 15L,A02,083655,Staff,8,0,50,42
1650180651729,CSE 20,A01,083657,Staff,53,0,80,27
1650180657756,CSE 30,A01,083084,Eldon; John,0,67,40,40
1650180663782,CSE 100,A01,083659,Cao; Yingjun,0,63,50,50
1650180669808,CSE 134B,A01,083661,Powell; Thomas Allan,0,27,65,65
1650180675835,CSE 140,A01,083663,Staff,1,0,75,74
1650180681857,CSE 140L,A01,083088,Eldon; John,0,4,75,75
1650180687882,CSE 175,A01,083665,Kumar; Rakesh,8,0,25,17
1650180693905,CSE 190,A00,092507,Dubnov; Shlomo,14,0,20,6
1650180699930,ECE 45,A01,083139,Staff,0,13,40,40
1650180705958,ECE 65,A50,083695,Staff,0,5,30,30
1650180711981,ECE 109,A01,091882,Touri; Behrouz,47,0,70,23
1650180718011,ECE 180,A00,083140,Abi Samra; Nicholas Camill,24,0,30,6
1650180718011,ECE 180,B00,083141,Abi Samra; Nicholas Camill,8,0,30,22
1650180724039,MATH 10A,A01,083735,Patchell; Gregory David,11,0,30,19
1650180724039,MATH 10A,A02,083736,Patchell; Gregory David,28,0,30,2
1650180724039,MATH 10A,A03,083737,Patchell; Gregory David,26,0,30,4
1650180730066,MATH 10B,A01,083207,Staff,0,5,30,30
1650180730066,MATH 10B,A02,083208,Staff,0,5,30,30
1650180730066,MATH 10B,B01,083739,Staff,17,0,30,13
1650180730066,MATH 10B,B02,083740,Staff,29,0,30,1
1650180736089,MATH 18,A01,083743,Staff,10,0,30,20
1650180736089,MATH 18,A02,083744,Staff,28,0,30,2
1650180736089,MATH 18,A03,083745,Staff,23,0,30,7
1650180736089,MATH 18,A04,083746,Staff,27,0,30,3
1650180736089,MATH 18,B01,083748,Staff,0,11,30,30
1650180736089,MATH 18,B02,083749,Staff,0,7,30,30
1650180736089,MATH 18,B03,083750,Staff,0,7,30,30
1650180736089,MATH 18,B04,083751,Staff,0,7,30,30
1650180742115,MATH 20A,A01,083754,Staff,26,0,40,14
1650180748141,MATH 20B,A01,083756,Staff,0,6,30,30
1650180748141,MATH 20B,A02,083757,Staff,0,5,30,30
1650180754170,MATH 20C,A01,083760,Staff,0,12,30,30
1650180754170,MATH 20C,A02,083761,Staff,0,12,30,30
1650180754170,MATH 20C,B01,083762,Staff,14,0,30,16
1650180754170,MATH 20C,B02,083763,Staff,28,0,30,2
1650180760192,MATH 20D,A01,083765,Staff,0,2,30,30
1650180760192,MATH 20D,A02,083766,Staff,10,0,30,20
1650180760192,MATH 20D,A03,083767,Staff,28,0,30,2
1650180766217,MATH 20E,A01,083771,Staff,8,0,30,22
1650180766217,MATH 20E,A02,083772,Staff,20,0,30,10
1650180766217,MATH 20E,B01,083773,Staff,0,0,30,30
1650180766217,MATH 20E,B02,083774,Staff,13,0,30,17
1650180772241,MATH 103A,A01,083777,Staff,0,9,30,30
1650180772241,MATH 103A,A02,083778,Staff,0,10,30,30
1650180772241,MATH 103A,B01,083779,Staff,0,9,30,30
1650180772241,MATH 103A,B02,083780,Staff,0,9,30,30
1650180778264,MATH 105,A01,085443,Staff,0,17,30,30
1650180784292,MATH 109,A01,083213,Anzaldo; Leesa B,0,3,30,30
1650180784292,MATH 109,A02,083214,Anzaldo; Leesa B,0,6,30,30
1650180784292,MATH 109,B01,083215,Anzaldo; Leesa B,0,4,30,30
1650180784292,MATH 109,B02,083216,Anzaldo; Leesa B,0,4,30,30
1650180790318,MATH 142A,A01,083219,Chow; Bennett,0,12,30,30
1650180790318,MATH 142A,A02,083220,Chow; Bennett,0,11,30,30
1650180790318,MATH 142A,B01,083221,Chow; Bennett,0,11,30,30
1650180790318,MATH 142A,B02,083222,Chow; Bennett,0,12,30,30
1650180796343,MATH 193A,A01,083224,Staff,0,4,30,30
1650180796343,MATH 193A,A02,083225,Staff,0,4,30,30
1650180796343,MATH 193A,A03,083781,Staff,0,1,30,30
1650180796343,MATH 193A,A04,083782,Staff,0,1,30,30
1650180802367,MATH 197,001,091859,McAuley; Julian John,9998,0,9999,1
1650180808428,COGS 9,A01,083615,Staff,0,14,60,60
1650180814450,COGS 11,A01,083617,Boyle; Mary E. T.,24,0,40,16
1650180820474,COGS 13,A01,083071,Staff,0,30,40,40
1650180826502,COGS 14A,A01,092681,Staff,0,12,100,100
1650180832525,COGS 14B,A01,083073,Cheng; Tzu-Han,0,7,50,50
1650180838553,COGS 17,A01,092677,Staff,34,0,75,41
1650180844581,COGS 100,A01,083619,Staff,0,20,60,60
1650180850605,COGS 101A,A01,083621,Davis; Joshua Daniel,0,21,60,60
1650180856632,COGS 101B,A01,091572,Staff,6,0,60,54
1650180862656,COGS 101C,A01,083625,Delgado; Tania,20,0,30,10
1650180868683,COGS 107A,A01,083627,Boyle; Mary E. T.,0,7,60,60
1650180874710,COGS 118A,A01,083075,Staff,16,0,60,44
1650180880738,CSE 3,A50,083646,Miranda; Gregory Joseph,22,0,38,16
1650180880738,CSE 3,A51,083647,Miranda; Gregory Joseph,37,0,37,0
1650180886761,CSE 8A,A50,083650,Miranda; Gregory Joseph,0,17,40,40
1650180892789,CSE 11,A01,083080,Cao; Yingjun,0,68,40,40
1650180898814,CSE 12,A01,083652,Staff,0,5,100,100
1650180904838,CSE 15L,A01,083654,Staff,0,0,50,50
1650180904838,CSE 15L,A02,083655,Staff,8,0,50,42
1650180910862,CSE 20,A01,083657,Staff,53,0,80,27
1650180916886,CSE 30,A01,083084,Eldon; John,0,67,40,40
1650180922913,CSE 100,A01,083659,Cao; Yingjun,0,63,50,50
1650180928941,CSE 134B,A01,083661,Powell; Thomas Allan,0,27,65,65
1650180934964,CSE 140,A01,083663,Staff,1,0,75,74
1650180940989,CSE 140L,A01,083088,Eldon; John,0,4,75,75
1650180947012,CSE 175,A01,083665,Kumar; Rakesh,8,0,25,17
1650180953038,CSE 190,A00,092507,Dubnov; Shlomo,14,0,20,6
1650180959065,ECE 45,A01,083139,Staff,0,13,40,40
1650180965104,ECE 65,A50,083695,Staff,0,5,30,30
1650180971127,ECE 109,A01,091882,Touri; Behrouz,47,0,70,23
1650180977155,ECE 180,A00,083140,Abi Samra; Nicholas Camill,24,0,30,6
1650180977155,ECE 180,B00,083141,Abi Samra; Nicholas Camill,8,0,30,22
1650180983250,MATH 10A,A01,083735,Patchell; Gregory David,11,0,30,19
1650180983250,MATH 10A,A02,083736,Patchell; Gregory David,28,0,30,2
1650180983250,MATH 10A,A03,083737,Patchell; Gregory David,26,0,30,4
1650180989273,MATH 10B,A01,083207,Staff,0,5,30,30
1650180989273,MATH 10B,A02,083208,Staff,0,5,30,30
1650180989273,MATH 10B,B01,083739,Staff,17,0,30,13
1650180989273,MATH 10B,B02,083740,Staff,29,0,30,1
1650180995296,MATH 18,A01,083743,Staff,10,0,30,20
1650180995296,MATH 18,A02,083744,Staff,28,0,30,2
1650180995296,MATH 18,A03,083745,Staff,23,0,30,7
1650180995296,MATH 18,A04,083746,Staff,27,0,30,3
1650180995296,MATH 18,B01,083748,Staff,0,10,30,30
1650180995296,MATH 18,B02,083749,Staff,0,7,30,30
1650180995296,MATH 18,B03,083750,Staff,0,7,30,30
1650180995296,MATH 18,B04,083751,Staff,0,7,30,30
1650181001318,MATH 20A,A01,083754,Staff,26,0,40,14
1650181007341,MATH 20B,A01,083756,Staff,0,6,30,30
1650181007341,MATH 20B,A02,083757,Staff,0,5,30,30
1650181013365,MATH 20C,A01,083760,Staff,0,12,30,30
1650181013365,MATH 20C,A02,083761,Staff,0,12,30,30
1650181013365,MATH 20C,B01,083762,Staff,14,0,30,16
1650181013365,MATH 20C,B02,083763,Staff,28,0,30,2
1650181019393,MATH 20D,A01,083765,Staff,0,2,30,30
1650181019393,MATH 20D,A02,083766,Staff,10,0,30,20
1650181019393,MATH 20D,A03,083767,Staff,28,0,30,2
1650181025416,MATH 20E,A01,083771,Staff,8,0,30,22
1650181025416,MATH 20E,A02,083772,Staff,20,0,30,10
1650181025416,MATH 20E,B01,083773,Staff,0,0,30,30
1650181025416,MATH 20E,B02,083774,Staff,13,0,30,17
1650181031445,MATH 103A,A01,083777,Staff,0,9,30,30
1650181031445,MATH 103A,A02,083778,Staff,0,10,30,30
1650181031445,MATH 103A,B01,083779,Staff,0,9,30,30
1650181031445,MATH 103A,B02,083780,Staff,0,9,30,30
1650181037472,MATH 105,A01,085443,Staff,0,17,30,30
1650181043499,MATH 109,A01,083213,Anzaldo; Leesa B,0,3,30,30
1650181043499,MATH 109,A02,083214,Anzaldo; Leesa B,0,6,30,30
1650181043499,MATH 109,B01,083215,Anzaldo; Leesa B,0,4,30,30
1650181043499,MATH 109,B02,083216,Anzaldo; Leesa B,0,4,30,30
1650181049523,MATH 142A,A01,083219,Chow; Bennett,0,12,30,30
1650181049523,MATH 142A,A02,083220,Chow; Bennett,0,11,30,30
1650181049523,MATH 142A,B01,083221,Chow; Bennett,0,11,30,30
1650181049523,MATH 142A,B02,083222,Chow; Bennett,0,12,30,30
1650181055553,MATH 193A,A01,083224,Staff,0,4,30,30
1650181055553,MATH 193A,A02,083225,Staff,0,4,30,30
1650181055553,MATH 193A,A03,083781,Staff,0,1,30,30
1650181055553,MATH 193A,A04,083782,Staff,0,1,30,30
1650181061574,MATH 197,001,091859,McAuley; Julian John,9998,0,9999,1
1650181067631,COGS 9,A01,083615,Staff,0,14,60,60
1650181073655,COGS 11,A01,083617,Boyle; Mary E. T.,24,0,40,16
1650181079680,COGS 13,A01,083071,Staff,0,30,40,40
1650181085705,COGS 14A,A01,092681,Staff,0,12,100,100
1650181091729,COGS 14B,A01,083073,Cheng; Tzu-Han,0,7,50,50
1650181097754,COGS 17,A01,092677,Staff,34,0,75,41
1650181103780,COGS 100,A01,083619,Staff,0,20,60,60
1650181109804,COGS 101A,A01,083621,Davis; Joshua Daniel,0,21,60,60
1650181115830,COGS 101B,A01,091572,Staff,6,0,60,54
1650181121852,COGS 101C,A01,083625,Delgado; Tania,20,0,30,10
1650181127895,COGS 107A,A01,083627,Boyle; Mary E. T.,0,7,60,60
1650181133920,COGS 118A,A01,083075,Staff,16,0,60,44
1650181139945,CSE 3,A50,083646,Miranda; Gregory Joseph,22,0,38,16
1650181139945,CSE 3,A51,083647,Miranda; Gregory Joseph,37,0,37,0
1650181145969,CSE 8A,A50,083650,Miranda; Gregory Joseph,0,17,40,40
1650181152013,CSE 11,A01,083080,Cao; Yingjun,0,68,40,40
1650181158041,CSE 12,A01,083652,Staff,0,5,100,100
1650181164065,CSE 15L,A01,083654,Staff,0,0,50,50
1650181164065,CSE 15L,A02,083655,Staff,8,0,50,42
1650181170090,CSE 20,A01,083657,Staff,53,0,80,27
1650181176117,CSE 30,A01,083084,Eldon; John,0,67,40,40
1650181182149,CSE 100,A01,083659,Cao; Yingjun,0,63,50,50
1650181188176,CSE 134B,A01,083661,Powell; Thomas Allan,0,27,65,65
1650181194200,CSE 140,A01,083663,Staff,1,0,75,74
1650181200229,CSE 140L,A01,083088,Eldon; John,0,4,75,75
1650181206251,CSE 175,A01,083665,Kumar; Rakesh,8,0,25,17
1650181212278,CSE 190,A00,092507,Dubnov; Shlomo,14,0,20,6
1650181218303,ECE 45,A01,083139,Staff,0,13,40,40
1650181224327,ECE 65,A50,083695,Staff,0,5,30,30
1650181230350,ECE 109,A01,091882,Touri; Behrouz,47,0,70,23
1650181236373,ECE 180,A00,083140,Abi Samra; Nicholas Camill,24,0,30,6
1650181236373,ECE 180,B00,083141,Abi Samra; Nicholas Camill,8,0,30,22
1650181242401,MATH 10A,A01,083735,Patchell; Gregory David,11,0,30,19
1650181242401,MATH 10A,A02,083736,Patchell; Gregory David,28,0,30,2
1650181242401,MATH 10A,A03,083737,Patchell; Gregory David,26,0,30,4
1650181248425,MATH 10B,A01,083207,Staff,0,5,30,30
1650181248425,MATH 10B,A02,083208,Staff,0,5,30,30
1650181248425,MATH 10B,B01,083739,Staff,17,0,30,13
1650181248425,MATH 10B,B02,083740,Staff,29,0,30,1
1650181254456,MATH 18,A01,083743,Staff,10,0,30,20
1650181254456,MATH 18,A02,083744,Staff,28,0,30,2
1650181254456,MATH 18,A03,083745,Staff,23,0,30,7
1650181254456,MATH 18,A04,083746,Staff,27,0,30,3
1650181254456,MATH 18,B01,083748,Staff,0,10,30,30
1650181254456,MATH 18,B02,083749,Staff,0,7,30,30
1650181254456,MATH 18,B03,083750,Staff,0,7,30,30
1650181254456,MATH 18,B04,083751,Staff,0,7,30,30
1650181260482,MATH 20A,A01,083754,Staff,26,0,40,14
1650181266510,MATH 20B,A01,083756,Staff,0,6,30,30
1650181266510,MATH 20B,A02,083757,Staff,0,5,30,30
1650181272534,MATH 20C,A01,083760,Staff,0,12,30,30
1650181272534,MATH 20C,A02,083761,Staff,0,12,30,30
1650181272534,MATH 20C,B01,083762,Staff,14,0,30,16
1650181272534,MATH 20C,B02,083763,Staff,28,0,30,2
1650181278561,MATH 20D,A01,083765,Staff,0,2,30,30
1650181278561,MATH 20D,A02,083766,Staff,10,0,30,20
1650181278561,MATH 20D,A03,083767,Staff,28,0,30,2
1650181284585,MATH 20E,A01,083771,Staff,8,0,30,22
1650181284585,MATH 20E,A02,083772,Staff,20,0,30,10
1650181284585,MATH 20E,B01,083773,Staff,0,0,30,30
1650181284585,MATH 20E,B02,083774,Staff,13,0,30,17
1650181290612,MATH 103A,A01,083777,Staff,0,9,30,30
1650181290612,MATH 103A,A02,083778,Staff,0,10,30,30
1650181290612,MATH 103A,B01,083779,Staff,0,9,30,30
1650181290612,MATH 103A,B02,083780,Staff,0,9,30,30
1650181296635,MATH 105,A01,085443,Staff,0,17,30,30
1650181302674,MATH 109,A01,083213,Anzaldo; Leesa B,0,3,30,30
1650181302674,MATH 109,A02,083214,Anzaldo; Leesa B,0,6,30,30
1650181302674,MATH 109,B01,083215,Anzaldo; Leesa B,0,4,30,30
1650181302674,MATH 109,B02,083216,Anzaldo; Leesa B,0,4,30,30
1650181308697,MATH 142A,A01,083219,Chow; Bennett,0,12,30,30
1650181308697,MATH 142A,A02,083220,Chow; Bennett,0,11,30,30
1650181308697,MATH 142A,B01,083221,Chow; Bennett,0,11,30,30
1650181308697,MATH 142A,B02,083222,Chow; Bennett,0,12,30,30
1650181314724,MATH 193A,A01,083224,Staff,0,4,30,30
1650181314724,MATH 193A,A02,083225,Staff,0,4,30,30
1650181314724,MATH 193A,A03,083781,Staff,0,1,30,30
1650181314724,MATH 193A,A04,083782,Staff,0,1,30,30
1650181320760,MATH 197,001,091859,McAuley; Julian John,9998,0,9999,1
1650181326811,COGS 9,A01,083615,Staff,0,14,60,60
1650181332835,COGS 11,A01,083617,Boyle; Mary E. T.,24,0,40,16
1650181338857,COGS 13,A01,083071,Staff,0,30,40,40
1650181344881,COGS 14A,A01,092681,Staff,0,12,100,100
1650181350910,COGS 14B,A01,083073,Cheng; Tzu-Han,0,7,50,50
1650181356935,COGS 17,A01,092677,Staff,34,0,75,41
1650181362963,COGS 100,A01,083619,Staff,0,20,60,60
1650181368990,COGS 101A,A01,083621,Davis; Joshua Daniel,0,21,60,60
1650181375024,COGS 101B,A01,091572,Staff,6,0,60,54
1650181381048,COGS 101C,A01,083625,Delgado; Tania,20,0,30,10
1650181387075,COGS 107A,A01,083627,Boyle; Mary E. T.,0,7,60,60
1650181393099,COGS 118A,A01,083075,Staff,16,0,60,44
1650181399122,CSE 3,A50,083646,Miranda; Gregory Joseph,22,0,38,16
1650181399122,CSE 3,A51,083647,Miranda; Gregory Joseph,37,0,37,0
1650181405146,CSE 8A,A50,083650,Miranda; Gregory Joseph,0,17,40,40
1650181411175,CSE 11,A01,083080,Cao; Yingjun,0,68,40,40
1650181417199,CSE 12,A01,083652,Staff,0,5,100,100
1650181423223,CSE 15L,A01,083654,Staff,0,0,50,50
1650181423223,CSE 15L,A02,083655,Staff,8,0,50,42
1650181429250,CSE 20,A01,083657,Staff,53,0,80,27
1650181435279,CSE 30,A01,083084,Eldon; John,0,67,40,40
1650181441303,CSE 100,A01,083659,Cao; Yingjun,0,63,50,50
1650181447325,CSE 134B,A01,083661,Powell; Thomas Allan,0,27,65,65
1650181453352,CSE 140,A01,083663,Staff,1,0,75,74
1650181459375,CSE 140L,A01,083088,Eldon; John,0,4,75,75
1650181465399,CSE 175,A01,083665,Kumar; Rakesh,8,0,25,17
1650181471424,CSE 190,A00,092507,Dubnov; Shlomo,14,0,20,6
1650181477448,ECE 45,A01,083139,Staff,0,13,40,40
1650181483471,ECE 65,A50,083695,Staff,0,5,30,30
1650181490081,ECE 109,A01,091882,Touri; Behrouz,47,0,70,23
1650181496103,ECE 180,A00,083140,Abi Samra; Nicholas Camill,24,0,30,6
1650181496103,ECE 180,B00,083141,Abi Samra; Nicholas Camill,8,0,30,22
1650181502135,MATH 10A,A01,083735,Patchell; Gregory David,11,0,30,19
1650181502135,MATH 10A,A02,083736,Patchell; Gregory David,28,0,30,2
1650181502135,MATH 10A,A03,083737,Patchell; Gregory David,26,0,30,4
1650181508160,MATH 10B,A01,083207,Staff,0,5,30,30
1650181508160,MATH 10B,A02,083208,Staff,0,5,30,30
1650181508160,MATH 10B,B01,083739,Staff,17,0,30,13
1650181508160,MATH 10B,B02,083740,Staff,29,0,30,1
1650181514185,MATH 18,A01,083743,Staff,10,0,30,20
1650181514185,MATH 18,A02,083744,Staff,28,0,30,2
1650181514185,MATH 18,A03,083745,Staff,23,0,30,7
1650181514185,MATH 18,A04,083746,Staff,27,0,30,3
1650181514185,MATH 18,B01,083748,Staff,0,10,30,30
1650181514185,MATH 18,B02,083749,Staff,0,7,30,30
1650181514185,MATH 18,B03,083750,Staff,0,7,30,30
1650181514185,MATH 18,B04,083751,Staff,0,7,30,30
1650181520208,MATH 20A,A01,083754,Staff,26,0,40,14
1650181526235,MATH 20B,A01,083756,Staff,0,6,30,30
1650181526235,MATH 20B,A02,083757,Staff,0,5,30,30
1650181532258,MATH 20C,A01,083760,Staff,0,12,30,30
1650181532258,MATH 20C,A02,083761,Staff,0,12,30,30
1650181532258,MATH 20C,B01,083762,Staff,14,0,30,16
1650181532258,MATH 20C,B02,083763,Staff,28,0,30,2
1650181538280,MATH 20D,A01,083765,Staff,1,2,30,29
1650181538280,MATH 20D,A02,083766,Staff,10,0,30,20
1650181538280,MATH 20D,A03,083767,Staff,28,0,30,2
1650181544309,MATH 20E,A01,083771,Staff,8,0,30,22
1650181544309,MATH 20E,A02,083772,Staff,20,0,30,10
1650181544309,MATH 20E,B01,083773,Staff,0,0,30,30
1650181544309,MATH 20E,B02,083774,Staff,12,0,30,18
1650181551234,MATH 103A,A01,083777,Staff,0,9,30,30
1650181551234,MATH 103A,A02,083778,Staff,0,10,30,30
1650181551234,MATH 103A,B01,083779,Staff,0,9,30,30
1650181551234,MATH 103A,B02,083780,Staff,0,9,30,30
