time,subj_course_id,sec_code,sec_id,prof,available,waitlist,total,enrolled_ct
1650712563638,COGS 9,A01,083615,Staff,1,15,60,59
1650712569667,COGS 11,A01,083617,Boyle; Mary E. T.,16,0,40,24
1650712575698,COGS 13,A01,083071,Staff,0,38,40,40
1650712581731,COGS 14A,A01,092681,Staff,0,35,100,100
1650712587765,COGS 14B,A01,083073,Cheng; Tzu-Han,1,13,50,49
1650712593795,COGS 17,A01,092677,Staff,13,0,75,62
1650712599831,COGS 100,A01,083619,Staff,0,28,60,60
1650712605860,COGS 101A,A01,083621,Davis; Joshua Daniel,0,27,60,60
1650712611895,COGS 101B,A01,091572,Staff,0,4,60,60
1650712617921,COGS 101C,A01,083625,Delgado; Tania,14,0,30,16
1650712623955,COGS 107A,A01,083627,Boyle; Mary E. T.,0,16,60,60
1650712629994,COGS 118A,A01,083075,Staff,0,8,60,60
1650712636030,CSE 3,A50,083646,Miranda; Gregory Joseph,18,0,38,20
1650712636030,CSE 3,A51,083647,Miranda; Gregory Joseph,36,0,37,1
1650712642064,CSE 8A,A50,083650,Miranda; Gregory Joseph,0,30,40,40
1650712648101,CSE 11,A01,083080,Cao; Yingjun,0,96,40,40
1650712654136,CSE 12,A01,083652,Staff,0,21,100,100
1650712660165,CSE 15L,A01,083654,Staff,0,3,50,50
1650712660165,CSE 15L,A02,083655,Staff,0,2,50,50
1650712666189,CSE 20,A01,083657,Staff,49,0,80,31
1650712672221,CSE 30,A01,083084,Eldon; John,0,77,40,40
1650712678254,CSE 100,A01,083659,Cao; Yingjun,0,70,50,50
1650712684285,CSE 134B,A01,083661,Powell; Thomas Allan,0,38,65,65
1650712690313,CSE 140,A01,083663,Staff,0,11,75,75
1650712696349,CSE 140L,A01,083088,Eldon; John,0,20,75,75
1650712702379,CSE 175,A01,083665,Kumar; Rakesh,7,0,25,18
1650712708414,CSE 190,A00,092507,Dubnov; Shlomo,10,0,20,10
1650712714444,ECE 45,A01,083139,Staff,1,2,60,59
1650712720478,ECE 65,A50,083695,Staff,0,5,30,30
1650712726514,ECE 109,A01,091882,Touri; Behrouz,33,0,70,37
1650712732551,ECE 180,A00,083140,Abi Samra; Nicholas Camill,20,0,30,10
1650712732551,ECE 180,B00,083141,Abi Samra; Nicholas Camill,0,0,30,30
1650712738583,MATH 10A,A01,083735,Patchell; Gregory David,2,0,30,28
1650712738583,MATH 10A,A02,083736,Patchell; Gregory David,27,0,30,3
1650712738583,MATH 10A,A03,083737,Patchell; Gregory David,24,0,30,6
1650712744621,MATH 10B,A01,083207,Staff,0,9,30,30
1650712744621,MATH 10B,A02,083208,Staff,1,7,30,29
1650712744621,MATH 10B,B01,083739,Staff,11,0,30,19
1650712744621,MATH 10B,B02,083740,Staff,28,0,30,2
1650712750653,MATH 18,A01,083743,Staff,0,0,30,30
1650712750653,MATH 18,A02,083744,Staff,23,0,30,7
1650712750653,MATH 18,A03,083745,Staff,21,0,30,9
1650712750653,MATH 18,A04,083746,Staff,26,0,30,4
1650712750653,MATH 18,B01,083748,Staff,0,15,30,30
1650712750653,MATH 18,B02,083749,Staff,0,12,30,30
1650712750653,MATH 18,B03,083750,Staff,0,12,30,30
1650712750653,MATH 18,B04,083751,Staff,0,12,30,30
1650712756682,MATH 20A,A01,083754,Staff,19,0,40,21
1650712762711,MATH 20B,A01,083756,Staff,0,11,30,30
1650712762711,MATH 20B,A02,083757,Staff,0,12,30,30
1650712768747,MATH 20C,A01,083760,Staff,0,16,30,30
1650712768747,MATH 20C,A02,083761,Staff,0,15,30,30
1650712768747,MATH 20C,B01,083762,Staff,9,0,30,21
1650712768747,MATH 20C,B02,083763,Staff,28,0,30,2
1650712774779,MATH 20D,A01,083765,Staff,2,1,30,28
1650712774779,MATH 20D,A02,083766,Staff,6,0,30,24
1650712774779,MATH 20D,A03,083767,Staff,24,0,30,6
1650712780804,MATH 20E,A01,083771,Staff,3,0,30,27
1650712780804,MATH 20E,A02,083772,Staff,16,0,30,14
1650712780804,MATH 20E,B01,083773,Staff,0,0,30,30
1650712780804,MATH 20E,B02,083774,Staff,6,0,30,24
1650712786841,MATH 103A,A01,083777,Staff,0,15,30,30
1650712786841,MATH 103A,A02,083778,Staff,0,15,30,30
1650712786841,MATH 103A,B01,083779,Staff,0,15,30,30
1650712786841,MATH 103A,B02,083780,Staff,0,15,30,30
1650712792872,MATH 105,A01,085443,Staff,0,22,30,30
1650712798911,MATH 109,A01,083213,Anzaldo; Leesa B,0,7,30,30
1650712798911,MATH 109,A02,083214,Anzaldo; Leesa B,0,7,30,30
1650712798911,MATH 109,B01,083215,Anzaldo; Leesa B,0,8,30,30
1650712798911,MATH 109,B02,083216,Anzaldo; Leesa B,0,6,30,30
1650712804951,MATH 142A,A01,083219,Chow; Bennett,0,16,30,30
1650712804951,MATH 142A,A02,083220,Chow; Bennett,0,15,30,30
1650712804951,MATH 142A,B01,083221,Chow; Bennett,0,15,30,30
1650712804951,MATH 142A,B02,083222,Chow; Bennett,0,14,30,30
1650712810982,MATH 193A,A01,083224,Staff,0,5,30,30
1650712810982,MATH 193A,A02,083225,Staff,0,6,30,30
1650712810982,MATH 193A,A03,083781,Staff,0,6,30,30
1650712810982,MATH 193A,A04,083782,Staff,0,7,30,30
1650712817014,MATH 197,001,091859,McAuley; Julian John,9998,0,9999,1
1650712823102,COGS 9,A01,083615,Staff,1,15,60,59
1650712829129,COGS 11,A01,083617,Boyle; Mary E. T.,16,0,40,24
1650712835156,COGS 13,A01,083071,Staff,0,38,40,40
1650712841190,COGS 14A,A01,092681,Staff,0,35,100,100
1650712847224,COGS 14B,A01,083073,Cheng; Tzu-Han,1,13,50,49
1650712853253,COGS 17,A01,092677,Staff,13,0,75,62
1650712859281,COGS 100,A01,083619,Staff,0,28,60,60
1650712865313,COGS 101A,A01,083621,Davis; Joshua Daniel,0,27,60,60
1650712871342,COGS 101B,A01,091572,Staff,0,4,60,60
1650712877377,COGS 101C,A01,083625,Delgado; Tania,14,0,30,16
1650712883411,COGS 107A,A01,083627,Boyle; Mary E. T.,0,16,60,60
1650712889441,COGS 118A,A01,083075,Staff,0,8,60,60
1650712895472,CSE 3,A50,083646,Miranda; Gregory Joseph,18,0,38,20
1650712895472,CSE 3,A51,083647,Miranda; Gregory Joseph,36,0,37,1
1650712901500,CSE 8A,A50,083650,Miranda; Gregory Joseph,0,30,40,40
1650712907534,CSE 11,A01,083080,Cao; Yingjun,0,96,40,40
1650712913562,CSE 12,A01,083652,Staff,0,21,100,100
1650712919596,CSE 15L,A01,083654,Staff,0,3,50,50
1650712919596,CSE 15L,A02,083655,Staff,0,2,50,50
1650712925622,CSE 20,A01,083657,Staff,49,0,80,31
1650712931653,CSE 30,A01,083084,Eldon; John,0,77,40,40
1650712937683,CSE 100,A01,083659,Cao; Yingjun,0,70,50,50
1650712943712,CSE 134B,A01,083661,Powell; Thomas Allan,0,38,65,65
1650712949741,CSE 140,A01,083663,Staff,0,11,75,75
1650712955774,CSE 140L,A01,083088,Eldon; John,0,20,75,75
1650712961804,CSE 175,A01,083665,Kumar; Rakesh,7,0,25,18
1650712967838,CSE 190,A00,092507,Dubnov; Shlomo,10,0,20,10
1650712973872,ECE 45,A01,083139,Staff,1,2,60,59
1650712979909,ECE 65,A50,083695,Staff,0,5,30,30
1650712985940,ECE 109,A01,091882,Touri; Behrouz,33,0,70,37
1650712991974,ECE 180,A00,083140,Abi Samra; Nicholas Camill,20,0,30,10
1650712991974,ECE 180,B00,083141,Abi Samra; Nicholas Camill,0,0,30,30
1650712998012,MATH 10A,A01,083735,Patchell; Gregory David,2,0,30,28
1650712998012,MATH 10A,A02,083736,Patchell; Gregory David,27,0,30,3
1650712998012,MATH 10A,A03,083737,Patchell; Gregory David,24,0,30,6
1650713004043,MATH 10B,A01,083207,Staff,0,9,30,30
1650713004043,MATH 10B,A02,083208,Staff,1,7,30,29
1650713004043,MATH 10B,B01,083739,Staff,11,0,30,19
1650713004043,MATH 10B,B02,083740,Staff,28,0,30,2
1650713010078,MATH 18,A01,083743,Staff,0,0,30,30
1650713010078,MATH 18,A02,083744,Staff,23,0,30,7
1650713010078,MATH 18,A03,083745,Staff,21,0,30,9
1650713010078,MATH 18,A04,083746,Staff,26,0,30,4
1650713010078,MATH 18,B01,083748,Staff,0,15,30,30
1650713010078,MATH 18,B02,083749,Staff,0,12,30,30
1650713010078,MATH 18,B03,083750,Staff,0,12,30,30
1650713010078,MATH 18,B04,083751,Staff,0,12,30,30
1650713016110,MATH 20A,A01,083754,Staff,19,0,40,21
1650713022140,MATH 20B,A01,083756,Staff,0,11,30,30
1650713022140,MATH 20B,A02,083757,Staff,0,12,30,30
1650713028167,MATH 20C,A01,083760,Staff,0,16,30,30
1650713028167,MATH 20C,A02,083761,Staff,0,15,30,30
1650713028167,MATH 20C,B01,083762,Staff,9,0,30,21
1650713028167,MATH 20C,B02,083763,Staff,28,0,30,2
1650713034198,MATH 20D,A01,083765,Staff,2,1,30,28
1650713034198,MATH 20D,A02,083766,Staff,6,0,30,24
1650713034198,MATH 20D,A03,083767,Staff,24,0,30,6
1650713040234,MATH 20E,A01,083771,Staff,3,0,30,27
1650713040234,MATH 20E,A02,083772,Staff,16,0,30,14
1650713040234,MATH 20E,B01,083773,Staff,0,0,30,30
1650713040234,MATH 20E,B02,083774,Staff,6,0,30,24
1650713046262,MATH 103A,A01,083777,Staff,0,15,30,30
1650713046262,MATH 103A,A02,083778,Staff,0,15,30,30
1650713046262,MATH 103A,B01,083779,Staff,0,15,30,30
1650713046262,MATH 103A,B02,083780,Staff,0,15,30,30
1650713052289,MATH 105,A01,085443,Staff,0,22,30,30
1650713058320,MATH 109,A01,083213,Anzaldo; Leesa B,0,7,30,30
1650713058320,MATH 109,A02,083214,Anzaldo; Leesa B,0,7,30,30
1650713058320,MATH 109,B01,083215,Anzaldo; Leesa B,0,8,30,30
1650713058320,MATH 109,B02,083216,Anzaldo; Leesa B,0,6,30,30
1650713064347,MATH 142A,A01,083219,Chow; Bennett,0,16,30,30
1650713064347,MATH 142A,A02,083220,Chow; Bennett,0,15,30,30
1650713064347,MATH 142A,B01,083221,Chow; Bennett,0,15,30,30
1650713064347,MATH 142A,B02,083222,Chow; Bennett,0,14,30,30
1650713070388,MATH 193A,A01,083224,Staff,0,5,30,30
1650713070388,MATH 193A,A02,083225,Staff,0,6,30,30
1650713070388,MATH 193A,A03,083781,Staff,0,6,30,30
1650713070388,MATH 193A,A04,083782,Staff,0,7,30,30
1650713076421,MATH 197,001,091859,McAuley; Julian John,9998,0,9999,1
1650713082507,COGS 9,A01,083615,Staff,1,15,60,59
1650713088539,COGS 11,A01,083617,Boyle; Mary E. T.,16,0,40,24
1650713094576,COGS 13,A01,083071,Staff,0,38,40,40
1650713100608,COGS 14A,A01,092681,Staff,0,35,100,100
1650713106641,COGS 14B,A01,083073,Cheng; Tzu-Han,1,13,50,49
1650713112664,COGS 17,A01,092677,Staff,13,0,75,62
1650713118690,COGS 100,A01,083619,Staff,0,28,60,60
1650713124720,COGS 101A,A01,083621,Davis; Joshua Daniel,0,27,60,60
1650713130748,COGS 101B,A01,091572,Staff,0,4,60,60
1650713136858,COGS 101C,A01,083625,Delgado; Tania,14,0,30,16
1650713142894,COGS 107A,A01,083627,Boyle; Mary E. T.,0,16,60,60
1650713148923,COGS 118A,A01,083075,Staff,0,8,60,60
1650713154962,CSE 3,A50,083646,Miranda; Gregory Joseph,18,0,38,20
1650713154962,CSE 3,A51,083647,Miranda; Gregory Joseph,36,0,37,1
1650713160996,CSE 8A,A50,083650,Miranda; Gregory Joseph,0,30,40,40
1650713167024,CSE 11,A01,083080,Cao; Yingjun,0,96,40,40
1650713173053,CSE 12,A01,083652,Staff,0,21,100,100
1650713179084,CSE 15L,A01,083654,Staff,0,3,50,50
1650713179084,CSE 15L,A02,083655,Staff,0,2,50,50
1650713185117,CSE 20,A01,083657,Staff,49,0,80,31
1650713191147,CSE 30,A01,083084,Eldon; John,0,77,40,40
1650713197182,CSE 100,A01,083659,Cao; Yingjun,0,70,50,50
1650713203216,CSE 134B,A01,083661,Powell; Thomas Allan,0,38,65,65
1650713209244,CSE 140,A01,083663,Staff,0,11,75,75
1650713215273,CSE 140L,A01,083088,Eldon; John,0,20,75,75
1650713221307,CSE 175,A01,083665,Kumar; Rakesh,7,0,25,18
1650713227343,CSE 190,A00,092507,Dubnov; Shlomo,10,0,20,10
1650713233374,ECE 45,A01,083139,Staff,1,2,60,59
1650713239402,ECE 65,A50,083695,Staff,0,5,30,30
1650713245428,ECE 109,A01,091882,Touri; Behrouz,33,0,70,37
1650713251457,ECE 180,A00,083140,Abi Samra; Nicholas Camill,20,0,30,10
1650713251457,ECE 180,B00,083141,Abi Samra; Nicholas Camill,0,0,30,30
1650713257494,MATH 10A,A01,083735,Patchell; Gregory David,2,0,30,28
1650713257494,MATH 10A,A02,083736,Patchell; Gregory David,27,0,30,3
1650713257494,MATH 10A,A03,083737,Patchell; Gregory David,24,0,30,6
1650713263526,MATH 10B,A01,083207,Staff,0,9,30,30
1650713263526,MATH 10B,A02,083208,Staff,1,7,30,29
1650713263526,MATH 10B,B01,083739,Staff,11,0,30,19
1650713263526,MATH 10B,B02,083740,Staff,28,0,30,2
1650713269565,MATH 18,A01,083743,Staff,0,0,30,30
1650713269565,MATH 18,A02,083744,Staff,23,0,30,7
1650713269565,MATH 18,A03,083745,Staff,21,0,30,9
1650713269565,MATH 18,A04,083746,Staff,26,0,30,4
1650713269565,MATH 18,B01,083748,Staff,0,15,30,30
1650713269565,MATH 18,B02,083749,Staff,0,12,30,30
1650713269565,MATH 18,B03,083750,Staff,0,12,30,30
1650713269565,MATH 18,B04,083751,Staff,0,12,30,30
1650713275592,MATH 20A,A01,083754,Staff,19,0,40,21
1650713281621,MATH 20B,A01,083756,Staff,0,11,30,30
1650713281621,MATH 20B,A02,083757,Staff,0,12,30,30
1650713287650,MATH 20C,A01,083760,Staff,0,16,30,30
1650713287650,MATH 20C,A02,083761,Staff,0,15,30,30
1650713287650,MATH 20C,B01,083762,Staff,9,0,30,21
1650713287650,MATH 20C,B02,083763,Staff,28,0,30,2
1650713293675,MATH 20D,A01,083765,Staff,2,1,30,28
1650713293675,MATH 20D,A02,083766,Staff,6,0,30,24
1650713293675,MATH 20D,A03,083767,Staff,24,0,30,6
1650713299709,MATH 20E,A01,083771,Staff,3,0,30,27
1650713299709,MATH 20E,A02,083772,Staff,16,0,30,14
1650713299709,MATH 20E,B01,083773,Staff,0,0,30,30
1650713299709,MATH 20E,B02,083774,Staff,6,0,30,24
1650713305744,MATH 103A,A01,083777,Staff,0,15,30,30
1650713305744,MATH 103A,A02,083778,Staff,0,15,30,30
1650713305744,MATH 103A,B01,083779,Staff,0,15,30,30
1650713305744,MATH 103A,B02,083780,Staff,0,15,30,30
1650713311779,MATH 105,A01,085443,Staff,0,22,30,30
1650713317826,MATH 109,A01,083213,Anzaldo; Leesa B,0,7,30,30
1650713317826,MATH 109,A02,083214,Anzaldo; Leesa B,0,7,30,30
1650713317826,MATH 109,B01,083215,Anzaldo; Leesa B,0,8,30,30
1650713317826,MATH 109,B02,083216,Anzaldo; Leesa B,0,6,30,30
1650713323856,MATH 142A,A01,083219,Chow; Bennett,0,16,30,30
1650713323856,MATH 142A,A02,083220,Chow; Bennett,0,15,30,30
1650713323856,MATH 142A,B01,083221,Chow; Bennett,0,15,30,30
1650713323856,MATH 142A,B02,083222,Chow; Bennett,0,14,30,30
1650713329890,MATH 193A,A01,083224,Staff,0,5,30,30
1650713329890,MATH 193A,A02,083225,Staff,0,6,30,30
1650713329890,MATH 193A,A03,083781,Staff,0,6,30,30
1650713329890,MATH 193A,A04,083782,Staff,0,7,30,30
1650713335916,MATH 197,001,091859,McAuley; Julian John,9998,0,9999,1
1650713341991,COGS 9,A01,083615,Staff,1,15,60,59
1650713348028,COGS 11,A01,083617,Boyle; Mary E. T.,16,0,40,24
1650713354055,COGS 13,A01,083071,Staff,0,38,40,40
1650713360092,COGS 14A,A01,092681,Staff,0,35,100,100
1650713366121,COGS 14B,A01,083073,Cheng; Tzu-Han,1,13,50,49
1650713372152,COGS 17,A01,092677,Staff,13,0,75,62
1650713378182,COGS 100,A01,083619,Staff,0,28,60,60
1650713384216,COGS 101A,A01,083621,Davis; Joshua Daniel,0,27,60,60
1650713390246,COGS 101B,A01,091572,Staff,0,4,60,60
1650713396278,COGS 101C,A01,083625,Delgado; Tania,14,0,30,16
1650713402304,COGS 107A,A01,083627,Boyle; Mary E. T.,0,16,60,60
1650713408331,COGS 118A,A01,083075,Staff,0,8,60,60
1650713414363,CSE 3,A50,083646,Miranda; Gregory Joseph,18,0,38,20
1650713414363,CSE 3,A51,083647,Miranda; Gregory Joseph,36,0,37,1
1650713420395,CSE 8A,A50,083650,Miranda; Gregory Joseph,0,30,40,40
1650713426424,CSE 11,A01,083080,Cao; Yingjun,0,96,40,40
1650713432453,CSE 12,A01,083652,Staff,0,21,100,100
1650713438479,CSE 15L,A01,083654,Staff,0,3,50,50
1650713438479,CSE 15L,A02,083655,Staff,0,2,50,50
1650713444511,CSE 20,A01,083657,Staff,49,0,80,31
1650713450541,CSE 30,A01,083084,Eldon; John,0,77,40,40
1650713456569,CSE 100,A01,083659,Cao; Yingjun,0,70,50,50
1650713462601,CSE 134B,A01,083661,Powell; Thomas Allan,0,38,65,65
1650713468633,CSE 140,A01,083663,Staff,0,11,75,75
1650713474662,CSE 140L,A01,083088,Eldon; John,0,20,75,75
1650713480691,CSE 175,A01,083665,Kumar; Rakesh,7,0,25,18
1650713486719,CSE 190,A00,092507,Dubnov; Shlomo,10,0,20,10
1650713492747,ECE 45,A01,083139,Staff,1,2,60,59
1650713498781,ECE 65,A50,083695,Staff,0,5,30,30
1650713504809,ECE 109,A01,091882,Touri; Behrouz,33,0,70,37
1650713510840,ECE 180,A00,083140,Abi Samra; Nicholas Camill,20,0,30,10
1650713510840,ECE 180,B00,083141,Abi Samra; Nicholas Camill,0,0,30,30
1650713516874,MATH 10A,A01,083735,Patchell; Gregory David,2,0,30,28
1650713516874,MATH 10A,A02,083736,Patchell; Gregory David,27,0,30,3
1650713516874,MATH 10A,A03,083737,Patchell; Gregory David,24,0,30,6
1650713522904,MATH 10B,A01,083207,Staff,0,9,30,30
1650713522904,MATH 10B,A02,083208,Staff,1,7,30,29
1650713522904,MATH 10B,B01,083739,Staff,11,0,30,19
1650713522904,MATH 10B,B02,083740,Staff,28,0,30,2
1650713528953,MATH 18,A01,083743,Staff,0,0,30,30
1650713528953,MATH 18,A02,083744,Staff,23,0,30,7
1650713528953,MATH 18,A03,083745,Staff,21,0,30,9
1650713528953,MATH 18,A04,083746,Staff,26,0,30,4
1650713528953,MATH 18,B01,083748,Staff,0,15,30,30
1650713528953,MATH 18,B02,083749,Staff,0,12,30,30
1650713528953,MATH 18,B03,083750,Staff,0,12,30,30
1650713528953,MATH 18,B04,083751,Staff,0,12,30,30
1650713534987,MATH 20A,A01,083754,Staff,19,0,40,21
1650713541016,MATH 20B,A01,083756,Staff,0,11,30,30
1650713541016,MATH 20B,A02,083757,Staff,0,12,30,30
1650713547045,MATH 20C,A01,083760,Staff,0,16,30,30
1650713547045,MATH 20C,A02,083761,Staff,0,15,30,30
1650713547045,MATH 20C,B01,083762,Staff,9,0,30,21
1650713547045,MATH 20C,B02,083763,Staff,28,0,30,2
1650713553076,MATH 20D,A01,083765,Staff,2,1,30,28
1650713553076,MATH 20D,A02,083766,Staff,6,0,30,24
1650713553076,MATH 20D,A03,083767,Staff,24,0,30,6
1650713559105,MATH 20E,A01,083771,Staff,3,0,30,27
1650713559105,MATH 20E,A02,083772,Staff,16,0,30,14
1650713559105,MATH 20E,B01,083773,Staff,0,0,30,30
1650713559105,MATH 20E,B02,083774,Staff,6,0,30,24
1650713565141,MATH 103A,A01,083777,Staff,0,15,30,30
1650713565141,MATH 103A,A02,083778,Staff,0,15,30,30
1650713565141,MATH 103A,B01,083779,Staff,0,15,30,30
1650713565141,MATH 103A,B02,083780,Staff,0,15,30,30
1650713571167,MATH 105,A01,085443,Staff,0,22,30,30
1650713577200,MATH 109,A01,083213,Anzaldo; Leesa B,0,7,30,30
1650713577200,MATH 109,A02,083214,Anzaldo; Leesa B,0,7,30,30
1650713577200,MATH 109,B01,083215,Anzaldo; Leesa B,0,8,30,30
1650713577200,MATH 109,B02,083216,Anzaldo; Leesa B,0,6,30,30
1650713583238,MATH 142A,A01,083219,Chow; Bennett,0,16,30,30
1650713583238,MATH 142A,A02,083220,Chow; Bennett,0,15,30,30
1650713583238,MATH 142A,B01,083221,Chow; Bennett,0,15,30,30
1650713583238,MATH 142A,B02,083222,Chow; Bennett,0,14,30,30
1650713589274,MATH 193A,A01,083224,Staff,0,5,30,30
1650713589274,MATH 193A,A02,083225,Staff,0,6,30,30
1650713589274,MATH 193A,A03,083781,Staff,0,6,30,30
1650713589274,MATH 193A,A04,083782,Staff,0,7,30,30
1650713595300,MATH 197,001,091859,McAuley; Julian John,9998,0,9999,1
1650713601375,COGS 9,A01,083615,Staff,1,15,60,59
1650713607408,COGS 11,A01,083617,Boyle; Mary E. T.,16,0,40,24
1650713613438,COGS 13,A01,083071,Staff,0,38,40,40
1650713619467,COGS 14A,A01,092681,Staff,0,35,100,100
1650713625501,COGS 14B,A01,083073,Cheng; Tzu-Han,1,13,50,49
1650713631528,COGS 17,A01,092677,Staff,13,0,75,62
1650713637553,COGS 100,A01,083619,Staff,0,28,60,60
1650713643580,COGS 101A,A01,083621,Davis; Joshua Daniel,0,27,60,60
1650713649613,COGS 101B,A01,091572,Staff,0,4,60,60
1650713655641,COGS 101C,A01,083625,Delgado; Tania,14,0,30,16
1650713661671,COGS 107A,A01,083627,Boyle; Mary E. T.,0,16,60,60
1650713667701,COGS 118A,A01,083075,Staff,0,8,60,60
1650713673731,CSE 3,A50,083646,Miranda; Gregory Joseph,18,0,38,20
1650713673731,CSE 3,A51,083647,Miranda; Gregory Joseph,36,0,37,1
1650713679762,CSE 8A,A50,083650,Miranda; Gregory Joseph,0,30,40,40
1650713685792,CSE 11,A01,083080,Cao; Yingjun,0,96,40,40
1650713691823,CSE 12,A01,083652,Staff,0,21,100,100
1650713697851,CSE 15L,A01,083654,Staff,0,3,50,50
1650713697851,CSE 15L,A02,083655,Staff,0,2,50,50
1650713703878,CSE 20,A01,083657,Staff,49,0,80,31
1650713709904,CSE 30,A01,083084,Eldon; John,0,77,40,40
1650713715936,CSE 100,A01,083659,Cao; Yingjun,0,70,50,50
1650713721963,CSE 134B,A01,083661,Powell; Thomas Allan,0,38,65,65
1650713727994,CSE 140,A01,083663,Staff,0,11,75,75
1650713734112,CSE 140L,A01,083088,Eldon; John,0,20,75,75
1650713740143,CSE 175,A01,083665,Kumar; Rakesh,7,0,25,18
1650713746170,CSE 190,A00,092507,Dubnov; Shlomo,10,0,20,10
1650713752201,ECE 45,A01,083139,Staff,1,2,60,59
1650713758231,ECE 65,A50,083695,Staff,0,5,30,30
1650713764263,ECE 109,A01,091882,Touri; Behrouz,33,0,70,37
1650713770306,ECE 180,A00,083140,Abi Samra; Nicholas Camill,20,0,30,10
1650713770306,ECE 180,B00,083141,Abi Samra; Nicholas Camill,0,0,30,30
1650713776339,MATH 10A,A01,083735,Patchell; Gregory David,2,0,30,28
1650713776339,MATH 10A,A02,083736,Patchell; Gregory David,27,0,30,3
1650713776339,MATH 10A,A03,083737,Patchell; Gregory David,24,0,30,6
1650713782369,MATH 10B,A01,083207,Staff,0,9,30,30
1650713782369,MATH 10B,A02,083208,Staff,1,7,30,29
1650713782369,MATH 10B,B01,083739,Staff,11,0,30,19
1650713782369,MATH 10B,B02,083740,Staff,28,0,30,2
1650713788413,MATH 18,A01,083743,Staff,0,0,30,30
1650713788413,MATH 18,A02,083744,Staff,23,0,30,7
1650713788413,MATH 18,A03,083745,Staff,21,0,30,9
1650713788413,MATH 18,A04,083746,Staff,26,0,30,4
1650713788413,MATH 18,B01,083748,Staff,0,15,30,30
1650713788413,MATH 18,B02,083749,Staff,0,12,30,30
1650713788413,MATH 18,B03,083750,Staff,0,12,30,30
1650713788413,MATH 18,B04,083751,Staff,0,12,30,30
1650713794441,MATH 20A,A01,083754,Staff,19,0,40,21
1650713800469,MATH 20B,A01,083756,Staff,0,11,30,30
1650713800469,MATH 20B,A02,083757,Staff,0,12,30,30
1650713806502,MATH 20C,A01,083760,Staff,0,16,30,30
1650713806502,MATH 20C,A02,083761,Staff,0,15,30,30
1650713806502,MATH 20C,B01,083762,Staff,9,0,30,21
1650713806502,MATH 20C,B02,083763,Staff,28,0,30,2
1650713812530,MATH 20D,A01,083765,Staff,2,1,30,28
1650713812530,MATH 20D,A02,083766,Staff,6,0,30,24
1650713812530,MATH 20D,A03,083767,Staff,24,0,30,6
1650713818558,MATH 20E,A01,083771,Staff,3,0,30,27
1650713818558,MATH 20E,A02,083772,Staff,16,0,30,14
1650713818558,MATH 20E,B01,083773,Staff,0,0,30,30
1650713818558,MATH 20E,B02,083774,Staff,6,0,30,24
1650713824586,MATH 103A,A01,083777,Staff,0,15,30,30
1650713824586,MATH 103A,A02,083778,Staff,0,15,30,30
1650713824586,MATH 103A,B01,083779,Staff,0,15,30,30
1650713824586,MATH 103A,B02,083780,Staff,0,15,30,30
1650713830620,MATH 105,A01,085443,Staff,0,22,30,30
1650713836654,MATH 109,A01,083213,Anzaldo; Leesa B,0,7,30,30
1650713836654,MATH 109,A02,083214,Anzaldo; Leesa B,0,7,30,30
1650713836654,MATH 109,B01,083215,Anzaldo; Leesa B,0,8,30,30
1650713836654,MATH 109,B02,083216,Anzaldo; Leesa B,0,6,30,30
1650713842688,MATH 142A,A01,083219,Chow; Bennett,0,16,30,30
1650713842688,MATH 142A,A02,083220,Chow; Bennett,0,15,30,30
1650713842688,MATH 142A,B01,083221,Chow; Bennett,0,15,30,30
1650713842688,MATH 142A,B02,083222,Chow; Bennett,0,14,30,30
1650713848720,MATH 193A,A01,083224,Staff,0,5,30,30
1650713848720,MATH 193A,A02,083225,Staff,0,6,30,30
1650713848720,MATH 193A,A03,083781,Staff,0,6,30,30
1650713848720,MATH 193A,A04,083782,Staff,0,7,30,30
1650713854751,MATH 197,001,091859,McAuley; Julian John,9998,0,9999,1
1650713860828,COGS 9,A01,083615,Staff,1,15,60,59
1650713866860,COGS 11,A01,083617,Boyle; Mary E. T.,16,0,40,24
1650713872893,COGS 13,A01,083071,Staff,0,38,40,40
1650713878937,COGS 14A,A01,092681,Staff,0,35,100,100
1650713884968,COGS 14B,A01,083073,Cheng; Tzu-Han,1,13,50,49
1650713890998,COGS 17,A01,092677,Staff,13,0,75,62
1650713907957,COGS 100,A01,083619,Staff,0,28,60,60
1650713914067,COGS 101A,A01,083621,Davis; Joshua Daniel,0,27,60,60
1650713929302,COGS 101B,A01,091572,Staff,0,4,60,60
1650713935337,COGS 101C,A01,083625,Delgado; Tania,14,0,30,16
1650713950735,COGS 107A,A01,083627,Boyle; Mary E. T.,0,16,60,60
1650713956812,COGS 118A,A01,083075,Staff,0,8,60,60
1650713972408,CSE 3,A50,083646,Miranda; Gregory Joseph,18,0,38,20
1650713972408,CSE 3,A51,083647,Miranda; Gregory Joseph,36,0,37,1
1650713978437,CSE 8A,A50,083650,Miranda; Gregory Joseph,0,30,40,40
1650713993893,CSE 11,A01,083080,Cao; Yingjun,0,96,40,40
1650713999926,CSE 12,A01,083652,Staff,0,21,100,100
1650714016019,CSE 15L,A01,083654,Staff,0,3,50,50
1650714016019,CSE 15L,A02,083655,Staff,0,2,50,50
1650714022048,CSE 20,A01,083657,Staff,49,0,80,31
1650714037398,CSE 30,A01,083084,Eldon; John,0,77,40,40
1650714043436,CSE 100,A01,083659,Cao; Yingjun,0,70,50,50
1650714049480,CSE 134B,A01,083661,Powell; Thomas Allan,0,38,65,65
1650714055508,CSE 140,A01,083663,Staff,0,11,75,75
1650714061537,CSE 140L,A01,083088,Eldon; John,0,20,75,75
1650714067572,CSE 175,A01,083665,Kumar; Rakesh,7,0,25,18
1650714073601,CSE 190,A00,092507,Dubnov; Shlomo,10,0,20,10
1650714079637,ECE 45,A01,083139,Staff,1,2,60,59
1650714085673,ECE 65,A50,083695,Staff,0,5,30,30
1650714091701,ECE 109,A01,091882,Touri; Behrouz,33,0,70,37
1650714097730,ECE 180,A00,083140,Abi Samra; Nicholas Camill,20,0,30,10
1650714097730,ECE 180,B00,083141,Abi Samra; Nicholas Camill,0,0,30,30
1650714103760,MATH 10A,A01,083735,Patchell; Gregory David,2,0,30,28
1650714103760,MATH 10A,A02,083736,Patchell; Gregory David,27,0,30,3
1650714103760,MATH 10A,A03,083737,Patchell; Gregory David,24,0,30,6
1650714109793,MATH 10B,A01,083207,Staff,0,9,30,30
1650714109793,MATH 10B,A02,083208,Staff,1,7,30,29
1650714109793,MATH 10B,B01,083739,Staff,11,0,30,19
1650714109793,MATH 10B,B02,083740,Staff,28,0,30,2
1650714115831,MATH 18,A01,083743,Staff,0,0,30,30
1650714115831,MATH 18,A02,083744,Staff,23,0,30,7
1650714115831,MATH 18,A03,083745,Staff,21,0,30,9
1650714115831,MATH 18,A04,083746,Staff,26,0,30,4
1650714115831,MATH 18,B01,083748,Staff,0,15,30,30
1650714115831,MATH 18,B02,083749,Staff,0,12,30,30
1650714115831,MATH 18,B03,083750,Staff,0,12,30,30
1650714115831,MATH 18,B04,083751,Staff,0,12,30,30
1650714121858,MATH 20A,A01,083754,Staff,19,0,40,21
1650714127887,MATH 20B,A01,083756,Staff,0,11,30,30
1650714127887,MATH 20B,A02,083757,Staff,0,12,30,30
1650714133914,MATH 20C,A01,083760,Staff,0,16,30,30
1650714133914,MATH 20C,A02,083761,Staff,0,16,30,30
1650714133914,MATH 20C,B01,083762,Staff,10,0,30,20
1650714133914,MATH 20C,B02,083763,Staff,28,0,30,2
1650714139941,MATH 20D,A01,083765,Staff,2,1,30,28
1650714139941,MATH 20D,A02,083766,Staff,6,0,30,24
1650714139941,MATH 20D,A03,083767,Staff,24,0,30,6
1650714145968,MATH 20E,A01,083771,Staff,3,0,30,27
1650714145968,MATH 20E,A02,083772,Staff,16,0,30,14
1650714145968,MATH 20E,B01,083773,Staff,0,0,30,30
1650714145968,MATH 20E,B02,083774,Staff,6,0,30,24
1650714152001,MATH 103A,A01,083777,Staff,0,15,30,30
1650714152001,MATH 103A,A02,083778,Staff,0,15,30,30
1650714152001,MATH 103A,B01,083779,Staff,0,15,30,30
1650714152001,MATH 103A,B02,083780,Staff,0,15,30,30
1650714158035,MATH 105,A01,085443,Staff,0,22,30,30
1650714164061,MATH 109,A01,083213,Anzaldo; Leesa B,0,7,30,30
1650714164061,MATH 109,A02,083214,Anzaldo; Leesa B,0,7,30,30
1650714164061,MATH 109,B01,083215,Anzaldo; Leesa B,0,8,30,30
1650714164061,MATH 109,B02,083216,Anzaldo; Leesa B,0,6,30,30
1650714170091,MATH 142A,A01,083219,Chow; Bennett,0,16,30,30
1650714170091,MATH 142A,A02,083220,Chow; Bennett,0,15,30,30
1650714170091,MATH 142A,B01,083221,Chow; Bennett,0,15,30,30
1650714170091,MATH 142A,B02,083222,Chow; Bennett,0,14,30,30
1650714176123,MATH 193A,A01,083224,Staff,0,5,30,30
1650714176123,MATH 193A,A02,083225,Staff,0,6,30,30
1650714176123,MATH 193A,A03,083781,Staff,0,6,30,30
1650714176123,MATH 193A,A04,083782,Staff,0,7,30,30
1650714182154,MATH 197,001,091859,McAuley; Julian John,9998,0,9999,1
1650714188232,COGS 9,A01,083615,Staff,1,15,60,59
1650714194268,COGS 11,A01,083617,Boyle; Mary E. T.,16,0,40,24
1650714200293,COGS 13,A01,083071,Staff,0,38,40,40
1650714206320,COGS 14A,A01,092681,Staff,0,35,100,100
1650714212346,COGS 14B,A01,083073,Cheng; Tzu-Han,1,13,50,49
1650714218371,COGS 17,A01,092677,Staff,13,0,75,62
1650714224403,COGS 100,A01,083619,Staff,0,28,60,60
1650714230437,COGS 101A,A01,083621,Davis; Joshua Daniel,0,27,60,60
1650714236467,COGS 101B,A01,091572,Staff,0,4,60,60
1650714242498,COGS 101C,A01,083625,Delgado; Tania,14,0,30,16
1650714248533,COGS 107A,A01,083627,Boyle; Mary E. T.,0,16,60,60
1650714254558,COGS 118A,A01,083075,Staff,0,8,60,60
1650714260588,CSE 3,A50,083646,Miranda; Gregory Joseph,18,0,38,20
1650714260588,CSE 3,A51,083647,Miranda; Gregory Joseph,36,0,37,1
1650714266612,CSE 8A,A50,083650,Miranda; Gregory Joseph,0,30,40,40
1650714272637,CSE 11,A01,083080,Cao; Yingjun,0,96,40,40
1650714278662,CSE 12,A01,083652,Staff,0,21,100,100
1650714284691,CSE 15L,A01,083654,Staff,0,3,50,50
1650714284691,CSE 15L,A02,083655,Staff,0,2,50,50
1650714290720,CSE 20,A01,083657,Staff,49,0,80,31
1650714296746,CSE 30,A01,083084,Eldon; John,0,77,40,40
1650714302772,CSE 100,A01,083659,Cao; Yingjun,0,70,50,50
1650714308796,CSE 134B,A01,083661,Powell; Thomas Allan,0,38,65,65
1650714314824,CSE 140,A01,083663,Staff,0,11,75,75
1650714320852,CSE 140L,A01,083088,Eldon; John,0,20,75,75
1650714326878,CSE 175,A01,083665,Kumar; Rakesh,7,0,25,18
1650714332905,CSE 190,A00,092507,Dubnov; Shlomo,10,0,20,10
1650714338932,ECE 45,A01,083139,Staff,1,2,60,59
1650714344966,ECE 65,A50,083695,Staff,0,5,30,30
1650714351001,ECE 109,A01,091882,Touri; Behrouz,33,0,70,37
1650714357988,ECE 180,A00,083140,Abi Samra; Nicholas Camill,20,0,30,10
1650714357988,ECE 180,B00,083141,Abi Samra; Nicholas Camill,0,0,30,30
1650714369884,MATH 10A,A01,083735,Patchell; Gregory David,2,0,30,28
1650714369884,MATH 10A,A02,083736,Patchell; Gregory David,27,0,30,3
1650714369884,MATH 10A,A03,083737,Patchell; Gregory David,24,0,30,6
1650714375912,MATH 10B,A01,083207,Staff,0,9,30,30
1650714375912,MATH 10B,A02,083208,Staff,1,7,30,29
1650714375912,MATH 10B,B01,083739,Staff,11,0,30,19
1650714375912,MATH 10B,B02,083740,Staff,28,0,30,2
1650714384762,MATH 18,A01,083743,Staff,0,0,30,30
1650714384762,MATH 18,A02,083744,Staff,23,0,30,7
1650714384762,MATH 18,A03,083745,Staff,21,0,30,9
1650714384762,MATH 18,A04,083746,Staff,26,0,30,4
1650714384762,MATH 18,B01,083748,Staff,0,15,30,30
1650714384762,MATH 18,B02,083749,Staff,0,12,30,30
1650714384762,MATH 18,B03,083750,Staff,0,12,30,30
1650714384762,MATH 18,B04,083751,Staff,0,12,30,30
1650714390790,MATH 20A,A01,083754,Staff,19,0,40,21
1650714396827,MATH 20B,A01,083756,Staff,0,11,30,30
1650714396827,MATH 20B,A02,083757,Staff,0,12,30,30
1650714402855,MATH 20C,A01,083760,Staff,0,16,30,30
1650714402855,MATH 20C,A02,083761,Staff,0,16,30,30
1650714402855,MATH 20C,B01,083762,Staff,10,0,30,20
1650714402855,MATH 20C,B02,083763,Staff,28,0,30,2
1650714408956,MATH 20D,A01,083765,Staff,2,1,30,28
1650714408956,MATH 20D,A02,083766,Staff,6,0,30,24
1650714408956,MATH 20D,A03,083767,Staff,24,0,30,6
1650714414985,MATH 20E,A01,083771,Staff,3,0,30,27
1650714414985,MATH 20E,A02,083772,Staff,16,0,30,14
1650714414985,MATH 20E,B01,083773,Staff,0,0,30,30
1650714414985,MATH 20E,B02,083774,Staff,6,0,30,24
1650714421015,MATH 103A,A01,083777,Staff,0,15,30,30
1650714421015,MATH 103A,A02,083778,Staff,0,15,30,30
1650714421015,MATH 103A,B01,083779,Staff,0,15,30,30
1650714421015,MATH 103A,B02,083780,Staff,0,15,30,30
1650714427054,MATH 105,A01,085443,Staff,0,22,30,30
1650714433088,MATH 109,A01,083213,Anzaldo; Leesa B,0,7,30,30
1650714433088,MATH 109,A02,083214,Anzaldo; Leesa B,0,7,30,30
1650714433088,MATH 109,B01,083215,Anzaldo; Leesa B,0,8,30,30
1650714433088,MATH 109,B02,083216,Anzaldo; Leesa B,0,6,30,30
1650714439116,MATH 142A,A01,083219,Chow; Bennett,0,16,30,30
1650714439116,MATH 142A,A02,083220,Chow; Bennett,0,15,30,30
1650714439116,MATH 142A,B01,083221,Chow; Bennett,0,15,30,30
1650714439116,MATH 142A,B02,083222,Chow; Bennett,0,14,30,30
1650714445141,MATH 193A,A01,083224,Staff,0,5,30,30
1650714445141,MATH 193A,A02,083225,Staff,0,6,30,30
1650714445141,MATH 193A,A03,083781,Staff,0,6,30,30
1650714445141,MATH 193A,A04,083782,Staff,0,7,30,30
1650714451167,MATH 197,001,091859,McAuley; Julian John,9998,0,9999,1
1650714457242,COGS 9,A01,083615,Staff,1,15,60,59
1650714463271,COGS 11,A01,083617,Boyle; Mary E. T.,16,0,40,24
1650714469295,COGS 13,A01,083071,Staff,0,38,40,40
1650714475319,COGS 14A,A01,092681,Staff,0,35,100,100
1650714481344,COGS 14B,A01,083073,Cheng; Tzu-Han,1,13,50,49
1650714487374,COGS 17,A01,092677,Staff,13,0,75,62
1650714493398,COGS 100,A01,083619,Staff,0,28,60,60
1650714499432,COGS 101A,A01,083621,Davis; Joshua Daniel,0,27,60,60
1650714505468,COGS 101B,A01,091572,Staff,0,4,60,60
1650714511499,COGS 101C,A01,083625,Delgado; Tania,14,0,30,16
1650714517524,COGS 107A,A01,083627,Boyle; Mary E. T.,0,16,60,60
1650714523549,COGS 118A,A01,083075,Staff,0,8,60,60
1650714529579,CSE 3,A50,083646,Miranda; Gregory Joseph,18,0,38,20
1650714529579,CSE 3,A51,083647,Miranda; Gregory Joseph,36,0,37,1
1650714535604,CSE 8A,A50,083650,Miranda; Gregory Joseph,0,30,40,40
1650714541631,CSE 11,A01,083080,Cao; Yingjun,0,96,40,40
1650714547657,CSE 12,A01,083652,Staff,0,21,100,100
1650714553685,CSE 15L,A01,083654,Staff,0,3,50,50
1650714553685,CSE 15L,A02,083655,Staff,0,2,50,50
1650714559717,CSE 20,A01,083657,Staff,49,0,80,31
1650714565742,CSE 30,A01,083084,Eldon; John,0,77,40,40
1650714571768,CSE 100,A01,083659,Cao; Yingjun,0,70,50,50
1650714577795,CSE 134B,A01,083661,Powell; Thomas Allan,0,38,65,65
1650714583822,CSE 140,A01,083663,Staff,0,11,75,75
1650714589851,CSE 140L,A01,083088,Eldon; John,0,20,75,75
1650714595883,CSE 175,A01,083665,Kumar; Rakesh,7,0,25,18
1650714601910,CSE 190,A00,092507,Dubnov; Shlomo,10,0,20,10
1650714607936,ECE 45,A01,083139,Staff,1,2,60,59
1650714613962,ECE 65,A50,083695,Staff,0,5,30,30
1650714619994,ECE 109,A01,091882,Touri; Behrouz,33,0,70,37
1650714626026,ECE 180,A00,083140,Abi Samra; Nicholas Camill,20,0,30,10
1650714626026,ECE 180,B00,083141,Abi Samra; Nicholas Camill,0,0,30,30
1650714632056,MATH 10A,A01,083735,Patchell; Gregory David,2,0,30,28
1650714632056,MATH 10A,A02,083736,Patchell; Gregory David,27,0,30,3
1650714632056,MATH 10A,A03,083737,Patchell; Gregory David,24,0,30,6
1650714638088,MATH 10B,A01,083207,Staff,0,9,30,30
1650714638088,MATH 10B,A02,083208,Staff,1,7,30,29
1650714638088,MATH 10B,B01,083739,Staff,11,0,30,19
1650714638088,MATH 10B,B02,083740,Staff,28,0,30,2
1650714644128,MATH 18,A01,083743,Staff,0,0,30,30
1650714644128,MATH 18,A02,083744,Staff,23,0,30,7
1650714644128,MATH 18,A03,083745,Staff,21,0,30,9
1650714644128,MATH 18,A04,083746,Staff,26,0,30,4
1650714644128,MATH 18,B01,083748,Staff,0,15,30,30
1650714644128,MATH 18,B02,083749,Staff,0,12,30,30
1650714644128,MATH 18,B03,083750,Staff,0,12,30,30
1650714644128,MATH 18,B04,083751,Staff,0,12,30,30
1650714650158,MATH 20A,A01,083754,Staff,19,0,40,21
1650714656185,MATH 20B,A01,083756,Staff,0,11,30,30
1650714656185,MATH 20B,A02,083757,Staff,0,12,30,30
1650714662212,MATH 20C,A01,083760,Staff,0,16,30,30
1650714662212,MATH 20C,A02,083761,Staff,0,16,30,30
1650714662212,MATH 20C,B01,083762,Staff,10,0,30,20
1650714662212,MATH 20C,B02,083763,Staff,28,0,30,2
1650714668242,MATH 20D,A01,083765,Staff,2,1,30,28
1650714668242,MATH 20D,A02,083766,Staff,6,0,30,24
1650714668242,MATH 20D,A03,083767,Staff,24,0,30,6
1650714674274,MATH 20E,A01,083771,Staff,3,0,30,27
1650714674274,MATH 20E,A02,083772,Staff,16,0,30,14
1650714674274,MATH 20E,B01,083773,Staff,0,0,30,30
1650714674274,MATH 20E,B02,083774,Staff,6,0,30,24
1650714680304,MATH 103A,A01,083777,Staff,0,15,30,30
1650714680304,MATH 103A,A02,083778,Staff,0,15,30,30
1650714680304,MATH 103A,B01,083779,Staff,0,15,30,30
1650714680304,MATH 103A,B02,083780,Staff,0,15,30,30
1650714686331,MATH 105,A01,085443,Staff,0,22,30,30
1650714692362,MATH 109,A01,083213,Anzaldo; Leesa B,0,7,30,30
1650714692362,MATH 109,A02,083214,Anzaldo; Leesa B,0,7,30,30
1650714692362,MATH 109,B01,083215,Anzaldo; Leesa B,0,8,30,30
1650714692362,MATH 109,B02,083216,Anzaldo; Leesa B,0,6,30,30
1650714698391,MATH 142A,A01,083219,Chow; Bennett,0,16,30,30
1650714698391,MATH 142A,A02,083220,Chow; Bennett,0,15,30,30
1650714698391,MATH 142A,B01,083221,Chow; Bennett,0,15,30,30
1650714698391,MATH 142A,B02,083222,Chow; Bennett,0,14,30,30
1650714704418,MATH 193A,A01,083224,Staff,0,5,30,30
1650714704418,MATH 193A,A02,083225,Staff,0,6,30,30
1650714704418,MATH 193A,A03,083781,Staff,0,6,30,30
1650714704418,MATH 193A,A04,083782,Staff,0,7,30,30
1650714710450,MATH 197,001,091859,McAuley; Julian John,9998,0,9999,1
1650714716526,COGS 9,A01,083615,Staff,1,15,60,59
1650714722554,COGS 11,A01,083617,Boyle; Mary E. T.,16,0,40,24
1650714728587,COGS 13,A01,083071,Staff,0,38,40,40
1650714734616,COGS 14A,A01,092681,Staff,0,35,100,100
1650714740647,COGS 14B,A01,083073,Cheng; Tzu-Han,1,13,50,49
1650714746673,COGS 17,A01,092677,Staff,13,0,75,62
1650714752705,COGS 100,A01,083619,Staff,0,28,60,60
1650714758734,COGS 101A,A01,083621,Davis; Joshua Daniel,0,27,60,60
1650714764764,COGS 101B,A01,091572,Staff,0,4,60,60
1650714770797,COGS 101C,A01,083625,Delgado; Tania,14,0,30,16
1650714776828,COGS 107A,A01,083627,Boyle; Mary E. T.,0,16,60,60
1650714782869,COGS 118A,A01,083075,Staff,0,8,60,60
1650714788903,CSE 3,A50,083646,Miranda; Gregory Joseph,18,0,38,20
1650714788903,CSE 3,A51,083647,Miranda; Gregory Joseph,36,0,37,1
1650714794930,CSE 8A,A50,083650,Miranda; Gregory Joseph,0,30,40,40
1650714800955,CSE 11,A01,083080,Cao; Yingjun,0,96,40,40
1650714806982,CSE 12,A01,083652,Staff,0,21,100,100
1650714813010,CSE 15L,A01,083654,Staff,0,3,50,50
1650714813010,CSE 15L,A02,083655,Staff,0,2,50,50
1650714819041,CSE 20,A01,083657,Staff,49,0,80,31
1650714825067,CSE 30,A01,083084,Eldon; John,0,77,40,40
1650714831096,CSE 100,A01,083659,Cao; Yingjun,0,70,50,50
1650714837124,CSE 134B,A01,083661,Powell; Thomas Allan,0,38,65,65
1650714843152,CSE 140,A01,083663,Staff,0,11,75,75
1650714849180,CSE 140L,A01,083088,Eldon; John,0,20,75,75
1650714855208,CSE 175,A01,083665,Kumar; Rakesh,7,0,25,18
1650714861240,CSE 190,A00,092507,Dubnov; Shlomo,10,0,20,10
1650714867266,ECE 45,A01,083139,Staff,1,2,60,59
1650714873293,ECE 65,A50,083695,Staff,0,5,30,30
1650714879325,ECE 109,A01,091882,Touri; Behrouz,33,0,70,37
1650714885354,ECE 180,A00,083140,Abi Samra; Nicholas Camill,20,0,30,10
1650714885354,ECE 180,B00,083141,Abi Samra; Nicholas Camill,0,0,30,30
1650714891387,MATH 10A,A01,083735,Patchell; Gregory David,2,0,30,28
1650714891387,MATH 10A,A02,083736,Patchell; Gregory David,27,0,30,3
1650714891387,MATH 10A,A03,083737,Patchell; Gregory David,24,0,30,6
1650714897415,MATH 10B,A01,083207,Staff,0,9,30,30
1650714897415,MATH 10B,A02,083208,Staff,1,7,30,29
1650714897415,MATH 10B,B01,083739,Staff,11,0,30,19
1650714897415,MATH 10B,B02,083740,Staff,28,0,30,2
1650714903447,MATH 18,A01,083743,Staff,0,0,30,30
1650714903447,MATH 18,A02,083744,Staff,23,0,30,7
1650714903447,MATH 18,A03,083745,Staff,21,0,30,9
1650714903447,MATH 18,A04,083746,Staff,26,0,30,4
1650714903447,MATH 18,B01,083748,Staff,0,15,30,30
1650714903447,MATH 18,B02,083749,Staff,0,12,30,30
1650714903447,MATH 18,B03,083750,Staff,0,12,30,30
1650714903447,MATH 18,B04,083751,Staff,0,12,30,30
1650714909475,MATH 20A,A01,083754,Staff,19,0,40,21
1650714915501,MATH 20B,A01,083756,Staff,0,11,30,30
1650714915501,MATH 20B,A02,083757,Staff,0,12,30,30
1650714921529,MATH 20C,A01,083760,Staff,0,16,30,30
1650714921529,MATH 20C,A02,083761,Staff,0,16,30,30
1650714921529,MATH 20C,B01,083762,Staff,10,0,30,20
1650714921529,MATH 20C,B02,083763,Staff,28,0,30,2
1650714927559,MATH 20D,A01,083765,Staff,2,1,30,28
1650714927559,MATH 20D,A02,083766,Staff,6,0,30,24
1650714927559,MATH 20D,A03,083767,Staff,24,0,30,6
1650714933587,MATH 20E,A01,083771,Staff,3,0,30,27
1650714933587,MATH 20E,A02,083772,Staff,16,0,30,14
1650714933587,MATH 20E,B01,083773,Staff,0,0,30,30
1650714933587,MATH 20E,B02,083774,Staff,6,0,30,24
1650714939617,MATH 103A,A01,083777,Staff,0,15,30,30
1650714939617,MATH 103A,A02,083778,Staff,0,15,30,30
1650714939617,MATH 103A,B01,083779,Staff,0,15,30,30
1650714939617,MATH 103A,B02,083780,Staff,0,15,30,30
1650714945642,MATH 105,A01,085443,Staff,0,22,30,30
1650714951669,MATH 109,A01,083213,Anzaldo; Leesa B,0,7,30,30
1650714951669,MATH 109,A02,083214,Anzaldo; Leesa B,0,7,30,30
1650714951669,MATH 109,B01,083215,Anzaldo; Leesa B,0,8,30,30
1650714951669,MATH 109,B02,083216,Anzaldo; Leesa B,0,6,30,30
1650714957703,MATH 142A,A01,083219,Chow; Bennett,0,16,30,30
1650714957703,MATH 142A,A02,083220,Chow; Bennett,0,15,30,30
1650714957703,MATH 142A,B01,083221,Chow; Bennett,0,15,30,30
1650714957703,MATH 142A,B02,083222,Chow; Bennett,0,14,30,30
1650714963732,MATH 193A,A01,083224,Staff,0,5,30,30
1650714963732,MATH 193A,A02,083225,Staff,0,6,30,30
1650714963732,MATH 193A,A03,083781,Staff,0,6,30,30
1650714963732,MATH 193A,A04,083782,Staff,0,7,30,30
1650714969758,MATH 197,001,091859,McAuley; Julian John,9998,0,9999,1
1650714975824,COGS 9,A01,083615,Staff,1,15,60,59
1650714981851,COGS 11,A01,083617,Boyle; Mary E. T.,16,0,40,24
1650714987882,COGS 13,A01,083071,Staff,0,38,40,40
1650714993908,COGS 14A,A01,092681,Staff,0,35,100,100
1650715000028,COGS 14B,A01,083073,Cheng; Tzu-Han,1,13,50,49
1650715006060,COGS 17,A01,092677,Staff,13,0,75,62
1650715012090,COGS 100,A01,083619,Staff,0,28,60,60
1650715018119,COGS 101A,A01,083621,Davis; Joshua Daniel,0,27,60,60
1650715024145,COGS 101B,A01,091572,Staff,0,4,60,60
1650715030185,COGS 101C,A01,083625,Delgado; Tania,14,0,30,16
1650715036215,COGS 107A,A01,083627,Boyle; Mary E. T.,0,16,60,60
1650715042241,COGS 118A,A01,083075,Staff,0,8,60,60
1650715048269,CSE 3,A50,083646,Miranda; Gregory Joseph,18,0,38,20
1650715048269,CSE 3,A51,083647,Miranda; Gregory Joseph,36,0,37,1
1650715054298,CSE 8A,A50,083650,Miranda; Gregory Joseph,0,30,40,40
1650715060326,CSE 11,A01,083080,Cao; Yingjun,0,96,40,40
1650715066352,CSE 12,A01,083652,Staff,0,21,100,100
1650715072384,CSE 15L,A01,083654,Staff,0,3,50,50
1650715072384,CSE 15L,A02,083655,Staff,0,2,50,50
1650715078411,CSE 20,A01,083657,Staff,49,0,80,31
1650715084441,CSE 30,A01,083084,Eldon; John,0,77,40,40
1650715090475,CSE 100,A01,083659,Cao; Yingjun,0,70,50,50
1650715096510,CSE 134B,A01,083661,Powell; Thomas Allan,0,38,65,65
1650715102534,CSE 140,A01,083663,Staff,0,11,75,75
1650715108561,CSE 140L,A01,083088,Eldon; John,0,20,75,75
1650715114594,CSE 175,A01,083665,Kumar; Rakesh,7,0,25,18
1650715120621,CSE 190,A00,092507,Dubnov; Shlomo,10,0,20,10
1650715126649,ECE 45,A01,083139,Staff,1,2,60,59
1650715132684,ECE 65,A50,083695,Staff,0,5,30,30
1650715138711,ECE 109,A01,091882,Touri; Behrouz,33,0,70,37
1650715144737,ECE 180,A00,083140,Abi Samra; Nicholas Camill,20,0,30,10
1650715144737,ECE 180,B00,083141,Abi Samra; Nicholas Camill,0,0,30,30
1650715150766,MATH 10A,A01,083735,Patchell; Gregory David,2,0,30,28
1650715150766,MATH 10A,A02,083736,Patchell; Gregory David,27,0,30,3
1650715150766,MATH 10A,A03,083737,Patchell; Gregory David,24,0,30,6
1650715156794,MATH 10B,A01,083207,Staff,0,9,30,30
1650715156794,MATH 10B,A02,083208,Staff,1,7,30,29
1650715156794,MATH 10B,B01,083739,Staff,11,0,30,19
1650715156794,MATH 10B,B02,083740,Staff,28,0,30,2
1650715162834,MATH 18,A01,083743,Staff,0,0,30,30
1650715162834,MATH 18,A02,083744,Staff,23,0,30,7
1650715162834,MATH 18,A03,083745,Staff,21,0,30,9
1650715162834,MATH 18,A04,083746,Staff,26,0,30,4
1650715162834,MATH 18,B01,083748,Staff,0,15,30,30
1650715162834,MATH 18,B02,083749,Staff,0,12,30,30
1650715162834,MATH 18,B03,083750,Staff,0,12,30,30
1650715162834,MATH 18,B04,083751,Staff,0,12,30,30
1650715168862,MATH 20A,A01,083754,Staff,19,0,40,21
1650715174900,MATH 20B,A01,083756,Staff,0,11,30,30
1650715174900,MATH 20B,A02,083757,Staff,0,12,30,30
1650715180927,MATH 20C,A01,083760,Staff,0,16,30,30
1650715180927,MATH 20C,A02,083761,Staff,0,16,30,30
1650715180927,MATH 20C,B01,083762,Staff,10,0,30,20
1650715180927,MATH 20C,B02,083763,Staff,28,0,30,2
1650715186953,MATH 20D,A01,083765,Staff,2,1,30,28
1650715186953,MATH 20D,A02,083766,Staff,6,0,30,24
1650715186953,MATH 20D,A03,083767,Staff,24,0,30,6
1650715192981,MATH 20E,A01,083771,Staff,3,0,30,27
1650715192981,MATH 20E,A02,083772,Staff,16,0,30,14
1650715192981,MATH 20E,B01,083773,Staff,0,0,30,30
1650715192981,MATH 20E,B02,083774,Staff,6,0,30,24
1650715199010,MATH 103A,A01,083777,Staff,0,15,30,30
1650715199010,MATH 103A,A02,083778,Staff,0,15,30,30
1650715199010,MATH 103A,B01,083779,Staff,0,15,30,30
1650715199010,MATH 103A,B02,083780,Staff,0,15,30,30
1650715205038,MATH 105,A01,085443,Staff,0,22,30,30
1650715211074,MATH 109,A01,083213,Anzaldo; Leesa B,0,7,30,30
1650715211074,MATH 109,A02,083214,Anzaldo; Leesa B,0,7,30,30
1650715211074,MATH 109,B01,083215,Anzaldo; Leesa B,0,8,30,30
1650715211074,MATH 109,B02,083216,Anzaldo; Leesa B,0,6,30,30
1650715217100,MATH 142A,A01,083219,Chow; Bennett,0,16,30,30
1650715217100,MATH 142A,A02,083220,Chow; Bennett,0,15,30,30
1650715217100,MATH 142A,B01,083221,Chow; Bennett,0,15,30,30
1650715217100,MATH 142A,B02,083222,Chow; Bennett,0,14,30,30
1650715223126,MATH 193A,A01,083224,Staff,0,5,30,30
1650715223126,MATH 193A,A02,083225,Staff,0,6,30,30
1650715223126,MATH 193A,A03,083781,Staff,0,6,30,30
1650715223126,MATH 193A,A04,083782,Staff,0,7,30,30
1650715229151,MATH 197,001,091859,McAuley; Julian John,9998,0,9999,1
1650715235222,COGS 9,A01,083615,Staff,1,15,60,59
1650715241253,COGS 11,A01,083617,Boyle; Mary E. T.,16,0,40,24
1650715247284,COGS 13,A01,083071,Staff,0,38,40,40
1650715253315,COGS 14A,A01,092681,Staff,0,35,100,100
1650715259342,COGS 14B,A01,083073,Cheng; Tzu-Han,1,13,50,49
1650715265369,COGS 17,A01,092677,Staff,13,0,75,62
1650715271397,COGS 100,A01,083619,Staff,0,28,60,60
1650715277425,COGS 101A,A01,083621,Davis; Joshua Daniel,0,27,60,60
1650715283452,COGS 101B,A01,091572,Staff,0,4,60,60
1650715289480,COGS 101C,A01,083625,Delgado; Tania,14,0,30,16
1650715295508,COGS 107A,A01,083627,Boyle; Mary E. T.,0,16,60,60
1650715301542,COGS 118A,A01,083075,Staff,0,8,60,60
1650715307572,CSE 3,A50,083646,Miranda; Gregory Joseph,18,0,38,20
1650715307572,CSE 3,A51,083647,Miranda; Gregory Joseph,36,0,37,1
1650715313638,CSE 8A,A50,083650,Miranda; Gregory Joseph,0,30,40,40
1650715319667,CSE 11,A01,083080,Cao; Yingjun,0,96,40,40
1650715325699,CSE 12,A01,083652,Staff,0,21,100,100
1650715331729,CSE 15L,A01,083654,Staff,0,3,50,50
1650715331729,CSE 15L,A02,083655,Staff,0,2,50,50
1650715337764,CSE 20,A01,083657,Staff,49,0,80,31
1650715343820,CSE 30,A01,083084,Eldon; John,0,77,40,40
1650715349858,CSE 100,A01,083659,Cao; Yingjun,0,70,50,50
1650715355896,CSE 134B,A01,083661,Powell; Thomas Allan,0,38,65,65
1650715361923,CSE 140,A01,083663,Staff,0,11,75,75
1650715367965,CSE 140L,A01,083088,Eldon; John,0,20,75,75
1650715373995,CSE 175,A01,083665,Kumar; Rakesh,7,0,25,18
1650715380032,CSE 190,A00,092507,Dubnov; Shlomo,10,0,20,10
1650715386066,ECE 45,A01,083139,Staff,1,2,60,59
1650715392094,ECE 65,A50,083695,Staff,0,5,30,30
1650715398121,ECE 109,A01,091882,Touri; Behrouz,33,0,70,37
1650715404163,ECE 180,A00,083140,Abi Samra; Nicholas Camill,20,0,30,10
1650715404163,ECE 180,B00,083141,Abi Samra; Nicholas Camill,0,0,30,30
1650715410207,MATH 10A,A01,083735,Patchell; Gregory David,2,0,30,28
1650715410207,MATH 10A,A02,083736,Patchell; Gregory David,27,0,30,3
1650715410207,MATH 10A,A03,083737,Patchell; Gregory David,24,0,30,6
1650715416238,MATH 10B,A01,083207,Staff,0,9,30,30
1650715416238,MATH 10B,A02,083208,Staff,1,7,30,29
1650715416238,MATH 10B,B01,083739,Staff,11,0,30,19
1650715416238,MATH 10B,B02,083740,Staff,28,0,30,2
1650715422267,MATH 18,A01,083743,Staff,0,0,30,30
1650715422267,MATH 18,A02,083744,Staff,23,0,30,7
1650715422267,MATH 18,A03,083745,Staff,21,0,30,9
1650715422267,MATH 18,A04,083746,Staff,26,0,30,4
1650715422267,MATH 18,B01,083748,Staff,0,15,30,30
1650715422267,MATH 18,B02,083749,Staff,0,12,30,30
1650715422267,MATH 18,B03,083750,Staff,0,12,30,30
1650715422267,MATH 18,B04,083751,Staff,0,12,30,30
1650715428294,MATH 20A,A01,083754,Staff,19,0,40,21
1650715434324,MATH 20B,A01,083756,Staff,0,11,30,30
1650715434324,MATH 20B,A02,083757,Staff,0,12,30,30
1650715440357,MATH 20C,A01,083760,Staff,0,16,30,30
1650715440357,MATH 20C,A02,083761,Staff,0,16,30,30
1650715440357,MATH 20C,B01,083762,Staff,10,0,30,20
1650715440357,MATH 20C,B02,083763,Staff,28,0,30,2
1650715446383,MATH 20D,A01,083765,Staff,2,1,30,28
1650715446383,MATH 20D,A02,083766,Staff,6,0,30,24
1650715446383,MATH 20D,A03,083767,Staff,24,0,30,6
1650715452411,MATH 20E,A01,083771,Staff,3,0,30,27
1650715452411,MATH 20E,A02,083772,Staff,16,0,30,14
1650715452411,MATH 20E,B01,083773,Staff,0,0,30,30
1650715452411,MATH 20E,B02,083774,Staff,6,0,30,24
1650715458438,MATH 103A,A01,083777,Staff,0,15,30,30
1650715458438,MATH 103A,A02,083778,Staff,0,15,30,30
1650715458438,MATH 103A,B01,083779,Staff,0,15,30,30
1650715458438,MATH 103A,B02,083780,Staff,0,15,30,30
1650715464470,MATH 105,A01,085443,Staff,0,22,30,30
1650715470498,MATH 109,A01,083213,Anzaldo; Leesa B,0,7,30,30
1650715470498,MATH 109,A02,083214,Anzaldo; Leesa B,0,7,30,30
1650715470498,MATH 109,B01,083215,Anzaldo; Leesa B,0,8,30,30
1650715470498,MATH 109,B02,083216,Anzaldo; Leesa B,0,6,30,30
1650715476527,MATH 142A,A01,083219,Chow; Bennett,0,16,30,30
1650715476527,MATH 142A,A02,083220,Chow; Bennett,0,15,30,30
1650715476527,MATH 142A,B01,083221,Chow; Bennett,0,15,30,30
1650715476527,MATH 142A,B02,083222,Chow; Bennett,0,14,30,30
1650715482555,MATH 193A,A01,083224,Staff,0,5,30,30
1650715482555,MATH 193A,A02,083225,Staff,0,6,30,30
1650715482555,MATH 193A,A03,083781,Staff,0,6,30,30
1650715482555,MATH 193A,A04,083782,Staff,0,7,30,30
1650715488579,MATH 197,001,091859,McAuley; Julian John,9998,0,9999,1
1650715494657,COGS 9,A01,083615,Staff,1,15,60,59
1650715500689,COGS 11,A01,083617,Boyle; Mary E. T.,16,0,40,24
1650715506717,COGS 13,A01,083071,Staff,0,38,40,40
1650715512748,COGS 14A,A01,092681,Staff,0,35,100,100
1650715518775,COGS 14B,A01,083073,Cheng; Tzu-Han,1,13,50,49
1650715524812,COGS 17,A01,092677,Staff,13,0,75,62
1650715530845,COGS 100,A01,083619,Staff,0,28,60,60
1650715536879,COGS 101A,A01,083621,Davis; Joshua Daniel,0,27,60,60
1650715542910,COGS 101B,A01,091572,Staff,0,4,60,60
1650715548945,COGS 101C,A01,083625,Delgado; Tania,14,0,30,16
1650715554972,COGS 107A,A01,083627,Boyle; Mary E. T.,0,16,60,60
1650715561002,COGS 118A,A01,083075,Staff,0,8,60,60
1650715567031,CSE 3,A50,083646,Miranda; Gregory Joseph,18,0,38,20
1650715567031,CSE 3,A51,083647,Miranda; Gregory Joseph,36,0,37,1
1650715573060,CSE 8A,A50,083650,Miranda; Gregory Joseph,0,30,40,40
1650715579088,CSE 11,A01,083080,Cao; Yingjun,0,96,40,40
1650715585120,CSE 12,A01,083652,Staff,0,21,100,100
1650715591151,CSE 15L,A01,083654,Staff,0,3,50,50
1650715591151,CSE 15L,A02,083655,Staff,0,2,50,50
1650715597270,CSE 20,A01,083657,Staff,49,0,80,31
1650715603295,CSE 30,A01,083084,Eldon; John,0,77,40,40
1650715609323,CSE 100,A01,083659,Cao; Yingjun,0,70,50,50
1650715615370,CSE 134B,A01,083661,Powell; Thomas Allan,0,38,65,65
1650715621399,CSE 140,A01,083663,Staff,0,11,75,75
1650715627435,CSE 140L,A01,083088,Eldon; John,0,20,75,75
1650715633460,CSE 175,A01,083665,Kumar; Rakesh,7,0,25,18
1650715639494,CSE 190,A00,092507,Dubnov; Shlomo,10,0,20,10
1650715645521,ECE 45,A01,083139,Staff,1,2,60,59
1650715651546,ECE 65,A50,083695,Staff,0,5,30,30
1650715657580,ECE 109,A01,091882,Touri; Behrouz,33,0,70,37
1650715663607,ECE 180,A00,083140,Abi Samra; Nicholas Camill,20,0,30,10
1650715663607,ECE 180,B00,083141,Abi Samra; Nicholas Camill,0,0,30,30
1650715669642,MATH 10A,A01,083735,Patchell; Gregory David,2,0,30,28
1650715669642,MATH 10A,A02,083736,Patchell; Gregory David,27,0,30,3
1650715669642,MATH 10A,A03,083737,Patchell; Gregory David,24,0,30,6
1650715675675,MATH 10B,A01,083207,Staff,0,9,30,30
1650715675675,MATH 10B,A02,083208,Staff,1,7,30,29
1650715675675,MATH 10B,B01,083739,Staff,11,0,30,19
1650715675675,MATH 10B,B02,083740,Staff,28,0,30,2
1650715681715,MATH 18,A01,083743,Staff,0,0,30,30
1650715681715,MATH 18,A02,083744,Staff,23,0,30,7
1650715681715,MATH 18,A03,083745,Staff,21,0,30,9
1650715681715,MATH 18,A04,083746,Staff,26,0,30,4
1650715681715,MATH 18,B01,083748,Staff,0,15,30,30
1650715681715,MATH 18,B02,083749,Staff,0,12,30,30
1650715681715,MATH 18,B03,083750,Staff,0,12,30,30
1650715681715,MATH 18,B04,083751,Staff,0,12,30,30
1650715687742,MATH 20A,A01,083754,Staff,19,0,40,21
1650715693770,MATH 20B,A01,083756,Staff,0,11,30,30
1650715693770,MATH 20B,A02,083757,Staff,0,12,30,30
1650715699796,MATH 20C,A01,083760,Staff,0,16,30,30
1650715699796,MATH 20C,A02,083761,Staff,0,16,30,30
1650715699796,MATH 20C,B01,083762,Staff,10,0,30,20
1650715699796,MATH 20C,B02,083763,Staff,28,0,30,2
1650715705826,MATH 20D,A01,083765,Staff,2,1,30,28
1650715705826,MATH 20D,A02,083766,Staff,6,0,30,24
1650715705826,MATH 20D,A03,083767,Staff,24,0,30,6
1650715711869,MATH 20E,A01,083771,Staff,3,0,30,27
1650715711869,MATH 20E,A02,083772,Staff,16,0,30,14
1650715711869,MATH 20E,B01,083773,Staff,0,0,30,30
1650715711869,MATH 20E,B02,083774,Staff,6,0,30,24
1650715717899,MATH 103A,A01,083777,Staff,0,15,30,30
1650715717899,MATH 103A,A02,083778,Staff,0,15,30,30
1650715717899,MATH 103A,B01,083779,Staff,0,15,30,30
1650715717899,MATH 103A,B02,083780,Staff,0,15,30,30
1650715723931,MATH 105,A01,085443,Staff,0,22,30,30
1650715729960,MATH 109,A01,083213,Anzaldo; Leesa B,0,7,30,30
1650715729960,MATH 109,A02,083214,Anzaldo; Leesa B,0,7,30,30
1650715729960,MATH 109,B01,083215,Anzaldo; Leesa B,0,8,30,30
1650715729960,MATH 109,B02,083216,Anzaldo; Leesa B,0,6,30,30
1650715735989,MATH 142A,A01,083219,Chow; Bennett,0,16,30,30
1650715735989,MATH 142A,A02,083220,Chow; Bennett,0,15,30,30
1650715735989,MATH 142A,B01,083221,Chow; Bennett,0,15,30,30
1650715735989,MATH 142A,B02,083222,Chow; Bennett,0,14,30,30
1650715742018,MATH 193A,A01,083224,Staff,0,5,30,30
1650715742018,MATH 193A,A02,083225,Staff,0,6,30,30
1650715742018,MATH 193A,A03,083781,Staff,0,6,30,30
1650715742018,MATH 193A,A04,083782,Staff,0,7,30,30
1650715748045,MATH 197,001,091859,McAuley; Julian John,9998,0,9999,1
1650715754149,COGS 9,A01,083615,Staff,1,15,60,59
1650715760176,COGS 11,A01,083617,Boyle; Mary E. T.,16,0,40,24
1650715766205,COGS 13,A01,083071,Staff,0,38,40,40
1650715772241,COGS 14A,A01,092681,Staff,0,35,100,100
1650715778272,COGS 14B,A01,083073,Cheng; Tzu-Han,1,13,50,49
1650715784303,COGS 17,A01,092677,Staff,13,0,75,62
1650715790329,COGS 100,A01,083619,Staff,0,28,60,60
1650715796357,COGS 101A,A01,083621,Davis; Joshua Daniel,0,27,60,60
1650715802385,COGS 101B,A01,091572,Staff,0,4,60,60
1650715808418,COGS 101C,A01,083625,Delgado; Tania,14,0,30,16
1650715814445,COGS 107A,A01,083627,Boyle; Mary E. T.,0,16,60,60
1650715820483,COGS 118A,A01,083075,Staff,0,8,60,60
1650715826511,CSE 3,A50,083646,Miranda; Gregory Joseph,18,0,38,20
1650715826511,CSE 3,A51,083647,Miranda; Gregory Joseph,36,0,37,1
1650715832538,CSE 8A,A50,083650,Miranda; Gregory Joseph,0,30,40,40
1650715838567,CSE 11,A01,083080,Cao; Yingjun,0,96,40,40
1650715844594,CSE 12,A01,083652,Staff,0,21,100,100
1650715850621,CSE 15L,A01,083654,Staff,0,3,50,50
1650715850621,CSE 15L,A02,083655,Staff,0,2,50,50
1650715856647,CSE 20,A01,083657,Staff,49,0,80,31
1650715862675,CSE 30,A01,083084,Eldon; John,0,77,40,40
1650715868705,CSE 100,A01,083659,Cao; Yingjun,0,70,50,50
1650715874733,CSE 134B,A01,083661,Powell; Thomas Allan,0,38,65,65
1650715880769,CSE 140,A01,083663,Staff,0,11,75,75
1650715886801,CSE 140L,A01,083088,Eldon; John,0,20,75,75
1650715892833,CSE 175,A01,083665,Kumar; Rakesh,7,0,25,18
1650715898860,CSE 190,A00,092507,Dubnov; Shlomo,10,0,20,10
1650715904889,ECE 45,A01,083139,Staff,1,2,60,59
1650715910917,ECE 65,A50,083695,Staff,0,5,30,30
1650715916946,ECE 109,A01,091882,Touri; Behrouz,33,0,70,37
1650715922972,ECE 180,A00,083140,Abi Samra; Nicholas Camill,20,0,30,10
1650715922972,ECE 180,B00,083141,Abi Samra; Nicholas Camill,0,0,30,30
1650715929005,MATH 10A,A01,083735,Patchell; Gregory David,2,0,30,28
1650715929005,MATH 10A,A02,083736,Patchell; Gregory David,27,0,30,3
1650715929005,MATH 10A,A03,083737,Patchell; Gregory David,24,0,30,6
1650715935034,MATH 10B,A01,083207,Staff,0,9,30,30
1650715935034,MATH 10B,A02,083208,Staff,1,7,30,29
1650715935034,MATH 10B,B01,083739,Staff,11,0,30,19
1650715935034,MATH 10B,B02,083740,Staff,28,0,30,2
1650715941063,MATH 18,A01,083743,Staff,0,0,30,30
1650715941063,MATH 18,A02,083744,Staff,23,0,30,7
1650715941063,MATH 18,A03,083745,Staff,21,0,30,9
1650715941063,MATH 18,A04,083746,Staff,26,0,30,4
1650715941063,MATH 18,B01,083748,Staff,0,15,30,30
1650715941063,MATH 18,B02,083749,Staff,0,12,30,30
1650715941063,MATH 18,B03,083750,Staff,0,12,30,30
1650715941063,MATH 18,B04,083751,Staff,0,12,30,30
1650715947092,MATH 20A,A01,083754,Staff,19,0,40,21
1650715953119,MATH 20B,A01,083756,Staff,0,11,30,30
1650715953119,MATH 20B,A02,083757,Staff,0,12,30,30
1650715959153,MATH 20C,A01,083760,Staff,0,16,30,30
1650715959153,MATH 20C,A02,083761,Staff,0,16,30,30
1650715959153,MATH 20C,B01,083762,Staff,10,0,30,20
1650715959153,MATH 20C,B02,083763,Staff,28,0,30,2
1650715965181,MATH 20D,A01,083765,Staff,2,1,30,28
1650715965181,MATH 20D,A02,083766,Staff,6,0,30,24
1650715965181,MATH 20D,A03,083767,Staff,24,0,30,6
1650715971216,MATH 20E,A01,083771,Staff,3,0,30,27
1650715971216,MATH 20E,A02,083772,Staff,16,0,30,14
1650715971216,MATH 20E,B01,083773,Staff,0,0,30,30
1650715971216,MATH 20E,B02,083774,Staff,6,0,30,24
1650715977248,MATH 103A,A01,083777,Staff,0,15,30,30
1650715977248,MATH 103A,A02,083778,Staff,0,15,30,30
1650715977248,MATH 103A,B01,083779,Staff,0,15,30,30
1650715977248,MATH 103A,B02,083780,Staff,0,15,30,30
1650715983284,MATH 105,A01,085443,Staff,0,22,30,30
1650715989320,MATH 109,A01,083213,Anzaldo; Leesa B,0,7,30,30
1650715989320,MATH 109,A02,083214,Anzaldo; Leesa B,0,7,30,30
1650715989320,MATH 109,B01,083215,Anzaldo; Leesa B,0,8,30,30
1650715989320,MATH 109,B02,083216,Anzaldo; Leesa B,0,6,30,30
1650715995348,MATH 142A,A01,083219,Chow; Bennett,0,16,30,30
1650715995348,MATH 142A,A02,083220,Chow; Bennett,0,15,30,30
1650715995348,MATH 142A,B01,083221,Chow; Bennett,0,15,30,30
1650715995348,MATH 142A,B02,083222,Chow; Bennett,0,14,30,30
1650716001375,MATH 193A,A01,083224,Staff,0,5,30,30
1650716001375,MATH 193A,A02,083225,Staff,0,6,30,30
1650716001375,MATH 193A,A03,083781,Staff,0,6,30,30
1650716001375,MATH 193A,A04,083782,Staff,0,7,30,30
1650716007402,MATH 197,001,091859,McAuley; Julian John,9998,0,9999,1
1650716013473,COGS 9,A01,083615,Staff,1,15,60,59
1650716019506,COGS 11,A01,083617,Boyle; Mary E. T.,16,0,40,24
1650716025544,COGS 13,A01,083071,Staff,0,38,40,40
1650716031569,COGS 14A,A01,092681,Staff,0,35,100,100
1650716037595,COGS 14B,A01,083073,Cheng; Tzu-Han,1,13,50,49
1650716043620,COGS 17,A01,092677,Staff,13,0,75,62
1650716049650,COGS 100,A01,083619,Staff,0,28,60,60
1650716055677,COGS 101A,A01,083621,Davis; Joshua Daniel,0,27,60,60
1650716061705,COGS 101B,A01,091572,Staff,0,4,60,60
1650716067732,COGS 101C,A01,083625,Delgado; Tania,14,0,30,16
1650716073773,COGS 107A,A01,083627,Boyle; Mary E. T.,0,16,60,60
1650716079811,COGS 118A,A01,083075,Staff,0,8,60,60
1650716085842,CSE 3,A50,083646,Miranda; Gregory Joseph,18,0,38,20
1650716085842,CSE 3,A51,083647,Miranda; Gregory Joseph,36,0,37,1
1650716091869,CSE 8A,A50,083650,Miranda; Gregory Joseph,0,30,40,40
1650716097896,CSE 11,A01,083080,Cao; Yingjun,0,96,40,40
1650716103922,CSE 12,A01,083652,Staff,0,21,100,100
1650716109953,CSE 15L,A01,083654,Staff,0,3,50,50
1650716109953,CSE 15L,A02,083655,Staff,0,2,50,50
1650716115981,CSE 20,A01,083657,Staff,49,0,80,31
1650716122011,CSE 30,A01,083084,Eldon; John,0,77,40,40
1650716128038,CSE 100,A01,083659,Cao; Yingjun,0,70,50,50
1650716134064,CSE 134B,A01,083661,Powell; Thomas Allan,0,38,65,65
1650716140096,CSE 140,A01,083663,Staff,0,11,75,75
1650716146124,CSE 140L,A01,083088,Eldon; John,0,20,75,75
1650716152152,CSE 175,A01,083665,Kumar; Rakesh,7,0,25,18
1650716158176,CSE 190,A00,092507,Dubnov; Shlomo,10,0,20,10
1650716164207,ECE 45,A01,083139,Staff,1,2,60,59
1650716170235,ECE 65,A50,083695,Staff,0,5,30,30
1650716176262,ECE 109,A01,091882,Touri; Behrouz,33,0,70,37
1650716182295,ECE 180,A00,083140,Abi Samra; Nicholas Camill,20,0,30,10
1650716182295,ECE 180,B00,083141,Abi Samra; Nicholas Camill,0,0,30,30
1650716188323,MATH 10A,A01,083735,Patchell; Gregory David,2,0,30,28
1650716188323,MATH 10A,A02,083736,Patchell; Gregory David,27,0,30,3
1650716188323,MATH 10A,A03,083737,Patchell; Gregory David,24,0,30,6
1650716194451,MATH 10B,A01,083207,Staff,0,9,30,30
1650716194451,MATH 10B,A02,083208,Staff,1,7,30,29
1650716194451,MATH 10B,B01,083739,Staff,11,0,30,19
1650716194451,MATH 10B,B02,083740,Staff,28,0,30,2
1650716200484,MATH 18,A01,083743,Staff,0,0,30,30
1650716200484,MATH 18,A02,083744,Staff,23,0,30,7
1650716200484,MATH 18,A03,083745,Staff,21,0,30,9
1650716200484,MATH 18,A04,083746,Staff,26,0,30,4
1650716200484,MATH 18,B01,083748,Staff,0,15,30,30
1650716200484,MATH 18,B02,083749,Staff,0,12,30,30
1650716200484,MATH 18,B03,083750,Staff,0,12,30,30
1650716200484,MATH 18,B04,083751,Staff,0,12,30,30
1650716206510,MATH 20A,A01,083754,Staff,19,0,40,21
1650716212537,MATH 20B,A01,083756,Staff,0,11,30,30
1650716212537,MATH 20B,A02,083757,Staff,0,12,30,30
1650716218564,MATH 20C,A01,083760,Staff,0,16,30,30
1650716218564,MATH 20C,A02,083761,Staff,0,16,30,30
1650716218564,MATH 20C,B01,083762,Staff,10,0,30,20
1650716218564,MATH 20C,B02,083763,Staff,28,0,30,2
1650716224591,MATH 20D,A01,083765,Staff,2,1,30,28
1650716224591,MATH 20D,A02,083766,Staff,6,0,30,24
1650716224591,MATH 20D,A03,083767,Staff,24,0,30,6
1650716230619,MATH 20E,A01,083771,Staff,3,0,30,27
1650716230619,MATH 20E,A02,083772,Staff,16,0,30,14
1650716230619,MATH 20E,B01,083773,Staff,0,0,30,30
1650716230619,MATH 20E,B02,083774,Staff,6,0,30,24
1650716236650,MATH 103A,A01,083777,Staff,0,15,30,30
1650716236650,MATH 103A,A02,083778,Staff,0,15,30,30
1650716236650,MATH 103A,B01,083779,Staff,0,15,30,30
1650716236650,MATH 103A,B02,083780,Staff,0,15,30,30
1650716242677,MATH 105,A01,085443,Staff,0,22,30,30
1650716248712,MATH 109,A01,083213,Anzaldo; Leesa B,0,7,30,30
1650716248712,MATH 109,A02,083214,Anzaldo; Leesa B,0,7,30,30
1650716248712,MATH 109,B01,083215,Anzaldo; Leesa B,0,8,30,30
1650716248712,MATH 109,B02,083216,Anzaldo; Leesa B,0,6,30,30
1650716254743,MATH 142A,A01,083219,Chow; Bennett,0,16,30,30
1650716254743,MATH 142A,A02,083220,Chow; Bennett,0,15,30,30
1650716254743,MATH 142A,B01,083221,Chow; Bennett,0,15,30,30
1650716254743,MATH 142A,B02,083222,Chow; Bennett,0,14,30,30
1650716260782,MATH 193A,A01,083224,Staff,0,5,30,30
1650716260782,MATH 193A,A02,083225,Staff,0,6,30,30
1650716260782,MATH 193A,A03,083781,Staff,0,6,30,30
1650716260782,MATH 193A,A04,083782,Staff,0,7,30,30
1650716266812,MATH 197,001,091859,McAuley; Julian John,9998,0,9999,1
1650716272910,COGS 9,A01,083615,Staff,1,15,60,59
1650716278936,COGS 11,A01,083617,Boyle; Mary E. T.,16,0,40,24
1650716284970,COGS 13,A01,083071,Staff,0,38,40,40
1650716291003,COGS 14A,A01,092681,Staff,0,35,100,100
1650716297029,COGS 14B,A01,083073,Cheng; Tzu-Han,1,13,50,49
1650716303058,COGS 17,A01,092677,Staff,13,0,75,62
1650716309091,COGS 100,A01,083619,Staff,0,28,60,60
1650716315119,COGS 101A,A01,083621,Davis; Joshua Daniel,0,27,60,60
1650716321144,COGS 101B,A01,091572,Staff,0,4,60,60
1650716327170,COGS 101C,A01,083625,Delgado; Tania,14,0,30,16
1650716333200,COGS 107A,A01,083627,Boyle; Mary E. T.,0,16,60,60
1650716339231,COGS 118A,A01,083075,Staff,0,8,60,60
1650716345266,CSE 3,A50,083646,Miranda; Gregory Joseph,18,0,38,20
1650716345266,CSE 3,A51,083647,Miranda; Gregory Joseph,36,0,37,1
1650716351292,CSE 8A,A50,083650,Miranda; Gregory Joseph,0,30,40,40
1650716357324,CSE 11,A01,083080,Cao; Yingjun,0,96,40,40
1650716363351,CSE 12,A01,083652,Staff,0,21,100,100
1650716369384,CSE 15L,A01,083654,Staff,0,3,50,50
1650716369384,CSE 15L,A02,083655,Staff,0,2,50,50
1650716375410,CSE 20,A01,083657,Staff,49,0,80,31
1650716381450,CSE 30,A01,083084,Eldon; John,0,77,40,40
1650716387482,CSE 100,A01,083659,Cao; Yingjun,0,70,50,50
1650716393510,CSE 134B,A01,083661,Powell; Thomas Allan,0,38,65,65
1650716399539,CSE 140,A01,083663,Staff,0,11,75,75
1650716405565,CSE 140L,A01,083088,Eldon; John,0,20,75,75
1650716411600,CSE 175,A01,083665,Kumar; Rakesh,7,0,25,18
1650716417634,CSE 190,A00,092507,Dubnov; Shlomo,10,0,20,10
1650716423660,ECE 45,A01,083139,Staff,1,2,60,59
1650716429692,ECE 65,A50,083695,Staff,0,5,30,30
1650716435723,ECE 109,A01,091882,Touri; Behrouz,33,0,70,37
1650716441749,ECE 180,A00,083140,Abi Samra; Nicholas Camill,20,0,30,10
1650716441749,ECE 180,B00,083141,Abi Samra; Nicholas Camill,0,0,30,30
1650716447778,MATH 10A,A01,083735,Patchell; Gregory David,2,0,30,28
1650716447778,MATH 10A,A02,083736,Patchell; Gregory David,27,0,30,3
1650716447778,MATH 10A,A03,083737,Patchell; Gregory David,24,0,30,6
1650716453808,MATH 10B,A01,083207,Staff,0,9,30,30
1650716453808,MATH 10B,A02,083208,Staff,1,7,30,29
1650716453808,MATH 10B,B01,083739,Staff,11,0,30,19
1650716453808,MATH 10B,B02,083740,Staff,28,0,30,2
1650716459843,MATH 18,A01,083743,Staff,0,0,30,30
1650716459843,MATH 18,A02,083744,Staff,23,0,30,7
1650716459843,MATH 18,A03,083745,Staff,21,0,30,9
1650716459843,MATH 18,A04,083746,Staff,26,0,30,4
1650716459843,MATH 18,B01,083748,Staff,0,15,30,30
1650716459843,MATH 18,B02,083749,Staff,0,12,30,30
1650716459843,MATH 18,B03,083750,Staff,0,12,30,30
1650716459843,MATH 18,B04,083751,Staff,0,12,30,30
1650716465868,MATH 20A,A01,083754,Staff,19,0,40,21
1650716471906,MATH 20B,A01,083756,Staff,0,11,30,30
1650716471906,MATH 20B,A02,083757,Staff,0,12,30,30
1650716477941,MATH 20C,A01,083760,Staff,0,16,30,30
1650716477941,MATH 20C,A02,083761,Staff,0,16,30,30
1650716477941,MATH 20C,B01,083762,Staff,10,0,30,20
1650716477941,MATH 20C,B02,083763,Staff,28,0,30,2
1650716483973,MATH 20D,A01,083765,Staff,2,1,30,28
1650716483973,MATH 20D,A02,083766,Staff,6,0,30,24
1650716483973,MATH 20D,A03,083767,Staff,24,0,30,6
1650716490005,MATH 20E,A01,083771,Staff,3,0,30,27
1650716490005,MATH 20E,A02,083772,Staff,16,0,30,14
1650716490005,MATH 20E,B01,083773,Staff,0,0,30,30
1650716490005,MATH 20E,B02,083774,Staff,6,0,30,24
1650716496037,MATH 103A,A01,083777,Staff,0,15,30,30
1650716496037,MATH 103A,A02,083778,Staff,0,15,30,30
1650716496037,MATH 103A,B01,083779,Staff,0,15,30,30
1650716496037,MATH 103A,B02,083780,Staff,0,15,30,30
1650716502063,MATH 105,A01,085443,Staff,0,22,30,30
1650716508090,MATH 109,A01,083213,Anzaldo; Leesa B,0,7,30,30
1650716508090,MATH 109,A02,083214,Anzaldo; Leesa B,0,7,30,30
1650716508090,MATH 109,B01,083215,Anzaldo; Leesa B,0,8,30,30
1650716508090,MATH 109,B02,083216,Anzaldo; Leesa B,0,6,30,30
1650716514122,MATH 142A,A01,083219,Chow; Bennett,0,16,30,30
1650716514122,MATH 142A,A02,083220,Chow; Bennett,0,15,30,30
1650716514122,MATH 142A,B01,083221,Chow; Bennett,0,15,30,30
1650716514122,MATH 142A,B02,083222,Chow; Bennett,0,14,30,30
1650716520147,MATH 193A,A01,083224,Staff,0,5,30,30
1650716520147,MATH 193A,A02,083225,Staff,0,6,30,30
1650716520147,MATH 193A,A03,083781,Staff,0,6,30,30
1650716520147,MATH 193A,A04,083782,Staff,0,7,30,30
1650716526174,MATH 197,001,091859,McAuley; Julian John,9998,0,9999,1
1650716532252,COGS 9,A01,083615,Staff,1,15,60,59
1650716538278,COGS 11,A01,083617,Boyle; Mary E. T.,16,0,40,24
1650716544305,COGS 13,A01,083071,Staff,0,38,40,40
1650716550333,COGS 14A,A01,092681,Staff,0,35,100,100
1650716556363,COGS 14B,A01,083073,Cheng; Tzu-Han,1,13,50,49
1650716562388,COGS 17,A01,092677,Staff,13,0,75,62
1650716568417,COGS 100,A01,083619,Staff,0,28,60,60
1650716574450,COGS 101A,A01,083621,Davis; Joshua Daniel,0,27,60,60
1650716580477,COGS 101B,A01,091572,Staff,0,4,60,60
1650716586509,COGS 101C,A01,083625,Delgado; Tania,14,0,30,16
1650716592533,COGS 107A,A01,083627,Boyle; Mary E. T.,0,16,60,60
1650716598557,COGS 118A,A01,083075,Staff,0,8,60,60
1650716604586,CSE 3,A50,083646,Miranda; Gregory Joseph,18,0,38,20
1650716604586,CSE 3,A51,083647,Miranda; Gregory Joseph,36,0,37,1
1650716610611,CSE 8A,A50,083650,Miranda; Gregory Joseph,0,30,40,40
1650716616636,CSE 11,A01,083080,Cao; Yingjun,0,96,40,40
1650716622664,CSE 12,A01,083652,Staff,0,21,100,100
1650716628696,CSE 15L,A01,083654,Staff,0,3,50,50
1650716628696,CSE 15L,A02,083655,Staff,0,2,50,50
1650716634729,CSE 20,A01,083657,Staff,49,0,80,31
1650716640754,CSE 30,A01,083084,Eldon; John,0,77,40,40
1650716646792,CSE 100,A01,083659,Cao; Yingjun,0,70,50,50
1650716652818,CSE 134B,A01,083661,Powell; Thomas Allan,0,38,65,65
1650716658846,CSE 140,A01,083663,Staff,0,11,75,75
1650716664876,CSE 140L,A01,083088,Eldon; John,0,20,75,75
1650716670902,CSE 175,A01,083665,Kumar; Rakesh,7,0,25,18
1650716676933,CSE 190,A00,092507,Dubnov; Shlomo,10,0,20,10
1650716682966,ECE 45,A01,083139,Staff,1,2,60,59
1650716688993,ECE 65,A50,083695,Staff,0,5,30,30
1650716695026,ECE 109,A01,091882,Touri; Behrouz,33,0,70,37
1650716701055,ECE 180,A00,083140,Abi Samra; Nicholas Camill,20,0,30,10
1650716701055,ECE 180,B00,083141,Abi Samra; Nicholas Camill,0,0,30,30
1650716707083,MATH 10A,A01,083735,Patchell; Gregory David,2,0,30,28
1650716707083,MATH 10A,A02,083736,Patchell; Gregory David,27,0,30,3
1650716707083,MATH 10A,A03,083737,Patchell; Gregory David,24,0,30,6
1650716713116,MATH 10B,A01,083207,Staff,0,9,30,30
1650716713116,MATH 10B,A02,083208,Staff,1,7,30,29
1650716713116,MATH 10B,B01,083739,Staff,11,0,30,19
1650716713116,MATH 10B,B02,083740,Staff,28,0,30,2
1650716719152,MATH 18,A01,083743,Staff,0,0,30,30
1650716719152,MATH 18,A02,083744,Staff,23,0,30,7
1650716719152,MATH 18,A03,083745,Staff,21,0,30,9
1650716719152,MATH 18,A04,083746,Staff,26,0,30,4
1650716719152,MATH 18,B01,083748,Staff,0,15,30,30
1650716719152,MATH 18,B02,083749,Staff,0,12,30,30
1650716719152,MATH 18,B03,083750,Staff,0,12,30,30
1650716719152,MATH 18,B04,083751,Staff,0,12,30,30
1650716725180,MATH 20A,A01,083754,Staff,19,0,40,21
1650716731215,MATH 20B,A01,083756,Staff,0,11,30,30
1650716731215,MATH 20B,A02,083757,Staff,0,12,30,30
1650716737246,MATH 20C,A01,083760,Staff,0,16,30,30
1650716737246,MATH 20C,A02,083761,Staff,0,16,30,30
1650716737246,MATH 20C,B01,083762,Staff,10,0,30,20
1650716737246,MATH 20C,B02,083763,Staff,28,0,30,2
1650716743275,MATH 20D,A01,083765,Staff,2,1,30,28
1650716743275,MATH 20D,A02,083766,Staff,6,0,30,24
1650716743275,MATH 20D,A03,083767,Staff,24,0,30,6
1650716749305,MATH 20E,A01,083771,Staff,3,0,30,27
1650716749305,MATH 20E,A02,083772,Staff,16,0,30,14
1650716749305,MATH 20E,B01,083773,Staff,0,0,30,30
1650716749305,MATH 20E,B02,083774,Staff,6,0,30,24
1650716755333,MATH 103A,A01,083777,Staff,0,15,30,30
1650716755333,MATH 103A,A02,083778,Staff,0,15,30,30
1650716755333,MATH 103A,B01,083779,Staff,0,15,30,30
1650716755333,MATH 103A,B02,083780,Staff,0,15,30,30
1650716761360,MATH 105,A01,085443,Staff,0,22,30,30
1650716767386,MATH 109,A01,083213,Anzaldo; Leesa B,0,7,30,30
1650716767386,MATH 109,A02,083214,Anzaldo; Leesa B,0,7,30,30
1650716767386,MATH 109,B01,083215,Anzaldo; Leesa B,0,8,30,30
1650716767386,MATH 109,B02,083216,Anzaldo; Leesa B,0,6,30,30
1650716773416,MATH 142A,A01,083219,Chow; Bennett,0,16,30,30
1650716773416,MATH 142A,A02,083220,Chow; Bennett,0,15,30,30
1650716773416,MATH 142A,B01,083221,Chow; Bennett,0,15,30,30
1650716773416,MATH 142A,B02,083222,Chow; Bennett,0,14,30,30
1650716779442,MATH 193A,A01,083224,Staff,0,5,30,30
1650716779442,MATH 193A,A02,083225,Staff,0,6,30,30
1650716779442,MATH 193A,A03,083781,Staff,0,6,30,30
1650716779442,MATH 193A,A04,083782,Staff,0,7,30,30
1650716785467,MATH 197,001,091859,McAuley; Julian John,9998,0,9999,1
1650716791628,COGS 9,A01,083615,Staff,1,15,60,59
1650716797658,COGS 11,A01,083617,Boyle; Mary E. T.,16,0,40,24
1650716803694,COGS 13,A01,083071,Staff,0,38,40,40
1650716809719,COGS 14A,A01,092681,Staff,0,35,100,100
1650716815745,COGS 14B,A01,083073,Cheng; Tzu-Han,1,13,50,49
1650716821773,COGS 17,A01,092677,Staff,13,0,75,62
1650716827799,COGS 100,A01,083619,Staff,0,28,60,60
1650716833826,COGS 101A,A01,083621,Davis; Joshua Daniel,0,27,60,60
1650716839857,COGS 101B,A01,091572,Staff,0,4,60,60
1650716845883,COGS 101C,A01,083625,Delgado; Tania,14,0,30,16
1650716851913,COGS 107A,A01,083627,Boyle; Mary E. T.,0,16,60,60
1650716857939,COGS 118A,A01,083075,Staff,0,8,60,60
1650716863971,CSE 3,A50,083646,Miranda; Gregory Joseph,18,0,38,20
1650716863971,CSE 3,A51,083647,Miranda; Gregory Joseph,36,0,37,1
1650716870001,CSE 8A,A50,083650,Miranda; Gregory Joseph,0,30,40,40
1650716876028,CSE 11,A01,083080,Cao; Yingjun,0,96,40,40
1650716882061,CSE 12,A01,083652,Staff,0,21,100,100
1650716888088,CSE 15L,A01,083654,Staff,0,3,50,50
1650716888088,CSE 15L,A02,083655,Staff,0,2,50,50
1650716894113,CSE 20,A01,083657,Staff,49,0,80,31
1650716900140,CSE 30,A01,083084,Eldon; John,0,77,40,40
1650716906165,CSE 100,A01,083659,Cao; Yingjun,0,70,50,50
1650716912191,CSE 134B,A01,083661,Powell; Thomas Allan,0,38,65,65
1650716918218,CSE 140,A01,083663,Staff,0,11,75,75
1650716924248,CSE 140L,A01,083088,Eldon; John,0,20,75,75
1650716930291,CSE 175,A01,083665,Kumar; Rakesh,7,0,25,18
1650716936315,CSE 190,A00,092507,Dubnov; Shlomo,10,0,20,10
1650716942342,ECE 45,A01,083139,Staff,1,2,60,59
1650716948372,ECE 65,A50,083695,Staff,0,5,30,30
1650716954402,ECE 109,A01,091882,Touri; Behrouz,33,0,70,37
1650716960433,ECE 180,A00,083140,Abi Samra; Nicholas Camill,20,0,30,10
1650716960433,ECE 180,B00,083141,Abi Samra; Nicholas Camill,0,0,30,30
1650716966463,MATH 10A,A01,083735,Patchell; Gregory David,2,0,30,28
1650716966463,MATH 10A,A02,083736,Patchell; Gregory David,27,0,30,3
1650716966463,MATH 10A,A03,083737,Patchell; Gregory David,24,0,30,6
1650716972493,MATH 10B,A01,083207,Staff,0,9,30,30
1650716972493,MATH 10B,A02,083208,Staff,1,7,30,29
1650716972493,MATH 10B,B01,083739,Staff,11,0,30,19
1650716972493,MATH 10B,B02,083740,Staff,28,0,30,2
1650716978535,MATH 18,A01,083743,Staff,0,0,30,30
1650716978535,MATH 18,A02,083744,Staff,23,0,30,7
1650716978535,MATH 18,A03,083745,Staff,21,0,30,9
1650716978535,MATH 18,A04,083746,Staff,26,0,30,4
1650716978535,MATH 18,B01,083748,Staff,0,15,30,30
1650716978535,MATH 18,B02,083749,Staff,0,12,30,30
1650716978535,MATH 18,B03,083750,Staff,0,12,30,30
1650716978535,MATH 18,B04,083751,Staff,0,12,30,30
1650716984558,MATH 20A,A01,083754,Staff,19,0,40,21
1650716990586,MATH 20B,A01,083756,Staff,0,11,30,30
1650716990586,MATH 20B,A02,083757,Staff,0,12,30,30
1650716996616,MATH 20C,A01,083760,Staff,0,16,30,30
1650716996616,MATH 20C,A02,083761,Staff,0,16,30,30
1650716996616,MATH 20C,B01,083762,Staff,10,0,30,20
1650716996616,MATH 20C,B02,083763,Staff,28,0,30,2
1650717002659,MATH 20D,A01,083765,Staff,2,1,30,28
1650717002659,MATH 20D,A02,083766,Staff,6,0,30,24
1650717002659,MATH 20D,A03,083767,Staff,24,0,30,6
1650717008684,MATH 20E,A01,083771,Staff,3,0,30,27
1650717008684,MATH 20E,A02,083772,Staff,16,0,30,14
1650717008684,MATH 20E,B01,083773,Staff,0,0,30,30
1650717008684,MATH 20E,B02,083774,Staff,6,0,30,24
1650717014717,MATH 103A,A01,083777,Staff,0,15,30,30
1650717014717,MATH 103A,A02,083778,Staff,0,15,30,30
1650717014717,MATH 103A,B01,083779,Staff,0,15,30,30
1650717014717,MATH 103A,B02,083780,Staff,0,15,30,30
1650717020745,MATH 105,A01,085443,Staff,0,22,30,30
1650717026786,MATH 109,A01,083213,Anzaldo; Leesa B,0,7,30,30
1650717026786,MATH 109,A02,083214,Anzaldo; Leesa B,0,7,30,30
1650717026786,MATH 109,B01,083215,Anzaldo; Leesa B,0,8,30,30
1650717026786,MATH 109,B02,083216,Anzaldo; Leesa B,0,6,30,30
1650717032820,MATH 142A,A01,083219,Chow; Bennett,0,16,30,30
1650717032820,MATH 142A,A02,083220,Chow; Bennett,0,15,30,30
1650717032820,MATH 142A,B01,083221,Chow; Bennett,0,15,30,30
1650717032820,MATH 142A,B02,083222,Chow; Bennett,0,14,30,30
1650717038846,MATH 193A,A01,083224,Staff,0,5,30,30
1650717038846,MATH 193A,A02,083225,Staff,0,6,30,30
1650717038846,MATH 193A,A03,083781,Staff,0,6,30,30
1650717038846,MATH 193A,A04,083782,Staff,0,7,30,30
1650717044883,MATH 197,001,091859,McAuley; Julian John,9998,0,9999,1
1650717050947,COGS 9,A01,083615,Staff,1,15,60,59
1650717056977,COGS 11,A01,083617,Boyle; Mary E. T.,16,0,40,24
1650717063008,COGS 13,A01,083071,Staff,0,38,40,40
1650717069031,COGS 14A,A01,092681,Staff,0,35,100,100
1650717075065,COGS 14B,A01,083073,Cheng; Tzu-Han,1,13,50,49
1650717081094,COGS 17,A01,092677,Staff,13,0,75,62
1650717087124,COGS 100,A01,083619,Staff,0,28,60,60
1650717093158,COGS 101A,A01,083621,Davis; Joshua Daniel,0,27,60,60
1650717099186,COGS 101B,A01,091572,Staff,0,4,60,60
1650717105211,COGS 101C,A01,083625,Delgado; Tania,14,0,30,16
1650717111237,COGS 107A,A01,083627,Boyle; Mary E. T.,0,16,60,60
1650717117262,COGS 118A,A01,083075,Staff,0,8,60,60
1650717123296,CSE 3,A50,083646,Miranda; Gregory Joseph,18,0,38,20
1650717123296,CSE 3,A51,083647,Miranda; Gregory Joseph,36,0,37,1
1650717129325,CSE 8A,A50,083650,Miranda; Gregory Joseph,0,30,40,40
1650717135355,CSE 11,A01,083080,Cao; Yingjun,0,96,40,40
1650717141396,CSE 12,A01,083652,Staff,0,21,100,100
1650717147428,CSE 15L,A01,083654,Staff,0,3,50,50
1650717147428,CSE 15L,A02,083655,Staff,0,2,50,50
1650717153458,CSE 20,A01,083657,Staff,49,0,80,31
1650717159492,CSE 30,A01,083084,Eldon; John,0,77,40,40
1650717165522,CSE 100,A01,083659,Cao; Yingjun,0,70,50,50
1650717171558,CSE 134B,A01,083661,Powell; Thomas Allan,0,38,65,65
1650717177586,CSE 140,A01,083663,Staff,0,11,75,75
1650717183613,CSE 140L,A01,083088,Eldon; John,0,20,75,75
1650717189640,CSE 175,A01,083665,Kumar; Rakesh,7,0,25,18
1650717195667,CSE 190,A00,092507,Dubnov; Shlomo,10,0,20,10
1650717201697,ECE 45,A01,083139,Staff,1,2,60,59
1650717207728,ECE 65,A50,083695,Staff,0,5,30,30
1650717213771,ECE 109,A01,091882,Touri; Behrouz,33,0,70,37
1650717219796,ECE 180,A00,083140,Abi Samra; Nicholas Camill,20,0,30,10
1650717219796,ECE 180,B00,083141,Abi Samra; Nicholas Camill,0,0,30,30
1650717225830,MATH 10A,A01,083735,Patchell; Gregory David,2,0,30,28
1650717225830,MATH 10A,A02,083736,Patchell; Gregory David,27,0,30,3
1650717225830,MATH 10A,A03,083737,Patchell; Gregory David,24,0,30,6
1650717231862,MATH 10B,A01,083207,Staff,0,9,30,30
1650717231862,MATH 10B,A02,083208,Staff,1,7,30,29
1650717231862,MATH 10B,B01,083739,Staff,11,0,30,19
1650717231862,MATH 10B,B02,083740,Staff,28,0,30,2
1650717237898,MATH 18,A01,083743,Staff,0,0,30,30
1650717237898,MATH 18,A02,083744,Staff,23,0,30,7
1650717237898,MATH 18,A03,083745,Staff,21,0,30,9
1650717237898,MATH 18,A04,083746,Staff,26,0,30,4
1650717237898,MATH 18,B01,083748,Staff,0,15,30,30
1650717237898,MATH 18,B02,083749,Staff,0,12,30,30
1650717237898,MATH 18,B03,083750,Staff,0,12,30,30
1650717237898,MATH 18,B04,083751,Staff,0,12,30,30
1650717243926,MATH 20A,A01,083754,Staff,19,0,40,21
1650717249958,MATH 20B,A01,083756,Staff,0,11,30,30
1650717249958,MATH 20B,A02,083757,Staff,0,12,30,30
1650717255999,MATH 20C,A01,083760,Staff,0,16,30,30
1650717255999,MATH 20C,A02,083761,Staff,0,16,30,30
1650717255999,MATH 20C,B01,083762,Staff,10,0,30,20
1650717255999,MATH 20C,B02,083763,Staff,28,0,30,2
1650717262028,MATH 20D,A01,083765,Staff,2,1,30,28
1650717262028,MATH 20D,A02,083766,Staff,6,0,30,24
1650717262028,MATH 20D,A03,083767,Staff,24,0,30,6
1650717268061,MATH 20E,A01,083771,Staff,3,0,30,27
1650717268061,MATH 20E,A02,083772,Staff,16,0,30,14
1650717268061,MATH 20E,B01,083773,Staff,0,0,30,30
1650717268061,MATH 20E,B02,083774,Staff,6,0,30,24
1650717274089,MATH 103A,A01,083777,Staff,0,15,30,30
1650717274089,MATH 103A,A02,083778,Staff,0,15,30,30
1650717274089,MATH 103A,B01,083779,Staff,0,15,30,30
1650717274089,MATH 103A,B02,083780,Staff,0,15,30,30
1650717280119,MATH 105,A01,085443,Staff,0,22,30,30
1650717286154,MATH 109,A01,083213,Anzaldo; Leesa B,0,7,30,30
1650717286154,MATH 109,A02,083214,Anzaldo; Leesa B,0,7,30,30
1650717286154,MATH 109,B01,083215,Anzaldo; Leesa B,0,8,30,30
1650717286154,MATH 109,B02,083216,Anzaldo; Leesa B,0,6,30,30
1650717292178,MATH 142A,A01,083219,Chow; Bennett,0,16,30,30
1650717292178,MATH 142A,A02,083220,Chow; Bennett,0,15,30,30
1650717292178,MATH 142A,B01,083221,Chow; Bennett,0,15,30,30
1650717292178,MATH 142A,B02,083222,Chow; Bennett,0,14,30,30
1650717298207,MATH 193A,A01,083224,Staff,0,5,30,30
1650717298207,MATH 193A,A02,083225,Staff,0,6,30,30
1650717298207,MATH 193A,A03,083781,Staff,0,6,30,30
1650717298207,MATH 193A,A04,083782,Staff,0,7,30,30
1650717304235,MATH 197,001,091859,McAuley; Julian John,9998,0,9999,1
1650717310295,COGS 9,A01,083615,Staff,1,15,60,59
1650717316333,COGS 11,A01,083617,Boyle; Mary E. T.,16,0,40,24
1650717322360,COGS 13,A01,083071,Staff,0,38,40,40
1650717328390,COGS 14A,A01,092681,Staff,0,35,100,100
1650717334416,COGS 14B,A01,083073,Cheng; Tzu-Han,1,13,50,49
1650717340441,COGS 17,A01,092677,Staff,13,0,75,62
1650717346474,COGS 100,A01,083619,Staff,0,28,60,60
1650717352498,COGS 101A,A01,083621,Davis; Joshua Daniel,0,27,60,60
1650717358528,COGS 101B,A01,091572,Staff,0,4,60,60
1650717364558,COGS 101C,A01,083625,Delgado; Tania,14,0,30,16
1650717370584,COGS 107A,A01,083627,Boyle; Mary E. T.,0,16,60,60
1650717376610,COGS 118A,A01,083075,Staff,0,8,60,60
1650717382742,CSE 3,A50,083646,Miranda; Gregory Joseph,18,0,38,20
1650717382742,CSE 3,A51,083647,Miranda; Gregory Joseph,36,0,37,1
1650717388769,CSE 8A,A50,083650,Miranda; Gregory Joseph,0,30,40,40
1650717394800,CSE 11,A01,083080,Cao; Yingjun,0,96,40,40
1650717400832,CSE 12,A01,083652,Staff,0,21,100,100
1650717406857,CSE 15L,A01,083654,Staff,0,3,50,50
1650717406857,CSE 15L,A02,083655,Staff,0,2,50,50
1650717412884,CSE 20,A01,083657,Staff,49,0,80,31
1650717418915,CSE 30,A01,083084,Eldon; John,0,77,40,40
1650717424946,CSE 100,A01,083659,Cao; Yingjun,0,70,50,50
1650717430973,CSE 134B,A01,083661,Powell; Thomas Allan,0,38,65,65
1650717436998,CSE 140,A01,083663,Staff,0,11,75,75
1650717443026,CSE 140L,A01,083088,Eldon; John,0,20,75,75
1650717449059,CSE 175,A01,083665,Kumar; Rakesh,7,0,25,18
1650717455085,CSE 190,A00,092507,Dubnov; Shlomo,10,0,20,10
1650717461111,ECE 45,A01,083139,Staff,1,2,60,59
1650717467143,ECE 65,A50,083695,Staff,0,5,30,30
1650717473169,ECE 109,A01,091882,Touri; Behrouz,33,0,70,37
1650717479196,ECE 180,A00,083140,Abi Samra; Nicholas Camill,20,0,30,10
1650717479196,ECE 180,B00,083141,Abi Samra; Nicholas Camill,0,0,30,30
1650717485224,MATH 10A,A01,083735,Patchell; Gregory David,2,0,30,28
1650717485224,MATH 10A,A02,083736,Patchell; Gregory David,27,0,30,3
1650717485224,MATH 10A,A03,083737,Patchell; Gregory David,24,0,30,6
1650717491251,MATH 10B,A01,083207,Staff,0,9,30,30
1650717491251,MATH 10B,A02,083208,Staff,1,7,30,29
1650717491251,MATH 10B,B01,083739,Staff,11,0,30,19
1650717491251,MATH 10B,B02,083740,Staff,28,0,30,2
1650717497289,MATH 18,A01,083743,Staff,0,0,30,30
1650717497289,MATH 18,A02,083744,Staff,23,0,30,7
1650717497289,MATH 18,A03,083745,Staff,21,0,30,9
1650717497289,MATH 18,A04,083746,Staff,26,0,30,4
1650717497289,MATH 18,B01,083748,Staff,0,15,30,30
1650717497289,MATH 18,B02,083749,Staff,0,12,30,30
1650717497289,MATH 18,B03,083750,Staff,0,12,30,30
1650717497289,MATH 18,B04,083751,Staff,0,12,30,30
1650717503318,MATH 20A,A01,083754,Staff,19,0,40,21
1650717509346,MATH 20B,A01,083756,Staff,0,11,30,30
1650717509346,MATH 20B,A02,083757,Staff,0,12,30,30
1650717515384,MATH 20C,A01,083760,Staff,0,16,30,30
1650717515384,MATH 20C,A02,083761,Staff,0,16,30,30
1650717515384,MATH 20C,B01,083762,Staff,10,0,30,20
1650717515384,MATH 20C,B02,083763,Staff,28,0,30,2
1650717521407,MATH 20D,A01,083765,Staff,2,1,30,28
1650717521407,MATH 20D,A02,083766,Staff,6,0,30,24
1650717521407,MATH 20D,A03,083767,Staff,24,0,30,6
1650717527433,MATH 20E,A01,083771,Staff,3,0,30,27
1650717527433,MATH 20E,A02,083772,Staff,16,0,30,14
1650717527433,MATH 20E,B01,083773,Staff,0,0,30,30
1650717527433,MATH 20E,B02,083774,Staff,6,0,30,24
1650717533465,MATH 103A,A01,083777,Staff,0,15,30,30
1650717533465,MATH 103A,A02,083778,Staff,0,15,30,30
1650717533465,MATH 103A,B01,083779,Staff,0,15,30,30
1650717533465,MATH 103A,B02,083780,Staff,0,15,30,30
1650717539496,MATH 105,A01,085443,Staff,0,22,30,30
1650717545524,MATH 109,A01,083213,Anzaldo; Leesa B,0,7,30,30
1650717545524,MATH 109,A02,083214,Anzaldo; Leesa B,0,7,30,30
1650717545524,MATH 109,B01,083215,Anzaldo; Leesa B,0,8,30,30
1650717545524,MATH 109,B02,083216,Anzaldo; Leesa B,0,6,30,30
1650717551559,MATH 142A,A01,083219,Chow; Bennett,0,16,30,30
1650717551559,MATH 142A,A02,083220,Chow; Bennett,0,15,30,30
1650717551559,MATH 142A,B01,083221,Chow; Bennett,0,15,30,30
1650717551559,MATH 142A,B02,083222,Chow; Bennett,0,14,30,30
1650717557584,MATH 193A,A01,083224,Staff,0,5,30,30
1650717557584,MATH 193A,A02,083225,Staff,0,6,30,30
1650717557584,MATH 193A,A03,083781,Staff,0,6,30,30
1650717557584,MATH 193A,A04,083782,Staff,0,7,30,30
1650717563609,MATH 197,001,091859,McAuley; Julian John,9998,0,9999,1
1650717569673,COGS 9,A01,083615,Staff,1,15,60,59
1650717575709,COGS 11,A01,083617,Boyle; Mary E. T.,16,0,40,24
1650717581735,COGS 13,A01,083071,Staff,0,38,40,40
1650717587764,COGS 14A,A01,092681,Staff,0,35,100,100
1650717593793,COGS 14B,A01,083073,Cheng; Tzu-Han,1,13,50,49
1650717599820,COGS 17,A01,092677,Staff,13,0,75,62
1650717605845,COGS 100,A01,083619,Staff,0,28,60,60
1650717611875,COGS 101A,A01,083621,Davis; Joshua Daniel,0,27,60,60
1650717617905,COGS 101B,A01,091572,Staff,0,4,60,60
1650717623937,COGS 101C,A01,083625,Delgado; Tania,14,0,30,16
1650717629965,COGS 107A,A01,083627,Boyle; Mary E. T.,0,16,60,60
1650717635993,COGS 118A,A01,083075,Staff,0,8,60,60
1650717642028,CSE 3,A50,083646,Miranda; Gregory Joseph,18,0,38,20
1650717642028,CSE 3,A51,083647,Miranda; Gregory Joseph,36,0,37,1
1650717648055,CSE 8A,A50,083650,Miranda; Gregory Joseph,0,30,40,40
1650717654087,CSE 11,A01,083080,Cao; Yingjun,0,96,40,40
1650717660119,CSE 12,A01,083652,Staff,0,21,100,100
1650717666149,CSE 15L,A01,083654,Staff,0,3,50,50
1650717666149,CSE 15L,A02,083655,Staff,0,2,50,50
1650717672175,CSE 20,A01,083657,Staff,49,0,80,31
1650717678202,CSE 30,A01,083084,Eldon; John,0,77,40,40
1650717684228,CSE 100,A01,083659,Cao; Yingjun,0,70,50,50
1650717690255,CSE 134B,A01,083661,Powell; Thomas Allan,0,38,65,65
1650717696283,CSE 140,A01,083663,Staff,0,11,75,75
1650717702315,CSE 140L,A01,083088,Eldon; John,0,20,75,75
1650717708341,CSE 175,A01,083665,Kumar; Rakesh,7,0,25,18
1650717714368,CSE 190,A00,092507,Dubnov; Shlomo,10,0,20,10
1650717720393,ECE 45,A01,083139,Staff,1,2,60,59
1650717726421,ECE 65,A50,083695,Staff,0,5,30,30
1650717732445,ECE 109,A01,091882,Touri; Behrouz,33,0,70,37
1650717738472,ECE 180,A00,083140,Abi Samra; Nicholas Camill,20,0,30,10
1650717738472,ECE 180,B00,083141,Abi Samra; Nicholas Camill,0,0,30,30
1650717744500,MATH 10A,A01,083735,Patchell; Gregory David,2,0,30,28
1650717744500,MATH 10A,A02,083736,Patchell; Gregory David,27,0,30,3
1650717744500,MATH 10A,A03,083737,Patchell; Gregory David,24,0,30,6
1650717750532,MATH 10B,A01,083207,Staff,0,9,30,30
1650717750532,MATH 10B,A02,083208,Staff,1,7,30,29
1650717750532,MATH 10B,B01,083739,Staff,11,0,30,19
1650717750532,MATH 10B,B02,083740,Staff,28,0,30,2
1650717756566,MATH 18,A01,083743,Staff,0,0,30,30
1650717756566,MATH 18,A02,083744,Staff,23,0,30,7
1650717756566,MATH 18,A03,083745,Staff,21,0,30,9
1650717756566,MATH 18,A04,083746,Staff,26,0,30,4
1650717756566,MATH 18,B01,083748,Staff,0,15,30,30
1650717756566,MATH 18,B02,083749,Staff,0,12,30,30
1650717756566,MATH 18,B03,083750,Staff,0,12,30,30
1650717756566,MATH 18,B04,083751,Staff,0,12,30,30
1650717762593,MATH 20A,A01,083754,Staff,19,0,40,21
1650717768618,MATH 20B,A01,083756,Staff,0,11,30,30
1650717768618,MATH 20B,A02,083757,Staff,0,12,30,30
1650717774645,MATH 20C,A01,083760,Staff,0,16,30,30
1650717774645,MATH 20C,A02,083761,Staff,0,16,30,30
1650717774645,MATH 20C,B01,083762,Staff,10,0,30,20
1650717774645,MATH 20C,B02,083763,Staff,28,0,30,2
1650717780671,MATH 20D,A01,083765,Staff,2,1,30,28
1650717780671,MATH 20D,A02,083766,Staff,6,0,30,24
1650717780671,MATH 20D,A03,083767,Staff,24,0,30,6
1650717786700,MATH 20E,A01,083771,Staff,3,0,30,27
1650717786700,MATH 20E,A02,083772,Staff,16,0,30,14
1650717786700,MATH 20E,B01,083773,Staff,0,0,30,30
1650717786700,MATH 20E,B02,083774,Staff,6,0,30,24
1650717792735,MATH 103A,A01,083777,Staff,0,15,30,30
1650717792735,MATH 103A,A02,083778,Staff,0,15,30,30
1650717792735,MATH 103A,B01,083779,Staff,0,15,30,30
1650717792735,MATH 103A,B02,083780,Staff,0,15,30,30
1650717798773,MATH 105,A01,085443,Staff,0,22,30,30
1650717804804,MATH 109,A01,083213,Anzaldo; Leesa B,0,7,30,30
1650717804804,MATH 109,A02,083214,Anzaldo; Leesa B,0,7,30,30
1650717804804,MATH 109,B01,083215,Anzaldo; Leesa B,0,8,30,30
1650717804804,MATH 109,B02,083216,Anzaldo; Leesa B,0,6,30,30
1650717810835,MATH 142A,A01,083219,Chow; Bennett,0,16,30,30
1650717810835,MATH 142A,A02,083220,Chow; Bennett,0,15,30,30
1650717810835,MATH 142A,B01,083221,Chow; Bennett,0,15,30,30
1650717810835,MATH 142A,B02,083222,Chow; Bennett,0,14,30,30
1650717816866,MATH 193A,A01,083224,Staff,0,5,30,30
1650717816866,MATH 193A,A02,083225,Staff,0,6,30,30
1650717816866,MATH 193A,A03,083781,Staff,0,6,30,30
1650717816866,MATH 193A,A04,083782,Staff,0,7,30,30
1650717822903,MATH 197,001,091859,McAuley; Julian John,9998,0,9999,1
1650717828983,COGS 9,A01,083615,Staff,1,15,60,59
1650717835009,COGS 11,A01,083617,Boyle; Mary E. T.,16,0,40,24
1650717841038,COGS 13,A01,083071,Staff,0,38,40,40
1650717847068,COGS 14A,A01,092681,Staff,0,35,100,100
1650717853093,COGS 14B,A01,083073,Cheng; Tzu-Han,1,13,50,49
1650717859122,COGS 17,A01,092677,Staff,13,0,75,62
1650717865150,COGS 100,A01,083619,Staff,0,28,60,60
1650717871183,COGS 101A,A01,083621,Davis; Joshua Daniel,0,27,60,60
1650717877214,COGS 101B,A01,091572,Staff,0,4,60,60
1650717883250,COGS 101C,A01,083625,Delgado; Tania,14,0,30,16
1650717889284,COGS 107A,A01,083627,Boyle; Mary E. T.,0,16,60,60
1650717895317,COGS 118A,A01,083075,Staff,0,8,60,60
1650717901355,CSE 3,A50,083646,Miranda; Gregory Joseph,18,0,38,20
1650717901355,CSE 3,A51,083647,Miranda; Gregory Joseph,36,0,37,1
1650717907380,CSE 8A,A50,083650,Miranda; Gregory Joseph,0,30,40,40
1650717913406,CSE 11,A01,083080,Cao; Yingjun,0,96,40,40
1650717919438,CSE 12,A01,083652,Staff,0,21,100,100
1650717925465,CSE 15L,A01,083654,Staff,0,3,50,50
1650717925465,CSE 15L,A02,083655,Staff,0,2,50,50
1650717931494,CSE 20,A01,083657,Staff,49,0,80,31
1650717937527,CSE 30,A01,083084,Eldon; John,0,77,40,40
1650717943552,CSE 100,A01,083659,Cao; Yingjun,0,70,50,50
1650717949579,CSE 134B,A01,083661,Powell; Thomas Allan,0,38,65,65
1650717955606,CSE 140,A01,083663,Staff,0,11,75,75
1650717961633,CSE 140L,A01,083088,Eldon; John,0,20,75,75
1650717967663,CSE 175,A01,083665,Kumar; Rakesh,7,0,25,18
1650717973693,CSE 190,A00,092507,Dubnov; Shlomo,10,0,20,10
1650717979803,ECE 45,A01,083139,Staff,1,2,60,59
1650717985835,ECE 65,A50,083695,Staff,0,5,30,30
1650717991863,ECE 109,A01,091882,Touri; Behrouz,33,0,70,37
1650717997891,ECE 180,A00,083140,Abi Samra; Nicholas Camill,20,0,30,10
1650717997891,ECE 180,B00,083141,Abi Samra; Nicholas Camill,0,0,30,30
1650718003921,MATH 10A,A01,083735,Patchell; Gregory David,2,0,30,28
1650718003921,MATH 10A,A02,083736,Patchell; Gregory David,27,0,30,3
1650718003921,MATH 10A,A03,083737,Patchell; Gregory David,24,0,30,6
1650718009958,MATH 10B,A01,083207,Staff,0,9,30,30
1650718009958,MATH 10B,A02,083208,Staff,1,7,30,29
1650718009958,MATH 10B,B01,083739,Staff,11,0,30,19
1650718009958,MATH 10B,B02,083740,Staff,28,0,30,2
1650718015987,MATH 18,A01,083743,Staff,0,0,30,30
1650718015987,MATH 18,A02,083744,Staff,23,0,30,7
1650718015987,MATH 18,A03,083745,Staff,21,0,30,9
1650718015987,MATH 18,A04,083746,Staff,26,0,30,4
1650718015987,MATH 18,B01,083748,Staff,0,15,30,30
1650718015987,MATH 18,B02,083749,Staff,0,12,30,30
1650718015987,MATH 18,B03,083750,Staff,0,12,30,30
1650718015987,MATH 18,B04,083751,Staff,0,12,30,30
1650718022017,MATH 20A,A01,083754,Staff,19,0,40,21
1650718028070,MATH 20B,A01,083756,Staff,0,11,30,30
1650718028070,MATH 20B,A02,083757,Staff,0,12,30,30
1650718034100,MATH 20C,A01,083760,Staff,0,16,30,30
1650718034100,MATH 20C,A02,083761,Staff,0,16,30,30
1650718034100,MATH 20C,B01,083762,Staff,10,0,30,20
1650718034100,MATH 20C,B02,083763,Staff,28,0,30,2
1650718040126,MATH 20D,A01,083765,Staff,2,1,30,28
1650718040126,MATH 20D,A02,083766,Staff,6,0,30,24
1650718040126,MATH 20D,A03,083767,Staff,24,0,30,6
1650718046154,MATH 20E,A01,083771,Staff,3,0,30,27
1650718046154,MATH 20E,A02,083772,Staff,16,0,30,14
1650718046154,MATH 20E,B01,083773,Staff,0,0,30,30
1650718046154,MATH 20E,B02,083774,Staff,6,0,30,24
1650718052188,MATH 103A,A01,083777,Staff,0,15,30,30
1650718052188,MATH 103A,A02,083778,Staff,0,15,30,30
1650718052188,MATH 103A,B01,083779,Staff,0,15,30,30
1650718052188,MATH 103A,B02,083780,Staff,0,15,30,30
1650718058215,MATH 105,A01,085443,Staff,0,22,30,30
1650718064254,MATH 109,A01,083213,Anzaldo; Leesa B,0,7,30,30
1650718064254,MATH 109,A02,083214,Anzaldo; Leesa B,0,7,30,30
1650718064254,MATH 109,B01,083215,Anzaldo; Leesa B,0,8,30,30
1650718064254,MATH 109,B02,083216,Anzaldo; Leesa B,0,6,30,30
1650718070288,MATH 142A,A01,083219,Chow; Bennett,0,16,30,30
1650718070288,MATH 142A,A02,083220,Chow; Bennett,0,15,30,30
1650718070288,MATH 142A,B01,083221,Chow; Bennett,0,15,30,30
1650718070288,MATH 142A,B02,083222,Chow; Bennett,0,14,30,30
1650718076315,MATH 193A,A01,083224,Staff,0,5,30,30
1650718076315,MATH 193A,A02,083225,Staff,0,6,30,30
1650718076315,MATH 193A,A03,083781,Staff,0,6,30,30
1650718076315,MATH 193A,A04,083782,Staff,0,7,30,30
1650718082346,MATH 197,001,091859,McAuley; Julian John,9998,0,9999,1
1650718088441,COGS 9,A01,083615,Staff,1,15,60,59
1650718094469,COGS 11,A01,083617,Boyle; Mary E. T.,16,0,40,24
1650718100508,COGS 13,A01,083071,Staff,0,38,40,40
1650718106540,COGS 14A,A01,092681,Staff,0,35,100,100
1650718112566,COGS 14B,A01,083073,Cheng; Tzu-Han,1,13,50,49
1650718118601,COGS 17,A01,092677,Staff,13,0,75,62
1650718124632,COGS 100,A01,083619,Staff,0,28,60,60
1650718130664,COGS 101A,A01,083621,Davis; Joshua Daniel,0,27,60,60
1650718136690,COGS 101B,A01,091572,Staff,0,4,60,60
1650718142717,COGS 101C,A01,083625,Delgado; Tania,14,0,30,16
1650718148744,COGS 107A,A01,083627,Boyle; Mary E. T.,0,16,60,60
1650718154776,COGS 118A,A01,083075,Staff,0,8,60,60
1650718160806,CSE 3,A50,083646,Miranda; Gregory Joseph,18,0,38,20
1650718160806,CSE 3,A51,083647,Miranda; Gregory Joseph,36,0,37,1
1650718166839,CSE 8A,A50,083650,Miranda; Gregory Joseph,0,30,40,40
1650718172868,CSE 11,A01,083080,Cao; Yingjun,0,96,40,40
1650718178896,CSE 12,A01,083652,Staff,0,21,100,100
1650718184925,CSE 15L,A01,083654,Staff,0,3,50,50
1650718184925,CSE 15L,A02,083655,Staff,0,2,50,50
1650718190953,CSE 20,A01,083657,Staff,49,0,80,31
1650718196979,CSE 30,A01,083084,Eldon; John,0,77,40,40
1650718203011,CSE 100,A01,083659,Cao; Yingjun,0,70,50,50
1650718209040,CSE 134B,A01,083661,Powell; Thomas Allan,0,38,65,65
1650718215066,CSE 140,A01,083663,Staff,0,11,75,75
1650718221097,CSE 140L,A01,083088,Eldon; John,0,20,75,75
1650718227125,CSE 175,A01,083665,Kumar; Rakesh,7,0,25,18
1650718233157,CSE 190,A00,092507,Dubnov; Shlomo,10,0,20,10
1650718239185,ECE 45,A01,083139,Staff,1,2,60,59
1650718245212,ECE 65,A50,083695,Staff,0,5,30,30
1650718251240,ECE 109,A01,091882,Touri; Behrouz,33,0,70,37
1650718257267,ECE 180,A00,083140,Abi Samra; Nicholas Camill,20,0,30,10
1650718257267,ECE 180,B00,083141,Abi Samra; Nicholas Camill,0,0,30,30
1650718263305,MATH 10A,A01,083735,Patchell; Gregory David,2,0,30,28
1650718263305,MATH 10A,A02,083736,Patchell; Gregory David,27,0,30,3
1650718263305,MATH 10A,A03,083737,Patchell; Gregory David,24,0,30,6
1650718269338,MATH 10B,A01,083207,Staff,0,9,30,30
1650718269338,MATH 10B,A02,083208,Staff,1,7,30,29
1650718269338,MATH 10B,B01,083739,Staff,11,0,30,19
1650718269338,MATH 10B,B02,083740,Staff,28,0,30,2
1650718275370,MATH 18,A01,083743,Staff,0,0,30,30
1650718275370,MATH 18,A02,083744,Staff,23,0,30,7
1650718275370,MATH 18,A03,083745,Staff,21,0,30,9
1650718275370,MATH 18,A04,083746,Staff,26,0,30,4
1650718275370,MATH 18,B01,083748,Staff,0,15,30,30
1650718275370,MATH 18,B02,083749,Staff,0,12,30,30
1650718275370,MATH 18,B03,083750,Staff,0,12,30,30
1650718275370,MATH 18,B04,083751,Staff,0,12,30,30
1650718281398,MATH 20A,A01,083754,Staff,19,0,40,21
1650718287428,MATH 20B,A01,083756,Staff,0,11,30,30
1650718287428,MATH 20B,A02,083757,Staff,0,12,30,30
1650718293458,MATH 20C,A01,083760,Staff,0,16,30,30
1650718293458,MATH 20C,A02,083761,Staff,0,16,30,30
1650718293458,MATH 20C,B01,083762,Staff,10,0,30,20
1650718293458,MATH 20C,B02,083763,Staff,28,0,30,2
1650718299487,MATH 20D,A01,083765,Staff,2,1,30,28
1650718299487,MATH 20D,A02,083766,Staff,6,0,30,24
1650718299487,MATH 20D,A03,083767,Staff,24,0,30,6
1650718305518,MATH 20E,A01,083771,Staff,3,0,30,27
1650718305518,MATH 20E,A02,083772,Staff,16,0,30,14
1650718305518,MATH 20E,B01,083773,Staff,0,0,30,30
1650718305518,MATH 20E,B02,083774,Staff,6,0,30,24
1650718311543,MATH 103A,A01,083777,Staff,0,15,30,30
1650718311543,MATH 103A,A02,083778,Staff,0,15,30,30
1650718311543,MATH 103A,B01,083779,Staff,0,15,30,30
1650718311543,MATH 103A,B02,083780,Staff,0,15,30,30
1650718317573,MATH 105,A01,085443,Staff,0,22,30,30
1650718323599,MATH 109,A01,083213,Anzaldo; Leesa B,0,7,30,30
1650718323599,MATH 109,A02,083214,Anzaldo; Leesa B,0,7,30,30
1650718323599,MATH 109,B01,083215,Anzaldo; Leesa B,0,8,30,30
1650718323599,MATH 109,B02,083216,Anzaldo; Leesa B,0,6,30,30
1650718329627,MATH 142A,A01,083219,Chow; Bennett,0,16,30,30
1650718329627,MATH 142A,A02,083220,Chow; Bennett,0,15,30,30
1650718329627,MATH 142A,B01,083221,Chow; Bennett,0,15,30,30
1650718329627,MATH 142A,B02,083222,Chow; Bennett,0,14,30,30
1650718335653,MATH 193A,A01,083224,Staff,0,5,30,30
1650718335653,MATH 193A,A02,083225,Staff,0,6,30,30
1650718335653,MATH 193A,A03,083781,Staff,0,6,30,30
1650718335653,MATH 193A,A04,083782,Staff,0,7,30,30
1650718341680,MATH 197,001,091859,McAuley; Julian John,9998,0,9999,1
1650718347758,COGS 9,A01,083615,Staff,1,15,60,59
1650718353790,COGS 11,A01,083617,Boyle; Mary E. T.,16,0,40,24
1650718359819,COGS 13,A01,083071,Staff,0,38,40,40
1650718365849,COGS 14A,A01,092681,Staff,0,35,100,100
1650718371878,COGS 14B,A01,083073,Cheng; Tzu-Han,1,13,50,49
1650718377904,COGS 17,A01,092677,Staff,13,0,75,62
1650718383935,COGS 100,A01,083619,Staff,0,28,60,60
1650718389975,COGS 101A,A01,083621,Davis; Joshua Daniel,0,27,60,60
1650718396001,COGS 101B,A01,091572,Staff,0,4,60,60
1650718402034,COGS 101C,A01,083625,Delgado; Tania,14,0,30,16
1650718408063,COGS 107A,A01,083627,Boyle; Mary E. T.,0,16,60,60
1650718414091,COGS 118A,A01,083075,Staff,0,8,60,60
1650718420122,CSE 3,A50,083646,Miranda; Gregory Joseph,18,0,38,20
1650718420122,CSE 3,A51,083647,Miranda; Gregory Joseph,36,0,37,1
1650718426162,CSE 8A,A50,083650,Miranda; Gregory Joseph,0,30,40,40
1650718432190,CSE 11,A01,083080,Cao; Yingjun,0,96,40,40
1650718438223,CSE 12,A01,083652,Staff,0,21,100,100
1650718444249,CSE 15L,A01,083654,Staff,0,3,50,50
1650718444249,CSE 15L,A02,083655,Staff,0,2,50,50
1650718450278,CSE 20,A01,083657,Staff,49,0,80,31
1650718456315,CSE 30,A01,083084,Eldon; John,0,77,40,40
1650718462344,CSE 100,A01,083659,Cao; Yingjun,0,70,50,50
1650718468370,CSE 134B,A01,083661,Powell; Thomas Allan,0,38,65,65
1650718474397,CSE 140,A01,083663,Staff,0,11,75,75
1650718480424,CSE 140L,A01,083088,Eldon; John,0,20,75,75
1650718486455,CSE 175,A01,083665,Kumar; Rakesh,7,0,25,18
1650718492486,CSE 190,A00,092507,Dubnov; Shlomo,10,0,20,10
1650718498513,ECE 45,A01,083139,Staff,1,2,60,59
1650718504545,ECE 65,A50,083695,Staff,0,5,30,30
1650718510576,ECE 109,A01,091882,Touri; Behrouz,33,0,70,37
1650718516606,ECE 180,A00,083140,Abi Samra; Nicholas Camill,20,0,30,10
1650718516606,ECE 180,B00,083141,Abi Samra; Nicholas Camill,0,0,30,30
1650718522642,MATH 10A,A01,083735,Patchell; Gregory David,2,0,30,28
1650718522642,MATH 10A,A02,083736,Patchell; Gregory David,27,0,30,3
1650718522642,MATH 10A,A03,083737,Patchell; Gregory David,24,0,30,6
1650718528670,MATH 10B,A01,083207,Staff,0,9,30,30
1650718528670,MATH 10B,A02,083208,Staff,1,7,30,29
1650718528670,MATH 10B,B01,083739,Staff,11,0,30,19
1650718528670,MATH 10B,B02,083740,Staff,28,0,30,2
1650718534702,MATH 18,A01,083743,Staff,0,0,30,30
1650718534702,MATH 18,A02,083744,Staff,23,0,30,7
1650718534702,MATH 18,A03,083745,Staff,21,0,30,9
1650718534702,MATH 18,A04,083746,Staff,26,0,30,4
1650718534702,MATH 18,B01,083748,Staff,0,15,30,30
1650718534702,MATH 18,B02,083749,Staff,0,12,30,30
1650718534702,MATH 18,B03,083750,Staff,0,12,30,30
1650718534702,MATH 18,B04,083751,Staff,0,12,30,30
1650718540729,MATH 20A,A01,083754,Staff,19,0,40,21
1650718546758,MATH 20B,A01,083756,Staff,0,11,30,30
1650718546758,MATH 20B,A02,083757,Staff,0,12,30,30
1650718552799,MATH 20C,A01,083760,Staff,0,16,30,30
1650718552799,MATH 20C,A02,083761,Staff,0,16,30,30
1650718552799,MATH 20C,B01,083762,Staff,10,0,30,20
1650718552799,MATH 20C,B02,083763,Staff,28,0,30,2
1650718558830,MATH 20D,A01,083765,Staff,2,1,30,28
1650718558830,MATH 20D,A02,083766,Staff,6,0,30,24
1650718558830,MATH 20D,A03,083767,Staff,24,0,30,6
1650718564857,MATH 20E,A01,083771,Staff,3,0,30,27
1650718564857,MATH 20E,A02,083772,Staff,16,0,30,14
1650718564857,MATH 20E,B01,083773,Staff,0,0,30,30
1650718564857,MATH 20E,B02,083774,Staff,6,0,30,24
1650718570886,MATH 103A,A01,083777,Staff,0,15,30,30
1650718570886,MATH 103A,A02,083778,Staff,0,15,30,30
1650718570886,MATH 103A,B01,083779,Staff,0,15,30,30
1650718570886,MATH 103A,B02,083780,Staff,0,15,30,30
1650718577001,MATH 105,A01,085443,Staff,0,22,30,30
1650718583034,MATH 109,A01,083213,Anzaldo; Leesa B,0,7,30,30
1650718583034,MATH 109,A02,083214,Anzaldo; Leesa B,0,7,30,30
1650718583034,MATH 109,B01,083215,Anzaldo; Leesa B,0,8,30,30
1650718583034,MATH 109,B02,083216,Anzaldo; Leesa B,0,6,30,30
1650718589067,MATH 142A,A01,083219,Chow; Bennett,0,16,30,30
1650718589067,MATH 142A,A02,083220,Chow; Bennett,0,15,30,30
1650718589067,MATH 142A,B01,083221,Chow; Bennett,0,15,30,30
1650718589067,MATH 142A,B02,083222,Chow; Bennett,0,14,30,30
1650718595101,MATH 193A,A01,083224,Staff,0,5,30,30
1650718595101,MATH 193A,A02,083225,Staff,0,6,30,30
1650718595101,MATH 193A,A03,083781,Staff,0,6,30,30
1650718595101,MATH 193A,A04,083782,Staff,0,7,30,30
1650718601129,MATH 197,001,091859,McAuley; Julian John,9998,0,9999,1
1650718607215,COGS 9,A01,083615,Staff,1,15,60,59
1650718613247,COGS 11,A01,083617,Boyle; Mary E. T.,16,0,40,24
1650718619273,COGS 13,A01,083071,Staff,0,38,40,40
1650718625300,COGS 14A,A01,092681,Staff,0,35,100,100
1650718631332,COGS 14B,A01,083073,Cheng; Tzu-Han,1,13,50,49
1650718637358,COGS 17,A01,092677,Staff,13,0,75,62
1650718643389,COGS 100,A01,083619,Staff,0,28,60,60
1650718649421,COGS 101A,A01,083621,Davis; Joshua Daniel,0,27,60,60
1650718655447,COGS 101B,A01,091572,Staff,0,4,60,60
1650718661473,COGS 101C,A01,083625,Delgado; Tania,14,0,30,16
1650718667499,COGS 107A,A01,083627,Boyle; Mary E. T.,0,16,60,60
1650718673524,COGS 118A,A01,083075,Staff,0,8,60,60
1650718679557,CSE 3,A50,083646,Miranda; Gregory Joseph,18,0,38,20
1650718679557,CSE 3,A51,083647,Miranda; Gregory Joseph,36,0,37,1
1650718685587,CSE 8A,A50,083650,Miranda; Gregory Joseph,0,30,40,40
1650718691613,CSE 11,A01,083080,Cao; Yingjun,0,96,40,40
1650718697639,CSE 12,A01,083652,Staff,0,21,100,100
1650718703663,CSE 15L,A01,083654,Staff,0,3,50,50
1650718703663,CSE 15L,A02,083655,Staff,0,2,50,50
1650718709689,CSE 20,A01,083657,Staff,49,0,80,31
1650718715725,CSE 30,A01,083084,Eldon; John,0,77,40,40
1650718721759,CSE 100,A01,083659,Cao; Yingjun,0,70,50,50
1650718727793,CSE 134B,A01,083661,Powell; Thomas Allan,0,38,65,65
1650718733818,CSE 140,A01,083663,Staff,0,11,75,75
1650718739844,CSE 140L,A01,083088,Eldon; John,0,20,75,75
1650718745872,CSE 175,A01,083665,Kumar; Rakesh,7,0,25,18
1650718751903,CSE 190,A00,092507,Dubnov; Shlomo,10,0,20,10
1650718757936,ECE 45,A01,083139,Staff,1,2,60,59
1650718763962,ECE 65,A50,083695,Staff,0,5,30,30
1650718769991,ECE 109,A01,091882,Touri; Behrouz,33,0,70,37
1650718776019,ECE 180,A00,083140,Abi Samra; Nicholas Camill,20,0,30,10
1650718776019,ECE 180,B00,083141,Abi Samra; Nicholas Camill,0,0,30,30
1650718782048,MATH 10A,A01,083735,Patchell; Gregory David,2,0,30,28
1650718782048,MATH 10A,A02,083736,Patchell; Gregory David,27,0,30,3
1650718782048,MATH 10A,A03,083737,Patchell; Gregory David,24,0,30,6
1650718788080,MATH 10B,A01,083207,Staff,0,9,30,30
1650718788080,MATH 10B,A02,083208,Staff,1,7,30,29
1650718788080,MATH 10B,B01,083739,Staff,11,0,30,19
1650718788080,MATH 10B,B02,083740,Staff,28,0,30,2
1650718794118,MATH 18,A01,083743,Staff,0,0,30,30
1650718794118,MATH 18,A02,083744,Staff,23,0,30,7
1650718794118,MATH 18,A03,083745,Staff,21,0,30,9
1650718794118,MATH 18,A04,083746,Staff,26,0,30,4
1650718794118,MATH 18,B01,083748,Staff,0,15,30,30
1650718794118,MATH 18,B02,083749,Staff,0,12,30,30
1650718794118,MATH 18,B03,083750,Staff,0,12,30,30
1650718794118,MATH 18,B04,083751,Staff,0,12,30,30
1650718800148,MATH 20A,A01,083754,Staff,19,0,40,21
1650718806175,MATH 20B,A01,083756,Staff,0,11,30,30
1650718806175,MATH 20B,A02,083757,Staff,0,12,30,30
1650718812200,MATH 20C,A01,083760,Staff,0,16,30,30
1650718812200,MATH 20C,A02,083761,Staff,0,16,30,30
1650718812200,MATH 20C,B01,083762,Staff,10,0,30,20
1650718812200,MATH 20C,B02,083763,Staff,28,0,30,2
1650718818225,MATH 20D,A01,083765,Staff,2,1,30,28
1650718818225,MATH 20D,A02,083766,Staff,6,0,30,24
1650718818225,MATH 20D,A03,083767,Staff,24,0,30,6
1650718824257,MATH 20E,A01,083771,Staff,3,0,30,27
1650718824257,MATH 20E,A02,083772,Staff,16,0,30,14
1650718824257,MATH 20E,B01,083773,Staff,0,0,30,30
1650718824257,MATH 20E,B02,083774,Staff,6,0,30,24
1650718830286,MATH 103A,A01,083777,Staff,0,15,30,30
1650718830286,MATH 103A,A02,083778,Staff,0,15,30,30
1650718830286,MATH 103A,B01,083779,Staff,0,15,30,30
1650718830286,MATH 103A,B02,083780,Staff,0,15,30,30
1650718836316,MATH 105,A01,085443,Staff,0,22,30,30
1650718842344,MATH 109,A01,083213,Anzaldo; Leesa B,0,7,30,30
1650718842344,MATH 109,A02,083214,Anzaldo; Leesa B,0,7,30,30
1650718842344,MATH 109,B01,083215,Anzaldo; Leesa B,0,8,30,30
1650718842344,MATH 109,B02,083216,Anzaldo; Leesa B,0,6,30,30
1650718848372,MATH 142A,A01,083219,Chow; Bennett,0,16,30,30
1650718848372,MATH 142A,A02,083220,Chow; Bennett,0,15,30,30
1650718848372,MATH 142A,B01,083221,Chow; Bennett,0,15,30,30
1650718848372,MATH 142A,B02,083222,Chow; Bennett,0,14,30,30
1650718854404,MATH 193A,A01,083224,Staff,0,5,30,30
1650718854404,MATH 193A,A02,083225,Staff,0,6,30,30
1650718854404,MATH 193A,A03,083781,Staff,0,6,30,30
1650718854404,MATH 193A,A04,083782,Staff,0,7,30,30
1650718860435,MATH 197,001,091859,McAuley; Julian John,9998,0,9999,1
1650718866502,COGS 9,A01,083615,Staff,1,15,60,59
1650718872535,COGS 11,A01,083617,Boyle; Mary E. T.,16,0,40,24
1650718878562,COGS 13,A01,083071,Staff,0,38,40,40
1650718884588,COGS 14A,A01,092681,Staff,0,35,100,100
1650718890620,COGS 14B,A01,083073,Cheng; Tzu-Han,1,13,50,49
1650718896646,COGS 17,A01,092677,Staff,13,0,75,62
1650718902670,COGS 100,A01,083619,Staff,0,28,60,60
1650718908698,COGS 101A,A01,083621,Davis; Joshua Daniel,0,27,60,60
1650718914728,COGS 101B,A01,091572,Staff,0,4,60,60
1650718920757,COGS 101C,A01,083625,Delgado; Tania,14,0,30,16
1650718926792,COGS 107A,A01,083627,Boyle; Mary E. T.,0,16,60,60
1650718932816,COGS 118A,A01,083075,Staff,0,8,60,60
1650718938844,CSE 3,A50,083646,Miranda; Gregory Joseph,18,0,38,20
1650718938844,CSE 3,A51,083647,Miranda; Gregory Joseph,36,0,37,1
1650718944871,CSE 8A,A50,083650,Miranda; Gregory Joseph,0,30,40,40
1650718950899,CSE 11,A01,083080,Cao; Yingjun,0,96,40,40
1650718956927,CSE 12,A01,083652,Staff,0,21,100,100
1650718962951,CSE 15L,A01,083654,Staff,0,3,50,50
1650718962951,CSE 15L,A02,083655,Staff,0,2,50,50
1650718968982,CSE 20,A01,083657,Staff,49,0,80,31
1650718975010,CSE 30,A01,083084,Eldon; John,0,77,40,40
1650718981040,CSE 100,A01,083659,Cao; Yingjun,0,70,50,50
1650718987071,CSE 134B,A01,083661,Powell; Thomas Allan,0,38,65,65
1650718993097,CSE 140,A01,083663,Staff,0,11,75,75
1650718999121,CSE 140L,A01,083088,Eldon; John,0,20,75,75
1650719005157,CSE 175,A01,083665,Kumar; Rakesh,7,0,25,18
1650719011189,CSE 190,A00,092507,Dubnov; Shlomo,10,0,20,10
1650719017218,ECE 45,A01,083139,Staff,1,2,60,59
1650719023243,ECE 65,A50,083695,Staff,0,5,30,30
1650719029271,ECE 109,A01,091882,Touri; Behrouz,33,0,70,37
1650719035298,ECE 180,A00,083140,Abi Samra; Nicholas Camill,20,0,30,10
1650719035298,ECE 180,B00,083141,Abi Samra; Nicholas Camill,0,0,30,30
1650719041334,MATH 10A,A01,083735,Patchell; Gregory David,2,0,30,28
1650719041334,MATH 10A,A02,083736,Patchell; Gregory David,27,0,30,3
1650719041334,MATH 10A,A03,083737,Patchell; Gregory David,24,0,30,6
1650719047362,MATH 10B,A01,083207,Staff,0,9,30,30
1650719047362,MATH 10B,A02,083208,Staff,1,7,30,29
1650719047362,MATH 10B,B01,083739,Staff,11,0,30,19
1650719047362,MATH 10B,B02,083740,Staff,28,0,30,2
1650719053392,MATH 18,A01,083743,Staff,0,0,30,30
1650719053392,MATH 18,A02,083744,Staff,23,0,30,7
1650719053392,MATH 18,A03,083745,Staff,21,0,30,9
1650719053392,MATH 18,A04,083746,Staff,26,0,30,4
1650719053392,MATH 18,B01,083748,Staff,0,15,30,30
1650719053392,MATH 18,B02,083749,Staff,0,12,30,30
1650719053392,MATH 18,B03,083750,Staff,0,12,30,30
1650719053392,MATH 18,B04,083751,Staff,0,12,30,30
1650719059421,MATH 20A,A01,083754,Staff,19,0,40,21
1650719065450,MATH 20B,A01,083756,Staff,0,11,30,30
1650719065450,MATH 20B,A02,083757,Staff,0,12,30,30
1650719071477,MATH 20C,A01,083760,Staff,0,16,30,30
1650719071477,MATH 20C,A02,083761,Staff,0,16,30,30
1650719071477,MATH 20C,B01,083762,Staff,10,0,30,20
1650719071477,MATH 20C,B02,083763,Staff,28,0,30,2
1650719077508,MATH 20D,A01,083765,Staff,2,1,30,28
1650719077508,MATH 20D,A02,083766,Staff,6,0,30,24
1650719077508,MATH 20D,A03,083767,Staff,24,0,30,6
1650719083541,MATH 20E,A01,083771,Staff,3,0,30,27
1650719083541,MATH 20E,A02,083772,Staff,16,0,30,14
1650719083541,MATH 20E,B01,083773,Staff,0,0,30,30
1650719083541,MATH 20E,B02,083774,Staff,6,0,30,24
1650719089570,MATH 103A,A01,083777,Staff,0,15,30,30
1650719089570,MATH 103A,A02,083778,Staff,0,15,30,30
1650719089570,MATH 103A,B01,083779,Staff,0,15,30,30
1650719089570,MATH 103A,B02,083780,Staff,0,15,30,30
1650719095597,MATH 105,A01,085443,Staff,0,22,30,30
1650719101642,MATH 109,A01,083213,Anzaldo; Leesa B,0,7,30,30
1650719101642,MATH 109,A02,083214,Anzaldo; Leesa B,0,7,30,30
1650719101642,MATH 109,B01,083215,Anzaldo; Leesa B,0,8,30,30
1650719101642,MATH 109,B02,083216,Anzaldo; Leesa B,0,6,30,30
1650719107668,MATH 142A,A01,083219,Chow; Bennett,0,16,30,30
1650719107668,MATH 142A,A02,083220,Chow; Bennett,0,15,30,30
1650719107668,MATH 142A,B01,083221,Chow; Bennett,0,15,30,30
1650719107668,MATH 142A,B02,083222,Chow; Bennett,0,14,30,30
1650719113694,MATH 193A,A01,083224,Staff,0,5,30,30
1650719113694,MATH 193A,A02,083225,Staff,0,6,30,30
1650719113694,MATH 193A,A03,083781,Staff,0,6,30,30
1650719113694,MATH 193A,A04,083782,Staff,0,7,30,30
1650719119723,MATH 197,001,091859,McAuley; Julian John,9998,0,9999,1
1650719125785,COGS 9,A01,083615,Staff,1,15,60,59
1650719131812,COGS 11,A01,083617,Boyle; Mary E. T.,16,0,40,24
1650719137836,COGS 13,A01,083071,Staff,0,38,40,40
1650719143869,COGS 14A,A01,092681,Staff,0,35,100,100
1650719149896,COGS 14B,A01,083073,Cheng; Tzu-Han,1,13,50,49
1650719155933,COGS 17,A01,092677,Staff,13,0,75,62
1650719161969,COGS 100,A01,083619,Staff,0,28,60,60
1650719168084,COGS 101A,A01,083621,Davis; Joshua Daniel,0,27,60,60
1650719174114,COGS 101B,A01,091572,Staff,0,4,60,60
1650719180140,COGS 101C,A01,083625,Delgado; Tania,14,0,30,16
1650719186165,COGS 107A,A01,083627,Boyle; Mary E. T.,0,16,60,60
1650719192192,COGS 118A,A01,083075,Staff,0,8,60,60
1650719198218,CSE 3,A50,083646,Miranda; Gregory Joseph,18,0,38,20
1650719198218,CSE 3,A51,083647,Miranda; Gregory Joseph,36,0,37,1
1650719204249,CSE 8A,A50,083650,Miranda; Gregory Joseph,0,30,40,40
1650719210279,CSE 11,A01,083080,Cao; Yingjun,0,96,40,40
1650719216310,CSE 12,A01,083652,Staff,0,21,100,100
1650719222345,CSE 15L,A01,083654,Staff,0,3,50,50
1650719222345,CSE 15L,A02,083655,Staff,0,2,50,50
1650719228370,CSE 20,A01,083657,Staff,49,0,80,31
1650719234395,CSE 30,A01,083084,Eldon; John,0,77,40,40
1650719240430,CSE 100,A01,083659,Cao; Yingjun,0,70,50,50
1650719246457,CSE 134B,A01,083661,Powell; Thomas Allan,0,38,65,65
1650719252483,CSE 140,A01,083663,Staff,0,11,75,75
1650719258514,CSE 140L,A01,083088,Eldon; John,0,20,75,75
1650719264541,CSE 175,A01,083665,Kumar; Rakesh,7,0,25,18
1650719270568,CSE 190,A00,092507,Dubnov; Shlomo,10,0,20,10
1650719276602,ECE 45,A01,083139,Staff,1,2,60,59
1650719282632,ECE 65,A50,083695,Staff,0,5,30,30
1650719288658,ECE 109,A01,091882,Touri; Behrouz,33,0,70,37
1650719294684,ECE 180,A00,083140,Abi Samra; Nicholas Camill,20,0,30,10
1650719294684,ECE 180,B00,083141,Abi Samra; Nicholas Camill,0,0,30,30
1650719300716,MATH 10A,A01,083735,Patchell; Gregory David,2,0,30,28
1650719300716,MATH 10A,A02,083736,Patchell; Gregory David,27,0,30,3
1650719300716,MATH 10A,A03,083737,Patchell; Gregory David,24,0,30,6
1650719306743,MATH 10B,A01,083207,Staff,0,9,30,30
1650719306743,MATH 10B,A02,083208,Staff,1,7,30,29
1650719306743,MATH 10B,B01,083739,Staff,11,0,30,19
1650719306743,MATH 10B,B02,083740,Staff,28,0,30,2
1650719312780,MATH 18,A01,083743,Staff,0,0,30,30
1650719312780,MATH 18,A02,083744,Staff,23,0,30,7
1650719312780,MATH 18,A03,083745,Staff,21,0,30,9
1650719312780,MATH 18,A04,083746,Staff,26,0,30,4
1650719312780,MATH 18,B01,083748,Staff,0,15,30,30
1650719312780,MATH 18,B02,083749,Staff,0,12,30,30
1650719312780,MATH 18,B03,083750,Staff,0,12,30,30
1650719312780,MATH 18,B04,083751,Staff,0,12,30,30
1650719318808,MATH 20A,A01,083754,Staff,19,0,40,21
1650719324838,MATH 20B,A01,083756,Staff,0,11,30,30
1650719324838,MATH 20B,A02,083757,Staff,0,12,30,30
1650719330866,MATH 20C,A01,083760,Staff,0,16,30,30
1650719330866,MATH 20C,A02,083761,Staff,0,16,30,30
1650719330866,MATH 20C,B01,083762,Staff,10,0,30,20
1650719330866,MATH 20C,B02,083763,Staff,28,0,30,2
1650719336896,MATH 20D,A01,083765,Staff,2,1,30,28
1650719336896,MATH 20D,A02,083766,Staff,6,0,30,24
1650719336896,MATH 20D,A03,083767,Staff,24,0,30,6
1650719342932,MATH 20E,A01,083771,Staff,3,0,30,27
1650719342932,MATH 20E,A02,083772,Staff,16,0,30,14
1650719342932,MATH 20E,B01,083773,Staff,0,0,30,30
1650719342932,MATH 20E,B02,083774,Staff,6,0,30,24
1650719348966,MATH 103A,A01,083777,Staff,0,15,30,30
1650719348966,MATH 103A,A02,083778,Staff,0,15,30,30
1650719348966,MATH 103A,B01,083779,Staff,0,15,30,30
1650719348966,MATH 103A,B02,083780,Staff,0,15,30,30
1650719354996,MATH 105,A01,085443,Staff,0,22,30,30
1650719361025,MATH 109,A01,083213,Anzaldo; Leesa B,0,7,30,30
1650719361025,MATH 109,A02,083214,Anzaldo; Leesa B,0,7,30,30
1650719361025,MATH 109,B01,083215,Anzaldo; Leesa B,0,8,30,30
1650719361025,MATH 109,B02,083216,Anzaldo; Leesa B,0,6,30,30
1650719367052,MATH 142A,A01,083219,Chow; Bennett,0,16,30,30
1650719367052,MATH 142A,A02,083220,Chow; Bennett,0,15,30,30
1650719367052,MATH 142A,B01,083221,Chow; Bennett,0,15,30,30
1650719367052,MATH 142A,B02,083222,Chow; Bennett,0,14,30,30
1650719373080,MATH 193A,A01,083224,Staff,0,5,30,30
1650719373080,MATH 193A,A02,083225,Staff,0,6,30,30
1650719373080,MATH 193A,A03,083781,Staff,0,6,30,30
1650719373080,MATH 193A,A04,083782,Staff,0,7,30,30
1650719379105,MATH 197,001,091859,McAuley; Julian John,9998,0,9999,1
1650719385179,COGS 9,A01,083615,Staff,1,15,60,59
1650719391225,COGS 11,A01,083617,Boyle; Mary E. T.,16,0,40,24
1650719397251,COGS 13,A01,083071,Staff,0,38,40,40
1650719403277,COGS 14A,A01,092681,Staff,0,35,100,100
1650719409306,COGS 14B,A01,083073,Cheng; Tzu-Han,1,13,50,49
1650719415334,COGS 17,A01,092677,Staff,13,0,75,62
1650719421362,COGS 100,A01,083619,Staff,0,28,60,60
1650719427390,COGS 101A,A01,083621,Davis; Joshua Daniel,0,27,60,60
1650719433419,COGS 101B,A01,091572,Staff,0,4,60,60
1650719439443,COGS 101C,A01,083625,Delgado; Tania,14,0,30,16
1650719445469,COGS 107A,A01,083627,Boyle; Mary E. T.,0,16,60,60
1650719451494,COGS 118A,A01,083075,Staff,0,8,60,60
1650719457521,CSE 3,A50,083646,Miranda; Gregory Joseph,18,0,38,20
1650719457521,CSE 3,A51,083647,Miranda; Gregory Joseph,36,0,37,1
1650719463546,CSE 8A,A50,083650,Miranda; Gregory Joseph,0,30,40,40
1650719469575,CSE 11,A01,083080,Cao; Yingjun,0,96,40,40
1650719475600,CSE 12,A01,083652,Staff,0,21,100,100
1650719481637,CSE 15L,A01,083654,Staff,0,3,50,50
1650719481637,CSE 15L,A02,083655,Staff,0,2,50,50
1650719487669,CSE 20,A01,083657,Staff,49,0,80,31
1650719493699,CSE 30,A01,083084,Eldon; John,0,77,40,40
1650719499730,CSE 100,A01,083659,Cao; Yingjun,0,70,50,50
1650719505754,CSE 134B,A01,083661,Powell; Thomas Allan,0,38,65,65
1650719511779,CSE 140,A01,083663,Staff,0,11,75,75
1650719517802,CSE 140L,A01,083088,Eldon; John,0,20,75,75
1650719523829,CSE 175,A01,083665,Kumar; Rakesh,7,0,25,18
1650719529865,CSE 190,A00,092507,Dubnov; Shlomo,10,0,20,10
1650719535892,ECE 45,A01,083139,Staff,1,2,60,59
1650719541922,ECE 65,A50,083695,Staff,0,5,30,30
1650719547952,ECE 109,A01,091882,Touri; Behrouz,33,0,70,37
1650719553978,ECE 180,A00,083140,Abi Samra; Nicholas Camill,20,0,30,10
1650719553978,ECE 180,B00,083141,Abi Samra; Nicholas Camill,0,0,30,30
1650719560007,MATH 10A,A01,083735,Patchell; Gregory David,2,0,30,28
1650719560007,MATH 10A,A02,083736,Patchell; Gregory David,27,0,30,3
1650719560007,MATH 10A,A03,083737,Patchell; Gregory David,24,0,30,6
1650719566034,MATH 10B,A01,083207,Staff,0,9,30,30
1650719566034,MATH 10B,A02,083208,Staff,1,7,30,29
1650719566034,MATH 10B,B01,083739,Staff,11,0,30,19
1650719566034,MATH 10B,B02,083740,Staff,28,0,30,2
1650719572070,MATH 18,A01,083743,Staff,0,0,30,30
1650719572070,MATH 18,A02,083744,Staff,23,0,30,7
1650719572070,MATH 18,A03,083745,Staff,21,0,30,9
1650719572070,MATH 18,A04,083746,Staff,26,0,30,4
1650719572070,MATH 18,B01,083748,Staff,0,15,30,30
1650719572070,MATH 18,B02,083749,Staff,0,12,30,30
1650719572070,MATH 18,B03,083750,Staff,0,12,30,30
1650719572070,MATH 18,B04,083751,Staff,0,12,30,30
1650719578097,MATH 20A,A01,083754,Staff,19,0,40,21
1650719584133,MATH 20B,A01,083756,Staff,0,11,30,30
1650719584133,MATH 20B,A02,083757,Staff,0,12,30,30
1650719590161,MATH 20C,A01,083760,Staff,0,16,30,30
1650719590161,MATH 20C,A02,083761,Staff,0,16,30,30
1650719590161,MATH 20C,B01,083762,Staff,10,0,30,20
1650719590161,MATH 20C,B02,083763,Staff,28,0,30,2
1650719596192,MATH 20D,A01,083765,Staff,2,1,30,28
1650719596192,MATH 20D,A02,083766,Staff,6,0,30,24
1650719596192,MATH 20D,A03,083767,Staff,24,0,30,6
1650719602216,MATH 20E,A01,083771,Staff,3,0,30,27
1650719602216,MATH 20E,A02,083772,Staff,16,0,30,14
1650719602216,MATH 20E,B01,083773,Staff,0,0,30,30
1650719602216,MATH 20E,B02,083774,Staff,6,0,30,24
1650719608243,MATH 103A,A01,083777,Staff,0,15,30,30
1650719608243,MATH 103A,A02,083778,Staff,0,15,30,30
1650719608243,MATH 103A,B01,083779,Staff,0,15,30,30
1650719608243,MATH 103A,B02,083780,Staff,0,15,30,30
1650719614272,MATH 105,A01,085443,Staff,0,22,30,30
1650719620299,MATH 109,A01,083213,Anzaldo; Leesa B,0,7,30,30
1650719620299,MATH 109,A02,083214,Anzaldo; Leesa B,0,7,30,30
1650719620299,MATH 109,B01,083215,Anzaldo; Leesa B,0,8,30,30
1650719620299,MATH 109,B02,083216,Anzaldo; Leesa B,0,6,30,30
1650719626337,MATH 142A,A01,083219,Chow; Bennett,0,16,30,30
1650719626337,MATH 142A,A02,083220,Chow; Bennett,0,15,30,30
1650719626337,MATH 142A,B01,083221,Chow; Bennett,0,15,30,30
1650719626337,MATH 142A,B02,083222,Chow; Bennett,0,14,30,30
1650719632364,MATH 193A,A01,083224,Staff,0,5,30,30
1650719632364,MATH 193A,A02,083225,Staff,0,6,30,30
1650719632364,MATH 193A,A03,083781,Staff,0,6,30,30
1650719632364,MATH 193A,A04,083782,Staff,0,7,30,30
1650719638390,MATH 197,001,091859,McAuley; Julian John,9998,0,9999,1
1650719644451,COGS 9,A01,083615,Staff,1,15,60,59
1650719650482,COGS 11,A01,083617,Boyle; Mary E. T.,16,0,40,24
1650719656513,COGS 13,A01,083071,Staff,0,38,40,40
1650719662540,COGS 14A,A01,092681,Staff,0,35,100,100
1650719668570,COGS 14B,A01,083073,Cheng; Tzu-Han,1,13,50,49
1650719674597,COGS 17,A01,092677,Staff,13,0,75,62
1650719680622,COGS 100,A01,083619,Staff,0,28,60,60
1650719686650,COGS 101A,A01,083621,Davis; Joshua Daniel,0,27,60,60
1650719692681,COGS 101B,A01,091572,Staff,0,4,60,60
1650719698715,COGS 101C,A01,083625,Delgado; Tania,14,0,30,16
1650719704745,COGS 107A,A01,083627,Boyle; Mary E. T.,0,16,60,60
1650719710769,COGS 118A,A01,083075,Staff,0,8,60,60
1650719716796,CSE 3,A50,083646,Miranda; Gregory Joseph,18,0,38,20
1650719716796,CSE 3,A51,083647,Miranda; Gregory Joseph,36,0,37,1
1650719722820,CSE 8A,A50,083650,Miranda; Gregory Joseph,0,30,40,40
1650719728845,CSE 11,A01,083080,Cao; Yingjun,0,96,40,40
1650719734869,CSE 12,A01,083652,Staff,0,21,100,100
1650719740895,CSE 15L,A01,083654,Staff,0,3,50,50
1650719740895,CSE 15L,A02,083655,Staff,0,2,50,50
1650719746924,CSE 20,A01,083657,Staff,49,0,80,31
1650719752950,CSE 30,A01,083084,Eldon; John,0,77,40,40
1650719758976,CSE 100,A01,083659,Cao; Yingjun,0,70,50,50
1650719765082,CSE 134B,A01,083661,Powell; Thomas Allan,0,38,65,65
1650719771109,CSE 140,A01,083663,Staff,0,11,75,75
1650719777139,CSE 140L,A01,083088,Eldon; John,0,20,75,75
1650719783166,CSE 175,A01,083665,Kumar; Rakesh,7,0,25,18
1650719789193,CSE 190,A00,092507,Dubnov; Shlomo,10,0,20,10
1650719795225,ECE 45,A01,083139,Staff,1,2,60,59
1650719801257,ECE 65,A50,083695,Staff,0,5,30,30
1650719807290,ECE 109,A01,091882,Touri; Behrouz,33,0,70,37
1650719813334,ECE 180,A00,083140,Abi Samra; Nicholas Camill,20,0,30,10
1650719813334,ECE 180,B00,083141,Abi Samra; Nicholas Camill,0,0,30,30
1650719819365,MATH 10A,A01,083735,Patchell; Gregory David,2,0,30,28
1650719819365,MATH 10A,A02,083736,Patchell; Gregory David,27,0,30,3
1650719819365,MATH 10A,A03,083737,Patchell; Gregory David,24,0,30,6
1650719825400,MATH 10B,A01,083207,Staff,0,9,30,30
1650719825400,MATH 10B,A02,083208,Staff,1,7,30,29
1650719825400,MATH 10B,B01,083739,Staff,11,0,30,19
1650719825400,MATH 10B,B02,083740,Staff,28,0,30,2
1650719831429,MATH 18,A01,083743,Staff,0,0,30,30
1650719831429,MATH 18,A02,083744,Staff,23,0,30,7
1650719831429,MATH 18,A03,083745,Staff,21,0,30,9
1650719831429,MATH 18,A04,083746,Staff,26,0,30,4
1650719831429,MATH 18,B01,083748,Staff,0,15,30,30
1650719831429,MATH 18,B02,083749,Staff,0,12,30,30
1650719831429,MATH 18,B03,083750,Staff,0,12,30,30
1650719831429,MATH 18,B04,083751,Staff,0,12,30,30
1650719837458,MATH 20A,A01,083754,Staff,19,0,40,21
1650719843492,MATH 20B,A01,083756,Staff,0,11,30,30
1650719843492,MATH 20B,A02,083757,Staff,0,12,30,30
1650719849530,MATH 20C,A01,083760,Staff,0,16,30,30
1650719849530,MATH 20C,A02,083761,Staff,0,16,30,30
1650719849530,MATH 20C,B01,083762,Staff,10,0,30,20
1650719849530,MATH 20C,B02,083763,Staff,28,0,30,2
1650719855561,MATH 20D,A01,083765,Staff,2,1,30,28
1650719855561,MATH 20D,A02,083766,Staff,6,0,30,24
1650719855561,MATH 20D,A03,083767,Staff,24,0,30,6
1650719861590,MATH 20E,A01,083771,Staff,3,0,30,27
1650719861590,MATH 20E,A02,083772,Staff,16,0,30,14
1650719861590,MATH 20E,B01,083773,Staff,0,0,30,30
1650719861590,MATH 20E,B02,083774,Staff,6,0,30,24
1650719867621,MATH 103A,A01,083777,Staff,0,15,30,30
1650719867621,MATH 103A,A02,083778,Staff,0,15,30,30
1650719867621,MATH 103A,B01,083779,Staff,0,15,30,30
1650719867621,MATH 103A,B02,083780,Staff,0,15,30,30
1650719873654,MATH 105,A01,085443,Staff,0,22,30,30
1650719879688,MATH 109,A01,083213,Anzaldo; Leesa B,0,7,30,30
1650719879688,MATH 109,A02,083214,Anzaldo; Leesa B,0,7,30,30
1650719879688,MATH 109,B01,083215,Anzaldo; Leesa B,0,8,30,30
1650719879688,MATH 109,B02,083216,Anzaldo; Leesa B,0,6,30,30
1650719885718,MATH 142A,A01,083219,Chow; Bennett,0,16,30,30
1650719885718,MATH 142A,A02,083220,Chow; Bennett,0,15,30,30
1650719885718,MATH 142A,B01,083221,Chow; Bennett,0,15,30,30
1650719885718,MATH 142A,B02,083222,Chow; Bennett,0,14,30,30
1650719891745,MATH 193A,A01,083224,Staff,0,5,30,30
1650719891745,MATH 193A,A02,083225,Staff,0,6,30,30
1650719891745,MATH 193A,A03,083781,Staff,0,6,30,30
1650719891745,MATH 193A,A04,083782,Staff,0,7,30,30
1650719897777,MATH 197,001,091859,McAuley; Julian John,9998,0,9999,1
1650719903855,COGS 9,A01,083615,Staff,1,15,60,59
1650719909884,COGS 11,A01,083617,Boyle; Mary E. T.,16,0,40,24
1650719915913,COGS 13,A01,083071,Staff,0,38,40,40
1650719921940,COGS 14A,A01,092681,Staff,0,35,100,100
1650719927967,COGS 14B,A01,083073,Cheng; Tzu-Han,1,13,50,49
1650719933992,COGS 17,A01,092677,Staff,13,0,75,62
1650719940026,COGS 100,A01,083619,Staff,0,28,60,60
1650719946058,COGS 101A,A01,083621,Davis; Joshua Daniel,0,27,60,60
1650719952089,COGS 101B,A01,091572,Staff,0,4,60,60
1650719958122,COGS 101C,A01,083625,Delgado; Tania,14,0,30,16
1650719964149,COGS 107A,A01,083627,Boyle; Mary E. T.,0,16,60,60
1650719970180,COGS 118A,A01,083075,Staff,0,8,60,60
1650719976207,CSE 3,A50,083646,Miranda; Gregory Joseph,18,0,38,20
1650719976207,CSE 3,A51,083647,Miranda; Gregory Joseph,36,0,37,1
1650719982245,CSE 8A,A50,083650,Miranda; Gregory Joseph,0,30,40,40
1650719988275,CSE 11,A01,083080,Cao; Yingjun,0,96,40,40
1650719994302,CSE 12,A01,083652,Staff,0,21,100,100
1650720000331,CSE 15L,A01,083654,Staff,0,3,50,50
1650720000331,CSE 15L,A02,083655,Staff,0,2,50,50
1650720006364,CSE 20,A01,083657,Staff,49,0,80,31
1650720012395,CSE 30,A01,083084,Eldon; John,0,77,40,40
1650720018422,CSE 100,A01,083659,Cao; Yingjun,0,70,50,50
1650720024446,CSE 134B,A01,083661,Powell; Thomas Allan,0,38,65,65
1650720030471,CSE 140,A01,083663,Staff,0,11,75,75
1650720036497,CSE 140L,A01,083088,Eldon; John,0,20,75,75
1650720042524,CSE 175,A01,083665,Kumar; Rakesh,7,0,25,18
1650720048555,CSE 190,A00,092507,Dubnov; Shlomo,10,0,20,10
1650720054583,ECE 45,A01,083139,Staff,1,2,60,59
1650720060609,ECE 65,A50,083695,Staff,0,5,30,30
1650720066634,ECE 109,A01,091882,Touri; Behrouz,33,0,70,37
1650720072661,ECE 180,A00,083140,Abi Samra; Nicholas Camill,20,0,30,10
1650720072661,ECE 180,B00,083141,Abi Samra; Nicholas Camill,0,0,30,30
1650720078689,MATH 10A,A01,083735,Patchell; Gregory David,2,0,30,28
1650720078689,MATH 10A,A02,083736,Patchell; Gregory David,27,0,30,3
1650720078689,MATH 10A,A03,083737,Patchell; Gregory David,24,0,30,6
1650720084721,MATH 10B,A01,083207,Staff,0,9,30,30
1650720084721,MATH 10B,A02,083208,Staff,1,7,30,29
1650720084721,MATH 10B,B01,083739,Staff,11,0,30,19
1650720084721,MATH 10B,B02,083740,Staff,28,0,30,2
1650720090749,MATH 18,A01,083743,Staff,0,0,30,30
1650720090749,MATH 18,A02,083744,Staff,23,0,30,7
1650720090749,MATH 18,A03,083745,Staff,21,0,30,9
1650720090749,MATH 18,A04,083746,Staff,26,0,30,4
1650720090749,MATH 18,B01,083748,Staff,0,15,30,30
1650720090749,MATH 18,B02,083749,Staff,0,12,30,30
1650720090749,MATH 18,B03,083750,Staff,0,12,30,30
1650720090749,MATH 18,B04,083751,Staff,0,12,30,30
1650720096773,MATH 20A,A01,083754,Staff,19,0,40,21
1650720102798,MATH 20B,A01,083756,Staff,0,11,30,30
1650720102798,MATH 20B,A02,083757,Staff,0,12,30,30
1650720108826,MATH 20C,A01,083760,Staff,0,16,30,30
1650720108826,MATH 20C,A02,083761,Staff,0,16,30,30
1650720108826,MATH 20C,B01,083762,Staff,10,0,30,20
1650720108826,MATH 20C,B02,083763,Staff,28,0,30,2
1650720114855,MATH 20D,A01,083765,Staff,2,1,30,28
1650720114855,MATH 20D,A02,083766,Staff,6,0,30,24
1650720114855,MATH 20D,A03,083767,Staff,24,0,30,6
1650720120882,MATH 20E,A01,083771,Staff,3,0,30,27
1650720120882,MATH 20E,A02,083772,Staff,16,0,30,14
1650720120882,MATH 20E,B01,083773,Staff,0,0,30,30
1650720120882,MATH 20E,B02,083774,Staff,6,0,30,24
1650720126912,MATH 103A,A01,083777,Staff,0,15,30,30
1650720126912,MATH 103A,A02,083778,Staff,0,15,30,30
1650720126912,MATH 103A,B01,083779,Staff,0,15,30,30
1650720126912,MATH 103A,B02,083780,Staff,0,15,30,30
1650720132940,MATH 105,A01,085443,Staff,0,22,30,30
1650720138967,MATH 109,A01,083213,Anzaldo; Leesa B,0,7,30,30
1650720138967,MATH 109,A02,083214,Anzaldo; Leesa B,0,7,30,30
1650720138967,MATH 109,B01,083215,Anzaldo; Leesa B,0,8,30,30
1650720138967,MATH 109,B02,083216,Anzaldo; Leesa B,0,6,30,30
1650720144996,MATH 142A,A01,083219,Chow; Bennett,0,16,30,30
1650720144996,MATH 142A,A02,083220,Chow; Bennett,0,15,30,30
1650720144996,MATH 142A,B01,083221,Chow; Bennett,0,15,30,30
1650720144996,MATH 142A,B02,083222,Chow; Bennett,0,14,30,30
1650720151022,MATH 193A,A01,083224,Staff,0,5,30,30
1650720151022,MATH 193A,A02,083225,Staff,0,6,30,30
1650720151022,MATH 193A,A03,083781,Staff,0,6,30,30
1650720151022,MATH 193A,A04,083782,Staff,0,7,30,30
1650720157048,MATH 197,001,091859,McAuley; Julian John,9998,0,9999,1
1650720163126,COGS 9,A01,083615,Staff,1,15,60,59
1650720169149,COGS 11,A01,083617,Boyle; Mary E. T.,16,0,40,24
1650720175182,COGS 13,A01,083071,Staff,0,38,40,40
1650720181207,COGS 14A,A01,092681,Staff,0,35,100,100
1650720187237,COGS 14B,A01,083073,Cheng; Tzu-Han,1,13,50,49
1650720193263,COGS 17,A01,092677,Staff,13,0,75,62
1650720199290,COGS 100,A01,083619,Staff,0,28,60,60
1650720205315,COGS 101A,A01,083621,Davis; Joshua Daniel,0,27,60,60
1650720211346,COGS 101B,A01,091572,Staff,0,4,60,60
1650720217373,COGS 101C,A01,083625,Delgado; Tania,14,0,30,16
1650720223401,COGS 107A,A01,083627,Boyle; Mary E. T.,0,16,60,60
1650720229429,COGS 118A,A01,083075,Staff,0,8,60,60
1650720235455,CSE 3,A50,083646,Miranda; Gregory Joseph,18,0,38,20
1650720235455,CSE 3,A51,083647,Miranda; Gregory Joseph,36,0,37,1
1650720241486,CSE 8A,A50,083650,Miranda; Gregory Joseph,0,30,40,40
1650720247511,CSE 11,A01,083080,Cao; Yingjun,0,96,40,40
1650720253535,CSE 12,A01,083652,Staff,0,21,100,100
1650720259563,CSE 15L,A01,083654,Staff,0,3,50,50
1650720259563,CSE 15L,A02,083655,Staff,0,2,50,50
1650720265589,CSE 20,A01,083657,Staff,49,0,80,31
1650720271614,CSE 30,A01,083084,Eldon; John,0,77,40,40
1650720277646,CSE 100,A01,083659,Cao; Yingjun,0,70,50,50
1650720283704,CSE 134B,A01,083661,Powell; Thomas Allan,0,38,65,65
1650720289733,CSE 140,A01,083663,Staff,0,11,75,75
1650720295761,CSE 140L,A01,083088,Eldon; John,0,20,75,75
1650720301790,CSE 175,A01,083665,Kumar; Rakesh,7,0,25,18
1650720307820,CSE 190,A00,092507,Dubnov; Shlomo,10,0,20,10
1650720313846,ECE 45,A01,083139,Staff,1,2,60,59
1650720319877,ECE 65,A50,083695,Staff,0,5,30,30
1650720325907,ECE 109,A01,091882,Touri; Behrouz,33,0,70,37
1650720331932,ECE 180,A00,083140,Abi Samra; Nicholas Camill,20,0,30,10
1650720331932,ECE 180,B00,083141,Abi Samra; Nicholas Camill,0,0,30,30
1650720337960,MATH 10A,A01,083735,Patchell; Gregory David,2,0,30,28
1650720337960,MATH 10A,A02,083736,Patchell; Gregory David,27,0,30,3
1650720337960,MATH 10A,A03,083737,Patchell; Gregory David,24,0,30,6
1650720343985,MATH 10B,A01,083207,Staff,0,9,30,30
1650720343985,MATH 10B,A02,083208,Staff,1,7,30,29
1650720343985,MATH 10B,B01,083739,Staff,11,0,30,19
1650720343985,MATH 10B,B02,083740,Staff,28,0,30,2
1650720350018,MATH 18,A01,083743,Staff,0,0,30,30
1650720350018,MATH 18,A02,083744,Staff,23,0,30,7
1650720350018,MATH 18,A03,083745,Staff,21,0,30,9
1650720350018,MATH 18,A04,083746,Staff,26,0,30,4
1650720350018,MATH 18,B01,083748,Staff,0,15,30,30
1650720350018,MATH 18,B02,083749,Staff,0,12,30,30
1650720350018,MATH 18,B03,083750,Staff,0,12,30,30
1650720350018,MATH 18,B04,083751,Staff,0,12,30,30
1650720356042,MATH 20A,A01,083754,Staff,19,0,40,21
1650720362141,MATH 20B,A01,083756,Staff,0,11,30,30
1650720362141,MATH 20B,A02,083757,Staff,0,12,30,30
1650720368169,MATH 20C,A01,083760,Staff,0,16,30,30
1650720368169,MATH 20C,A02,083761,Staff,0,16,30,30
1650720368169,MATH 20C,B01,083762,Staff,10,0,30,20
1650720368169,MATH 20C,B02,083763,Staff,28,0,30,2
1650720374194,MATH 20D,A01,083765,Staff,2,1,30,28
1650720374194,MATH 20D,A02,083766,Staff,6,0,30,24
1650720374194,MATH 20D,A03,083767,Staff,24,0,30,6
1650720380225,MATH 20E,A01,083771,Staff,3,0,30,27
1650720380225,MATH 20E,A02,083772,Staff,16,0,30,14
1650720380225,MATH 20E,B01,083773,Staff,0,0,30,30
1650720380225,MATH 20E,B02,083774,Staff,6,0,30,24
1650720386251,MATH 103A,A01,083777,Staff,0,15,30,30
1650720386251,MATH 103A,A02,083778,Staff,0,15,30,30
1650720386251,MATH 103A,B01,083779,Staff,0,15,30,30
1650720386251,MATH 103A,B02,083780,Staff,0,15,30,30
1650720392279,MATH 105,A01,085443,Staff,0,22,30,30
1650720398310,MATH 109,A01,083213,Anzaldo; Leesa B,0,7,30,30
1650720398310,MATH 109,A02,083214,Anzaldo; Leesa B,0,7,30,30
1650720398310,MATH 109,B01,083215,Anzaldo; Leesa B,0,8,30,30
1650720398310,MATH 109,B02,083216,Anzaldo; Leesa B,0,6,30,30
1650720404335,MATH 142A,A01,083219,Chow; Bennett,0,16,30,30
1650720404335,MATH 142A,A02,083220,Chow; Bennett,0,15,30,30
1650720404335,MATH 142A,B01,083221,Chow; Bennett,0,15,30,30
1650720404335,MATH 142A,B02,083222,Chow; Bennett,0,14,30,30
1650720410360,MATH 193A,A01,083224,Staff,0,5,30,30
1650720410360,MATH 193A,A02,083225,Staff,0,6,30,30
1650720410360,MATH 193A,A03,083781,Staff,0,6,30,30
1650720410360,MATH 193A,A04,083782,Staff,0,7,30,30
1650720416385,MATH 197,001,091859,McAuley; Julian John,9998,0,9999,1
1650720422451,COGS 9,A01,083615,Staff,1,15,60,59
1650720428480,COGS 11,A01,083617,Boyle; Mary E. T.,16,0,40,24
1650720434508,COGS 13,A01,083071,Staff,0,38,40,40
1650720440533,COGS 14A,A01,092681,Staff,0,35,100,100
1650720446559,COGS 14B,A01,083073,Cheng; Tzu-Han,1,13,50,49
1650720452585,COGS 17,A01,092677,Staff,13,0,75,62
1650720458611,COGS 100,A01,083619,Staff,0,28,60,60
1650720464641,COGS 101A,A01,083621,Davis; Joshua Daniel,0,27,60,60
1650720470669,COGS 101B,A01,091572,Staff,0,4,60,60
1650720476700,COGS 101C,A01,083625,Delgado; Tania,14,0,30,16
1650720482736,COGS 107A,A01,083627,Boyle; Mary E. T.,0,16,60,60
1650720488761,COGS 118A,A01,083075,Staff,0,8,60,60
1650720494787,CSE 3,A50,083646,Miranda; Gregory Joseph,18,0,38,20
1650720494787,CSE 3,A51,083647,Miranda; Gregory Joseph,36,0,37,1
1650720500817,CSE 8A,A50,083650,Miranda; Gregory Joseph,0,30,40,40
1650720506845,CSE 11,A01,083080,Cao; Yingjun,0,96,40,40
1650720512870,CSE 12,A01,083652,Staff,0,21,100,100
1650720518899,CSE 15L,A01,083654,Staff,0,3,50,50
1650720518899,CSE 15L,A02,083655,Staff,0,2,50,50
1650720524925,CSE 20,A01,083657,Staff,49,0,80,31
1650720530950,CSE 30,A01,083084,Eldon; John,0,77,40,40
1650720536980,CSE 100,A01,083659,Cao; Yingjun,0,70,50,50
1650720543011,CSE 134B,A01,083661,Powell; Thomas Allan,0,38,65,65
1650720549036,CSE 140,A01,083663,Staff,0,11,75,75
1650720555060,CSE 140L,A01,083088,Eldon; John,0,20,75,75
1650720561089,CSE 175,A01,083665,Kumar; Rakesh,7,0,25,18
1650720567116,CSE 190,A00,092507,Dubnov; Shlomo,10,0,20,10
1650720573142,ECE 45,A01,083139,Staff,1,2,60,59
1650720579166,ECE 65,A50,083695,Staff,0,5,30,30
1650720585191,ECE 109,A01,091882,Touri; Behrouz,33,0,70,37
1650720591218,ECE 180,A00,083140,Abi Samra; Nicholas Camill,20,0,30,10
1650720591218,ECE 180,B00,083141,Abi Samra; Nicholas Camill,0,0,30,30
1650720597244,MATH 10A,A01,083735,Patchell; Gregory David,2,0,30,28
1650720597244,MATH 10A,A02,083736,Patchell; Gregory David,27,0,30,3
1650720597244,MATH 10A,A03,083737,Patchell; Gregory David,24,0,30,6
1650720603271,MATH 10B,A01,083207,Staff,0,9,30,30
1650720603271,MATH 10B,A02,083208,Staff,1,7,30,29
1650720603271,MATH 10B,B01,083739,Staff,11,0,30,19
1650720603271,MATH 10B,B02,083740,Staff,28,0,30,2
1650720609304,MATH 18,A01,083743,Staff,0,0,30,30
1650720609304,MATH 18,A02,083744,Staff,23,0,30,7
1650720609304,MATH 18,A03,083745,Staff,21,0,30,9
1650720609304,MATH 18,A04,083746,Staff,26,0,30,4
1650720609304,MATH 18,B01,083748,Staff,0,15,30,30
1650720609304,MATH 18,B02,083749,Staff,0,12,30,30
1650720609304,MATH 18,B03,083750,Staff,0,12,30,30
1650720609304,MATH 18,B04,083751,Staff,0,12,30,30
1650720615327,MATH 20A,A01,083754,Staff,19,0,40,21
1650720621354,MATH 20B,A01,083756,Staff,0,11,30,30
1650720621354,MATH 20B,A02,083757,Staff,0,12,30,30
1650720627379,MATH 20C,A01,083760,Staff,0,16,30,30
1650720627379,MATH 20C,A02,083761,Staff,0,16,30,30
1650720627379,MATH 20C,B01,083762,Staff,10,0,30,20
1650720627379,MATH 20C,B02,083763,Staff,28,0,30,2
1650720633407,MATH 20D,A01,083765,Staff,2,1,30,28
1650720633407,MATH 20D,A02,083766,Staff,6,0,30,24
1650720633407,MATH 20D,A03,083767,Staff,24,0,30,6
1650720639438,MATH 20E,A01,083771,Staff,3,0,30,27
1650720639438,MATH 20E,A02,083772,Staff,16,0,30,14
1650720639438,MATH 20E,B01,083773,Staff,0,0,30,30
1650720639438,MATH 20E,B02,083774,Staff,6,0,30,24
1650720645468,MATH 103A,A01,083777,Staff,0,15,30,30
1650720645468,MATH 103A,A02,083778,Staff,0,15,30,30
1650720645468,MATH 103A,B01,083779,Staff,0,15,30,30
1650720645468,MATH 103A,B02,083780,Staff,0,15,30,30
1650720651491,MATH 105,A01,085443,Staff,0,22,30,30
1650720657516,MATH 109,A01,083213,Anzaldo; Leesa B,0,7,30,30
1650720657516,MATH 109,A02,083214,Anzaldo; Leesa B,0,7,30,30
1650720657516,MATH 109,B01,083215,Anzaldo; Leesa B,0,8,30,30
1650720657516,MATH 109,B02,083216,Anzaldo; Leesa B,0,6,30,30
1650720663548,MATH 142A,A01,083219,Chow; Bennett,0,16,30,30
1650720663548,MATH 142A,A02,083220,Chow; Bennett,0,15,30,30
1650720663548,MATH 142A,B01,083221,Chow; Bennett,0,15,30,30
1650720663548,MATH 142A,B02,083222,Chow; Bennett,0,14,30,30
1650720669572,MATH 193A,A01,083224,Staff,0,5,30,30
1650720669572,MATH 193A,A02,083225,Staff,0,6,30,30
1650720669572,MATH 193A,A03,083781,Staff,0,6,30,30
1650720669572,MATH 193A,A04,083782,Staff,0,7,30,30
1650720675596,MATH 197,001,091859,McAuley; Julian John,9998,0,9999,1
1650720681665,COGS 9,A01,083615,Staff,1,15,60,59
1650720687690,COGS 11,A01,083617,Boyle; Mary E. T.,16,0,40,24
1650720693719,COGS 13,A01,083071,Staff,0,38,40,40
1650720699745,COGS 14A,A01,092681,Staff,0,35,100,100
1650720705772,COGS 14B,A01,083073,Cheng; Tzu-Han,1,13,50,49
1650720711799,COGS 17,A01,092677,Staff,13,0,75,62
1650720717823,COGS 100,A01,083619,Staff,0,28,60,60
1650720723852,COGS 101A,A01,083621,Davis; Joshua Daniel,0,27,60,60
1650720729879,COGS 101B,A01,091572,Staff,0,4,60,60
1650720735908,COGS 101C,A01,083625,Delgado; Tania,14,0,30,16
1650720741936,COGS 107A,A01,083627,Boyle; Mary E. T.,0,16,60,60
1650720747959,COGS 118A,A01,083075,Staff,0,8,60,60
1650720753989,CSE 3,A50,083646,Miranda; Gregory Joseph,18,0,38,20
1650720753989,CSE 3,A51,083647,Miranda; Gregory Joseph,36,0,37,1
1650720760018,CSE 8A,A50,083650,Miranda; Gregory Joseph,0,30,40,40
1650720766044,CSE 11,A01,083080,Cao; Yingjun,0,96,40,40
1650720772080,CSE 12,A01,083652,Staff,0,21,100,100
1650720778109,CSE 15L,A01,083654,Staff,0,3,50,50
1650720778109,CSE 15L,A02,083655,Staff,0,2,50,50
1650720784137,CSE 20,A01,083657,Staff,49,0,80,31
1650720790161,CSE 30,A01,083084,Eldon; John,0,77,40,40
1650720796190,CSE 100,A01,083659,Cao; Yingjun,0,70,50,50
1650720802216,CSE 134B,A01,083661,Powell; Thomas Allan,0,38,65,65
1650720808244,CSE 140,A01,083663,Staff,0,11,75,75
1650720814269,CSE 140L,A01,083088,Eldon; John,0,20,75,75
1650720820296,CSE 175,A01,083665,Kumar; Rakesh,7,0,25,18
1650720826325,CSE 190,A00,092507,Dubnov; Shlomo,10,0,20,10
1650720832363,ECE 45,A01,083139,Staff,1,2,60,59
1650720838387,ECE 65,A50,083695,Staff,0,5,30,30
1650720844416,ECE 109,A01,091882,Touri; Behrouz,33,0,70,37
1650720850441,ECE 180,A00,083140,Abi Samra; Nicholas Camill,20,0,30,10
1650720850441,ECE 180,B00,083141,Abi Samra; Nicholas Camill,0,0,30,30
1650720856470,MATH 10A,A01,083735,Patchell; Gregory David,2,0,30,28
1650720856470,MATH 10A,A02,083736,Patchell; Gregory David,27,0,30,3
1650720856470,MATH 10A,A03,083737,Patchell; Gregory David,24,0,30,6
1650720862494,MATH 10B,A01,083207,Staff,0,9,30,30
1650720862494,MATH 10B,A02,083208,Staff,1,7,30,29
1650720862494,MATH 10B,B01,083739,Staff,11,0,30,19
1650720862494,MATH 10B,B02,083740,Staff,28,0,30,2
1650720868532,MATH 18,A01,083743,Staff,0,0,30,30
1650720868532,MATH 18,A02,083744,Staff,23,0,30,7
1650720868532,MATH 18,A03,083745,Staff,21,0,30,9
1650720868532,MATH 18,A04,083746,Staff,26,0,30,4
1650720868532,MATH 18,B01,083748,Staff,0,15,30,30
1650720868532,MATH 18,B02,083749,Staff,0,12,30,30
1650720868532,MATH 18,B03,083750,Staff,0,12,30,30
1650720868532,MATH 18,B04,083751,Staff,0,12,30,30
1650720874555,MATH 20A,A01,083754,Staff,19,0,40,21
1650720880581,MATH 20B,A01,083756,Staff,0,11,30,30
1650720880581,MATH 20B,A02,083757,Staff,0,12,30,30
1650720886607,MATH 20C,A01,083760,Staff,0,16,30,30
1650720886607,MATH 20C,A02,083761,Staff,0,16,30,30
1650720886607,MATH 20C,B01,083762,Staff,10,0,30,20
1650720886607,MATH 20C,B02,083763,Staff,28,0,30,2
1650720892637,MATH 20D,A01,083765,Staff,2,1,30,28
1650720892637,MATH 20D,A02,083766,Staff,6,0,30,24
1650720892637,MATH 20D,A03,083767,Staff,24,0,30,6
1650720898663,MATH 20E,A01,083771,Staff,3,0,30,27
1650720898663,MATH 20E,A02,083772,Staff,16,0,30,14
1650720898663,MATH 20E,B01,083773,Staff,0,0,30,30
1650720898663,MATH 20E,B02,083774,Staff,6,0,30,24
1650720904694,MATH 103A,A01,083777,Staff,0,15,30,30
1650720904694,MATH 103A,A02,083778,Staff,0,15,30,30
1650720904694,MATH 103A,B01,083779,Staff,0,15,30,30
1650720904694,MATH 103A,B02,083780,Staff,0,15,30,30
1650720910734,MATH 105,A01,085443,Staff,0,22,30,30
1650720916767,MATH 109,A01,083213,Anzaldo; Leesa B,0,7,30,30
1650720916767,MATH 109,A02,083214,Anzaldo; Leesa B,0,7,30,30
1650720916767,MATH 109,B01,083215,Anzaldo; Leesa B,0,8,30,30
1650720916767,MATH 109,B02,083216,Anzaldo; Leesa B,0,6,30,30
1650720922792,MATH 142A,A01,083219,Chow; Bennett,0,16,30,30
1650720922792,MATH 142A,A02,083220,Chow; Bennett,0,15,30,30
1650720922792,MATH 142A,B01,083221,Chow; Bennett,0,15,30,30
1650720922792,MATH 142A,B02,083222,Chow; Bennett,0,14,30,30
1650720928821,MATH 193A,A01,083224,Staff,0,5,30,30
1650720928821,MATH 193A,A02,083225,Staff,0,6,30,30
1650720928821,MATH 193A,A03,083781,Staff,0,6,30,30
1650720928821,MATH 193A,A04,083782,Staff,0,7,30,30
1650720934848,MATH 197,001,091859,McAuley; Julian John,9998,0,9999,1
1650720940908,COGS 9,A01,083615,Staff,1,15,60,59
1650720946936,COGS 11,A01,083617,Boyle; Mary E. T.,16,0,40,24
1650720953039,COGS 13,A01,083071,Staff,0,38,40,40
1650720959065,COGS 14A,A01,092681,Staff,0,35,100,100
1650720965093,COGS 14B,A01,083073,Cheng; Tzu-Han,1,13,50,49
1650720971121,COGS 17,A01,092677,Staff,13,0,75,62
1650720977145,COGS 100,A01,083619,Staff,0,28,60,60
1650720983172,COGS 101A,A01,083621,Davis; Joshua Daniel,0,27,60,60
1650720989196,COGS 101B,A01,091572,Staff,0,4,60,60
1650720995224,COGS 101C,A01,083625,Delgado; Tania,14,0,30,16
1650721001254,COGS 107A,A01,083627,Boyle; Mary E. T.,0,16,60,60
1650721007283,COGS 118A,A01,083075,Staff,0,8,60,60
1650721013316,CSE 3,A50,083646,Miranda; Gregory Joseph,18,0,38,20
1650721013316,CSE 3,A51,083647,Miranda; Gregory Joseph,36,0,37,1
1650721019344,CSE 8A,A50,083650,Miranda; Gregory Joseph,0,30,40,40
1650721025379,CSE 11,A01,083080,Cao; Yingjun,0,96,40,40
1650721031410,CSE 12,A01,083652,Staff,0,21,100,100
1650721037437,CSE 15L,A01,083654,Staff,0,3,50,50
1650721037437,CSE 15L,A02,083655,Staff,0,2,50,50
1650721043464,CSE 20,A01,083657,Staff,49,0,80,31
1650721049490,CSE 30,A01,083084,Eldon; John,0,77,40,40
1650721055515,CSE 100,A01,083659,Cao; Yingjun,0,70,50,50
1650721061545,CSE 134B,A01,083661,Powell; Thomas Allan,0,38,65,65
1650721067574,CSE 140,A01,083663,Staff,0,11,75,75
1650721073602,CSE 140L,A01,083088,Eldon; John,0,20,75,75
1650721079633,CSE 175,A01,083665,Kumar; Rakesh,7,0,25,18
1650721085657,CSE 190,A00,092507,Dubnov; Shlomo,10,0,20,10
1650721091689,ECE 45,A01,083139,Staff,1,2,60,59
1650721097715,ECE 65,A50,083695,Staff,0,5,30,30
1650721103742,ECE 109,A01,091882,Touri; Behrouz,33,0,70,37
1650721109773,ECE 180,A00,083140,Abi Samra; Nicholas Camill,20,0,30,10
1650721109773,ECE 180,B00,083141,Abi Samra; Nicholas Camill,0,0,30,30
1650721115807,MATH 10A,A01,083735,Patchell; Gregory David,2,0,30,28
1650721115807,MATH 10A,A02,083736,Patchell; Gregory David,27,0,30,3
1650721115807,MATH 10A,A03,083737,Patchell; Gregory David,24,0,30,6
1650721121834,MATH 10B,A01,083207,Staff,0,9,30,30
1650721121834,MATH 10B,A02,083208,Staff,1,7,30,29
1650721121834,MATH 10B,B01,083739,Staff,11,0,30,19
1650721121834,MATH 10B,B02,083740,Staff,28,0,30,2
1650721127864,MATH 18,A01,083743,Staff,0,0,30,30
1650721127864,MATH 18,A02,083744,Staff,23,0,30,7
1650721127864,MATH 18,A03,083745,Staff,21,0,30,9
1650721127864,MATH 18,A04,083746,Staff,26,0,30,4
1650721127864,MATH 18,B01,083748,Staff,0,15,30,30
1650721127864,MATH 18,B02,083749,Staff,0,12,30,30
1650721127864,MATH 18,B03,083750,Staff,0,12,30,30
1650721127864,MATH 18,B04,083751,Staff,0,12,30,30
1650721133890,MATH 20A,A01,083754,Staff,19,0,40,21
1650721139920,MATH 20B,A01,083756,Staff,0,11,30,30
1650721139920,MATH 20B,A02,083757,Staff,0,12,30,30
1650721145947,MATH 20C,A01,083760,Staff,0,16,30,30
1650721145947,MATH 20C,A02,083761,Staff,0,16,30,30
1650721145947,MATH 20C,B01,083762,Staff,10,0,30,20
1650721145947,MATH 20C,B02,083763,Staff,28,0,30,2
1650721151976,MATH 20D,A01,083765,Staff,2,1,30,28
1650721151976,MATH 20D,A02,083766,Staff,6,0,30,24
1650721151976,MATH 20D,A03,083767,Staff,24,0,30,6
1650721158008,MATH 20E,A01,083771,Staff,3,0,30,27
1650721158008,MATH 20E,A02,083772,Staff,16,0,30,14
1650721158008,MATH 20E,B01,083773,Staff,0,0,30,30
1650721158008,MATH 20E,B02,083774,Staff,6,0,30,24
1650721164034,MATH 103A,A01,083777,Staff,0,15,30,30
1650721164034,MATH 103A,A02,083778,Staff,0,15,30,30
1650721164034,MATH 103A,B01,083779,Staff,0,15,30,30
1650721164034,MATH 103A,B02,083780,Staff,0,15,30,30
1650721170063,MATH 105,A01,085443,Staff,0,22,30,30
1650721176095,MATH 109,A01,083213,Anzaldo; Leesa B,0,7,30,30
1650721176095,MATH 109,A02,083214,Anzaldo; Leesa B,0,7,30,30
1650721176095,MATH 109,B01,083215,Anzaldo; Leesa B,0,8,30,30
1650721176095,MATH 109,B02,083216,Anzaldo; Leesa B,0,6,30,30
1650721182124,MATH 142A,A01,083219,Chow; Bennett,0,16,30,30
1650721182124,MATH 142A,A02,083220,Chow; Bennett,0,15,30,30
1650721182124,MATH 142A,B01,083221,Chow; Bennett,0,15,30,30
1650721182124,MATH 142A,B02,083222,Chow; Bennett,0,14,30,30
1650721188149,MATH 193A,A01,083224,Staff,0,5,30,30
1650721188149,MATH 193A,A02,083225,Staff,0,6,30,30
1650721188149,MATH 193A,A03,083781,Staff,0,6,30,30
1650721188149,MATH 193A,A04,083782,Staff,0,7,30,30
1650721194173,MATH 197,001,091859,McAuley; Julian John,9998,0,9999,1
1650721200242,COGS 9,A01,083615,Staff,1,15,60,59
1650721206267,COGS 11,A01,083617,Boyle; Mary E. T.,16,0,40,24
1650721212295,COGS 13,A01,083071,Staff,0,38,40,40
1650721218330,COGS 14A,A01,092681,Staff,0,35,100,100
1650721224355,COGS 14B,A01,083073,Cheng; Tzu-Han,1,13,50,49
1650721230379,COGS 17,A01,092677,Staff,13,0,75,62
1650721236414,COGS 100,A01,083619,Staff,0,28,60,60
1650721242439,COGS 101A,A01,083621,Davis; Joshua Daniel,0,27,60,60
1650721248465,COGS 101B,A01,091572,Staff,0,4,60,60
1650721254491,COGS 101C,A01,083625,Delgado; Tania,14,0,30,16
1650721260523,COGS 107A,A01,083627,Boyle; Mary E. T.,0,16,60,60
1650721266552,COGS 118A,A01,083075,Staff,0,8,60,60
1650721272578,CSE 3,A50,083646,Miranda; Gregory Joseph,18,0,38,20
1650721272578,CSE 3,A51,083647,Miranda; Gregory Joseph,36,0,37,1
1650721278603,CSE 8A,A50,083650,Miranda; Gregory Joseph,0,30,40,40
1650721284631,CSE 11,A01,083080,Cao; Yingjun,0,96,40,40
1650721290658,CSE 12,A01,083652,Staff,0,21,100,100
1650721296683,CSE 15L,A01,083654,Staff,0,3,50,50
1650721296683,CSE 15L,A02,083655,Staff,0,2,50,50
1650721302705,CSE 20,A01,083657,Staff,49,0,80,31
1650721308737,CSE 30,A01,083084,Eldon; John,0,77,40,40
1650721314761,CSE 100,A01,083659,Cao; Yingjun,0,70,50,50
1650721320792,CSE 134B,A01,083661,Powell; Thomas Allan,0,38,65,65
1650721326829,CSE 140,A01,083663,Staff,0,11,75,75
1650721332858,CSE 140L,A01,083088,Eldon; John,0,20,75,75
1650721338882,CSE 175,A01,083665,Kumar; Rakesh,7,0,25,18
1650721344908,CSE 190,A00,092507,Dubnov; Shlomo,10,0,20,10
1650721350939,ECE 45,A01,083139,Staff,1,2,60,59
1650721356973,ECE 65,A50,083695,Staff,0,5,30,30
1650721363000,ECE 109,A01,091882,Touri; Behrouz,33,0,70,37
1650721369030,ECE 180,A00,083140,Abi Samra; Nicholas Camill,20,0,30,10
1650721369030,ECE 180,B00,083141,Abi Samra; Nicholas Camill,0,0,30,30
1650721375058,MATH 10A,A01,083735,Patchell; Gregory David,2,0,30,28
1650721375058,MATH 10A,A02,083736,Patchell; Gregory David,27,0,30,3
1650721375058,MATH 10A,A03,083737,Patchell; Gregory David,24,0,30,6
1650721381084,MATH 10B,A01,083207,Staff,0,9,30,30
1650721381084,MATH 10B,A02,083208,Staff,1,7,30,29
1650721381084,MATH 10B,B01,083739,Staff,11,0,30,19
1650721381084,MATH 10B,B02,083740,Staff,28,0,30,2
1650721387111,MATH 18,A01,083743,Staff,0,0,30,30
1650721387111,MATH 18,A02,083744,Staff,23,0,30,7
1650721387111,MATH 18,A03,083745,Staff,21,0,30,9
1650721387111,MATH 18,A04,083746,Staff,26,0,30,4
1650721387111,MATH 18,B01,083748,Staff,0,15,30,30
1650721387111,MATH 18,B02,083749,Staff,0,12,30,30
1650721387111,MATH 18,B03,083750,Staff,0,12,30,30
1650721387111,MATH 18,B04,083751,Staff,0,12,30,30
1650721393139,MATH 20A,A01,083754,Staff,19,0,40,21
1650721399162,MATH 20B,A01,083756,Staff,0,11,30,30
1650721399162,MATH 20B,A02,083757,Staff,0,12,30,30
1650721405186,MATH 20C,A01,083760,Staff,0,16,30,30
1650721405186,MATH 20C,A02,083761,Staff,0,16,30,30
1650721405186,MATH 20C,B01,083762,Staff,10,0,30,20
1650721405186,MATH 20C,B02,083763,Staff,28,0,30,2
1650721411213,MATH 20D,A01,083765,Staff,2,1,30,28
1650721411213,MATH 20D,A02,083766,Staff,6,0,30,24
1650721411213,MATH 20D,A03,083767,Staff,24,0,30,6
1650721417244,MATH 20E,A01,083771,Staff,3,0,30,27
1650721417244,MATH 20E,A02,083772,Staff,16,0,30,14
1650721417244,MATH 20E,B01,083773,Staff,0,0,30,30
1650721417244,MATH 20E,B02,083774,Staff,6,0,30,24
1650721423271,MATH 103A,A01,083777,Staff,0,15,30,30
1650721423271,MATH 103A,A02,083778,Staff,0,15,30,30
1650721423271,MATH 103A,B01,083779,Staff,0,15,30,30
1650721423271,MATH 103A,B02,083780,Staff,0,15,30,30
1650721429299,MATH 105,A01,085443,Staff,0,22,30,30
1650721435325,MATH 109,A01,083213,Anzaldo; Leesa B,0,7,30,30
1650721435325,MATH 109,A02,083214,Anzaldo; Leesa B,0,7,30,30
1650721435325,MATH 109,B01,083215,Anzaldo; Leesa B,0,8,30,30
1650721435325,MATH 109,B02,083216,Anzaldo; Leesa B,0,6,30,30
1650721441356,MATH 142A,A01,083219,Chow; Bennett,0,16,30,30
1650721441356,MATH 142A,A02,083220,Chow; Bennett,0,15,30,30
1650721441356,MATH 142A,B01,083221,Chow; Bennett,0,15,30,30
1650721441356,MATH 142A,B02,083222,Chow; Bennett,0,14,30,30
1650721447387,MATH 193A,A01,083224,Staff,0,5,30,30
1650721447387,MATH 193A,A02,083225,Staff,0,6,30,30
1650721447387,MATH 193A,A03,083781,Staff,0,6,30,30
1650721447387,MATH 193A,A04,083782,Staff,0,7,30,30
1650721453412,MATH 197,001,091859,McAuley; Julian John,9998,0,9999,1
1650721459474,COGS 9,A01,083615,Staff,1,15,60,59
1650721465504,COGS 11,A01,083617,Boyle; Mary E. T.,16,0,40,24
1650721471531,COGS 13,A01,083071,Staff,0,38,40,40
1650721477555,COGS 14A,A01,092681,Staff,0,35,100,100
1650721483585,COGS 14B,A01,083073,Cheng; Tzu-Han,1,13,50,49
1650721489608,COGS 17,A01,092677,Staff,13,0,75,62
1650721495633,COGS 100,A01,083619,Staff,0,28,60,60
1650721501662,COGS 101A,A01,083621,Davis; Joshua Daniel,0,27,60,60
1650721507690,COGS 101B,A01,091572,Staff,0,4,60,60
1650721513715,COGS 101C,A01,083625,Delgado; Tania,14,0,30,16
1650721519739,COGS 107A,A01,083627,Boyle; Mary E. T.,0,16,60,60
1650721525765,COGS 118A,A01,083075,Staff,0,8,60,60
1650721531797,CSE 3,A50,083646,Miranda; Gregory Joseph,18,0,38,20
1650721531797,CSE 3,A51,083647,Miranda; Gregory Joseph,36,0,37,1
1650721537822,CSE 8A,A50,083650,Miranda; Gregory Joseph,0,30,40,40
1650721543856,CSE 11,A01,083080,Cao; Yingjun,0,96,40,40
1650721549959,CSE 12,A01,083652,Staff,0,21,100,100
1650721555981,CSE 15L,A01,083654,Staff,0,3,50,50
1650721555981,CSE 15L,A02,083655,Staff,0,2,50,50
1650721562010,CSE 20,A01,083657,Staff,49,0,80,31
1650721568040,CSE 30,A01,083084,Eldon; John,0,77,40,40
1650721574069,CSE 100,A01,083659,Cao; Yingjun,0,70,50,50
1650721580094,CSE 134B,A01,083661,Powell; Thomas Allan,0,38,65,65
1650721586118,CSE 140,A01,083663,Staff,0,11,75,75
1650721592143,CSE 140L,A01,083088,Eldon; John,0,20,75,75
1650721598173,CSE 175,A01,083665,Kumar; Rakesh,7,0,25,18
1650721604199,CSE 190,A00,092507,Dubnov; Shlomo,10,0,20,10
1650721610228,ECE 45,A01,083139,Staff,1,2,60,59
1650721616258,ECE 65,A50,083695,Staff,0,5,30,30
1650721622287,ECE 109,A01,091882,Touri; Behrouz,33,0,70,37
1650721628314,ECE 180,A00,083140,Abi Samra; Nicholas Camill,20,0,30,10
1650721628314,ECE 180,B00,083141,Abi Samra; Nicholas Camill,0,0,30,30
1650721634342,MATH 10A,A01,083735,Patchell; Gregory David,2,0,30,28
1650721634342,MATH 10A,A02,083736,Patchell; Gregory David,27,0,30,3
1650721634342,MATH 10A,A03,083737,Patchell; Gregory David,24,0,30,6
1650721640371,MATH 10B,A01,083207,Staff,0,9,30,30
1650721640371,MATH 10B,A02,083208,Staff,1,7,30,29
1650721640371,MATH 10B,B01,083739,Staff,11,0,30,19
1650721640371,MATH 10B,B02,083740,Staff,28,0,30,2
1650721646400,MATH 18,A01,083743,Staff,0,0,30,30
1650721646400,MATH 18,A02,083744,Staff,23,0,30,7
1650721646400,MATH 18,A03,083745,Staff,21,0,30,9
1650721646400,MATH 18,A04,083746,Staff,26,0,30,4
1650721646400,MATH 18,B01,083748,Staff,0,15,30,30
1650721646400,MATH 18,B02,083749,Staff,0,12,30,30
1650721646400,MATH 18,B03,083750,Staff,0,12,30,30
1650721646400,MATH 18,B04,083751,Staff,0,12,30,30
1650721652428,MATH 20A,A01,083754,Staff,19,0,40,21
1650721658453,MATH 20B,A01,083756,Staff,0,11,30,30
1650721658453,MATH 20B,A02,083757,Staff,0,12,30,30
1650721664479,MATH 20C,A01,083760,Staff,0,16,30,30
1650721664479,MATH 20C,A02,083761,Staff,0,16,30,30
1650721664479,MATH 20C,B01,083762,Staff,10,0,30,20
1650721664479,MATH 20C,B02,083763,Staff,28,0,30,2
1650721670507,MATH 20D,A01,083765,Staff,2,1,30,28
1650721670507,MATH 20D,A02,083766,Staff,6,0,30,24
1650721670507,MATH 20D,A03,083767,Staff,24,0,30,6
1650721676535,MATH 20E,A01,083771,Staff,3,0,30,27
1650721676535,MATH 20E,A02,083772,Staff,16,0,30,14
1650721676535,MATH 20E,B01,083773,Staff,0,0,30,30
1650721676535,MATH 20E,B02,083774,Staff,6,0,30,24
1650721682562,MATH 103A,A01,083777,Staff,0,15,30,30
1650721682562,MATH 103A,A02,083778,Staff,0,15,30,30
1650721682562,MATH 103A,B01,083779,Staff,0,15,30,30
1650721682562,MATH 103A,B02,083780,Staff,0,15,30,30
1650721688586,MATH 105,A01,085443,Staff,0,22,30,30
1650721694616,MATH 109,A01,083213,Anzaldo; Leesa B,0,7,30,30
1650721694616,MATH 109,A02,083214,Anzaldo; Leesa B,0,7,30,30
1650721694616,MATH 109,B01,083215,Anzaldo; Leesa B,0,8,30,30
1650721694616,MATH 109,B02,083216,Anzaldo; Leesa B,0,6,30,30
1650721700640,MATH 142A,A01,083219,Chow; Bennett,0,16,30,30
1650721700640,MATH 142A,A02,083220,Chow; Bennett,0,15,30,30
1650721700640,MATH 142A,B01,083221,Chow; Bennett,0,15,30,30
1650721700640,MATH 142A,B02,083222,Chow; Bennett,0,14,30,30
1650721706667,MATH 193A,A01,083224,Staff,0,5,30,30
1650721706667,MATH 193A,A02,083225,Staff,0,6,30,30
1650721706667,MATH 193A,A03,083781,Staff,0,6,30,30
1650721706667,MATH 193A,A04,083782,Staff,0,7,30,30
1650721712693,MATH 197,001,091859,McAuley; Julian John,9998,0,9999,1
1650721718760,COGS 9,A01,083615,Staff,1,15,60,59
1650721724791,COGS 11,A01,083617,Boyle; Mary E. T.,16,0,40,24
1650721730816,COGS 13,A01,083071,Staff,0,38,40,40
1650721736840,COGS 14A,A01,092681,Staff,0,35,100,100
1650721742872,COGS 14B,A01,083073,Cheng; Tzu-Han,1,13,50,49
1650721748897,COGS 17,A01,092677,Staff,13,0,75,62
1650721754923,COGS 100,A01,083619,Staff,0,28,60,60
1650721760952,COGS 101A,A01,083621,Davis; Joshua Daniel,0,27,60,60
1650721766977,COGS 101B,A01,091572,Staff,0,4,60,60
1650721773003,COGS 101C,A01,083625,Delgado; Tania,14,0,30,16
1650721779034,COGS 107A,A01,083627,Boyle; Mary E. T.,0,16,60,60
1650721785059,COGS 118A,A01,083075,Staff,0,8,60,60
1650721791087,CSE 3,A50,083646,Miranda; Gregory Joseph,18,0,38,20
1650721791087,CSE 3,A51,083647,Miranda; Gregory Joseph,36,0,37,1
1650721797113,CSE 8A,A50,083650,Miranda; Gregory Joseph,0,30,40,40
1650721803137,CSE 11,A01,083080,Cao; Yingjun,0,96,40,40
1650721809166,CSE 12,A01,083652,Staff,0,21,100,100
1650721815189,CSE 15L,A01,083654,Staff,0,3,50,50
1650721815189,CSE 15L,A02,083655,Staff,0,2,50,50
1650721821212,CSE 20,A01,083657,Staff,49,0,80,31
1650721827241,CSE 30,A01,083084,Eldon; John,0,77,40,40
1650721833268,CSE 100,A01,083659,Cao; Yingjun,0,70,50,50
1650721839298,CSE 134B,A01,083661,Powell; Thomas Allan,0,38,65,65
1650721845323,CSE 140,A01,083663,Staff,0,11,75,75
1650721851348,CSE 140L,A01,083088,Eldon; John,0,20,75,75
1650721857376,CSE 175,A01,083665,Kumar; Rakesh,7,0,25,18
1650721863410,CSE 190,A00,092507,Dubnov; Shlomo,10,0,20,10
1650721869439,ECE 45,A01,083139,Staff,1,2,60,59
1650721875466,ECE 65,A50,083695,Staff,0,5,30,30
1650721881497,ECE 109,A01,091882,Touri; Behrouz,33,0,70,37
1650721887522,ECE 180,A00,083140,Abi Samra; Nicholas Camill,20,0,30,10
1650721887522,ECE 180,B00,083141,Abi Samra; Nicholas Camill,0,0,30,30
1650721893576,MATH 10A,A01,083735,Patchell; Gregory David,2,0,30,28
1650721893576,MATH 10A,A02,083736,Patchell; Gregory David,27,0,30,3
1650721893576,MATH 10A,A03,083737,Patchell; Gregory David,24,0,30,6
1650721899608,MATH 10B,A01,083207,Staff,0,9,30,30
1650721899608,MATH 10B,A02,083208,Staff,1,7,30,29
1650721899608,MATH 10B,B01,083739,Staff,11,0,30,19
1650721899608,MATH 10B,B02,083740,Staff,28,0,30,2
1650721905639,MATH 18,A01,083743,Staff,0,0,30,30
1650721905639,MATH 18,A02,083744,Staff,23,0,30,7
1650721905639,MATH 18,A03,083745,Staff,21,0,30,9
1650721905639,MATH 18,A04,083746,Staff,26,0,30,4
1650721905639,MATH 18,B01,083748,Staff,0,15,30,30
1650721905639,MATH 18,B02,083749,Staff,0,12,30,30
1650721905639,MATH 18,B03,083750,Staff,0,12,30,30
1650721905639,MATH 18,B04,083751,Staff,0,12,30,30
1650721911664,MATH 20A,A01,083754,Staff,19,0,40,21
1650721917690,MATH 20B,A01,083756,Staff,0,11,30,30
1650721917690,MATH 20B,A02,083757,Staff,0,12,30,30
1650721923719,MATH 20C,A01,083760,Staff,0,16,30,30
1650721923719,MATH 20C,A02,083761,Staff,0,16,30,30
1650721923719,MATH 20C,B01,083762,Staff,10,0,30,20
1650721923719,MATH 20C,B02,083763,Staff,28,0,30,2
1650721929750,MATH 20D,A01,083765,Staff,2,1,30,28
1650721929750,MATH 20D,A02,083766,Staff,6,0,30,24
1650721929750,MATH 20D,A03,083767,Staff,24,0,30,6
1650721935781,MATH 20E,A01,083771,Staff,3,0,30,27
1650721935781,MATH 20E,A02,083772,Staff,16,0,30,14
1650721935781,MATH 20E,B01,083773,Staff,0,0,30,30
1650721935781,MATH 20E,B02,083774,Staff,6,0,30,24
1650721941812,MATH 103A,A01,083777,Staff,0,15,30,30
1650721941812,MATH 103A,A02,083778,Staff,0,15,30,30
1650721941812,MATH 103A,B01,083779,Staff,0,15,30,30
1650721941812,MATH 103A,B02,083780,Staff,0,15,30,30
1650721947836,MATH 105,A01,085443,Staff,0,22,30,30
1650721953868,MATH 109,A01,083213,Anzaldo; Leesa B,0,7,30,30
1650721953868,MATH 109,A02,083214,Anzaldo; Leesa B,0,7,30,30
1650721953868,MATH 109,B01,083215,Anzaldo; Leesa B,0,8,30,30
1650721953868,MATH 109,B02,083216,Anzaldo; Leesa B,0,6,30,30
1650721959899,MATH 142A,A01,083219,Chow; Bennett,0,16,30,30
1650721959899,MATH 142A,A02,083220,Chow; Bennett,0,15,30,30
1650721959899,MATH 142A,B01,083221,Chow; Bennett,0,15,30,30
1650721959899,MATH 142A,B02,083222,Chow; Bennett,0,14,30,30
1650721965926,MATH 193A,A01,083224,Staff,0,5,30,30
1650721965926,MATH 193A,A02,083225,Staff,0,6,30,30
1650721965926,MATH 193A,A03,083781,Staff,0,6,30,30
1650721965926,MATH 193A,A04,083782,Staff,0,7,30,30
1650721971951,MATH 197,001,091859,McAuley; Julian John,9998,0,9999,1
1650721978014,COGS 9,A01,083615,Staff,1,15,60,59
1650721984045,COGS 11,A01,083617,Boyle; Mary E. T.,16,0,40,24
1650721990077,COGS 13,A01,083071,Staff,0,38,40,40
1650721996108,COGS 14A,A01,092681,Staff,0,35,100,100
1650722002136,COGS 14B,A01,083073,Cheng; Tzu-Han,1,13,50,49
1650722008164,COGS 17,A01,092677,Staff,13,0,75,62
1650722014188,COGS 100,A01,083619,Staff,0,28,60,60
1650722020221,COGS 101A,A01,083621,Davis; Joshua Daniel,0,27,60,60
1650722026246,COGS 101B,A01,091572,Staff,0,4,60,60
1650722032275,COGS 101C,A01,083625,Delgado; Tania,14,0,30,16
1650722038304,COGS 107A,A01,083627,Boyle; Mary E. T.,0,16,60,60
1650722044329,COGS 118A,A01,083075,Staff,0,8,60,60
1650722050364,CSE 3,A50,083646,Miranda; Gregory Joseph,18,0,38,20
1650722050364,CSE 3,A51,083647,Miranda; Gregory Joseph,36,0,37,1
1650722056390,CSE 8A,A50,083650,Miranda; Gregory Joseph,0,30,40,40
1650722062419,CSE 11,A01,083080,Cao; Yingjun,0,96,40,40
1650722068448,CSE 12,A01,083652,Staff,0,21,100,100
1650722074472,CSE 15L,A01,083654,Staff,0,3,50,50
1650722074472,CSE 15L,A02,083655,Staff,0,2,50,50
1650722080498,CSE 20,A01,083657,Staff,49,0,80,31
1650722086527,CSE 30,A01,083084,Eldon; John,0,77,40,40
1650722092551,CSE 100,A01,083659,Cao; Yingjun,0,70,50,50
1650722098576,CSE 134B,A01,083661,Powell; Thomas Allan,0,38,65,65
1650722104600,CSE 140,A01,083663,Staff,0,11,75,75
1650722110631,CSE 140L,A01,083088,Eldon; John,0,20,75,75
1650722116657,CSE 175,A01,083665,Kumar; Rakesh,7,0,25,18
1650722122686,CSE 190,A00,092507,Dubnov; Shlomo,10,0,20,10
1650722128714,ECE 45,A01,083139,Staff,1,2,60,59
1650722134745,ECE 65,A50,083695,Staff,0,5,30,30
1650722140771,ECE 109,A01,091882,Touri; Behrouz,33,0,70,37
1650722146873,ECE 180,A00,083140,Abi Samra; Nicholas Camill,20,0,30,10
1650722146873,ECE 180,B00,083141,Abi Samra; Nicholas Camill,0,0,30,30
1650722152908,MATH 10A,A01,083735,Patchell; Gregory David,2,0,30,28
1650722152908,MATH 10A,A02,083736,Patchell; Gregory David,27,0,30,3
1650722152908,MATH 10A,A03,083737,Patchell; Gregory David,24,0,30,6
1650722158935,MATH 10B,A01,083207,Staff,0,9,30,30
1650722158935,MATH 10B,A02,083208,Staff,1,7,30,29
1650722158935,MATH 10B,B01,083739,Staff,11,0,30,19
1650722158935,MATH 10B,B02,083740,Staff,28,0,30,2
1650722164962,MATH 18,A01,083743,Staff,0,0,30,30
1650722164962,MATH 18,A02,083744,Staff,23,0,30,7
1650722164962,MATH 18,A03,083745,Staff,21,0,30,9
1650722164962,MATH 18,A04,083746,Staff,26,0,30,4
1650722164962,MATH 18,B01,083748,Staff,0,15,30,30
1650722164962,MATH 18,B02,083749,Staff,0,12,30,30
1650722164962,MATH 18,B03,083750,Staff,0,12,30,30
1650722164962,MATH 18,B04,083751,Staff,0,12,30,30
1650722170986,MATH 20A,A01,083754,Staff,19,0,40,21
1650722177015,MATH 20B,A01,083756,Staff,0,11,30,30
1650722177015,MATH 20B,A02,083757,Staff,0,12,30,30
1650722183059,MATH 20C,A01,083760,Staff,0,16,30,30
1650722183059,MATH 20C,A02,083761,Staff,0,16,30,30
1650722183059,MATH 20C,B01,083762,Staff,10,0,30,20
1650722183059,MATH 20C,B02,083763,Staff,28,0,30,2
1650722189089,MATH 20D,A01,083765,Staff,2,1,30,28
1650722189089,MATH 20D,A02,083766,Staff,6,0,30,24
1650722189089,MATH 20D,A03,083767,Staff,24,0,30,6
1650722195121,MATH 20E,A01,083771,Staff,3,0,30,27
1650722195121,MATH 20E,A02,083772,Staff,16,0,30,14
1650722195121,MATH 20E,B01,083773,Staff,0,0,30,30
1650722195121,MATH 20E,B02,083774,Staff,6,0,30,24
1650722201146,MATH 103A,A01,083777,Staff,0,15,30,30
1650722201146,MATH 103A,A02,083778,Staff,0,15,30,30
1650722201146,MATH 103A,B01,083779,Staff,0,15,30,30
1650722201146,MATH 103A,B02,083780,Staff,0,15,30,30
1650722207175,MATH 105,A01,085443,Staff,0,22,30,30
1650722213205,MATH 109,A01,083213,Anzaldo; Leesa B,0,7,30,30
1650722213205,MATH 109,A02,083214,Anzaldo; Leesa B,0,7,30,30
1650722213205,MATH 109,B01,083215,Anzaldo; Leesa B,0,8,30,30
1650722213205,MATH 109,B02,083216,Anzaldo; Leesa B,0,6,30,30
1650722219231,MATH 142A,A01,083219,Chow; Bennett,0,16,30,30
1650722219231,MATH 142A,A02,083220,Chow; Bennett,0,15,30,30
1650722219231,MATH 142A,B01,083221,Chow; Bennett,0,15,30,30
1650722219231,MATH 142A,B02,083222,Chow; Bennett,0,14,30,30
1650722225257,MATH 193A,A01,083224,Staff,0,5,30,30
1650722225257,MATH 193A,A02,083225,Staff,0,6,30,30
1650722225257,MATH 193A,A03,083781,Staff,0,6,30,30
1650722225257,MATH 193A,A04,083782,Staff,0,7,30,30
1650722231283,MATH 197,001,091859,McAuley; Julian John,9998,0,9999,1
1650722237347,COGS 9,A01,083615,Staff,1,15,60,59
1650722243377,COGS 11,A01,083617,Boyle; Mary E. T.,16,0,40,24
1650722249401,COGS 13,A01,083071,Staff,0,38,40,40
1650722255427,COGS 14A,A01,092681,Staff,0,35,100,100
1650722261455,COGS 14B,A01,083073,Cheng; Tzu-Han,1,13,50,49
1650722267483,COGS 17,A01,092677,Staff,13,0,75,62
1650722273513,COGS 100,A01,083619,Staff,0,28,60,60
1650722279543,COGS 101A,A01,083621,Davis; Joshua Daniel,0,27,60,60
1650722285567,COGS 101B,A01,091572,Staff,0,4,60,60
1650722291595,COGS 101C,A01,083625,Delgado; Tania,14,0,30,16
1650722297618,COGS 107A,A01,083627,Boyle; Mary E. T.,0,16,60,60
1650722303647,COGS 118A,A01,083075,Staff,0,8,60,60
1650722309681,CSE 3,A50,083646,Miranda; Gregory Joseph,18,0,38,20
1650722309681,CSE 3,A51,083647,Miranda; Gregory Joseph,36,0,37,1
1650722315714,CSE 8A,A50,083650,Miranda; Gregory Joseph,0,30,40,40
1650722321740,CSE 11,A01,083080,Cao; Yingjun,0,96,40,40
1650722327768,CSE 12,A01,083652,Staff,0,21,100,100
1650722333793,CSE 15L,A01,083654,Staff,0,3,50,50
1650722333793,CSE 15L,A02,083655,Staff,0,2,50,50
1650722339829,CSE 20,A01,083657,Staff,49,0,80,31
1650722345855,CSE 30,A01,083084,Eldon; John,0,77,40,40
1650722351885,CSE 100,A01,083659,Cao; Yingjun,0,70,50,50
1650722357916,CSE 134B,A01,083661,Powell; Thomas Allan,0,38,65,65
1650722363944,CSE 140,A01,083663,Staff,0,11,75,75
1650722369970,CSE 140L,A01,083088,Eldon; John,0,20,75,75
1650722375996,CSE 175,A01,083665,Kumar; Rakesh,7,0,25,18
1650722382024,CSE 190,A00,092507,Dubnov; Shlomo,10,0,20,10
1650722388050,ECE 45,A01,083139,Staff,1,2,60,59
1650722394080,ECE 65,A50,083695,Staff,0,5,30,30
1650722400110,ECE 109,A01,091882,Touri; Behrouz,33,0,70,37
1650722406140,ECE 180,A00,083140,Abi Samra; Nicholas Camill,20,0,30,10
1650722406140,ECE 180,B00,083141,Abi Samra; Nicholas Camill,0,0,30,30
1650722412168,MATH 10A,A01,083735,Patchell; Gregory David,2,0,30,28
1650722412168,MATH 10A,A02,083736,Patchell; Gregory David,27,0,30,3
1650722412168,MATH 10A,A03,083737,Patchell; Gregory David,24,0,30,6
1650722418198,MATH 10B,A01,083207,Staff,0,9,30,30
1650722418198,MATH 10B,A02,083208,Staff,1,7,30,29
1650722418198,MATH 10B,B01,083739,Staff,11,0,30,19
1650722418198,MATH 10B,B02,083740,Staff,28,0,30,2
1650722424228,MATH 18,A01,083743,Staff,0,0,30,30
1650722424228,MATH 18,A02,083744,Staff,23,0,30,7
1650722424228,MATH 18,A03,083745,Staff,21,0,30,9
1650722424228,MATH 18,A04,083746,Staff,26,0,30,4
1650722424228,MATH 18,B01,083748,Staff,0,15,30,30
1650722424228,MATH 18,B02,083749,Staff,0,12,30,30
1650722424228,MATH 18,B03,083750,Staff,0,12,30,30
1650722424228,MATH 18,B04,083751,Staff,0,12,30,30
1650722430252,MATH 20A,A01,083754,Staff,19,0,40,21
1650722436283,MATH 20B,A01,083756,Staff,0,11,30,30
1650722436283,MATH 20B,A02,083757,Staff,0,12,30,30
1650722442310,MATH 20C,A01,083760,Staff,0,16,30,30
1650722442310,MATH 20C,A02,083761,Staff,0,16,30,30
1650722442310,MATH 20C,B01,083762,Staff,10,0,30,20
1650722442310,MATH 20C,B02,083763,Staff,28,0,30,2
1650722448335,MATH 20D,A01,083765,Staff,2,1,30,28
1650722448335,MATH 20D,A02,083766,Staff,6,0,30,24
1650722448335,MATH 20D,A03,083767,Staff,24,0,30,6
1650722454361,MATH 20E,A01,083771,Staff,3,0,30,27
1650722454361,MATH 20E,A02,083772,Staff,16,0,30,14
1650722454361,MATH 20E,B01,083773,Staff,0,0,30,30
1650722454361,MATH 20E,B02,083774,Staff,6,0,30,24
1650722460393,MATH 103A,A01,083777,Staff,0,15,30,30
1650722460393,MATH 103A,A02,083778,Staff,0,15,30,30
1650722460393,MATH 103A,B01,083779,Staff,0,15,30,30
1650722460393,MATH 103A,B02,083780,Staff,0,15,30,30
1650722466417,MATH 105,A01,085443,Staff,0,22,30,30
1650722472447,MATH 109,A01,083213,Anzaldo; Leesa B,0,7,30,30
1650722472447,MATH 109,A02,083214,Anzaldo; Leesa B,0,7,30,30
1650722472447,MATH 109,B01,083215,Anzaldo; Leesa B,0,8,30,30
1650722472447,MATH 109,B02,083216,Anzaldo; Leesa B,0,6,30,30
1650722478477,MATH 142A,A01,083219,Chow; Bennett,0,16,30,30
1650722478477,MATH 142A,A02,083220,Chow; Bennett,0,15,30,30
1650722478477,MATH 142A,B01,083221,Chow; Bennett,0,15,30,30
1650722478477,MATH 142A,B02,083222,Chow; Bennett,0,14,30,30
1650722484500,MATH 193A,A01,083224,Staff,0,5,30,30
1650722484500,MATH 193A,A02,083225,Staff,0,6,30,30
1650722484500,MATH 193A,A03,083781,Staff,0,6,30,30
1650722484500,MATH 193A,A04,083782,Staff,0,7,30,30
1650722490534,MATH 197,001,091859,McAuley; Julian John,9998,0,9999,1
1650722496601,COGS 9,A01,083615,Staff,1,15,60,59
1650722502627,COGS 11,A01,083617,Boyle; Mary E. T.,16,0,40,24
1650722508652,COGS 13,A01,083071,Staff,0,38,40,40
1650722514677,COGS 14A,A01,092681,Staff,0,35,100,100
1650722520707,COGS 14B,A01,083073,Cheng; Tzu-Han,1,13,50,49
1650722526733,COGS 17,A01,092677,Staff,13,0,75,62
1650722532757,COGS 100,A01,083619,Staff,0,28,60,60
1650722538787,COGS 101A,A01,083621,Davis; Joshua Daniel,0,27,60,60
1650722544815,COGS 101B,A01,091572,Staff,0,4,60,60
1650722550840,COGS 101C,A01,083625,Delgado; Tania,14,0,30,16
1650722556870,COGS 107A,A01,083627,Boyle; Mary E. T.,0,16,60,60
1650722562895,COGS 118A,A01,083075,Staff,0,8,60,60
1650722568922,CSE 3,A50,083646,Miranda; Gregory Joseph,18,0,38,20
1650722568922,CSE 3,A51,083647,Miranda; Gregory Joseph,36,0,37,1
1650722574950,CSE 8A,A50,083650,Miranda; Gregory Joseph,0,30,40,40
1650722580976,CSE 11,A01,083080,Cao; Yingjun,0,96,40,40
1650722587002,CSE 12,A01,083652,Staff,0,21,100,100
1650722593033,CSE 15L,A01,083654,Staff,0,3,50,50
1650722593033,CSE 15L,A02,083655,Staff,0,2,50,50
1650722599062,CSE 20,A01,083657,Staff,49,0,80,31
1650722605088,CSE 30,A01,083084,Eldon; John,0,77,40,40
1650722611113,CSE 100,A01,083659,Cao; Yingjun,0,70,50,50
1650722617137,CSE 134B,A01,083661,Powell; Thomas Allan,0,38,65,65
1650722623164,CSE 140,A01,083663,Staff,0,11,75,75
1650722629194,CSE 140L,A01,083088,Eldon; John,0,20,75,75
1650722635221,CSE 175,A01,083665,Kumar; Rakesh,7,0,25,18
1650722641251,CSE 190,A00,092507,Dubnov; Shlomo,10,0,20,10
1650722647280,ECE 45,A01,083139,Staff,1,2,60,59
1650722653314,ECE 65,A50,083695,Staff,0,5,30,30
1650722659344,ECE 109,A01,091882,Touri; Behrouz,33,0,70,37
1650722665374,ECE 180,A00,083140,Abi Samra; Nicholas Camill,20,0,30,10
1650722665374,ECE 180,B00,083141,Abi Samra; Nicholas Camill,0,0,30,30
1650722671401,MATH 10A,A01,083735,Patchell; Gregory David,2,0,30,28
1650722671401,MATH 10A,A02,083736,Patchell; Gregory David,27,0,30,3
1650722671401,MATH 10A,A03,083737,Patchell; Gregory David,24,0,30,6
1650722677428,MATH 10B,A01,083207,Staff,0,9,30,30
1650722677428,MATH 10B,A02,083208,Staff,1,7,30,29
1650722677428,MATH 10B,B01,083739,Staff,11,0,30,19
1650722677428,MATH 10B,B02,083740,Staff,28,0,30,2
1650722683461,MATH 18,A01,083743,Staff,0,0,30,30
1650722683461,MATH 18,A02,083744,Staff,23,0,30,7
1650722683461,MATH 18,A03,083745,Staff,21,0,30,9
1650722683461,MATH 18,A04,083746,Staff,26,0,30,4
1650722683461,MATH 18,B01,083748,Staff,0,15,30,30
1650722683461,MATH 18,B02,083749,Staff,0,12,30,30
1650722683461,MATH 18,B03,083750,Staff,0,12,30,30
1650722683461,MATH 18,B04,083751,Staff,0,12,30,30
1650722689487,MATH 20A,A01,083754,Staff,19,0,40,21
1650722695517,MATH 20B,A01,083756,Staff,0,11,30,30
1650722695517,MATH 20B,A02,083757,Staff,0,12,30,30
1650722701556,MATH 20C,A01,083760,Staff,0,16,30,30
1650722701556,MATH 20C,A02,083761,Staff,0,16,30,30
1650722701556,MATH 20C,B01,083762,Staff,10,0,30,20
1650722701556,MATH 20C,B02,083763,Staff,28,0,30,2
1650722707585,MATH 20D,A01,083765,Staff,2,1,30,28
1650722707585,MATH 20D,A02,083766,Staff,6,0,30,24
1650722707585,MATH 20D,A03,083767,Staff,24,0,30,6
1650722713612,MATH 20E,A01,083771,Staff,3,0,30,27
1650722713612,MATH 20E,A02,083772,Staff,16,0,30,14
1650722713612,MATH 20E,B01,083773,Staff,0,0,30,30
1650722713612,MATH 20E,B02,083774,Staff,6,0,30,24
1650722719638,MATH 103A,A01,083777,Staff,0,15,30,30
1650722719638,MATH 103A,A02,083778,Staff,0,15,30,30
1650722719638,MATH 103A,B01,083779,Staff,0,15,30,30
1650722719638,MATH 103A,B02,083780,Staff,0,15,30,30
1650722725663,MATH 105,A01,085443,Staff,0,22,30,30
1650722731689,MATH 109,A01,083213,Anzaldo; Leesa B,0,7,30,30
1650722731689,MATH 109,A02,083214,Anzaldo; Leesa B,0,7,30,30
1650722731689,MATH 109,B01,083215,Anzaldo; Leesa B,0,8,30,30
1650722731689,MATH 109,B02,083216,Anzaldo; Leesa B,0,6,30,30
1650722737724,MATH 142A,A01,083219,Chow; Bennett,0,16,30,30
1650722737724,MATH 142A,A02,083220,Chow; Bennett,0,15,30,30
1650722737724,MATH 142A,B01,083221,Chow; Bennett,0,15,30,30
1650722737724,MATH 142A,B02,083222,Chow; Bennett,0,14,30,30
1650722743824,MATH 193A,A01,083224,Staff,0,5,30,30
1650722743824,MATH 193A,A02,083225,Staff,0,6,30,30
1650722743824,MATH 193A,A03,083781,Staff,0,6,30,30
1650722743824,MATH 193A,A04,083782,Staff,0,7,30,30
1650722749850,MATH 197,001,091859,McAuley; Julian John,9998,0,9999,1
1650722755915,COGS 9,A01,083615,Staff,1,15,60,59
1650722761947,COGS 11,A01,083617,Boyle; Mary E. T.,16,0,40,24
1650722767972,COGS 13,A01,083071,Staff,0,38,40,40
1650722773997,COGS 14A,A01,092681,Staff,0,35,100,100
1650722780028,COGS 14B,A01,083073,Cheng; Tzu-Han,1,13,50,49
1650722786057,COGS 17,A01,092677,Staff,13,0,75,62
1650722792081,COGS 100,A01,083619,Staff,0,28,60,60
1650722798109,COGS 101A,A01,083621,Davis; Joshua Daniel,0,27,60,60
1650722804134,COGS 101B,A01,091572,Staff,0,4,60,60
1650722810166,COGS 101C,A01,083625,Delgado; Tania,14,0,30,16
1650722816195,COGS 107A,A01,083627,Boyle; Mary E. T.,0,16,60,60
1650722822221,COGS 118A,A01,083075,Staff,0,8,60,60
1650722828252,CSE 3,A50,083646,Miranda; Gregory Joseph,18,0,38,20
1650722828252,CSE 3,A51,083647,Miranda; Gregory Joseph,36,0,37,1
1650722834278,CSE 8A,A50,083650,Miranda; Gregory Joseph,0,30,40,40
1650722840305,CSE 11,A01,083080,Cao; Yingjun,0,96,40,40
1650722846334,CSE 12,A01,083652,Staff,0,21,100,100
1650722852361,CSE 15L,A01,083654,Staff,0,3,50,50
1650722852361,CSE 15L,A02,083655,Staff,0,2,50,50
1650722858387,CSE 20,A01,083657,Staff,49,0,80,31
1650722864415,CSE 30,A01,083084,Eldon; John,0,77,40,40
1650722870443,CSE 100,A01,083659,Cao; Yingjun,0,70,50,50
1650722876473,CSE 134B,A01,083661,Powell; Thomas Allan,0,38,65,65
1650722882509,CSE 140,A01,083663,Staff,0,11,75,75
1650722888539,CSE 140L,A01,083088,Eldon; John,0,20,75,75
1650722894566,CSE 175,A01,083665,Kumar; Rakesh,7,0,25,18
1650722900594,CSE 190,A00,092507,Dubnov; Shlomo,10,0,20,10
1650722906666,ECE 45,A01,083139,Staff,1,2,60,59
1650722912690,ECE 65,A50,083695,Staff,0,5,30,30
1650722918718,ECE 109,A01,091882,Touri; Behrouz,33,0,70,37
1650722924750,ECE 180,A00,083140,Abi Samra; Nicholas Camill,20,0,30,10
1650722924750,ECE 180,B00,083141,Abi Samra; Nicholas Camill,0,0,30,30
1650722930779,MATH 10A,A01,083735,Patchell; Gregory David,2,0,30,28
1650722930779,MATH 10A,A02,083736,Patchell; Gregory David,27,0,30,3
1650722930779,MATH 10A,A03,083737,Patchell; Gregory David,24,0,30,6
1650722936810,MATH 10B,A01,083207,Staff,0,9,30,30
1650722936810,MATH 10B,A02,083208,Staff,1,7,30,29
1650722936810,MATH 10B,B01,083739,Staff,11,0,30,19
1650722936810,MATH 10B,B02,083740,Staff,28,0,30,2
1650722942840,MATH 18,A01,083743,Staff,0,0,30,30
1650722942840,MATH 18,A02,083744,Staff,23,0,30,7
1650722942840,MATH 18,A03,083745,Staff,21,0,30,9
1650722942840,MATH 18,A04,083746,Staff,26,0,30,4
1650722942840,MATH 18,B01,083748,Staff,0,15,30,30
1650722942840,MATH 18,B02,083749,Staff,0,12,30,30
1650722942840,MATH 18,B03,083750,Staff,0,12,30,30
1650722942840,MATH 18,B04,083751,Staff,0,12,30,30
1650722948869,MATH 20A,A01,083754,Staff,19,0,40,21
1650722954896,MATH 20B,A01,083756,Staff,0,11,30,30
1650722954896,MATH 20B,A02,083757,Staff,0,12,30,30
1650722960922,MATH 20C,A01,083760,Staff,0,16,30,30
1650722960922,MATH 20C,A02,083761,Staff,0,16,30,30
1650722960922,MATH 20C,B01,083762,Staff,10,0,30,20
1650722960922,MATH 20C,B02,083763,Staff,28,0,30,2
1650722966948,MATH 20D,A01,083765,Staff,2,1,30,28
1650722966948,MATH 20D,A02,083766,Staff,6,0,30,24
1650722966948,MATH 20D,A03,083767,Staff,24,0,30,6
1650722972991,MATH 20E,A01,083771,Staff,3,0,30,27
1650722972991,MATH 20E,A02,083772,Staff,16,0,30,14
1650722972991,MATH 20E,B01,083773,Staff,0,0,30,30
1650722972991,MATH 20E,B02,083774,Staff,6,0,30,24
1650722979018,MATH 103A,A01,083777,Staff,0,15,30,30
1650722979018,MATH 103A,A02,083778,Staff,0,15,30,30
1650722979018,MATH 103A,B01,083779,Staff,0,15,30,30
1650722979018,MATH 103A,B02,083780,Staff,0,15,30,30
1650722985048,MATH 105,A01,085443,Staff,0,22,30,30
1650722991074,MATH 109,A01,083213,Anzaldo; Leesa B,0,7,30,30
1650722991074,MATH 109,A02,083214,Anzaldo; Leesa B,0,7,30,30
1650722991074,MATH 109,B01,083215,Anzaldo; Leesa B,0,8,30,30
1650722991074,MATH 109,B02,083216,Anzaldo; Leesa B,0,6,30,30
1650722997100,MATH 142A,A01,083219,Chow; Bennett,0,16,30,30
1650722997100,MATH 142A,A02,083220,Chow; Bennett,0,15,30,30
1650722997100,MATH 142A,B01,083221,Chow; Bennett,0,15,30,30
1650722997100,MATH 142A,B02,083222,Chow; Bennett,0,14,30,30
1650723003127,MATH 193A,A01,083224,Staff,0,5,30,30
1650723003127,MATH 193A,A02,083225,Staff,0,6,30,30
1650723003127,MATH 193A,A03,083781,Staff,0,6,30,30
1650723003127,MATH 193A,A04,083782,Staff,0,7,30,30
1650723009156,MATH 197,001,091859,McAuley; Julian John,9998,0,9999,1
1650723015218,COGS 9,A01,083615,Staff,1,15,60,59
1650723021244,COGS 11,A01,083617,Boyle; Mary E. T.,16,0,40,24
1650723027276,COGS 13,A01,083071,Staff,0,38,40,40
1650723033302,COGS 14A,A01,092681,Staff,0,35,100,100
1650723039328,COGS 14B,A01,083073,Cheng; Tzu-Han,1,13,50,49
1650723045355,COGS 17,A01,092677,Staff,13,0,75,62
1650723051380,COGS 100,A01,083619,Staff,0,28,60,60
1650723057406,COGS 101A,A01,083621,Davis; Joshua Daniel,0,27,60,60
1650723063431,COGS 101B,A01,091572,Staff,0,4,60,60
1650723069457,COGS 101C,A01,083625,Delgado; Tania,14,0,30,16
1650723075488,COGS 107A,A01,083627,Boyle; Mary E. T.,0,16,60,60
1650723081522,COGS 118A,A01,083075,Staff,0,8,60,60
1650723087553,CSE 3,A50,083646,Miranda; Gregory Joseph,18,0,38,20
1650723087553,CSE 3,A51,083647,Miranda; Gregory Joseph,36,0,37,1
1650723093582,CSE 8A,A50,083650,Miranda; Gregory Joseph,0,30,40,40
1650723099611,CSE 11,A01,083080,Cao; Yingjun,0,96,40,40
1650723105634,CSE 12,A01,083652,Staff,0,21,100,100
1650723111658,CSE 15L,A01,083654,Staff,0,3,50,50
1650723111658,CSE 15L,A02,083655,Staff,0,2,50,50
1650723117683,CSE 20,A01,083657,Staff,49,0,80,31
1650723123712,CSE 30,A01,083084,Eldon; John,0,77,40,40
1650723129763,CSE 100,A01,083659,Cao; Yingjun,0,70,50,50
1650723135787,CSE 134B,A01,083661,Powell; Thomas Allan,0,38,65,65
1650723141814,CSE 140,A01,083663,Staff,0,11,75,75
1650723147839,CSE 140L,A01,083088,Eldon; John,0,20,75,75
1650723153864,CSE 175,A01,083665,Kumar; Rakesh,7,0,25,18
1650723159895,CSE 190,A00,092507,Dubnov; Shlomo,10,0,20,10
1650723165924,ECE 45,A01,083139,Staff,1,2,60,59
1650723171953,ECE 65,A50,083695,Staff,0,5,30,30
1650723177988,ECE 109,A01,091882,Touri; Behrouz,33,0,70,37
1650723184015,ECE 180,A00,083140,Abi Samra; Nicholas Camill,20,0,30,10
1650723184015,ECE 180,B00,083141,Abi Samra; Nicholas Camill,0,0,30,30
1650723190055,MATH 10A,A01,083735,Patchell; Gregory David,2,0,30,28
1650723190055,MATH 10A,A02,083736,Patchell; Gregory David,27,0,30,3
1650723190055,MATH 10A,A03,083737,Patchell; Gregory David,24,0,30,6
1650723196085,MATH 10B,A01,083207,Staff,0,9,30,30
1650723196085,MATH 10B,A02,083208,Staff,1,7,30,29
1650723196085,MATH 10B,B01,083739,Staff,11,0,30,19
1650723196085,MATH 10B,B02,083740,Staff,28,0,30,2
1650723202121,MATH 18,A01,083743,Staff,0,0,30,30
1650723202121,MATH 18,A02,083744,Staff,23,0,30,7
1650723202121,MATH 18,A03,083745,Staff,21,0,30,9
1650723202121,MATH 18,A04,083746,Staff,26,0,30,4
1650723202121,MATH 18,B01,083748,Staff,0,15,30,30
1650723202121,MATH 18,B02,083749,Staff,0,12,30,30
1650723202121,MATH 18,B03,083750,Staff,0,12,30,30
1650723202121,MATH 18,B04,083751,Staff,0,12,30,30
1650723208144,MATH 20A,A01,083754,Staff,19,0,40,21
1650723214169,MATH 20B,A01,083756,Staff,0,11,30,30
1650723214169,MATH 20B,A02,083757,Staff,0,12,30,30
1650723220198,MATH 20C,A01,083760,Staff,0,16,30,30
1650723220198,MATH 20C,A02,083761,Staff,0,16,30,30
1650723220198,MATH 20C,B01,083762,Staff,10,0,30,20
1650723220198,MATH 20C,B02,083763,Staff,28,0,30,2
1650723226223,MATH 20D,A01,083765,Staff,2,1,30,28
1650723226223,MATH 20D,A02,083766,Staff,6,0,30,24
1650723226223,MATH 20D,A03,083767,Staff,24,0,30,6
1650723232250,MATH 20E,A01,083771,Staff,3,0,30,27
1650723232250,MATH 20E,A02,083772,Staff,16,0,30,14
1650723232250,MATH 20E,B01,083773,Staff,0,0,30,30
1650723232250,MATH 20E,B02,083774,Staff,6,0,30,24
1650723238282,MATH 103A,A01,083777,Staff,0,15,30,30
1650723238282,MATH 103A,A02,083778,Staff,0,15,30,30
1650723238282,MATH 103A,B01,083779,Staff,0,15,30,30
1650723238282,MATH 103A,B02,083780,Staff,0,15,30,30
1650723244308,MATH 105,A01,085443,Staff,0,22,30,30
1650723250334,MATH 109,A01,083213,Anzaldo; Leesa B,0,7,30,30
1650723250334,MATH 109,A02,083214,Anzaldo; Leesa B,0,7,30,30
1650723250334,MATH 109,B01,083215,Anzaldo; Leesa B,0,8,30,30
1650723250334,MATH 109,B02,083216,Anzaldo; Leesa B,0,6,30,30
1650723256372,MATH 142A,A01,083219,Chow; Bennett,0,16,30,30
1650723256372,MATH 142A,A02,083220,Chow; Bennett,0,15,30,30
1650723256372,MATH 142A,B01,083221,Chow; Bennett,0,15,30,30
1650723256372,MATH 142A,B02,083222,Chow; Bennett,0,14,30,30
1650723262397,MATH 193A,A01,083224,Staff,0,5,30,30
1650723262397,MATH 193A,A02,083225,Staff,0,6,30,30
1650723262397,MATH 193A,A03,083781,Staff,0,6,30,30
1650723262397,MATH 193A,A04,083782,Staff,0,7,30,30
1650723268422,MATH 197,001,091859,McAuley; Julian John,9998,0,9999,1
1650723274486,COGS 9,A01,083615,Staff,1,15,60,59
1650723280512,COGS 11,A01,083617,Boyle; Mary E. T.,16,0,40,24
1650723286543,COGS 13,A01,083071,Staff,0,38,40,40
1650723292572,COGS 14A,A01,092681,Staff,0,35,100,100
1650723298597,COGS 14B,A01,083073,Cheng; Tzu-Han,1,13,50,49
1650723304625,COGS 17,A01,092677,Staff,13,0,75,62
1650723310650,COGS 100,A01,083619,Staff,0,28,60,60
1650723316676,COGS 101A,A01,083621,Davis; Joshua Daniel,0,27,60,60
1650723322704,COGS 101B,A01,091572,Staff,0,4,60,60
1650723328730,COGS 101C,A01,083625,Delgado; Tania,14,0,30,16
1650723334847,COGS 107A,A01,083627,Boyle; Mary E. T.,0,16,60,60
1650723340875,COGS 118A,A01,083075,Staff,0,8,60,60
1650723346902,CSE 3,A50,083646,Miranda; Gregory Joseph,18,0,38,20
1650723346902,CSE 3,A51,083647,Miranda; Gregory Joseph,36,0,37,1
1650723352931,CSE 8A,A50,083650,Miranda; Gregory Joseph,0,30,40,40
1650723358957,CSE 11,A01,083080,Cao; Yingjun,0,96,40,40
1650723364986,CSE 12,A01,083652,Staff,0,21,100,100
1650723371021,CSE 15L,A01,083654,Staff,0,3,50,50
1650723371021,CSE 15L,A02,083655,Staff,0,2,50,50
1650723377061,CSE 20,A01,083657,Staff,49,0,80,31
1650723383093,CSE 30,A01,083084,Eldon; John,0,77,40,40
1650723389125,CSE 100,A01,083659,Cao; Yingjun,0,70,50,50
1650723395149,CSE 134B,A01,083661,Powell; Thomas Allan,0,38,65,65
1650723401188,CSE 140,A01,083663,Staff,0,11,75,75
1650723407216,CSE 140L,A01,083088,Eldon; John,0,20,75,75
1650723413241,CSE 175,A01,083665,Kumar; Rakesh,7,0,25,18
1650723419271,CSE 190,A00,092507,Dubnov; Shlomo,10,0,20,10
1650723425299,ECE 45,A01,083139,Staff,1,2,60,59
1650723431327,ECE 65,A50,083695,Staff,0,5,30,30
1650723437354,ECE 109,A01,091882,Touri; Behrouz,33,0,70,37
1650723443380,ECE 180,A00,083140,Abi Samra; Nicholas Camill,20,0,30,10
1650723443380,ECE 180,B00,083141,Abi Samra; Nicholas Camill,0,0,30,30
1650723449427,MATH 10A,A01,083735,Patchell; Gregory David,2,0,30,28
1650723449427,MATH 10A,A02,083736,Patchell; Gregory David,27,0,30,3
1650723449427,MATH 10A,A03,083737,Patchell; Gregory David,24,0,30,6
1650723455463,MATH 10B,A01,083207,Staff,0,9,30,30
1650723455463,MATH 10B,A02,083208,Staff,1,7,30,29
1650723455463,MATH 10B,B01,083739,Staff,11,0,30,19
1650723455463,MATH 10B,B02,083740,Staff,28,0,30,2
1650723461498,MATH 18,A01,083743,Staff,0,0,30,30
1650723461498,MATH 18,A02,083744,Staff,23,0,30,7
1650723461498,MATH 18,A03,083745,Staff,21,0,30,9
1650723461498,MATH 18,A04,083746,Staff,26,0,30,4
1650723461498,MATH 18,B01,083748,Staff,0,15,30,30
1650723461498,MATH 18,B02,083749,Staff,0,12,30,30
1650723461498,MATH 18,B03,083750,Staff,0,12,30,30
1650723461498,MATH 18,B04,083751,Staff,0,12,30,30
1650723467526,MATH 20A,A01,083754,Staff,19,0,40,21
1650723473558,MATH 20B,A01,083756,Staff,0,11,30,30
1650723473558,MATH 20B,A02,083757,Staff,0,12,30,30
1650723479586,MATH 20C,A01,083760,Staff,0,16,30,30
1650723479586,MATH 20C,A02,083761,Staff,0,16,30,30
1650723479586,MATH 20C,B01,083762,Staff,10,0,30,20
1650723479586,MATH 20C,B02,083763,Staff,28,0,30,2
1650723485610,MATH 20D,A01,083765,Staff,2,1,30,28
1650723485610,MATH 20D,A02,083766,Staff,6,0,30,24
1650723485610,MATH 20D,A03,083767,Staff,24,0,30,6
1650723491637,MATH 20E,A01,083771,Staff,3,0,30,27
1650723491637,MATH 20E,A02,083772,Staff,16,0,30,14
1650723491637,MATH 20E,B01,083773,Staff,0,0,30,30
1650723491637,MATH 20E,B02,083774,Staff,6,0,30,24
1650723497666,MATH 103A,A01,083777,Staff,0,15,30,30
1650723497666,MATH 103A,A02,083778,Staff,0,15,30,30
1650723497666,MATH 103A,B01,083779,Staff,0,15,30,30
1650723497666,MATH 103A,B02,083780,Staff,0,15,30,30
1650723503696,MATH 105,A01,085443,Staff,0,22,30,30
1650723509734,MATH 109,A01,083213,Anzaldo; Leesa B,0,7,30,30
1650723509734,MATH 109,A02,083214,Anzaldo; Leesa B,0,7,30,30
1650723509734,MATH 109,B01,083215,Anzaldo; Leesa B,0,8,30,30
1650723509734,MATH 109,B02,083216,Anzaldo; Leesa B,0,6,30,30
1650723515760,MATH 142A,A01,083219,Chow; Bennett,0,16,30,30
1650723515760,MATH 142A,A02,083220,Chow; Bennett,0,15,30,30
1650723515760,MATH 142A,B01,083221,Chow; Bennett,0,15,30,30
1650723515760,MATH 142A,B02,083222,Chow; Bennett,0,14,30,30
1650723521792,MATH 193A,A01,083224,Staff,0,5,30,30
1650723521792,MATH 193A,A02,083225,Staff,0,6,30,30
1650723521792,MATH 193A,A03,083781,Staff,0,6,30,30
1650723521792,MATH 193A,A04,083782,Staff,0,7,30,30
1650723527824,MATH 197,001,091859,McAuley; Julian John,9998,0,9999,1
1650723533902,COGS 9,A01,083615,Staff,1,15,60,59
1650723539927,COGS 11,A01,083617,Boyle; Mary E. T.,16,0,40,24
1650723545958,COGS 13,A01,083071,Staff,0,38,40,40
1650723551989,COGS 14A,A01,092681,Staff,0,35,100,100
1650723558020,COGS 14B,A01,083073,Cheng; Tzu-Han,1,13,50,49
1650723564043,COGS 17,A01,092677,Staff,13,0,75,62
1650723570069,COGS 100,A01,083619,Staff,0,28,60,60
1650723576096,COGS 101A,A01,083621,Davis; Joshua Daniel,0,27,60,60
1650723582123,COGS 101B,A01,091572,Staff,0,4,60,60
1650723588154,COGS 101C,A01,083625,Delgado; Tania,14,0,30,16
1650723594179,COGS 107A,A01,083627,Boyle; Mary E. T.,0,16,60,60
1650723600206,COGS 118A,A01,083075,Staff,0,8,60,60
1650723606247,CSE 3,A50,083646,Miranda; Gregory Joseph,18,0,38,20
1650723606247,CSE 3,A51,083647,Miranda; Gregory Joseph,36,0,37,1
1650723612273,CSE 8A,A50,083650,Miranda; Gregory Joseph,0,30,40,40
1650723618312,CSE 11,A01,083080,Cao; Yingjun,0,96,40,40
1650723624335,CSE 12,A01,083652,Staff,0,21,100,100
1650723630363,CSE 15L,A01,083654,Staff,0,3,50,50
1650723630363,CSE 15L,A02,083655,Staff,0,2,50,50
1650723636390,CSE 20,A01,083657,Staff,49,0,80,31
1650723642416,CSE 30,A01,083084,Eldon; John,0,77,40,40
1650723648445,CSE 100,A01,083659,Cao; Yingjun,0,70,50,50
1650723654478,CSE 134B,A01,083661,Powell; Thomas Allan,0,38,65,65
1650723660505,CSE 140,A01,083663,Staff,0,11,75,75
1650723666536,CSE 140L,A01,083088,Eldon; John,0,20,75,75
1650723672562,CSE 175,A01,083665,Kumar; Rakesh,7,0,25,18
1650723678585,CSE 190,A00,092507,Dubnov; Shlomo,10,0,20,10
1650723684609,ECE 45,A01,083139,Staff,1,2,60,59
1650723690638,ECE 65,A50,083695,Staff,0,5,30,30
1650723696664,ECE 109,A01,091882,Touri; Behrouz,33,0,70,37
1650723702690,ECE 180,A00,083140,Abi Samra; Nicholas Camill,20,0,30,10
1650723702690,ECE 180,B00,083141,Abi Samra; Nicholas Camill,0,0,30,30
1650723708723,MATH 10A,A01,083735,Patchell; Gregory David,2,0,30,28
1650723708723,MATH 10A,A02,083736,Patchell; Gregory David,27,0,30,3
1650723708723,MATH 10A,A03,083737,Patchell; Gregory David,24,0,30,6
1650723714748,MATH 10B,A01,083207,Staff,0,9,30,30
1650723714748,MATH 10B,A02,083208,Staff,1,7,30,29
1650723714748,MATH 10B,B01,083739,Staff,11,0,30,19
1650723714748,MATH 10B,B02,083740,Staff,28,0,30,2
1650723720781,MATH 18,A01,083743,Staff,0,0,30,30
1650723720781,MATH 18,A02,083744,Staff,23,0,30,7
1650723720781,MATH 18,A03,083745,Staff,21,0,30,9
1650723720781,MATH 18,A04,083746,Staff,26,0,30,4
1650723720781,MATH 18,B01,083748,Staff,0,15,30,30
1650723720781,MATH 18,B02,083749,Staff,0,12,30,30
1650723720781,MATH 18,B03,083750,Staff,0,12,30,30
1650723720781,MATH 18,B04,083751,Staff,0,12,30,30
1650723726810,MATH 20A,A01,083754,Staff,19,0,40,21
1650723732839,MATH 20B,A01,083756,Staff,0,11,30,30
1650723732839,MATH 20B,A02,083757,Staff,0,12,30,30
1650723738867,MATH 20C,A01,083760,Staff,0,16,30,30
1650723738867,MATH 20C,A02,083761,Staff,0,16,30,30
1650723738867,MATH 20C,B01,083762,Staff,10,0,30,20
1650723738867,MATH 20C,B02,083763,Staff,28,0,30,2
1650723744893,MATH 20D,A01,083765,Staff,2,1,30,28
1650723744893,MATH 20D,A02,083766,Staff,6,0,30,24
1650723744893,MATH 20D,A03,083767,Staff,24,0,30,6
1650723750919,MATH 20E,A01,083771,Staff,3,0,30,27
1650723750919,MATH 20E,A02,083772,Staff,16,0,30,14
1650723750919,MATH 20E,B01,083773,Staff,0,0,30,30
1650723750919,MATH 20E,B02,083774,Staff,6,0,30,24
1650723756944,MATH 103A,A01,083777,Staff,0,15,30,30
1650723756944,MATH 103A,A02,083778,Staff,0,15,30,30
1650723756944,MATH 103A,B01,083779,Staff,0,15,30,30
1650723756944,MATH 103A,B02,083780,Staff,0,15,30,30
1650723762969,MATH 105,A01,085443,Staff,0,22,30,30
1650723768995,MATH 109,A01,083213,Anzaldo; Leesa B,0,7,30,30
1650723768995,MATH 109,A02,083214,Anzaldo; Leesa B,0,7,30,30
1650723768995,MATH 109,B01,083215,Anzaldo; Leesa B,0,8,30,30
1650723768995,MATH 109,B02,083216,Anzaldo; Leesa B,0,6,30,30
1650723775025,MATH 142A,A01,083219,Chow; Bennett,0,16,30,30
1650723775025,MATH 142A,A02,083220,Chow; Bennett,0,15,30,30
1650723775025,MATH 142A,B01,083221,Chow; Bennett,0,15,30,30
1650723775025,MATH 142A,B02,083222,Chow; Bennett,0,14,30,30
1650723781055,MATH 193A,A01,083224,Staff,0,5,30,30
1650723781055,MATH 193A,A02,083225,Staff,0,6,30,30
1650723781055,MATH 193A,A03,083781,Staff,0,6,30,30
1650723781055,MATH 193A,A04,083782,Staff,0,7,30,30
1650723787081,MATH 197,001,091859,McAuley; Julian John,9998,0,9999,1
1650723793137,COGS 9,A01,083615,Staff,1,15,60,59
1650723799163,COGS 11,A01,083617,Boyle; Mary E. T.,16,0,40,24
1650723805187,COGS 13,A01,083071,Staff,0,38,40,40
1650723811211,COGS 14A,A01,092681,Staff,0,35,100,100
1650723817241,COGS 14B,A01,083073,Cheng; Tzu-Han,1,13,50,49
1650723823267,COGS 17,A01,092677,Staff,13,0,75,62
1650723829293,COGS 100,A01,083619,Staff,0,28,60,60
1650723835322,COGS 101A,A01,083621,Davis; Joshua Daniel,0,27,60,60
1650723841345,COGS 101B,A01,091572,Staff,0,4,60,60
1650723847373,COGS 101C,A01,083625,Delgado; Tania,14,0,30,16
1650723853397,COGS 107A,A01,083627,Boyle; Mary E. T.,0,16,60,60
1650723859425,COGS 118A,A01,083075,Staff,0,8,60,60
1650723865449,CSE 3,A50,083646,Miranda; Gregory Joseph,18,0,38,20
1650723865449,CSE 3,A51,083647,Miranda; Gregory Joseph,36,0,37,1
1650723871476,CSE 8A,A50,083650,Miranda; Gregory Joseph,0,30,40,40
1650723877502,CSE 11,A01,083080,Cao; Yingjun,0,96,40,40
1650723883526,CSE 12,A01,083652,Staff,0,21,100,100
1650723889550,CSE 15L,A01,083654,Staff,0,3,50,50
1650723889550,CSE 15L,A02,083655,Staff,0,2,50,50
1650723895576,CSE 20,A01,083657,Staff,49,0,80,31
1650723901601,CSE 30,A01,083084,Eldon; John,0,77,40,40
1650723907630,CSE 100,A01,083659,Cao; Yingjun,0,70,50,50
1650723913654,CSE 134B,A01,083661,Powell; Thomas Allan,0,38,65,65
1650723919693,CSE 140,A01,083663,Staff,0,11,75,75
1650723925717,CSE 140L,A01,083088,Eldon; John,0,20,75,75
1650723931835,CSE 175,A01,083665,Kumar; Rakesh,7,0,25,18
1650723937859,CSE 190,A00,092507,Dubnov; Shlomo,10,0,20,10
1650723943886,ECE 45,A01,083139,Staff,1,2,60,59
1650723949911,ECE 65,A50,083695,Staff,0,5,30,30
1650723955936,ECE 109,A01,091882,Touri; Behrouz,33,0,70,37
1650723961973,ECE 180,A00,083140,Abi Samra; Nicholas Camill,20,0,30,10
1650723961973,ECE 180,B00,083141,Abi Samra; Nicholas Camill,0,0,30,30
1650723967999,MATH 10A,A01,083735,Patchell; Gregory David,2,0,30,28
1650723967999,MATH 10A,A02,083736,Patchell; Gregory David,27,0,30,3
1650723967999,MATH 10A,A03,083737,Patchell; Gregory David,24,0,30,6
1650723974025,MATH 10B,A01,083207,Staff,0,9,30,30
1650723974025,MATH 10B,A02,083208,Staff,1,7,30,29
1650723974025,MATH 10B,B01,083739,Staff,11,0,30,19
1650723974025,MATH 10B,B02,083740,Staff,28,0,30,2
1650723980050,MATH 18,A01,083743,Staff,0,0,30,30
1650723980050,MATH 18,A02,083744,Staff,23,0,30,7
1650723980050,MATH 18,A03,083745,Staff,21,0,30,9
1650723980050,MATH 18,A04,083746,Staff,26,0,30,4
1650723980050,MATH 18,B01,083748,Staff,0,15,30,30
1650723980050,MATH 18,B02,083749,Staff,0,12,30,30
1650723980050,MATH 18,B03,083750,Staff,0,12,30,30
1650723980050,MATH 18,B04,083751,Staff,0,12,30,30
1650723986079,MATH 20A,A01,083754,Staff,19,0,40,21
1650723992110,MATH 20B,A01,083756,Staff,0,11,30,30
1650723992110,MATH 20B,A02,083757,Staff,0,12,30,30
1650723998143,MATH 20C,A01,083760,Staff,0,16,30,30
1650723998143,MATH 20C,A02,083761,Staff,0,16,30,30
1650723998143,MATH 20C,B01,083762,Staff,10,0,30,20
1650723998143,MATH 20C,B02,083763,Staff,28,0,30,2
1650724004166,MATH 20D,A01,083765,Staff,2,1,30,28
1650724004166,MATH 20D,A02,083766,Staff,6,0,30,24
1650724004166,MATH 20D,A03,083767,Staff,24,0,30,6
1650724010196,MATH 20E,A01,083771,Staff,3,0,30,27
1650724010196,MATH 20E,A02,083772,Staff,16,0,30,14
1650724010196,MATH 20E,B01,083773,Staff,0,0,30,30
1650724010196,MATH 20E,B02,083774,Staff,6,0,30,24
1650724016220,MATH 103A,A01,083777,Staff,0,15,30,30
1650724016220,MATH 103A,A02,083778,Staff,0,15,30,30
1650724016220,MATH 103A,B01,083779,Staff,0,15,30,30
1650724016220,MATH 103A,B02,083780,Staff,0,15,30,30
1650724022245,MATH 105,A01,085443,Staff,0,22,30,30
1650724028273,MATH 109,A01,083213,Anzaldo; Leesa B,0,7,30,30
1650724028273,MATH 109,A02,083214,Anzaldo; Leesa B,0,7,30,30
1650724028273,MATH 109,B01,083215,Anzaldo; Leesa B,0,8,30,30
1650724028273,MATH 109,B02,083216,Anzaldo; Leesa B,0,6,30,30
1650724034303,MATH 142A,A01,083219,Chow; Bennett,0,16,30,30
1650724034303,MATH 142A,A02,083220,Chow; Bennett,0,15,30,30
1650724034303,MATH 142A,B01,083221,Chow; Bennett,0,15,30,30
1650724034303,MATH 142A,B02,083222,Chow; Bennett,0,14,30,30
1650724040327,MATH 193A,A01,083224,Staff,0,5,30,30
1650724040327,MATH 193A,A02,083225,Staff,0,6,30,30
1650724040327,MATH 193A,A03,083781,Staff,0,6,30,30
1650724040327,MATH 193A,A04,083782,Staff,0,7,30,30
1650724046354,MATH 197,001,091859,McAuley; Julian John,9998,0,9999,1
1650724052419,COGS 9,A01,083615,Staff,1,15,60,59
1650724058448,COGS 11,A01,083617,Boyle; Mary E. T.,16,0,40,24
1650724064473,COGS 13,A01,083071,Staff,0,38,40,40
1650724070503,COGS 14A,A01,092681,Staff,0,35,100,100
1650724076536,COGS 14B,A01,083073,Cheng; Tzu-Han,1,13,50,49
1650724082565,COGS 17,A01,092677,Staff,13,0,75,62
1650724088597,COGS 100,A01,083619,Staff,0,28,60,60
1650724094627,COGS 101A,A01,083621,Davis; Joshua Daniel,0,27,60,60
1650724100651,COGS 101B,A01,091572,Staff,0,4,60,60
1650724106680,COGS 101C,A01,083625,Delgado; Tania,14,0,30,16
1650724112706,COGS 107A,A01,083627,Boyle; Mary E. T.,0,16,60,60
1650724118733,COGS 118A,A01,083075,Staff,0,8,60,60
1650724124757,CSE 3,A50,083646,Miranda; Gregory Joseph,18,0,38,20
1650724124757,CSE 3,A51,083647,Miranda; Gregory Joseph,36,0,37,1
1650724130786,CSE 8A,A50,083650,Miranda; Gregory Joseph,0,30,40,40
1650724136809,CSE 11,A01,083080,Cao; Yingjun,0,96,40,40
1650724142858,CSE 12,A01,083652,Staff,0,21,100,100
1650724148882,CSE 15L,A01,083654,Staff,0,3,50,50
1650724148882,CSE 15L,A02,083655,Staff,0,2,50,50
1650724154906,CSE 20,A01,083657,Staff,49,0,80,31
1650724160932,CSE 30,A01,083084,Eldon; John,0,77,40,40
1650724166958,CSE 100,A01,083659,Cao; Yingjun,0,70,50,50
1650724172983,CSE 134B,A01,083661,Powell; Thomas Allan,0,38,65,65
1650724179013,CSE 140,A01,083663,Staff,0,11,75,75
1650724185036,CSE 140L,A01,083088,Eldon; John,0,20,75,75
1650724191066,CSE 175,A01,083665,Kumar; Rakesh,7,0,25,18
1650724197101,CSE 190,A00,092507,Dubnov; Shlomo,10,0,20,10
1650724203126,ECE 45,A01,083139,Staff,1,2,60,59
1650724209154,ECE 65,A50,083695,Staff,0,5,30,30
1650724215181,ECE 109,A01,091882,Touri; Behrouz,33,0,70,37
1650724221203,ECE 180,A00,083140,Abi Samra; Nicholas Camill,20,0,30,10
1650724221203,ECE 180,B00,083141,Abi Samra; Nicholas Camill,0,0,30,30
1650724227231,MATH 10A,A01,083735,Patchell; Gregory David,2,0,30,28
1650724227231,MATH 10A,A02,083736,Patchell; Gregory David,27,0,30,3
1650724227231,MATH 10A,A03,083737,Patchell; Gregory David,24,0,30,6
1650724233257,MATH 10B,A01,083207,Staff,0,9,30,30
1650724233257,MATH 10B,A02,083208,Staff,1,7,30,29
1650724233257,MATH 10B,B01,083739,Staff,11,0,30,19
1650724233257,MATH 10B,B02,083740,Staff,28,0,30,2
1650724239284,MATH 18,A01,083743,Staff,0,0,30,30
1650724239284,MATH 18,A02,083744,Staff,23,0,30,7
1650724239284,MATH 18,A03,083745,Staff,21,0,30,9
1650724239284,MATH 18,A04,083746,Staff,26,0,30,4
1650724239284,MATH 18,B01,083748,Staff,0,15,30,30
1650724239284,MATH 18,B02,083749,Staff,0,12,30,30
1650724239284,MATH 18,B03,083750,Staff,0,12,30,30
1650724239284,MATH 18,B04,083751,Staff,0,12,30,30
1650724245316,MATH 20A,A01,083754,Staff,19,0,40,21
1650724251340,MATH 20B,A01,083756,Staff,0,11,30,30
1650724251340,MATH 20B,A02,083757,Staff,0,12,30,30
1650724257365,MATH 20C,A01,083760,Staff,0,16,30,30
1650724257365,MATH 20C,A02,083761,Staff,0,16,30,30
1650724257365,MATH 20C,B01,083762,Staff,10,0,30,20
1650724257365,MATH 20C,B02,083763,Staff,28,0,30,2
1650724263395,MATH 20D,A01,083765,Staff,2,1,30,28
1650724263395,MATH 20D,A02,083766,Staff,6,0,30,24
1650724263395,MATH 20D,A03,083767,Staff,24,0,30,6
1650724269427,MATH 20E,A01,083771,Staff,3,0,30,27
1650724269427,MATH 20E,A02,083772,Staff,16,0,30,14
1650724269427,MATH 20E,B01,083773,Staff,0,0,30,30
1650724269427,MATH 20E,B02,083774,Staff,6,0,30,24
1650724275453,MATH 103A,A01,083777,Staff,0,15,30,30
1650724275453,MATH 103A,A02,083778,Staff,0,15,30,30
1650724275453,MATH 103A,B01,083779,Staff,0,15,30,30
1650724275453,MATH 103A,B02,083780,Staff,0,15,30,30
1650724281477,MATH 105,A01,085443,Staff,0,22,30,30
1650724287507,MATH 109,A01,083213,Anzaldo; Leesa B,0,7,30,30
1650724287507,MATH 109,A02,083214,Anzaldo; Leesa B,0,7,30,30
1650724287507,MATH 109,B01,083215,Anzaldo; Leesa B,0,8,30,30
1650724287507,MATH 109,B02,083216,Anzaldo; Leesa B,0,6,30,30
1650724293531,MATH 142A,A01,083219,Chow; Bennett,0,16,30,30
1650724293531,MATH 142A,A02,083220,Chow; Bennett,0,15,30,30
1650724293531,MATH 142A,B01,083221,Chow; Bennett,0,15,30,30
1650724293531,MATH 142A,B02,083222,Chow; Bennett,0,14,30,30
1650724299556,MATH 193A,A01,083224,Staff,0,5,30,30
1650724299556,MATH 193A,A02,083225,Staff,0,6,30,30
1650724299556,MATH 193A,A03,083781,Staff,0,6,30,30
1650724299556,MATH 193A,A04,083782,Staff,0,7,30,30
1650724305580,MATH 197,001,091859,McAuley; Julian John,9998,0,9999,1
1650724311645,COGS 9,A01,083615,Staff,1,15,60,59
1650724317672,COGS 11,A01,083617,Boyle; Mary E. T.,16,0,40,24
1650724323699,COGS 13,A01,083071,Staff,0,38,40,40
1650724329731,COGS 14A,A01,092681,Staff,0,35,100,100
1650724335756,COGS 14B,A01,083073,Cheng; Tzu-Han,1,13,50,49
1650724341780,COGS 17,A01,092677,Staff,13,0,75,62
1650724347809,COGS 100,A01,083619,Staff,0,28,60,60
1650724353837,COGS 101A,A01,083621,Davis; Joshua Daniel,0,27,60,60
1650724359862,COGS 101B,A01,091572,Staff,0,4,60,60
1650724365894,COGS 101C,A01,083625,Delgado; Tania,14,0,30,16
1650724371924,COGS 107A,A01,083627,Boyle; Mary E. T.,0,16,60,60
1650724377953,COGS 118A,A01,083075,Staff,0,8,60,60
1650724383984,CSE 3,A50,083646,Miranda; Gregory Joseph,18,0,38,20
1650724383984,CSE 3,A51,083647,Miranda; Gregory Joseph,36,0,37,1
1650724390013,CSE 8A,A50,083650,Miranda; Gregory Joseph,0,30,40,40
1650724396038,CSE 11,A01,083080,Cao; Yingjun,0,96,40,40
1650724402064,CSE 12,A01,083652,Staff,0,21,100,100
1650724408088,CSE 15L,A01,083654,Staff,0,3,50,50
1650724408088,CSE 15L,A02,083655,Staff,0,2,50,50
1650724414111,CSE 20,A01,083657,Staff,49,0,80,31
1650724420135,CSE 30,A01,083084,Eldon; John,0,77,40,40
1650724426157,CSE 100,A01,083659,Cao; Yingjun,0,70,50,50
1650724432182,CSE 134B,A01,083661,Powell; Thomas Allan,0,38,65,65
1650724438211,CSE 140,A01,083663,Staff,0,11,75,75
1650724444240,CSE 140L,A01,083088,Eldon; John,0,20,75,75
1650724450265,CSE 175,A01,083665,Kumar; Rakesh,7,0,25,18
1650724456297,CSE 190,A00,092507,Dubnov; Shlomo,10,0,20,10
1650724462320,ECE 45,A01,083139,Staff,1,2,60,59
1650724468345,ECE 65,A50,083695,Staff,0,5,30,30
1650724474374,ECE 109,A01,091882,Touri; Behrouz,33,0,70,37
1650724480398,ECE 180,A00,083140,Abi Samra; Nicholas Camill,20,0,30,10
1650724480398,ECE 180,B00,083141,Abi Samra; Nicholas Camill,0,0,30,30
1650724486427,MATH 10A,A01,083735,Patchell; Gregory David,2,0,30,28
1650724486427,MATH 10A,A02,083736,Patchell; Gregory David,27,0,30,3
1650724486427,MATH 10A,A03,083737,Patchell; Gregory David,24,0,30,6
1650724492460,MATH 10B,A01,083207,Staff,0,9,30,30
1650724492460,MATH 10B,A02,083208,Staff,1,7,30,29
1650724492460,MATH 10B,B01,083739,Staff,11,0,30,19
1650724492460,MATH 10B,B02,083740,Staff,28,0,30,2
1650724498486,MATH 18,A01,083743,Staff,0,0,30,30
1650724498486,MATH 18,A02,083744,Staff,23,0,30,7
1650724498486,MATH 18,A03,083745,Staff,21,0,30,9
1650724498486,MATH 18,A04,083746,Staff,26,0,30,4
1650724498486,MATH 18,B01,083748,Staff,0,15,30,30
1650724498486,MATH 18,B02,083749,Staff,0,12,30,30
1650724498486,MATH 18,B03,083750,Staff,0,12,30,30
1650724498486,MATH 18,B04,083751,Staff,0,12,30,30
1650724504512,MATH 20A,A01,083754,Staff,19,0,40,21
1650724510541,MATH 20B,A01,083756,Staff,0,11,30,30
1650724510541,MATH 20B,A02,083757,Staff,0,12,30,30
1650724516570,MATH 20C,A01,083760,Staff,0,16,30,30
1650724516570,MATH 20C,A02,083761,Staff,0,16,30,30
1650724516570,MATH 20C,B01,083762,Staff,10,0,30,20
1650724516570,MATH 20C,B02,083763,Staff,28,0,30,2
1650724522594,MATH 20D,A01,083765,Staff,2,1,30,28
1650724522594,MATH 20D,A02,083766,Staff,6,0,30,24
1650724522594,MATH 20D,A03,083767,Staff,24,0,30,6
1650724528722,MATH 20E,A01,083771,Staff,3,0,30,27
1650724528722,MATH 20E,A02,083772,Staff,16,0,30,14
1650724528722,MATH 20E,B01,083773,Staff,0,0,30,30
1650724528722,MATH 20E,B02,083774,Staff,6,0,30,24
1650724534748,MATH 103A,A01,083777,Staff,0,15,30,30
1650724534748,MATH 103A,A02,083778,Staff,0,15,30,30
1650724534748,MATH 103A,B01,083779,Staff,0,15,30,30
1650724534748,MATH 103A,B02,083780,Staff,0,15,30,30
1650724540775,MATH 105,A01,085443,Staff,0,22,30,30
1650724546800,MATH 109,A01,083213,Anzaldo; Leesa B,0,7,30,30
1650724546800,MATH 109,A02,083214,Anzaldo; Leesa B,0,7,30,30
1650724546800,MATH 109,B01,083215,Anzaldo; Leesa B,0,8,30,30
1650724546800,MATH 109,B02,083216,Anzaldo; Leesa B,0,6,30,30
1650724552828,MATH 142A,A01,083219,Chow; Bennett,0,16,30,30
1650724552828,MATH 142A,A02,083220,Chow; Bennett,0,15,30,30
1650724552828,MATH 142A,B01,083221,Chow; Bennett,0,15,30,30
1650724552828,MATH 142A,B02,083222,Chow; Bennett,0,14,30,30
1650724558854,MATH 193A,A01,083224,Staff,0,5,30,30
1650724558854,MATH 193A,A02,083225,Staff,0,6,30,30
1650724558854,MATH 193A,A03,083781,Staff,0,6,30,30
1650724558854,MATH 193A,A04,083782,Staff,0,7,30,30
1650724564878,MATH 197,001,091859,McAuley; Julian John,9998,0,9999,1
1650724570943,COGS 9,A01,083615,Staff,1,15,60,59
1650724576968,COGS 11,A01,083617,Boyle; Mary E. T.,16,0,40,24
1650724582993,COGS 13,A01,083071,Staff,0,38,40,40
1650724589018,COGS 14A,A01,092681,Staff,0,35,100,100
1650724595043,COGS 14B,A01,083073,Cheng; Tzu-Han,1,13,50,49
1650724601068,COGS 17,A01,092677,Staff,13,0,75,62
1650724607095,COGS 100,A01,083619,Staff,0,28,60,60
1650724613122,COGS 101A,A01,083621,Davis; Joshua Daniel,0,27,60,60
1650724619151,COGS 101B,A01,091572,Staff,0,4,60,60
1650724625176,COGS 101C,A01,083625,Delgado; Tania,14,0,30,16
1650724631208,COGS 107A,A01,083627,Boyle; Mary E. T.,0,16,60,60
1650724637241,COGS 118A,A01,083075,Staff,0,8,60,60
1650724643266,CSE 3,A50,083646,Miranda; Gregory Joseph,18,0,38,20
1650724643266,CSE 3,A51,083647,Miranda; Gregory Joseph,36,0,37,1
1650724649297,CSE 8A,A50,083650,Miranda; Gregory Joseph,0,30,40,40
1650724655325,CSE 11,A01,083080,Cao; Yingjun,0,96,40,40
1650724661347,CSE 12,A01,083652,Staff,0,21,100,100
1650724667372,CSE 15L,A01,083654,Staff,0,3,50,50
1650724667372,CSE 15L,A02,083655,Staff,0,2,50,50
1650724673401,CSE 20,A01,083657,Staff,49,0,80,31
1650724679427,CSE 30,A01,083084,Eldon; John,0,77,40,40
1650724685454,CSE 100,A01,083659,Cao; Yingjun,0,70,50,50
1650724691480,CSE 134B,A01,083661,Powell; Thomas Allan,0,38,65,65
1650724697508,CSE 140,A01,083663,Staff,0,11,75,75
1650724703533,CSE 140L,A01,083088,Eldon; John,0,20,75,75
1650724709560,CSE 175,A01,083665,Kumar; Rakesh,7,0,25,18
1650724715584,CSE 190,A00,092507,Dubnov; Shlomo,10,0,20,10
1650724721608,ECE 45,A01,083139,Staff,1,2,60,59
1650724727631,ECE 65,A50,083695,Staff,0,5,30,30
1650724733658,ECE 109,A01,091882,Touri; Behrouz,33,0,70,37
1650724739687,ECE 180,A00,083140,Abi Samra; Nicholas Camill,20,0,30,10
1650724739687,ECE 180,B00,083141,Abi Samra; Nicholas Camill,0,0,30,30
1650724745726,MATH 10A,A01,083735,Patchell; Gregory David,2,0,30,28
1650724745726,MATH 10A,A02,083736,Patchell; Gregory David,27,0,30,3
1650724745726,MATH 10A,A03,083737,Patchell; Gregory David,24,0,30,6
1650724751755,MATH 10B,A01,083207,Staff,0,9,30,30
1650724751755,MATH 10B,A02,083208,Staff,1,7,30,29
1650724751755,MATH 10B,B01,083739,Staff,11,0,30,19
1650724751755,MATH 10B,B02,083740,Staff,28,0,30,2
1650724757778,MATH 18,A01,083743,Staff,0,0,30,30
1650724757778,MATH 18,A02,083744,Staff,23,0,30,7
1650724757778,MATH 18,A03,083745,Staff,21,0,30,9
1650724757778,MATH 18,A04,083746,Staff,26,0,30,4
1650724757778,MATH 18,B01,083748,Staff,0,15,30,30
1650724757778,MATH 18,B02,083749,Staff,0,12,30,30
1650724757778,MATH 18,B03,083750,Staff,0,12,30,30
1650724757778,MATH 18,B04,083751,Staff,0,12,30,30
1650724763801,MATH 20A,A01,083754,Staff,19,0,40,21
1650724769826,MATH 20B,A01,083756,Staff,0,11,30,30
1650724769826,MATH 20B,A02,083757,Staff,0,12,30,30
1650724775851,MATH 20C,A01,083760,Staff,0,16,30,30
1650724775851,MATH 20C,A02,083761,Staff,0,16,30,30
1650724775851,MATH 20C,B01,083762,Staff,10,0,30,20
1650724775851,MATH 20C,B02,083763,Staff,28,0,30,2
1650724781874,MATH 20D,A01,083765,Staff,2,1,30,28
1650724781874,MATH 20D,A02,083766,Staff,6,0,30,24
1650724781874,MATH 20D,A03,083767,Staff,24,0,30,6
1650724787899,MATH 20E,A01,083771,Staff,3,0,30,27
1650724787899,MATH 20E,A02,083772,Staff,16,0,30,14
1650724787899,MATH 20E,B01,083773,Staff,0,0,30,30
1650724787899,MATH 20E,B02,083774,Staff,6,0,30,24
1650724793924,MATH 103A,A01,083777,Staff,0,15,30,30
1650724793924,MATH 103A,A02,083778,Staff,0,15,30,30
1650724793924,MATH 103A,B01,083779,Staff,0,15,30,30
1650724793924,MATH 103A,B02,083780,Staff,0,15,30,30
1650724799950,MATH 105,A01,085443,Staff,0,22,30,30
1650724805975,MATH 109,A01,083213,Anzaldo; Leesa B,0,7,30,30
1650724805975,MATH 109,A02,083214,Anzaldo; Leesa B,0,7,30,30
1650724805975,MATH 109,B01,083215,Anzaldo; Leesa B,0,8,30,30
1650724805975,MATH 109,B02,083216,Anzaldo; Leesa B,0,6,30,30
1650724812010,MATH 142A,A01,083219,Chow; Bennett,0,16,30,30
1650724812010,MATH 142A,A02,083220,Chow; Bennett,0,15,30,30
1650724812010,MATH 142A,B01,083221,Chow; Bennett,0,15,30,30
1650724812010,MATH 142A,B02,083222,Chow; Bennett,0,14,30,30
1650724818035,MATH 193A,A01,083224,Staff,0,5,30,30
1650724818035,MATH 193A,A02,083225,Staff,0,6,30,30
1650724818035,MATH 193A,A03,083781,Staff,0,6,30,30
1650724818035,MATH 193A,A04,083782,Staff,0,7,30,30
1650724824060,MATH 197,001,091859,McAuley; Julian John,9998,0,9999,1
1650724830125,COGS 9,A01,083615,Staff,1,15,60,59
1650724836149,COGS 11,A01,083617,Boyle; Mary E. T.,16,0,40,24
1650724842173,COGS 13,A01,083071,Staff,0,38,40,40
1650724848197,COGS 14A,A01,092681,Staff,0,35,100,100
1650724854222,COGS 14B,A01,083073,Cheng; Tzu-Han,1,13,50,49
1650724860251,COGS 17,A01,092677,Staff,13,0,75,62
1650724866277,COGS 100,A01,083619,Staff,0,28,60,60
1650724872306,COGS 101A,A01,083621,Davis; Joshua Daniel,0,27,60,60
1650724878333,COGS 101B,A01,091572,Staff,0,4,60,60
1650724884360,COGS 101C,A01,083625,Delgado; Tania,14,0,30,16
1650724890384,COGS 107A,A01,083627,Boyle; Mary E. T.,0,16,60,60
1650724896408,COGS 118A,A01,083075,Staff,0,8,60,60
1650724902432,CSE 3,A50,083646,Miranda; Gregory Joseph,18,0,38,20
1650724902432,CSE 3,A51,083647,Miranda; Gregory Joseph,36,0,37,1
1650724908461,CSE 8A,A50,083650,Miranda; Gregory Joseph,0,30,40,40
1650724914486,CSE 11,A01,083080,Cao; Yingjun,0,96,40,40
1650724920514,CSE 12,A01,083652,Staff,0,21,100,100
1650724926544,CSE 15L,A01,083654,Staff,0,3,50,50
1650724926544,CSE 15L,A02,083655,Staff,0,2,50,50
1650724932570,CSE 20,A01,083657,Staff,49,0,80,31
1650724938597,CSE 30,A01,083084,Eldon; John,0,77,40,40
1650724944619,CSE 100,A01,083659,Cao; Yingjun,0,70,50,50
1650724950645,CSE 134B,A01,083661,Powell; Thomas Allan,0,38,65,65
1650724956672,CSE 140,A01,083663,Staff,0,11,75,75
1650724962697,CSE 140L,A01,083088,Eldon; John,0,20,75,75
1650724968725,CSE 175,A01,083665,Kumar; Rakesh,7,0,25,18
1650724974752,CSE 190,A00,092507,Dubnov; Shlomo,10,0,20,10
1650724980779,ECE 45,A01,083139,Staff,1,2,60,59
1650724986807,ECE 65,A50,083695,Staff,0,5,30,30
1650724992831,ECE 109,A01,091882,Touri; Behrouz,33,0,70,37
1650724998861,ECE 180,A00,083140,Abi Samra; Nicholas Camill,20,0,30,10
1650724998861,ECE 180,B00,083141,Abi Samra; Nicholas Camill,0,0,30,30
1650725004889,MATH 10A,A01,083735,Patchell; Gregory David,2,0,30,28
1650725004889,MATH 10A,A02,083736,Patchell; Gregory David,27,0,30,3
1650725004889,MATH 10A,A03,083737,Patchell; Gregory David,24,0,30,6
1650725010920,MATH 10B,A01,083207,Staff,0,9,30,30
1650725010920,MATH 10B,A02,083208,Staff,1,7,30,29
1650725010920,MATH 10B,B01,083739,Staff,11,0,30,19
1650725010920,MATH 10B,B02,083740,Staff,28,0,30,2
1650725016946,MATH 18,A01,083743,Staff,0,0,30,30
1650725016946,MATH 18,A02,083744,Staff,23,0,30,7
1650725016946,MATH 18,A03,083745,Staff,21,0,30,9
1650725016946,MATH 18,A04,083746,Staff,26,0,30,4
1650725016946,MATH 18,B01,083748,Staff,0,15,30,30
1650725016946,MATH 18,B02,083749,Staff,0,12,30,30
1650725016946,MATH 18,B03,083750,Staff,0,12,30,30
1650725016946,MATH 18,B04,083751,Staff,0,12,30,30
1650725022975,MATH 20A,A01,083754,Staff,19,0,40,21
1650725029004,MATH 20B,A01,083756,Staff,0,11,30,30
1650725029004,MATH 20B,A02,083757,Staff,0,12,30,30
1650725035031,MATH 20C,A01,083760,Staff,0,16,30,30
1650725035031,MATH 20C,A02,083761,Staff,0,16,30,30
1650725035031,MATH 20C,B01,083762,Staff,10,0,30,20
1650725035031,MATH 20C,B02,083763,Staff,28,0,30,2
1650725041060,MATH 20D,A01,083765,Staff,2,1,30,28
1650725041060,MATH 20D,A02,083766,Staff,6,0,30,24
1650725041060,MATH 20D,A03,083767,Staff,24,0,30,6
1650725047092,MATH 20E,A01,083771,Staff,3,0,30,27
1650725047092,MATH 20E,A02,083772,Staff,16,0,30,14
1650725047092,MATH 20E,B01,083773,Staff,0,0,30,30
1650725047092,MATH 20E,B02,083774,Staff,6,0,30,24
1650725053119,MATH 103A,A01,083777,Staff,0,15,30,30
1650725053119,MATH 103A,A02,083778,Staff,0,15,30,30
1650725053119,MATH 103A,B01,083779,Staff,0,15,30,30
1650725053119,MATH 103A,B02,083780,Staff,0,15,30,30
1650725059146,MATH 105,A01,085443,Staff,0,22,30,30
1650725065177,MATH 109,A01,083213,Anzaldo; Leesa B,0,7,30,30
1650725065177,MATH 109,A02,083214,Anzaldo; Leesa B,0,7,30,30
1650725065177,MATH 109,B01,083215,Anzaldo; Leesa B,0,8,30,30
1650725065177,MATH 109,B02,083216,Anzaldo; Leesa B,0,6,30,30
1650725071202,MATH 142A,A01,083219,Chow; Bennett,0,16,30,30
1650725071202,MATH 142A,A02,083220,Chow; Bennett,0,15,30,30
1650725071202,MATH 142A,B01,083221,Chow; Bennett,0,15,30,30
1650725071202,MATH 142A,B02,083222,Chow; Bennett,0,14,30,30
1650725077227,MATH 193A,A01,083224,Staff,0,5,30,30
1650725077227,MATH 193A,A02,083225,Staff,0,6,30,30
1650725077227,MATH 193A,A03,083781,Staff,0,6,30,30
1650725077227,MATH 193A,A04,083782,Staff,0,7,30,30
1650725083253,MATH 197,001,091859,McAuley; Julian John,9998,0,9999,1
1650725089314,COGS 9,A01,083615,Staff,1,15,60,59
1650725095343,COGS 11,A01,083617,Boyle; Mary E. T.,16,0,40,24
1650725101380,COGS 13,A01,083071,Staff,0,38,40,40
1650725107405,COGS 14A,A01,092681,Staff,0,35,100,100
1650725113433,COGS 14B,A01,083073,Cheng; Tzu-Han,1,13,50,49
1650725119548,COGS 17,A01,092677,Staff,13,0,75,62
1650725125575,COGS 100,A01,083619,Staff,0,28,60,60
1650725131622,COGS 101A,A01,083621,Davis; Joshua Daniel,0,27,60,60
1650725137650,COGS 101B,A01,091572,Staff,0,4,60,60
1650725143703,COGS 101C,A01,083625,Delgado; Tania,14,0,30,16
1650725149730,COGS 107A,A01,083627,Boyle; Mary E. T.,0,16,60,60
1650725155758,COGS 118A,A01,083075,Staff,0,8,60,60
1650725161795,CSE 3,A50,083646,Miranda; Gregory Joseph,18,0,38,20
1650725161795,CSE 3,A51,083647,Miranda; Gregory Joseph,36,0,37,1
1650725167826,CSE 8A,A50,083650,Miranda; Gregory Joseph,0,30,40,40
1650725173879,CSE 11,A01,083080,Cao; Yingjun,0,96,40,40
1650725179906,CSE 12,A01,083652,Staff,0,21,100,100
1650725185934,CSE 15L,A01,083654,Staff,0,3,50,50
1650725185934,CSE 15L,A02,083655,Staff,0,2,50,50
1650725191966,CSE 20,A01,083657,Staff,49,0,80,31
1650725197992,CSE 30,A01,083084,Eldon; John,0,77,40,40
1650725204019,CSE 100,A01,083659,Cao; Yingjun,0,70,50,50
1650725210043,CSE 134B,A01,083661,Powell; Thomas Allan,0,38,65,65
1650725216077,CSE 140,A01,083663,Staff,0,11,75,75
1650725222102,CSE 140L,A01,083088,Eldon; John,0,20,75,75
1650725228137,CSE 175,A01,083665,Kumar; Rakesh,7,0,25,18
1650725234162,CSE 190,A00,092507,Dubnov; Shlomo,10,0,20,10
1650725240206,ECE 45,A01,083139,Staff,1,2,60,59
1650725246231,ECE 65,A50,083695,Staff,0,5,30,30
1650725252258,ECE 109,A01,091882,Touri; Behrouz,33,0,70,37
1650725258284,ECE 180,A00,083140,Abi Samra; Nicholas Camill,20,0,30,10
1650725258284,ECE 180,B00,083141,Abi Samra; Nicholas Camill,0,0,30,30
1650725264311,MATH 10A,A01,083735,Patchell; Gregory David,2,0,30,28
1650725264311,MATH 10A,A02,083736,Patchell; Gregory David,27,0,30,3
1650725264311,MATH 10A,A03,083737,Patchell; Gregory David,24,0,30,6
1650725270336,MATH 10B,A01,083207,Staff,0,9,30,30
1650725270336,MATH 10B,A02,083208,Staff,1,7,30,29
1650725270336,MATH 10B,B01,083739,Staff,11,0,30,19
1650725270336,MATH 10B,B02,083740,Staff,28,0,30,2
1650725276364,MATH 18,A01,083743,Staff,0,0,30,30
1650725276364,MATH 18,A02,083744,Staff,23,0,30,7
1650725276364,MATH 18,A03,083745,Staff,21,0,30,9
1650725276364,MATH 18,A04,083746,Staff,26,0,30,4
1650725276364,MATH 18,B01,083748,Staff,0,15,30,30
1650725276364,MATH 18,B02,083749,Staff,0,12,30,30
1650725276364,MATH 18,B03,083750,Staff,0,12,30,30
1650725276364,MATH 18,B04,083751,Staff,0,12,30,30
1650725282387,MATH 20A,A01,083754,Staff,19,0,40,21
1650725288417,MATH 20B,A01,083756,Staff,0,11,30,30
1650725288417,MATH 20B,A02,083757,Staff,0,12,30,30
1650725294441,MATH 20C,A01,083760,Staff,0,16,30,30
1650725294441,MATH 20C,A02,083761,Staff,0,16,30,30
1650725294441,MATH 20C,B01,083762,Staff,10,0,30,20
1650725294441,MATH 20C,B02,083763,Staff,28,0,30,2
1650725300470,MATH 20D,A01,083765,Staff,2,1,30,28
1650725300470,MATH 20D,A02,083766,Staff,6,0,30,24
1650725300470,MATH 20D,A03,083767,Staff,24,0,30,6
1650725306500,MATH 20E,A01,083771,Staff,3,0,30,27
1650725306500,MATH 20E,A02,083772,Staff,16,0,30,14
1650725306500,MATH 20E,B01,083773,Staff,0,0,30,30
1650725306500,MATH 20E,B02,083774,Staff,6,0,30,24
1650725312526,MATH 103A,A01,083777,Staff,0,15,30,30
1650725312526,MATH 103A,A02,083778,Staff,0,15,30,30
1650725312526,MATH 103A,B01,083779,Staff,0,15,30,30
1650725312526,MATH 103A,B02,083780,Staff,0,15,30,30
1650725318549,MATH 105,A01,085443,Staff,0,22,30,30
1650725324579,MATH 109,A01,083213,Anzaldo; Leesa B,0,7,30,30
1650725324579,MATH 109,A02,083214,Anzaldo; Leesa B,0,7,30,30
1650725324579,MATH 109,B01,083215,Anzaldo; Leesa B,0,8,30,30
1650725324579,MATH 109,B02,083216,Anzaldo; Leesa B,0,6,30,30
1650725330613,MATH 142A,A01,083219,Chow; Bennett,0,16,30,30
1650725330613,MATH 142A,A02,083220,Chow; Bennett,0,15,30,30
1650725330613,MATH 142A,B01,083221,Chow; Bennett,0,15,30,30
1650725330613,MATH 142A,B02,083222,Chow; Bennett,0,14,30,30
1650725336644,MATH 193A,A01,083224,Staff,0,5,30,30
1650725336644,MATH 193A,A02,083225,Staff,0,6,30,30
1650725336644,MATH 193A,A03,083781,Staff,0,6,30,30
1650725336644,MATH 193A,A04,083782,Staff,0,7,30,30
1650725342668,MATH 197,001,091859,McAuley; Julian John,9998,0,9999,1
1650725348730,COGS 9,A01,083615,Staff,1,15,60,59
1650725354758,COGS 11,A01,083617,Boyle; Mary E. T.,16,0,40,24
1650725360786,COGS 13,A01,083071,Staff,0,38,40,40
1650725366816,COGS 14A,A01,092681,Staff,0,35,100,100
1650725372842,COGS 14B,A01,083073,Cheng; Tzu-Han,1,13,50,49
1650725378868,COGS 17,A01,092677,Staff,13,0,75,62
1650725384891,COGS 100,A01,083619,Staff,0,28,60,60
1650725390920,COGS 101A,A01,083621,Davis; Joshua Daniel,0,27,60,60
1650725396944,COGS 101B,A01,091572,Staff,0,4,60,60
1650725402971,COGS 101C,A01,083625,Delgado; Tania,14,0,30,16
1650725408995,COGS 107A,A01,083627,Boyle; Mary E. T.,0,16,60,60
1650725415020,COGS 118A,A01,083075,Staff,0,8,60,60
1650725421049,CSE 3,A50,083646,Miranda; Gregory Joseph,18,0,38,20
1650725421049,CSE 3,A51,083647,Miranda; Gregory Joseph,36,0,37,1
1650725427075,CSE 8A,A50,083650,Miranda; Gregory Joseph,0,30,40,40
1650725433103,CSE 11,A01,083080,Cao; Yingjun,0,96,40,40
1650725439129,CSE 12,A01,083652,Staff,0,21,100,100
1650725445156,CSE 15L,A01,083654,Staff,0,3,50,50
1650725445156,CSE 15L,A02,083655,Staff,0,2,50,50
1650725451186,CSE 20,A01,083657,Staff,49,0,80,31
1650725457210,CSE 30,A01,083084,Eldon; John,0,77,40,40
1650725463241,CSE 100,A01,083659,Cao; Yingjun,0,70,50,50
1650725469268,CSE 134B,A01,083661,Powell; Thomas Allan,0,38,65,65
1650725475291,CSE 140,A01,083663,Staff,0,11,75,75
1650725481326,CSE 140L,A01,083088,Eldon; John,0,20,75,75
1650725487357,CSE 175,A01,083665,Kumar; Rakesh,7,0,25,18
1650725493381,CSE 190,A00,092507,Dubnov; Shlomo,10,0,20,10
1650725499410,ECE 45,A01,083139,Staff,1,2,60,59
1650725505437,ECE 65,A50,083695,Staff,0,5,30,30
1650725511465,ECE 109,A01,091882,Touri; Behrouz,33,0,70,37
1650725517495,ECE 180,A00,083140,Abi Samra; Nicholas Camill,20,0,30,10
1650725517495,ECE 180,B00,083141,Abi Samra; Nicholas Camill,0,0,30,30
1650725523550,MATH 10A,A01,083735,Patchell; Gregory David,2,0,30,28
1650725523550,MATH 10A,A02,083736,Patchell; Gregory David,27,0,30,3
1650725523550,MATH 10A,A03,083737,Patchell; Gregory David,24,0,30,6
1650725529581,MATH 10B,A01,083207,Staff,0,9,30,30
1650725529581,MATH 10B,A02,083208,Staff,1,7,30,29
1650725529581,MATH 10B,B01,083739,Staff,11,0,30,19
1650725529581,MATH 10B,B02,083740,Staff,28,0,30,2
1650725535606,MATH 18,A01,083743,Staff,0,0,30,30
1650725535606,MATH 18,A02,083744,Staff,23,0,30,7
1650725535606,MATH 18,A03,083745,Staff,21,0,30,9
1650725535606,MATH 18,A04,083746,Staff,26,0,30,4
1650725535606,MATH 18,B01,083748,Staff,0,15,30,30
1650725535606,MATH 18,B02,083749,Staff,0,12,30,30
1650725535606,MATH 18,B03,083750,Staff,0,12,30,30
1650725535606,MATH 18,B04,083751,Staff,0,12,30,30
1650725541631,MATH 20A,A01,083754,Staff,19,0,40,21
1650725547659,MATH 20B,A01,083756,Staff,0,11,30,30
1650725547659,MATH 20B,A02,083757,Staff,0,12,30,30
1650725553693,MATH 20C,A01,083760,Staff,0,16,30,30
1650725553693,MATH 20C,A02,083761,Staff,0,16,30,30
1650725553693,MATH 20C,B01,083762,Staff,10,0,30,20
1650725553693,MATH 20C,B02,083763,Staff,28,0,30,2
1650725559718,MATH 20D,A01,083765,Staff,2,1,30,28
1650725559718,MATH 20D,A02,083766,Staff,6,0,30,24
1650725559718,MATH 20D,A03,083767,Staff,24,0,30,6
1650725565753,MATH 20E,A01,083771,Staff,3,0,30,27
1650725565753,MATH 20E,A02,083772,Staff,16,0,30,14
1650725565753,MATH 20E,B01,083773,Staff,0,0,30,30
1650725565753,MATH 20E,B02,083774,Staff,6,0,30,24
1650725571785,MATH 103A,A01,083777,Staff,0,15,30,30
1650725571785,MATH 103A,A02,083778,Staff,0,15,30,30
1650725571785,MATH 103A,B01,083779,Staff,0,15,30,30
1650725571785,MATH 103A,B02,083780,Staff,0,15,30,30
1650725577809,MATH 105,A01,085443,Staff,0,22,30,30
1650725583840,MATH 109,A01,083213,Anzaldo; Leesa B,0,7,30,30
1650725583840,MATH 109,A02,083214,Anzaldo; Leesa B,0,7,30,30
1650725583840,MATH 109,B01,083215,Anzaldo; Leesa B,0,8,30,30
1650725583840,MATH 109,B02,083216,Anzaldo; Leesa B,0,6,30,30
1650725589870,MATH 142A,A01,083219,Chow; Bennett,0,16,30,30
1650725589870,MATH 142A,A02,083220,Chow; Bennett,0,15,30,30
1650725589870,MATH 142A,B01,083221,Chow; Bennett,0,15,30,30
1650725589870,MATH 142A,B02,083222,Chow; Bennett,0,14,30,30
1650725595897,MATH 193A,A01,083224,Staff,0,5,30,30
1650725595897,MATH 193A,A02,083225,Staff,0,6,30,30
1650725595897,MATH 193A,A03,083781,Staff,0,6,30,30
1650725595897,MATH 193A,A04,083782,Staff,0,7,30,30
1650725601921,MATH 197,001,091859,McAuley; Julian John,9998,0,9999,1
1650725607984,COGS 9,A01,083615,Staff,1,15,60,59
1650725614009,COGS 11,A01,083617,Boyle; Mary E. T.,16,0,40,24
1650725620034,COGS 13,A01,083071,Staff,0,38,40,40
1650725626062,COGS 14A,A01,092681,Staff,0,35,100,100
1650725632086,COGS 14B,A01,083073,Cheng; Tzu-Han,1,13,50,49
1650725638111,COGS 17,A01,092677,Staff,13,0,75,62
1650725644137,COGS 100,A01,083619,Staff,0,28,60,60
1650725650173,COGS 101A,A01,083621,Davis; Joshua Daniel,0,27,60,60
1650725656199,COGS 101B,A01,091572,Staff,0,4,60,60
1650725662225,COGS 101C,A01,083625,Delgado; Tania,14,0,30,16
1650725668253,COGS 107A,A01,083627,Boyle; Mary E. T.,0,16,60,60
1650725674282,COGS 118A,A01,083075,Staff,0,8,60,60
1650725680308,CSE 3,A50,083646,Miranda; Gregory Joseph,18,0,38,20
1650725680308,CSE 3,A51,083647,Miranda; Gregory Joseph,36,0,37,1
1650725686336,CSE 8A,A50,083650,Miranda; Gregory Joseph,0,30,40,40
1650725692365,CSE 11,A01,083080,Cao; Yingjun,0,96,40,40
1650725698389,CSE 12,A01,083652,Staff,0,21,100,100
1650725704420,CSE 15L,A01,083654,Staff,0,3,50,50
1650725704420,CSE 15L,A02,083655,Staff,0,2,50,50
1650725710444,CSE 20,A01,083657,Staff,49,0,80,31
1650725716564,CSE 30,A01,083084,Eldon; John,0,77,40,40
1650725722588,CSE 100,A01,083659,Cao; Yingjun,0,70,50,50
1650725728613,CSE 134B,A01,083661,Powell; Thomas Allan,0,38,65,65
1650725734637,CSE 140,A01,083663,Staff,0,11,75,75
1650725740663,CSE 140L,A01,083088,Eldon; John,0,20,75,75
1650725746687,CSE 175,A01,083665,Kumar; Rakesh,7,0,25,18
1650725752712,CSE 190,A00,092507,Dubnov; Shlomo,10,0,20,10
1650725758756,ECE 45,A01,083139,Staff,1,2,60,59
1650725764779,ECE 65,A50,083695,Staff,0,5,30,30
1650725770807,ECE 109,A01,091882,Touri; Behrouz,33,0,70,37
1650725776831,ECE 180,A00,083140,Abi Samra; Nicholas Camill,20,0,30,10
1650725776831,ECE 180,B00,083141,Abi Samra; Nicholas Camill,0,0,30,30
1650725782858,MATH 10A,A01,083735,Patchell; Gregory David,2,0,30,28
1650725782858,MATH 10A,A02,083736,Patchell; Gregory David,27,0,30,3
1650725782858,MATH 10A,A03,083737,Patchell; Gregory David,24,0,30,6
1650725788890,MATH 10B,A01,083207,Staff,0,9,30,30
1650725788890,MATH 10B,A02,083208,Staff,1,7,30,29
1650725788890,MATH 10B,B01,083739,Staff,11,0,30,19
1650725788890,MATH 10B,B02,083740,Staff,28,0,30,2
1650725794922,MATH 18,A01,083743,Staff,0,0,30,30
1650725794922,MATH 18,A02,083744,Staff,23,0,30,7
1650725794922,MATH 18,A03,083745,Staff,21,0,30,9
1650725794922,MATH 18,A04,083746,Staff,26,0,30,4
1650725794922,MATH 18,B01,083748,Staff,0,15,30,30
1650725794922,MATH 18,B02,083749,Staff,0,12,30,30
1650725794922,MATH 18,B03,083750,Staff,0,12,30,30
1650725794922,MATH 18,B04,083751,Staff,0,12,30,30
1650725800975,MATH 20A,A01,083754,Staff,19,0,40,21
1650725807000,MATH 20B,A01,083756,Staff,0,11,30,30
1650725807000,MATH 20B,A02,083757,Staff,0,12,30,30
1650725813025,MATH 20C,A01,083760,Staff,0,16,30,30
1650725813025,MATH 20C,A02,083761,Staff,0,16,30,30
1650725813025,MATH 20C,B01,083762,Staff,10,0,30,20
1650725813025,MATH 20C,B02,083763,Staff,28,0,30,2
1650725819053,MATH 20D,A01,083765,Staff,2,1,30,28
1650725819053,MATH 20D,A02,083766,Staff,6,0,30,24
1650725819053,MATH 20D,A03,083767,Staff,24,0,30,6
1650725825079,MATH 20E,A01,083771,Staff,3,0,30,27
1650725825079,MATH 20E,A02,083772,Staff,16,0,30,14
1650725825079,MATH 20E,B01,083773,Staff,0,0,30,30
1650725825079,MATH 20E,B02,083774,Staff,6,0,30,24
1650725831104,MATH 103A,A01,083777,Staff,0,15,30,30
1650725831104,MATH 103A,A02,083778,Staff,0,15,30,30
1650725831104,MATH 103A,B01,083779,Staff,0,15,30,30
1650725831104,MATH 103A,B02,083780,Staff,0,15,30,30
1650725837133,MATH 105,A01,085443,Staff,0,22,30,30
1650725843159,MATH 109,A01,083213,Anzaldo; Leesa B,0,7,30,30
1650725843159,MATH 109,A02,083214,Anzaldo; Leesa B,0,7,30,30
1650725843159,MATH 109,B01,083215,Anzaldo; Leesa B,0,8,30,30
1650725843159,MATH 109,B02,083216,Anzaldo; Leesa B,0,6,30,30
1650725849189,MATH 142A,A01,083219,Chow; Bennett,0,16,30,30
1650725849189,MATH 142A,A02,083220,Chow; Bennett,0,15,30,30
1650725849189,MATH 142A,B01,083221,Chow; Bennett,0,15,30,30
1650725849189,MATH 142A,B02,083222,Chow; Bennett,0,14,30,30
1650725855217,MATH 193A,A01,083224,Staff,0,5,30,30
1650725855217,MATH 193A,A02,083225,Staff,0,6,30,30
1650725855217,MATH 193A,A03,083781,Staff,0,6,30,30
1650725855217,MATH 193A,A04,083782,Staff,0,7,30,30
1650725861242,MATH 197,001,091859,McAuley; Julian John,9998,0,9999,1
1650725867329,COGS 9,A01,083615,Staff,1,15,60,59
1650725873355,COGS 11,A01,083617,Boyle; Mary E. T.,16,0,40,24
1650725879381,COGS 13,A01,083071,Staff,0,38,40,40
1650725885405,COGS 14A,A01,092681,Staff,0,35,100,100
1650725891430,COGS 14B,A01,083073,Cheng; Tzu-Han,1,13,50,49
1650725897469,COGS 17,A01,092677,Staff,13,0,75,62
1650725903492,COGS 100,A01,083619,Staff,0,28,60,60
1650725909516,COGS 101A,A01,083621,Davis; Joshua Daniel,0,27,60,60
1650725915546,COGS 101B,A01,091572,Staff,0,4,60,60
1650725921571,COGS 101C,A01,083625,Delgado; Tania,14,0,30,16
1650725927595,COGS 107A,A01,083627,Boyle; Mary E. T.,0,16,60,60
1650725933622,COGS 118A,A01,083075,Staff,0,8,60,60
1650725939649,CSE 3,A50,083646,Miranda; Gregory Joseph,18,0,38,20
1650725939649,CSE 3,A51,083647,Miranda; Gregory Joseph,36,0,37,1
1650725945676,CSE 8A,A50,083650,Miranda; Gregory Joseph,0,30,40,40
1650725951722,CSE 11,A01,083080,Cao; Yingjun,0,96,40,40
1650725957752,CSE 12,A01,083652,Staff,0,21,100,100
1650725963779,CSE 15L,A01,083654,Staff,0,3,50,50
1650725963779,CSE 15L,A02,083655,Staff,0,2,50,50
1650725969803,CSE 20,A01,083657,Staff,49,0,80,31
1650725975828,CSE 30,A01,083084,Eldon; John,0,77,40,40
1650725981858,CSE 100,A01,083659,Cao; Yingjun,0,70,50,50
1650725987889,CSE 134B,A01,083661,Powell; Thomas Allan,0,38,65,65
1650725993912,CSE 140,A01,083663,Staff,0,11,75,75
1650725999941,CSE 140L,A01,083088,Eldon; John,0,20,75,75
1650726005972,CSE 175,A01,083665,Kumar; Rakesh,7,0,25,18
1650726012000,CSE 190,A00,092507,Dubnov; Shlomo,10,0,20,10
1650726018027,ECE 45,A01,083139,Staff,1,2,60,59
1650726024055,ECE 65,A50,083695,Staff,0,5,30,30
1650726030080,ECE 109,A01,091882,Touri; Behrouz,33,0,70,37
1650726036105,ECE 180,A00,083140,Abi Samra; Nicholas Camill,20,0,30,10
1650726036105,ECE 180,B00,083141,Abi Samra; Nicholas Camill,0,0,30,30
1650726042130,MATH 10A,A01,083735,Patchell; Gregory David,2,0,30,28
1650726042130,MATH 10A,A02,083736,Patchell; Gregory David,27,0,30,3
1650726042130,MATH 10A,A03,083737,Patchell; Gregory David,24,0,30,6
1650726048159,MATH 10B,A01,083207,Staff,0,9,30,30
1650726048159,MATH 10B,A02,083208,Staff,1,7,30,29
1650726048159,MATH 10B,B01,083739,Staff,11,0,30,19
1650726048159,MATH 10B,B02,083740,Staff,28,0,30,2
1650726054190,MATH 18,A01,083743,Staff,0,0,30,30
1650726054190,MATH 18,A02,083744,Staff,23,0,30,7
1650726054190,MATH 18,A03,083745,Staff,21,0,30,9
1650726054190,MATH 18,A04,083746,Staff,26,0,30,4
1650726054190,MATH 18,B01,083748,Staff,0,15,30,30
1650726054190,MATH 18,B02,083749,Staff,0,12,30,30
1650726054190,MATH 18,B03,083750,Staff,0,12,30,30
1650726054190,MATH 18,B04,083751,Staff,0,12,30,30
1650726060224,MATH 20A,A01,083754,Staff,19,0,40,21
1650726066252,MATH 20B,A01,083756,Staff,0,11,30,30
1650726066252,MATH 20B,A02,083757,Staff,0,12,30,30
1650726072281,MATH 20C,A01,083760,Staff,0,16,30,30
1650726072281,MATH 20C,A02,083761,Staff,0,16,30,30
1650726072281,MATH 20C,B01,083762,Staff,10,0,30,20
1650726072281,MATH 20C,B02,083763,Staff,28,0,30,2
1650726078305,MATH 20D,A01,083765,Staff,2,1,30,28
1650726078305,MATH 20D,A02,083766,Staff,6,0,30,24
1650726078305,MATH 20D,A03,083767,Staff,24,0,30,6
1650726084335,MATH 20E,A01,083771,Staff,3,0,30,27
1650726084335,MATH 20E,A02,083772,Staff,16,0,30,14
1650726084335,MATH 20E,B01,083773,Staff,0,0,30,30
1650726084335,MATH 20E,B02,083774,Staff,6,0,30,24
1650726090360,MATH 103A,A01,083777,Staff,0,15,30,30
1650726090360,MATH 103A,A02,083778,Staff,0,15,30,30
1650726090360,MATH 103A,B01,083779,Staff,0,15,30,30
1650726090360,MATH 103A,B02,083780,Staff,0,15,30,30
1650726096386,MATH 105,A01,085443,Staff,0,22,30,30
1650726102410,MATH 109,A01,083213,Anzaldo; Leesa B,0,7,30,30
1650726102410,MATH 109,A02,083214,Anzaldo; Leesa B,0,7,30,30
1650726102410,MATH 109,B01,083215,Anzaldo; Leesa B,0,8,30,30
1650726102410,MATH 109,B02,083216,Anzaldo; Leesa B,0,6,30,30
1650726108435,MATH 142A,A01,083219,Chow; Bennett,0,16,30,30
1650726108435,MATH 142A,A02,083220,Chow; Bennett,0,15,30,30
1650726108435,MATH 142A,B01,083221,Chow; Bennett,0,15,30,30
1650726108435,MATH 142A,B02,083222,Chow; Bennett,0,14,30,30
1650726114467,MATH 193A,A01,083224,Staff,0,5,30,30
1650726114467,MATH 193A,A02,083225,Staff,0,6,30,30
1650726114467,MATH 193A,A03,083781,Staff,0,6,30,30
1650726114467,MATH 193A,A04,083782,Staff,0,7,30,30
1650726120494,MATH 197,001,091859,McAuley; Julian John,9998,0,9999,1
1650726126570,COGS 9,A01,083615,Staff,1,15,60,59
1650726132593,COGS 11,A01,083617,Boyle; Mary E. T.,16,0,40,24
1650726138617,COGS 13,A01,083071,Staff,0,38,40,40
1650726144644,COGS 14A,A01,092681,Staff,0,35,100,100
1650726150668,COGS 14B,A01,083073,Cheng; Tzu-Han,1,13,50,49
1650726156694,COGS 17,A01,092677,Staff,13,0,75,62
1650726162720,COGS 100,A01,083619,Staff,0,28,60,60
1650726168744,COGS 101A,A01,083621,Davis; Joshua Daniel,0,27,60,60
1650726174771,COGS 101B,A01,091572,Staff,0,4,60,60
1650726180798,COGS 101C,A01,083625,Delgado; Tania,14,0,30,16
1650726186829,COGS 107A,A01,083627,Boyle; Mary E. T.,0,16,60,60
1650726192856,COGS 118A,A01,083075,Staff,0,8,60,60
1650726198879,CSE 3,A50,083646,Miranda; Gregory Joseph,18,0,38,20
1650726198879,CSE 3,A51,083647,Miranda; Gregory Joseph,36,0,37,1
1650726204910,CSE 8A,A50,083650,Miranda; Gregory Joseph,0,30,40,40
1650726210934,CSE 11,A01,083080,Cao; Yingjun,0,96,40,40
1650726216959,CSE 12,A01,083652,Staff,0,21,100,100
1650726222985,CSE 15L,A01,083654,Staff,0,3,50,50
1650726222985,CSE 15L,A02,083655,Staff,0,2,50,50
1650726229012,CSE 20,A01,083657,Staff,49,0,80,31
1650726235036,CSE 30,A01,083084,Eldon; John,0,77,40,40
1650726241064,CSE 100,A01,083659,Cao; Yingjun,0,70,50,50
1650726247089,CSE 134B,A01,083661,Powell; Thomas Allan,0,38,65,65
1650726253115,CSE 140,A01,083663,Staff,0,11,75,75
1650726259141,CSE 140L,A01,083088,Eldon; John,0,20,75,75
1650726265164,CSE 175,A01,083665,Kumar; Rakesh,7,0,25,18
1650726271192,CSE 190,A00,092507,Dubnov; Shlomo,10,0,20,10
1650726277220,ECE 45,A01,083139,Staff,1,2,60,59
1650726283245,ECE 65,A50,083695,Staff,0,5,30,30
1650726289273,ECE 109,A01,091882,Touri; Behrouz,33,0,70,37
1650726295301,ECE 180,A00,083140,Abi Samra; Nicholas Camill,20,0,30,10
1650726295301,ECE 180,B00,083141,Abi Samra; Nicholas Camill,0,0,30,30
1650726301330,MATH 10A,A01,083735,Patchell; Gregory David,2,0,30,28
1650726301330,MATH 10A,A02,083736,Patchell; Gregory David,27,0,30,3
1650726301330,MATH 10A,A03,083737,Patchell; Gregory David,24,0,30,6
1650726307359,MATH 10B,A01,083207,Staff,0,9,30,30
1650726307359,MATH 10B,A02,083208,Staff,1,7,30,29
1650726307359,MATH 10B,B01,083739,Staff,11,0,30,19
1650726307359,MATH 10B,B02,083740,Staff,28,0,30,2
1650726313480,MATH 18,A01,083743,Staff,0,0,30,30
1650726313480,MATH 18,A02,083744,Staff,23,0,30,7
1650726313480,MATH 18,A03,083745,Staff,21,0,30,9
1650726313480,MATH 18,A04,083746,Staff,26,0,30,4
1650726313480,MATH 18,B01,083748,Staff,0,15,30,30
1650726313480,MATH 18,B02,083749,Staff,0,12,30,30
1650726313480,MATH 18,B03,083750,Staff,0,12,30,30
1650726313480,MATH 18,B04,083751,Staff,0,12,30,30
1650726319509,MATH 20A,A01,083754,Staff,19,0,40,21
1650726325533,MATH 20B,A01,083756,Staff,0,11,30,30
1650726325533,MATH 20B,A02,083757,Staff,0,12,30,30
1650726331563,MATH 20C,A01,083760,Staff,0,16,30,30
1650726331563,MATH 20C,A02,083761,Staff,0,16,30,30
1650726331563,MATH 20C,B01,083762,Staff,10,0,30,20
1650726331563,MATH 20C,B02,083763,Staff,28,0,30,2
1650726337589,MATH 20D,A01,083765,Staff,2,1,30,28
1650726337589,MATH 20D,A02,083766,Staff,6,0,30,24
1650726337589,MATH 20D,A03,083767,Staff,24,0,30,6
1650726343617,MATH 20E,A01,083771,Staff,3,0,30,27
1650726343617,MATH 20E,A02,083772,Staff,16,0,30,14
1650726343617,MATH 20E,B01,083773,Staff,0,0,30,30
1650726343617,MATH 20E,B02,083774,Staff,6,0,30,24
1650726349642,MATH 103A,A01,083777,Staff,0,15,30,30
1650726349642,MATH 103A,A02,083778,Staff,0,15,30,30
1650726349642,MATH 103A,B01,083779,Staff,0,15,30,30
1650726349642,MATH 103A,B02,083780,Staff,0,15,30,30
1650726355666,MATH 105,A01,085443,Staff,0,22,30,30
1650726361694,MATH 109,A01,083213,Anzaldo; Leesa B,0,7,30,30
1650726361694,MATH 109,A02,083214,Anzaldo; Leesa B,0,7,30,30
1650726361694,MATH 109,B01,083215,Anzaldo; Leesa B,0,8,30,30
1650726361694,MATH 109,B02,083216,Anzaldo; Leesa B,0,6,30,30
1650726367723,MATH 142A,A01,083219,Chow; Bennett,0,16,30,30
1650726367723,MATH 142A,A02,083220,Chow; Bennett,0,15,30,30
1650726367723,MATH 142A,B01,083221,Chow; Bennett,0,15,30,30
1650726367723,MATH 142A,B02,083222,Chow; Bennett,0,14,30,30
1650726373752,MATH 193A,A01,083224,Staff,0,5,30,30
1650726373752,MATH 193A,A02,083225,Staff,0,6,30,30
1650726373752,MATH 193A,A03,083781,Staff,0,6,30,30
1650726373752,MATH 193A,A04,083782,Staff,0,7,30,30
1650726379776,MATH 197,001,091859,McAuley; Julian John,9998,0,9999,1
1650726385830,COGS 9,A01,083615,Staff,1,15,60,59
1650726391856,COGS 11,A01,083617,Boyle; Mary E. T.,16,0,40,24
1650726397884,COGS 13,A01,083071,Staff,0,38,40,40
1650726403908,COGS 14A,A01,092681,Staff,0,35,100,100
1650726409938,COGS 14B,A01,083073,Cheng; Tzu-Han,1,13,50,49
1650726415962,COGS 17,A01,092677,Staff,13,0,75,62
1650726421988,COGS 100,A01,083619,Staff,0,28,60,60
1650726428014,COGS 101A,A01,083621,Davis; Joshua Daniel,0,27,60,60
1650726434038,COGS 101B,A01,091572,Staff,0,4,60,60
1650726440063,COGS 101C,A01,083625,Delgado; Tania,14,0,30,16
1650726446087,COGS 107A,A01,083627,Boyle; Mary E. T.,0,16,60,60
1650726452110,COGS 118A,A01,083075,Staff,0,8,60,60
1650726458136,CSE 3,A50,083646,Miranda; Gregory Joseph,18,0,38,20
1650726458136,CSE 3,A51,083647,Miranda; Gregory Joseph,36,0,37,1
1650726464158,CSE 8A,A50,083650,Miranda; Gregory Joseph,0,30,40,40
1650726470187,CSE 11,A01,083080,Cao; Yingjun,0,96,40,40
1650726476214,CSE 12,A01,083652,Staff,0,21,100,100
1650726482239,CSE 15L,A01,083654,Staff,0,3,50,50
1650726482239,CSE 15L,A02,083655,Staff,0,2,50,50
1650726488263,CSE 20,A01,083657,Staff,49,0,80,31
1650726494294,CSE 30,A01,083084,Eldon; John,0,77,40,40
1650726500317,CSE 100,A01,083659,Cao; Yingjun,0,70,50,50
1650726506349,CSE 134B,A01,083661,Powell; Thomas Allan,0,38,65,65
1650726512377,CSE 140,A01,083663,Staff,0,11,75,75
1650726518402,CSE 140L,A01,083088,Eldon; John,0,20,75,75
1650726524426,CSE 175,A01,083665,Kumar; Rakesh,7,0,25,18
1650726530457,CSE 190,A00,092507,Dubnov; Shlomo,10,0,20,10
1650726536480,ECE 45,A01,083139,Staff,1,2,60,59
1650726542509,ECE 65,A50,083695,Staff,0,5,30,30
1650726548534,ECE 109,A01,091882,Touri; Behrouz,33,0,70,37
1650726554562,ECE 180,A00,083140,Abi Samra; Nicholas Camill,20,0,30,10
1650726554562,ECE 180,B00,083141,Abi Samra; Nicholas Camill,0,0,30,30
1650726560592,MATH 10A,A01,083735,Patchell; Gregory David,2,0,30,28
1650726560592,MATH 10A,A02,083736,Patchell; Gregory David,27,0,30,3
1650726560592,MATH 10A,A03,083737,Patchell; Gregory David,24,0,30,6
1650726566624,MATH 10B,A01,083207,Staff,0,9,30,30
1650726566624,MATH 10B,A02,083208,Staff,1,7,30,29
1650726566624,MATH 10B,B01,083739,Staff,11,0,30,19
1650726566624,MATH 10B,B02,083740,Staff,28,0,30,2
1650726572654,MATH 18,A01,083743,Staff,0,0,30,30
1650726572654,MATH 18,A02,083744,Staff,23,0,30,7
1650726572654,MATH 18,A03,083745,Staff,21,0,30,9
1650726572654,MATH 18,A04,083746,Staff,26,0,30,4
1650726572654,MATH 18,B01,083748,Staff,0,15,30,30
1650726572654,MATH 18,B02,083749,Staff,0,12,30,30
1650726572654,MATH 18,B03,083750,Staff,0,12,30,30
1650726572654,MATH 18,B04,083751,Staff,0,12,30,30
1650726578681,MATH 20A,A01,083754,Staff,19,0,40,21
1650726584705,MATH 20B,A01,083756,Staff,0,11,30,30
1650726584705,MATH 20B,A02,083757,Staff,0,12,30,30
1650726590730,MATH 20C,A01,083760,Staff,0,16,30,30
1650726590730,MATH 20C,A02,083761,Staff,0,16,30,30
1650726590730,MATH 20C,B01,083762,Staff,10,0,30,20
1650726590730,MATH 20C,B02,083763,Staff,28,0,30,2
1650726596756,MATH 20D,A01,083765,Staff,2,1,30,28
1650726596756,MATH 20D,A02,083766,Staff,6,0,30,24
1650726596756,MATH 20D,A03,083767,Staff,24,0,30,6
1650726602782,MATH 20E,A01,083771,Staff,3,0,30,27
1650726602782,MATH 20E,A02,083772,Staff,16,0,30,14
1650726602782,MATH 20E,B01,083773,Staff,0,0,30,30
1650726602782,MATH 20E,B02,083774,Staff,6,0,30,24
1650726608819,MATH 103A,A01,083777,Staff,0,15,30,30
1650726608819,MATH 103A,A02,083778,Staff,0,15,30,30
1650726608819,MATH 103A,B01,083779,Staff,0,15,30,30
1650726608819,MATH 103A,B02,083780,Staff,0,15,30,30
1650726614843,MATH 105,A01,085443,Staff,0,22,30,30
1650726620872,MATH 109,A01,083213,Anzaldo; Leesa B,0,7,30,30
1650726620872,MATH 109,A02,083214,Anzaldo; Leesa B,0,7,30,30
1650726620872,MATH 109,B01,083215,Anzaldo; Leesa B,0,8,30,30
1650726620872,MATH 109,B02,083216,Anzaldo; Leesa B,0,6,30,30
1650726626895,MATH 142A,A01,083219,Chow; Bennett,0,16,30,30
1650726626895,MATH 142A,A02,083220,Chow; Bennett,0,15,30,30
1650726626895,MATH 142A,B01,083221,Chow; Bennett,0,15,30,30
1650726626895,MATH 142A,B02,083222,Chow; Bennett,0,14,30,30
1650726632920,MATH 193A,A01,083224,Staff,0,5,30,30
1650726632920,MATH 193A,A02,083225,Staff,0,6,30,30
1650726632920,MATH 193A,A03,083781,Staff,0,6,30,30
1650726632920,MATH 193A,A04,083782,Staff,0,7,30,30
1650726638948,MATH 197,001,091859,McAuley; Julian John,9998,0,9999,1
1650726645000,COGS 9,A01,083615,Staff,1,15,60,59
1650726651025,COGS 11,A01,083617,Boyle; Mary E. T.,16,0,40,24
1650726657051,COGS 13,A01,083071,Staff,0,38,40,40
1650726663087,COGS 14A,A01,092681,Staff,0,35,100,100
1650726669113,COGS 14B,A01,083073,Cheng; Tzu-Han,1,13,50,49
1650726675137,COGS 17,A01,092677,Staff,13,0,75,62
1650726681162,COGS 100,A01,083619,Staff,0,28,60,60
1650726687190,COGS 101A,A01,083621,Davis; Joshua Daniel,0,27,60,60
1650726693213,COGS 101B,A01,091572,Staff,0,4,60,60
1650726699238,COGS 101C,A01,083625,Delgado; Tania,14,0,30,16
1650726705263,COGS 107A,A01,083627,Boyle; Mary E. T.,0,16,60,60
1650726711288,COGS 118A,A01,083075,Staff,0,8,60,60
1650726717314,CSE 3,A50,083646,Miranda; Gregory Joseph,18,0,38,20
1650726717314,CSE 3,A51,083647,Miranda; Gregory Joseph,36,0,37,1
1650726723342,CSE 8A,A50,083650,Miranda; Gregory Joseph,0,30,40,40
1650726729367,CSE 11,A01,083080,Cao; Yingjun,0,96,40,40
1650726735392,CSE 12,A01,083652,Staff,0,21,100,100
1650726741423,CSE 15L,A01,083654,Staff,0,3,50,50
1650726741423,CSE 15L,A02,083655,Staff,0,2,50,50
1650726747446,CSE 20,A01,083657,Staff,49,0,80,31
1650726753477,CSE 30,A01,083084,Eldon; John,0,77,40,40
1650726759503,CSE 100,A01,083659,Cao; Yingjun,0,70,50,50
1650726765529,CSE 134B,A01,083661,Powell; Thomas Allan,0,38,65,65
1650726771564,CSE 140,A01,083663,Staff,0,11,75,75
1650726777589,CSE 140L,A01,083088,Eldon; John,0,20,75,75
1650726783615,CSE 175,A01,083665,Kumar; Rakesh,7,0,25,18
1650726789643,CSE 190,A00,092507,Dubnov; Shlomo,10,0,20,10
1650726795672,ECE 45,A01,083139,Staff,1,2,60,59
1650726801696,ECE 65,A50,083695,Staff,0,5,30,30
1650726807727,ECE 109,A01,091882,Touri; Behrouz,33,0,70,37
1650726813752,ECE 180,A00,083140,Abi Samra; Nicholas Camill,20,0,30,10
1650726813752,ECE 180,B00,083141,Abi Samra; Nicholas Camill,0,0,30,30
1650726819775,MATH 10A,A01,083735,Patchell; Gregory David,2,0,30,28
1650726819775,MATH 10A,A02,083736,Patchell; Gregory David,27,0,30,3
1650726819775,MATH 10A,A03,083737,Patchell; Gregory David,24,0,30,6
1650726825803,MATH 10B,A01,083207,Staff,0,9,30,30
1650726825803,MATH 10B,A02,083208,Staff,1,7,30,29
1650726825803,MATH 10B,B01,083739,Staff,11,0,30,19
1650726825803,MATH 10B,B02,083740,Staff,28,0,30,2
1650726831837,MATH 18,A01,083743,Staff,0,0,30,30
1650726831837,MATH 18,A02,083744,Staff,23,0,30,7
1650726831837,MATH 18,A03,083745,Staff,21,0,30,9
1650726831837,MATH 18,A04,083746,Staff,26,0,30,4
1650726831837,MATH 18,B01,083748,Staff,0,15,30,30
1650726831837,MATH 18,B02,083749,Staff,0,12,30,30
1650726831837,MATH 18,B03,083750,Staff,0,12,30,30
1650726831837,MATH 18,B04,083751,Staff,0,12,30,30
1650726837868,MATH 20A,A01,083754,Staff,19,0,40,21
1650726843894,MATH 20B,A01,083756,Staff,0,11,30,30
1650726843894,MATH 20B,A02,083757,Staff,0,12,30,30
1650726849923,MATH 20C,A01,083760,Staff,0,16,30,30
1650726849923,MATH 20C,A02,083761,Staff,0,16,30,30
1650726849923,MATH 20C,B01,083762,Staff,10,0,30,20
1650726849923,MATH 20C,B02,083763,Staff,28,0,30,2
1650726855951,MATH 20D,A01,083765,Staff,2,1,30,28
1650726855951,MATH 20D,A02,083766,Staff,6,0,30,24
1650726855951,MATH 20D,A03,083767,Staff,24,0,30,6
1650726861974,MATH 20E,A01,083771,Staff,3,0,30,27
1650726861974,MATH 20E,A02,083772,Staff,16,0,30,14
1650726861974,MATH 20E,B01,083773,Staff,0,0,30,30
1650726861974,MATH 20E,B02,083774,Staff,6,0,30,24
1650726868003,MATH 103A,A01,083777,Staff,0,15,30,30
1650726868003,MATH 103A,A02,083778,Staff,0,15,30,30
1650726868003,MATH 103A,B01,083779,Staff,0,15,30,30
1650726868003,MATH 103A,B02,083780,Staff,0,15,30,30
1650726874028,MATH 105,A01,085443,Staff,0,22,30,30
1650726880057,MATH 109,A01,083213,Anzaldo; Leesa B,0,7,30,30
1650726880057,MATH 109,A02,083214,Anzaldo; Leesa B,0,7,30,30
1650726880057,MATH 109,B01,083215,Anzaldo; Leesa B,0,8,30,30
1650726880057,MATH 109,B02,083216,Anzaldo; Leesa B,0,6,30,30
1650726886089,MATH 142A,A01,083219,Chow; Bennett,0,16,30,30
1650726886089,MATH 142A,A02,083220,Chow; Bennett,0,15,30,30
1650726886089,MATH 142A,B01,083221,Chow; Bennett,0,15,30,30
1650726886089,MATH 142A,B02,083222,Chow; Bennett,0,14,30,30
1650726892116,MATH 193A,A01,083224,Staff,0,5,30,30
1650726892116,MATH 193A,A02,083225,Staff,0,6,30,30
1650726892116,MATH 193A,A03,083781,Staff,0,6,30,30
1650726892116,MATH 193A,A04,083782,Staff,0,7,30,30
1650726898141,MATH 197,001,091859,McAuley; Julian John,9998,0,9999,1
1650726904313,COGS 9,A01,083615,Staff,1,15,60,59
1650726910338,COGS 11,A01,083617,Boyle; Mary E. T.,16,0,40,24
1650726916369,COGS 13,A01,083071,Staff,0,38,40,40
1650726922396,COGS 14A,A01,092681,Staff,0,35,100,100
1650726928422,COGS 14B,A01,083073,Cheng; Tzu-Han,1,13,50,49
1650726934445,COGS 17,A01,092677,Staff,13,0,75,62
1650726940468,COGS 100,A01,083619,Staff,0,28,60,60
1650726946491,COGS 101A,A01,083621,Davis; Joshua Daniel,0,27,60,60
1650726952515,COGS 101B,A01,091572,Staff,0,4,60,60
1650726958542,COGS 101C,A01,083625,Delgado; Tania,14,0,30,16
1650726964564,COGS 107A,A01,083627,Boyle; Mary E. T.,0,16,60,60
1650726970589,COGS 118A,A01,083075,Staff,0,8,60,60
1650726976612,CSE 3,A50,083646,Miranda; Gregory Joseph,18,0,38,20
1650726976612,CSE 3,A51,083647,Miranda; Gregory Joseph,36,0,37,1
1650726982646,CSE 8A,A50,083650,Miranda; Gregory Joseph,0,30,40,40
1650726988673,CSE 11,A01,083080,Cao; Yingjun,0,96,40,40
1650726994699,CSE 12,A01,083652,Staff,0,21,100,100
1650727000724,CSE 15L,A01,083654,Staff,0,3,50,50
1650727000724,CSE 15L,A02,083655,Staff,0,2,50,50
1650727006747,CSE 20,A01,083657,Staff,49,0,80,31
1650727012776,CSE 30,A01,083084,Eldon; John,0,77,40,40
1650727018800,CSE 100,A01,083659,Cao; Yingjun,0,70,50,50
1650727024837,CSE 134B,A01,083661,Powell; Thomas Allan,0,38,65,65
1650727030861,CSE 140,A01,083663,Staff,0,11,75,75
1650727036896,CSE 140L,A01,083088,Eldon; John,0,20,75,75
1650727042922,CSE 175,A01,083665,Kumar; Rakesh,7,0,25,18
1650727048946,CSE 190,A00,092507,Dubnov; Shlomo,10,0,20,10
1650727054976,ECE 45,A01,083139,Staff,1,2,60,59
1650727061002,ECE 65,A50,083695,Staff,0,5,30,30
1650727067028,ECE 109,A01,091882,Touri; Behrouz,33,0,70,37
1650727073053,ECE 180,A00,083140,Abi Samra; Nicholas Camill,20,0,30,10
1650727073053,ECE 180,B00,083141,Abi Samra; Nicholas Camill,0,0,30,30
1650727079086,MATH 10A,A01,083735,Patchell; Gregory David,2,0,30,28
1650727079086,MATH 10A,A02,083736,Patchell; Gregory David,27,0,30,3
1650727079086,MATH 10A,A03,083737,Patchell; Gregory David,24,0,30,6
1650727085114,MATH 10B,A01,083207,Staff,0,9,30,30
1650727085114,MATH 10B,A02,083208,Staff,1,7,30,29
1650727085114,MATH 10B,B01,083739,Staff,11,0,30,19
1650727085114,MATH 10B,B02,083740,Staff,28,0,30,2
1650727091144,MATH 18,A01,083743,Staff,0,0,30,30
1650727091144,MATH 18,A02,083744,Staff,23,0,30,7
1650727091144,MATH 18,A03,083745,Staff,21,0,30,9
1650727091144,MATH 18,A04,083746,Staff,26,0,30,4
1650727091144,MATH 18,B01,083748,Staff,0,15,30,30
1650727091144,MATH 18,B02,083749,Staff,0,12,30,30
1650727091144,MATH 18,B03,083750,Staff,0,12,30,30
1650727091144,MATH 18,B04,083751,Staff,0,12,30,30
1650727097169,MATH 20A,A01,083754,Staff,19,0,40,21
1650727103196,MATH 20B,A01,083756,Staff,0,11,30,30
1650727103196,MATH 20B,A02,083757,Staff,0,12,30,30
1650727109219,MATH 20C,A01,083760,Staff,0,16,30,30
1650727109219,MATH 20C,A02,083761,Staff,0,16,30,30
1650727109219,MATH 20C,B01,083762,Staff,10,0,30,20
1650727109219,MATH 20C,B02,083763,Staff,28,0,30,2
1650727115252,MATH 20D,A01,083765,Staff,2,1,30,28
1650727115252,MATH 20D,A02,083766,Staff,6,0,30,24
1650727115252,MATH 20D,A03,083767,Staff,24,0,30,6
1650727121282,MATH 20E,A01,083771,Staff,3,0,30,27
1650727121282,MATH 20E,A02,083772,Staff,16,0,30,14
1650727121282,MATH 20E,B01,083773,Staff,0,0,30,30
1650727121282,MATH 20E,B02,083774,Staff,6,0,30,24
1650727127307,MATH 103A,A01,083777,Staff,0,15,30,30
1650727127307,MATH 103A,A02,083778,Staff,0,15,30,30
1650727127307,MATH 103A,B01,083779,Staff,0,15,30,30
1650727127307,MATH 103A,B02,083780,Staff,0,15,30,30
1650727133330,MATH 105,A01,085443,Staff,0,22,30,30
1650727139354,MATH 109,A01,083213,Anzaldo; Leesa B,0,7,30,30
1650727139354,MATH 109,A02,083214,Anzaldo; Leesa B,0,7,30,30
1650727139354,MATH 109,B01,083215,Anzaldo; Leesa B,0,8,30,30
1650727139354,MATH 109,B02,083216,Anzaldo; Leesa B,0,6,30,30
1650727145380,MATH 142A,A01,083219,Chow; Bennett,0,16,30,30
1650727145380,MATH 142A,A02,083220,Chow; Bennett,0,15,30,30
1650727145380,MATH 142A,B01,083221,Chow; Bennett,0,15,30,30
1650727145380,MATH 142A,B02,083222,Chow; Bennett,0,14,30,30
1650727151405,MATH 193A,A01,083224,Staff,0,5,30,30
1650727151405,MATH 193A,A02,083225,Staff,0,6,30,30
1650727151405,MATH 193A,A03,083781,Staff,0,6,30,30
1650727151405,MATH 193A,A04,083782,Staff,0,7,30,30
1650727157430,MATH 197,001,091859,McAuley; Julian John,9998,0,9999,1
1650727163490,COGS 9,A01,083615,Staff,1,15,60,59
1650727169513,COGS 11,A01,083617,Boyle; Mary E. T.,16,0,40,24
1650727175539,COGS 13,A01,083071,Staff,0,38,40,40
1650727181561,COGS 14A,A01,092681,Staff,0,35,100,100
1650727187588,COGS 14B,A01,083073,Cheng; Tzu-Han,1,13,50,49
1650727193614,COGS 17,A01,092677,Staff,13,0,75,62
1650727199639,COGS 100,A01,083619,Staff,0,28,60,60
1650727205663,COGS 101A,A01,083621,Davis; Joshua Daniel,0,27,60,60
1650727211688,COGS 101B,A01,091572,Staff,0,4,60,60
1650727217717,COGS 101C,A01,083625,Delgado; Tania,14,0,30,16
1650727223742,COGS 107A,A01,083627,Boyle; Mary E. T.,0,16,60,60
1650727229769,COGS 118A,A01,083075,Staff,0,8,60,60
1650727235798,CSE 3,A50,083646,Miranda; Gregory Joseph,18,0,38,20
1650727235798,CSE 3,A51,083647,Miranda; Gregory Joseph,36,0,37,1
1650727241827,CSE 8A,A50,083650,Miranda; Gregory Joseph,0,30,40,40
1650727247854,CSE 11,A01,083080,Cao; Yingjun,0,96,40,40
1650727253878,CSE 12,A01,083652,Staff,0,21,100,100
1650727259905,CSE 15L,A01,083654,Staff,0,3,50,50
1650727259905,CSE 15L,A02,083655,Staff,0,2,50,50
1650727265927,CSE 20,A01,083657,Staff,49,0,80,31
1650727271951,CSE 30,A01,083084,Eldon; John,0,77,40,40
1650727277981,CSE 100,A01,083659,Cao; Yingjun,0,70,50,50
1650727284008,CSE 134B,A01,083661,Powell; Thomas Allan,0,38,65,65
1650727290034,CSE 140,A01,083663,Staff,0,11,75,75
1650727296057,CSE 140L,A01,083088,Eldon; John,0,20,75,75
1650727302080,CSE 175,A01,083665,Kumar; Rakesh,7,0,25,18
1650727308106,CSE 190,A00,092507,Dubnov; Shlomo,10,0,20,10
1650727314132,ECE 45,A01,083139,Staff,1,2,60,59
1650727320157,ECE 65,A50,083695,Staff,0,5,30,30
1650727326181,ECE 109,A01,091882,Touri; Behrouz,33,0,70,37
1650727332206,ECE 180,A00,083140,Abi Samra; Nicholas Camill,20,0,30,10
1650727332206,ECE 180,B00,083141,Abi Samra; Nicholas Camill,0,0,30,30
1650727338232,MATH 10A,A01,083735,Patchell; Gregory David,2,0,30,28
1650727338232,MATH 10A,A02,083736,Patchell; Gregory David,27,0,30,3
1650727338232,MATH 10A,A03,083737,Patchell; Gregory David,24,0,30,6
1650727344256,MATH 10B,A01,083207,Staff,0,9,30,30
1650727344256,MATH 10B,A02,083208,Staff,1,7,30,29
1650727344256,MATH 10B,B01,083739,Staff,11,0,30,19
1650727344256,MATH 10B,B02,083740,Staff,28,0,30,2
1650727350288,MATH 18,A01,083743,Staff,0,0,30,30
1650727350288,MATH 18,A02,083744,Staff,23,0,30,7
1650727350288,MATH 18,A03,083745,Staff,21,0,30,9
1650727350288,MATH 18,A04,083746,Staff,26,0,30,4
1650727350288,MATH 18,B01,083748,Staff,0,15,30,30
1650727350288,MATH 18,B02,083749,Staff,0,12,30,30
1650727350288,MATH 18,B03,083750,Staff,0,12,30,30
1650727350288,MATH 18,B04,083751,Staff,0,12,30,30
1650727356312,MATH 20A,A01,083754,Staff,19,0,40,21
1650727362340,MATH 20B,A01,083756,Staff,0,11,30,30
1650727362340,MATH 20B,A02,083757,Staff,0,12,30,30
1650727368370,MATH 20C,A01,083760,Staff,0,16,30,30
1650727368370,MATH 20C,A02,083761,Staff,0,16,30,30
1650727368370,MATH 20C,B01,083762,Staff,10,0,30,20
1650727368370,MATH 20C,B02,083763,Staff,28,0,30,2
1650727374393,MATH 20D,A01,083765,Staff,2,1,30,28
1650727374393,MATH 20D,A02,083766,Staff,6,0,30,24
1650727374393,MATH 20D,A03,083767,Staff,24,0,30,6
1650727380425,MATH 20E,A01,083771,Staff,3,0,30,27
1650727380425,MATH 20E,A02,083772,Staff,16,0,30,14
1650727380425,MATH 20E,B01,083773,Staff,0,0,30,30
1650727380425,MATH 20E,B02,083774,Staff,6,0,30,24
1650727386458,MATH 103A,A01,083777,Staff,0,15,30,30
1650727386458,MATH 103A,A02,083778,Staff,0,15,30,30
1650727386458,MATH 103A,B01,083779,Staff,0,15,30,30
1650727386458,MATH 103A,B02,083780,Staff,0,15,30,30
1650727392482,MATH 105,A01,085443,Staff,0,22,30,30
1650727398505,MATH 109,A01,083213,Anzaldo; Leesa B,0,7,30,30
1650727398505,MATH 109,A02,083214,Anzaldo; Leesa B,0,7,30,30
1650727398505,MATH 109,B01,083215,Anzaldo; Leesa B,0,8,30,30
1650727398505,MATH 109,B02,083216,Anzaldo; Leesa B,0,6,30,30
1650727404531,MATH 142A,A01,083219,Chow; Bennett,0,16,30,30
1650727404531,MATH 142A,A02,083220,Chow; Bennett,0,15,30,30
1650727404531,MATH 142A,B01,083221,Chow; Bennett,0,15,30,30
1650727404531,MATH 142A,B02,083222,Chow; Bennett,0,14,30,30
1650727410559,MATH 193A,A01,083224,Staff,0,5,30,30
1650727410559,MATH 193A,A02,083225,Staff,0,6,30,30
1650727410559,MATH 193A,A03,083781,Staff,0,6,30,30
1650727410559,MATH 193A,A04,083782,Staff,0,7,30,30
1650727416587,MATH 197,001,091859,McAuley; Julian John,9998,0,9999,1
1650727422653,COGS 9,A01,083615,Staff,1,15,60,59
1650727428681,COGS 11,A01,083617,Boyle; Mary E. T.,16,0,40,24
1650727434706,COGS 13,A01,083071,Staff,0,38,40,40
1650727440733,COGS 14A,A01,092681,Staff,0,35,100,100
1650727446762,COGS 14B,A01,083073,Cheng; Tzu-Han,1,13,50,49
1650727452784,COGS 17,A01,092677,Staff,13,0,75,62
1650727458808,COGS 100,A01,083619,Staff,0,28,60,60
1650727464835,COGS 101A,A01,083621,Davis; Joshua Daniel,0,27,60,60
1650727470858,COGS 101B,A01,091572,Staff,0,4,60,60
1650727476882,COGS 101C,A01,083625,Delgado; Tania,14,0,30,16
1650727482905,COGS 107A,A01,083627,Boyle; Mary E. T.,0,16,60,60
1650727488938,COGS 118A,A01,083075,Staff,0,8,60,60
1650727494962,CSE 3,A50,083646,Miranda; Gregory Joseph,18,0,38,20
1650727494962,CSE 3,A51,083647,Miranda; Gregory Joseph,36,0,37,1
1650727501082,CSE 8A,A50,083650,Miranda; Gregory Joseph,0,30,40,40
1650727507106,CSE 11,A01,083080,Cao; Yingjun,0,96,40,40
1650727513133,CSE 12,A01,083652,Staff,0,21,100,100
1650727519159,CSE 15L,A01,083654,Staff,0,3,50,50
1650727519159,CSE 15L,A02,083655,Staff,0,2,50,50
1650727525193,CSE 20,A01,083657,Staff,49,0,80,31
1650727531218,CSE 30,A01,083084,Eldon; John,0,77,40,40
1650727537242,CSE 100,A01,083659,Cao; Yingjun,0,70,50,50
1650727543270,CSE 134B,A01,083661,Powell; Thomas Allan,0,38,65,65
1650727549293,CSE 140,A01,083663,Staff,0,11,75,75
1650727555321,CSE 140L,A01,083088,Eldon; John,0,20,75,75
1650727561347,CSE 175,A01,083665,Kumar; Rakesh,7,0,25,18
1650727567371,CSE 190,A00,092507,Dubnov; Shlomo,10,0,20,10
1650727573404,ECE 45,A01,083139,Staff,1,2,60,59
1650727579429,ECE 65,A50,083695,Staff,0,5,30,30
1650727585453,ECE 109,A01,091882,Touri; Behrouz,33,0,70,37
1650727591477,ECE 180,A00,083140,Abi Samra; Nicholas Camill,20,0,30,10
1650727591477,ECE 180,B00,083141,Abi Samra; Nicholas Camill,0,0,30,30
1650727597505,MATH 10A,A01,083735,Patchell; Gregory David,2,0,30,28
1650727597505,MATH 10A,A02,083736,Patchell; Gregory David,27,0,30,3
1650727597505,MATH 10A,A03,083737,Patchell; Gregory David,24,0,30,6
1650727603534,MATH 10B,A01,083207,Staff,0,9,30,30
1650727603534,MATH 10B,A02,083208,Staff,1,7,30,29
1650727603534,MATH 10B,B01,083739,Staff,11,0,30,19
1650727603534,MATH 10B,B02,083740,Staff,28,0,30,2
1650727609561,MATH 18,A01,083743,Staff,0,0,30,30
1650727609561,MATH 18,A02,083744,Staff,23,0,30,7
1650727609561,MATH 18,A03,083745,Staff,21,0,30,9
1650727609561,MATH 18,A04,083746,Staff,26,0,30,4
1650727609561,MATH 18,B01,083748,Staff,0,15,30,30
1650727609561,MATH 18,B02,083749,Staff,0,12,30,30
1650727609561,MATH 18,B03,083750,Staff,0,12,30,30
1650727609561,MATH 18,B04,083751,Staff,0,12,30,30
1650727615589,MATH 20A,A01,083754,Staff,19,0,40,21
1650727621613,MATH 20B,A01,083756,Staff,0,11,30,30
1650727621613,MATH 20B,A02,083757,Staff,0,12,30,30
1650727627640,MATH 20C,A01,083760,Staff,0,16,30,30
1650727627640,MATH 20C,A02,083761,Staff,0,16,30,30
1650727627640,MATH 20C,B01,083762,Staff,10,0,30,20
1650727627640,MATH 20C,B02,083763,Staff,28,0,30,2
1650727633663,MATH 20D,A01,083765,Staff,2,1,30,28
1650727633663,MATH 20D,A02,083766,Staff,6,0,30,24
1650727633663,MATH 20D,A03,083767,Staff,24,0,30,6
1650727639693,MATH 20E,A01,083771,Staff,3,0,30,27
1650727639693,MATH 20E,A02,083772,Staff,16,0,30,14
1650727639693,MATH 20E,B01,083773,Staff,0,0,30,30
1650727639693,MATH 20E,B02,083774,Staff,6,0,30,24
1650727645721,MATH 103A,A01,083777,Staff,0,15,30,30
1650727645721,MATH 103A,A02,083778,Staff,0,15,30,30
1650727645721,MATH 103A,B01,083779,Staff,0,15,30,30
1650727645721,MATH 103A,B02,083780,Staff,0,15,30,30
1650727651749,MATH 105,A01,085443,Staff,0,22,30,30
1650727657774,MATH 109,A01,083213,Anzaldo; Leesa B,0,7,30,30
1650727657774,MATH 109,A02,083214,Anzaldo; Leesa B,0,7,30,30
1650727657774,MATH 109,B01,083215,Anzaldo; Leesa B,0,8,30,30
1650727657774,MATH 109,B02,083216,Anzaldo; Leesa B,0,6,30,30
1650727663806,MATH 142A,A01,083219,Chow; Bennett,0,16,30,30
1650727663806,MATH 142A,A02,083220,Chow; Bennett,0,15,30,30
1650727663806,MATH 142A,B01,083221,Chow; Bennett,0,15,30,30
1650727663806,MATH 142A,B02,083222,Chow; Bennett,0,14,30,30
1650727669834,MATH 193A,A01,083224,Staff,0,5,30,30
1650727669834,MATH 193A,A02,083225,Staff,0,6,30,30
1650727669834,MATH 193A,A03,083781,Staff,0,6,30,30
1650727669834,MATH 193A,A04,083782,Staff,0,7,30,30
1650727675859,MATH 197,001,091859,McAuley; Julian John,9998,0,9999,1
1650727681919,COGS 9,A01,083615,Staff,1,15,60,59
1650727687946,COGS 11,A01,083617,Boyle; Mary E. T.,16,0,40,24
1650727693969,COGS 13,A01,083071,Staff,0,38,40,40
1650727699994,COGS 14A,A01,092681,Staff,0,35,100,100
1650727706018,COGS 14B,A01,083073,Cheng; Tzu-Han,1,13,50,49
1650727712042,COGS 17,A01,092677,Staff,13,0,75,62
1650727718067,COGS 100,A01,083619,Staff,0,28,60,60
1650727724091,COGS 101A,A01,083621,Davis; Joshua Daniel,0,27,60,60
1650727730114,COGS 101B,A01,091572,Staff,0,4,60,60
1650727736139,COGS 101C,A01,083625,Delgado; Tania,14,0,30,16
1650727742162,COGS 107A,A01,083627,Boyle; Mary E. T.,0,16,60,60
1650727748185,COGS 118A,A01,083075,Staff,0,8,60,60
1650727754213,CSE 3,A50,083646,Miranda; Gregory Joseph,18,0,38,20
1650727754213,CSE 3,A51,083647,Miranda; Gregory Joseph,36,0,37,1
1650727760245,CSE 8A,A50,083650,Miranda; Gregory Joseph,0,30,40,40
1650727766269,CSE 11,A01,083080,Cao; Yingjun,0,96,40,40
1650727772292,CSE 12,A01,083652,Staff,0,21,100,100
1650727778319,CSE 15L,A01,083654,Staff,0,3,50,50
1650727778319,CSE 15L,A02,083655,Staff,0,2,50,50
1650727784343,CSE 20,A01,083657,Staff,49,0,80,31
1650727790367,CSE 30,A01,083084,Eldon; John,0,77,40,40
1650727796395,CSE 100,A01,083659,Cao; Yingjun,0,70,50,50
1650727802428,CSE 134B,A01,083661,Powell; Thomas Allan,0,38,65,65
1650727808452,CSE 140,A01,083663,Staff,0,11,75,75
1650727814475,CSE 140L,A01,083088,Eldon; John,0,20,75,75
1650727820499,CSE 175,A01,083665,Kumar; Rakesh,7,0,25,18
1650727826537,CSE 190,A00,092507,Dubnov; Shlomo,10,0,20,10
1650727832561,ECE 45,A01,083139,Staff,1,2,60,59
1650727838586,ECE 65,A50,083695,Staff,0,5,30,30
1650727844609,ECE 109,A01,091882,Touri; Behrouz,33,0,70,37
1650727850633,ECE 180,A00,083140,Abi Samra; Nicholas Camill,20,0,30,10
1650727850633,ECE 180,B00,083141,Abi Samra; Nicholas Camill,0,0,30,30
1650727856658,MATH 10A,A01,083735,Patchell; Gregory David,2,0,30,28
1650727856658,MATH 10A,A02,083736,Patchell; Gregory David,27,0,30,3
1650727856658,MATH 10A,A03,083737,Patchell; Gregory David,24,0,30,6
1650727862682,MATH 10B,A01,083207,Staff,0,9,30,30
1650727862682,MATH 10B,A02,083208,Staff,1,7,30,29
1650727862682,MATH 10B,B01,083739,Staff,11,0,30,19
1650727862682,MATH 10B,B02,083740,Staff,28,0,30,2
1650727868706,MATH 18,A01,083743,Staff,0,0,30,30
1650727868706,MATH 18,A02,083744,Staff,23,0,30,7
1650727868706,MATH 18,A03,083745,Staff,21,0,30,9
1650727868706,MATH 18,A04,083746,Staff,26,0,30,4
1650727868706,MATH 18,B01,083748,Staff,0,15,30,30
1650727868706,MATH 18,B02,083749,Staff,0,12,30,30
1650727868706,MATH 18,B03,083750,Staff,0,12,30,30
1650727868706,MATH 18,B04,083751,Staff,0,12,30,30
1650727874733,MATH 20A,A01,083754,Staff,19,0,40,21
1650727880761,MATH 20B,A01,083756,Staff,0,11,30,30
1650727880761,MATH 20B,A02,083757,Staff,0,12,30,30
1650727886785,MATH 20C,A01,083760,Staff,0,16,30,30
1650727886785,MATH 20C,A02,083761,Staff,0,16,30,30
1650727886785,MATH 20C,B01,083762,Staff,10,0,30,20
1650727886785,MATH 20C,B02,083763,Staff,28,0,30,2
1650727892811,MATH 20D,A01,083765,Staff,2,1,30,28
1650727892811,MATH 20D,A02,083766,Staff,6,0,30,24
1650727892811,MATH 20D,A03,083767,Staff,24,0,30,6
1650727898839,MATH 20E,A01,083771,Staff,3,0,30,27
1650727898839,MATH 20E,A02,083772,Staff,16,0,30,14
1650727898839,MATH 20E,B01,083773,Staff,0,0,30,30
1650727898839,MATH 20E,B02,083774,Staff,6,0,30,24
1650727904863,MATH 103A,A01,083777,Staff,0,15,30,30
1650727904863,MATH 103A,A02,083778,Staff,0,15,30,30
1650727904863,MATH 103A,B01,083779,Staff,0,15,30,30
1650727904863,MATH 103A,B02,083780,Staff,0,15,30,30
1650727910890,MATH 105,A01,085443,Staff,0,22,30,30
1650727916918,MATH 109,A01,083213,Anzaldo; Leesa B,0,7,30,30
1650727916918,MATH 109,A02,083214,Anzaldo; Leesa B,0,7,30,30
1650727916918,MATH 109,B01,083215,Anzaldo; Leesa B,0,8,30,30
1650727916918,MATH 109,B02,083216,Anzaldo; Leesa B,0,6,30,30
1650727922943,MATH 142A,A01,083219,Chow; Bennett,0,16,30,30
1650727922943,MATH 142A,A02,083220,Chow; Bennett,0,15,30,30
1650727922943,MATH 142A,B01,083221,Chow; Bennett,0,15,30,30
1650727922943,MATH 142A,B02,083222,Chow; Bennett,0,14,30,30
1650727928970,MATH 193A,A01,083224,Staff,0,5,30,30
1650727928970,MATH 193A,A02,083225,Staff,0,6,30,30
1650727928970,MATH 193A,A03,083781,Staff,0,6,30,30
1650727928970,MATH 193A,A04,083782,Staff,0,7,30,30
1650727934995,MATH 197,001,091859,McAuley; Julian John,9998,0,9999,1
1650727941046,COGS 9,A01,083615,Staff,1,15,60,59
1650727947071,COGS 11,A01,083617,Boyle; Mary E. T.,16,0,40,24
1650727953095,COGS 13,A01,083071,Staff,0,38,40,40
1650727959119,COGS 14A,A01,092681,Staff,0,35,100,100
1650727965142,COGS 14B,A01,083073,Cheng; Tzu-Han,1,13,50,49
1650727971164,COGS 17,A01,092677,Staff,13,0,75,62
1650727977188,COGS 100,A01,083619,Staff,0,28,60,60
1650727983212,COGS 101A,A01,083621,Davis; Joshua Daniel,0,27,60,60
1650727989240,COGS 101B,A01,091572,Staff,0,4,60,60
1650727995265,COGS 101C,A01,083625,Delgado; Tania,14,0,30,16
1650728001291,COGS 107A,A01,083627,Boyle; Mary E. T.,0,16,60,60
1650728007317,COGS 118A,A01,083075,Staff,0,8,60,60
1650728013342,CSE 3,A50,083646,Miranda; Gregory Joseph,18,0,38,20
1650728013342,CSE 3,A51,083647,Miranda; Gregory Joseph,36,0,37,1
1650728019367,CSE 8A,A50,083650,Miranda; Gregory Joseph,0,30,40,40
1650728025391,CSE 11,A01,083080,Cao; Yingjun,0,96,40,40
1650728031419,CSE 12,A01,083652,Staff,0,21,100,100
1650728037448,CSE 15L,A01,083654,Staff,0,3,50,50
1650728037448,CSE 15L,A02,083655,Staff,0,2,50,50
1650728043471,CSE 20,A01,083657,Staff,49,0,80,31
1650728049495,CSE 30,A01,083084,Eldon; John,0,77,40,40
1650728055519,CSE 100,A01,083659,Cao; Yingjun,0,70,50,50
1650728061543,CSE 134B,A01,083661,Powell; Thomas Allan,0,38,65,65
1650728067565,CSE 140,A01,083663,Staff,0,11,75,75
1650728073592,CSE 140L,A01,083088,Eldon; John,0,20,75,75
1650728079616,CSE 175,A01,083665,Kumar; Rakesh,7,0,25,18
1650728085641,CSE 190,A00,092507,Dubnov; Shlomo,10,0,20,10
1650728091671,ECE 45,A01,083139,Staff,1,2,60,59
1650728097819,ECE 65,A50,083695,Staff,0,5,30,30
1650728103848,ECE 109,A01,091882,Touri; Behrouz,33,0,70,37
1650728109877,ECE 180,A00,083140,Abi Samra; Nicholas Camill,20,0,30,10
1650728109877,ECE 180,B00,083141,Abi Samra; Nicholas Camill,0,0,30,30
1650728115903,MATH 10A,A01,083735,Patchell; Gregory David,2,0,30,28
1650728115903,MATH 10A,A02,083736,Patchell; Gregory David,27,0,30,3
1650728115903,MATH 10A,A03,083737,Patchell; Gregory David,24,0,30,6
1650728121930,MATH 10B,A01,083207,Staff,0,9,30,30
1650728121930,MATH 10B,A02,083208,Staff,1,7,30,29
1650728121930,MATH 10B,B01,083739,Staff,11,0,30,19
1650728121930,MATH 10B,B02,083740,Staff,28,0,30,2
1650728127957,MATH 18,A01,083743,Staff,0,0,30,30
1650728127957,MATH 18,A02,083744,Staff,23,0,30,7
1650728127957,MATH 18,A03,083745,Staff,21,0,30,9
1650728127957,MATH 18,A04,083746,Staff,26,0,30,4
1650728127957,MATH 18,B01,083748,Staff,0,15,30,30
1650728127957,MATH 18,B02,083749,Staff,0,12,30,30
1650728127957,MATH 18,B03,083750,Staff,0,12,30,30
1650728127957,MATH 18,B04,083751,Staff,0,12,30,30
1650728133979,MATH 20A,A01,083754,Staff,19,0,40,21
1650728140004,MATH 20B,A01,083756,Staff,0,11,30,30
1650728140004,MATH 20B,A02,083757,Staff,0,12,30,30
1650728146028,MATH 20C,A01,083760,Staff,0,16,30,30
1650728146028,MATH 20C,A02,083761,Staff,0,16,30,30
1650728146028,MATH 20C,B01,083762,Staff,10,0,30,20
1650728146028,MATH 20C,B02,083763,Staff,28,0,30,2
1650728152055,MATH 20D,A01,083765,Staff,2,1,30,28
1650728152055,MATH 20D,A02,083766,Staff,6,0,30,24
1650728152055,MATH 20D,A03,083767,Staff,24,0,30,6
1650728158078,MATH 20E,A01,083771,Staff,3,0,30,27
1650728158078,MATH 20E,A02,083772,Staff,16,0,30,14
1650728158078,MATH 20E,B01,083773,Staff,0,0,30,30
1650728158078,MATH 20E,B02,083774,Staff,6,0,30,24
1650728164103,MATH 103A,A01,083777,Staff,0,15,30,30
1650728164103,MATH 103A,A02,083778,Staff,0,15,30,30
1650728164103,MATH 103A,B01,083779,Staff,0,15,30,30
1650728164103,MATH 103A,B02,083780,Staff,0,15,30,30
1650728170130,MATH 105,A01,085443,Staff,0,22,30,30
1650728176153,MATH 109,A01,083213,Anzaldo; Leesa B,0,7,30,30
1650728176153,MATH 109,A02,083214,Anzaldo; Leesa B,0,7,30,30
1650728176153,MATH 109,B01,083215,Anzaldo; Leesa B,0,8,30,30
1650728176153,MATH 109,B02,083216,Anzaldo; Leesa B,0,6,30,30
1650728182183,MATH 142A,A01,083219,Chow; Bennett,0,16,30,30
1650728182183,MATH 142A,A02,083220,Chow; Bennett,0,15,30,30
1650728182183,MATH 142A,B01,083221,Chow; Bennett,0,15,30,30
1650728182183,MATH 142A,B02,083222,Chow; Bennett,0,14,30,30
1650728188213,MATH 193A,A01,083224,Staff,0,5,30,30
1650728188213,MATH 193A,A02,083225,Staff,0,6,30,30
1650728188213,MATH 193A,A03,083781,Staff,0,6,30,30
1650728188213,MATH 193A,A04,083782,Staff,0,7,30,30
1650728194237,MATH 197,001,091859,McAuley; Julian John,9998,0,9999,1
1650728200297,COGS 9,A01,083615,Staff,1,15,60,59
1650728206321,COGS 11,A01,083617,Boyle; Mary E. T.,16,0,40,24
1650728212343,COGS 13,A01,083071,Staff,0,38,40,40
1650728218370,COGS 14A,A01,092681,Staff,0,35,100,100
1650728224402,COGS 14B,A01,083073,Cheng; Tzu-Han,1,13,50,49
1650728230431,COGS 17,A01,092677,Staff,13,0,75,62
1650728236457,COGS 100,A01,083619,Staff,0,28,60,60
1650728242493,COGS 101A,A01,083621,Davis; Joshua Daniel,0,27,60,60
1650728248530,COGS 101B,A01,091572,Staff,0,4,60,60
1650728254565,COGS 101C,A01,083625,Delgado; Tania,14,0,30,16
1650728260590,COGS 107A,A01,083627,Boyle; Mary E. T.,0,16,60,60
1650728266612,COGS 118A,A01,083075,Staff,0,8,60,60
1650728272640,CSE 3,A50,083646,Miranda; Gregory Joseph,18,0,38,20
1650728272640,CSE 3,A51,083647,Miranda; Gregory Joseph,36,0,37,1
1650728278664,CSE 8A,A50,083650,Miranda; Gregory Joseph,0,30,40,40
1650728284688,CSE 11,A01,083080,Cao; Yingjun,0,96,40,40
1650728290717,CSE 12,A01,083652,Staff,0,21,100,100
1650728296744,CSE 15L,A01,083654,Staff,0,3,50,50
1650728296744,CSE 15L,A02,083655,Staff,0,2,50,50
1650728302768,CSE 20,A01,083657,Staff,49,0,80,31
1650728308792,CSE 30,A01,083084,Eldon; John,0,77,40,40
1650728314824,CSE 100,A01,083659,Cao; Yingjun,0,70,50,50
1650728320859,CSE 134B,A01,083661,Powell; Thomas Allan,0,38,65,65
1650728326881,CSE 140,A01,083663,Staff,0,11,75,75
1650728332904,CSE 140L,A01,083088,Eldon; John,0,20,75,75
1650728338925,CSE 175,A01,083665,Kumar; Rakesh,7,0,25,18
1650728344950,CSE 190,A00,092507,Dubnov; Shlomo,10,0,20,10
1650728350984,ECE 45,A01,083139,Staff,1,2,60,59
1650728357007,ECE 65,A50,083695,Staff,0,5,30,30
1650728363032,ECE 109,A01,091882,Touri; Behrouz,33,0,70,37
1650728369061,ECE 180,A00,083140,Abi Samra; Nicholas Camill,20,0,30,10
1650728369061,ECE 180,B00,083141,Abi Samra; Nicholas Camill,0,0,30,30
1650728375085,MATH 10A,A01,083735,Patchell; Gregory David,2,0,30,28
1650728375085,MATH 10A,A02,083736,Patchell; Gregory David,27,0,30,3
1650728375085,MATH 10A,A03,083737,Patchell; Gregory David,24,0,30,6
1650728381115,MATH 10B,A01,083207,Staff,0,9,30,30
1650728381115,MATH 10B,A02,083208,Staff,1,7,30,29
1650728381115,MATH 10B,B01,083739,Staff,11,0,30,19
1650728381115,MATH 10B,B02,083740,Staff,28,0,30,2
1650728387139,MATH 18,A01,083743,Staff,0,0,30,30
1650728387139,MATH 18,A02,083744,Staff,23,0,30,7
1650728387139,MATH 18,A03,083745,Staff,21,0,30,9
1650728387139,MATH 18,A04,083746,Staff,26,0,30,4
1650728387139,MATH 18,B01,083748,Staff,0,15,30,30
1650728387139,MATH 18,B02,083749,Staff,0,12,30,30
1650728387139,MATH 18,B03,083750,Staff,0,12,30,30
1650728387139,MATH 18,B04,083751,Staff,0,12,30,30
1650728393167,MATH 20A,A01,083754,Staff,19,0,40,21
1650728399192,MATH 20B,A01,083756,Staff,0,11,30,30
1650728399192,MATH 20B,A02,083757,Staff,0,12,30,30
1650728405219,MATH 20C,A01,083760,Staff,0,16,30,30
1650728405219,MATH 20C,A02,083761,Staff,0,16,30,30
1650728405219,MATH 20C,B01,083762,Staff,10,0,30,20
1650728405219,MATH 20C,B02,083763,Staff,28,0,30,2
1650728411247,MATH 20D,A01,083765,Staff,2,1,30,28
1650728411247,MATH 20D,A02,083766,Staff,6,0,30,24
1650728411247,MATH 20D,A03,083767,Staff,24,0,30,6
1650728417275,MATH 20E,A01,083771,Staff,3,0,30,27
1650728417275,MATH 20E,A02,083772,Staff,16,0,30,14
1650728417275,MATH 20E,B01,083773,Staff,0,0,30,30
1650728417275,MATH 20E,B02,083774,Staff,6,0,30,24
1650728423299,MATH 103A,A01,083777,Staff,0,15,30,30
1650728423299,MATH 103A,A02,083778,Staff,0,15,30,30
1650728423299,MATH 103A,B01,083779,Staff,0,15,30,30
1650728423299,MATH 103A,B02,083780,Staff,0,15,30,30
1650728429329,MATH 105,A01,085443,Staff,0,22,30,30
1650728435353,MATH 109,A01,083213,Anzaldo; Leesa B,0,7,30,30
1650728435353,MATH 109,A02,083214,Anzaldo; Leesa B,0,7,30,30
1650728435353,MATH 109,B01,083215,Anzaldo; Leesa B,0,8,30,30
1650728435353,MATH 109,B02,083216,Anzaldo; Leesa B,0,6,30,30
1650728441379,MATH 142A,A01,083219,Chow; Bennett,0,16,30,30
1650728441379,MATH 142A,A02,083220,Chow; Bennett,0,15,30,30
1650728441379,MATH 142A,B01,083221,Chow; Bennett,0,15,30,30
1650728441379,MATH 142A,B02,083222,Chow; Bennett,0,14,30,30
1650728447401,MATH 193A,A01,083224,Staff,0,5,30,30
1650728447401,MATH 193A,A02,083225,Staff,0,6,30,30
1650728447401,MATH 193A,A03,083781,Staff,0,6,30,30
1650728447401,MATH 193A,A04,083782,Staff,0,7,30,30
1650728453425,MATH 197,001,091859,McAuley; Julian John,9998,0,9999,1
1650728459492,COGS 9,A01,083615,Staff,1,15,60,59
1650728465515,COGS 11,A01,083617,Boyle; Mary E. T.,16,0,40,24
1650728471540,COGS 13,A01,083071,Staff,0,38,40,40
1650728477563,COGS 14A,A01,092681,Staff,0,35,100,100
1650728483587,COGS 14B,A01,083073,Cheng; Tzu-Han,1,13,50,49
1650728489610,COGS 17,A01,092677,Staff,13,0,75,62
1650728495638,COGS 100,A01,083619,Staff,0,28,60,60
1650728506603,COGS 101A,A01,083621,Davis; Joshua Daniel,0,27,60,60
1650728512630,COGS 101B,A01,091572,Staff,0,4,60,60
1650728518658,COGS 101C,A01,083625,Delgado; Tania,14,0,30,16
1650728524683,COGS 107A,A01,083627,Boyle; Mary E. T.,0,16,60,60
1650728530706,COGS 118A,A01,083075,Staff,0,8,60,60
1650728536734,CSE 3,A50,083646,Miranda; Gregory Joseph,18,0,38,20
1650728536734,CSE 3,A51,083647,Miranda; Gregory Joseph,36,0,37,1
1650728542764,CSE 8A,A50,083650,Miranda; Gregory Joseph,0,30,40,40
1650728548791,CSE 11,A01,083080,Cao; Yingjun,0,96,40,40
1650728554816,CSE 12,A01,083652,Staff,0,21,100,100
1650728560840,CSE 15L,A01,083654,Staff,0,3,50,50
1650728560840,CSE 15L,A02,083655,Staff,0,2,50,50
1650728566866,CSE 20,A01,083657,Staff,49,0,80,31
1650728572890,CSE 30,A01,083084,Eldon; John,0,77,40,40
1650728578915,CSE 100,A01,083659,Cao; Yingjun,0,70,50,50
1650728584939,CSE 134B,A01,083661,Powell; Thomas Allan,0,38,65,65
1650728590964,CSE 140,A01,083663,Staff,0,11,75,75
1650728596986,CSE 140L,A01,083088,Eldon; John,0,20,75,75
1650728603011,CSE 175,A01,083665,Kumar; Rakesh,7,0,25,18
1650728609035,CSE 190,A00,092507,Dubnov; Shlomo,10,0,20,10
1650728615059,ECE 45,A01,083139,Staff,1,2,60,59
1650728621090,ECE 65,A50,083695,Staff,0,5,30,30
1650728627113,ECE 109,A01,091882,Touri; Behrouz,33,0,70,37
1650728633139,ECE 180,A00,083140,Abi Samra; Nicholas Camill,20,0,30,10
1650728633139,ECE 180,B00,083141,Abi Samra; Nicholas Camill,0,0,30,30
1650728639166,MATH 10A,A01,083735,Patchell; Gregory David,2,0,30,28
1650728639166,MATH 10A,A02,083736,Patchell; Gregory David,27,0,30,3
1650728639166,MATH 10A,A03,083737,Patchell; Gregory David,24,0,30,6
1650728645191,MATH 10B,A01,083207,Staff,0,9,30,30
1650728645191,MATH 10B,A02,083208,Staff,1,7,30,29
1650728645191,MATH 10B,B01,083739,Staff,11,0,30,19
1650728645191,MATH 10B,B02,083740,Staff,28,0,30,2
1650728651217,MATH 18,A01,083743,Staff,0,0,30,30
1650728651217,MATH 18,A02,083744,Staff,23,0,30,7
1650728651217,MATH 18,A03,083745,Staff,21,0,30,9
1650728651217,MATH 18,A04,083746,Staff,26,0,30,4
1650728651217,MATH 18,B01,083748,Staff,0,15,30,30
1650728651217,MATH 18,B02,083749,Staff,0,12,30,30
1650728651217,MATH 18,B03,083750,Staff,0,12,30,30
1650728651217,MATH 18,B04,083751,Staff,0,12,30,30
1650728657241,MATH 20A,A01,083754,Staff,19,0,40,21
1650728663268,MATH 20B,A01,083756,Staff,0,11,30,30
1650728663268,MATH 20B,A02,083757,Staff,0,12,30,30
1650728669295,MATH 20C,A01,083760,Staff,0,16,30,30
1650728669295,MATH 20C,A02,083761,Staff,0,16,30,30
1650728669295,MATH 20C,B01,083762,Staff,10,0,30,20
1650728669295,MATH 20C,B02,083763,Staff,28,0,30,2
1650728675322,MATH 20D,A01,083765,Staff,2,1,30,28
1650728675322,MATH 20D,A02,083766,Staff,6,0,30,24
1650728675322,MATH 20D,A03,083767,Staff,24,0,30,6
1650728681347,MATH 20E,A01,083771,Staff,3,0,30,27
1650728681347,MATH 20E,A02,083772,Staff,16,0,30,14
1650728681347,MATH 20E,B01,083773,Staff,0,0,30,30
1650728681347,MATH 20E,B02,083774,Staff,6,0,30,24
1650728687371,MATH 103A,A01,083777,Staff,0,15,30,30
1650728687371,MATH 103A,A02,083778,Staff,0,15,30,30
1650728687371,MATH 103A,B01,083779,Staff,0,15,30,30
1650728687371,MATH 103A,B02,083780,Staff,0,15,30,30
1650728693396,MATH 105,A01,085443,Staff,0,22,30,30
1650728699516,MATH 109,A01,083213,Anzaldo; Leesa B,0,7,30,30
1650728699516,MATH 109,A02,083214,Anzaldo; Leesa B,0,7,30,30
1650728699516,MATH 109,B01,083215,Anzaldo; Leesa B,0,8,30,30
1650728699516,MATH 109,B02,083216,Anzaldo; Leesa B,0,6,30,30
1650728705544,MATH 142A,A01,083219,Chow; Bennett,0,16,30,30
1650728705544,MATH 142A,A02,083220,Chow; Bennett,0,15,30,30
1650728705544,MATH 142A,B01,083221,Chow; Bennett,0,15,30,30
1650728705544,MATH 142A,B02,083222,Chow; Bennett,0,14,30,30
1650728711571,MATH 193A,A01,083224,Staff,0,5,30,30
1650728711571,MATH 193A,A02,083225,Staff,0,6,30,30
1650728711571,MATH 193A,A03,083781,Staff,0,6,30,30
1650728711571,MATH 193A,A04,083782,Staff,0,7,30,30
1650728717597,MATH 197,001,091859,McAuley; Julian John,9998,0,9999,1
1650728723649,COGS 9,A01,083615,Staff,1,15,60,59
1650728729673,COGS 11,A01,083617,Boyle; Mary E. T.,16,0,40,24
1650728735697,COGS 13,A01,083071,Staff,0,38,40,40
1650728741719,COGS 14A,A01,092681,Staff,0,35,100,100
1650728747742,COGS 14B,A01,083073,Cheng; Tzu-Han,1,13,50,49
1650728753767,COGS 17,A01,092677,Staff,13,0,75,62
1650728759795,COGS 100,A01,083619,Staff,0,28,60,60
1650728765819,COGS 101A,A01,083621,Davis; Joshua Daniel,0,27,60,60
1650728771843,COGS 101B,A01,091572,Staff,0,4,60,60
1650728777870,COGS 101C,A01,083625,Delgado; Tania,14,0,30,16
1650728783894,COGS 107A,A01,083627,Boyle; Mary E. T.,0,16,60,60
1650728789919,COGS 118A,A01,083075,Staff,0,8,60,60
1650728795948,CSE 3,A50,083646,Miranda; Gregory Joseph,18,0,38,20
1650728795948,CSE 3,A51,083647,Miranda; Gregory Joseph,36,0,37,1
1650728801971,CSE 8A,A50,083650,Miranda; Gregory Joseph,0,30,40,40
1650728807995,CSE 11,A01,083080,Cao; Yingjun,0,96,40,40
1650728814020,CSE 12,A01,083652,Staff,0,21,100,100
1650728820045,CSE 15L,A01,083654,Staff,0,3,50,50
1650728820045,CSE 15L,A02,083655,Staff,0,2,50,50
1650728826069,CSE 20,A01,083657,Staff,49,0,80,31
1650728832096,CSE 30,A01,083084,Eldon; John,0,77,40,40
1650728838122,CSE 100,A01,083659,Cao; Yingjun,0,70,50,50
1650728844146,CSE 134B,A01,083661,Powell; Thomas Allan,0,38,65,65
1650728850176,CSE 140,A01,083663,Staff,0,11,75,75
1650728856200,CSE 140L,A01,083088,Eldon; John,0,20,75,75
1650728862224,CSE 175,A01,083665,Kumar; Rakesh,7,0,25,18
1650728868247,CSE 190,A00,092507,Dubnov; Shlomo,10,0,20,10
1650728874272,ECE 45,A01,083139,Staff,1,2,60,59
1650728880315,ECE 65,A50,083695,Staff,0,5,30,30
1650728886337,ECE 109,A01,091882,Touri; Behrouz,33,0,70,37
1650728892366,ECE 180,A00,083140,Abi Samra; Nicholas Camill,20,0,30,10
1650728892366,ECE 180,B00,083141,Abi Samra; Nicholas Camill,0,0,30,30
1650728898393,MATH 10A,A01,083735,Patchell; Gregory David,2,0,30,28
1650728898393,MATH 10A,A02,083736,Patchell; Gregory David,27,0,30,3
1650728898393,MATH 10A,A03,083737,Patchell; Gregory David,24,0,30,6
1650728904418,MATH 10B,A01,083207,Staff,0,9,30,30
1650728904418,MATH 10B,A02,083208,Staff,1,7,30,29
1650728904418,MATH 10B,B01,083739,Staff,11,0,30,19
1650728904418,MATH 10B,B02,083740,Staff,28,0,30,2
1650728910448,MATH 18,A01,083743,Staff,0,0,30,30
1650728910448,MATH 18,A02,083744,Staff,23,0,30,7
1650728910448,MATH 18,A03,083745,Staff,21,0,30,9
1650728910448,MATH 18,A04,083746,Staff,26,0,30,4
1650728910448,MATH 18,B01,083748,Staff,0,15,30,30
1650728910448,MATH 18,B02,083749,Staff,0,12,30,30
1650728910448,MATH 18,B03,083750,Staff,0,12,30,30
1650728910448,MATH 18,B04,083751,Staff,0,12,30,30
1650728916472,MATH 20A,A01,083754,Staff,19,0,40,21
1650728922494,MATH 20B,A01,083756,Staff,0,11,30,30
1650728922494,MATH 20B,A02,083757,Staff,0,12,30,30
1650728928518,MATH 20C,A01,083760,Staff,0,16,30,30
1650728928518,MATH 20C,A02,083761,Staff,0,16,30,30
1650728928518,MATH 20C,B01,083762,Staff,10,0,30,20
1650728928518,MATH 20C,B02,083763,Staff,28,0,30,2
1650728934545,MATH 20D,A01,083765,Staff,2,1,30,28
1650728934545,MATH 20D,A02,083766,Staff,6,0,30,24
1650728934545,MATH 20D,A03,083767,Staff,24,0,30,6
1650728940569,MATH 20E,A01,083771,Staff,3,0,30,27
1650728940569,MATH 20E,A02,083772,Staff,16,0,30,14
1650728940569,MATH 20E,B01,083773,Staff,0,0,30,30
1650728940569,MATH 20E,B02,083774,Staff,6,0,30,24
1650728946596,MATH 103A,A01,083777,Staff,0,15,30,30
1650728946596,MATH 103A,A02,083778,Staff,0,15,30,30
1650728946596,MATH 103A,B01,083779,Staff,0,15,30,30
1650728946596,MATH 103A,B02,083780,Staff,0,15,30,30
1650728952623,MATH 105,A01,085443,Staff,0,22,30,30
1650728958648,MATH 109,A01,083213,Anzaldo; Leesa B,0,7,30,30
1650728958648,MATH 109,A02,083214,Anzaldo; Leesa B,0,7,30,30
1650728958648,MATH 109,B01,083215,Anzaldo; Leesa B,0,8,30,30
1650728958648,MATH 109,B02,083216,Anzaldo; Leesa B,0,6,30,30
1650728964678,MATH 142A,A01,083219,Chow; Bennett,0,16,30,30
1650728964678,MATH 142A,A02,083220,Chow; Bennett,0,15,30,30
1650728964678,MATH 142A,B01,083221,Chow; Bennett,0,15,30,30
1650728964678,MATH 142A,B02,083222,Chow; Bennett,0,14,30,30
1650728970712,MATH 193A,A01,083224,Staff,0,5,30,30
1650728970712,MATH 193A,A02,083225,Staff,0,6,30,30
1650728970712,MATH 193A,A03,083781,Staff,0,6,30,30
1650728970712,MATH 193A,A04,083782,Staff,0,7,30,30
1650728976734,MATH 197,001,091859,McAuley; Julian John,9998,0,9999,1
1650728982789,COGS 9,A01,083615,Staff,1,15,60,59
1650728988821,COGS 11,A01,083617,Boyle; Mary E. T.,16,0,40,24
1650728994846,COGS 13,A01,083071,Staff,0,38,40,40
1650729000872,COGS 14A,A01,092681,Staff,0,35,100,100
1650729006895,COGS 14B,A01,083073,Cheng; Tzu-Han,1,13,50,49
1650729012920,COGS 17,A01,092677,Staff,13,0,75,62
1650729018945,COGS 100,A01,083619,Staff,0,28,60,60
1650729024972,COGS 101A,A01,083621,Davis; Joshua Daniel,0,27,60,60
1650729030998,COGS 101B,A01,091572,Staff,0,4,60,60
1650729037021,COGS 101C,A01,083625,Delgado; Tania,14,0,30,16
1650729043046,COGS 107A,A01,083627,Boyle; Mary E. T.,0,16,60,60
1650729049073,COGS 118A,A01,083075,Staff,0,8,60,60
1650729055098,CSE 3,A50,083646,Miranda; Gregory Joseph,18,0,38,20
1650729055098,CSE 3,A51,083647,Miranda; Gregory Joseph,36,0,37,1
1650729061123,CSE 8A,A50,083650,Miranda; Gregory Joseph,0,30,40,40
1650729067151,CSE 11,A01,083080,Cao; Yingjun,0,96,40,40
1650729073177,CSE 12,A01,083652,Staff,0,21,100,100
1650729079201,CSE 15L,A01,083654,Staff,0,3,50,50
1650729079201,CSE 15L,A02,083655,Staff,0,2,50,50
1650729085228,CSE 20,A01,083657,Staff,49,0,80,31
1650729091256,CSE 30,A01,083084,Eldon; John,0,77,40,40
1650729097283,CSE 100,A01,083659,Cao; Yingjun,0,70,50,50
1650729103305,CSE 134B,A01,083661,Powell; Thomas Allan,0,38,65,65
1650729109339,CSE 140,A01,083663,Staff,0,11,75,75
1650729115366,CSE 140L,A01,083088,Eldon; John,0,20,75,75
1650729121396,CSE 175,A01,083665,Kumar; Rakesh,7,0,25,18
1650729127422,CSE 190,A00,092507,Dubnov; Shlomo,10,0,20,10
1650729133446,ECE 45,A01,083139,Staff,1,2,60,59
1650729139470,ECE 65,A50,083695,Staff,0,5,30,30
1650729145492,ECE 109,A01,091882,Touri; Behrouz,33,0,70,37
1650729151518,ECE 180,A00,083140,Abi Samra; Nicholas Camill,20,0,30,10
1650729151518,ECE 180,B00,083141,Abi Samra; Nicholas Camill,0,0,30,30
1650729157545,MATH 10A,A01,083735,Patchell; Gregory David,2,0,30,28
1650729157545,MATH 10A,A02,083736,Patchell; Gregory David,27,0,30,3
1650729157545,MATH 10A,A03,083737,Patchell; Gregory David,24,0,30,6
1650729163568,MATH 10B,A01,083207,Staff,0,9,30,30
1650729163568,MATH 10B,A02,083208,Staff,1,7,30,29
1650729163568,MATH 10B,B01,083739,Staff,11,0,30,19
1650729163568,MATH 10B,B02,083740,Staff,28,0,30,2
1650729169594,MATH 18,A01,083743,Staff,0,0,30,30
1650729169594,MATH 18,A02,083744,Staff,23,0,30,7
1650729169594,MATH 18,A03,083745,Staff,21,0,30,9
1650729169594,MATH 18,A04,083746,Staff,26,0,30,4
1650729169594,MATH 18,B01,083748,Staff,0,15,30,30
1650729169594,MATH 18,B02,083749,Staff,0,12,30,30
1650729169594,MATH 18,B03,083750,Staff,0,12,30,30
1650729169594,MATH 18,B04,083751,Staff,0,12,30,30
1650729175617,MATH 20A,A01,083754,Staff,19,0,40,21
1650729181641,MATH 20B,A01,083756,Staff,0,11,30,30
1650729181641,MATH 20B,A02,083757,Staff,0,12,30,30
1650729187665,MATH 20C,A01,083760,Staff,0,16,30,30
1650729187665,MATH 20C,A02,083761,Staff,0,16,30,30
1650729187665,MATH 20C,B01,083762,Staff,10,0,30,20
1650729187665,MATH 20C,B02,083763,Staff,28,0,30,2
1650729193687,MATH 20D,A01,083765,Staff,2,1,30,28
1650729193687,MATH 20D,A02,083766,Staff,6,0,30,24
1650729193687,MATH 20D,A03,083767,Staff,24,0,30,6
1650729199711,MATH 20E,A01,083771,Staff,3,0,30,27
1650729199711,MATH 20E,A02,083772,Staff,16,0,30,14
1650729199711,MATH 20E,B01,083773,Staff,0,0,30,30
1650729199711,MATH 20E,B02,083774,Staff,6,0,30,24
1650729205752,MATH 103A,A01,083777,Staff,0,15,30,30
1650729205752,MATH 103A,A02,083778,Staff,0,15,30,30
1650729205752,MATH 103A,B01,083779,Staff,0,15,30,30
1650729205752,MATH 103A,B02,083780,Staff,0,15,30,30
1650729211774,MATH 105,A01,085443,Staff,0,22,30,30
1650729217798,MATH 109,A01,083213,Anzaldo; Leesa B,0,7,30,30
1650729217798,MATH 109,A02,083214,Anzaldo; Leesa B,0,7,30,30
1650729217798,MATH 109,B01,083215,Anzaldo; Leesa B,0,8,30,30
1650729217798,MATH 109,B02,083216,Anzaldo; Leesa B,0,6,30,30
1650729223825,MATH 142A,A01,083219,Chow; Bennett,0,16,30,30
1650729223825,MATH 142A,A02,083220,Chow; Bennett,0,15,30,30
1650729223825,MATH 142A,B01,083221,Chow; Bennett,0,15,30,30
1650729223825,MATH 142A,B02,083222,Chow; Bennett,0,14,30,30
1650729229852,MATH 193A,A01,083224,Staff,0,5,30,30
1650729229852,MATH 193A,A02,083225,Staff,0,6,30,30
1650729229852,MATH 193A,A03,083781,Staff,0,6,30,30
1650729229852,MATH 193A,A04,083782,Staff,0,7,30,30
1650729235878,MATH 197,001,091859,McAuley; Julian John,9998,0,9999,1
1650729241945,COGS 9,A01,083615,Staff,1,15,60,59
1650729247975,COGS 11,A01,083617,Boyle; Mary E. T.,16,0,40,24
1650729254002,COGS 13,A01,083071,Staff,0,38,40,40
1650729260025,COGS 14A,A01,092681,Staff,0,35,100,100
1650729266047,COGS 14B,A01,083073,Cheng; Tzu-Han,1,13,50,49
1650729272070,COGS 17,A01,092677,Staff,13,0,75,62
1650729278095,COGS 100,A01,083619,Staff,0,28,60,60
1650729284123,COGS 101A,A01,083621,Davis; Joshua Daniel,0,27,60,60
1650729290245,COGS 101B,A01,091572,Staff,0,4,60,60
1650729296269,COGS 101C,A01,083625,Delgado; Tania,14,0,30,16
1650729302294,COGS 107A,A01,083627,Boyle; Mary E. T.,0,16,60,60
1650729308318,COGS 118A,A01,083075,Staff,0,8,60,60
1650729314345,CSE 3,A50,083646,Miranda; Gregory Joseph,18,0,38,20
1650729314345,CSE 3,A51,083647,Miranda; Gregory Joseph,36,0,37,1
1650729320368,CSE 8A,A50,083650,Miranda; Gregory Joseph,0,30,40,40
1650729326394,CSE 11,A01,083080,Cao; Yingjun,0,96,40,40
1650729332417,CSE 12,A01,083652,Staff,0,21,100,100
1650729338441,CSE 15L,A01,083654,Staff,0,3,50,50
1650729338441,CSE 15L,A02,083655,Staff,0,2,50,50
1650729344468,CSE 20,A01,083657,Staff,49,0,80,31
1650729350500,CSE 30,A01,083084,Eldon; John,0,77,40,40
1650729356537,CSE 100,A01,083659,Cao; Yingjun,0,70,50,50
1650729362565,CSE 134B,A01,083661,Powell; Thomas Allan,0,38,65,65
1650729368591,CSE 140,A01,083663,Staff,0,11,75,75
1650729374617,CSE 140L,A01,083088,Eldon; John,0,20,75,75
1650729380645,CSE 175,A01,083665,Kumar; Rakesh,7,0,25,18
1650729386669,CSE 190,A00,092507,Dubnov; Shlomo,10,0,20,10
1650729392697,ECE 45,A01,083139,Staff,1,2,60,59
1650729398722,ECE 65,A50,083695,Staff,0,5,30,30
1650729404747,ECE 109,A01,091882,Touri; Behrouz,33,0,70,37
1650729410771,ECE 180,A00,083140,Abi Samra; Nicholas Camill,20,0,30,10
1650729410771,ECE 180,B00,083141,Abi Samra; Nicholas Camill,0,0,30,30
1650729416795,MATH 10A,A01,083735,Patchell; Gregory David,2,0,30,28
1650729416795,MATH 10A,A02,083736,Patchell; Gregory David,27,0,30,3
1650729416795,MATH 10A,A03,083737,Patchell; Gregory David,24,0,30,6
1650729422827,MATH 10B,A01,083207,Staff,0,9,30,30
1650729422827,MATH 10B,A02,083208,Staff,1,7,30,29
1650729422827,MATH 10B,B01,083739,Staff,11,0,30,19
1650729422827,MATH 10B,B02,083740,Staff,28,0,30,2
1650729428854,MATH 18,A01,083743,Staff,0,0,30,30
1650729428854,MATH 18,A02,083744,Staff,23,0,30,7
1650729428854,MATH 18,A03,083745,Staff,21,0,30,9
1650729428854,MATH 18,A04,083746,Staff,26,0,30,4
1650729428854,MATH 18,B01,083748,Staff,0,15,30,30
1650729428854,MATH 18,B02,083749,Staff,0,12,30,30
1650729428854,MATH 18,B03,083750,Staff,0,12,30,30
1650729428854,MATH 18,B04,083751,Staff,0,12,30,30
1650729434888,MATH 20A,A01,083754,Staff,19,0,40,21
1650729440916,MATH 20B,A01,083756,Staff,0,11,30,30
1650729440916,MATH 20B,A02,083757,Staff,0,12,30,30
1650729446942,MATH 20C,A01,083760,Staff,0,16,30,30
1650729446942,MATH 20C,A02,083761,Staff,0,16,30,30
1650729446942,MATH 20C,B01,083762,Staff,10,0,30,20
1650729446942,MATH 20C,B02,083763,Staff,28,0,30,2
1650729452970,MATH 20D,A01,083765,Staff,2,1,30,28
1650729452970,MATH 20D,A02,083766,Staff,6,0,30,24
1650729452970,MATH 20D,A03,083767,Staff,24,0,30,6
1650729458994,MATH 20E,A01,083771,Staff,3,0,30,27
1650729458994,MATH 20E,A02,083772,Staff,16,0,30,14
1650729458994,MATH 20E,B01,083773,Staff,0,0,30,30
1650729458994,MATH 20E,B02,083774,Staff,6,0,30,24
1650729465018,MATH 103A,A01,083777,Staff,0,15,30,30
1650729465018,MATH 103A,A02,083778,Staff,0,15,30,30
1650729465018,MATH 103A,B01,083779,Staff,0,15,30,30
1650729465018,MATH 103A,B02,083780,Staff,0,15,30,30
1650729471044,MATH 105,A01,085443,Staff,0,22,30,30
1650729477072,MATH 109,A01,083213,Anzaldo; Leesa B,0,7,30,30
1650729477072,MATH 109,A02,083214,Anzaldo; Leesa B,0,7,30,30
1650729477072,MATH 109,B01,083215,Anzaldo; Leesa B,0,8,30,30
1650729477072,MATH 109,B02,083216,Anzaldo; Leesa B,0,6,30,30
1650729483101,MATH 142A,A01,083219,Chow; Bennett,0,16,30,30
1650729483101,MATH 142A,A02,083220,Chow; Bennett,0,15,30,30
1650729483101,MATH 142A,B01,083221,Chow; Bennett,0,15,30,30
1650729483101,MATH 142A,B02,083222,Chow; Bennett,0,14,30,30
1650729489130,MATH 193A,A01,083224,Staff,0,5,30,30
1650729489130,MATH 193A,A02,083225,Staff,0,6,30,30
1650729489130,MATH 193A,A03,083781,Staff,0,6,30,30
1650729489130,MATH 193A,A04,083782,Staff,0,7,30,30
1650729495159,MATH 197,001,091859,McAuley; Julian John,9998,0,9999,1
1650729501209,COGS 9,A01,083615,Staff,1,15,60,59
1650729507234,COGS 11,A01,083617,Boyle; Mary E. T.,16,0,40,24
1650729513258,COGS 13,A01,083071,Staff,0,38,40,40
1650729519284,COGS 14A,A01,092681,Staff,0,35,100,100
1650729525309,COGS 14B,A01,083073,Cheng; Tzu-Han,1,13,50,49
1650729531333,COGS 17,A01,092677,Staff,13,0,75,62
1650729537356,COGS 100,A01,083619,Staff,0,28,60,60
1650729543380,COGS 101A,A01,083621,Davis; Joshua Daniel,0,27,60,60
1650729549401,COGS 101B,A01,091572,Staff,0,4,60,60
1650729555429,COGS 101C,A01,083625,Delgado; Tania,14,0,30,16
1650729561453,COGS 107A,A01,083627,Boyle; Mary E. T.,0,16,60,60
1650729567475,COGS 118A,A01,083075,Staff,0,8,60,60
1650729573502,CSE 3,A50,083646,Miranda; Gregory Joseph,18,0,38,20
1650729573502,CSE 3,A51,083647,Miranda; Gregory Joseph,36,0,37,1
1650729579529,CSE 8A,A50,083650,Miranda; Gregory Joseph,0,30,40,40
1650729585564,CSE 11,A01,083080,Cao; Yingjun,0,96,40,40
1650729591590,CSE 12,A01,083652,Staff,0,21,100,100
1650729597613,CSE 15L,A01,083654,Staff,0,3,50,50
1650729597613,CSE 15L,A02,083655,Staff,0,2,50,50
1650729603639,CSE 20,A01,083657,Staff,49,0,80,31
1650729609666,CSE 30,A01,083084,Eldon; John,0,77,40,40
1650729615689,CSE 100,A01,083659,Cao; Yingjun,0,70,50,50
1650729621716,CSE 134B,A01,083661,Powell; Thomas Allan,0,38,65,65
1650729627742,CSE 140,A01,083663,Staff,0,11,75,75
1650729633779,CSE 140L,A01,083088,Eldon; John,0,20,75,75
1650729639801,CSE 175,A01,083665,Kumar; Rakesh,7,0,25,18
1650729645830,CSE 190,A00,092507,Dubnov; Shlomo,10,0,20,10
1650729651853,ECE 45,A01,083139,Staff,1,2,60,59
1650729657878,ECE 65,A50,083695,Staff,0,5,30,30
1650729663903,ECE 109,A01,091882,Touri; Behrouz,33,0,70,37
1650729669927,ECE 180,A00,083140,Abi Samra; Nicholas Camill,20,0,30,10
1650729669927,ECE 180,B00,083141,Abi Samra; Nicholas Camill,0,0,30,30
1650729675953,MATH 10A,A01,083735,Patchell; Gregory David,2,0,30,28
1650729675953,MATH 10A,A02,083736,Patchell; Gregory David,27,0,30,3
1650729675953,MATH 10A,A03,083737,Patchell; Gregory David,24,0,30,6
1650729681993,MATH 10B,A01,083207,Staff,0,9,30,30
1650729681993,MATH 10B,A02,083208,Staff,1,7,30,29
1650729681993,MATH 10B,B01,083739,Staff,11,0,30,19
1650729681993,MATH 10B,B02,083740,Staff,28,0,30,2
1650729688025,MATH 18,A01,083743,Staff,0,0,30,30
1650729688025,MATH 18,A02,083744,Staff,23,0,30,7
1650729688025,MATH 18,A03,083745,Staff,21,0,30,9
1650729688025,MATH 18,A04,083746,Staff,26,0,30,4
1650729688025,MATH 18,B01,083748,Staff,0,15,30,30
1650729688025,MATH 18,B02,083749,Staff,0,12,30,30
1650729688025,MATH 18,B03,083750,Staff,0,12,30,30
1650729688025,MATH 18,B04,083751,Staff,0,12,30,30
1650729694065,MATH 20A,A01,083754,Staff,19,0,40,21
1650729700114,MATH 20B,A01,083756,Staff,0,11,30,30
1650729700114,MATH 20B,A02,083757,Staff,0,12,30,30
1650729706143,MATH 20C,A01,083760,Staff,0,16,30,30
1650729706143,MATH 20C,A02,083761,Staff,0,16,30,30
1650729706143,MATH 20C,B01,083762,Staff,10,0,30,20
1650729706143,MATH 20C,B02,083763,Staff,28,0,30,2
1650729712173,MATH 20D,A01,083765,Staff,2,1,30,28
1650729712173,MATH 20D,A02,083766,Staff,6,0,30,24
1650729712173,MATH 20D,A03,083767,Staff,24,0,30,6
1650729718198,MATH 20E,A01,083771,Staff,3,0,30,27
1650729718198,MATH 20E,A02,083772,Staff,16,0,30,14
1650729718198,MATH 20E,B01,083773,Staff,0,0,30,30
1650729718198,MATH 20E,B02,083774,Staff,6,0,30,24
1650729724222,MATH 103A,A01,083777,Staff,0,15,30,30
1650729724222,MATH 103A,A02,083778,Staff,0,15,30,30
1650729724222,MATH 103A,B01,083779,Staff,0,15,30,30
1650729724222,MATH 103A,B02,083780,Staff,0,15,30,30
1650729730246,MATH 105,A01,085443,Staff,0,22,30,30
1650729736282,MATH 109,A01,083213,Anzaldo; Leesa B,0,7,30,30
1650729736282,MATH 109,A02,083214,Anzaldo; Leesa B,0,7,30,30
1650729736282,MATH 109,B01,083215,Anzaldo; Leesa B,0,8,30,30
1650729736282,MATH 109,B02,083216,Anzaldo; Leesa B,0,6,30,30
1650729742308,MATH 142A,A01,083219,Chow; Bennett,0,16,30,30
1650729742308,MATH 142A,A02,083220,Chow; Bennett,0,15,30,30
1650729742308,MATH 142A,B01,083221,Chow; Bennett,0,15,30,30
1650729742308,MATH 142A,B02,083222,Chow; Bennett,0,14,30,30
1650729748333,MATH 193A,A01,083224,Staff,0,5,30,30
1650729748333,MATH 193A,A02,083225,Staff,0,6,30,30
1650729748333,MATH 193A,A03,083781,Staff,0,6,30,30
1650729748333,MATH 193A,A04,083782,Staff,0,7,30,30
1650729754362,MATH 197,001,091859,McAuley; Julian John,9998,0,9999,1
1650729760442,COGS 9,A01,083615,Staff,1,15,60,59
1650729766466,COGS 11,A01,083617,Boyle; Mary E. T.,16,0,40,24
1650729772490,COGS 13,A01,083071,Staff,0,38,40,40
1650729778516,COGS 14A,A01,092681,Staff,0,35,100,100
1650729784544,COGS 14B,A01,083073,Cheng; Tzu-Han,1,13,50,49
1650729790579,COGS 17,A01,092677,Staff,13,0,75,62
1650729796604,COGS 100,A01,083619,Staff,0,28,60,60
1650729802642,COGS 101A,A01,083621,Davis; Joshua Daniel,0,27,60,60
1650729808673,COGS 101B,A01,091572,Staff,0,4,60,60
1650729814696,COGS 101C,A01,083625,Delgado; Tania,14,0,30,16
1650729820724,COGS 107A,A01,083627,Boyle; Mary E. T.,0,16,60,60
1650729826751,COGS 118A,A01,083075,Staff,0,8,60,60
1650729832784,CSE 3,A50,083646,Miranda; Gregory Joseph,18,0,38,20
1650729832784,CSE 3,A51,083647,Miranda; Gregory Joseph,36,0,37,1
1650729838809,CSE 8A,A50,083650,Miranda; Gregory Joseph,0,30,40,40
1650729844850,CSE 11,A01,083080,Cao; Yingjun,0,96,40,40
1650729850885,CSE 12,A01,083652,Staff,0,21,100,100
1650729856910,CSE 15L,A01,083654,Staff,0,3,50,50
1650729856910,CSE 15L,A02,083655,Staff,0,2,50,50
1650729862938,CSE 20,A01,083657,Staff,49,0,80,31
1650729868965,CSE 30,A01,083084,Eldon; John,0,77,40,40
1650729874990,CSE 100,A01,083659,Cao; Yingjun,0,70,50,50
1650729881033,CSE 134B,A01,083661,Powell; Thomas Allan,0,38,65,65
1650729887144,CSE 140,A01,083663,Staff,0,11,75,75
1650729893169,CSE 140L,A01,083088,Eldon; John,0,20,75,75
1650729899192,CSE 175,A01,083665,Kumar; Rakesh,7,0,25,18
1650729905225,CSE 190,A00,092507,Dubnov; Shlomo,10,0,20,10
1650729911250,ECE 45,A01,083139,Staff,1,2,60,59
1650729917275,ECE 65,A50,083695,Staff,0,5,30,30
1650729923297,ECE 109,A01,091882,Touri; Behrouz,33,0,70,37
1650729929339,ECE 180,A00,083140,Abi Samra; Nicholas Camill,20,0,30,10
1650729929339,ECE 180,B00,083141,Abi Samra; Nicholas Camill,0,0,30,30
1650729935365,MATH 10A,A01,083735,Patchell; Gregory David,2,0,30,28
1650729935365,MATH 10A,A02,083736,Patchell; Gregory David,27,0,30,3
1650729935365,MATH 10A,A03,083737,Patchell; Gregory David,24,0,30,6
1650729941401,MATH 10B,A01,083207,Staff,0,9,30,30
1650729941401,MATH 10B,A02,083208,Staff,1,7,30,29
1650729941401,MATH 10B,B01,083739,Staff,11,0,30,19
1650729941401,MATH 10B,B02,083740,Staff,28,0,30,2
1650729947428,MATH 18,A01,083743,Staff,0,0,30,30
1650729947428,MATH 18,A02,083744,Staff,23,0,30,7
1650729947428,MATH 18,A03,083745,Staff,21,0,30,9
1650729947428,MATH 18,A04,083746,Staff,26,0,30,4
1650729947428,MATH 18,B01,083748,Staff,0,15,30,30
1650729947428,MATH 18,B02,083749,Staff,0,12,30,30
1650729947428,MATH 18,B03,083750,Staff,0,12,30,30
1650729947428,MATH 18,B04,083751,Staff,0,12,30,30
1650729953453,MATH 20A,A01,083754,Staff,19,0,40,21
1650729959486,MATH 20B,A01,083756,Staff,0,11,30,30
1650729959486,MATH 20B,A02,083757,Staff,0,12,30,30
1650729965535,MATH 20C,A01,083760,Staff,0,16,30,30
1650729965535,MATH 20C,A02,083761,Staff,0,16,30,30
1650729965535,MATH 20C,B01,083762,Staff,10,0,30,20
1650729965535,MATH 20C,B02,083763,Staff,28,0,30,2
1650729971586,MATH 20D,A01,083765,Staff,2,1,30,28
1650729971586,MATH 20D,A02,083766,Staff,6,0,30,24
1650729971586,MATH 20D,A03,083767,Staff,24,0,30,6
1650729977614,MATH 20E,A01,083771,Staff,3,0,30,27
1650729977614,MATH 20E,A02,083772,Staff,16,0,30,14
1650729977614,MATH 20E,B01,083773,Staff,0,0,30,30
1650729977614,MATH 20E,B02,083774,Staff,6,0,30,24
1650729983648,MATH 103A,A01,083777,Staff,0,15,30,30
1650729983648,MATH 103A,A02,083778,Staff,0,15,30,30
1650729983648,MATH 103A,B01,083779,Staff,0,15,30,30
1650729983648,MATH 103A,B02,083780,Staff,0,15,30,30
1650729989686,MATH 105,A01,085443,Staff,0,22,30,30
1650729995724,MATH 109,A01,083213,Anzaldo; Leesa B,0,7,30,30
1650729995724,MATH 109,A02,083214,Anzaldo; Leesa B,0,7,30,30
1650729995724,MATH 109,B01,083215,Anzaldo; Leesa B,0,8,30,30
1650729995724,MATH 109,B02,083216,Anzaldo; Leesa B,0,6,30,30
1650730001749,MATH 142A,A01,083219,Chow; Bennett,0,16,30,30
1650730001749,MATH 142A,A02,083220,Chow; Bennett,0,15,30,30
1650730001749,MATH 142A,B01,083221,Chow; Bennett,0,15,30,30
1650730001749,MATH 142A,B02,083222,Chow; Bennett,0,14,30,30
1650730007774,MATH 193A,A01,083224,Staff,0,5,30,30
1650730007774,MATH 193A,A02,083225,Staff,0,6,30,30
1650730007774,MATH 193A,A03,083781,Staff,0,6,30,30
1650730007774,MATH 193A,A04,083782,Staff,0,7,30,30
1650730013798,MATH 197,001,091859,McAuley; Julian John,9998,0,9999,1
1650730019849,COGS 9,A01,083615,Staff,1,15,60,59
1650730025883,COGS 11,A01,083617,Boyle; Mary E. T.,16,0,40,24
1650730031908,COGS 13,A01,083071,Staff,0,38,40,40
1650730037937,COGS 14A,A01,092681,Staff,0,35,100,100
1650730043965,COGS 14B,A01,083073,Cheng; Tzu-Han,1,13,50,49
1650730049992,COGS 17,A01,092677,Staff,13,0,75,62
1650730056018,COGS 100,A01,083619,Staff,0,28,60,60
1650730062054,COGS 101A,A01,083621,Davis; Joshua Daniel,0,27,60,60
1650730068078,COGS 101B,A01,091572,Staff,0,4,60,60
1650730074125,COGS 101C,A01,083625,Delgado; Tania,14,0,30,16
1650730080151,COGS 107A,A01,083627,Boyle; Mary E. T.,0,16,60,60
1650730086176,COGS 118A,A01,083075,Staff,0,8,60,60
1650730092206,CSE 3,A50,083646,Miranda; Gregory Joseph,18,0,38,20
1650730092206,CSE 3,A51,083647,Miranda; Gregory Joseph,36,0,37,1
1650730098230,CSE 8A,A50,083650,Miranda; Gregory Joseph,0,30,40,40
1650730104255,CSE 11,A01,083080,Cao; Yingjun,0,96,40,40
1650730110282,CSE 12,A01,083652,Staff,0,21,100,100
1650730116305,CSE 15L,A01,083654,Staff,0,3,50,50
1650730116305,CSE 15L,A02,083655,Staff,0,2,50,50
1650730122330,CSE 20,A01,083657,Staff,49,0,80,31
1650730128358,CSE 30,A01,083084,Eldon; John,0,77,40,40
1650730134386,CSE 100,A01,083659,Cao; Yingjun,0,70,50,50
1650730140411,CSE 134B,A01,083661,Powell; Thomas Allan,0,38,65,65
1650730146435,CSE 140,A01,083663,Staff,0,11,75,75
1650730152460,CSE 140L,A01,083088,Eldon; John,0,20,75,75
1650730158492,CSE 175,A01,083665,Kumar; Rakesh,7,0,25,18
1650730164524,CSE 190,A00,092507,Dubnov; Shlomo,10,0,20,10
1650730170551,ECE 45,A01,083139,Staff,1,2,60,59
1650730176574,ECE 65,A50,083695,Staff,0,5,30,30
1650730182600,ECE 109,A01,091882,Touri; Behrouz,33,0,70,37
1650730188623,ECE 180,A00,083140,Abi Samra; Nicholas Camill,20,0,30,10
1650730188623,ECE 180,B00,083141,Abi Samra; Nicholas Camill,0,0,30,30
1650730194647,MATH 10A,A01,083735,Patchell; Gregory David,2,0,30,28
1650730194647,MATH 10A,A02,083736,Patchell; Gregory David,27,0,30,3
1650730194647,MATH 10A,A03,083737,Patchell; Gregory David,24,0,30,6
1650730200672,MATH 10B,A01,083207,Staff,0,9,30,30
1650730200672,MATH 10B,A02,083208,Staff,1,7,30,29
1650730200672,MATH 10B,B01,083739,Staff,11,0,30,19
1650730200672,MATH 10B,B02,083740,Staff,28,0,30,2
1650730206696,MATH 18,A01,083743,Staff,0,0,30,30
1650730206696,MATH 18,A02,083744,Staff,23,0,30,7
1650730206696,MATH 18,A03,083745,Staff,21,0,30,9
1650730206696,MATH 18,A04,083746,Staff,26,0,30,4
1650730206696,MATH 18,B01,083748,Staff,0,15,30,30
1650730206696,MATH 18,B02,083749,Staff,0,12,30,30
1650730206696,MATH 18,B03,083750,Staff,0,12,30,30
1650730206696,MATH 18,B04,083751,Staff,0,12,30,30
1650730212726,MATH 20A,A01,083754,Staff,19,0,40,21
1650730218764,MATH 20B,A01,083756,Staff,0,11,30,30
1650730218764,MATH 20B,A02,083757,Staff,0,12,30,30
1650730224786,MATH 20C,A01,083760,Staff,0,16,30,30
1650730224786,MATH 20C,A02,083761,Staff,0,16,30,30
1650730224786,MATH 20C,B01,083762,Staff,10,0,30,20
1650730224786,MATH 20C,B02,083763,Staff,28,0,30,2
1650730230817,MATH 20D,A01,083765,Staff,2,1,30,28
1650730230817,MATH 20D,A02,083766,Staff,6,0,30,24
1650730230817,MATH 20D,A03,083767,Staff,24,0,30,6
1650730236847,MATH 20E,A01,083771,Staff,3,0,30,27
1650730236847,MATH 20E,A02,083772,Staff,16,0,30,14
1650730236847,MATH 20E,B01,083773,Staff,0,0,30,30
1650730236847,MATH 20E,B02,083774,Staff,6,0,30,24
1650730242876,MATH 103A,A01,083777,Staff,0,15,30,30
1650730242876,MATH 103A,A02,083778,Staff,0,15,30,30
1650730242876,MATH 103A,B01,083779,Staff,0,15,30,30
1650730242876,MATH 103A,B02,083780,Staff,0,15,30,30
1650730248901,MATH 105,A01,085443,Staff,0,22,30,30
1650730254927,MATH 109,A01,083213,Anzaldo; Leesa B,0,7,30,30
1650730254927,MATH 109,A02,083214,Anzaldo; Leesa B,0,7,30,30
1650730254927,MATH 109,B01,083215,Anzaldo; Leesa B,0,8,30,30
1650730254927,MATH 109,B02,083216,Anzaldo; Leesa B,0,6,30,30
1650730260952,MATH 142A,A01,083219,Chow; Bennett,0,16,30,30
1650730260952,MATH 142A,A02,083220,Chow; Bennett,0,15,30,30
1650730260952,MATH 142A,B01,083221,Chow; Bennett,0,15,30,30
1650730260952,MATH 142A,B02,083222,Chow; Bennett,0,14,30,30
1650730266980,MATH 193A,A01,083224,Staff,0,5,30,30
1650730266980,MATH 193A,A02,083225,Staff,0,6,30,30
1650730266980,MATH 193A,A03,083781,Staff,0,6,30,30
1650730266980,MATH 193A,A04,083782,Staff,0,7,30,30
1650730273022,MATH 197,001,091859,McAuley; Julian John,9998,0,9999,1
1650730279082,COGS 9,A01,083615,Staff,1,15,60,59
1650730285107,COGS 11,A01,083617,Boyle; Mary E. T.,16,0,40,24
1650730291136,COGS 13,A01,083071,Staff,0,38,40,40
1650730297167,COGS 14A,A01,092681,Staff,0,35,100,100
1650730303204,COGS 14B,A01,083073,Cheng; Tzu-Han,1,13,50,49
1650730309228,COGS 17,A01,092677,Staff,13,0,75,62
1650730315255,COGS 100,A01,083619,Staff,0,28,60,60
1650730321280,COGS 101A,A01,083621,Davis; Joshua Daniel,0,27,60,60
1650730327304,COGS 101B,A01,091572,Staff,0,4,60,60
1650730333330,COGS 101C,A01,083625,Delgado; Tania,14,0,30,16
1650730339357,COGS 107A,A01,083627,Boyle; Mary E. T.,0,16,60,60
1650730345381,COGS 118A,A01,083075,Staff,0,8,60,60
1650730351419,CSE 3,A50,083646,Miranda; Gregory Joseph,18,0,38,20
1650730351419,CSE 3,A51,083647,Miranda; Gregory Joseph,36,0,37,1
1650730357444,CSE 8A,A50,083650,Miranda; Gregory Joseph,0,30,40,40
1650730363468,CSE 11,A01,083080,Cao; Yingjun,0,96,40,40
1650730369492,CSE 12,A01,083652,Staff,0,21,100,100
1650730375517,CSE 15L,A01,083654,Staff,0,3,50,50
1650730375517,CSE 15L,A02,083655,Staff,0,2,50,50
1650730381545,CSE 20,A01,083657,Staff,49,0,80,31
1650730387576,CSE 30,A01,083084,Eldon; John,0,77,40,40
1650730393599,CSE 100,A01,083659,Cao; Yingjun,0,70,50,50
1650730399624,CSE 134B,A01,083661,Powell; Thomas Allan,0,38,65,65
1650730405652,CSE 140,A01,083663,Staff,0,11,75,75
1650730411688,CSE 140L,A01,083088,Eldon; John,0,20,75,75
1650730417712,CSE 175,A01,083665,Kumar; Rakesh,7,0,25,18
1650730423738,CSE 190,A00,092507,Dubnov; Shlomo,10,0,20,10
1650730429762,ECE 45,A01,083139,Staff,1,2,60,59
1650730435787,ECE 65,A50,083695,Staff,0,5,30,30
1650730441810,ECE 109,A01,091882,Touri; Behrouz,33,0,70,37
1650730447834,ECE 180,A00,083140,Abi Samra; Nicholas Camill,20,0,30,10
1650730447834,ECE 180,B00,083141,Abi Samra; Nicholas Camill,0,0,30,30
1650730453862,MATH 10A,A01,083735,Patchell; Gregory David,2,0,30,28
1650730453862,MATH 10A,A02,083736,Patchell; Gregory David,27,0,30,3
1650730453862,MATH 10A,A03,083737,Patchell; Gregory David,24,0,30,6
1650730459888,MATH 10B,A01,083207,Staff,0,9,30,30
1650730459888,MATH 10B,A02,083208,Staff,1,7,30,29
1650730459888,MATH 10B,B01,083739,Staff,11,0,30,19
1650730459888,MATH 10B,B02,083740,Staff,28,0,30,2
1650730465920,MATH 18,A01,083743,Staff,0,0,30,30
1650730465920,MATH 18,A02,083744,Staff,23,0,30,7
1650730465920,MATH 18,A03,083745,Staff,21,0,30,9
1650730465920,MATH 18,A04,083746,Staff,26,0,30,4
1650730465920,MATH 18,B01,083748,Staff,0,15,30,30
1650730465920,MATH 18,B02,083749,Staff,0,12,30,30
1650730465920,MATH 18,B03,083750,Staff,0,12,30,30
1650730465920,MATH 18,B04,083751,Staff,0,12,30,30
1650730471948,MATH 20A,A01,083754,Staff,19,0,40,21
1650730477973,MATH 20B,A01,083756,Staff,0,11,30,30
1650730477973,MATH 20B,A02,083757,Staff,0,12,30,30
1650730484088,MATH 20C,A01,083760,Staff,0,16,30,30
1650730484088,MATH 20C,A02,083761,Staff,0,16,30,30
1650730484088,MATH 20C,B01,083762,Staff,10,0,30,20
1650730484088,MATH 20C,B02,083763,Staff,28,0,30,2
1650730490112,MATH 20D,A01,083765,Staff,2,1,30,28
1650730490112,MATH 20D,A02,083766,Staff,6,0,30,24
1650730490112,MATH 20D,A03,083767,Staff,24,0,30,6
1650730496141,MATH 20E,A01,083771,Staff,3,0,30,27
1650730496141,MATH 20E,A02,083772,Staff,16,0,30,14
1650730496141,MATH 20E,B01,083773,Staff,0,0,30,30
1650730496141,MATH 20E,B02,083774,Staff,6,0,30,24
1650730502179,MATH 103A,A01,083777,Staff,0,15,30,30
1650730502179,MATH 103A,A02,083778,Staff,0,15,30,30
1650730502179,MATH 103A,B01,083779,Staff,0,15,30,30
1650730502179,MATH 103A,B02,083780,Staff,0,15,30,30
1650730508204,MATH 105,A01,085443,Staff,0,22,30,30
1650730514229,MATH 109,A01,083213,Anzaldo; Leesa B,0,7,30,30
1650730514229,MATH 109,A02,083214,Anzaldo; Leesa B,0,7,30,30
1650730514229,MATH 109,B01,083215,Anzaldo; Leesa B,0,8,30,30
1650730514229,MATH 109,B02,083216,Anzaldo; Leesa B,0,6,30,30
1650730520263,MATH 142A,A01,083219,Chow; Bennett,0,16,30,30
1650730520263,MATH 142A,A02,083220,Chow; Bennett,0,15,30,30
1650730520263,MATH 142A,B01,083221,Chow; Bennett,0,15,30,30
1650730520263,MATH 142A,B02,083222,Chow; Bennett,0,14,30,30
1650730526291,MATH 193A,A01,083224,Staff,0,5,30,30
1650730526291,MATH 193A,A02,083225,Staff,0,6,30,30
1650730526291,MATH 193A,A03,083781,Staff,0,6,30,30
1650730526291,MATH 193A,A04,083782,Staff,0,7,30,30
1650730532320,MATH 197,001,091859,McAuley; Julian John,9998,0,9999,1
1650730538379,COGS 9,A01,083615,Staff,1,15,60,59
1650730544414,COGS 11,A01,083617,Boyle; Mary E. T.,16,0,40,24
1650730550443,COGS 13,A01,083071,Staff,0,38,40,40
1650730556466,COGS 14A,A01,092681,Staff,0,35,100,100
1650730562490,COGS 14B,A01,083073,Cheng; Tzu-Han,1,13,50,49
1650730568514,COGS 17,A01,092677,Staff,13,0,75,62
1650730574537,COGS 100,A01,083619,Staff,0,28,60,60
1650730580562,COGS 101A,A01,083621,Davis; Joshua Daniel,0,27,60,60
1650730586586,COGS 101B,A01,091572,Staff,0,4,60,60
1650730592612,COGS 101C,A01,083625,Delgado; Tania,14,0,30,16
1650730598644,COGS 107A,A01,083627,Boyle; Mary E. T.,0,16,60,60
1650730604668,COGS 118A,A01,083075,Staff,0,8,60,60
1650730610692,CSE 3,A50,083646,Miranda; Gregory Joseph,18,0,38,20
1650730610692,CSE 3,A51,083647,Miranda; Gregory Joseph,36,0,37,1
1650730616717,CSE 8A,A50,083650,Miranda; Gregory Joseph,0,30,40,40
1650730622742,CSE 11,A01,083080,Cao; Yingjun,0,96,40,40
1650730628767,CSE 12,A01,083652,Staff,0,21,100,100
1650730634792,CSE 15L,A01,083654,Staff,0,3,50,50
1650730634792,CSE 15L,A02,083655,Staff,0,2,50,50
1650730640824,CSE 20,A01,083657,Staff,49,0,80,31
1650730646852,CSE 30,A01,083084,Eldon; John,0,77,40,40
1650730652876,CSE 100,A01,083659,Cao; Yingjun,0,70,50,50
1650730658901,CSE 134B,A01,083661,Powell; Thomas Allan,0,38,65,65
1650730664925,CSE 140,A01,083663,Staff,0,11,75,75
1650730670951,CSE 140L,A01,083088,Eldon; John,0,20,75,75
1650730676979,CSE 175,A01,083665,Kumar; Rakesh,7,0,25,18
1650730683004,CSE 190,A00,092507,Dubnov; Shlomo,10,0,20,10
1650730689028,ECE 45,A01,083139,Staff,1,2,60,59
1650730695051,ECE 65,A50,083695,Staff,0,5,30,30
1650730701080,ECE 109,A01,091882,Touri; Behrouz,33,0,70,37
1650730707109,ECE 180,A00,083140,Abi Samra; Nicholas Camill,20,0,30,10
1650730707109,ECE 180,B00,083141,Abi Samra; Nicholas Camill,0,0,30,30
1650730713137,MATH 10A,A01,083735,Patchell; Gregory David,2,0,30,28
1650730713137,MATH 10A,A02,083736,Patchell; Gregory David,27,0,30,3
1650730713137,MATH 10A,A03,083737,Patchell; Gregory David,24,0,30,6
1650730719161,MATH 10B,A01,083207,Staff,0,9,30,30
1650730719161,MATH 10B,A02,083208,Staff,1,7,30,29
1650730719161,MATH 10B,B01,083739,Staff,11,0,30,19
1650730719161,MATH 10B,B02,083740,Staff,28,0,30,2
1650730725195,MATH 18,A01,083743,Staff,0,0,30,30
1650730725195,MATH 18,A02,083744,Staff,23,0,30,7
1650730725195,MATH 18,A03,083745,Staff,21,0,30,9
1650730725195,MATH 18,A04,083746,Staff,26,0,30,4
1650730725195,MATH 18,B01,083748,Staff,0,15,30,30
1650730725195,MATH 18,B02,083749,Staff,0,12,30,30
1650730725195,MATH 18,B03,083750,Staff,0,12,30,30
1650730725195,MATH 18,B04,083751,Staff,0,12,30,30
1650730731226,MATH 20A,A01,083754,Staff,19,0,40,21
1650730737253,MATH 20B,A01,083756,Staff,0,11,30,30
1650730737253,MATH 20B,A02,083757,Staff,0,12,30,30
1650730743296,MATH 20C,A01,083760,Staff,0,16,30,30
1650730743296,MATH 20C,A02,083761,Staff,0,16,30,30
1650730743296,MATH 20C,B01,083762,Staff,10,0,30,20
1650730743296,MATH 20C,B02,083763,Staff,28,0,30,2
1650730749320,MATH 20D,A01,083765,Staff,2,1,30,28
1650730749320,MATH 20D,A02,083766,Staff,6,0,30,24
1650730749320,MATH 20D,A03,083767,Staff,24,0,30,6
1650730755344,MATH 20E,A01,083771,Staff,3,0,30,27
1650730755344,MATH 20E,A02,083772,Staff,16,0,30,14
1650730755344,MATH 20E,B01,083773,Staff,0,0,30,30
1650730755344,MATH 20E,B02,083774,Staff,6,0,30,24
1650730761372,MATH 103A,A01,083777,Staff,0,15,30,30
1650730761372,MATH 103A,A02,083778,Staff,0,15,30,30
1650730761372,MATH 103A,B01,083779,Staff,0,15,30,30
1650730761372,MATH 103A,B02,083780,Staff,0,15,30,30
1650730767399,MATH 105,A01,085443,Staff,0,22,30,30
1650730773424,MATH 109,A01,083213,Anzaldo; Leesa B,0,7,30,30
1650730773424,MATH 109,A02,083214,Anzaldo; Leesa B,0,7,30,30
1650730773424,MATH 109,B01,083215,Anzaldo; Leesa B,0,8,30,30
1650730773424,MATH 109,B02,083216,Anzaldo; Leesa B,0,6,30,30
1650730779451,MATH 142A,A01,083219,Chow; Bennett,0,16,30,30
1650730779451,MATH 142A,A02,083220,Chow; Bennett,0,15,30,30
1650730779451,MATH 142A,B01,083221,Chow; Bennett,0,15,30,30
1650730779451,MATH 142A,B02,083222,Chow; Bennett,0,14,30,30
1650730785476,MATH 193A,A01,083224,Staff,0,5,30,30
1650730785476,MATH 193A,A02,083225,Staff,0,6,30,30
1650730785476,MATH 193A,A03,083781,Staff,0,6,30,30
1650730785476,MATH 193A,A04,083782,Staff,0,7,30,30
1650730791500,MATH 197,001,091859,McAuley; Julian John,9998,0,9999,1
1650730797564,COGS 9,A01,083615,Staff,1,15,60,59
1650730803586,COGS 11,A01,083617,Boyle; Mary E. T.,16,0,40,24
1650730809609,COGS 13,A01,083071,Staff,0,38,40,40
1650730815639,COGS 14A,A01,092681,Staff,0,35,100,100
1650730821667,COGS 14B,A01,083073,Cheng; Tzu-Han,1,13,50,49
1650730827691,COGS 17,A01,092677,Staff,13,0,75,62
1650730833715,COGS 100,A01,083619,Staff,0,28,60,60
1650730839743,COGS 101A,A01,083621,Davis; Joshua Daniel,0,27,60,60
1650730845767,COGS 101B,A01,091572,Staff,0,4,60,60
1650730851791,COGS 101C,A01,083625,Delgado; Tania,14,0,30,16
1650730857824,COGS 107A,A01,083627,Boyle; Mary E. T.,0,16,60,60
1650730863853,COGS 118A,A01,083075,Staff,0,8,60,60
1650730869887,CSE 3,A50,083646,Miranda; Gregory Joseph,18,0,38,20
1650730869887,CSE 3,A51,083647,Miranda; Gregory Joseph,36,0,37,1
1650730875915,CSE 8A,A50,083650,Miranda; Gregory Joseph,0,30,40,40
1650730881940,CSE 11,A01,083080,Cao; Yingjun,0,96,40,40
1650730887964,CSE 12,A01,083652,Staff,0,21,100,100
1650730893991,CSE 15L,A01,083654,Staff,0,3,50,50
1650730893991,CSE 15L,A02,083655,Staff,0,2,50,50
1650730900015,CSE 20,A01,083657,Staff,49,0,80,31
1650730906042,CSE 30,A01,083084,Eldon; John,0,77,40,40
1650730912067,CSE 100,A01,083659,Cao; Yingjun,0,70,50,50
1650730918092,CSE 134B,A01,083661,Powell; Thomas Allan,0,38,65,65
1650730924120,CSE 140,A01,083663,Staff,0,11,75,75
1650730930141,CSE 140L,A01,083088,Eldon; John,0,20,75,75
1650730936165,CSE 175,A01,083665,Kumar; Rakesh,7,0,25,18
1650730942189,CSE 190,A00,092507,Dubnov; Shlomo,10,0,20,10
1650730948216,ECE 45,A01,083139,Staff,1,2,60,59
1650730954241,ECE 65,A50,083695,Staff,0,5,30,30
1650730960268,ECE 109,A01,091882,Touri; Behrouz,33,0,70,37
1650730966292,ECE 180,A00,083140,Abi Samra; Nicholas Camill,20,0,30,10
1650730966292,ECE 180,B00,083141,Abi Samra; Nicholas Camill,0,0,30,30
1650730972322,MATH 10A,A01,083735,Patchell; Gregory David,2,0,30,28
1650730972322,MATH 10A,A02,083736,Patchell; Gregory David,27,0,30,3
1650730972322,MATH 10A,A03,083737,Patchell; Gregory David,24,0,30,6
1650730978350,MATH 10B,A01,083207,Staff,0,9,30,30
1650730978350,MATH 10B,A02,083208,Staff,1,7,30,29
1650730978350,MATH 10B,B01,083739,Staff,11,0,30,19
1650730978350,MATH 10B,B02,083740,Staff,28,0,30,2
1650730984381,MATH 18,A01,083743,Staff,0,0,30,30
1650730984381,MATH 18,A02,083744,Staff,23,0,30,7
1650730984381,MATH 18,A03,083745,Staff,21,0,30,9
1650730984381,MATH 18,A04,083746,Staff,26,0,30,4
1650730984381,MATH 18,B01,083748,Staff,0,15,30,30
1650730984381,MATH 18,B02,083749,Staff,0,12,30,30
1650730984381,MATH 18,B03,083750,Staff,0,12,30,30
1650730984381,MATH 18,B04,083751,Staff,0,12,30,30
1650730990407,MATH 20A,A01,083754,Staff,19,0,40,21
1650730996430,MATH 20B,A01,083756,Staff,0,11,30,30
1650730996430,MATH 20B,A02,083757,Staff,0,12,30,30
1650731002456,MATH 20C,A01,083760,Staff,0,16,30,30
1650731002456,MATH 20C,A02,083761,Staff,0,16,30,30
1650731002456,MATH 20C,B01,083762,Staff,10,0,30,20
1650731002456,MATH 20C,B02,083763,Staff,28,0,30,2
1650731008483,MATH 20D,A01,083765,Staff,2,1,30,28
1650731008483,MATH 20D,A02,083766,Staff,6,0,30,24
1650731008483,MATH 20D,A03,083767,Staff,24,0,30,6
1650731014509,MATH 20E,A01,083771,Staff,3,0,30,27
1650731014509,MATH 20E,A02,083772,Staff,16,0,30,14
1650731014509,MATH 20E,B01,083773,Staff,0,0,30,30
1650731014509,MATH 20E,B02,083774,Staff,6,0,30,24
1650731020537,MATH 103A,A01,083777,Staff,0,15,30,30
1650731020537,MATH 103A,A02,083778,Staff,0,15,30,30
1650731020537,MATH 103A,B01,083779,Staff,0,15,30,30
1650731020537,MATH 103A,B02,083780,Staff,0,15,30,30
1650731026560,MATH 105,A01,085443,Staff,0,22,30,30
1650731032593,MATH 109,A01,083213,Anzaldo; Leesa B,0,7,30,30
1650731032593,MATH 109,A02,083214,Anzaldo; Leesa B,0,7,30,30
1650731032593,MATH 109,B01,083215,Anzaldo; Leesa B,0,8,30,30
1650731032593,MATH 109,B02,083216,Anzaldo; Leesa B,0,6,30,30
1650731038622,MATH 142A,A01,083219,Chow; Bennett,0,16,30,30
1650731038622,MATH 142A,A02,083220,Chow; Bennett,0,15,30,30
1650731038622,MATH 142A,B01,083221,Chow; Bennett,0,15,30,30
1650731038622,MATH 142A,B02,083222,Chow; Bennett,0,14,30,30
1650731044649,MATH 193A,A01,083224,Staff,0,5,30,30
1650731044649,MATH 193A,A02,083225,Staff,0,6,30,30
1650731044649,MATH 193A,A03,083781,Staff,0,6,30,30
1650731044649,MATH 193A,A04,083782,Staff,0,7,30,30
1650731050676,MATH 197,001,091859,McAuley; Julian John,9998,0,9999,1
1650731056727,COGS 9,A01,083615,Staff,1,15,60,59
1650731062750,COGS 11,A01,083617,Boyle; Mary E. T.,16,0,40,24
1650731068784,COGS 13,A01,083071,Staff,0,38,40,40
1650731074898,COGS 14A,A01,092681,Staff,0,35,100,100
1650731080936,COGS 14B,A01,083073,Cheng; Tzu-Han,1,13,50,49
1650731086961,COGS 17,A01,092677,Staff,13,0,75,62
1650731092986,COGS 100,A01,083619,Staff,0,28,60,60
1650731099010,COGS 101A,A01,083621,Davis; Joshua Daniel,0,27,60,60
1650731105039,COGS 101B,A01,091572,Staff,0,4,60,60
1650731111067,COGS 101C,A01,083625,Delgado; Tania,14,0,30,16
1650731117095,COGS 107A,A01,083627,Boyle; Mary E. T.,0,16,60,60
1650731123133,COGS 118A,A01,083075,Staff,0,8,60,60
1650731129161,CSE 3,A50,083646,Miranda; Gregory Joseph,18,0,38,20
1650731129161,CSE 3,A51,083647,Miranda; Gregory Joseph,36,0,37,1
1650731135189,CSE 8A,A50,083650,Miranda; Gregory Joseph,0,30,40,40
1650731141219,CSE 11,A01,083080,Cao; Yingjun,0,96,40,40
1650731147245,CSE 12,A01,083652,Staff,0,21,100,100
1650731153269,CSE 15L,A01,083654,Staff,0,3,50,50
1650731153269,CSE 15L,A02,083655,Staff,0,2,50,50
1650731159294,CSE 20,A01,083657,Staff,49,0,80,31
1650731165323,CSE 30,A01,083084,Eldon; John,0,77,40,40
1650731171347,CSE 100,A01,083659,Cao; Yingjun,0,70,50,50
1650731177373,CSE 134B,A01,083661,Powell; Thomas Allan,0,38,65,65
1650731183400,CSE 140,A01,083663,Staff,0,11,75,75
1650731189425,CSE 140L,A01,083088,Eldon; John,0,20,75,75
1650731195462,CSE 175,A01,083665,Kumar; Rakesh,7,0,25,18
1650731201484,CSE 190,A00,092507,Dubnov; Shlomo,10,0,20,10
1650731207509,ECE 45,A01,083139,Staff,1,2,60,59
1650731213535,ECE 65,A50,083695,Staff,0,5,30,30
1650731219563,ECE 109,A01,091882,Touri; Behrouz,33,0,70,37
1650731225589,ECE 180,A00,083140,Abi Samra; Nicholas Camill,20,0,30,10
1650731225589,ECE 180,B00,083141,Abi Samra; Nicholas Camill,0,0,30,30
1650731231613,MATH 10A,A01,083735,Patchell; Gregory David,2,0,30,28
1650731231613,MATH 10A,A02,083736,Patchell; Gregory David,27,0,30,3
1650731231613,MATH 10A,A03,083737,Patchell; Gregory David,24,0,30,6
1650731237644,MATH 10B,A01,083207,Staff,0,9,30,30
1650731237644,MATH 10B,A02,083208,Staff,1,7,30,29
1650731237644,MATH 10B,B01,083739,Staff,11,0,30,19
1650731237644,MATH 10B,B02,083740,Staff,28,0,30,2
1650731243676,MATH 18,A01,083743,Staff,0,0,30,30
1650731243676,MATH 18,A02,083744,Staff,23,0,30,7
1650731243676,MATH 18,A03,083745,Staff,21,0,30,9
1650731243676,MATH 18,A04,083746,Staff,26,0,30,4
1650731243676,MATH 18,B01,083748,Staff,0,15,30,30
1650731243676,MATH 18,B02,083749,Staff,0,12,30,30
1650731243676,MATH 18,B03,083750,Staff,0,12,30,30
1650731243676,MATH 18,B04,083751,Staff,0,12,30,30
1650731249702,MATH 20A,A01,083754,Staff,19,0,40,21
1650731255730,MATH 20B,A01,083756,Staff,0,11,30,30
1650731255730,MATH 20B,A02,083757,Staff,0,12,30,30
1650731261757,MATH 20C,A01,083760,Staff,0,16,30,30
1650731261757,MATH 20C,A02,083761,Staff,0,16,30,30
1650731261757,MATH 20C,B01,083762,Staff,10,0,30,20
1650731261757,MATH 20C,B02,083763,Staff,28,0,30,2
1650731267784,MATH 20D,A01,083765,Staff,2,1,30,28
1650731267784,MATH 20D,A02,083766,Staff,6,0,30,24
1650731267784,MATH 20D,A03,083767,Staff,24,0,30,6
1650731273809,MATH 20E,A01,083771,Staff,3,0,30,27
1650731273809,MATH 20E,A02,083772,Staff,16,0,30,14
1650731273809,MATH 20E,B01,083773,Staff,0,0,30,30
1650731273809,MATH 20E,B02,083774,Staff,6,0,30,24
1650731279834,MATH 103A,A01,083777,Staff,0,15,30,30
1650731279834,MATH 103A,A02,083778,Staff,0,15,30,30
1650731279834,MATH 103A,B01,083779,Staff,0,15,30,30
1650731279834,MATH 103A,B02,083780,Staff,0,15,30,30
1650731285861,MATH 105,A01,085443,Staff,0,22,30,30
1650731291885,MATH 109,A01,083213,Anzaldo; Leesa B,0,7,30,30
1650731291885,MATH 109,A02,083214,Anzaldo; Leesa B,0,7,30,30
1650731291885,MATH 109,B01,083215,Anzaldo; Leesa B,0,8,30,30
1650731291885,MATH 109,B02,083216,Anzaldo; Leesa B,0,6,30,30
1650731297913,MATH 142A,A01,083219,Chow; Bennett,0,16,30,30
1650731297913,MATH 142A,A02,083220,Chow; Bennett,0,15,30,30
1650731297913,MATH 142A,B01,083221,Chow; Bennett,0,15,30,30
1650731297913,MATH 142A,B02,083222,Chow; Bennett,0,14,30,30
1650731303936,MATH 193A,A01,083224,Staff,0,5,30,30
1650731303936,MATH 193A,A02,083225,Staff,0,6,30,30
1650731303936,MATH 193A,A03,083781,Staff,0,6,30,30
1650731303936,MATH 193A,A04,083782,Staff,0,7,30,30
1650731309962,MATH 197,001,091859,McAuley; Julian John,9998,0,9999,1
1650731316014,COGS 9,A01,083615,Staff,1,15,60,59
1650731322041,COGS 11,A01,083617,Boyle; Mary E. T.,16,0,40,24
1650731328066,COGS 13,A01,083071,Staff,0,38,40,40
1650731334090,COGS 14A,A01,092681,Staff,0,35,100,100
1650731340118,COGS 14B,A01,083073,Cheng; Tzu-Han,1,13,50,49
1650731346143,COGS 17,A01,092677,Staff,13,0,75,62
1650731352170,COGS 100,A01,083619,Staff,0,28,60,60
1650731358194,COGS 101A,A01,083621,Davis; Joshua Daniel,0,27,60,60
1650731364220,COGS 101B,A01,091572,Staff,0,4,60,60
1650731370247,COGS 101C,A01,083625,Delgado; Tania,14,0,30,16
1650731376272,COGS 107A,A01,083627,Boyle; Mary E. T.,0,16,60,60
1650731382297,COGS 118A,A01,083075,Staff,0,8,60,60
1650731388322,CSE 3,A50,083646,Miranda; Gregory Joseph,18,0,38,20
1650731388322,CSE 3,A51,083647,Miranda; Gregory Joseph,36,0,37,1
1650731394359,CSE 8A,A50,083650,Miranda; Gregory Joseph,0,30,40,40
1650731400387,CSE 11,A01,083080,Cao; Yingjun,0,96,40,40
1650731406415,CSE 12,A01,083652,Staff,0,21,100,100
1650731412438,CSE 15L,A01,083654,Staff,0,3,50,50
1650731412438,CSE 15L,A02,083655,Staff,0,2,50,50
1650731418465,CSE 20,A01,083657,Staff,49,0,80,31
1650731424488,CSE 30,A01,083084,Eldon; John,0,77,40,40
1650731430514,CSE 100,A01,083659,Cao; Yingjun,0,70,50,50
1650731436544,CSE 134B,A01,083661,Powell; Thomas Allan,0,38,65,65
1650731442568,CSE 140,A01,083663,Staff,0,11,75,75
1650731448591,CSE 140L,A01,083088,Eldon; John,0,20,75,75
1650731454616,CSE 175,A01,083665,Kumar; Rakesh,7,0,25,18
1650731460643,CSE 190,A00,092507,Dubnov; Shlomo,10,0,20,10
1650731466666,ECE 45,A01,083139,Staff,1,2,60,59
1650731472689,ECE 65,A50,083695,Staff,0,5,30,30
1650731478725,ECE 109,A01,091882,Touri; Behrouz,33,0,70,37
1650731484754,ECE 180,A00,083140,Abi Samra; Nicholas Camill,20,0,30,10
1650731484754,ECE 180,B00,083141,Abi Samra; Nicholas Camill,0,0,30,30
1650731490781,MATH 10A,A01,083735,Patchell; Gregory David,2,0,30,28
1650731490781,MATH 10A,A02,083736,Patchell; Gregory David,27,0,30,3
1650731490781,MATH 10A,A03,083737,Patchell; Gregory David,24,0,30,6
1650731496802,MATH 10B,A01,083207,Staff,0,9,30,30
1650731496802,MATH 10B,A02,083208,Staff,1,7,30,29
1650731496802,MATH 10B,B01,083739,Staff,11,0,30,19
1650731496802,MATH 10B,B02,083740,Staff,28,0,30,2
1650731502828,MATH 18,A01,083743,Staff,0,0,30,30
1650731502828,MATH 18,A02,083744,Staff,23,0,30,7
1650731502828,MATH 18,A03,083745,Staff,21,0,30,9
1650731502828,MATH 18,A04,083746,Staff,26,0,30,4
1650731502828,MATH 18,B01,083748,Staff,0,15,30,30
1650731502828,MATH 18,B02,083749,Staff,0,12,30,30
1650731502828,MATH 18,B03,083750,Staff,0,12,30,30
1650731502828,MATH 18,B04,083751,Staff,0,12,30,30
1650731508853,MATH 20A,A01,083754,Staff,19,0,40,21
1650731514878,MATH 20B,A01,083756,Staff,0,11,30,30
1650731514878,MATH 20B,A02,083757,Staff,0,12,30,30
1650731520906,MATH 20C,A01,083760,Staff,0,16,30,30
1650731520906,MATH 20C,A02,083761,Staff,0,16,30,30
1650731520906,MATH 20C,B01,083762,Staff,10,0,30,20
1650731520906,MATH 20C,B02,083763,Staff,28,0,30,2
1650731526930,MATH 20D,A01,083765,Staff,2,1,30,28
1650731526930,MATH 20D,A02,083766,Staff,6,0,30,24
1650731526930,MATH 20D,A03,083767,Staff,24,0,30,6
1650731532958,MATH 20E,A01,083771,Staff,3,0,30,27
1650731532958,MATH 20E,A02,083772,Staff,16,0,30,14
1650731532958,MATH 20E,B01,083773,Staff,0,0,30,30
1650731532958,MATH 20E,B02,083774,Staff,6,0,30,24
1650731538983,MATH 103A,A01,083777,Staff,0,15,30,30
1650731538983,MATH 103A,A02,083778,Staff,0,15,30,30
1650731538983,MATH 103A,B01,083779,Staff,0,15,30,30
1650731538983,MATH 103A,B02,083780,Staff,0,15,30,30
1650731545029,MATH 105,A01,085443,Staff,0,22,30,30
1650731551058,MATH 109,A01,083213,Anzaldo; Leesa B,0,7,30,30
1650731551058,MATH 109,A02,083214,Anzaldo; Leesa B,0,7,30,30
1650731551058,MATH 109,B01,083215,Anzaldo; Leesa B,0,8,30,30
1650731551058,MATH 109,B02,083216,Anzaldo; Leesa B,0,6,30,30
1650731557083,MATH 142A,A01,083219,Chow; Bennett,0,16,30,30
1650731557083,MATH 142A,A02,083220,Chow; Bennett,0,15,30,30
1650731557083,MATH 142A,B01,083221,Chow; Bennett,0,15,30,30
1650731557083,MATH 142A,B02,083222,Chow; Bennett,0,14,30,30
1650731563108,MATH 193A,A01,083224,Staff,0,5,30,30
1650731563108,MATH 193A,A02,083225,Staff,0,6,30,30
1650731563108,MATH 193A,A03,083781,Staff,0,6,30,30
1650731563108,MATH 193A,A04,083782,Staff,0,7,30,30
1650731569139,MATH 197,001,091859,McAuley; Julian John,9998,0,9999,1
1650731575202,COGS 9,A01,083615,Staff,1,15,60,59
1650731581228,COGS 11,A01,083617,Boyle; Mary E. T.,16,0,40,24
1650731587255,COGS 13,A01,083071,Staff,0,38,40,40
1650731593277,COGS 14A,A01,092681,Staff,0,35,100,100
1650731599305,COGS 14B,A01,083073,Cheng; Tzu-Han,1,13,50,49
1650731605331,COGS 17,A01,092677,Staff,13,0,75,62
1650731611355,COGS 100,A01,083619,Staff,0,28,60,60
1650731617379,COGS 101A,A01,083621,Davis; Joshua Daniel,0,27,60,60
1650731623403,COGS 101B,A01,091572,Staff,0,4,60,60
1650731629433,COGS 101C,A01,083625,Delgado; Tania,14,0,30,16
1650731635458,COGS 107A,A01,083627,Boyle; Mary E. T.,0,16,60,60
1650731641482,COGS 118A,A01,083075,Staff,0,8,60,60
1650731647507,CSE 3,A50,083646,Miranda; Gregory Joseph,18,0,38,20
1650731647507,CSE 3,A51,083647,Miranda; Gregory Joseph,36,0,37,1
1650731653532,CSE 8A,A50,083650,Miranda; Gregory Joseph,0,30,40,40
1650731659557,CSE 11,A01,083080,Cao; Yingjun,0,96,40,40
1650731665598,CSE 12,A01,083652,Staff,0,21,100,100
1650731671695,CSE 15L,A01,083654,Staff,0,3,50,50
1650731671695,CSE 15L,A02,083655,Staff,0,2,50,50
1650731677720,CSE 20,A01,083657,Staff,49,0,80,31
1650731683757,CSE 30,A01,083084,Eldon; John,0,77,40,40
1650731689780,CSE 100,A01,083659,Cao; Yingjun,0,70,50,50
1650731695808,CSE 134B,A01,083661,Powell; Thomas Allan,0,38,65,65
1650731701832,CSE 140,A01,083663,Staff,0,11,75,75
1650731707856,CSE 140L,A01,083088,Eldon; John,0,20,75,75
1650731713880,CSE 175,A01,083665,Kumar; Rakesh,7,0,25,18
1650731719905,CSE 190,A00,092507,Dubnov; Shlomo,10,0,20,10
1650731725930,ECE 45,A01,083139,Staff,1,2,60,59
1650731731954,ECE 65,A50,083695,Staff,0,5,30,30
1650731737982,ECE 109,A01,091882,Touri; Behrouz,33,0,70,37
1650731744010,ECE 180,A00,083140,Abi Samra; Nicholas Camill,20,0,30,10
1650731744010,ECE 180,B00,083141,Abi Samra; Nicholas Camill,0,0,30,30
1650731750033,MATH 10A,A01,083735,Patchell; Gregory David,2,0,30,28
1650731750033,MATH 10A,A02,083736,Patchell; Gregory David,27,0,30,3
1650731750033,MATH 10A,A03,083737,Patchell; Gregory David,24,0,30,6
1650731756061,MATH 10B,A01,083207,Staff,0,9,30,30
1650731756061,MATH 10B,A02,083208,Staff,1,7,30,29
1650731756061,MATH 10B,B01,083739,Staff,11,0,30,19
1650731756061,MATH 10B,B02,083740,Staff,28,0,30,2
1650731762087,MATH 18,A01,083743,Staff,0,0,30,30
1650731762087,MATH 18,A02,083744,Staff,23,0,30,7
1650731762087,MATH 18,A03,083745,Staff,21,0,30,9
1650731762087,MATH 18,A04,083746,Staff,26,0,30,4
1650731762087,MATH 18,B01,083748,Staff,0,15,30,30
1650731762087,MATH 18,B02,083749,Staff,0,12,30,30
1650731762087,MATH 18,B03,083750,Staff,0,12,30,30
1650731762087,MATH 18,B04,083751,Staff,0,12,30,30
1650731768110,MATH 20A,A01,083754,Staff,19,0,40,21
1650731774135,MATH 20B,A01,083756,Staff,0,11,30,30
1650731774135,MATH 20B,A02,083757,Staff,0,12,30,30
1650731780160,MATH 20C,A01,083760,Staff,0,16,30,30
1650731780160,MATH 20C,A02,083761,Staff,0,16,30,30
1650731780160,MATH 20C,B01,083762,Staff,10,0,30,20
1650731780160,MATH 20C,B02,083763,Staff,28,0,30,2
1650731786182,MATH 20D,A01,083765,Staff,2,1,30,28
1650731786182,MATH 20D,A02,083766,Staff,6,0,30,24
1650731786182,MATH 20D,A03,083767,Staff,24,0,30,6
1650731792208,MATH 20E,A01,083771,Staff,3,0,30,27
1650731792208,MATH 20E,A02,083772,Staff,16,0,30,14
1650731792208,MATH 20E,B01,083773,Staff,0,0,30,30
1650731792208,MATH 20E,B02,083774,Staff,6,0,30,24
1650731798234,MATH 103A,A01,083777,Staff,0,15,30,30
1650731798234,MATH 103A,A02,083778,Staff,0,15,30,30
1650731798234,MATH 103A,B01,083779,Staff,0,15,30,30
1650731798234,MATH 103A,B02,083780,Staff,0,15,30,30
1650731804257,MATH 105,A01,085443,Staff,0,22,30,30
1650731810281,MATH 109,A01,083213,Anzaldo; Leesa B,0,7,30,30
1650731810281,MATH 109,A02,083214,Anzaldo; Leesa B,0,7,30,30
1650731810281,MATH 109,B01,083215,Anzaldo; Leesa B,0,8,30,30
1650731810281,MATH 109,B02,083216,Anzaldo; Leesa B,0,6,30,30
1650731816305,MATH 142A,A01,083219,Chow; Bennett,0,16,30,30
1650731816305,MATH 142A,A02,083220,Chow; Bennett,0,15,30,30
1650731816305,MATH 142A,B01,083221,Chow; Bennett,0,15,30,30
1650731816305,MATH 142A,B02,083222,Chow; Bennett,0,14,30,30
1650731822328,MATH 193A,A01,083224,Staff,0,5,30,30
1650731822328,MATH 193A,A02,083225,Staff,0,6,30,30
1650731822328,MATH 193A,A03,083781,Staff,0,6,30,30
1650731822328,MATH 193A,A04,083782,Staff,0,7,30,30
1650731828352,MATH 197,001,091859,McAuley; Julian John,9998,0,9999,1
1650731834422,COGS 9,A01,083615,Staff,1,15,60,59
1650731840447,COGS 11,A01,083617,Boyle; Mary E. T.,16,0,40,24
1650731846473,COGS 13,A01,083071,Staff,0,38,40,40
1650731852497,COGS 14A,A01,092681,Staff,0,35,100,100
1650731858536,COGS 14B,A01,083073,Cheng; Tzu-Han,1,13,50,49
1650731864558,COGS 17,A01,092677,Staff,13,0,75,62
1650731870586,COGS 100,A01,083619,Staff,0,28,60,60
1650731876614,COGS 101A,A01,083621,Davis; Joshua Daniel,0,27,60,60
1650731882641,COGS 101B,A01,091572,Staff,0,4,60,60
1650731888673,COGS 101C,A01,083625,Delgado; Tania,14,0,30,16
1650731894695,COGS 107A,A01,083627,Boyle; Mary E. T.,0,16,60,60
1650731900720,COGS 118A,A01,083075,Staff,0,8,60,60
1650731906744,CSE 3,A50,083646,Miranda; Gregory Joseph,18,0,38,20
1650731906744,CSE 3,A51,083647,Miranda; Gregory Joseph,36,0,37,1
1650731912769,CSE 8A,A50,083650,Miranda; Gregory Joseph,0,30,40,40
1650731918792,CSE 11,A01,083080,Cao; Yingjun,0,96,40,40
1650731924819,CSE 12,A01,083652,Staff,0,21,100,100
1650731930850,CSE 15L,A01,083654,Staff,0,3,50,50
1650731930850,CSE 15L,A02,083655,Staff,0,2,50,50
1650731936874,CSE 20,A01,083657,Staff,49,0,80,31
1650731942899,CSE 30,A01,083084,Eldon; John,0,77,40,40
1650731948923,CSE 100,A01,083659,Cao; Yingjun,0,70,50,50
1650731954947,CSE 134B,A01,083661,Powell; Thomas Allan,0,38,65,65
1650731960972,CSE 140,A01,083663,Staff,0,11,75,75
1650731966996,CSE 140L,A01,083088,Eldon; John,0,20,75,75
1650731973021,CSE 175,A01,083665,Kumar; Rakesh,7,0,25,18
1650731979046,CSE 190,A00,092507,Dubnov; Shlomo,10,0,20,10
1650731985074,ECE 45,A01,083139,Staff,1,2,60,59
1650731991098,ECE 65,A50,083695,Staff,0,5,30,30
1650731997124,ECE 109,A01,091882,Touri; Behrouz,33,0,70,37
1650732003148,ECE 180,A00,083140,Abi Samra; Nicholas Camill,20,0,30,10
1650732003148,ECE 180,B00,083141,Abi Samra; Nicholas Camill,0,0,30,30
1650732009177,MATH 10A,A01,083735,Patchell; Gregory David,2,0,30,28
1650732009177,MATH 10A,A02,083736,Patchell; Gregory David,27,0,30,3
1650732009177,MATH 10A,A03,083737,Patchell; Gregory David,24,0,30,6
1650732015213,MATH 10B,A01,083207,Staff,0,9,30,30
1650732015213,MATH 10B,A02,083208,Staff,1,7,30,29
1650732015213,MATH 10B,B01,083739,Staff,11,0,30,19
1650732015213,MATH 10B,B02,083740,Staff,28,0,30,2
1650732021251,MATH 18,A01,083743,Staff,0,0,30,30
1650732021251,MATH 18,A02,083744,Staff,23,0,30,7
1650732021251,MATH 18,A03,083745,Staff,21,0,30,9
1650732021251,MATH 18,A04,083746,Staff,26,0,30,4
1650732021251,MATH 18,B01,083748,Staff,0,15,30,30
1650732021251,MATH 18,B02,083749,Staff,0,12,30,30
1650732021251,MATH 18,B03,083750,Staff,0,12,30,30
1650732021251,MATH 18,B04,083751,Staff,0,12,30,30
1650732027274,MATH 20A,A01,083754,Staff,19,0,40,21
1650732033297,MATH 20B,A01,083756,Staff,0,11,30,30
1650732033297,MATH 20B,A02,083757,Staff,0,12,30,30
1650732039326,MATH 20C,A01,083760,Staff,0,16,30,30
1650732039326,MATH 20C,A02,083761,Staff,0,16,30,30
1650732039326,MATH 20C,B01,083762,Staff,10,0,30,20
1650732039326,MATH 20C,B02,083763,Staff,28,0,30,2
1650732045354,MATH 20D,A01,083765,Staff,2,1,30,28
1650732045354,MATH 20D,A02,083766,Staff,6,0,30,24
1650732045354,MATH 20D,A03,083767,Staff,24,0,30,6
1650732051378,MATH 20E,A01,083771,Staff,3,0,30,27
1650732051378,MATH 20E,A02,083772,Staff,16,0,30,14
1650732051378,MATH 20E,B01,083773,Staff,0,0,30,30
1650732051378,MATH 20E,B02,083774,Staff,6,0,30,24
1650732057401,MATH 103A,A01,083777,Staff,0,15,30,30
1650732057401,MATH 103A,A02,083778,Staff,0,15,30,30
1650732057401,MATH 103A,B01,083779,Staff,0,15,30,30
1650732057401,MATH 103A,B02,083780,Staff,0,15,30,30
1650732063428,MATH 105,A01,085443,Staff,0,22,30,30
1650732069452,MATH 109,A01,083213,Anzaldo; Leesa B,0,7,30,30
1650732069452,MATH 109,A02,083214,Anzaldo; Leesa B,0,7,30,30
1650732069452,MATH 109,B01,083215,Anzaldo; Leesa B,0,8,30,30
1650732069452,MATH 109,B02,083216,Anzaldo; Leesa B,0,6,30,30
1650732075476,MATH 142A,A01,083219,Chow; Bennett,0,16,30,30
1650732075476,MATH 142A,A02,083220,Chow; Bennett,0,15,30,30
1650732075476,MATH 142A,B01,083221,Chow; Bennett,0,15,30,30
1650732075476,MATH 142A,B02,083222,Chow; Bennett,0,14,30,30
1650732081499,MATH 193A,A01,083224,Staff,0,5,30,30
1650732081499,MATH 193A,A02,083225,Staff,0,6,30,30
1650732081499,MATH 193A,A03,083781,Staff,0,6,30,30
1650732081499,MATH 193A,A04,083782,Staff,0,7,30,30
1650732087521,MATH 197,001,091859,McAuley; Julian John,9998,0,9999,1
1650732093586,COGS 9,A01,083615,Staff,1,15,60,59
1650732099608,COGS 11,A01,083617,Boyle; Mary E. T.,16,0,40,24
1650732105633,COGS 13,A01,083071,Staff,0,38,40,40
1650732111667,COGS 14A,A01,092681,Staff,0,35,100,100
1650732117691,COGS 14B,A01,083073,Cheng; Tzu-Han,1,13,50,49
1650732123718,COGS 17,A01,092677,Staff,13,0,75,62
1650732129743,COGS 100,A01,083619,Staff,0,28,60,60
1650732135769,COGS 101A,A01,083621,Davis; Joshua Daniel,0,27,60,60
1650732141796,COGS 101B,A01,091572,Staff,0,4,60,60
1650732147820,COGS 101C,A01,083625,Delgado; Tania,14,0,30,16
1650732153846,COGS 107A,A01,083627,Boyle; Mary E. T.,0,16,60,60
1650732159871,COGS 118A,A01,083075,Staff,0,8,60,60
1650732165896,CSE 3,A50,083646,Miranda; Gregory Joseph,18,0,38,20
1650732165896,CSE 3,A51,083647,Miranda; Gregory Joseph,36,0,37,1
1650732171924,CSE 8A,A50,083650,Miranda; Gregory Joseph,0,30,40,40
1650732177952,CSE 11,A01,083080,Cao; Yingjun,0,96,40,40
1650732183986,CSE 12,A01,083652,Staff,0,21,100,100
1650732190015,CSE 15L,A01,083654,Staff,0,3,50,50
1650732190015,CSE 15L,A02,083655,Staff,0,2,50,50
1650732196041,CSE 20,A01,083657,Staff,49,0,80,31
1650732202071,CSE 30,A01,083084,Eldon; John,0,77,40,40
1650732208094,CSE 100,A01,083659,Cao; Yingjun,0,70,50,50
1650732214121,CSE 134B,A01,083661,Powell; Thomas Allan,0,38,65,65
1650732220148,CSE 140,A01,083663,Staff,0,11,75,75
1650732226175,CSE 140L,A01,083088,Eldon; John,0,20,75,75
1650732232198,CSE 175,A01,083665,Kumar; Rakesh,7,0,25,18
1650732238222,CSE 190,A00,092507,Dubnov; Shlomo,10,0,20,10
1650732244246,ECE 45,A01,083139,Staff,1,2,60,59
1650732250271,ECE 65,A50,083695,Staff,0,5,30,30
1650732256301,ECE 109,A01,091882,Touri; Behrouz,33,0,70,37
1650732262324,ECE 180,A00,083140,Abi Samra; Nicholas Camill,20,0,30,10
1650732262324,ECE 180,B00,083141,Abi Samra; Nicholas Camill,0,0,30,30
1650732268453,MATH 10A,A01,083735,Patchell; Gregory David,2,0,30,28
1650732268453,MATH 10A,A02,083736,Patchell; Gregory David,27,0,30,3
1650732268453,MATH 10A,A03,083737,Patchell; Gregory David,24,0,30,6
1650732274478,MATH 10B,A01,083207,Staff,0,9,30,30
1650732274478,MATH 10B,A02,083208,Staff,1,7,30,29
1650732274478,MATH 10B,B01,083739,Staff,11,0,30,19
1650732274478,MATH 10B,B02,083740,Staff,28,0,30,2
1650732280513,MATH 18,A01,083743,Staff,0,0,30,30
1650732280513,MATH 18,A02,083744,Staff,23,0,30,7
1650732280513,MATH 18,A03,083745,Staff,21,0,30,9
1650732280513,MATH 18,A04,083746,Staff,26,0,30,4
1650732280513,MATH 18,B01,083748,Staff,0,15,30,30
1650732280513,MATH 18,B02,083749,Staff,0,12,30,30
1650732280513,MATH 18,B03,083750,Staff,0,12,30,30
1650732280513,MATH 18,B04,083751,Staff,0,12,30,30
1650732286541,MATH 20A,A01,083754,Staff,19,0,40,21
1650732292568,MATH 20B,A01,083756,Staff,0,11,30,30
1650732292568,MATH 20B,A02,083757,Staff,0,12,30,30
1650732298592,MATH 20C,A01,083760,Staff,0,16,30,30
1650732298592,MATH 20C,A02,083761,Staff,0,16,30,30
1650732298592,MATH 20C,B01,083762,Staff,10,0,30,20
1650732298592,MATH 20C,B02,083763,Staff,28,0,30,2
1650732304615,MATH 20D,A01,083765,Staff,2,1,30,28
1650732304615,MATH 20D,A02,083766,Staff,6,0,30,24
1650732304615,MATH 20D,A03,083767,Staff,24,0,30,6
1650732310639,MATH 20E,A01,083771,Staff,3,0,30,27
1650732310639,MATH 20E,A02,083772,Staff,16,0,30,14
1650732310639,MATH 20E,B01,083773,Staff,0,0,30,30
1650732310639,MATH 20E,B02,083774,Staff,6,0,30,24
1650732316666,MATH 103A,A01,083777,Staff,0,15,30,30
1650732316666,MATH 103A,A02,083778,Staff,0,15,30,30
1650732316666,MATH 103A,B01,083779,Staff,0,15,30,30
1650732316666,MATH 103A,B02,083780,Staff,0,15,30,30
1650732322692,MATH 105,A01,085443,Staff,0,22,30,30
1650732328716,MATH 109,A01,083213,Anzaldo; Leesa B,0,7,30,30
1650732328716,MATH 109,A02,083214,Anzaldo; Leesa B,0,7,30,30
1650732328716,MATH 109,B01,083215,Anzaldo; Leesa B,0,8,30,30
1650732328716,MATH 109,B02,083216,Anzaldo; Leesa B,0,6,30,30
1650732334741,MATH 142A,A01,083219,Chow; Bennett,0,16,30,30
1650732334741,MATH 142A,A02,083220,Chow; Bennett,0,15,30,30
1650732334741,MATH 142A,B01,083221,Chow; Bennett,0,15,30,30
1650732334741,MATH 142A,B02,083222,Chow; Bennett,0,14,30,30
1650732340766,MATH 193A,A01,083224,Staff,0,5,30,30
1650732340766,MATH 193A,A02,083225,Staff,0,6,30,30
1650732340766,MATH 193A,A03,083781,Staff,0,6,30,30
1650732340766,MATH 193A,A04,083782,Staff,0,7,30,30
1650732346791,MATH 197,001,091859,McAuley; Julian John,9998,0,9999,1
1650732352852,COGS 9,A01,083615,Staff,1,15,60,59
1650732358875,COGS 11,A01,083617,Boyle; Mary E. T.,16,0,40,24
1650732364915,COGS 13,A01,083071,Staff,0,38,40,40
1650732370939,COGS 14A,A01,092681,Staff,0,35,100,100
1650732376964,COGS 14B,A01,083073,Cheng; Tzu-Han,1,13,50,49
1650732382991,COGS 17,A01,092677,Staff,13,0,75,62
1650732389014,COGS 100,A01,083619,Staff,0,28,60,60
1650732395042,COGS 101A,A01,083621,Davis; Joshua Daniel,0,27,60,60
1650732401074,COGS 101B,A01,091572,Staff,0,4,60,60
1650732407096,COGS 101C,A01,083625,Delgado; Tania,14,0,30,16
1650732413121,COGS 107A,A01,083627,Boyle; Mary E. T.,0,16,60,60
1650732419145,COGS 118A,A01,083075,Staff,0,8,60,60
1650732425169,CSE 3,A50,083646,Miranda; Gregory Joseph,18,0,38,20
1650732425169,CSE 3,A51,083647,Miranda; Gregory Joseph,36,0,37,1
1650732431195,CSE 8A,A50,083650,Miranda; Gregory Joseph,0,30,40,40
1650732437222,CSE 11,A01,083080,Cao; Yingjun,0,96,40,40
1650732443245,CSE 12,A01,083652,Staff,0,21,100,100
1650732449271,CSE 15L,A01,083654,Staff,0,3,50,50
1650732449271,CSE 15L,A02,083655,Staff,0,2,50,50
1650732455293,CSE 20,A01,083657,Staff,49,0,80,31
1650732461322,CSE 30,A01,083084,Eldon; John,0,77,40,40
1650732467347,CSE 100,A01,083659,Cao; Yingjun,0,70,50,50
1650732473377,CSE 134B,A01,083661,Powell; Thomas Allan,0,38,65,65
1650732479399,CSE 140,A01,083663,Staff,0,11,75,75
1650732485426,CSE 140L,A01,083088,Eldon; John,0,20,75,75
1650732491450,CSE 175,A01,083665,Kumar; Rakesh,7,0,25,18
1650732497474,CSE 190,A00,092507,Dubnov; Shlomo,10,0,20,10
1650732503498,ECE 45,A01,083139,Staff,1,2,60,59
1650732509523,ECE 65,A50,083695,Staff,0,5,30,30
1650732515548,ECE 109,A01,091882,Touri; Behrouz,33,0,70,37
1650732521575,ECE 180,A00,083140,Abi Samra; Nicholas Camill,20,0,30,10
1650732521575,ECE 180,B00,083141,Abi Samra; Nicholas Camill,0,0,30,30
1650732527598,MATH 10A,A01,083735,Patchell; Gregory David,2,0,30,28
1650732527598,MATH 10A,A02,083736,Patchell; Gregory David,27,0,30,3
1650732527598,MATH 10A,A03,083737,Patchell; Gregory David,24,0,30,6
1650732533627,MATH 10B,A01,083207,Staff,0,9,30,30
1650732533627,MATH 10B,A02,083208,Staff,1,7,30,29
1650732533627,MATH 10B,B01,083739,Staff,11,0,30,19
1650732533627,MATH 10B,B02,083740,Staff,28,0,30,2
1650732539660,MATH 18,A01,083743,Staff,0,0,30,30
1650732539660,MATH 18,A02,083744,Staff,23,0,30,7
1650732539660,MATH 18,A03,083745,Staff,21,0,30,9
1650732539660,MATH 18,A04,083746,Staff,26,0,30,4
1650732539660,MATH 18,B01,083748,Staff,0,15,30,30
1650732539660,MATH 18,B02,083749,Staff,0,12,30,30
1650732539660,MATH 18,B03,083750,Staff,0,12,30,30
1650732539660,MATH 18,B04,083751,Staff,0,12,30,30
1650732545687,MATH 20A,A01,083754,Staff,19,0,40,21
1650732551716,MATH 20B,A01,083756,Staff,0,11,30,30
1650732551716,MATH 20B,A02,083757,Staff,0,12,30,30
1650732557745,MATH 20C,A01,083760,Staff,0,16,30,30
1650732557745,MATH 20C,A02,083761,Staff,0,16,30,30
1650732557745,MATH 20C,B01,083762,Staff,10,0,30,20
1650732557745,MATH 20C,B02,083763,Staff,28,0,30,2
1650732563771,MATH 20D,A01,083765,Staff,2,1,30,28
1650732563771,MATH 20D,A02,083766,Staff,6,0,30,24
1650732563771,MATH 20D,A03,083767,Staff,24,0,30,6
1650732569802,MATH 20E,A01,083771,Staff,3,0,30,27
1650732569802,MATH 20E,A02,083772,Staff,16,0,30,14
1650732569802,MATH 20E,B01,083773,Staff,0,0,30,30
1650732569802,MATH 20E,B02,083774,Staff,6,0,30,24
1650732575829,MATH 103A,A01,083777,Staff,0,15,30,30
1650732575829,MATH 103A,A02,083778,Staff,0,15,30,30
1650732575829,MATH 103A,B01,083779,Staff,0,15,30,30
1650732575829,MATH 103A,B02,083780,Staff,0,15,30,30
1650732581852,MATH 105,A01,085443,Staff,0,22,30,30
1650732587876,MATH 109,A01,083213,Anzaldo; Leesa B,0,7,30,30
1650732587876,MATH 109,A02,083214,Anzaldo; Leesa B,0,7,30,30
1650732587876,MATH 109,B01,083215,Anzaldo; Leesa B,0,8,30,30
1650732587876,MATH 109,B02,083216,Anzaldo; Leesa B,0,6,30,30
1650732593907,MATH 142A,A01,083219,Chow; Bennett,0,16,30,30
1650732593907,MATH 142A,A02,083220,Chow; Bennett,0,15,30,30
1650732593907,MATH 142A,B01,083221,Chow; Bennett,0,15,30,30
1650732593907,MATH 142A,B02,083222,Chow; Bennett,0,14,30,30
1650732599933,MATH 193A,A01,083224,Staff,0,5,30,30
1650732599933,MATH 193A,A02,083225,Staff,0,6,30,30
1650732599933,MATH 193A,A03,083781,Staff,0,6,30,30
1650732599933,MATH 193A,A04,083782,Staff,0,7,30,30
1650732605956,MATH 197,001,091859,McAuley; Julian John,9998,0,9999,1
1650732612006,COGS 9,A01,083615,Staff,1,15,60,59
1650732618031,COGS 11,A01,083617,Boyle; Mary E. T.,16,0,40,24
1650732624079,COGS 13,A01,083071,Staff,0,38,40,40
1650732630107,COGS 14A,A01,092681,Staff,0,35,100,100
1650732636135,COGS 14B,A01,083073,Cheng; Tzu-Han,1,13,50,49
1650732642168,COGS 17,A01,092677,Staff,13,0,75,62
1650732648197,COGS 100,A01,083619,Staff,0,28,60,60
1650732654226,COGS 101A,A01,083621,Davis; Joshua Daniel,0,27,60,60
1650732660255,COGS 101B,A01,091572,Staff,0,4,60,60
1650732666280,COGS 101C,A01,083625,Delgado; Tania,14,0,30,16
1650732672305,COGS 107A,A01,083627,Boyle; Mary E. T.,0,16,60,60
1650732678333,COGS 118A,A01,083075,Staff,0,8,60,60
1650732684357,CSE 3,A50,083646,Miranda; Gregory Joseph,18,0,38,20
1650732684357,CSE 3,A51,083647,Miranda; Gregory Joseph,36,0,37,1
1650732690413,CSE 8A,A50,083650,Miranda; Gregory Joseph,0,30,40,40
1650732696442,CSE 11,A01,083080,Cao; Yingjun,0,96,40,40
1650732702466,CSE 12,A01,083652,Staff,0,21,100,100
1650732708489,CSE 15L,A01,083654,Staff,0,3,50,50
1650732708489,CSE 15L,A02,083655,Staff,0,2,50,50
1650732714516,CSE 20,A01,083657,Staff,49,0,80,31
1650732720544,CSE 30,A01,083084,Eldon; John,0,77,40,40
1650732726567,CSE 100,A01,083659,Cao; Yingjun,0,70,50,50
1650732732590,CSE 134B,A01,083661,Powell; Thomas Allan,0,38,65,65
1650732738614,CSE 140,A01,083663,Staff,0,11,75,75
1650732744640,CSE 140L,A01,083088,Eldon; John,0,20,75,75
1650732750672,CSE 175,A01,083665,Kumar; Rakesh,7,0,25,18
1650732756696,CSE 190,A00,092507,Dubnov; Shlomo,10,0,20,10
1650732762724,ECE 45,A01,083139,Staff,1,2,60,59
1650732768756,ECE 65,A50,083695,Staff,0,5,30,30
1650732774782,ECE 109,A01,091882,Touri; Behrouz,33,0,70,37
1650732780806,ECE 180,A00,083140,Abi Samra; Nicholas Camill,20,0,30,10
1650732780806,ECE 180,B00,083141,Abi Samra; Nicholas Camill,0,0,30,30
1650732786840,MATH 10A,A01,083735,Patchell; Gregory David,2,0,30,28
1650732786840,MATH 10A,A02,083736,Patchell; Gregory David,27,0,30,3
1650732786840,MATH 10A,A03,083737,Patchell; Gregory David,24,0,30,6
1650732792869,MATH 10B,A01,083207,Staff,0,9,30,30
1650732792869,MATH 10B,A02,083208,Staff,1,7,30,29
1650732792869,MATH 10B,B01,083739,Staff,11,0,30,19
1650732792869,MATH 10B,B02,083740,Staff,28,0,30,2
1650732798896,MATH 18,A01,083743,Staff,0,0,30,30
1650732798896,MATH 18,A02,083744,Staff,23,0,30,7
1650732798896,MATH 18,A03,083745,Staff,21,0,30,9
1650732798896,MATH 18,A04,083746,Staff,26,0,30,4
1650732798896,MATH 18,B01,083748,Staff,0,15,30,30
1650732798896,MATH 18,B02,083749,Staff,0,12,30,30
1650732798896,MATH 18,B03,083750,Staff,0,12,30,30
1650732798896,MATH 18,B04,083751,Staff,0,12,30,30
1650732804921,MATH 20A,A01,083754,Staff,19,0,40,21
1650732810944,MATH 20B,A01,083756,Staff,0,11,30,30
1650732810944,MATH 20B,A02,083757,Staff,0,12,30,30
1650732816974,MATH 20C,A01,083760,Staff,0,16,30,30
1650732816974,MATH 20C,A02,083761,Staff,0,16,30,30
1650732816974,MATH 20C,B01,083762,Staff,10,0,30,20
1650732816974,MATH 20C,B02,083763,Staff,28,0,30,2
1650732823002,MATH 20D,A01,083765,Staff,2,1,30,28
1650732823002,MATH 20D,A02,083766,Staff,6,0,30,24
1650732823002,MATH 20D,A03,083767,Staff,24,0,30,6
1650732829027,MATH 20E,A01,083771,Staff,3,0,30,27
1650732829027,MATH 20E,A02,083772,Staff,16,0,30,14
1650732829027,MATH 20E,B01,083773,Staff,0,0,30,30
1650732829027,MATH 20E,B02,083774,Staff,6,0,30,24
1650732835063,MATH 103A,A01,083777,Staff,0,15,30,30
1650732835063,MATH 103A,A02,083778,Staff,0,15,30,30
1650732835063,MATH 103A,B01,083779,Staff,0,15,30,30
1650732835063,MATH 103A,B02,083780,Staff,0,15,30,30
1650732841090,MATH 105,A01,085443,Staff,0,22,30,30
1650732847115,MATH 109,A01,083213,Anzaldo; Leesa B,0,7,30,30
1650732847115,MATH 109,A02,083214,Anzaldo; Leesa B,0,7,30,30
1650732847115,MATH 109,B01,083215,Anzaldo; Leesa B,0,8,30,30
1650732847115,MATH 109,B02,083216,Anzaldo; Leesa B,0,6,30,30
1650732853141,MATH 142A,A01,083219,Chow; Bennett,0,16,30,30
1650732853141,MATH 142A,A02,083220,Chow; Bennett,0,15,30,30
1650732853141,MATH 142A,B01,083221,Chow; Bennett,0,15,30,30
1650732853141,MATH 142A,B02,083222,Chow; Bennett,0,14,30,30
1650732859167,MATH 193A,A01,083224,Staff,0,5,30,30
1650732859167,MATH 193A,A02,083225,Staff,0,6,30,30
1650732859167,MATH 193A,A03,083781,Staff,0,6,30,30
1650732859167,MATH 193A,A04,083782,Staff,0,7,30,30
1650732865290,MATH 197,001,091859,McAuley; Julian John,9998,0,9999,1
1650732871341,COGS 9,A01,083615,Staff,1,15,60,59
1650732877367,COGS 11,A01,083617,Boyle; Mary E. T.,16,0,40,24
1650732883391,COGS 13,A01,083071,Staff,0,38,40,40
1650732889423,COGS 14A,A01,092681,Staff,0,35,100,100
1650732895448,COGS 14B,A01,083073,Cheng; Tzu-Han,1,13,50,49
1650732901476,COGS 17,A01,092677,Staff,13,0,75,62
1650732907499,COGS 100,A01,083619,Staff,0,28,60,60
1650732913534,COGS 101A,A01,083621,Davis; Joshua Daniel,0,27,60,60
1650732919561,COGS 101B,A01,091572,Staff,0,4,60,60
1650732925587,COGS 101C,A01,083625,Delgado; Tania,14,0,30,16
1650732931611,COGS 107A,A01,083627,Boyle; Mary E. T.,0,16,60,60
1650732937634,COGS 118A,A01,083075,Staff,0,8,60,60
1650732943663,CSE 3,A50,083646,Miranda; Gregory Joseph,18,0,38,20
1650732943663,CSE 3,A51,083647,Miranda; Gregory Joseph,36,0,37,1
1650732949687,CSE 8A,A50,083650,Miranda; Gregory Joseph,0,30,40,40
1650732955718,CSE 11,A01,083080,Cao; Yingjun,0,96,40,40
1650732961742,CSE 12,A01,083652,Staff,0,21,100,100
1650732967768,CSE 15L,A01,083654,Staff,0,3,50,50
1650732967768,CSE 15L,A02,083655,Staff,0,2,50,50
1650732973793,CSE 20,A01,083657,Staff,49,0,80,31
1650732979821,CSE 30,A01,083084,Eldon; John,0,77,40,40
1650732985845,CSE 100,A01,083659,Cao; Yingjun,0,70,50,50
1650732991878,CSE 134B,A01,083661,Powell; Thomas Allan,0,38,65,65
1650732997902,CSE 140,A01,083663,Staff,0,11,75,75
1650733003928,CSE 140L,A01,083088,Eldon; John,0,20,75,75
1650733009950,CSE 175,A01,083665,Kumar; Rakesh,7,0,25,18
1650733015980,CSE 190,A00,092507,Dubnov; Shlomo,10,0,20,10
1650733022008,ECE 45,A01,083139,Staff,1,2,60,59
1650733028038,ECE 65,A50,083695,Staff,0,5,30,30
1650733034060,ECE 109,A01,091882,Touri; Behrouz,33,0,70,37
1650733040086,ECE 180,A00,083140,Abi Samra; Nicholas Camill,20,0,30,10
1650733040086,ECE 180,B00,083141,Abi Samra; Nicholas Camill,0,0,30,30
1650733046114,MATH 10A,A01,083735,Patchell; Gregory David,2,0,30,28
1650733046114,MATH 10A,A02,083736,Patchell; Gregory David,27,0,30,3
1650733046114,MATH 10A,A03,083737,Patchell; Gregory David,24,0,30,6
1650733052143,MATH 10B,A01,083207,Staff,0,9,30,30
1650733052143,MATH 10B,A02,083208,Staff,1,7,30,29
1650733052143,MATH 10B,B01,083739,Staff,11,0,30,19
1650733052143,MATH 10B,B02,083740,Staff,28,0,30,2
1650733058172,MATH 18,A01,083743,Staff,0,0,30,30
1650733058172,MATH 18,A02,083744,Staff,23,0,30,7
1650733058172,MATH 18,A03,083745,Staff,21,0,30,9
1650733058172,MATH 18,A04,083746,Staff,26,0,30,4
1650733058172,MATH 18,B01,083748,Staff,0,15,30,30
1650733058172,MATH 18,B02,083749,Staff,0,12,30,30
1650733058172,MATH 18,B03,083750,Staff,0,12,30,30
1650733058172,MATH 18,B04,083751,Staff,0,12,30,30
1650733064199,MATH 20A,A01,083754,Staff,19,0,40,21
1650733070234,MATH 20B,A01,083756,Staff,0,11,30,30
1650733070234,MATH 20B,A02,083757,Staff,0,12,30,30
1650733076263,MATH 20C,A01,083760,Staff,0,16,30,30
1650733076263,MATH 20C,A02,083761,Staff,0,16,30,30
1650733076263,MATH 20C,B01,083762,Staff,10,0,30,20
1650733076263,MATH 20C,B02,083763,Staff,28,0,30,2
1650733082290,MATH 20D,A01,083765,Staff,2,1,30,28
1650733082290,MATH 20D,A02,083766,Staff,6,0,30,24
1650733082290,MATH 20D,A03,083767,Staff,24,0,30,6
1650733088314,MATH 20E,A01,083771,Staff,3,0,30,27
1650733088314,MATH 20E,A02,083772,Staff,16,0,30,14
1650733088314,MATH 20E,B01,083773,Staff,0,0,30,30
1650733088314,MATH 20E,B02,083774,Staff,6,0,30,24
1650733094338,MATH 103A,A01,083777,Staff,0,15,30,30
1650733094338,MATH 103A,A02,083778,Staff,0,15,30,30
1650733094338,MATH 103A,B01,083779,Staff,0,15,30,30
1650733094338,MATH 103A,B02,083780,Staff,0,15,30,30
1650733100362,MATH 105,A01,085443,Staff,0,22,30,30
1650733106386,MATH 109,A01,083213,Anzaldo; Leesa B,0,7,30,30
1650733106386,MATH 109,A02,083214,Anzaldo; Leesa B,0,7,30,30
1650733106386,MATH 109,B01,083215,Anzaldo; Leesa B,0,8,30,30
1650733106386,MATH 109,B02,083216,Anzaldo; Leesa B,0,6,30,30
1650733112417,MATH 142A,A01,083219,Chow; Bennett,0,16,30,30
1650733112417,MATH 142A,A02,083220,Chow; Bennett,0,15,30,30
1650733112417,MATH 142A,B01,083221,Chow; Bennett,0,15,30,30
1650733112417,MATH 142A,B02,083222,Chow; Bennett,0,14,30,30
1650733118446,MATH 193A,A01,083224,Staff,0,5,30,30
1650733118446,MATH 193A,A02,083225,Staff,0,6,30,30
1650733118446,MATH 193A,A03,083781,Staff,0,6,30,30
1650733118446,MATH 193A,A04,083782,Staff,0,7,30,30
1650733124473,MATH 197,001,091859,McAuley; Julian John,9998,0,9999,1
1650733130529,COGS 9,A01,083615,Staff,1,15,60,59
1650733136554,COGS 11,A01,083617,Boyle; Mary E. T.,16,0,40,24
1650733142582,COGS 13,A01,083071,Staff,0,38,40,40
1650733148609,COGS 14A,A01,092681,Staff,0,35,100,100
1650733154635,COGS 14B,A01,083073,Cheng; Tzu-Han,1,13,50,49
1650733160661,COGS 17,A01,092677,Staff,13,0,75,62
1650733166684,COGS 100,A01,083619,Staff,0,28,60,60
1650733172709,COGS 101A,A01,083621,Davis; Joshua Daniel,0,27,60,60
1650733178736,COGS 101B,A01,091572,Staff,0,4,60,60
1650733184761,COGS 101C,A01,083625,Delgado; Tania,14,0,30,16
1650733190786,COGS 107A,A01,083627,Boyle; Mary E. T.,0,16,60,60
1650733196813,COGS 118A,A01,083075,Staff,0,8,60,60
1650733202843,CSE 3,A50,083646,Miranda; Gregory Joseph,18,0,38,20
1650733202843,CSE 3,A51,083647,Miranda; Gregory Joseph,36,0,37,1
1650733208867,CSE 8A,A50,083650,Miranda; Gregory Joseph,0,30,40,40
1650733214891,CSE 11,A01,083080,Cao; Yingjun,0,96,40,40
1650733220917,CSE 12,A01,083652,Staff,0,21,100,100
1650733226942,CSE 15L,A01,083654,Staff,0,3,50,50
1650733226942,CSE 15L,A02,083655,Staff,0,2,50,50
1650733232968,CSE 20,A01,083657,Staff,49,0,80,31
1650733238991,CSE 30,A01,083084,Eldon; John,0,77,40,40
1650733245017,CSE 100,A01,083659,Cao; Yingjun,0,70,50,50
1650733251043,CSE 134B,A01,083661,Powell; Thomas Allan,0,38,65,65
1650733257066,CSE 140,A01,083663,Staff,0,11,75,75
1650733263094,CSE 140L,A01,083088,Eldon; John,0,20,75,75
1650733269120,CSE 175,A01,083665,Kumar; Rakesh,7,0,25,18
1650733275143,CSE 190,A00,092507,Dubnov; Shlomo,10,0,20,10
1650733281167,ECE 45,A01,083139,Staff,1,2,60,59
1650733287190,ECE 65,A50,083695,Staff,0,5,30,30
1650733293218,ECE 109,A01,091882,Touri; Behrouz,33,0,70,37
1650733299248,ECE 180,A00,083140,Abi Samra; Nicholas Camill,20,0,30,10
1650733299248,ECE 180,B00,083141,Abi Samra; Nicholas Camill,0,0,30,30
1650733305278,MATH 10A,A01,083735,Patchell; Gregory David,2,0,30,28
1650733305278,MATH 10A,A02,083736,Patchell; Gregory David,27,0,30,3
1650733305278,MATH 10A,A03,083737,Patchell; Gregory David,24,0,30,6
1650733311305,MATH 10B,A01,083207,Staff,0,9,30,30
1650733311305,MATH 10B,A02,083208,Staff,1,7,30,29
1650733311305,MATH 10B,B01,083739,Staff,11,0,30,19
1650733311305,MATH 10B,B02,083740,Staff,28,0,30,2
1650733317333,MATH 18,A01,083743,Staff,0,0,30,30
1650733317333,MATH 18,A02,083744,Staff,23,0,30,7
1650733317333,MATH 18,A03,083745,Staff,21,0,30,9
1650733317333,MATH 18,A04,083746,Staff,26,0,30,4
1650733317333,MATH 18,B01,083748,Staff,0,15,30,30
1650733317333,MATH 18,B02,083749,Staff,0,12,30,30
1650733317333,MATH 18,B03,083750,Staff,0,12,30,30
1650733317333,MATH 18,B04,083751,Staff,0,12,30,30
1650733323361,MATH 20A,A01,083754,Staff,19,0,40,21
1650733329400,MATH 20B,A01,083756,Staff,0,11,30,30
1650733329400,MATH 20B,A02,083757,Staff,0,12,30,30
1650733335425,MATH 20C,A01,083760,Staff,0,16,30,30
1650733335425,MATH 20C,A02,083761,Staff,0,16,30,30
1650733335425,MATH 20C,B01,083762,Staff,10,0,30,20
1650733335425,MATH 20C,B02,083763,Staff,28,0,30,2
1650733341457,MATH 20D,A01,083765,Staff,2,1,30,28
1650733341457,MATH 20D,A02,083766,Staff,6,0,30,24
1650733341457,MATH 20D,A03,083767,Staff,24,0,30,6
1650733347483,MATH 20E,A01,083771,Staff,3,0,30,27
1650733347483,MATH 20E,A02,083772,Staff,16,0,30,14
1650733347483,MATH 20E,B01,083773,Staff,0,0,30,30
1650733347483,MATH 20E,B02,083774,Staff,6,0,30,24
1650733353508,MATH 103A,A01,083777,Staff,0,15,30,30
1650733353508,MATH 103A,A02,083778,Staff,0,15,30,30
1650733353508,MATH 103A,B01,083779,Staff,0,15,30,30
1650733353508,MATH 103A,B02,083780,Staff,0,15,30,30
1650733359532,MATH 105,A01,085443,Staff,0,22,30,30
1650733365561,MATH 109,A01,083213,Anzaldo; Leesa B,0,7,30,30
1650733365561,MATH 109,A02,083214,Anzaldo; Leesa B,0,7,30,30
1650733365561,MATH 109,B01,083215,Anzaldo; Leesa B,0,8,30,30
1650733365561,MATH 109,B02,083216,Anzaldo; Leesa B,0,6,30,30
1650733371586,MATH 142A,A01,083219,Chow; Bennett,0,16,30,30
1650733371586,MATH 142A,A02,083220,Chow; Bennett,0,15,30,30
1650733371586,MATH 142A,B01,083221,Chow; Bennett,0,15,30,30
1650733371586,MATH 142A,B02,083222,Chow; Bennett,0,14,30,30
1650733377614,MATH 193A,A01,083224,Staff,0,5,30,30
1650733377614,MATH 193A,A02,083225,Staff,0,6,30,30
1650733377614,MATH 193A,A03,083781,Staff,0,6,30,30
1650733377614,MATH 193A,A04,083782,Staff,0,7,30,30
1650733383638,MATH 197,001,091859,McAuley; Julian John,9998,0,9999,1
1650733389698,COGS 9,A01,083615,Staff,1,15,60,59
1650733395721,COGS 11,A01,083617,Boyle; Mary E. T.,16,0,40,24
1650733401745,COGS 13,A01,083071,Staff,0,38,40,40
1650733407768,COGS 14A,A01,092681,Staff,0,35,100,100
1650733413791,COGS 14B,A01,083073,Cheng; Tzu-Han,1,13,50,49
1650733419815,COGS 17,A01,092677,Staff,13,0,75,62
1650733425838,COGS 100,A01,083619,Staff,0,28,60,60
1650733431866,COGS 101A,A01,083621,Davis; Joshua Daniel,0,27,60,60
1650733437890,COGS 101B,A01,091572,Staff,0,4,60,60
1650733443917,COGS 101C,A01,083625,Delgado; Tania,14,0,30,16
1650733449949,COGS 107A,A01,083627,Boyle; Mary E. T.,0,16,60,60
1650733456072,COGS 118A,A01,083075,Staff,0,8,60,60
1650733462100,CSE 3,A50,083646,Miranda; Gregory Joseph,18,0,38,20
1650733462100,CSE 3,A51,083647,Miranda; Gregory Joseph,36,0,37,1
1650733468124,CSE 8A,A50,083650,Miranda; Gregory Joseph,0,30,40,40
1650733474148,CSE 11,A01,083080,Cao; Yingjun,0,96,40,40
1650733480172,CSE 12,A01,083652,Staff,0,21,100,100
1650733486197,CSE 15L,A01,083654,Staff,0,3,50,50
1650733486197,CSE 15L,A02,083655,Staff,0,2,50,50
1650733492224,CSE 20,A01,083657,Staff,49,0,80,31
1650733498252,CSE 30,A01,083084,Eldon; John,0,77,40,40
1650733504275,CSE 100,A01,083659,Cao; Yingjun,0,70,50,50
1650733510300,CSE 134B,A01,083661,Powell; Thomas Allan,0,38,65,65
1650733516328,CSE 140,A01,083663,Staff,0,11,75,75
1650733522355,CSE 140L,A01,083088,Eldon; John,0,20,75,75
1650733528386,CSE 175,A01,083665,Kumar; Rakesh,7,0,25,18
1650733534410,CSE 190,A00,092507,Dubnov; Shlomo,10,0,20,10
1650733540435,ECE 45,A01,083139,Staff,1,2,60,59
1650733546458,ECE 65,A50,083695,Staff,0,5,30,30
1650733552492,ECE 109,A01,091882,Touri; Behrouz,33,0,70,37
1650733558515,ECE 180,A00,083140,Abi Samra; Nicholas Camill,20,0,30,10
1650733558515,ECE 180,B00,083141,Abi Samra; Nicholas Camill,0,0,30,30
1650733564544,MATH 10A,A01,083735,Patchell; Gregory David,2,0,30,28
1650733564544,MATH 10A,A02,083736,Patchell; Gregory David,27,0,30,3
1650733564544,MATH 10A,A03,083737,Patchell; Gregory David,24,0,30,6
1650733570573,MATH 10B,A01,083207,Staff,0,9,30,30
1650733570573,MATH 10B,A02,083208,Staff,1,7,30,29
1650733570573,MATH 10B,B01,083739,Staff,11,0,30,19
1650733570573,MATH 10B,B02,083740,Staff,28,0,30,2
1650733576602,MATH 18,A01,083743,Staff,0,0,30,30
1650733576602,MATH 18,A02,083744,Staff,23,0,30,7
1650733576602,MATH 18,A03,083745,Staff,21,0,30,9
1650733576602,MATH 18,A04,083746,Staff,26,0,30,4
1650733576602,MATH 18,B01,083748,Staff,0,15,30,30
1650733576602,MATH 18,B02,083749,Staff,0,12,30,30
1650733576602,MATH 18,B03,083750,Staff,0,12,30,30
1650733576602,MATH 18,B04,083751,Staff,0,12,30,30
1650733582638,MATH 20A,A01,083754,Staff,19,0,40,21
1650733588663,MATH 20B,A01,083756,Staff,0,11,30,30
1650733588663,MATH 20B,A02,083757,Staff,0,12,30,30
1650733594685,MATH 20C,A01,083760,Staff,0,16,30,30
1650733594685,MATH 20C,A02,083761,Staff,0,16,30,30
1650733594685,MATH 20C,B01,083762,Staff,10,0,30,20
1650733594685,MATH 20C,B02,083763,Staff,28,0,30,2
1650733600714,MATH 20D,A01,083765,Staff,2,1,30,28
1650733600714,MATH 20D,A02,083766,Staff,6,0,30,24
1650733600714,MATH 20D,A03,083767,Staff,24,0,30,6
1650733606742,MATH 20E,A01,083771,Staff,3,0,30,27
1650733606742,MATH 20E,A02,083772,Staff,16,0,30,14
1650733606742,MATH 20E,B01,083773,Staff,0,0,30,30
1650733606742,MATH 20E,B02,083774,Staff,6,0,30,24
1650733612772,MATH 103A,A01,083777,Staff,0,15,30,30
1650733612772,MATH 103A,A02,083778,Staff,0,15,30,30
1650733612772,MATH 103A,B01,083779,Staff,0,15,30,30
1650733612772,MATH 103A,B02,083780,Staff,0,15,30,30
1650733618796,MATH 105,A01,085443,Staff,0,22,30,30
1650733624825,MATH 109,A01,083213,Anzaldo; Leesa B,0,7,30,30
1650733624825,MATH 109,A02,083214,Anzaldo; Leesa B,0,7,30,30
1650733624825,MATH 109,B01,083215,Anzaldo; Leesa B,0,8,30,30
1650733624825,MATH 109,B02,083216,Anzaldo; Leesa B,0,6,30,30
1650733630853,MATH 142A,A01,083219,Chow; Bennett,0,16,30,30
1650733630853,MATH 142A,A02,083220,Chow; Bennett,0,15,30,30
1650733630853,MATH 142A,B01,083221,Chow; Bennett,0,15,30,30
1650733630853,MATH 142A,B02,083222,Chow; Bennett,0,14,30,30
1650733636876,MATH 193A,A01,083224,Staff,0,5,30,30
1650733636876,MATH 193A,A02,083225,Staff,0,6,30,30
1650733636876,MATH 193A,A03,083781,Staff,0,6,30,30
1650733636876,MATH 193A,A04,083782,Staff,0,7,30,30
1650733642900,MATH 197,001,091859,McAuley; Julian John,9998,0,9999,1
1650733648955,COGS 9,A01,083615,Staff,1,15,60,59
1650733654983,COGS 11,A01,083617,Boyle; Mary E. T.,16,0,40,24
1650733661018,COGS 13,A01,083071,Staff,0,38,40,40
1650733667042,COGS 14A,A01,092681,Staff,0,35,100,100
1650733673070,COGS 14B,A01,083073,Cheng; Tzu-Han,1,13,50,49
1650733679092,COGS 17,A01,092677,Staff,13,0,75,62
1650733685118,COGS 100,A01,083619,Staff,0,28,60,60
1650733691158,COGS 101A,A01,083621,Davis; Joshua Daniel,0,27,60,60
1650733697181,COGS 101B,A01,091572,Staff,0,4,60,60
1650733703208,COGS 101C,A01,083625,Delgado; Tania,14,0,30,16
1650733709235,COGS 107A,A01,083627,Boyle; Mary E. T.,0,16,60,60
1650733715265,COGS 118A,A01,083075,Staff,0,8,60,60
1650733721289,CSE 3,A50,083646,Miranda; Gregory Joseph,18,0,38,20
1650733721289,CSE 3,A51,083647,Miranda; Gregory Joseph,36,0,37,1
1650733727317,CSE 8A,A50,083650,Miranda; Gregory Joseph,0,30,40,40
1650733733341,CSE 11,A01,083080,Cao; Yingjun,0,96,40,40
1650733739368,CSE 12,A01,083652,Staff,0,21,100,100
1650733745394,CSE 15L,A01,083654,Staff,0,3,50,50
1650733745394,CSE 15L,A02,083655,Staff,0,2,50,50
1650733751422,CSE 20,A01,083657,Staff,49,0,80,31
1650733757445,CSE 30,A01,083084,Eldon; John,0,77,40,40
1650733763476,CSE 100,A01,083659,Cao; Yingjun,0,70,50,50
1650733769504,CSE 134B,A01,083661,Powell; Thomas Allan,0,38,65,65
1650733775531,CSE 140,A01,083663,Staff,0,11,75,75
1650733781558,CSE 140L,A01,083088,Eldon; John,0,20,75,75
1650733787584,CSE 175,A01,083665,Kumar; Rakesh,7,0,25,18
1650733793609,CSE 190,A00,092507,Dubnov; Shlomo,10,0,20,10
1650733799632,ECE 45,A01,083139,Staff,1,2,60,59
1650733805663,ECE 65,A50,083695,Staff,0,5,30,30
1650733811688,ECE 109,A01,091882,Touri; Behrouz,33,0,70,37
1650733817711,ECE 180,A00,083140,Abi Samra; Nicholas Camill,20,0,30,10
1650733817711,ECE 180,B00,083141,Abi Samra; Nicholas Camill,0,0,30,30
1650733823738,MATH 10A,A01,083735,Patchell; Gregory David,2,0,30,28
1650733823738,MATH 10A,A02,083736,Patchell; Gregory David,27,0,30,3
1650733823738,MATH 10A,A03,083737,Patchell; Gregory David,24,0,30,6
1650733829762,MATH 10B,A01,083207,Staff,0,9,30,30
1650733829762,MATH 10B,A02,083208,Staff,1,7,30,29
1650733829762,MATH 10B,B01,083739,Staff,11,0,30,19
1650733829762,MATH 10B,B02,083740,Staff,28,0,30,2
1650733835787,MATH 18,A01,083743,Staff,0,0,30,30
1650733835787,MATH 18,A02,083744,Staff,23,0,30,7
1650733835787,MATH 18,A03,083745,Staff,21,0,30,9
1650733835787,MATH 18,A04,083746,Staff,26,0,30,4
1650733835787,MATH 18,B01,083748,Staff,0,15,30,30
1650733835787,MATH 18,B02,083749,Staff,0,12,30,30
1650733835787,MATH 18,B03,083750,Staff,0,12,30,30
1650733835787,MATH 18,B04,083751,Staff,0,12,30,30
1650733841810,MATH 20A,A01,083754,Staff,19,0,40,21
1650733847835,MATH 20B,A01,083756,Staff,0,11,30,30
1650733847835,MATH 20B,A02,083757,Staff,0,12,30,30
1650733853878,MATH 20C,A01,083760,Staff,0,16,30,30
1650733853878,MATH 20C,A02,083761,Staff,0,16,30,30
1650733853878,MATH 20C,B01,083762,Staff,10,0,30,20
1650733853878,MATH 20C,B02,083763,Staff,28,0,30,2
1650733859905,MATH 20D,A01,083765,Staff,2,1,30,28
1650733859905,MATH 20D,A02,083766,Staff,6,0,30,24
1650733859905,MATH 20D,A03,083767,Staff,24,0,30,6
1650733865929,MATH 20E,A01,083771,Staff,3,0,30,27
1650733865929,MATH 20E,A02,083772,Staff,16,0,30,14
1650733865929,MATH 20E,B01,083773,Staff,0,0,30,30
1650733865929,MATH 20E,B02,083774,Staff,6,0,30,24
1650733871953,MATH 103A,A01,083777,Staff,0,15,30,30
1650733871953,MATH 103A,A02,083778,Staff,0,15,30,30
1650733871953,MATH 103A,B01,083779,Staff,0,15,30,30
1650733871953,MATH 103A,B02,083780,Staff,0,15,30,30
1650733877979,MATH 105,A01,085443,Staff,0,22,30,30
1650733884006,MATH 109,A01,083213,Anzaldo; Leesa B,0,7,30,30
1650733884006,MATH 109,A02,083214,Anzaldo; Leesa B,0,7,30,30
1650733884006,MATH 109,B01,083215,Anzaldo; Leesa B,0,8,30,30
1650733884006,MATH 109,B02,083216,Anzaldo; Leesa B,0,6,30,30
1650733890030,MATH 142A,A01,083219,Chow; Bennett,0,16,30,30
1650733890030,MATH 142A,A02,083220,Chow; Bennett,0,15,30,30
1650733890030,MATH 142A,B01,083221,Chow; Bennett,0,15,30,30
1650733890030,MATH 142A,B02,083222,Chow; Bennett,0,14,30,30
1650733896055,MATH 193A,A01,083224,Staff,0,5,30,30
1650733896055,MATH 193A,A02,083225,Staff,0,6,30,30
1650733896055,MATH 193A,A03,083781,Staff,0,6,30,30
1650733896055,MATH 193A,A04,083782,Staff,0,7,30,30
1650733902082,MATH 197,001,091859,McAuley; Julian John,9998,0,9999,1
1650733908137,COGS 9,A01,083615,Staff,1,15,60,59
1650733914160,COGS 11,A01,083617,Boyle; Mary E. T.,16,0,40,24
1650733920186,COGS 13,A01,083071,Staff,0,38,40,40
1650733926213,COGS 14A,A01,092681,Staff,0,35,100,100
1650733932240,COGS 14B,A01,083073,Cheng; Tzu-Han,1,13,50,49
1650733938263,COGS 17,A01,092677,Staff,13,0,75,62
1650733944290,COGS 100,A01,083619,Staff,0,28,60,60
1650733950320,COGS 101A,A01,083621,Davis; Joshua Daniel,0,27,60,60
1650733956344,COGS 101B,A01,091572,Staff,0,4,60,60
1650733962368,COGS 101C,A01,083625,Delgado; Tania,14,0,30,16
1650733968406,COGS 107A,A01,083627,Boyle; Mary E. T.,0,16,60,60
1650733974431,COGS 118A,A01,083075,Staff,0,8,60,60
1650733980459,CSE 3,A50,083646,Miranda; Gregory Joseph,18,0,38,20
1650733980459,CSE 3,A51,083647,Miranda; Gregory Joseph,36,0,37,1
1650733986489,CSE 8A,A50,083650,Miranda; Gregory Joseph,0,30,40,40
1650733992512,CSE 11,A01,083080,Cao; Yingjun,0,96,40,40
1650733998541,CSE 12,A01,083652,Staff,0,21,100,100
1650734004569,CSE 15L,A01,083654,Staff,0,3,50,50
1650734004569,CSE 15L,A02,083655,Staff,0,2,50,50
1650734010595,CSE 20,A01,083657,Staff,49,0,80,31
1650734016619,CSE 30,A01,083084,Eldon; John,0,77,40,40
1650734022642,CSE 100,A01,083659,Cao; Yingjun,0,70,50,50
1650734028665,CSE 134B,A01,083661,Powell; Thomas Allan,0,38,65,65
1650734034689,CSE 140,A01,083663,Staff,0,11,75,75
1650734040717,CSE 140L,A01,083088,Eldon; John,0,20,75,75
1650734046749,CSE 175,A01,083665,Kumar; Rakesh,7,0,25,18
1650734052868,CSE 190,A00,092507,Dubnov; Shlomo,10,0,20,10
1650734058897,ECE 45,A01,083139,Staff,1,2,60,59
1650734064923,ECE 65,A50,083695,Staff,0,5,30,30
1650734070949,ECE 109,A01,091882,Touri; Behrouz,33,0,70,37
1650734076976,ECE 180,A00,083140,Abi Samra; Nicholas Camill,20,0,30,10
1650734076976,ECE 180,B00,083141,Abi Samra; Nicholas Camill,0,0,30,30
1650734082998,MATH 10A,A01,083735,Patchell; Gregory David,2,0,30,28
1650734082998,MATH 10A,A02,083736,Patchell; Gregory David,27,0,30,3
1650734082998,MATH 10A,A03,083737,Patchell; Gregory David,24,0,30,6
1650734089024,MATH 10B,A01,083207,Staff,0,9,30,30
1650734089024,MATH 10B,A02,083208,Staff,1,7,30,29
1650734089024,MATH 10B,B01,083739,Staff,11,0,30,19
1650734089024,MATH 10B,B02,083740,Staff,28,0,30,2
1650734095056,MATH 18,A01,083743,Staff,0,0,30,30
1650734095056,MATH 18,A02,083744,Staff,23,0,30,7
1650734095056,MATH 18,A03,083745,Staff,21,0,30,9
1650734095056,MATH 18,A04,083746,Staff,26,0,30,4
1650734095056,MATH 18,B01,083748,Staff,0,15,30,30
1650734095056,MATH 18,B02,083749,Staff,0,12,30,30
1650734095056,MATH 18,B03,083750,Staff,0,12,30,30
1650734095056,MATH 18,B04,083751,Staff,0,12,30,30
1650734101081,MATH 20A,A01,083754,Staff,19,0,40,21
1650734107106,MATH 20B,A01,083756,Staff,0,11,30,30
1650734107106,MATH 20B,A02,083757,Staff,0,12,30,30
1650734113134,MATH 20C,A01,083760,Staff,0,16,30,30
1650734113134,MATH 20C,A02,083761,Staff,0,16,30,30
1650734113134,MATH 20C,B01,083762,Staff,10,0,30,20
1650734113134,MATH 20C,B02,083763,Staff,28,0,30,2
1650734119160,MATH 20D,A01,083765,Staff,2,1,30,28
1650734119160,MATH 20D,A02,083766,Staff,6,0,30,24
1650734119160,MATH 20D,A03,083767,Staff,24,0,30,6
1650734125184,MATH 20E,A01,083771,Staff,3,0,30,27
1650734125184,MATH 20E,A02,083772,Staff,16,0,30,14
1650734125184,MATH 20E,B01,083773,Staff,0,0,30,30
1650734125184,MATH 20E,B02,083774,Staff,6,0,30,24
1650734131214,MATH 103A,A01,083777,Staff,0,15,30,30
1650734131214,MATH 103A,A02,083778,Staff,0,15,30,30
1650734131214,MATH 103A,B01,083779,Staff,0,15,30,30
1650734131214,MATH 103A,B02,083780,Staff,0,15,30,30
1650734137240,MATH 105,A01,085443,Staff,0,22,30,30
1650734143264,MATH 109,A01,083213,Anzaldo; Leesa B,0,7,30,30
1650734143264,MATH 109,A02,083214,Anzaldo; Leesa B,0,7,30,30
1650734143264,MATH 109,B01,083215,Anzaldo; Leesa B,0,8,30,30
1650734143264,MATH 109,B02,083216,Anzaldo; Leesa B,0,6,30,30
1650734149293,MATH 142A,A01,083219,Chow; Bennett,0,16,30,30
1650734149293,MATH 142A,A02,083220,Chow; Bennett,0,15,30,30
1650734149293,MATH 142A,B01,083221,Chow; Bennett,0,15,30,30
1650734149293,MATH 142A,B02,083222,Chow; Bennett,0,14,30,30
1650734155326,MATH 193A,A01,083224,Staff,0,5,30,30
1650734155326,MATH 193A,A02,083225,Staff,0,6,30,30
1650734155326,MATH 193A,A03,083781,Staff,0,6,30,30
1650734155326,MATH 193A,A04,083782,Staff,0,7,30,30
1650734161350,MATH 197,001,091859,McAuley; Julian John,9998,0,9999,1
1650734167411,COGS 9,A01,083615,Staff,1,15,60,59
1650734173436,COGS 11,A01,083617,Boyle; Mary E. T.,16,0,40,24
1650734179462,COGS 13,A01,083071,Staff,0,38,40,40
1650734185486,COGS 14A,A01,092681,Staff,0,35,100,100
1650734191509,COGS 14B,A01,083073,Cheng; Tzu-Han,1,13,50,49
1650734197557,COGS 17,A01,092677,Staff,13,0,75,62
1650734203582,COGS 100,A01,083619,Staff,0,28,60,60
1650734209608,COGS 101A,A01,083621,Davis; Joshua Daniel,0,27,60,60
1650734215634,COGS 101B,A01,091572,Staff,0,4,60,60
1650734221659,COGS 101C,A01,083625,Delgado; Tania,14,0,30,16
1650734227684,COGS 107A,A01,083627,Boyle; Mary E. T.,0,16,60,60
1650734233709,COGS 118A,A01,083075,Staff,0,8,60,60
1650734239738,CSE 3,A50,083646,Miranda; Gregory Joseph,18,0,38,20
1650734239738,CSE 3,A51,083647,Miranda; Gregory Joseph,36,0,37,1
1650734245762,CSE 8A,A50,083650,Miranda; Gregory Joseph,0,30,40,40
1650734251792,CSE 11,A01,083080,Cao; Yingjun,0,96,40,40
1650734257820,CSE 12,A01,083652,Staff,0,21,100,100
1650734263844,CSE 15L,A01,083654,Staff,0,3,50,50
1650734263844,CSE 15L,A02,083655,Staff,0,2,50,50
1650734269871,CSE 20,A01,083657,Staff,49,0,80,31
1650734275894,CSE 30,A01,083084,Eldon; John,0,77,40,40
1650734281920,CSE 100,A01,083659,Cao; Yingjun,0,70,50,50
1650734287944,CSE 134B,A01,083661,Powell; Thomas Allan,0,38,65,65
1650734293970,CSE 140,A01,083663,Staff,0,11,75,75
1650734300002,CSE 140L,A01,083088,Eldon; John,0,20,75,75
1650734306028,CSE 175,A01,083665,Kumar; Rakesh,7,0,25,18
1650734312052,CSE 190,A00,092507,Dubnov; Shlomo,10,0,20,10
1650734318075,ECE 45,A01,083139,Staff,1,2,60,59
1650734324100,ECE 65,A50,083695,Staff,0,5,30,30
1650734330123,ECE 109,A01,091882,Touri; Behrouz,33,0,70,37
1650734336151,ECE 180,A00,083140,Abi Samra; Nicholas Camill,20,0,30,10
1650734336151,ECE 180,B00,083141,Abi Samra; Nicholas Camill,0,0,30,30
1650734342175,MATH 10A,A01,083735,Patchell; Gregory David,2,0,30,28
1650734342175,MATH 10A,A02,083736,Patchell; Gregory David,27,0,30,3
1650734342175,MATH 10A,A03,083737,Patchell; Gregory David,24,0,30,6
1650734348204,MATH 10B,A01,083207,Staff,0,9,30,30
1650734348204,MATH 10B,A02,083208,Staff,1,7,30,29
1650734348204,MATH 10B,B01,083739,Staff,11,0,30,19
1650734348204,MATH 10B,B02,083740,Staff,28,0,30,2
1650734354229,MATH 18,A01,083743,Staff,0,0,30,30
1650734354229,MATH 18,A02,083744,Staff,23,0,30,7
1650734354229,MATH 18,A03,083745,Staff,21,0,30,9
1650734354229,MATH 18,A04,083746,Staff,26,0,30,4
1650734354229,MATH 18,B01,083748,Staff,0,15,30,30
1650734354229,MATH 18,B02,083749,Staff,0,12,30,30
1650734354229,MATH 18,B03,083750,Staff,0,12,30,30
1650734354229,MATH 18,B04,083751,Staff,0,12,30,30
1650734360252,MATH 20A,A01,083754,Staff,19,0,40,21
1650734366280,MATH 20B,A01,083756,Staff,0,11,30,30
1650734366280,MATH 20B,A02,083757,Staff,0,12,30,30
1650734372305,MATH 20C,A01,083760,Staff,0,16,30,30
1650734372305,MATH 20C,A02,083761,Staff,0,16,30,30
1650734372305,MATH 20C,B01,083762,Staff,10,0,30,20
1650734372305,MATH 20C,B02,083763,Staff,28,0,30,2
1650734378330,MATH 20D,A01,083765,Staff,2,1,30,28
1650734378330,MATH 20D,A02,083766,Staff,6,0,30,24
1650734378330,MATH 20D,A03,083767,Staff,24,0,30,6
1650734384354,MATH 20E,A01,083771,Staff,3,0,30,27
1650734384354,MATH 20E,A02,083772,Staff,16,0,30,14
1650734384354,MATH 20E,B01,083773,Staff,0,0,30,30
1650734384354,MATH 20E,B02,083774,Staff,6,0,30,24
1650734390383,MATH 103A,A01,083777,Staff,0,15,30,30
1650734390383,MATH 103A,A02,083778,Staff,0,15,30,30
1650734390383,MATH 103A,B01,083779,Staff,0,15,30,30
1650734390383,MATH 103A,B02,083780,Staff,0,15,30,30
1650734396407,MATH 105,A01,085443,Staff,0,22,30,30
1650734402437,MATH 109,A01,083213,Anzaldo; Leesa B,0,7,30,30
1650734402437,MATH 109,A02,083214,Anzaldo; Leesa B,0,7,30,30
1650734402437,MATH 109,B01,083215,Anzaldo; Leesa B,0,8,30,30
1650734402437,MATH 109,B02,083216,Anzaldo; Leesa B,0,6,30,30
1650734408461,MATH 142A,A01,083219,Chow; Bennett,0,16,30,30
1650734408461,MATH 142A,A02,083220,Chow; Bennett,0,15,30,30
1650734408461,MATH 142A,B01,083221,Chow; Bennett,0,15,30,30
1650734408461,MATH 142A,B02,083222,Chow; Bennett,0,14,30,30
1650734414487,MATH 193A,A01,083224,Staff,0,5,30,30
1650734414487,MATH 193A,A02,083225,Staff,0,6,30,30
1650734414487,MATH 193A,A03,083781,Staff,0,6,30,30
1650734414487,MATH 193A,A04,083782,Staff,0,7,30,30
1650734420511,MATH 197,001,091859,McAuley; Julian John,9998,0,9999,1
1650734426572,COGS 9,A01,083615,Staff,1,15,60,59
1650734432594,COGS 11,A01,083617,Boyle; Mary E. T.,16,0,40,24
1650734438621,COGS 13,A01,083071,Staff,0,38,40,40
1650734444648,COGS 14A,A01,092681,Staff,0,35,100,100
1650734450675,COGS 14B,A01,083073,Cheng; Tzu-Han,1,13,50,49
1650734456706,COGS 17,A01,092677,Staff,13,0,75,62
1650734462734,COGS 100,A01,083619,Staff,0,28,60,60
1650734468765,COGS 101A,A01,083621,Davis; Joshua Daniel,0,27,60,60
1650734474792,COGS 101B,A01,091572,Staff,0,4,60,60
1650734480817,COGS 101C,A01,083625,Delgado; Tania,14,0,30,16
1650734486839,COGS 107A,A01,083627,Boyle; Mary E. T.,0,16,60,60
1650734492866,COGS 118A,A01,083075,Staff,0,8,60,60
1650734498893,CSE 3,A50,083646,Miranda; Gregory Joseph,18,0,38,20
1650734498893,CSE 3,A51,083647,Miranda; Gregory Joseph,36,0,37,1
1650734504917,CSE 8A,A50,083650,Miranda; Gregory Joseph,0,30,40,40
1650734510941,CSE 11,A01,083080,Cao; Yingjun,0,96,40,40
1650734516968,CSE 12,A01,083652,Staff,0,21,100,100
1650734522992,CSE 15L,A01,083654,Staff,0,3,50,50
1650734522992,CSE 15L,A02,083655,Staff,0,2,50,50
1650734529030,CSE 20,A01,083657,Staff,49,0,80,31
1650734535058,CSE 30,A01,083084,Eldon; John,0,77,40,40
1650734541083,CSE 100,A01,083659,Cao; Yingjun,0,70,50,50
1650734547108,CSE 134B,A01,083661,Powell; Thomas Allan,0,38,65,65
1650734553133,CSE 140,A01,083663,Staff,0,11,75,75
1650734559160,CSE 140L,A01,083088,Eldon; John,0,20,75,75
1650734565186,CSE 175,A01,083665,Kumar; Rakesh,7,0,25,18
1650734571212,CSE 190,A00,092507,Dubnov; Shlomo,10,0,20,10
1650734577234,ECE 45,A01,083139,Staff,1,2,60,59
1650734583262,ECE 65,A50,083695,Staff,0,5,30,30
1650734589289,ECE 109,A01,091882,Touri; Behrouz,33,0,70,37
1650734595317,ECE 180,A00,083140,Abi Samra; Nicholas Camill,20,0,30,10
1650734595317,ECE 180,B00,083141,Abi Samra; Nicholas Camill,0,0,30,30
1650734601340,MATH 10A,A01,083735,Patchell; Gregory David,2,0,30,28
1650734601340,MATH 10A,A02,083736,Patchell; Gregory David,27,0,30,3
1650734601340,MATH 10A,A03,083737,Patchell; Gregory David,24,0,30,6
1650734607363,MATH 10B,A01,083207,Staff,0,9,30,30
1650734607363,MATH 10B,A02,083208,Staff,1,7,30,29
1650734607363,MATH 10B,B01,083739,Staff,11,0,30,19
1650734607363,MATH 10B,B02,083740,Staff,28,0,30,2
1650734613389,MATH 18,A01,083743,Staff,0,0,30,30
1650734613389,MATH 18,A02,083744,Staff,23,0,30,7
1650734613389,MATH 18,A03,083745,Staff,21,0,30,9
1650734613389,MATH 18,A04,083746,Staff,26,0,30,4
1650734613389,MATH 18,B01,083748,Staff,0,15,30,30
1650734613389,MATH 18,B02,083749,Staff,0,12,30,30
1650734613389,MATH 18,B03,083750,Staff,0,12,30,30
1650734613389,MATH 18,B04,083751,Staff,0,12,30,30
1650734619414,MATH 20A,A01,083754,Staff,19,0,40,21
1650734625443,MATH 20B,A01,083756,Staff,0,11,30,30
1650734625443,MATH 20B,A02,083757,Staff,0,12,30,30
1650734631470,MATH 20C,A01,083760,Staff,0,16,30,30
1650734631470,MATH 20C,A02,083761,Staff,0,16,30,30
1650734631470,MATH 20C,B01,083762,Staff,10,0,30,20
1650734631470,MATH 20C,B02,083763,Staff,28,0,30,2
1650734637497,MATH 20D,A01,083765,Staff,2,1,30,28
1650734637497,MATH 20D,A02,083766,Staff,6,0,30,24
1650734637497,MATH 20D,A03,083767,Staff,24,0,30,6
1650734643527,MATH 20E,A01,083771,Staff,3,0,30,27
1650734643527,MATH 20E,A02,083772,Staff,16,0,30,14
1650734643527,MATH 20E,B01,083773,Staff,0,0,30,30
1650734643527,MATH 20E,B02,083774,Staff,6,0,30,24
1650734649645,MATH 103A,A01,083777,Staff,0,15,30,30
1650734649645,MATH 103A,A02,083778,Staff,0,15,30,30
1650734649645,MATH 103A,B01,083779,Staff,0,15,30,30
1650734649645,MATH 103A,B02,083780,Staff,0,15,30,30
1650734655676,MATH 105,A01,085443,Staff,0,22,30,30
1650734661700,MATH 109,A01,083213,Anzaldo; Leesa B,0,7,30,30
1650734661700,MATH 109,A02,083214,Anzaldo; Leesa B,0,7,30,30
1650734661700,MATH 109,B01,083215,Anzaldo; Leesa B,0,8,30,30
1650734661700,MATH 109,B02,083216,Anzaldo; Leesa B,0,6,30,30
1650734667725,MATH 142A,A01,083219,Chow; Bennett,0,16,30,30
1650734667725,MATH 142A,A02,083220,Chow; Bennett,0,15,30,30
1650734667725,MATH 142A,B01,083221,Chow; Bennett,0,15,30,30
1650734667725,MATH 142A,B02,083222,Chow; Bennett,0,14,30,30
1650734673747,MATH 193A,A01,083224,Staff,0,5,30,30
1650734673747,MATH 193A,A02,083225,Staff,0,6,30,30
1650734673747,MATH 193A,A03,083781,Staff,0,6,30,30
1650734673747,MATH 193A,A04,083782,Staff,0,7,30,30
1650734679772,MATH 197,001,091859,McAuley; Julian John,9998,0,9999,1
1650734685840,COGS 9,A01,083615,Staff,1,15,60,59
1650734691867,COGS 11,A01,083617,Boyle; Mary E. T.,16,0,40,24
1650734697892,COGS 13,A01,083071,Staff,0,38,40,40
1650734703916,COGS 14A,A01,092681,Staff,0,35,100,100
1650734709944,COGS 14B,A01,083073,Cheng; Tzu-Han,1,13,50,49
1650734715970,COGS 17,A01,092677,Staff,13,0,75,62
1650734721993,COGS 100,A01,083619,Staff,0,28,60,60
1650734728018,COGS 101A,A01,083621,Davis; Joshua Daniel,0,27,60,60
1650734734046,COGS 101B,A01,091572,Staff,0,4,60,60
1650734740069,COGS 101C,A01,083625,Delgado; Tania,14,0,30,16
1650734746097,COGS 107A,A01,083627,Boyle; Mary E. T.,0,16,60,60
1650734752120,COGS 118A,A01,083075,Staff,0,8,60,60
1650734758151,CSE 3,A50,083646,Miranda; Gregory Joseph,18,0,38,20
1650734758151,CSE 3,A51,083647,Miranda; Gregory Joseph,36,0,37,1
1650734764178,CSE 8A,A50,083650,Miranda; Gregory Joseph,0,30,40,40
1650734770205,CSE 11,A01,083080,Cao; Yingjun,0,96,40,40
1650734776233,CSE 12,A01,083652,Staff,0,21,100,100
1650734782260,CSE 15L,A01,083654,Staff,0,3,50,50
1650734782260,CSE 15L,A02,083655,Staff,0,2,50,50
1650734788282,CSE 20,A01,083657,Staff,49,0,80,31
1650734794306,CSE 30,A01,083084,Eldon; John,0,77,40,40
1650734800330,CSE 100,A01,083659,Cao; Yingjun,0,70,50,50
1650734806355,CSE 134B,A01,083661,Powell; Thomas Allan,0,38,65,65
1650734812382,CSE 140,A01,083663,Staff,0,11,75,75
1650734818412,CSE 140L,A01,083088,Eldon; John,0,20,75,75
1650734824436,CSE 175,A01,083665,Kumar; Rakesh,7,0,25,18
1650734830463,CSE 190,A00,092507,Dubnov; Shlomo,10,0,20,10
1650734836489,ECE 45,A01,083139,Staff,1,2,60,59
1650734842516,ECE 65,A50,083695,Staff,0,5,30,30
1650734848543,ECE 109,A01,091882,Touri; Behrouz,33,0,70,37
1650734854584,ECE 180,A00,083140,Abi Samra; Nicholas Camill,20,0,30,10
1650734854584,ECE 180,B00,083141,Abi Samra; Nicholas Camill,0,0,30,30
1650734860612,MATH 10A,A01,083735,Patchell; Gregory David,2,0,30,28
1650734860612,MATH 10A,A02,083736,Patchell; Gregory David,27,0,30,3
1650734860612,MATH 10A,A03,083737,Patchell; Gregory David,24,0,30,6
1650734866637,MATH 10B,A01,083207,Staff,0,9,30,30
1650734866637,MATH 10B,A02,083208,Staff,1,7,30,29
1650734866637,MATH 10B,B01,083739,Staff,11,0,30,19
1650734866637,MATH 10B,B02,083740,Staff,28,0,30,2
1650734872671,MATH 18,A01,083743,Staff,0,0,30,30
1650734872671,MATH 18,A02,083744,Staff,23,0,30,7
1650734872671,MATH 18,A03,083745,Staff,21,0,30,9
1650734872671,MATH 18,A04,083746,Staff,26,0,30,4
1650734872671,MATH 18,B01,083748,Staff,0,15,30,30
1650734872671,MATH 18,B02,083749,Staff,0,12,30,30
1650734872671,MATH 18,B03,083750,Staff,0,12,30,30
1650734872671,MATH 18,B04,083751,Staff,0,12,30,30
1650734878697,MATH 20A,A01,083754,Staff,19,0,40,21
1650734884721,MATH 20B,A01,083756,Staff,0,11,30,30
1650734884721,MATH 20B,A02,083757,Staff,0,12,30,30
1650734890745,MATH 20C,A01,083760,Staff,0,16,30,30
1650734890745,MATH 20C,A02,083761,Staff,0,16,30,30
1650734890745,MATH 20C,B01,083762,Staff,10,0,30,20
1650734890745,MATH 20C,B02,083763,Staff,28,0,30,2
1650734896773,MATH 20D,A01,083765,Staff,2,1,30,28
1650734896773,MATH 20D,A02,083766,Staff,6,0,30,24
1650734896773,MATH 20D,A03,083767,Staff,24,0,30,6
1650734902801,MATH 20E,A01,083771,Staff,3,0,30,27
1650734902801,MATH 20E,A02,083772,Staff,16,0,30,14
1650734902801,MATH 20E,B01,083773,Staff,0,0,30,30
1650734902801,MATH 20E,B02,083774,Staff,6,0,30,24
1650734908826,MATH 103A,A01,083777,Staff,0,15,30,30
1650734908826,MATH 103A,A02,083778,Staff,0,15,30,30
1650734908826,MATH 103A,B01,083779,Staff,0,15,30,30
1650734908826,MATH 103A,B02,083780,Staff,0,15,30,30
1650734914851,MATH 105,A01,085443,Staff,0,22,30,30
1650734920876,MATH 109,A01,083213,Anzaldo; Leesa B,0,7,30,30
1650734920876,MATH 109,A02,083214,Anzaldo; Leesa B,0,7,30,30
1650734920876,MATH 109,B01,083215,Anzaldo; Leesa B,0,8,30,30
1650734920876,MATH 109,B02,083216,Anzaldo; Leesa B,0,6,30,30
1650734926905,MATH 142A,A01,083219,Chow; Bennett,0,16,30,30
1650734926905,MATH 142A,A02,083220,Chow; Bennett,0,15,30,30
1650734926905,MATH 142A,B01,083221,Chow; Bennett,0,15,30,30
1650734926905,MATH 142A,B02,083222,Chow; Bennett,0,14,30,30
1650734932933,MATH 193A,A01,083224,Staff,0,5,30,30
1650734932933,MATH 193A,A02,083225,Staff,0,6,30,30
1650734932933,MATH 193A,A03,083781,Staff,0,6,30,30
1650734932933,MATH 193A,A04,083782,Staff,0,7,30,30
1650734938957,MATH 197,001,091859,McAuley; Julian John,9998,0,9999,1
1650734945011,COGS 9,A01,083615,Staff,1,15,60,59
1650734951034,COGS 11,A01,083617,Boyle; Mary E. T.,16,0,40,24
1650734957061,COGS 13,A01,083071,Staff,0,38,40,40
1650734963088,COGS 14A,A01,092681,Staff,0,35,100,100
1650734969111,COGS 14B,A01,083073,Cheng; Tzu-Han,1,13,50,49
1650734975135,COGS 17,A01,092677,Staff,13,0,75,62
1650734981163,COGS 100,A01,083619,Staff,0,28,60,60
1650734987188,COGS 101A,A01,083621,Davis; Joshua Daniel,0,27,60,60
1650734993217,COGS 101B,A01,091572,Staff,0,4,60,60
1650734999246,COGS 101C,A01,083625,Delgado; Tania,14,0,30,16
1650735005276,COGS 107A,A01,083627,Boyle; Mary E. T.,0,16,60,60
1650735011302,COGS 118A,A01,083075,Staff,0,8,60,60
1650735017327,CSE 3,A50,083646,Miranda; Gregory Joseph,18,0,38,20
1650735017327,CSE 3,A51,083647,Miranda; Gregory Joseph,36,0,37,1
1650735023352,CSE 8A,A50,083650,Miranda; Gregory Joseph,0,30,40,40
1650735029377,CSE 11,A01,083080,Cao; Yingjun,0,96,40,40
1650735035400,CSE 12,A01,083652,Staff,0,21,100,100
1650735041424,CSE 15L,A01,083654,Staff,0,3,50,50
1650735041424,CSE 15L,A02,083655,Staff,0,2,50,50
1650735047450,CSE 20,A01,083657,Staff,49,0,80,31
1650735053472,CSE 30,A01,083084,Eldon; John,0,77,40,40
1650735059510,CSE 100,A01,083659,Cao; Yingjun,0,70,50,50
1650735065540,CSE 134B,A01,083661,Powell; Thomas Allan,0,38,65,65
1650735071564,CSE 140,A01,083663,Staff,0,11,75,75
1650735077589,CSE 140L,A01,083088,Eldon; John,0,20,75,75
1650735083616,CSE 175,A01,083665,Kumar; Rakesh,7,0,25,18
1650735089641,CSE 190,A00,092507,Dubnov; Shlomo,10,0,20,10
1650735095665,ECE 45,A01,083139,Staff,1,2,60,59
1650735101699,ECE 65,A50,083695,Staff,0,5,30,30
1650735107725,ECE 109,A01,091882,Touri; Behrouz,33,0,70,37
1650735113753,ECE 180,A00,083140,Abi Samra; Nicholas Camill,20,0,30,10
1650735113753,ECE 180,B00,083141,Abi Samra; Nicholas Camill,0,0,30,30
1650735119780,MATH 10A,A01,083735,Patchell; Gregory David,2,0,30,28
1650735119780,MATH 10A,A02,083736,Patchell; Gregory David,27,0,30,3
1650735119780,MATH 10A,A03,083737,Patchell; Gregory David,24,0,30,6
1650735125811,MATH 10B,A01,083207,Staff,0,9,30,30
1650735125811,MATH 10B,A02,083208,Staff,1,7,30,29
1650735125811,MATH 10B,B01,083739,Staff,11,0,30,19
1650735125811,MATH 10B,B02,083740,Staff,28,0,30,2
1650735131837,MATH 18,A01,083743,Staff,0,0,30,30
1650735131837,MATH 18,A02,083744,Staff,23,0,30,7
1650735131837,MATH 18,A03,083745,Staff,21,0,30,9
1650735131837,MATH 18,A04,083746,Staff,26,0,30,4
1650735131837,MATH 18,B01,083748,Staff,0,15,30,30
1650735131837,MATH 18,B02,083749,Staff,0,12,30,30
1650735131837,MATH 18,B03,083750,Staff,0,12,30,30
1650735131837,MATH 18,B04,083751,Staff,0,12,30,30
1650735137862,MATH 20A,A01,083754,Staff,19,0,40,21
1650735143886,MATH 20B,A01,083756,Staff,0,11,30,30
1650735143886,MATH 20B,A02,083757,Staff,0,12,30,30
1650735149910,MATH 20C,A01,083760,Staff,0,16,30,30
1650735149910,MATH 20C,A02,083761,Staff,0,16,30,30
1650735149910,MATH 20C,B01,083762,Staff,10,0,30,20
1650735149910,MATH 20C,B02,083763,Staff,28,0,30,2
1650735155935,MATH 20D,A01,083765,Staff,2,1,30,28
1650735155935,MATH 20D,A02,083766,Staff,6,0,30,24
1650735155935,MATH 20D,A03,083767,Staff,24,0,30,6
1650735161964,MATH 20E,A01,083771,Staff,3,0,30,27
1650735161964,MATH 20E,A02,083772,Staff,16,0,30,14
1650735161964,MATH 20E,B01,083773,Staff,0,0,30,30
1650735161964,MATH 20E,B02,083774,Staff,6,0,30,24
1650735167989,MATH 103A,A01,083777,Staff,0,15,30,30
1650735167989,MATH 103A,A02,083778,Staff,0,15,30,30
1650735167989,MATH 103A,B01,083779,Staff,0,15,30,30
1650735167989,MATH 103A,B02,083780,Staff,0,15,30,30
1650735174016,MATH 105,A01,085443,Staff,0,22,30,30
1650735180039,MATH 109,A01,083213,Anzaldo; Leesa B,0,7,30,30
1650735180039,MATH 109,A02,083214,Anzaldo; Leesa B,0,7,30,30
1650735180039,MATH 109,B01,083215,Anzaldo; Leesa B,0,8,30,30
1650735180039,MATH 109,B02,083216,Anzaldo; Leesa B,0,6,30,30
1650735186066,MATH 142A,A01,083219,Chow; Bennett,0,16,30,30
1650735186066,MATH 142A,A02,083220,Chow; Bennett,0,15,30,30
1650735186066,MATH 142A,B01,083221,Chow; Bennett,0,15,30,30
1650735186066,MATH 142A,B02,083222,Chow; Bennett,0,14,30,30
1650735192089,MATH 193A,A01,083224,Staff,0,5,30,30
1650735192089,MATH 193A,A02,083225,Staff,0,6,30,30
1650735192089,MATH 193A,A03,083781,Staff,0,6,30,30
1650735192089,MATH 193A,A04,083782,Staff,0,7,30,30
1650735198113,MATH 197,001,091859,McAuley; Julian John,9998,0,9999,1
1650735204166,COGS 9,A01,083615,Staff,1,15,60,59
1650735210189,COGS 11,A01,083617,Boyle; Mary E. T.,16,0,40,24
1650735216215,COGS 13,A01,083071,Staff,0,38,40,40
1650735222241,COGS 14A,A01,092681,Staff,0,35,100,100
1650735228269,COGS 14B,A01,083073,Cheng; Tzu-Han,1,13,50,49
1650735234298,COGS 17,A01,092677,Staff,13,0,75,62
1650735240398,COGS 100,A01,083619,Staff,0,28,60,60
1650735246427,COGS 101A,A01,083621,Davis; Joshua Daniel,0,27,60,60
1650735252452,COGS 101B,A01,091572,Staff,0,4,60,60
1650735258483,COGS 101C,A01,083625,Delgado; Tania,14,0,30,16
1650735264508,COGS 107A,A01,083627,Boyle; Mary E. T.,0,16,60,60
1650735270545,COGS 118A,A01,083075,Staff,0,8,60,60
1650735276570,CSE 3,A50,083646,Miranda; Gregory Joseph,18,0,38,20
1650735276570,CSE 3,A51,083647,Miranda; Gregory Joseph,36,0,37,1
1650735282596,CSE 8A,A50,083650,Miranda; Gregory Joseph,0,30,40,40
1650735288621,CSE 11,A01,083080,Cao; Yingjun,0,96,40,40
1650735294647,CSE 12,A01,083652,Staff,0,21,100,100
1650735300671,CSE 15L,A01,083654,Staff,0,3,50,50
1650735300671,CSE 15L,A02,083655,Staff,0,2,50,50
1650735306694,CSE 20,A01,083657,Staff,49,0,80,31
1650735312719,CSE 30,A01,083084,Eldon; John,0,77,40,40
1650735318742,CSE 100,A01,083659,Cao; Yingjun,0,70,50,50
1650735324766,CSE 134B,A01,083661,Powell; Thomas Allan,0,38,65,65
1650735330791,CSE 140,A01,083663,Staff,0,11,75,75
1650735336814,CSE 140L,A01,083088,Eldon; John,0,20,75,75
1650735342854,CSE 175,A01,083665,Kumar; Rakesh,7,0,25,18
1650735348882,CSE 190,A00,092507,Dubnov; Shlomo,10,0,20,10
1650735354906,ECE 45,A01,083139,Staff,1,2,60,59
1650735360929,ECE 65,A50,083695,Staff,0,5,30,30
1650735366954,ECE 109,A01,091882,Touri; Behrouz,33,0,70,37
1650735372977,ECE 180,A00,083140,Abi Samra; Nicholas Camill,20,0,30,10
1650735372977,ECE 180,B00,083141,Abi Samra; Nicholas Camill,0,0,30,30
1650735379001,MATH 10A,A01,083735,Patchell; Gregory David,2,0,30,28
1650735379001,MATH 10A,A02,083736,Patchell; Gregory David,27,0,30,3
1650735379001,MATH 10A,A03,083737,Patchell; Gregory David,24,0,30,6
1650735385033,MATH 10B,A01,083207,Staff,0,9,30,30
1650735385033,MATH 10B,A02,083208,Staff,1,7,30,29
1650735385033,MATH 10B,B01,083739,Staff,11,0,30,19
1650735385033,MATH 10B,B02,083740,Staff,28,0,30,2
1650735391061,MATH 18,A01,083743,Staff,0,0,30,30
1650735391061,MATH 18,A02,083744,Staff,23,0,30,7
1650735391061,MATH 18,A03,083745,Staff,21,0,30,9
1650735391061,MATH 18,A04,083746,Staff,26,0,30,4
1650735391061,MATH 18,B01,083748,Staff,0,15,30,30
1650735391061,MATH 18,B02,083749,Staff,0,12,30,30
1650735391061,MATH 18,B03,083750,Staff,0,12,30,30
1650735391061,MATH 18,B04,083751,Staff,0,12,30,30
1650735397086,MATH 20A,A01,083754,Staff,19,0,40,21
1650735403115,MATH 20B,A01,083756,Staff,0,11,30,30
1650735403115,MATH 20B,A02,083757,Staff,0,12,30,30
1650735409141,MATH 20C,A01,083760,Staff,0,16,30,30
1650735409141,MATH 20C,A02,083761,Staff,0,16,30,30
1650735409141,MATH 20C,B01,083762,Staff,10,0,30,20
1650735409141,MATH 20C,B02,083763,Staff,28,0,30,2
1650735415164,MATH 20D,A01,083765,Staff,2,1,30,28
1650735415164,MATH 20D,A02,083766,Staff,6,0,30,24
1650735415164,MATH 20D,A03,083767,Staff,24,0,30,6
1650735421192,MATH 20E,A01,083771,Staff,3,0,30,27
1650735421192,MATH 20E,A02,083772,Staff,16,0,30,14
1650735421192,MATH 20E,B01,083773,Staff,0,0,30,30
1650735421192,MATH 20E,B02,083774,Staff,6,0,30,24
1650735427219,MATH 103A,A01,083777,Staff,0,15,30,30
1650735427219,MATH 103A,A02,083778,Staff,0,15,30,30
1650735427219,MATH 103A,B01,083779,Staff,0,15,30,30
1650735427219,MATH 103A,B02,083780,Staff,0,15,30,30
1650735433242,MATH 105,A01,085443,Staff,0,22,30,30
1650735439264,MATH 109,A01,083213,Anzaldo; Leesa B,0,7,30,30
1650735439264,MATH 109,A02,083214,Anzaldo; Leesa B,0,7,30,30
1650735439264,MATH 109,B01,083215,Anzaldo; Leesa B,0,8,30,30
1650735439264,MATH 109,B02,083216,Anzaldo; Leesa B,0,6,30,30
1650735445288,MATH 142A,A01,083219,Chow; Bennett,0,16,30,30
1650735445288,MATH 142A,A02,083220,Chow; Bennett,0,15,30,30
1650735445288,MATH 142A,B01,083221,Chow; Bennett,0,15,30,30
1650735445288,MATH 142A,B02,083222,Chow; Bennett,0,14,30,30
1650735451317,MATH 193A,A01,083224,Staff,0,5,30,30
1650735451317,MATH 193A,A02,083225,Staff,0,6,30,30
1650735451317,MATH 193A,A03,083781,Staff,0,6,30,30
1650735451317,MATH 193A,A04,083782,Staff,0,7,30,30
1650735457341,MATH 197,001,091859,McAuley; Julian John,9998,0,9999,1
1650735463409,COGS 9,A01,083615,Staff,1,15,60,59
1650735469435,COGS 11,A01,083617,Boyle; Mary E. T.,16,0,40,24
1650735475458,COGS 13,A01,083071,Staff,0,38,40,40
1650735481482,COGS 14A,A01,092681,Staff,0,35,100,100
1650735487509,COGS 14B,A01,083073,Cheng; Tzu-Han,1,13,50,49
1650735493535,COGS 17,A01,092677,Staff,13,0,75,62
1650735499559,COGS 100,A01,083619,Staff,0,28,60,60
1650735505582,COGS 101A,A01,083621,Davis; Joshua Daniel,0,27,60,60
1650735511612,COGS 101B,A01,091572,Staff,0,4,60,60
1650735517637,COGS 101C,A01,083625,Delgado; Tania,14,0,30,16
1650735523664,COGS 107A,A01,083627,Boyle; Mary E. T.,0,16,60,60
1650735529688,COGS 118A,A01,083075,Staff,0,8,60,60
1650735535712,CSE 3,A50,083646,Miranda; Gregory Joseph,18,0,38,20
1650735535712,CSE 3,A51,083647,Miranda; Gregory Joseph,36,0,37,1
1650735541739,CSE 8A,A50,083650,Miranda; Gregory Joseph,0,30,40,40
1650735547763,CSE 11,A01,083080,Cao; Yingjun,0,96,40,40
1650735553788,CSE 12,A01,083652,Staff,0,21,100,100
1650735559816,CSE 15L,A01,083654,Staff,0,3,50,50
1650735559816,CSE 15L,A02,083655,Staff,0,2,50,50
1650735565841,CSE 20,A01,083657,Staff,49,0,80,31
1650735571869,CSE 30,A01,083084,Eldon; John,0,77,40,40
1650735577892,CSE 100,A01,083659,Cao; Yingjun,0,70,50,50
1650735583915,CSE 134B,A01,083661,Powell; Thomas Allan,0,38,65,65
1650735589941,CSE 140,A01,083663,Staff,0,11,75,75
1650735595964,CSE 140L,A01,083088,Eldon; John,0,20,75,75
1650735601988,CSE 175,A01,083665,Kumar; Rakesh,7,0,25,18
1650735608011,CSE 190,A00,092507,Dubnov; Shlomo,10,0,20,10
1650735614038,ECE 45,A01,083139,Staff,1,2,60,59
1650735620064,ECE 65,A50,083695,Staff,0,5,30,30
1650735626092,ECE 109,A01,091882,Touri; Behrouz,33,0,70,37
1650735632118,ECE 180,A00,083140,Abi Samra; Nicholas Camill,20,0,30,10
1650735632118,ECE 180,B00,083141,Abi Samra; Nicholas Camill,0,0,30,30
1650735638141,MATH 10A,A01,083735,Patchell; Gregory David,2,0,30,28
1650735638141,MATH 10A,A02,083736,Patchell; Gregory David,27,0,30,3
1650735638141,MATH 10A,A03,083737,Patchell; Gregory David,24,0,30,6
1650735644164,MATH 10B,A01,083207,Staff,0,9,30,30
1650735644164,MATH 10B,A02,083208,Staff,1,7,30,29
1650735644164,MATH 10B,B01,083739,Staff,11,0,30,19
1650735644164,MATH 10B,B02,083740,Staff,28,0,30,2
1650735650188,MATH 18,A01,083743,Staff,0,0,30,30
1650735650188,MATH 18,A02,083744,Staff,23,0,30,7
1650735650188,MATH 18,A03,083745,Staff,21,0,30,9
1650735650188,MATH 18,A04,083746,Staff,26,0,30,4
1650735650188,MATH 18,B01,083748,Staff,0,15,30,30
1650735650188,MATH 18,B02,083749,Staff,0,12,30,30
1650735650188,MATH 18,B03,083750,Staff,0,12,30,30
1650735650188,MATH 18,B04,083751,Staff,0,12,30,30
1650735656215,MATH 20A,A01,083754,Staff,19,0,40,21
1650735662244,MATH 20B,A01,083756,Staff,0,11,30,30
1650735662244,MATH 20B,A02,083757,Staff,0,12,30,30
1650735668269,MATH 20C,A01,083760,Staff,0,16,30,30
1650735668269,MATH 20C,A02,083761,Staff,0,16,30,30
1650735668269,MATH 20C,B01,083762,Staff,10,0,30,20
1650735668269,MATH 20C,B02,083763,Staff,28,0,30,2
1650735674294,MATH 20D,A01,083765,Staff,2,1,30,28
1650735674294,MATH 20D,A02,083766,Staff,6,0,30,24
1650735674294,MATH 20D,A03,083767,Staff,24,0,30,6
1650735680319,MATH 20E,A01,083771,Staff,3,0,30,27
1650735680319,MATH 20E,A02,083772,Staff,16,0,30,14
1650735680319,MATH 20E,B01,083773,Staff,0,0,30,30
1650735680319,MATH 20E,B02,083774,Staff,6,0,30,24
1650735686347,MATH 103A,A01,083777,Staff,0,16,30,30
1650735686347,MATH 103A,A02,083778,Staff,0,15,30,30
1650735686347,MATH 103A,B01,083779,Staff,0,15,30,30
1650735686347,MATH 103A,B02,083780,Staff,0,15,30,30
1650735692373,MATH 105,A01,085443,Staff,0,22,30,30
1650735698396,MATH 109,A01,083213,Anzaldo; Leesa B,0,7,30,30
1650735698396,MATH 109,A02,083214,Anzaldo; Leesa B,0,7,30,30
1650735698396,MATH 109,B01,083215,Anzaldo; Leesa B,0,8,30,30
1650735698396,MATH 109,B02,083216,Anzaldo; Leesa B,0,6,30,30
1650735704426,MATH 142A,A01,083219,Chow; Bennett,0,16,30,30
1650735704426,MATH 142A,A02,083220,Chow; Bennett,0,15,30,30
1650735704426,MATH 142A,B01,083221,Chow; Bennett,0,15,30,30
1650735704426,MATH 142A,B02,083222,Chow; Bennett,0,14,30,30
1650735710449,MATH 193A,A01,083224,Staff,0,5,30,30
1650735710449,MATH 193A,A02,083225,Staff,0,6,30,30
1650735710449,MATH 193A,A03,083781,Staff,0,6,30,30
1650735710449,MATH 193A,A04,083782,Staff,0,7,30,30
1650735716475,MATH 197,001,091859,McAuley; Julian John,9998,0,9999,1
1650735722534,COGS 9,A01,083615,Staff,1,15,60,59
1650735728557,COGS 11,A01,083617,Boyle; Mary E. T.,16,0,40,24
1650735734583,COGS 13,A01,083071,Staff,0,38,40,40
1650735740612,COGS 14A,A01,092681,Staff,0,35,100,100
1650735746640,COGS 14B,A01,083073,Cheng; Tzu-Han,1,13,50,49
1650735752666,COGS 17,A01,092677,Staff,13,0,75,62
1650735758689,COGS 100,A01,083619,Staff,0,28,60,60
1650735764712,COGS 101A,A01,083621,Davis; Joshua Daniel,0,27,60,60
1650735770735,COGS 101B,A01,091572,Staff,0,4,60,60
1650735776757,COGS 101C,A01,083625,Delgado; Tania,14,0,30,16
1650735782782,COGS 107A,A01,083627,Boyle; Mary E. T.,0,16,60,60
1650735788813,COGS 118A,A01,083075,Staff,0,8,60,60
1650735794835,CSE 3,A50,083646,Miranda; Gregory Joseph,18,0,38,20
1650735794835,CSE 3,A51,083647,Miranda; Gregory Joseph,36,0,37,1
1650735800867,CSE 8A,A50,083650,Miranda; Gregory Joseph,0,30,40,40
1650735806894,CSE 11,A01,083080,Cao; Yingjun,0,96,40,40
1650735812917,CSE 12,A01,083652,Staff,0,21,100,100
1650735818939,CSE 15L,A01,083654,Staff,0,3,50,50
1650735818939,CSE 15L,A02,083655,Staff,0,2,50,50
1650735824963,CSE 20,A01,083657,Staff,49,0,80,31
1650735830986,CSE 30,A01,083084,Eldon; John,0,77,40,40
1650735837100,CSE 100,A01,083659,Cao; Yingjun,0,70,50,50
1650735843132,CSE 134B,A01,083661,Powell; Thomas Allan,0,38,65,65
1650735849154,CSE 140,A01,083663,Staff,0,11,75,75
1650735855178,CSE 140L,A01,083088,Eldon; John,0,20,75,75
1650735861203,CSE 175,A01,083665,Kumar; Rakesh,7,0,25,18
1650735867227,CSE 190,A00,092507,Dubnov; Shlomo,10,0,20,10
1650735873248,ECE 45,A01,083139,Staff,1,2,60,59
1650735879274,ECE 65,A50,083695,Staff,0,5,30,30
1650735885301,ECE 109,A01,091882,Touri; Behrouz,33,0,70,37
1650735900293,ECE 180,A00,083140,Abi Samra; Nicholas Camill,20,0,30,10
1650735900293,ECE 180,B00,083141,Abi Samra; Nicholas Camill,0,0,30,30
1650735906315,MATH 10A,A01,083735,Patchell; Gregory David,2,0,30,28
1650735906315,MATH 10A,A02,083736,Patchell; Gregory David,27,0,30,3
1650735906315,MATH 10A,A03,083737,Patchell; Gregory David,24,0,30,6
1650735912338,MATH 10B,A01,083207,Staff,0,9,30,30
1650735912338,MATH 10B,A02,083208,Staff,1,7,30,29
1650735912338,MATH 10B,B01,083739,Staff,11,0,30,19
1650735912338,MATH 10B,B02,083740,Staff,28,0,30,2
1650735918369,MATH 18,A01,083743,Staff,0,0,30,30
1650735918369,MATH 18,A02,083744,Staff,23,0,30,7
1650735918369,MATH 18,A03,083745,Staff,21,0,30,9
1650735918369,MATH 18,A04,083746,Staff,26,0,30,4
1650735918369,MATH 18,B01,083748,Staff,0,15,30,30
1650735918369,MATH 18,B02,083749,Staff,0,12,30,30
1650735918369,MATH 18,B03,083750,Staff,0,12,30,30
1650735918369,MATH 18,B04,083751,Staff,0,12,30,30
1650735924396,MATH 20A,A01,083754,Staff,19,0,40,21
1650735930418,MATH 20B,A01,083756,Staff,0,11,30,30
1650735930418,MATH 20B,A02,083757,Staff,0,12,30,30
1650735936452,MATH 20C,A01,083760,Staff,0,16,30,30
1650735936452,MATH 20C,A02,083761,Staff,0,16,30,30
1650735936452,MATH 20C,B01,083762,Staff,10,0,30,20
1650735936452,MATH 20C,B02,083763,Staff,28,0,30,2
1650735942475,MATH 20D,A01,083765,Staff,2,1,30,28
1650735942475,MATH 20D,A02,083766,Staff,6,0,30,24
1650735942475,MATH 20D,A03,083767,Staff,24,0,30,6
1650735948497,MATH 20E,A01,083771,Staff,3,0,30,27
1650735948497,MATH 20E,A02,083772,Staff,16,0,30,14
1650735948497,MATH 20E,B01,083773,Staff,0,0,30,30
1650735948497,MATH 20E,B02,083774,Staff,6,0,30,24
1650735954520,MATH 103A,A01,083777,Staff,0,16,30,30
1650735954520,MATH 103A,A02,083778,Staff,0,15,30,30
1650735954520,MATH 103A,B01,083779,Staff,0,15,30,30
1650735954520,MATH 103A,B02,083780,Staff,0,15,30,30
1650735960545,MATH 105,A01,085443,Staff,0,22,30,30
1650735966581,MATH 109,A01,083213,Anzaldo; Leesa B,0,7,30,30
1650735966581,MATH 109,A02,083214,Anzaldo; Leesa B,0,7,30,30
1650735966581,MATH 109,B01,083215,Anzaldo; Leesa B,0,8,30,30
1650735966581,MATH 109,B02,083216,Anzaldo; Leesa B,0,6,30,30
1650735972602,MATH 142A,A01,083219,Chow; Bennett,0,16,30,30
1650735972602,MATH 142A,A02,083220,Chow; Bennett,0,15,30,30
1650735972602,MATH 142A,B01,083221,Chow; Bennett,0,15,30,30
1650735972602,MATH 142A,B02,083222,Chow; Bennett,0,14,30,30
1650735978626,MATH 193A,A01,083224,Staff,0,5,30,30
1650735978626,MATH 193A,A02,083225,Staff,0,6,30,30
1650735978626,MATH 193A,A03,083781,Staff,0,6,30,30
1650735978626,MATH 193A,A04,083782,Staff,0,7,30,30
1650735984653,MATH 197,001,091859,McAuley; Julian John,9998,0,9999,1
1650735990699,COGS 9,A01,083615,Staff,1,15,60,59
1650735996739,COGS 11,A01,083617,Boyle; Mary E. T.,16,0,40,24
1650736002761,COGS 13,A01,083071,Staff,0,38,40,40
1650736008784,COGS 14A,A01,092681,Staff,0,35,100,100
1650736014810,COGS 14B,A01,083073,Cheng; Tzu-Han,1,13,50,49
1650736020835,COGS 17,A01,092677,Staff,13,0,75,62
1650736026856,COGS 100,A01,083619,Staff,0,28,60,60
1650736032883,COGS 101A,A01,083621,Davis; Joshua Daniel,0,27,60,60
1650736038907,COGS 101B,A01,091572,Staff,0,4,60,60
1650736044932,COGS 101C,A01,083625,Delgado; Tania,14,0,30,16
1650736050959,COGS 107A,A01,083627,Boyle; Mary E. T.,0,16,60,60
1650736056980,COGS 118A,A01,083075,Staff,0,8,60,60
1650736063008,CSE 3,A50,083646,Miranda; Gregory Joseph,18,0,38,20
1650736063008,CSE 3,A51,083647,Miranda; Gregory Joseph,36,0,37,1
1650736069031,CSE 8A,A50,083650,Miranda; Gregory Joseph,0,30,40,40
1650736075058,CSE 11,A01,083080,Cao; Yingjun,0,96,40,40
1650736081085,CSE 12,A01,083652,Staff,0,21,100,100
1650736087106,CSE 15L,A01,083654,Staff,0,3,50,50
1650736087106,CSE 15L,A02,083655,Staff,0,2,50,50
1650736093130,CSE 20,A01,083657,Staff,49,0,80,31
1650736099152,CSE 30,A01,083084,Eldon; John,0,77,40,40
1650736105175,CSE 100,A01,083659,Cao; Yingjun,0,70,50,50
1650736111200,CSE 134B,A01,083661,Powell; Thomas Allan,0,38,65,65
1650736117224,CSE 140,A01,083663,Staff,0,11,75,75
1650736123253,CSE 140L,A01,083088,Eldon; John,0,20,75,75
1650736129276,CSE 175,A01,083665,Kumar; Rakesh,7,0,25,18
1650736135298,CSE 190,A00,092507,Dubnov; Shlomo,10,0,20,10
1650736141322,ECE 45,A01,083139,Staff,1,2,60,59
1650736147347,ECE 65,A50,083695,Staff,0,5,30,30
1650736153372,ECE 109,A01,091882,Touri; Behrouz,33,0,70,37
1650736159396,ECE 180,A00,083140,Abi Samra; Nicholas Camill,20,0,30,10
1650736159396,ECE 180,B00,083141,Abi Samra; Nicholas Camill,0,0,30,30
1650736165419,MATH 10A,A01,083735,Patchell; Gregory David,2,0,30,28
1650736165419,MATH 10A,A02,083736,Patchell; Gregory David,27,0,30,3
1650736165419,MATH 10A,A03,083737,Patchell; Gregory David,24,0,30,6
1650736171443,MATH 10B,A01,083207,Staff,0,9,30,30
1650736171443,MATH 10B,A02,083208,Staff,1,7,30,29
1650736171443,MATH 10B,B01,083739,Staff,11,0,30,19
1650736171443,MATH 10B,B02,083740,Staff,28,0,30,2
1650736177478,MATH 18,A01,083743,Staff,0,0,30,30
1650736177478,MATH 18,A02,083744,Staff,23,0,30,7
1650736177478,MATH 18,A03,083745,Staff,21,0,30,9
1650736177478,MATH 18,A04,083746,Staff,26,0,30,4
1650736177478,MATH 18,B01,083748,Staff,0,15,30,30
1650736177478,MATH 18,B02,083749,Staff,0,12,30,30
1650736177478,MATH 18,B03,083750,Staff,0,12,30,30
1650736177478,MATH 18,B04,083751,Staff,0,12,30,30
1650736183506,MATH 20A,A01,083754,Staff,19,0,40,21
1650736189531,MATH 20B,A01,083756,Staff,0,11,30,30
1650736189531,MATH 20B,A02,083757,Staff,0,12,30,30
1650736195561,MATH 20C,A01,083760,Staff,0,16,30,30
1650736195561,MATH 20C,A02,083761,Staff,0,16,30,30
1650736195561,MATH 20C,B01,083762,Staff,10,0,30,20
1650736195561,MATH 20C,B02,083763,Staff,28,0,30,2
1650736201585,MATH 20D,A01,083765,Staff,2,1,30,28
1650736201585,MATH 20D,A02,083766,Staff,6,0,30,24
1650736201585,MATH 20D,A03,083767,Staff,24,0,30,6
1650736207609,MATH 20E,A01,083771,Staff,3,0,30,27
1650736207609,MATH 20E,A02,083772,Staff,16,0,30,14
1650736207609,MATH 20E,B01,083773,Staff,0,0,30,30
1650736207609,MATH 20E,B02,083774,Staff,6,0,30,24
1650736213632,MATH 103A,A01,083777,Staff,0,16,30,30
1650736213632,MATH 103A,A02,083778,Staff,0,15,30,30
1650736213632,MATH 103A,B01,083779,Staff,0,15,30,30
1650736213632,MATH 103A,B02,083780,Staff,0,15,30,30
1650736219655,MATH 105,A01,085443,Staff,0,22,30,30
1650736225684,MATH 109,A01,083213,Anzaldo; Leesa B,0,7,30,30
1650736225684,MATH 109,A02,083214,Anzaldo; Leesa B,0,7,30,30
1650736225684,MATH 109,B01,083215,Anzaldo; Leesa B,0,8,30,30
1650736225684,MATH 109,B02,083216,Anzaldo; Leesa B,0,6,30,30
1650736231709,MATH 142A,A01,083219,Chow; Bennett,0,16,30,30
1650736231709,MATH 142A,A02,083220,Chow; Bennett,0,15,30,30
1650736231709,MATH 142A,B01,083221,Chow; Bennett,0,15,30,30
1650736231709,MATH 142A,B02,083222,Chow; Bennett,0,14,30,30
1650736237737,MATH 193A,A01,083224,Staff,0,5,30,30
1650736237737,MATH 193A,A02,083225,Staff,0,6,30,30
1650736237737,MATH 193A,A03,083781,Staff,0,6,30,30
1650736237737,MATH 193A,A04,083782,Staff,0,7,30,30
1650736243763,MATH 197,001,091859,McAuley; Julian John,9998,0,9999,1
1650736249809,COGS 9,A01,083615,Staff,1,15,60,59
1650736255835,COGS 11,A01,083617,Boyle; Mary E. T.,16,0,40,24
1650736261862,COGS 13,A01,083071,Staff,0,38,40,40
1650736267887,COGS 14A,A01,092681,Staff,0,35,100,100
1650736273912,COGS 14B,A01,083073,Cheng; Tzu-Han,1,13,50,49
1650736279936,COGS 17,A01,092677,Staff,13,0,75,62
1650736285963,COGS 100,A01,083619,Staff,0,28,60,60
1650736291988,COGS 101A,A01,083621,Davis; Joshua Daniel,0,27,60,60
1650736298016,COGS 101B,A01,091572,Staff,0,4,60,60
1650736304042,COGS 101C,A01,083625,Delgado; Tania,14,0,30,16
1650736310066,COGS 107A,A01,083627,Boyle; Mary E. T.,0,16,60,60
1650736316093,COGS 118A,A01,083075,Staff,0,8,60,60
1650736322124,CSE 3,A50,083646,Miranda; Gregory Joseph,18,0,38,20
1650736322124,CSE 3,A51,083647,Miranda; Gregory Joseph,36,0,37,1
1650736328151,CSE 8A,A50,083650,Miranda; Gregory Joseph,0,30,40,40
1650736334180,CSE 11,A01,083080,Cao; Yingjun,0,96,40,40
1650736340205,CSE 12,A01,083652,Staff,0,21,100,100
1650736346233,CSE 15L,A01,083654,Staff,0,3,50,50
1650736346233,CSE 15L,A02,083655,Staff,0,2,50,50
1650736352260,CSE 20,A01,083657,Staff,49,0,80,31
1650736358286,CSE 30,A01,083084,Eldon; John,0,77,40,40
1650736364309,CSE 100,A01,083659,Cao; Yingjun,0,70,50,50
1650736370337,CSE 134B,A01,083661,Powell; Thomas Allan,0,38,65,65
1650736376368,CSE 140,A01,083663,Staff,0,11,75,75
1650736382392,CSE 140L,A01,083088,Eldon; John,0,20,75,75
1650736388416,CSE 175,A01,083665,Kumar; Rakesh,7,0,25,18
1650736394441,CSE 190,A00,092507,Dubnov; Shlomo,10,0,20,10
1650736400475,ECE 45,A01,083139,Staff,1,2,60,59
1650736406498,ECE 65,A50,083695,Staff,0,5,30,30
1650736412522,ECE 109,A01,091882,Touri; Behrouz,33,0,70,37
1650736418546,ECE 180,A00,083140,Abi Samra; Nicholas Camill,20,0,30,10
1650736418546,ECE 180,B00,083141,Abi Samra; Nicholas Camill,0,0,30,30
1650736424580,MATH 10A,A01,083735,Patchell; Gregory David,2,0,30,28
1650736424580,MATH 10A,A02,083736,Patchell; Gregory David,27,0,30,3
1650736424580,MATH 10A,A03,083737,Patchell; Gregory David,24,0,30,6
1650736430605,MATH 10B,A01,083207,Staff,0,9,30,30
1650736430605,MATH 10B,A02,083208,Staff,1,7,30,29
1650736430605,MATH 10B,B01,083739,Staff,11,0,30,19
1650736430605,MATH 10B,B02,083740,Staff,28,0,30,2
1650736436636,MATH 18,A01,083743,Staff,0,0,30,30
1650736436636,MATH 18,A02,083744,Staff,23,0,30,7
1650736436636,MATH 18,A03,083745,Staff,21,0,30,9
1650736436636,MATH 18,A04,083746,Staff,26,0,30,4
1650736436636,MATH 18,B01,083748,Staff,0,15,30,30
1650736436636,MATH 18,B02,083749,Staff,0,12,30,30
1650736436636,MATH 18,B03,083750,Staff,0,12,30,30
1650736436636,MATH 18,B04,083751,Staff,0,12,30,30
1650736442764,MATH 20A,A01,083754,Staff,19,0,40,21
1650736448796,MATH 20B,A01,083756,Staff,0,11,30,30
1650736448796,MATH 20B,A02,083757,Staff,0,12,30,30
1650736454824,MATH 20C,A01,083760,Staff,0,16,30,30
1650736454824,MATH 20C,A02,083761,Staff,0,16,30,30
1650736454824,MATH 20C,B01,083762,Staff,10,0,30,20
1650736454824,MATH 20C,B02,083763,Staff,28,0,30,2
1650736460852,MATH 20D,A01,083765,Staff,2,1,30,28
1650736460852,MATH 20D,A02,083766,Staff,6,0,30,24
1650736460852,MATH 20D,A03,083767,Staff,24,0,30,6
1650736466876,MATH 20E,A01,083771,Staff,3,0,30,27
1650736466876,MATH 20E,A02,083772,Staff,16,0,30,14
1650736466876,MATH 20E,B01,083773,Staff,0,0,30,30
1650736466876,MATH 20E,B02,083774,Staff,6,0,30,24
1650736472905,MATH 103A,A01,083777,Staff,0,16,30,30
1650736472905,MATH 103A,A02,083778,Staff,0,15,30,30
1650736472905,MATH 103A,B01,083779,Staff,0,15,30,30
1650736472905,MATH 103A,B02,083780,Staff,0,15,30,30
1650736478929,MATH 105,A01,085443,Staff,0,22,30,30
1650736484958,MATH 109,A01,083213,Anzaldo; Leesa B,0,7,30,30
1650736484958,MATH 109,A02,083214,Anzaldo; Leesa B,0,7,30,30
1650736484958,MATH 109,B01,083215,Anzaldo; Leesa B,0,8,30,30
1650736484958,MATH 109,B02,083216,Anzaldo; Leesa B,0,6,30,30
1650736490984,MATH 142A,A01,083219,Chow; Bennett,0,16,30,30
1650736490984,MATH 142A,A02,083220,Chow; Bennett,0,15,30,30
1650736490984,MATH 142A,B01,083221,Chow; Bennett,0,15,30,30
1650736490984,MATH 142A,B02,083222,Chow; Bennett,0,14,30,30
1650736497012,MATH 193A,A01,083224,Staff,0,5,30,30
1650736497012,MATH 193A,A02,083225,Staff,0,6,30,30
1650736497012,MATH 193A,A03,083781,Staff,0,6,30,30
1650736497012,MATH 193A,A04,083782,Staff,0,7,30,30
1650736503035,MATH 197,001,091859,McAuley; Julian John,9998,0,9999,1
1650736509094,COGS 9,A01,083615,Staff,1,15,60,59
1650736515117,COGS 11,A01,083617,Boyle; Mary E. T.,16,0,40,24
1650736521145,COGS 13,A01,083071,Staff,0,38,40,40
1650736527170,COGS 14A,A01,092681,Staff,0,35,100,100
1650736533196,COGS 14B,A01,083073,Cheng; Tzu-Han,1,13,50,49
1650736539221,COGS 17,A01,092677,Staff,13,0,75,62
1650736545245,COGS 100,A01,083619,Staff,0,28,60,60
1650736551271,COGS 101A,A01,083621,Davis; Joshua Daniel,0,27,60,60
1650736557296,COGS 101B,A01,091572,Staff,0,4,60,60
1650736563321,COGS 101C,A01,083625,Delgado; Tania,14,0,30,16
1650736569350,COGS 107A,A01,083627,Boyle; Mary E. T.,0,16,60,60
1650736575374,COGS 118A,A01,083075,Staff,0,8,60,60
1650736581403,CSE 3,A50,083646,Miranda; Gregory Joseph,18,0,38,20
1650736581403,CSE 3,A51,083647,Miranda; Gregory Joseph,36,0,37,1
1650736587426,CSE 8A,A50,083650,Miranda; Gregory Joseph,0,30,40,40
1650736593451,CSE 11,A01,083080,Cao; Yingjun,0,96,40,40
1650736599480,CSE 12,A01,083652,Staff,0,21,100,100
1650736605503,CSE 15L,A01,083654,Staff,0,3,50,50
1650736605503,CSE 15L,A02,083655,Staff,0,2,50,50
1650736611528,CSE 20,A01,083657,Staff,49,0,80,31
1650736617553,CSE 30,A01,083084,Eldon; John,0,77,40,40
1650736623581,CSE 100,A01,083659,Cao; Yingjun,0,70,50,50
1650736629603,CSE 134B,A01,083661,Powell; Thomas Allan,0,38,65,65
1650736635626,CSE 140,A01,083663,Staff,0,11,75,75
1650736641654,CSE 140L,A01,083088,Eldon; John,0,20,75,75
1650736647679,CSE 175,A01,083665,Kumar; Rakesh,7,0,25,18
1650736653704,CSE 190,A00,092507,Dubnov; Shlomo,10,0,20,10
1650736659729,ECE 45,A01,083139,Staff,1,2,60,59
1650736665779,ECE 65,A50,083695,Staff,0,5,30,30
1650736671803,ECE 109,A01,091882,Touri; Behrouz,33,0,70,37
1650736677835,ECE 180,A00,083140,Abi Samra; Nicholas Camill,20,0,30,10
1650736677835,ECE 180,B00,083141,Abi Samra; Nicholas Camill,0,0,30,30
1650736683861,MATH 10A,A01,083735,Patchell; Gregory David,2,0,30,28
1650736683861,MATH 10A,A02,083736,Patchell; Gregory David,27,0,30,3
1650736683861,MATH 10A,A03,083737,Patchell; Gregory David,24,0,30,6
1650736689896,MATH 10B,A01,083207,Staff,0,9,30,30
1650736689896,MATH 10B,A02,083208,Staff,1,7,30,29
1650736689896,MATH 10B,B01,083739,Staff,11,0,30,19
1650736689896,MATH 10B,B02,083740,Staff,28,0,30,2
1650736695927,MATH 18,A01,083743,Staff,0,0,30,30
1650736695927,MATH 18,A02,083744,Staff,23,0,30,7
1650736695927,MATH 18,A03,083745,Staff,21,0,30,9
1650736695927,MATH 18,A04,083746,Staff,26,0,30,4
1650736695927,MATH 18,B01,083748,Staff,0,15,30,30
1650736695927,MATH 18,B02,083749,Staff,0,12,30,30
1650736695927,MATH 18,B03,083750,Staff,0,12,30,30
1650736695927,MATH 18,B04,083751,Staff,0,12,30,30
1650736701978,MATH 20A,A01,083754,Staff,19,0,40,21
1650736708009,MATH 20B,A01,083756,Staff,0,11,30,30
1650736708009,MATH 20B,A02,083757,Staff,0,12,30,30
1650736714043,MATH 20C,A01,083760,Staff,0,16,30,30
1650736714043,MATH 20C,A02,083761,Staff,0,16,30,30
1650736714043,MATH 20C,B01,083762,Staff,10,0,30,20
1650736714043,MATH 20C,B02,083763,Staff,28,0,30,2
1650736720072,MATH 20D,A01,083765,Staff,2,1,30,28
1650736720072,MATH 20D,A02,083766,Staff,6,0,30,24
1650736720072,MATH 20D,A03,083767,Staff,24,0,30,6
1650736726101,MATH 20E,A01,083771,Staff,3,0,30,27
1650736726101,MATH 20E,A02,083772,Staff,16,0,30,14
1650736726101,MATH 20E,B01,083773,Staff,0,0,30,30
1650736726101,MATH 20E,B02,083774,Staff,6,0,30,24
1650736732126,MATH 103A,A01,083777,Staff,0,16,30,30
1650736732126,MATH 103A,A02,083778,Staff,0,15,30,30
1650736732126,MATH 103A,B01,083779,Staff,0,15,30,30
1650736732126,MATH 103A,B02,083780,Staff,0,15,30,30
1650736738154,MATH 105,A01,085443,Staff,0,22,30,30
1650736744183,MATH 109,A01,083213,Anzaldo; Leesa B,0,7,30,30
1650736744183,MATH 109,A02,083214,Anzaldo; Leesa B,0,7,30,30
1650736744183,MATH 109,B01,083215,Anzaldo; Leesa B,0,8,30,30
1650736744183,MATH 109,B02,083216,Anzaldo; Leesa B,0,6,30,30
1650736750214,MATH 142A,A01,083219,Chow; Bennett,0,16,30,30
1650736750214,MATH 142A,A02,083220,Chow; Bennett,0,15,30,30
1650736750214,MATH 142A,B01,083221,Chow; Bennett,0,15,30,30
1650736750214,MATH 142A,B02,083222,Chow; Bennett,0,14,30,30
1650736756241,MATH 193A,A01,083224,Staff,0,5,30,30
1650736756241,MATH 193A,A02,083225,Staff,0,6,30,30
1650736756241,MATH 193A,A03,083781,Staff,0,6,30,30
1650736756241,MATH 193A,A04,083782,Staff,0,7,30,30
1650736762271,MATH 197,001,091859,McAuley; Julian John,9998,0,9999,1
1650736768336,COGS 9,A01,083615,Staff,1,15,60,59
1650736774361,COGS 11,A01,083617,Boyle; Mary E. T.,16,0,40,24
1650736780387,COGS 13,A01,083071,Staff,0,38,40,40
1650736786409,COGS 14A,A01,092681,Staff,0,35,100,100
1650736792443,COGS 14B,A01,083073,Cheng; Tzu-Han,1,13,50,49
1650736798466,COGS 17,A01,092677,Staff,13,0,75,62
1650736804491,COGS 100,A01,083619,Staff,0,28,60,60
1650736810524,COGS 101A,A01,083621,Davis; Joshua Daniel,0,27,60,60
1650736816555,COGS 101B,A01,091572,Staff,0,4,60,60
1650736822579,COGS 101C,A01,083625,Delgado; Tania,14,0,30,16
1650736828619,COGS 107A,A01,083627,Boyle; Mary E. T.,0,16,60,60
1650736834644,COGS 118A,A01,083075,Staff,0,8,60,60
1650736840673,CSE 3,A50,083646,Miranda; Gregory Joseph,18,0,38,20
1650736840673,CSE 3,A51,083647,Miranda; Gregory Joseph,36,0,37,1
1650736846697,CSE 8A,A50,083650,Miranda; Gregory Joseph,0,30,40,40
1650736852721,CSE 11,A01,083080,Cao; Yingjun,0,96,40,40
1650736858746,CSE 12,A01,083652,Staff,0,21,100,100
1650736864785,CSE 15L,A01,083654,Staff,0,3,50,50
1650736864785,CSE 15L,A02,083655,Staff,0,2,50,50
1650736870810,CSE 20,A01,083657,Staff,49,0,80,31
1650736876835,CSE 30,A01,083084,Eldon; John,0,77,40,40
1650736882870,CSE 100,A01,083659,Cao; Yingjun,0,70,50,50
1650736888897,CSE 134B,A01,083661,Powell; Thomas Allan,0,38,65,65
1650736894923,CSE 140,A01,083663,Staff,0,11,75,75
1650736900963,CSE 140L,A01,083088,Eldon; John,0,20,75,75
1650736906988,CSE 175,A01,083665,Kumar; Rakesh,7,0,25,18
1650736913028,CSE 190,A00,092507,Dubnov; Shlomo,10,0,20,10
1650736919052,ECE 45,A01,083139,Staff,1,2,60,59
1650736925077,ECE 65,A50,083695,Staff,0,5,30,30
1650736931110,ECE 109,A01,091882,Touri; Behrouz,33,0,70,37
1650736937138,ECE 180,A00,083140,Abi Samra; Nicholas Camill,20,0,30,10
1650736937138,ECE 180,B00,083141,Abi Samra; Nicholas Camill,0,0,30,30
1650736943162,MATH 10A,A01,083735,Patchell; Gregory David,2,0,30,28
1650736943162,MATH 10A,A02,083736,Patchell; Gregory David,27,0,30,3
1650736943162,MATH 10A,A03,083737,Patchell; Gregory David,24,0,30,6
1650736949185,MATH 10B,A01,083207,Staff,0,9,30,30
1650736949185,MATH 10B,A02,083208,Staff,1,7,30,29
1650736949185,MATH 10B,B01,083739,Staff,11,0,30,19
1650736949185,MATH 10B,B02,083740,Staff,28,0,30,2
1650736955209,MATH 18,A01,083743,Staff,0,0,30,30
1650736955209,MATH 18,A02,083744,Staff,23,0,30,7
1650736955209,MATH 18,A03,083745,Staff,21,0,30,9
1650736955209,MATH 18,A04,083746,Staff,26,0,30,4
1650736955209,MATH 18,B01,083748,Staff,0,15,30,30
1650736955209,MATH 18,B02,083749,Staff,0,12,30,30
1650736955209,MATH 18,B03,083750,Staff,0,12,30,30
1650736955209,MATH 18,B04,083751,Staff,0,12,30,30
1650736961231,MATH 20A,A01,083754,Staff,19,0,40,21
1650736967255,MATH 20B,A01,083756,Staff,0,11,30,30
1650736967255,MATH 20B,A02,083757,Staff,0,12,30,30
1650736973281,MATH 20C,A01,083760,Staff,0,16,30,30
1650736973281,MATH 20C,A02,083761,Staff,0,16,30,30
1650736973281,MATH 20C,B01,083762,Staff,10,0,30,20
1650736973281,MATH 20C,B02,083763,Staff,28,0,30,2
1650736979305,MATH 20D,A01,083765,Staff,2,1,30,28
1650736979305,MATH 20D,A02,083766,Staff,6,0,30,24
1650736979305,MATH 20D,A03,083767,Staff,24,0,30,6
1650736985337,MATH 20E,A01,083771,Staff,3,0,30,27
1650736985337,MATH 20E,A02,083772,Staff,16,0,30,14
1650736985337,MATH 20E,B01,083773,Staff,0,0,30,30
1650736985337,MATH 20E,B02,083774,Staff,6,0,30,24
1650736991362,MATH 103A,A01,083777,Staff,0,16,30,30
1650736991362,MATH 103A,A02,083778,Staff,0,15,30,30
1650736991362,MATH 103A,B01,083779,Staff,0,15,30,30
1650736991362,MATH 103A,B02,083780,Staff,0,15,30,30
1650736997388,MATH 105,A01,085443,Staff,0,22,30,30
1650737003412,MATH 109,A01,083213,Anzaldo; Leesa B,0,7,30,30
1650737003412,MATH 109,A02,083214,Anzaldo; Leesa B,0,7,30,30
1650737003412,MATH 109,B01,083215,Anzaldo; Leesa B,0,8,30,30
1650737003412,MATH 109,B02,083216,Anzaldo; Leesa B,0,6,30,30
1650737009441,MATH 142A,A01,083219,Chow; Bennett,0,16,30,30
1650737009441,MATH 142A,A02,083220,Chow; Bennett,0,15,30,30
1650737009441,MATH 142A,B01,083221,Chow; Bennett,0,15,30,30
1650737009441,MATH 142A,B02,083222,Chow; Bennett,0,14,30,30
1650737015468,MATH 193A,A01,083224,Staff,0,5,30,30
1650737015468,MATH 193A,A02,083225,Staff,0,6,30,30
1650737015468,MATH 193A,A03,083781,Staff,0,6,30,30
1650737015468,MATH 193A,A04,083782,Staff,0,7,30,30
1650737021490,MATH 197,001,091859,McAuley; Julian John,9998,0,9999,1
1650737027542,COGS 9,A01,083615,Staff,1,15,60,59
1650737033663,COGS 11,A01,083617,Boyle; Mary E. T.,16,0,40,24
1650737039690,COGS 13,A01,083071,Staff,0,38,40,40
1650737045716,COGS 14A,A01,092681,Staff,0,35,100,100
1650737051741,COGS 14B,A01,083073,Cheng; Tzu-Han,1,13,50,49
1650737057768,COGS 17,A01,092677,Staff,13,0,75,62
1650737063801,COGS 100,A01,083619,Staff,0,28,60,60
1650737069824,COGS 101A,A01,083621,Davis; Joshua Daniel,0,27,60,60
1650737075851,COGS 101B,A01,091572,Staff,0,4,60,60
1650737081874,COGS 101C,A01,083625,Delgado; Tania,14,0,30,16
1650737087911,COGS 107A,A01,083627,Boyle; Mary E. T.,0,16,60,60
1650737093935,COGS 118A,A01,083075,Staff,0,8,60,60
1650737099961,CSE 3,A50,083646,Miranda; Gregory Joseph,18,0,38,20
1650737099961,CSE 3,A51,083647,Miranda; Gregory Joseph,36,0,37,1
1650737105987,CSE 8A,A50,083650,Miranda; Gregory Joseph,0,30,40,40
1650737112020,CSE 11,A01,083080,Cao; Yingjun,0,96,40,40
1650737118066,CSE 12,A01,083652,Staff,0,21,100,100
1650737124092,CSE 15L,A01,083654,Staff,0,3,50,50
1650737124092,CSE 15L,A02,083655,Staff,0,2,50,50
1650737130120,CSE 20,A01,083657,Staff,49,0,80,31
1650737136147,CSE 30,A01,083084,Eldon; John,0,77,40,40
1650737142170,CSE 100,A01,083659,Cao; Yingjun,0,70,50,50
1650737148194,CSE 134B,A01,083661,Powell; Thomas Allan,0,38,65,65
1650737154218,CSE 140,A01,083663,Staff,0,11,75,75
1650737160247,CSE 140L,A01,083088,Eldon; John,0,20,75,75
1650737166284,CSE 175,A01,083665,Kumar; Rakesh,7,0,25,18
1650737172310,CSE 190,A00,092507,Dubnov; Shlomo,10,0,20,10
1650737178337,ECE 45,A01,083139,Staff,1,2,60,59
1650737184361,ECE 65,A50,083695,Staff,0,5,30,30
1650737190388,ECE 109,A01,091882,Touri; Behrouz,33,0,70,37
1650737196412,ECE 180,A00,083140,Abi Samra; Nicholas Camill,20,0,30,10
1650737196412,ECE 180,B00,083141,Abi Samra; Nicholas Camill,0,0,30,30
1650737202436,MATH 10A,A01,083735,Patchell; Gregory David,2,0,30,28
1650737202436,MATH 10A,A02,083736,Patchell; Gregory David,27,0,30,3
1650737202436,MATH 10A,A03,083737,Patchell; Gregory David,24,0,30,6
1650737208463,MATH 10B,A01,083207,Staff,0,9,30,30
1650737208463,MATH 10B,A02,083208,Staff,1,7,30,29
1650737208463,MATH 10B,B01,083739,Staff,11,0,30,19
1650737208463,MATH 10B,B02,083740,Staff,28,0,30,2
1650737214491,MATH 18,A01,083743,Staff,0,0,30,30
1650737214491,MATH 18,A02,083744,Staff,23,0,30,7
1650737214491,MATH 18,A03,083745,Staff,21,0,30,9
1650737214491,MATH 18,A04,083746,Staff,26,0,30,4
1650737214491,MATH 18,B01,083748,Staff,0,15,30,30
1650737214491,MATH 18,B02,083749,Staff,0,12,30,30
1650737214491,MATH 18,B03,083750,Staff,0,12,30,30
1650737214491,MATH 18,B04,083751,Staff,0,12,30,30
1650737220513,MATH 20A,A01,083754,Staff,19,0,40,21
1650737226536,MATH 20B,A01,083756,Staff,0,11,30,30
1650737226536,MATH 20B,A02,083757,Staff,0,12,30,30
1650737232562,MATH 20C,A01,083760,Staff,0,16,30,30
1650737232562,MATH 20C,A02,083761,Staff,0,16,30,30
1650737232562,MATH 20C,B01,083762,Staff,10,0,30,20
1650737232562,MATH 20C,B02,083763,Staff,28,0,30,2
1650737238583,MATH 20D,A01,083765,Staff,2,1,30,28
1650737238583,MATH 20D,A02,083766,Staff,6,0,30,24
1650737238583,MATH 20D,A03,083767,Staff,24,0,30,6
1650737244617,MATH 20E,A01,083771,Staff,3,0,30,27
1650737244617,MATH 20E,A02,083772,Staff,16,0,30,14
1650737244617,MATH 20E,B01,083773,Staff,0,0,30,30
1650737244617,MATH 20E,B02,083774,Staff,6,0,30,24
1650737250650,MATH 103A,A01,083777,Staff,0,16,30,30
1650737250650,MATH 103A,A02,083778,Staff,0,15,30,30
1650737250650,MATH 103A,B01,083779,Staff,0,15,30,30
1650737250650,MATH 103A,B02,083780,Staff,0,15,30,30
1650737256685,MATH 105,A01,085443,Staff,0,22,30,30
1650737262712,MATH 109,A01,083213,Anzaldo; Leesa B,0,7,30,30
1650737262712,MATH 109,A02,083214,Anzaldo; Leesa B,0,7,30,30
1650737262712,MATH 109,B01,083215,Anzaldo; Leesa B,0,8,30,30
1650737262712,MATH 109,B02,083216,Anzaldo; Leesa B,0,6,30,30
1650737268739,MATH 142A,A01,083219,Chow; Bennett,0,16,30,30
1650737268739,MATH 142A,A02,083220,Chow; Bennett,0,15,30,30
1650737268739,MATH 142A,B01,083221,Chow; Bennett,0,15,30,30
1650737268739,MATH 142A,B02,083222,Chow; Bennett,0,14,30,30
1650737274762,MATH 193A,A01,083224,Staff,0,5,30,30
1650737274762,MATH 193A,A02,083225,Staff,0,6,30,30
1650737274762,MATH 193A,A03,083781,Staff,0,6,30,30
1650737274762,MATH 193A,A04,083782,Staff,0,7,30,30
1650737280788,MATH 197,001,091859,McAuley; Julian John,9998,0,9999,1
1650737286846,COGS 9,A01,083615,Staff,1,15,60,59
1650737292869,COGS 11,A01,083617,Boyle; Mary E. T.,16,0,40,24
1650737298897,COGS 13,A01,083071,Staff,0,38,40,40
1650737304921,COGS 14A,A01,092681,Staff,0,35,100,100
1650737310948,COGS 14B,A01,083073,Cheng; Tzu-Han,1,13,50,49
1650737316972,COGS 17,A01,092677,Staff,13,0,75,62
1650737322998,COGS 100,A01,083619,Staff,0,28,60,60
1650737329025,COGS 101A,A01,083621,Davis; Joshua Daniel,0,27,60,60
1650737335049,COGS 101B,A01,091572,Staff,0,4,60,60
1650737341075,COGS 101C,A01,083625,Delgado; Tania,14,0,30,16
1650737347111,COGS 107A,A01,083627,Boyle; Mary E. T.,0,16,60,60
1650737353134,COGS 118A,A01,083075,Staff,0,8,60,60
1650737359173,CSE 3,A50,083646,Miranda; Gregory Joseph,18,0,38,20
1650737359173,CSE 3,A51,083647,Miranda; Gregory Joseph,36,0,37,1
1650737365204,CSE 8A,A50,083650,Miranda; Gregory Joseph,0,30,40,40
1650737371245,CSE 11,A01,083080,Cao; Yingjun,0,96,40,40
1650737377268,CSE 12,A01,083652,Staff,0,21,100,100
1650737383293,CSE 15L,A01,083654,Staff,0,3,50,50
1650737383293,CSE 15L,A02,083655,Staff,0,2,50,50
1650737389320,CSE 20,A01,083657,Staff,49,0,80,31
1650737395354,CSE 30,A01,083084,Eldon; John,0,77,40,40
1650737401378,CSE 100,A01,083659,Cao; Yingjun,0,70,50,50
1650737407406,CSE 134B,A01,083661,Powell; Thomas Allan,0,38,65,65
1650737413433,CSE 140,A01,083663,Staff,0,11,75,75
1650737419460,CSE 140L,A01,083088,Eldon; John,0,20,75,75
1650737425485,CSE 175,A01,083665,Kumar; Rakesh,7,0,25,18
1650737431524,CSE 190,A00,092507,Dubnov; Shlomo,10,0,20,10
1650737437546,ECE 45,A01,083139,Staff,1,2,60,59
1650737443578,ECE 65,A50,083695,Staff,0,5,30,30
1650737449605,ECE 109,A01,091882,Touri; Behrouz,33,0,70,37
1650737455629,ECE 180,A00,083140,Abi Samra; Nicholas Camill,20,0,30,10
1650737455629,ECE 180,B00,083141,Abi Samra; Nicholas Camill,0,0,30,30
1650737461654,MATH 10A,A01,083735,Patchell; Gregory David,2,0,30,28
1650737461654,MATH 10A,A02,083736,Patchell; Gregory David,27,0,30,3
1650737461654,MATH 10A,A03,083737,Patchell; Gregory David,24,0,30,6
1650737467677,MATH 10B,A01,083207,Staff,0,9,30,30
1650737467677,MATH 10B,A02,083208,Staff,1,7,30,29
1650737467677,MATH 10B,B01,083739,Staff,11,0,30,19
1650737467677,MATH 10B,B02,083740,Staff,28,0,30,2
1650737473702,MATH 18,A01,083743,Staff,0,0,30,30
1650737473702,MATH 18,A02,083744,Staff,23,0,30,7
1650737473702,MATH 18,A03,083745,Staff,21,0,30,9
1650737473702,MATH 18,A04,083746,Staff,26,0,30,4
1650737473702,MATH 18,B01,083748,Staff,0,15,30,30
1650737473702,MATH 18,B02,083749,Staff,0,12,30,30
1650737473702,MATH 18,B03,083750,Staff,0,12,30,30
1650737473702,MATH 18,B04,083751,Staff,0,12,30,30
1650737479725,MATH 20A,A01,083754,Staff,19,0,40,21
1650737485750,MATH 20B,A01,083756,Staff,0,11,30,30
1650737485750,MATH 20B,A02,083757,Staff,0,12,30,30
1650737491780,MATH 20C,A01,083760,Staff,0,16,30,30
1650737491780,MATH 20C,A02,083761,Staff,0,16,30,30
1650737491780,MATH 20C,B01,083762,Staff,10,0,30,20
1650737491780,MATH 20C,B02,083763,Staff,28,0,30,2
1650737497804,MATH 20D,A01,083765,Staff,2,1,30,28
1650737497804,MATH 20D,A02,083766,Staff,6,0,30,24
1650737497804,MATH 20D,A03,083767,Staff,24,0,30,6
1650737503829,MATH 20E,A01,083771,Staff,3,0,30,27
1650737503829,MATH 20E,A02,083772,Staff,16,0,30,14
1650737503829,MATH 20E,B01,083773,Staff,0,0,30,30
1650737503829,MATH 20E,B02,083774,Staff,6,0,30,24
1650737509853,MATH 103A,A01,083777,Staff,0,16,30,30
1650737509853,MATH 103A,A02,083778,Staff,0,15,30,30
1650737509853,MATH 103A,B01,083779,Staff,0,15,30,30
1650737509853,MATH 103A,B02,083780,Staff,0,15,30,30
1650737515880,MATH 105,A01,085443,Staff,0,22,30,30
1650737521908,MATH 109,A01,083213,Anzaldo; Leesa B,0,7,30,30
1650737521908,MATH 109,A02,083214,Anzaldo; Leesa B,0,7,30,30
1650737521908,MATH 109,B01,083215,Anzaldo; Leesa B,0,8,30,30
1650737521908,MATH 109,B02,083216,Anzaldo; Leesa B,0,6,30,30
1650737527937,MATH 142A,A01,083219,Chow; Bennett,0,16,30,30
1650737527937,MATH 142A,A02,083220,Chow; Bennett,0,15,30,30
1650737527937,MATH 142A,B01,083221,Chow; Bennett,0,15,30,30
1650737527937,MATH 142A,B02,083222,Chow; Bennett,0,14,30,30
1650737533971,MATH 193A,A01,083224,Staff,0,5,30,30
1650737533971,MATH 193A,A02,083225,Staff,0,6,30,30
1650737533971,MATH 193A,A03,083781,Staff,0,6,30,30
1650737533971,MATH 193A,A04,083782,Staff,0,7,30,30
1650737539996,MATH 197,001,091859,McAuley; Julian John,9998,0,9999,1
1650737546057,COGS 9,A01,083615,Staff,1,15,60,59
1650737552083,COGS 11,A01,083617,Boyle; Mary E. T.,16,0,40,24
1650737558107,COGS 13,A01,083071,Staff,0,38,40,40
1650737564130,COGS 14A,A01,092681,Staff,0,35,100,100
1650737570160,COGS 14B,A01,083073,Cheng; Tzu-Han,1,13,50,49
1650737576184,COGS 17,A01,092677,Staff,13,0,75,62
1650737582207,COGS 100,A01,083619,Staff,0,28,60,60
1650737588230,COGS 101A,A01,083621,Davis; Joshua Daniel,0,27,60,60
1650737594265,COGS 101B,A01,091572,Staff,0,4,60,60
1650737600291,COGS 101C,A01,083625,Delgado; Tania,14,0,30,16
1650737606335,COGS 107A,A01,083627,Boyle; Mary E. T.,0,16,60,60
1650737612364,COGS 118A,A01,083075,Staff,0,8,60,60
1650737618392,CSE 3,A50,083646,Miranda; Gregory Joseph,18,0,38,20
1650737618392,CSE 3,A51,083647,Miranda; Gregory Joseph,36,0,37,1
1650737624419,CSE 8A,A50,083650,Miranda; Gregory Joseph,0,30,40,40
1650737630531,CSE 11,A01,083080,Cao; Yingjun,0,96,40,40
1650737636554,CSE 12,A01,083652,Staff,0,21,100,100
1650737642579,CSE 15L,A01,083654,Staff,0,3,50,50
1650737642579,CSE 15L,A02,083655,Staff,0,2,50,50
1650737648602,CSE 20,A01,083657,Staff,49,0,80,31
1650737654629,CSE 30,A01,083084,Eldon; John,0,77,40,40
1650737660655,CSE 100,A01,083659,Cao; Yingjun,0,70,50,50
1650737666682,CSE 134B,A01,083661,Powell; Thomas Allan,0,38,65,65
1650737672706,CSE 140,A01,083663,Staff,0,11,75,75
1650737678731,CSE 140L,A01,083088,Eldon; John,0,20,75,75
1650737684753,CSE 175,A01,083665,Kumar; Rakesh,7,0,25,18
1650737690779,CSE 190,A00,092507,Dubnov; Shlomo,10,0,20,10
1650737696810,ECE 45,A01,083139,Staff,1,2,60,59
1650737702834,ECE 65,A50,083695,Staff,0,5,30,30
1650737708857,ECE 109,A01,091882,Touri; Behrouz,33,0,70,37
1650737714880,ECE 180,A00,083140,Abi Samra; Nicholas Camill,20,0,30,10
1650737714880,ECE 180,B00,083141,Abi Samra; Nicholas Camill,0,0,30,30
1650737720903,MATH 10A,A01,083735,Patchell; Gregory David,2,0,30,28
1650737720903,MATH 10A,A02,083736,Patchell; Gregory David,27,0,30,3
1650737720903,MATH 10A,A03,083737,Patchell; Gregory David,24,0,30,6
1650737726925,MATH 10B,A01,083207,Staff,0,9,30,30
1650737726925,MATH 10B,A02,083208,Staff,1,7,30,29
1650737726925,MATH 10B,B01,083739,Staff,11,0,30,19
1650737726925,MATH 10B,B02,083740,Staff,28,0,30,2
1650737732955,MATH 18,A01,083743,Staff,0,0,30,30
1650737732955,MATH 18,A02,083744,Staff,23,0,30,7
1650737732955,MATH 18,A03,083745,Staff,21,0,30,9
1650737732955,MATH 18,A04,083746,Staff,26,0,30,4
1650737732955,MATH 18,B01,083748,Staff,0,15,30,30
1650737732955,MATH 18,B02,083749,Staff,0,12,30,30
1650737732955,MATH 18,B03,083750,Staff,0,12,30,30
1650737732955,MATH 18,B04,083751,Staff,0,12,30,30
1650737738978,MATH 20A,A01,083754,Staff,19,0,40,21
1650737745002,MATH 20B,A01,083756,Staff,0,11,30,30
1650737745002,MATH 20B,A02,083757,Staff,0,12,30,30
1650737751029,MATH 20C,A01,083760,Staff,0,16,30,30
1650737751029,MATH 20C,A02,083761,Staff,0,16,30,30
1650737751029,MATH 20C,B01,083762,Staff,10,0,30,20
1650737751029,MATH 20C,B02,083763,Staff,28,0,30,2
1650737757053,MATH 20D,A01,083765,Staff,2,1,30,28
1650737757053,MATH 20D,A02,083766,Staff,6,0,30,24
1650737757053,MATH 20D,A03,083767,Staff,24,0,30,6
1650737763080,MATH 20E,A01,083771,Staff,3,0,30,27
1650737763080,MATH 20E,A02,083772,Staff,16,0,30,14
1650737763080,MATH 20E,B01,083773,Staff,0,0,30,30
1650737763080,MATH 20E,B02,083774,Staff,6,0,30,24
1650737769115,MATH 103A,A01,083777,Staff,0,16,30,30
1650737769115,MATH 103A,A02,083778,Staff,0,15,30,30
1650737769115,MATH 103A,B01,083779,Staff,0,15,30,30
1650737769115,MATH 103A,B02,083780,Staff,0,15,30,30
1650737775138,MATH 105,A01,085443,Staff,0,22,30,30
1650737781164,MATH 109,A01,083213,Anzaldo; Leesa B,0,7,30,30
1650737781164,MATH 109,A02,083214,Anzaldo; Leesa B,0,7,30,30
1650737781164,MATH 109,B01,083215,Anzaldo; Leesa B,0,8,30,30
1650737781164,MATH 109,B02,083216,Anzaldo; Leesa B,0,6,30,30
1650737787189,MATH 142A,A01,083219,Chow; Bennett,0,16,30,30
1650737787189,MATH 142A,A02,083220,Chow; Bennett,0,15,30,30
1650737787189,MATH 142A,B01,083221,Chow; Bennett,0,15,30,30
1650737787189,MATH 142A,B02,083222,Chow; Bennett,0,14,30,30
1650737793212,MATH 193A,A01,083224,Staff,0,5,30,30
1650737793212,MATH 193A,A02,083225,Staff,0,6,30,30
1650737793212,MATH 193A,A03,083781,Staff,0,6,30,30
1650737793212,MATH 193A,A04,083782,Staff,0,7,30,30
1650737799238,MATH 197,001,091859,McAuley; Julian John,9998,0,9999,1
1650737805289,COGS 9,A01,083615,Staff,1,15,60,59
1650737811315,COGS 11,A01,083617,Boyle; Mary E. T.,16,0,40,24
1650737817342,COGS 13,A01,083071,Staff,0,38,40,40
1650737823390,COGS 14A,A01,092681,Staff,0,35,100,100
1650737829416,COGS 14B,A01,083073,Cheng; Tzu-Han,1,13,50,49
1650737835440,COGS 17,A01,092677,Staff,13,0,75,62
1650737841462,COGS 100,A01,083619,Staff,0,28,60,60
1650737847487,COGS 101A,A01,083621,Davis; Joshua Daniel,0,27,60,60
1650737853512,COGS 101B,A01,091572,Staff,0,4,60,60
1650737859537,COGS 101C,A01,083625,Delgado; Tania,14,0,30,16
1650737865561,COGS 107A,A01,083627,Boyle; Mary E. T.,0,16,60,60
1650737871583,COGS 118A,A01,083075,Staff,0,8,60,60
1650737877609,CSE 3,A50,083646,Miranda; Gregory Joseph,18,0,38,20
1650737877609,CSE 3,A51,083647,Miranda; Gregory Joseph,36,0,37,1
1650737883636,CSE 8A,A50,083650,Miranda; Gregory Joseph,0,30,40,40
1650737889660,CSE 11,A01,083080,Cao; Yingjun,0,96,40,40
1650737895686,CSE 12,A01,083652,Staff,0,21,100,100
1650737901714,CSE 15L,A01,083654,Staff,0,3,50,50
1650737901714,CSE 15L,A02,083655,Staff,0,2,50,50
1650737907737,CSE 20,A01,083657,Staff,49,0,80,31
1650737913760,CSE 30,A01,083084,Eldon; John,0,77,40,40
1650737919786,CSE 100,A01,083659,Cao; Yingjun,0,70,50,50
1650737925810,CSE 134B,A01,083661,Powell; Thomas Allan,0,38,65,65
1650737931836,CSE 140,A01,083663,Staff,0,11,75,75
1650737937863,CSE 140L,A01,083088,Eldon; John,0,20,75,75
1650737943889,CSE 175,A01,083665,Kumar; Rakesh,7,0,25,18
1650737949912,CSE 190,A00,092507,Dubnov; Shlomo,10,0,20,10
1650737955936,ECE 45,A01,083139,Staff,1,2,60,59
1650737961960,ECE 65,A50,083695,Staff,0,5,30,30
1650737967983,ECE 109,A01,091882,Touri; Behrouz,33,0,70,37
1650737974010,ECE 180,A00,083140,Abi Samra; Nicholas Camill,20,0,30,10
1650737974010,ECE 180,B00,083141,Abi Samra; Nicholas Camill,0,0,30,30
1650737980033,MATH 10A,A01,083735,Patchell; Gregory David,2,0,30,28
1650737980033,MATH 10A,A02,083736,Patchell; Gregory David,27,0,30,3
1650737980033,MATH 10A,A03,083737,Patchell; Gregory David,24,0,30,6
1650737986057,MATH 10B,A01,083207,Staff,0,9,30,30
1650737986057,MATH 10B,A02,083208,Staff,1,7,30,29
1650737986057,MATH 10B,B01,083739,Staff,11,0,30,19
1650737986057,MATH 10B,B02,083740,Staff,28,0,30,2
1650737992082,MATH 18,A01,083743,Staff,0,0,30,30
1650737992082,MATH 18,A02,083744,Staff,23,0,30,7
1650737992082,MATH 18,A03,083745,Staff,21,0,30,9
1650737992082,MATH 18,A04,083746,Staff,26,0,30,4
1650737992082,MATH 18,B01,083748,Staff,0,15,30,30
1650737992082,MATH 18,B02,083749,Staff,0,12,30,30
1650737992082,MATH 18,B03,083750,Staff,0,12,30,30
1650737992082,MATH 18,B04,083751,Staff,0,12,30,30
1650737998105,MATH 20A,A01,083754,Staff,19,0,40,21
1650738004137,MATH 20B,A01,083756,Staff,0,11,30,30
1650738004137,MATH 20B,A02,083757,Staff,0,12,30,30
1650738010165,MATH 20C,A01,083760,Staff,0,16,30,30
1650738010165,MATH 20C,A02,083761,Staff,0,16,30,30
1650738010165,MATH 20C,B01,083762,Staff,10,0,30,20
1650738010165,MATH 20C,B02,083763,Staff,28,0,30,2
1650738016187,MATH 20D,A01,083765,Staff,2,1,30,28
1650738016187,MATH 20D,A02,083766,Staff,6,0,30,24
1650738016187,MATH 20D,A03,083767,Staff,24,0,30,6
1650738022214,MATH 20E,A01,083771,Staff,3,0,30,27
1650738022214,MATH 20E,A02,083772,Staff,16,0,30,14
1650738022214,MATH 20E,B01,083773,Staff,0,0,30,30
1650738022214,MATH 20E,B02,083774,Staff,6,0,30,24
1650738028239,MATH 103A,A01,083777,Staff,0,16,30,30
1650738028239,MATH 103A,A02,083778,Staff,0,15,30,30
1650738028239,MATH 103A,B01,083779,Staff,0,15,30,30
1650738028239,MATH 103A,B02,083780,Staff,0,15,30,30
1650738034265,MATH 105,A01,085443,Staff,0,22,30,30
1650738040297,MATH 109,A01,083213,Anzaldo; Leesa B,0,7,30,30
1650738040297,MATH 109,A02,083214,Anzaldo; Leesa B,0,7,30,30
1650738040297,MATH 109,B01,083215,Anzaldo; Leesa B,0,8,30,30
1650738040297,MATH 109,B02,083216,Anzaldo; Leesa B,0,6,30,30
1650738046321,MATH 142A,A01,083219,Chow; Bennett,0,16,30,30
1650738046321,MATH 142A,A02,083220,Chow; Bennett,0,15,30,30
1650738046321,MATH 142A,B01,083221,Chow; Bennett,0,15,30,30
1650738046321,MATH 142A,B02,083222,Chow; Bennett,0,14,30,30
1650738052344,MATH 193A,A01,083224,Staff,0,5,30,30
1650738052344,MATH 193A,A02,083225,Staff,0,6,30,30
1650738052344,MATH 193A,A03,083781,Staff,0,6,30,30
1650738052344,MATH 193A,A04,083782,Staff,0,7,30,30
1650738058367,MATH 197,001,091859,McAuley; Julian John,9998,0,9999,1
1650738064420,COGS 9,A01,083615,Staff,1,15,60,59
1650738070453,COGS 11,A01,083617,Boyle; Mary E. T.,16,0,40,24
1650738076477,COGS 13,A01,083071,Staff,0,38,40,40
1650738082509,COGS 14A,A01,092681,Staff,0,35,100,100
1650738088542,COGS 14B,A01,083073,Cheng; Tzu-Han,1,13,50,49
1650738094565,COGS 17,A01,092677,Staff,13,0,75,62
1650738100589,COGS 100,A01,083619,Staff,0,28,60,60
1650738106618,COGS 101A,A01,083621,Davis; Joshua Daniel,0,27,60,60
1650738112642,COGS 101B,A01,091572,Staff,0,4,60,60
1650738118666,COGS 101C,A01,083625,Delgado; Tania,14,0,30,16
1650738124690,COGS 107A,A01,083627,Boyle; Mary E. T.,0,16,60,60
1650738130715,COGS 118A,A01,083075,Staff,0,8,60,60
1650738136746,CSE 3,A50,083646,Miranda; Gregory Joseph,18,0,38,20
1650738136746,CSE 3,A51,083647,Miranda; Gregory Joseph,36,0,37,1
1650738142770,CSE 8A,A50,083650,Miranda; Gregory Joseph,0,30,40,40
1650738148795,CSE 11,A01,083080,Cao; Yingjun,0,96,40,40
1650738154820,CSE 12,A01,083652,Staff,0,21,100,100
1650738160846,CSE 15L,A01,083654,Staff,0,3,50,50
1650738160846,CSE 15L,A02,083655,Staff,0,2,50,50
1650738166870,CSE 20,A01,083657,Staff,49,0,80,31
1650738172892,CSE 30,A01,083084,Eldon; John,0,77,40,40
1650738178919,CSE 100,A01,083659,Cao; Yingjun,0,70,50,50
1650738184943,CSE 134B,A01,083661,Powell; Thomas Allan,0,38,65,65
1650738190966,CSE 140,A01,083663,Staff,0,11,75,75
1650738196988,CSE 140L,A01,083088,Eldon; John,0,20,75,75
1650738203010,CSE 175,A01,083665,Kumar; Rakesh,7,0,25,18
1650738209036,CSE 190,A00,092507,Dubnov; Shlomo,10,0,20,10
1650738215059,ECE 45,A01,083139,Staff,1,2,60,59
1650738221089,ECE 65,A50,083695,Staff,0,5,30,30
1650738227201,ECE 109,A01,091882,Touri; Behrouz,33,0,70,37
1650738233238,ECE 180,A00,083140,Abi Samra; Nicholas Camill,20,0,30,10
1650738233238,ECE 180,B00,083141,Abi Samra; Nicholas Camill,0,0,30,30
1650738239265,MATH 10A,A01,083735,Patchell; Gregory David,2,0,30,28
1650738239265,MATH 10A,A02,083736,Patchell; Gregory David,27,0,30,3
1650738239265,MATH 10A,A03,083737,Patchell; Gregory David,24,0,30,6
1650738245293,MATH 10B,A01,083207,Staff,0,9,30,30
1650738245293,MATH 10B,A02,083208,Staff,1,7,30,29
1650738245293,MATH 10B,B01,083739,Staff,11,0,30,19
1650738245293,MATH 10B,B02,083740,Staff,28,0,30,2
1650738251319,MATH 18,A01,083743,Staff,0,0,30,30
1650738251319,MATH 18,A02,083744,Staff,23,0,30,7
1650738251319,MATH 18,A03,083745,Staff,21,0,30,9
1650738251319,MATH 18,A04,083746,Staff,26,0,30,4
1650738251319,MATH 18,B01,083748,Staff,0,15,30,30
1650738251319,MATH 18,B02,083749,Staff,0,12,30,30
1650738251319,MATH 18,B03,083750,Staff,0,12,30,30
1650738251319,MATH 18,B04,083751,Staff,0,12,30,30
1650738257346,MATH 20A,A01,083754,Staff,19,0,40,21
1650738263379,MATH 20B,A01,083756,Staff,0,11,30,30
1650738263379,MATH 20B,A02,083757,Staff,0,12,30,30
1650738269403,MATH 20C,A01,083760,Staff,0,16,30,30
1650738269403,MATH 20C,A02,083761,Staff,0,16,30,30
1650738269403,MATH 20C,B01,083762,Staff,10,0,30,20
1650738269403,MATH 20C,B02,083763,Staff,28,0,30,2
1650738275429,MATH 20D,A01,083765,Staff,2,1,30,28
1650738275429,MATH 20D,A02,083766,Staff,6,0,30,24
1650738275429,MATH 20D,A03,083767,Staff,24,0,30,6
1650738281453,MATH 20E,A01,083771,Staff,3,0,30,27
1650738281453,MATH 20E,A02,083772,Staff,16,0,30,14
1650738281453,MATH 20E,B01,083773,Staff,0,0,30,30
1650738281453,MATH 20E,B02,083774,Staff,6,0,30,24
1650738287481,MATH 103A,A01,083777,Staff,0,16,30,30
1650738287481,MATH 103A,A02,083778,Staff,0,15,30,30
1650738287481,MATH 103A,B01,083779,Staff,0,15,30,30
1650738287481,MATH 103A,B02,083780,Staff,0,15,30,30
1650738293504,MATH 105,A01,085443,Staff,0,22,30,30
1650738299534,MATH 109,A01,083213,Anzaldo; Leesa B,0,7,30,30
1650738299534,MATH 109,A02,083214,Anzaldo; Leesa B,0,7,30,30
1650738299534,MATH 109,B01,083215,Anzaldo; Leesa B,0,8,30,30
1650738299534,MATH 109,B02,083216,Anzaldo; Leesa B,0,6,30,30
1650738305561,MATH 142A,A01,083219,Chow; Bennett,0,16,30,30
1650738305561,MATH 142A,A02,083220,Chow; Bennett,0,15,30,30
1650738305561,MATH 142A,B01,083221,Chow; Bennett,0,15,30,30
1650738305561,MATH 142A,B02,083222,Chow; Bennett,0,14,30,30
1650738311586,MATH 193A,A01,083224,Staff,0,5,30,30
1650738311586,MATH 193A,A02,083225,Staff,0,6,30,30
1650738311586,MATH 193A,A03,083781,Staff,0,6,30,30
1650738311586,MATH 193A,A04,083782,Staff,0,7,30,30
1650738317609,MATH 197,001,091859,McAuley; Julian John,9998,0,9999,1
1650738323659,COGS 9,A01,083615,Staff,1,15,60,59
1650738329684,COGS 11,A01,083617,Boyle; Mary E. T.,16,0,40,24
1650738335706,COGS 13,A01,083071,Staff,0,38,40,40
1650738341731,COGS 14A,A01,092681,Staff,0,35,100,100
1650738347758,COGS 14B,A01,083073,Cheng; Tzu-Han,1,13,50,49
1650738353781,COGS 17,A01,092677,Staff,13,0,75,62
1650738359804,COGS 100,A01,083619,Staff,0,28,60,60
1650738365826,COGS 101A,A01,083621,Davis; Joshua Daniel,0,27,60,60
1650738371854,COGS 101B,A01,091572,Staff,0,4,60,60
1650738377877,COGS 101C,A01,083625,Delgado; Tania,14,0,30,16
1650738383903,COGS 107A,A01,083627,Boyle; Mary E. T.,0,16,60,60
1650738389930,COGS 118A,A01,083075,Staff,0,8,60,60
1650738395957,CSE 3,A50,083646,Miranda; Gregory Joseph,18,0,38,20
1650738395957,CSE 3,A51,083647,Miranda; Gregory Joseph,36,0,37,1
1650738401984,CSE 8A,A50,083650,Miranda; Gregory Joseph,0,30,40,40
1650738408010,CSE 11,A01,083080,Cao; Yingjun,0,96,40,40
1650738414036,CSE 12,A01,083652,Staff,0,21,100,100
1650738420061,CSE 15L,A01,083654,Staff,0,3,50,50
1650738420061,CSE 15L,A02,083655,Staff,0,2,50,50
1650738426083,CSE 20,A01,083657,Staff,49,0,80,31
1650738432129,CSE 30,A01,083084,Eldon; John,0,77,40,40
1650738438162,CSE 100,A01,083659,Cao; Yingjun,0,70,50,50
1650738444196,CSE 134B,A01,083661,Powell; Thomas Allan,0,38,65,65
1650738450223,CSE 140,A01,083663,Staff,0,11,75,75
1650738456248,CSE 140L,A01,083088,Eldon; John,0,20,75,75
1650738462274,CSE 175,A01,083665,Kumar; Rakesh,7,0,25,18
1650738468301,CSE 190,A00,092507,Dubnov; Shlomo,10,0,20,10
1650738474325,ECE 45,A01,083139,Staff,1,2,60,59
1650738480347,ECE 65,A50,083695,Staff,0,5,30,30
1650738486372,ECE 109,A01,091882,Touri; Behrouz,33,0,70,37
1650738492398,ECE 180,A00,083140,Abi Samra; Nicholas Camill,20,0,30,10
1650738492398,ECE 180,B00,083141,Abi Samra; Nicholas Camill,0,0,30,30
1650738498428,MATH 10A,A01,083735,Patchell; Gregory David,2,0,30,28
1650738498428,MATH 10A,A02,083736,Patchell; Gregory David,27,0,30,3
1650738498428,MATH 10A,A03,083737,Patchell; Gregory David,24,0,30,6
1650738504454,MATH 10B,A01,083207,Staff,0,9,30,30
1650738504454,MATH 10B,A02,083208,Staff,1,7,30,29
1650738504454,MATH 10B,B01,083739,Staff,11,0,30,19
1650738504454,MATH 10B,B02,083740,Staff,28,0,30,2
1650738510483,MATH 18,A01,083743,Staff,0,0,30,30
1650738510483,MATH 18,A02,083744,Staff,23,0,30,7
1650738510483,MATH 18,A03,083745,Staff,21,0,30,9
1650738510483,MATH 18,A04,083746,Staff,26,0,30,4
1650738510483,MATH 18,B01,083748,Staff,0,15,30,30
1650738510483,MATH 18,B02,083749,Staff,0,12,30,30
1650738510483,MATH 18,B03,083750,Staff,0,12,30,30
1650738510483,MATH 18,B04,083751,Staff,0,12,30,30
1650738516507,MATH 20A,A01,083754,Staff,19,0,40,21
1650738522532,MATH 20B,A01,083756,Staff,0,11,30,30
1650738522532,MATH 20B,A02,083757,Staff,0,12,30,30
1650738528560,MATH 20C,A01,083760,Staff,0,16,30,30
1650738528560,MATH 20C,A02,083761,Staff,0,16,30,30
1650738528560,MATH 20C,B01,083762,Staff,10,0,30,20
1650738528560,MATH 20C,B02,083763,Staff,28,0,30,2
1650738534587,MATH 20D,A01,083765,Staff,2,1,30,28
1650738534587,MATH 20D,A02,083766,Staff,6,0,30,24
1650738534587,MATH 20D,A03,083767,Staff,24,0,30,6
1650738540610,MATH 20E,A01,083771,Staff,3,0,30,27
1650738540610,MATH 20E,A02,083772,Staff,16,0,30,14
1650738540610,MATH 20E,B01,083773,Staff,0,0,30,30
1650738540610,MATH 20E,B02,083774,Staff,6,0,30,24
1650738546638,MATH 103A,A01,083777,Staff,0,16,30,30
1650738546638,MATH 103A,A02,083778,Staff,0,15,30,30
1650738546638,MATH 103A,B01,083779,Staff,0,15,30,30
1650738546638,MATH 103A,B02,083780,Staff,0,15,30,30
1650738552660,MATH 105,A01,085443,Staff,0,22,30,30
1650738558686,MATH 109,A01,083213,Anzaldo; Leesa B,0,7,30,30
1650738558686,MATH 109,A02,083214,Anzaldo; Leesa B,0,7,30,30
1650738558686,MATH 109,B01,083215,Anzaldo; Leesa B,0,8,30,30
1650738558686,MATH 109,B02,083216,Anzaldo; Leesa B,0,6,30,30
1650738564715,MATH 142A,A01,083219,Chow; Bennett,0,16,30,30
1650738564715,MATH 142A,A02,083220,Chow; Bennett,0,15,30,30
1650738564715,MATH 142A,B01,083221,Chow; Bennett,0,15,30,30
1650738564715,MATH 142A,B02,083222,Chow; Bennett,0,14,30,30
1650738570742,MATH 193A,A01,083224,Staff,0,5,30,30
1650738570742,MATH 193A,A02,083225,Staff,0,6,30,30
1650738570742,MATH 193A,A03,083781,Staff,0,6,30,30
1650738570742,MATH 193A,A04,083782,Staff,0,7,30,30
1650738576765,MATH 197,001,091859,McAuley; Julian John,9998,0,9999,1
1650738582814,COGS 9,A01,083615,Staff,1,15,60,59
1650738588852,COGS 11,A01,083617,Boyle; Mary E. T.,16,0,40,24
1650738594879,COGS 13,A01,083071,Staff,0,38,40,40
1650738600902,COGS 14A,A01,092681,Staff,0,35,100,100
1650738606928,COGS 14B,A01,083073,Cheng; Tzu-Han,1,13,50,49
1650738612951,COGS 17,A01,092677,Staff,13,0,75,62
1650738618974,COGS 100,A01,083619,Staff,0,28,60,60
1650738625000,COGS 101A,A01,083621,Davis; Joshua Daniel,0,27,60,60
1650738631023,COGS 101B,A01,091572,Staff,0,4,60,60
1650738637045,COGS 101C,A01,083625,Delgado; Tania,14,0,30,16
1650738643071,COGS 107A,A01,083627,Boyle; Mary E. T.,0,16,60,60
1650738649097,COGS 118A,A01,083075,Staff,0,8,60,60
1650738655129,CSE 3,A50,083646,Miranda; Gregory Joseph,18,0,38,20
1650738655129,CSE 3,A51,083647,Miranda; Gregory Joseph,36,0,37,1
1650738661153,CSE 8A,A50,083650,Miranda; Gregory Joseph,0,30,40,40
1650738667176,CSE 11,A01,083080,Cao; Yingjun,0,96,40,40
1650738673201,CSE 12,A01,083652,Staff,0,21,100,100
1650738679230,CSE 15L,A01,083654,Staff,0,3,50,50
1650738679230,CSE 15L,A02,083655,Staff,0,2,50,50
1650738685257,CSE 20,A01,083657,Staff,49,0,80,31
1650738691283,CSE 30,A01,083084,Eldon; John,0,77,40,40
1650738697315,CSE 100,A01,083659,Cao; Yingjun,0,70,50,50
1650738703338,CSE 134B,A01,083661,Powell; Thomas Allan,0,38,65,65
1650738709365,CSE 140,A01,083663,Staff,0,11,75,75
1650738715388,CSE 140L,A01,083088,Eldon; John,0,20,75,75
1650738721411,CSE 175,A01,083665,Kumar; Rakesh,7,0,25,18
1650738727436,CSE 190,A00,092507,Dubnov; Shlomo,10,0,20,10
1650738733462,ECE 45,A01,083139,Staff,1,2,60,59
1650738739488,ECE 65,A50,083695,Staff,0,5,30,30
1650738745515,ECE 109,A01,091882,Touri; Behrouz,33,0,70,37
1650738751542,ECE 180,A00,083140,Abi Samra; Nicholas Camill,20,0,30,10
1650738751542,ECE 180,B00,083141,Abi Samra; Nicholas Camill,0,0,30,30
1650738757568,MATH 10A,A01,083735,Patchell; Gregory David,2,0,30,28
1650738757568,MATH 10A,A02,083736,Patchell; Gregory David,27,0,30,3
1650738757568,MATH 10A,A03,083737,Patchell; Gregory David,24,0,30,6
1650738763593,MATH 10B,A01,083207,Staff,0,9,30,30
1650738763593,MATH 10B,A02,083208,Staff,1,7,30,29
1650738763593,MATH 10B,B01,083739,Staff,11,0,30,19
1650738763593,MATH 10B,B02,083740,Staff,28,0,30,2
1650738769622,MATH 18,A01,083743,Staff,0,0,30,30
1650738769622,MATH 18,A02,083744,Staff,23,0,30,7
1650738769622,MATH 18,A03,083745,Staff,21,0,30,9
1650738769622,MATH 18,A04,083746,Staff,26,0,30,4
1650738769622,MATH 18,B01,083748,Staff,0,15,30,30
1650738769622,MATH 18,B02,083749,Staff,0,12,30,30
1650738769622,MATH 18,B03,083750,Staff,0,12,30,30
1650738769622,MATH 18,B04,083751,Staff,0,12,30,30
1650738775647,MATH 20A,A01,083754,Staff,19,0,40,21
1650738781670,MATH 20B,A01,083756,Staff,0,11,30,30
1650738781670,MATH 20B,A02,083757,Staff,0,12,30,30
1650738787708,MATH 20C,A01,083760,Staff,0,16,30,30
1650738787708,MATH 20C,A02,083761,Staff,0,16,30,30
1650738787708,MATH 20C,B01,083762,Staff,10,0,30,20
1650738787708,MATH 20C,B02,083763,Staff,28,0,30,2
1650738793735,MATH 20D,A01,083765,Staff,2,1,30,28
1650738793735,MATH 20D,A02,083766,Staff,6,0,30,24
1650738793735,MATH 20D,A03,083767,Staff,24,0,30,6
1650738799762,MATH 20E,A01,083771,Staff,3,0,30,27
1650738799762,MATH 20E,A02,083772,Staff,16,0,30,14
1650738799762,MATH 20E,B01,083773,Staff,0,0,30,30
1650738799762,MATH 20E,B02,083774,Staff,6,0,30,24
1650738805786,MATH 103A,A01,083777,Staff,0,16,30,30
1650738805786,MATH 103A,A02,083778,Staff,0,15,30,30
1650738805786,MATH 103A,B01,083779,Staff,0,15,30,30
1650738805786,MATH 103A,B02,083780,Staff,0,15,30,30
1650738811810,MATH 105,A01,085443,Staff,0,22,30,30
1650738817834,MATH 109,A01,083213,Anzaldo; Leesa B,0,7,30,30
1650738817834,MATH 109,A02,083214,Anzaldo; Leesa B,0,7,30,30
1650738817834,MATH 109,B01,083215,Anzaldo; Leesa B,0,8,30,30
1650738817834,MATH 109,B02,083216,Anzaldo; Leesa B,0,6,30,30
1650738823958,MATH 142A,A01,083219,Chow; Bennett,0,16,30,30
1650738823958,MATH 142A,A02,083220,Chow; Bennett,0,15,30,30
1650738823958,MATH 142A,B01,083221,Chow; Bennett,0,15,30,30
1650738823958,MATH 142A,B02,083222,Chow; Bennett,0,14,30,30
1650738829982,MATH 193A,A01,083224,Staff,0,5,30,30
1650738829982,MATH 193A,A02,083225,Staff,0,6,30,30
1650738829982,MATH 193A,A03,083781,Staff,0,6,30,30
1650738829982,MATH 193A,A04,083782,Staff,0,7,30,30
1650738836009,MATH 197,001,091859,McAuley; Julian John,9998,0,9999,1
1650738842069,COGS 9,A01,083615,Staff,1,15,60,59
1650738848096,COGS 11,A01,083617,Boyle; Mary E. T.,16,0,40,24
1650738854119,COGS 13,A01,083071,Staff,0,38,40,40
1650738860151,COGS 14A,A01,092681,Staff,0,35,100,100
1650738866175,COGS 14B,A01,083073,Cheng; Tzu-Han,1,13,50,49
1650738872199,COGS 17,A01,092677,Staff,13,0,75,62
1650738878223,COGS 100,A01,083619,Staff,0,28,60,60
1650738884248,COGS 101A,A01,083621,Davis; Joshua Daniel,0,27,60,60
1650738890270,COGS 101B,A01,091572,Staff,0,4,60,60
1650738896295,COGS 101C,A01,083625,Delgado; Tania,14,0,30,16
1650738902323,COGS 107A,A01,083627,Boyle; Mary E. T.,0,16,60,60
1650738908349,COGS 118A,A01,083075,Staff,0,8,60,60
1650738914371,CSE 3,A50,083646,Miranda; Gregory Joseph,18,0,38,20
1650738914371,CSE 3,A51,083647,Miranda; Gregory Joseph,36,0,37,1
1650738920393,CSE 8A,A50,083650,Miranda; Gregory Joseph,0,30,40,40
1650738926419,CSE 11,A01,083080,Cao; Yingjun,0,96,40,40
1650738932447,CSE 12,A01,083652,Staff,0,21,100,100
1650738938470,CSE 15L,A01,083654,Staff,0,3,50,50
1650738938470,CSE 15L,A02,083655,Staff,0,2,50,50
1650738944492,CSE 20,A01,083657,Staff,49,0,80,31
1650738950523,CSE 30,A01,083084,Eldon; John,0,77,40,40
1650738956547,CSE 100,A01,083659,Cao; Yingjun,0,70,50,50
1650738962575,CSE 134B,A01,083661,Powell; Thomas Allan,0,38,65,65
1650738968600,CSE 140,A01,083663,Staff,0,11,75,75
1650738974624,CSE 140L,A01,083088,Eldon; John,0,20,75,75
1650738980648,CSE 175,A01,083665,Kumar; Rakesh,7,0,25,18
1650738986671,CSE 190,A00,092507,Dubnov; Shlomo,10,0,20,10
1650738992694,ECE 45,A01,083139,Staff,1,2,60,59
1650738998722,ECE 65,A50,083695,Staff,0,5,30,30
1650739004749,ECE 109,A01,091882,Touri; Behrouz,33,0,70,37
1650739010777,ECE 180,A00,083140,Abi Samra; Nicholas Camill,20,0,30,10
1650739010777,ECE 180,B00,083141,Abi Samra; Nicholas Camill,0,0,30,30
1650739016802,MATH 10A,A01,083735,Patchell; Gregory David,2,0,30,28
1650739016802,MATH 10A,A02,083736,Patchell; Gregory David,27,0,30,3
1650739016802,MATH 10A,A03,083737,Patchell; Gregory David,24,0,30,6
1650739022827,MATH 10B,A01,083207,Staff,0,9,30,30
1650739022827,MATH 10B,A02,083208,Staff,1,7,30,29
1650739022827,MATH 10B,B01,083739,Staff,11,0,30,19
1650739022827,MATH 10B,B02,083740,Staff,28,0,30,2
1650739028858,MATH 18,A01,083743,Staff,0,0,30,30
1650739028858,MATH 18,A02,083744,Staff,23,0,30,7
1650739028858,MATH 18,A03,083745,Staff,21,0,30,9
1650739028858,MATH 18,A04,083746,Staff,26,0,30,4
1650739028858,MATH 18,B01,083748,Staff,0,15,30,30
1650739028858,MATH 18,B02,083749,Staff,0,12,30,30
1650739028858,MATH 18,B03,083750,Staff,0,12,30,30
1650739028858,MATH 18,B04,083751,Staff,0,12,30,30
1650739034884,MATH 20A,A01,083754,Staff,19,0,40,21
1650739040910,MATH 20B,A01,083756,Staff,0,11,30,30
1650739040910,MATH 20B,A02,083757,Staff,0,12,30,30
1650739046943,MATH 20C,A01,083760,Staff,0,16,30,30
1650739046943,MATH 20C,A02,083761,Staff,0,16,30,30
1650739046943,MATH 20C,B01,083762,Staff,10,0,30,20
1650739046943,MATH 20C,B02,083763,Staff,28,0,30,2
1650739052968,MATH 20D,A01,083765,Staff,2,1,30,28
1650739052968,MATH 20D,A02,083766,Staff,6,0,30,24
1650739052968,MATH 20D,A03,083767,Staff,24,0,30,6
1650739058993,MATH 20E,A01,083771,Staff,3,0,30,27
1650739058993,MATH 20E,A02,083772,Staff,16,0,30,14
1650739058993,MATH 20E,B01,083773,Staff,0,0,30,30
1650739058993,MATH 20E,B02,083774,Staff,6,0,30,24
1650739065017,MATH 103A,A01,083777,Staff,0,16,30,30
1650739065017,MATH 103A,A02,083778,Staff,0,15,30,30
1650739065017,MATH 103A,B01,083779,Staff,0,15,30,30
1650739065017,MATH 103A,B02,083780,Staff,0,15,30,30
1650739071044,MATH 105,A01,085443,Staff,0,22,30,30
1650739077076,MATH 109,A01,083213,Anzaldo; Leesa B,0,7,30,30
1650739077076,MATH 109,A02,083214,Anzaldo; Leesa B,0,7,30,30
1650739077076,MATH 109,B01,083215,Anzaldo; Leesa B,0,8,30,30
1650739077076,MATH 109,B02,083216,Anzaldo; Leesa B,0,6,30,30
1650739083104,MATH 142A,A01,083219,Chow; Bennett,0,16,30,30
1650739083104,MATH 142A,A02,083220,Chow; Bennett,0,15,30,30
1650739083104,MATH 142A,B01,083221,Chow; Bennett,0,15,30,30
1650739083104,MATH 142A,B02,083222,Chow; Bennett,0,14,30,30
1650739089133,MATH 193A,A01,083224,Staff,0,5,30,30
1650739089133,MATH 193A,A02,083225,Staff,0,6,30,30
1650739089133,MATH 193A,A03,083781,Staff,0,6,30,30
1650739089133,MATH 193A,A04,083782,Staff,0,7,30,30
1650739095157,MATH 197,001,091859,McAuley; Julian John,9998,0,9999,1
1650739101218,COGS 9,A01,083615,Staff,1,15,60,59
1650739107240,COGS 11,A01,083617,Boyle; Mary E. T.,16,0,40,24
1650739113261,COGS 13,A01,083071,Staff,0,38,40,40
1650739119290,COGS 14A,A01,092681,Staff,0,35,100,100
1650739125314,COGS 14B,A01,083073,Cheng; Tzu-Han,1,13,50,49
1650739131337,COGS 17,A01,092677,Staff,13,0,75,62
1650739137361,COGS 100,A01,083619,Staff,0,28,60,60
1650739143385,COGS 101A,A01,083621,Davis; Joshua Daniel,0,27,60,60
1650739149414,COGS 101B,A01,091572,Staff,0,4,60,60
1650739155441,COGS 101C,A01,083625,Delgado; Tania,14,0,30,16
1650739161463,COGS 107A,A01,083627,Boyle; Mary E. T.,0,16,60,60
1650739167489,COGS 118A,A01,083075,Staff,0,8,60,60
1650739173517,CSE 3,A50,083646,Miranda; Gregory Joseph,18,0,38,20
1650739173517,CSE 3,A51,083647,Miranda; Gregory Joseph,36,0,37,1
1650739179542,CSE 8A,A50,083650,Miranda; Gregory Joseph,0,30,40,40
1650739185578,CSE 11,A01,083080,Cao; Yingjun,0,96,40,40
1650739191601,CSE 12,A01,083652,Staff,0,21,100,100
1650739197626,CSE 15L,A01,083654,Staff,0,3,50,50
1650739197626,CSE 15L,A02,083655,Staff,0,2,50,50
1650739203650,CSE 20,A01,083657,Staff,49,0,80,31
1650739209678,CSE 30,A01,083084,Eldon; John,0,77,40,40
1650739215702,CSE 100,A01,083659,Cao; Yingjun,0,70,50,50
1650739221727,CSE 134B,A01,083661,Powell; Thomas Allan,0,38,65,65
1650739227752,CSE 140,A01,083663,Staff,0,11,75,75
1650739233775,CSE 140L,A01,083088,Eldon; John,0,20,75,75
1650739239799,CSE 175,A01,083665,Kumar; Rakesh,7,0,25,18
1650739245825,CSE 190,A00,092507,Dubnov; Shlomo,10,0,20,10
1650739251848,ECE 45,A01,083139,Staff,1,2,60,59
1650739257882,ECE 65,A50,083695,Staff,0,5,30,30
1650739263905,ECE 109,A01,091882,Touri; Behrouz,33,0,70,37
1650739269928,ECE 180,A00,083140,Abi Samra; Nicholas Camill,20,0,30,10
1650739269928,ECE 180,B00,083141,Abi Samra; Nicholas Camill,0,0,30,30
1650739275956,MATH 10A,A01,083735,Patchell; Gregory David,2,0,30,28
1650739275956,MATH 10A,A02,083736,Patchell; Gregory David,27,0,30,3
1650739275956,MATH 10A,A03,083737,Patchell; Gregory David,24,0,30,6
1650739281980,MATH 10B,A01,083207,Staff,0,9,30,30
1650739281980,MATH 10B,A02,083208,Staff,1,7,30,29
1650739281980,MATH 10B,B01,083739,Staff,11,0,30,19
1650739281980,MATH 10B,B02,083740,Staff,28,0,30,2
1650739288006,MATH 18,A01,083743,Staff,0,0,30,30
1650739288006,MATH 18,A02,083744,Staff,23,0,30,7
1650739288006,MATH 18,A03,083745,Staff,21,0,30,9
1650739288006,MATH 18,A04,083746,Staff,26,0,30,4
1650739288006,MATH 18,B01,083748,Staff,0,15,30,30
1650739288006,MATH 18,B02,083749,Staff,0,12,30,30
1650739288006,MATH 18,B03,083750,Staff,0,12,30,30
1650739288006,MATH 18,B04,083751,Staff,0,12,30,30
1650739294033,MATH 20A,A01,083754,Staff,19,0,40,21
1650739300057,MATH 20B,A01,083756,Staff,0,11,30,30
1650739300057,MATH 20B,A02,083757,Staff,0,12,30,30
1650739306084,MATH 20C,A01,083760,Staff,0,16,30,30
1650739306084,MATH 20C,A02,083761,Staff,0,16,30,30
1650739306084,MATH 20C,B01,083762,Staff,10,0,30,20
1650739306084,MATH 20C,B02,083763,Staff,28,0,30,2
1650739312111,MATH 20D,A01,083765,Staff,2,1,30,28
1650739312111,MATH 20D,A02,083766,Staff,6,0,30,24
1650739312111,MATH 20D,A03,083767,Staff,24,0,30,6
1650739318133,MATH 20E,A01,083771,Staff,3,0,30,27
1650739318133,MATH 20E,A02,083772,Staff,16,0,30,14
1650739318133,MATH 20E,B01,083773,Staff,0,0,30,30
1650739318133,MATH 20E,B02,083774,Staff,6,0,30,24
1650739324161,MATH 103A,A01,083777,Staff,0,16,30,30
1650739324161,MATH 103A,A02,083778,Staff,0,15,30,30
1650739324161,MATH 103A,B01,083779,Staff,0,15,30,30
1650739324161,MATH 103A,B02,083780,Staff,0,15,30,30
1650739330184,MATH 105,A01,085443,Staff,0,22,30,30
1650739336205,MATH 109,A01,083213,Anzaldo; Leesa B,0,7,30,30
1650739336205,MATH 109,A02,083214,Anzaldo; Leesa B,0,7,30,30
1650739336205,MATH 109,B01,083215,Anzaldo; Leesa B,0,8,30,30
1650739336205,MATH 109,B02,083216,Anzaldo; Leesa B,0,6,30,30
1650739342230,MATH 142A,A01,083219,Chow; Bennett,0,16,30,30
1650739342230,MATH 142A,A02,083220,Chow; Bennett,0,15,30,30
1650739342230,MATH 142A,B01,083221,Chow; Bennett,0,15,30,30
1650739342230,MATH 142A,B02,083222,Chow; Bennett,0,14,30,30
1650739348254,MATH 193A,A01,083224,Staff,0,5,30,30
1650739348254,MATH 193A,A02,083225,Staff,0,6,30,30
1650739348254,MATH 193A,A03,083781,Staff,0,6,30,30
1650739348254,MATH 193A,A04,083782,Staff,0,7,30,30
1650739354276,MATH 197,001,091859,McAuley; Julian John,9998,0,9999,1
1650739360324,COGS 9,A01,083615,Staff,1,15,60,59
1650739366347,COGS 11,A01,083617,Boyle; Mary E. T.,16,0,40,24
1650739372370,COGS 13,A01,083071,Staff,0,38,40,40
1650739378393,COGS 14A,A01,092681,Staff,0,35,100,100
1650739384420,COGS 14B,A01,083073,Cheng; Tzu-Han,1,13,50,49
1650739390443,COGS 17,A01,092677,Staff,13,0,75,62
1650739396468,COGS 100,A01,083619,Staff,0,28,60,60
1650739402496,COGS 101A,A01,083621,Davis; Joshua Daniel,0,27,60,60
1650739408518,COGS 101B,A01,091572,Staff,0,4,60,60
1650739414632,COGS 101C,A01,083625,Delgado; Tania,14,0,30,16
1650739420654,COGS 107A,A01,083627,Boyle; Mary E. T.,0,16,60,60
1650739426679,COGS 118A,A01,083075,Staff,0,8,60,60
1650739432706,CSE 3,A50,083646,Miranda; Gregory Joseph,18,0,38,20
1650739432706,CSE 3,A51,083647,Miranda; Gregory Joseph,36,0,37,1
1650739438728,CSE 8A,A50,083650,Miranda; Gregory Joseph,0,30,40,40
1650739444756,CSE 11,A01,083080,Cao; Yingjun,0,96,40,40
1650739450780,CSE 12,A01,083652,Staff,0,21,100,100
1650739456806,CSE 15L,A01,083654,Staff,0,3,50,50
1650739456806,CSE 15L,A02,083655,Staff,0,2,50,50
1650739462831,CSE 20,A01,083657,Staff,49,0,80,31
1650739468856,CSE 30,A01,083084,Eldon; John,0,77,40,40
1650739474883,CSE 100,A01,083659,Cao; Yingjun,0,70,50,50
1650739480910,CSE 134B,A01,083661,Powell; Thomas Allan,0,38,65,65
1650739486941,CSE 140,A01,083663,Staff,0,11,75,75
1650739492965,CSE 140L,A01,083088,Eldon; John,0,20,75,75
1650739498998,CSE 175,A01,083665,Kumar; Rakesh,7,0,25,18
1650739505025,CSE 190,A00,092507,Dubnov; Shlomo,10,0,20,10
1650739511046,ECE 45,A01,083139,Staff,1,2,60,59
1650739517074,ECE 65,A50,083695,Staff,0,5,30,30
1650739523100,ECE 109,A01,091882,Touri; Behrouz,33,0,70,37
1650739529122,ECE 180,A00,083140,Abi Samra; Nicholas Camill,20,0,30,10
1650739529122,ECE 180,B00,083141,Abi Samra; Nicholas Camill,0,0,30,30
1650739535145,MATH 10A,A01,083735,Patchell; Gregory David,2,0,30,28
1650739535145,MATH 10A,A02,083736,Patchell; Gregory David,27,0,30,3
1650739535145,MATH 10A,A03,083737,Patchell; Gregory David,24,0,30,6
1650739541170,MATH 10B,A01,083207,Staff,0,9,30,30
1650739541170,MATH 10B,A02,083208,Staff,1,7,30,29
1650739541170,MATH 10B,B01,083739,Staff,11,0,30,19
1650739541170,MATH 10B,B02,083740,Staff,28,0,30,2
1650739547193,MATH 18,A01,083743,Staff,0,0,30,30
1650739547193,MATH 18,A02,083744,Staff,23,0,30,7
1650739547193,MATH 18,A03,083745,Staff,21,0,30,9
1650739547193,MATH 18,A04,083746,Staff,26,0,30,4
1650739547193,MATH 18,B01,083748,Staff,0,15,30,30
1650739547193,MATH 18,B02,083749,Staff,0,12,30,30
1650739547193,MATH 18,B03,083750,Staff,0,12,30,30
1650739547193,MATH 18,B04,083751,Staff,0,12,30,30
1650739553215,MATH 20A,A01,083754,Staff,19,0,40,21
1650739559240,MATH 20B,A01,083756,Staff,0,11,30,30
1650739559240,MATH 20B,A02,083757,Staff,0,12,30,30
1650739565262,MATH 20C,A01,083760,Staff,0,16,30,30
1650739565262,MATH 20C,A02,083761,Staff,0,16,30,30
1650739565262,MATH 20C,B01,083762,Staff,10,0,30,20
1650739565262,MATH 20C,B02,083763,Staff,28,0,30,2
1650739571286,MATH 20D,A01,083765,Staff,2,1,30,28
1650739571286,MATH 20D,A02,083766,Staff,6,0,30,24
1650739571286,MATH 20D,A03,083767,Staff,24,0,30,6
1650739577313,MATH 20E,A01,083771,Staff,3,0,30,27
1650739577313,MATH 20E,A02,083772,Staff,16,0,30,14
1650739577313,MATH 20E,B01,083773,Staff,0,0,30,30
1650739577313,MATH 20E,B02,083774,Staff,6,0,30,24
1650739583337,MATH 103A,A01,083777,Staff,0,16,30,30
1650739583337,MATH 103A,A02,083778,Staff,0,15,30,30
1650739583337,MATH 103A,B01,083779,Staff,0,15,30,30
1650739583337,MATH 103A,B02,083780,Staff,0,15,30,30
1650739589360,MATH 105,A01,085443,Staff,0,22,30,30
1650739595380,MATH 109,A01,083213,Anzaldo; Leesa B,0,7,30,30
1650739595380,MATH 109,A02,083214,Anzaldo; Leesa B,0,7,30,30
1650739595380,MATH 109,B01,083215,Anzaldo; Leesa B,0,8,30,30
1650739595380,MATH 109,B02,083216,Anzaldo; Leesa B,0,6,30,30
1650739601408,MATH 142A,A01,083219,Chow; Bennett,0,16,30,30
1650739601408,MATH 142A,A02,083220,Chow; Bennett,0,15,30,30
1650739601408,MATH 142A,B01,083221,Chow; Bennett,0,15,30,30
1650739601408,MATH 142A,B02,083222,Chow; Bennett,0,14,30,30
1650739607431,MATH 193A,A01,083224,Staff,0,5,30,30
1650739607431,MATH 193A,A02,083225,Staff,0,6,30,30
1650739607431,MATH 193A,A03,083781,Staff,0,6,30,30
1650739607431,MATH 193A,A04,083782,Staff,0,7,30,30
1650739613460,MATH 197,001,091859,McAuley; Julian John,9998,0,9999,1
1650739619515,COGS 9,A01,083615,Staff,1,15,60,59
1650739625540,COGS 11,A01,083617,Boyle; Mary E. T.,16,0,40,24
1650739631563,COGS 13,A01,083071,Staff,0,38,40,40
1650739637584,COGS 14A,A01,092681,Staff,0,35,100,100
1650739643606,COGS 14B,A01,083073,Cheng; Tzu-Han,1,13,50,49
1650739649630,COGS 17,A01,092677,Staff,13,0,75,62
1650739655665,COGS 100,A01,083619,Staff,0,28,60,60
1650739661687,COGS 101A,A01,083621,Davis; Joshua Daniel,0,27,60,60
1650739667713,COGS 101B,A01,091572,Staff,0,4,60,60
1650739673735,COGS 101C,A01,083625,Delgado; Tania,14,0,30,16
1650739679761,COGS 107A,A01,083627,Boyle; Mary E. T.,0,16,60,60
1650739685784,COGS 118A,A01,083075,Staff,0,8,60,60
1650739691804,CSE 3,A50,083646,Miranda; Gregory Joseph,18,0,38,20
1650739691804,CSE 3,A51,083647,Miranda; Gregory Joseph,36,0,37,1
1650739697829,CSE 8A,A50,083650,Miranda; Gregory Joseph,0,30,40,40
1650739703856,CSE 11,A01,083080,Cao; Yingjun,0,96,40,40
1650739709882,CSE 12,A01,083652,Staff,0,21,100,100
1650739715952,CSE 15L,A01,083654,Staff,0,3,50,50
1650739715952,CSE 15L,A02,083655,Staff,0,2,50,50
1650739721976,CSE 20,A01,083657,Staff,49,0,80,31
1650739728010,CSE 30,A01,083084,Eldon; John,0,77,40,40
1650739734032,CSE 100,A01,083659,Cao; Yingjun,0,70,50,50
1650739740059,CSE 134B,A01,083661,Powell; Thomas Allan,0,38,65,65
1650739746087,CSE 140,A01,083663,Staff,0,11,75,75
1650739752111,CSE 140L,A01,083088,Eldon; John,0,20,75,75
1650739758133,CSE 175,A01,083665,Kumar; Rakesh,7,0,25,18
1650739764156,CSE 190,A00,092507,Dubnov; Shlomo,10,0,20,10
1650739770178,ECE 45,A01,083139,Staff,1,2,60,59
1650739776204,ECE 65,A50,083695,Staff,0,5,30,30
1650739782230,ECE 109,A01,091882,Touri; Behrouz,33,0,70,37
1650739788253,ECE 180,A00,083140,Abi Samra; Nicholas Camill,20,0,30,10
1650739788253,ECE 180,B00,083141,Abi Samra; Nicholas Camill,0,0,30,30
1650739794281,MATH 10A,A01,083735,Patchell; Gregory David,2,0,30,28
1650739794281,MATH 10A,A02,083736,Patchell; Gregory David,27,0,30,3
1650739794281,MATH 10A,A03,083737,Patchell; Gregory David,24,0,30,6
1650739800309,MATH 10B,A01,083207,Staff,0,9,30,30
1650739800309,MATH 10B,A02,083208,Staff,1,7,30,29
1650739800309,MATH 10B,B01,083739,Staff,11,0,30,19
1650739800309,MATH 10B,B02,083740,Staff,28,0,30,2
1650739806332,MATH 18,A01,083743,Staff,0,0,30,30
1650739806332,MATH 18,A02,083744,Staff,23,0,30,7
1650739806332,MATH 18,A03,083745,Staff,21,0,30,9
1650739806332,MATH 18,A04,083746,Staff,26,0,30,4
1650739806332,MATH 18,B01,083748,Staff,0,15,30,30
1650739806332,MATH 18,B02,083749,Staff,0,12,30,30
1650739806332,MATH 18,B03,083750,Staff,0,12,30,30
1650739806332,MATH 18,B04,083751,Staff,0,12,30,30
1650739812357,MATH 20A,A01,083754,Staff,19,0,40,21
1650739818381,MATH 20B,A01,083756,Staff,0,11,30,30
1650739818381,MATH 20B,A02,083757,Staff,0,12,30,30
1650739824405,MATH 20C,A01,083760,Staff,0,16,30,30
1650739824405,MATH 20C,A02,083761,Staff,0,16,30,30
1650739824405,MATH 20C,B01,083762,Staff,10,0,30,20
1650739824405,MATH 20C,B02,083763,Staff,28,0,30,2
1650739830428,MATH 20D,A01,083765,Staff,2,1,30,28
1650739830428,MATH 20D,A02,083766,Staff,6,0,30,24
1650739830428,MATH 20D,A03,083767,Staff,24,0,30,6
1650739836452,MATH 20E,A01,083771,Staff,3,0,30,27
1650739836452,MATH 20E,A02,083772,Staff,16,0,30,14
1650739836452,MATH 20E,B01,083773,Staff,0,0,30,30
1650739836452,MATH 20E,B02,083774,Staff,6,0,30,24
1650739842474,MATH 103A,A01,083777,Staff,0,16,30,30
1650739842474,MATH 103A,A02,083778,Staff,0,15,30,30
1650739842474,MATH 103A,B01,083779,Staff,0,15,30,30
1650739842474,MATH 103A,B02,083780,Staff,0,15,30,30
1650739848495,MATH 105,A01,085443,Staff,0,22,30,30
1650739854517,MATH 109,A01,083213,Anzaldo; Leesa B,0,7,30,30
1650739854517,MATH 109,A02,083214,Anzaldo; Leesa B,0,7,30,30
1650739854517,MATH 109,B01,083215,Anzaldo; Leesa B,0,8,30,30
1650739854517,MATH 109,B02,083216,Anzaldo; Leesa B,0,6,30,30
1650739860544,MATH 142A,A01,083219,Chow; Bennett,0,16,30,30
1650739860544,MATH 142A,A02,083220,Chow; Bennett,0,15,30,30
1650739860544,MATH 142A,B01,083221,Chow; Bennett,0,15,30,30
1650739860544,MATH 142A,B02,083222,Chow; Bennett,0,14,30,30
1650739866573,MATH 193A,A01,083224,Staff,0,5,30,30
1650739866573,MATH 193A,A02,083225,Staff,0,6,30,30
1650739866573,MATH 193A,A03,083781,Staff,0,6,30,30
1650739866573,MATH 193A,A04,083782,Staff,0,7,30,30
1650739872594,MATH 197,001,091859,McAuley; Julian John,9998,0,9999,1
1650739878654,COGS 9,A01,083615,Staff,1,15,60,59
1650739884680,COGS 11,A01,083617,Boyle; Mary E. T.,16,0,40,24
1650739890707,COGS 13,A01,083071,Staff,0,38,40,40
1650739896731,COGS 14A,A01,092681,Staff,0,35,100,100
1650739902757,COGS 14B,A01,083073,Cheng; Tzu-Han,1,13,50,49
1650739908779,COGS 17,A01,092677,Staff,13,0,75,62
1650739914800,COGS 100,A01,083619,Staff,0,28,60,60
1650739920823,COGS 101A,A01,083621,Davis; Joshua Daniel,0,27,60,60
1650739926846,COGS 101B,A01,091572,Staff,0,4,60,60
1650739932870,COGS 101C,A01,083625,Delgado; Tania,14,0,30,16
1650739938897,COGS 107A,A01,083627,Boyle; Mary E. T.,0,16,60,60
1650739944920,COGS 118A,A01,083075,Staff,0,8,60,60
1650739950944,CSE 3,A50,083646,Miranda; Gregory Joseph,18,0,38,20
1650739950944,CSE 3,A51,083647,Miranda; Gregory Joseph,36,0,37,1
1650739956971,CSE 8A,A50,083650,Miranda; Gregory Joseph,0,30,40,40
1650739963002,CSE 11,A01,083080,Cao; Yingjun,0,96,40,40
1650739969025,CSE 12,A01,083652,Staff,0,21,100,100
1650739975051,CSE 15L,A01,083654,Staff,0,3,50,50
1650739975051,CSE 15L,A02,083655,Staff,0,2,50,50
1650739981076,CSE 20,A01,083657,Staff,49,0,80,31
1650739987099,CSE 30,A01,083084,Eldon; John,0,77,40,40
1650739993127,CSE 100,A01,083659,Cao; Yingjun,0,70,50,50
1650739999153,CSE 134B,A01,083661,Powell; Thomas Allan,0,38,65,65
1650740005178,CSE 140,A01,083663,Staff,0,11,75,75
1650740011294,CSE 140L,A01,083088,Eldon; John,0,20,75,75
1650740017320,CSE 175,A01,083665,Kumar; Rakesh,7,0,25,18
1650740023344,CSE 190,A00,092507,Dubnov; Shlomo,10,0,20,10
1650740029370,ECE 45,A01,083139,Staff,1,2,60,59
1650740035399,ECE 65,A50,083695,Staff,0,5,30,30
1650740041426,ECE 109,A01,091882,Touri; Behrouz,33,0,70,37
1650740047451,ECE 180,A00,083140,Abi Samra; Nicholas Camill,20,0,30,10
1650740047451,ECE 180,B00,083141,Abi Samra; Nicholas Camill,0,0,30,30
1650740053475,MATH 10A,A01,083735,Patchell; Gregory David,2,0,30,28
1650740053475,MATH 10A,A02,083736,Patchell; Gregory David,27,0,30,3
1650740053475,MATH 10A,A03,083737,Patchell; Gregory David,24,0,30,6
1650740059501,MATH 10B,A01,083207,Staff,0,9,30,30
1650740059501,MATH 10B,A02,083208,Staff,1,7,30,29
1650740059501,MATH 10B,B01,083739,Staff,11,0,30,19
1650740059501,MATH 10B,B02,083740,Staff,28,0,30,2
1650740065527,MATH 18,A01,083743,Staff,0,0,30,30
1650740065527,MATH 18,A02,083744,Staff,23,0,30,7
1650740065527,MATH 18,A03,083745,Staff,21,0,30,9
1650740065527,MATH 18,A04,083746,Staff,26,0,30,4
1650740065527,MATH 18,B01,083748,Staff,0,15,30,30
1650740065527,MATH 18,B02,083749,Staff,0,12,30,30
1650740065527,MATH 18,B03,083750,Staff,0,12,30,30
1650740065527,MATH 18,B04,083751,Staff,0,12,30,30
1650740071551,MATH 20A,A01,083754,Staff,19,0,40,21
1650740077574,MATH 20B,A01,083756,Staff,0,11,30,30
1650740077574,MATH 20B,A02,083757,Staff,0,12,30,30
1650740083597,MATH 20C,A01,083760,Staff,0,16,30,30
1650740083597,MATH 20C,A02,083761,Staff,0,16,30,30
1650740083597,MATH 20C,B01,083762,Staff,10,0,30,20
1650740083597,MATH 20C,B02,083763,Staff,28,0,30,2
1650740089622,MATH 20D,A01,083765,Staff,2,1,30,28
1650740089622,MATH 20D,A02,083766,Staff,6,0,30,24
1650740089622,MATH 20D,A03,083767,Staff,24,0,30,6
1650740095645,MATH 20E,A01,083771,Staff,3,0,30,27
1650740095645,MATH 20E,A02,083772,Staff,16,0,30,14
1650740095645,MATH 20E,B01,083773,Staff,0,0,30,30
1650740095645,MATH 20E,B02,083774,Staff,6,0,30,24
1650740101668,MATH 103A,A01,083777,Staff,0,16,30,30
1650740101668,MATH 103A,A02,083778,Staff,0,15,30,30
1650740101668,MATH 103A,B01,083779,Staff,0,15,30,30
1650740101668,MATH 103A,B02,083780,Staff,0,15,30,30
1650740107692,MATH 105,A01,085443,Staff,0,22,30,30
1650740113716,MATH 109,A01,083213,Anzaldo; Leesa B,0,7,30,30
1650740113716,MATH 109,A02,083214,Anzaldo; Leesa B,0,7,30,30
1650740113716,MATH 109,B01,083215,Anzaldo; Leesa B,0,8,30,30
1650740113716,MATH 109,B02,083216,Anzaldo; Leesa B,0,6,30,30
1650740119741,MATH 142A,A01,083219,Chow; Bennett,0,16,30,30
1650740119741,MATH 142A,A02,083220,Chow; Bennett,0,15,30,30
1650740119741,MATH 142A,B01,083221,Chow; Bennett,0,15,30,30
1650740119741,MATH 142A,B02,083222,Chow; Bennett,0,14,30,30
1650740125765,MATH 193A,A01,083224,Staff,0,5,30,30
1650740125765,MATH 193A,A02,083225,Staff,0,6,30,30
1650740125765,MATH 193A,A03,083781,Staff,0,6,30,30
1650740125765,MATH 193A,A04,083782,Staff,0,7,30,30
1650740131790,MATH 197,001,091859,McAuley; Julian John,9998,0,9999,1
1650740137844,COGS 9,A01,083615,Staff,1,15,60,59
1650740143870,COGS 11,A01,083617,Boyle; Mary E. T.,16,0,40,24
1650740149893,COGS 13,A01,083071,Staff,0,38,40,40
1650740155918,COGS 14A,A01,092681,Staff,0,35,100,100
1650740161941,COGS 14B,A01,083073,Cheng; Tzu-Han,1,13,50,49
1650740167964,COGS 17,A01,092677,Staff,13,0,75,62
1650740173987,COGS 100,A01,083619,Staff,0,28,60,60
1650740180011,COGS 101A,A01,083621,Davis; Joshua Daniel,0,27,60,60
1650740186035,COGS 101B,A01,091572,Staff,0,4,60,60
1650740192062,COGS 101C,A01,083625,Delgado; Tania,14,0,30,16
1650740198089,COGS 107A,A01,083627,Boyle; Mary E. T.,0,16,60,60
1650740204112,COGS 118A,A01,083075,Staff,0,8,60,60
1650740210135,CSE 3,A50,083646,Miranda; Gregory Joseph,18,0,38,20
1650740210135,CSE 3,A51,083647,Miranda; Gregory Joseph,36,0,37,1
1650740216158,CSE 8A,A50,083650,Miranda; Gregory Joseph,0,30,40,40
1650740222185,CSE 11,A01,083080,Cao; Yingjun,0,96,40,40
1650740228211,CSE 12,A01,083652,Staff,0,21,100,100
1650740234240,CSE 15L,A01,083654,Staff,0,3,50,50
1650740234240,CSE 15L,A02,083655,Staff,0,2,50,50
1650740240268,CSE 20,A01,083657,Staff,49,0,80,31
1650740246293,CSE 30,A01,083084,Eldon; John,0,77,40,40
1650740252317,CSE 100,A01,083659,Cao; Yingjun,0,70,50,50
1650740258339,CSE 134B,A01,083661,Powell; Thomas Allan,0,38,65,65
1650740264364,CSE 140,A01,083663,Staff,0,11,75,75
1650740270392,CSE 140L,A01,083088,Eldon; John,0,20,75,75
1650740276417,CSE 175,A01,083665,Kumar; Rakesh,7,0,25,18
1650740282447,CSE 190,A00,092507,Dubnov; Shlomo,10,0,20,10
1650740288483,ECE 45,A01,083139,Staff,1,2,60,59
1650740294507,ECE 65,A50,083695,Staff,0,5,30,30
1650740300534,ECE 109,A01,091882,Touri; Behrouz,33,0,70,37
1650740306555,ECE 180,A00,083140,Abi Samra; Nicholas Camill,20,0,30,10
1650740306555,ECE 180,B00,083141,Abi Samra; Nicholas Camill,0,0,30,30
1650740312583,MATH 10A,A01,083735,Patchell; Gregory David,2,0,30,28
1650740312583,MATH 10A,A02,083736,Patchell; Gregory David,27,0,30,3
1650740312583,MATH 10A,A03,083737,Patchell; Gregory David,24,0,30,6
1650740318609,MATH 10B,A01,083207,Staff,0,9,30,30
1650740318609,MATH 10B,A02,083208,Staff,1,7,30,29
1650740318609,MATH 10B,B01,083739,Staff,11,0,30,19
1650740318609,MATH 10B,B02,083740,Staff,28,0,30,2
1650740324636,MATH 18,A01,083743,Staff,0,0,30,30
1650740324636,MATH 18,A02,083744,Staff,23,0,30,7
1650740324636,MATH 18,A03,083745,Staff,21,0,30,9
1650740324636,MATH 18,A04,083746,Staff,26,0,30,4
1650740324636,MATH 18,B01,083748,Staff,0,15,30,30
1650740324636,MATH 18,B02,083749,Staff,0,12,30,30
1650740324636,MATH 18,B03,083750,Staff,0,12,30,30
1650740324636,MATH 18,B04,083751,Staff,0,12,30,30
1650740330659,MATH 20A,A01,083754,Staff,19,0,40,21
1650740336683,MATH 20B,A01,083756,Staff,0,11,30,30
1650740336683,MATH 20B,A02,083757,Staff,0,12,30,30
1650740342708,MATH 20C,A01,083760,Staff,0,16,30,30
1650740342708,MATH 20C,A02,083761,Staff,0,16,30,30
1650740342708,MATH 20C,B01,083762,Staff,10,0,30,20
1650740342708,MATH 20C,B02,083763,Staff,28,0,30,2
1650740348735,MATH 20D,A01,083765,Staff,2,1,30,28
1650740348735,MATH 20D,A02,083766,Staff,6,0,30,24
1650740348735,MATH 20D,A03,083767,Staff,24,0,30,6
1650740354763,MATH 20E,A01,083771,Staff,3,0,30,27
1650740354763,MATH 20E,A02,083772,Staff,16,0,30,14
1650740354763,MATH 20E,B01,083773,Staff,0,0,30,30
1650740354763,MATH 20E,B02,083774,Staff,6,0,30,24
1650740360788,MATH 103A,A01,083777,Staff,0,16,30,30
1650740360788,MATH 103A,A02,083778,Staff,0,15,30,30
1650740360788,MATH 103A,B01,083779,Staff,0,15,30,30
1650740360788,MATH 103A,B02,083780,Staff,0,15,30,30
1650740366814,MATH 105,A01,085443,Staff,0,22,30,30
1650740372842,MATH 109,A01,083213,Anzaldo; Leesa B,0,7,30,30
1650740372842,MATH 109,A02,083214,Anzaldo; Leesa B,0,7,30,30
1650740372842,MATH 109,B01,083215,Anzaldo; Leesa B,0,8,30,30
1650740372842,MATH 109,B02,083216,Anzaldo; Leesa B,0,6,30,30
1650740378866,MATH 142A,A01,083219,Chow; Bennett,0,16,30,30
1650740378866,MATH 142A,A02,083220,Chow; Bennett,0,15,30,30
1650740378866,MATH 142A,B01,083221,Chow; Bennett,0,15,30,30
1650740378866,MATH 142A,B02,083222,Chow; Bennett,0,14,30,30
1650740384888,MATH 193A,A01,083224,Staff,0,5,30,30
1650740384888,MATH 193A,A02,083225,Staff,0,6,30,30
1650740384888,MATH 193A,A03,083781,Staff,0,6,30,30
1650740384888,MATH 193A,A04,083782,Staff,0,7,30,30
1650740390912,MATH 197,001,091859,McAuley; Julian John,9998,0,9999,1
1650740396975,COGS 9,A01,083615,Staff,1,15,60,59
1650740403000,COGS 11,A01,083617,Boyle; Mary E. T.,16,0,40,24
1650740409026,COGS 13,A01,083071,Staff,0,38,40,40
1650740415049,COGS 14A,A01,092681,Staff,0,35,100,100
1650740421072,COGS 14B,A01,083073,Cheng; Tzu-Han,1,13,50,49
1650740427095,COGS 17,A01,092677,Staff,13,0,75,62
1650740433118,COGS 100,A01,083619,Staff,0,28,60,60
1650740439144,COGS 101A,A01,083621,Davis; Joshua Daniel,0,27,60,60
1650740445170,COGS 101B,A01,091572,Staff,0,4,60,60
1650740451196,COGS 101C,A01,083625,Delgado; Tania,14,0,30,16
1650740457225,COGS 107A,A01,083627,Boyle; Mary E. T.,0,16,60,60
1650740463249,COGS 118A,A01,083075,Staff,0,8,60,60
1650740469282,CSE 3,A50,083646,Miranda; Gregory Joseph,18,0,38,20
1650740469282,CSE 3,A51,083647,Miranda; Gregory Joseph,36,0,37,1
1650740475306,CSE 8A,A50,083650,Miranda; Gregory Joseph,0,30,40,40
1650740481329,CSE 11,A01,083080,Cao; Yingjun,0,96,40,40
1650740487366,CSE 12,A01,083652,Staff,0,21,100,100
1650740493390,CSE 15L,A01,083654,Staff,0,3,50,50
1650740493390,CSE 15L,A02,083655,Staff,0,2,50,50
1650740499414,CSE 20,A01,083657,Staff,49,0,80,31
1650740505436,CSE 30,A01,083084,Eldon; John,0,77,40,40
1650740511458,CSE 100,A01,083659,Cao; Yingjun,0,70,50,50
1650740517481,CSE 134B,A01,083661,Powell; Thomas Allan,0,38,65,65
1650740523507,CSE 140,A01,083663,Staff,0,11,75,75
1650740529535,CSE 140L,A01,083088,Eldon; John,0,20,75,75
1650740535557,CSE 175,A01,083665,Kumar; Rakesh,7,0,25,18
1650740541579,CSE 190,A00,092507,Dubnov; Shlomo,10,0,20,10
1650740547603,ECE 45,A01,083139,Staff,1,2,60,59
1650740553625,ECE 65,A50,083695,Staff,0,5,30,30
1650740559652,ECE 109,A01,091882,Touri; Behrouz,33,0,70,37
1650740565687,ECE 180,A00,083140,Abi Samra; Nicholas Camill,20,0,30,10
1650740565687,ECE 180,B00,083141,Abi Samra; Nicholas Camill,0,0,30,30
1650740571711,MATH 10A,A01,083735,Patchell; Gregory David,2,0,30,28
1650740571711,MATH 10A,A02,083736,Patchell; Gregory David,27,0,30,3
1650740571711,MATH 10A,A03,083737,Patchell; Gregory David,24,0,30,6
1650740577738,MATH 10B,A01,083207,Staff,0,9,30,30
1650740577738,MATH 10B,A02,083208,Staff,1,7,30,29
1650740577738,MATH 10B,B01,083739,Staff,11,0,30,19
1650740577738,MATH 10B,B02,083740,Staff,28,0,30,2
1650740583768,MATH 18,A01,083743,Staff,0,0,30,30
1650740583768,MATH 18,A02,083744,Staff,23,0,30,7
1650740583768,MATH 18,A03,083745,Staff,21,0,30,9
1650740583768,MATH 18,A04,083746,Staff,26,0,30,4
1650740583768,MATH 18,B01,083748,Staff,0,15,30,30
1650740583768,MATH 18,B02,083749,Staff,0,12,30,30
1650740583768,MATH 18,B03,083750,Staff,0,12,30,30
1650740583768,MATH 18,B04,083751,Staff,0,12,30,30
1650740589790,MATH 20A,A01,083754,Staff,19,0,40,21
1650740595816,MATH 20B,A01,083756,Staff,0,11,30,30
1650740595816,MATH 20B,A02,083757,Staff,0,12,30,30
1650740601839,MATH 20C,A01,083760,Staff,0,16,30,30
1650740601839,MATH 20C,A02,083761,Staff,0,16,30,30
1650740601839,MATH 20C,B01,083762,Staff,10,0,30,20
1650740601839,MATH 20C,B02,083763,Staff,28,0,30,2
1650740607952,MATH 20D,A01,083765,Staff,2,1,30,28
1650740607952,MATH 20D,A02,083766,Staff,6,0,30,24
1650740607952,MATH 20D,A03,083767,Staff,24,0,30,6
1650740613976,MATH 20E,A01,083771,Staff,3,0,30,27
1650740613976,MATH 20E,A02,083772,Staff,16,0,30,14
1650740613976,MATH 20E,B01,083773,Staff,0,0,30,30
1650740613976,MATH 20E,B02,083774,Staff,6,0,30,24
1650740620000,MATH 103A,A01,083777,Staff,0,16,30,30
1650740620000,MATH 103A,A02,083778,Staff,0,15,30,30
1650740620000,MATH 103A,B01,083779,Staff,0,15,30,30
1650740620000,MATH 103A,B02,083780,Staff,0,15,30,30
1650740626025,MATH 105,A01,085443,Staff,0,22,30,30
1650740632055,MATH 109,A01,083213,Anzaldo; Leesa B,0,7,30,30
1650740632055,MATH 109,A02,083214,Anzaldo; Leesa B,0,7,30,30
1650740632055,MATH 109,B01,083215,Anzaldo; Leesa B,0,8,30,30
1650740632055,MATH 109,B02,083216,Anzaldo; Leesa B,0,6,30,30
1650740638088,MATH 142A,A01,083219,Chow; Bennett,0,16,30,30
1650740638088,MATH 142A,A02,083220,Chow; Bennett,0,15,30,30
1650740638088,MATH 142A,B01,083221,Chow; Bennett,0,15,30,30
1650740638088,MATH 142A,B02,083222,Chow; Bennett,0,14,30,30
1650740644126,MATH 193A,A01,083224,Staff,0,5,30,30
1650740644126,MATH 193A,A02,083225,Staff,0,6,30,30
1650740644126,MATH 193A,A03,083781,Staff,0,6,30,30
1650740644126,MATH 193A,A04,083782,Staff,0,7,30,30
1650740650152,MATH 197,001,091859,McAuley; Julian John,9998,0,9999,1
1650740656210,COGS 9,A01,083615,Staff,1,15,60,59
1650740662238,COGS 11,A01,083617,Boyle; Mary E. T.,16,0,40,24
1650740668261,COGS 13,A01,083071,Staff,0,38,40,40
1650740674292,COGS 14A,A01,092681,Staff,0,35,100,100
1650740680319,COGS 14B,A01,083073,Cheng; Tzu-Han,1,13,50,49
1650740686341,COGS 17,A01,092677,Staff,13,0,75,62
1650740692367,COGS 100,A01,083619,Staff,0,28,60,60
1650740698393,COGS 101A,A01,083621,Davis; Joshua Daniel,0,27,60,60
1650740704418,COGS 101B,A01,091572,Staff,0,4,60,60
1650740710442,COGS 101C,A01,083625,Delgado; Tania,14,0,30,16
1650740716472,COGS 107A,A01,083627,Boyle; Mary E. T.,0,16,60,60
1650740722493,COGS 118A,A01,083075,Staff,0,8,60,60
1650740728518,CSE 3,A50,083646,Miranda; Gregory Joseph,18,0,38,20
1650740728518,CSE 3,A51,083647,Miranda; Gregory Joseph,36,0,37,1
1650740734543,CSE 8A,A50,083650,Miranda; Gregory Joseph,0,30,40,40
1650740740565,CSE 11,A01,083080,Cao; Yingjun,0,96,40,40
1650740746592,CSE 12,A01,083652,Staff,0,21,100,100
1650740752618,CSE 15L,A01,083654,Staff,0,3,50,50
1650740752618,CSE 15L,A02,083655,Staff,0,2,50,50
1650740758643,CSE 20,A01,083657,Staff,49,0,80,31
1650740764667,CSE 30,A01,083084,Eldon; John,0,77,40,40
1650740770695,CSE 100,A01,083659,Cao; Yingjun,0,70,50,50
1650740776720,CSE 134B,A01,083661,Powell; Thomas Allan,0,38,65,65
1650740782742,CSE 140,A01,083663,Staff,0,11,75,75
1650740788768,CSE 140L,A01,083088,Eldon; John,0,20,75,75
1650740794794,CSE 175,A01,083665,Kumar; Rakesh,7,0,25,18
1650740800817,CSE 190,A00,092507,Dubnov; Shlomo,10,0,20,10
1650740806842,ECE 45,A01,083139,Staff,1,2,60,59
1650740812867,ECE 65,A50,083695,Staff,0,5,30,30
1650740818892,ECE 109,A01,091882,Touri; Behrouz,33,0,70,37
1650740824927,ECE 180,A00,083140,Abi Samra; Nicholas Camill,20,0,30,10
1650740824927,ECE 180,B00,083141,Abi Samra; Nicholas Camill,0,0,30,30
1650740830949,MATH 10A,A01,083735,Patchell; Gregory David,2,0,30,28
1650740830949,MATH 10A,A02,083736,Patchell; Gregory David,27,0,30,3
1650740830949,MATH 10A,A03,083737,Patchell; Gregory David,24,0,30,6
1650740836975,MATH 10B,A01,083207,Staff,0,9,30,30
1650740836975,MATH 10B,A02,083208,Staff,1,7,30,29
1650740836975,MATH 10B,B01,083739,Staff,11,0,30,19
1650740836975,MATH 10B,B02,083740,Staff,28,0,30,2
1650740842999,MATH 18,A01,083743,Staff,0,0,30,30
1650740842999,MATH 18,A02,083744,Staff,23,0,30,7
1650740842999,MATH 18,A03,083745,Staff,21,0,30,9
1650740842999,MATH 18,A04,083746,Staff,26,0,30,4
1650740842999,MATH 18,B01,083748,Staff,0,15,30,30
1650740842999,MATH 18,B02,083749,Staff,0,12,30,30
1650740842999,MATH 18,B03,083750,Staff,0,12,30,30
1650740842999,MATH 18,B04,083751,Staff,0,12,30,30
1650740849023,MATH 20A,A01,083754,Staff,19,0,40,21
1650740855053,MATH 20B,A01,083756,Staff,0,11,30,30
1650740855053,MATH 20B,A02,083757,Staff,0,12,30,30
1650740861086,MATH 20C,A01,083760,Staff,0,16,30,30
1650740861086,MATH 20C,A02,083761,Staff,0,16,30,30
1650740861086,MATH 20C,B01,083762,Staff,10,0,30,20
1650740861086,MATH 20C,B02,083763,Staff,28,0,30,2
1650740867111,MATH 20D,A01,083765,Staff,2,1,30,28
1650740867111,MATH 20D,A02,083766,Staff,6,0,30,24
1650740867111,MATH 20D,A03,083767,Staff,24,0,30,6
1650740873135,MATH 20E,A01,083771,Staff,3,0,30,27
1650740873135,MATH 20E,A02,083772,Staff,16,0,30,14
1650740873135,MATH 20E,B01,083773,Staff,0,0,30,30
1650740873135,MATH 20E,B02,083774,Staff,6,0,30,24
1650740879158,MATH 103A,A01,083777,Staff,0,16,30,30
1650740879158,MATH 103A,A02,083778,Staff,0,15,30,30
1650740879158,MATH 103A,B01,083779,Staff,0,15,30,30
1650740879158,MATH 103A,B02,083780,Staff,0,15,30,30
1650740885185,MATH 105,A01,085443,Staff,0,22,30,30
1650740891208,MATH 109,A01,083213,Anzaldo; Leesa B,0,7,30,30
1650740891208,MATH 109,A02,083214,Anzaldo; Leesa B,0,7,30,30
1650740891208,MATH 109,B01,083215,Anzaldo; Leesa B,0,8,30,30
1650740891208,MATH 109,B02,083216,Anzaldo; Leesa B,0,6,30,30
1650740897232,MATH 142A,A01,083219,Chow; Bennett,0,16,30,30
1650740897232,MATH 142A,A02,083220,Chow; Bennett,0,15,30,30
1650740897232,MATH 142A,B01,083221,Chow; Bennett,0,15,30,30
1650740897232,MATH 142A,B02,083222,Chow; Bennett,0,14,30,30
1650740903258,MATH 193A,A01,083224,Staff,0,5,30,30
1650740903258,MATH 193A,A02,083225,Staff,0,6,30,30
1650740903258,MATH 193A,A03,083781,Staff,0,6,30,30
1650740903258,MATH 193A,A04,083782,Staff,0,7,30,30
1650740909282,MATH 197,001,091859,McAuley; Julian John,9998,0,9999,1
1650740915356,COGS 9,A01,083615,Staff,1,15,60,59
1650740921381,COGS 11,A01,083617,Boyle; Mary E. T.,16,0,40,24
1650740927405,COGS 13,A01,083071,Staff,0,38,40,40
1650740933429,COGS 14A,A01,092681,Staff,0,35,100,100
1650740939454,COGS 14B,A01,083073,Cheng; Tzu-Han,1,13,50,49
1650740945484,COGS 17,A01,092677,Staff,13,0,75,62
1650740951510,COGS 100,A01,083619,Staff,0,28,60,60
1650740957534,COGS 101A,A01,083621,Davis; Joshua Daniel,0,27,60,60
1650740963564,COGS 101B,A01,091572,Staff,0,4,60,60
1650740969590,COGS 101C,A01,083625,Delgado; Tania,14,0,30,16
1650740975633,COGS 107A,A01,083627,Boyle; Mary E. T.,0,16,60,60
1650740981659,COGS 118A,A01,083075,Staff,0,8,60,60
1650740987681,CSE 3,A50,083646,Miranda; Gregory Joseph,18,0,38,20
1650740987681,CSE 3,A51,083647,Miranda; Gregory Joseph,36,0,37,1
1650740993711,CSE 8A,A50,083650,Miranda; Gregory Joseph,0,30,40,40
1650740999733,CSE 11,A01,083080,Cao; Yingjun,0,96,40,40
1650741005761,CSE 12,A01,083652,Staff,0,21,100,100
1650741011783,CSE 15L,A01,083654,Staff,0,3,50,50
1650741011783,CSE 15L,A02,083655,Staff,0,2,50,50
1650741017806,CSE 20,A01,083657,Staff,49,0,80,31
1650741023833,CSE 30,A01,083084,Eldon; John,0,77,40,40
1650741029859,CSE 100,A01,083659,Cao; Yingjun,0,70,50,50
1650741035882,CSE 134B,A01,083661,Powell; Thomas Allan,0,38,65,65
1650741041917,CSE 140,A01,083663,Staff,0,11,75,75
1650741047941,CSE 140L,A01,083088,Eldon; John,0,20,75,75
1650741053968,CSE 175,A01,083665,Kumar; Rakesh,7,0,25,18
1650741059994,CSE 190,A00,092507,Dubnov; Shlomo,10,0,20,10
1650741066018,ECE 45,A01,083139,Staff,1,2,60,59
1650741072047,ECE 65,A50,083695,Staff,0,5,30,30
1650741078071,ECE 109,A01,091882,Touri; Behrouz,33,0,70,37
1650741084099,ECE 180,A00,083140,Abi Samra; Nicholas Camill,20,0,30,10
1650741084099,ECE 180,B00,083141,Abi Samra; Nicholas Camill,0,0,30,30
1650741090127,MATH 10A,A01,083735,Patchell; Gregory David,2,0,30,28
1650741090127,MATH 10A,A02,083736,Patchell; Gregory David,27,0,30,3
1650741090127,MATH 10A,A03,083737,Patchell; Gregory David,24,0,30,6
1650741096150,MATH 10B,A01,083207,Staff,0,9,30,30
1650741096150,MATH 10B,A02,083208,Staff,1,7,30,29
1650741096150,MATH 10B,B01,083739,Staff,11,0,30,19
1650741096150,MATH 10B,B02,083740,Staff,28,0,30,2
1650741102178,MATH 18,A01,083743,Staff,0,0,30,30
1650741102178,MATH 18,A02,083744,Staff,23,0,30,7
1650741102178,MATH 18,A03,083745,Staff,21,0,30,9
1650741102178,MATH 18,A04,083746,Staff,26,0,30,4
1650741102178,MATH 18,B01,083748,Staff,0,15,30,30
1650741102178,MATH 18,B02,083749,Staff,0,12,30,30
1650741102178,MATH 18,B03,083750,Staff,0,12,30,30
1650741102178,MATH 18,B04,083751,Staff,0,12,30,30
1650741108202,MATH 20A,A01,083754,Staff,19,0,40,21
1650741114231,MATH 20B,A01,083756,Staff,0,11,30,30
1650741114231,MATH 20B,A02,083757,Staff,0,12,30,30
1650741120258,MATH 20C,A01,083760,Staff,0,16,30,30
1650741120258,MATH 20C,A02,083761,Staff,0,16,30,30
1650741120258,MATH 20C,B01,083762,Staff,10,0,30,20
1650741120258,MATH 20C,B02,083763,Staff,28,0,30,2
1650741126285,MATH 20D,A01,083765,Staff,2,1,30,28
1650741126285,MATH 20D,A02,083766,Staff,6,0,30,24
1650741126285,MATH 20D,A03,083767,Staff,24,0,30,6
1650741132308,MATH 20E,A01,083771,Staff,3,0,30,27
1650741132308,MATH 20E,A02,083772,Staff,16,0,30,14
1650741132308,MATH 20E,B01,083773,Staff,0,0,30,30
1650741132308,MATH 20E,B02,083774,Staff,6,0,30,24
1650741138332,MATH 103A,A01,083777,Staff,0,16,30,30
1650741138332,MATH 103A,A02,083778,Staff,0,15,30,30
1650741138332,MATH 103A,B01,083779,Staff,0,15,30,30
1650741138332,MATH 103A,B02,083780,Staff,0,15,30,30
1650741144365,MATH 105,A01,085443,Staff,0,22,30,30
1650741150392,MATH 109,A01,083213,Anzaldo; Leesa B,0,7,30,30
1650741150392,MATH 109,A02,083214,Anzaldo; Leesa B,0,7,30,30
1650741150392,MATH 109,B01,083215,Anzaldo; Leesa B,0,8,30,30
1650741150392,MATH 109,B02,083216,Anzaldo; Leesa B,0,6,30,30
1650741156417,MATH 142A,A01,083219,Chow; Bennett,0,16,30,30
1650741156417,MATH 142A,A02,083220,Chow; Bennett,0,15,30,30
1650741156417,MATH 142A,B01,083221,Chow; Bennett,0,15,30,30
1650741156417,MATH 142A,B02,083222,Chow; Bennett,0,14,30,30
1650741162459,MATH 193A,A01,083224,Staff,0,5,30,30
1650741162459,MATH 193A,A02,083225,Staff,0,6,30,30
1650741162459,MATH 193A,A03,083781,Staff,0,6,30,30
1650741162459,MATH 193A,A04,083782,Staff,0,7,30,30
1650741168481,MATH 197,001,091859,McAuley; Julian John,9998,0,9999,1
1650741174544,COGS 9,A01,083615,Staff,1,15,60,59
1650741180580,COGS 11,A01,083617,Boyle; Mary E. T.,16,0,40,24
1650741186606,COGS 13,A01,083071,Staff,0,38,40,40
1650741192627,COGS 14A,A01,092681,Staff,0,35,100,100
1650741198742,COGS 14B,A01,083073,Cheng; Tzu-Han,1,13,50,49
1650741204766,COGS 17,A01,092677,Staff,13,0,75,62
1650741210791,COGS 100,A01,083619,Staff,0,28,60,60
1650741216814,COGS 101A,A01,083621,Davis; Joshua Daniel,0,27,60,60
1650741222837,COGS 101B,A01,091572,Staff,0,4,60,60
1650741228862,COGS 101C,A01,083625,Delgado; Tania,14,0,30,16
1650741234887,COGS 107A,A01,083627,Boyle; Mary E. T.,0,16,60,60
1650741240909,COGS 118A,A01,083075,Staff,0,8,60,60
1650741246937,CSE 3,A50,083646,Miranda; Gregory Joseph,18,0,38,20
1650741246937,CSE 3,A51,083647,Miranda; Gregory Joseph,36,0,37,1
1650741252961,CSE 8A,A50,083650,Miranda; Gregory Joseph,0,30,40,40
1650741258984,CSE 11,A01,083080,Cao; Yingjun,0,96,40,40
1650741265011,CSE 12,A01,083652,Staff,0,21,100,100
1650741271034,CSE 15L,A01,083654,Staff,0,3,50,50
1650741271034,CSE 15L,A02,083655,Staff,0,2,50,50
1650741277056,CSE 20,A01,083657,Staff,49,0,80,31
1650741283084,CSE 30,A01,083084,Eldon; John,0,77,40,40
1650741289111,CSE 100,A01,083659,Cao; Yingjun,0,70,50,50
1650741295133,CSE 134B,A01,083661,Powell; Thomas Allan,0,38,65,65
1650741301158,CSE 140,A01,083663,Staff,0,11,75,75
1650741307181,CSE 140L,A01,083088,Eldon; John,0,20,75,75
1650741313206,CSE 175,A01,083665,Kumar; Rakesh,7,0,25,18
1650741319229,CSE 190,A00,092507,Dubnov; Shlomo,10,0,20,10
1650741325257,ECE 45,A01,083139,Staff,1,2,60,59
1650741331290,ECE 65,A50,083695,Staff,0,5,30,30
1650741337313,ECE 109,A01,091882,Touri; Behrouz,33,0,70,37
1650741343344,ECE 180,A00,083140,Abi Samra; Nicholas Camill,20,0,30,10
1650741343344,ECE 180,B00,083141,Abi Samra; Nicholas Camill,0,0,30,30
1650741349382,MATH 10A,A01,083735,Patchell; Gregory David,2,0,30,28
1650741349382,MATH 10A,A02,083736,Patchell; Gregory David,27,0,30,3
1650741349382,MATH 10A,A03,083737,Patchell; Gregory David,24,0,30,6
1650741355406,MATH 10B,A01,083207,Staff,0,9,30,30
1650741355406,MATH 10B,A02,083208,Staff,1,7,30,29
1650741355406,MATH 10B,B01,083739,Staff,11,0,30,19
1650741355406,MATH 10B,B02,083740,Staff,28,0,30,2
1650741361431,MATH 18,A01,083743,Staff,0,0,30,30
1650741361431,MATH 18,A02,083744,Staff,23,0,30,7
1650741361431,MATH 18,A03,083745,Staff,21,0,30,9
1650741361431,MATH 18,A04,083746,Staff,26,0,30,4
1650741361431,MATH 18,B01,083748,Staff,0,15,30,30
1650741361431,MATH 18,B02,083749,Staff,0,12,30,30
1650741361431,MATH 18,B03,083750,Staff,0,12,30,30
1650741361431,MATH 18,B04,083751,Staff,0,12,30,30
1650741367456,MATH 20A,A01,083754,Staff,19,0,40,21
1650741373482,MATH 20B,A01,083756,Staff,0,11,30,30
1650741373482,MATH 20B,A02,083757,Staff,0,12,30,30
1650741379505,MATH 20C,A01,083760,Staff,0,16,30,30
1650741379505,MATH 20C,A02,083761,Staff,0,16,30,30
1650741379505,MATH 20C,B01,083762,Staff,10,0,30,20
1650741379505,MATH 20C,B02,083763,Staff,28,0,30,2
1650741385528,MATH 20D,A01,083765,Staff,2,1,30,28
1650741385528,MATH 20D,A02,083766,Staff,6,0,30,24
1650741385528,MATH 20D,A03,083767,Staff,24,0,30,6
1650741391552,MATH 20E,A01,083771,Staff,3,0,30,27
1650741391552,MATH 20E,A02,083772,Staff,16,0,30,14
1650741391552,MATH 20E,B01,083773,Staff,0,0,30,30
1650741391552,MATH 20E,B02,083774,Staff,6,0,30,24
1650741397574,MATH 103A,A01,083777,Staff,0,16,30,30
1650741397574,MATH 103A,A02,083778,Staff,0,15,30,30
1650741397574,MATH 103A,B01,083779,Staff,0,15,30,30
1650741397574,MATH 103A,B02,083780,Staff,0,15,30,30
1650741403599,MATH 105,A01,085443,Staff,0,22,30,30
1650741409621,MATH 109,A01,083213,Anzaldo; Leesa B,0,7,30,30
1650741409621,MATH 109,A02,083214,Anzaldo; Leesa B,0,7,30,30
1650741409621,MATH 109,B01,083215,Anzaldo; Leesa B,0,8,30,30
1650741409621,MATH 109,B02,083216,Anzaldo; Leesa B,0,6,30,30
1650741415644,MATH 142A,A01,083219,Chow; Bennett,0,16,30,30
1650741415644,MATH 142A,A02,083220,Chow; Bennett,0,15,30,30
1650741415644,MATH 142A,B01,083221,Chow; Bennett,0,15,30,30
1650741415644,MATH 142A,B02,083222,Chow; Bennett,0,14,30,30
1650741421670,MATH 193A,A01,083224,Staff,0,5,30,30
1650741421670,MATH 193A,A02,083225,Staff,0,6,30,30
1650741421670,MATH 193A,A03,083781,Staff,0,6,30,30
1650741421670,MATH 193A,A04,083782,Staff,0,7,30,30
1650741427699,MATH 197,001,091859,McAuley; Julian John,9998,0,9999,1
1650741433757,COGS 9,A01,083615,Staff,1,15,60,59
1650741439780,COGS 11,A01,083617,Boyle; Mary E. T.,16,0,40,24
1650741445803,COGS 13,A01,083071,Staff,0,38,40,40
1650741451826,COGS 14A,A01,092681,Staff,0,35,100,100
1650741457851,COGS 14B,A01,083073,Cheng; Tzu-Han,1,13,50,49
1650741463875,COGS 17,A01,092677,Staff,13,0,75,62
1650741469897,COGS 100,A01,083619,Staff,0,28,60,60
1650741475925,COGS 101A,A01,083621,Davis; Joshua Daniel,0,27,60,60
1650741481949,COGS 101B,A01,091572,Staff,0,4,60,60
1650741487974,COGS 101C,A01,083625,Delgado; Tania,14,0,30,16
1650741493997,COGS 107A,A01,083627,Boyle; Mary E. T.,0,16,60,60
1650741500020,COGS 118A,A01,083075,Staff,0,8,60,60
1650741506044,CSE 3,A50,083646,Miranda; Gregory Joseph,18,0,38,20
1650741506044,CSE 3,A51,083647,Miranda; Gregory Joseph,36,0,37,1
1650741512078,CSE 8A,A50,083650,Miranda; Gregory Joseph,0,30,40,40
1650741518107,CSE 11,A01,083080,Cao; Yingjun,0,96,40,40
1650741524133,CSE 12,A01,083652,Staff,0,21,100,100
1650741530156,CSE 15L,A01,083654,Staff,0,3,50,50
1650741530156,CSE 15L,A02,083655,Staff,0,2,50,50
1650741536178,CSE 20,A01,083657,Staff,49,0,80,31
1650741542201,CSE 30,A01,083084,Eldon; John,0,77,40,40
1650741548228,CSE 100,A01,083659,Cao; Yingjun,0,70,50,50
1650741554251,CSE 134B,A01,083661,Powell; Thomas Allan,0,38,65,65
1650741560274,CSE 140,A01,083663,Staff,0,11,75,75
1650741566300,CSE 140L,A01,083088,Eldon; John,0,20,75,75
1650741572332,CSE 175,A01,083665,Kumar; Rakesh,7,0,25,18
1650741578358,CSE 190,A00,092507,Dubnov; Shlomo,10,0,20,10
1650741584384,ECE 45,A01,083139,Staff,1,2,60,59
1650741590408,ECE 65,A50,083695,Staff,0,5,30,30
1650741596440,ECE 109,A01,091882,Touri; Behrouz,33,0,70,37
1650741602469,ECE 180,A00,083140,Abi Samra; Nicholas Camill,20,0,30,10
1650741602469,ECE 180,B00,083141,Abi Samra; Nicholas Camill,0,0,30,30
1650741608508,MATH 10A,A01,083735,Patchell; Gregory David,2,0,30,28
1650741608508,MATH 10A,A02,083736,Patchell; Gregory David,27,0,30,3
1650741608508,MATH 10A,A03,083737,Patchell; Gregory David,24,0,30,6
1650741614531,MATH 10B,A01,083207,Staff,0,9,30,30
1650741614531,MATH 10B,A02,083208,Staff,1,7,30,29
1650741614531,MATH 10B,B01,083739,Staff,11,0,30,19
1650741614531,MATH 10B,B02,083740,Staff,28,0,30,2
1650741620563,MATH 18,A01,083743,Staff,0,0,30,30
1650741620563,MATH 18,A02,083744,Staff,23,0,30,7
1650741620563,MATH 18,A03,083745,Staff,21,0,30,9
1650741620563,MATH 18,A04,083746,Staff,26,0,30,4
1650741620563,MATH 18,B01,083748,Staff,0,15,30,30
1650741620563,MATH 18,B02,083749,Staff,0,12,30,30
1650741620563,MATH 18,B03,083750,Staff,0,12,30,30
1650741620563,MATH 18,B04,083751,Staff,0,12,30,30
1650741626588,MATH 20A,A01,083754,Staff,19,0,40,21
1650741632612,MATH 20B,A01,083756,Staff,0,11,30,30
1650741632612,MATH 20B,A02,083757,Staff,0,12,30,30
1650741638640,MATH 20C,A01,083760,Staff,0,16,30,30
1650741638640,MATH 20C,A02,083761,Staff,0,16,30,30
1650741638640,MATH 20C,B01,083762,Staff,10,0,30,20
1650741638640,MATH 20C,B02,083763,Staff,28,0,30,2
1650741644676,MATH 20D,A01,083765,Staff,2,1,30,28
1650741644676,MATH 20D,A02,083766,Staff,6,0,30,24
1650741644676,MATH 20D,A03,083767,Staff,24,0,30,6
1650741650704,MATH 20E,A01,083771,Staff,3,0,30,27
1650741650704,MATH 20E,A02,083772,Staff,16,0,30,14
1650741650704,MATH 20E,B01,083773,Staff,0,0,30,30
1650741650704,MATH 20E,B02,083774,Staff,6,0,30,24
1650741656733,MATH 103A,A01,083777,Staff,0,16,30,30
1650741656733,MATH 103A,A02,083778,Staff,0,15,30,30
1650741656733,MATH 103A,B01,083779,Staff,0,15,30,30
1650741656733,MATH 103A,B02,083780,Staff,0,15,30,30
1650741662760,MATH 105,A01,085443,Staff,0,22,30,30
1650741668783,MATH 109,A01,083213,Anzaldo; Leesa B,0,7,30,30
1650741668783,MATH 109,A02,083214,Anzaldo; Leesa B,0,7,30,30
1650741668783,MATH 109,B01,083215,Anzaldo; Leesa B,0,8,30,30
1650741668783,MATH 109,B02,083216,Anzaldo; Leesa B,0,6,30,30
1650741674808,MATH 142A,A01,083219,Chow; Bennett,0,16,30,30
1650741674808,MATH 142A,A02,083220,Chow; Bennett,0,15,30,30
1650741674808,MATH 142A,B01,083221,Chow; Bennett,0,15,30,30
1650741674808,MATH 142A,B02,083222,Chow; Bennett,0,14,30,30
1650741680835,MATH 193A,A01,083224,Staff,0,5,30,30
1650741680835,MATH 193A,A02,083225,Staff,0,6,30,30
1650741680835,MATH 193A,A03,083781,Staff,0,6,30,30
1650741680835,MATH 193A,A04,083782,Staff,0,7,30,30
1650741686859,MATH 197,001,091859,McAuley; Julian John,9998,0,9999,1
1650741692921,COGS 9,A01,083615,Staff,1,15,60,59
1650741698945,COGS 11,A01,083617,Boyle; Mary E. T.,16,0,40,24
1650741704969,COGS 13,A01,083071,Staff,0,38,40,40
1650741710995,COGS 14A,A01,092681,Staff,0,35,100,100
1650741717020,COGS 14B,A01,083073,Cheng; Tzu-Han,1,13,50,49
1650741723044,COGS 17,A01,092677,Staff,13,0,75,62
1650741729070,COGS 100,A01,083619,Staff,0,28,60,60
1650741735097,COGS 101A,A01,083621,Davis; Joshua Daniel,0,27,60,60
1650741741122,COGS 101B,A01,091572,Staff,0,4,60,60
1650741747145,COGS 101C,A01,083625,Delgado; Tania,14,0,30,16
1650741753167,COGS 107A,A01,083627,Boyle; Mary E. T.,0,16,60,60
1650741759192,COGS 118A,A01,083075,Staff,0,8,60,60
1650741765215,CSE 3,A50,083646,Miranda; Gregory Joseph,18,0,38,20
1650741765215,CSE 3,A51,083647,Miranda; Gregory Joseph,36,0,37,1
1650741771247,CSE 8A,A50,083650,Miranda; Gregory Joseph,0,30,40,40
1650741777270,CSE 11,A01,083080,Cao; Yingjun,0,96,40,40
1650741783294,CSE 12,A01,083652,Staff,0,21,100,100
1650741789317,CSE 15L,A01,083654,Staff,0,3,50,50
1650741789317,CSE 15L,A02,083655,Staff,0,2,50,50
1650741795428,CSE 20,A01,083657,Staff,49,0,80,31
1650741801455,CSE 30,A01,083084,Eldon; John,0,77,40,40
1650741807478,CSE 100,A01,083659,Cao; Yingjun,0,70,50,50
1650741813513,CSE 134B,A01,083661,Powell; Thomas Allan,0,38,65,65
1650741819538,CSE 140,A01,083663,Staff,0,11,75,75
1650741825564,CSE 140L,A01,083088,Eldon; John,0,20,75,75
1650741831594,CSE 175,A01,083665,Kumar; Rakesh,7,0,25,18
1650741837617,CSE 190,A00,092507,Dubnov; Shlomo,10,0,20,10
1650741843655,ECE 45,A01,083139,Staff,1,2,60,59
1650741849679,ECE 65,A50,083695,Staff,0,5,30,30
1650741855703,ECE 109,A01,091882,Touri; Behrouz,33,0,70,37
1650741861727,ECE 180,A00,083140,Abi Samra; Nicholas Camill,20,0,30,10
1650741861727,ECE 180,B00,083141,Abi Samra; Nicholas Camill,0,0,30,30
1650741867750,MATH 10A,A01,083735,Patchell; Gregory David,2,0,30,28
1650741867750,MATH 10A,A02,083736,Patchell; Gregory David,27,0,30,3
1650741867750,MATH 10A,A03,083737,Patchell; Gregory David,24,0,30,6
1650741873778,MATH 10B,A01,083207,Staff,0,9,30,30
1650741873778,MATH 10B,A02,083208,Staff,1,7,30,29
1650741873778,MATH 10B,B01,083739,Staff,11,0,30,19
1650741873778,MATH 10B,B02,083740,Staff,28,0,30,2
1650741879809,MATH 18,A01,083743,Staff,0,0,30,30
1650741879809,MATH 18,A02,083744,Staff,23,0,30,7
1650741879809,MATH 18,A03,083745,Staff,21,0,30,9
1650741879809,MATH 18,A04,083746,Staff,26,0,30,4
1650741879809,MATH 18,B01,083748,Staff,0,15,30,30
1650741879809,MATH 18,B02,083749,Staff,0,12,30,30
1650741879809,MATH 18,B03,083750,Staff,0,12,30,30
1650741879809,MATH 18,B04,083751,Staff,0,12,30,30
1650741885832,MATH 20A,A01,083754,Staff,19,0,40,21
1650741891854,MATH 20B,A01,083756,Staff,0,11,30,30
1650741891854,MATH 20B,A02,083757,Staff,0,12,30,30
1650741897877,MATH 20C,A01,083760,Staff,0,16,30,30
1650741897877,MATH 20C,A02,083761,Staff,0,16,30,30
1650741897877,MATH 20C,B01,083762,Staff,10,0,30,20
1650741897877,MATH 20C,B02,083763,Staff,28,0,30,2
1650741903901,MATH 20D,A01,083765,Staff,2,1,30,28
1650741903901,MATH 20D,A02,083766,Staff,6,0,30,24
1650741903901,MATH 20D,A03,083767,Staff,24,0,30,6
1650741909924,MATH 20E,A01,083771,Staff,3,0,30,27
1650741909924,MATH 20E,A02,083772,Staff,16,0,30,14
1650741909924,MATH 20E,B01,083773,Staff,0,0,30,30
1650741909924,MATH 20E,B02,083774,Staff,6,0,30,24
1650741915953,MATH 103A,A01,083777,Staff,0,16,30,30
1650741915953,MATH 103A,A02,083778,Staff,0,15,30,30
1650741915953,MATH 103A,B01,083779,Staff,0,15,30,30
1650741915953,MATH 103A,B02,083780,Staff,0,15,30,30
1650741921978,MATH 105,A01,085443,Staff,0,22,30,30
1650741928001,MATH 109,A01,083213,Anzaldo; Leesa B,0,7,30,30
1650741928001,MATH 109,A02,083214,Anzaldo; Leesa B,0,7,30,30
1650741928001,MATH 109,B01,083215,Anzaldo; Leesa B,0,8,30,30
1650741928001,MATH 109,B02,083216,Anzaldo; Leesa B,0,6,30,30
1650741934026,MATH 142A,A01,083219,Chow; Bennett,0,16,30,30
1650741934026,MATH 142A,A02,083220,Chow; Bennett,0,15,30,30
1650741934026,MATH 142A,B01,083221,Chow; Bennett,0,15,30,30
1650741934026,MATH 142A,B02,083222,Chow; Bennett,0,14,30,30
1650741940050,MATH 193A,A01,083224,Staff,0,5,30,30
1650741940050,MATH 193A,A02,083225,Staff,0,6,30,30
1650741940050,MATH 193A,A03,083781,Staff,0,6,30,30
1650741940050,MATH 193A,A04,083782,Staff,0,7,30,30
1650741946072,MATH 197,001,091859,McAuley; Julian John,9998,0,9999,1
1650741952133,COGS 9,A01,083615,Staff,1,15,60,59
1650741958159,COGS 11,A01,083617,Boyle; Mary E. T.,16,0,40,24
1650741964186,COGS 13,A01,083071,Staff,0,38,40,40
1650741970211,COGS 14A,A01,092681,Staff,0,35,100,100
1650741976283,COGS 14B,A01,083073,Cheng; Tzu-Han,1,13,50,49
1650741982307,COGS 17,A01,092677,Staff,13,0,75,62
1650741988331,COGS 100,A01,083619,Staff,0,28,60,60
1650741994359,COGS 101A,A01,083621,Davis; Joshua Daniel,0,27,60,60
1650742000386,COGS 101B,A01,091572,Staff,0,4,60,60
1650742006407,COGS 101C,A01,083625,Delgado; Tania,14,0,30,16
1650742012431,COGS 107A,A01,083627,Boyle; Mary E. T.,0,16,60,60
1650742018454,COGS 118A,A01,083075,Staff,0,8,60,60
1650742024479,CSE 3,A50,083646,Miranda; Gregory Joseph,18,0,38,20
1650742024479,CSE 3,A51,083647,Miranda; Gregory Joseph,36,0,37,1
1650742030503,CSE 8A,A50,083650,Miranda; Gregory Joseph,0,30,40,40
1650742036530,CSE 11,A01,083080,Cao; Yingjun,0,96,40,40
1650742042557,CSE 12,A01,083652,Staff,0,21,100,100
1650742048581,CSE 15L,A01,083654,Staff,0,3,50,50
1650742048581,CSE 15L,A02,083655,Staff,0,2,50,50
1650742054606,CSE 20,A01,083657,Staff,49,0,80,31
1650742060633,CSE 30,A01,083084,Eldon; John,0,77,40,40
1650742066662,CSE 100,A01,083659,Cao; Yingjun,0,70,50,50
1650742072689,CSE 134B,A01,083661,Powell; Thomas Allan,0,38,65,65
1650742078717,CSE 140,A01,083663,Staff,0,11,75,75
1650742084740,CSE 140L,A01,083088,Eldon; John,0,20,75,75
1650742090766,CSE 175,A01,083665,Kumar; Rakesh,7,0,25,18
1650742096797,CSE 190,A00,092507,Dubnov; Shlomo,10,0,20,10
1650742102825,ECE 45,A01,083139,Staff,1,2,60,59
1650742108848,ECE 65,A50,083695,Staff,0,5,30,30
1650742114873,ECE 109,A01,091882,Touri; Behrouz,33,0,70,37
1650742120897,ECE 180,A00,083140,Abi Samra; Nicholas Camill,20,0,30,10
1650742120897,ECE 180,B00,083141,Abi Samra; Nicholas Camill,0,0,30,30
1650742126931,MATH 10A,A01,083735,Patchell; Gregory David,2,0,30,28
1650742126931,MATH 10A,A02,083736,Patchell; Gregory David,27,0,30,3
1650742126931,MATH 10A,A03,083737,Patchell; Gregory David,24,0,30,6
1650742132956,MATH 10B,A01,083207,Staff,0,9,30,30
1650742132956,MATH 10B,A02,083208,Staff,1,7,30,29
1650742132956,MATH 10B,B01,083739,Staff,11,0,30,19
1650742132956,MATH 10B,B02,083740,Staff,28,0,30,2
1650742138981,MATH 18,A01,083743,Staff,0,0,30,30
1650742138981,MATH 18,A02,083744,Staff,23,0,30,7
1650742138981,MATH 18,A03,083745,Staff,21,0,30,9
1650742138981,MATH 18,A04,083746,Staff,26,0,30,4
1650742138981,MATH 18,B01,083748,Staff,0,15,30,30
1650742138981,MATH 18,B02,083749,Staff,0,12,30,30
1650742138981,MATH 18,B03,083750,Staff,0,12,30,30
1650742138981,MATH 18,B04,083751,Staff,0,12,30,30
1650742145008,MATH 20A,A01,083754,Staff,19,0,40,21
1650742151034,MATH 20B,A01,083756,Staff,0,11,30,30
1650742151034,MATH 20B,A02,083757,Staff,0,12,30,30
1650742157060,MATH 20C,A01,083760,Staff,0,16,30,30
1650742157060,MATH 20C,A02,083761,Staff,0,16,30,30
1650742157060,MATH 20C,B01,083762,Staff,10,0,30,20
1650742157060,MATH 20C,B02,083763,Staff,28,0,30,2
1650742163082,MATH 20D,A01,083765,Staff,2,1,30,28
1650742163082,MATH 20D,A02,083766,Staff,6,0,30,24
1650742163082,MATH 20D,A03,083767,Staff,24,0,30,6
1650742169110,MATH 20E,A01,083771,Staff,3,0,30,27
1650742169110,MATH 20E,A02,083772,Staff,16,0,30,14
1650742169110,MATH 20E,B01,083773,Staff,0,0,30,30
1650742169110,MATH 20E,B02,083774,Staff,6,0,30,24
1650742175134,MATH 103A,A01,083777,Staff,0,16,30,30
1650742175134,MATH 103A,A02,083778,Staff,0,15,30,30
1650742175134,MATH 103A,B01,083779,Staff,0,15,30,30
1650742175134,MATH 103A,B02,083780,Staff,0,15,30,30
1650742181162,MATH 105,A01,085443,Staff,0,22,30,30
1650742187186,MATH 109,A01,083213,Anzaldo; Leesa B,0,7,30,30
1650742187186,MATH 109,A02,083214,Anzaldo; Leesa B,0,7,30,30
1650742187186,MATH 109,B01,083215,Anzaldo; Leesa B,0,8,30,30
1650742187186,MATH 109,B02,083216,Anzaldo; Leesa B,0,6,30,30
1650742193214,MATH 142A,A01,083219,Chow; Bennett,0,16,30,30
1650742193214,MATH 142A,A02,083220,Chow; Bennett,0,15,30,30
1650742193214,MATH 142A,B01,083221,Chow; Bennett,0,15,30,30
1650742193214,MATH 142A,B02,083222,Chow; Bennett,0,14,30,30
1650742199239,MATH 193A,A01,083224,Staff,0,5,30,30
1650742199239,MATH 193A,A02,083225,Staff,0,6,30,30
1650742199239,MATH 193A,A03,083781,Staff,0,6,30,30
1650742199239,MATH 193A,A04,083782,Staff,0,7,30,30
1650742205264,MATH 197,001,091859,McAuley; Julian John,9998,0,9999,1
1650742211321,COGS 9,A01,083615,Staff,1,15,60,59
1650742217350,COGS 11,A01,083617,Boyle; Mary E. T.,16,0,40,24
1650742223374,COGS 13,A01,083071,Staff,0,38,40,40
1650742229395,COGS 14A,A01,092681,Staff,0,35,100,100
1650742235422,COGS 14B,A01,083073,Cheng; Tzu-Han,1,13,50,49
1650742241447,COGS 17,A01,092677,Staff,13,0,75,62
1650742247471,COGS 100,A01,083619,Staff,0,28,60,60
1650742253499,COGS 101A,A01,083621,Davis; Joshua Daniel,0,27,60,60
1650742259525,COGS 101B,A01,091572,Staff,0,4,60,60
1650742265551,COGS 101C,A01,083625,Delgado; Tania,14,0,30,16
1650742271575,COGS 107A,A01,083627,Boyle; Mary E. T.,0,16,60,60
1650742277599,COGS 118A,A01,083075,Staff,0,8,60,60
1650742283627,CSE 3,A50,083646,Miranda; Gregory Joseph,18,0,38,20
1650742283627,CSE 3,A51,083647,Miranda; Gregory Joseph,36,0,37,1
1650742289655,CSE 8A,A50,083650,Miranda; Gregory Joseph,0,30,40,40
1650742295697,CSE 11,A01,083080,Cao; Yingjun,0,96,40,40
1650742301721,CSE 12,A01,083652,Staff,0,21,100,100
1650742307742,CSE 15L,A01,083654,Staff,0,3,50,50
1650742307742,CSE 15L,A02,083655,Staff,0,2,50,50
1650742313766,CSE 20,A01,083657,Staff,49,0,80,31
1650742319790,CSE 30,A01,083084,Eldon; John,0,77,40,40
1650742325830,CSE 100,A01,083659,Cao; Yingjun,0,70,50,50
1650742331861,CSE 134B,A01,083661,Powell; Thomas Allan,0,38,65,65
1650742337883,CSE 140,A01,083663,Staff,0,11,75,75
1650742343907,CSE 140L,A01,083088,Eldon; John,0,20,75,75
1650742349933,CSE 175,A01,083665,Kumar; Rakesh,7,0,25,18
1650742355956,CSE 190,A00,092507,Dubnov; Shlomo,10,0,20,10
1650742361979,ECE 45,A01,083139,Staff,1,2,60,59
1650742368003,ECE 65,A50,083695,Staff,0,5,30,30
1650742374029,ECE 109,A01,091882,Touri; Behrouz,33,0,70,37
1650742380053,ECE 180,A00,083140,Abi Samra; Nicholas Camill,20,0,30,10
1650742380053,ECE 180,B00,083141,Abi Samra; Nicholas Camill,0,0,30,30
1650742386081,MATH 10A,A01,083735,Patchell; Gregory David,2,0,30,28
1650742386081,MATH 10A,A02,083736,Patchell; Gregory David,27,0,30,3
1650742386081,MATH 10A,A03,083737,Patchell; Gregory David,24,0,30,6
1650742392193,MATH 10B,A01,083207,Staff,0,9,30,30
1650742392193,MATH 10B,A02,083208,Staff,1,7,30,29
1650742392193,MATH 10B,B01,083739,Staff,11,0,30,19
1650742392193,MATH 10B,B02,083740,Staff,28,0,30,2
1650742398225,MATH 18,A01,083743,Staff,0,0,30,30
1650742398225,MATH 18,A02,083744,Staff,23,0,30,7
1650742398225,MATH 18,A03,083745,Staff,21,0,30,9
1650742398225,MATH 18,A04,083746,Staff,26,0,30,4
1650742398225,MATH 18,B01,083748,Staff,0,15,30,30
1650742398225,MATH 18,B02,083749,Staff,0,12,30,30
1650742398225,MATH 18,B03,083750,Staff,0,12,30,30
1650742398225,MATH 18,B04,083751,Staff,0,12,30,30
1650742404249,MATH 20A,A01,083754,Staff,19,0,40,21
1650742410271,MATH 20B,A01,083756,Staff,0,11,30,30
1650742410271,MATH 20B,A02,083757,Staff,0,12,30,30
1650742416298,MATH 20C,A01,083760,Staff,0,16,30,30
1650742416298,MATH 20C,A02,083761,Staff,0,16,30,30
1650742416298,MATH 20C,B01,083762,Staff,10,0,30,20
1650742416298,MATH 20C,B02,083763,Staff,28,0,30,2
1650742422322,MATH 20D,A01,083765,Staff,2,1,30,28
1650742422322,MATH 20D,A02,083766,Staff,6,0,30,24
1650742422322,MATH 20D,A03,083767,Staff,24,0,30,6
1650742428346,MATH 20E,A01,083771,Staff,3,0,30,27
1650742428346,MATH 20E,A02,083772,Staff,16,0,30,14
1650742428346,MATH 20E,B01,083773,Staff,0,0,30,30
1650742428346,MATH 20E,B02,083774,Staff,6,0,30,24
1650742434374,MATH 103A,A01,083777,Staff,0,16,30,30
1650742434374,MATH 103A,A02,083778,Staff,0,15,30,30
1650742434374,MATH 103A,B01,083779,Staff,0,15,30,30
1650742434374,MATH 103A,B02,083780,Staff,0,15,30,30
1650742440399,MATH 105,A01,085443,Staff,0,22,30,30
1650742446423,MATH 109,A01,083213,Anzaldo; Leesa B,0,7,30,30
1650742446423,MATH 109,A02,083214,Anzaldo; Leesa B,0,7,30,30
1650742446423,MATH 109,B01,083215,Anzaldo; Leesa B,0,8,30,30
1650742446423,MATH 109,B02,083216,Anzaldo; Leesa B,0,6,30,30
1650742452452,MATH 142A,A01,083219,Chow; Bennett,0,16,30,30
1650742452452,MATH 142A,A02,083220,Chow; Bennett,0,15,30,30
1650742452452,MATH 142A,B01,083221,Chow; Bennett,0,15,30,30
1650742452452,MATH 142A,B02,083222,Chow; Bennett,0,14,30,30
1650742458477,MATH 193A,A01,083224,Staff,0,5,30,30
1650742458477,MATH 193A,A02,083225,Staff,0,6,30,30
1650742458477,MATH 193A,A03,083781,Staff,0,6,30,30
1650742458477,MATH 193A,A04,083782,Staff,0,7,30,30
1650742464501,MATH 197,001,091859,McAuley; Julian John,9998,0,9999,1
1650742470554,COGS 9,A01,083615,Staff,1,15,60,59
1650742476577,COGS 11,A01,083617,Boyle; Mary E. T.,16,0,40,24
1650742482598,COGS 13,A01,083071,Staff,0,38,40,40
1650742488622,COGS 14A,A01,092681,Staff,0,35,100,100
1650742494646,COGS 14B,A01,083073,Cheng; Tzu-Han,1,13,50,49
1650742500671,COGS 17,A01,092677,Staff,13,0,75,62
1650742506697,COGS 100,A01,083619,Staff,0,28,60,60
1650742512723,COGS 101A,A01,083621,Davis; Joshua Daniel,0,27,60,60
1650742518747,COGS 101B,A01,091572,Staff,0,4,60,60
1650742524774,COGS 101C,A01,083625,Delgado; Tania,14,0,30,16
1650742530799,COGS 107A,A01,083627,Boyle; Mary E. T.,0,16,60,60
1650742536825,COGS 118A,A01,083075,Staff,0,8,60,60
1650742542849,CSE 3,A50,083646,Miranda; Gregory Joseph,18,0,38,20
1650742542849,CSE 3,A51,083647,Miranda; Gregory Joseph,36,0,37,1
1650742548875,CSE 8A,A50,083650,Miranda; Gregory Joseph,0,30,40,40
1650742554899,CSE 11,A01,083080,Cao; Yingjun,0,96,40,40
1650742560923,CSE 12,A01,083652,Staff,0,21,100,100
1650742566947,CSE 15L,A01,083654,Staff,0,3,50,50
1650742566947,CSE 15L,A02,083655,Staff,0,2,50,50
1650742572974,CSE 20,A01,083657,Staff,49,0,80,31
1650742578998,CSE 30,A01,083084,Eldon; John,0,77,40,40
1650742585040,CSE 100,A01,083659,Cao; Yingjun,0,70,50,50
1650742591064,CSE 134B,A01,083661,Powell; Thomas Allan,0,38,65,65
1650742597089,CSE 140,A01,083663,Staff,0,11,75,75
1650742603116,CSE 140L,A01,083088,Eldon; John,0,20,75,75
1650742609143,CSE 175,A01,083665,Kumar; Rakesh,7,0,25,18
1650742615167,CSE 190,A00,092507,Dubnov; Shlomo,10,0,20,10
1650742621194,ECE 45,A01,083139,Staff,1,2,60,59
1650742627218,ECE 65,A50,083695,Staff,0,5,30,30
1650742633244,ECE 109,A01,091882,Touri; Behrouz,33,0,70,37
1650742639271,ECE 180,A00,083140,Abi Samra; Nicholas Camill,20,0,30,10
1650742639271,ECE 180,B00,083141,Abi Samra; Nicholas Camill,0,0,30,30
1650742645294,MATH 10A,A01,083735,Patchell; Gregory David,2,0,30,28
1650742645294,MATH 10A,A02,083736,Patchell; Gregory David,27,0,30,3
1650742645294,MATH 10A,A03,083737,Patchell; Gregory David,24,0,30,6
1650742651317,MATH 10B,A01,083207,Staff,0,9,30,30
1650742651317,MATH 10B,A02,083208,Staff,1,7,30,29
1650742651317,MATH 10B,B01,083739,Staff,11,0,30,19
1650742651317,MATH 10B,B02,083740,Staff,28,0,30,2
1650742657346,MATH 18,A01,083743,Staff,0,0,30,30
1650742657346,MATH 18,A02,083744,Staff,23,0,30,7
1650742657346,MATH 18,A03,083745,Staff,21,0,30,9
1650742657346,MATH 18,A04,083746,Staff,26,0,30,4
1650742657346,MATH 18,B01,083748,Staff,0,15,30,30
1650742657346,MATH 18,B02,083749,Staff,0,12,30,30
1650742657346,MATH 18,B03,083750,Staff,0,12,30,30
1650742657346,MATH 18,B04,083751,Staff,0,12,30,30
1650742663373,MATH 20A,A01,083754,Staff,19,0,40,21
1650742669400,MATH 20B,A01,083756,Staff,0,11,30,30
1650742669400,MATH 20B,A02,083757,Staff,0,13,30,30
1650742675423,MATH 20C,A01,083760,Staff,0,16,30,30
1650742675423,MATH 20C,A02,083761,Staff,0,16,30,30
1650742675423,MATH 20C,B01,083762,Staff,10,0,30,20
1650742675423,MATH 20C,B02,083763,Staff,28,0,30,2
1650742681447,MATH 20D,A01,083765,Staff,2,1,30,28
1650742681447,MATH 20D,A02,083766,Staff,6,0,30,24
1650742681447,MATH 20D,A03,083767,Staff,24,0,30,6
1650742687471,MATH 20E,A01,083771,Staff,3,0,30,27
1650742687471,MATH 20E,A02,083772,Staff,16,0,30,14
1650742687471,MATH 20E,B01,083773,Staff,0,0,30,30
1650742687471,MATH 20E,B02,083774,Staff,6,0,30,24
1650742693495,MATH 103A,A01,083777,Staff,0,16,30,30
1650742693495,MATH 103A,A02,083778,Staff,0,15,30,30
1650742693495,MATH 103A,B01,083779,Staff,0,15,30,30
1650742693495,MATH 103A,B02,083780,Staff,0,15,30,30
1650742699519,MATH 105,A01,085443,Staff,0,22,30,30
1650742705551,MATH 109,A01,083213,Anzaldo; Leesa B,0,7,30,30
1650742705551,MATH 109,A02,083214,Anzaldo; Leesa B,0,7,30,30
1650742705551,MATH 109,B01,083215,Anzaldo; Leesa B,0,8,30,30
1650742705551,MATH 109,B02,083216,Anzaldo; Leesa B,0,6,30,30
1650742711579,MATH 142A,A01,083219,Chow; Bennett,0,16,30,30
1650742711579,MATH 142A,A02,083220,Chow; Bennett,0,15,30,30
1650742711579,MATH 142A,B01,083221,Chow; Bennett,0,15,30,30
1650742711579,MATH 142A,B02,083222,Chow; Bennett,0,14,30,30
1650742717604,MATH 193A,A01,083224,Staff,0,5,30,30
1650742717604,MATH 193A,A02,083225,Staff,0,6,30,30
1650742717604,MATH 193A,A03,083781,Staff,0,6,30,30
1650742717604,MATH 193A,A04,083782,Staff,0,7,30,30
1650742723628,MATH 197,001,091859,McAuley; Julian John,9998,0,9999,1
1650742729689,COGS 9,A01,083615,Staff,1,15,60,59
1650742735715,COGS 11,A01,083617,Boyle; Mary E. T.,16,0,40,24
1650742741746,COGS 13,A01,083071,Staff,0,38,40,40
1650742747773,COGS 14A,A01,092681,Staff,0,35,100,100
1650742753796,COGS 14B,A01,083073,Cheng; Tzu-Han,1,13,50,49
1650742759820,COGS 17,A01,092677,Staff,13,0,75,62
1650742765850,COGS 100,A01,083619,Staff,0,28,60,60
1650742771873,COGS 101A,A01,083621,Davis; Joshua Daniel,0,27,60,60
1650742777897,COGS 101B,A01,091572,Staff,0,4,60,60
1650742783921,COGS 101C,A01,083625,Delgado; Tania,14,0,30,16
1650742789948,COGS 107A,A01,083627,Boyle; Mary E. T.,0,16,60,60
1650742795971,COGS 118A,A01,083075,Staff,0,8,60,60
1650742801999,CSE 3,A50,083646,Miranda; Gregory Joseph,18,0,38,20
1650742801999,CSE 3,A51,083647,Miranda; Gregory Joseph,36,0,37,1
1650742808027,CSE 8A,A50,083650,Miranda; Gregory Joseph,0,30,40,40
1650742814052,CSE 11,A01,083080,Cao; Yingjun,0,96,40,40
1650742820076,CSE 12,A01,083652,Staff,0,21,100,100
1650742826101,CSE 15L,A01,083654,Staff,0,3,50,50
1650742826101,CSE 15L,A02,083655,Staff,0,2,50,50
1650742832124,CSE 20,A01,083657,Staff,49,0,80,31
1650742838151,CSE 30,A01,083084,Eldon; John,0,77,40,40
1650742844176,CSE 100,A01,083659,Cao; Yingjun,0,70,50,50
1650742850204,CSE 134B,A01,083661,Powell; Thomas Allan,0,38,65,65
1650742856228,CSE 140,A01,083663,Staff,0,11,75,75
1650742862253,CSE 140L,A01,083088,Eldon; John,0,20,75,75
1650742868297,CSE 175,A01,083665,Kumar; Rakesh,7,0,25,18
1650742874321,CSE 190,A00,092507,Dubnov; Shlomo,10,0,20,10
1650742880347,ECE 45,A01,083139,Staff,1,2,60,59
1650742886372,ECE 65,A50,083695,Staff,0,5,30,30
1650742892396,ECE 109,A01,091882,Touri; Behrouz,33,0,70,37
1650742898426,ECE 180,A00,083140,Abi Samra; Nicholas Camill,20,0,30,10
1650742898426,ECE 180,B00,083141,Abi Samra; Nicholas Camill,0,0,30,30
1650742904455,MATH 10A,A01,083735,Patchell; Gregory David,2,0,30,28
1650742904455,MATH 10A,A02,083736,Patchell; Gregory David,27,0,30,3
1650742904455,MATH 10A,A03,083737,Patchell; Gregory David,24,0,30,6
1650742910479,MATH 10B,A01,083207,Staff,0,9,30,30
1650742910479,MATH 10B,A02,083208,Staff,1,7,30,29
1650742910479,MATH 10B,B01,083739,Staff,11,0,30,19
1650742910479,MATH 10B,B02,083740,Staff,28,0,30,2
1650742916505,MATH 18,A01,083743,Staff,0,0,30,30
1650742916505,MATH 18,A02,083744,Staff,23,0,30,7
1650742916505,MATH 18,A03,083745,Staff,21,0,30,9
1650742916505,MATH 18,A04,083746,Staff,26,0,30,4
1650742916505,MATH 18,B01,083748,Staff,0,15,30,30
1650742916505,MATH 18,B02,083749,Staff,0,12,30,30
1650742916505,MATH 18,B03,083750,Staff,0,12,30,30
1650742916505,MATH 18,B04,083751,Staff,0,12,30,30
1650742922530,MATH 20A,A01,083754,Staff,19,0,40,21
1650742928554,MATH 20B,A01,083756,Staff,0,12,30,30
1650742928554,MATH 20B,A02,083757,Staff,0,12,30,30
1650742934578,MATH 20C,A01,083760,Staff,0,16,30,30
1650742934578,MATH 20C,A02,083761,Staff,0,16,30,30
1650742934578,MATH 20C,B01,083762,Staff,10,0,30,20
1650742934578,MATH 20C,B02,083763,Staff,28,0,30,2
1650742940603,MATH 20D,A01,083765,Staff,2,1,30,28
1650742940603,MATH 20D,A02,083766,Staff,6,0,30,24
1650742940603,MATH 20D,A03,083767,Staff,24,0,30,6
1650742946628,MATH 20E,A01,083771,Staff,3,0,30,27
1650742946628,MATH 20E,A02,083772,Staff,16,0,30,14
1650742946628,MATH 20E,B01,083773,Staff,0,0,30,30
1650742946628,MATH 20E,B02,083774,Staff,6,0,30,24
1650742952652,MATH 103A,A01,083777,Staff,0,16,30,30
1650742952652,MATH 103A,A02,083778,Staff,0,15,30,30
1650742952652,MATH 103A,B01,083779,Staff,0,15,30,30
1650742952652,MATH 103A,B02,083780,Staff,0,15,30,30
1650742958680,MATH 105,A01,085443,Staff,0,22,30,30
1650742964704,MATH 109,A01,083213,Anzaldo; Leesa B,0,7,30,30
1650742964704,MATH 109,A02,083214,Anzaldo; Leesa B,0,7,30,30
1650742964704,MATH 109,B01,083215,Anzaldo; Leesa B,0,8,30,30
1650742964704,MATH 109,B02,083216,Anzaldo; Leesa B,0,6,30,30
1650742970731,MATH 142A,A01,083219,Chow; Bennett,0,16,30,30
1650742970731,MATH 142A,A02,083220,Chow; Bennett,0,15,30,30
1650742970731,MATH 142A,B01,083221,Chow; Bennett,0,15,30,30
1650742970731,MATH 142A,B02,083222,Chow; Bennett,0,14,30,30
1650742976758,MATH 193A,A01,083224,Staff,0,5,30,30
1650742976758,MATH 193A,A02,083225,Staff,0,6,30,30
1650742976758,MATH 193A,A03,083781,Staff,0,6,30,30
1650742976758,MATH 193A,A04,083782,Staff,0,7,30,30
1650742982782,MATH 197,001,091859,McAuley; Julian John,9998,0,9999,1
1650742988924,COGS 9,A01,083615,Staff,1,15,60,59
1650742994949,COGS 11,A01,083617,Boyle; Mary E. T.,16,0,40,24
1650743000973,COGS 13,A01,083071,Staff,0,38,40,40
1650743006999,COGS 14A,A01,092681,Staff,0,35,100,100
1650743013023,COGS 14B,A01,083073,Cheng; Tzu-Han,1,13,50,49
1650743019047,COGS 17,A01,092677,Staff,13,0,75,62
1650743025071,COGS 100,A01,083619,Staff,0,28,60,60
1650743031096,COGS 101A,A01,083621,Davis; Joshua Daniel,0,27,60,60
1650743037122,COGS 101B,A01,091572,Staff,0,4,60,60
1650743043144,COGS 101C,A01,083625,Delgado; Tania,14,0,30,16
1650743049170,COGS 107A,A01,083627,Boyle; Mary E. T.,0,16,60,60
1650743055201,COGS 118A,A01,083075,Staff,0,8,60,60
1650743061224,CSE 3,A50,083646,Miranda; Gregory Joseph,18,0,38,20
1650743061224,CSE 3,A51,083647,Miranda; Gregory Joseph,36,0,37,1
1650743067248,CSE 8A,A50,083650,Miranda; Gregory Joseph,0,30,40,40
1650743073274,CSE 11,A01,083080,Cao; Yingjun,0,96,40,40
1650743079299,CSE 12,A01,083652,Staff,0,21,100,100
1650743085321,CSE 15L,A01,083654,Staff,0,3,50,50
1650743085321,CSE 15L,A02,083655,Staff,0,2,50,50
1650743091348,CSE 20,A01,083657,Staff,49,0,80,31
1650743097387,CSE 30,A01,083084,Eldon; John,0,77,40,40
1650743103410,CSE 100,A01,083659,Cao; Yingjun,0,70,50,50
1650743109432,CSE 134B,A01,083661,Powell; Thomas Allan,0,38,65,65
1650743115458,CSE 140,A01,083663,Staff,0,11,75,75
1650743121480,CSE 140L,A01,083088,Eldon; John,0,20,75,75
1650743127511,CSE 175,A01,083665,Kumar; Rakesh,7,0,25,18
1650743133533,CSE 190,A00,092507,Dubnov; Shlomo,10,0,20,10
1650743139564,ECE 45,A01,083139,Staff,1,2,60,59
1650743145589,ECE 65,A50,083695,Staff,0,5,30,30
1650743151612,ECE 109,A01,091882,Touri; Behrouz,33,0,70,37
1650743157639,ECE 180,A00,083140,Abi Samra; Nicholas Camill,20,0,30,10
1650743157639,ECE 180,B00,083141,Abi Samra; Nicholas Camill,0,0,30,30
1650743163673,MATH 10A,A01,083735,Patchell; Gregory David,2,0,30,28
1650743163673,MATH 10A,A02,083736,Patchell; Gregory David,27,0,30,3
1650743163673,MATH 10A,A03,083737,Patchell; Gregory David,24,0,30,6
1650743169696,MATH 10B,A01,083207,Staff,0,9,30,30
1650743169696,MATH 10B,A02,083208,Staff,1,7,30,29
1650743169696,MATH 10B,B01,083739,Staff,11,0,30,19
1650743169696,MATH 10B,B02,083740,Staff,28,0,30,2
1650743175721,MATH 18,A01,083743,Staff,0,0,30,30
1650743175721,MATH 18,A02,083744,Staff,23,0,30,7
1650743175721,MATH 18,A03,083745,Staff,21,0,30,9
1650743175721,MATH 18,A04,083746,Staff,26,0,30,4
1650743175721,MATH 18,B01,083748,Staff,0,15,30,30
1650743175721,MATH 18,B02,083749,Staff,0,12,30,30
1650743175721,MATH 18,B03,083750,Staff,0,12,30,30
1650743175721,MATH 18,B04,083751,Staff,0,12,30,30
1650743181744,MATH 20A,A01,083754,Staff,19,0,40,21
1650743187767,MATH 20B,A01,083756,Staff,0,12,30,30
1650743187767,MATH 20B,A02,083757,Staff,0,12,30,30
1650743193792,MATH 20C,A01,083760,Staff,0,16,30,30
1650743193792,MATH 20C,A02,083761,Staff,0,16,30,30
1650743193792,MATH 20C,B01,083762,Staff,10,0,30,20
1650743193792,MATH 20C,B02,083763,Staff,28,0,30,2
1650743199819,MATH 20D,A01,083765,Staff,2,1,30,28
1650743199819,MATH 20D,A02,083766,Staff,6,0,30,24
1650743199819,MATH 20D,A03,083767,Staff,24,0,30,6
1650743205843,MATH 20E,A01,083771,Staff,3,0,30,27
1650743205843,MATH 20E,A02,083772,Staff,16,0,30,14
1650743205843,MATH 20E,B01,083773,Staff,0,0,30,30
1650743205843,MATH 20E,B02,083774,Staff,6,0,30,24
1650743211876,MATH 103A,A01,083777,Staff,0,16,30,30
1650743211876,MATH 103A,A02,083778,Staff,0,15,30,30
1650743211876,MATH 103A,B01,083779,Staff,0,15,30,30
1650743211876,MATH 103A,B02,083780,Staff,0,15,30,30
1650743217903,MATH 105,A01,085443,Staff,0,22,30,30
1650743223931,MATH 109,A01,083213,Anzaldo; Leesa B,0,7,30,30
1650743223931,MATH 109,A02,083214,Anzaldo; Leesa B,0,7,30,30
1650743223931,MATH 109,B01,083215,Anzaldo; Leesa B,0,8,30,30
1650743223931,MATH 109,B02,083216,Anzaldo; Leesa B,0,6,30,30
1650743229965,MATH 142A,A01,083219,Chow; Bennett,0,16,30,30
1650743229965,MATH 142A,A02,083220,Chow; Bennett,0,15,30,30
1650743229965,MATH 142A,B01,083221,Chow; Bennett,0,15,30,30
1650743229965,MATH 142A,B02,083222,Chow; Bennett,0,14,30,30
1650743235990,MATH 193A,A01,083224,Staff,0,5,30,30
1650743235990,MATH 193A,A02,083225,Staff,0,6,30,30
1650743235990,MATH 193A,A03,083781,Staff,0,6,30,30
1650743235990,MATH 193A,A04,083782,Staff,0,7,30,30
1650743242013,MATH 197,001,091859,McAuley; Julian John,9998,0,9999,1
1650743248067,COGS 9,A01,083615,Staff,1,15,60,59
1650743254090,COGS 11,A01,083617,Boyle; Mary E. T.,16,0,40,24
1650743260119,COGS 13,A01,083071,Staff,0,38,40,40
1650743266143,COGS 14A,A01,092681,Staff,0,35,100,100
1650743272168,COGS 14B,A01,083073,Cheng; Tzu-Han,1,13,50,49
1650743278196,COGS 17,A01,092677,Staff,13,0,75,62
1650743284222,COGS 100,A01,083619,Staff,0,28,60,60
1650743290243,COGS 101A,A01,083621,Davis; Joshua Daniel,0,27,60,60
1650743296271,COGS 101B,A01,091572,Staff,0,4,60,60
1650743302297,COGS 101C,A01,083625,Delgado; Tania,14,0,30,16
1650743308320,COGS 107A,A01,083627,Boyle; Mary E. T.,0,16,60,60
1650743314350,COGS 118A,A01,083075,Staff,0,8,60,60
1650743320374,CSE 3,A50,083646,Miranda; Gregory Joseph,18,0,38,20
1650743320374,CSE 3,A51,083647,Miranda; Gregory Joseph,36,0,37,1
1650743326397,CSE 8A,A50,083650,Miranda; Gregory Joseph,0,30,40,40
1650743332422,CSE 11,A01,083080,Cao; Yingjun,0,96,40,40
1650743338449,CSE 12,A01,083652,Staff,0,21,100,100
1650743344482,CSE 15L,A01,083654,Staff,0,3,50,50
1650743344482,CSE 15L,A02,083655,Staff,0,2,50,50
1650743350509,CSE 20,A01,083657,Staff,49,0,80,31
1650743356532,CSE 30,A01,083084,Eldon; John,0,77,40,40
1650743362559,CSE 100,A01,083659,Cao; Yingjun,0,70,50,50
1650743368584,CSE 134B,A01,083661,Powell; Thomas Allan,0,38,65,65
1650743374615,CSE 140,A01,083663,Staff,0,11,75,75
1650743380642,CSE 140L,A01,083088,Eldon; John,0,20,75,75
1650743386666,CSE 175,A01,083665,Kumar; Rakesh,7,0,25,18
1650743392689,CSE 190,A00,092507,Dubnov; Shlomo,10,0,20,10
1650743398717,ECE 45,A01,083139,Staff,1,2,60,59
1650743404740,ECE 65,A50,083695,Staff,0,5,30,30
1650743410768,ECE 109,A01,091882,Touri; Behrouz,33,0,70,37
1650743416794,ECE 180,A00,083140,Abi Samra; Nicholas Camill,20,0,30,10
1650743416794,ECE 180,B00,083141,Abi Samra; Nicholas Camill,0,0,30,30
1650743422819,MATH 10A,A01,083735,Patchell; Gregory David,2,0,30,28
1650743422819,MATH 10A,A02,083736,Patchell; Gregory David,27,0,30,3
1650743422819,MATH 10A,A03,083737,Patchell; Gregory David,24,0,30,6
1650743428844,MATH 10B,A01,083207,Staff,0,9,30,30
1650743428844,MATH 10B,A02,083208,Staff,1,7,30,29
1650743428844,MATH 10B,B01,083739,Staff,11,0,30,19
1650743428844,MATH 10B,B02,083740,Staff,28,0,30,2
1650743434869,MATH 18,A01,083743,Staff,0,0,30,30
1650743434869,MATH 18,A02,083744,Staff,23,0,30,7
1650743434869,MATH 18,A03,083745,Staff,21,0,30,9
1650743434869,MATH 18,A04,083746,Staff,26,0,30,4
1650743434869,MATH 18,B01,083748,Staff,0,15,30,30
1650743434869,MATH 18,B02,083749,Staff,0,12,30,30
1650743434869,MATH 18,B03,083750,Staff,0,12,30,30
1650743434869,MATH 18,B04,083751,Staff,0,12,30,30
1650743440905,MATH 20A,A01,083754,Staff,19,0,40,21
1650743446929,MATH 20B,A01,083756,Staff,0,12,30,30
1650743446929,MATH 20B,A02,083757,Staff,0,12,30,30
1650743452951,MATH 20C,A01,083760,Staff,0,16,30,30
1650743452951,MATH 20C,A02,083761,Staff,0,16,30,30
1650743452951,MATH 20C,B01,083762,Staff,10,0,30,20
1650743452951,MATH 20C,B02,083763,Staff,28,0,30,2
1650743458975,MATH 20D,A01,083765,Staff,2,1,30,28
1650743458975,MATH 20D,A02,083766,Staff,6,0,30,24
1650743458975,MATH 20D,A03,083767,Staff,24,0,30,6
1650743464998,MATH 20E,A01,083771,Staff,3,0,30,27
1650743464998,MATH 20E,A02,083772,Staff,16,0,30,14
1650743464998,MATH 20E,B01,083773,Staff,0,0,30,30
1650743464998,MATH 20E,B02,083774,Staff,6,0,30,24
1650743471046,MATH 103A,A01,083777,Staff,0,16,30,30
1650743471046,MATH 103A,A02,083778,Staff,0,15,30,30
1650743471046,MATH 103A,B01,083779,Staff,0,15,30,30
1650743471046,MATH 103A,B02,083780,Staff,0,15,30,30
1650743477070,MATH 105,A01,085443,Staff,0,22,30,30
1650743483099,MATH 109,A01,083213,Anzaldo; Leesa B,0,7,30,30
1650743483099,MATH 109,A02,083214,Anzaldo; Leesa B,0,7,30,30
1650743483099,MATH 109,B01,083215,Anzaldo; Leesa B,0,8,30,30
1650743483099,MATH 109,B02,083216,Anzaldo; Leesa B,0,6,30,30
1650743489124,MATH 142A,A01,083219,Chow; Bennett,0,16,30,30
1650743489124,MATH 142A,A02,083220,Chow; Bennett,0,15,30,30
1650743489124,MATH 142A,B01,083221,Chow; Bennett,0,15,30,30
1650743489124,MATH 142A,B02,083222,Chow; Bennett,0,14,30,30
1650743495147,MATH 193A,A01,083224,Staff,0,5,30,30
1650743495147,MATH 193A,A02,083225,Staff,0,6,30,30
1650743495147,MATH 193A,A03,083781,Staff,0,6,30,30
1650743495147,MATH 193A,A04,083782,Staff,0,7,30,30
1650743501173,MATH 197,001,091859,McAuley; Julian John,9998,0,9999,1
1650743507224,COGS 9,A01,083615,Staff,1,15,60,59
1650743513248,COGS 11,A01,083617,Boyle; Mary E. T.,16,0,40,24
1650743519272,COGS 13,A01,083071,Staff,0,38,40,40
1650743525294,COGS 14A,A01,092681,Staff,0,35,100,100
1650743531321,COGS 14B,A01,083073,Cheng; Tzu-Han,1,13,50,49
1650743537346,COGS 17,A01,092677,Staff,13,0,75,62
1650743543367,COGS 100,A01,083619,Staff,0,28,60,60
1650743549393,COGS 101A,A01,083621,Davis; Joshua Daniel,0,27,60,60
1650743555420,COGS 101B,A01,091572,Staff,0,4,60,60
1650743561443,COGS 101C,A01,083625,Delgado; Tania,14,0,30,16
1650743567467,COGS 107A,A01,083627,Boyle; Mary E. T.,0,16,60,60
1650743573497,COGS 118A,A01,083075,Staff,0,8,60,60
1650743579623,CSE 3,A50,083646,Miranda; Gregory Joseph,18,0,38,20
1650743579623,CSE 3,A51,083647,Miranda; Gregory Joseph,36,0,37,1
1650743585648,CSE 8A,A50,083650,Miranda; Gregory Joseph,0,30,40,40
1650743591670,CSE 11,A01,083080,Cao; Yingjun,0,96,40,40
1650743597693,CSE 12,A01,083652,Staff,0,21,100,100
1650743603715,CSE 15L,A01,083654,Staff,0,3,50,50
1650743603715,CSE 15L,A02,083655,Staff,0,2,50,50
1650743609740,CSE 20,A01,083657,Staff,49,0,80,31
1650743615762,CSE 30,A01,083084,Eldon; John,0,77,40,40
1650743621786,CSE 100,A01,083659,Cao; Yingjun,0,70,50,50
1650743627809,CSE 134B,A01,083661,Powell; Thomas Allan,0,38,65,65
1650743633832,CSE 140,A01,083663,Staff,0,11,75,75
1650743639856,CSE 140L,A01,083088,Eldon; John,0,20,75,75
1650743645880,CSE 175,A01,083665,Kumar; Rakesh,7,0,25,18
1650743651907,CSE 190,A00,092507,Dubnov; Shlomo,10,0,20,10
1650743657934,ECE 45,A01,083139,Staff,1,2,60,59
1650743663958,ECE 65,A50,083695,Staff,0,5,30,30
1650743669989,ECE 109,A01,091882,Touri; Behrouz,33,0,70,37
1650743676011,ECE 180,A00,083140,Abi Samra; Nicholas Camill,20,0,30,10
1650743676011,ECE 180,B00,083141,Abi Samra; Nicholas Camill,0,0,30,30
1650743682038,MATH 10A,A01,083735,Patchell; Gregory David,2,0,30,28
1650743682038,MATH 10A,A02,083736,Patchell; Gregory David,27,0,30,3
1650743682038,MATH 10A,A03,083737,Patchell; Gregory David,24,0,30,6
1650743688062,MATH 10B,A01,083207,Staff,0,9,30,30
1650743688062,MATH 10B,A02,083208,Staff,1,7,30,29
1650743688062,MATH 10B,B01,083739,Staff,11,0,30,19
1650743688062,MATH 10B,B02,083740,Staff,28,0,30,2
1650743694093,MATH 18,A01,083743,Staff,0,0,30,30
1650743694093,MATH 18,A02,083744,Staff,23,0,30,7
1650743694093,MATH 18,A03,083745,Staff,21,0,30,9
1650743694093,MATH 18,A04,083746,Staff,26,0,30,4
1650743694093,MATH 18,B01,083748,Staff,0,15,30,30
1650743694093,MATH 18,B02,083749,Staff,0,12,30,30
1650743694093,MATH 18,B03,083750,Staff,0,12,30,30
1650743694093,MATH 18,B04,083751,Staff,0,12,30,30
1650743700119,MATH 20A,A01,083754,Staff,19,0,40,21
1650743706142,MATH 20B,A01,083756,Staff,0,12,30,30
1650743706142,MATH 20B,A02,083757,Staff,0,12,30,30
1650743712168,MATH 20C,A01,083760,Staff,0,16,30,30
1650743712168,MATH 20C,A02,083761,Staff,0,16,30,30
1650743712168,MATH 20C,B01,083762,Staff,10,0,30,20
1650743712168,MATH 20C,B02,083763,Staff,28,0,30,2
1650743718194,MATH 20D,A01,083765,Staff,2,1,30,28
1650743718194,MATH 20D,A02,083766,Staff,6,0,30,24
1650743718194,MATH 20D,A03,083767,Staff,24,0,30,6
1650743724221,MATH 20E,A01,083771,Staff,3,0,30,27
1650743724221,MATH 20E,A02,083772,Staff,16,0,30,14
1650743724221,MATH 20E,B01,083773,Staff,0,0,30,30
1650743724221,MATH 20E,B02,083774,Staff,6,0,30,24
1650743730247,MATH 103A,A01,083777,Staff,0,16,30,30
1650743730247,MATH 103A,A02,083778,Staff,0,15,30,30
1650743730247,MATH 103A,B01,083779,Staff,0,15,30,30
1650743730247,MATH 103A,B02,083780,Staff,0,15,30,30
1650743736273,MATH 105,A01,085443,Staff,0,22,30,30
1650743742299,MATH 109,A01,083213,Anzaldo; Leesa B,0,7,30,30
1650743742299,MATH 109,A02,083214,Anzaldo; Leesa B,0,7,30,30
1650743742299,MATH 109,B01,083215,Anzaldo; Leesa B,0,8,30,30
1650743742299,MATH 109,B02,083216,Anzaldo; Leesa B,0,6,30,30
1650743748323,MATH 142A,A01,083219,Chow; Bennett,0,16,30,30
1650743748323,MATH 142A,A02,083220,Chow; Bennett,0,15,30,30
1650743748323,MATH 142A,B01,083221,Chow; Bennett,0,15,30,30
1650743748323,MATH 142A,B02,083222,Chow; Bennett,0,14,30,30
1650743754347,MATH 193A,A01,083224,Staff,0,5,30,30
1650743754347,MATH 193A,A02,083225,Staff,0,6,30,30
1650743754347,MATH 193A,A03,083781,Staff,0,6,30,30
1650743754347,MATH 193A,A04,083782,Staff,0,7,30,30
1650743760368,MATH 197,001,091859,McAuley; Julian John,9998,0,9999,1
1650743766429,COGS 9,A01,083615,Staff,1,15,60,59
1650743772451,COGS 11,A01,083617,Boyle; Mary E. T.,16,0,40,24
1650743778476,COGS 13,A01,083071,Staff,0,38,40,40
1650743784499,COGS 14A,A01,092681,Staff,0,35,100,100
1650743790522,COGS 14B,A01,083073,Cheng; Tzu-Han,1,13,50,49
1650743796545,COGS 17,A01,092677,Staff,13,0,75,62
1650743802569,COGS 100,A01,083619,Staff,0,28,60,60
1650743808595,COGS 101A,A01,083621,Davis; Joshua Daniel,0,27,60,60
1650743814620,COGS 101B,A01,091572,Staff,0,4,60,60
1650743820643,COGS 101C,A01,083625,Delgado; Tania,14,0,30,16
1650743826669,COGS 107A,A01,083627,Boyle; Mary E. T.,0,16,60,60
1650743832694,COGS 118A,A01,083075,Staff,0,8,60,60
1650743838718,CSE 3,A50,083646,Miranda; Gregory Joseph,18,0,38,20
1650743838718,CSE 3,A51,083647,Miranda; Gregory Joseph,36,0,37,1
1650743844744,CSE 8A,A50,083650,Miranda; Gregory Joseph,0,30,40,40
1650743850766,CSE 11,A01,083080,Cao; Yingjun,0,96,40,40
1650743856791,CSE 12,A01,083652,Staff,0,21,100,100
1650743862817,CSE 15L,A01,083654,Staff,0,3,50,50
1650743862817,CSE 15L,A02,083655,Staff,0,2,50,50
1650743868844,CSE 20,A01,083657,Staff,49,0,80,31
1650743874867,CSE 30,A01,083084,Eldon; John,0,77,40,40
1650743880894,CSE 100,A01,083659,Cao; Yingjun,0,70,50,50
1650743886920,CSE 134B,A01,083661,Powell; Thomas Allan,0,38,65,65
1650743892945,CSE 140,A01,083663,Staff,0,11,75,75
1650743898967,CSE 140L,A01,083088,Eldon; John,0,20,75,75
1650743904994,CSE 175,A01,083665,Kumar; Rakesh,7,0,25,18
1650743911016,CSE 190,A00,092507,Dubnov; Shlomo,10,0,20,10
1650743917042,ECE 45,A01,083139,Staff,1,2,60,59
1650743923068,ECE 65,A50,083695,Staff,0,5,30,30
1650743929091,ECE 109,A01,091882,Touri; Behrouz,33,0,70,37
1650743935119,ECE 180,A00,083140,Abi Samra; Nicholas Camill,20,0,30,10
1650743935119,ECE 180,B00,083141,Abi Samra; Nicholas Camill,0,0,30,30
1650743941144,MATH 10A,A01,083735,Patchell; Gregory David,2,0,30,28
1650743941144,MATH 10A,A02,083736,Patchell; Gregory David,27,0,30,3
1650743941144,MATH 10A,A03,083737,Patchell; Gregory David,24,0,30,6
1650743947170,MATH 10B,A01,083207,Staff,0,9,30,30
1650743947170,MATH 10B,A02,083208,Staff,1,7,30,29
1650743947170,MATH 10B,B01,083739,Staff,11,0,30,19
1650743947170,MATH 10B,B02,083740,Staff,28,0,30,2
1650743953201,MATH 18,A01,083743,Staff,0,0,30,30
1650743953201,MATH 18,A02,083744,Staff,23,0,30,7
1650743953201,MATH 18,A03,083745,Staff,21,0,30,9
1650743953201,MATH 18,A04,083746,Staff,26,0,30,4
1650743953201,MATH 18,B01,083748,Staff,0,15,30,30
1650743953201,MATH 18,B02,083749,Staff,0,12,30,30
1650743953201,MATH 18,B03,083750,Staff,0,12,30,30
1650743953201,MATH 18,B04,083751,Staff,0,12,30,30
1650743959225,MATH 20A,A01,083754,Staff,19,0,40,21
1650743965253,MATH 20B,A01,083756,Staff,0,12,30,30
1650743965253,MATH 20B,A02,083757,Staff,0,12,30,30
1650743971277,MATH 20C,A01,083760,Staff,0,16,30,30
1650743971277,MATH 20C,A02,083761,Staff,0,16,30,30
1650743971277,MATH 20C,B01,083762,Staff,10,0,30,20
1650743971277,MATH 20C,B02,083763,Staff,28,0,30,2
1650743977300,MATH 20D,A01,083765,Staff,2,1,30,28
1650743977300,MATH 20D,A02,083766,Staff,6,0,30,24
1650743977300,MATH 20D,A03,083767,Staff,24,0,30,6
1650743983328,MATH 20E,A01,083771,Staff,3,0,30,27
1650743983328,MATH 20E,A02,083772,Staff,16,0,30,14
1650743983328,MATH 20E,B01,083773,Staff,0,0,30,30
1650743983328,MATH 20E,B02,083774,Staff,6,0,30,24
1650743989351,MATH 103A,A01,083777,Staff,0,16,30,30
1650743989351,MATH 103A,A02,083778,Staff,0,15,30,30
1650743989351,MATH 103A,B01,083779,Staff,0,15,30,30
1650743989351,MATH 103A,B02,083780,Staff,0,15,30,30
1650743995377,MATH 105,A01,085443,Staff,0,22,30,30
1650744001399,MATH 109,A01,083213,Anzaldo; Leesa B,0,7,30,30
1650744001399,MATH 109,A02,083214,Anzaldo; Leesa B,0,7,30,30
1650744001399,MATH 109,B01,083215,Anzaldo; Leesa B,0,8,30,30
1650744001399,MATH 109,B02,083216,Anzaldo; Leesa B,0,6,30,30
1650744007423,MATH 142A,A01,083219,Chow; Bennett,0,16,30,30
1650744007423,MATH 142A,A02,083220,Chow; Bennett,0,15,30,30
1650744007423,MATH 142A,B01,083221,Chow; Bennett,0,15,30,30
1650744007423,MATH 142A,B02,083222,Chow; Bennett,0,14,30,30
1650744013446,MATH 193A,A01,083224,Staff,0,5,30,30
1650744013446,MATH 193A,A02,083225,Staff,0,6,30,30
1650744013446,MATH 193A,A03,083781,Staff,0,6,30,30
1650744013446,MATH 193A,A04,083782,Staff,0,7,30,30
1650744019469,MATH 197,001,091859,McAuley; Julian John,9998,0,9999,1
1650744025530,COGS 9,A01,083615,Staff,1,15,60,59
1650744031552,COGS 11,A01,083617,Boyle; Mary E. T.,16,0,40,24
1650744037580,COGS 13,A01,083071,Staff,0,38,40,40
1650744043604,COGS 14A,A01,092681,Staff,0,35,100,100
1650744049627,COGS 14B,A01,083073,Cheng; Tzu-Han,1,13,50,49
1650744055654,COGS 17,A01,092677,Staff,13,0,75,62
1650744061682,COGS 100,A01,083619,Staff,0,28,60,60
1650744067722,COGS 101A,A01,083621,Davis; Joshua Daniel,0,27,60,60
1650744073745,COGS 101B,A01,091572,Staff,0,4,60,60
1650744079775,COGS 101C,A01,083625,Delgado; Tania,14,0,30,16
1650744085803,COGS 107A,A01,083627,Boyle; Mary E. T.,0,16,60,60
1650744091826,COGS 118A,A01,083075,Staff,0,8,60,60
1650744097850,CSE 3,A50,083646,Miranda; Gregory Joseph,18,0,38,20
1650744097850,CSE 3,A51,083647,Miranda; Gregory Joseph,36,0,37,1
1650744103878,CSE 8A,A50,083650,Miranda; Gregory Joseph,0,30,40,40
1650744109906,CSE 11,A01,083080,Cao; Yingjun,0,96,40,40
1650744115930,CSE 12,A01,083652,Staff,0,21,100,100
1650744121957,CSE 15L,A01,083654,Staff,0,3,50,50
1650744121957,CSE 15L,A02,083655,Staff,0,2,50,50
1650744127981,CSE 20,A01,083657,Staff,49,0,80,31
1650744134008,CSE 30,A01,083084,Eldon; John,0,77,40,40
1650744140035,CSE 100,A01,083659,Cao; Yingjun,0,70,50,50
1650744146066,CSE 134B,A01,083661,Powell; Thomas Allan,0,38,65,65
1650744152089,CSE 140,A01,083663,Staff,0,11,75,75
1650744158114,CSE 140L,A01,083088,Eldon; John,0,20,75,75
1650744164140,CSE 175,A01,083665,Kumar; Rakesh,7,0,25,18
1650744170165,CSE 190,A00,092507,Dubnov; Shlomo,10,0,20,10
1650744176289,ECE 45,A01,083139,Staff,1,2,60,59
1650744182312,ECE 65,A50,083695,Staff,0,5,30,30
1650744188339,ECE 109,A01,091882,Touri; Behrouz,33,0,70,37
1650744194361,ECE 180,A00,083140,Abi Samra; Nicholas Camill,20,0,30,10
1650744194361,ECE 180,B00,083141,Abi Samra; Nicholas Camill,0,0,30,30
1650744200385,MATH 10A,A01,083735,Patchell; Gregory David,2,0,30,28
1650744200385,MATH 10A,A02,083736,Patchell; Gregory David,27,0,30,3
1650744200385,MATH 10A,A03,083737,Patchell; Gregory David,24,0,30,6
1650744206408,MATH 10B,A01,083207,Staff,0,9,30,30
1650744206408,MATH 10B,A02,083208,Staff,1,7,30,29
1650744206408,MATH 10B,B01,083739,Staff,11,0,30,19
1650744206408,MATH 10B,B02,083740,Staff,28,0,30,2
1650744212433,MATH 18,A01,083743,Staff,0,0,30,30
1650744212433,MATH 18,A02,083744,Staff,23,0,30,7
1650744212433,MATH 18,A03,083745,Staff,21,0,30,9
1650744212433,MATH 18,A04,083746,Staff,26,0,30,4
1650744212433,MATH 18,B01,083748,Staff,0,15,30,30
1650744212433,MATH 18,B02,083749,Staff,0,12,30,30
1650744212433,MATH 18,B03,083750,Staff,0,12,30,30
1650744212433,MATH 18,B04,083751,Staff,0,12,30,30
1650744218458,MATH 20A,A01,083754,Staff,19,0,40,21
1650744224482,MATH 20B,A01,083756,Staff,0,12,30,30
1650744224482,MATH 20B,A02,083757,Staff,0,12,30,30
1650744230511,MATH 20C,A01,083760,Staff,0,16,30,30
1650744230511,MATH 20C,A02,083761,Staff,0,16,30,30
1650744230511,MATH 20C,B01,083762,Staff,10,0,30,20
1650744230511,MATH 20C,B02,083763,Staff,28,0,30,2
1650744236535,MATH 20D,A01,083765,Staff,2,1,30,28
1650744236535,MATH 20D,A02,083766,Staff,6,0,30,24
1650744236535,MATH 20D,A03,083767,Staff,24,0,30,6
1650744242559,MATH 20E,A01,083771,Staff,3,0,30,27
1650744242559,MATH 20E,A02,083772,Staff,16,0,30,14
1650744242559,MATH 20E,B01,083773,Staff,0,0,30,30
1650744242559,MATH 20E,B02,083774,Staff,6,0,30,24
1650744248583,MATH 103A,A01,083777,Staff,0,16,30,30
1650744248583,MATH 103A,A02,083778,Staff,0,15,30,30
1650744248583,MATH 103A,B01,083779,Staff,0,15,30,30
1650744248583,MATH 103A,B02,083780,Staff,0,15,30,30
1650744254609,MATH 105,A01,085443,Staff,0,22,30,30
1650744260633,MATH 109,A01,083213,Anzaldo; Leesa B,0,7,30,30
1650744260633,MATH 109,A02,083214,Anzaldo; Leesa B,0,7,30,30
1650744260633,MATH 109,B01,083215,Anzaldo; Leesa B,0,8,30,30
1650744260633,MATH 109,B02,083216,Anzaldo; Leesa B,0,6,30,30
1650744266658,MATH 142A,A01,083219,Chow; Bennett,0,16,30,30
1650744266658,MATH 142A,A02,083220,Chow; Bennett,0,15,30,30
1650744266658,MATH 142A,B01,083221,Chow; Bennett,0,15,30,30
1650744266658,MATH 142A,B02,083222,Chow; Bennett,0,14,30,30
1650744272687,MATH 193A,A01,083224,Staff,0,5,30,30
1650744272687,MATH 193A,A02,083225,Staff,0,6,30,30
1650744272687,MATH 193A,A03,083781,Staff,0,6,30,30
1650744272687,MATH 193A,A04,083782,Staff,0,7,30,30
1650744278713,MATH 197,001,091859,McAuley; Julian John,9998,0,9999,1
1650744284770,COGS 9,A01,083615,Staff,1,15,60,59
1650744290794,COGS 11,A01,083617,Boyle; Mary E. T.,16,0,40,24
1650744296819,COGS 13,A01,083071,Staff,0,38,40,40
1650744302846,COGS 14A,A01,092681,Staff,0,35,100,100
1650744308868,COGS 14B,A01,083073,Cheng; Tzu-Han,1,13,50,49
1650744314891,COGS 17,A01,092677,Staff,13,0,75,62
1650744320915,COGS 100,A01,083619,Staff,0,28,60,60
1650744326945,COGS 101A,A01,083621,Davis; Joshua Daniel,0,27,60,60
1650744332976,COGS 101B,A01,091572,Staff,0,4,60,60
1650744339001,COGS 101C,A01,083625,Delgado; Tania,14,0,30,16
1650744345027,COGS 107A,A01,083627,Boyle; Mary E. T.,0,16,60,60
1650744351061,COGS 118A,A01,083075,Staff,0,8,60,60
1650744357084,CSE 3,A50,083646,Miranda; Gregory Joseph,18,0,38,20
1650744357084,CSE 3,A51,083647,Miranda; Gregory Joseph,36,0,37,1
1650744363111,CSE 8A,A50,083650,Miranda; Gregory Joseph,0,30,40,40
1650744369137,CSE 11,A01,083080,Cao; Yingjun,0,96,40,40
1650744375162,CSE 12,A01,083652,Staff,0,21,100,100
1650744381184,CSE 15L,A01,083654,Staff,0,3,50,50
1650744381184,CSE 15L,A02,083655,Staff,0,2,50,50
1650744387207,CSE 20,A01,083657,Staff,49,0,80,31
1650744393233,CSE 30,A01,083084,Eldon; John,0,77,40,40
1650744399257,CSE 100,A01,083659,Cao; Yingjun,0,70,50,50
1650744405280,CSE 134B,A01,083661,Powell; Thomas Allan,0,38,65,65
1650744411303,CSE 140,A01,083663,Staff,0,11,75,75
1650744417330,CSE 140L,A01,083088,Eldon; John,0,20,75,75
1650744423353,CSE 175,A01,083665,Kumar; Rakesh,7,0,25,18
1650744429377,CSE 190,A00,092507,Dubnov; Shlomo,10,0,20,10
1650744435403,ECE 45,A01,083139,Staff,1,2,60,59
1650744441426,ECE 65,A50,083695,Staff,0,5,30,30
1650744447452,ECE 109,A01,091882,Touri; Behrouz,33,0,70,37
1650744453475,ECE 180,A00,083140,Abi Samra; Nicholas Camill,20,0,30,10
1650744453475,ECE 180,B00,083141,Abi Samra; Nicholas Camill,0,0,30,30
1650744459500,MATH 10A,A01,083735,Patchell; Gregory David,2,0,30,28
1650744459500,MATH 10A,A02,083736,Patchell; Gregory David,27,0,30,3
1650744459500,MATH 10A,A03,083737,Patchell; Gregory David,24,0,30,6
1650744465524,MATH 10B,A01,083207,Staff,0,9,30,30
1650744465524,MATH 10B,A02,083208,Staff,1,7,30,29
1650744465524,MATH 10B,B01,083739,Staff,11,0,30,19
1650744465524,MATH 10B,B02,083740,Staff,28,0,30,2
1650744471548,MATH 18,A01,083743,Staff,0,0,30,30
1650744471548,MATH 18,A02,083744,Staff,23,0,30,7
1650744471548,MATH 18,A03,083745,Staff,21,0,30,9
1650744471548,MATH 18,A04,083746,Staff,26,0,30,4
1650744471548,MATH 18,B01,083748,Staff,0,15,30,30
1650744471548,MATH 18,B02,083749,Staff,0,12,30,30
1650744471548,MATH 18,B03,083750,Staff,0,12,30,30
1650744471548,MATH 18,B04,083751,Staff,0,12,30,30
1650744477572,MATH 20A,A01,083754,Staff,19,0,40,21
1650744483594,MATH 20B,A01,083756,Staff,0,12,30,30
1650744483594,MATH 20B,A02,083757,Staff,0,12,30,30
1650744489616,MATH 20C,A01,083760,Staff,0,16,30,30
1650744489616,MATH 20C,A02,083761,Staff,0,16,30,30
1650744489616,MATH 20C,B01,083762,Staff,10,0,30,20
1650744489616,MATH 20C,B02,083763,Staff,28,0,30,2
1650744495641,MATH 20D,A01,083765,Staff,2,1,30,28
1650744495641,MATH 20D,A02,083766,Staff,6,0,30,24
1650744495641,MATH 20D,A03,083767,Staff,24,0,30,6
1650744501669,MATH 20E,A01,083771,Staff,3,0,30,27
1650744501669,MATH 20E,A02,083772,Staff,16,0,30,14
1650744501669,MATH 20E,B01,083773,Staff,0,0,30,30
1650744501669,MATH 20E,B02,083774,Staff,6,0,30,24
1650744507692,MATH 103A,A01,083777,Staff,0,16,30,30
1650744507692,MATH 103A,A02,083778,Staff,0,15,30,30
1650744507692,MATH 103A,B01,083779,Staff,0,15,30,30
1650744507692,MATH 103A,B02,083780,Staff,0,15,30,30
1650744513717,MATH 105,A01,085443,Staff,0,22,30,30
1650744519741,MATH 109,A01,083213,Anzaldo; Leesa B,0,7,30,30
1650744519741,MATH 109,A02,083214,Anzaldo; Leesa B,0,7,30,30
1650744519741,MATH 109,B01,083215,Anzaldo; Leesa B,0,8,30,30
1650744519741,MATH 109,B02,083216,Anzaldo; Leesa B,0,6,30,30
1650744525762,MATH 142A,A01,083219,Chow; Bennett,0,16,30,30
1650744525762,MATH 142A,A02,083220,Chow; Bennett,0,15,30,30
1650744525762,MATH 142A,B01,083221,Chow; Bennett,0,15,30,30
1650744525762,MATH 142A,B02,083222,Chow; Bennett,0,14,30,30
1650744531789,MATH 193A,A01,083224,Staff,0,5,30,30
1650744531789,MATH 193A,A02,083225,Staff,0,6,30,30
1650744531789,MATH 193A,A03,083781,Staff,0,6,30,30
1650744531789,MATH 193A,A04,083782,Staff,0,7,30,30
1650744537811,MATH 197,001,091859,McAuley; Julian John,9998,0,9999,1
1650744543865,COGS 9,A01,083615,Staff,1,15,60,59
1650744549897,COGS 11,A01,083617,Boyle; Mary E. T.,16,0,40,24
1650744555921,COGS 13,A01,083071,Staff,0,38,40,40
1650744561952,COGS 14A,A01,092681,Staff,0,36,100,100
1650744567975,COGS 14B,A01,083073,Cheng; Tzu-Han,1,13,50,49
1650744573996,COGS 17,A01,092677,Staff,13,0,75,62
1650744580020,COGS 100,A01,083619,Staff,0,28,60,60
1650744586044,COGS 101A,A01,083621,Davis; Joshua Daniel,0,27,60,60
1650744592070,COGS 101B,A01,091572,Staff,0,4,60,60
1650744598094,COGS 101C,A01,083625,Delgado; Tania,14,0,30,16
1650744604120,COGS 107A,A01,083627,Boyle; Mary E. T.,0,16,60,60
1650744610143,COGS 118A,A01,083075,Staff,0,8,60,60
1650744616166,CSE 3,A50,083646,Miranda; Gregory Joseph,18,0,38,20
1650744616166,CSE 3,A51,083647,Miranda; Gregory Joseph,36,0,37,1
1650744622201,CSE 8A,A50,083650,Miranda; Gregory Joseph,0,30,40,40
1650744628226,CSE 11,A01,083080,Cao; Yingjun,0,96,40,40
1650744634250,CSE 12,A01,083652,Staff,0,21,100,100
1650744640273,CSE 15L,A01,083654,Staff,0,3,50,50
1650744640273,CSE 15L,A02,083655,Staff,0,2,50,50
1650744646298,CSE 20,A01,083657,Staff,49,0,80,31
1650744652321,CSE 30,A01,083084,Eldon; John,0,77,40,40
1650744658349,CSE 100,A01,083659,Cao; Yingjun,0,70,50,50
1650744664377,CSE 134B,A01,083661,Powell; Thomas Allan,0,38,65,65
1650744670401,CSE 140,A01,083663,Staff,0,11,75,75
1650744676428,CSE 140L,A01,083088,Eldon; John,0,20,75,75
1650744682451,CSE 175,A01,083665,Kumar; Rakesh,7,0,25,18
1650744688477,CSE 190,A00,092507,Dubnov; Shlomo,10,0,20,10
1650744694501,ECE 45,A01,083139,Staff,1,2,60,59
1650744700525,ECE 65,A50,083695,Staff,0,5,30,30
1650744706547,ECE 109,A01,091882,Touri; Behrouz,33,0,70,37
1650744712574,ECE 180,A00,083140,Abi Samra; Nicholas Camill,20,0,30,10
1650744712574,ECE 180,B00,083141,Abi Samra; Nicholas Camill,0,0,30,30
1650744718602,MATH 10A,A01,083735,Patchell; Gregory David,2,0,30,28
1650744718602,MATH 10A,A02,083736,Patchell; Gregory David,27,0,30,3
1650744718602,MATH 10A,A03,083737,Patchell; Gregory David,24,0,30,6
1650744731818,MATH 10B,A01,083207,Staff,0,9,30,30
1650744731818,MATH 10B,A02,083208,Staff,1,7,30,29
1650744731818,MATH 10B,B01,083739,Staff,11,0,30,19
1650744731818,MATH 10B,B02,083740,Staff,28,0,30,2
1650744737845,MATH 18,A01,083743,Staff,0,0,30,30
1650744737845,MATH 18,A02,083744,Staff,23,0,30,7
1650744737845,MATH 18,A03,083745,Staff,21,0,30,9
1650744737845,MATH 18,A04,083746,Staff,26,0,30,4
1650744737845,MATH 18,B01,083748,Staff,0,15,30,30
1650744737845,MATH 18,B02,083749,Staff,0,12,30,30
1650744737845,MATH 18,B03,083750,Staff,0,12,30,30
1650744737845,MATH 18,B04,083751,Staff,0,12,30,30
1650744743868,MATH 20A,A01,083754,Staff,19,0,40,21
1650744749894,MATH 20B,A01,083756,Staff,0,12,30,30
1650744749894,MATH 20B,A02,083757,Staff,0,12,30,30
1650744755919,MATH 20C,A01,083760,Staff,0,16,30,30
1650744755919,MATH 20C,A02,083761,Staff,0,16,30,30
1650744755919,MATH 20C,B01,083762,Staff,10,0,30,20
1650744755919,MATH 20C,B02,083763,Staff,28,0,30,2
1650744761947,MATH 20D,A01,083765,Staff,2,1,30,28
1650744761947,MATH 20D,A02,083766,Staff,6,0,30,24
1650744761947,MATH 20D,A03,083767,Staff,24,0,30,6
1650744767972,MATH 20E,A01,083771,Staff,3,0,30,27
1650744767972,MATH 20E,A02,083772,Staff,16,0,30,14
1650744767972,MATH 20E,B01,083773,Staff,0,0,30,30
1650744767972,MATH 20E,B02,083774,Staff,6,0,30,24
1650744773998,MATH 103A,A01,083777,Staff,0,16,30,30
1650744773998,MATH 103A,A02,083778,Staff,0,15,30,30
1650744773998,MATH 103A,B01,083779,Staff,0,15,30,30
1650744773998,MATH 103A,B02,083780,Staff,0,15,30,30
1650744780113,MATH 105,A01,085443,Staff,0,22,30,30
1650744786138,MATH 109,A01,083213,Anzaldo; Leesa B,0,7,30,30
1650744786138,MATH 109,A02,083214,Anzaldo; Leesa B,0,7,30,30
1650744786138,MATH 109,B01,083215,Anzaldo; Leesa B,0,8,30,30
1650744786138,MATH 109,B02,083216,Anzaldo; Leesa B,0,6,30,30
1650744792161,MATH 142A,A01,083219,Chow; Bennett,0,16,30,30
1650744792161,MATH 142A,A02,083220,Chow; Bennett,0,15,30,30
1650744792161,MATH 142A,B01,083221,Chow; Bennett,0,15,30,30
1650744792161,MATH 142A,B02,083222,Chow; Bennett,0,14,30,30
1650744798188,MATH 193A,A01,083224,Staff,0,5,30,30
1650744798188,MATH 193A,A02,083225,Staff,0,6,30,30
1650744798188,MATH 193A,A03,083781,Staff,0,6,30,30
1650744798188,MATH 193A,A04,083782,Staff,0,7,30,30
1650744804214,MATH 197,001,091859,McAuley; Julian John,9998,0,9999,1
1650744810265,COGS 9,A01,083615,Staff,1,15,60,59
1650744816297,COGS 11,A01,083617,Boyle; Mary E. T.,16,0,40,24
1650744822320,COGS 13,A01,083071,Staff,0,38,40,40
1650744828344,COGS 14A,A01,092681,Staff,0,36,100,100
1650744834368,COGS 14B,A01,083073,Cheng; Tzu-Han,1,13,50,49
1650744840390,COGS 17,A01,092677,Staff,12,0,75,63
1650744846415,COGS 100,A01,083619,Staff,0,28,60,60
1650744852444,COGS 101A,A01,083621,Davis; Joshua Daniel,0,27,60,60
1650744858473,COGS 101B,A01,091572,Staff,0,4,60,60
1650744864498,COGS 101C,A01,083625,Delgado; Tania,14,0,30,16
1650744870520,COGS 107A,A01,083627,Boyle; Mary E. T.,0,16,60,60
1650744876559,COGS 118A,A01,083075,Staff,0,8,60,60
1650744882586,CSE 3,A50,083646,Miranda; Gregory Joseph,18,0,38,20
1650744882586,CSE 3,A51,083647,Miranda; Gregory Joseph,36,0,37,1
1650744888620,CSE 8A,A50,083650,Miranda; Gregory Joseph,0,30,40,40
1650744894647,CSE 11,A01,083080,Cao; Yingjun,0,96,40,40
1650744900670,CSE 12,A01,083652,Staff,0,21,100,100
1650744906697,CSE 15L,A01,083654,Staff,0,3,50,50
1650744906697,CSE 15L,A02,083655,Staff,0,2,50,50
1650744912722,CSE 20,A01,083657,Staff,49,0,80,31
1650744918750,CSE 30,A01,083084,Eldon; John,0,77,40,40
1650744924775,CSE 100,A01,083659,Cao; Yingjun,0,71,50,50
1650744930802,CSE 134B,A01,083661,Powell; Thomas Allan,0,38,65,65
1650744936829,CSE 140,A01,083663,Staff,0,11,75,75
1650744942854,CSE 140L,A01,083088,Eldon; John,0,20,75,75
1650744948882,CSE 175,A01,083665,Kumar; Rakesh,7,0,25,18
1650744954905,CSE 190,A00,092507,Dubnov; Shlomo,10,0,20,10
1650744960928,ECE 45,A01,083139,Staff,1,2,60,59
1650744966955,ECE 65,A50,083695,Staff,0,5,30,30
1650744972977,ECE 109,A01,091882,Touri; Behrouz,33,0,70,37
1650744979000,ECE 180,A00,083140,Abi Samra; Nicholas Camill,20,0,30,10
1650744979000,ECE 180,B00,083141,Abi Samra; Nicholas Camill,0,0,30,30
1650744985023,MATH 10A,A01,083735,Patchell; Gregory David,2,0,30,28
1650744985023,MATH 10A,A02,083736,Patchell; Gregory David,27,0,30,3
1650744985023,MATH 10A,A03,083737,Patchell; Gregory David,24,0,30,6
1650744991053,MATH 10B,A01,083207,Staff,0,9,30,30
1650744991053,MATH 10B,A02,083208,Staff,1,7,30,29
1650744991053,MATH 10B,B01,083739,Staff,11,0,30,19
1650744991053,MATH 10B,B02,083740,Staff,28,0,30,2
1650744997078,MATH 18,A01,083743,Staff,0,0,30,30
1650744997078,MATH 18,A02,083744,Staff,23,0,30,7
1650744997078,MATH 18,A03,083745,Staff,21,0,30,9
1650744997078,MATH 18,A04,083746,Staff,26,0,30,4
1650744997078,MATH 18,B01,083748,Staff,0,15,30,30
1650744997078,MATH 18,B02,083749,Staff,0,12,30,30
1650744997078,MATH 18,B03,083750,Staff,0,12,30,30
1650744997078,MATH 18,B04,083751,Staff,0,12,30,30
1650745003119,MATH 20A,A01,083754,Staff,19,0,40,21
1650745009142,MATH 20B,A01,083756,Staff,0,12,30,30
1650745009142,MATH 20B,A02,083757,Staff,0,12,30,30
1650745015166,MATH 20C,A01,083760,Staff,0,16,30,30
1650745015166,MATH 20C,A02,083761,Staff,0,16,30,30
1650745015166,MATH 20C,B01,083762,Staff,10,0,30,20
1650745015166,MATH 20C,B02,083763,Staff,28,0,30,2
1650745021191,MATH 20D,A01,083765,Staff,2,1,30,28
1650745021191,MATH 20D,A02,083766,Staff,6,0,30,24
1650745021191,MATH 20D,A03,083767,Staff,24,0,30,6
1650745027215,MATH 20E,A01,083771,Staff,3,0,30,27
1650745027215,MATH 20E,A02,083772,Staff,16,0,30,14
1650745027215,MATH 20E,B01,083773,Staff,0,0,30,30
1650745027215,MATH 20E,B02,083774,Staff,6,0,30,24
1650745033239,MATH 103A,A01,083777,Staff,0,16,30,30
1650745033239,MATH 103A,A02,083778,Staff,0,15,30,30
1650745033239,MATH 103A,B01,083779,Staff,0,15,30,30
1650745033239,MATH 103A,B02,083780,Staff,0,15,30,30
1650745039265,MATH 105,A01,085443,Staff,0,22,30,30
1650745045291,MATH 109,A01,083213,Anzaldo; Leesa B,0,7,30,30
1650745045291,MATH 109,A02,083214,Anzaldo; Leesa B,0,7,30,30
1650745045291,MATH 109,B01,083215,Anzaldo; Leesa B,0,8,30,30
1650745045291,MATH 109,B02,083216,Anzaldo; Leesa B,0,6,30,30
1650745051314,MATH 142A,A01,083219,Chow; Bennett,0,16,30,30
1650745051314,MATH 142A,A02,083220,Chow; Bennett,0,15,30,30
1650745051314,MATH 142A,B01,083221,Chow; Bennett,0,15,30,30
1650745051314,MATH 142A,B02,083222,Chow; Bennett,0,14,30,30
1650745057339,MATH 193A,A01,083224,Staff,0,5,30,30
1650745057339,MATH 193A,A02,083225,Staff,0,6,30,30
1650745057339,MATH 193A,A03,083781,Staff,0,6,30,30
1650745057339,MATH 193A,A04,083782,Staff,0,7,30,30
1650745063364,MATH 197,001,091859,McAuley; Julian John,9998,0,9999,1
1650745069423,COGS 9,A01,083615,Staff,1,15,60,59
1650745075447,COGS 11,A01,083617,Boyle; Mary E. T.,16,0,40,24
1650745081479,COGS 13,A01,083071,Staff,0,38,40,40
1650745087504,COGS 14A,A01,092681,Staff,0,36,100,100
1650745093529,COGS 14B,A01,083073,Cheng; Tzu-Han,1,13,50,49
1650745099556,COGS 17,A01,092677,Staff,12,0,75,63
1650745105578,COGS 100,A01,083619,Staff,0,28,60,60
1650745111601,COGS 101A,A01,083621,Davis; Joshua Daniel,0,27,60,60
1650745117625,COGS 101B,A01,091572,Staff,0,4,60,60
1650745123648,COGS 101C,A01,083625,Delgado; Tania,14,0,30,16
1650745129671,COGS 107A,A01,083627,Boyle; Mary E. T.,0,16,60,60
1650745135698,COGS 118A,A01,083075,Staff,0,8,60,60
1650745141748,CSE 3,A50,083646,Miranda; Gregory Joseph,18,0,38,20
1650745141748,CSE 3,A51,083647,Miranda; Gregory Joseph,36,0,37,1
1650745147777,CSE 8A,A50,083650,Miranda; Gregory Joseph,0,30,40,40
1650745153800,CSE 11,A01,083080,Cao; Yingjun,0,96,40,40
1650745159832,CSE 12,A01,083652,Staff,0,21,100,100
1650745165858,CSE 15L,A01,083654,Staff,0,3,50,50
1650745165858,CSE 15L,A02,083655,Staff,0,2,50,50
1650745171886,CSE 20,A01,083657,Staff,49,0,80,31
1650745177912,CSE 30,A01,083084,Eldon; John,0,77,40,40
1650745183939,CSE 100,A01,083659,Cao; Yingjun,0,71,50,50
1650745189962,CSE 134B,A01,083661,Powell; Thomas Allan,0,38,65,65
1650745195987,CSE 140,A01,083663,Staff,0,11,75,75
1650745202012,CSE 140L,A01,083088,Eldon; John,0,20,75,75
1650745208038,CSE 175,A01,083665,Kumar; Rakesh,7,0,25,18
1650745214063,CSE 190,A00,092507,Dubnov; Shlomo,10,0,20,10
1650745220090,ECE 45,A01,083139,Staff,1,2,60,59
1650745226114,ECE 65,A50,083695,Staff,0,5,30,30
1650745232137,ECE 109,A01,091882,Touri; Behrouz,33,0,70,37
1650745238161,ECE 180,A00,083140,Abi Samra; Nicholas Camill,20,0,30,10
1650745238161,ECE 180,B00,083141,Abi Samra; Nicholas Camill,0,0,30,30
1650745244188,MATH 10A,A01,083735,Patchell; Gregory David,2,0,30,28
1650745244188,MATH 10A,A02,083736,Patchell; Gregory David,27,0,30,3
1650745244188,MATH 10A,A03,083737,Patchell; Gregory David,24,0,30,6
1650745250210,MATH 10B,A01,083207,Staff,0,9,30,30
1650745250210,MATH 10B,A02,083208,Staff,1,7,30,29
1650745250210,MATH 10B,B01,083739,Staff,11,0,30,19
1650745250210,MATH 10B,B02,083740,Staff,28,0,30,2
1650745256235,MATH 18,A01,083743,Staff,0,0,30,30
1650745256235,MATH 18,A02,083744,Staff,23,0,30,7
1650745256235,MATH 18,A03,083745,Staff,21,0,30,9
1650745256235,MATH 18,A04,083746,Staff,26,0,30,4
1650745256235,MATH 18,B01,083748,Staff,0,15,30,30
1650745256235,MATH 18,B02,083749,Staff,0,12,30,30
1650745256235,MATH 18,B03,083750,Staff,0,12,30,30
1650745256235,MATH 18,B04,083751,Staff,0,12,30,30
1650745262262,MATH 20A,A01,083754,Staff,19,0,40,21
1650745268293,MATH 20B,A01,083756,Staff,0,12,30,30
1650745268293,MATH 20B,A02,083757,Staff,0,12,30,30
1650745274318,MATH 20C,A01,083760,Staff,0,16,30,30
1650745274318,MATH 20C,A02,083761,Staff,0,16,30,30
1650745274318,MATH 20C,B01,083762,Staff,10,0,30,20
1650745274318,MATH 20C,B02,083763,Staff,28,0,30,2
1650745280342,MATH 20D,A01,083765,Staff,2,1,30,28
1650745280342,MATH 20D,A02,083766,Staff,6,0,30,24
1650745280342,MATH 20D,A03,083767,Staff,24,0,30,6
1650745286371,MATH 20E,A01,083771,Staff,3,0,30,27
1650745286371,MATH 20E,A02,083772,Staff,16,0,30,14
1650745286371,MATH 20E,B01,083773,Staff,0,0,30,30
1650745286371,MATH 20E,B02,083774,Staff,6,0,30,24
1650745292398,MATH 103A,A01,083777,Staff,0,16,30,30
1650745292398,MATH 103A,A02,083778,Staff,0,15,30,30
1650745292398,MATH 103A,B01,083779,Staff,0,15,30,30
1650745292398,MATH 103A,B02,083780,Staff,0,15,30,30
1650745298422,MATH 105,A01,085443,Staff,0,22,30,30
1650745304456,MATH 109,A01,083213,Anzaldo; Leesa B,0,7,30,30
1650745304456,MATH 109,A02,083214,Anzaldo; Leesa B,0,7,30,30
1650745304456,MATH 109,B01,083215,Anzaldo; Leesa B,0,8,30,30
1650745304456,MATH 109,B02,083216,Anzaldo; Leesa B,0,6,30,30
1650745310480,MATH 142A,A01,083219,Chow; Bennett,0,16,30,30
1650745310480,MATH 142A,A02,083220,Chow; Bennett,0,15,30,30
1650745310480,MATH 142A,B01,083221,Chow; Bennett,0,15,30,30
1650745310480,MATH 142A,B02,083222,Chow; Bennett,0,14,30,30
1650745316505,MATH 193A,A01,083224,Staff,0,5,30,30
1650745316505,MATH 193A,A02,083225,Staff,0,6,30,30
1650745316505,MATH 193A,A03,083781,Staff,0,6,30,30
1650745316505,MATH 193A,A04,083782,Staff,0,7,30,30
1650745322536,MATH 197,001,091859,McAuley; Julian John,9998,0,9999,1
1650745328594,COGS 9,A01,083615,Staff,1,15,60,59
1650745334620,COGS 11,A01,083617,Boyle; Mary E. T.,16,0,40,24
1650745340645,COGS 13,A01,083071,Staff,0,38,40,40
1650745346672,COGS 14A,A01,092681,Staff,0,36,100,100
1650745352696,COGS 14B,A01,083073,Cheng; Tzu-Han,1,13,50,49
1650745358721,COGS 17,A01,092677,Staff,12,0,75,63
1650745364745,COGS 100,A01,083619,Staff,0,28,60,60
1650745370861,COGS 101A,A01,083621,Davis; Joshua Daniel,0,27,60,60
1650745376887,COGS 101B,A01,091572,Staff,1,4,60,59
1650745382911,COGS 101C,A01,083625,Delgado; Tania,14,0,30,16
1650745388934,COGS 107A,A01,083627,Boyle; Mary E. T.,0,16,60,60
1650745394958,COGS 118A,A01,083075,Staff,0,8,60,60
1650745400981,CSE 3,A50,083646,Miranda; Gregory Joseph,18,0,38,20
1650745400981,CSE 3,A51,083647,Miranda; Gregory Joseph,36,0,37,1
1650745407005,CSE 8A,A50,083650,Miranda; Gregory Joseph,0,30,40,40
1650745413029,CSE 11,A01,083080,Cao; Yingjun,0,96,40,40
1650745419053,CSE 12,A01,083652,Staff,0,21,100,100
1650745425076,CSE 15L,A01,083654,Staff,0,3,50,50
1650745425076,CSE 15L,A02,083655,Staff,0,2,50,50
1650745431100,CSE 20,A01,083657,Staff,49,0,80,31
1650745437126,CSE 30,A01,083084,Eldon; John,0,77,40,40
1650745443150,CSE 100,A01,083659,Cao; Yingjun,0,71,50,50
1650745449177,CSE 134B,A01,083661,Powell; Thomas Allan,0,38,65,65
1650745455199,CSE 140,A01,083663,Staff,0,11,75,75
1650745461228,CSE 140L,A01,083088,Eldon; John,0,20,75,75
1650745467250,CSE 175,A01,083665,Kumar; Rakesh,7,0,25,18
1650745473279,CSE 190,A00,092507,Dubnov; Shlomo,10,0,20,10
1650745479303,ECE 45,A01,083139,Staff,1,2,60,59
1650745485327,ECE 65,A50,083695,Staff,0,5,30,30
1650745491349,ECE 109,A01,091882,Touri; Behrouz,33,0,70,37
1650745497373,ECE 180,A00,083140,Abi Samra; Nicholas Camill,20,0,30,10
1650745497373,ECE 180,B00,083141,Abi Samra; Nicholas Camill,0,0,30,30
1650745503402,MATH 10A,A01,083735,Patchell; Gregory David,2,0,30,28
1650745503402,MATH 10A,A02,083736,Patchell; Gregory David,27,0,30,3
1650745503402,MATH 10A,A03,083737,Patchell; Gregory David,24,0,30,6
1650745509430,MATH 10B,A01,083207,Staff,0,9,30,30
1650745509430,MATH 10B,A02,083208,Staff,1,7,30,29
1650745509430,MATH 10B,B01,083739,Staff,11,0,30,19
1650745509430,MATH 10B,B02,083740,Staff,28,0,30,2
1650745515457,MATH 18,A01,083743,Staff,0,0,30,30
1650745515457,MATH 18,A02,083744,Staff,23,0,30,7
1650745515457,MATH 18,A03,083745,Staff,21,0,30,9
1650745515457,MATH 18,A04,083746,Staff,26,0,30,4
1650745515457,MATH 18,B01,083748,Staff,0,15,30,30
1650745515457,MATH 18,B02,083749,Staff,0,12,30,30
1650745515457,MATH 18,B03,083750,Staff,0,12,30,30
1650745515457,MATH 18,B04,083751,Staff,0,12,30,30
1650745521482,MATH 20A,A01,083754,Staff,19,0,40,21
1650745527504,MATH 20B,A01,083756,Staff,0,12,30,30
1650745527504,MATH 20B,A02,083757,Staff,0,12,30,30
1650745533530,MATH 20C,A01,083760,Staff,0,16,30,30
1650745533530,MATH 20C,A02,083761,Staff,0,16,30,30
1650745533530,MATH 20C,B01,083762,Staff,10,0,30,20
1650745533530,MATH 20C,B02,083763,Staff,28,0,30,2
1650745539561,MATH 20D,A01,083765,Staff,2,1,30,28
1650745539561,MATH 20D,A02,083766,Staff,6,0,30,24
1650745539561,MATH 20D,A03,083767,Staff,24,0,30,6
1650745545586,MATH 20E,A01,083771,Staff,3,0,30,27
1650745545586,MATH 20E,A02,083772,Staff,16,0,30,14
1650745545586,MATH 20E,B01,083773,Staff,0,0,30,30
1650745545586,MATH 20E,B02,083774,Staff,6,0,30,24
1650745551615,MATH 103A,A01,083777,Staff,0,16,30,30
1650745551615,MATH 103A,A02,083778,Staff,0,15,30,30
1650745551615,MATH 103A,B01,083779,Staff,0,15,30,30
1650745551615,MATH 103A,B02,083780,Staff,0,15,30,30
1650745557642,MATH 105,A01,085443,Staff,0,22,30,30
1650745563667,MATH 109,A01,083213,Anzaldo; Leesa B,0,7,30,30
1650745563667,MATH 109,A02,083214,Anzaldo; Leesa B,0,7,30,30
1650745563667,MATH 109,B01,083215,Anzaldo; Leesa B,0,8,30,30
1650745563667,MATH 109,B02,083216,Anzaldo; Leesa B,0,6,30,30
1650745569690,MATH 142A,A01,083219,Chow; Bennett,0,16,30,30
1650745569690,MATH 142A,A02,083220,Chow; Bennett,0,15,30,30
1650745569690,MATH 142A,B01,083221,Chow; Bennett,0,15,30,30
1650745569690,MATH 142A,B02,083222,Chow; Bennett,0,14,30,30
1650745575715,MATH 193A,A01,083224,Staff,0,5,30,30
1650745575715,MATH 193A,A02,083225,Staff,0,6,30,30
1650745575715,MATH 193A,A03,083781,Staff,0,6,30,30
1650745575715,MATH 193A,A04,083782,Staff,0,7,30,30
1650745581738,MATH 197,001,091859,McAuley; Julian John,9998,0,9999,1
1650745587798,COGS 9,A01,083615,Staff,1,15,60,59
1650745593823,COGS 11,A01,083617,Boyle; Mary E. T.,16,0,40,24
1650745599859,COGS 13,A01,083071,Staff,0,38,40,40
1650745605884,COGS 14A,A01,092681,Staff,0,36,100,100
1650745611910,COGS 14B,A01,083073,Cheng; Tzu-Han,1,13,50,49
1650745617942,COGS 17,A01,092677,Staff,12,0,75,63
1650745623965,COGS 100,A01,083619,Staff,0,28,60,60
1650745629989,COGS 101A,A01,083621,Davis; Joshua Daniel,0,27,60,60
1650745636014,COGS 101B,A01,091572,Staff,1,4,60,59
1650745642040,COGS 101C,A01,083625,Delgado; Tania,14,0,30,16
1650745648063,COGS 107A,A01,083627,Boyle; Mary E. T.,0,16,60,60
1650745654090,COGS 118A,A01,083075,Staff,0,8,60,60
1650745660112,CSE 3,A50,083646,Miranda; Gregory Joseph,18,0,38,20
1650745660112,CSE 3,A51,083647,Miranda; Gregory Joseph,36,0,37,1
1650745666144,CSE 8A,A50,083650,Miranda; Gregory Joseph,0,30,40,40
1650745672179,CSE 11,A01,083080,Cao; Yingjun,0,96,40,40
1650745678232,CSE 12,A01,083652,Staff,0,21,100,100
1650745684260,CSE 15L,A01,083654,Staff,0,3,50,50
1650745684260,CSE 15L,A02,083655,Staff,0,2,50,50
1650745690285,CSE 20,A01,083657,Staff,49,0,80,31
1650745696308,CSE 30,A01,083084,Eldon; John,0,77,40,40
1650745702331,CSE 100,A01,083659,Cao; Yingjun,0,71,50,50
1650745708355,CSE 134B,A01,083661,Powell; Thomas Allan,0,38,65,65
1650745714379,CSE 140,A01,083663,Staff,0,11,75,75
1650745720402,CSE 140L,A01,083088,Eldon; John,0,20,75,75
1650745726438,CSE 175,A01,083665,Kumar; Rakesh,7,0,25,18
1650745732465,CSE 190,A00,092507,Dubnov; Shlomo,10,0,20,10
1650745738493,ECE 45,A01,083139,Staff,1,2,60,59
1650745744519,ECE 65,A50,083695,Staff,0,5,30,30
1650745750542,ECE 109,A01,091882,Touri; Behrouz,33,0,70,37
1650745756571,ECE 180,A00,083140,Abi Samra; Nicholas Camill,20,0,30,10
1650745756571,ECE 180,B00,083141,Abi Samra; Nicholas Camill,0,0,30,30
1650745762598,MATH 10A,A01,083735,Patchell; Gregory David,2,0,30,28
1650745762598,MATH 10A,A02,083736,Patchell; Gregory David,27,0,30,3
1650745762598,MATH 10A,A03,083737,Patchell; Gregory David,24,0,30,6
1650745768622,MATH 10B,A01,083207,Staff,0,9,30,30
1650745768622,MATH 10B,A02,083208,Staff,1,7,30,29
1650745768622,MATH 10B,B01,083739,Staff,11,0,30,19
1650745768622,MATH 10B,B02,083740,Staff,28,0,30,2
1650745774655,MATH 18,A01,083743,Staff,0,0,30,30
1650745774655,MATH 18,A02,083744,Staff,23,0,30,7
1650745774655,MATH 18,A03,083745,Staff,21,0,30,9
1650745774655,MATH 18,A04,083746,Staff,26,0,30,4
1650745774655,MATH 18,B01,083748,Staff,0,15,30,30
1650745774655,MATH 18,B02,083749,Staff,0,12,30,30
1650745774655,MATH 18,B03,083750,Staff,0,12,30,30
1650745774655,MATH 18,B04,083751,Staff,0,12,30,30
1650745780677,MATH 20A,A01,083754,Staff,19,0,40,21
1650745786705,MATH 20B,A01,083756,Staff,0,12,30,30
1650745786705,MATH 20B,A02,083757,Staff,0,12,30,30
1650745792729,MATH 20C,A01,083760,Staff,0,16,30,30
1650745792729,MATH 20C,A02,083761,Staff,0,16,30,30
1650745792729,MATH 20C,B01,083762,Staff,10,0,30,20
1650745792729,MATH 20C,B02,083763,Staff,28,0,30,2
1650745798753,MATH 20D,A01,083765,Staff,2,1,30,28
1650745798753,MATH 20D,A02,083766,Staff,6,0,30,24
1650745798753,MATH 20D,A03,083767,Staff,24,0,30,6
1650745804781,MATH 20E,A01,083771,Staff,3,0,30,27
1650745804781,MATH 20E,A02,083772,Staff,16,0,30,14
1650745804781,MATH 20E,B01,083773,Staff,0,0,30,30
1650745804781,MATH 20E,B02,083774,Staff,6,0,30,24
1650745810808,MATH 103A,A01,083777,Staff,0,16,30,30
1650745810808,MATH 103A,A02,083778,Staff,0,15,30,30
1650745810808,MATH 103A,B01,083779,Staff,0,15,30,30
1650745810808,MATH 103A,B02,083780,Staff,0,15,30,30
1650745816829,MATH 105,A01,085443,Staff,0,22,30,30
1650745822857,MATH 109,A01,083213,Anzaldo; Leesa B,0,7,30,30
1650745822857,MATH 109,A02,083214,Anzaldo; Leesa B,0,7,30,30
1650745822857,MATH 109,B01,083215,Anzaldo; Leesa B,0,8,30,30
1650745822857,MATH 109,B02,083216,Anzaldo; Leesa B,0,6,30,30
1650745828883,MATH 142A,A01,083219,Chow; Bennett,0,16,30,30
1650745828883,MATH 142A,A02,083220,Chow; Bennett,0,15,30,30
1650745828883,MATH 142A,B01,083221,Chow; Bennett,0,15,30,30
1650745828883,MATH 142A,B02,083222,Chow; Bennett,0,14,30,30
1650745834908,MATH 193A,A01,083224,Staff,0,5,30,30
1650745834908,MATH 193A,A02,083225,Staff,0,6,30,30
1650745834908,MATH 193A,A03,083781,Staff,0,6,30,30
1650745834908,MATH 193A,A04,083782,Staff,0,7,30,30
1650745840931,MATH 197,001,091859,McAuley; Julian John,9998,0,9999,1
1650745846988,COGS 9,A01,083615,Staff,1,15,60,59
1650745853013,COGS 11,A01,083617,Boyle; Mary E. T.,16,0,40,24
1650745859040,COGS 13,A01,083071,Staff,0,38,40,40
1650745865062,COGS 14A,A01,092681,Staff,0,36,100,100
1650745871088,COGS 14B,A01,083073,Cheng; Tzu-Han,1,13,50,49
1650745877111,COGS 17,A01,092677,Staff,12,0,75,63
1650745883136,COGS 100,A01,083619,Staff,0,28,60,60
1650745889162,COGS 101A,A01,083621,Davis; Joshua Daniel,0,27,60,60
1650745895184,COGS 101B,A01,091572,Staff,1,4,60,59
1650745901208,COGS 101C,A01,083625,Delgado; Tania,14,0,30,16
1650745907229,COGS 107A,A01,083627,Boyle; Mary E. T.,0,16,60,60
1650745913254,COGS 118A,A01,083075,Staff,0,8,60,60
1650745919281,CSE 3,A50,083646,Miranda; Gregory Joseph,18,0,38,20
1650745919281,CSE 3,A51,083647,Miranda; Gregory Joseph,36,0,37,1
1650745925306,CSE 8A,A50,083650,Miranda; Gregory Joseph,0,30,40,40
1650745931333,CSE 11,A01,083080,Cao; Yingjun,0,96,40,40
1650745937357,CSE 12,A01,083652,Staff,0,21,100,100
1650745943380,CSE 15L,A01,083654,Staff,0,3,50,50
1650745943380,CSE 15L,A02,083655,Staff,0,2,50,50
1650745949410,CSE 20,A01,083657,Staff,49,0,80,31
1650745955436,CSE 30,A01,083084,Eldon; John,0,77,40,40
1650745961459,CSE 100,A01,083659,Cao; Yingjun,0,71,50,50
1650745967575,CSE 134B,A01,083661,Powell; Thomas Allan,0,38,65,65
1650745973599,CSE 140,A01,083663,Staff,0,11,75,75
1650745979623,CSE 140L,A01,083088,Eldon; John,0,20,75,75
1650745985644,CSE 175,A01,083665,Kumar; Rakesh,7,0,25,18
1650745991680,CSE 190,A00,092507,Dubnov; Shlomo,10,0,20,10
1650745997711,ECE 45,A01,083139,Staff,1,2,60,59
1650746003734,ECE 65,A50,083695,Staff,0,5,30,30
1650746009759,ECE 109,A01,091882,Touri; Behrouz,33,0,70,37
1650746015783,ECE 180,A00,083140,Abi Samra; Nicholas Camill,20,0,30,10
1650746015783,ECE 180,B00,083141,Abi Samra; Nicholas Camill,0,0,30,30
1650746021807,MATH 10A,A01,083735,Patchell; Gregory David,2,0,30,28
1650746021807,MATH 10A,A02,083736,Patchell; Gregory David,27,0,30,3
1650746021807,MATH 10A,A03,083737,Patchell; Gregory David,24,0,30,6
1650746027833,MATH 10B,A01,083207,Staff,0,9,30,30
1650746027833,MATH 10B,A02,083208,Staff,1,7,30,29
1650746027833,MATH 10B,B01,083739,Staff,11,0,30,19
1650746027833,MATH 10B,B02,083740,Staff,28,0,30,2
1650746033857,MATH 18,A01,083743,Staff,0,0,30,30
1650746033857,MATH 18,A02,083744,Staff,23,0,30,7
1650746033857,MATH 18,A03,083745,Staff,21,0,30,9
1650746033857,MATH 18,A04,083746,Staff,26,0,30,4
1650746033857,MATH 18,B01,083748,Staff,0,15,30,30
1650746033857,MATH 18,B02,083749,Staff,0,12,30,30
1650746033857,MATH 18,B03,083750,Staff,0,12,30,30
1650746033857,MATH 18,B04,083751,Staff,0,12,30,30
1650746039881,MATH 20A,A01,083754,Staff,19,0,40,21
1650746045910,MATH 20B,A01,083756,Staff,0,12,30,30
1650746045910,MATH 20B,A02,083757,Staff,0,12,30,30
1650746051938,MATH 20C,A01,083760,Staff,0,16,30,30
1650746051938,MATH 20C,A02,083761,Staff,0,16,30,30
1650746051938,MATH 20C,B01,083762,Staff,10,0,30,20
1650746051938,MATH 20C,B02,083763,Staff,28,0,30,2
1650746057961,MATH 20D,A01,083765,Staff,2,1,30,28
1650746057961,MATH 20D,A02,083766,Staff,6,0,30,24
1650746057961,MATH 20D,A03,083767,Staff,24,0,30,6
1650746063996,MATH 20E,A01,083771,Staff,3,0,30,27
1650746063996,MATH 20E,A02,083772,Staff,16,0,30,14
1650746063996,MATH 20E,B01,083773,Staff,0,0,30,30
1650746063996,MATH 20E,B02,083774,Staff,6,0,30,24
1650746070028,MATH 103A,A01,083777,Staff,0,16,30,30
1650746070028,MATH 103A,A02,083778,Staff,0,15,30,30
1650746070028,MATH 103A,B01,083779,Staff,0,15,30,30
1650746070028,MATH 103A,B02,083780,Staff,0,15,30,30
1650746076052,MATH 105,A01,085443,Staff,0,22,30,30
1650746082080,MATH 109,A01,083213,Anzaldo; Leesa B,0,7,30,30
1650746082080,MATH 109,A02,083214,Anzaldo; Leesa B,0,7,30,30
1650746082080,MATH 109,B01,083215,Anzaldo; Leesa B,0,8,30,30
1650746082080,MATH 109,B02,083216,Anzaldo; Leesa B,0,6,30,30
1650746088103,MATH 142A,A01,083219,Chow; Bennett,0,16,30,30
1650746088103,MATH 142A,A02,083220,Chow; Bennett,0,15,30,30
1650746088103,MATH 142A,B01,083221,Chow; Bennett,0,15,30,30
1650746088103,MATH 142A,B02,083222,Chow; Bennett,0,14,30,30
1650746094127,MATH 193A,A01,083224,Staff,0,5,30,30
1650746094127,MATH 193A,A02,083225,Staff,0,6,30,30
1650746094127,MATH 193A,A03,083781,Staff,0,6,30,30
1650746094127,MATH 193A,A04,083782,Staff,0,7,30,30
1650746100150,MATH 197,001,091859,McAuley; Julian John,9998,0,9999,1
1650746106215,COGS 9,A01,083615,Staff,1,15,60,59
1650746112243,COGS 11,A01,083617,Boyle; Mary E. T.,16,0,40,24
1650746118274,COGS 13,A01,083071,Staff,0,38,40,40
1650746124301,COGS 14A,A01,092681,Staff,0,36,100,100
1650746130324,COGS 14B,A01,083073,Cheng; Tzu-Han,1,13,50,49
1650746136355,COGS 17,A01,092677,Staff,12,0,75,63
1650746142378,COGS 100,A01,083619,Staff,0,28,60,60
1650746148405,COGS 101A,A01,083621,Davis; Joshua Daniel,0,27,60,60
1650746154430,COGS 101B,A01,091572,Staff,1,4,60,59
1650746160454,COGS 101C,A01,083625,Delgado; Tania,14,0,30,16
1650746166481,COGS 107A,A01,083627,Boyle; Mary E. T.,0,16,60,60
1650746172506,COGS 118A,A01,083075,Staff,0,8,60,60
1650746178531,CSE 3,A50,083646,Miranda; Gregory Joseph,18,0,38,20
1650746178531,CSE 3,A51,083647,Miranda; Gregory Joseph,36,0,37,1
1650746184559,CSE 8A,A50,083650,Miranda; Gregory Joseph,0,30,40,40
1650746190590,CSE 11,A01,083080,Cao; Yingjun,0,96,40,40
1650746196614,CSE 12,A01,083652,Staff,0,21,100,100
1650746202636,CSE 15L,A01,083654,Staff,0,3,50,50
1650746202636,CSE 15L,A02,083655,Staff,0,2,50,50
1650746208657,CSE 20,A01,083657,Staff,49,0,80,31
1650746214704,CSE 30,A01,083084,Eldon; John,0,77,40,40
1650746220730,CSE 100,A01,083659,Cao; Yingjun,0,71,50,50
1650746226764,CSE 134B,A01,083661,Powell; Thomas Allan,0,38,65,65
1650746232788,CSE 140,A01,083663,Staff,0,11,75,75
1650746238814,CSE 140L,A01,083088,Eldon; John,0,20,75,75
1650746244840,CSE 175,A01,083665,Kumar; Rakesh,7,0,25,18
1650746250867,CSE 190,A00,092507,Dubnov; Shlomo,10,0,20,10
1650746256888,ECE 45,A01,083139,Staff,1,2,60,59
1650746262914,ECE 65,A50,083695,Staff,0,5,30,30
1650746268937,ECE 109,A01,091882,Touri; Behrouz,33,0,70,37
1650746274961,ECE 180,A00,083140,Abi Samra; Nicholas Camill,20,0,30,10
1650746274961,ECE 180,B00,083141,Abi Samra; Nicholas Camill,0,0,30,30
1650746280989,MATH 10A,A01,083735,Patchell; Gregory David,2,0,30,28
1650746280989,MATH 10A,A02,083736,Patchell; Gregory David,27,0,30,3
1650746280989,MATH 10A,A03,083737,Patchell; Gregory David,24,0,30,6
1650746287020,MATH 10B,A01,083207,Staff,0,9,30,30
1650746287020,MATH 10B,A02,083208,Staff,1,7,30,29
1650746287020,MATH 10B,B01,083739,Staff,11,0,30,19
1650746287020,MATH 10B,B02,083740,Staff,28,0,30,2
1650746293043,MATH 18,A01,083743,Staff,0,0,30,30
1650746293043,MATH 18,A02,083744,Staff,23,0,30,7
1650746293043,MATH 18,A03,083745,Staff,21,0,30,9
1650746293043,MATH 18,A04,083746,Staff,26,0,30,4
1650746293043,MATH 18,B01,083748,Staff,0,15,30,30
1650746293043,MATH 18,B02,083749,Staff,0,12,30,30
1650746293043,MATH 18,B03,083750,Staff,0,12,30,30
1650746293043,MATH 18,B04,083751,Staff,0,12,30,30
1650746299068,MATH 20A,A01,083754,Staff,19,0,40,21
1650746305092,MATH 20B,A01,083756,Staff,0,12,30,30
1650746305092,MATH 20B,A02,083757,Staff,0,12,30,30
1650746311115,MATH 20C,A01,083760,Staff,0,16,30,30
1650746311115,MATH 20C,A02,083761,Staff,0,16,30,30
1650746311115,MATH 20C,B01,083762,Staff,10,0,30,20
1650746311115,MATH 20C,B02,083763,Staff,28,0,30,2
1650746317143,MATH 20D,A01,083765,Staff,2,1,30,28
1650746317143,MATH 20D,A02,083766,Staff,6,0,30,24
1650746317143,MATH 20D,A03,083767,Staff,24,0,30,6
1650746323169,MATH 20E,A01,083771,Staff,3,0,30,27
1650746323169,MATH 20E,A02,083772,Staff,16,0,30,14
1650746323169,MATH 20E,B01,083773,Staff,0,0,30,30
1650746323169,MATH 20E,B02,083774,Staff,6,0,30,24
1650746329192,MATH 103A,A01,083777,Staff,0,16,30,30
1650746329192,MATH 103A,A02,083778,Staff,0,15,30,30
1650746329192,MATH 103A,B01,083779,Staff,0,15,30,30
1650746329192,MATH 103A,B02,083780,Staff,0,15,30,30
1650746335216,MATH 105,A01,085443,Staff,0,22,30,30
1650746341244,MATH 109,A01,083213,Anzaldo; Leesa B,0,7,30,30
1650746341244,MATH 109,A02,083214,Anzaldo; Leesa B,0,7,30,30
1650746341244,MATH 109,B01,083215,Anzaldo; Leesa B,0,8,30,30
1650746341244,MATH 109,B02,083216,Anzaldo; Leesa B,0,6,30,30
1650746347267,MATH 142A,A01,083219,Chow; Bennett,0,16,30,30
1650746347267,MATH 142A,A02,083220,Chow; Bennett,0,15,30,30
1650746347267,MATH 142A,B01,083221,Chow; Bennett,0,15,30,30
1650746347267,MATH 142A,B02,083222,Chow; Bennett,0,14,30,30
1650746353297,MATH 193A,A01,083224,Staff,0,5,30,30
1650746353297,MATH 193A,A02,083225,Staff,0,6,30,30
1650746353297,MATH 193A,A03,083781,Staff,0,6,30,30
1650746353297,MATH 193A,A04,083782,Staff,0,7,30,30
1650746359322,MATH 197,001,091859,McAuley; Julian John,9998,0,9999,1
1650746365379,COGS 9,A01,083615,Staff,1,15,60,59
1650746371403,COGS 11,A01,083617,Boyle; Mary E. T.,16,0,40,24
1650746377437,COGS 13,A01,083071,Staff,0,38,40,40
1650746383462,COGS 14A,A01,092681,Staff,0,36,100,100
1650746389499,COGS 14B,A01,083073,Cheng; Tzu-Han,1,13,50,49
1650746395525,COGS 17,A01,092677,Staff,12,0,75,63
1650746401565,COGS 100,A01,083619,Staff,0,28,60,60
1650746407588,COGS 101A,A01,083621,Davis; Joshua Daniel,0,27,60,60
1650746413615,COGS 101B,A01,091572,Staff,1,4,60,59
1650746419641,COGS 101C,A01,083625,Delgado; Tania,14,0,30,16
1650746425667,COGS 107A,A01,083627,Boyle; Mary E. T.,0,16,60,60
1650746431692,COGS 118A,A01,083075,Staff,0,8,60,60
1650746437726,CSE 3,A50,083646,Miranda; Gregory Joseph,18,0,38,20
1650746437726,CSE 3,A51,083647,Miranda; Gregory Joseph,36,0,37,1
1650746443753,CSE 8A,A50,083650,Miranda; Gregory Joseph,0,30,40,40
1650746449775,CSE 11,A01,083080,Cao; Yingjun,0,96,40,40
1650746455798,CSE 12,A01,083652,Staff,0,21,100,100
1650746461822,CSE 15L,A01,083654,Staff,0,3,50,50
1650746461822,CSE 15L,A02,083655,Staff,0,2,50,50
1650746467848,CSE 20,A01,083657,Staff,49,0,80,31
1650746473875,CSE 30,A01,083084,Eldon; John,0,77,40,40
1650746479899,CSE 100,A01,083659,Cao; Yingjun,0,71,50,50
1650746485923,CSE 134B,A01,083661,Powell; Thomas Allan,0,38,65,65
1650746491947,CSE 140,A01,083663,Staff,0,11,75,75
1650746497971,CSE 140L,A01,083088,Eldon; John,0,20,75,75
1650746503995,CSE 175,A01,083665,Kumar; Rakesh,7,0,25,18
1650746510018,CSE 190,A00,092507,Dubnov; Shlomo,10,0,20,10
1650746516044,ECE 45,A01,083139,Staff,1,2,60,59
1650746522070,ECE 65,A50,083695,Staff,0,5,30,30
1650746528108,ECE 109,A01,091882,Touri; Behrouz,33,0,70,37
1650746534136,ECE 180,A00,083140,Abi Samra; Nicholas Camill,20,0,30,10
1650746534136,ECE 180,B00,083141,Abi Samra; Nicholas Camill,0,0,30,30
1650746540168,MATH 10A,A01,083735,Patchell; Gregory David,2,0,30,28
1650746540168,MATH 10A,A02,083736,Patchell; Gregory David,27,0,30,3
1650746540168,MATH 10A,A03,083737,Patchell; Gregory David,24,0,30,6
1650746546191,MATH 10B,A01,083207,Staff,0,9,30,30
1650746546191,MATH 10B,A02,083208,Staff,1,7,30,29
1650746546191,MATH 10B,B01,083739,Staff,11,0,30,19
1650746546191,MATH 10B,B02,083740,Staff,28,0,30,2
1650746552217,MATH 18,A01,083743,Staff,0,0,30,30
1650746552217,MATH 18,A02,083744,Staff,23,0,30,7
1650746552217,MATH 18,A03,083745,Staff,21,0,30,9
1650746552217,MATH 18,A04,083746,Staff,26,0,30,4
1650746552217,MATH 18,B01,083748,Staff,0,15,30,30
1650746552217,MATH 18,B02,083749,Staff,0,12,30,30
1650746552217,MATH 18,B03,083750,Staff,0,12,30,30
1650746552217,MATH 18,B04,083751,Staff,0,12,30,30
1650746558241,MATH 20A,A01,083754,Staff,19,0,40,21
1650746564355,MATH 20B,A01,083756,Staff,0,12,30,30
1650746564355,MATH 20B,A02,083757,Staff,0,12,30,30
1650746570378,MATH 20C,A01,083760,Staff,0,16,30,30
1650746570378,MATH 20C,A02,083761,Staff,0,16,30,30
1650746570378,MATH 20C,B01,083762,Staff,10,0,30,20
1650746570378,MATH 20C,B02,083763,Staff,28,0,30,2
1650746576405,MATH 20D,A01,083765,Staff,2,1,30,28
1650746576405,MATH 20D,A02,083766,Staff,6,0,30,24
1650746576405,MATH 20D,A03,083767,Staff,24,0,30,6
1650746582429,MATH 20E,A01,083771,Staff,3,0,30,27
1650746582429,MATH 20E,A02,083772,Staff,16,0,30,14
1650746582429,MATH 20E,B01,083773,Staff,0,0,30,30
1650746582429,MATH 20E,B02,083774,Staff,6,0,30,24
1650746588470,MATH 103A,A01,083777,Staff,0,16,30,30
1650746588470,MATH 103A,A02,083778,Staff,0,15,30,30
1650746588470,MATH 103A,B01,083779,Staff,0,15,30,30
1650746588470,MATH 103A,B02,083780,Staff,0,15,30,30
1650746594496,MATH 105,A01,085443,Staff,0,22,30,30
1650746600519,MATH 109,A01,083213,Anzaldo; Leesa B,0,7,30,30
1650746600519,MATH 109,A02,083214,Anzaldo; Leesa B,0,7,30,30
1650746600519,MATH 109,B01,083215,Anzaldo; Leesa B,0,8,30,30
1650746600519,MATH 109,B02,083216,Anzaldo; Leesa B,0,6,30,30
1650746606558,MATH 142A,A01,083219,Chow; Bennett,0,16,30,30
1650746606558,MATH 142A,A02,083220,Chow; Bennett,0,15,30,30
1650746606558,MATH 142A,B01,083221,Chow; Bennett,0,15,30,30
1650746606558,MATH 142A,B02,083222,Chow; Bennett,0,14,30,30
1650746612582,MATH 193A,A01,083224,Staff,0,5,30,30
1650746612582,MATH 193A,A02,083225,Staff,0,6,30,30
1650746612582,MATH 193A,A03,083781,Staff,0,6,30,30
1650746612582,MATH 193A,A04,083782,Staff,0,7,30,30
1650746618610,MATH 197,001,091859,McAuley; Julian John,9998,0,9999,1
1650746624661,COGS 9,A01,083615,Staff,1,15,60,59
1650746630686,COGS 11,A01,083617,Boyle; Mary E. T.,16,0,40,24
1650746636710,COGS 13,A01,083071,Staff,0,38,40,40
1650746642744,COGS 14A,A01,092681,Staff,0,36,100,100
1650746648767,COGS 14B,A01,083073,Cheng; Tzu-Han,1,13,50,49
1650746654791,COGS 17,A01,092677,Staff,12,0,75,63
1650746660814,COGS 100,A01,083619,Staff,0,28,60,60
1650746666841,COGS 101A,A01,083621,Davis; Joshua Daniel,0,27,60,60
1650746672875,COGS 101B,A01,091572,Staff,1,4,60,59
1650746678903,COGS 101C,A01,083625,Delgado; Tania,14,0,30,16
1650746684926,COGS 107A,A01,083627,Boyle; Mary E. T.,0,16,60,60
1650746690951,COGS 118A,A01,083075,Staff,0,8,60,60
1650746696981,CSE 3,A50,083646,Miranda; Gregory Joseph,18,0,38,20
1650746696981,CSE 3,A51,083647,Miranda; Gregory Joseph,36,0,37,1
1650746703013,CSE 8A,A50,083650,Miranda; Gregory Joseph,0,30,40,40
1650746709036,CSE 11,A01,083080,Cao; Yingjun,0,96,40,40
1650746715060,CSE 12,A01,083652,Staff,0,21,100,100
1650746721085,CSE 15L,A01,083654,Staff,0,3,50,50
1650746721085,CSE 15L,A02,083655,Staff,0,2,50,50
1650746727108,CSE 20,A01,083657,Staff,49,0,80,31
1650746733132,CSE 30,A01,083084,Eldon; John,0,77,40,40
1650746739155,CSE 100,A01,083659,Cao; Yingjun,0,71,50,50
1650746745178,CSE 134B,A01,083661,Powell; Thomas Allan,0,38,65,65
1650746751201,CSE 140,A01,083663,Staff,0,11,75,75
1650746757228,CSE 140L,A01,083088,Eldon; John,0,20,75,75
1650746763255,CSE 175,A01,083665,Kumar; Rakesh,7,0,25,18
1650746769282,CSE 190,A00,092507,Dubnov; Shlomo,10,0,20,10
1650746775305,ECE 45,A01,083139,Staff,1,2,60,59
1650746781327,ECE 65,A50,083695,Staff,0,5,30,30
1650746787350,ECE 109,A01,091882,Touri; Behrouz,33,0,70,37
1650746793373,ECE 180,A00,083140,Abi Samra; Nicholas Camill,20,0,30,10
1650746793373,ECE 180,B00,083141,Abi Samra; Nicholas Camill,0,0,30,30
1650746799396,MATH 10A,A01,083735,Patchell; Gregory David,2,0,30,28
1650746799396,MATH 10A,A02,083736,Patchell; Gregory David,27,0,30,3
1650746799396,MATH 10A,A03,083737,Patchell; Gregory David,24,0,30,6
1650746805424,MATH 10B,A01,083207,Staff,0,9,30,30
1650746805424,MATH 10B,A02,083208,Staff,1,7,30,29
1650746805424,MATH 10B,B01,083739,Staff,11,0,30,19
1650746805424,MATH 10B,B02,083740,Staff,28,0,30,2
1650746811459,MATH 18,A01,083743,Staff,0,0,30,30
1650746811459,MATH 18,A02,083744,Staff,23,0,30,7
1650746811459,MATH 18,A03,083745,Staff,21,0,30,9
1650746811459,MATH 18,A04,083746,Staff,26,0,30,4
1650746811459,MATH 18,B01,083748,Staff,0,15,30,30
1650746811459,MATH 18,B02,083749,Staff,0,12,30,30
1650746811459,MATH 18,B03,083750,Staff,0,12,30,30
1650746811459,MATH 18,B04,083751,Staff,0,12,30,30
1650746817483,MATH 20A,A01,083754,Staff,19,0,40,21
1650746823507,MATH 20B,A01,083756,Staff,0,12,30,30
1650746823507,MATH 20B,A02,083757,Staff,0,12,30,30
1650746829537,MATH 20C,A01,083760,Staff,0,16,30,30
1650746829537,MATH 20C,A02,083761,Staff,0,16,30,30
1650746829537,MATH 20C,B01,083762,Staff,10,0,30,20
1650746829537,MATH 20C,B02,083763,Staff,28,0,30,2
1650746835566,MATH 20D,A01,083765,Staff,2,1,30,28
1650746835566,MATH 20D,A02,083766,Staff,6,0,30,24
1650746835566,MATH 20D,A03,083767,Staff,24,0,30,6
1650746841591,MATH 20E,A01,083771,Staff,3,0,30,27
1650746841591,MATH 20E,A02,083772,Staff,16,0,30,14
1650746841591,MATH 20E,B01,083773,Staff,0,0,30,30
1650746841591,MATH 20E,B02,083774,Staff,6,0,30,24
1650746847615,MATH 103A,A01,083777,Staff,0,16,30,30
1650746847615,MATH 103A,A02,083778,Staff,0,15,30,30
1650746847615,MATH 103A,B01,083779,Staff,0,15,30,30
1650746847615,MATH 103A,B02,083780,Staff,0,15,30,30
1650746853638,MATH 105,A01,085443,Staff,0,22,30,30
1650746859666,MATH 109,A01,083213,Anzaldo; Leesa B,0,7,30,30
1650746859666,MATH 109,A02,083214,Anzaldo; Leesa B,0,7,30,30
1650746859666,MATH 109,B01,083215,Anzaldo; Leesa B,0,8,30,30
1650746859666,MATH 109,B02,083216,Anzaldo; Leesa B,0,6,30,30
1650746865694,MATH 142A,A01,083219,Chow; Bennett,0,16,30,30
1650746865694,MATH 142A,A02,083220,Chow; Bennett,0,15,30,30
1650746865694,MATH 142A,B01,083221,Chow; Bennett,0,15,30,30
1650746865694,MATH 142A,B02,083222,Chow; Bennett,0,14,30,30
1650746871718,MATH 193A,A01,083224,Staff,0,5,30,30
1650746871718,MATH 193A,A02,083225,Staff,0,6,30,30
1650746871718,MATH 193A,A03,083781,Staff,0,6,30,30
1650746871718,MATH 193A,A04,083782,Staff,0,7,30,30
1650746877743,MATH 197,001,091859,McAuley; Julian John,9998,0,9999,1
1650746883805,COGS 9,A01,083615,Staff,1,15,60,59
1650746889831,COGS 11,A01,083617,Boyle; Mary E. T.,16,0,40,24
1650746895855,COGS 13,A01,083071,Staff,0,38,40,40
1650746901883,COGS 14A,A01,092681,Staff,0,36,100,100
1650746907911,COGS 14B,A01,083073,Cheng; Tzu-Han,1,13,50,49
1650746913942,COGS 17,A01,092677,Staff,12,0,75,63
1650746919969,COGS 100,A01,083619,Staff,0,28,60,60
1650746925997,COGS 101A,A01,083621,Davis; Joshua Daniel,0,27,60,60
1650746932022,COGS 101B,A01,091572,Staff,1,4,60,59
1650746938055,COGS 101C,A01,083625,Delgado; Tania,14,0,30,16
1650746944081,COGS 107A,A01,083627,Boyle; Mary E. T.,0,16,60,60
1650746950107,COGS 118A,A01,083075,Staff,0,8,60,60
1650746956131,CSE 3,A50,083646,Miranda; Gregory Joseph,18,0,38,20
1650746956131,CSE 3,A51,083647,Miranda; Gregory Joseph,36,0,37,1
1650746962160,CSE 8A,A50,083650,Miranda; Gregory Joseph,0,30,40,40
1650746968183,CSE 11,A01,083080,Cao; Yingjun,0,96,40,40
1650746974209,CSE 12,A01,083652,Staff,0,21,100,100
1650746980234,CSE 15L,A01,083654,Staff,0,3,50,50
1650746980234,CSE 15L,A02,083655,Staff,0,2,50,50
1650746986258,CSE 20,A01,083657,Staff,49,0,80,31
1650746992286,CSE 30,A01,083084,Eldon; John,0,77,40,40
1650746998310,CSE 100,A01,083659,Cao; Yingjun,0,71,50,50
1650747004335,CSE 134B,A01,083661,Powell; Thomas Allan,0,38,65,65
1650747010361,CSE 140,A01,083663,Staff,0,11,75,75
1650747016385,CSE 140L,A01,083088,Eldon; John,0,20,75,75
1650747022411,CSE 175,A01,083665,Kumar; Rakesh,7,0,25,18
1650747028437,CSE 190,A00,092507,Dubnov; Shlomo,10,0,20,10
1650747034464,ECE 45,A01,083139,Staff,1,2,60,59
1650747040493,ECE 65,A50,083695,Staff,0,5,30,30
1650747046515,ECE 109,A01,091882,Touri; Behrouz,33,0,70,37
1650747052542,ECE 180,A00,083140,Abi Samra; Nicholas Camill,20,0,30,10
1650747052542,ECE 180,B00,083141,Abi Samra; Nicholas Camill,0,0,30,30
1650747058570,MATH 10A,A01,083735,Patchell; Gregory David,2,0,30,28
1650747058570,MATH 10A,A02,083736,Patchell; Gregory David,27,0,30,3
1650747058570,MATH 10A,A03,083737,Patchell; Gregory David,24,0,30,6
1650747064593,MATH 10B,A01,083207,Staff,0,9,30,30
1650747064593,MATH 10B,A02,083208,Staff,1,7,30,29
1650747064593,MATH 10B,B01,083739,Staff,11,0,30,19
1650747064593,MATH 10B,B02,083740,Staff,28,0,30,2
1650747070623,MATH 18,A01,083743,Staff,0,0,30,30
1650747070623,MATH 18,A02,083744,Staff,23,0,30,7
1650747070623,MATH 18,A03,083745,Staff,21,0,30,9
1650747070623,MATH 18,A04,083746,Staff,26,0,30,4
1650747070623,MATH 18,B01,083748,Staff,0,15,30,30
1650747070623,MATH 18,B02,083749,Staff,0,12,30,30
1650747070623,MATH 18,B03,083750,Staff,0,12,30,30
1650747070623,MATH 18,B04,083751,Staff,0,12,30,30
1650747076654,MATH 20A,A01,083754,Staff,19,0,40,21
1650747082678,MATH 20B,A01,083756,Staff,0,12,30,30
1650747082678,MATH 20B,A02,083757,Staff,0,12,30,30
1650747088712,MATH 20C,A01,083760,Staff,0,16,30,30
1650747088712,MATH 20C,A02,083761,Staff,0,16,30,30
1650747088712,MATH 20C,B01,083762,Staff,10,0,30,20
1650747088712,MATH 20C,B02,083763,Staff,28,0,30,2
1650747094737,MATH 20D,A01,083765,Staff,2,1,30,28
1650747094737,MATH 20D,A02,083766,Staff,6,0,30,24
1650747094737,MATH 20D,A03,083767,Staff,24,0,30,6
1650747100761,MATH 20E,A01,083771,Staff,3,0,30,27
1650747100761,MATH 20E,A02,083772,Staff,16,0,30,14
1650747100761,MATH 20E,B01,083773,Staff,0,0,30,30
1650747100761,MATH 20E,B02,083774,Staff,6,0,30,24
1650747106785,MATH 103A,A01,083777,Staff,0,16,30,30
1650747106785,MATH 103A,A02,083778,Staff,0,15,30,30
1650747106785,MATH 103A,B01,083779,Staff,0,15,30,30
1650747106785,MATH 103A,B02,083780,Staff,0,15,30,30
1650747112818,MATH 105,A01,085443,Staff,0,22,30,30
1650747118842,MATH 109,A01,083213,Anzaldo; Leesa B,0,7,30,30
1650747118842,MATH 109,A02,083214,Anzaldo; Leesa B,0,7,30,30
1650747118842,MATH 109,B01,083215,Anzaldo; Leesa B,0,8,30,30
1650747118842,MATH 109,B02,083216,Anzaldo; Leesa B,0,6,30,30
1650747124873,MATH 142A,A01,083219,Chow; Bennett,0,16,30,30
1650747124873,MATH 142A,A02,083220,Chow; Bennett,0,15,30,30
1650747124873,MATH 142A,B01,083221,Chow; Bennett,0,15,30,30
1650747124873,MATH 142A,B02,083222,Chow; Bennett,0,14,30,30
1650747130901,MATH 193A,A01,083224,Staff,0,5,30,30
1650747130901,MATH 193A,A02,083225,Staff,0,6,30,30
1650747130901,MATH 193A,A03,083781,Staff,0,6,30,30
1650747130901,MATH 193A,A04,083782,Staff,0,7,30,30
1650747136923,MATH 197,001,091859,McAuley; Julian John,9998,0,9999,1
1650747142980,COGS 9,A01,083615,Staff,1,15,60,59
1650747149007,COGS 11,A01,083617,Boyle; Mary E. T.,16,0,40,24
1650747155125,COGS 13,A01,083071,Staff,0,38,40,40
1650747161148,COGS 14A,A01,092681,Staff,0,36,100,100
1650747167180,COGS 14B,A01,083073,Cheng; Tzu-Han,1,13,50,49
1650747173204,COGS 17,A01,092677,Staff,12,0,75,63
1650747179231,COGS 100,A01,083619,Staff,0,28,60,60
1650747185253,COGS 101A,A01,083621,Davis; Joshua Daniel,0,27,60,60
1650747191279,COGS 101B,A01,091572,Staff,1,4,60,59
1650747197301,COGS 101C,A01,083625,Delgado; Tania,14,0,30,16
1650747203324,COGS 107A,A01,083627,Boyle; Mary E. T.,0,16,60,60
1650747209347,COGS 118A,A01,083075,Staff,0,8,60,60
1650747215376,CSE 3,A50,083646,Miranda; Gregory Joseph,18,0,38,20
1650747215376,CSE 3,A51,083647,Miranda; Gregory Joseph,36,0,37,1
1650747221402,CSE 8A,A50,083650,Miranda; Gregory Joseph,0,30,40,40
1650747227426,CSE 11,A01,083080,Cao; Yingjun,0,96,40,40
1650747233449,CSE 12,A01,083652,Staff,0,21,100,100
1650747239474,CSE 15L,A01,083654,Staff,0,3,50,50
1650747239474,CSE 15L,A02,083655,Staff,0,2,50,50
1650747245505,CSE 20,A01,083657,Staff,49,0,80,31
1650747251540,CSE 30,A01,083084,Eldon; John,0,77,40,40
1650747257565,CSE 100,A01,083659,Cao; Yingjun,0,71,50,50
1650747263592,CSE 134B,A01,083661,Powell; Thomas Allan,0,38,65,65
1650747269614,CSE 140,A01,083663,Staff,0,11,75,75
1650747275639,CSE 140L,A01,083088,Eldon; John,0,20,75,75
1650747281672,CSE 175,A01,083665,Kumar; Rakesh,7,0,25,18
1650747287694,CSE 190,A00,092507,Dubnov; Shlomo,10,0,20,10
1650747293722,ECE 45,A01,083139,Staff,1,2,60,59
1650747299746,ECE 65,A50,083695,Staff,0,5,30,30
1650747305769,ECE 109,A01,091882,Touri; Behrouz,33,0,70,37
1650747311794,ECE 180,A00,083140,Abi Samra; Nicholas Camill,20,0,30,10
1650747311794,ECE 180,B00,083141,Abi Samra; Nicholas Camill,0,0,30,30
1650747317818,MATH 10A,A01,083735,Patchell; Gregory David,2,0,30,28
1650747317818,MATH 10A,A02,083736,Patchell; Gregory David,27,0,30,3
1650747317818,MATH 10A,A03,083737,Patchell; Gregory David,24,0,30,6
1650747323846,MATH 10B,A01,083207,Staff,0,9,30,30
1650747323846,MATH 10B,A02,083208,Staff,1,7,30,29
1650747323846,MATH 10B,B01,083739,Staff,11,0,30,19
1650747323846,MATH 10B,B02,083740,Staff,28,0,30,2
1650747329877,MATH 18,A01,083743,Staff,0,0,30,30
1650747329877,MATH 18,A02,083744,Staff,23,0,30,7
1650747329877,MATH 18,A03,083745,Staff,21,0,30,9
1650747329877,MATH 18,A04,083746,Staff,26,0,30,4
1650747329877,MATH 18,B01,083748,Staff,0,15,30,30
1650747329877,MATH 18,B02,083749,Staff,0,12,30,30
1650747329877,MATH 18,B03,083750,Staff,0,12,30,30
1650747329877,MATH 18,B04,083751,Staff,0,12,30,30
1650747335901,MATH 20A,A01,083754,Staff,19,0,40,21
1650747341928,MATH 20B,A01,083756,Staff,0,12,30,30
1650747341928,MATH 20B,A02,083757,Staff,0,12,30,30
1650747347952,MATH 20C,A01,083760,Staff,0,16,30,30
1650747347952,MATH 20C,A02,083761,Staff,0,16,30,30
1650747347952,MATH 20C,B01,083762,Staff,10,0,30,20
1650747347952,MATH 20C,B02,083763,Staff,28,0,30,2
1650747353983,MATH 20D,A01,083765,Staff,2,1,30,28
1650747353983,MATH 20D,A02,083766,Staff,6,0,30,24
1650747353983,MATH 20D,A03,083767,Staff,24,0,30,6
1650747360008,MATH 20E,A01,083771,Staff,3,0,30,27
1650747360008,MATH 20E,A02,083772,Staff,16,0,30,14
1650747360008,MATH 20E,B01,083773,Staff,0,0,30,30
1650747360008,MATH 20E,B02,083774,Staff,6,0,30,24
1650747366035,MATH 103A,A01,083777,Staff,0,16,30,30
1650747366035,MATH 103A,A02,083778,Staff,0,15,30,30
1650747366035,MATH 103A,B01,083779,Staff,0,15,30,30
1650747366035,MATH 103A,B02,083780,Staff,0,15,30,30
1650747372059,MATH 105,A01,085443,Staff,0,22,30,30
1650747378083,MATH 109,A01,083213,Anzaldo; Leesa B,0,7,30,30
1650747378083,MATH 109,A02,083214,Anzaldo; Leesa B,0,7,30,30
1650747378083,MATH 109,B01,083215,Anzaldo; Leesa B,0,8,30,30
1650747378083,MATH 109,B02,083216,Anzaldo; Leesa B,0,6,30,30
1650747384114,MATH 142A,A01,083219,Chow; Bennett,0,16,30,30
1650747384114,MATH 142A,A02,083220,Chow; Bennett,0,15,30,30
1650747384114,MATH 142A,B01,083221,Chow; Bennett,0,15,30,30
1650747384114,MATH 142A,B02,083222,Chow; Bennett,0,14,30,30
1650747390143,MATH 193A,A01,083224,Staff,0,5,30,30
1650747390143,MATH 193A,A02,083225,Staff,0,6,30,30
1650747390143,MATH 193A,A03,083781,Staff,0,6,30,30
1650747390143,MATH 193A,A04,083782,Staff,0,7,30,30
1650747396168,MATH 197,001,091859,McAuley; Julian John,9998,0,9999,1
1650747402219,COGS 9,A01,083615,Staff,1,15,60,59
1650747408244,COGS 11,A01,083617,Boyle; Mary E. T.,15,0,40,25
1650747414267,COGS 13,A01,083071,Staff,0,38,40,40
1650747420290,COGS 14A,A01,092681,Staff,0,36,100,100
1650747426318,COGS 14B,A01,083073,Cheng; Tzu-Han,1,13,50,49
1650747432342,COGS 17,A01,092677,Staff,12,0,75,63
1650747438365,COGS 100,A01,083619,Staff,0,28,60,60
1650747444389,COGS 101A,A01,083621,Davis; Joshua Daniel,0,27,60,60
1650747450416,COGS 101B,A01,091572,Staff,1,4,60,59
1650747456453,COGS 101C,A01,083625,Delgado; Tania,14,0,30,16
1650747462476,COGS 107A,A01,083627,Boyle; Mary E. T.,0,16,60,60
1650747468499,COGS 118A,A01,083075,Staff,0,8,60,60
1650747474521,CSE 3,A50,083646,Miranda; Gregory Joseph,18,0,38,20
1650747474521,CSE 3,A51,083647,Miranda; Gregory Joseph,36,0,37,1
1650747480551,CSE 8A,A50,083650,Miranda; Gregory Joseph,0,30,40,40
1650747486577,CSE 11,A01,083080,Cao; Yingjun,0,96,40,40
1650747492600,CSE 12,A01,083652,Staff,0,21,100,100
1650747498623,CSE 15L,A01,083654,Staff,0,3,50,50
1650747498623,CSE 15L,A02,083655,Staff,0,2,50,50
1650747504650,CSE 20,A01,083657,Staff,49,0,80,31
1650747510674,CSE 30,A01,083084,Eldon; John,0,77,40,40
1650747516702,CSE 100,A01,083659,Cao; Yingjun,0,71,50,50
1650747522731,CSE 134B,A01,083661,Powell; Thomas Allan,0,38,65,65
1650747528755,CSE 140,A01,083663,Staff,0,11,75,75
1650747534791,CSE 140L,A01,083088,Eldon; John,0,20,75,75
1650747540814,CSE 175,A01,083665,Kumar; Rakesh,7,0,25,18
1650747546841,CSE 190,A00,092507,Dubnov; Shlomo,10,0,20,10
1650747552870,ECE 45,A01,083139,Staff,1,2,60,59
1650747558902,ECE 65,A50,083695,Staff,0,5,30,30
1650747564945,ECE 109,A01,091882,Touri; Behrouz,33,0,70,37
1650747570970,ECE 180,A00,083140,Abi Samra; Nicholas Camill,20,0,30,10
1650747570970,ECE 180,B00,083141,Abi Samra; Nicholas Camill,0,0,30,30
1650747576994,MATH 10A,A01,083735,Patchell; Gregory David,2,0,30,28
1650747576994,MATH 10A,A02,083736,Patchell; Gregory David,27,0,30,3
1650747576994,MATH 10A,A03,083737,Patchell; Gregory David,24,0,30,6
1650747583022,MATH 10B,A01,083207,Staff,0,9,30,30
1650747583022,MATH 10B,A02,083208,Staff,1,7,30,29
1650747583022,MATH 10B,B01,083739,Staff,11,0,30,19
1650747583022,MATH 10B,B02,083740,Staff,28,0,30,2
1650747589045,MATH 18,A01,083743,Staff,0,0,30,30
1650747589045,MATH 18,A02,083744,Staff,23,0,30,7
1650747589045,MATH 18,A03,083745,Staff,21,0,30,9
1650747589045,MATH 18,A04,083746,Staff,26,0,30,4
1650747589045,MATH 18,B01,083748,Staff,0,15,30,30
1650747589045,MATH 18,B02,083749,Staff,0,12,30,30
1650747589045,MATH 18,B03,083750,Staff,0,12,30,30
1650747589045,MATH 18,B04,083751,Staff,0,12,30,30
1650747595069,MATH 20A,A01,083754,Staff,19,0,40,21
1650747601110,MATH 20B,A01,083756,Staff,0,12,30,30
1650747601110,MATH 20B,A02,083757,Staff,0,12,30,30
1650747607138,MATH 20C,A01,083760,Staff,0,16,30,30
1650747607138,MATH 20C,A02,083761,Staff,0,16,30,30
1650747607138,MATH 20C,B01,083762,Staff,10,0,30,20
1650747607138,MATH 20C,B02,083763,Staff,28,0,30,2
1650747613161,MATH 20D,A01,083765,Staff,2,1,30,28
1650747613161,MATH 20D,A02,083766,Staff,6,0,30,24
1650747613161,MATH 20D,A03,083767,Staff,24,0,30,6
1650747619186,MATH 20E,A01,083771,Staff,3,0,30,27
1650747619186,MATH 20E,A02,083772,Staff,16,0,30,14
1650747619186,MATH 20E,B01,083773,Staff,0,0,30,30
1650747619186,MATH 20E,B02,083774,Staff,6,0,30,24
1650747625210,MATH 103A,A01,083777,Staff,0,16,30,30
1650747625210,MATH 103A,A02,083778,Staff,0,15,30,30
1650747625210,MATH 103A,B01,083779,Staff,0,15,30,30
1650747625210,MATH 103A,B02,083780,Staff,0,15,30,30
1650747631238,MATH 105,A01,085443,Staff,0,22,30,30
1650747637266,MATH 109,A01,083213,Anzaldo; Leesa B,0,7,30,30
1650747637266,MATH 109,A02,083214,Anzaldo; Leesa B,0,7,30,30
1650747637266,MATH 109,B01,083215,Anzaldo; Leesa B,0,8,30,30
1650747637266,MATH 109,B02,083216,Anzaldo; Leesa B,0,6,30,30
1650747643293,MATH 142A,A01,083219,Chow; Bennett,0,16,30,30
1650747643293,MATH 142A,A02,083220,Chow; Bennett,0,15,30,30
1650747643293,MATH 142A,B01,083221,Chow; Bennett,0,15,30,30
1650747643293,MATH 142A,B02,083222,Chow; Bennett,0,14,30,30
1650747649315,MATH 193A,A01,083224,Staff,0,5,30,30
1650747649315,MATH 193A,A02,083225,Staff,0,6,30,30
1650747649315,MATH 193A,A03,083781,Staff,0,6,30,30
1650747649315,MATH 193A,A04,083782,Staff,0,7,30,30
1650747655354,MATH 197,001,091859,McAuley; Julian John,9998,0,9999,1
1650747661412,COGS 9,A01,083615,Staff,1,15,60,59
1650747667435,COGS 11,A01,083617,Boyle; Mary E. T.,15,0,40,25
1650747673458,COGS 13,A01,083071,Staff,0,38,40,40
1650747679485,COGS 14A,A01,092681,Staff,0,36,100,100
1650747685512,COGS 14B,A01,083073,Cheng; Tzu-Han,1,13,50,49
1650747691538,COGS 17,A01,092677,Staff,12,0,75,63
1650747697565,COGS 100,A01,083619,Staff,0,28,60,60
1650747703590,COGS 101A,A01,083621,Davis; Joshua Daniel,0,27,60,60
1650747709620,COGS 101B,A01,091572,Staff,1,4,60,59
1650747715650,COGS 101C,A01,083625,Delgado; Tania,14,0,30,16
1650747721674,COGS 107A,A01,083627,Boyle; Mary E. T.,0,16,60,60
1650747727696,COGS 118A,A01,083075,Staff,0,8,60,60
1650747733728,CSE 3,A50,083646,Miranda; Gregory Joseph,18,0,38,20
1650747733728,CSE 3,A51,083647,Miranda; Gregory Joseph,36,0,37,1
1650747739764,CSE 8A,A50,083650,Miranda; Gregory Joseph,0,30,40,40
1650747745792,CSE 11,A01,083080,Cao; Yingjun,0,96,40,40
1650747751911,CSE 12,A01,083652,Staff,0,21,100,100
1650747757935,CSE 15L,A01,083654,Staff,0,3,50,50
1650747757935,CSE 15L,A02,083655,Staff,0,2,50,50
1650747763958,CSE 20,A01,083657,Staff,49,0,80,31
1650747769982,CSE 30,A01,083084,Eldon; John,0,77,40,40
1650747776006,CSE 100,A01,083659,Cao; Yingjun,0,71,50,50
1650747782034,CSE 134B,A01,083661,Powell; Thomas Allan,0,38,65,65
1650747788057,CSE 140,A01,083663,Staff,0,11,75,75
1650747794082,CSE 140L,A01,083088,Eldon; John,0,20,75,75
1650747800106,CSE 175,A01,083665,Kumar; Rakesh,7,0,25,18
1650747806130,CSE 190,A00,092507,Dubnov; Shlomo,10,0,20,10
1650747812155,ECE 45,A01,083139,Staff,1,2,60,59
1650747818183,ECE 65,A50,083695,Staff,0,5,30,30
1650747824206,ECE 109,A01,091882,Touri; Behrouz,33,0,70,37
1650747830232,ECE 180,A00,083140,Abi Samra; Nicholas Camill,20,0,30,10
1650747830232,ECE 180,B00,083141,Abi Samra; Nicholas Camill,0,0,30,30
1650747836261,MATH 10A,A01,083735,Patchell; Gregory David,2,0,30,28
1650747836261,MATH 10A,A02,083736,Patchell; Gregory David,27,0,30,3
1650747836261,MATH 10A,A03,083737,Patchell; Gregory David,24,0,30,6
1650747842286,MATH 10B,A01,083207,Staff,0,9,30,30
1650747842286,MATH 10B,A02,083208,Staff,1,7,30,29
1650747842286,MATH 10B,B01,083739,Staff,11,0,30,19
1650747842286,MATH 10B,B02,083740,Staff,28,0,30,2
1650747848317,MATH 18,A01,083743,Staff,0,0,30,30
1650747848317,MATH 18,A02,083744,Staff,23,0,30,7
1650747848317,MATH 18,A03,083745,Staff,21,0,30,9
1650747848317,MATH 18,A04,083746,Staff,26,0,30,4
1650747848317,MATH 18,B01,083748,Staff,0,15,30,30
1650747848317,MATH 18,B02,083749,Staff,0,12,30,30
1650747848317,MATH 18,B03,083750,Staff,0,12,30,30
1650747848317,MATH 18,B04,083751,Staff,0,12,30,30
1650747854338,MATH 20A,A01,083754,Staff,19,0,40,21
1650747860363,MATH 20B,A01,083756,Staff,0,12,30,30
1650747860363,MATH 20B,A02,083757,Staff,0,12,30,30
1650747866390,MATH 20C,A01,083760,Staff,0,16,30,30
1650747866390,MATH 20C,A02,083761,Staff,0,16,30,30
1650747866390,MATH 20C,B01,083762,Staff,10,0,30,20
1650747866390,MATH 20C,B02,083763,Staff,28,0,30,2
1650747872416,MATH 20D,A01,083765,Staff,2,1,30,28
1650747872416,MATH 20D,A02,083766,Staff,6,0,30,24
1650747872416,MATH 20D,A03,083767,Staff,24,0,30,6
1650747878440,MATH 20E,A01,083771,Staff,3,0,30,27
1650747878440,MATH 20E,A02,083772,Staff,16,0,30,14
1650747878440,MATH 20E,B01,083773,Staff,0,0,30,30
1650747878440,MATH 20E,B02,083774,Staff,6,0,30,24
1650747884465,MATH 103A,A01,083777,Staff,0,16,30,30
1650747884465,MATH 103A,A02,083778,Staff,0,15,30,30
1650747884465,MATH 103A,B01,083779,Staff,0,15,30,30
1650747884465,MATH 103A,B02,083780,Staff,0,15,30,30
1650747890493,MATH 105,A01,085443,Staff,0,22,30,30
1650747896533,MATH 109,A01,083213,Anzaldo; Leesa B,0,7,30,30
1650747896533,MATH 109,A02,083214,Anzaldo; Leesa B,0,7,30,30
1650747896533,MATH 109,B01,083215,Anzaldo; Leesa B,0,8,30,30
1650747896533,MATH 109,B02,083216,Anzaldo; Leesa B,0,6,30,30
1650747902556,MATH 142A,A01,083219,Chow; Bennett,0,16,30,30
1650747902556,MATH 142A,A02,083220,Chow; Bennett,0,15,30,30
1650747902556,MATH 142A,B01,083221,Chow; Bennett,0,15,30,30
1650747902556,MATH 142A,B02,083222,Chow; Bennett,0,14,30,30
1650747908579,MATH 193A,A01,083224,Staff,0,5,30,30
1650747908579,MATH 193A,A02,083225,Staff,0,6,30,30
1650747908579,MATH 193A,A03,083781,Staff,0,6,30,30
1650747908579,MATH 193A,A04,083782,Staff,0,7,30,30
1650747914606,MATH 197,001,091859,McAuley; Julian John,9998,0,9999,1
1650747920660,COGS 9,A01,083615,Staff,1,15,60,59
1650747926686,COGS 11,A01,083617,Boyle; Mary E. T.,15,0,40,25
1650747932711,COGS 13,A01,083071,Staff,0,38,40,40
1650747938739,COGS 14A,A01,092681,Staff,0,36,100,100
1650747944763,COGS 14B,A01,083073,Cheng; Tzu-Han,1,13,50,49
1650747950787,COGS 17,A01,092677,Staff,11,0,75,64
1650747956811,COGS 100,A01,083619,Staff,0,28,60,60
1650747962833,COGS 101A,A01,083621,Davis; Joshua Daniel,0,27,60,60
1650747968857,COGS 101B,A01,091572,Staff,1,4,60,59
1650747974885,COGS 101C,A01,083625,Delgado; Tania,14,0,30,16
1650747980908,COGS 107A,A01,083627,Boyle; Mary E. T.,0,16,60,60
1650747986932,COGS 118A,A01,083075,Staff,0,8,60,60
1650747992959,CSE 3,A50,083646,Miranda; Gregory Joseph,18,0,38,20
1650747992959,CSE 3,A51,083647,Miranda; Gregory Joseph,36,0,37,1
1650747998993,CSE 8A,A50,083650,Miranda; Gregory Joseph,0,30,40,40
1650748005020,CSE 11,A01,083080,Cao; Yingjun,0,96,40,40
1650748011049,CSE 12,A01,083652,Staff,0,21,100,100
1650748017075,CSE 15L,A01,083654,Staff,0,3,50,50
1650748017075,CSE 15L,A02,083655,Staff,0,2,50,50
1650748023114,CSE 20,A01,083657,Staff,49,0,80,31
1650748029138,CSE 30,A01,083084,Eldon; John,0,77,40,40
1650748035161,CSE 100,A01,083659,Cao; Yingjun,0,71,50,50
1650748041184,CSE 134B,A01,083661,Powell; Thomas Allan,0,38,65,65
1650748047214,CSE 140,A01,083663,Staff,0,11,75,75
1650748053242,CSE 140L,A01,083088,Eldon; John,0,20,75,75
1650748059270,CSE 175,A01,083665,Kumar; Rakesh,7,0,25,18
1650748065297,CSE 190,A00,092507,Dubnov; Shlomo,10,0,20,10
1650748071321,ECE 45,A01,083139,Staff,1,2,60,59
1650748077360,ECE 65,A50,083695,Staff,0,5,30,30
1650748083386,ECE 109,A01,091882,Touri; Behrouz,33,0,70,37
1650748089412,ECE 180,A00,083140,Abi Samra; Nicholas Camill,20,0,30,10
1650748089412,ECE 180,B00,083141,Abi Samra; Nicholas Camill,0,0,30,30
1650748095454,MATH 10A,A01,083735,Patchell; Gregory David,2,0,30,28
1650748095454,MATH 10A,A02,083736,Patchell; Gregory David,27,0,30,3
1650748095454,MATH 10A,A03,083737,Patchell; Gregory David,24,0,30,6
1650748101482,MATH 10B,A01,083207,Staff,0,9,30,30
1650748101482,MATH 10B,A02,083208,Staff,1,7,30,29
1650748101482,MATH 10B,B01,083739,Staff,11,0,30,19
1650748101482,MATH 10B,B02,083740,Staff,28,0,30,2
1650748107513,MATH 18,A01,083743,Staff,0,0,30,30
1650748107513,MATH 18,A02,083744,Staff,23,0,30,7
1650748107513,MATH 18,A03,083745,Staff,21,0,30,9
1650748107513,MATH 18,A04,083746,Staff,26,0,30,4
1650748107513,MATH 18,B01,083748,Staff,0,15,30,30
1650748107513,MATH 18,B02,083749,Staff,0,12,30,30
1650748107513,MATH 18,B03,083750,Staff,0,12,30,30
1650748107513,MATH 18,B04,083751,Staff,0,12,30,30
1650748113535,MATH 20A,A01,083754,Staff,19,0,40,21
1650748119560,MATH 20B,A01,083756,Staff,0,12,30,30
1650748119560,MATH 20B,A02,083757,Staff,0,12,30,30
1650748125590,MATH 20C,A01,083760,Staff,0,16,30,30
1650748125590,MATH 20C,A02,083761,Staff,0,16,30,30
1650748125590,MATH 20C,B01,083762,Staff,10,0,30,20
1650748125590,MATH 20C,B02,083763,Staff,28,0,30,2
1650748131620,MATH 20D,A01,083765,Staff,2,1,30,28
1650748131620,MATH 20D,A02,083766,Staff,6,0,30,24
1650748131620,MATH 20D,A03,083767,Staff,24,0,30,6
1650748137645,MATH 20E,A01,083771,Staff,3,0,30,27
1650748137645,MATH 20E,A02,083772,Staff,16,0,30,14
1650748137645,MATH 20E,B01,083773,Staff,0,0,30,30
1650748137645,MATH 20E,B02,083774,Staff,6,0,30,24
1650748143675,MATH 103A,A01,083777,Staff,0,16,30,30
1650748143675,MATH 103A,A02,083778,Staff,0,15,30,30
1650748143675,MATH 103A,B01,083779,Staff,0,15,30,30
1650748143675,MATH 103A,B02,083780,Staff,0,15,30,30
1650748149698,MATH 105,A01,085443,Staff,0,22,30,30
1650748155722,MATH 109,A01,083213,Anzaldo; Leesa B,0,7,30,30
1650748155722,MATH 109,A02,083214,Anzaldo; Leesa B,0,7,30,30
1650748155722,MATH 109,B01,083215,Anzaldo; Leesa B,0,8,30,30
1650748155722,MATH 109,B02,083216,Anzaldo; Leesa B,0,6,30,30
1650748161751,MATH 142A,A01,083219,Chow; Bennett,0,16,30,30
1650748161751,MATH 142A,A02,083220,Chow; Bennett,0,15,30,30
1650748161751,MATH 142A,B01,083221,Chow; Bennett,0,15,30,30
1650748161751,MATH 142A,B02,083222,Chow; Bennett,0,14,30,30
1650748167774,MATH 193A,A01,083224,Staff,0,5,30,30
1650748167774,MATH 193A,A02,083225,Staff,0,6,30,30
1650748167774,MATH 193A,A03,083781,Staff,0,6,30,30
1650748167774,MATH 193A,A04,083782,Staff,0,7,30,30
1650748173796,MATH 197,001,091859,McAuley; Julian John,9998,0,9999,1
1650748179856,COGS 9,A01,083615,Staff,1,15,60,59
1650748185881,COGS 11,A01,083617,Boyle; Mary E. T.,16,0,40,24
1650748191904,COGS 13,A01,083071,Staff,0,38,40,40
1650748197930,COGS 14A,A01,092681,Staff,0,36,100,100
1650748203962,COGS 14B,A01,083073,Cheng; Tzu-Han,1,13,50,49
1650748209987,COGS 17,A01,092677,Staff,11,0,75,64
1650748216012,COGS 100,A01,083619,Staff,0,28,60,60
1650748222038,COGS 101A,A01,083621,Davis; Joshua Daniel,0,27,60,60
1650748228062,COGS 101B,A01,091572,Staff,1,4,60,59
1650748234090,COGS 101C,A01,083625,Delgado; Tania,14,0,30,16
1650748240117,COGS 107A,A01,083627,Boyle; Mary E. T.,0,16,60,60
1650748246142,COGS 118A,A01,083075,Staff,0,8,60,60
1650748252174,CSE 3,A50,083646,Miranda; Gregory Joseph,18,0,38,20
1650748252174,CSE 3,A51,083647,Miranda; Gregory Joseph,36,0,37,1
1650748258200,CSE 8A,A50,083650,Miranda; Gregory Joseph,0,30,40,40
1650748264223,CSE 11,A01,083080,Cao; Yingjun,0,96,40,40
1650748270257,CSE 12,A01,083652,Staff,0,21,100,100
1650748276284,CSE 15L,A01,083654,Staff,0,3,50,50
1650748276284,CSE 15L,A02,083655,Staff,0,2,50,50
1650748282307,CSE 20,A01,083657,Staff,49,0,80,31
1650748288331,CSE 30,A01,083084,Eldon; John,0,77,40,40
1650748294357,CSE 100,A01,083659,Cao; Yingjun,0,71,50,50
1650748300399,CSE 134B,A01,083661,Powell; Thomas Allan,0,38,65,65
1650748306424,CSE 140,A01,083663,Staff,0,11,75,75
1650748312446,CSE 140L,A01,083088,Eldon; John,0,20,75,75
1650748318470,CSE 175,A01,083665,Kumar; Rakesh,7,0,25,18
1650748324496,CSE 190,A00,092507,Dubnov; Shlomo,10,0,20,10
1650748330525,ECE 45,A01,083139,Staff,1,2,60,59
1650748336557,ECE 65,A50,083695,Staff,0,5,30,30
1650748342584,ECE 109,A01,091882,Touri; Behrouz,33,0,70,37
1650748348709,ECE 180,A00,083140,Abi Samra; Nicholas Camill,20,0,30,10
1650748348709,ECE 180,B00,083141,Abi Samra; Nicholas Camill,0,0,30,30
1650748354741,MATH 10A,A01,083735,Patchell; Gregory David,2,0,30,28
1650748354741,MATH 10A,A02,083736,Patchell; Gregory David,27,0,30,3
1650748354741,MATH 10A,A03,083737,Patchell; Gregory David,24,0,30,6
1650748360768,MATH 10B,A01,083207,Staff,0,9,30,30
1650748360768,MATH 10B,A02,083208,Staff,1,7,30,29
1650748360768,MATH 10B,B01,083739,Staff,11,0,30,19
1650748360768,MATH 10B,B02,083740,Staff,28,0,30,2
1650748366798,MATH 18,A01,083743,Staff,0,0,30,30
1650748366798,MATH 18,A02,083744,Staff,23,0,30,7
1650748366798,MATH 18,A03,083745,Staff,21,0,30,9
1650748366798,MATH 18,A04,083746,Staff,26,0,30,4
1650748366798,MATH 18,B01,083748,Staff,0,15,30,30
1650748366798,MATH 18,B02,083749,Staff,0,12,30,30
1650748366798,MATH 18,B03,083750,Staff,0,12,30,30
1650748366798,MATH 18,B04,083751,Staff,0,12,30,30
1650748372821,MATH 20A,A01,083754,Staff,19,0,40,21
1650748378845,MATH 20B,A01,083756,Staff,0,12,30,30
1650748378845,MATH 20B,A02,083757,Staff,0,12,30,30
1650748384872,MATH 20C,A01,083760,Staff,0,16,30,30
1650748384872,MATH 20C,A02,083761,Staff,0,16,30,30
1650748384872,MATH 20C,B01,083762,Staff,10,0,30,20
1650748384872,MATH 20C,B02,083763,Staff,28,0,30,2
1650748390898,MATH 20D,A01,083765,Staff,2,1,30,28
1650748390898,MATH 20D,A02,083766,Staff,6,0,30,24
1650748390898,MATH 20D,A03,083767,Staff,24,0,30,6
1650748396926,MATH 20E,A01,083771,Staff,3,0,30,27
1650748396926,MATH 20E,A02,083772,Staff,16,0,30,14
1650748396926,MATH 20E,B01,083773,Staff,0,0,30,30
1650748396926,MATH 20E,B02,083774,Staff,6,0,30,24
1650748402952,MATH 103A,A01,083777,Staff,0,16,30,30
1650748402952,MATH 103A,A02,083778,Staff,0,15,30,30
1650748402952,MATH 103A,B01,083779,Staff,0,15,30,30
1650748402952,MATH 103A,B02,083780,Staff,0,15,30,30
1650748408988,MATH 105,A01,085443,Staff,0,22,30,30
1650748415016,MATH 109,A01,083213,Anzaldo; Leesa B,0,7,30,30
1650748415016,MATH 109,A02,083214,Anzaldo; Leesa B,0,7,30,30
1650748415016,MATH 109,B01,083215,Anzaldo; Leesa B,0,8,30,30
1650748415016,MATH 109,B02,083216,Anzaldo; Leesa B,0,6,30,30
1650748421041,MATH 142A,A01,083219,Chow; Bennett,0,16,30,30
1650748421041,MATH 142A,A02,083220,Chow; Bennett,0,15,30,30
1650748421041,MATH 142A,B01,083221,Chow; Bennett,0,15,30,30
1650748421041,MATH 142A,B02,083222,Chow; Bennett,0,14,30,30
1650748427065,MATH 193A,A01,083224,Staff,0,5,30,30
1650748427065,MATH 193A,A02,083225,Staff,0,6,30,30
1650748427065,MATH 193A,A03,083781,Staff,0,6,30,30
1650748427065,MATH 193A,A04,083782,Staff,0,7,30,30
1650748433089,MATH 197,001,091859,McAuley; Julian John,9998,0,9999,1
1650748439147,COGS 9,A01,083615,Staff,1,15,60,59
1650748445183,COGS 11,A01,083617,Boyle; Mary E. T.,16,0,40,24
1650748451206,COGS 13,A01,083071,Staff,0,38,40,40
1650748457232,COGS 14A,A01,092681,Staff,0,36,100,100
1650748463260,COGS 14B,A01,083073,Cheng; Tzu-Han,1,13,50,49
1650748469286,COGS 17,A01,092677,Staff,11,0,75,64
1650748475312,COGS 100,A01,083619,Staff,0,28,60,60
1650748481338,COGS 101A,A01,083621,Davis; Joshua Daniel,0,27,60,60
1650748487365,COGS 101B,A01,091572,Staff,1,4,60,59
1650748493391,COGS 101C,A01,083625,Delgado; Tania,14,0,30,16
1650748499418,COGS 107A,A01,083627,Boyle; Mary E. T.,0,16,60,60
1650748505443,COGS 118A,A01,083075,Staff,0,8,60,60
1650748511466,CSE 3,A50,083646,Miranda; Gregory Joseph,18,0,38,20
1650748511466,CSE 3,A51,083647,Miranda; Gregory Joseph,36,0,37,1
1650748517495,CSE 8A,A50,083650,Miranda; Gregory Joseph,0,30,40,40
1650748523519,CSE 11,A01,083080,Cao; Yingjun,0,96,40,40
1650748529546,CSE 12,A01,083652,Staff,0,21,100,100
1650748535568,CSE 15L,A01,083654,Staff,0,3,50,50
1650748535568,CSE 15L,A02,083655,Staff,0,2,50,50
1650748541592,CSE 20,A01,083657,Staff,49,0,80,31
1650748547630,CSE 30,A01,083084,Eldon; John,0,77,40,40
1650748553654,CSE 100,A01,083659,Cao; Yingjun,0,71,50,50
1650748559679,CSE 134B,A01,083661,Powell; Thomas Allan,0,38,65,65
1650748565702,CSE 140,A01,083663,Staff,0,11,75,75
1650748571733,CSE 140L,A01,083088,Eldon; John,0,20,75,75
1650748577758,CSE 175,A01,083665,Kumar; Rakesh,7,0,25,18
1650748583783,CSE 190,A00,092507,Dubnov; Shlomo,10,0,20,10
1650748589807,ECE 45,A01,083139,Staff,1,2,60,59
1650748595831,ECE 65,A50,083695,Staff,0,5,30,30
1650748601854,ECE 109,A01,091882,Touri; Behrouz,33,0,70,37
1650748607878,ECE 180,A00,083140,Abi Samra; Nicholas Camill,20,0,30,10
1650748607878,ECE 180,B00,083141,Abi Samra; Nicholas Camill,0,0,30,30
1650748613906,MATH 10A,A01,083735,Patchell; Gregory David,2,0,30,28
1650748613906,MATH 10A,A02,083736,Patchell; Gregory David,27,0,30,3
1650748613906,MATH 10A,A03,083737,Patchell; Gregory David,24,0,30,6
1650748619929,MATH 10B,A01,083207,Staff,0,9,30,30
1650748619929,MATH 10B,A02,083208,Staff,1,7,30,29
1650748619929,MATH 10B,B01,083739,Staff,11,0,30,19
1650748619929,MATH 10B,B02,083740,Staff,28,0,30,2
1650748625959,MATH 18,A01,083743,Staff,0,0,30,30
1650748625959,MATH 18,A02,083744,Staff,23,0,30,7
1650748625959,MATH 18,A03,083745,Staff,21,0,30,9
1650748625959,MATH 18,A04,083746,Staff,26,0,30,4
1650748625959,MATH 18,B01,083748,Staff,0,15,30,30
1650748625959,MATH 18,B02,083749,Staff,0,12,30,30
1650748625959,MATH 18,B03,083750,Staff,0,12,30,30
1650748625959,MATH 18,B04,083751,Staff,0,12,30,30
1650748631985,MATH 20A,A01,083754,Staff,19,0,40,21
1650748638013,MATH 20B,A01,083756,Staff,0,12,30,30
1650748638013,MATH 20B,A02,083757,Staff,0,12,30,30
1650748644037,MATH 20C,A01,083760,Staff,0,16,30,30
1650748644037,MATH 20C,A02,083761,Staff,0,16,30,30
1650748644037,MATH 20C,B01,083762,Staff,10,0,30,20
1650748644037,MATH 20C,B02,083763,Staff,28,0,30,2
1650748650060,MATH 20D,A01,083765,Staff,2,1,30,28
1650748650060,MATH 20D,A02,083766,Staff,6,0,30,24
1650748650060,MATH 20D,A03,083767,Staff,24,0,30,6
1650748656084,MATH 20E,A01,083771,Staff,3,0,30,27
1650748656084,MATH 20E,A02,083772,Staff,16,0,30,14
1650748656084,MATH 20E,B01,083773,Staff,0,0,30,30
1650748656084,MATH 20E,B02,083774,Staff,6,0,30,24
1650748662115,MATH 103A,A01,083777,Staff,0,16,30,30
1650748662115,MATH 103A,A02,083778,Staff,0,15,30,30
1650748662115,MATH 103A,B01,083779,Staff,0,15,30,30
1650748662115,MATH 103A,B02,083780,Staff,0,15,30,30
1650748668137,MATH 105,A01,085443,Staff,0,22,30,30
1650748674166,MATH 109,A01,083213,Anzaldo; Leesa B,0,7,30,30
1650748674166,MATH 109,A02,083214,Anzaldo; Leesa B,0,7,30,30
1650748674166,MATH 109,B01,083215,Anzaldo; Leesa B,0,8,30,30
1650748674166,MATH 109,B02,083216,Anzaldo; Leesa B,0,6,30,30
1650748680195,MATH 142A,A01,083219,Chow; Bennett,0,16,30,30
1650748680195,MATH 142A,A02,083220,Chow; Bennett,0,15,30,30
1650748680195,MATH 142A,B01,083221,Chow; Bennett,0,15,30,30
1650748680195,MATH 142A,B02,083222,Chow; Bennett,0,14,30,30
1650748686220,MATH 193A,A01,083224,Staff,0,5,30,30
1650748686220,MATH 193A,A02,083225,Staff,0,6,30,30
1650748686220,MATH 193A,A03,083781,Staff,0,6,30,30
1650748686220,MATH 193A,A04,083782,Staff,0,7,30,30
1650748692242,MATH 197,001,091859,McAuley; Julian John,9998,0,9999,1
1650748698293,COGS 9,A01,083615,Staff,1,15,60,59
1650748704316,COGS 11,A01,083617,Boyle; Mary E. T.,16,0,40,24
1650748710341,COGS 13,A01,083071,Staff,0,38,40,40
1650748716365,COGS 14A,A01,092681,Staff,0,36,100,100
1650748722394,COGS 14B,A01,083073,Cheng; Tzu-Han,1,13,50,49
1650748728420,COGS 17,A01,092677,Staff,11,0,75,64
1650748734445,COGS 100,A01,083619,Staff,0,28,60,60
1650748740473,COGS 101A,A01,083621,Davis; Joshua Daniel,0,27,60,60
1650748746497,COGS 101B,A01,091572,Staff,1,4,60,59
1650748752520,COGS 101C,A01,083625,Delgado; Tania,14,0,30,16
1650748758547,COGS 107A,A01,083627,Boyle; Mary E. T.,0,16,60,60
1650748764572,COGS 118A,A01,083075,Staff,0,8,60,60
1650748770595,CSE 3,A50,083646,Miranda; Gregory Joseph,18,0,38,20
1650748770595,CSE 3,A51,083647,Miranda; Gregory Joseph,36,0,37,1
1650748776619,CSE 8A,A50,083650,Miranda; Gregory Joseph,0,30,40,40
1650748782642,CSE 11,A01,083080,Cao; Yingjun,0,96,40,40
1650748788669,CSE 12,A01,083652,Staff,0,21,100,100
1650748794691,CSE 15L,A01,083654,Staff,0,3,50,50
1650748794691,CSE 15L,A02,083655,Staff,0,2,50,50
1650748800718,CSE 20,A01,083657,Staff,49,0,80,31
1650748806741,CSE 30,A01,083084,Eldon; John,0,77,40,40
1650748812769,CSE 100,A01,083659,Cao; Yingjun,0,71,50,50
1650748818790,CSE 134B,A01,083661,Powell; Thomas Allan,0,38,65,65
1650748824814,CSE 140,A01,083663,Staff,0,11,75,75
1650748830837,CSE 140L,A01,083088,Eldon; John,0,20,75,75
1650748836861,CSE 175,A01,083665,Kumar; Rakesh,7,0,25,18
1650748842886,CSE 190,A00,092507,Dubnov; Shlomo,10,0,20,10
1650748848914,ECE 45,A01,083139,Staff,1,2,60,59
1650748854938,ECE 65,A50,083695,Staff,0,5,30,30
1650748860965,ECE 109,A01,091882,Touri; Behrouz,33,0,70,37
1650748866989,ECE 180,A00,083140,Abi Samra; Nicholas Camill,20,0,30,10
1650748866989,ECE 180,B00,083141,Abi Samra; Nicholas Camill,0,0,30,30
1650748873013,MATH 10A,A01,083735,Patchell; Gregory David,2,0,30,28
1650748873013,MATH 10A,A02,083736,Patchell; Gregory David,27,0,30,3
1650748873013,MATH 10A,A03,083737,Patchell; Gregory David,24,0,30,6
1650748879041,MATH 10B,A01,083207,Staff,0,9,30,30
1650748879041,MATH 10B,A02,083208,Staff,1,7,30,29
1650748879041,MATH 10B,B01,083739,Staff,11,0,30,19
1650748879041,MATH 10B,B02,083740,Staff,28,0,30,2
1650748885072,MATH 18,A01,083743,Staff,0,0,30,30
1650748885072,MATH 18,A02,083744,Staff,23,0,30,7
1650748885072,MATH 18,A03,083745,Staff,21,0,30,9
1650748885072,MATH 18,A04,083746,Staff,26,0,30,4
1650748885072,MATH 18,B01,083748,Staff,0,15,30,30
1650748885072,MATH 18,B02,083749,Staff,0,12,30,30
1650748885072,MATH 18,B03,083750,Staff,0,12,30,30
1650748885072,MATH 18,B04,083751,Staff,0,12,30,30
1650748891098,MATH 20A,A01,083754,Staff,19,0,40,21
1650748897126,MATH 20B,A01,083756,Staff,0,12,30,30
1650748897126,MATH 20B,A02,083757,Staff,0,12,30,30
1650748903149,MATH 20C,A01,083760,Staff,0,16,30,30
1650748903149,MATH 20C,A02,083761,Staff,0,16,30,30
1650748903149,MATH 20C,B01,083762,Staff,10,0,30,20
1650748903149,MATH 20C,B02,083763,Staff,28,0,30,2
1650748909172,MATH 20D,A01,083765,Staff,2,1,30,28
1650748909172,MATH 20D,A02,083766,Staff,6,0,30,24
1650748909172,MATH 20D,A03,083767,Staff,24,0,30,6
1650748915199,MATH 20E,A01,083771,Staff,3,0,30,27
1650748915199,MATH 20E,A02,083772,Staff,16,0,30,14
1650748915199,MATH 20E,B01,083773,Staff,0,0,30,30
1650748915199,MATH 20E,B02,083774,Staff,6,0,30,24
1650748921223,MATH 103A,A01,083777,Staff,0,16,30,30
1650748921223,MATH 103A,A02,083778,Staff,0,15,30,30
1650748921223,MATH 103A,B01,083779,Staff,0,15,30,30
1650748921223,MATH 103A,B02,083780,Staff,0,15,30,30
1650748927247,MATH 105,A01,085443,Staff,0,22,30,30
1650748933282,MATH 109,A01,083213,Anzaldo; Leesa B,0,7,30,30
1650748933282,MATH 109,A02,083214,Anzaldo; Leesa B,0,7,30,30
1650748933282,MATH 109,B01,083215,Anzaldo; Leesa B,0,8,30,30
1650748933282,MATH 109,B02,083216,Anzaldo; Leesa B,0,6,30,30
1650748939306,MATH 142A,A01,083219,Chow; Bennett,0,16,30,30
1650748939306,MATH 142A,A02,083220,Chow; Bennett,0,15,30,30
1650748939306,MATH 142A,B01,083221,Chow; Bennett,0,15,30,30
1650748939306,MATH 142A,B02,083222,Chow; Bennett,0,14,30,30
1650748945407,MATH 193A,A01,083224,Staff,0,5,30,30
1650748945407,MATH 193A,A02,083225,Staff,0,6,30,30
1650748945407,MATH 193A,A03,083781,Staff,0,6,30,30
1650748945407,MATH 193A,A04,083782,Staff,0,7,30,30
1650748951430,MATH 197,001,091859,McAuley; Julian John,9998,0,9999,1
1650748957478,COGS 9,A01,083615,Staff,1,15,60,59
1650748963513,COGS 11,A01,083617,Boyle; Mary E. T.,16,0,40,24
1650748969540,COGS 13,A01,083071,Staff,0,38,40,40
1650748975564,COGS 14A,A01,092681,Staff,0,36,100,100
1650748981592,COGS 14B,A01,083073,Cheng; Tzu-Han,1,13,50,49
1650748987614,COGS 17,A01,092677,Staff,11,0,75,64
1650748993637,COGS 100,A01,083619,Staff,0,28,60,60
1650748999659,COGS 101A,A01,083621,Davis; Joshua Daniel,0,27,60,60
1650749005683,COGS 101B,A01,091572,Staff,1,4,60,59
1650749011710,COGS 101C,A01,083625,Delgado; Tania,14,0,30,16
1650749017736,COGS 107A,A01,083627,Boyle; Mary E. T.,0,16,60,60
1650749023761,COGS 118A,A01,083075,Staff,0,8,60,60
1650749029786,CSE 3,A50,083646,Miranda; Gregory Joseph,18,0,38,20
1650749029786,CSE 3,A51,083647,Miranda; Gregory Joseph,36,0,37,1
1650749035811,CSE 8A,A50,083650,Miranda; Gregory Joseph,0,30,40,40
1650749041835,CSE 11,A01,083080,Cao; Yingjun,0,96,40,40
1650749047861,CSE 12,A01,083652,Staff,0,21,100,100
1650749053890,CSE 15L,A01,083654,Staff,0,3,50,50
1650749053890,CSE 15L,A02,083655,Staff,0,2,50,50
1650749059917,CSE 20,A01,083657,Staff,49,0,80,31
1650749065941,CSE 30,A01,083084,Eldon; John,0,77,40,40
1650749071967,CSE 100,A01,083659,Cao; Yingjun,0,71,50,50
1650749077991,CSE 134B,A01,083661,Powell; Thomas Allan,0,38,65,65
1650749084018,CSE 140,A01,083663,Staff,0,11,75,75
1650749090041,CSE 140L,A01,083088,Eldon; John,0,20,75,75
1650749096065,CSE 175,A01,083665,Kumar; Rakesh,7,0,25,18
1650749102093,CSE 190,A00,092507,Dubnov; Shlomo,10,0,20,10
1650749108116,ECE 45,A01,083139,Staff,1,2,60,59
1650749114140,ECE 65,A50,083695,Staff,0,5,30,30
1650749120168,ECE 109,A01,091882,Touri; Behrouz,33,0,70,37
1650749126189,ECE 180,A00,083140,Abi Samra; Nicholas Camill,20,0,30,10
1650749126189,ECE 180,B00,083141,Abi Samra; Nicholas Camill,0,0,30,30
1650749132216,MATH 10A,A01,083735,Patchell; Gregory David,2,0,30,28
1650749132216,MATH 10A,A02,083736,Patchell; Gregory David,27,0,30,3
1650749132216,MATH 10A,A03,083737,Patchell; Gregory David,24,0,30,6
1650749138244,MATH 10B,A01,083207,Staff,0,9,30,30
1650749138244,MATH 10B,A02,083208,Staff,1,7,30,29
1650749138244,MATH 10B,B01,083739,Staff,11,0,30,19
1650749138244,MATH 10B,B02,083740,Staff,28,0,30,2
1650749144273,MATH 18,A01,083743,Staff,0,0,30,30
1650749144273,MATH 18,A02,083744,Staff,23,0,30,7
1650749144273,MATH 18,A03,083745,Staff,21,0,30,9
1650749144273,MATH 18,A04,083746,Staff,26,0,30,4
1650749144273,MATH 18,B01,083748,Staff,0,15,30,30
1650749144273,MATH 18,B02,083749,Staff,0,12,30,30
1650749144273,MATH 18,B03,083750,Staff,0,12,30,30
1650749144273,MATH 18,B04,083751,Staff,0,12,30,30
1650749150298,MATH 20A,A01,083754,Staff,19,0,40,21
1650749156322,MATH 20B,A01,083756,Staff,0,12,30,30
1650749156322,MATH 20B,A02,083757,Staff,0,12,30,30
1650749162344,MATH 20C,A01,083760,Staff,0,16,30,30
1650749162344,MATH 20C,A02,083761,Staff,0,16,30,30
1650749162344,MATH 20C,B01,083762,Staff,10,0,30,20
1650749162344,MATH 20C,B02,083763,Staff,28,0,30,2
1650749168379,MATH 20D,A01,083765,Staff,2,1,30,28
1650749168379,MATH 20D,A02,083766,Staff,6,0,30,24
1650749168379,MATH 20D,A03,083767,Staff,24,0,30,6
1650749174407,MATH 20E,A01,083771,Staff,3,0,30,27
1650749174407,MATH 20E,A02,083772,Staff,16,0,30,14
1650749174407,MATH 20E,B01,083773,Staff,0,0,30,30
1650749174407,MATH 20E,B02,083774,Staff,6,0,30,24
1650749180438,MATH 103A,A01,083777,Staff,0,16,30,30
1650749180438,MATH 103A,A02,083778,Staff,0,15,30,30
1650749180438,MATH 103A,B01,083779,Staff,0,15,30,30
1650749180438,MATH 103A,B02,083780,Staff,0,15,30,30
1650749186463,MATH 105,A01,085443,Staff,0,22,30,30
1650749192490,MATH 109,A01,083213,Anzaldo; Leesa B,0,7,30,30
1650749192490,MATH 109,A02,083214,Anzaldo; Leesa B,0,7,30,30
1650749192490,MATH 109,B01,083215,Anzaldo; Leesa B,0,8,30,30
1650749192490,MATH 109,B02,083216,Anzaldo; Leesa B,0,6,30,30
1650749198515,MATH 142A,A01,083219,Chow; Bennett,0,16,30,30
1650749198515,MATH 142A,A02,083220,Chow; Bennett,0,15,30,30
1650749198515,MATH 142A,B01,083221,Chow; Bennett,0,15,30,30
1650749198515,MATH 142A,B02,083222,Chow; Bennett,0,14,30,30
1650749204539,MATH 193A,A01,083224,Staff,0,5,30,30
1650749204539,MATH 193A,A02,083225,Staff,0,6,30,30
1650749204539,MATH 193A,A03,083781,Staff,0,6,30,30
1650749204539,MATH 193A,A04,083782,Staff,0,7,30,30
1650749210566,MATH 197,001,091859,McAuley; Julian John,9998,0,9999,1
1650749216614,COGS 9,A01,083615,Staff,1,15,60,59
1650749222639,COGS 11,A01,083617,Boyle; Mary E. T.,16,0,40,24
1650749228666,COGS 13,A01,083071,Staff,0,38,40,40
1650749234688,COGS 14A,A01,092681,Staff,0,36,100,100
1650749240712,COGS 14B,A01,083073,Cheng; Tzu-Han,1,13,50,49
1650749246740,COGS 17,A01,092677,Staff,11,0,75,64
1650749252764,COGS 100,A01,083619,Staff,0,28,60,60
1650749258789,COGS 101A,A01,083621,Davis; Joshua Daniel,0,27,60,60
1650749264812,COGS 101B,A01,091572,Staff,1,4,60,59
1650749270843,COGS 101C,A01,083625,Delgado; Tania,14,0,30,16
1650749276867,COGS 107A,A01,083627,Boyle; Mary E. T.,0,16,60,60
1650749282890,COGS 118A,A01,083075,Staff,0,8,60,60
1650749288912,CSE 3,A50,083646,Miranda; Gregory Joseph,18,0,38,20
1650749288912,CSE 3,A51,083647,Miranda; Gregory Joseph,36,0,37,1
1650749294940,CSE 8A,A50,083650,Miranda; Gregory Joseph,0,30,40,40
1650749300978,CSE 11,A01,083080,Cao; Yingjun,0,96,40,40
1650749307004,CSE 12,A01,083652,Staff,0,21,100,100
1650749313029,CSE 15L,A01,083654,Staff,0,3,50,50
1650749313029,CSE 15L,A02,083655,Staff,0,2,50,50
1650749319060,CSE 20,A01,083657,Staff,49,0,80,31
1650749325084,CSE 30,A01,083084,Eldon; John,0,77,40,40
1650749331115,CSE 100,A01,083659,Cao; Yingjun,0,71,50,50
1650749337138,CSE 134B,A01,083661,Powell; Thomas Allan,0,38,65,65
1650749343165,CSE 140,A01,083663,Staff,0,11,75,75
1650749349189,CSE 140L,A01,083088,Eldon; John,0,20,75,75
1650749355213,CSE 175,A01,083665,Kumar; Rakesh,7,0,25,18
1650749361238,CSE 190,A00,092507,Dubnov; Shlomo,10,0,20,10
1650749367271,ECE 45,A01,083139,Staff,1,2,60,59
1650749373295,ECE 65,A50,083695,Staff,0,5,30,30
1650749379320,ECE 109,A01,091882,Touri; Behrouz,33,0,70,37
1650749385343,ECE 180,A00,083140,Abi Samra; Nicholas Camill,20,0,30,10
1650749385343,ECE 180,B00,083141,Abi Samra; Nicholas Camill,0,0,30,30
1650749391373,MATH 10A,A01,083735,Patchell; Gregory David,2,0,30,28
1650749391373,MATH 10A,A02,083736,Patchell; Gregory David,27,0,30,3
1650749391373,MATH 10A,A03,083737,Patchell; Gregory David,24,0,30,6
1650749397396,MATH 10B,A01,083207,Staff,0,9,30,30
1650749397396,MATH 10B,A02,083208,Staff,1,7,30,29
1650749397396,MATH 10B,B01,083739,Staff,11,0,30,19
1650749397396,MATH 10B,B02,083740,Staff,28,0,30,2
1650749403423,MATH 18,A01,083743,Staff,0,0,30,30
1650749403423,MATH 18,A02,083744,Staff,23,0,30,7
1650749403423,MATH 18,A03,083745,Staff,21,0,30,9
1650749403423,MATH 18,A04,083746,Staff,26,0,30,4
1650749403423,MATH 18,B01,083748,Staff,0,15,30,30
1650749403423,MATH 18,B02,083749,Staff,0,12,30,30
1650749403423,MATH 18,B03,083750,Staff,0,12,30,30
1650749403423,MATH 18,B04,083751,Staff,0,12,30,30
1650749409449,MATH 20A,A01,083754,Staff,19,0,40,21
1650749415472,MATH 20B,A01,083756,Staff,0,12,30,30
1650749415472,MATH 20B,A02,083757,Staff,0,12,30,30
1650749421499,MATH 20C,A01,083760,Staff,0,16,30,30
1650749421499,MATH 20C,A02,083761,Staff,0,16,30,30
1650749421499,MATH 20C,B01,083762,Staff,10,0,30,20
1650749421499,MATH 20C,B02,083763,Staff,28,0,30,2
1650749427523,MATH 20D,A01,083765,Staff,2,1,30,28
1650749427523,MATH 20D,A02,083766,Staff,6,0,30,24
1650749427523,MATH 20D,A03,083767,Staff,24,0,30,6
1650749433547,MATH 20E,A01,083771,Staff,3,0,30,27
1650749433547,MATH 20E,A02,083772,Staff,16,0,30,14
1650749433547,MATH 20E,B01,083773,Staff,0,0,30,30
1650749433547,MATH 20E,B02,083774,Staff,6,0,30,24
1650749439570,MATH 103A,A01,083777,Staff,0,16,30,30
1650749439570,MATH 103A,A02,083778,Staff,0,15,30,30
1650749439570,MATH 103A,B01,083779,Staff,0,15,30,30
1650749439570,MATH 103A,B02,083780,Staff,0,15,30,30
1650749445596,MATH 105,A01,085443,Staff,0,22,30,30
1650749451618,MATH 109,A01,083213,Anzaldo; Leesa B,0,7,30,30
1650749451618,MATH 109,A02,083214,Anzaldo; Leesa B,0,7,30,30
1650749451618,MATH 109,B01,083215,Anzaldo; Leesa B,0,8,30,30
1650749451618,MATH 109,B02,083216,Anzaldo; Leesa B,0,6,30,30
1650749457647,MATH 142A,A01,083219,Chow; Bennett,0,16,30,30
1650749457647,MATH 142A,A02,083220,Chow; Bennett,0,15,30,30
1650749457647,MATH 142A,B01,083221,Chow; Bennett,0,15,30,30
1650749457647,MATH 142A,B02,083222,Chow; Bennett,0,14,30,30
1650749463671,MATH 193A,A01,083224,Staff,0,5,30,30
1650749463671,MATH 193A,A02,083225,Staff,0,6,30,30
1650749463671,MATH 193A,A03,083781,Staff,0,6,30,30
1650749463671,MATH 193A,A04,083782,Staff,0,7,30,30
1650749469698,MATH 197,001,091859,McAuley; Julian John,9998,0,9999,1
1650749475765,COGS 9,A01,083615,Staff,1,15,60,59
1650749481789,COGS 11,A01,083617,Boyle; Mary E. T.,16,0,40,24
1650749487812,COGS 13,A01,083071,Staff,0,38,40,40
1650749493838,COGS 14A,A01,092681,Staff,0,36,100,100
1650749499867,COGS 14B,A01,083073,Cheng; Tzu-Han,1,13,50,49
1650749505891,COGS 17,A01,092677,Staff,11,0,75,64
1650749511916,COGS 100,A01,083619,Staff,0,28,60,60
1650749517968,COGS 101A,A01,083621,Davis; Joshua Daniel,0,27,60,60
1650749523996,COGS 101B,A01,091572,Staff,1,4,60,59
1650749530022,COGS 101C,A01,083625,Delgado; Tania,14,0,30,16
1650749536136,COGS 107A,A01,083627,Boyle; Mary E. T.,0,16,60,60
1650749542172,COGS 118A,A01,083075,Staff,0,8,60,60
1650749548200,CSE 3,A50,083646,Miranda; Gregory Joseph,18,0,38,20
1650749548200,CSE 3,A51,083647,Miranda; Gregory Joseph,36,0,37,1
1650749554225,CSE 8A,A50,083650,Miranda; Gregory Joseph,0,30,40,40
1650749560251,CSE 11,A01,083080,Cao; Yingjun,0,96,40,40
1650749566278,CSE 12,A01,083652,Staff,0,21,100,100
1650749572301,CSE 15L,A01,083654,Staff,0,3,50,50
1650749572301,CSE 15L,A02,083655,Staff,0,2,50,50
1650749578330,CSE 20,A01,083657,Staff,49,0,80,31
1650749584356,CSE 30,A01,083084,Eldon; John,0,77,40,40
1650749590381,CSE 100,A01,083659,Cao; Yingjun,0,71,50,50
1650749596404,CSE 134B,A01,083661,Powell; Thomas Allan,0,38,65,65
1650749602428,CSE 140,A01,083663,Staff,0,11,75,75
1650749608452,CSE 140L,A01,083088,Eldon; John,0,20,75,75
1650749614476,CSE 175,A01,083665,Kumar; Rakesh,7,0,25,18
1650749620500,CSE 190,A00,092507,Dubnov; Shlomo,10,0,20,10
1650749626528,ECE 45,A01,083139,Staff,1,2,60,59
1650749632553,ECE 65,A50,083695,Staff,0,5,30,30
1650749638578,ECE 109,A01,091882,Touri; Behrouz,33,0,70,37
1650749644604,ECE 180,A00,083140,Abi Samra; Nicholas Camill,20,0,30,10
1650749644604,ECE 180,B00,083141,Abi Samra; Nicholas Camill,0,0,30,30
1650749650644,MATH 10A,A01,083735,Patchell; Gregory David,2,0,30,28
1650749650644,MATH 10A,A02,083736,Patchell; Gregory David,27,0,30,3
1650749650644,MATH 10A,A03,083737,Patchell; Gregory David,24,0,30,6
1650749656669,MATH 10B,A01,083207,Staff,0,9,30,30
1650749656669,MATH 10B,A02,083208,Staff,1,7,30,29
1650749656669,MATH 10B,B01,083739,Staff,11,0,30,19
1650749656669,MATH 10B,B02,083740,Staff,28,0,30,2
1650749662695,MATH 18,A01,083743,Staff,0,0,30,30
1650749662695,MATH 18,A02,083744,Staff,23,0,30,7
1650749662695,MATH 18,A03,083745,Staff,21,0,30,9
1650749662695,MATH 18,A04,083746,Staff,26,0,30,4
1650749662695,MATH 18,B01,083748,Staff,0,15,30,30
1650749662695,MATH 18,B02,083749,Staff,0,12,30,30
1650749662695,MATH 18,B03,083750,Staff,0,12,30,30
1650749662695,MATH 18,B04,083751,Staff,0,12,30,30
1650749668717,MATH 20A,A01,083754,Staff,19,0,40,21
1650749674745,MATH 20B,A01,083756,Staff,0,12,30,30
1650749674745,MATH 20B,A02,083757,Staff,0,12,30,30
1650749680773,MATH 20C,A01,083760,Staff,0,16,30,30
1650749680773,MATH 20C,A02,083761,Staff,0,16,30,30
1650749680773,MATH 20C,B01,083762,Staff,10,0,30,20
1650749680773,MATH 20C,B02,083763,Staff,28,0,30,2
1650749686800,MATH 20D,A01,083765,Staff,2,1,30,28
1650749686800,MATH 20D,A02,083766,Staff,5,0,30,25
1650749686800,MATH 20D,A03,083767,Staff,24,0,30,6
1650749692825,MATH 20E,A01,083771,Staff,3,0,30,27
1650749692825,MATH 20E,A02,083772,Staff,16,0,30,14
1650749692825,MATH 20E,B01,083773,Staff,0,0,30,30
1650749692825,MATH 20E,B02,083774,Staff,6,0,30,24
1650749698854,MATH 103A,A01,083777,Staff,0,16,30,30
1650749698854,MATH 103A,A02,083778,Staff,0,15,30,30
1650749698854,MATH 103A,B01,083779,Staff,0,15,30,30
1650749698854,MATH 103A,B02,083780,Staff,0,15,30,30
1650749704876,MATH 105,A01,085443,Staff,0,22,30,30
1650749710902,MATH 109,A01,083213,Anzaldo; Leesa B,0,7,30,30
1650749710902,MATH 109,A02,083214,Anzaldo; Leesa B,0,7,30,30
1650749710902,MATH 109,B01,083215,Anzaldo; Leesa B,0,8,30,30
1650749710902,MATH 109,B02,083216,Anzaldo; Leesa B,0,6,30,30
1650749716936,MATH 142A,A01,083219,Chow; Bennett,0,16,30,30
1650749716936,MATH 142A,A02,083220,Chow; Bennett,0,15,30,30
1650749716936,MATH 142A,B01,083221,Chow; Bennett,0,15,30,30
1650749716936,MATH 142A,B02,083222,Chow; Bennett,0,14,30,30
1650749722961,MATH 193A,A01,083224,Staff,0,5,30,30
1650749722961,MATH 193A,A02,083225,Staff,0,6,30,30
1650749722961,MATH 193A,A03,083781,Staff,0,6,30,30
1650749722961,MATH 193A,A04,083782,Staff,0,7,30,30
1650749728985,MATH 197,001,091859,McAuley; Julian John,9998,0,9999,1
1650749735041,COGS 9,A01,083615,Staff,1,15,60,59
1650749741069,COGS 11,A01,083617,Boyle; Mary E. T.,16,0,40,24
1650749747092,COGS 13,A01,083071,Staff,0,38,40,40
1650749753120,COGS 14A,A01,092681,Staff,0,36,100,100
1650749759143,COGS 14B,A01,083073,Cheng; Tzu-Han,1,13,50,49
1650749765171,COGS 17,A01,092677,Staff,11,0,75,64
1650749771194,COGS 100,A01,083619,Staff,0,28,60,60
1650749777217,COGS 101A,A01,083621,Davis; Joshua Daniel,0,27,60,60
1650749783244,COGS 101B,A01,091572,Staff,1,4,60,59
1650749789268,COGS 101C,A01,083625,Delgado; Tania,14,0,30,16
1650749795298,COGS 107A,A01,083627,Boyle; Mary E. T.,0,16,60,60
1650749801326,COGS 118A,A01,083075,Staff,0,8,60,60
1650749807350,CSE 3,A50,083646,Miranda; Gregory Joseph,18,0,38,20
1650749807350,CSE 3,A51,083647,Miranda; Gregory Joseph,36,0,37,1
1650749813374,CSE 8A,A50,083650,Miranda; Gregory Joseph,0,30,40,40
1650749819542,CSE 11,A01,083080,Cao; Yingjun,0,96,40,40
1650749825569,CSE 12,A01,083652,Staff,0,21,100,100
1650749831596,CSE 15L,A01,083654,Staff,0,3,50,50
1650749831596,CSE 15L,A02,083655,Staff,0,2,50,50
1650749837621,CSE 20,A01,083657,Staff,49,0,80,31
1650749843652,CSE 30,A01,083084,Eldon; John,0,77,40,40
1650749849679,CSE 100,A01,083659,Cao; Yingjun,0,71,50,50
1650749855706,CSE 134B,A01,083661,Powell; Thomas Allan,0,38,65,65
1650749861734,CSE 140,A01,083663,Staff,0,11,75,75
1650749867761,CSE 140L,A01,083088,Eldon; John,0,20,75,75
1650749873788,CSE 175,A01,083665,Kumar; Rakesh,7,0,25,18
1650749879814,CSE 190,A00,092507,Dubnov; Shlomo,10,0,20,10
1650749885839,ECE 45,A01,083139,Staff,1,2,60,59
1650749891866,ECE 65,A50,083695,Staff,0,5,30,30
1650749897893,ECE 109,A01,091882,Touri; Behrouz,33,0,70,37
1650749903920,ECE 180,A00,083140,Abi Samra; Nicholas Camill,20,0,30,10
1650749903920,ECE 180,B00,083141,Abi Samra; Nicholas Camill,0,0,30,30
1650749909949,MATH 10A,A01,083735,Patchell; Gregory David,2,0,30,28
1650749909949,MATH 10A,A02,083736,Patchell; Gregory David,27,0,30,3
1650749909949,MATH 10A,A03,083737,Patchell; Gregory David,24,0,30,6
1650749915996,MATH 10B,A01,083207,Staff,0,9,30,30
1650749915996,MATH 10B,A02,083208,Staff,1,7,30,29
1650749915996,MATH 10B,B01,083739,Staff,11,0,30,19
1650749915996,MATH 10B,B02,083740,Staff,28,0,30,2
1650749922021,MATH 18,A01,083743,Staff,0,0,30,30
1650749922021,MATH 18,A02,083744,Staff,23,0,30,7
1650749922021,MATH 18,A03,083745,Staff,21,0,30,9
1650749922021,MATH 18,A04,083746,Staff,26,0,30,4
1650749922021,MATH 18,B01,083748,Staff,0,15,30,30
1650749922021,MATH 18,B02,083749,Staff,0,12,30,30
1650749922021,MATH 18,B03,083750,Staff,0,12,30,30
1650749922021,MATH 18,B04,083751,Staff,0,12,30,30
1650749928049,MATH 20A,A01,083754,Staff,19,0,40,21
1650749934092,MATH 20B,A01,083756,Staff,0,12,30,30
1650749934092,MATH 20B,A02,083757,Staff,0,12,30,30
1650749940119,MATH 20C,A01,083760,Staff,0,16,30,30
1650749940119,MATH 20C,A02,083761,Staff,0,16,30,30
1650749940119,MATH 20C,B01,083762,Staff,10,0,30,20
1650749940119,MATH 20C,B02,083763,Staff,28,0,30,2
1650749946143,MATH 20D,A01,083765,Staff,2,1,30,28
1650749946143,MATH 20D,A02,083766,Staff,5,0,30,25
1650749946143,MATH 20D,A03,083767,Staff,24,0,30,6
1650749952167,MATH 20E,A01,083771,Staff,3,0,30,27
1650749952167,MATH 20E,A02,083772,Staff,16,0,30,14
1650749952167,MATH 20E,B01,083773,Staff,0,0,30,30
1650749952167,MATH 20E,B02,083774,Staff,6,0,30,24
1650749958192,MATH 103A,A01,083777,Staff,0,16,30,30
1650749958192,MATH 103A,A02,083778,Staff,0,15,30,30
1650749958192,MATH 103A,B01,083779,Staff,0,15,30,30
1650749958192,MATH 103A,B02,083780,Staff,0,15,30,30
1650749964216,MATH 105,A01,085443,Staff,0,22,30,30
1650749970241,MATH 109,A01,083213,Anzaldo; Leesa B,0,7,30,30
1650749970241,MATH 109,A02,083214,Anzaldo; Leesa B,0,7,30,30
1650749970241,MATH 109,B01,083215,Anzaldo; Leesa B,0,8,30,30
1650749970241,MATH 109,B02,083216,Anzaldo; Leesa B,0,6,30,30
1650749976266,MATH 142A,A01,083219,Chow; Bennett,0,16,30,30
1650749976266,MATH 142A,A02,083220,Chow; Bennett,0,15,30,30
1650749976266,MATH 142A,B01,083221,Chow; Bennett,0,15,30,30
1650749976266,MATH 142A,B02,083222,Chow; Bennett,0,14,30,30
1650749982291,MATH 193A,A01,083224,Staff,0,5,30,30
1650749982291,MATH 193A,A02,083225,Staff,0,6,30,30
1650749982291,MATH 193A,A03,083781,Staff,0,6,30,30
1650749982291,MATH 193A,A04,083782,Staff,0,7,30,30
1650749988316,MATH 197,001,091859,McAuley; Julian John,9998,0,9999,1
1650749994381,COGS 9,A01,083615,Staff,1,15,60,59
1650750000405,COGS 11,A01,083617,Boyle; Mary E. T.,16,0,40,24
1650750006432,COGS 13,A01,083071,Staff,0,38,40,40
1650750012454,COGS 14A,A01,092681,Staff,0,36,100,100
1650750018476,COGS 14B,A01,083073,Cheng; Tzu-Han,1,13,50,49
1650750024501,COGS 17,A01,092677,Staff,11,0,75,64
1650750030525,COGS 100,A01,083619,Staff,0,28,60,60
1650750036550,COGS 101A,A01,083621,Davis; Joshua Daniel,0,27,60,60
1650750042572,COGS 101B,A01,091572,Staff,1,4,60,59
1650750048598,COGS 101C,A01,083625,Delgado; Tania,14,0,30,16
1650750054622,COGS 107A,A01,083627,Boyle; Mary E. T.,0,16,60,60
1650750060646,COGS 118A,A01,083075,Staff,0,8,60,60
1650750066674,CSE 3,A50,083646,Miranda; Gregory Joseph,18,0,38,20
1650750066674,CSE 3,A51,083647,Miranda; Gregory Joseph,36,0,37,1
1650750072696,CSE 8A,A50,083650,Miranda; Gregory Joseph,0,30,40,40
1650750078719,CSE 11,A01,083080,Cao; Yingjun,0,96,40,40
1650750084743,CSE 12,A01,083652,Staff,0,21,100,100
1650750090767,CSE 15L,A01,083654,Staff,0,3,50,50
1650750090767,CSE 15L,A02,083655,Staff,0,2,50,50
1650750096794,CSE 20,A01,083657,Staff,49,0,80,31
1650750102824,CSE 30,A01,083084,Eldon; John,0,77,40,40
1650750108849,CSE 100,A01,083659,Cao; Yingjun,0,71,50,50
1650750114873,CSE 134B,A01,083661,Powell; Thomas Allan,0,38,65,65
1650750120900,CSE 140,A01,083663,Staff,0,11,75,75
1650750126927,CSE 140L,A01,083088,Eldon; John,0,20,75,75
1650750133048,CSE 175,A01,083665,Kumar; Rakesh,7,0,25,18
1650750139076,CSE 190,A00,092507,Dubnov; Shlomo,10,0,20,10
1650750145109,ECE 45,A01,083139,Staff,1,2,60,59
1650750151136,ECE 65,A50,083695,Staff,0,5,30,30
1650750157158,ECE 109,A01,091882,Touri; Behrouz,33,0,70,37
1650750163186,ECE 180,A00,083140,Abi Samra; Nicholas Camill,20,0,30,10
1650750163186,ECE 180,B00,083141,Abi Samra; Nicholas Camill,0,0,30,30
1650750169210,MATH 10A,A01,083735,Patchell; Gregory David,2,0,30,28
1650750169210,MATH 10A,A02,083736,Patchell; Gregory David,27,0,30,3
1650750169210,MATH 10A,A03,083737,Patchell; Gregory David,24,0,30,6
1650750175236,MATH 10B,A01,083207,Staff,0,9,30,30
1650750175236,MATH 10B,A02,083208,Staff,1,7,30,29
1650750175236,MATH 10B,B01,083739,Staff,11,0,30,19
1650750175236,MATH 10B,B02,083740,Staff,28,0,30,2
1650750181259,MATH 18,A01,083743,Staff,0,0,30,30
1650750181259,MATH 18,A02,083744,Staff,23,0,30,7
1650750181259,MATH 18,A03,083745,Staff,21,0,30,9
1650750181259,MATH 18,A04,083746,Staff,26,0,30,4
1650750181259,MATH 18,B01,083748,Staff,0,15,30,30
1650750181259,MATH 18,B02,083749,Staff,0,12,30,30
1650750181259,MATH 18,B03,083750,Staff,0,12,30,30
1650750181259,MATH 18,B04,083751,Staff,0,12,30,30
1650750187283,MATH 20A,A01,083754,Staff,19,0,40,21
1650750193311,MATH 20B,A01,083756,Staff,0,12,30,30
1650750193311,MATH 20B,A02,083757,Staff,0,12,30,30
1650750199340,MATH 20C,A01,083760,Staff,0,16,30,30
1650750199340,MATH 20C,A02,083761,Staff,0,16,30,30
1650750199340,MATH 20C,B01,083762,Staff,10,0,30,20
1650750199340,MATH 20C,B02,083763,Staff,28,0,30,2
1650750205367,MATH 20D,A01,083765,Staff,2,1,30,28
1650750205367,MATH 20D,A02,083766,Staff,5,0,30,25
1650750205367,MATH 20D,A03,083767,Staff,24,0,30,6
1650750211391,MATH 20E,A01,083771,Staff,3,0,30,27
1650750211391,MATH 20E,A02,083772,Staff,16,0,30,14
1650750211391,MATH 20E,B01,083773,Staff,0,0,30,30
1650750211391,MATH 20E,B02,083774,Staff,6,0,30,24
1650750217416,MATH 103A,A01,083777,Staff,0,16,30,30
1650750217416,MATH 103A,A02,083778,Staff,0,15,30,30
1650750217416,MATH 103A,B01,083779,Staff,0,15,30,30
1650750217416,MATH 103A,B02,083780,Staff,0,15,30,30
1650750223441,MATH 105,A01,085443,Staff,0,22,30,30
1650750229470,MATH 109,A01,083213,Anzaldo; Leesa B,0,7,30,30
1650750229470,MATH 109,A02,083214,Anzaldo; Leesa B,0,7,30,30
1650750229470,MATH 109,B01,083215,Anzaldo; Leesa B,0,8,30,30
1650750229470,MATH 109,B02,083216,Anzaldo; Leesa B,0,6,30,30
1650750235504,MATH 142A,A01,083219,Chow; Bennett,0,16,30,30
1650750235504,MATH 142A,A02,083220,Chow; Bennett,0,15,30,30
1650750235504,MATH 142A,B01,083221,Chow; Bennett,0,15,30,30
1650750235504,MATH 142A,B02,083222,Chow; Bennett,0,14,30,30
1650750241531,MATH 193A,A01,083224,Staff,0,5,30,30
1650750241531,MATH 193A,A02,083225,Staff,0,6,30,30
1650750241531,MATH 193A,A03,083781,Staff,0,6,30,30
1650750241531,MATH 193A,A04,083782,Staff,0,7,30,30
1650750247567,MATH 197,001,091859,McAuley; Julian John,9998,0,9999,1
1650750253627,COGS 9,A01,083615,Staff,1,15,60,59
1650750259651,COGS 11,A01,083617,Boyle; Mary E. T.,16,0,40,24
1650750265683,COGS 13,A01,083071,Staff,0,38,40,40
1650750271706,COGS 14A,A01,092681,Staff,0,36,100,100
1650750277734,COGS 14B,A01,083073,Cheng; Tzu-Han,1,13,50,49
1650750283758,COGS 17,A01,092677,Staff,11,0,75,64
1650750289783,COGS 100,A01,083619,Staff,0,28,60,60
1650750295811,COGS 101A,A01,083621,Davis; Joshua Daniel,0,27,60,60
1650750301836,COGS 101B,A01,091572,Staff,1,4,60,59
1650750307862,COGS 101C,A01,083625,Delgado; Tania,14,0,30,16
1650750313888,COGS 107A,A01,083627,Boyle; Mary E. T.,0,16,60,60
1650750319915,COGS 118A,A01,083075,Staff,0,8,60,60
1650750325946,CSE 3,A50,083646,Miranda; Gregory Joseph,18,0,38,20
1650750325946,CSE 3,A51,083647,Miranda; Gregory Joseph,36,0,37,1
1650750331972,CSE 8A,A50,083650,Miranda; Gregory Joseph,0,30,40,40
1650750337996,CSE 11,A01,083080,Cao; Yingjun,0,96,40,40
1650750344021,CSE 12,A01,083652,Staff,0,21,100,100
1650750350051,CSE 15L,A01,083654,Staff,0,3,50,50
1650750350051,CSE 15L,A02,083655,Staff,0,2,50,50
1650750356078,CSE 20,A01,083657,Staff,49,0,80,31
1650750362103,CSE 30,A01,083084,Eldon; John,0,77,40,40
1650750368126,CSE 100,A01,083659,Cao; Yingjun,0,71,50,50
1650750374149,CSE 134B,A01,083661,Powell; Thomas Allan,0,38,65,65
1650750380173,CSE 140,A01,083663,Staff,0,11,75,75
1650750386197,CSE 140L,A01,083088,Eldon; John,0,20,75,75
1650750392223,CSE 175,A01,083665,Kumar; Rakesh,7,0,25,18
1650750398257,CSE 190,A00,092507,Dubnov; Shlomo,10,0,20,10
1650750404283,ECE 45,A01,083139,Staff,1,2,60,59
1650750410309,ECE 65,A50,083695,Staff,0,5,30,30
1650750416335,ECE 109,A01,091882,Touri; Behrouz,33,0,70,37
1650750422362,ECE 180,A00,083140,Abi Samra; Nicholas Camill,20,0,30,10
1650750422362,ECE 180,B00,083141,Abi Samra; Nicholas Camill,0,0,30,30
1650750428386,MATH 10A,A01,083735,Patchell; Gregory David,2,0,30,28
1650750428386,MATH 10A,A02,083736,Patchell; Gregory David,27,0,30,3
1650750428386,MATH 10A,A03,083737,Patchell; Gregory David,24,0,30,6
1650750434412,MATH 10B,A01,083207,Staff,0,9,30,30
1650750434412,MATH 10B,A02,083208,Staff,1,7,30,29
1650750434412,MATH 10B,B01,083739,Staff,11,0,30,19
1650750434412,MATH 10B,B02,083740,Staff,28,0,30,2
1650750440438,MATH 18,A01,083743,Staff,0,0,30,30
1650750440438,MATH 18,A02,083744,Staff,23,0,30,7
1650750440438,MATH 18,A03,083745,Staff,21,0,30,9
1650750440438,MATH 18,A04,083746,Staff,26,0,30,4
1650750440438,MATH 18,B01,083748,Staff,0,15,30,30
1650750440438,MATH 18,B02,083749,Staff,0,12,30,30
1650750440438,MATH 18,B03,083750,Staff,0,12,30,30
1650750440438,MATH 18,B04,083751,Staff,0,12,30,30
1650750446465,MATH 20A,A01,083754,Staff,19,0,40,21
1650750452496,MATH 20B,A01,083756,Staff,0,12,30,30
1650750452496,MATH 20B,A02,083757,Staff,0,12,30,30
1650750458521,MATH 20C,A01,083760,Staff,0,16,30,30
1650750458521,MATH 20C,A02,083761,Staff,0,16,30,30
1650750458521,MATH 20C,B01,083762,Staff,10,0,30,20
1650750458521,MATH 20C,B02,083763,Staff,28,0,30,2
1650750464547,MATH 20D,A01,083765,Staff,2,1,30,28
1650750464547,MATH 20D,A02,083766,Staff,5,0,30,25
1650750464547,MATH 20D,A03,083767,Staff,24,0,30,6
1650750470575,MATH 20E,A01,083771,Staff,3,0,30,27
1650750470575,MATH 20E,A02,083772,Staff,16,0,30,14
1650750470575,MATH 20E,B01,083773,Staff,0,0,30,30
1650750470575,MATH 20E,B02,083774,Staff,6,0,30,24
1650750476601,MATH 103A,A01,083777,Staff,0,16,30,30
1650750476601,MATH 103A,A02,083778,Staff,0,15,30,30
1650750476601,MATH 103A,B01,083779,Staff,0,15,30,30
1650750476601,MATH 103A,B02,083780,Staff,0,15,30,30
1650750482626,MATH 105,A01,085443,Staff,0,22,30,30
1650750488653,MATH 109,A01,083213,Anzaldo; Leesa B,0,7,30,30
1650750488653,MATH 109,A02,083214,Anzaldo; Leesa B,0,7,30,30
1650750488653,MATH 109,B01,083215,Anzaldo; Leesa B,0,8,30,30
1650750488653,MATH 109,B02,083216,Anzaldo; Leesa B,0,6,30,30
1650750494684,MATH 142A,A01,083219,Chow; Bennett,0,16,30,30
1650750494684,MATH 142A,A02,083220,Chow; Bennett,0,15,30,30
1650750494684,MATH 142A,B01,083221,Chow; Bennett,0,15,30,30
1650750494684,MATH 142A,B02,083222,Chow; Bennett,0,14,30,30
1650750500710,MATH 193A,A01,083224,Staff,0,5,30,30
1650750500710,MATH 193A,A02,083225,Staff,0,6,30,30
1650750500710,MATH 193A,A03,083781,Staff,0,6,30,30
1650750500710,MATH 193A,A04,083782,Staff,0,7,30,30
1650750506734,MATH 197,001,091859,McAuley; Julian John,9998,0,9999,1
1650750512786,COGS 9,A01,083615,Staff,1,15,60,59
1650750518810,COGS 11,A01,083617,Boyle; Mary E. T.,16,0,40,24
1650750524837,COGS 13,A01,083071,Staff,0,38,40,40
1650750530865,COGS 14A,A01,092681,Staff,0,36,100,100
1650750536889,COGS 14B,A01,083073,Cheng; Tzu-Han,1,13,50,49
1650750542915,COGS 17,A01,092677,Staff,11,0,75,64
1650750548939,COGS 100,A01,083619,Staff,0,28,60,60
1650750554963,COGS 101A,A01,083621,Davis; Joshua Daniel,0,27,60,60
1650750560989,COGS 101B,A01,091572,Staff,1,4,60,59
1650750567014,COGS 101C,A01,083625,Delgado; Tania,14,0,30,16
1650750573037,COGS 107A,A01,083627,Boyle; Mary E. T.,0,16,60,60
1650750579065,COGS 118A,A01,083075,Staff,0,8,60,60
1650750585090,CSE 3,A50,083646,Miranda; Gregory Joseph,18,0,38,20
1650750585090,CSE 3,A51,083647,Miranda; Gregory Joseph,36,0,37,1
1650750591114,CSE 8A,A50,083650,Miranda; Gregory Joseph,0,30,40,40
1650750597139,CSE 11,A01,083080,Cao; Yingjun,0,96,40,40
1650750603162,CSE 12,A01,083652,Staff,0,21,100,100
1650750609185,CSE 15L,A01,083654,Staff,0,3,50,50
1650750609185,CSE 15L,A02,083655,Staff,0,2,50,50
1650750615209,CSE 20,A01,083657,Staff,49,0,80,31
1650750621239,CSE 30,A01,083084,Eldon; John,0,77,40,40
1650750627266,CSE 100,A01,083659,Cao; Yingjun,0,71,50,50
1650750633293,CSE 134B,A01,083661,Powell; Thomas Allan,0,38,65,65
1650750639319,CSE 140,A01,083663,Staff,0,11,75,75
1650750645349,CSE 140L,A01,083088,Eldon; John,0,20,75,75
1650750651376,CSE 175,A01,083665,Kumar; Rakesh,7,0,25,18
1650750657402,CSE 190,A00,092507,Dubnov; Shlomo,10,0,20,10
1650750663444,ECE 45,A01,083139,Staff,1,2,60,59
1650750669471,ECE 65,A50,083695,Staff,0,5,30,30
1650750675497,ECE 109,A01,091882,Touri; Behrouz,33,0,70,37
1650750681525,ECE 180,A00,083140,Abi Samra; Nicholas Camill,20,0,30,10
1650750681525,ECE 180,B00,083141,Abi Samra; Nicholas Camill,0,0,30,30
1650750687549,MATH 10A,A01,083735,Patchell; Gregory David,2,0,30,28
1650750687549,MATH 10A,A02,083736,Patchell; Gregory David,27,0,30,3
1650750687549,MATH 10A,A03,083737,Patchell; Gregory David,24,0,30,6
1650750693571,MATH 10B,A01,083207,Staff,0,9,30,30
1650750693571,MATH 10B,A02,083208,Staff,1,7,30,29
1650750693571,MATH 10B,B01,083739,Staff,11,0,30,19
1650750693571,MATH 10B,B02,083740,Staff,28,0,30,2
1650750699598,MATH 18,A01,083743,Staff,0,0,30,30
1650750699598,MATH 18,A02,083744,Staff,23,0,30,7
1650750699598,MATH 18,A03,083745,Staff,21,0,30,9
1650750699598,MATH 18,A04,083746,Staff,26,0,30,4
1650750699598,MATH 18,B01,083748,Staff,0,15,30,30
1650750699598,MATH 18,B02,083749,Staff,0,12,30,30
1650750699598,MATH 18,B03,083750,Staff,0,12,30,30
1650750699598,MATH 18,B04,083751,Staff,0,12,30,30
1650750705622,MATH 20A,A01,083754,Staff,19,0,40,21
1650750711648,MATH 20B,A01,083756,Staff,0,12,30,30
1650750711648,MATH 20B,A02,083757,Staff,0,12,30,30
1650750717672,MATH 20C,A01,083760,Staff,0,16,30,30
1650750717672,MATH 20C,A02,083761,Staff,0,16,30,30
1650750717672,MATH 20C,B01,083762,Staff,10,0,30,20
1650750717672,MATH 20C,B02,083763,Staff,28,0,30,2
1650750723700,MATH 20D,A01,083765,Staff,2,1,30,28
1650750723700,MATH 20D,A02,083766,Staff,5,0,30,25
1650750723700,MATH 20D,A03,083767,Staff,24,0,30,6
1650750729813,MATH 20E,A01,083771,Staff,3,0,30,27
1650750729813,MATH 20E,A02,083772,Staff,16,0,30,14
1650750729813,MATH 20E,B01,083773,Staff,0,0,30,30
1650750729813,MATH 20E,B02,083774,Staff,6,0,30,24
1650750735837,MATH 103A,A01,083777,Staff,0,16,30,30
1650750735837,MATH 103A,A02,083778,Staff,0,15,30,30
1650750735837,MATH 103A,B01,083779,Staff,0,15,30,30
1650750735837,MATH 103A,B02,083780,Staff,0,15,30,30
1650750741859,MATH 105,A01,085443,Staff,0,22,30,30
1650750747888,MATH 109,A01,083213,Anzaldo; Leesa B,0,7,30,30
1650750747888,MATH 109,A02,083214,Anzaldo; Leesa B,0,7,30,30
1650750747888,MATH 109,B01,083215,Anzaldo; Leesa B,0,8,30,30
1650750747888,MATH 109,B02,083216,Anzaldo; Leesa B,0,6,30,30
1650750753913,MATH 142A,A01,083219,Chow; Bennett,0,16,30,30
1650750753913,MATH 142A,A02,083220,Chow; Bennett,0,15,30,30
1650750753913,MATH 142A,B01,083221,Chow; Bennett,0,15,30,30
1650750753913,MATH 142A,B02,083222,Chow; Bennett,0,14,30,30
1650750759937,MATH 193A,A01,083224,Staff,0,5,30,30
1650750759937,MATH 193A,A02,083225,Staff,0,6,30,30
1650750759937,MATH 193A,A03,083781,Staff,0,6,30,30
1650750759937,MATH 193A,A04,083782,Staff,0,7,30,30
1650750765964,MATH 197,001,091859,McAuley; Julian John,9998,0,9999,1
1650750772014,COGS 9,A01,083615,Staff,1,15,60,59
1650750778038,COGS 11,A01,083617,Boyle; Mary E. T.,16,0,40,24
1650750784061,COGS 13,A01,083071,Staff,0,38,40,40
1650750790084,COGS 14A,A01,092681,Staff,0,36,100,100
1650750796111,COGS 14B,A01,083073,Cheng; Tzu-Han,1,13,50,49
1650750802136,COGS 17,A01,092677,Staff,11,0,75,64
1650750808164,COGS 100,A01,083619,Staff,0,28,60,60
1650750814190,COGS 101A,A01,083621,Davis; Joshua Daniel,0,27,60,60
1650750820218,COGS 101B,A01,091572,Staff,1,4,60,59
1650750826244,COGS 101C,A01,083625,Delgado; Tania,14,0,30,16
1650750832269,COGS 107A,A01,083627,Boyle; Mary E. T.,0,16,60,60
1650750838295,COGS 118A,A01,083075,Staff,0,8,60,60
1650750844323,CSE 3,A50,083646,Miranda; Gregory Joseph,18,0,38,20
1650750844323,CSE 3,A51,083647,Miranda; Gregory Joseph,36,0,37,1
1650750850347,CSE 8A,A50,083650,Miranda; Gregory Joseph,0,30,40,40
1650750856370,CSE 11,A01,083080,Cao; Yingjun,0,96,40,40
1650750862392,CSE 12,A01,083652,Staff,0,21,100,100
1650750868413,CSE 15L,A01,083654,Staff,0,3,50,50
1650750868413,CSE 15L,A02,083655,Staff,0,2,50,50
1650750874436,CSE 20,A01,083657,Staff,49,0,80,31
1650750880463,CSE 30,A01,083084,Eldon; John,0,77,40,40
1650750886498,CSE 100,A01,083659,Cao; Yingjun,0,71,50,50
1650750892522,CSE 134B,A01,083661,Powell; Thomas Allan,0,38,65,65
1650750898548,CSE 140,A01,083663,Staff,0,11,75,75
1650750904581,CSE 140L,A01,083088,Eldon; John,0,20,75,75
1650750910604,CSE 175,A01,083665,Kumar; Rakesh,7,0,25,18
1650750916627,CSE 190,A00,092507,Dubnov; Shlomo,10,0,20,10
1650750922650,ECE 45,A01,083139,Staff,1,2,60,59
1650750928675,ECE 65,A50,083695,Staff,0,5,30,30
1650750934699,ECE 109,A01,091882,Touri; Behrouz,33,0,70,37
1650750940724,ECE 180,A00,083140,Abi Samra; Nicholas Camill,20,0,30,10
1650750940724,ECE 180,B00,083141,Abi Samra; Nicholas Camill,0,0,30,30
1650750946748,MATH 10A,A01,083735,Patchell; Gregory David,2,0,30,28
1650750946748,MATH 10A,A02,083736,Patchell; Gregory David,27,0,30,3
1650750946748,MATH 10A,A03,083737,Patchell; Gregory David,24,0,30,6
1650750952777,MATH 10B,A01,083207,Staff,0,9,30,30
1650750952777,MATH 10B,A02,083208,Staff,1,7,30,29
1650750952777,MATH 10B,B01,083739,Staff,11,0,30,19
1650750952777,MATH 10B,B02,083740,Staff,28,0,30,2
1650750958808,MATH 18,A01,083743,Staff,0,0,30,30
1650750958808,MATH 18,A02,083744,Staff,23,0,30,7
1650750958808,MATH 18,A03,083745,Staff,21,0,30,9
1650750958808,MATH 18,A04,083746,Staff,26,0,30,4
1650750958808,MATH 18,B01,083748,Staff,0,15,30,30
1650750958808,MATH 18,B02,083749,Staff,0,12,30,30
1650750958808,MATH 18,B03,083750,Staff,0,12,30,30
1650750958808,MATH 18,B04,083751,Staff,0,12,30,30
1650750964830,MATH 20A,A01,083754,Staff,19,0,40,21
1650750970855,MATH 20B,A01,083756,Staff,0,12,30,30
1650750970855,MATH 20B,A02,083757,Staff,0,12,30,30
1650750976878,MATH 20C,A01,083760,Staff,0,16,30,30
1650750976878,MATH 20C,A02,083761,Staff,0,16,30,30
1650750976878,MATH 20C,B01,083762,Staff,10,0,30,20
1650750976878,MATH 20C,B02,083763,Staff,28,0,30,2
1650750982901,MATH 20D,A01,083765,Staff,2,1,30,28
1650750982901,MATH 20D,A02,083766,Staff,5,0,30,25
1650750982901,MATH 20D,A03,083767,Staff,24,0,30,6
1650750988926,MATH 20E,A01,083771,Staff,3,0,30,27
1650750988926,MATH 20E,A02,083772,Staff,16,0,30,14
1650750988926,MATH 20E,B01,083773,Staff,0,0,30,30
1650750988926,MATH 20E,B02,083774,Staff,6,0,30,24
1650750994951,MATH 103A,A01,083777,Staff,0,16,30,30
1650750994951,MATH 103A,A02,083778,Staff,0,15,30,30
1650750994951,MATH 103A,B01,083779,Staff,0,15,30,30
1650750994951,MATH 103A,B02,083780,Staff,0,15,30,30
1650751000975,MATH 105,A01,085443,Staff,0,22,30,30
1650751006999,MATH 109,A01,083213,Anzaldo; Leesa B,0,7,30,30
1650751006999,MATH 109,A02,083214,Anzaldo; Leesa B,0,7,30,30
1650751006999,MATH 109,B01,083215,Anzaldo; Leesa B,0,8,30,30
1650751006999,MATH 109,B02,083216,Anzaldo; Leesa B,0,6,30,30
1650751013023,MATH 142A,A01,083219,Chow; Bennett,0,16,30,30
1650751013023,MATH 142A,A02,083220,Chow; Bennett,0,15,30,30
1650751013023,MATH 142A,B01,083221,Chow; Bennett,0,15,30,30
1650751013023,MATH 142A,B02,083222,Chow; Bennett,0,14,30,30
1650751019051,MATH 193A,A01,083224,Staff,0,5,30,30
1650751019051,MATH 193A,A02,083225,Staff,0,6,30,30
1650751019051,MATH 193A,A03,083781,Staff,0,6,30,30
1650751019051,MATH 193A,A04,083782,Staff,0,7,30,30
1650751025075,MATH 197,001,091859,McAuley; Julian John,9998,0,9999,1
1650751031126,COGS 9,A01,083615,Staff,1,15,60,59
1650751037153,COGS 11,A01,083617,Boyle; Mary E. T.,16,0,40,24
1650751043178,COGS 13,A01,083071,Staff,0,38,40,40
1650751049210,COGS 14A,A01,092681,Staff,0,36,100,100
1650751055236,COGS 14B,A01,083073,Cheng; Tzu-Han,1,13,50,49
1650751061263,COGS 17,A01,092677,Staff,11,0,75,64
1650751067289,COGS 100,A01,083619,Staff,0,28,60,60
1650751073312,COGS 101A,A01,083621,Davis; Joshua Daniel,0,27,60,60
1650751079340,COGS 101B,A01,091572,Staff,1,4,60,59
1650751085366,COGS 101C,A01,083625,Delgado; Tania,14,0,30,16
1650751091392,COGS 107A,A01,083627,Boyle; Mary E. T.,0,16,60,60
1650751097416,COGS 118A,A01,083075,Staff,0,8,60,60
1650751103441,CSE 3,A50,083646,Miranda; Gregory Joseph,18,0,38,20
1650751103441,CSE 3,A51,083647,Miranda; Gregory Joseph,36,0,37,1
1650751109468,CSE 8A,A50,083650,Miranda; Gregory Joseph,0,30,40,40
1650751115497,CSE 11,A01,083080,Cao; Yingjun,0,96,40,40
1650751121523,CSE 12,A01,083652,Staff,0,21,100,100
1650751127547,CSE 15L,A01,083654,Staff,0,3,50,50
1650751127547,CSE 15L,A02,083655,Staff,0,2,50,50
1650751133571,CSE 20,A01,083657,Staff,49,0,80,31
1650751139596,CSE 30,A01,083084,Eldon; John,0,77,40,40
1650751145625,CSE 100,A01,083659,Cao; Yingjun,0,71,50,50
1650751151651,CSE 134B,A01,083661,Powell; Thomas Allan,0,38,65,65
1650751157674,CSE 140,A01,083663,Staff,0,11,75,75
1650751163698,CSE 140L,A01,083088,Eldon; John,0,20,75,75
1650751169721,CSE 175,A01,083665,Kumar; Rakesh,7,0,25,18
1650751175744,CSE 190,A00,092507,Dubnov; Shlomo,10,0,20,10
1650751181768,ECE 45,A01,083139,Staff,1,2,60,59
1650751187791,ECE 65,A50,083695,Staff,0,5,30,30
1650751193815,ECE 109,A01,091882,Touri; Behrouz,33,0,70,37
1650751199837,ECE 180,A00,083140,Abi Samra; Nicholas Camill,20,0,30,10
1650751199837,ECE 180,B00,083141,Abi Samra; Nicholas Camill,0,0,30,30
1650751205865,MATH 10A,A01,083735,Patchell; Gregory David,2,0,30,28
1650751205865,MATH 10A,A02,083736,Patchell; Gregory David,27,0,30,3
1650751205865,MATH 10A,A03,083737,Patchell; Gregory David,24,0,30,6
1650751211892,MATH 10B,A01,083207,Staff,0,9,30,30
1650751211892,MATH 10B,A02,083208,Staff,1,7,30,29
1650751211892,MATH 10B,B01,083739,Staff,11,0,30,19
1650751211892,MATH 10B,B02,083740,Staff,28,0,30,2
1650751217916,MATH 18,A01,083743,Staff,0,0,30,30
1650751217916,MATH 18,A02,083744,Staff,23,0,30,7
1650751217916,MATH 18,A03,083745,Staff,21,0,30,9
1650751217916,MATH 18,A04,083746,Staff,26,0,30,4
1650751217916,MATH 18,B01,083748,Staff,0,15,30,30
1650751217916,MATH 18,B02,083749,Staff,0,12,30,30
1650751217916,MATH 18,B03,083750,Staff,0,12,30,30
1650751217916,MATH 18,B04,083751,Staff,0,12,30,30
1650751223952,MATH 20A,A01,083754,Staff,19,0,40,21
1650751229977,MATH 20B,A01,083756,Staff,0,12,30,30
1650751229977,MATH 20B,A02,083757,Staff,0,12,30,30
1650751236006,MATH 20C,A01,083760,Staff,0,16,30,30
1650751236006,MATH 20C,A02,083761,Staff,0,16,30,30
1650751236006,MATH 20C,B01,083762,Staff,10,0,30,20
1650751236006,MATH 20C,B02,083763,Staff,28,0,30,2
1650751242034,MATH 20D,A01,083765,Staff,2,1,30,28
1650751242034,MATH 20D,A02,083766,Staff,5,0,30,25
1650751242034,MATH 20D,A03,083767,Staff,24,0,30,6
1650751248060,MATH 20E,A01,083771,Staff,3,0,30,27
1650751248060,MATH 20E,A02,083772,Staff,16,0,30,14
1650751248060,MATH 20E,B01,083773,Staff,0,0,30,30
1650751248060,MATH 20E,B02,083774,Staff,6,0,30,24
1650751254121,MATH 103A,A01,083777,Staff,0,16,30,30
1650751254121,MATH 103A,A02,083778,Staff,0,15,30,30
1650751254121,MATH 103A,B01,083779,Staff,0,15,30,30
1650751254121,MATH 103A,B02,083780,Staff,0,15,30,30
1650751260145,MATH 105,A01,085443,Staff,0,22,30,30
1650751266171,MATH 109,A01,083213,Anzaldo; Leesa B,0,7,30,30
1650751266171,MATH 109,A02,083214,Anzaldo; Leesa B,0,7,30,30
1650751266171,MATH 109,B01,083215,Anzaldo; Leesa B,0,8,30,30
1650751266171,MATH 109,B02,083216,Anzaldo; Leesa B,0,6,30,30
1650751272200,MATH 142A,A01,083219,Chow; Bennett,0,16,30,30
1650751272200,MATH 142A,A02,083220,Chow; Bennett,0,15,30,30
1650751272200,MATH 142A,B01,083221,Chow; Bennett,0,15,30,30
1650751272200,MATH 142A,B02,083222,Chow; Bennett,0,14,30,30
1650751278225,MATH 193A,A01,083224,Staff,0,5,30,30
1650751278225,MATH 193A,A02,083225,Staff,0,6,30,30
1650751278225,MATH 193A,A03,083781,Staff,0,6,30,30
1650751278225,MATH 193A,A04,083782,Staff,0,7,30,30
1650751284249,MATH 197,001,091859,McAuley; Julian John,9998,0,9999,1
1650751290317,COGS 9,A01,083615,Staff,1,15,60,59
1650751296342,COGS 11,A01,083617,Boyle; Mary E. T.,16,0,40,24
1650751302366,COGS 13,A01,083071,Staff,0,38,40,40
1650751308390,COGS 14A,A01,092681,Staff,0,36,100,100
1650751314419,COGS 14B,A01,083073,Cheng; Tzu-Han,1,13,50,49
1650751320540,COGS 17,A01,092677,Staff,11,0,75,64
1650751326564,COGS 100,A01,083619,Staff,0,28,60,60
1650751332593,COGS 101A,A01,083621,Davis; Joshua Daniel,0,27,60,60
1650751338619,COGS 101B,A01,091572,Staff,1,4,60,59
1650751344658,COGS 101C,A01,083625,Delgado; Tania,14,0,30,16
1650751350683,COGS 107A,A01,083627,Boyle; Mary E. T.,0,16,60,60
1650751356708,COGS 118A,A01,083075,Staff,0,8,60,60
1650751362731,CSE 3,A50,083646,Miranda; Gregory Joseph,18,0,38,20
1650751362731,CSE 3,A51,083647,Miranda; Gregory Joseph,36,0,37,1
1650751368756,CSE 8A,A50,083650,Miranda; Gregory Joseph,0,30,40,40
1650751374780,CSE 11,A01,083080,Cao; Yingjun,0,96,40,40
1650751380804,CSE 12,A01,083652,Staff,0,21,100,100
1650751386829,CSE 15L,A01,083654,Staff,0,3,50,50
1650751386829,CSE 15L,A02,083655,Staff,0,2,50,50
1650751392853,CSE 20,A01,083657,Staff,49,0,80,31
1650751398880,CSE 30,A01,083084,Eldon; John,0,77,40,40
1650751404905,CSE 100,A01,083659,Cao; Yingjun,0,71,50,50
1650751410929,CSE 134B,A01,083661,Powell; Thomas Allan,0,38,65,65
1650751416955,CSE 140,A01,083663,Staff,0,11,75,75
1650751422984,CSE 140L,A01,083088,Eldon; John,0,20,75,75
1650751429010,CSE 175,A01,083665,Kumar; Rakesh,7,0,25,18
1650751435039,CSE 190,A00,092507,Dubnov; Shlomo,10,0,20,10
1650751441064,ECE 45,A01,083139,Staff,1,2,60,59
1650751447092,ECE 65,A50,083695,Staff,0,5,30,30
1650751453139,ECE 109,A01,091882,Touri; Behrouz,33,0,70,37
1650751459163,ECE 180,A00,083140,Abi Samra; Nicholas Camill,20,0,30,10
1650751459163,ECE 180,B00,083141,Abi Samra; Nicholas Camill,0,0,30,30
1650751465193,MATH 10A,A01,083735,Patchell; Gregory David,2,0,30,28
1650751465193,MATH 10A,A02,083736,Patchell; Gregory David,27,0,30,3
1650751465193,MATH 10A,A03,083737,Patchell; Gregory David,24,0,30,6
1650751471222,MATH 10B,A01,083207,Staff,0,9,30,30
1650751471222,MATH 10B,A02,083208,Staff,1,7,30,29
1650751471222,MATH 10B,B01,083739,Staff,11,0,30,19
1650751471222,MATH 10B,B02,083740,Staff,28,0,30,2
1650751477249,MATH 18,A01,083743,Staff,0,0,30,30
1650751477249,MATH 18,A02,083744,Staff,23,0,30,7
1650751477249,MATH 18,A03,083745,Staff,21,0,30,9
1650751477249,MATH 18,A04,083746,Staff,26,0,30,4
1650751477249,MATH 18,B01,083748,Staff,0,15,30,30
1650751477249,MATH 18,B02,083749,Staff,0,12,30,30
1650751477249,MATH 18,B03,083750,Staff,0,12,30,30
1650751477249,MATH 18,B04,083751,Staff,0,12,30,30
1650751483276,MATH 20A,A01,083754,Staff,19,0,40,21
1650751489302,MATH 20B,A01,083756,Staff,0,12,30,30
1650751489302,MATH 20B,A02,083757,Staff,0,12,30,30
1650751495328,MATH 20C,A01,083760,Staff,0,16,30,30
1650751495328,MATH 20C,A02,083761,Staff,0,16,30,30
1650751495328,MATH 20C,B01,083762,Staff,10,0,30,20
1650751495328,MATH 20C,B02,083763,Staff,28,0,30,2
1650751501352,MATH 20D,A01,083765,Staff,2,1,30,28
1650751501352,MATH 20D,A02,083766,Staff,5,0,30,25
1650751501352,MATH 20D,A03,083767,Staff,24,0,30,6
1650751507376,MATH 20E,A01,083771,Staff,3,0,30,27
1650751507376,MATH 20E,A02,083772,Staff,16,0,30,14
1650751507376,MATH 20E,B01,083773,Staff,0,0,30,30
1650751507376,MATH 20E,B02,083774,Staff,6,0,30,24
1650751513409,MATH 103A,A01,083777,Staff,0,16,30,30
1650751513409,MATH 103A,A02,083778,Staff,0,15,30,30
1650751513409,MATH 103A,B01,083779,Staff,0,15,30,30
1650751513409,MATH 103A,B02,083780,Staff,0,15,30,30
1650751519434,MATH 105,A01,085443,Staff,0,22,30,30
1650751525457,MATH 109,A01,083213,Anzaldo; Leesa B,0,7,30,30
1650751525457,MATH 109,A02,083214,Anzaldo; Leesa B,0,7,30,30
1650751525457,MATH 109,B01,083215,Anzaldo; Leesa B,0,8,30,30
1650751525457,MATH 109,B02,083216,Anzaldo; Leesa B,0,6,30,30
1650751531487,MATH 142A,A01,083219,Chow; Bennett,0,16,30,30
1650751531487,MATH 142A,A02,083220,Chow; Bennett,0,15,30,30
1650751531487,MATH 142A,B01,083221,Chow; Bennett,0,15,30,30
1650751531487,MATH 142A,B02,083222,Chow; Bennett,0,14,30,30
1650751537513,MATH 193A,A01,083224,Staff,0,5,30,30
1650751537513,MATH 193A,A02,083225,Staff,0,6,30,30
1650751537513,MATH 193A,A03,083781,Staff,0,6,30,30
1650751537513,MATH 193A,A04,083782,Staff,0,7,30,30
1650751543535,MATH 197,001,091859,McAuley; Julian John,9998,0,9999,1
1650751549600,COGS 9,A01,083615,Staff,1,15,60,59
1650751555634,COGS 11,A01,083617,Boyle; Mary E. T.,16,0,40,24
1650751561669,COGS 13,A01,083071,Staff,0,38,40,40
1650751567693,COGS 14A,A01,092681,Staff,0,36,100,100
1650751573728,COGS 14B,A01,083073,Cheng; Tzu-Han,1,13,50,49
1650751579753,COGS 17,A01,092677,Staff,11,0,75,64
1650751585782,COGS 100,A01,083619,Staff,0,28,60,60
1650751591808,COGS 101A,A01,083621,Davis; Joshua Daniel,0,27,60,60
1650751597842,COGS 101B,A01,091572,Staff,1,4,60,59
1650751603866,COGS 101C,A01,083625,Delgado; Tania,14,0,30,16
1650751609898,COGS 107A,A01,083627,Boyle; Mary E. T.,0,16,60,60
1650751615932,COGS 118A,A01,083075,Staff,0,8,60,60
1650751621961,CSE 3,A50,083646,Miranda; Gregory Joseph,18,0,38,20
1650751621961,CSE 3,A51,083647,Miranda; Gregory Joseph,36,0,37,1
1650751627986,CSE 8A,A50,083650,Miranda; Gregory Joseph,0,30,40,40
1650751634011,CSE 11,A01,083080,Cao; Yingjun,0,96,40,40
1650751640035,CSE 12,A01,083652,Staff,0,21,100,100
1650751646059,CSE 15L,A01,083654,Staff,0,3,50,50
1650751646059,CSE 15L,A02,083655,Staff,0,2,50,50
1650751652087,CSE 20,A01,083657,Staff,49,0,80,31
1650751658114,CSE 30,A01,083084,Eldon; John,0,77,40,40
1650751664158,CSE 100,A01,083659,Cao; Yingjun,0,71,50,50
1650751670182,CSE 134B,A01,083661,Powell; Thomas Allan,0,38,65,65
1650751676207,CSE 140,A01,083663,Staff,0,11,75,75
1650751682232,CSE 140L,A01,083088,Eldon; John,0,20,75,75
1650751688260,CSE 175,A01,083665,Kumar; Rakesh,7,0,25,18
1650751694285,CSE 190,A00,092507,Dubnov; Shlomo,10,0,20,10
1650751700310,ECE 45,A01,083139,Staff,1,2,60,59
1650751706337,ECE 65,A50,083695,Staff,0,5,30,30
1650751712365,ECE 109,A01,091882,Touri; Behrouz,33,0,70,37
1650751718389,ECE 180,A00,083140,Abi Samra; Nicholas Camill,20,0,30,10
1650751718389,ECE 180,B00,083141,Abi Samra; Nicholas Camill,0,0,30,30
1650751724419,MATH 10A,A01,083735,Patchell; Gregory David,2,0,30,28
1650751724419,MATH 10A,A02,083736,Patchell; Gregory David,27,0,30,3
1650751724419,MATH 10A,A03,083737,Patchell; Gregory David,24,0,30,6
1650751730444,MATH 10B,A01,083207,Staff,0,9,30,30
1650751730444,MATH 10B,A02,083208,Staff,1,7,30,29
1650751730444,MATH 10B,B01,083739,Staff,11,0,30,19
1650751730444,MATH 10B,B02,083740,Staff,28,0,30,2
1650751736469,MATH 18,A01,083743,Staff,0,0,30,30
1650751736469,MATH 18,A02,083744,Staff,23,0,30,7
1650751736469,MATH 18,A03,083745,Staff,21,0,30,9
1650751736469,MATH 18,A04,083746,Staff,26,0,30,4
1650751736469,MATH 18,B01,083748,Staff,0,15,30,30
1650751736469,MATH 18,B02,083749,Staff,0,12,30,30
1650751736469,MATH 18,B03,083750,Staff,0,12,30,30
1650751736469,MATH 18,B04,083751,Staff,0,12,30,30
1650751742492,MATH 20A,A01,083754,Staff,19,0,40,21
1650751748517,MATH 20B,A01,083756,Staff,0,12,30,30
1650751748517,MATH 20B,A02,083757,Staff,0,12,30,30
1650751754543,MATH 20C,A01,083760,Staff,0,16,30,30
1650751754543,MATH 20C,A02,083761,Staff,0,16,30,30
1650751754543,MATH 20C,B01,083762,Staff,10,0,30,20
1650751754543,MATH 20C,B02,083763,Staff,28,0,30,2
1650751760568,MATH 20D,A01,083765,Staff,2,1,30,28
1650751760568,MATH 20D,A02,083766,Staff,5,0,30,25
1650751760568,MATH 20D,A03,083767,Staff,24,0,30,6
1650751766593,MATH 20E,A01,083771,Staff,3,0,30,27
1650751766593,MATH 20E,A02,083772,Staff,15,0,30,15
1650751766593,MATH 20E,B01,083773,Staff,0,0,30,30
1650751766593,MATH 20E,B02,083774,Staff,6,0,30,24
1650751772624,MATH 103A,A01,083777,Staff,0,16,30,30
1650751772624,MATH 103A,A02,083778,Staff,0,15,30,30
1650751772624,MATH 103A,B01,083779,Staff,0,15,30,30
1650751772624,MATH 103A,B02,083780,Staff,0,15,30,30
1650751778648,MATH 105,A01,085443,Staff,0,22,30,30
1650751784676,MATH 109,A01,083213,Anzaldo; Leesa B,0,7,30,30
1650751784676,MATH 109,A02,083214,Anzaldo; Leesa B,0,7,30,30
1650751784676,MATH 109,B01,083215,Anzaldo; Leesa B,0,8,30,30
1650751784676,MATH 109,B02,083216,Anzaldo; Leesa B,0,6,30,30
1650751790715,MATH 142A,A01,083219,Chow; Bennett,0,16,30,30
1650751790715,MATH 142A,A02,083220,Chow; Bennett,0,15,30,30
1650751790715,MATH 142A,B01,083221,Chow; Bennett,0,15,30,30
1650751790715,MATH 142A,B02,083222,Chow; Bennett,0,14,30,30
1650751796740,MATH 193A,A01,083224,Staff,0,5,30,30
1650751796740,MATH 193A,A02,083225,Staff,0,6,30,30
1650751796740,MATH 193A,A03,083781,Staff,0,6,30,30
1650751796740,MATH 193A,A04,083782,Staff,0,7,30,30
1650751802765,MATH 197,001,091859,McAuley; Julian John,9998,0,9999,1
1650751808823,COGS 9,A01,083615,Staff,1,15,60,59
1650751814848,COGS 11,A01,083617,Boyle; Mary E. T.,16,0,40,24
1650751820870,COGS 13,A01,083071,Staff,0,38,40,40
1650751826894,COGS 14A,A01,092681,Staff,0,36,100,100
1650751832918,COGS 14B,A01,083073,Cheng; Tzu-Han,1,13,50,49
1650751838942,COGS 17,A01,092677,Staff,11,0,75,64
1650751844968,COGS 100,A01,083619,Staff,0,29,60,60
1650751850996,COGS 101A,A01,083621,Davis; Joshua Daniel,0,27,60,60
1650751857020,COGS 101B,A01,091572,Staff,1,4,60,59
1650751863043,COGS 101C,A01,083625,Delgado; Tania,14,0,30,16
1650751869072,COGS 107A,A01,083627,Boyle; Mary E. T.,0,16,60,60
1650751875098,COGS 118A,A01,083075,Staff,0,8,60,60
1650751881126,CSE 3,A50,083646,Miranda; Gregory Joseph,18,0,38,20
1650751881126,CSE 3,A51,083647,Miranda; Gregory Joseph,36,0,37,1
1650751887157,CSE 8A,A50,083650,Miranda; Gregory Joseph,0,30,40,40
1650751893182,CSE 11,A01,083080,Cao; Yingjun,0,96,40,40
1650751899209,CSE 12,A01,083652,Staff,0,21,100,100
1650751905234,CSE 15L,A01,083654,Staff,0,3,50,50
1650751905234,CSE 15L,A02,083655,Staff,0,2,50,50
1650751911259,CSE 20,A01,083657,Staff,49,0,80,31
1650751917375,CSE 30,A01,083084,Eldon; John,0,77,40,40
1650751923405,CSE 100,A01,083659,Cao; Yingjun,0,71,50,50
1650751929430,CSE 134B,A01,083661,Powell; Thomas Allan,0,38,65,65
1650751935461,CSE 140,A01,083663,Staff,0,11,75,75
1650751941484,CSE 140L,A01,083088,Eldon; John,0,20,75,75
1650751947523,CSE 175,A01,083665,Kumar; Rakesh,7,0,25,18
1650751953545,CSE 190,A00,092507,Dubnov; Shlomo,10,0,20,10
1650751959567,ECE 45,A01,083139,Staff,1,2,60,59
1650751965593,ECE 65,A50,083695,Staff,0,5,30,30
1650751971619,ECE 109,A01,091882,Touri; Behrouz,33,0,70,37
1650751977641,ECE 180,A00,083140,Abi Samra; Nicholas Camill,20,0,30,10
1650751977641,ECE 180,B00,083141,Abi Samra; Nicholas Camill,0,0,30,30
1650751983675,MATH 10A,A01,083735,Patchell; Gregory David,2,0,30,28
1650751983675,MATH 10A,A02,083736,Patchell; Gregory David,27,0,30,3
1650751983675,MATH 10A,A03,083737,Patchell; Gregory David,24,0,30,6
1650751989700,MATH 10B,A01,083207,Staff,0,9,30,30
1650751989700,MATH 10B,A02,083208,Staff,1,7,30,29
1650751989700,MATH 10B,B01,083739,Staff,11,0,30,19
1650751989700,MATH 10B,B02,083740,Staff,28,0,30,2
1650751995725,MATH 18,A01,083743,Staff,0,0,30,30
1650751995725,MATH 18,A02,083744,Staff,23,0,30,7
1650751995725,MATH 18,A03,083745,Staff,21,0,30,9
1650751995725,MATH 18,A04,083746,Staff,26,0,30,4
1650751995725,MATH 18,B01,083748,Staff,0,15,30,30
1650751995725,MATH 18,B02,083749,Staff,0,12,30,30
1650751995725,MATH 18,B03,083750,Staff,0,12,30,30
1650751995725,MATH 18,B04,083751,Staff,0,12,30,30
1650752001747,MATH 20A,A01,083754,Staff,19,0,40,21
1650752007775,MATH 20B,A01,083756,Staff,0,12,30,30
1650752007775,MATH 20B,A02,083757,Staff,0,12,30,30
1650752013800,MATH 20C,A01,083760,Staff,0,16,30,30
1650752013800,MATH 20C,A02,083761,Staff,0,16,30,30
1650752013800,MATH 20C,B01,083762,Staff,10,0,30,20
1650752013800,MATH 20C,B02,083763,Staff,28,0,30,2
1650752019828,MATH 20D,A01,083765,Staff,2,1,30,28
1650752019828,MATH 20D,A02,083766,Staff,5,0,30,25
1650752019828,MATH 20D,A03,083767,Staff,24,0,30,6
1650752025853,MATH 20E,A01,083771,Staff,3,0,30,27
1650752025853,MATH 20E,A02,083772,Staff,15,0,30,15
1650752025853,MATH 20E,B01,083773,Staff,0,0,30,30
1650752025853,MATH 20E,B02,083774,Staff,6,0,30,24
1650752031882,MATH 103A,A01,083777,Staff,0,16,30,30
1650752031882,MATH 103A,A02,083778,Staff,0,15,30,30
1650752031882,MATH 103A,B01,083779,Staff,0,15,30,30
1650752031882,MATH 103A,B02,083780,Staff,0,15,30,30
1650752037910,MATH 105,A01,085443,Staff,0,22,30,30
1650752043938,MATH 109,A01,083213,Anzaldo; Leesa B,0,7,30,30
1650752043938,MATH 109,A02,083214,Anzaldo; Leesa B,0,7,30,30
1650752043938,MATH 109,B01,083215,Anzaldo; Leesa B,0,8,30,30
1650752043938,MATH 109,B02,083216,Anzaldo; Leesa B,0,6,30,30
1650752049963,MATH 142A,A01,083219,Chow; Bennett,0,16,30,30
1650752049963,MATH 142A,A02,083220,Chow; Bennett,0,15,30,30
1650752049963,MATH 142A,B01,083221,Chow; Bennett,0,15,30,30
1650752049963,MATH 142A,B02,083222,Chow; Bennett,0,14,30,30
1650752055998,MATH 193A,A01,083224,Staff,0,5,30,30
1650752055998,MATH 193A,A02,083225,Staff,0,6,30,30
1650752055998,MATH 193A,A03,083781,Staff,0,6,30,30
1650752055998,MATH 193A,A04,083782,Staff,0,7,30,30
1650752062025,MATH 197,001,091859,McAuley; Julian John,9998,0,9999,1
1650752068076,COGS 9,A01,083615,Staff,1,15,60,59
1650752074102,COGS 11,A01,083617,Boyle; Mary E. T.,16,0,40,24
1650752080133,COGS 13,A01,083071,Staff,0,38,40,40
1650752086161,COGS 14A,A01,092681,Staff,0,36,100,100
1650752092190,COGS 14B,A01,083073,Cheng; Tzu-Han,1,13,50,49
1650752098215,COGS 17,A01,092677,Staff,11,0,75,64
1650752104239,COGS 100,A01,083619,Staff,0,29,60,60
1650752110267,COGS 101A,A01,083621,Davis; Joshua Daniel,0,27,60,60
1650752116291,COGS 101B,A01,091572,Staff,1,4,60,59
1650752122314,COGS 101C,A01,083625,Delgado; Tania,14,0,30,16
1650752128339,COGS 107A,A01,083627,Boyle; Mary E. T.,0,16,60,60
1650752134363,COGS 118A,A01,083075,Staff,0,8,60,60
1650752140393,CSE 3,A50,083646,Miranda; Gregory Joseph,18,0,38,20
1650752140393,CSE 3,A51,083647,Miranda; Gregory Joseph,36,0,37,1
1650752146419,CSE 8A,A50,083650,Miranda; Gregory Joseph,0,30,40,40
1650752152445,CSE 11,A01,083080,Cao; Yingjun,0,96,40,40
1650752158470,CSE 12,A01,083652,Staff,0,21,100,100
1650752164502,CSE 15L,A01,083654,Staff,0,3,50,50
1650752164502,CSE 15L,A02,083655,Staff,0,2,50,50
1650752170527,CSE 20,A01,083657,Staff,49,0,80,31
1650752176563,CSE 30,A01,083084,Eldon; John,0,77,40,40
1650752182588,CSE 100,A01,083659,Cao; Yingjun,0,71,50,50
1650752188616,CSE 134B,A01,083661,Powell; Thomas Allan,0,38,65,65
1650752194642,CSE 140,A01,083663,Staff,0,11,75,75
1650752200672,CSE 140L,A01,083088,Eldon; John,0,20,75,75
1650752206697,CSE 175,A01,083665,Kumar; Rakesh,7,0,25,18
1650752212719,CSE 190,A00,092507,Dubnov; Shlomo,10,0,20,10
1650752218747,ECE 45,A01,083139,Staff,1,2,60,59
1650752224775,ECE 65,A50,083695,Staff,0,5,30,30
1650752230802,ECE 109,A01,091882,Touri; Behrouz,33,0,70,37
1650752236828,ECE 180,A00,083140,Abi Samra; Nicholas Camill,20,0,30,10
1650752236828,ECE 180,B00,083141,Abi Samra; Nicholas Camill,0,0,30,30
1650752242853,MATH 10A,A01,083735,Patchell; Gregory David,2,0,30,28
1650752242853,MATH 10A,A02,083736,Patchell; Gregory David,27,0,30,3
1650752242853,MATH 10A,A03,083737,Patchell; Gregory David,24,0,30,6
1650752248877,MATH 10B,A01,083207,Staff,0,9,30,30
1650752248877,MATH 10B,A02,083208,Staff,1,7,30,29
1650752248877,MATH 10B,B01,083739,Staff,11,0,30,19
1650752248877,MATH 10B,B02,083740,Staff,28,0,30,2
1650752254903,MATH 18,A01,083743,Staff,0,0,30,30
1650752254903,MATH 18,A02,083744,Staff,23,0,30,7
1650752254903,MATH 18,A03,083745,Staff,21,0,30,9
1650752254903,MATH 18,A04,083746,Staff,26,0,30,4
1650752254903,MATH 18,B01,083748,Staff,0,15,30,30
1650752254903,MATH 18,B02,083749,Staff,0,12,30,30
1650752254903,MATH 18,B03,083750,Staff,0,12,30,30
1650752254903,MATH 18,B04,083751,Staff,0,12,30,30
1650752260928,MATH 20A,A01,083754,Staff,19,0,40,21
1650752266952,MATH 20B,A01,083756,Staff,0,12,30,30
1650752266952,MATH 20B,A02,083757,Staff,0,12,30,30
1650752272978,MATH 20C,A01,083760,Staff,0,16,30,30
1650752272978,MATH 20C,A02,083761,Staff,0,16,30,30
1650752272978,MATH 20C,B01,083762,Staff,10,0,30,20
1650752272978,MATH 20C,B02,083763,Staff,28,0,30,2
1650752279003,MATH 20D,A01,083765,Staff,2,1,30,28
1650752279003,MATH 20D,A02,083766,Staff,5,0,30,25
1650752279003,MATH 20D,A03,083767,Staff,24,0,30,6
1650752285027,MATH 20E,A01,083771,Staff,3,0,30,27
1650752285027,MATH 20E,A02,083772,Staff,15,0,30,15
1650752285027,MATH 20E,B01,083773,Staff,0,0,30,30
1650752285027,MATH 20E,B02,083774,Staff,6,0,30,24
1650752291054,MATH 103A,A01,083777,Staff,0,16,30,30
1650752291054,MATH 103A,A02,083778,Staff,0,15,30,30
1650752291054,MATH 103A,B01,083779,Staff,0,15,30,30
1650752291054,MATH 103A,B02,083780,Staff,0,15,30,30
1650752297081,MATH 105,A01,085443,Staff,0,22,30,30
1650752303109,MATH 109,A01,083213,Anzaldo; Leesa B,0,7,30,30
1650752303109,MATH 109,A02,083214,Anzaldo; Leesa B,0,7,30,30
1650752303109,MATH 109,B01,083215,Anzaldo; Leesa B,0,8,30,30
1650752303109,MATH 109,B02,083216,Anzaldo; Leesa B,0,6,30,30
1650752309135,MATH 142A,A01,083219,Chow; Bennett,0,16,30,30
1650752309135,MATH 142A,A02,083220,Chow; Bennett,0,15,30,30
1650752309135,MATH 142A,B01,083221,Chow; Bennett,0,15,30,30
1650752309135,MATH 142A,B02,083222,Chow; Bennett,0,14,30,30
1650752315174,MATH 193A,A01,083224,Staff,0,5,30,30
1650752315174,MATH 193A,A02,083225,Staff,0,6,30,30
1650752315174,MATH 193A,A03,083781,Staff,0,6,30,30
1650752315174,MATH 193A,A04,083782,Staff,0,7,30,30
1650752321208,MATH 197,001,091859,McAuley; Julian John,9998,0,9999,1
1650752327263,COGS 9,A01,083615,Staff,1,16,60,59
1650752333290,COGS 11,A01,083617,Boyle; Mary E. T.,16,0,40,24
1650752339327,COGS 13,A01,083071,Staff,0,38,40,40
1650752345351,COGS 14A,A01,092681,Staff,0,36,100,100
1650752351383,COGS 14B,A01,083073,Cheng; Tzu-Han,1,13,50,49
1650752357407,COGS 17,A01,092677,Staff,11,0,75,64
1650752363432,COGS 100,A01,083619,Staff,0,29,60,60
1650752369465,COGS 101A,A01,083621,Davis; Joshua Daniel,0,27,60,60
1650752375492,COGS 101B,A01,091572,Staff,1,4,60,59
1650752381514,COGS 101C,A01,083625,Delgado; Tania,14,0,30,16
1650752387539,COGS 107A,A01,083627,Boyle; Mary E. T.,0,16,60,60
1650752393563,COGS 118A,A01,083075,Staff,0,8,60,60
1650752399592,CSE 3,A50,083646,Miranda; Gregory Joseph,18,0,38,20
1650752399592,CSE 3,A51,083647,Miranda; Gregory Joseph,36,0,37,1
1650752405620,CSE 8A,A50,083650,Miranda; Gregory Joseph,0,30,40,40
1650752411649,CSE 11,A01,083080,Cao; Yingjun,0,96,40,40
1650752417676,CSE 12,A01,083652,Staff,0,21,100,100
1650752423705,CSE 15L,A01,083654,Staff,0,3,50,50
1650752423705,CSE 15L,A02,083655,Staff,0,2,50,50
1650752429732,CSE 20,A01,083657,Staff,49,0,80,31
1650752435755,CSE 30,A01,083084,Eldon; John,0,77,40,40
1650752441783,CSE 100,A01,083659,Cao; Yingjun,0,71,50,50
1650752447809,CSE 134B,A01,083661,Powell; Thomas Allan,0,38,65,65
1650752453837,CSE 140,A01,083663,Staff,0,11,75,75
1650752459862,CSE 140L,A01,083088,Eldon; John,0,20,75,75
1650752465887,CSE 175,A01,083665,Kumar; Rakesh,7,0,25,18
1650752471913,CSE 190,A00,092507,Dubnov; Shlomo,10,0,20,10
1650752477939,ECE 45,A01,083139,Staff,1,2,60,59
1650752483967,ECE 65,A50,083695,Staff,0,5,30,30
1650752489993,ECE 109,A01,091882,Touri; Behrouz,33,0,70,37
1650752496022,ECE 180,A00,083140,Abi Samra; Nicholas Camill,20,0,30,10
1650752496022,ECE 180,B00,083141,Abi Samra; Nicholas Camill,0,0,30,30
1650752502049,MATH 10A,A01,083735,Patchell; Gregory David,2,0,30,28
1650752502049,MATH 10A,A02,083736,Patchell; Gregory David,27,0,30,3
1650752502049,MATH 10A,A03,083737,Patchell; Gregory David,24,0,30,6
1650752508078,MATH 10B,A01,083207,Staff,0,9,30,30
1650752508078,MATH 10B,A02,083208,Staff,1,7,30,29
1650752508078,MATH 10B,B01,083739,Staff,11,0,30,19
1650752508078,MATH 10B,B02,083740,Staff,28,0,30,2
1650752514179,MATH 18,A01,083743,Staff,0,0,30,30
1650752514179,MATH 18,A02,083744,Staff,23,0,30,7
1650752514179,MATH 18,A03,083745,Staff,21,0,30,9
1650752514179,MATH 18,A04,083746,Staff,26,0,30,4
1650752514179,MATH 18,B01,083748,Staff,0,15,30,30
1650752514179,MATH 18,B02,083749,Staff,0,12,30,30
1650752514179,MATH 18,B03,083750,Staff,0,12,30,30
1650752514179,MATH 18,B04,083751,Staff,0,12,30,30
1650752520211,MATH 20A,A01,083754,Staff,19,0,40,21
1650752526244,MATH 20B,A01,083756,Staff,0,12,30,30
1650752526244,MATH 20B,A02,083757,Staff,0,12,30,30
1650752532271,MATH 20C,A01,083760,Staff,0,16,30,30
1650752532271,MATH 20C,A02,083761,Staff,0,16,30,30
1650752532271,MATH 20C,B01,083762,Staff,10,0,30,20
1650752532271,MATH 20C,B02,083763,Staff,28,0,30,2
1650752538296,MATH 20D,A01,083765,Staff,2,1,30,28
1650752538296,MATH 20D,A02,083766,Staff,5,0,30,25
1650752538296,MATH 20D,A03,083767,Staff,24,0,30,6
1650752544322,MATH 20E,A01,083771,Staff,3,0,30,27
1650752544322,MATH 20E,A02,083772,Staff,16,0,30,14
1650752544322,MATH 20E,B01,083773,Staff,0,0,30,30
1650752544322,MATH 20E,B02,083774,Staff,5,0,30,25
1650752550350,MATH 103A,A01,083777,Staff,0,16,30,30
1650752550350,MATH 103A,A02,083778,Staff,0,15,30,30
1650752550350,MATH 103A,B01,083779,Staff,0,15,30,30
1650752550350,MATH 103A,B02,083780,Staff,0,15,30,30
1650752556374,MATH 105,A01,085443,Staff,0,22,30,30
1650752562404,MATH 109,A01,083213,Anzaldo; Leesa B,0,7,30,30
1650752562404,MATH 109,A02,083214,Anzaldo; Leesa B,0,7,30,30
1650752562404,MATH 109,B01,083215,Anzaldo; Leesa B,0,8,30,30
1650752562404,MATH 109,B02,083216,Anzaldo; Leesa B,0,6,30,30
1650752568432,MATH 142A,A01,083219,Chow; Bennett,0,16,30,30
1650752568432,MATH 142A,A02,083220,Chow; Bennett,0,15,30,30
1650752568432,MATH 142A,B01,083221,Chow; Bennett,0,15,30,30
1650752568432,MATH 142A,B02,083222,Chow; Bennett,0,14,30,30
1650752574461,MATH 193A,A01,083224,Staff,0,5,30,30
1650752574461,MATH 193A,A02,083225,Staff,0,6,30,30
1650752574461,MATH 193A,A03,083781,Staff,0,6,30,30
1650752574461,MATH 193A,A04,083782,Staff,0,7,30,30
1650752580488,MATH 197,001,091859,McAuley; Julian John,9998,0,9999,1
1650752586579,COGS 9,A01,083615,Staff,1,16,60,59
1650752592601,COGS 11,A01,083617,Boyle; Mary E. T.,16,0,40,24
1650752598623,COGS 13,A01,083071,Staff,0,38,40,40
1650752604660,COGS 14A,A01,092681,Staff,0,37,100,100
1650752610687,COGS 14B,A01,083073,Cheng; Tzu-Han,1,13,50,49
1650752616710,COGS 17,A01,092677,Staff,11,0,75,64
1650752622738,COGS 100,A01,083619,Staff,0,29,60,60
1650752628763,COGS 101A,A01,083621,Davis; Joshua Daniel,0,27,60,60
1650752634801,COGS 101B,A01,091572,Staff,1,4,60,59
1650752640829,COGS 101C,A01,083625,Delgado; Tania,14,0,30,16
1650752646856,COGS 107A,A01,083627,Boyle; Mary E. T.,0,16,60,60
1650752652880,COGS 118A,A01,083075,Staff,0,8,60,60
1650752658906,CSE 3,A50,083646,Miranda; Gregory Joseph,18,0,38,20
1650752658906,CSE 3,A51,083647,Miranda; Gregory Joseph,36,0,37,1
1650752664930,CSE 8A,A50,083650,Miranda; Gregory Joseph,0,30,40,40
1650752670957,CSE 11,A01,083080,Cao; Yingjun,0,96,40,40
1650752677071,CSE 12,A01,083652,Staff,0,21,100,100
1650752683109,CSE 15L,A01,083654,Staff,0,3,50,50
1650752683109,CSE 15L,A02,083655,Staff,0,2,50,50
1650752689133,CSE 20,A01,083657,Staff,49,0,80,31
1650752695158,CSE 30,A01,083084,Eldon; John,0,77,40,40
1650752701184,CSE 100,A01,083659,Cao; Yingjun,0,71,50,50
1650752707208,CSE 134B,A01,083661,Powell; Thomas Allan,0,38,65,65
1650752713244,CSE 140,A01,083663,Staff,0,11,75,75
1650752719278,CSE 140L,A01,083088,Eldon; John,0,20,75,75
1650752725301,CSE 175,A01,083665,Kumar; Rakesh,7,0,25,18
1650752731329,CSE 190,A00,092507,Dubnov; Shlomo,10,0,20,10
1650752737359,ECE 45,A01,083139,Staff,1,2,60,59
1650752743383,ECE 65,A50,083695,Staff,0,5,30,30
1650752749411,ECE 109,A01,091882,Touri; Behrouz,33,0,70,37
1650752755439,ECE 180,A00,083140,Abi Samra; Nicholas Camill,20,0,30,10
1650752755439,ECE 180,B00,083141,Abi Samra; Nicholas Camill,0,0,30,30
1650752761463,MATH 10A,A01,083735,Patchell; Gregory David,2,0,30,28
1650752761463,MATH 10A,A02,083736,Patchell; Gregory David,27,0,30,3
1650752761463,MATH 10A,A03,083737,Patchell; Gregory David,24,0,30,6
1650752767487,MATH 10B,A01,083207,Staff,0,9,30,30
1650752767487,MATH 10B,A02,083208,Staff,1,7,30,29
1650752767487,MATH 10B,B01,083739,Staff,11,0,30,19
1650752767487,MATH 10B,B02,083740,Staff,28,0,30,2
1650752773513,MATH 18,A01,083743,Staff,0,0,30,30
1650752773513,MATH 18,A02,083744,Staff,23,0,30,7
1650752773513,MATH 18,A03,083745,Staff,21,0,30,9
1650752773513,MATH 18,A04,083746,Staff,26,0,30,4
1650752773513,MATH 18,B01,083748,Staff,0,15,30,30
1650752773513,MATH 18,B02,083749,Staff,0,12,30,30
1650752773513,MATH 18,B03,083750,Staff,0,12,30,30
1650752773513,MATH 18,B04,083751,Staff,0,12,30,30
1650752779537,MATH 20A,A01,083754,Staff,19,0,40,21
1650752785560,MATH 20B,A01,083756,Staff,0,12,30,30
1650752785560,MATH 20B,A02,083757,Staff,0,12,30,30
1650752791590,MATH 20C,A01,083760,Staff,0,16,30,30
1650752791590,MATH 20C,A02,083761,Staff,0,16,30,30
1650752791590,MATH 20C,B01,083762,Staff,10,0,30,20
1650752791590,MATH 20C,B02,083763,Staff,28,0,30,2
1650752797614,MATH 20D,A01,083765,Staff,2,1,30,28
1650752797614,MATH 20D,A02,083766,Staff,5,0,30,25
1650752797614,MATH 20D,A03,083767,Staff,24,0,30,6
1650752803638,MATH 20E,A01,083771,Staff,3,0,30,27
1650752803638,MATH 20E,A02,083772,Staff,16,0,30,14
1650752803638,MATH 20E,B01,083773,Staff,0,0,30,30
1650752803638,MATH 20E,B02,083774,Staff,5,0,30,25
1650752809663,MATH 103A,A01,083777,Staff,0,16,30,30
1650752809663,MATH 103A,A02,083778,Staff,0,15,30,30
1650752809663,MATH 103A,B01,083779,Staff,0,15,30,30
1650752809663,MATH 103A,B02,083780,Staff,0,15,30,30
1650752815698,MATH 105,A01,085443,Staff,0,22,30,30
1650752821727,MATH 109,A01,083213,Anzaldo; Leesa B,0,7,30,30
1650752821727,MATH 109,A02,083214,Anzaldo; Leesa B,0,7,30,30
1650752821727,MATH 109,B01,083215,Anzaldo; Leesa B,0,8,30,30
1650752821727,MATH 109,B02,083216,Anzaldo; Leesa B,0,6,30,30
1650752827753,MATH 142A,A01,083219,Chow; Bennett,0,16,30,30
1650752827753,MATH 142A,A02,083220,Chow; Bennett,0,15,30,30
1650752827753,MATH 142A,B01,083221,Chow; Bennett,0,15,30,30
1650752827753,MATH 142A,B02,083222,Chow; Bennett,0,14,30,30
1650752833782,MATH 193A,A01,083224,Staff,0,5,30,30
1650752833782,MATH 193A,A02,083225,Staff,0,6,30,30
1650752833782,MATH 193A,A03,083781,Staff,0,6,30,30
1650752833782,MATH 193A,A04,083782,Staff,0,7,30,30
1650752839805,MATH 197,001,091859,McAuley; Julian John,9998,0,9999,1
1650752845869,COGS 9,A01,083615,Staff,1,16,60,59
1650752851897,COGS 11,A01,083617,Boyle; Mary E. T.,16,0,40,24
1650752857925,COGS 13,A01,083071,Staff,0,38,40,40
1650752863959,COGS 14A,A01,092681,Staff,0,36,100,100
1650752869987,COGS 14B,A01,083073,Cheng; Tzu-Han,1,13,50,49
1650752876020,COGS 17,A01,092677,Staff,11,0,75,64
1650752882045,COGS 100,A01,083619,Staff,0,29,60,60
1650752888068,COGS 101A,A01,083621,Davis; Joshua Daniel,0,28,60,60
1650752894095,COGS 101B,A01,091572,Staff,1,4,60,59
1650752900123,COGS 101C,A01,083625,Delgado; Tania,14,0,30,16
1650752906148,COGS 107A,A01,083627,Boyle; Mary E. T.,0,16,60,60
1650752912173,COGS 118A,A01,083075,Staff,0,8,60,60
1650752918198,CSE 3,A50,083646,Miranda; Gregory Joseph,18,0,38,20
1650752918198,CSE 3,A51,083647,Miranda; Gregory Joseph,36,0,37,1
1650752924222,CSE 8A,A50,083650,Miranda; Gregory Joseph,0,30,40,40
1650752930253,CSE 11,A01,083080,Cao; Yingjun,0,96,40,40
1650752936278,CSE 12,A01,083652,Staff,0,21,100,100
1650752942302,CSE 15L,A01,083654,Staff,0,3,50,50
1650752942302,CSE 15L,A02,083655,Staff,0,2,50,50
1650752948331,CSE 20,A01,083657,Staff,49,0,80,31
1650752954368,CSE 30,A01,083084,Eldon; John,0,76,40,40
1650752960392,CSE 100,A01,083659,Cao; Yingjun,0,71,50,50
1650752966416,CSE 134B,A01,083661,Powell; Thomas Allan,0,38,65,65
1650752972440,CSE 140,A01,083663,Staff,0,11,75,75
1650752978464,CSE 140L,A01,083088,Eldon; John,0,20,75,75
1650752984491,CSE 175,A01,083665,Kumar; Rakesh,7,0,25,18
1650752990516,CSE 190,A00,092507,Dubnov; Shlomo,10,0,20,10
1650752996545,ECE 45,A01,083139,Staff,1,2,60,59
1650753002570,ECE 65,A50,083695,Staff,0,5,30,30
1650753008595,ECE 109,A01,091882,Touri; Behrouz,33,0,70,37
1650753014617,ECE 180,A00,083140,Abi Samra; Nicholas Camill,20,0,30,10
1650753014617,ECE 180,B00,083141,Abi Samra; Nicholas Camill,0,0,30,30
1650753020641,MATH 10A,A01,083735,Patchell; Gregory David,2,0,30,28
1650753020641,MATH 10A,A02,083736,Patchell; Gregory David,27,0,30,3
1650753020641,MATH 10A,A03,083737,Patchell; Gregory David,24,0,30,6
1650753026667,MATH 10B,A01,083207,Staff,0,9,30,30
1650753026667,MATH 10B,A02,083208,Staff,1,7,30,29
1650753026667,MATH 10B,B01,083739,Staff,11,0,30,19
1650753026667,MATH 10B,B02,083740,Staff,28,0,30,2
1650753032699,MATH 18,A01,083743,Staff,0,0,30,30
1650753032699,MATH 18,A02,083744,Staff,23,0,30,7
1650753032699,MATH 18,A03,083745,Staff,21,0,30,9
1650753032699,MATH 18,A04,083746,Staff,26,0,30,4
1650753032699,MATH 18,B01,083748,Staff,0,15,30,30
1650753032699,MATH 18,B02,083749,Staff,0,12,30,30
1650753032699,MATH 18,B03,083750,Staff,0,12,30,30
1650753032699,MATH 18,B04,083751,Staff,0,12,30,30
1650753038725,MATH 20A,A01,083754,Staff,19,0,40,21
1650753044748,MATH 20B,A01,083756,Staff,0,12,30,30
1650753044748,MATH 20B,A02,083757,Staff,0,12,30,30
1650753050775,MATH 20C,A01,083760,Staff,0,16,30,30
1650753050775,MATH 20C,A02,083761,Staff,0,16,30,30
1650753050775,MATH 20C,B01,083762,Staff,10,0,30,20
1650753050775,MATH 20C,B02,083763,Staff,28,0,30,2
1650753056801,MATH 20D,A01,083765,Staff,2,1,30,28
1650753056801,MATH 20D,A02,083766,Staff,5,0,30,25
1650753056801,MATH 20D,A03,083767,Staff,24,0,30,6
1650753062833,MATH 20E,A01,083771,Staff,3,0,30,27
1650753062833,MATH 20E,A02,083772,Staff,16,0,30,14
1650753062833,MATH 20E,B01,083773,Staff,0,0,30,30
1650753062833,MATH 20E,B02,083774,Staff,5,0,30,25
1650753068863,MATH 103A,A01,083777,Staff,0,16,30,30
1650753068863,MATH 103A,A02,083778,Staff,0,15,30,30
1650753068863,MATH 103A,B01,083779,Staff,0,15,30,30
1650753068863,MATH 103A,B02,083780,Staff,0,15,30,30
1650753074885,MATH 105,A01,085443,Staff,0,22,30,30
1650753080919,MATH 109,A01,083213,Anzaldo; Leesa B,0,7,30,30
1650753080919,MATH 109,A02,083214,Anzaldo; Leesa B,0,7,30,30
1650753080919,MATH 109,B01,083215,Anzaldo; Leesa B,0,8,30,30
1650753080919,MATH 109,B02,083216,Anzaldo; Leesa B,0,6,30,30
1650753086943,MATH 142A,A01,083219,Chow; Bennett,0,16,30,30
1650753086943,MATH 142A,A02,083220,Chow; Bennett,0,15,30,30
1650753086943,MATH 142A,B01,083221,Chow; Bennett,0,15,30,30
1650753086943,MATH 142A,B02,083222,Chow; Bennett,0,14,30,30
1650753092975,MATH 193A,A01,083224,Staff,0,5,30,30
1650753092975,MATH 193A,A02,083225,Staff,0,6,30,30
1650753092975,MATH 193A,A03,083781,Staff,0,6,30,30
1650753092975,MATH 193A,A04,083782,Staff,0,7,30,30
1650753099007,MATH 197,001,091859,McAuley; Julian John,9998,0,9999,1
1650753105151,COGS 9,A01,083615,Staff,1,16,60,59
1650753111183,COGS 11,A01,083617,Boyle; Mary E. T.,16,0,40,24
1650753117210,COGS 13,A01,083071,Staff,0,38,40,40
1650753123243,COGS 14A,A01,092681,Staff,0,36,100,100
1650753129284,COGS 14B,A01,083073,Cheng; Tzu-Han,1,13,50,49
1650753135309,COGS 17,A01,092677,Staff,11,0,75,64
1650753141336,COGS 100,A01,083619,Staff,0,29,60,60
1650753147360,COGS 101A,A01,083621,Davis; Joshua Daniel,0,28,60,60
1650753153391,COGS 101B,A01,091572,Staff,1,4,60,59
1650753159417,COGS 101C,A01,083625,Delgado; Tania,14,0,30,16
1650753165444,COGS 107A,A01,083627,Boyle; Mary E. T.,0,16,60,60
1650753171466,COGS 118A,A01,083075,Staff,0,8,60,60
1650753177494,CSE 3,A50,083646,Miranda; Gregory Joseph,18,0,38,20
1650753177494,CSE 3,A51,083647,Miranda; Gregory Joseph,36,0,37,1
1650753183519,CSE 8A,A50,083650,Miranda; Gregory Joseph,0,30,40,40
1650753189547,CSE 11,A01,083080,Cao; Yingjun,0,96,40,40
1650753195573,CSE 12,A01,083652,Staff,0,21,100,100
1650753201596,CSE 15L,A01,083654,Staff,0,3,50,50
1650753201596,CSE 15L,A02,083655,Staff,0,2,50,50
1650753207626,CSE 20,A01,083657,Staff,49,0,80,31
1650753213654,CSE 30,A01,083084,Eldon; John,0,76,40,40
1650753219680,CSE 100,A01,083659,Cao; Yingjun,0,71,50,50
1650753225704,CSE 134B,A01,083661,Powell; Thomas Allan,0,38,65,65
1650753231730,CSE 140,A01,083663,Staff,0,11,75,75
1650753237754,CSE 140L,A01,083088,Eldon; John,0,20,75,75
1650753243779,CSE 175,A01,083665,Kumar; Rakesh,7,0,25,18
1650753249806,CSE 190,A00,092507,Dubnov; Shlomo,10,0,20,10
1650753255835,ECE 45,A01,083139,Staff,1,2,60,59
1650753261857,ECE 65,A50,083695,Staff,0,5,30,30
1650753267881,ECE 109,A01,091882,Touri; Behrouz,33,0,70,37
1650753273909,ECE 180,A00,083140,Abi Samra; Nicholas Camill,20,0,30,10
1650753273909,ECE 180,B00,083141,Abi Samra; Nicholas Camill,0,0,30,30
1650753279933,MATH 10A,A01,083735,Patchell; Gregory David,2,0,30,28
1650753279933,MATH 10A,A02,083736,Patchell; Gregory David,27,0,30,3
1650753279933,MATH 10A,A03,083737,Patchell; Gregory David,24,0,30,6
1650753285956,MATH 10B,A01,083207,Staff,0,9,30,30
1650753285956,MATH 10B,A02,083208,Staff,1,7,30,29
1650753285956,MATH 10B,B01,083739,Staff,11,0,30,19
1650753285956,MATH 10B,B02,083740,Staff,28,0,30,2
1650753291981,MATH 18,A01,083743,Staff,0,0,30,30
1650753291981,MATH 18,A02,083744,Staff,23,0,30,7
1650753291981,MATH 18,A03,083745,Staff,21,0,30,9
1650753291981,MATH 18,A04,083746,Staff,26,0,30,4
1650753291981,MATH 18,B01,083748,Staff,0,15,30,30
1650753291981,MATH 18,B02,083749,Staff,0,12,30,30
1650753291981,MATH 18,B03,083750,Staff,0,12,30,30
1650753291981,MATH 18,B04,083751,Staff,0,12,30,30
1650753298005,MATH 20A,A01,083754,Staff,19,0,40,21
1650753304031,MATH 20B,A01,083756,Staff,0,12,30,30
1650753304031,MATH 20B,A02,083757,Staff,0,12,30,30
1650753310061,MATH 20C,A01,083760,Staff,0,16,30,30
1650753310061,MATH 20C,A02,083761,Staff,0,16,30,30
1650753310061,MATH 20C,B01,083762,Staff,10,0,30,20
1650753310061,MATH 20C,B02,083763,Staff,28,0,30,2
1650753316090,MATH 20D,A01,083765,Staff,2,1,30,28
1650753316090,MATH 20D,A02,083766,Staff,5,0,30,25
1650753316090,MATH 20D,A03,083767,Staff,24,0,30,6
1650753322114,MATH 20E,A01,083771,Staff,3,0,30,27
1650753322114,MATH 20E,A02,083772,Staff,16,0,30,14
1650753322114,MATH 20E,B01,083773,Staff,0,0,30,30
1650753322114,MATH 20E,B02,083774,Staff,5,0,30,25
1650753328143,MATH 103A,A01,083777,Staff,0,16,30,30
1650753328143,MATH 103A,A02,083778,Staff,0,15,30,30
1650753328143,MATH 103A,B01,083779,Staff,0,15,30,30
1650753328143,MATH 103A,B02,083780,Staff,0,15,30,30
1650753334169,MATH 105,A01,085443,Staff,0,22,30,30
1650753340194,MATH 109,A01,083213,Anzaldo; Leesa B,0,7,30,30
1650753340194,MATH 109,A02,083214,Anzaldo; Leesa B,0,7,30,30
1650753340194,MATH 109,B01,083215,Anzaldo; Leesa B,0,8,30,30
1650753340194,MATH 109,B02,083216,Anzaldo; Leesa B,0,6,30,30
1650753346219,MATH 142A,A01,083219,Chow; Bennett,0,16,30,30
1650753346219,MATH 142A,A02,083220,Chow; Bennett,0,15,30,30
1650753346219,MATH 142A,B01,083221,Chow; Bennett,0,15,30,30
1650753346219,MATH 142A,B02,083222,Chow; Bennett,0,14,30,30
1650753352244,MATH 193A,A01,083224,Staff,0,5,30,30
1650753352244,MATH 193A,A02,083225,Staff,0,6,30,30
1650753352244,MATH 193A,A03,083781,Staff,0,6,30,30
1650753352244,MATH 193A,A04,083782,Staff,0,7,30,30
1650753358271,MATH 197,001,091859,McAuley; Julian John,9998,0,9999,1
1650753364339,COGS 9,A01,083615,Staff,1,16,60,59
1650753370364,COGS 11,A01,083617,Boyle; Mary E. T.,16,0,40,24
1650753376389,COGS 13,A01,083071,Staff,0,38,40,40
1650753382418,COGS 14A,A01,092681,Staff,0,36,100,100
1650753388442,COGS 14B,A01,083073,Cheng; Tzu-Han,1,13,50,49
1650753394470,COGS 17,A01,092677,Staff,11,0,75,64
1650753400494,COGS 100,A01,083619,Staff,0,29,60,60
1650753406518,COGS 101A,A01,083621,Davis; Joshua Daniel,0,28,60,60
1650753412541,COGS 101B,A01,091572,Staff,1,4,60,59
1650753418563,COGS 101C,A01,083625,Delgado; Tania,14,0,30,16
1650753424587,COGS 107A,A01,083627,Boyle; Mary E. T.,0,16,60,60
1650753430611,COGS 118A,A01,083075,Staff,0,8,60,60
1650753436637,CSE 3,A50,083646,Miranda; Gregory Joseph,18,0,38,20
1650753436637,CSE 3,A51,083647,Miranda; Gregory Joseph,36,0,37,1
1650753442662,CSE 8A,A50,083650,Miranda; Gregory Joseph,0,30,40,40
1650753448688,CSE 11,A01,083080,Cao; Yingjun,0,96,40,40
1650753454713,CSE 12,A01,083652,Staff,0,21,100,100
1650753460737,CSE 15L,A01,083654,Staff,0,3,50,50
1650753460737,CSE 15L,A02,083655,Staff,0,2,50,50
1650753466761,CSE 20,A01,083657,Staff,49,0,80,31
1650753472787,CSE 30,A01,083084,Eldon; John,0,76,40,40
1650753478815,CSE 100,A01,083659,Cao; Yingjun,0,71,50,50
1650753484839,CSE 134B,A01,083661,Powell; Thomas Allan,0,38,65,65
1650753490866,CSE 140,A01,083663,Staff,0,11,75,75
1650753496895,CSE 140L,A01,083088,Eldon; John,0,20,75,75
1650753502918,CSE 175,A01,083665,Kumar; Rakesh,7,0,25,18
1650753508945,CSE 190,A00,092507,Dubnov; Shlomo,10,0,20,10
1650753514971,ECE 45,A01,083139,Staff,1,2,60,59
1650753521000,ECE 65,A50,083695,Staff,0,5,30,30
1650753527025,ECE 109,A01,091882,Touri; Behrouz,33,0,70,37
1650753533053,ECE 180,A00,083140,Abi Samra; Nicholas Camill,20,0,30,10
1650753533053,ECE 180,B00,083141,Abi Samra; Nicholas Camill,0,0,30,30
1650753539081,MATH 10A,A01,083735,Patchell; Gregory David,2,0,30,28
1650753539081,MATH 10A,A02,083736,Patchell; Gregory David,27,0,30,3
1650753539081,MATH 10A,A03,083737,Patchell; Gregory David,24,0,30,6
1650753545108,MATH 10B,A01,083207,Staff,0,9,30,30
1650753545108,MATH 10B,A02,083208,Staff,1,7,30,29
1650753545108,MATH 10B,B01,083739,Staff,11,0,30,19
1650753545108,MATH 10B,B02,083740,Staff,28,0,30,2
1650753551134,MATH 18,A01,083743,Staff,0,0,30,30
1650753551134,MATH 18,A02,083744,Staff,23,0,30,7
1650753551134,MATH 18,A03,083745,Staff,21,0,30,9
1650753551134,MATH 18,A04,083746,Staff,26,0,30,4
1650753551134,MATH 18,B01,083748,Staff,0,15,30,30
1650753551134,MATH 18,B02,083749,Staff,0,12,30,30
1650753551134,MATH 18,B03,083750,Staff,0,12,30,30
1650753551134,MATH 18,B04,083751,Staff,0,12,30,30
1650753557169,MATH 20A,A01,083754,Staff,19,0,40,21
1650753563194,MATH 20B,A01,083756,Staff,0,12,30,30
1650753563194,MATH 20B,A02,083757,Staff,0,12,30,30
1650753569219,MATH 20C,A01,083760,Staff,0,16,30,30
1650753569219,MATH 20C,A02,083761,Staff,0,16,30,30
1650753569219,MATH 20C,B01,083762,Staff,10,0,30,20
1650753569219,MATH 20C,B02,083763,Staff,28,0,30,2
1650753575242,MATH 20D,A01,083765,Staff,2,1,30,28
1650753575242,MATH 20D,A02,083766,Staff,5,0,30,25
1650753575242,MATH 20D,A03,083767,Staff,24,0,30,6
1650753581270,MATH 20E,A01,083771,Staff,3,0,30,27
1650753581270,MATH 20E,A02,083772,Staff,16,0,30,14
1650753581270,MATH 20E,B01,083773,Staff,0,0,30,30
1650753581270,MATH 20E,B02,083774,Staff,5,0,30,25
1650753587294,MATH 103A,A01,083777,Staff,0,16,30,30
1650753587294,MATH 103A,A02,083778,Staff,0,15,30,30
1650753587294,MATH 103A,B01,083779,Staff,0,15,30,30
1650753587294,MATH 103A,B02,083780,Staff,0,15,30,30
1650753593326,MATH 105,A01,085443,Staff,0,22,30,30
1650753599356,MATH 109,A01,083213,Anzaldo; Leesa B,0,7,30,30
1650753599356,MATH 109,A02,083214,Anzaldo; Leesa B,0,7,30,30
1650753599356,MATH 109,B01,083215,Anzaldo; Leesa B,0,8,30,30
1650753599356,MATH 109,B02,083216,Anzaldo; Leesa B,0,6,30,30
1650753605385,MATH 142A,A01,083219,Chow; Bennett,0,16,30,30
1650753605385,MATH 142A,A02,083220,Chow; Bennett,0,15,30,30
1650753605385,MATH 142A,B01,083221,Chow; Bennett,0,15,30,30
1650753605385,MATH 142A,B02,083222,Chow; Bennett,0,14,30,30
1650753611422,MATH 193A,A01,083224,Staff,0,5,30,30
1650753611422,MATH 193A,A02,083225,Staff,0,6,30,30
1650753611422,MATH 193A,A03,083781,Staff,0,6,30,30
1650753611422,MATH 193A,A04,083782,Staff,0,7,30,30
1650753617463,MATH 197,001,091859,McAuley; Julian John,9998,0,9999,1
1650753623514,COGS 9,A01,083615,Staff,1,16,60,59
1650753629538,COGS 11,A01,083617,Boyle; Mary E. T.,16,0,40,24
1650753635562,COGS 13,A01,083071,Staff,0,38,40,40
1650753641588,COGS 14A,A01,092681,Staff,0,36,100,100
1650753647617,COGS 14B,A01,083073,Cheng; Tzu-Han,1,13,50,49
1650753653643,COGS 17,A01,092677,Staff,11,0,75,64
1650753659673,COGS 100,A01,083619,Staff,0,29,60,60
1650753665700,COGS 101A,A01,083621,Davis; Joshua Daniel,0,28,60,60
1650753671722,COGS 101B,A01,091572,Staff,1,4,60,59
1650753677750,COGS 101C,A01,083625,Delgado; Tania,14,0,30,16
1650753683777,COGS 107A,A01,083627,Boyle; Mary E. T.,0,16,60,60
1650753689801,COGS 118A,A01,083075,Staff,0,8,60,60
1650753695829,CSE 3,A50,083646,Miranda; Gregory Joseph,18,0,38,20
1650753695829,CSE 3,A51,083647,Miranda; Gregory Joseph,36,0,37,1
1650753701950,CSE 8A,A50,083650,Miranda; Gregory Joseph,0,30,40,40
1650753707977,CSE 11,A01,083080,Cao; Yingjun,0,96,40,40
1650753714013,CSE 12,A01,083652,Staff,0,21,100,100
1650753720046,CSE 15L,A01,083654,Staff,0,3,50,50
1650753720046,CSE 15L,A02,083655,Staff,0,2,50,50
1650753726073,CSE 20,A01,083657,Staff,49,0,80,31
1650753732098,CSE 30,A01,083084,Eldon; John,0,76,40,40
1650753738124,CSE 100,A01,083659,Cao; Yingjun,0,71,50,50
1650753744160,CSE 134B,A01,083661,Powell; Thomas Allan,0,38,65,65
1650753750187,CSE 140,A01,083663,Staff,0,11,75,75
1650753756214,CSE 140L,A01,083088,Eldon; John,0,20,75,75
1650753762238,CSE 175,A01,083665,Kumar; Rakesh,7,0,25,18
1650753768265,CSE 190,A00,092507,Dubnov; Shlomo,10,0,20,10
1650753774289,ECE 45,A01,083139,Staff,1,2,60,59
1650753780328,ECE 65,A50,083695,Staff,0,5,30,30
1650753786352,ECE 109,A01,091882,Touri; Behrouz,33,0,70,37
1650753792376,ECE 180,A00,083140,Abi Samra; Nicholas Camill,20,0,30,10
1650753792376,ECE 180,B00,083141,Abi Samra; Nicholas Camill,0,0,30,30
1650753798401,MATH 10A,A01,083735,Patchell; Gregory David,2,0,30,28
1650753798401,MATH 10A,A02,083736,Patchell; Gregory David,27,0,30,3
1650753798401,MATH 10A,A03,083737,Patchell; Gregory David,24,0,30,6
1650753804425,MATH 10B,A01,083207,Staff,0,9,30,30
1650753804425,MATH 10B,A02,083208,Staff,1,7,30,29
1650753804425,MATH 10B,B01,083739,Staff,11,0,30,19
1650753804425,MATH 10B,B02,083740,Staff,28,0,30,2
1650753810457,MATH 18,A01,083743,Staff,0,0,30,30
1650753810457,MATH 18,A02,083744,Staff,23,0,30,7
1650753810457,MATH 18,A03,083745,Staff,21,0,30,9
1650753810457,MATH 18,A04,083746,Staff,26,0,30,4
1650753810457,MATH 18,B01,083748,Staff,0,15,30,30
1650753810457,MATH 18,B02,083749,Staff,0,12,30,30
1650753810457,MATH 18,B03,083750,Staff,0,12,30,30
1650753810457,MATH 18,B04,083751,Staff,0,12,30,30
1650753816482,MATH 20A,A01,083754,Staff,19,0,40,21
1650753822512,MATH 20B,A01,083756,Staff,0,12,30,30
1650753822512,MATH 20B,A02,083757,Staff,0,12,30,30
1650753828549,MATH 20C,A01,083760,Staff,0,16,30,30
1650753828549,MATH 20C,A02,083761,Staff,0,16,30,30
1650753828549,MATH 20C,B01,083762,Staff,10,0,30,20
1650753828549,MATH 20C,B02,083763,Staff,28,0,30,2
1650753834575,MATH 20D,A01,083765,Staff,2,1,30,28
1650753834575,MATH 20D,A02,083766,Staff,5,0,30,25
1650753834575,MATH 20D,A03,083767,Staff,24,0,30,6
1650753840603,MATH 20E,A01,083771,Staff,3,0,30,27
1650753840603,MATH 20E,A02,083772,Staff,16,0,30,14
1650753840603,MATH 20E,B01,083773,Staff,0,0,30,30
1650753840603,MATH 20E,B02,083774,Staff,5,0,30,25
1650753846626,MATH 103A,A01,083777,Staff,0,16,30,30
1650753846626,MATH 103A,A02,083778,Staff,0,15,30,30
1650753846626,MATH 103A,B01,083779,Staff,0,15,30,30
1650753846626,MATH 103A,B02,083780,Staff,0,15,30,30
1650753852652,MATH 105,A01,085443,Staff,0,22,30,30
1650753858685,MATH 109,A01,083213,Anzaldo; Leesa B,0,7,30,30
1650753858685,MATH 109,A02,083214,Anzaldo; Leesa B,0,7,30,30
1650753858685,MATH 109,B01,083215,Anzaldo; Leesa B,0,8,30,30
1650753858685,MATH 109,B02,083216,Anzaldo; Leesa B,0,6,30,30
1650753864711,MATH 142A,A01,083219,Chow; Bennett,0,16,30,30
1650753864711,MATH 142A,A02,083220,Chow; Bennett,0,15,30,30
1650753864711,MATH 142A,B01,083221,Chow; Bennett,0,15,30,30
1650753864711,MATH 142A,B02,083222,Chow; Bennett,0,14,30,30
1650753870735,MATH 193A,A01,083224,Staff,0,5,30,30
1650753870735,MATH 193A,A02,083225,Staff,0,6,30,30
1650753870735,MATH 193A,A03,083781,Staff,0,6,30,30
1650753870735,MATH 193A,A04,083782,Staff,0,7,30,30
1650753876759,MATH 197,001,091859,McAuley; Julian John,9998,0,9999,1
1650753882809,COGS 9,A01,083615,Staff,1,16,60,59
1650753888833,COGS 11,A01,083617,Boyle; Mary E. T.,16,0,40,24
1650753894857,COGS 13,A01,083071,Staff,0,38,40,40
1650753900883,COGS 14A,A01,092681,Staff,0,36,100,100
1650753906906,COGS 14B,A01,083073,Cheng; Tzu-Han,1,13,50,49
1650753912930,COGS 17,A01,092677,Staff,11,0,75,64
1650753918953,COGS 100,A01,083619,Staff,0,29,60,60
1650753924977,COGS 101A,A01,083621,Davis; Joshua Daniel,0,28,60,60
1650753931000,COGS 101B,A01,091572,Staff,1,4,60,59
1650753937029,COGS 101C,A01,083625,Delgado; Tania,14,0,30,16
1650753943060,COGS 107A,A01,083627,Boyle; Mary E. T.,0,16,60,60
1650753949084,COGS 118A,A01,083075,Staff,0,8,60,60
1650753955112,CSE 3,A50,083646,Miranda; Gregory Joseph,18,0,38,20
1650753955112,CSE 3,A51,083647,Miranda; Gregory Joseph,36,0,37,1
1650753961141,CSE 8A,A50,083650,Miranda; Gregory Joseph,0,30,40,40
1650753967166,CSE 11,A01,083080,Cao; Yingjun,0,96,40,40
1650753973197,CSE 12,A01,083652,Staff,0,21,100,100
1650753979220,CSE 15L,A01,083654,Staff,0,3,50,50
1650753979220,CSE 15L,A02,083655,Staff,0,2,50,50
1650753985249,CSE 20,A01,083657,Staff,49,0,80,31
1650753991273,CSE 30,A01,083084,Eldon; John,0,76,40,40
1650753997300,CSE 100,A01,083659,Cao; Yingjun,0,71,50,50
1650754003324,CSE 134B,A01,083661,Powell; Thomas Allan,0,38,65,65
1650754009359,CSE 140,A01,083663,Staff,0,11,75,75
1650754015385,CSE 140L,A01,083088,Eldon; John,0,20,75,75
1650754021408,CSE 175,A01,083665,Kumar; Rakesh,7,0,25,18
1650754027436,CSE 190,A00,092507,Dubnov; Shlomo,10,0,20,10
1650754033460,ECE 45,A01,083139,Staff,1,2,60,59
1650754039485,ECE 65,A50,083695,Staff,0,5,30,30
1650754045507,ECE 109,A01,091882,Touri; Behrouz,33,0,70,37
1650754051533,ECE 180,A00,083140,Abi Samra; Nicholas Camill,20,0,30,10
1650754051533,ECE 180,B00,083141,Abi Samra; Nicholas Camill,0,0,30,30
1650754057559,MATH 10A,A01,083735,Patchell; Gregory David,2,0,30,28
1650754057559,MATH 10A,A02,083736,Patchell; Gregory David,27,0,30,3
1650754057559,MATH 10A,A03,083737,Patchell; Gregory David,24,0,30,6
1650754063586,MATH 10B,A01,083207,Staff,0,9,30,30
1650754063586,MATH 10B,A02,083208,Staff,1,7,30,29
1650754063586,MATH 10B,B01,083739,Staff,11,0,30,19
1650754063586,MATH 10B,B02,083740,Staff,28,0,30,2
1650754069616,MATH 18,A01,083743,Staff,0,0,30,30
1650754069616,MATH 18,A02,083744,Staff,23,0,30,7
1650754069616,MATH 18,A03,083745,Staff,21,0,30,9
1650754069616,MATH 18,A04,083746,Staff,26,0,30,4
1650754069616,MATH 18,B01,083748,Staff,0,15,30,30
1650754069616,MATH 18,B02,083749,Staff,0,12,30,30
1650754069616,MATH 18,B03,083750,Staff,0,12,30,30
1650754069616,MATH 18,B04,083751,Staff,0,12,30,30
1650754075640,MATH 20A,A01,083754,Staff,19,0,40,21
1650754081665,MATH 20B,A01,083756,Staff,0,12,30,30
1650754081665,MATH 20B,A02,083757,Staff,0,12,30,30
1650754087690,MATH 20C,A01,083760,Staff,0,16,30,30
1650754087690,MATH 20C,A02,083761,Staff,0,16,30,30
1650754087690,MATH 20C,B01,083762,Staff,10,0,30,20
1650754087690,MATH 20C,B02,083763,Staff,28,0,30,2
1650754093712,MATH 20D,A01,083765,Staff,2,1,30,28
1650754093712,MATH 20D,A02,083766,Staff,5,0,30,25
1650754093712,MATH 20D,A03,083767,Staff,24,0,30,6
1650754099736,MATH 20E,A01,083771,Staff,3,0,30,27
1650754099736,MATH 20E,A02,083772,Staff,16,0,30,14
1650754099736,MATH 20E,B01,083773,Staff,0,0,30,30
1650754099736,MATH 20E,B02,083774,Staff,5,0,30,25
1650754105761,MATH 103A,A01,083777,Staff,0,16,30,30
1650754105761,MATH 103A,A02,083778,Staff,0,15,30,30
1650754105761,MATH 103A,B01,083779,Staff,0,15,30,30
1650754105761,MATH 103A,B02,083780,Staff,0,15,30,30
1650754111788,MATH 105,A01,085443,Staff,0,22,30,30
1650754117812,MATH 109,A01,083213,Anzaldo; Leesa B,0,7,30,30
1650754117812,MATH 109,A02,083214,Anzaldo; Leesa B,0,7,30,30
1650754117812,MATH 109,B01,083215,Anzaldo; Leesa B,0,8,30,30
1650754117812,MATH 109,B02,083216,Anzaldo; Leesa B,0,6,30,30
1650754123839,MATH 142A,A01,083219,Chow; Bennett,0,16,30,30
1650754123839,MATH 142A,A02,083220,Chow; Bennett,0,15,30,30
1650754123839,MATH 142A,B01,083221,Chow; Bennett,0,15,30,30
1650754123839,MATH 142A,B02,083222,Chow; Bennett,0,14,30,30
1650754129867,MATH 193A,A01,083224,Staff,0,5,30,30
1650754129867,MATH 193A,A02,083225,Staff,0,6,30,30
1650754129867,MATH 193A,A03,083781,Staff,0,6,30,30
1650754129867,MATH 193A,A04,083782,Staff,0,7,30,30
1650754135889,MATH 197,001,091859,McAuley; Julian John,9998,0,9999,1
1650754141960,COGS 9,A01,083615,Staff,1,16,60,59
1650754147988,COGS 11,A01,083617,Boyle; Mary E. T.,16,0,40,24
1650754154015,COGS 13,A01,083071,Staff,0,38,40,40
1650754160049,COGS 14A,A01,092681,Staff,0,36,100,100
1650754166073,COGS 14B,A01,083073,Cheng; Tzu-Han,1,13,50,49
1650754172096,COGS 17,A01,092677,Staff,11,0,75,64
1650754178123,COGS 100,A01,083619,Staff,0,29,60,60
1650754184151,COGS 101A,A01,083621,Davis; Joshua Daniel,0,28,60,60
1650754190175,COGS 101B,A01,091572,Staff,1,4,60,59
1650754196204,COGS 101C,A01,083625,Delgado; Tania,14,0,30,16
1650754202230,COGS 107A,A01,083627,Boyle; Mary E. T.,0,16,60,60
1650754208341,COGS 118A,A01,083075,Staff,0,8,60,60
1650754214365,CSE 3,A50,083646,Miranda; Gregory Joseph,18,0,38,20
1650754214365,CSE 3,A51,083647,Miranda; Gregory Joseph,36,0,37,1
1650754220393,CSE 8A,A50,083650,Miranda; Gregory Joseph,0,30,40,40
1650754226420,CSE 11,A01,083080,Cao; Yingjun,0,96,40,40
1650754232443,CSE 12,A01,083652,Staff,0,21,100,100
1650754238471,CSE 15L,A01,083654,Staff,0,3,50,50
1650754238471,CSE 15L,A02,083655,Staff,0,2,50,50
1650754244493,CSE 20,A01,083657,Staff,49,0,80,31
1650754250516,CSE 30,A01,083084,Eldon; John,0,76,40,40
1650754256539,CSE 100,A01,083659,Cao; Yingjun,0,71,50,50
1650754262565,CSE 134B,A01,083661,Powell; Thomas Allan,0,38,65,65
1650754268592,CSE 140,A01,083663,Staff,0,11,75,75
1650754274616,CSE 140L,A01,083088,Eldon; John,0,20,75,75
1650754280640,CSE 175,A01,083665,Kumar; Rakesh,7,0,25,18
1650754286667,CSE 190,A00,092507,Dubnov; Shlomo,10,0,20,10
1650754292691,ECE 45,A01,083139,Staff,1,2,60,59
1650754298804,ECE 65,A50,083695,Staff,0,5,30,30
1650754304827,ECE 109,A01,091882,Touri; Behrouz,33,0,70,37
1650754310870,ECE 180,A00,083140,Abi Samra; Nicholas Camill,20,0,30,10
1650754310870,ECE 180,B00,083141,Abi Samra; Nicholas Camill,0,0,30,30
1650754316896,MATH 10A,A01,083735,Patchell; Gregory David,2,0,30,28
1650754316896,MATH 10A,A02,083736,Patchell; Gregory David,27,0,30,3
1650754316896,MATH 10A,A03,083737,Patchell; Gregory David,24,0,30,6
1650754322923,MATH 10B,A01,083207,Staff,0,9,30,30
1650754322923,MATH 10B,A02,083208,Staff,1,7,30,29
1650754322923,MATH 10B,B01,083739,Staff,11,0,30,19
1650754322923,MATH 10B,B02,083740,Staff,28,0,30,2
1650754328962,MATH 18,A01,083743,Staff,0,0,30,30
1650754328962,MATH 18,A02,083744,Staff,23,0,30,7
1650754328962,MATH 18,A03,083745,Staff,21,0,30,9
1650754328962,MATH 18,A04,083746,Staff,26,0,30,4
1650754328962,MATH 18,B01,083748,Staff,0,15,30,30
1650754328962,MATH 18,B02,083749,Staff,0,12,30,30
1650754328962,MATH 18,B03,083750,Staff,0,12,30,30
1650754328962,MATH 18,B04,083751,Staff,0,12,30,30
1650754334989,MATH 20A,A01,083754,Staff,19,0,40,21
1650754341016,MATH 20B,A01,083756,Staff,0,12,30,30
1650754341016,MATH 20B,A02,083757,Staff,0,12,30,30
1650754347041,MATH 20C,A01,083760,Staff,0,16,30,30
1650754347041,MATH 20C,A02,083761,Staff,0,16,30,30
1650754347041,MATH 20C,B01,083762,Staff,10,0,30,20
1650754347041,MATH 20C,B02,083763,Staff,28,0,30,2
1650754353066,MATH 20D,A01,083765,Staff,2,1,30,28
1650754353066,MATH 20D,A02,083766,Staff,5,0,30,25
1650754353066,MATH 20D,A03,083767,Staff,24,0,30,6
1650754359091,MATH 20E,A01,083771,Staff,3,0,30,27
1650754359091,MATH 20E,A02,083772,Staff,16,0,30,14
1650754359091,MATH 20E,B01,083773,Staff,0,0,30,30
1650754359091,MATH 20E,B02,083774,Staff,5,0,30,25
1650754365117,MATH 103A,A01,083777,Staff,0,16,30,30
1650754365117,MATH 103A,A02,083778,Staff,0,15,30,30
1650754365117,MATH 103A,B01,083779,Staff,0,15,30,30
1650754365117,MATH 103A,B02,083780,Staff,0,15,30,30
1650754371142,MATH 105,A01,085443,Staff,0,22,30,30
1650754377164,MATH 109,A01,083213,Anzaldo; Leesa B,0,7,30,30
1650754377164,MATH 109,A02,083214,Anzaldo; Leesa B,0,7,30,30
1650754377164,MATH 109,B01,083215,Anzaldo; Leesa B,0,8,30,30
1650754377164,MATH 109,B02,083216,Anzaldo; Leesa B,0,6,30,30
1650754383188,MATH 142A,A01,083219,Chow; Bennett,0,16,30,30
1650754383188,MATH 142A,A02,083220,Chow; Bennett,0,15,30,30
1650754383188,MATH 142A,B01,083221,Chow; Bennett,0,15,30,30
1650754383188,MATH 142A,B02,083222,Chow; Bennett,0,14,30,30
1650754389210,MATH 193A,A01,083224,Staff,0,5,30,30
1650754389210,MATH 193A,A02,083225,Staff,0,6,30,30
1650754389210,MATH 193A,A03,083781,Staff,0,6,30,30
1650754389210,MATH 193A,A04,083782,Staff,0,7,30,30
1650754395236,MATH 197,001,091859,McAuley; Julian John,9998,0,9999,1
1650754401286,COGS 9,A01,083615,Staff,1,16,60,59
1650754407310,COGS 11,A01,083617,Boyle; Mary E. T.,16,0,40,24
1650754413334,COGS 13,A01,083071,Staff,0,38,40,40
1650754419358,COGS 14A,A01,092681,Staff,0,36,100,100
1650754425385,COGS 14B,A01,083073,Cheng; Tzu-Han,1,13,50,49
1650754431413,COGS 17,A01,092677,Staff,11,0,75,64
1650754437440,COGS 100,A01,083619,Staff,0,29,60,60
1650754443467,COGS 101A,A01,083621,Davis; Joshua Daniel,0,28,60,60
1650754449493,COGS 101B,A01,091572,Staff,1,4,60,59
1650754455520,COGS 101C,A01,083625,Delgado; Tania,14,0,30,16
1650754461544,COGS 107A,A01,083627,Boyle; Mary E. T.,0,16,60,60
1650754467569,COGS 118A,A01,083075,Staff,0,8,60,60
1650754473599,CSE 3,A50,083646,Miranda; Gregory Joseph,18,0,38,20
1650754473599,CSE 3,A51,083647,Miranda; Gregory Joseph,36,0,37,1
1650754479623,CSE 8A,A50,083650,Miranda; Gregory Joseph,0,30,40,40
1650754485653,CSE 11,A01,083080,Cao; Yingjun,0,96,40,40
1650754491676,CSE 12,A01,083652,Staff,0,21,100,100
1650754497700,CSE 15L,A01,083654,Staff,0,3,50,50
1650754497700,CSE 15L,A02,083655,Staff,0,2,50,50
1650754503725,CSE 20,A01,083657,Staff,49,0,80,31
1650754509754,CSE 30,A01,083084,Eldon; John,0,76,40,40
1650754515778,CSE 100,A01,083659,Cao; Yingjun,0,71,50,50
1650754521801,CSE 134B,A01,083661,Powell; Thomas Allan,0,38,65,65
1650754527827,CSE 140,A01,083663,Staff,0,11,75,75
1650754533850,CSE 140L,A01,083088,Eldon; John,0,20,75,75
1650754539876,CSE 175,A01,083665,Kumar; Rakesh,7,0,25,18
1650754545904,CSE 190,A00,092507,Dubnov; Shlomo,10,0,20,10
1650754551931,ECE 45,A01,083139,Staff,1,2,60,59
1650754557956,ECE 65,A50,083695,Staff,0,5,30,30
1650754563984,ECE 109,A01,091882,Touri; Behrouz,33,0,70,37
1650754570012,ECE 180,A00,083140,Abi Samra; Nicholas Camill,20,0,30,10
1650754570012,ECE 180,B00,083141,Abi Samra; Nicholas Camill,0,0,30,30
1650754576040,MATH 10A,A01,083735,Patchell; Gregory David,2,0,30,28
1650754576040,MATH 10A,A02,083736,Patchell; Gregory David,27,0,30,3
1650754576040,MATH 10A,A03,083737,Patchell; Gregory David,24,0,30,6
1650754582064,MATH 10B,A01,083207,Staff,0,9,30,30
1650754582064,MATH 10B,A02,083208,Staff,1,7,30,29
1650754582064,MATH 10B,B01,083739,Staff,11,0,30,19
1650754582064,MATH 10B,B02,083740,Staff,28,0,30,2
1650754588090,MATH 18,A01,083743,Staff,0,0,30,30
1650754588090,MATH 18,A02,083744,Staff,23,0,30,7
1650754588090,MATH 18,A03,083745,Staff,21,0,30,9
1650754588090,MATH 18,A04,083746,Staff,26,0,30,4
1650754588090,MATH 18,B01,083748,Staff,0,15,30,30
1650754588090,MATH 18,B02,083749,Staff,0,12,30,30
1650754588090,MATH 18,B03,083750,Staff,0,12,30,30
1650754588090,MATH 18,B04,083751,Staff,0,12,30,30
1650754594117,MATH 20A,A01,083754,Staff,19,0,40,21
1650754600148,MATH 20B,A01,083756,Staff,0,12,30,30
1650754600148,MATH 20B,A02,083757,Staff,0,12,30,30
1650754606173,MATH 20C,A01,083760,Staff,0,16,30,30
1650754606173,MATH 20C,A02,083761,Staff,0,16,30,30
1650754606173,MATH 20C,B01,083762,Staff,10,0,30,20
1650754606173,MATH 20C,B02,083763,Staff,28,0,30,2
1650754612206,MATH 20D,A01,083765,Staff,2,1,30,28
1650754612206,MATH 20D,A02,083766,Staff,5,0,30,25
1650754612206,MATH 20D,A03,083767,Staff,24,0,30,6
1650754618234,MATH 20E,A01,083771,Staff,3,0,30,27
1650754618234,MATH 20E,A02,083772,Staff,16,0,30,14
1650754618234,MATH 20E,B01,083773,Staff,0,0,30,30
1650754618234,MATH 20E,B02,083774,Staff,5,0,30,25
1650754624259,MATH 103A,A01,083777,Staff,0,16,30,30
1650754624259,MATH 103A,A02,083778,Staff,0,15,30,30
1650754624259,MATH 103A,B01,083779,Staff,0,15,30,30
1650754624259,MATH 103A,B02,083780,Staff,0,15,30,30
1650754630285,MATH 105,A01,085443,Staff,0,22,30,30
1650754636310,MATH 109,A01,083213,Anzaldo; Leesa B,0,7,30,30
1650754636310,MATH 109,A02,083214,Anzaldo; Leesa B,0,7,30,30
1650754636310,MATH 109,B01,083215,Anzaldo; Leesa B,0,8,30,30
1650754636310,MATH 109,B02,083216,Anzaldo; Leesa B,0,6,30,30
1650754642340,MATH 142A,A01,083219,Chow; Bennett,0,16,30,30
1650754642340,MATH 142A,A02,083220,Chow; Bennett,0,15,30,30
1650754642340,MATH 142A,B01,083221,Chow; Bennett,0,15,30,30
1650754642340,MATH 142A,B02,083222,Chow; Bennett,0,14,30,30
1650754648371,MATH 193A,A01,083224,Staff,0,5,30,30
1650754648371,MATH 193A,A02,083225,Staff,0,6,30,30
1650754648371,MATH 193A,A03,083781,Staff,0,6,30,30
1650754648371,MATH 193A,A04,083782,Staff,0,7,30,30
1650754654393,MATH 197,001,091859,McAuley; Julian John,9998,0,9999,1
1650754660452,COGS 9,A01,083615,Staff,1,16,60,59
1650754666474,COGS 11,A01,083617,Boyle; Mary E. T.,16,0,40,24
1650754672500,COGS 13,A01,083071,Staff,0,38,40,40
1650754678524,COGS 14A,A01,092681,Staff,0,36,100,100
1650754684548,COGS 14B,A01,083073,Cheng; Tzu-Han,1,13,50,49
1650754690576,COGS 17,A01,092677,Staff,11,0,75,64
1650754696607,COGS 100,A01,083619,Staff,0,29,60,60
1650754702632,COGS 101A,A01,083621,Davis; Joshua Daniel,0,28,60,60
1650754708655,COGS 101B,A01,091572,Staff,1,4,60,59
1650754714678,COGS 101C,A01,083625,Delgado; Tania,14,0,30,16
1650754720701,COGS 107A,A01,083627,Boyle; Mary E. T.,0,16,60,60
1650754726725,COGS 118A,A01,083075,Staff,0,8,60,60
1650754732750,CSE 3,A50,083646,Miranda; Gregory Joseph,18,0,38,20
1650754732750,CSE 3,A51,083647,Miranda; Gregory Joseph,36,0,37,1
1650754738774,CSE 8A,A50,083650,Miranda; Gregory Joseph,0,30,40,40
1650754744798,CSE 11,A01,083080,Cao; Yingjun,0,96,40,40
1650754750823,CSE 12,A01,083652,Staff,0,21,100,100
1650754756850,CSE 15L,A01,083654,Staff,0,3,50,50
1650754756850,CSE 15L,A02,083655,Staff,0,2,50,50
1650754762881,CSE 20,A01,083657,Staff,49,0,80,31
1650754768908,CSE 30,A01,083084,Eldon; John,0,76,40,40
1650754774933,CSE 100,A01,083659,Cao; Yingjun,0,71,50,50
1650754780961,CSE 134B,A01,083661,Powell; Thomas Allan,0,38,65,65
1650754786985,CSE 140,A01,083663,Staff,0,11,75,75
1650754793007,CSE 140L,A01,083088,Eldon; John,0,20,75,75
1650754799033,CSE 175,A01,083665,Kumar; Rakesh,7,0,25,18
1650754805058,CSE 190,A00,092507,Dubnov; Shlomo,10,0,20,10
1650754811088,ECE 45,A01,083139,Staff,1,2,60,59
1650754817111,ECE 65,A50,083695,Staff,0,5,30,30
1650754823134,ECE 109,A01,091882,Touri; Behrouz,33,0,70,37
1650754829160,ECE 180,A00,083140,Abi Samra; Nicholas Camill,20,0,30,10
1650754829160,ECE 180,B00,083141,Abi Samra; Nicholas Camill,0,0,30,30
1650754835184,MATH 10A,A01,083735,Patchell; Gregory David,2,0,30,28
1650754835184,MATH 10A,A02,083736,Patchell; Gregory David,27,0,30,3
1650754835184,MATH 10A,A03,083737,Patchell; Gregory David,24,0,30,6
1650754841209,MATH 10B,A01,083207,Staff,0,9,30,30
1650754841209,MATH 10B,A02,083208,Staff,1,7,30,29
1650754841209,MATH 10B,B01,083739,Staff,11,0,30,19
1650754841209,MATH 10B,B02,083740,Staff,28,0,30,2
1650754847250,MATH 18,A01,083743,Staff,0,0,30,30
1650754847250,MATH 18,A02,083744,Staff,23,0,30,7
1650754847250,MATH 18,A03,083745,Staff,21,0,30,9
1650754847250,MATH 18,A04,083746,Staff,26,0,30,4
1650754847250,MATH 18,B01,083748,Staff,0,15,30,30
1650754847250,MATH 18,B02,083749,Staff,0,12,30,30
1650754847250,MATH 18,B03,083750,Staff,0,12,30,30
1650754847250,MATH 18,B04,083751,Staff,0,12,30,30
1650754853273,MATH 20A,A01,083754,Staff,19,0,40,21
1650754859298,MATH 20B,A01,083756,Staff,0,12,30,30
1650754859298,MATH 20B,A02,083757,Staff,0,12,30,30
1650754865324,MATH 20C,A01,083760,Staff,0,16,30,30
1650754865324,MATH 20C,A02,083761,Staff,0,16,30,30
1650754865324,MATH 20C,B01,083762,Staff,10,0,30,20
1650754865324,MATH 20C,B02,083763,Staff,28,0,30,2
1650754871348,MATH 20D,A01,083765,Staff,2,1,30,28
1650754871348,MATH 20D,A02,083766,Staff,5,0,30,25
1650754871348,MATH 20D,A03,083767,Staff,24,0,30,6
1650754877372,MATH 20E,A01,083771,Staff,3,0,30,27
1650754877372,MATH 20E,A02,083772,Staff,16,0,30,14
1650754877372,MATH 20E,B01,083773,Staff,0,0,30,30
1650754877372,MATH 20E,B02,083774,Staff,5,0,30,25
1650754883398,MATH 103A,A01,083777,Staff,0,16,30,30
1650754883398,MATH 103A,A02,083778,Staff,0,15,30,30
1650754883398,MATH 103A,B01,083779,Staff,0,15,30,30
1650754883398,MATH 103A,B02,083780,Staff,0,15,30,30
1650754889422,MATH 105,A01,085443,Staff,0,22,30,30
1650754895539,MATH 109,A01,083213,Anzaldo; Leesa B,0,7,30,30
1650754895539,MATH 109,A02,083214,Anzaldo; Leesa B,0,7,30,30
1650754895539,MATH 109,B01,083215,Anzaldo; Leesa B,0,8,30,30
1650754895539,MATH 109,B02,083216,Anzaldo; Leesa B,0,6,30,30
1650754901567,MATH 142A,A01,083219,Chow; Bennett,0,16,30,30
1650754901567,MATH 142A,A02,083220,Chow; Bennett,0,15,30,30
1650754901567,MATH 142A,B01,083221,Chow; Bennett,0,15,30,30
1650754901567,MATH 142A,B02,083222,Chow; Bennett,0,14,30,30
1650754907591,MATH 193A,A01,083224,Staff,0,5,30,30
1650754907591,MATH 193A,A02,083225,Staff,0,6,30,30
1650754907591,MATH 193A,A03,083781,Staff,0,6,30,30
1650754907591,MATH 193A,A04,083782,Staff,0,7,30,30
1650754913618,MATH 197,001,091859,McAuley; Julian John,9998,0,9999,1
1650754919679,COGS 9,A01,083615,Staff,1,16,60,59
1650754925702,COGS 11,A01,083617,Boyle; Mary E. T.,16,0,40,24
1650754931730,COGS 13,A01,083071,Staff,0,38,40,40
1650754937761,COGS 14A,A01,092681,Staff,0,36,100,100
1650754943803,COGS 14B,A01,083073,Cheng; Tzu-Han,1,13,50,49
1650754949827,COGS 17,A01,092677,Staff,11,0,75,64
1650754955852,COGS 100,A01,083619,Staff,0,29,60,60
1650754961886,COGS 101A,A01,083621,Davis; Joshua Daniel,0,28,60,60
1650754967914,COGS 101B,A01,091572,Staff,1,4,60,59
1650754973940,COGS 101C,A01,083625,Delgado; Tania,14,0,30,16
1650754979968,COGS 107A,A01,083627,Boyle; Mary E. T.,0,16,60,60
1650754985993,COGS 118A,A01,083075,Staff,0,8,60,60
1650754992024,CSE 3,A50,083646,Miranda; Gregory Joseph,18,0,38,20
1650754992024,CSE 3,A51,083647,Miranda; Gregory Joseph,36,0,37,1
1650754998049,CSE 8A,A50,083650,Miranda; Gregory Joseph,0,30,40,40
1650755004077,CSE 11,A01,083080,Cao; Yingjun,0,96,40,40
1650755010104,CSE 12,A01,083652,Staff,0,21,100,100
1650755016133,CSE 15L,A01,083654,Staff,0,3,50,50
1650755016133,CSE 15L,A02,083655,Staff,0,2,50,50
1650755022160,CSE 20,A01,083657,Staff,49,0,80,31
1650755028188,CSE 30,A01,083084,Eldon; John,0,76,40,40
1650755034215,CSE 100,A01,083659,Cao; Yingjun,0,71,50,50
1650755040240,CSE 134B,A01,083661,Powell; Thomas Allan,0,38,65,65
1650755046266,CSE 140,A01,083663,Staff,0,11,75,75
1650755052290,CSE 140L,A01,083088,Eldon; John,0,20,75,75
1650755063028,CSE 175,A01,083665,Kumar; Rakesh,7,0,25,18
1650755069053,CSE 190,A00,092507,Dubnov; Shlomo,10,0,20,10
1650755075080,ECE 45,A01,083139,Staff,1,2,60,59
1650755081105,ECE 65,A50,083695,Staff,0,5,30,30
1650755087127,ECE 109,A01,091882,Touri; Behrouz,33,0,70,37
1650755093151,ECE 180,A00,083140,Abi Samra; Nicholas Camill,20,0,30,10
1650755093151,ECE 180,B00,083141,Abi Samra; Nicholas Camill,0,0,30,30
1650755099176,MATH 10A,A01,083735,Patchell; Gregory David,2,0,30,28
1650755099176,MATH 10A,A02,083736,Patchell; Gregory David,27,0,30,3
1650755099176,MATH 10A,A03,083737,Patchell; Gregory David,24,0,30,6
1650755105200,MATH 10B,A01,083207,Staff,0,9,30,30
1650755105200,MATH 10B,A02,083208,Staff,1,7,30,29
1650755105200,MATH 10B,B01,083739,Staff,11,0,30,19
1650755105200,MATH 10B,B02,083740,Staff,28,0,30,2
1650755111228,MATH 18,A01,083743,Staff,0,0,30,30
1650755111228,MATH 18,A02,083744,Staff,23,0,30,7
1650755111228,MATH 18,A03,083745,Staff,21,0,30,9
1650755111228,MATH 18,A04,083746,Staff,26,0,30,4
1650755111228,MATH 18,B01,083748,Staff,0,15,30,30
1650755111228,MATH 18,B02,083749,Staff,0,12,30,30
1650755111228,MATH 18,B03,083750,Staff,0,12,30,30
1650755111228,MATH 18,B04,083751,Staff,0,12,30,30
1650755117255,MATH 20A,A01,083754,Staff,19,0,40,21
1650755123277,MATH 20B,A01,083756,Staff,0,12,30,30
1650755123277,MATH 20B,A02,083757,Staff,0,12,30,30
1650755129305,MATH 20C,A01,083760,Staff,0,16,30,30
1650755129305,MATH 20C,A02,083761,Staff,0,16,30,30
1650755129305,MATH 20C,B01,083762,Staff,10,0,30,20
1650755129305,MATH 20C,B02,083763,Staff,28,0,30,2
1650755135333,MATH 20D,A01,083765,Staff,2,1,30,28
1650755135333,MATH 20D,A02,083766,Staff,5,0,30,25
1650755135333,MATH 20D,A03,083767,Staff,24,0,30,6
1650755141357,MATH 20E,A01,083771,Staff,3,0,30,27
1650755141357,MATH 20E,A02,083772,Staff,16,0,30,14
1650755141357,MATH 20E,B01,083773,Staff,0,0,30,30
1650755141357,MATH 20E,B02,083774,Staff,5,0,30,25
1650755147386,MATH 103A,A01,083777,Staff,0,16,30,30
1650755147386,MATH 103A,A02,083778,Staff,0,15,30,30
1650755147386,MATH 103A,B01,083779,Staff,0,15,30,30
1650755147386,MATH 103A,B02,083780,Staff,0,15,30,30
1650755153410,MATH 105,A01,085443,Staff,0,22,30,30
1650755159454,MATH 109,A01,083213,Anzaldo; Leesa B,0,7,30,30
1650755159454,MATH 109,A02,083214,Anzaldo; Leesa B,0,7,30,30
1650755159454,MATH 109,B01,083215,Anzaldo; Leesa B,0,8,30,30
1650755159454,MATH 109,B02,083216,Anzaldo; Leesa B,0,6,30,30
1650755165480,MATH 142A,A01,083219,Chow; Bennett,0,16,30,30
1650755165480,MATH 142A,A02,083220,Chow; Bennett,0,15,30,30
1650755165480,MATH 142A,B01,083221,Chow; Bennett,0,15,30,30
1650755165480,MATH 142A,B02,083222,Chow; Bennett,0,14,30,30
1650755171505,MATH 193A,A01,083224,Staff,0,5,30,30
1650755171505,MATH 193A,A02,083225,Staff,0,6,30,30
1650755171505,MATH 193A,A03,083781,Staff,0,6,30,30
1650755171505,MATH 193A,A04,083782,Staff,0,7,30,30
1650755177530,MATH 197,001,091859,McAuley; Julian John,9998,0,9999,1
1650755183591,COGS 9,A01,083615,Staff,1,16,60,59
1650755189617,COGS 11,A01,083617,Boyle; Mary E. T.,16,0,40,24
1650755195641,COGS 13,A01,083071,Staff,0,38,40,40
1650755201679,COGS 14A,A01,092681,Staff,0,36,100,100
1650755207706,COGS 14B,A01,083073,Cheng; Tzu-Han,1,13,50,49
1650755213733,COGS 17,A01,092677,Staff,11,0,75,64
1650755219760,COGS 100,A01,083619,Staff,0,29,60,60
1650755225784,COGS 101A,A01,083621,Davis; Joshua Daniel,0,28,60,60
1650755231809,COGS 101B,A01,091572,Staff,1,4,60,59
1650755237834,COGS 101C,A01,083625,Delgado; Tania,14,0,30,16
1650755243857,COGS 107A,A01,083627,Boyle; Mary E. T.,0,16,60,60
1650755249882,COGS 118A,A01,083075,Staff,0,8,60,60
1650755255906,CSE 3,A50,083646,Miranda; Gregory Joseph,18,0,38,20
1650755255906,CSE 3,A51,083647,Miranda; Gregory Joseph,36,0,37,1
1650755261931,CSE 8A,A50,083650,Miranda; Gregory Joseph,0,30,40,40
1650755267958,CSE 11,A01,083080,Cao; Yingjun,0,96,40,40
1650755273985,CSE 12,A01,083652,Staff,0,21,100,100
1650755280008,CSE 15L,A01,083654,Staff,0,3,50,50
1650755280008,CSE 15L,A02,083655,Staff,0,2,50,50
1650755286042,CSE 20,A01,083657,Staff,49,0,80,31
1650755292071,CSE 30,A01,083084,Eldon; John,0,76,40,40
1650755298095,CSE 100,A01,083659,Cao; Yingjun,0,71,50,50
1650755304122,CSE 134B,A01,083661,Powell; Thomas Allan,0,38,65,65
1650755310149,CSE 140,A01,083663,Staff,0,11,75,75
1650755316174,CSE 140L,A01,083088,Eldon; John,0,20,75,75
1650755322198,CSE 175,A01,083665,Kumar; Rakesh,7,0,25,18
1650755328222,CSE 190,A00,092507,Dubnov; Shlomo,10,0,20,10
1650755334248,ECE 45,A01,083139,Staff,1,2,60,59
1650755340274,ECE 65,A50,083695,Staff,0,5,30,30
1650755346297,ECE 109,A01,091882,Touri; Behrouz,33,0,70,37
1650755352321,ECE 180,A00,083140,Abi Samra; Nicholas Camill,20,0,30,10
1650755352321,ECE 180,B00,083141,Abi Samra; Nicholas Camill,0,0,30,30
1650755358345,MATH 10A,A01,083735,Patchell; Gregory David,2,0,30,28
1650755358345,MATH 10A,A02,083736,Patchell; Gregory David,27,0,30,3
1650755358345,MATH 10A,A03,083737,Patchell; Gregory David,24,0,30,6
1650755364372,MATH 10B,A01,083207,Staff,0,9,30,30
1650755364372,MATH 10B,A02,083208,Staff,1,7,30,29
1650755364372,MATH 10B,B01,083739,Staff,11,0,30,19
1650755364372,MATH 10B,B02,083740,Staff,28,0,30,2
1650755370401,MATH 18,A01,083743,Staff,0,0,30,30
1650755370401,MATH 18,A02,083744,Staff,23,0,30,7
1650755370401,MATH 18,A03,083745,Staff,21,0,30,9
1650755370401,MATH 18,A04,083746,Staff,26,0,30,4
1650755370401,MATH 18,B01,083748,Staff,0,15,30,30
1650755370401,MATH 18,B02,083749,Staff,0,12,30,30
1650755370401,MATH 18,B03,083750,Staff,0,12,30,30
1650755370401,MATH 18,B04,083751,Staff,0,12,30,30
1650755376424,MATH 20A,A01,083754,Staff,19,0,40,21
1650755382450,MATH 20B,A01,083756,Staff,0,12,30,30
1650755382450,MATH 20B,A02,083757,Staff,0,12,30,30
1650755388480,MATH 20C,A01,083760,Staff,0,16,30,30
1650755388480,MATH 20C,A02,083761,Staff,0,16,30,30
1650755388480,MATH 20C,B01,083762,Staff,10,0,30,20
1650755388480,MATH 20C,B02,083763,Staff,28,0,30,2
1650755394503,MATH 20D,A01,083765,Staff,2,1,30,28
1650755394503,MATH 20D,A02,083766,Staff,5,0,30,25
1650755394503,MATH 20D,A03,083767,Staff,24,0,30,6
1650755400528,MATH 20E,A01,083771,Staff,3,0,30,27
1650755400528,MATH 20E,A02,083772,Staff,16,0,30,14
1650755400528,MATH 20E,B01,083773,Staff,0,0,30,30
1650755400528,MATH 20E,B02,083774,Staff,5,0,30,25
1650755406554,MATH 103A,A01,083777,Staff,0,16,30,30
1650755406554,MATH 103A,A02,083778,Staff,0,15,30,30
1650755406554,MATH 103A,B01,083779,Staff,0,15,30,30
1650755406554,MATH 103A,B02,083780,Staff,0,15,30,30
1650755412576,MATH 105,A01,085443,Staff,0,22,30,30
1650755418599,MATH 109,A01,083213,Anzaldo; Leesa B,0,7,30,30
1650755418599,MATH 109,A02,083214,Anzaldo; Leesa B,0,7,30,30
1650755418599,MATH 109,B01,083215,Anzaldo; Leesa B,0,8,30,30
1650755418599,MATH 109,B02,083216,Anzaldo; Leesa B,0,6,30,30
1650755424626,MATH 142A,A01,083219,Chow; Bennett,0,16,30,30
1650755424626,MATH 142A,A02,083220,Chow; Bennett,0,15,30,30
1650755424626,MATH 142A,B01,083221,Chow; Bennett,0,15,30,30
1650755424626,MATH 142A,B02,083222,Chow; Bennett,0,14,30,30
1650755430650,MATH 193A,A01,083224,Staff,0,5,30,30
1650755430650,MATH 193A,A02,083225,Staff,0,6,30,30
1650755430650,MATH 193A,A03,083781,Staff,0,6,30,30
1650755430650,MATH 193A,A04,083782,Staff,0,7,30,30
1650755436675,MATH 197,001,091859,McAuley; Julian John,9998,0,9999,1
1650755442732,COGS 9,A01,083615,Staff,1,16,60,59
1650755448756,COGS 11,A01,083617,Boyle; Mary E. T.,16,0,40,24
1650755454781,COGS 13,A01,083071,Staff,0,38,40,40
1650755460803,COGS 14A,A01,092681,Staff,0,36,100,100
1650755466826,COGS 14B,A01,083073,Cheng; Tzu-Han,1,13,50,49
1650755472851,COGS 17,A01,092677,Staff,11,0,75,64
1650755478876,COGS 100,A01,083619,Staff,0,29,60,60
1650755484905,COGS 101A,A01,083621,Davis; Joshua Daniel,0,28,60,60
1650755491018,COGS 101B,A01,091572,Staff,1,4,60,59
1650755497041,COGS 101C,A01,083625,Delgado; Tania,14,0,30,16
1650755503064,COGS 107A,A01,083627,Boyle; Mary E. T.,0,16,60,60
1650755509088,COGS 118A,A01,083075,Staff,0,8,60,60
1650755515113,CSE 3,A50,083646,Miranda; Gregory Joseph,18,0,38,20
1650755515113,CSE 3,A51,083647,Miranda; Gregory Joseph,36,0,37,1
1650755521137,CSE 8A,A50,083650,Miranda; Gregory Joseph,0,30,40,40
1650755527166,CSE 11,A01,083080,Cao; Yingjun,0,96,40,40
1650755533193,CSE 12,A01,083652,Staff,0,21,100,100
1650755539226,CSE 15L,A01,083654,Staff,0,3,50,50
1650755539226,CSE 15L,A02,083655,Staff,0,2,50,50
1650755545252,CSE 20,A01,083657,Staff,49,0,80,31
1650755551282,CSE 30,A01,083084,Eldon; John,0,76,40,40
1650755557306,CSE 100,A01,083659,Cao; Yingjun,0,71,50,50
1650755563330,CSE 134B,A01,083661,Powell; Thomas Allan,0,38,65,65
1650755569354,CSE 140,A01,083663,Staff,0,11,75,75
1650755575389,CSE 140L,A01,083088,Eldon; John,0,20,75,75
1650755581424,CSE 175,A01,083665,Kumar; Rakesh,7,0,25,18
1650755587454,CSE 190,A00,092507,Dubnov; Shlomo,10,0,20,10
1650755593482,ECE 45,A01,083139,Staff,1,2,60,59
1650755599506,ECE 65,A50,083695,Staff,0,5,30,30
1650755605530,ECE 109,A01,091882,Touri; Behrouz,33,0,70,37
1650755611558,ECE 180,A00,083140,Abi Samra; Nicholas Camill,20,0,30,10
1650755611558,ECE 180,B00,083141,Abi Samra; Nicholas Camill,0,0,30,30
1650755617580,MATH 10A,A01,083735,Patchell; Gregory David,2,0,30,28
1650755617580,MATH 10A,A02,083736,Patchell; Gregory David,27,0,30,3
1650755617580,MATH 10A,A03,083737,Patchell; Gregory David,24,0,30,6
1650755623604,MATH 10B,A01,083207,Staff,0,9,30,30
1650755623604,MATH 10B,A02,083208,Staff,1,7,30,29
1650755623604,MATH 10B,B01,083739,Staff,11,0,30,19
1650755623604,MATH 10B,B02,083740,Staff,28,0,30,2
1650755629629,MATH 18,A01,083743,Staff,0,0,30,30
1650755629629,MATH 18,A02,083744,Staff,23,0,30,7
1650755629629,MATH 18,A03,083745,Staff,21,0,30,9
1650755629629,MATH 18,A04,083746,Staff,26,0,30,4
1650755629629,MATH 18,B01,083748,Staff,0,15,30,30
1650755629629,MATH 18,B02,083749,Staff,0,12,30,30
1650755629629,MATH 18,B03,083750,Staff,0,12,30,30
1650755629629,MATH 18,B04,083751,Staff,0,12,30,30
1650755635653,MATH 20A,A01,083754,Staff,19,0,40,21
1650755641682,MATH 20B,A01,083756,Staff,0,12,30,30
1650755641682,MATH 20B,A02,083757,Staff,0,12,30,30
1650755647709,MATH 20C,A01,083760,Staff,0,16,30,30
1650755647709,MATH 20C,A02,083761,Staff,0,16,30,30
1650755647709,MATH 20C,B01,083762,Staff,10,0,30,20
1650755647709,MATH 20C,B02,083763,Staff,28,0,30,2
1650755653733,MATH 20D,A01,083765,Staff,2,1,30,28
1650755653733,MATH 20D,A02,083766,Staff,5,0,30,25
1650755653733,MATH 20D,A03,083767,Staff,24,0,30,6
1650755659757,MATH 20E,A01,083771,Staff,3,0,30,27
1650755659757,MATH 20E,A02,083772,Staff,16,0,30,14
1650755659757,MATH 20E,B01,083773,Staff,0,0,30,30
1650755659757,MATH 20E,B02,083774,Staff,5,0,30,25
1650755665781,MATH 103A,A01,083777,Staff,0,16,30,30
1650755665781,MATH 103A,A02,083778,Staff,0,15,30,30
1650755665781,MATH 103A,B01,083779,Staff,0,15,30,30
1650755665781,MATH 103A,B02,083780,Staff,0,15,30,30
1650755671808,MATH 105,A01,085443,Staff,0,22,30,30
1650755677836,MATH 109,A01,083213,Anzaldo; Leesa B,0,7,30,30
1650755677836,MATH 109,A02,083214,Anzaldo; Leesa B,0,7,30,30
1650755677836,MATH 109,B01,083215,Anzaldo; Leesa B,0,8,30,30
1650755677836,MATH 109,B02,083216,Anzaldo; Leesa B,0,6,30,30
1650755683860,MATH 142A,A01,083219,Chow; Bennett,0,16,30,30
1650755683860,MATH 142A,A02,083220,Chow; Bennett,0,15,30,30
1650755683860,MATH 142A,B01,083221,Chow; Bennett,0,15,30,30
1650755683860,MATH 142A,B02,083222,Chow; Bennett,0,14,30,30
1650755689884,MATH 193A,A01,083224,Staff,0,5,30,30
1650755689884,MATH 193A,A02,083225,Staff,0,6,30,30
1650755689884,MATH 193A,A03,083781,Staff,0,6,30,30
1650755689884,MATH 193A,A04,083782,Staff,0,7,30,30
1650755695907,MATH 197,001,091859,McAuley; Julian John,9998,0,9999,1
1650755701971,COGS 9,A01,083615,Staff,1,16,60,59
1650755708002,COGS 11,A01,083617,Boyle; Mary E. T.,16,0,40,24
1650755714031,COGS 13,A01,083071,Staff,0,38,40,40
1650755720055,COGS 14A,A01,092681,Staff,0,36,100,100
1650755726084,COGS 14B,A01,083073,Cheng; Tzu-Han,1,13,50,49
1650755732109,COGS 17,A01,092677,Staff,11,0,75,64
1650755738132,COGS 100,A01,083619,Staff,0,29,60,60
1650755744157,COGS 101A,A01,083621,Davis; Joshua Daniel,0,28,60,60
1650755750183,COGS 101B,A01,091572,Staff,1,4,60,59
1650755756207,COGS 101C,A01,083625,Delgado; Tania,14,0,30,16
1650755762237,COGS 107A,A01,083627,Boyle; Mary E. T.,0,16,60,60
1650755768261,COGS 118A,A01,083075,Staff,0,8,60,60
1650755774283,CSE 3,A50,083646,Miranda; Gregory Joseph,18,0,38,20
1650755774283,CSE 3,A51,083647,Miranda; Gregory Joseph,36,0,37,1
1650755780312,CSE 8A,A50,083650,Miranda; Gregory Joseph,0,30,40,40
1650755786338,CSE 11,A01,083080,Cao; Yingjun,0,96,40,40
1650755792360,CSE 12,A01,083652,Staff,0,21,100,100
1650755798382,CSE 15L,A01,083654,Staff,0,3,50,50
1650755798382,CSE 15L,A02,083655,Staff,0,2,50,50
1650755804409,CSE 20,A01,083657,Staff,49,0,80,31
1650755810433,CSE 30,A01,083084,Eldon; John,0,76,40,40
1650755816460,CSE 100,A01,083659,Cao; Yingjun,0,71,50,50
1650755822483,CSE 134B,A01,083661,Powell; Thomas Allan,0,38,65,65
1650755828514,CSE 140,A01,083663,Staff,0,11,75,75
1650755834541,CSE 140L,A01,083088,Eldon; John,0,20,75,75
1650755840564,CSE 175,A01,083665,Kumar; Rakesh,7,0,25,18
1650755846588,CSE 190,A00,092507,Dubnov; Shlomo,10,0,20,10
1650755852614,ECE 45,A01,083139,Staff,1,2,60,59
1650755858638,ECE 65,A50,083695,Staff,0,5,30,30
1650755864662,ECE 109,A01,091882,Touri; Behrouz,33,0,70,37
1650755870689,ECE 180,A00,083140,Abi Samra; Nicholas Camill,20,0,30,10
1650755870689,ECE 180,B00,083141,Abi Samra; Nicholas Camill,0,0,30,30
1650755876715,MATH 10A,A01,083735,Patchell; Gregory David,2,0,30,28
1650755876715,MATH 10A,A02,083736,Patchell; Gregory David,27,0,30,3
1650755876715,MATH 10A,A03,083737,Patchell; Gregory David,24,0,30,6
1650755882742,MATH 10B,A01,083207,Staff,0,9,30,30
1650755882742,MATH 10B,A02,083208,Staff,1,7,30,29
1650755882742,MATH 10B,B01,083739,Staff,11,0,30,19
1650755882742,MATH 10B,B02,083740,Staff,28,0,30,2
1650755888768,MATH 18,A01,083743,Staff,0,0,30,30
1650755888768,MATH 18,A02,083744,Staff,23,0,30,7
1650755888768,MATH 18,A03,083745,Staff,21,0,30,9
1650755888768,MATH 18,A04,083746,Staff,26,0,30,4
1650755888768,MATH 18,B01,083748,Staff,0,15,30,30
1650755888768,MATH 18,B02,083749,Staff,0,12,30,30
1650755888768,MATH 18,B03,083750,Staff,0,12,30,30
1650755888768,MATH 18,B04,083751,Staff,0,12,30,30
1650755894795,MATH 20A,A01,083754,Staff,19,0,40,21
1650755900819,MATH 20B,A01,083756,Staff,0,12,30,30
1650755900819,MATH 20B,A02,083757,Staff,0,12,30,30
1650755906845,MATH 20C,A01,083760,Staff,0,16,30,30
1650755906845,MATH 20C,A02,083761,Staff,0,16,30,30
1650755906845,MATH 20C,B01,083762,Staff,10,0,30,20
1650755906845,MATH 20C,B02,083763,Staff,28,0,30,2
1650755912873,MATH 20D,A01,083765,Staff,2,1,30,28
1650755912873,MATH 20D,A02,083766,Staff,5,0,30,25
1650755912873,MATH 20D,A03,083767,Staff,24,0,30,6
1650755918901,MATH 20E,A01,083771,Staff,3,0,30,27
1650755918901,MATH 20E,A02,083772,Staff,16,0,30,14
1650755918901,MATH 20E,B01,083773,Staff,0,0,30,30
1650755918901,MATH 20E,B02,083774,Staff,5,0,30,25
1650755924930,MATH 103A,A01,083777,Staff,0,16,30,30
1650755924930,MATH 103A,A02,083778,Staff,0,15,30,30
1650755924930,MATH 103A,B01,083779,Staff,0,15,30,30
1650755924930,MATH 103A,B02,083780,Staff,0,15,30,30
1650755930953,MATH 105,A01,085443,Staff,0,22,30,30
1650755936982,MATH 109,A01,083213,Anzaldo; Leesa B,0,7,30,30
1650755936982,MATH 109,A02,083214,Anzaldo; Leesa B,0,7,30,30
1650755936982,MATH 109,B01,083215,Anzaldo; Leesa B,0,8,30,30
1650755936982,MATH 109,B02,083216,Anzaldo; Leesa B,0,6,30,30
1650755943007,MATH 142A,A01,083219,Chow; Bennett,0,16,30,30
1650755943007,MATH 142A,A02,083220,Chow; Bennett,0,15,30,30
1650755943007,MATH 142A,B01,083221,Chow; Bennett,0,15,30,30
1650755943007,MATH 142A,B02,083222,Chow; Bennett,0,14,30,30
1650755949031,MATH 193A,A01,083224,Staff,0,5,30,30
1650755949031,MATH 193A,A02,083225,Staff,0,6,30,30
1650755949031,MATH 193A,A03,083781,Staff,0,6,30,30
1650755949031,MATH 193A,A04,083782,Staff,0,7,30,30
1650755955055,MATH 197,001,091859,McAuley; Julian John,9998,0,9999,1
1650755961118,COGS 9,A01,083615,Staff,1,16,60,59
1650755967142,COGS 11,A01,083617,Boyle; Mary E. T.,16,0,40,24
1650755973167,COGS 13,A01,083071,Staff,0,38,40,40
1650755979191,COGS 14A,A01,092681,Staff,0,36,100,100
1650755985214,COGS 14B,A01,083073,Cheng; Tzu-Han,1,13,50,49
1650755991239,COGS 17,A01,092677,Staff,11,0,75,64
1650755997276,COGS 100,A01,083619,Staff,0,29,60,60
1650756003300,COGS 101A,A01,083621,Davis; Joshua Daniel,0,28,60,60
1650756009323,COGS 101B,A01,091572,Staff,1,4,60,59
1650756015350,COGS 101C,A01,083625,Delgado; Tania,14,0,30,16
1650756021377,COGS 107A,A01,083627,Boyle; Mary E. T.,0,16,60,60
1650756027404,COGS 118A,A01,083075,Staff,0,8,60,60
1650756033432,CSE 3,A50,083646,Miranda; Gregory Joseph,18,0,38,20
1650756033432,CSE 3,A51,083647,Miranda; Gregory Joseph,36,0,37,1
1650756039456,CSE 8A,A50,083650,Miranda; Gregory Joseph,0,30,40,40
1650756045480,CSE 11,A01,083080,Cao; Yingjun,0,96,40,40
1650756051504,CSE 12,A01,083652,Staff,0,21,100,100
1650756057527,CSE 15L,A01,083654,Staff,0,3,50,50
1650756057527,CSE 15L,A02,083655,Staff,0,2,50,50
1650756063554,CSE 20,A01,083657,Staff,49,0,80,31
1650756069580,CSE 30,A01,083084,Eldon; John,0,76,40,40
1650756075611,CSE 100,A01,083659,Cao; Yingjun,0,71,50,50
1650756081633,CSE 134B,A01,083661,Powell; Thomas Allan,0,38,65,65
1650756087745,CSE 140,A01,083663,Staff,0,11,75,75
1650756093770,CSE 140L,A01,083088,Eldon; John,0,20,75,75
1650756099803,CSE 175,A01,083665,Kumar; Rakesh,7,0,25,18
1650756105826,CSE 190,A00,092507,Dubnov; Shlomo,10,0,20,10
1650756111850,ECE 45,A01,083139,Staff,1,2,60,59
1650756117872,ECE 65,A50,083695,Staff,0,5,30,30
1650756123897,ECE 109,A01,091882,Touri; Behrouz,33,0,70,37
1650756129925,ECE 180,A00,083140,Abi Samra; Nicholas Camill,20,0,30,10
1650756129925,ECE 180,B00,083141,Abi Samra; Nicholas Camill,0,0,30,30
1650756135954,MATH 10A,A01,083735,Patchell; Gregory David,2,0,30,28
1650756135954,MATH 10A,A02,083736,Patchell; Gregory David,27,0,30,3
1650756135954,MATH 10A,A03,083737,Patchell; Gregory David,24,0,30,6
1650756141977,MATH 10B,A01,083207,Staff,0,9,30,30
1650756141977,MATH 10B,A02,083208,Staff,1,7,30,29
1650756141977,MATH 10B,B01,083739,Staff,11,0,30,19
1650756141977,MATH 10B,B02,083740,Staff,28,0,30,2
1650756148005,MATH 18,A01,083743,Staff,0,0,30,30
1650756148005,MATH 18,A02,083744,Staff,23,0,30,7
1650756148005,MATH 18,A03,083745,Staff,21,0,30,9
1650756148005,MATH 18,A04,083746,Staff,26,0,30,4
1650756148005,MATH 18,B01,083748,Staff,0,15,30,30
1650756148005,MATH 18,B02,083749,Staff,0,12,30,30
1650756148005,MATH 18,B03,083750,Staff,0,12,30,30
1650756148005,MATH 18,B04,083751,Staff,0,12,30,30
1650756154034,MATH 20A,A01,083754,Staff,19,0,40,21
1650756160076,MATH 20B,A01,083756,Staff,0,12,30,30
1650756160076,MATH 20B,A02,083757,Staff,0,12,30,30
1650756166121,MATH 20C,A01,083760,Staff,0,16,30,30
1650756166121,MATH 20C,A02,083761,Staff,0,16,30,30
1650756166121,MATH 20C,B01,083762,Staff,10,0,30,20
1650756166121,MATH 20C,B02,083763,Staff,28,0,30,2
1650756172145,MATH 20D,A01,083765,Staff,2,1,30,28
1650756172145,MATH 20D,A02,083766,Staff,5,0,30,25
1650756172145,MATH 20D,A03,083767,Staff,24,0,30,6
1650756178172,MATH 20E,A01,083771,Staff,3,0,30,27
1650756178172,MATH 20E,A02,083772,Staff,16,0,30,14
1650756178172,MATH 20E,B01,083773,Staff,0,0,30,30
1650756178172,MATH 20E,B02,083774,Staff,5,0,30,25
1650756184207,MATH 103A,A01,083777,Staff,0,16,30,30
1650756184207,MATH 103A,A02,083778,Staff,0,15,30,30
1650756184207,MATH 103A,B01,083779,Staff,0,15,30,30
1650756184207,MATH 103A,B02,083780,Staff,0,15,30,30
1650756190233,MATH 105,A01,085443,Staff,0,22,30,30
1650756196261,MATH 109,A01,083213,Anzaldo; Leesa B,0,7,30,30
1650756196261,MATH 109,A02,083214,Anzaldo; Leesa B,0,7,30,30
1650756196261,MATH 109,B01,083215,Anzaldo; Leesa B,0,8,30,30
1650756196261,MATH 109,B02,083216,Anzaldo; Leesa B,0,6,30,30
1650756202286,MATH 142A,A01,083219,Chow; Bennett,0,16,30,30
1650756202286,MATH 142A,A02,083220,Chow; Bennett,0,15,30,30
1650756202286,MATH 142A,B01,083221,Chow; Bennett,0,15,30,30
1650756202286,MATH 142A,B02,083222,Chow; Bennett,0,14,30,30
1650756208313,MATH 193A,A01,083224,Staff,0,5,30,30
1650756208313,MATH 193A,A02,083225,Staff,0,6,30,30
1650756208313,MATH 193A,A03,083781,Staff,0,6,30,30
1650756208313,MATH 193A,A04,083782,Staff,0,7,30,30
1650756214337,MATH 197,001,091859,McAuley; Julian John,9998,0,9999,1
1650756220411,COGS 9,A01,083615,Staff,1,16,60,59
1650756226434,COGS 11,A01,083617,Boyle; Mary E. T.,16,0,40,24
1650756232459,COGS 13,A01,083071,Staff,0,38,40,40
1650756238483,COGS 14A,A01,092681,Staff,0,36,100,100
1650756244517,COGS 14B,A01,083073,Cheng; Tzu-Han,1,13,50,49
1650756250542,COGS 17,A01,092677,Staff,11,0,75,64
1650756256569,COGS 100,A01,083619,Staff,0,29,60,60
1650756262592,COGS 101A,A01,083621,Davis; Joshua Daniel,0,28,60,60
1650756268618,COGS 101B,A01,091572,Staff,1,4,60,59
1650756274645,COGS 101C,A01,083625,Delgado; Tania,14,0,30,16
1650756280669,COGS 107A,A01,083627,Boyle; Mary E. T.,0,16,60,60
1650756286693,COGS 118A,A01,083075,Staff,0,8,60,60
1650756292718,CSE 3,A50,083646,Miranda; Gregory Joseph,18,0,38,20
1650756292718,CSE 3,A51,083647,Miranda; Gregory Joseph,36,0,37,1
1650756298741,CSE 8A,A50,083650,Miranda; Gregory Joseph,0,30,40,40
1650756304767,CSE 11,A01,083080,Cao; Yingjun,0,96,40,40
1650756310791,CSE 12,A01,083652,Staff,0,21,100,100
1650756316818,CSE 15L,A01,083654,Staff,0,3,50,50
1650756316818,CSE 15L,A02,083655,Staff,0,2,50,50
1650756322841,CSE 20,A01,083657,Staff,49,0,80,31
1650756328867,CSE 30,A01,083084,Eldon; John,0,76,40,40
1650756334894,CSE 100,A01,083659,Cao; Yingjun,0,71,50,50
1650756340927,CSE 134B,A01,083661,Powell; Thomas Allan,0,38,65,65
1650756346951,CSE 140,A01,083663,Staff,0,11,75,75
1650756352975,CSE 140L,A01,083088,Eldon; John,0,20,75,75
1650756359009,CSE 175,A01,083665,Kumar; Rakesh,7,0,25,18
1650756365032,CSE 190,A00,092507,Dubnov; Shlomo,10,0,20,10
1650756371059,ECE 45,A01,083139,Staff,1,2,60,59
1650756377088,ECE 65,A50,083695,Staff,0,5,30,30
1650756383112,ECE 109,A01,091882,Touri; Behrouz,33,0,70,37
1650756389140,ECE 180,A00,083140,Abi Samra; Nicholas Camill,20,0,30,10
1650756389140,ECE 180,B00,083141,Abi Samra; Nicholas Camill,0,0,30,30
1650756395162,MATH 10A,A01,083735,Patchell; Gregory David,2,0,30,28
1650756395162,MATH 10A,A02,083736,Patchell; Gregory David,27,0,30,3
1650756395162,MATH 10A,A03,083737,Patchell; Gregory David,24,0,30,6
1650756401188,MATH 10B,A01,083207,Staff,0,9,30,30
1650756401188,MATH 10B,A02,083208,Staff,1,7,30,29
1650756401188,MATH 10B,B01,083739,Staff,11,0,30,19
1650756401188,MATH 10B,B02,083740,Staff,28,0,30,2
1650756407216,MATH 18,A01,083743,Staff,0,0,30,30
1650756407216,MATH 18,A02,083744,Staff,23,0,30,7
1650756407216,MATH 18,A03,083745,Staff,21,0,30,9
1650756407216,MATH 18,A04,083746,Staff,26,0,30,4
1650756407216,MATH 18,B01,083748,Staff,0,15,30,30
1650756407216,MATH 18,B02,083749,Staff,0,12,30,30
1650756407216,MATH 18,B03,083750,Staff,0,12,30,30
1650756407216,MATH 18,B04,083751,Staff,0,12,30,30
1650756413240,MATH 20A,A01,083754,Staff,19,0,40,21
1650756419266,MATH 20B,A01,083756,Staff,0,12,30,30
1650756419266,MATH 20B,A02,083757,Staff,0,12,30,30
1650756425297,MATH 20C,A01,083760,Staff,0,16,30,30
1650756425297,MATH 20C,A02,083761,Staff,0,16,30,30
1650756425297,MATH 20C,B01,083762,Staff,10,0,30,20
1650756425297,MATH 20C,B02,083763,Staff,28,0,30,2
1650756431320,MATH 20D,A01,083765,Staff,2,1,30,28
1650756431320,MATH 20D,A02,083766,Staff,5,0,30,25
1650756431320,MATH 20D,A03,083767,Staff,24,0,30,6
1650756437344,MATH 20E,A01,083771,Staff,3,0,30,27
1650756437344,MATH 20E,A02,083772,Staff,16,0,30,14
1650756437344,MATH 20E,B01,083773,Staff,0,0,30,30
1650756437344,MATH 20E,B02,083774,Staff,5,0,30,25
1650756443372,MATH 103A,A01,083777,Staff,0,16,30,30
1650756443372,MATH 103A,A02,083778,Staff,0,15,30,30
1650756443372,MATH 103A,B01,083779,Staff,0,15,30,30
1650756443372,MATH 103A,B02,083780,Staff,0,15,30,30
1650756449398,MATH 105,A01,085443,Staff,0,22,30,30
1650756455422,MATH 109,A01,083213,Anzaldo; Leesa B,0,7,30,30
1650756455422,MATH 109,A02,083214,Anzaldo; Leesa B,0,7,30,30
1650756455422,MATH 109,B01,083215,Anzaldo; Leesa B,0,8,30,30
1650756455422,MATH 109,B02,083216,Anzaldo; Leesa B,0,6,30,30
1650756461447,MATH 142A,A01,083219,Chow; Bennett,0,16,30,30
1650756461447,MATH 142A,A02,083220,Chow; Bennett,0,15,30,30
1650756461447,MATH 142A,B01,083221,Chow; Bennett,0,15,30,30
1650756461447,MATH 142A,B02,083222,Chow; Bennett,0,14,30,30
1650756467476,MATH 193A,A01,083224,Staff,0,5,30,30
1650756467476,MATH 193A,A02,083225,Staff,0,6,30,30
1650756467476,MATH 193A,A03,083781,Staff,0,6,30,30
1650756467476,MATH 193A,A04,083782,Staff,0,7,30,30
1650756473503,MATH 197,001,091859,McAuley; Julian John,9998,0,9999,1
1650756479570,COGS 9,A01,083615,Staff,1,16,60,59
1650756485592,COGS 11,A01,083617,Boyle; Mary E. T.,16,0,40,24
1650756491619,COGS 13,A01,083071,Staff,0,38,40,40
1650756497644,COGS 14A,A01,092681,Staff,0,36,100,100
1650756503668,COGS 14B,A01,083073,Cheng; Tzu-Han,1,13,50,49
1650756509691,COGS 17,A01,092677,Staff,11,0,75,64
1650756515718,COGS 100,A01,083619,Staff,0,29,60,60
1650756521746,COGS 101A,A01,083621,Davis; Joshua Daniel,0,28,60,60
1650756527773,COGS 101B,A01,091572,Staff,1,4,60,59
1650756533797,COGS 101C,A01,083625,Delgado; Tania,14,0,30,16
1650756539824,COGS 107A,A01,083627,Boyle; Mary E. T.,0,16,60,60
1650756545850,COGS 118A,A01,083075,Staff,0,8,60,60
1650756551878,CSE 3,A50,083646,Miranda; Gregory Joseph,18,0,38,20
1650756551878,CSE 3,A51,083647,Miranda; Gregory Joseph,36,0,37,1
1650756557901,CSE 8A,A50,083650,Miranda; Gregory Joseph,0,30,40,40
1650756563925,CSE 11,A01,083080,Cao; Yingjun,0,96,40,40
1650756569950,CSE 12,A01,083652,Staff,0,21,100,100
1650756575975,CSE 15L,A01,083654,Staff,0,3,50,50
1650756575975,CSE 15L,A02,083655,Staff,0,2,50,50
1650756582004,CSE 20,A01,083657,Staff,49,0,80,31
1650756588026,CSE 30,A01,083084,Eldon; John,0,76,40,40
1650756594053,CSE 100,A01,083659,Cao; Yingjun,0,71,50,50
1650756600076,CSE 134B,A01,083661,Powell; Thomas Allan,0,38,65,65
1650756606100,CSE 140,A01,083663,Staff,0,11,75,75
1650756612127,CSE 140L,A01,083088,Eldon; John,0,20,75,75
1650756618151,CSE 175,A01,083665,Kumar; Rakesh,7,0,25,18
1650756624179,CSE 190,A00,092507,Dubnov; Shlomo,10,0,20,10
1650756630203,ECE 45,A01,083139,Staff,1,2,60,59
1650756636230,ECE 65,A50,083695,Staff,0,5,30,30
1650756642254,ECE 109,A01,091882,Touri; Behrouz,33,0,70,37
1650756648279,ECE 180,A00,083140,Abi Samra; Nicholas Camill,20,0,30,10
1650756648279,ECE 180,B00,083141,Abi Samra; Nicholas Camill,0,0,30,30
1650756654305,MATH 10A,A01,083735,Patchell; Gregory David,2,0,30,28
1650756654305,MATH 10A,A02,083736,Patchell; Gregory David,27,0,30,3
1650756654305,MATH 10A,A03,083737,Patchell; Gregory David,24,0,30,6
1650756660329,MATH 10B,A01,083207,Staff,0,9,30,30
1650756660329,MATH 10B,A02,083208,Staff,1,7,30,29
1650756660329,MATH 10B,B01,083739,Staff,11,0,30,19
1650756660329,MATH 10B,B02,083740,Staff,28,0,30,2
1650756666360,MATH 18,A01,083743,Staff,0,0,30,30
1650756666360,MATH 18,A02,083744,Staff,23,0,30,7
1650756666360,MATH 18,A03,083745,Staff,21,0,30,9
1650756666360,MATH 18,A04,083746,Staff,26,0,30,4
1650756666360,MATH 18,B01,083748,Staff,0,15,30,30
1650756666360,MATH 18,B02,083749,Staff,0,12,30,30
1650756666360,MATH 18,B03,083750,Staff,0,12,30,30
1650756666360,MATH 18,B04,083751,Staff,0,12,30,30
1650756672384,MATH 20A,A01,083754,Staff,19,0,40,21
1650756678407,MATH 20B,A01,083756,Staff,0,12,30,30
1650756678407,MATH 20B,A02,083757,Staff,0,12,30,30
1650756684504,MATH 20C,A01,083760,Staff,0,16,30,30
1650756684504,MATH 20C,A02,083761,Staff,0,16,30,30
1650756684504,MATH 20C,B01,083762,Staff,10,0,30,20
1650756684504,MATH 20C,B02,083763,Staff,28,0,30,2
1650756690528,MATH 20D,A01,083765,Staff,2,1,30,28
1650756690528,MATH 20D,A02,083766,Staff,5,0,30,25
1650756690528,MATH 20D,A03,083767,Staff,24,0,30,6
1650756696557,MATH 20E,A01,083771,Staff,3,0,30,27
1650756696557,MATH 20E,A02,083772,Staff,16,0,30,14
1650756696557,MATH 20E,B01,083773,Staff,0,0,30,30
1650756696557,MATH 20E,B02,083774,Staff,5,0,30,25
1650756702584,MATH 103A,A01,083777,Staff,0,16,30,30
1650756702584,MATH 103A,A02,083778,Staff,0,15,30,30
1650756702584,MATH 103A,B01,083779,Staff,0,15,30,30
1650756702584,MATH 103A,B02,083780,Staff,0,15,30,30
1650756708609,MATH 105,A01,085443,Staff,0,22,30,30
1650756714631,MATH 109,A01,083213,Anzaldo; Leesa B,0,7,30,30
1650756714631,MATH 109,A02,083214,Anzaldo; Leesa B,0,7,30,30
1650756714631,MATH 109,B01,083215,Anzaldo; Leesa B,0,8,30,30
1650756714631,MATH 109,B02,083216,Anzaldo; Leesa B,0,6,30,30
1650756720656,MATH 142A,A01,083219,Chow; Bennett,0,16,30,30
1650756720656,MATH 142A,A02,083220,Chow; Bennett,0,15,30,30
1650756720656,MATH 142A,B01,083221,Chow; Bennett,0,15,30,30
1650756720656,MATH 142A,B02,083222,Chow; Bennett,0,14,30,30
1650756726680,MATH 193A,A01,083224,Staff,0,5,30,30
1650756726680,MATH 193A,A02,083225,Staff,0,6,30,30
1650756726680,MATH 193A,A03,083781,Staff,0,6,30,30
1650756726680,MATH 193A,A04,083782,Staff,0,7,30,30
1650756732711,MATH 197,001,091859,McAuley; Julian John,9998,0,9999,1
1650756738763,COGS 9,A01,083615,Staff,1,16,60,59
1650756744786,COGS 11,A01,083617,Boyle; Mary E. T.,16,0,40,24
1650756750810,COGS 13,A01,083071,Staff,0,38,40,40
1650756756836,COGS 14A,A01,092681,Staff,0,36,100,100
1650756762871,COGS 14B,A01,083073,Cheng; Tzu-Han,1,13,50,49
1650756768896,COGS 17,A01,092677,Staff,11,0,75,64
1650756774920,COGS 100,A01,083619,Staff,0,29,60,60
1650756780952,COGS 101A,A01,083621,Davis; Joshua Daniel,0,28,60,60
1650756786978,COGS 101B,A01,091572,Staff,1,4,60,59
1650756793005,COGS 101C,A01,083625,Delgado; Tania,14,0,30,16
1650756799031,COGS 107A,A01,083627,Boyle; Mary E. T.,0,16,60,60
1650756805055,COGS 118A,A01,083075,Staff,0,8,60,60
1650756811079,CSE 3,A50,083646,Miranda; Gregory Joseph,18,0,38,20
1650756811079,CSE 3,A51,083647,Miranda; Gregory Joseph,36,0,37,1
1650756817104,CSE 8A,A50,083650,Miranda; Gregory Joseph,0,30,40,40
1650756823135,CSE 11,A01,083080,Cao; Yingjun,0,96,40,40
1650756829160,CSE 12,A01,083652,Staff,0,21,100,100
1650756835182,CSE 15L,A01,083654,Staff,0,3,50,50
1650756835182,CSE 15L,A02,083655,Staff,0,2,50,50
1650756841206,CSE 20,A01,083657,Staff,49,0,80,31
1650756847245,CSE 30,A01,083084,Eldon; John,0,76,40,40
1650756853269,CSE 100,A01,083659,Cao; Yingjun,0,71,50,50
1650756859295,CSE 134B,A01,083661,Powell; Thomas Allan,0,38,65,65
1650756865320,CSE 140,A01,083663,Staff,0,11,75,75
1650756871343,CSE 140L,A01,083088,Eldon; John,0,20,75,75
1650756877370,CSE 175,A01,083665,Kumar; Rakesh,7,0,25,18
1650756883403,CSE 190,A00,092507,Dubnov; Shlomo,10,0,20,10
1650756889431,ECE 45,A01,083139,Staff,1,2,60,59
1650756895454,ECE 65,A50,083695,Staff,0,5,30,30
1650756901484,ECE 109,A01,091882,Touri; Behrouz,33,0,70,37
1650756907510,ECE 180,A00,083140,Abi Samra; Nicholas Camill,20,0,30,10
1650756907510,ECE 180,B00,083141,Abi Samra; Nicholas Camill,0,0,30,30
1650756913545,MATH 10A,A01,083735,Patchell; Gregory David,2,0,30,28
1650756913545,MATH 10A,A02,083736,Patchell; Gregory David,27,0,30,3
1650756913545,MATH 10A,A03,083737,Patchell; Gregory David,24,0,30,6
1650756919570,MATH 10B,A01,083207,Staff,0,9,30,30
1650756919570,MATH 10B,A02,083208,Staff,1,7,30,29
1650756919570,MATH 10B,B01,083739,Staff,11,0,30,19
1650756919570,MATH 10B,B02,083740,Staff,28,0,30,2
1650756925599,MATH 18,A01,083743,Staff,0,0,30,30
1650756925599,MATH 18,A02,083744,Staff,23,0,30,7
1650756925599,MATH 18,A03,083745,Staff,21,0,30,9
1650756925599,MATH 18,A04,083746,Staff,26,0,30,4
1650756925599,MATH 18,B01,083748,Staff,0,15,30,30
1650756925599,MATH 18,B02,083749,Staff,0,12,30,30
1650756925599,MATH 18,B03,083750,Staff,0,12,30,30
1650756925599,MATH 18,B04,083751,Staff,0,12,30,30
1650756931624,MATH 20A,A01,083754,Staff,19,0,40,21
1650756937646,MATH 20B,A01,083756,Staff,0,12,30,30
1650756937646,MATH 20B,A02,083757,Staff,0,12,30,30
1650756943671,MATH 20C,A01,083760,Staff,0,16,30,30
1650756943671,MATH 20C,A02,083761,Staff,0,16,30,30
1650756943671,MATH 20C,B01,083762,Staff,10,0,30,20
1650756943671,MATH 20C,B02,083763,Staff,28,0,30,2
1650756949695,MATH 20D,A01,083765,Staff,2,1,30,28
1650756949695,MATH 20D,A02,083766,Staff,5,0,30,25
1650756949695,MATH 20D,A03,083767,Staff,24,0,30,6
1650756955719,MATH 20E,A01,083771,Staff,3,0,30,27
1650756955719,MATH 20E,A02,083772,Staff,16,0,30,14
1650756955719,MATH 20E,B01,083773,Staff,0,0,30,30
1650756955719,MATH 20E,B02,083774,Staff,5,0,30,25
1650756961744,MATH 103A,A01,083777,Staff,0,16,30,30
1650756961744,MATH 103A,A02,083778,Staff,0,15,30,30
1650756961744,MATH 103A,B01,083779,Staff,0,15,30,30
1650756961744,MATH 103A,B02,083780,Staff,0,15,30,30
1650756967770,MATH 105,A01,085443,Staff,0,22,30,30
1650756973799,MATH 109,A01,083213,Anzaldo; Leesa B,0,7,30,30
1650756973799,MATH 109,A02,083214,Anzaldo; Leesa B,0,7,30,30
1650756973799,MATH 109,B01,083215,Anzaldo; Leesa B,0,8,30,30
1650756973799,MATH 109,B02,083216,Anzaldo; Leesa B,0,6,30,30
1650756979827,MATH 142A,A01,083219,Chow; Bennett,0,16,30,30
1650756979827,MATH 142A,A02,083220,Chow; Bennett,0,15,30,30
1650756979827,MATH 142A,B01,083221,Chow; Bennett,0,15,30,30
1650756979827,MATH 142A,B02,083222,Chow; Bennett,0,14,30,30
1650756985851,MATH 193A,A01,083224,Staff,0,5,30,30
1650756985851,MATH 193A,A02,083225,Staff,0,6,30,30
1650756985851,MATH 193A,A03,083781,Staff,0,6,30,30
1650756985851,MATH 193A,A04,083782,Staff,0,7,30,30
1650756991877,MATH 197,001,091859,McAuley; Julian John,9998,0,9999,1
1650756997963,COGS 9,A01,083615,Staff,1,16,60,59
1650757003998,COGS 11,A01,083617,Boyle; Mary E. T.,16,0,40,24
1650757010028,COGS 13,A01,083071,Staff,0,38,40,40
1650757016052,COGS 14A,A01,092681,Staff,0,36,100,100
1650757022076,COGS 14B,A01,083073,Cheng; Tzu-Han,1,13,50,49
1650757028106,COGS 17,A01,092677,Staff,11,0,75,64
1650757034134,COGS 100,A01,083619,Staff,0,29,60,60
1650757040158,COGS 101A,A01,083621,Davis; Joshua Daniel,0,28,60,60
1650757046184,COGS 101B,A01,091572,Staff,1,4,60,59
1650757052211,COGS 101C,A01,083625,Delgado; Tania,14,0,30,16
1650757058235,COGS 107A,A01,083627,Boyle; Mary E. T.,0,16,60,60
1650757064257,COGS 118A,A01,083075,Staff,0,8,60,60
1650757070283,CSE 3,A50,083646,Miranda; Gregory Joseph,18,0,38,20
1650757070283,CSE 3,A51,083647,Miranda; Gregory Joseph,36,0,37,1
1650757076312,CSE 8A,A50,083650,Miranda; Gregory Joseph,0,30,40,40
1650757082335,CSE 11,A01,083080,Cao; Yingjun,0,96,40,40
1650757088361,CSE 12,A01,083652,Staff,0,21,100,100
1650757094389,CSE 15L,A01,083654,Staff,0,3,50,50
1650757094389,CSE 15L,A02,083655,Staff,0,2,50,50
1650757100416,CSE 20,A01,083657,Staff,49,0,80,31
1650757106440,CSE 30,A01,083084,Eldon; John,0,76,40,40
1650757112464,CSE 100,A01,083659,Cao; Yingjun,0,71,50,50
1650757118493,CSE 134B,A01,083661,Powell; Thomas Allan,0,38,65,65
1650757124517,CSE 140,A01,083663,Staff,0,11,75,75
1650757130542,CSE 140L,A01,083088,Eldon; John,0,20,75,75
1650757136565,CSE 175,A01,083665,Kumar; Rakesh,7,0,25,18
1650757142591,CSE 190,A00,092507,Dubnov; Shlomo,10,0,20,10
1650757148615,ECE 45,A01,083139,Staff,1,2,60,59
1650757154656,ECE 65,A50,083695,Staff,0,5,30,30
1650757160682,ECE 109,A01,091882,Touri; Behrouz,33,0,70,37
1650757166706,ECE 180,A00,083140,Abi Samra; Nicholas Camill,20,0,30,10
1650757166706,ECE 180,B00,083141,Abi Samra; Nicholas Camill,0,0,30,30
1650757172731,MATH 10A,A01,083735,Patchell; Gregory David,2,0,30,28
1650757172731,MATH 10A,A02,083736,Patchell; Gregory David,27,0,30,3
1650757172731,MATH 10A,A03,083737,Patchell; Gregory David,24,0,30,6
1650757178769,MATH 10B,A01,083207,Staff,0,9,30,30
1650757178769,MATH 10B,A02,083208,Staff,1,7,30,29
1650757178769,MATH 10B,B01,083739,Staff,11,0,30,19
1650757178769,MATH 10B,B02,083740,Staff,28,0,30,2
1650757184801,MATH 18,A01,083743,Staff,0,0,30,30
1650757184801,MATH 18,A02,083744,Staff,23,0,30,7
1650757184801,MATH 18,A03,083745,Staff,21,0,30,9
1650757184801,MATH 18,A04,083746,Staff,26,0,30,4
1650757184801,MATH 18,B01,083748,Staff,0,15,30,30
1650757184801,MATH 18,B02,083749,Staff,0,12,30,30
1650757184801,MATH 18,B03,083750,Staff,0,12,30,30
1650757184801,MATH 18,B04,083751,Staff,0,12,30,30
1650757190827,MATH 20A,A01,083754,Staff,19,0,40,21
1650757196851,MATH 20B,A01,083756,Staff,0,12,30,30
1650757196851,MATH 20B,A02,083757,Staff,0,12,30,30
1650757202879,MATH 20C,A01,083760,Staff,0,16,30,30
1650757202879,MATH 20C,A02,083761,Staff,0,16,30,30
1650757202879,MATH 20C,B01,083762,Staff,10,0,30,20
1650757202879,MATH 20C,B02,083763,Staff,28,0,30,2
1650757208907,MATH 20D,A01,083765,Staff,2,1,30,28
1650757208907,MATH 20D,A02,083766,Staff,5,0,30,25
1650757208907,MATH 20D,A03,083767,Staff,24,0,30,6
1650757214932,MATH 20E,A01,083771,Staff,3,0,30,27
1650757214932,MATH 20E,A02,083772,Staff,16,0,30,14
1650757214932,MATH 20E,B01,083773,Staff,0,0,30,30
1650757214932,MATH 20E,B02,083774,Staff,5,0,30,25
1650757220962,MATH 103A,A01,083777,Staff,0,16,30,30
1650757220962,MATH 103A,A02,083778,Staff,0,15,30,30
1650757220962,MATH 103A,B01,083779,Staff,0,15,30,30
1650757220962,MATH 103A,B02,083780,Staff,0,15,30,30
1650757226986,MATH 105,A01,085443,Staff,0,22,30,30
1650757233015,MATH 109,A01,083213,Anzaldo; Leesa B,0,7,30,30
1650757233015,MATH 109,A02,083214,Anzaldo; Leesa B,0,7,30,30
1650757233015,MATH 109,B01,083215,Anzaldo; Leesa B,0,8,30,30
1650757233015,MATH 109,B02,083216,Anzaldo; Leesa B,0,6,30,30
1650757239044,MATH 142A,A01,083219,Chow; Bennett,0,16,30,30
1650757239044,MATH 142A,A02,083220,Chow; Bennett,0,15,30,30
1650757239044,MATH 142A,B01,083221,Chow; Bennett,0,15,30,30
1650757239044,MATH 142A,B02,083222,Chow; Bennett,0,14,30,30
1650757245067,MATH 193A,A01,083224,Staff,0,5,30,30
1650757245067,MATH 193A,A02,083225,Staff,0,6,30,30
1650757245067,MATH 193A,A03,083781,Staff,0,6,30,30
1650757245067,MATH 193A,A04,083782,Staff,0,7,30,30
1650757251090,MATH 197,001,091859,McAuley; Julian John,9998,0,9999,1
1650757257148,COGS 9,A01,083615,Staff,1,16,60,59
1650757263174,COGS 11,A01,083617,Boyle; Mary E. T.,16,0,40,24
1650757269197,COGS 13,A01,083071,Staff,0,38,40,40
1650757275330,COGS 14A,A01,092681,Staff,0,36,100,100
1650757281359,COGS 14B,A01,083073,Cheng; Tzu-Han,1,13,50,49
1650757287382,COGS 17,A01,092677,Staff,11,0,75,64
1650757293405,COGS 100,A01,083619,Staff,0,29,60,60
1650757299430,COGS 101A,A01,083621,Davis; Joshua Daniel,0,28,60,60
1650757305453,COGS 101B,A01,091572,Staff,1,4,60,59
1650757311480,COGS 101C,A01,083625,Delgado; Tania,14,0,30,16
1650757317505,COGS 107A,A01,083627,Boyle; Mary E. T.,0,16,60,60
1650757323529,COGS 118A,A01,083075,Staff,0,8,60,60
1650757329551,CSE 3,A50,083646,Miranda; Gregory Joseph,18,0,38,20
1650757329551,CSE 3,A51,083647,Miranda; Gregory Joseph,36,0,37,1
1650757335577,CSE 8A,A50,083650,Miranda; Gregory Joseph,0,30,40,40
1650757341601,CSE 11,A01,083080,Cao; Yingjun,0,96,40,40
1650757347626,CSE 12,A01,083652,Staff,0,21,100,100
1650757353652,CSE 15L,A01,083654,Staff,0,3,50,50
1650757353652,CSE 15L,A02,083655,Staff,0,2,50,50
1650757359682,CSE 20,A01,083657,Staff,49,0,80,31
1650757365708,CSE 30,A01,083084,Eldon; John,0,76,40,40
1650757371735,CSE 100,A01,083659,Cao; Yingjun,0,71,50,50
1650757377761,CSE 134B,A01,083661,Powell; Thomas Allan,0,38,65,65
1650757383788,CSE 140,A01,083663,Staff,0,11,75,75
1650757389810,CSE 140L,A01,083088,Eldon; John,0,20,75,75
1650757395841,CSE 175,A01,083665,Kumar; Rakesh,7,0,25,18
1650757401865,CSE 190,A00,092507,Dubnov; Shlomo,10,0,20,10
1650757407896,ECE 45,A01,083139,Staff,1,2,60,59
1650757413922,ECE 65,A50,083695,Staff,0,5,30,30
1650757419947,ECE 109,A01,091882,Touri; Behrouz,33,0,70,37
1650757425974,ECE 180,A00,083140,Abi Samra; Nicholas Camill,20,0,30,10
1650757425974,ECE 180,B00,083141,Abi Samra; Nicholas Camill,0,0,30,30
1650757432003,MATH 10A,A01,083735,Patchell; Gregory David,2,0,30,28
1650757432003,MATH 10A,A02,083736,Patchell; Gregory David,27,0,30,3
1650757432003,MATH 10A,A03,083737,Patchell; Gregory David,24,0,30,6
1650757438035,MATH 10B,A01,083207,Staff,0,9,30,30
1650757438035,MATH 10B,A02,083208,Staff,1,7,30,29
1650757438035,MATH 10B,B01,083739,Staff,11,0,30,19
1650757438035,MATH 10B,B02,083740,Staff,28,0,30,2
1650757444061,MATH 18,A01,083743,Staff,0,0,30,30
1650757444061,MATH 18,A02,083744,Staff,23,0,30,7
1650757444061,MATH 18,A03,083745,Staff,21,0,30,9
1650757444061,MATH 18,A04,083746,Staff,26,0,30,4
1650757444061,MATH 18,B01,083748,Staff,0,15,30,30
1650757444061,MATH 18,B02,083749,Staff,0,12,30,30
1650757444061,MATH 18,B03,083750,Staff,0,12,30,30
1650757444061,MATH 18,B04,083751,Staff,0,12,30,30
1650757450086,MATH 20A,A01,083754,Staff,19,0,40,21
1650757456114,MATH 20B,A01,083756,Staff,0,12,30,30
1650757456114,MATH 20B,A02,083757,Staff,0,12,30,30
1650757462139,MATH 20C,A01,083760,Staff,0,16,30,30
1650757462139,MATH 20C,A02,083761,Staff,0,16,30,30
1650757462139,MATH 20C,B01,083762,Staff,10,0,30,20
1650757462139,MATH 20C,B02,083763,Staff,28,0,30,2
1650757468163,MATH 20D,A01,083765,Staff,2,1,30,28
1650757468163,MATH 20D,A02,083766,Staff,5,0,30,25
1650757468163,MATH 20D,A03,083767,Staff,24,0,30,6
1650757474190,MATH 20E,A01,083771,Staff,3,0,30,27
1650757474190,MATH 20E,A02,083772,Staff,16,0,30,14
1650757474190,MATH 20E,B01,083773,Staff,0,0,30,30
1650757474190,MATH 20E,B02,083774,Staff,5,0,30,25
1650757480219,MATH 103A,A01,083777,Staff,0,16,30,30
1650757480219,MATH 103A,A02,083778,Staff,0,15,30,30
1650757480219,MATH 103A,B01,083779,Staff,0,15,30,30
1650757480219,MATH 103A,B02,083780,Staff,0,15,30,30
1650757486247,MATH 105,A01,085443,Staff,0,22,30,30
1650757492272,MATH 109,A01,083213,Anzaldo; Leesa B,0,7,30,30
1650757492272,MATH 109,A02,083214,Anzaldo; Leesa B,0,7,30,30
1650757492272,MATH 109,B01,083215,Anzaldo; Leesa B,0,8,30,30
1650757492272,MATH 109,B02,083216,Anzaldo; Leesa B,0,6,30,30
1650757498296,MATH 142A,A01,083219,Chow; Bennett,0,16,30,30
1650757498296,MATH 142A,A02,083220,Chow; Bennett,0,15,30,30
1650757498296,MATH 142A,B01,083221,Chow; Bennett,0,15,30,30
1650757498296,MATH 142A,B02,083222,Chow; Bennett,0,14,30,30
1650757504319,MATH 193A,A01,083224,Staff,0,5,30,30
1650757504319,MATH 193A,A02,083225,Staff,0,6,30,30
1650757504319,MATH 193A,A03,083781,Staff,0,6,30,30
1650757504319,MATH 193A,A04,083782,Staff,0,7,30,30
1650757510341,MATH 197,001,091859,McAuley; Julian John,9998,0,9999,1
1650757516395,COGS 9,A01,083615,Staff,1,16,60,59
1650757522420,COGS 11,A01,083617,Boyle; Mary E. T.,16,0,40,24
1650757528444,COGS 13,A01,083071,Staff,0,38,40,40
1650757534467,COGS 14A,A01,092681,Staff,0,36,100,100
1650757540492,COGS 14B,A01,083073,Cheng; Tzu-Han,1,13,50,49
1650757546517,COGS 17,A01,092677,Staff,11,0,75,64
1650757552543,COGS 100,A01,083619,Staff,0,29,60,60
1650757558571,COGS 101A,A01,083621,Davis; Joshua Daniel,0,28,60,60
1650757564595,COGS 101B,A01,091572,Staff,1,4,60,59
1650757570619,COGS 101C,A01,083625,Delgado; Tania,14,0,30,16
1650757576643,COGS 107A,A01,083627,Boyle; Mary E. T.,0,16,60,60
1650757582668,COGS 118A,A01,083075,Staff,0,8,60,60
1650757588693,CSE 3,A50,083646,Miranda; Gregory Joseph,18,0,38,20
1650757588693,CSE 3,A51,083647,Miranda; Gregory Joseph,36,0,37,1
1650757594719,CSE 8A,A50,083650,Miranda; Gregory Joseph,0,30,40,40
1650757600753,CSE 11,A01,083080,Cao; Yingjun,0,96,40,40
1650757606779,CSE 12,A01,083652,Staff,0,21,100,100
1650757612803,CSE 15L,A01,083654,Staff,0,3,50,50
1650757612803,CSE 15L,A02,083655,Staff,0,2,50,50
1650757618827,CSE 20,A01,083657,Staff,49,0,80,31
1650757624854,CSE 30,A01,083084,Eldon; John,0,76,40,40
1650757630881,CSE 100,A01,083659,Cao; Yingjun,0,71,50,50
1650757636909,CSE 134B,A01,083661,Powell; Thomas Allan,0,38,65,65
1650757642936,CSE 140,A01,083663,Staff,0,11,75,75
1650757648963,CSE 140L,A01,083088,Eldon; John,0,20,75,75
1650757654988,CSE 175,A01,083665,Kumar; Rakesh,7,0,25,18
1650757661020,CSE 190,A00,092507,Dubnov; Shlomo,10,0,20,10
1650757667044,ECE 45,A01,083139,Staff,1,2,60,59
1650757673069,ECE 65,A50,083695,Staff,0,5,30,30
1650757679092,ECE 109,A01,091882,Touri; Behrouz,33,0,70,37
1650757685119,ECE 180,A00,083140,Abi Samra; Nicholas Camill,20,0,30,10
1650757685119,ECE 180,B00,083141,Abi Samra; Nicholas Camill,0,0,30,30
1650757691147,MATH 10A,A01,083735,Patchell; Gregory David,2,0,30,28
1650757691147,MATH 10A,A02,083736,Patchell; Gregory David,27,0,30,3
1650757691147,MATH 10A,A03,083737,Patchell; Gregory David,24,0,30,6
1650757697171,MATH 10B,A01,083207,Staff,0,9,30,30
1650757697171,MATH 10B,A02,083208,Staff,1,7,30,29
1650757697171,MATH 10B,B01,083739,Staff,11,0,30,19
1650757697171,MATH 10B,B02,083740,Staff,28,0,30,2
1650757703199,MATH 18,A01,083743,Staff,0,0,30,30
1650757703199,MATH 18,A02,083744,Staff,23,0,30,7
1650757703199,MATH 18,A03,083745,Staff,21,0,30,9
1650757703199,MATH 18,A04,083746,Staff,26,0,30,4
1650757703199,MATH 18,B01,083748,Staff,0,15,30,30
1650757703199,MATH 18,B02,083749,Staff,0,12,30,30
1650757703199,MATH 18,B03,083750,Staff,0,12,30,30
1650757703199,MATH 18,B04,083751,Staff,0,12,30,30
1650757709224,MATH 20A,A01,083754,Staff,19,0,40,21
1650757715251,MATH 20B,A01,083756,Staff,0,12,30,30
1650757715251,MATH 20B,A02,083757,Staff,0,12,30,30
1650757721275,MATH 20C,A01,083760,Staff,0,16,30,30
1650757721275,MATH 20C,A02,083761,Staff,0,16,30,30
1650757721275,MATH 20C,B01,083762,Staff,10,0,30,20
1650757721275,MATH 20C,B02,083763,Staff,28,0,30,2
1650757727303,MATH 20D,A01,083765,Staff,2,1,30,28
1650757727303,MATH 20D,A02,083766,Staff,5,0,30,25
1650757727303,MATH 20D,A03,083767,Staff,24,0,30,6
1650757733327,MATH 20E,A01,083771,Staff,3,0,30,27
1650757733327,MATH 20E,A02,083772,Staff,16,0,30,14
1650757733327,MATH 20E,B01,083773,Staff,0,0,30,30
1650757733327,MATH 20E,B02,083774,Staff,5,0,30,25
1650757739350,MATH 103A,A01,083777,Staff,0,16,30,30
1650757739350,MATH 103A,A02,083778,Staff,0,15,30,30
1650757739350,MATH 103A,B01,083779,Staff,0,15,30,30
1650757739350,MATH 103A,B02,083780,Staff,0,15,30,30
1650757745378,MATH 105,A01,085443,Staff,0,22,30,30
1650757751403,MATH 109,A01,083213,Anzaldo; Leesa B,0,7,30,30
1650757751403,MATH 109,A02,083214,Anzaldo; Leesa B,0,7,30,30
1650757751403,MATH 109,B01,083215,Anzaldo; Leesa B,0,8,30,30
1650757751403,MATH 109,B02,083216,Anzaldo; Leesa B,0,6,30,30
1650757757428,MATH 142A,A01,083219,Chow; Bennett,0,16,30,30
1650757757428,MATH 142A,A02,083220,Chow; Bennett,0,15,30,30
1650757757428,MATH 142A,B01,083221,Chow; Bennett,0,15,30,30
1650757757428,MATH 142A,B02,083222,Chow; Bennett,0,14,30,30
1650757763453,MATH 193A,A01,083224,Staff,0,5,30,30
1650757763453,MATH 193A,A02,083225,Staff,0,6,30,30
1650757763453,MATH 193A,A03,083781,Staff,0,6,30,30
1650757763453,MATH 193A,A04,083782,Staff,0,7,30,30
1650757769479,MATH 197,001,091859,McAuley; Julian John,9998,0,9999,1
1650757775529,COGS 9,A01,083615,Staff,1,16,60,59
1650757781553,COGS 11,A01,083617,Boyle; Mary E. T.,16,0,40,24
1650757787581,COGS 13,A01,083071,Staff,0,38,40,40
1650757793605,COGS 14A,A01,092681,Staff,0,36,100,100
1650757799635,COGS 14B,A01,083073,Cheng; Tzu-Han,1,13,50,49
1650757805659,COGS 17,A01,092677,Staff,11,0,75,64
1650757811687,COGS 100,A01,083619,Staff,0,29,60,60
1650757817714,COGS 101A,A01,083621,Davis; Joshua Daniel,0,28,60,60
1650757823739,COGS 101B,A01,091572,Staff,1,4,60,59
1650757829775,COGS 101C,A01,083625,Delgado; Tania,14,0,30,16
1650757835802,COGS 107A,A01,083627,Boyle; Mary E. T.,0,16,60,60
1650757841828,COGS 118A,A01,083075,Staff,0,8,60,60
1650757847856,CSE 3,A50,083646,Miranda; Gregory Joseph,18,0,38,20
1650757847856,CSE 3,A51,083647,Miranda; Gregory Joseph,36,0,37,1
1650757853881,CSE 8A,A50,083650,Miranda; Gregory Joseph,0,30,40,40
1650757859914,CSE 11,A01,083080,Cao; Yingjun,0,96,40,40
1650757865945,CSE 12,A01,083652,Staff,0,21,100,100
1650757872041,CSE 15L,A01,083654,Staff,0,3,50,50
1650757872041,CSE 15L,A02,083655,Staff,0,2,50,50
1650757878065,CSE 20,A01,083657,Staff,49,0,80,31
1650757884088,CSE 30,A01,083084,Eldon; John,0,76,40,40
1650757890112,CSE 100,A01,083659,Cao; Yingjun,0,71,50,50
1650757896138,CSE 134B,A01,083661,Powell; Thomas Allan,0,38,65,65
1650757902162,CSE 140,A01,083663,Staff,0,11,75,75
1650757908197,CSE 140L,A01,083088,Eldon; John,0,20,75,75
1650757914221,CSE 175,A01,083665,Kumar; Rakesh,7,0,25,18
1650757920254,CSE 190,A00,092507,Dubnov; Shlomo,10,0,20,10
1650757926283,ECE 45,A01,083139,Staff,1,2,60,59
1650757932306,ECE 65,A50,083695,Staff,0,5,30,30
1650757938336,ECE 109,A01,091882,Touri; Behrouz,33,0,70,37
1650757944361,ECE 180,A00,083140,Abi Samra; Nicholas Camill,20,0,30,10
1650757944361,ECE 180,B00,083141,Abi Samra; Nicholas Camill,0,0,30,30
1650757950385,MATH 10A,A01,083735,Patchell; Gregory David,2,0,30,28
1650757950385,MATH 10A,A02,083736,Patchell; Gregory David,27,0,30,3
1650757950385,MATH 10A,A03,083737,Patchell; Gregory David,24,0,30,6
1650757956410,MATH 10B,A01,083207,Staff,0,9,30,30
1650757956410,MATH 10B,A02,083208,Staff,1,7,30,29
1650757956410,MATH 10B,B01,083739,Staff,11,0,30,19
1650757956410,MATH 10B,B02,083740,Staff,28,0,30,2
1650757962436,MATH 18,A01,083743,Staff,0,0,30,30
1650757962436,MATH 18,A02,083744,Staff,23,0,30,7
1650757962436,MATH 18,A03,083745,Staff,21,0,30,9
1650757962436,MATH 18,A04,083746,Staff,26,0,30,4
1650757962436,MATH 18,B01,083748,Staff,0,15,30,30
1650757962436,MATH 18,B02,083749,Staff,0,12,30,30
1650757962436,MATH 18,B03,083750,Staff,0,12,30,30
1650757962436,MATH 18,B04,083751,Staff,0,12,30,30
1650757968458,MATH 20A,A01,083754,Staff,19,0,40,21
1650757974482,MATH 20B,A01,083756,Staff,0,12,30,30
1650757974482,MATH 20B,A02,083757,Staff,0,12,30,30
1650757980513,MATH 20C,A01,083760,Staff,0,16,30,30
1650757980513,MATH 20C,A02,083761,Staff,0,16,30,30
1650757980513,MATH 20C,B01,083762,Staff,10,0,30,20
1650757980513,MATH 20C,B02,083763,Staff,28,0,30,2
1650757986535,MATH 20D,A01,083765,Staff,2,1,30,28
1650757986535,MATH 20D,A02,083766,Staff,5,0,30,25
1650757986535,MATH 20D,A03,083767,Staff,24,0,30,6
1650757992561,MATH 20E,A01,083771,Staff,3,0,30,27
1650757992561,MATH 20E,A02,083772,Staff,16,0,30,14
1650757992561,MATH 20E,B01,083773,Staff,0,0,30,30
1650757992561,MATH 20E,B02,083774,Staff,5,0,30,25
1650757998587,MATH 103A,A01,083777,Staff,0,16,30,30
1650757998587,MATH 103A,A02,083778,Staff,0,15,30,30
1650757998587,MATH 103A,B01,083779,Staff,0,15,30,30
1650757998587,MATH 103A,B02,083780,Staff,0,15,30,30
1650758004619,MATH 105,A01,085443,Staff,0,22,30,30
1650758010668,MATH 109,A01,083213,Anzaldo; Leesa B,0,7,30,30
1650758010668,MATH 109,A02,083214,Anzaldo; Leesa B,0,7,30,30
1650758010668,MATH 109,B01,083215,Anzaldo; Leesa B,0,8,30,30
1650758010668,MATH 109,B02,083216,Anzaldo; Leesa B,0,6,30,30
1650758016697,MATH 142A,A01,083219,Chow; Bennett,0,16,30,30
1650758016697,MATH 142A,A02,083220,Chow; Bennett,0,15,30,30
1650758016697,MATH 142A,B01,083221,Chow; Bennett,0,15,30,30
1650758016697,MATH 142A,B02,083222,Chow; Bennett,0,14,30,30
1650758022719,MATH 193A,A01,083224,Staff,0,5,30,30
1650758022719,MATH 193A,A02,083225,Staff,0,6,30,30
1650758022719,MATH 193A,A03,083781,Staff,0,6,30,30
1650758022719,MATH 193A,A04,083782,Staff,0,7,30,30
1650758028745,MATH 197,001,091859,McAuley; Julian John,9998,0,9999,1
1650758034798,COGS 9,A01,083615,Staff,1,16,60,59
1650758040820,COGS 11,A01,083617,Boyle; Mary E. T.,16,0,40,24
1650758046847,COGS 13,A01,083071,Staff,0,38,40,40
1650758052871,COGS 14A,A01,092681,Staff,0,36,100,100
1650758058896,COGS 14B,A01,083073,Cheng; Tzu-Han,1,13,50,49
1650758064924,COGS 17,A01,092677,Staff,11,0,75,64
1650758070949,COGS 100,A01,083619,Staff,0,29,60,60
1650758076976,COGS 101A,A01,083621,Davis; Joshua Daniel,0,28,60,60
1650758083003,COGS 101B,A01,091572,Staff,1,4,60,59
1650758089027,COGS 101C,A01,083625,Delgado; Tania,14,0,30,16
1650758095051,COGS 107A,A01,083627,Boyle; Mary E. T.,0,16,60,60
1650758101080,COGS 118A,A01,083075,Staff,0,8,60,60
1650758107109,CSE 3,A50,083646,Miranda; Gregory Joseph,18,0,38,20
1650758107109,CSE 3,A51,083647,Miranda; Gregory Joseph,36,0,37,1
1650758113136,CSE 8A,A50,083650,Miranda; Gregory Joseph,0,30,40,40
1650758119160,CSE 11,A01,083080,Cao; Yingjun,0,96,40,40
1650758125197,CSE 12,A01,083652,Staff,0,21,100,100
1650758131224,CSE 15L,A01,083654,Staff,0,3,50,50
1650758131224,CSE 15L,A02,083655,Staff,0,2,50,50
1650758137249,CSE 20,A01,083657,Staff,49,0,80,31
1650758143280,CSE 30,A01,083084,Eldon; John,0,76,40,40
1650758149305,CSE 100,A01,083659,Cao; Yingjun,0,71,50,50
1650758155328,CSE 134B,A01,083661,Powell; Thomas Allan,0,38,65,65
1650758161366,CSE 140,A01,083663,Staff,0,11,75,75
1650758167391,CSE 140L,A01,083088,Eldon; John,0,20,75,75
1650758173422,CSE 175,A01,083665,Kumar; Rakesh,7,0,25,18
1650758179447,CSE 190,A00,092507,Dubnov; Shlomo,10,0,20,10
1650758185471,ECE 45,A01,083139,Staff,1,2,60,59
1650758191496,ECE 65,A50,083695,Staff,0,5,30,30
1650758197534,ECE 109,A01,091882,Touri; Behrouz,33,0,70,37
1650758203563,ECE 180,A00,083140,Abi Samra; Nicholas Camill,20,0,30,10
1650758203563,ECE 180,B00,083141,Abi Samra; Nicholas Camill,0,0,30,30
1650758209588,MATH 10A,A01,083735,Patchell; Gregory David,2,0,30,28
1650758209588,MATH 10A,A02,083736,Patchell; Gregory David,27,0,30,3
1650758209588,MATH 10A,A03,083737,Patchell; Gregory David,24,0,30,6
1650758215613,MATH 10B,A01,083207,Staff,0,9,30,30
1650758215613,MATH 10B,A02,083208,Staff,1,7,30,29
1650758215613,MATH 10B,B01,083739,Staff,11,0,30,19
1650758215613,MATH 10B,B02,083740,Staff,28,0,30,2
1650758221651,MATH 18,A01,083743,Staff,0,0,30,30
1650758221651,MATH 18,A02,083744,Staff,23,0,30,7
1650758221651,MATH 18,A03,083745,Staff,21,0,30,9
1650758221651,MATH 18,A04,083746,Staff,26,0,30,4
1650758221651,MATH 18,B01,083748,Staff,0,15,30,30
1650758221651,MATH 18,B02,083749,Staff,0,12,30,30
1650758221651,MATH 18,B03,083750,Staff,0,12,30,30
1650758221651,MATH 18,B04,083751,Staff,0,12,30,30
1650758227681,MATH 20A,A01,083754,Staff,19,0,40,21
1650758233705,MATH 20B,A01,083756,Staff,0,12,30,30
1650758233705,MATH 20B,A02,083757,Staff,0,12,30,30
1650758239741,MATH 20C,A01,083760,Staff,0,16,30,30
1650758239741,MATH 20C,A02,083761,Staff,0,16,30,30
1650758239741,MATH 20C,B01,083762,Staff,10,0,30,20
1650758239741,MATH 20C,B02,083763,Staff,28,0,30,2
1650758245766,MATH 20D,A01,083765,Staff,2,1,30,28
1650758245766,MATH 20D,A02,083766,Staff,5,0,30,25
1650758245766,MATH 20D,A03,083767,Staff,24,0,30,6
1650758251789,MATH 20E,A01,083771,Staff,3,0,30,27
1650758251789,MATH 20E,A02,083772,Staff,16,0,30,14
1650758251789,MATH 20E,B01,083773,Staff,0,0,30,30
1650758251789,MATH 20E,B02,083774,Staff,5,0,30,25
1650758257814,MATH 103A,A01,083777,Staff,0,16,30,30
1650758257814,MATH 103A,A02,083778,Staff,0,15,30,30
1650758257814,MATH 103A,B01,083779,Staff,0,15,30,30
1650758257814,MATH 103A,B02,083780,Staff,0,15,30,30
1650758263842,MATH 105,A01,085443,Staff,0,22,30,30
1650758269877,MATH 109,A01,083213,Anzaldo; Leesa B,0,7,30,30
1650758269877,MATH 109,A02,083214,Anzaldo; Leesa B,0,7,30,30
1650758269877,MATH 109,B01,083215,Anzaldo; Leesa B,0,8,30,30
1650758269877,MATH 109,B02,083216,Anzaldo; Leesa B,0,6,30,30
1650758275901,MATH 142A,A01,083219,Chow; Bennett,0,16,30,30
1650758275901,MATH 142A,A02,083220,Chow; Bennett,0,15,30,30
1650758275901,MATH 142A,B01,083221,Chow; Bennett,0,15,30,30
1650758275901,MATH 142A,B02,083222,Chow; Bennett,0,14,30,30
1650758281931,MATH 193A,A01,083224,Staff,0,5,30,30
1650758281931,MATH 193A,A02,083225,Staff,0,6,30,30
1650758281931,MATH 193A,A03,083781,Staff,0,6,30,30
1650758281931,MATH 193A,A04,083782,Staff,0,7,30,30
1650758287957,MATH 197,001,091859,McAuley; Julian John,9998,0,9999,1
1650758294010,COGS 9,A01,083615,Staff,1,16,60,59
1650758300036,COGS 11,A01,083617,Boyle; Mary E. T.,16,0,40,24
1650758306059,COGS 13,A01,083071,Staff,0,38,40,40
1650758312083,COGS 14A,A01,092681,Staff,0,36,100,100
1650758318111,COGS 14B,A01,083073,Cheng; Tzu-Han,1,13,50,49
1650758324139,COGS 17,A01,092677,Staff,11,0,75,64
1650758330166,COGS 100,A01,083619,Staff,0,29,60,60
1650758336194,COGS 101A,A01,083621,Davis; Joshua Daniel,0,28,60,60
1650758342218,COGS 101B,A01,091572,Staff,1,4,60,59
1650758348242,COGS 101C,A01,083625,Delgado; Tania,14,0,30,16
1650758354267,COGS 107A,A01,083627,Boyle; Mary E. T.,0,16,60,60
1650758360291,COGS 118A,A01,083075,Staff,0,8,60,60
1650758366316,CSE 3,A50,083646,Miranda; Gregory Joseph,18,0,38,20
1650758366316,CSE 3,A51,083647,Miranda; Gregory Joseph,36,0,37,1
1650758372340,CSE 8A,A50,083650,Miranda; Gregory Joseph,0,30,40,40
1650758378368,CSE 11,A01,083080,Cao; Yingjun,0,96,40,40
1650758384392,CSE 12,A01,083652,Staff,0,21,100,100
1650758390416,CSE 15L,A01,083654,Staff,0,3,50,50
1650758390416,CSE 15L,A02,083655,Staff,0,2,50,50
1650758396439,CSE 20,A01,083657,Staff,49,0,80,31
1650758402465,CSE 30,A01,083084,Eldon; John,0,76,40,40
1650758408490,CSE 100,A01,083659,Cao; Yingjun,0,71,50,50
1650758414514,CSE 134B,A01,083661,Powell; Thomas Allan,0,38,65,65
1650758420537,CSE 140,A01,083663,Staff,0,11,75,75
1650758426562,CSE 140L,A01,083088,Eldon; John,0,20,75,75
1650758432590,CSE 175,A01,083665,Kumar; Rakesh,7,0,25,18
1650758438618,CSE 190,A00,092507,Dubnov; Shlomo,10,0,20,10
1650758444645,ECE 45,A01,083139,Staff,1,2,60,59
1650758450669,ECE 65,A50,083695,Staff,0,5,30,30
1650758456697,ECE 109,A01,091882,Touri; Behrouz,33,0,70,37
1650758462720,ECE 180,A00,083140,Abi Samra; Nicholas Camill,20,0,30,10
1650758462720,ECE 180,B00,083141,Abi Samra; Nicholas Camill,0,0,30,30
1650758468840,MATH 10A,A01,083735,Patchell; Gregory David,2,0,30,28
1650758468840,MATH 10A,A02,083736,Patchell; Gregory David,27,0,30,3
1650758468840,MATH 10A,A03,083737,Patchell; Gregory David,24,0,30,6
1650758474864,MATH 10B,A01,083207,Staff,0,9,30,30
1650758474864,MATH 10B,A02,083208,Staff,1,7,30,29
1650758474864,MATH 10B,B01,083739,Staff,11,0,30,19
1650758474864,MATH 10B,B02,083740,Staff,28,0,30,2
1650758480893,MATH 18,A01,083743,Staff,0,0,30,30
1650758480893,MATH 18,A02,083744,Staff,23,0,30,7
1650758480893,MATH 18,A03,083745,Staff,21,0,30,9
1650758480893,MATH 18,A04,083746,Staff,26,0,30,4
1650758480893,MATH 18,B01,083748,Staff,0,15,30,30
1650758480893,MATH 18,B02,083749,Staff,0,12,30,30
1650758480893,MATH 18,B03,083750,Staff,0,12,30,30
1650758480893,MATH 18,B04,083751,Staff,0,12,30,30
1650758486916,MATH 20A,A01,083754,Staff,19,0,40,21
1650758492941,MATH 20B,A01,083756,Staff,0,12,30,30
1650758492941,MATH 20B,A02,083757,Staff,0,12,30,30
1650758498978,MATH 20C,A01,083760,Staff,0,16,30,30
1650758498978,MATH 20C,A02,083761,Staff,0,16,30,30
1650758498978,MATH 20C,B01,083762,Staff,10,0,30,20
1650758498978,MATH 20C,B02,083763,Staff,28,0,30,2
1650758505005,MATH 20D,A01,083765,Staff,2,1,30,28
1650758505005,MATH 20D,A02,083766,Staff,5,0,30,25
1650758505005,MATH 20D,A03,083767,Staff,24,0,30,6
1650758511036,MATH 20E,A01,083771,Staff,3,0,30,27
1650758511036,MATH 20E,A02,083772,Staff,16,0,30,14
1650758511036,MATH 20E,B01,083773,Staff,0,0,30,30
1650758511036,MATH 20E,B02,083774,Staff,5,0,30,25
1650758517062,MATH 103A,A01,083777,Staff,0,16,30,30
1650758517062,MATH 103A,A02,083778,Staff,0,15,30,30
1650758517062,MATH 103A,B01,083779,Staff,0,15,30,30
1650758517062,MATH 103A,B02,083780,Staff,0,15,30,30
1650758523085,MATH 105,A01,085443,Staff,0,22,30,30
1650758529114,MATH 109,A01,083213,Anzaldo; Leesa B,0,7,30,30
1650758529114,MATH 109,A02,083214,Anzaldo; Leesa B,0,7,30,30
1650758529114,MATH 109,B01,083215,Anzaldo; Leesa B,0,8,30,30
1650758529114,MATH 109,B02,083216,Anzaldo; Leesa B,0,6,30,30
1650758535146,MATH 142A,A01,083219,Chow; Bennett,0,16,30,30
1650758535146,MATH 142A,A02,083220,Chow; Bennett,0,15,30,30
1650758535146,MATH 142A,B01,083221,Chow; Bennett,0,15,30,30
1650758535146,MATH 142A,B02,083222,Chow; Bennett,0,14,30,30
1650758541170,MATH 193A,A01,083224,Staff,0,5,30,30
1650758541170,MATH 193A,A02,083225,Staff,0,6,30,30
1650758541170,MATH 193A,A03,083781,Staff,0,6,30,30
1650758541170,MATH 193A,A04,083782,Staff,0,7,30,30
1650758547194,MATH 197,001,091859,McAuley; Julian John,9998,0,9999,1
1650758553255,COGS 9,A01,083615,Staff,1,16,60,59
1650758559282,COGS 11,A01,083617,Boyle; Mary E. T.,16,0,40,24
1650758565314,COGS 13,A01,083071,Staff,0,38,40,40
1650758571342,COGS 14A,A01,092681,Staff,0,36,100,100
1650758577369,COGS 14B,A01,083073,Cheng; Tzu-Han,1,13,50,49
1650758583393,COGS 17,A01,092677,Staff,11,0,75,64
1650758589417,COGS 100,A01,083619,Staff,0,29,60,60
1650758595451,COGS 101A,A01,083621,Davis; Joshua Daniel,0,28,60,60
1650758601473,COGS 101B,A01,091572,Staff,1,4,60,59
1650758607498,COGS 101C,A01,083625,Delgado; Tania,14,0,30,16
1650758613520,COGS 107A,A01,083627,Boyle; Mary E. T.,0,16,60,60
1650758619548,COGS 118A,A01,083075,Staff,0,8,60,60
1650758625580,CSE 3,A50,083646,Miranda; Gregory Joseph,18,0,38,20
1650758625580,CSE 3,A51,083647,Miranda; Gregory Joseph,36,0,37,1
1650758631607,CSE 8A,A50,083650,Miranda; Gregory Joseph,0,30,40,40
1650758637631,CSE 11,A01,083080,Cao; Yingjun,0,96,40,40
1650758643655,CSE 12,A01,083652,Staff,0,21,100,100
1650758649685,CSE 15L,A01,083654,Staff,0,3,50,50
1650758649685,CSE 15L,A02,083655,Staff,0,2,50,50
1650758655708,CSE 20,A01,083657,Staff,49,0,80,31
1650758661738,CSE 30,A01,083084,Eldon; John,0,76,40,40
1650758667766,CSE 100,A01,083659,Cao; Yingjun,0,71,50,50
1650758673790,CSE 134B,A01,083661,Powell; Thomas Allan,0,38,65,65
1650758679816,CSE 140,A01,083663,Staff,0,11,75,75
1650758685842,CSE 140L,A01,083088,Eldon; John,0,20,75,75
1650758691867,CSE 175,A01,083665,Kumar; Rakesh,7,0,25,18
1650758697900,CSE 190,A00,092507,Dubnov; Shlomo,10,0,20,10
1650758703928,ECE 45,A01,083139,Staff,1,2,60,59
1650758709951,ECE 65,A50,083695,Staff,0,5,30,30
1650758715977,ECE 109,A01,091882,Touri; Behrouz,33,0,70,37
1650758722002,ECE 180,A00,083140,Abi Samra; Nicholas Camill,20,0,30,10
1650758722002,ECE 180,B00,083141,Abi Samra; Nicholas Camill,0,0,30,30
1650758728037,MATH 10A,A01,083735,Patchell; Gregory David,2,0,30,28
1650758728037,MATH 10A,A02,083736,Patchell; Gregory David,27,0,30,3
1650758728037,MATH 10A,A03,083737,Patchell; Gregory David,24,0,30,6
1650758734062,MATH 10B,A01,083207,Staff,0,9,30,30
1650758734062,MATH 10B,A02,083208,Staff,1,7,30,29
1650758734062,MATH 10B,B01,083739,Staff,11,0,30,19
1650758734062,MATH 10B,B02,083740,Staff,28,0,30,2
1650758740094,MATH 18,A01,083743,Staff,0,0,30,30
1650758740094,MATH 18,A02,083744,Staff,23,0,30,7
1650758740094,MATH 18,A03,083745,Staff,21,0,30,9
1650758740094,MATH 18,A04,083746,Staff,26,0,30,4
1650758740094,MATH 18,B01,083748,Staff,0,15,30,30
1650758740094,MATH 18,B02,083749,Staff,0,12,30,30
1650758740094,MATH 18,B03,083750,Staff,0,12,30,30
1650758740094,MATH 18,B04,083751,Staff,0,12,30,30
1650758746120,MATH 20A,A01,083754,Staff,19,0,40,21
1650758752147,MATH 20B,A01,083756,Staff,0,12,30,30
1650758752147,MATH 20B,A02,083757,Staff,0,12,30,30
1650758758172,MATH 20C,A01,083760,Staff,0,16,30,30
1650758758172,MATH 20C,A02,083761,Staff,0,16,30,30
1650758758172,MATH 20C,B01,083762,Staff,10,0,30,20
1650758758172,MATH 20C,B02,083763,Staff,28,0,30,2
1650758764199,MATH 20D,A01,083765,Staff,2,1,30,28
1650758764199,MATH 20D,A02,083766,Staff,5,0,30,25
1650758764199,MATH 20D,A03,083767,Staff,24,0,30,6
1650758770223,MATH 20E,A01,083771,Staff,3,0,30,27
1650758770223,MATH 20E,A02,083772,Staff,16,0,30,14
1650758770223,MATH 20E,B01,083773,Staff,0,0,30,30
1650758770223,MATH 20E,B02,083774,Staff,5,0,30,25
1650758776252,MATH 103A,A01,083777,Staff,0,16,30,30
1650758776252,MATH 103A,A02,083778,Staff,0,15,30,30
1650758776252,MATH 103A,B01,083779,Staff,0,15,30,30
1650758776252,MATH 103A,B02,083780,Staff,0,15,30,30
1650758782280,MATH 105,A01,085443,Staff,0,22,30,30
1650758788305,MATH 109,A01,083213,Anzaldo; Leesa B,0,7,30,30
1650758788305,MATH 109,A02,083214,Anzaldo; Leesa B,0,7,30,30
1650758788305,MATH 109,B01,083215,Anzaldo; Leesa B,0,8,30,30
1650758788305,MATH 109,B02,083216,Anzaldo; Leesa B,0,6,30,30
1650758794334,MATH 142A,A01,083219,Chow; Bennett,0,16,30,30
1650758794334,MATH 142A,A02,083220,Chow; Bennett,0,15,30,30
1650758794334,MATH 142A,B01,083221,Chow; Bennett,0,15,30,30
1650758794334,MATH 142A,B02,083222,Chow; Bennett,0,14,30,30
1650758800359,MATH 193A,A01,083224,Staff,0,5,30,30
1650758800359,MATH 193A,A02,083225,Staff,0,6,30,30
1650758800359,MATH 193A,A03,083781,Staff,0,6,30,30
1650758800359,MATH 193A,A04,083782,Staff,0,7,30,30
1650758806385,MATH 197,001,091859,McAuley; Julian John,9998,0,9999,1
1650758812455,COGS 9,A01,083615,Staff,1,16,60,59
1650758818480,COGS 11,A01,083617,Boyle; Mary E. T.,16,0,40,24
1650758824506,COGS 13,A01,083071,Staff,0,38,40,40
1650758830544,COGS 14A,A01,092681,Staff,0,36,100,100
1650758836568,COGS 14B,A01,083073,Cheng; Tzu-Han,1,13,50,49
1650758842591,COGS 17,A01,092677,Staff,11,0,75,64
1650758848616,COGS 100,A01,083619,Staff,0,29,60,60
1650758854640,COGS 101A,A01,083621,Davis; Joshua Daniel,0,28,60,60
1650758860667,COGS 101B,A01,091572,Staff,1,4,60,59
1650758866696,COGS 101C,A01,083625,Delgado; Tania,14,0,30,16
1650758872723,COGS 107A,A01,083627,Boyle; Mary E. T.,0,16,60,60
1650758878747,COGS 118A,A01,083075,Staff,0,8,60,60
1650758884777,CSE 3,A50,083646,Miranda; Gregory Joseph,18,0,38,20
1650758884777,CSE 3,A51,083647,Miranda; Gregory Joseph,36,0,37,1
1650758890803,CSE 8A,A50,083650,Miranda; Gregory Joseph,0,30,40,40
1650758896826,CSE 11,A01,083080,Cao; Yingjun,0,96,40,40
1650758902852,CSE 12,A01,083652,Staff,0,21,100,100
1650758908880,CSE 15L,A01,083654,Staff,0,3,50,50
1650758908880,CSE 15L,A02,083655,Staff,0,2,50,50
1650758914903,CSE 20,A01,083657,Staff,49,0,80,31
1650758920927,CSE 30,A01,083084,Eldon; John,0,76,40,40
1650758926954,CSE 100,A01,083659,Cao; Yingjun,0,71,50,50
1650758932978,CSE 134B,A01,083661,Powell; Thomas Allan,0,38,65,65
1650758939004,CSE 140,A01,083663,Staff,0,11,75,75
1650758945032,CSE 140L,A01,083088,Eldon; John,0,20,75,75
1650758951072,CSE 175,A01,083665,Kumar; Rakesh,7,0,25,18
1650758957096,CSE 190,A00,092507,Dubnov; Shlomo,10,0,20,10
1650758963119,ECE 45,A01,083139,Staff,1,2,60,59
1650758969143,ECE 65,A50,083695,Staff,0,5,30,30
1650758975171,ECE 109,A01,091882,Touri; Behrouz,33,0,70,37
1650758981199,ECE 180,A00,083140,Abi Samra; Nicholas Camill,20,0,30,10
1650758981199,ECE 180,B00,083141,Abi Samra; Nicholas Camill,0,0,30,30
1650758987223,MATH 10A,A01,083735,Patchell; Gregory David,2,0,30,28
1650758987223,MATH 10A,A02,083736,Patchell; Gregory David,27,0,30,3
1650758987223,MATH 10A,A03,083737,Patchell; Gregory David,24,0,30,6
1650758993249,MATH 10B,A01,083207,Staff,0,9,30,30
1650758993249,MATH 10B,A02,083208,Staff,1,7,30,29
1650758993249,MATH 10B,B01,083739,Staff,11,0,30,19
1650758993249,MATH 10B,B02,083740,Staff,28,0,30,2
1650758999274,MATH 18,A01,083743,Staff,0,0,30,30
1650758999274,MATH 18,A02,083744,Staff,23,0,30,7
1650758999274,MATH 18,A03,083745,Staff,21,0,30,9
1650758999274,MATH 18,A04,083746,Staff,26,0,30,4
1650758999274,MATH 18,B01,083748,Staff,0,15,30,30
1650758999274,MATH 18,B02,083749,Staff,0,12,30,30
1650758999274,MATH 18,B03,083750,Staff,0,12,30,30
1650758999274,MATH 18,B04,083751,Staff,0,12,30,30
1650759005298,MATH 20A,A01,083754,Staff,19,0,40,21
1650759011329,MATH 20B,A01,083756,Staff,0,12,30,30
1650759011329,MATH 20B,A02,083757,Staff,0,12,30,30
1650759017353,MATH 20C,A01,083760,Staff,0,16,30,30
1650759017353,MATH 20C,A02,083761,Staff,0,16,30,30
1650759017353,MATH 20C,B01,083762,Staff,10,0,30,20
1650759017353,MATH 20C,B02,083763,Staff,28,0,30,2
1650759023376,MATH 20D,A01,083765,Staff,2,1,30,28
1650759023376,MATH 20D,A02,083766,Staff,5,0,30,25
1650759023376,MATH 20D,A03,083767,Staff,24,0,30,6
1650759029400,MATH 20E,A01,083771,Staff,3,0,30,27
1650759029400,MATH 20E,A02,083772,Staff,16,0,30,14
1650759029400,MATH 20E,B01,083773,Staff,0,0,30,30
1650759029400,MATH 20E,B02,083774,Staff,5,0,30,25
1650759035429,MATH 103A,A01,083777,Staff,0,16,30,30
1650759035429,MATH 103A,A02,083778,Staff,0,15,30,30
1650759035429,MATH 103A,B01,083779,Staff,0,15,30,30
1650759035429,MATH 103A,B02,083780,Staff,0,15,30,30
1650759041453,MATH 105,A01,085443,Staff,0,22,30,30
1650759047477,MATH 109,A01,083213,Anzaldo; Leesa B,0,7,30,30
1650759047477,MATH 109,A02,083214,Anzaldo; Leesa B,0,7,30,30
1650759047477,MATH 109,B01,083215,Anzaldo; Leesa B,0,8,30,30
1650759047477,MATH 109,B02,083216,Anzaldo; Leesa B,0,6,30,30
1650759053506,MATH 142A,A01,083219,Chow; Bennett,0,16,30,30
1650759053506,MATH 142A,A02,083220,Chow; Bennett,0,15,30,30
1650759053506,MATH 142A,B01,083221,Chow; Bennett,0,15,30,30
1650759053506,MATH 142A,B02,083222,Chow; Bennett,0,14,30,30
1650759059530,MATH 193A,A01,083224,Staff,0,5,30,30
1650759059530,MATH 193A,A02,083225,Staff,0,6,30,30
1650759059530,MATH 193A,A03,083781,Staff,0,6,30,30
1650759059530,MATH 193A,A04,083782,Staff,0,7,30,30
1650759065658,MATH 197,001,091859,McAuley; Julian John,9998,0,9999,1
1650759071708,COGS 9,A01,083615,Staff,1,16,60,59
1650759077733,COGS 11,A01,083617,Boyle; Mary E. T.,16,0,40,24
1650759083757,COGS 13,A01,083071,Staff,0,38,40,40
1650759089780,COGS 14A,A01,092681,Staff,0,36,100,100
1650759095807,COGS 14B,A01,083073,Cheng; Tzu-Han,1,13,50,49
1650759101830,COGS 17,A01,092677,Staff,11,0,75,64
1650759107854,COGS 100,A01,083619,Staff,0,29,60,60
1650759113882,COGS 101A,A01,083621,Davis; Joshua Daniel,0,28,60,60
1650759119913,COGS 101B,A01,091572,Staff,1,4,60,59
1650759125944,COGS 101C,A01,083625,Delgado; Tania,14,0,30,16
1650759131972,COGS 107A,A01,083627,Boyle; Mary E. T.,0,16,60,60
1650759137999,COGS 118A,A01,083075,Staff,0,8,60,60
1650759144026,CSE 3,A50,083646,Miranda; Gregory Joseph,18,0,38,20
1650759144026,CSE 3,A51,083647,Miranda; Gregory Joseph,36,0,37,1
1650759150054,CSE 8A,A50,083650,Miranda; Gregory Joseph,0,30,40,40
1650759156079,CSE 11,A01,083080,Cao; Yingjun,0,96,40,40
1650759162103,CSE 12,A01,083652,Staff,0,21,100,100
1650759168127,CSE 15L,A01,083654,Staff,0,3,50,50
1650759168127,CSE 15L,A02,083655,Staff,0,2,50,50
1650759174152,CSE 20,A01,083657,Staff,49,0,80,31
1650759180176,CSE 30,A01,083084,Eldon; John,0,76,40,40
1650759186210,CSE 100,A01,083659,Cao; Yingjun,0,71,50,50
1650759192237,CSE 134B,A01,083661,Powell; Thomas Allan,0,38,65,65
1650759198262,CSE 140,A01,083663,Staff,0,11,75,75
1650759204286,CSE 140L,A01,083088,Eldon; John,0,20,75,75
1650759210310,CSE 175,A01,083665,Kumar; Rakesh,7,0,25,18
1650759216335,CSE 190,A00,092507,Dubnov; Shlomo,10,0,20,10
1650759222363,ECE 45,A01,083139,Staff,1,2,60,59
1650759228391,ECE 65,A50,083695,Staff,0,5,30,30
1650759234420,ECE 109,A01,091882,Touri; Behrouz,33,0,70,37
1650759240449,ECE 180,A00,083140,Abi Samra; Nicholas Camill,20,0,30,10
1650759240449,ECE 180,B00,083141,Abi Samra; Nicholas Camill,0,0,30,30
1650759246476,MATH 10A,A01,083735,Patchell; Gregory David,2,0,30,28
1650759246476,MATH 10A,A02,083736,Patchell; Gregory David,27,0,30,3
1650759246476,MATH 10A,A03,083737,Patchell; Gregory David,24,0,30,6
1650759252504,MATH 10B,A01,083207,Staff,0,9,30,30
1650759252504,MATH 10B,A02,083208,Staff,1,7,30,29
1650759252504,MATH 10B,B01,083739,Staff,11,0,30,19
1650759252504,MATH 10B,B02,083740,Staff,28,0,30,2
1650759258543,MATH 18,A01,083743,Staff,0,0,30,30
1650759258543,MATH 18,A02,083744,Staff,23,0,30,7
1650759258543,MATH 18,A03,083745,Staff,21,0,30,9
1650759258543,MATH 18,A04,083746,Staff,26,0,30,4
1650759258543,MATH 18,B01,083748,Staff,0,15,30,30
1650759258543,MATH 18,B02,083749,Staff,0,12,30,30
1650759258543,MATH 18,B03,083750,Staff,0,12,30,30
1650759258543,MATH 18,B04,083751,Staff,0,12,30,30
1650759264567,MATH 20A,A01,083754,Staff,19,0,40,21
1650759270593,MATH 20B,A01,083756,Staff,0,12,30,30
1650759270593,MATH 20B,A02,083757,Staff,0,12,30,30
1650759276614,MATH 20C,A01,083760,Staff,0,16,30,30
1650759276614,MATH 20C,A02,083761,Staff,0,16,30,30
1650759276614,MATH 20C,B01,083762,Staff,10,0,30,20
1650759276614,MATH 20C,B02,083763,Staff,28,0,30,2
1650759282638,MATH 20D,A01,083765,Staff,2,1,30,28
1650759282638,MATH 20D,A02,083766,Staff,5,0,30,25
1650759282638,MATH 20D,A03,083767,Staff,24,0,30,6
1650759288665,MATH 20E,A01,083771,Staff,3,0,30,27
1650759288665,MATH 20E,A02,083772,Staff,16,0,30,14
1650759288665,MATH 20E,B01,083773,Staff,0,0,30,30
1650759288665,MATH 20E,B02,083774,Staff,5,0,30,25
1650759294690,MATH 103A,A01,083777,Staff,0,16,30,30
1650759294690,MATH 103A,A02,083778,Staff,0,15,30,30
1650759294690,MATH 103A,B01,083779,Staff,0,15,30,30
1650759294690,MATH 103A,B02,083780,Staff,0,15,30,30
1650759300714,MATH 105,A01,085443,Staff,0,22,30,30
1650759306738,MATH 109,A01,083213,Anzaldo; Leesa B,0,7,30,30
1650759306738,MATH 109,A02,083214,Anzaldo; Leesa B,0,7,30,30
1650759306738,MATH 109,B01,083215,Anzaldo; Leesa B,0,8,30,30
1650759306738,MATH 109,B02,083216,Anzaldo; Leesa B,0,6,30,30
1650759312762,MATH 142A,A01,083219,Chow; Bennett,0,16,30,30
1650759312762,MATH 142A,A02,083220,Chow; Bennett,0,15,30,30
1650759312762,MATH 142A,B01,083221,Chow; Bennett,0,15,30,30
1650759312762,MATH 142A,B02,083222,Chow; Bennett,0,14,30,30
1650759318786,MATH 193A,A01,083224,Staff,0,5,30,30
1650759318786,MATH 193A,A02,083225,Staff,0,6,30,30
1650759318786,MATH 193A,A03,083781,Staff,0,6,30,30
1650759318786,MATH 193A,A04,083782,Staff,0,7,30,30
1650759324809,MATH 197,001,091859,McAuley; Julian John,9998,0,9999,1
1650759330885,COGS 9,A01,083615,Staff,1,17,60,59
1650759336908,COGS 11,A01,083617,Boyle; Mary E. T.,16,0,40,24
1650759342936,COGS 13,A01,083071,Staff,0,38,40,40
1650759348964,COGS 14A,A01,092681,Staff,0,36,100,100
1650759354992,COGS 14B,A01,083073,Cheng; Tzu-Han,1,13,50,49
1650759361021,COGS 17,A01,092677,Staff,11,0,75,64
1650759367048,COGS 100,A01,083619,Staff,0,29,60,60
1650759373080,COGS 101A,A01,083621,Davis; Joshua Daniel,0,28,60,60
1650759379107,COGS 101B,A01,091572,Staff,1,4,60,59
1650759385130,COGS 101C,A01,083625,Delgado; Tania,14,0,30,16
1650759391164,COGS 107A,A01,083627,Boyle; Mary E. T.,0,16,60,60
1650759397188,COGS 118A,A01,083075,Staff,0,8,60,60
1650759403211,CSE 3,A50,083646,Miranda; Gregory Joseph,18,0,38,20
1650759403211,CSE 3,A51,083647,Miranda; Gregory Joseph,36,0,37,1
1650759409236,CSE 8A,A50,083650,Miranda; Gregory Joseph,0,30,40,40
1650759415263,CSE 11,A01,083080,Cao; Yingjun,0,96,40,40
1650759421288,CSE 12,A01,083652,Staff,0,21,100,100
1650759427311,CSE 15L,A01,083654,Staff,0,3,50,50
1650759427311,CSE 15L,A02,083655,Staff,0,2,50,50
1650759433337,CSE 20,A01,083657,Staff,49,0,80,31
1650759439361,CSE 30,A01,083084,Eldon; John,0,76,40,40
1650759445390,CSE 100,A01,083659,Cao; Yingjun,0,71,50,50
1650759451414,CSE 134B,A01,083661,Powell; Thomas Allan,0,38,65,65
1650759457440,CSE 140,A01,083663,Staff,0,11,75,75
1650759463464,CSE 140L,A01,083088,Eldon; John,0,20,75,75
1650759469487,CSE 175,A01,083665,Kumar; Rakesh,7,0,25,18
1650759475513,CSE 190,A00,092507,Dubnov; Shlomo,10,0,20,10
1650759481541,ECE 45,A01,083139,Staff,1,2,60,59
1650759487565,ECE 65,A50,083695,Staff,0,5,30,30
1650759493591,ECE 109,A01,091882,Touri; Behrouz,33,0,70,37
1650759499618,ECE 180,A00,083140,Abi Samra; Nicholas Camill,20,0,30,10
1650759499618,ECE 180,B00,083141,Abi Samra; Nicholas Camill,0,0,30,30
1650759505643,MATH 10A,A01,083735,Patchell; Gregory David,2,0,30,28
1650759505643,MATH 10A,A02,083736,Patchell; Gregory David,27,0,30,3
1650759505643,MATH 10A,A03,083737,Patchell; Gregory David,24,0,30,6
1650759511677,MATH 10B,A01,083207,Staff,0,9,30,30
1650759511677,MATH 10B,A02,083208,Staff,1,7,30,29
1650759511677,MATH 10B,B01,083739,Staff,11,0,30,19
1650759511677,MATH 10B,B02,083740,Staff,28,0,30,2
1650759517713,MATH 18,A01,083743,Staff,0,0,30,30
1650759517713,MATH 18,A02,083744,Staff,23,0,30,7
1650759517713,MATH 18,A03,083745,Staff,21,0,30,9
1650759517713,MATH 18,A04,083746,Staff,26,0,30,4
1650759517713,MATH 18,B01,083748,Staff,0,15,30,30
1650759517713,MATH 18,B02,083749,Staff,0,12,30,30
1650759517713,MATH 18,B03,083750,Staff,0,12,30,30
1650759517713,MATH 18,B04,083751,Staff,0,12,30,30
1650759523736,MATH 20A,A01,083754,Staff,19,0,40,21
1650759529766,MATH 20B,A01,083756,Staff,0,12,30,30
1650759529766,MATH 20B,A02,083757,Staff,0,12,30,30
1650759535791,MATH 20C,A01,083760,Staff,0,16,30,30
1650759535791,MATH 20C,A02,083761,Staff,0,16,30,30
1650759535791,MATH 20C,B01,083762,Staff,10,0,30,20
1650759535791,MATH 20C,B02,083763,Staff,28,0,30,2
1650759541818,MATH 20D,A01,083765,Staff,2,1,30,28
1650759541818,MATH 20D,A02,083766,Staff,5,0,30,25
1650759541818,MATH 20D,A03,083767,Staff,24,0,30,6
1650759547845,MATH 20E,A01,083771,Staff,3,0,30,27
1650759547845,MATH 20E,A02,083772,Staff,16,0,30,14
1650759547845,MATH 20E,B01,083773,Staff,0,0,30,30
1650759547845,MATH 20E,B02,083774,Staff,5,0,30,25
1650759553870,MATH 103A,A01,083777,Staff,0,16,30,30
1650759553870,MATH 103A,A02,083778,Staff,0,15,30,30
1650759553870,MATH 103A,B01,083779,Staff,0,15,30,30
1650759553870,MATH 103A,B02,083780,Staff,0,15,30,30
1650759559894,MATH 105,A01,085443,Staff,0,22,30,30
1650759565922,MATH 109,A01,083213,Anzaldo; Leesa B,0,7,30,30
1650759565922,MATH 109,A02,083214,Anzaldo; Leesa B,0,7,30,30
1650759565922,MATH 109,B01,083215,Anzaldo; Leesa B,0,8,30,30
1650759565922,MATH 109,B02,083216,Anzaldo; Leesa B,0,6,30,30
1650759571947,MATH 142A,A01,083219,Chow; Bennett,0,16,30,30
1650759571947,MATH 142A,A02,083220,Chow; Bennett,0,15,30,30
1650759571947,MATH 142A,B01,083221,Chow; Bennett,0,15,30,30
1650759571947,MATH 142A,B02,083222,Chow; Bennett,0,14,30,30
1650759577970,MATH 193A,A01,083224,Staff,0,5,30,30
1650759577970,MATH 193A,A02,083225,Staff,0,6,30,30
1650759577970,MATH 193A,A03,083781,Staff,0,6,30,30
1650759577970,MATH 193A,A04,083782,Staff,0,7,30,30
1650759583997,MATH 197,001,091859,McAuley; Julian John,9998,0,9999,1
1650759590066,COGS 9,A01,083615,Staff,1,17,60,59
1650759596090,COGS 11,A01,083617,Boyle; Mary E. T.,16,0,40,24
1650759602118,COGS 13,A01,083071,Staff,0,38,40,40
1650759608141,COGS 14A,A01,092681,Staff,0,36,100,100
1650759614165,COGS 14B,A01,083073,Cheng; Tzu-Han,1,13,50,49
1650759620190,COGS 17,A01,092677,Staff,11,0,75,64
1650759626216,COGS 100,A01,083619,Staff,0,29,60,60
1650759632243,COGS 101A,A01,083621,Davis; Joshua Daniel,0,28,60,60
1650759638270,COGS 101B,A01,091572,Staff,1,4,60,59
1650759644294,COGS 101C,A01,083625,Delgado; Tania,14,0,30,16
1650759650321,COGS 107A,A01,083627,Boyle; Mary E. T.,0,16,60,60
1650759656481,COGS 118A,A01,083075,Staff,0,8,60,60
1650759662506,CSE 3,A50,083646,Miranda; Gregory Joseph,18,0,38,20
1650759662506,CSE 3,A51,083647,Miranda; Gregory Joseph,36,0,37,1
1650759668536,CSE 8A,A50,083650,Miranda; Gregory Joseph,0,30,40,40
1650759674559,CSE 11,A01,083080,Cao; Yingjun,0,96,40,40
1650759680582,CSE 12,A01,083652,Staff,0,21,100,100
1650759686608,CSE 15L,A01,083654,Staff,0,3,50,50
1650759686608,CSE 15L,A02,083655,Staff,0,2,50,50
1650759692634,CSE 20,A01,083657,Staff,49,0,80,31
1650759698661,CSE 30,A01,083084,Eldon; John,0,76,40,40
1650759704684,CSE 100,A01,083659,Cao; Yingjun,0,71,50,50
1650759710707,CSE 134B,A01,083661,Powell; Thomas Allan,0,38,65,65
1650759716733,CSE 140,A01,083663,Staff,0,11,75,75
1650759722757,CSE 140L,A01,083088,Eldon; John,0,20,75,75
1650759728781,CSE 175,A01,083665,Kumar; Rakesh,7,0,25,18
1650759734813,CSE 190,A00,092507,Dubnov; Shlomo,10,0,20,10
1650759740837,ECE 45,A01,083139,Staff,1,2,60,59
1650759746863,ECE 65,A50,083695,Staff,0,5,30,30
1650759752886,ECE 109,A01,091882,Touri; Behrouz,33,0,70,37
1650759758912,ECE 180,A00,083140,Abi Samra; Nicholas Camill,20,0,30,10
1650759758912,ECE 180,B00,083141,Abi Samra; Nicholas Camill,0,0,30,30
1650759764936,MATH 10A,A01,083735,Patchell; Gregory David,2,0,30,28
1650759764936,MATH 10A,A02,083736,Patchell; Gregory David,27,0,30,3
1650759764936,MATH 10A,A03,083737,Patchell; Gregory David,24,0,30,6
1650759770965,MATH 10B,A01,083207,Staff,0,9,30,30
1650759770965,MATH 10B,A02,083208,Staff,1,7,30,29
1650759770965,MATH 10B,B01,083739,Staff,11,0,30,19
1650759770965,MATH 10B,B02,083740,Staff,28,0,30,2
1650759776991,MATH 18,A01,083743,Staff,0,0,30,30
1650759776991,MATH 18,A02,083744,Staff,23,0,30,7
1650759776991,MATH 18,A03,083745,Staff,21,0,30,9
1650759776991,MATH 18,A04,083746,Staff,26,0,30,4
1650759776991,MATH 18,B01,083748,Staff,0,15,30,30
1650759776991,MATH 18,B02,083749,Staff,0,12,30,30
1650759776991,MATH 18,B03,083750,Staff,0,12,30,30
1650759776991,MATH 18,B04,083751,Staff,0,12,30,30
1650759783018,MATH 20A,A01,083754,Staff,19,0,40,21
1650759789044,MATH 20B,A01,083756,Staff,0,12,30,30
1650759789044,MATH 20B,A02,083757,Staff,0,12,30,30
1650759795077,MATH 20C,A01,083760,Staff,0,16,30,30
1650759795077,MATH 20C,A02,083761,Staff,0,16,30,30
1650759795077,MATH 20C,B01,083762,Staff,9,0,30,21
1650759795077,MATH 20C,B02,083763,Staff,28,0,30,2
1650759801104,MATH 20D,A01,083765,Staff,2,1,30,28
1650759801104,MATH 20D,A02,083766,Staff,5,0,30,25
1650759801104,MATH 20D,A03,083767,Staff,24,0,30,6
1650759807128,MATH 20E,A01,083771,Staff,3,0,30,27
1650759807128,MATH 20E,A02,083772,Staff,16,0,30,14
1650759807128,MATH 20E,B01,083773,Staff,0,0,30,30
1650759807128,MATH 20E,B02,083774,Staff,5,0,30,25
1650759813156,MATH 103A,A01,083777,Staff,0,16,30,30
1650759813156,MATH 103A,A02,083778,Staff,0,15,30,30
1650759813156,MATH 103A,B01,083779,Staff,0,15,30,30
1650759813156,MATH 103A,B02,083780,Staff,0,15,30,30
1650759819186,MATH 105,A01,085443,Staff,0,22,30,30
1650759825211,MATH 109,A01,083213,Anzaldo; Leesa B,0,7,30,30
1650759825211,MATH 109,A02,083214,Anzaldo; Leesa B,0,7,30,30
1650759825211,MATH 109,B01,083215,Anzaldo; Leesa B,0,8,30,30
1650759825211,MATH 109,B02,083216,Anzaldo; Leesa B,0,6,30,30
1650759831243,MATH 142A,A01,083219,Chow; Bennett,0,16,30,30
1650759831243,MATH 142A,A02,083220,Chow; Bennett,0,15,30,30
1650759831243,MATH 142A,B01,083221,Chow; Bennett,0,15,30,30
1650759831243,MATH 142A,B02,083222,Chow; Bennett,0,14,30,30
1650759837269,MATH 193A,A01,083224,Staff,0,5,30,30
1650759837269,MATH 193A,A02,083225,Staff,0,6,30,30
1650759837269,MATH 193A,A03,083781,Staff,0,6,30,30
1650759837269,MATH 193A,A04,083782,Staff,0,7,30,30
1650759843295,MATH 197,001,091859,McAuley; Julian John,9998,0,9999,1
1650759849346,COGS 9,A01,083615,Staff,1,17,60,59
1650759855374,COGS 11,A01,083617,Boyle; Mary E. T.,16,0,40,24
1650759861401,COGS 13,A01,083071,Staff,0,38,40,40
1650759867426,COGS 14A,A01,092681,Staff,0,36,100,100
1650759873467,COGS 14B,A01,083073,Cheng; Tzu-Han,1,13,50,49
1650759879490,COGS 17,A01,092677,Staff,11,0,75,64
1650759885512,COGS 100,A01,083619,Staff,0,29,60,60
1650759891533,COGS 101A,A01,083621,Davis; Joshua Daniel,0,28,60,60
1650759897555,COGS 101B,A01,091572,Staff,1,4,60,59
1650759903580,COGS 101C,A01,083625,Delgado; Tania,14,0,30,16
1650759909605,COGS 107A,A01,083627,Boyle; Mary E. T.,0,16,60,60
1650759915629,COGS 118A,A01,083075,Staff,0,8,60,60
1650759921657,CSE 3,A50,083646,Miranda; Gregory Joseph,18,0,38,20
1650759921657,CSE 3,A51,083647,Miranda; Gregory Joseph,36,0,37,1
1650759927680,CSE 8A,A50,083650,Miranda; Gregory Joseph,0,30,40,40
1650759933707,CSE 11,A01,083080,Cao; Yingjun,0,96,40,40
1650759939729,CSE 12,A01,083652,Staff,0,21,100,100
1650759945755,CSE 15L,A01,083654,Staff,0,3,50,50
1650759945755,CSE 15L,A02,083655,Staff,0,2,50,50
1650759951776,CSE 20,A01,083657,Staff,49,0,80,31
1650759957806,CSE 30,A01,083084,Eldon; John,0,76,40,40
1650759963832,CSE 100,A01,083659,Cao; Yingjun,0,71,50,50
1650759969860,CSE 134B,A01,083661,Powell; Thomas Allan,0,38,65,65
1650759975883,CSE 140,A01,083663,Staff,0,11,75,75
1650759981907,CSE 140L,A01,083088,Eldon; John,0,20,75,75
1650759987929,CSE 175,A01,083665,Kumar; Rakesh,7,0,25,18
1650759993956,CSE 190,A00,092507,Dubnov; Shlomo,10,0,20,10
1650759999983,ECE 45,A01,083139,Staff,1,2,60,59
1650760006009,ECE 65,A50,083695,Staff,0,5,30,30
1650760012032,ECE 109,A01,091882,Touri; Behrouz,33,0,70,37
1650760018063,ECE 180,A00,083140,Abi Samra; Nicholas Camill,20,0,30,10
1650760018063,ECE 180,B00,083141,Abi Samra; Nicholas Camill,0,0,30,30
1650760024091,MATH 10A,A01,083735,Patchell; Gregory David,2,0,30,28
1650760024091,MATH 10A,A02,083736,Patchell; Gregory David,27,0,30,3
1650760024091,MATH 10A,A03,083737,Patchell; Gregory David,24,0,30,6
1650760030119,MATH 10B,A01,083207,Staff,0,9,30,30
1650760030119,MATH 10B,A02,083208,Staff,1,7,30,29
1650760030119,MATH 10B,B01,083739,Staff,11,0,30,19
1650760030119,MATH 10B,B02,083740,Staff,28,0,30,2
1650760036150,MATH 18,A01,083743,Staff,0,0,30,30
1650760036150,MATH 18,A02,083744,Staff,23,0,30,7
1650760036150,MATH 18,A03,083745,Staff,21,0,30,9
1650760036150,MATH 18,A04,083746,Staff,26,0,30,4
1650760036150,MATH 18,B01,083748,Staff,0,15,30,30
1650760036150,MATH 18,B02,083749,Staff,0,12,30,30
1650760036150,MATH 18,B03,083750,Staff,0,12,30,30
1650760036150,MATH 18,B04,083751,Staff,0,12,30,30
1650760042176,MATH 20A,A01,083754,Staff,19,0,40,21
1650760048202,MATH 20B,A01,083756,Staff,0,12,30,30
1650760048202,MATH 20B,A02,083757,Staff,0,12,30,30
1650760054229,MATH 20C,A01,083760,Staff,0,16,30,30
1650760054229,MATH 20C,A02,083761,Staff,0,16,30,30
1650760054229,MATH 20C,B01,083762,Staff,9,0,30,21
1650760054229,MATH 20C,B02,083763,Staff,28,0,30,2
1650760060254,MATH 20D,A01,083765,Staff,2,1,30,28
1650760060254,MATH 20D,A02,083766,Staff,5,0,30,25
1650760060254,MATH 20D,A03,083767,Staff,24,0,30,6
1650760066279,MATH 20E,A01,083771,Staff,3,0,30,27
1650760066279,MATH 20E,A02,083772,Staff,16,0,30,14
1650760066279,MATH 20E,B01,083773,Staff,0,0,30,30
1650760066279,MATH 20E,B02,083774,Staff,5,0,30,25
1650760072306,MATH 103A,A01,083777,Staff,0,16,30,30
1650760072306,MATH 103A,A02,083778,Staff,0,15,30,30
1650760072306,MATH 103A,B01,083779,Staff,0,15,30,30
1650760072306,MATH 103A,B02,083780,Staff,0,15,30,30
1650760078331,MATH 105,A01,085443,Staff,0,22,30,30
1650760084357,MATH 109,A01,083213,Anzaldo; Leesa B,0,7,30,30
1650760084357,MATH 109,A02,083214,Anzaldo; Leesa B,0,7,30,30
1650760084357,MATH 109,B01,083215,Anzaldo; Leesa B,0,8,30,30
1650760084357,MATH 109,B02,083216,Anzaldo; Leesa B,0,6,30,30
1650760090382,MATH 142A,A01,083219,Chow; Bennett,0,16,30,30
1650760090382,MATH 142A,A02,083220,Chow; Bennett,0,15,30,30
1650760090382,MATH 142A,B01,083221,Chow; Bennett,0,15,30,30
1650760090382,MATH 142A,B02,083222,Chow; Bennett,0,14,30,30
1650760096405,MATH 193A,A01,083224,Staff,0,5,30,30
1650760096405,MATH 193A,A02,083225,Staff,0,6,30,30
1650760096405,MATH 193A,A03,083781,Staff,0,6,30,30
1650760096405,MATH 193A,A04,083782,Staff,0,7,30,30
1650760102432,MATH 197,001,091859,McAuley; Julian John,9998,0,9999,1
1650760108490,COGS 9,A01,083615,Staff,1,17,60,59
1650760114513,COGS 11,A01,083617,Boyle; Mary E. T.,16,0,40,24
1650760120537,COGS 13,A01,083071,Staff,0,38,40,40
1650760126561,COGS 14A,A01,092681,Staff,0,36,100,100
1650760132589,COGS 14B,A01,083073,Cheng; Tzu-Han,1,13,50,49
1650760138615,COGS 17,A01,092677,Staff,11,0,75,64
1650760144642,COGS 100,A01,083619,Staff,0,29,60,60
1650760150670,COGS 101A,A01,083621,Davis; Joshua Daniel,0,28,60,60
1650760156693,COGS 101B,A01,091572,Staff,1,4,60,59
1650760162719,COGS 101C,A01,083625,Delgado; Tania,14,0,30,16
1650760168745,COGS 107A,A01,083627,Boyle; Mary E. T.,0,16,60,60
1650760174770,COGS 118A,A01,083075,Staff,0,8,60,60
1650760180793,CSE 3,A50,083646,Miranda; Gregory Joseph,18,0,38,20
1650760180793,CSE 3,A51,083647,Miranda; Gregory Joseph,36,0,37,1
1650760186832,CSE 8A,A50,083650,Miranda; Gregory Joseph,0,30,40,40
1650760192855,CSE 11,A01,083080,Cao; Yingjun,0,96,40,40
1650760198879,CSE 12,A01,083652,Staff,0,21,100,100
1650760204906,CSE 15L,A01,083654,Staff,0,3,50,50
1650760204906,CSE 15L,A02,083655,Staff,0,2,50,50
1650760210930,CSE 20,A01,083657,Staff,49,0,80,31
1650760216952,CSE 30,A01,083084,Eldon; John,0,76,40,40
1650760222975,CSE 100,A01,083659,Cao; Yingjun,0,71,50,50
1650760228998,CSE 134B,A01,083661,Powell; Thomas Allan,0,38,65,65
1650760235022,CSE 140,A01,083663,Staff,0,11,75,75
1650760241046,CSE 140L,A01,083088,Eldon; John,0,20,75,75
1650760247072,CSE 175,A01,083665,Kumar; Rakesh,7,0,25,18
1650760253191,CSE 190,A00,092507,Dubnov; Shlomo,10,0,20,10
1650760259224,ECE 45,A01,083139,Staff,1,2,60,59
1650760265247,ECE 65,A50,083695,Staff,0,5,30,30
1650760271270,ECE 109,A01,091882,Touri; Behrouz,33,0,70,37
1650760277295,ECE 180,A00,083140,Abi Samra; Nicholas Camill,20,0,30,10
1650760277295,ECE 180,B00,083141,Abi Samra; Nicholas Camill,0,0,30,30
1650760283318,MATH 10A,A01,083735,Patchell; Gregory David,2,0,30,28
1650760283318,MATH 10A,A02,083736,Patchell; Gregory David,27,0,30,3
1650760283318,MATH 10A,A03,083737,Patchell; Gregory David,24,0,30,6
1650760289342,MATH 10B,A01,083207,Staff,0,9,30,30
1650760289342,MATH 10B,A02,083208,Staff,1,7,30,29
1650760289342,MATH 10B,B01,083739,Staff,11,0,30,19
1650760289342,MATH 10B,B02,083740,Staff,28,0,30,2
1650760295370,MATH 18,A01,083743,Staff,0,0,30,30
1650760295370,MATH 18,A02,083744,Staff,23,0,30,7
1650760295370,MATH 18,A03,083745,Staff,21,0,30,9
1650760295370,MATH 18,A04,083746,Staff,26,0,30,4
1650760295370,MATH 18,B01,083748,Staff,0,15,30,30
1650760295370,MATH 18,B02,083749,Staff,0,12,30,30
1650760295370,MATH 18,B03,083750,Staff,0,12,30,30
1650760295370,MATH 18,B04,083751,Staff,0,12,30,30
1650760301396,MATH 20A,A01,083754,Staff,19,0,40,21
1650760307422,MATH 20B,A01,083756,Staff,0,12,30,30
1650760307422,MATH 20B,A02,083757,Staff,0,12,30,30
1650760313447,MATH 20C,A01,083760,Staff,0,16,30,30
1650760313447,MATH 20C,A02,083761,Staff,0,16,30,30
1650760313447,MATH 20C,B01,083762,Staff,9,0,30,21
1650760313447,MATH 20C,B02,083763,Staff,28,0,30,2
1650760319468,MATH 20D,A01,083765,Staff,2,1,30,28
1650760319468,MATH 20D,A02,083766,Staff,5,0,30,25
1650760319468,MATH 20D,A03,083767,Staff,24,0,30,6
1650760325493,MATH 20E,A01,083771,Staff,3,0,30,27
1650760325493,MATH 20E,A02,083772,Staff,16,0,30,14
1650760325493,MATH 20E,B01,083773,Staff,0,0,30,30
1650760325493,MATH 20E,B02,083774,Staff,5,0,30,25
1650760331516,MATH 103A,A01,083777,Staff,0,16,30,30
1650760331516,MATH 103A,A02,083778,Staff,0,15,30,30
1650760331516,MATH 103A,B01,083779,Staff,0,15,30,30
1650760331516,MATH 103A,B02,083780,Staff,0,15,30,30
1650760337540,MATH 105,A01,085443,Staff,0,22,30,30
1650760343565,MATH 109,A01,083213,Anzaldo; Leesa B,0,7,30,30
1650760343565,MATH 109,A02,083214,Anzaldo; Leesa B,0,7,30,30
1650760343565,MATH 109,B01,083215,Anzaldo; Leesa B,0,8,30,30
1650760343565,MATH 109,B02,083216,Anzaldo; Leesa B,0,6,30,30
1650760349590,MATH 142A,A01,083219,Chow; Bennett,0,16,30,30
1650760349590,MATH 142A,A02,083220,Chow; Bennett,0,15,30,30
1650760349590,MATH 142A,B01,083221,Chow; Bennett,0,15,30,30
1650760349590,MATH 142A,B02,083222,Chow; Bennett,0,14,30,30
1650760355615,MATH 193A,A01,083224,Staff,0,5,30,30
1650760355615,MATH 193A,A02,083225,Staff,0,6,30,30
1650760355615,MATH 193A,A03,083781,Staff,0,6,30,30
1650760355615,MATH 193A,A04,083782,Staff,0,7,30,30
1650760361641,MATH 197,001,091859,McAuley; Julian John,9998,0,9999,1
1650760367693,COGS 9,A01,083615,Staff,1,17,60,59
1650760373719,COGS 11,A01,083617,Boyle; Mary E. T.,16,0,40,24
1650760379743,COGS 13,A01,083071,Staff,0,38,40,40
1650760385769,COGS 14A,A01,092681,Staff,0,36,100,100
1650760391792,COGS 14B,A01,083073,Cheng; Tzu-Han,1,13,50,49
1650760397816,COGS 17,A01,092677,Staff,11,0,75,64
1650760403842,COGS 100,A01,083619,Staff,0,29,60,60
1650760409866,COGS 101A,A01,083621,Davis; Joshua Daniel,0,28,60,60
1650760415890,COGS 101B,A01,091572,Staff,1,4,60,59
1650760421917,COGS 101C,A01,083625,Delgado; Tania,14,0,30,16
1650760427940,COGS 107A,A01,083627,Boyle; Mary E. T.,0,16,60,60
1650760433976,COGS 118A,A01,083075,Staff,0,8,60,60
1650760440001,CSE 3,A50,083646,Miranda; Gregory Joseph,18,0,38,20
1650760440001,CSE 3,A51,083647,Miranda; Gregory Joseph,36,0,37,1
1650760446023,CSE 8A,A50,083650,Miranda; Gregory Joseph,0,30,40,40
1650760452050,CSE 11,A01,083080,Cao; Yingjun,0,96,40,40
1650760458072,CSE 12,A01,083652,Staff,0,21,100,100
1650760464099,CSE 15L,A01,083654,Staff,0,3,50,50
1650760464099,CSE 15L,A02,083655,Staff,0,2,50,50
1650760470121,CSE 20,A01,083657,Staff,49,0,80,31
1650760476148,CSE 30,A01,083084,Eldon; John,0,76,40,40
1650760482174,CSE 100,A01,083659,Cao; Yingjun,0,71,50,50
1650760488205,CSE 134B,A01,083661,Powell; Thomas Allan,0,38,65,65
1650760494230,CSE 140,A01,083663,Staff,0,11,75,75
1650760500259,CSE 140L,A01,083088,Eldon; John,0,20,75,75
1650760506283,CSE 175,A01,083665,Kumar; Rakesh,7,0,25,18
1650760512306,CSE 190,A00,092507,Dubnov; Shlomo,10,0,20,10
1650760518335,ECE 45,A01,083139,Staff,1,2,60,59
1650760524367,ECE 65,A50,083695,Staff,0,5,30,30
1650760530389,ECE 109,A01,091882,Touri; Behrouz,33,0,70,37
1650760536413,ECE 180,A00,083140,Abi Samra; Nicholas Camill,20,0,30,10
1650760536413,ECE 180,B00,083141,Abi Samra; Nicholas Camill,0,0,30,30
1650760542440,MATH 10A,A01,083735,Patchell; Gregory David,2,0,30,28
1650760542440,MATH 10A,A02,083736,Patchell; Gregory David,27,0,30,3
1650760542440,MATH 10A,A03,083737,Patchell; Gregory David,24,0,30,6
1650760548463,MATH 10B,A01,083207,Staff,0,9,30,30
1650760548463,MATH 10B,A02,083208,Staff,1,7,30,29
1650760548463,MATH 10B,B01,083739,Staff,11,0,30,19
1650760548463,MATH 10B,B02,083740,Staff,28,0,30,2
1650760554492,MATH 18,A01,083743,Staff,0,0,30,30
1650760554492,MATH 18,A02,083744,Staff,23,0,30,7
1650760554492,MATH 18,A03,083745,Staff,21,0,30,9
1650760554492,MATH 18,A04,083746,Staff,26,0,30,4
1650760554492,MATH 18,B01,083748,Staff,0,15,30,30
1650760554492,MATH 18,B02,083749,Staff,0,12,30,30
1650760554492,MATH 18,B03,083750,Staff,0,12,30,30
1650760554492,MATH 18,B04,083751,Staff,0,12,30,30
1650760560518,MATH 20A,A01,083754,Staff,19,0,40,21
1650760566542,MATH 20B,A01,083756,Staff,0,12,30,30
1650760566542,MATH 20B,A02,083757,Staff,0,12,30,30
1650760572566,MATH 20C,A01,083760,Staff,0,16,30,30
1650760572566,MATH 20C,A02,083761,Staff,0,16,30,30
1650760572566,MATH 20C,B01,083762,Staff,9,0,30,21
1650760572566,MATH 20C,B02,083763,Staff,28,0,30,2
1650760578591,MATH 20D,A01,083765,Staff,2,1,30,28
1650760578591,MATH 20D,A02,083766,Staff,5,0,30,25
1650760578591,MATH 20D,A03,083767,Staff,24,0,30,6
1650760584618,MATH 20E,A01,083771,Staff,3,0,30,27
1650760584618,MATH 20E,A02,083772,Staff,16,0,30,14
1650760584618,MATH 20E,B01,083773,Staff,0,0,30,30
1650760584618,MATH 20E,B02,083774,Staff,5,0,30,25
1650760590642,MATH 103A,A01,083777,Staff,0,16,30,30
1650760590642,MATH 103A,A02,083778,Staff,0,15,30,30
1650760590642,MATH 103A,B01,083779,Staff,0,15,30,30
1650760590642,MATH 103A,B02,083780,Staff,0,15,30,30
1650760596668,MATH 105,A01,085443,Staff,0,22,30,30
1650760602698,MATH 109,A01,083213,Anzaldo; Leesa B,0,7,30,30
1650760602698,MATH 109,A02,083214,Anzaldo; Leesa B,0,7,30,30
1650760602698,MATH 109,B01,083215,Anzaldo; Leesa B,0,8,30,30
1650760602698,MATH 109,B02,083216,Anzaldo; Leesa B,0,6,30,30
1650760608727,MATH 142A,A01,083219,Chow; Bennett,0,16,30,30
1650760608727,MATH 142A,A02,083220,Chow; Bennett,0,15,30,30
1650760608727,MATH 142A,B01,083221,Chow; Bennett,0,15,30,30
1650760608727,MATH 142A,B02,083222,Chow; Bennett,0,14,30,30
1650760614756,MATH 193A,A01,083224,Staff,0,5,30,30
1650760614756,MATH 193A,A02,083225,Staff,0,6,30,30
1650760614756,MATH 193A,A03,083781,Staff,0,6,30,30
1650760614756,MATH 193A,A04,083782,Staff,0,7,30,30
1650760620780,MATH 197,001,091859,McAuley; Julian John,9998,0,9999,1
1650760626838,COGS 9,A01,083615,Staff,1,17,60,59
1650760632861,COGS 11,A01,083617,Boyle; Mary E. T.,16,0,40,24
1650760638883,COGS 13,A01,083071,Staff,0,38,40,40
1650760644907,COGS 14A,A01,092681,Staff,0,36,100,100
1650760650932,COGS 14B,A01,083073,Cheng; Tzu-Han,1,13,50,49
1650760656957,COGS 17,A01,092677,Staff,11,0,75,64
1650760662984,COGS 100,A01,083619,Staff,0,29,60,60
1650760669016,COGS 101A,A01,083621,Davis; Joshua Daniel,0,28,60,60
1650760675043,COGS 101B,A01,091572,Staff,1,4,60,59
1650760681066,COGS 101C,A01,083625,Delgado; Tania,14,0,30,16
1650760687096,COGS 107A,A01,083627,Boyle; Mary E. T.,0,16,60,60
1650760693123,COGS 118A,A01,083075,Staff,0,8,60,60
1650760699157,CSE 3,A50,083646,Miranda; Gregory Joseph,18,0,38,20
1650760699157,CSE 3,A51,083647,Miranda; Gregory Joseph,36,0,37,1
1650760705186,CSE 8A,A50,083650,Miranda; Gregory Joseph,0,30,40,40
1650760711212,CSE 11,A01,083080,Cao; Yingjun,0,96,40,40
1650760717238,CSE 12,A01,083652,Staff,0,21,100,100
1650760723262,CSE 15L,A01,083654,Staff,0,3,50,50
1650760723262,CSE 15L,A02,083655,Staff,0,2,50,50
1650760729289,CSE 20,A01,083657,Staff,49,0,80,31
1650760735315,CSE 30,A01,083084,Eldon; John,0,76,40,40
1650760741339,CSE 100,A01,083659,Cao; Yingjun,0,71,50,50
1650760747363,CSE 134B,A01,083661,Powell; Thomas Allan,0,38,65,65
1650760753387,CSE 140,A01,083663,Staff,0,11,75,75
1650760759416,CSE 140L,A01,083088,Eldon; John,0,20,75,75
1650760765439,CSE 175,A01,083665,Kumar; Rakesh,7,0,25,18
1650760771466,CSE 190,A00,092507,Dubnov; Shlomo,10,0,20,10
1650760777490,ECE 45,A01,083139,Staff,1,2,60,59
1650760783517,ECE 65,A50,083695,Staff,0,5,30,30
1650760789544,ECE 109,A01,091882,Touri; Behrouz,33,0,70,37
1650760795572,ECE 180,A00,083140,Abi Samra; Nicholas Camill,20,0,30,10
1650760795572,ECE 180,B00,083141,Abi Samra; Nicholas Camill,0,0,30,30
1650760801599,MATH 10A,A01,083735,Patchell; Gregory David,2,0,30,28
1650760801599,MATH 10A,A02,083736,Patchell; Gregory David,27,0,30,3
1650760801599,MATH 10A,A03,083737,Patchell; Gregory David,24,0,30,6
1650760807626,MATH 10B,A01,083207,Staff,0,9,30,30
1650760807626,MATH 10B,A02,083208,Staff,1,7,30,29
1650760807626,MATH 10B,B01,083739,Staff,11,0,30,19
1650760807626,MATH 10B,B02,083740,Staff,28,0,30,2
1650760813652,MATH 18,A01,083743,Staff,0,0,30,30
1650760813652,MATH 18,A02,083744,Staff,23,0,30,7
1650760813652,MATH 18,A03,083745,Staff,21,0,30,9
1650760813652,MATH 18,A04,083746,Staff,26,0,30,4
1650760813652,MATH 18,B01,083748,Staff,0,15,30,30
1650760813652,MATH 18,B02,083749,Staff,0,12,30,30
1650760813652,MATH 18,B03,083750,Staff,0,12,30,30
1650760813652,MATH 18,B04,083751,Staff,0,12,30,30
1650760819676,MATH 20A,A01,083754,Staff,19,0,40,21
1650760825703,MATH 20B,A01,083756,Staff,0,12,30,30
1650760825703,MATH 20B,A02,083757,Staff,0,12,30,30
1650760831729,MATH 20C,A01,083760,Staff,0,16,30,30
1650760831729,MATH 20C,A02,083761,Staff,0,16,30,30
1650760831729,MATH 20C,B01,083762,Staff,9,0,30,21
1650760831729,MATH 20C,B02,083763,Staff,28,0,30,2
1650760837755,MATH 20D,A01,083765,Staff,2,1,30,28
1650760837755,MATH 20D,A02,083766,Staff,5,0,30,25
1650760837755,MATH 20D,A03,083767,Staff,24,0,30,6
1650760843780,MATH 20E,A01,083771,Staff,3,0,30,27
1650760843780,MATH 20E,A02,083772,Staff,16,0,30,14
1650760843780,MATH 20E,B01,083773,Staff,0,0,30,30
1650760843780,MATH 20E,B02,083774,Staff,5,0,30,25
1650760849895,MATH 103A,A01,083777,Staff,0,16,30,30
1650760849895,MATH 103A,A02,083778,Staff,0,15,30,30
1650760849895,MATH 103A,B01,083779,Staff,0,15,30,30
1650760849895,MATH 103A,B02,083780,Staff,0,15,30,30
1650760855930,MATH 105,A01,085443,Staff,0,22,30,30
1650760861960,MATH 109,A01,083213,Anzaldo; Leesa B,0,7,30,30
1650760861960,MATH 109,A02,083214,Anzaldo; Leesa B,0,7,30,30
1650760861960,MATH 109,B01,083215,Anzaldo; Leesa B,0,8,30,30
1650760861960,MATH 109,B02,083216,Anzaldo; Leesa B,0,6,30,30
1650760867984,MATH 142A,A01,083219,Chow; Bennett,0,16,30,30
1650760867984,MATH 142A,A02,083220,Chow; Bennett,0,15,30,30
1650760867984,MATH 142A,B01,083221,Chow; Bennett,0,15,30,30
1650760867984,MATH 142A,B02,083222,Chow; Bennett,0,14,30,30
1650760874012,MATH 193A,A01,083224,Staff,0,5,30,30
1650760874012,MATH 193A,A02,083225,Staff,0,6,30,30
1650760874012,MATH 193A,A03,083781,Staff,0,6,30,30
1650760874012,MATH 193A,A04,083782,Staff,0,7,30,30
1650760880038,MATH 197,001,091859,McAuley; Julian John,9998,0,9999,1
1650760886099,COGS 9,A01,083615,Staff,1,17,60,59
1650760892122,COGS 11,A01,083617,Boyle; Mary E. T.,16,0,40,24
1650760898146,COGS 13,A01,083071,Staff,0,38,40,40
1650760904172,COGS 14A,A01,092681,Staff,0,36,100,100
1650760910200,COGS 14B,A01,083073,Cheng; Tzu-Han,1,13,50,49
1650760916222,COGS 17,A01,092677,Staff,11,0,75,64
1650760922245,COGS 100,A01,083619,Staff,0,29,60,60
1650760928269,COGS 101A,A01,083621,Davis; Joshua Daniel,0,28,60,60
1650760934296,COGS 101B,A01,091572,Staff,1,4,60,59
1650760940327,COGS 101C,A01,083625,Delgado; Tania,14,0,30,16
1650760946357,COGS 107A,A01,083627,Boyle; Mary E. T.,0,16,60,60
1650760952381,COGS 118A,A01,083075,Staff,0,8,60,60
1650760958406,CSE 3,A50,083646,Miranda; Gregory Joseph,18,0,38,20
1650760958406,CSE 3,A51,083647,Miranda; Gregory Joseph,36,0,37,1
1650760964433,CSE 8A,A50,083650,Miranda; Gregory Joseph,0,30,40,40
1650760970457,CSE 11,A01,083080,Cao; Yingjun,0,96,40,40
1650760976484,CSE 12,A01,083652,Staff,0,21,100,100
1650760982507,CSE 15L,A01,083654,Staff,0,3,50,50
1650760982507,CSE 15L,A02,083655,Staff,0,2,50,50
1650760988530,CSE 20,A01,083657,Staff,49,0,80,31
1650760994558,CSE 30,A01,083084,Eldon; John,0,76,40,40
1650761000586,CSE 100,A01,083659,Cao; Yingjun,0,71,50,50
1650761006610,CSE 134B,A01,083661,Powell; Thomas Allan,0,38,65,65
1650761012634,CSE 140,A01,083663,Staff,0,11,75,75
1650761018662,CSE 140L,A01,083088,Eldon; John,0,20,75,75
1650761024684,CSE 175,A01,083665,Kumar; Rakesh,7,0,25,18
1650761030710,CSE 190,A00,092507,Dubnov; Shlomo,10,0,20,10
1650761036733,ECE 45,A01,083139,Staff,1,2,60,59
1650761042760,ECE 65,A50,083695,Staff,0,5,30,30
1650761048784,ECE 109,A01,091882,Touri; Behrouz,33,0,70,37
1650761054807,ECE 180,A00,083140,Abi Samra; Nicholas Camill,20,0,30,10
1650761054807,ECE 180,B00,083141,Abi Samra; Nicholas Camill,0,0,30,30
1650761060832,MATH 10A,A01,083735,Patchell; Gregory David,2,0,30,28
1650761060832,MATH 10A,A02,083736,Patchell; Gregory David,27,0,30,3
1650761060832,MATH 10A,A03,083737,Patchell; Gregory David,24,0,30,6
1650761066867,MATH 10B,A01,083207,Staff,0,9,30,30
1650761066867,MATH 10B,A02,083208,Staff,1,7,30,29
1650761066867,MATH 10B,B01,083739,Staff,11,0,30,19
1650761066867,MATH 10B,B02,083740,Staff,28,0,30,2
1650761072890,MATH 18,A01,083743,Staff,0,0,30,30
1650761072890,MATH 18,A02,083744,Staff,23,0,30,7
1650761072890,MATH 18,A03,083745,Staff,21,0,30,9
1650761072890,MATH 18,A04,083746,Staff,26,0,30,4
1650761072890,MATH 18,B01,083748,Staff,0,15,30,30
1650761072890,MATH 18,B02,083749,Staff,0,12,30,30
1650761072890,MATH 18,B03,083750,Staff,0,12,30,30
1650761072890,MATH 18,B04,083751,Staff,0,12,30,30
1650761078915,MATH 20A,A01,083754,Staff,19,0,40,21
1650761084939,MATH 20B,A01,083756,Staff,0,13,30,30
1650761084939,MATH 20B,A02,083757,Staff,0,12,30,30
1650761090964,MATH 20C,A01,083760,Staff,0,16,30,30
1650761090964,MATH 20C,A02,083761,Staff,0,16,30,30
1650761090964,MATH 20C,B01,083762,Staff,9,0,30,21
1650761090964,MATH 20C,B02,083763,Staff,28,0,30,2
1650761096987,MATH 20D,A01,083765,Staff,2,1,30,28
1650761096987,MATH 20D,A02,083766,Staff,5,0,30,25
1650761096987,MATH 20D,A03,083767,Staff,24,0,30,6
1650761103012,MATH 20E,A01,083771,Staff,3,0,30,27
1650761103012,MATH 20E,A02,083772,Staff,16,0,30,14
1650761103012,MATH 20E,B01,083773,Staff,0,0,30,30
1650761103012,MATH 20E,B02,083774,Staff,5,0,30,25
1650761109041,MATH 103A,A01,083777,Staff,0,16,30,30
1650761109041,MATH 103A,A02,083778,Staff,0,15,30,30
1650761109041,MATH 103A,B01,083779,Staff,0,15,30,30
1650761109041,MATH 103A,B02,083780,Staff,0,15,30,30
1650761115068,MATH 105,A01,085443,Staff,0,22,30,30
1650761121093,MATH 109,A01,083213,Anzaldo; Leesa B,0,7,30,30
1650761121093,MATH 109,A02,083214,Anzaldo; Leesa B,0,7,30,30
1650761121093,MATH 109,B01,083215,Anzaldo; Leesa B,0,8,30,30
1650761121093,MATH 109,B02,083216,Anzaldo; Leesa B,0,6,30,30
1650761127122,MATH 142A,A01,083219,Chow; Bennett,0,16,30,30
1650761127122,MATH 142A,A02,083220,Chow; Bennett,0,15,30,30
1650761127122,MATH 142A,B01,083221,Chow; Bennett,0,15,30,30
1650761127122,MATH 142A,B02,083222,Chow; Bennett,0,14,30,30
1650761133146,MATH 193A,A01,083224,Staff,0,5,30,30
1650761133146,MATH 193A,A02,083225,Staff,0,6,30,30
1650761133146,MATH 193A,A03,083781,Staff,0,6,30,30
1650761133146,MATH 193A,A04,083782,Staff,0,7,30,30
1650761139168,MATH 197,001,091859,McAuley; Julian John,9998,0,9999,1
1650761145228,COGS 9,A01,083615,Staff,1,17,60,59
1650761151252,COGS 11,A01,083617,Boyle; Mary E. T.,16,0,40,24
1650761157284,COGS 13,A01,083071,Staff,0,38,40,40
1650761163311,COGS 14A,A01,092681,Staff,0,36,100,100
1650761169338,COGS 14B,A01,083073,Cheng; Tzu-Han,1,13,50,49
1650761175363,COGS 17,A01,092677,Staff,11,0,75,64
1650761181396,COGS 100,A01,083619,Staff,0,29,60,60
1650761187424,COGS 101A,A01,083621,Davis; Joshua Daniel,0,28,60,60
1650761193447,COGS 101B,A01,091572,Staff,1,4,60,59
1650761199470,COGS 101C,A01,083625,Delgado; Tania,14,0,30,16
1650761205498,COGS 107A,A01,083627,Boyle; Mary E. T.,0,16,60,60
1650761211534,COGS 118A,A01,083075,Staff,0,8,60,60
1650761217559,CSE 3,A50,083646,Miranda; Gregory Joseph,18,0,38,20
1650761217559,CSE 3,A51,083647,Miranda; Gregory Joseph,36,0,37,1
1650761223581,CSE 8A,A50,083650,Miranda; Gregory Joseph,0,30,40,40
1650761229618,CSE 11,A01,083080,Cao; Yingjun,0,96,40,40
1650761235645,CSE 12,A01,083652,Staff,0,21,100,100
1650761241672,CSE 15L,A01,083654,Staff,0,3,50,50
1650761241672,CSE 15L,A02,083655,Staff,0,2,50,50
1650761247695,CSE 20,A01,083657,Staff,49,0,80,31
1650761253730,CSE 30,A01,083084,Eldon; John,0,76,40,40
1650761259755,CSE 100,A01,083659,Cao; Yingjun,0,71,50,50
1650761265783,CSE 134B,A01,083661,Powell; Thomas Allan,0,38,65,65
1650761271806,CSE 140,A01,083663,Staff,0,11,75,75
1650761277833,CSE 140L,A01,083088,Eldon; John,0,20,75,75
1650761283856,CSE 175,A01,083665,Kumar; Rakesh,7,0,25,18
1650761289881,CSE 190,A00,092507,Dubnov; Shlomo,10,0,20,10
1650761295907,ECE 45,A01,083139,Staff,1,2,60,59
1650761301931,ECE 65,A50,083695,Staff,0,5,30,30
1650761307958,ECE 109,A01,091882,Touri; Behrouz,33,0,70,37
1650761313982,ECE 180,A00,083140,Abi Samra; Nicholas Camill,20,0,30,10
1650761313982,ECE 180,B00,083141,Abi Samra; Nicholas Camill,0,0,30,30
1650761320008,MATH 10A,A01,083735,Patchell; Gregory David,2,0,30,28
1650761320008,MATH 10A,A02,083736,Patchell; Gregory David,27,0,30,3
1650761320008,MATH 10A,A03,083737,Patchell; Gregory David,24,0,30,6
1650761326036,MATH 10B,A01,083207,Staff,0,9,30,30
1650761326036,MATH 10B,A02,083208,Staff,1,7,30,29
1650761326036,MATH 10B,B01,083739,Staff,11,0,30,19
1650761326036,MATH 10B,B02,083740,Staff,28,0,30,2
1650761332069,MATH 18,A01,083743,Staff,0,0,30,30
1650761332069,MATH 18,A02,083744,Staff,23,0,30,7
1650761332069,MATH 18,A03,083745,Staff,21,0,30,9
1650761332069,MATH 18,A04,083746,Staff,26,0,30,4
1650761332069,MATH 18,B01,083748,Staff,0,15,30,30
1650761332069,MATH 18,B02,083749,Staff,0,12,30,30
1650761332069,MATH 18,B03,083750,Staff,0,12,30,30
1650761332069,MATH 18,B04,083751,Staff,0,12,30,30
1650761338101,MATH 20A,A01,083754,Staff,19,0,40,21
1650761344124,MATH 20B,A01,083756,Staff,0,13,30,30
1650761344124,MATH 20B,A02,083757,Staff,0,12,30,30
1650761350148,MATH 20C,A01,083760,Staff,0,16,30,30
1650761350148,MATH 20C,A02,083761,Staff,0,16,30,30
1650761350148,MATH 20C,B01,083762,Staff,9,0,30,21
1650761350148,MATH 20C,B02,083763,Staff,28,0,30,2
1650761356175,MATH 20D,A01,083765,Staff,2,1,30,28
1650761356175,MATH 20D,A02,083766,Staff,5,0,30,25
1650761356175,MATH 20D,A03,083767,Staff,24,0,30,6
1650761362203,MATH 20E,A01,083771,Staff,3,0,30,27
1650761362203,MATH 20E,A02,083772,Staff,16,0,30,14
1650761362203,MATH 20E,B01,083773,Staff,0,0,30,30
1650761362203,MATH 20E,B02,083774,Staff,5,0,30,25
1650761368232,MATH 103A,A01,083777,Staff,0,16,30,30
1650761368232,MATH 103A,A02,083778,Staff,0,15,30,30
1650761368232,MATH 103A,B01,083779,Staff,0,15,30,30
1650761368232,MATH 103A,B02,083780,Staff,0,15,30,30
1650761374257,MATH 105,A01,085443,Staff,0,22,30,30
1650761380285,MATH 109,A01,083213,Anzaldo; Leesa B,0,7,30,30
1650761380285,MATH 109,A02,083214,Anzaldo; Leesa B,0,7,30,30
1650761380285,MATH 109,B01,083215,Anzaldo; Leesa B,0,8,30,30
1650761380285,MATH 109,B02,083216,Anzaldo; Leesa B,0,6,30,30
1650761386309,MATH 142A,A01,083219,Chow; Bennett,0,16,30,30
1650761386309,MATH 142A,A02,083220,Chow; Bennett,0,15,30,30
1650761386309,MATH 142A,B01,083221,Chow; Bennett,0,15,30,30
1650761386309,MATH 142A,B02,083222,Chow; Bennett,0,14,30,30
1650761392332,MATH 193A,A01,083224,Staff,0,5,30,30
1650761392332,MATH 193A,A02,083225,Staff,0,6,30,30
1650761392332,MATH 193A,A03,083781,Staff,0,6,30,30
1650761392332,MATH 193A,A04,083782,Staff,0,7,30,30
1650761398367,MATH 197,001,091859,McAuley; Julian John,9998,0,9999,1
1650761404432,COGS 9,A01,083615,Staff,1,17,60,59
1650761410460,COGS 11,A01,083617,Boyle; Mary E. T.,16,0,40,24
1650761416487,COGS 13,A01,083071,Staff,0,38,40,40
1650761422509,COGS 14A,A01,092681,Staff,0,36,100,100
1650761428533,COGS 14B,A01,083073,Cheng; Tzu-Han,1,13,50,49
1650761434557,COGS 17,A01,092677,Staff,11,0,75,64
1650761440670,COGS 100,A01,083619,Staff,0,29,60,60
1650761446697,COGS 101A,A01,083621,Davis; Joshua Daniel,0,28,60,60
1650761452724,COGS 101B,A01,091572,Staff,1,4,60,59
1650761458748,COGS 101C,A01,083625,Delgado; Tania,14,0,30,16
1650761464779,COGS 107A,A01,083627,Boyle; Mary E. T.,0,16,60,60
1650761470805,COGS 118A,A01,083075,Staff,0,8,60,60
1650761476830,CSE 3,A50,083646,Miranda; Gregory Joseph,18,0,38,20
1650761476830,CSE 3,A51,083647,Miranda; Gregory Joseph,36,0,37,1
1650761482867,CSE 8A,A50,083650,Miranda; Gregory Joseph,0,30,40,40
1650761488893,CSE 11,A01,083080,Cao; Yingjun,0,96,40,40
1650761494916,CSE 12,A01,083652,Staff,0,21,100,100
1650761500940,CSE 15L,A01,083654,Staff,0,3,50,50
1650761500940,CSE 15L,A02,083655,Staff,0,2,50,50
1650761506964,CSE 20,A01,083657,Staff,49,0,80,31
1650761512996,CSE 30,A01,083084,Eldon; John,0,76,40,40
1650761519023,CSE 100,A01,083659,Cao; Yingjun,0,71,50,50
1650761525054,CSE 134B,A01,083661,Powell; Thomas Allan,0,38,65,65
1650761531083,CSE 140,A01,083663,Staff,0,11,75,75
1650761537106,CSE 140L,A01,083088,Eldon; John,0,20,75,75
1650761543130,CSE 175,A01,083665,Kumar; Rakesh,7,0,25,18
1650761549154,CSE 190,A00,092507,Dubnov; Shlomo,10,0,20,10
1650761555179,ECE 45,A01,083139,Staff,1,2,60,59
1650761561201,ECE 65,A50,083695,Staff,0,5,30,30
1650761567226,ECE 109,A01,091882,Touri; Behrouz,33,0,70,37
1650761573257,ECE 180,A00,083140,Abi Samra; Nicholas Camill,20,0,30,10
1650761573257,ECE 180,B00,083141,Abi Samra; Nicholas Camill,0,0,30,30
1650761579281,MATH 10A,A01,083735,Patchell; Gregory David,2,0,30,28
1650761579281,MATH 10A,A02,083736,Patchell; Gregory David,27,0,30,3
1650761579281,MATH 10A,A03,083737,Patchell; Gregory David,24,0,30,6
1650761585303,MATH 10B,A01,083207,Staff,0,9,30,30
1650761585303,MATH 10B,A02,083208,Staff,1,7,30,29
1650761585303,MATH 10B,B01,083739,Staff,11,0,30,19
1650761585303,MATH 10B,B02,083740,Staff,28,0,30,2
1650761591327,MATH 18,A01,083743,Staff,0,0,30,30
1650761591327,MATH 18,A02,083744,Staff,23,0,30,7
1650761591327,MATH 18,A03,083745,Staff,21,0,30,9
1650761591327,MATH 18,A04,083746,Staff,26,0,30,4
1650761591327,MATH 18,B01,083748,Staff,0,15,30,30
1650761591327,MATH 18,B02,083749,Staff,0,12,30,30
1650761591327,MATH 18,B03,083750,Staff,0,12,30,30
1650761591327,MATH 18,B04,083751,Staff,0,12,30,30
1650761597352,MATH 20A,A01,083754,Staff,19,0,40,21
1650761603376,MATH 20B,A01,083756,Staff,0,13,30,30
1650761603376,MATH 20B,A02,083757,Staff,0,12,30,30
1650761609404,MATH 20C,A01,083760,Staff,0,16,30,30
1650761609404,MATH 20C,A02,083761,Staff,0,16,30,30
1650761609404,MATH 20C,B01,083762,Staff,9,0,30,21
1650761609404,MATH 20C,B02,083763,Staff,28,0,30,2
1650761615428,MATH 20D,A01,083765,Staff,2,1,30,28
1650761615428,MATH 20D,A02,083766,Staff,5,0,30,25
1650761615428,MATH 20D,A03,083767,Staff,24,0,30,6
1650761621453,MATH 20E,A01,083771,Staff,3,0,30,27
1650761621453,MATH 20E,A02,083772,Staff,16,0,30,14
1650761621453,MATH 20E,B01,083773,Staff,0,0,30,30
1650761621453,MATH 20E,B02,083774,Staff,5,0,30,25
1650761627482,MATH 103A,A01,083777,Staff,0,16,30,30
1650761627482,MATH 103A,A02,083778,Staff,0,15,30,30
1650761627482,MATH 103A,B01,083779,Staff,0,15,30,30
1650761627482,MATH 103A,B02,083780,Staff,0,15,30,30
1650761633509,MATH 105,A01,085443,Staff,0,22,30,30
1650761639546,MATH 109,A01,083213,Anzaldo; Leesa B,0,7,30,30
1650761639546,MATH 109,A02,083214,Anzaldo; Leesa B,0,7,30,30
1650761639546,MATH 109,B01,083215,Anzaldo; Leesa B,0,8,30,30
1650761639546,MATH 109,B02,083216,Anzaldo; Leesa B,0,6,30,30
1650761645573,MATH 142A,A01,083219,Chow; Bennett,0,16,30,30
1650761645573,MATH 142A,A02,083220,Chow; Bennett,0,15,30,30
1650761645573,MATH 142A,B01,083221,Chow; Bennett,0,15,30,30
1650761645573,MATH 142A,B02,083222,Chow; Bennett,0,14,30,30
1650761651596,MATH 193A,A01,083224,Staff,0,5,30,30
1650761651596,MATH 193A,A02,083225,Staff,0,6,30,30
1650761651596,MATH 193A,A03,083781,Staff,0,6,30,30
1650761651596,MATH 193A,A04,083782,Staff,0,7,30,30
1650761657632,MATH 197,001,091859,McAuley; Julian John,9998,0,9999,1
1650761663701,COGS 9,A01,083615,Staff,1,17,60,59
1650761669724,COGS 11,A01,083617,Boyle; Mary E. T.,16,0,40,24
1650761675748,COGS 13,A01,083071,Staff,0,38,40,40
1650761681773,COGS 14A,A01,092681,Staff,0,36,100,100
1650761687800,COGS 14B,A01,083073,Cheng; Tzu-Han,1,13,50,49
1650761693824,COGS 17,A01,092677,Staff,11,0,75,64
1650761699854,COGS 100,A01,083619,Staff,0,29,60,60
1650761705878,COGS 101A,A01,083621,Davis; Joshua Daniel,0,28,60,60
1650761711904,COGS 101B,A01,091572,Staff,1,4,60,59
1650761717931,COGS 101C,A01,083625,Delgado; Tania,14,0,30,16
1650761723958,COGS 107A,A01,083627,Boyle; Mary E. T.,0,16,60,60
1650761729983,COGS 118A,A01,083075,Staff,0,8,60,60
1650761736008,CSE 3,A50,083646,Miranda; Gregory Joseph,18,0,38,20
1650761736008,CSE 3,A51,083647,Miranda; Gregory Joseph,36,0,37,1
1650761742035,CSE 8A,A50,083650,Miranda; Gregory Joseph,0,30,40,40
1650761748059,CSE 11,A01,083080,Cao; Yingjun,0,96,40,40
1650761754081,CSE 12,A01,083652,Staff,0,21,100,100
1650761760107,CSE 15L,A01,083654,Staff,0,3,50,50
1650761760107,CSE 15L,A02,083655,Staff,0,2,50,50
1650761766139,CSE 20,A01,083657,Staff,49,0,80,31
1650761772163,CSE 30,A01,083084,Eldon; John,0,76,40,40
1650761778188,CSE 100,A01,083659,Cao; Yingjun,0,71,50,50
1650761784211,CSE 134B,A01,083661,Powell; Thomas Allan,0,38,65,65
1650761790239,CSE 140,A01,083663,Staff,0,11,75,75
1650761796266,CSE 140L,A01,083088,Eldon; John,0,20,75,75
1650761802296,CSE 175,A01,083665,Kumar; Rakesh,7,0,25,18
1650761808320,CSE 190,A00,092507,Dubnov; Shlomo,10,0,20,10
1650761814344,ECE 45,A01,083139,Staff,1,2,60,59
1650761820367,ECE 65,A50,083695,Staff,0,5,30,30
1650761826392,ECE 109,A01,091882,Touri; Behrouz,33,0,70,37
1650761832414,ECE 180,A00,083140,Abi Samra; Nicholas Camill,20,0,30,10
1650761832414,ECE 180,B00,083141,Abi Samra; Nicholas Camill,0,0,30,30
1650761838437,MATH 10A,A01,083735,Patchell; Gregory David,2,0,30,28
1650761838437,MATH 10A,A02,083736,Patchell; Gregory David,27,0,30,3
1650761838437,MATH 10A,A03,083737,Patchell; Gregory David,24,0,30,6
1650761844482,MATH 10B,A01,083207,Staff,0,9,30,30
1650761844482,MATH 10B,A02,083208,Staff,1,7,30,29
1650761844482,MATH 10B,B01,083739,Staff,11,0,30,19
1650761844482,MATH 10B,B02,083740,Staff,28,0,30,2
1650761850510,MATH 18,A01,083743,Staff,0,0,30,30
1650761850510,MATH 18,A02,083744,Staff,23,0,30,7
1650761850510,MATH 18,A03,083745,Staff,21,0,30,9
1650761850510,MATH 18,A04,083746,Staff,26,0,30,4
1650761850510,MATH 18,B01,083748,Staff,0,15,30,30
1650761850510,MATH 18,B02,083749,Staff,0,12,30,30
1650761850510,MATH 18,B03,083750,Staff,0,12,30,30
1650761850510,MATH 18,B04,083751,Staff,0,12,30,30
1650761856537,MATH 20A,A01,083754,Staff,19,0,40,21
1650761862559,MATH 20B,A01,083756,Staff,0,13,30,30
1650761862559,MATH 20B,A02,083757,Staff,0,12,30,30
1650761868584,MATH 20C,A01,083760,Staff,0,16,30,30
1650761868584,MATH 20C,A02,083761,Staff,0,16,30,30
1650761868584,MATH 20C,B01,083762,Staff,9,0,30,21
1650761868584,MATH 20C,B02,083763,Staff,28,0,30,2
1650761874608,MATH 20D,A01,083765,Staff,2,1,30,28
1650761874608,MATH 20D,A02,083766,Staff,5,0,30,25
1650761874608,MATH 20D,A03,083767,Staff,24,0,30,6
1650761880633,MATH 20E,A01,083771,Staff,3,0,30,27
1650761880633,MATH 20E,A02,083772,Staff,16,0,30,14
1650761880633,MATH 20E,B01,083773,Staff,0,0,30,30
1650761880633,MATH 20E,B02,083774,Staff,5,0,30,25
1650761886659,MATH 103A,A01,083777,Staff,0,16,30,30
1650761886659,MATH 103A,A02,083778,Staff,0,15,30,30
1650761886659,MATH 103A,B01,083779,Staff,0,15,30,30
1650761886659,MATH 103A,B02,083780,Staff,0,15,30,30
1650761892681,MATH 105,A01,085443,Staff,0,22,30,30
1650761898706,MATH 109,A01,083213,Anzaldo; Leesa B,0,7,30,30
1650761898706,MATH 109,A02,083214,Anzaldo; Leesa B,0,7,30,30
1650761898706,MATH 109,B01,083215,Anzaldo; Leesa B,0,8,30,30
1650761898706,MATH 109,B02,083216,Anzaldo; Leesa B,0,6,30,30
1650761904729,MATH 142A,A01,083219,Chow; Bennett,0,16,30,30
1650761904729,MATH 142A,A02,083220,Chow; Bennett,0,15,30,30
1650761904729,MATH 142A,B01,083221,Chow; Bennett,0,15,30,30
1650761904729,MATH 142A,B02,083222,Chow; Bennett,0,14,30,30
1650761910764,MATH 193A,A01,083224,Staff,0,5,30,30
1650761910764,MATH 193A,A02,083225,Staff,0,6,30,30
1650761910764,MATH 193A,A03,083781,Staff,0,6,30,30
1650761910764,MATH 193A,A04,083782,Staff,0,7,30,30
1650761916790,MATH 197,001,091859,McAuley; Julian John,9998,0,9999,1
1650761922845,COGS 9,A01,083615,Staff,1,17,60,59
1650761928872,COGS 11,A01,083617,Boyle; Mary E. T.,16,0,40,24
1650761934896,COGS 13,A01,083071,Staff,0,38,40,40
1650761940923,COGS 14A,A01,092681,Staff,0,36,100,100
1650761946946,COGS 14B,A01,083073,Cheng; Tzu-Han,1,13,50,49
1650761952970,COGS 17,A01,092677,Staff,11,0,75,64
1650761958994,COGS 100,A01,083619,Staff,0,29,60,60
1650761965022,COGS 101A,A01,083621,Davis; Joshua Daniel,0,28,60,60
1650761971046,COGS 101B,A01,091572,Staff,1,4,60,59
1650761977077,COGS 101C,A01,083625,Delgado; Tania,14,0,30,16
1650761983102,COGS 107A,A01,083627,Boyle; Mary E. T.,0,16,60,60
1650761989129,COGS 118A,A01,083075,Staff,0,8,60,60
1650761995151,CSE 3,A50,083646,Miranda; Gregory Joseph,18,0,38,20
1650761995151,CSE 3,A51,083647,Miranda; Gregory Joseph,36,0,37,1
1650762001174,CSE 8A,A50,083650,Miranda; Gregory Joseph,0,30,40,40
1650762007201,CSE 11,A01,083080,Cao; Yingjun,0,96,40,40
1650762013234,CSE 12,A01,083652,Staff,0,21,100,100
1650762019258,CSE 15L,A01,083654,Staff,0,3,50,50
1650762019258,CSE 15L,A02,083655,Staff,0,2,50,50
1650762025282,CSE 20,A01,083657,Staff,49,0,80,31
1650762031315,CSE 30,A01,083084,Eldon; John,0,76,40,40
1650762037429,CSE 100,A01,083659,Cao; Yingjun,0,71,50,50
1650762043456,CSE 134B,A01,083661,Powell; Thomas Allan,0,38,65,65
1650762049479,CSE 140,A01,083663,Staff,0,11,75,75
1650762055502,CSE 140L,A01,083088,Eldon; John,0,20,75,75
1650762061528,CSE 175,A01,083665,Kumar; Rakesh,7,0,25,18
1650762067552,CSE 190,A00,092507,Dubnov; Shlomo,10,0,20,10
1650762073580,ECE 45,A01,083139,Staff,1,2,60,59
1650762079603,ECE 65,A50,083695,Staff,0,5,30,30
1650762085627,ECE 109,A01,091882,Touri; Behrouz,33,0,70,37
1650762091652,ECE 180,A00,083140,Abi Samra; Nicholas Camill,20,0,30,10
1650762091652,ECE 180,B00,083141,Abi Samra; Nicholas Camill,0,0,30,30
1650762097675,MATH 10A,A01,083735,Patchell; Gregory David,2,0,30,28
1650762097675,MATH 10A,A02,083736,Patchell; Gregory David,27,0,30,3
1650762097675,MATH 10A,A03,083737,Patchell; Gregory David,24,0,30,6
1650762103700,MATH 10B,A01,083207,Staff,0,9,30,30
1650762103700,MATH 10B,A02,083208,Staff,1,7,30,29
1650762103700,MATH 10B,B01,083739,Staff,11,0,30,19
1650762103700,MATH 10B,B02,083740,Staff,28,0,30,2
1650762109725,MATH 18,A01,083743,Staff,0,0,30,30
1650762109725,MATH 18,A02,083744,Staff,23,0,30,7
1650762109725,MATH 18,A03,083745,Staff,21,0,30,9
1650762109725,MATH 18,A04,083746,Staff,26,0,30,4
1650762109725,MATH 18,B01,083748,Staff,0,15,30,30
1650762109725,MATH 18,B02,083749,Staff,0,12,30,30
1650762109725,MATH 18,B03,083750,Staff,0,12,30,30
1650762109725,MATH 18,B04,083751,Staff,0,12,30,30
1650762115752,MATH 20A,A01,083754,Staff,19,0,40,21
1650762121779,MATH 20B,A01,083756,Staff,0,13,30,30
1650762121779,MATH 20B,A02,083757,Staff,0,12,30,30
1650762127809,MATH 20C,A01,083760,Staff,0,16,30,30
1650762127809,MATH 20C,A02,083761,Staff,0,16,30,30
1650762127809,MATH 20C,B01,083762,Staff,9,0,30,21
1650762127809,MATH 20C,B02,083763,Staff,28,0,30,2
1650762133833,MATH 20D,A01,083765,Staff,2,1,30,28
1650762133833,MATH 20D,A02,083766,Staff,5,0,30,25
1650762133833,MATH 20D,A03,083767,Staff,24,0,30,6
1650762139862,MATH 20E,A01,083771,Staff,3,0,30,27
1650762139862,MATH 20E,A02,083772,Staff,16,0,30,14
1650762139862,MATH 20E,B01,083773,Staff,0,0,30,30
1650762139862,MATH 20E,B02,083774,Staff,5,0,30,25
1650762145901,MATH 103A,A01,083777,Staff,0,16,30,30
1650762145901,MATH 103A,A02,083778,Staff,0,15,30,30
1650762145901,MATH 103A,B01,083779,Staff,0,15,30,30
1650762145901,MATH 103A,B02,083780,Staff,0,15,30,30
1650762151924,MATH 105,A01,085443,Staff,0,22,30,30
1650762157949,MATH 109,A01,083213,Anzaldo; Leesa B,0,7,30,30
1650762157949,MATH 109,A02,083214,Anzaldo; Leesa B,0,7,30,30
1650762157949,MATH 109,B01,083215,Anzaldo; Leesa B,0,8,30,30
1650762157949,MATH 109,B02,083216,Anzaldo; Leesa B,0,6,30,30
1650762163971,MATH 142A,A01,083219,Chow; Bennett,0,16,30,30
1650762163971,MATH 142A,A02,083220,Chow; Bennett,0,15,30,30
1650762163971,MATH 142A,B01,083221,Chow; Bennett,0,15,30,30
1650762163971,MATH 142A,B02,083222,Chow; Bennett,0,14,30,30
1650762169997,MATH 193A,A01,083224,Staff,0,5,30,30
1650762169997,MATH 193A,A02,083225,Staff,0,6,30,30
1650762169997,MATH 193A,A03,083781,Staff,0,6,30,30
1650762169997,MATH 193A,A04,083782,Staff,0,7,30,30
1650762176019,MATH 197,001,091859,McAuley; Julian John,9998,0,9999,1
1650762182074,COGS 9,A01,083615,Staff,1,17,60,59
1650762188098,COGS 11,A01,083617,Boyle; Mary E. T.,16,0,40,24
1650762194121,COGS 13,A01,083071,Staff,0,38,40,40
1650762200144,COGS 14A,A01,092681,Staff,0,36,100,100
1650762206171,COGS 14B,A01,083073,Cheng; Tzu-Han,1,13,50,49
1650762212197,COGS 17,A01,092677,Staff,11,0,75,64
1650762218223,COGS 100,A01,083619,Staff,0,29,60,60
1650762224251,COGS 101A,A01,083621,Davis; Joshua Daniel,0,28,60,60
1650762230282,COGS 101B,A01,091572,Staff,1,4,60,59
1650762236310,COGS 101C,A01,083625,Delgado; Tania,14,0,30,16
1650762242333,COGS 107A,A01,083627,Boyle; Mary E. T.,0,16,60,60
1650762248357,COGS 118A,A01,083075,Staff,0,8,60,60
1650762254382,CSE 3,A50,083646,Miranda; Gregory Joseph,18,0,38,20
1650762254382,CSE 3,A51,083647,Miranda; Gregory Joseph,36,0,37,1
1650762260406,CSE 8A,A50,083650,Miranda; Gregory Joseph,0,30,40,40
1650762266433,CSE 11,A01,083080,Cao; Yingjun,0,96,40,40
1650762272457,CSE 12,A01,083652,Staff,0,21,100,100
1650762278487,CSE 15L,A01,083654,Staff,0,3,50,50
1650762278487,CSE 15L,A02,083655,Staff,0,2,50,50
1650762284514,CSE 20,A01,083657,Staff,49,0,80,31
1650762290537,CSE 30,A01,083084,Eldon; John,0,76,40,40
1650762296565,CSE 100,A01,083659,Cao; Yingjun,0,71,50,50
1650762302592,CSE 134B,A01,083661,Powell; Thomas Allan,0,38,65,65
1650762308615,CSE 140,A01,083663,Staff,0,11,75,75
1650762314650,CSE 140L,A01,083088,Eldon; John,0,20,75,75
1650762320676,CSE 175,A01,083665,Kumar; Rakesh,7,0,25,18
1650762326703,CSE 190,A00,092507,Dubnov; Shlomo,10,0,20,10
1650762332727,ECE 45,A01,083139,Staff,1,2,60,59
1650762338755,ECE 65,A50,083695,Staff,0,5,30,30
1650762344780,ECE 109,A01,091882,Touri; Behrouz,33,0,70,37
1650762350807,ECE 180,A00,083140,Abi Samra; Nicholas Camill,20,0,30,10
1650762350807,ECE 180,B00,083141,Abi Samra; Nicholas Camill,0,0,30,30
1650762356834,MATH 10A,A01,083735,Patchell; Gregory David,2,0,30,28
1650762356834,MATH 10A,A02,083736,Patchell; Gregory David,27,0,30,3
1650762356834,MATH 10A,A03,083737,Patchell; Gregory David,24,0,30,6
1650762362862,MATH 10B,A01,083207,Staff,0,9,30,30
1650762362862,MATH 10B,A02,083208,Staff,1,7,30,29
1650762362862,MATH 10B,B01,083739,Staff,11,0,30,19
1650762362862,MATH 10B,B02,083740,Staff,28,0,30,2
1650762368889,MATH 18,A01,083743,Staff,0,0,30,30
1650762368889,MATH 18,A02,083744,Staff,23,0,30,7
1650762368889,MATH 18,A03,083745,Staff,21,0,30,9
1650762368889,MATH 18,A04,083746,Staff,26,0,30,4
1650762368889,MATH 18,B01,083748,Staff,0,15,30,30
1650762368889,MATH 18,B02,083749,Staff,0,12,30,30
1650762368889,MATH 18,B03,083750,Staff,0,12,30,30
1650762368889,MATH 18,B04,083751,Staff,0,12,30,30
1650762374913,MATH 20A,A01,083754,Staff,19,0,40,21
1650762380937,MATH 20B,A01,083756,Staff,0,13,30,30
1650762380937,MATH 20B,A02,083757,Staff,0,12,30,30
1650762386961,MATH 20C,A01,083760,Staff,0,16,30,30
1650762386961,MATH 20C,A02,083761,Staff,0,16,30,30
1650762386961,MATH 20C,B01,083762,Staff,9,0,30,21
1650762386961,MATH 20C,B02,083763,Staff,28,0,30,2
1650762392985,MATH 20D,A01,083765,Staff,2,1,30,28
1650762392985,MATH 20D,A02,083766,Staff,5,0,30,25
1650762392985,MATH 20D,A03,083767,Staff,24,0,30,6
1650762399013,MATH 20E,A01,083771,Staff,3,0,30,27
1650762399013,MATH 20E,A02,083772,Staff,16,0,30,14
1650762399013,MATH 20E,B01,083773,Staff,0,0,30,30
1650762399013,MATH 20E,B02,083774,Staff,5,0,30,25
1650762405038,MATH 103A,A01,083777,Staff,0,16,30,30
1650762405038,MATH 103A,A02,083778,Staff,0,15,30,30
1650762405038,MATH 103A,B01,083779,Staff,0,15,30,30
1650762405038,MATH 103A,B02,083780,Staff,0,15,30,30
1650762411061,MATH 105,A01,085443,Staff,0,22,30,30
1650762417088,MATH 109,A01,083213,Anzaldo; Leesa B,0,7,30,30
1650762417088,MATH 109,A02,083214,Anzaldo; Leesa B,0,7,30,30
1650762417088,MATH 109,B01,083215,Anzaldo; Leesa B,0,8,30,30
1650762417088,MATH 109,B02,083216,Anzaldo; Leesa B,0,6,30,30
1650762423114,MATH 142A,A01,083219,Chow; Bennett,0,16,30,30
1650762423114,MATH 142A,A02,083220,Chow; Bennett,0,15,30,30
1650762423114,MATH 142A,B01,083221,Chow; Bennett,0,15,30,30
1650762423114,MATH 142A,B02,083222,Chow; Bennett,0,14,30,30
1650762429139,MATH 193A,A01,083224,Staff,0,5,30,30
1650762429139,MATH 193A,A02,083225,Staff,0,6,30,30
1650762429139,MATH 193A,A03,083781,Staff,0,6,30,30
1650762429139,MATH 193A,A04,083782,Staff,0,7,30,30
1650762435166,MATH 197,001,091859,McAuley; Julian John,9998,0,9999,1
1650762441228,COGS 9,A01,083615,Staff,1,17,60,59
1650762447253,COGS 11,A01,083617,Boyle; Mary E. T.,16,0,40,24
1650762453276,COGS 13,A01,083071,Staff,0,38,40,40
1650762459299,COGS 14A,A01,092681,Staff,0,36,100,100
1650762465331,COGS 14B,A01,083073,Cheng; Tzu-Han,1,13,50,49
1650762471356,COGS 17,A01,092677,Staff,11,0,75,64
1650762477378,COGS 100,A01,083619,Staff,0,29,60,60
1650762483407,COGS 101A,A01,083621,Davis; Joshua Daniel,0,28,60,60
1650762489436,COGS 101B,A01,091572,Staff,1,4,60,59
1650762495457,COGS 101C,A01,083625,Delgado; Tania,14,0,30,16
1650762501485,COGS 107A,A01,083627,Boyle; Mary E. T.,0,16,60,60
1650762507510,COGS 118A,A01,083075,Staff,0,8,60,60
1650762513538,CSE 3,A50,083646,Miranda; Gregory Joseph,18,0,38,20
1650762513538,CSE 3,A51,083647,Miranda; Gregory Joseph,36,0,37,1
1650762519561,CSE 8A,A50,083650,Miranda; Gregory Joseph,0,30,40,40
1650762525584,CSE 11,A01,083080,Cao; Yingjun,0,96,40,40
1650762531606,CSE 12,A01,083652,Staff,0,21,100,100
1650762537632,CSE 15L,A01,083654,Staff,0,3,50,50
1650762537632,CSE 15L,A02,083655,Staff,0,2,50,50
1650762543656,CSE 20,A01,083657,Staff,49,0,80,31
1650762549680,CSE 30,A01,083084,Eldon; John,0,76,40,40
1650762555711,CSE 100,A01,083659,Cao; Yingjun,0,71,50,50
1650762561734,CSE 134B,A01,083661,Powell; Thomas Allan,0,38,65,65
1650762567758,CSE 140,A01,083663,Staff,0,11,75,75
1650762573782,CSE 140L,A01,083088,Eldon; John,0,20,75,75
1650762579808,CSE 175,A01,083665,Kumar; Rakesh,7,0,25,18
1650762585842,CSE 190,A00,092507,Dubnov; Shlomo,10,0,20,10
1650762591866,ECE 45,A01,083139,Staff,1,2,60,59
1650762597890,ECE 65,A50,083695,Staff,0,5,30,30
1650762603921,ECE 109,A01,091882,Touri; Behrouz,32,0,70,38
1650762609945,ECE 180,A00,083140,Abi Samra; Nicholas Camill,20,0,30,10
1650762609945,ECE 180,B00,083141,Abi Samra; Nicholas Camill,0,0,30,30
1650762615974,MATH 10A,A01,083735,Patchell; Gregory David,2,0,30,28
1650762615974,MATH 10A,A02,083736,Patchell; Gregory David,27,0,30,3
1650762615974,MATH 10A,A03,083737,Patchell; Gregory David,24,0,30,6
1650762621999,MATH 10B,A01,083207,Staff,0,9,30,30
1650762621999,MATH 10B,A02,083208,Staff,1,7,30,29
1650762621999,MATH 10B,B01,083739,Staff,11,0,30,19
1650762621999,MATH 10B,B02,083740,Staff,28,0,30,2
1650762628030,MATH 18,A01,083743,Staff,0,0,30,30
1650762628030,MATH 18,A02,083744,Staff,23,0,30,7
1650762628030,MATH 18,A03,083745,Staff,21,0,30,9
1650762628030,MATH 18,A04,083746,Staff,26,0,30,4
1650762628030,MATH 18,B01,083748,Staff,0,15,30,30
1650762628030,MATH 18,B02,083749,Staff,0,12,30,30
1650762628030,MATH 18,B03,083750,Staff,0,12,30,30
1650762628030,MATH 18,B04,083751,Staff,0,12,30,30
1650762634145,MATH 20A,A01,083754,Staff,19,0,40,21
1650762640169,MATH 20B,A01,083756,Staff,0,13,30,30
1650762640169,MATH 20B,A02,083757,Staff,0,12,30,30
1650762646196,MATH 20C,A01,083760,Staff,0,16,30,30
1650762646196,MATH 20C,A02,083761,Staff,0,16,30,30
1650762646196,MATH 20C,B01,083762,Staff,9,0,30,21
1650762646196,MATH 20C,B02,083763,Staff,28,0,30,2
1650762652221,MATH 20D,A01,083765,Staff,2,1,30,28
1650762652221,MATH 20D,A02,083766,Staff,5,0,30,25
1650762652221,MATH 20D,A03,083767,Staff,24,0,30,6
1650762658249,MATH 20E,A01,083771,Staff,3,0,30,27
1650762658249,MATH 20E,A02,083772,Staff,16,0,30,14
1650762658249,MATH 20E,B01,083773,Staff,0,0,30,30
1650762658249,MATH 20E,B02,083774,Staff,5,0,30,25
1650762664278,MATH 103A,A01,083777,Staff,0,16,30,30
1650762664278,MATH 103A,A02,083778,Staff,0,15,30,30
1650762664278,MATH 103A,B01,083779,Staff,0,15,30,30
1650762664278,MATH 103A,B02,083780,Staff,0,15,30,30
1650762670301,MATH 105,A01,085443,Staff,0,22,30,30
1650762676324,MATH 109,A01,083213,Anzaldo; Leesa B,0,7,30,30
1650762676324,MATH 109,A02,083214,Anzaldo; Leesa B,0,7,30,30
1650762676324,MATH 109,B01,083215,Anzaldo; Leesa B,0,8,30,30
1650762676324,MATH 109,B02,083216,Anzaldo; Leesa B,0,6,30,30
1650762682349,MATH 142A,A01,083219,Chow; Bennett,0,16,30,30
1650762682349,MATH 142A,A02,083220,Chow; Bennett,0,15,30,30
1650762682349,MATH 142A,B01,083221,Chow; Bennett,0,15,30,30
1650762682349,MATH 142A,B02,083222,Chow; Bennett,0,14,30,30
1650762688373,MATH 193A,A01,083224,Staff,0,5,30,30
1650762688373,MATH 193A,A02,083225,Staff,0,6,30,30
1650762688373,MATH 193A,A03,083781,Staff,0,6,30,30
1650762688373,MATH 193A,A04,083782,Staff,0,7,30,30
1650762694396,MATH 197,001,091859,McAuley; Julian John,9998,0,9999,1
1650762700447,COGS 9,A01,083615,Staff,1,17,60,59
1650762706476,COGS 11,A01,083617,Boyle; Mary E. T.,16,0,40,24
1650762712499,COGS 13,A01,083071,Staff,0,38,40,40
1650762718524,COGS 14A,A01,092681,Staff,0,36,100,100
1650762724548,COGS 14B,A01,083073,Cheng; Tzu-Han,1,13,50,49
1650762730570,COGS 17,A01,092677,Staff,11,0,75,64
1650762736593,COGS 100,A01,083619,Staff,0,29,60,60
1650762742630,COGS 101A,A01,083621,Davis; Joshua Daniel,0,28,60,60
1650762748654,COGS 101B,A01,091572,Staff,1,4,60,59
1650762754676,COGS 101C,A01,083625,Delgado; Tania,14,0,30,16
1650762760700,COGS 107A,A01,083627,Boyle; Mary E. T.,0,16,60,60
1650762766726,COGS 118A,A01,083075,Staff,0,8,60,60
1650762772754,CSE 3,A50,083646,Miranda; Gregory Joseph,18,0,38,20
1650762772754,CSE 3,A51,083647,Miranda; Gregory Joseph,36,0,37,1
1650762778782,CSE 8A,A50,083650,Miranda; Gregory Joseph,0,30,40,40
1650762784811,CSE 11,A01,083080,Cao; Yingjun,0,96,40,40
1650762790835,CSE 12,A01,083652,Staff,0,21,100,100
1650762796856,CSE 15L,A01,083654,Staff,0,3,50,50
1650762796856,CSE 15L,A02,083655,Staff,0,2,50,50
1650762802886,CSE 20,A01,083657,Staff,49,0,80,31
1650762808912,CSE 30,A01,083084,Eldon; John,0,76,40,40
1650762814935,CSE 100,A01,083659,Cao; Yingjun,0,71,50,50
1650762820970,CSE 134B,A01,083661,Powell; Thomas Allan,0,38,65,65
1650762826994,CSE 140,A01,083663,Staff,0,11,75,75
1650762833018,CSE 140L,A01,083088,Eldon; John,0,20,75,75
1650762839042,CSE 175,A01,083665,Kumar; Rakesh,7,0,25,18
1650762845067,CSE 190,A00,092507,Dubnov; Shlomo,10,0,20,10
1650762851095,ECE 45,A01,083139,Staff,1,2,60,59
1650762857119,ECE 65,A50,083695,Staff,0,5,30,30
1650762863145,ECE 109,A01,091882,Touri; Behrouz,32,0,70,38
1650762869168,ECE 180,A00,083140,Abi Samra; Nicholas Camill,20,0,30,10
1650762869168,ECE 180,B00,083141,Abi Samra; Nicholas Camill,0,0,30,30
1650762875191,MATH 10A,A01,083735,Patchell; Gregory David,2,0,30,28
1650762875191,MATH 10A,A02,083736,Patchell; Gregory David,27,0,30,3
1650762875191,MATH 10A,A03,083737,Patchell; Gregory David,24,0,30,6
1650762881219,MATH 10B,A01,083207,Staff,0,9,30,30
1650762881219,MATH 10B,A02,083208,Staff,1,7,30,29
1650762881219,MATH 10B,B01,083739,Staff,11,0,30,19
1650762881219,MATH 10B,B02,083740,Staff,28,0,30,2
1650762887246,MATH 18,A01,083743,Staff,0,0,30,30
1650762887246,MATH 18,A02,083744,Staff,23,0,30,7
1650762887246,MATH 18,A03,083745,Staff,21,0,30,9
1650762887246,MATH 18,A04,083746,Staff,26,0,30,4
1650762887246,MATH 18,B01,083748,Staff,0,15,30,30
1650762887246,MATH 18,B02,083749,Staff,0,12,30,30
1650762887246,MATH 18,B03,083750,Staff,0,12,30,30
1650762887246,MATH 18,B04,083751,Staff,0,12,30,30
1650762893270,MATH 20A,A01,083754,Staff,19,0,40,21
1650762899294,MATH 20B,A01,083756,Staff,0,13,30,30
1650762899294,MATH 20B,A02,083757,Staff,0,12,30,30
1650762905315,MATH 20C,A01,083760,Staff,0,16,30,30
1650762905315,MATH 20C,A02,083761,Staff,0,16,30,30
1650762905315,MATH 20C,B01,083762,Staff,9,0,30,21
1650762905315,MATH 20C,B02,083763,Staff,28,0,30,2
1650762911338,MATH 20D,A01,083765,Staff,2,1,30,28
1650762911338,MATH 20D,A02,083766,Staff,5,0,30,25
1650762911338,MATH 20D,A03,083767,Staff,24,0,30,6
1650762917362,MATH 20E,A01,083771,Staff,3,0,30,27
1650762917362,MATH 20E,A02,083772,Staff,16,0,30,14
1650762917362,MATH 20E,B01,083773,Staff,0,0,30,30
1650762917362,MATH 20E,B02,083774,Staff,5,0,30,25
1650762923387,MATH 103A,A01,083777,Staff,0,16,30,30
1650762923387,MATH 103A,A02,083778,Staff,0,15,30,30
1650762923387,MATH 103A,B01,083779,Staff,0,15,30,30
1650762923387,MATH 103A,B02,083780,Staff,0,15,30,30
1650762929411,MATH 105,A01,085443,Staff,0,22,30,30
1650762935436,MATH 109,A01,083213,Anzaldo; Leesa B,0,7,30,30
1650762935436,MATH 109,A02,083214,Anzaldo; Leesa B,0,7,30,30
1650762935436,MATH 109,B01,083215,Anzaldo; Leesa B,0,8,30,30
1650762935436,MATH 109,B02,083216,Anzaldo; Leesa B,0,6,30,30
1650762941460,MATH 142A,A01,083219,Chow; Bennett,0,16,30,30
1650762941460,MATH 142A,A02,083220,Chow; Bennett,0,15,30,30
1650762941460,MATH 142A,B01,083221,Chow; Bennett,0,15,30,30
1650762941460,MATH 142A,B02,083222,Chow; Bennett,0,14,30,30
1650762947488,MATH 193A,A01,083224,Staff,0,5,30,30
1650762947488,MATH 193A,A02,083225,Staff,0,6,30,30
1650762947488,MATH 193A,A03,083781,Staff,0,6,30,30
1650762947488,MATH 193A,A04,083782,Staff,0,7,30,30
1650762953519,MATH 197,001,091859,McAuley; Julian John,9998,0,9999,1
1650762959579,COGS 9,A01,083615,Staff,1,17,60,59
1650762965601,COGS 11,A01,083617,Boyle; Mary E. T.,16,0,40,24
1650762971635,COGS 13,A01,083071,Staff,0,38,40,40
1650762977658,COGS 14A,A01,092681,Staff,0,36,100,100
1650762983685,COGS 14B,A01,083073,Cheng; Tzu-Han,1,13,50,49
1650762989712,COGS 17,A01,092677,Staff,11,0,75,64
1650762995738,COGS 100,A01,083619,Staff,0,29,60,60
1650763001761,COGS 101A,A01,083621,Davis; Joshua Daniel,0,28,60,60
1650763007791,COGS 101B,A01,091572,Staff,1,4,60,59
1650763013818,COGS 101C,A01,083625,Delgado; Tania,14,0,30,16
1650763019841,COGS 107A,A01,083627,Boyle; Mary E. T.,0,16,60,60
1650763025865,COGS 118A,A01,083075,Staff,0,8,60,60
1650763031890,CSE 3,A50,083646,Miranda; Gregory Joseph,18,0,38,20
1650763031890,CSE 3,A51,083647,Miranda; Gregory Joseph,36,0,37,1
1650763037914,CSE 8A,A50,083650,Miranda; Gregory Joseph,0,30,40,40
1650763043940,CSE 11,A01,083080,Cao; Yingjun,0,96,40,40
1650763049966,CSE 12,A01,083652,Staff,0,21,100,100
1650763055990,CSE 15L,A01,083654,Staff,0,3,50,50
1650763055990,CSE 15L,A02,083655,Staff,0,2,50,50
1650763062015,CSE 20,A01,083657,Staff,49,0,80,31
1650763068043,CSE 30,A01,083084,Eldon; John,0,76,40,40
1650763074066,CSE 100,A01,083659,Cao; Yingjun,0,71,50,50
1650763080099,CSE 134B,A01,083661,Powell; Thomas Allan,0,38,65,65
1650763086124,CSE 140,A01,083663,Staff,0,11,75,75
1650763092147,CSE 140L,A01,083088,Eldon; John,0,20,75,75
1650763098172,CSE 175,A01,083665,Kumar; Rakesh,7,0,25,18
1650763104205,CSE 190,A00,092507,Dubnov; Shlomo,10,0,20,10
1650763110231,ECE 45,A01,083139,Staff,1,2,60,59
1650763116256,ECE 65,A50,083695,Staff,0,5,30,30
1650763122281,ECE 109,A01,091882,Touri; Behrouz,32,0,70,38
1650763128304,ECE 180,A00,083140,Abi Samra; Nicholas Camill,20,0,30,10
1650763128304,ECE 180,B00,083141,Abi Samra; Nicholas Camill,0,0,30,30
1650763134327,MATH 10A,A01,083735,Patchell; Gregory David,2,0,30,28
1650763134327,MATH 10A,A02,083736,Patchell; Gregory David,27,0,30,3
1650763134327,MATH 10A,A03,083737,Patchell; Gregory David,24,0,30,6
1650763140355,MATH 10B,A01,083207,Staff,0,9,30,30
1650763140355,MATH 10B,A02,083208,Staff,1,7,30,29
1650763140355,MATH 10B,B01,083739,Staff,11,0,30,19
1650763140355,MATH 10B,B02,083740,Staff,28,0,30,2
1650763146381,MATH 18,A01,083743,Staff,0,0,30,30
1650763146381,MATH 18,A02,083744,Staff,23,0,30,7
1650763146381,MATH 18,A03,083745,Staff,21,0,30,9
1650763146381,MATH 18,A04,083746,Staff,26,0,30,4
1650763146381,MATH 18,B01,083748,Staff,0,15,30,30
1650763146381,MATH 18,B02,083749,Staff,0,12,30,30
1650763146381,MATH 18,B03,083750,Staff,0,12,30,30
1650763146381,MATH 18,B04,083751,Staff,0,12,30,30
1650763152404,MATH 20A,A01,083754,Staff,19,0,40,21
1650763158435,MATH 20B,A01,083756,Staff,0,13,30,30
1650763158435,MATH 20B,A02,083757,Staff,0,12,30,30
1650763164459,MATH 20C,A01,083760,Staff,0,16,30,30
1650763164459,MATH 20C,A02,083761,Staff,0,16,30,30
1650763164459,MATH 20C,B01,083762,Staff,9,0,30,21
1650763164459,MATH 20C,B02,083763,Staff,28,0,30,2
1650763170486,MATH 20D,A01,083765,Staff,2,1,30,28
1650763170486,MATH 20D,A02,083766,Staff,5,0,30,25
1650763170486,MATH 20D,A03,083767,Staff,24,0,30,6
1650763176515,MATH 20E,A01,083771,Staff,3,0,30,27
1650763176515,MATH 20E,A02,083772,Staff,16,0,30,14
1650763176515,MATH 20E,B01,083773,Staff,0,0,30,30
1650763176515,MATH 20E,B02,083774,Staff,5,0,30,25
1650763182546,MATH 103A,A01,083777,Staff,0,16,30,30
1650763182546,MATH 103A,A02,083778,Staff,0,15,30,30
1650763182546,MATH 103A,B01,083779,Staff,0,15,30,30
1650763182546,MATH 103A,B02,083780,Staff,0,15,30,30
1650763188584,MATH 105,A01,085443,Staff,0,22,30,30
1650763194615,MATH 109,A01,083213,Anzaldo; Leesa B,0,7,30,30
1650763194615,MATH 109,A02,083214,Anzaldo; Leesa B,0,7,30,30
1650763194615,MATH 109,B01,083215,Anzaldo; Leesa B,0,8,30,30
1650763194615,MATH 109,B02,083216,Anzaldo; Leesa B,0,6,30,30
1650763200639,MATH 142A,A01,083219,Chow; Bennett,0,16,30,30
1650763200639,MATH 142A,A02,083220,Chow; Bennett,0,15,30,30
1650763200639,MATH 142A,B01,083221,Chow; Bennett,0,15,30,30
1650763200639,MATH 142A,B02,083222,Chow; Bennett,0,14,30,30
1650763206664,MATH 193A,A01,083224,Staff,0,5,30,30
1650763206664,MATH 193A,A02,083225,Staff,0,6,30,30
1650763206664,MATH 193A,A03,083781,Staff,0,6,30,30
1650763206664,MATH 193A,A04,083782,Staff,0,7,30,30
1650763212689,MATH 197,001,091859,McAuley; Julian John,9998,0,9999,1
1650763218741,COGS 9,A01,083615,Staff,1,17,60,59
1650763224872,COGS 11,A01,083617,Boyle; Mary E. T.,16,0,40,24
1650763230899,COGS 13,A01,083071,Staff,0,38,40,40
1650763236931,COGS 14A,A01,092681,Staff,0,36,100,100
1650763242954,COGS 14B,A01,083073,Cheng; Tzu-Han,1,13,50,49
1650763248978,COGS 17,A01,092677,Staff,11,0,75,64
1650763255020,COGS 100,A01,083619,Staff,0,29,60,60
1650763261045,COGS 101A,A01,083621,Davis; Joshua Daniel,0,28,60,60
1650763267069,COGS 101B,A01,091572,Staff,1,4,60,59
1650763273096,COGS 101C,A01,083625,Delgado; Tania,14,0,30,16
1650763279120,COGS 107A,A01,083627,Boyle; Mary E. T.,0,16,60,60
1650763285143,COGS 118A,A01,083075,Staff,0,8,60,60
1650763291168,CSE 3,A50,083646,Miranda; Gregory Joseph,18,0,38,20
1650763291168,CSE 3,A51,083647,Miranda; Gregory Joseph,36,0,37,1
1650763297193,CSE 8A,A50,083650,Miranda; Gregory Joseph,0,30,40,40
1650763303217,CSE 11,A01,083080,Cao; Yingjun,0,96,40,40
1650763309241,CSE 12,A01,083652,Staff,0,21,100,100
1650763315265,CSE 15L,A01,083654,Staff,0,3,50,50
1650763315265,CSE 15L,A02,083655,Staff,0,2,50,50
1650763321290,CSE 20,A01,083657,Staff,49,0,80,31
1650763327313,CSE 30,A01,083084,Eldon; John,0,76,40,40
1650763333342,CSE 100,A01,083659,Cao; Yingjun,0,71,50,50
1650763339365,CSE 134B,A01,083661,Powell; Thomas Allan,0,38,65,65
1650763345392,CSE 140,A01,083663,Staff,0,11,75,75
1650763351416,CSE 140L,A01,083088,Eldon; John,0,20,75,75
1650763357450,CSE 175,A01,083665,Kumar; Rakesh,7,0,25,18
1650763363472,CSE 190,A00,092507,Dubnov; Shlomo,10,0,20,10
1650763369496,ECE 45,A01,083139,Staff,1,2,60,59
1650763375523,ECE 65,A50,083695,Staff,0,5,30,30
1650763381549,ECE 109,A01,091882,Touri; Behrouz,32,0,70,38
1650763387587,ECE 180,A00,083140,Abi Samra; Nicholas Camill,20,0,30,10
1650763387587,ECE 180,B00,083141,Abi Samra; Nicholas Camill,0,0,30,30
1650763393615,MATH 10A,A01,083735,Patchell; Gregory David,2,0,30,28
1650763393615,MATH 10A,A02,083736,Patchell; Gregory David,27,0,30,3
1650763393615,MATH 10A,A03,083737,Patchell; Gregory David,24,0,30,6
1650763399642,MATH 10B,A01,083207,Staff,0,9,30,30
1650763399642,MATH 10B,A02,083208,Staff,1,7,30,29
1650763399642,MATH 10B,B01,083739,Staff,11,0,30,19
1650763399642,MATH 10B,B02,083740,Staff,28,0,30,2
1650763405678,MATH 18,A01,083743,Staff,0,0,30,30
1650763405678,MATH 18,A02,083744,Staff,23,0,30,7
1650763405678,MATH 18,A03,083745,Staff,21,0,30,9
1650763405678,MATH 18,A04,083746,Staff,26,0,30,4
1650763405678,MATH 18,B01,083748,Staff,0,15,30,30
1650763405678,MATH 18,B02,083749,Staff,0,12,30,30
1650763405678,MATH 18,B03,083750,Staff,0,12,30,30
1650763405678,MATH 18,B04,083751,Staff,0,12,30,30
1650763411704,MATH 20A,A01,083754,Staff,19,0,40,21
1650763417731,MATH 20B,A01,083756,Staff,0,13,30,30
1650763417731,MATH 20B,A02,083757,Staff,0,12,30,30
1650763423758,MATH 20C,A01,083760,Staff,0,16,30,30
1650763423758,MATH 20C,A02,083761,Staff,0,16,30,30
1650763423758,MATH 20C,B01,083762,Staff,9,0,30,21
1650763423758,MATH 20C,B02,083763,Staff,28,0,30,2
1650763429782,MATH 20D,A01,083765,Staff,2,1,30,28
1650763429782,MATH 20D,A02,083766,Staff,5,0,30,25
1650763429782,MATH 20D,A03,083767,Staff,24,0,30,6
1650763435809,MATH 20E,A01,083771,Staff,3,0,30,27
1650763435809,MATH 20E,A02,083772,Staff,16,0,30,14
1650763435809,MATH 20E,B01,083773,Staff,0,0,30,30
1650763435809,MATH 20E,B02,083774,Staff,5,0,30,25
1650763441849,MATH 103A,A01,083777,Staff,0,16,30,30
1650763441849,MATH 103A,A02,083778,Staff,0,15,30,30
1650763441849,MATH 103A,B01,083779,Staff,0,15,30,30
1650763441849,MATH 103A,B02,083780,Staff,0,15,30,30
1650763447876,MATH 105,A01,085443,Staff,0,22,30,30
1650763453901,MATH 109,A01,083213,Anzaldo; Leesa B,0,7,30,30
1650763453901,MATH 109,A02,083214,Anzaldo; Leesa B,0,7,30,30
1650763453901,MATH 109,B01,083215,Anzaldo; Leesa B,0,8,30,30
1650763453901,MATH 109,B02,083216,Anzaldo; Leesa B,0,6,30,30
1650763459923,MATH 142A,A01,083219,Chow; Bennett,0,16,30,30
1650763459923,MATH 142A,A02,083220,Chow; Bennett,0,15,30,30
1650763459923,MATH 142A,B01,083221,Chow; Bennett,0,15,30,30
1650763459923,MATH 142A,B02,083222,Chow; Bennett,0,14,30,30
1650763465948,MATH 193A,A01,083224,Staff,0,5,30,30
1650763465948,MATH 193A,A02,083225,Staff,0,6,30,30
1650763465948,MATH 193A,A03,083781,Staff,0,6,30,30
1650763465948,MATH 193A,A04,083782,Staff,0,7,30,30
1650763471974,MATH 197,001,091859,McAuley; Julian John,9998,0,9999,1
1650763478028,COGS 9,A01,083615,Staff,1,17,60,59
1650763484054,COGS 11,A01,083617,Boyle; Mary E. T.,16,0,40,24
1650763490078,COGS 13,A01,083071,Staff,0,38,40,40
1650763496106,COGS 14A,A01,092681,Staff,0,36,100,100
1650763502131,COGS 14B,A01,083073,Cheng; Tzu-Han,1,13,50,49
1650763508159,COGS 17,A01,092677,Staff,11,0,75,64
1650763514187,COGS 100,A01,083619,Staff,0,29,60,60
1650763520215,COGS 101A,A01,083621,Davis; Joshua Daniel,0,28,60,60
1650763526255,COGS 101B,A01,091572,Staff,1,4,60,59
1650763532282,COGS 101C,A01,083625,Delgado; Tania,14,0,30,16
1650763538307,COGS 107A,A01,083627,Boyle; Mary E. T.,0,16,60,60
1650763544331,COGS 118A,A01,083075,Staff,0,8,60,60
1650763550360,CSE 3,A50,083646,Miranda; Gregory Joseph,18,0,38,20
1650763550360,CSE 3,A51,083647,Miranda; Gregory Joseph,36,0,37,1
1650763556384,CSE 8A,A50,083650,Miranda; Gregory Joseph,0,30,40,40
1650763562408,CSE 11,A01,083080,Cao; Yingjun,0,96,40,40
1650763568436,CSE 12,A01,083652,Staff,0,21,100,100
1650763574460,CSE 15L,A01,083654,Staff,0,3,50,50
1650763574460,CSE 15L,A02,083655,Staff,0,2,50,50
1650763580487,CSE 20,A01,083657,Staff,49,0,80,31
1650763586522,CSE 30,A01,083084,Eldon; John,0,76,40,40
1650763592557,CSE 100,A01,083659,Cao; Yingjun,0,71,50,50
1650763598581,CSE 134B,A01,083661,Powell; Thomas Allan,0,38,65,65
1650763604607,CSE 140,A01,083663,Staff,0,11,75,75
1650763610635,CSE 140L,A01,083088,Eldon; John,0,20,75,75
1650763616660,CSE 175,A01,083665,Kumar; Rakesh,7,0,25,18
1650763622686,CSE 190,A00,092507,Dubnov; Shlomo,10,0,20,10
1650763628713,ECE 45,A01,083139,Staff,1,2,60,59
1650763634735,ECE 65,A50,083695,Staff,0,5,30,30
1650763640764,ECE 109,A01,091882,Touri; Behrouz,32,0,70,38
1650763646789,ECE 180,A00,083140,Abi Samra; Nicholas Camill,20,0,30,10
1650763646789,ECE 180,B00,083141,Abi Samra; Nicholas Camill,0,0,30,30
1650763652827,MATH 10A,A01,083735,Patchell; Gregory David,2,0,30,28
1650763652827,MATH 10A,A02,083736,Patchell; Gregory David,27,0,30,3
1650763652827,MATH 10A,A03,083737,Patchell; Gregory David,24,0,30,6
1650763658855,MATH 10B,A01,083207,Staff,0,9,30,30
1650763658855,MATH 10B,A02,083208,Staff,1,7,30,29
1650763658855,MATH 10B,B01,083739,Staff,11,0,30,19
1650763658855,MATH 10B,B02,083740,Staff,28,0,30,2
1650763664899,MATH 18,A01,083743,Staff,0,0,30,30
1650763664899,MATH 18,A02,083744,Staff,23,0,30,7
1650763664899,MATH 18,A03,083745,Staff,21,0,30,9
1650763664899,MATH 18,A04,083746,Staff,26,0,30,4
1650763664899,MATH 18,B01,083748,Staff,0,15,30,30
1650763664899,MATH 18,B02,083749,Staff,0,12,30,30
1650763664899,MATH 18,B03,083750,Staff,0,12,30,30
1650763664899,MATH 18,B04,083751,Staff,0,12,30,30
1650763670922,MATH 20A,A01,083754,Staff,19,0,40,21
1650763676946,MATH 20B,A01,083756,Staff,0,13,30,30
1650763676946,MATH 20B,A02,083757,Staff,0,12,30,30
1650763682974,MATH 20C,A01,083760,Staff,0,16,30,30
1650763682974,MATH 20C,A02,083761,Staff,0,16,30,30
1650763682974,MATH 20C,B01,083762,Staff,9,0,30,21
1650763682974,MATH 20C,B02,083763,Staff,28,0,30,2
1650763689004,MATH 20D,A01,083765,Staff,2,1,30,28
1650763689004,MATH 20D,A02,083766,Staff,5,0,30,25
1650763689004,MATH 20D,A03,083767,Staff,24,0,30,6
1650763695033,MATH 20E,A01,083771,Staff,3,0,30,27
1650763695033,MATH 20E,A02,083772,Staff,16,0,30,14
1650763695033,MATH 20E,B01,083773,Staff,0,0,30,30
1650763695033,MATH 20E,B02,083774,Staff,5,0,30,25
1650763701058,MATH 103A,A01,083777,Staff,0,16,30,30
1650763701058,MATH 103A,A02,083778,Staff,0,15,30,30
1650763701058,MATH 103A,B01,083779,Staff,0,15,30,30
1650763701058,MATH 103A,B02,083780,Staff,0,15,30,30
1650763707081,MATH 105,A01,085443,Staff,0,22,30,30
1650763713110,MATH 109,A01,083213,Anzaldo; Leesa B,0,7,30,30
1650763713110,MATH 109,A02,083214,Anzaldo; Leesa B,0,7,30,30
1650763713110,MATH 109,B01,083215,Anzaldo; Leesa B,0,8,30,30
1650763713110,MATH 109,B02,083216,Anzaldo; Leesa B,0,6,30,30
1650763719144,MATH 142A,A01,083219,Chow; Bennett,0,16,30,30
1650763719144,MATH 142A,A02,083220,Chow; Bennett,0,15,30,30
1650763719144,MATH 142A,B01,083221,Chow; Bennett,0,15,30,30
1650763719144,MATH 142A,B02,083222,Chow; Bennett,0,14,30,30
1650763725172,MATH 193A,A01,083224,Staff,0,5,30,30
1650763725172,MATH 193A,A02,083225,Staff,0,6,30,30
1650763725172,MATH 193A,A03,083781,Staff,0,6,30,30
1650763725172,MATH 193A,A04,083782,Staff,0,7,30,30
1650763731199,MATH 197,001,091859,McAuley; Julian John,9998,0,9999,1
1650763737265,COGS 9,A01,083615,Staff,1,17,60,59
1650763743289,COGS 11,A01,083617,Boyle; Mary E. T.,16,0,40,24
1650763749317,COGS 13,A01,083071,Staff,0,38,40,40
1650763755343,COGS 14A,A01,092681,Staff,0,36,100,100
1650763761366,COGS 14B,A01,083073,Cheng; Tzu-Han,1,13,50,49
1650763767393,COGS 17,A01,092677,Staff,11,0,75,64
1650763773419,COGS 100,A01,083619,Staff,0,29,60,60
1650763779441,COGS 101A,A01,083621,Davis; Joshua Daniel,0,28,60,60
1650763785470,COGS 101B,A01,091572,Staff,1,4,60,59
1650763791495,COGS 101C,A01,083625,Delgado; Tania,14,0,30,16
1650763797525,COGS 107A,A01,083627,Boyle; Mary E. T.,0,16,60,60
1650763803550,COGS 118A,A01,083075,Staff,0,8,60,60
1650763809580,CSE 3,A50,083646,Miranda; Gregory Joseph,18,0,38,20
1650763809580,CSE 3,A51,083647,Miranda; Gregory Joseph,36,0,37,1
1650763815606,CSE 8A,A50,083650,Miranda; Gregory Joseph,0,30,40,40
1650763821752,CSE 11,A01,083080,Cao; Yingjun,0,96,40,40
1650763827778,CSE 12,A01,083652,Staff,0,21,100,100
1650763833805,CSE 15L,A01,083654,Staff,0,3,50,50
1650763833805,CSE 15L,A02,083655,Staff,0,2,50,50
1650763839828,CSE 20,A01,083657,Staff,49,0,80,31
1650763845853,CSE 30,A01,083084,Eldon; John,0,76,40,40
1650763851882,CSE 100,A01,083659,Cao; Yingjun,0,71,50,50
1650763857910,CSE 134B,A01,083661,Powell; Thomas Allan,0,38,65,65
1650763863933,CSE 140,A01,083663,Staff,0,11,75,75
1650763869957,CSE 140L,A01,083088,Eldon; John,0,20,75,75
1650763875984,CSE 175,A01,083665,Kumar; Rakesh,7,0,25,18
1650763882011,CSE 190,A00,092507,Dubnov; Shlomo,10,0,20,10
1650763888036,ECE 45,A01,083139,Staff,1,2,60,59
1650763894062,ECE 65,A50,083695,Staff,0,5,30,30
1650763900088,ECE 109,A01,091882,Touri; Behrouz,32,0,70,38
1650763906111,ECE 180,A00,083140,Abi Samra; Nicholas Camill,20,0,30,10
1650763906111,ECE 180,B00,083141,Abi Samra; Nicholas Camill,0,0,30,30
1650763912140,MATH 10A,A01,083735,Patchell; Gregory David,2,0,30,28
1650763912140,MATH 10A,A02,083736,Patchell; Gregory David,27,0,30,3
1650763912140,MATH 10A,A03,083737,Patchell; Gregory David,24,0,30,6
1650763918168,MATH 10B,A01,083207,Staff,0,9,30,30
1650763918168,MATH 10B,A02,083208,Staff,1,7,30,29
1650763918168,MATH 10B,B01,083739,Staff,11,0,30,19
1650763918168,MATH 10B,B02,083740,Staff,28,0,30,2
1650763924194,MATH 18,A01,083743,Staff,0,0,30,30
1650763924194,MATH 18,A02,083744,Staff,23,0,30,7
1650763924194,MATH 18,A03,083745,Staff,21,0,30,9
1650763924194,MATH 18,A04,083746,Staff,26,0,30,4
1650763924194,MATH 18,B01,083748,Staff,0,15,30,30
1650763924194,MATH 18,B02,083749,Staff,0,12,30,30
1650763924194,MATH 18,B03,083750,Staff,0,12,30,30
1650763924194,MATH 18,B04,083751,Staff,0,12,30,30
1650763930219,MATH 20A,A01,083754,Staff,19,0,40,21
1650763936247,MATH 20B,A01,083756,Staff,0,13,30,30
1650763936247,MATH 20B,A02,083757,Staff,0,12,30,30
1650763942276,MATH 20C,A01,083760,Staff,0,16,30,30
1650763942276,MATH 20C,A02,083761,Staff,0,16,30,30
1650763942276,MATH 20C,B01,083762,Staff,9,0,30,21
1650763942276,MATH 20C,B02,083763,Staff,28,0,30,2
1650763948299,MATH 20D,A01,083765,Staff,2,1,30,28
1650763948299,MATH 20D,A02,083766,Staff,5,0,30,25
1650763948299,MATH 20D,A03,083767,Staff,24,0,30,6
1650763954327,MATH 20E,A01,083771,Staff,3,0,30,27
1650763954327,MATH 20E,A02,083772,Staff,16,0,30,14
1650763954327,MATH 20E,B01,083773,Staff,0,0,30,30
1650763954327,MATH 20E,B02,083774,Staff,5,0,30,25
1650763960355,MATH 103A,A01,083777,Staff,0,16,30,30
1650763960355,MATH 103A,A02,083778,Staff,0,15,30,30
1650763960355,MATH 103A,B01,083779,Staff,0,15,30,30
1650763960355,MATH 103A,B02,083780,Staff,0,15,30,30
1650763966379,MATH 105,A01,085443,Staff,0,22,30,30
1650763972405,MATH 109,A01,083213,Anzaldo; Leesa B,0,7,30,30
1650763972405,MATH 109,A02,083214,Anzaldo; Leesa B,0,7,30,30
1650763972405,MATH 109,B01,083215,Anzaldo; Leesa B,0,8,30,30
1650763972405,MATH 109,B02,083216,Anzaldo; Leesa B,0,6,30,30
1650763978430,MATH 142A,A01,083219,Chow; Bennett,0,16,30,30
1650763978430,MATH 142A,A02,083220,Chow; Bennett,0,15,30,30
1650763978430,MATH 142A,B01,083221,Chow; Bennett,0,15,30,30
1650763978430,MATH 142A,B02,083222,Chow; Bennett,0,14,30,30
1650763984462,MATH 193A,A01,083224,Staff,0,5,30,30
1650763984462,MATH 193A,A02,083225,Staff,0,6,30,30
1650763984462,MATH 193A,A03,083781,Staff,0,6,30,30
1650763984462,MATH 193A,A04,083782,Staff,0,7,30,30
1650763990487,MATH 197,001,091859,McAuley; Julian John,9998,0,9999,1
1650763996547,COGS 9,A01,083615,Staff,1,17,60,59
1650764002574,COGS 11,A01,083617,Boyle; Mary E. T.,16,0,40,24
1650764008605,COGS 13,A01,083071,Staff,0,38,40,40
1650764014629,COGS 14A,A01,092681,Staff,0,36,100,100
1650764020656,COGS 14B,A01,083073,Cheng; Tzu-Han,1,13,50,49
1650764026678,COGS 17,A01,092677,Staff,11,0,75,64
1650764032705,COGS 100,A01,083619,Staff,0,29,60,60
1650764038728,COGS 101A,A01,083621,Davis; Joshua Daniel,0,28,60,60
1650764044749,COGS 101B,A01,091572,Staff,1,4,60,59
1650764050776,COGS 101C,A01,083625,Delgado; Tania,14,0,30,16
1650764056803,COGS 107A,A01,083627,Boyle; Mary E. T.,0,16,60,60
1650764062827,COGS 118A,A01,083075,Staff,0,8,60,60
1650764068851,CSE 3,A50,083646,Miranda; Gregory Joseph,18,0,38,20
1650764068851,CSE 3,A51,083647,Miranda; Gregory Joseph,36,0,37,1
1650764074876,CSE 8A,A50,083650,Miranda; Gregory Joseph,0,30,40,40
1650764080905,CSE 11,A01,083080,Cao; Yingjun,0,96,40,40
1650764086928,CSE 12,A01,083652,Staff,0,21,100,100
1650764092951,CSE 15L,A01,083654,Staff,0,3,50,50
1650764092951,CSE 15L,A02,083655,Staff,0,2,50,50
1650764098975,CSE 20,A01,083657,Staff,49,0,80,31
1650764105004,CSE 30,A01,083084,Eldon; John,0,76,40,40
1650764111033,CSE 100,A01,083659,Cao; Yingjun,0,71,50,50
1650764117057,CSE 134B,A01,083661,Powell; Thomas Allan,0,38,65,65
1650764123080,CSE 140,A01,083663,Staff,0,11,75,75
1650764129107,CSE 140L,A01,083088,Eldon; John,0,20,75,75
1650764135132,CSE 175,A01,083665,Kumar; Rakesh,7,0,25,18
1650764141159,CSE 190,A00,092507,Dubnov; Shlomo,10,0,20,10
1650764147183,ECE 45,A01,083139,Staff,1,2,60,59
1650764153208,ECE 65,A50,083695,Staff,0,5,30,30
1650764159232,ECE 109,A01,091882,Touri; Behrouz,32,0,70,38
1650764165256,ECE 180,A00,083140,Abi Samra; Nicholas Camill,20,0,30,10
1650764165256,ECE 180,B00,083141,Abi Samra; Nicholas Camill,0,0,30,30
1650764171297,MATH 10A,A01,083735,Patchell; Gregory David,2,0,30,28
1650764171297,MATH 10A,A02,083736,Patchell; Gregory David,27,0,30,3
1650764171297,MATH 10A,A03,083737,Patchell; Gregory David,24,0,30,6
1650764177321,MATH 10B,A01,083207,Staff,0,9,30,30
1650764177321,MATH 10B,A02,083208,Staff,1,7,30,29
1650764177321,MATH 10B,B01,083739,Staff,11,0,30,19
1650764177321,MATH 10B,B02,083740,Staff,28,0,30,2
1650764183348,MATH 18,A01,083743,Staff,0,0,30,30
1650764183348,MATH 18,A02,083744,Staff,23,0,30,7
1650764183348,MATH 18,A03,083745,Staff,21,0,30,9
1650764183348,MATH 18,A04,083746,Staff,26,0,30,4
1650764183348,MATH 18,B01,083748,Staff,0,15,30,30
1650764183348,MATH 18,B02,083749,Staff,0,12,30,30
1650764183348,MATH 18,B03,083750,Staff,0,12,30,30
1650764183348,MATH 18,B04,083751,Staff,0,12,30,30
1650764189384,MATH 20A,A01,083754,Staff,19,0,40,21
1650764195409,MATH 20B,A01,083756,Staff,0,13,30,30
1650764195409,MATH 20B,A02,083757,Staff,0,12,30,30
1650764201434,MATH 20C,A01,083760,Staff,0,16,30,30
1650764201434,MATH 20C,A02,083761,Staff,0,16,30,30
1650764201434,MATH 20C,B01,083762,Staff,9,0,30,21
1650764201434,MATH 20C,B02,083763,Staff,28,0,30,2
1650764207461,MATH 20D,A01,083765,Staff,2,1,30,28
1650764207461,MATH 20D,A02,083766,Staff,5,0,30,25
1650764207461,MATH 20D,A03,083767,Staff,24,0,30,6
1650764213490,MATH 20E,A01,083771,Staff,3,0,30,27
1650764213490,MATH 20E,A02,083772,Staff,16,0,30,14
1650764213490,MATH 20E,B01,083773,Staff,0,0,30,30
1650764213490,MATH 20E,B02,083774,Staff,5,0,30,25
1650764219515,MATH 103A,A01,083777,Staff,0,16,30,30
1650764219515,MATH 103A,A02,083778,Staff,0,15,30,30
1650764219515,MATH 103A,B01,083779,Staff,0,15,30,30
1650764219515,MATH 103A,B02,083780,Staff,0,15,30,30
1650764225545,MATH 105,A01,085443,Staff,0,22,30,30
1650764231569,MATH 109,A01,083213,Anzaldo; Leesa B,0,7,30,30
1650764231569,MATH 109,A02,083214,Anzaldo; Leesa B,0,7,30,30
1650764231569,MATH 109,B01,083215,Anzaldo; Leesa B,0,8,30,30
1650764231569,MATH 109,B02,083216,Anzaldo; Leesa B,0,6,30,30
1650764237594,MATH 142A,A01,083219,Chow; Bennett,0,16,30,30
1650764237594,MATH 142A,A02,083220,Chow; Bennett,0,15,30,30
1650764237594,MATH 142A,B01,083221,Chow; Bennett,0,15,30,30
1650764237594,MATH 142A,B02,083222,Chow; Bennett,0,14,30,30
1650764243621,MATH 193A,A01,083224,Staff,0,5,30,30
1650764243621,MATH 193A,A02,083225,Staff,0,6,30,30
1650764243621,MATH 193A,A03,083781,Staff,0,6,30,30
1650764243621,MATH 193A,A04,083782,Staff,0,7,30,30
1650764249645,MATH 197,001,091859,McAuley; Julian John,9998,0,9999,1
1650764255710,COGS 9,A01,083615,Staff,1,17,60,59
1650764261734,COGS 11,A01,083617,Boyle; Mary E. T.,16,0,40,24
1650764267768,COGS 13,A01,083071,Staff,0,38,40,40
1650764273792,COGS 14A,A01,092681,Staff,0,36,100,100
1650764279816,COGS 14B,A01,083073,Cheng; Tzu-Han,1,13,50,49
1650764285839,COGS 17,A01,092677,Staff,11,0,75,64
1650764291866,COGS 100,A01,083619,Staff,0,29,60,60
1650764297890,COGS 101A,A01,083621,Davis; Joshua Daniel,0,28,60,60
1650764303916,COGS 101B,A01,091572,Staff,1,4,60,59
1650764309941,COGS 101C,A01,083625,Delgado; Tania,14,0,30,16
1650764315965,COGS 107A,A01,083627,Boyle; Mary E. T.,0,16,60,60
1650764321989,COGS 118A,A01,083075,Staff,0,8,60,60
1650764328012,CSE 3,A50,083646,Miranda; Gregory Joseph,18,0,38,20
1650764328012,CSE 3,A51,083647,Miranda; Gregory Joseph,36,0,37,1
1650764334036,CSE 8A,A50,083650,Miranda; Gregory Joseph,0,30,40,40
1650764340060,CSE 11,A01,083080,Cao; Yingjun,0,96,40,40
1650764346084,CSE 12,A01,083652,Staff,0,21,100,100
1650764352111,CSE 15L,A01,083654,Staff,0,3,50,50
1650764352111,CSE 15L,A02,083655,Staff,0,2,50,50
1650764358135,CSE 20,A01,083657,Staff,49,0,80,31
1650764364159,CSE 30,A01,083084,Eldon; John,0,76,40,40
1650764370186,CSE 100,A01,083659,Cao; Yingjun,0,71,50,50
1650764376213,CSE 134B,A01,083661,Powell; Thomas Allan,0,38,65,65
1650764382239,CSE 140,A01,083663,Staff,0,11,75,75
1650764388266,CSE 140L,A01,083088,Eldon; John,0,20,75,75
1650764394303,CSE 175,A01,083665,Kumar; Rakesh,7,0,25,18
1650764400333,CSE 190,A00,092507,Dubnov; Shlomo,10,0,20,10
1650764406360,ECE 45,A01,083139,Staff,1,2,60,59
1650764412384,ECE 65,A50,083695,Staff,0,5,30,30
1650764418501,ECE 109,A01,091882,Touri; Behrouz,32,0,70,38
1650764424524,ECE 180,A00,083140,Abi Samra; Nicholas Camill,20,0,30,10
1650764424524,ECE 180,B00,083141,Abi Samra; Nicholas Camill,0,0,30,30
1650764430551,MATH 10A,A01,083735,Patchell; Gregory David,2,0,30,28
1650764430551,MATH 10A,A02,083736,Patchell; Gregory David,27,0,30,3
1650764430551,MATH 10A,A03,083737,Patchell; Gregory David,24,0,30,6
1650764436579,MATH 10B,A01,083207,Staff,0,9,30,30
1650764436579,MATH 10B,A02,083208,Staff,1,7,30,29
1650764436579,MATH 10B,B01,083739,Staff,11,0,30,19
1650764436579,MATH 10B,B02,083740,Staff,28,0,30,2
1650764442618,MATH 18,A01,083743,Staff,0,0,30,30
1650764442618,MATH 18,A02,083744,Staff,23,0,30,7
1650764442618,MATH 18,A03,083745,Staff,21,0,30,9
1650764442618,MATH 18,A04,083746,Staff,26,0,30,4
1650764442618,MATH 18,B01,083748,Staff,0,15,30,30
1650764442618,MATH 18,B02,083749,Staff,0,12,30,30
1650764442618,MATH 18,B03,083750,Staff,0,12,30,30
1650764442618,MATH 18,B04,083751,Staff,0,12,30,30
1650764448640,MATH 20A,A01,083754,Staff,19,0,40,21
1650764454667,MATH 20B,A01,083756,Staff,0,13,30,30
1650764454667,MATH 20B,A02,083757,Staff,0,12,30,30
1650764460691,MATH 20C,A01,083760,Staff,0,16,30,30
1650764460691,MATH 20C,A02,083761,Staff,0,16,30,30
1650764460691,MATH 20C,B01,083762,Staff,9,0,30,21
1650764460691,MATH 20C,B02,083763,Staff,28,0,30,2
1650764466717,MATH 20D,A01,083765,Staff,2,1,30,28
1650764466717,MATH 20D,A02,083766,Staff,5,0,30,25
1650764466717,MATH 20D,A03,083767,Staff,24,0,30,6
1650764472739,MATH 20E,A01,083771,Staff,3,0,30,27
1650764472739,MATH 20E,A02,083772,Staff,16,0,30,14
1650764472739,MATH 20E,B01,083773,Staff,0,0,30,30
1650764472739,MATH 20E,B02,083774,Staff,5,0,30,25
1650764478763,MATH 103A,A01,083777,Staff,0,16,30,30
1650764478763,MATH 103A,A02,083778,Staff,0,15,30,30
1650764478763,MATH 103A,B01,083779,Staff,0,15,30,30
1650764478763,MATH 103A,B02,083780,Staff,0,15,30,30
1650764484789,MATH 105,A01,085443,Staff,0,22,30,30
1650764490812,MATH 109,A01,083213,Anzaldo; Leesa B,0,7,30,30
1650764490812,MATH 109,A02,083214,Anzaldo; Leesa B,0,7,30,30
1650764490812,MATH 109,B01,083215,Anzaldo; Leesa B,0,8,30,30
1650764490812,MATH 109,B02,083216,Anzaldo; Leesa B,0,6,30,30
1650764496838,MATH 142A,A01,083219,Chow; Bennett,0,16,30,30
1650764496838,MATH 142A,A02,083220,Chow; Bennett,0,15,30,30
1650764496838,MATH 142A,B01,083221,Chow; Bennett,0,15,30,30
1650764496838,MATH 142A,B02,083222,Chow; Bennett,0,14,30,30
1650764502860,MATH 193A,A01,083224,Staff,0,5,30,30
1650764502860,MATH 193A,A02,083225,Staff,0,6,30,30
1650764502860,MATH 193A,A03,083781,Staff,0,6,30,30
1650764502860,MATH 193A,A04,083782,Staff,0,7,30,30
1650764508883,MATH 197,001,091859,McAuley; Julian John,9998,0,9999,1
1650764514937,COGS 9,A01,083615,Staff,1,17,60,59
1650764520962,COGS 11,A01,083617,Boyle; Mary E. T.,16,0,40,24
1650764526985,COGS 13,A01,083071,Staff,0,38,40,40
1650764533009,COGS 14A,A01,092681,Staff,0,36,100,100
1650764539037,COGS 14B,A01,083073,Cheng; Tzu-Han,1,13,50,49
1650764545060,COGS 17,A01,092677,Staff,11,0,75,64
1650764551087,COGS 100,A01,083619,Staff,0,29,60,60
1650764557111,COGS 101A,A01,083621,Davis; Joshua Daniel,0,28,60,60
1650764563133,COGS 101B,A01,091572,Staff,1,4,60,59
1650764569159,COGS 101C,A01,083625,Delgado; Tania,14,0,30,16
1650764575183,COGS 107A,A01,083627,Boyle; Mary E. T.,0,16,60,60
1650764581207,COGS 118A,A01,083075,Staff,0,8,60,60
1650764587231,CSE 3,A50,083646,Miranda; Gregory Joseph,18,0,38,20
1650764587231,CSE 3,A51,083647,Miranda; Gregory Joseph,36,0,37,1
1650764593257,CSE 8A,A50,083650,Miranda; Gregory Joseph,0,30,40,40
1650764599282,CSE 11,A01,083080,Cao; Yingjun,0,96,40,40
1650764605305,CSE 12,A01,083652,Staff,0,21,100,100
1650764611331,CSE 15L,A01,083654,Staff,0,3,50,50
1650764611331,CSE 15L,A02,083655,Staff,0,2,50,50
1650764617355,CSE 20,A01,083657,Staff,49,0,80,31
1650764623382,CSE 30,A01,083084,Eldon; John,0,76,40,40
1650764629409,CSE 100,A01,083659,Cao; Yingjun,0,71,50,50
1650764635435,CSE 134B,A01,083661,Powell; Thomas Allan,0,38,65,65
1650764641465,CSE 140,A01,083663,Staff,0,11,75,75
1650764647489,CSE 140L,A01,083088,Eldon; John,0,20,75,75
1650764653516,CSE 175,A01,083665,Kumar; Rakesh,7,0,25,18
1650764659540,CSE 190,A00,092507,Dubnov; Shlomo,10,0,20,10
1650764665564,ECE 45,A01,083139,Staff,1,2,60,59
1650764671590,ECE 65,A50,083695,Staff,0,5,30,30
1650764677613,ECE 109,A01,091882,Touri; Behrouz,32,0,70,38
1650764683637,ECE 180,A00,083140,Abi Samra; Nicholas Camill,20,0,30,10
1650764683637,ECE 180,B00,083141,Abi Samra; Nicholas Camill,0,0,30,30
1650764689664,MATH 10A,A01,083735,Patchell; Gregory David,2,0,30,28
1650764689664,MATH 10A,A02,083736,Patchell; Gregory David,27,0,30,3
1650764689664,MATH 10A,A03,083737,Patchell; Gregory David,24,0,30,6
1650764695691,MATH 10B,A01,083207,Staff,0,9,30,30
1650764695691,MATH 10B,A02,083208,Staff,1,7,30,29
1650764695691,MATH 10B,B01,083739,Staff,11,0,30,19
1650764695691,MATH 10B,B02,083740,Staff,28,0,30,2
1650764701717,MATH 18,A01,083743,Staff,0,0,30,30
1650764701717,MATH 18,A02,083744,Staff,23,0,30,7
1650764701717,MATH 18,A03,083745,Staff,21,0,30,9
1650764701717,MATH 18,A04,083746,Staff,26,0,30,4
1650764701717,MATH 18,B01,083748,Staff,0,15,30,30
1650764701717,MATH 18,B02,083749,Staff,0,12,30,30
1650764701717,MATH 18,B03,083750,Staff,0,12,30,30
1650764701717,MATH 18,B04,083751,Staff,0,12,30,30
1650764707748,MATH 20A,A01,083754,Staff,19,0,40,21
1650764713774,MATH 20B,A01,083756,Staff,0,13,30,30
1650764713774,MATH 20B,A02,083757,Staff,0,12,30,30
1650764719801,MATH 20C,A01,083760,Staff,0,16,30,30
1650764719801,MATH 20C,A02,083761,Staff,0,16,30,30
1650764719801,MATH 20C,B01,083762,Staff,9,0,30,21
1650764719801,MATH 20C,B02,083763,Staff,28,0,30,2
1650764725825,MATH 20D,A01,083765,Staff,2,1,30,28
1650764725825,MATH 20D,A02,083766,Staff,5,0,30,25
1650764725825,MATH 20D,A03,083767,Staff,24,0,30,6
1650764731848,MATH 20E,A01,083771,Staff,3,0,30,27
1650764731848,MATH 20E,A02,083772,Staff,16,0,30,14
1650764731848,MATH 20E,B01,083773,Staff,0,0,30,30
1650764731848,MATH 20E,B02,083774,Staff,5,0,30,25
1650764737873,MATH 103A,A01,083777,Staff,0,16,30,30
1650764737873,MATH 103A,A02,083778,Staff,0,15,30,30
1650764737873,MATH 103A,B01,083779,Staff,0,15,30,30
1650764737873,MATH 103A,B02,083780,Staff,0,15,30,30
1650764743895,MATH 105,A01,085443,Staff,0,22,30,30
1650764749925,MATH 109,A01,083213,Anzaldo; Leesa B,0,7,30,30
1650764749925,MATH 109,A02,083214,Anzaldo; Leesa B,0,7,30,30
1650764749925,MATH 109,B01,083215,Anzaldo; Leesa B,0,8,30,30
1650764749925,MATH 109,B02,083216,Anzaldo; Leesa B,0,6,30,30
1650764755949,MATH 142A,A01,083219,Chow; Bennett,0,16,30,30
1650764755949,MATH 142A,A02,083220,Chow; Bennett,0,15,30,30
1650764755949,MATH 142A,B01,083221,Chow; Bennett,0,15,30,30
1650764755949,MATH 142A,B02,083222,Chow; Bennett,0,14,30,30
1650764761974,MATH 193A,A01,083224,Staff,0,5,30,30
1650764761974,MATH 193A,A02,083225,Staff,0,6,30,30
1650764761974,MATH 193A,A03,083781,Staff,0,6,30,30
1650764761974,MATH 193A,A04,083782,Staff,0,7,30,30
1650764768000,MATH 197,001,091859,McAuley; Julian John,9998,0,9999,1
1650764774058,COGS 9,A01,083615,Staff,1,17,60,59
1650764780081,COGS 11,A01,083617,Boyle; Mary E. T.,16,0,40,24
1650764786105,COGS 13,A01,083071,Staff,0,38,40,40
1650764792132,COGS 14A,A01,092681,Staff,0,36,100,100
1650764798157,COGS 14B,A01,083073,Cheng; Tzu-Han,1,13,50,49
1650764804190,COGS 17,A01,092677,Staff,11,0,75,64
1650764810214,COGS 100,A01,083619,Staff,0,29,60,60
1650764816246,COGS 101A,A01,083621,Davis; Joshua Daniel,0,28,60,60
1650764822269,COGS 101B,A01,091572,Staff,1,4,60,59
1650764828295,COGS 101C,A01,083625,Delgado; Tania,14,0,30,16
1650764834323,COGS 107A,A01,083627,Boyle; Mary E. T.,0,16,60,60
1650764840346,COGS 118A,A01,083075,Staff,0,8,60,60
1650764846375,CSE 3,A50,083646,Miranda; Gregory Joseph,18,0,38,20
1650764846375,CSE 3,A51,083647,Miranda; Gregory Joseph,36,0,37,1
1650764852404,CSE 8A,A50,083650,Miranda; Gregory Joseph,0,30,40,40
1650764858432,CSE 11,A01,083080,Cao; Yingjun,0,96,40,40
1650764864456,CSE 12,A01,083652,Staff,0,21,100,100
1650764870481,CSE 15L,A01,083654,Staff,0,3,50,50
1650764870481,CSE 15L,A02,083655,Staff,0,2,50,50
1650764876510,CSE 20,A01,083657,Staff,49,0,80,31
1650764882540,CSE 30,A01,083084,Eldon; John,0,76,40,40
1650764888563,CSE 100,A01,083659,Cao; Yingjun,0,71,50,50
1650764894591,CSE 134B,A01,083661,Powell; Thomas Allan,0,38,65,65
1650764900613,CSE 140,A01,083663,Staff,0,11,75,75
1650764906637,CSE 140L,A01,083088,Eldon; John,0,20,75,75
1650764912660,CSE 175,A01,083665,Kumar; Rakesh,7,0,25,18
1650764918689,CSE 190,A00,092507,Dubnov; Shlomo,10,0,20,10
1650764924713,ECE 45,A01,083139,Staff,1,2,60,59
1650764930737,ECE 65,A50,083695,Staff,0,5,30,30
1650764936761,ECE 109,A01,091882,Touri; Behrouz,32,0,70,38
1650764942789,ECE 180,A00,083140,Abi Samra; Nicholas Camill,20,0,30,10
1650764942789,ECE 180,B00,083141,Abi Samra; Nicholas Camill,0,0,30,30
1650764948817,MATH 10A,A01,083735,Patchell; Gregory David,2,0,30,28
1650764948817,MATH 10A,A02,083736,Patchell; Gregory David,27,0,30,3
1650764948817,MATH 10A,A03,083737,Patchell; Gregory David,24,0,30,6
1650764954844,MATH 10B,A01,083207,Staff,0,9,30,30
1650764954844,MATH 10B,A02,083208,Staff,1,7,30,29
1650764954844,MATH 10B,B01,083739,Staff,11,0,30,19
1650764954844,MATH 10B,B02,083740,Staff,28,0,30,2
1650764960874,MATH 18,A01,083743,Staff,0,0,30,30
1650764960874,MATH 18,A02,083744,Staff,23,0,30,7
1650764960874,MATH 18,A03,083745,Staff,21,0,30,9
1650764960874,MATH 18,A04,083746,Staff,26,0,30,4
1650764960874,MATH 18,B01,083748,Staff,0,15,30,30
1650764960874,MATH 18,B02,083749,Staff,0,12,30,30
1650764960874,MATH 18,B03,083750,Staff,0,12,30,30
1650764960874,MATH 18,B04,083751,Staff,0,12,30,30
1650764966901,MATH 20A,A01,083754,Staff,19,0,40,21
1650764972924,MATH 20B,A01,083756,Staff,0,13,30,30
1650764972924,MATH 20B,A02,083757,Staff,0,12,30,30
1650764978948,MATH 20C,A01,083760,Staff,0,16,30,30
1650764978948,MATH 20C,A02,083761,Staff,0,16,30,30
1650764978948,MATH 20C,B01,083762,Staff,9,0,30,21
1650764978948,MATH 20C,B02,083763,Staff,28,0,30,2
1650764984973,MATH 20D,A01,083765,Staff,2,1,30,28
1650764984973,MATH 20D,A02,083766,Staff,5,0,30,25
1650764984973,MATH 20D,A03,083767,Staff,24,0,30,6
1650764990997,MATH 20E,A01,083771,Staff,3,0,30,27
1650764990997,MATH 20E,A02,083772,Staff,16,0,30,14
1650764990997,MATH 20E,B01,083773,Staff,0,0,30,30
1650764990997,MATH 20E,B02,083774,Staff,5,0,30,25
1650764997022,MATH 103A,A01,083777,Staff,0,16,30,30
1650764997022,MATH 103A,A02,083778,Staff,0,15,30,30
1650764997022,MATH 103A,B01,083779,Staff,0,15,30,30
1650764997022,MATH 103A,B02,083780,Staff,0,15,30,30
1650765003046,MATH 105,A01,085443,Staff,0,22,30,30
1650765009077,MATH 109,A01,083213,Anzaldo; Leesa B,0,7,30,30
1650765009077,MATH 109,A02,083214,Anzaldo; Leesa B,0,7,30,30
1650765009077,MATH 109,B01,083215,Anzaldo; Leesa B,0,8,30,30
1650765009077,MATH 109,B02,083216,Anzaldo; Leesa B,0,6,30,30
1650765015189,MATH 142A,A01,083219,Chow; Bennett,0,16,30,30
1650765015189,MATH 142A,A02,083220,Chow; Bennett,0,15,30,30
1650765015189,MATH 142A,B01,083221,Chow; Bennett,0,15,30,30
1650765015189,MATH 142A,B02,083222,Chow; Bennett,0,14,30,30
1650765021216,MATH 193A,A01,083224,Staff,0,5,30,30
1650765021216,MATH 193A,A02,083225,Staff,0,6,30,30
1650765021216,MATH 193A,A03,083781,Staff,0,6,30,30
1650765021216,MATH 193A,A04,083782,Staff,0,7,30,30
1650765027242,MATH 197,001,091859,McAuley; Julian John,9998,0,9999,1
1650765033290,COGS 9,A01,083615,Staff,1,17,60,59
1650765039314,COGS 11,A01,083617,Boyle; Mary E. T.,16,0,40,24
1650765045343,COGS 13,A01,083071,Staff,0,38,40,40
1650765051372,COGS 14A,A01,092681,Staff,0,36,100,100
1650765057396,COGS 14B,A01,083073,Cheng; Tzu-Han,1,13,50,49
1650765063419,COGS 17,A01,092677,Staff,11,0,75,64
1650765069443,COGS 100,A01,083619,Staff,0,29,60,60
1650765075467,COGS 101A,A01,083621,Davis; Joshua Daniel,0,28,60,60
1650765081491,COGS 101B,A01,091572,Staff,1,4,60,59
1650765087515,COGS 101C,A01,083625,Delgado; Tania,14,0,30,16
1650765093539,COGS 107A,A01,083627,Boyle; Mary E. T.,0,16,60,60
1650765099566,COGS 118A,A01,083075,Staff,0,8,60,60
1650765105592,CSE 3,A50,083646,Miranda; Gregory Joseph,18,0,38,20
1650765105592,CSE 3,A51,083647,Miranda; Gregory Joseph,36,0,37,1
1650765111626,CSE 8A,A50,083650,Miranda; Gregory Joseph,0,30,40,40
1650765117649,CSE 11,A01,083080,Cao; Yingjun,0,96,40,40
1650765123675,CSE 12,A01,083652,Staff,0,21,100,100
1650765129702,CSE 15L,A01,083654,Staff,0,3,50,50
1650765129702,CSE 15L,A02,083655,Staff,0,2,50,50
1650765135728,CSE 20,A01,083657,Staff,49,0,80,31
1650765141761,CSE 30,A01,083084,Eldon; John,0,76,40,40
1650765147787,CSE 100,A01,083659,Cao; Yingjun,0,71,50,50
1650765153810,CSE 134B,A01,083661,Powell; Thomas Allan,0,38,65,65
1650765159833,CSE 140,A01,083663,Staff,0,11,75,75
1650765165859,CSE 140L,A01,083088,Eldon; John,0,20,75,75
1650765171882,CSE 175,A01,083665,Kumar; Rakesh,7,0,25,18
1650765177906,CSE 190,A00,092507,Dubnov; Shlomo,10,0,20,10
1650765183930,ECE 45,A01,083139,Staff,1,2,60,59
1650765189957,ECE 65,A50,083695,Staff,0,5,30,30
1650765195981,ECE 109,A01,091882,Touri; Behrouz,32,0,70,38
1650765202005,ECE 180,A00,083140,Abi Samra; Nicholas Camill,20,0,30,10
1650765202005,ECE 180,B00,083141,Abi Samra; Nicholas Camill,0,0,30,30
1650765208038,MATH 10A,A01,083735,Patchell; Gregory David,2,0,30,28
1650765208038,MATH 10A,A02,083736,Patchell; Gregory David,27,0,30,3
1650765208038,MATH 10A,A03,083737,Patchell; Gregory David,24,0,30,6
1650765214061,MATH 10B,A01,083207,Staff,0,9,30,30
1650765214061,MATH 10B,A02,083208,Staff,1,7,30,29
1650765214061,MATH 10B,B01,083739,Staff,11,0,30,19
1650765214061,MATH 10B,B02,083740,Staff,28,0,30,2
1650765220086,MATH 18,A01,083743,Staff,0,0,30,30
1650765220086,MATH 18,A02,083744,Staff,23,0,30,7
1650765220086,MATH 18,A03,083745,Staff,21,0,30,9
1650765220086,MATH 18,A04,083746,Staff,26,0,30,4
1650765220086,MATH 18,B01,083748,Staff,0,15,30,30
1650765220086,MATH 18,B02,083749,Staff,0,12,30,30
1650765220086,MATH 18,B03,083750,Staff,0,12,30,30
1650765220086,MATH 18,B04,083751,Staff,0,12,30,30
1650765226110,MATH 20A,A01,083754,Staff,19,0,40,21
1650765232134,MATH 20B,A01,083756,Staff,0,13,30,30
1650765232134,MATH 20B,A02,083757,Staff,0,12,30,30
1650765238163,MATH 20C,A01,083760,Staff,0,16,30,30
1650765238163,MATH 20C,A02,083761,Staff,0,16,30,30
1650765238163,MATH 20C,B01,083762,Staff,9,0,30,21
1650765238163,MATH 20C,B02,083763,Staff,28,0,30,2
1650765244187,MATH 20D,A01,083765,Staff,2,1,30,28
1650765244187,MATH 20D,A02,083766,Staff,5,0,30,25
1650765244187,MATH 20D,A03,083767,Staff,24,0,30,6
1650765250211,MATH 20E,A01,083771,Staff,3,0,30,27
1650765250211,MATH 20E,A02,083772,Staff,16,0,30,14
1650765250211,MATH 20E,B01,083773,Staff,0,0,30,30
1650765250211,MATH 20E,B02,083774,Staff,5,0,30,25
1650765256239,MATH 103A,A01,083777,Staff,0,16,30,30
1650765256239,MATH 103A,A02,083778,Staff,0,15,30,30
1650765256239,MATH 103A,B01,083779,Staff,0,15,30,30
1650765256239,MATH 103A,B02,083780,Staff,0,15,30,30
1650765262274,MATH 105,A01,085443,Staff,0,22,30,30
1650765268299,MATH 109,A01,083213,Anzaldo; Leesa B,0,7,30,30
1650765268299,MATH 109,A02,083214,Anzaldo; Leesa B,0,7,30,30
1650765268299,MATH 109,B01,083215,Anzaldo; Leesa B,0,8,30,30
1650765268299,MATH 109,B02,083216,Anzaldo; Leesa B,0,6,30,30
1650765274323,MATH 142A,A01,083219,Chow; Bennett,0,16,30,30
1650765274323,MATH 142A,A02,083220,Chow; Bennett,0,15,30,30
1650765274323,MATH 142A,B01,083221,Chow; Bennett,0,15,30,30
1650765274323,MATH 142A,B02,083222,Chow; Bennett,0,14,30,30
1650765280347,MATH 193A,A01,083224,Staff,0,5,30,30
1650765280347,MATH 193A,A02,083225,Staff,0,6,30,30
1650765280347,MATH 193A,A03,083781,Staff,0,6,30,30
1650765280347,MATH 193A,A04,083782,Staff,0,7,30,30
1650765286371,MATH 197,001,091859,McAuley; Julian John,9998,0,9999,1
1650765292433,COGS 9,A01,083615,Staff,1,17,60,59
1650765298457,COGS 11,A01,083617,Boyle; Mary E. T.,16,0,40,24
1650765304484,COGS 13,A01,083071,Staff,0,38,40,40
1650765310508,COGS 14A,A01,092681,Staff,0,36,100,100
1650765316533,COGS 14B,A01,083073,Cheng; Tzu-Han,1,13,50,49
1650765322558,COGS 17,A01,092677,Staff,11,0,75,64
1650765328583,COGS 100,A01,083619,Staff,0,29,60,60
1650765334616,COGS 101A,A01,083621,Davis; Joshua Daniel,0,28,60,60
1650765340643,COGS 101B,A01,091572,Staff,1,4,60,59
1650765346670,COGS 101C,A01,083625,Delgado; Tania,14,0,30,16
1650765352698,COGS 107A,A01,083627,Boyle; Mary E. T.,0,16,60,60
1650765358724,COGS 118A,A01,083075,Staff,0,8,60,60
1650765364753,CSE 3,A50,083646,Miranda; Gregory Joseph,18,0,38,20
1650765364753,CSE 3,A51,083647,Miranda; Gregory Joseph,36,0,37,1
1650765370777,CSE 8A,A50,083650,Miranda; Gregory Joseph,0,30,40,40
1650765376806,CSE 11,A01,083080,Cao; Yingjun,0,96,40,40
1650765382830,CSE 12,A01,083652,Staff,0,21,100,100
1650765388853,CSE 15L,A01,083654,Staff,0,3,50,50
1650765388853,CSE 15L,A02,083655,Staff,0,2,50,50
1650765394882,CSE 20,A01,083657,Staff,49,0,80,31
1650765400905,CSE 30,A01,083084,Eldon; John,0,76,40,40
1650765406932,CSE 100,A01,083659,Cao; Yingjun,0,71,50,50
1650765412956,CSE 134B,A01,083661,Powell; Thomas Allan,0,38,65,65
1650765418982,CSE 140,A01,083663,Staff,0,11,75,75
1650765425010,CSE 140L,A01,083088,Eldon; John,0,20,75,75
1650765431034,CSE 175,A01,083665,Kumar; Rakesh,7,0,25,18
1650765437058,CSE 190,A00,092507,Dubnov; Shlomo,10,0,20,10
1650765443081,ECE 45,A01,083139,Staff,1,2,60,59
1650765449105,ECE 65,A50,083695,Staff,0,5,30,30
1650765455132,ECE 109,A01,091882,Touri; Behrouz,32,0,70,38
1650765461156,ECE 180,A00,083140,Abi Samra; Nicholas Camill,20,0,30,10
1650765461156,ECE 180,B00,083141,Abi Samra; Nicholas Camill,0,0,30,30
1650765467180,MATH 10A,A01,083735,Patchell; Gregory David,2,0,30,28
1650765467180,MATH 10A,A02,083736,Patchell; Gregory David,27,0,30,3
1650765467180,MATH 10A,A03,083737,Patchell; Gregory David,24,0,30,6
1650765473207,MATH 10B,A01,083207,Staff,0,9,30,30
1650765473207,MATH 10B,A02,083208,Staff,1,7,30,29
1650765473207,MATH 10B,B01,083739,Staff,11,0,30,19
1650765473207,MATH 10B,B02,083740,Staff,28,0,30,2
1650765479235,MATH 18,A01,083743,Staff,0,0,30,30
1650765479235,MATH 18,A02,083744,Staff,23,0,30,7
1650765479235,MATH 18,A03,083745,Staff,21,0,30,9
1650765479235,MATH 18,A04,083746,Staff,26,0,30,4
1650765479235,MATH 18,B01,083748,Staff,0,15,30,30
1650765479235,MATH 18,B02,083749,Staff,0,12,30,30
1650765479235,MATH 18,B03,083750,Staff,0,12,30,30
1650765479235,MATH 18,B04,083751,Staff,0,12,30,30
1650765485259,MATH 20A,A01,083754,Staff,19,0,40,21
1650765491296,MATH 20B,A01,083756,Staff,0,13,30,30
1650765491296,MATH 20B,A02,083757,Staff,0,12,30,30
1650765497333,MATH 20C,A01,083760,Staff,0,16,30,30
1650765497333,MATH 20C,A02,083761,Staff,0,16,30,30
1650765497333,MATH 20C,B01,083762,Staff,9,0,30,21
1650765497333,MATH 20C,B02,083763,Staff,28,0,30,2
1650765503365,MATH 20D,A01,083765,Staff,2,1,30,28
1650765503365,MATH 20D,A02,083766,Staff,5,0,30,25
1650765503365,MATH 20D,A03,083767,Staff,24,0,30,6
1650765509406,MATH 20E,A01,083771,Staff,3,0,30,27
1650765509406,MATH 20E,A02,083772,Staff,16,0,30,14
1650765509406,MATH 20E,B01,083773,Staff,0,0,30,30
1650765509406,MATH 20E,B02,083774,Staff,5,0,30,25
1650765515432,MATH 103A,A01,083777,Staff,0,16,30,30
1650765515432,MATH 103A,A02,083778,Staff,0,15,30,30
1650765515432,MATH 103A,B01,083779,Staff,0,15,30,30
1650765515432,MATH 103A,B02,083780,Staff,0,15,30,30
1650765521456,MATH 105,A01,085443,Staff,0,22,30,30
1650765527490,MATH 109,A01,083213,Anzaldo; Leesa B,0,7,30,30
1650765527490,MATH 109,A02,083214,Anzaldo; Leesa B,0,7,30,30
1650765527490,MATH 109,B01,083215,Anzaldo; Leesa B,0,8,30,30
1650765527490,MATH 109,B02,083216,Anzaldo; Leesa B,0,6,30,30
1650765533518,MATH 142A,A01,083219,Chow; Bennett,0,16,30,30
1650765533518,MATH 142A,A02,083220,Chow; Bennett,0,15,30,30
1650765533518,MATH 142A,B01,083221,Chow; Bennett,0,15,30,30
1650765533518,MATH 142A,B02,083222,Chow; Bennett,0,14,30,30
1650765539542,MATH 193A,A01,083224,Staff,0,5,30,30
1650765539542,MATH 193A,A02,083225,Staff,0,6,30,30
1650765539542,MATH 193A,A03,083781,Staff,0,6,30,30
1650765539542,MATH 193A,A04,083782,Staff,0,7,30,30
1650765545565,MATH 197,001,091859,McAuley; Julian John,9998,0,9999,1
1650765551626,COGS 9,A01,083615,Staff,1,17,60,59
1650765557650,COGS 11,A01,083617,Boyle; Mary E. T.,16,0,40,24
1650765563674,COGS 13,A01,083071,Staff,0,38,40,40
1650765569699,COGS 14A,A01,092681,Staff,0,36,100,100
1650765575723,COGS 14B,A01,083073,Cheng; Tzu-Han,1,13,50,49
1650765581751,COGS 17,A01,092677,Staff,11,0,75,64
1650765587774,COGS 100,A01,083619,Staff,0,29,60,60
1650765593798,COGS 101A,A01,083621,Davis; Joshua Daniel,0,28,60,60
1650765599822,COGS 101B,A01,091572,Staff,1,4,60,59
1650765605971,COGS 101C,A01,083625,Delgado; Tania,14,0,30,16
1650765612005,COGS 107A,A01,083627,Boyle; Mary E. T.,0,16,60,60
1650765618028,COGS 118A,A01,083075,Staff,0,8,60,60
1650765624052,CSE 3,A50,083646,Miranda; Gregory Joseph,18,0,38,20
1650765624052,CSE 3,A51,083647,Miranda; Gregory Joseph,36,0,37,1
1650765630076,CSE 8A,A50,083650,Miranda; Gregory Joseph,0,30,40,40
1650765636103,CSE 11,A01,083080,Cao; Yingjun,0,96,40,40
1650765642133,CSE 12,A01,083652,Staff,0,21,100,100
1650765648158,CSE 15L,A01,083654,Staff,0,3,50,50
1650765648158,CSE 15L,A02,083655,Staff,0,2,50,50
1650765654181,CSE 20,A01,083657,Staff,49,0,80,31
1650765660209,CSE 30,A01,083084,Eldon; John,0,76,40,40
1650765666233,CSE 100,A01,083659,Cao; Yingjun,0,71,50,50
1650765672257,CSE 134B,A01,083661,Powell; Thomas Allan,0,38,65,65
1650765678284,CSE 140,A01,083663,Staff,0,11,75,75
1650765684312,CSE 140L,A01,083088,Eldon; John,0,20,75,75
1650765690336,CSE 175,A01,083665,Kumar; Rakesh,7,0,25,18
1650765696361,CSE 190,A00,092507,Dubnov; Shlomo,10,0,20,10
1650765702385,ECE 45,A01,083139,Staff,1,2,60,59
1650765708408,ECE 65,A50,083695,Staff,0,5,30,30
1650765714434,ECE 109,A01,091882,Touri; Behrouz,32,0,70,38
1650765720458,ECE 180,A00,083140,Abi Samra; Nicholas Camill,20,0,30,10
1650765720458,ECE 180,B00,083141,Abi Samra; Nicholas Camill,0,0,30,30
1650765726481,MATH 10A,A01,083735,Patchell; Gregory David,2,0,30,28
1650765726481,MATH 10A,A02,083736,Patchell; Gregory David,27,0,30,3
1650765726481,MATH 10A,A03,083737,Patchell; Gregory David,24,0,30,6
1650765732505,MATH 10B,A01,083207,Staff,0,9,30,30
1650765732505,MATH 10B,A02,083208,Staff,1,7,30,29
1650765732505,MATH 10B,B01,083739,Staff,11,0,30,19
1650765732505,MATH 10B,B02,083740,Staff,28,0,30,2
1650765738529,MATH 18,A01,083743,Staff,0,0,30,30
1650765738529,MATH 18,A02,083744,Staff,23,0,30,7
1650765738529,MATH 18,A03,083745,Staff,21,0,30,9
1650765738529,MATH 18,A04,083746,Staff,26,0,30,4
1650765738529,MATH 18,B01,083748,Staff,0,15,30,30
1650765738529,MATH 18,B02,083749,Staff,0,12,30,30
1650765738529,MATH 18,B03,083750,Staff,0,12,30,30
1650765738529,MATH 18,B04,083751,Staff,0,12,30,30
1650765744550,MATH 20A,A01,083754,Staff,19,0,40,21
1650765750573,MATH 20B,A01,083756,Staff,0,13,30,30
1650765750573,MATH 20B,A02,083757,Staff,0,12,30,30
1650765756601,MATH 20C,A01,083760,Staff,0,16,30,30
1650765756601,MATH 20C,A02,083761,Staff,0,16,30,30
1650765756601,MATH 20C,B01,083762,Staff,9,0,30,21
1650765756601,MATH 20C,B02,083763,Staff,28,0,30,2
1650765762630,MATH 20D,A01,083765,Staff,2,1,30,28
1650765762630,MATH 20D,A02,083766,Staff,5,0,30,25
1650765762630,MATH 20D,A03,083767,Staff,24,0,30,6
1650765768657,MATH 20E,A01,083771,Staff,3,0,30,27
1650765768657,MATH 20E,A02,083772,Staff,16,0,30,14
1650765768657,MATH 20E,B01,083773,Staff,0,0,30,30
1650765768657,MATH 20E,B02,083774,Staff,5,0,30,25
1650765774686,MATH 103A,A01,083777,Staff,0,16,30,30
1650765774686,MATH 103A,A02,083778,Staff,0,15,30,30
1650765774686,MATH 103A,B01,083779,Staff,0,15,30,30
1650765774686,MATH 103A,B02,083780,Staff,0,15,30,30
1650765780716,MATH 105,A01,085443,Staff,0,22,30,30
1650765786739,MATH 109,A01,083213,Anzaldo; Leesa B,0,7,30,30
1650765786739,MATH 109,A02,083214,Anzaldo; Leesa B,0,7,30,30
1650765786739,MATH 109,B01,083215,Anzaldo; Leesa B,0,8,30,30
1650765786739,MATH 109,B02,083216,Anzaldo; Leesa B,0,6,30,30
1650765792762,MATH 142A,A01,083219,Chow; Bennett,0,16,30,30
1650765792762,MATH 142A,A02,083220,Chow; Bennett,0,15,30,30
1650765792762,MATH 142A,B01,083221,Chow; Bennett,0,15,30,30
1650765792762,MATH 142A,B02,083222,Chow; Bennett,0,14,30,30
1650765798799,MATH 193A,A01,083224,Staff,0,5,30,30
1650765798799,MATH 193A,A02,083225,Staff,0,6,30,30
1650765798799,MATH 193A,A03,083781,Staff,0,6,30,30
1650765798799,MATH 193A,A04,083782,Staff,0,7,30,30
1650765804826,MATH 197,001,091859,McAuley; Julian John,9998,0,9999,1
1650765810879,COGS 9,A01,083615,Staff,1,17,60,59
1650765816914,COGS 11,A01,083617,Boyle; Mary E. T.,16,0,40,24
1650765822937,COGS 13,A01,083071,Staff,0,38,40,40
1650765828965,COGS 14A,A01,092681,Staff,0,36,100,100
1650765834989,COGS 14B,A01,083073,Cheng; Tzu-Han,1,13,50,49
1650765841012,COGS 17,A01,092677,Staff,11,0,75,64
1650765847046,COGS 100,A01,083619,Staff,0,29,60,60
1650765853070,COGS 101A,A01,083621,Davis; Joshua Daniel,0,28,60,60
1650765859096,COGS 101B,A01,091572,Staff,1,4,60,59
1650765865133,COGS 101C,A01,083625,Delgado; Tania,14,0,30,16
1650765871157,COGS 107A,A01,083627,Boyle; Mary E. T.,0,16,60,60
1650765877192,COGS 118A,A01,083075,Staff,0,8,60,60
1650765883228,CSE 3,A50,083646,Miranda; Gregory Joseph,18,0,38,20
1650765883228,CSE 3,A51,083647,Miranda; Gregory Joseph,36,0,37,1
1650765889253,CSE 8A,A50,083650,Miranda; Gregory Joseph,0,30,40,40
1650765895279,CSE 11,A01,083080,Cao; Yingjun,0,96,40,40
1650765901306,CSE 12,A01,083652,Staff,0,21,100,100
1650765907330,CSE 15L,A01,083654,Staff,0,3,50,50
1650765907330,CSE 15L,A02,083655,Staff,0,2,50,50
1650765913353,CSE 20,A01,083657,Staff,49,0,80,31
1650765919377,CSE 30,A01,083084,Eldon; John,0,76,40,40
1650765925402,CSE 100,A01,083659,Cao; Yingjun,0,71,50,50
1650765931430,CSE 134B,A01,083661,Powell; Thomas Allan,0,38,65,65
1650765937455,CSE 140,A01,083663,Staff,0,11,75,75
1650765943479,CSE 140L,A01,083088,Eldon; John,0,20,75,75
1650765949503,CSE 175,A01,083665,Kumar; Rakesh,7,0,25,18
1650765955538,CSE 190,A00,092507,Dubnov; Shlomo,10,0,20,10
1650765961585,ECE 45,A01,083139,Staff,1,2,60,59
1650765967609,ECE 65,A50,083695,Staff,0,5,30,30
1650765973641,ECE 109,A01,091882,Touri; Behrouz,32,0,70,38
1650765979665,ECE 180,A00,083140,Abi Samra; Nicholas Camill,20,0,30,10
1650765979665,ECE 180,B00,083141,Abi Samra; Nicholas Camill,0,0,30,30
1650765985690,MATH 10A,A01,083735,Patchell; Gregory David,2,0,30,28
1650765985690,MATH 10A,A02,083736,Patchell; Gregory David,27,0,30,3
1650765985690,MATH 10A,A03,083737,Patchell; Gregory David,24,0,30,6
1650765991718,MATH 10B,A01,083207,Staff,0,9,30,30
1650765991718,MATH 10B,A02,083208,Staff,1,7,30,29
1650765991718,MATH 10B,B01,083739,Staff,11,0,30,19
1650765991718,MATH 10B,B02,083740,Staff,28,0,30,2
1650765997747,MATH 18,A01,083743,Staff,0,0,30,30
1650765997747,MATH 18,A02,083744,Staff,23,0,30,7
1650765997747,MATH 18,A03,083745,Staff,21,0,30,9
1650765997747,MATH 18,A04,083746,Staff,26,0,30,4
1650765997747,MATH 18,B01,083748,Staff,0,15,30,30
1650765997747,MATH 18,B02,083749,Staff,0,12,30,30
1650765997747,MATH 18,B03,083750,Staff,0,12,30,30
1650765997747,MATH 18,B04,083751,Staff,0,12,30,30
1650766003774,MATH 20A,A01,083754,Staff,19,0,40,21
1650766009806,MATH 20B,A01,083756,Staff,0,13,30,30
1650766009806,MATH 20B,A02,083757,Staff,0,12,30,30
1650766015834,MATH 20C,A01,083760,Staff,0,16,30,30
1650766015834,MATH 20C,A02,083761,Staff,0,16,30,30
1650766015834,MATH 20C,B01,083762,Staff,9,0,30,21
1650766015834,MATH 20C,B02,083763,Staff,28,0,30,2
1650766021859,MATH 20D,A01,083765,Staff,2,1,30,28
1650766021859,MATH 20D,A02,083766,Staff,5,0,30,25
1650766021859,MATH 20D,A03,083767,Staff,24,0,30,6
1650766027889,MATH 20E,A01,083771,Staff,3,0,30,27
1650766027889,MATH 20E,A02,083772,Staff,16,0,30,14
1650766027889,MATH 20E,B01,083773,Staff,0,0,30,30
1650766027889,MATH 20E,B02,083774,Staff,5,0,30,25
1650766033919,MATH 103A,A01,083777,Staff,0,16,30,30
1650766033919,MATH 103A,A02,083778,Staff,0,15,30,30
1650766033919,MATH 103A,B01,083779,Staff,0,15,30,30
1650766033919,MATH 103A,B02,083780,Staff,0,15,30,30
1650766039945,MATH 105,A01,085443,Staff,0,22,30,30
1650766045975,MATH 109,A01,083213,Anzaldo; Leesa B,0,7,30,30
1650766045975,MATH 109,A02,083214,Anzaldo; Leesa B,0,7,30,30
1650766045975,MATH 109,B01,083215,Anzaldo; Leesa B,0,8,30,30
1650766045975,MATH 109,B02,083216,Anzaldo; Leesa B,0,6,30,30
1650766051999,MATH 142A,A01,083219,Chow; Bennett,0,16,30,30
1650766051999,MATH 142A,A02,083220,Chow; Bennett,0,15,30,30
1650766051999,MATH 142A,B01,083221,Chow; Bennett,0,15,30,30
1650766051999,MATH 142A,B02,083222,Chow; Bennett,0,14,30,30
1650766058035,MATH 193A,A01,083224,Staff,0,5,30,30
1650766058035,MATH 193A,A02,083225,Staff,0,6,30,30
1650766058035,MATH 193A,A03,083781,Staff,0,6,30,30
1650766058035,MATH 193A,A04,083782,Staff,0,7,30,30
1650766064057,MATH 197,001,091859,McAuley; Julian John,9998,0,9999,1
1650766070109,COGS 9,A01,083615,Staff,1,17,60,59
1650766076132,COGS 11,A01,083617,Boyle; Mary E. T.,16,0,40,24
1650766082158,COGS 13,A01,083071,Staff,0,38,40,40
1650766088201,COGS 14A,A01,092681,Staff,0,36,100,100
1650766094231,COGS 14B,A01,083073,Cheng; Tzu-Han,1,13,50,49
1650766100255,COGS 17,A01,092677,Staff,11,0,75,64
1650766106283,COGS 100,A01,083619,Staff,0,29,60,60
1650766112307,COGS 101A,A01,083621,Davis; Joshua Daniel,0,28,60,60
1650766118336,COGS 101B,A01,091572,Staff,1,4,60,59
1650766124360,COGS 101C,A01,083625,Delgado; Tania,14,0,30,16
1650766130386,COGS 107A,A01,083627,Boyle; Mary E. T.,0,16,60,60
1650766136410,COGS 118A,A01,083075,Staff,0,8,60,60
1650766142434,CSE 3,A50,083646,Miranda; Gregory Joseph,18,0,38,20
1650766142434,CSE 3,A51,083647,Miranda; Gregory Joseph,36,0,37,1
1650766148463,CSE 8A,A50,083650,Miranda; Gregory Joseph,0,30,40,40
1650766154488,CSE 11,A01,083080,Cao; Yingjun,0,96,40,40
1650766160511,CSE 12,A01,083652,Staff,0,21,100,100
1650766166535,CSE 15L,A01,083654,Staff,0,3,50,50
1650766166535,CSE 15L,A02,083655,Staff,0,2,50,50
1650766172560,CSE 20,A01,083657,Staff,49,0,80,31
1650766178584,CSE 30,A01,083084,Eldon; John,0,76,40,40
1650766184625,CSE 100,A01,083659,Cao; Yingjun,0,71,50,50
1650766190652,CSE 134B,A01,083661,Powell; Thomas Allan,0,38,65,65
1650766196686,CSE 140,A01,083663,Staff,0,11,75,75
1650766202800,CSE 140L,A01,083088,Eldon; John,0,20,75,75
1650766208824,CSE 175,A01,083665,Kumar; Rakesh,7,0,25,18
1650766214850,CSE 190,A00,092507,Dubnov; Shlomo,10,0,20,10
1650766220874,ECE 45,A01,083139,Staff,1,2,60,59
1650766226911,ECE 65,A50,083695,Staff,0,5,30,30
1650766232939,ECE 109,A01,091882,Touri; Behrouz,32,0,70,38
1650766238966,ECE 180,A00,083140,Abi Samra; Nicholas Camill,20,0,30,10
1650766238966,ECE 180,B00,083141,Abi Samra; Nicholas Camill,0,0,30,30
1650766244994,MATH 10A,A01,083735,Patchell; Gregory David,2,0,30,28
1650766244994,MATH 10A,A02,083736,Patchell; Gregory David,27,0,30,3
1650766244994,MATH 10A,A03,083737,Patchell; Gregory David,24,0,30,6
1650766251022,MATH 10B,A01,083207,Staff,0,9,30,30
1650766251022,MATH 10B,A02,083208,Staff,1,7,30,29
1650766251022,MATH 10B,B01,083739,Staff,11,0,30,19
1650766251022,MATH 10B,B02,083740,Staff,28,0,30,2
1650766257055,MATH 18,A01,083743,Staff,0,0,30,30
1650766257055,MATH 18,A02,083744,Staff,23,0,30,7
1650766257055,MATH 18,A03,083745,Staff,21,0,30,9
1650766257055,MATH 18,A04,083746,Staff,26,0,30,4
1650766257055,MATH 18,B01,083748,Staff,0,15,30,30
1650766257055,MATH 18,B02,083749,Staff,0,12,30,30
1650766257055,MATH 18,B03,083750,Staff,0,12,30,30
1650766257055,MATH 18,B04,083751,Staff,0,12,30,30
1650766263085,MATH 20A,A01,083754,Staff,19,0,40,21
1650766269110,MATH 20B,A01,083756,Staff,0,13,30,30
1650766269110,MATH 20B,A02,083757,Staff,0,12,30,30
1650766275138,MATH 20C,A01,083760,Staff,0,16,30,30
1650766275138,MATH 20C,A02,083761,Staff,0,16,30,30
1650766275138,MATH 20C,B01,083762,Staff,9,0,30,21
1650766275138,MATH 20C,B02,083763,Staff,28,0,30,2
1650766281165,MATH 20D,A01,083765,Staff,2,1,30,28
1650766281165,MATH 20D,A02,083766,Staff,5,0,30,25
1650766281165,MATH 20D,A03,083767,Staff,24,0,30,6
1650766294295,MATH 20E,A01,083771,Staff,3,0,30,27
1650766294295,MATH 20E,A02,083772,Staff,16,0,30,14
1650766294295,MATH 20E,B01,083773,Staff,0,0,30,30
1650766294295,MATH 20E,B02,083774,Staff,5,0,30,25
1650766300320,MATH 103A,A01,083777,Staff,0,16,30,30
1650766300320,MATH 103A,A02,083778,Staff,0,15,30,30
1650766300320,MATH 103A,B01,083779,Staff,0,15,30,30
1650766300320,MATH 103A,B02,083780,Staff,0,15,30,30
1650766306344,MATH 105,A01,085443,Staff,0,22,30,30
1650766312370,MATH 109,A01,083213,Anzaldo; Leesa B,0,7,30,30
1650766312370,MATH 109,A02,083214,Anzaldo; Leesa B,0,7,30,30
1650766312370,MATH 109,B01,083215,Anzaldo; Leesa B,0,8,30,30
1650766312370,MATH 109,B02,083216,Anzaldo; Leesa B,0,7,30,30
1650766318394,MATH 142A,A01,083219,Chow; Bennett,0,16,30,30
1650766318394,MATH 142A,A02,083220,Chow; Bennett,0,15,30,30
1650766318394,MATH 142A,B01,083221,Chow; Bennett,0,15,30,30
1650766318394,MATH 142A,B02,083222,Chow; Bennett,0,14,30,30
1650766324423,MATH 193A,A01,083224,Staff,0,5,30,30
1650766324423,MATH 193A,A02,083225,Staff,0,6,30,30
1650766324423,MATH 193A,A03,083781,Staff,0,6,30,30
1650766324423,MATH 193A,A04,083782,Staff,0,7,30,30
1650766330449,MATH 197,001,091859,McAuley; Julian John,9998,0,9999,1
1650766336503,COGS 9,A01,083615,Staff,1,17,60,59
1650766342526,COGS 11,A01,083617,Boyle; Mary E. T.,16,0,40,24
1650766348553,COGS 13,A01,083071,Staff,0,38,40,40
1650766354580,COGS 14A,A01,092681,Staff,0,36,100,100
1650766360608,COGS 14B,A01,083073,Cheng; Tzu-Han,1,13,50,49
1650766366631,COGS 17,A01,092677,Staff,11,0,75,64
1650766372654,COGS 100,A01,083619,Staff,0,29,60,60
1650766378678,COGS 101A,A01,083621,Davis; Joshua Daniel,0,28,60,60
1650766384701,COGS 101B,A01,091572,Staff,1,4,60,59
1650766390725,COGS 101C,A01,083625,Delgado; Tania,14,0,30,16
1650766396753,COGS 107A,A01,083627,Boyle; Mary E. T.,0,16,60,60
1650766402778,COGS 118A,A01,083075,Staff,0,8,60,60
1650766408802,CSE 3,A50,083646,Miranda; Gregory Joseph,18,0,38,20
1650766408802,CSE 3,A51,083647,Miranda; Gregory Joseph,36,0,37,1
1650766414827,CSE 8A,A50,083650,Miranda; Gregory Joseph,0,30,40,40
1650766420853,CSE 11,A01,083080,Cao; Yingjun,0,96,40,40
1650766426882,CSE 12,A01,083652,Staff,0,21,100,100
1650766432906,CSE 15L,A01,083654,Staff,0,3,50,50
1650766432906,CSE 15L,A02,083655,Staff,0,2,50,50
1650766438930,CSE 20,A01,083657,Staff,49,0,80,31
1650766444956,CSE 30,A01,083084,Eldon; John,0,76,40,40
1650766450983,CSE 100,A01,083659,Cao; Yingjun,0,71,50,50
1650766457009,CSE 134B,A01,083661,Powell; Thomas Allan,0,38,65,65
1650766463035,CSE 140,A01,083663,Staff,0,11,75,75
1650766469065,CSE 140L,A01,083088,Eldon; John,0,20,75,75
1650766475095,CSE 175,A01,083665,Kumar; Rakesh,7,0,25,18
1650766481119,CSE 190,A00,092507,Dubnov; Shlomo,10,0,20,10
1650766487143,ECE 45,A01,083139,Staff,1,2,60,59
1650766493167,ECE 65,A50,083695,Staff,0,5,30,30
1650766499190,ECE 109,A01,091882,Touri; Behrouz,32,0,70,38
1650766505216,ECE 180,A00,083140,Abi Samra; Nicholas Camill,20,0,30,10
1650766505216,ECE 180,B00,083141,Abi Samra; Nicholas Camill,0,0,30,30
1650766511242,MATH 10A,A01,083735,Patchell; Gregory David,2,0,30,28
1650766511242,MATH 10A,A02,083736,Patchell; Gregory David,27,0,30,3
1650766511242,MATH 10A,A03,083737,Patchell; Gregory David,24,0,30,6
1650766517267,MATH 10B,A01,083207,Staff,0,9,30,30
1650766517267,MATH 10B,A02,083208,Staff,1,7,30,29
1650766517267,MATH 10B,B01,083739,Staff,11,0,30,19
1650766517267,MATH 10B,B02,083740,Staff,28,0,30,2
1650766523294,MATH 18,A01,083743,Staff,0,0,30,30
1650766523294,MATH 18,A02,083744,Staff,23,0,30,7
1650766523294,MATH 18,A03,083745,Staff,21,0,30,9
1650766523294,MATH 18,A04,083746,Staff,26,0,30,4
1650766523294,MATH 18,B01,083748,Staff,0,15,30,30
1650766523294,MATH 18,B02,083749,Staff,0,12,30,30
1650766523294,MATH 18,B03,083750,Staff,0,12,30,30
1650766523294,MATH 18,B04,083751,Staff,0,12,30,30
1650766529324,MATH 20A,A01,083754,Staff,19,0,40,21
1650766535348,MATH 20B,A01,083756,Staff,0,13,30,30
1650766535348,MATH 20B,A02,083757,Staff,0,12,30,30
1650766541376,MATH 20C,A01,083760,Staff,0,16,30,30
1650766541376,MATH 20C,A02,083761,Staff,0,16,30,30
1650766541376,MATH 20C,B01,083762,Staff,9,0,30,21
1650766541376,MATH 20C,B02,083763,Staff,28,0,30,2
1650766547398,MATH 20D,A01,083765,Staff,2,1,30,28
1650766547398,MATH 20D,A02,083766,Staff,5,0,30,25
1650766547398,MATH 20D,A03,083767,Staff,24,0,30,6
1650766553424,MATH 20E,A01,083771,Staff,3,0,30,27
1650766553424,MATH 20E,A02,083772,Staff,16,0,30,14
1650766553424,MATH 20E,B01,083773,Staff,0,0,30,30
1650766553424,MATH 20E,B02,083774,Staff,5,0,30,25
1650766559452,MATH 103A,A01,083777,Staff,0,16,30,30
1650766559452,MATH 103A,A02,083778,Staff,0,15,30,30
1650766559452,MATH 103A,B01,083779,Staff,0,15,30,30
1650766559452,MATH 103A,B02,083780,Staff,0,15,30,30
1650766565479,MATH 105,A01,085443,Staff,0,22,30,30
1650766571503,MATH 109,A01,083213,Anzaldo; Leesa B,0,7,30,30
1650766571503,MATH 109,A02,083214,Anzaldo; Leesa B,0,7,30,30
1650766571503,MATH 109,B01,083215,Anzaldo; Leesa B,0,8,30,30
1650766571503,MATH 109,B02,083216,Anzaldo; Leesa B,0,7,30,30
1650766577533,MATH 142A,A01,083219,Chow; Bennett,0,16,30,30
1650766577533,MATH 142A,A02,083220,Chow; Bennett,0,15,30,30
1650766577533,MATH 142A,B01,083221,Chow; Bennett,0,15,30,30
1650766577533,MATH 142A,B02,083222,Chow; Bennett,0,14,30,30
1650766583558,MATH 193A,A01,083224,Staff,0,6,30,30
1650766583558,MATH 193A,A02,083225,Staff,0,6,30,30
1650766583558,MATH 193A,A03,083781,Staff,0,6,30,30
1650766583558,MATH 193A,A04,083782,Staff,0,7,30,30
1650766589582,MATH 197,001,091859,McAuley; Julian John,9998,0,9999,1
1650766595644,COGS 9,A01,083615,Staff,1,17,60,59
1650766601671,COGS 11,A01,083617,Boyle; Mary E. T.,16,0,40,24
1650766607696,COGS 13,A01,083071,Staff,0,38,40,40
1650766613724,COGS 14A,A01,092681,Staff,0,36,100,100
1650766619751,COGS 14B,A01,083073,Cheng; Tzu-Han,1,13,50,49
1650766625776,COGS 17,A01,092677,Staff,11,0,75,64
1650766631800,COGS 100,A01,083619,Staff,0,29,60,60
1650766637824,COGS 101A,A01,083621,Davis; Joshua Daniel,0,28,60,60
1650766643848,COGS 101B,A01,091572,Staff,1,4,60,59
1650766649880,COGS 101C,A01,083625,Delgado; Tania,14,0,30,16
1650766655901,COGS 107A,A01,083627,Boyle; Mary E. T.,0,16,60,60
1650766661925,COGS 118A,A01,083075,Staff,0,8,60,60
1650766667952,CSE 3,A50,083646,Miranda; Gregory Joseph,18,0,38,20
1650766667952,CSE 3,A51,083647,Miranda; Gregory Joseph,36,0,37,1
1650766673975,CSE 8A,A50,083650,Miranda; Gregory Joseph,0,30,40,40
1650766679999,CSE 11,A01,083080,Cao; Yingjun,0,96,40,40
1650766686027,CSE 12,A01,083652,Staff,0,21,100,100
1650766692054,CSE 15L,A01,083654,Staff,0,3,50,50
1650766692054,CSE 15L,A02,083655,Staff,0,2,50,50
1650766698085,CSE 20,A01,083657,Staff,49,0,80,31
1650766704108,CSE 30,A01,083084,Eldon; John,0,76,40,40
1650766710135,CSE 100,A01,083659,Cao; Yingjun,0,71,50,50
1650766716162,CSE 134B,A01,083661,Powell; Thomas Allan,0,38,65,65
1650766722186,CSE 140,A01,083663,Staff,0,11,75,75
1650766728210,CSE 140L,A01,083088,Eldon; John,0,20,75,75
1650766734234,CSE 175,A01,083665,Kumar; Rakesh,7,0,25,18
1650766740257,CSE 190,A00,092507,Dubnov; Shlomo,10,0,20,10
1650766746283,ECE 45,A01,083139,Staff,1,2,60,59
1650766752315,ECE 65,A50,083695,Staff,0,5,30,30
1650766758339,ECE 109,A01,091882,Touri; Behrouz,32,0,70,38
1650766764362,ECE 180,A00,083140,Abi Samra; Nicholas Camill,20,0,30,10
1650766764362,ECE 180,B00,083141,Abi Samra; Nicholas Camill,0,0,30,30
1650766770395,MATH 10A,A01,083735,Patchell; Gregory David,2,0,30,28
1650766770395,MATH 10A,A02,083736,Patchell; Gregory David,27,0,30,3
1650766770395,MATH 10A,A03,083737,Patchell; Gregory David,24,0,30,6
1650766776426,MATH 10B,A01,083207,Staff,0,9,30,30
1650766776426,MATH 10B,A02,083208,Staff,1,7,30,29
1650766776426,MATH 10B,B01,083739,Staff,11,0,30,19
1650766776426,MATH 10B,B02,083740,Staff,28,0,30,2
1650766782455,MATH 18,A01,083743,Staff,0,0,30,30
1650766782455,MATH 18,A02,083744,Staff,23,0,30,7
1650766782455,MATH 18,A03,083745,Staff,21,0,30,9
1650766782455,MATH 18,A04,083746,Staff,26,0,30,4
1650766782455,MATH 18,B01,083748,Staff,0,15,30,30
1650766782455,MATH 18,B02,083749,Staff,0,12,30,30
1650766782455,MATH 18,B03,083750,Staff,0,12,30,30
1650766782455,MATH 18,B04,083751,Staff,0,12,30,30
1650766788484,MATH 20A,A01,083754,Staff,19,0,40,21
1650766794507,MATH 20B,A01,083756,Staff,0,13,30,30
1650766794507,MATH 20B,A02,083757,Staff,0,12,30,30
1650766800545,MATH 20C,A01,083760,Staff,0,16,30,30
1650766800545,MATH 20C,A02,083761,Staff,0,16,30,30
1650766800545,MATH 20C,B01,083762,Staff,9,0,30,21
1650766800545,MATH 20C,B02,083763,Staff,28,0,30,2
1650766806667,MATH 20D,A01,083765,Staff,2,1,30,28
1650766806667,MATH 20D,A02,083766,Staff,5,0,30,25
1650766806667,MATH 20D,A03,083767,Staff,24,0,30,6
1650766812689,MATH 20E,A01,083771,Staff,3,0,30,27
1650766812689,MATH 20E,A02,083772,Staff,16,0,30,14
1650766812689,MATH 20E,B01,083773,Staff,0,0,30,30
1650766812689,MATH 20E,B02,083774,Staff,5,0,30,25
1650766818718,MATH 103A,A01,083777,Staff,0,16,30,30
1650766818718,MATH 103A,A02,083778,Staff,0,15,30,30
1650766818718,MATH 103A,B01,083779,Staff,0,15,30,30
1650766818718,MATH 103A,B02,083780,Staff,0,15,30,30
1650766824740,MATH 105,A01,085443,Staff,0,22,30,30
1650766830772,MATH 109,A01,083213,Anzaldo; Leesa B,0,7,30,30
1650766830772,MATH 109,A02,083214,Anzaldo; Leesa B,0,7,30,30
1650766830772,MATH 109,B01,083215,Anzaldo; Leesa B,0,8,30,30
1650766830772,MATH 109,B02,083216,Anzaldo; Leesa B,0,7,30,30
1650766836804,MATH 142A,A01,083219,Chow; Bennett,0,16,30,30
1650766836804,MATH 142A,A02,083220,Chow; Bennett,0,15,30,30
1650766836804,MATH 142A,B01,083221,Chow; Bennett,0,15,30,30
1650766836804,MATH 142A,B02,083222,Chow; Bennett,0,14,30,30
1650766842828,MATH 193A,A01,083224,Staff,0,6,30,30
1650766842828,MATH 193A,A02,083225,Staff,0,6,30,30
1650766842828,MATH 193A,A03,083781,Staff,0,6,30,30
1650766842828,MATH 193A,A04,083782,Staff,0,7,30,30
1650766848852,MATH 197,001,091859,McAuley; Julian John,9998,0,9999,1
1650766854912,COGS 9,A01,083615,Staff,1,17,60,59
1650766860938,COGS 11,A01,083617,Boyle; Mary E. T.,16,0,40,24
1650766866962,COGS 13,A01,083071,Staff,0,38,40,40
1650766872989,COGS 14A,A01,092681,Staff,0,36,100,100
1650766879021,COGS 14B,A01,083073,Cheng; Tzu-Han,1,13,50,49
1650766885045,COGS 17,A01,092677,Staff,11,0,75,64
1650766891070,COGS 100,A01,083619,Staff,0,29,60,60
1650766897098,COGS 101A,A01,083621,Davis; Joshua Daniel,0,28,60,60
1650766903124,COGS 101B,A01,091572,Staff,1,4,60,59
1650766909149,COGS 101C,A01,083625,Delgado; Tania,14,0,30,16
1650766915173,COGS 107A,A01,083627,Boyle; Mary E. T.,0,16,60,60
1650766921203,COGS 118A,A01,083075,Staff,0,8,60,60
1650766927226,CSE 3,A50,083646,Miranda; Gregory Joseph,18,0,38,20
1650766927226,CSE 3,A51,083647,Miranda; Gregory Joseph,36,0,37,1
1650766933260,CSE 8A,A50,083650,Miranda; Gregory Joseph,0,30,40,40
1650766939288,CSE 11,A01,083080,Cao; Yingjun,0,96,40,40
1650766945314,CSE 12,A01,083652,Staff,0,21,100,100
1650766951338,CSE 15L,A01,083654,Staff,0,3,50,50
1650766951338,CSE 15L,A02,083655,Staff,0,2,50,50
1650766957376,CSE 20,A01,083657,Staff,49,0,80,31
1650766963400,CSE 30,A01,083084,Eldon; John,0,76,40,40
1650766969423,CSE 100,A01,083659,Cao; Yingjun,0,71,50,50
1650766975448,CSE 134B,A01,083661,Powell; Thomas Allan,0,38,65,65
1650766981474,CSE 140,A01,083663,Staff,0,11,75,75
1650766987497,CSE 140L,A01,083088,Eldon; John,0,20,75,75
1650766993520,CSE 175,A01,083665,Kumar; Rakesh,7,0,25,18
1650766999543,CSE 190,A00,092507,Dubnov; Shlomo,10,0,20,10
1650767005572,ECE 45,A01,083139,Staff,1,2,60,59
1650767011595,ECE 65,A50,083695,Staff,0,5,30,30
1650767017619,ECE 109,A01,091882,Touri; Behrouz,32,0,70,38
1650767023647,ECE 180,A00,083140,Abi Samra; Nicholas Camill,20,0,30,10
1650767023647,ECE 180,B00,083141,Abi Samra; Nicholas Camill,0,0,30,30
1650767029678,MATH 10A,A01,083735,Patchell; Gregory David,2,0,30,28
1650767029678,MATH 10A,A02,083736,Patchell; Gregory David,27,0,30,3
1650767029678,MATH 10A,A03,083737,Patchell; Gregory David,24,0,30,6
1650767035713,MATH 10B,A01,083207,Staff,0,9,30,30
1650767035713,MATH 10B,A02,083208,Staff,1,7,30,29
1650767035713,MATH 10B,B01,083739,Staff,11,0,30,19
1650767035713,MATH 10B,B02,083740,Staff,28,0,30,2
1650767041759,MATH 18,A01,083743,Staff,0,0,30,30
1650767041759,MATH 18,A02,083744,Staff,23,0,30,7
1650767041759,MATH 18,A03,083745,Staff,21,0,30,9
1650767041759,MATH 18,A04,083746,Staff,26,0,30,4
1650767041759,MATH 18,B01,083748,Staff,0,15,30,30
1650767041759,MATH 18,B02,083749,Staff,0,12,30,30
1650767041759,MATH 18,B03,083750,Staff,0,12,30,30
1650767041759,MATH 18,B04,083751,Staff,0,12,30,30
1650767047783,MATH 20A,A01,083754,Staff,19,0,40,21
1650767053809,MATH 20B,A01,083756,Staff,0,13,30,30
1650767053809,MATH 20B,A02,083757,Staff,0,12,30,30
1650767059843,MATH 20C,A01,083760,Staff,0,16,30,30
1650767059843,MATH 20C,A02,083761,Staff,0,16,30,30
1650767059843,MATH 20C,B01,083762,Staff,9,0,30,21
1650767059843,MATH 20C,B02,083763,Staff,28,0,30,2
1650767065867,MATH 20D,A01,083765,Staff,2,1,30,28
1650767065867,MATH 20D,A02,083766,Staff,5,0,30,25
1650767065867,MATH 20D,A03,083767,Staff,24,0,30,6
1650767071891,MATH 20E,A01,083771,Staff,3,0,30,27
1650767071891,MATH 20E,A02,083772,Staff,16,0,30,14
1650767071891,MATH 20E,B01,083773,Staff,0,0,30,30
1650767071891,MATH 20E,B02,083774,Staff,5,0,30,25
1650767077921,MATH 103A,A01,083777,Staff,0,16,30,30
1650767077921,MATH 103A,A02,083778,Staff,0,15,30,30
1650767077921,MATH 103A,B01,083779,Staff,0,15,30,30
1650767077921,MATH 103A,B02,083780,Staff,0,15,30,30
1650767083944,MATH 105,A01,085443,Staff,0,22,30,30
1650767089973,MATH 109,A01,083213,Anzaldo; Leesa B,0,7,30,30
1650767089973,MATH 109,A02,083214,Anzaldo; Leesa B,0,7,30,30
1650767089973,MATH 109,B01,083215,Anzaldo; Leesa B,0,8,30,30
1650767089973,MATH 109,B02,083216,Anzaldo; Leesa B,0,7,30,30
1650767095999,MATH 142A,A01,083219,Chow; Bennett,0,16,30,30
1650767095999,MATH 142A,A02,083220,Chow; Bennett,0,15,30,30
1650767095999,MATH 142A,B01,083221,Chow; Bennett,0,15,30,30
1650767095999,MATH 142A,B02,083222,Chow; Bennett,0,14,30,30
1650767102037,MATH 193A,A01,083224,Staff,0,6,30,30
1650767102037,MATH 193A,A02,083225,Staff,0,6,30,30
1650767102037,MATH 193A,A03,083781,Staff,0,6,30,30
1650767102037,MATH 193A,A04,083782,Staff,0,7,30,30
1650767108062,MATH 197,001,091859,McAuley; Julian John,9998,0,9999,1
1650767114127,COGS 9,A01,083615,Staff,1,17,60,59
1650767120152,COGS 11,A01,083617,Boyle; Mary E. T.,16,0,40,24
1650767126176,COGS 13,A01,083071,Staff,0,38,40,40
1650767132204,COGS 14A,A01,092681,Staff,0,36,100,100
1650767138231,COGS 14B,A01,083073,Cheng; Tzu-Han,1,13,50,49
1650767144255,COGS 17,A01,092677,Staff,11,0,75,64
1650767150283,COGS 100,A01,083619,Staff,0,29,60,60
1650767156307,COGS 101A,A01,083621,Davis; Joshua Daniel,0,28,60,60
1650767162330,COGS 101B,A01,091572,Staff,1,4,60,59
1650767168358,COGS 101C,A01,083625,Delgado; Tania,14,0,30,16
1650767174386,COGS 107A,A01,083627,Boyle; Mary E. T.,0,16,60,60
1650767180410,COGS 118A,A01,083075,Staff,0,8,60,60
1650767186434,CSE 3,A50,083646,Miranda; Gregory Joseph,18,0,38,20
1650767186434,CSE 3,A51,083647,Miranda; Gregory Joseph,36,0,37,1
1650767192458,CSE 8A,A50,083650,Miranda; Gregory Joseph,0,30,40,40
1650767198482,CSE 11,A01,083080,Cao; Yingjun,0,96,40,40
1650767204506,CSE 12,A01,083652,Staff,0,21,100,100
1650767210530,CSE 15L,A01,083654,Staff,0,3,50,50
1650767210530,CSE 15L,A02,083655,Staff,0,2,50,50
1650767216558,CSE 20,A01,083657,Staff,49,0,80,31
1650767222592,CSE 30,A01,083084,Eldon; John,0,76,40,40
1650767228619,CSE 100,A01,083659,Cao; Yingjun,0,71,50,50
1650767234644,CSE 134B,A01,083661,Powell; Thomas Allan,0,38,65,65
1650767240668,CSE 140,A01,083663,Staff,0,11,75,75
1650767246701,CSE 140L,A01,083088,Eldon; John,0,20,75,75
1650767252725,CSE 175,A01,083665,Kumar; Rakesh,7,0,25,18
1650767258748,CSE 190,A00,092507,Dubnov; Shlomo,10,0,20,10
1650767264773,ECE 45,A01,083139,Staff,1,2,60,59
1650767270798,ECE 65,A50,083695,Staff,0,5,30,30
1650767276822,ECE 109,A01,091882,Touri; Behrouz,32,0,70,38
1650767282845,ECE 180,A00,083140,Abi Samra; Nicholas Camill,20,0,30,10
1650767282845,ECE 180,B00,083141,Abi Samra; Nicholas Camill,0,0,30,30
1650767288874,MATH 10A,A01,083735,Patchell; Gregory David,2,0,30,28
1650767288874,MATH 10A,A02,083736,Patchell; Gregory David,27,0,30,3
1650767288874,MATH 10A,A03,083737,Patchell; Gregory David,24,0,30,6
1650767294897,MATH 10B,A01,083207,Staff,0,9,30,30
1650767294897,MATH 10B,A02,083208,Staff,1,7,30,29
1650767294897,MATH 10B,B01,083739,Staff,11,0,30,19
1650767294897,MATH 10B,B02,083740,Staff,28,0,30,2
1650767300922,MATH 18,A01,083743,Staff,0,0,30,30
1650767300922,MATH 18,A02,083744,Staff,23,0,30,7
1650767300922,MATH 18,A03,083745,Staff,21,0,30,9
1650767300922,MATH 18,A04,083746,Staff,26,0,30,4
1650767300922,MATH 18,B01,083748,Staff,0,15,30,30
1650767300922,MATH 18,B02,083749,Staff,0,12,30,30
1650767300922,MATH 18,B03,083750,Staff,0,12,30,30
1650767300922,MATH 18,B04,083751,Staff,0,12,30,30
1650767306948,MATH 20A,A01,083754,Staff,19,0,40,21
1650767312972,MATH 20B,A01,083756,Staff,0,13,30,30
1650767312972,MATH 20B,A02,083757,Staff,0,12,30,30
1650767319000,MATH 20C,A01,083760,Staff,0,16,30,30
1650767319000,MATH 20C,A02,083761,Staff,0,16,30,30
1650767319000,MATH 20C,B01,083762,Staff,9,0,30,21
1650767319000,MATH 20C,B02,083763,Staff,28,0,30,2
1650767325028,MATH 20D,A01,083765,Staff,2,1,30,28
1650767325028,MATH 20D,A02,083766,Staff,5,0,30,25
1650767325028,MATH 20D,A03,083767,Staff,24,0,30,6
1650767331058,MATH 20E,A01,083771,Staff,3,0,30,27
1650767331058,MATH 20E,A02,083772,Staff,16,0,30,14
1650767331058,MATH 20E,B01,083773,Staff,0,0,30,30
1650767331058,MATH 20E,B02,083774,Staff,5,0,30,25
1650767337088,MATH 103A,A01,083777,Staff,0,16,30,30
1650767337088,MATH 103A,A02,083778,Staff,0,15,30,30
1650767337088,MATH 103A,B01,083779,Staff,0,15,30,30
1650767337088,MATH 103A,B02,083780,Staff,0,15,30,30
1650767343114,MATH 105,A01,085443,Staff,0,22,30,30
1650767349138,MATH 109,A01,083213,Anzaldo; Leesa B,0,7,30,30
1650767349138,MATH 109,A02,083214,Anzaldo; Leesa B,0,7,30,30
1650767349138,MATH 109,B01,083215,Anzaldo; Leesa B,0,8,30,30
1650767349138,MATH 109,B02,083216,Anzaldo; Leesa B,0,7,30,30
1650767355169,MATH 142A,A01,083219,Chow; Bennett,0,16,30,30
1650767355169,MATH 142A,A02,083220,Chow; Bennett,0,15,30,30
1650767355169,MATH 142A,B01,083221,Chow; Bennett,0,15,30,30
1650767355169,MATH 142A,B02,083222,Chow; Bennett,0,14,30,30
1650767361196,MATH 193A,A01,083224,Staff,0,6,30,30
1650767361196,MATH 193A,A02,083225,Staff,0,6,30,30
1650767361196,MATH 193A,A03,083781,Staff,0,6,30,30
1650767361196,MATH 193A,A04,083782,Staff,0,7,30,30
1650767367228,MATH 197,001,091859,McAuley; Julian John,9998,0,9999,1
1650767373279,COGS 9,A01,083615,Staff,1,17,60,59
1650767379304,COGS 11,A01,083617,Boyle; Mary E. T.,16,0,40,24
1650767385330,COGS 13,A01,083071,Staff,0,38,40,40
1650767391354,COGS 14A,A01,092681,Staff,0,36,100,100
1650767397500,COGS 14B,A01,083073,Cheng; Tzu-Han,1,13,50,49
1650767403524,COGS 17,A01,092677,Staff,11,0,75,64
1650767409546,COGS 100,A01,083619,Staff,0,29,60,60
1650767415574,COGS 101A,A01,083621,Davis; Joshua Daniel,0,28,60,60
1650767421614,COGS 101B,A01,091572,Staff,1,4,60,59
1650767427637,COGS 101C,A01,083625,Delgado; Tania,14,0,30,16
1650767433658,COGS 107A,A01,083627,Boyle; Mary E. T.,0,16,60,60
1650767439690,COGS 118A,A01,083075,Staff,0,8,60,60
1650767445714,CSE 3,A50,083646,Miranda; Gregory Joseph,18,0,38,20
1650767445714,CSE 3,A51,083647,Miranda; Gregory Joseph,36,0,37,1
1650767451737,CSE 8A,A50,083650,Miranda; Gregory Joseph,0,30,40,40
1650767457764,CSE 11,A01,083080,Cao; Yingjun,0,96,40,40
1650767463787,CSE 12,A01,083652,Staff,0,21,100,100
1650767469813,CSE 15L,A01,083654,Staff,0,3,50,50
1650767469813,CSE 15L,A02,083655,Staff,0,2,50,50
1650767475837,CSE 20,A01,083657,Staff,49,0,80,31
1650767481864,CSE 30,A01,083084,Eldon; John,0,76,40,40
1650767487887,CSE 100,A01,083659,Cao; Yingjun,0,71,50,50
1650767493908,CSE 134B,A01,083661,Powell; Thomas Allan,0,38,65,65
1650767499931,CSE 140,A01,083663,Staff,0,11,75,75
1650767505954,CSE 140L,A01,083088,Eldon; John,0,20,75,75
1650767511982,CSE 175,A01,083665,Kumar; Rakesh,7,0,25,18
1650767518005,CSE 190,A00,092507,Dubnov; Shlomo,10,0,20,10
1650767524029,ECE 45,A01,083139,Staff,1,2,60,59
1650767530054,ECE 65,A50,083695,Staff,0,5,30,30
1650767536087,ECE 109,A01,091882,Touri; Behrouz,32,0,70,38
1650767542121,ECE 180,A00,083140,Abi Samra; Nicholas Camill,20,0,30,10
1650767542121,ECE 180,B00,083141,Abi Samra; Nicholas Camill,0,0,30,30
1650767548148,MATH 10A,A01,083735,Patchell; Gregory David,2,0,30,28
1650767548148,MATH 10A,A02,083736,Patchell; Gregory David,27,0,30,3
1650767548148,MATH 10A,A03,083737,Patchell; Gregory David,24,0,30,6
1650767554173,MATH 10B,A01,083207,Staff,0,9,30,30
1650767554173,MATH 10B,A02,083208,Staff,1,7,30,29
1650767554173,MATH 10B,B01,083739,Staff,11,0,30,19
1650767554173,MATH 10B,B02,083740,Staff,28,0,30,2
1650767560198,MATH 18,A01,083743,Staff,0,0,30,30
1650767560198,MATH 18,A02,083744,Staff,23,0,30,7
1650767560198,MATH 18,A03,083745,Staff,21,0,30,9
1650767560198,MATH 18,A04,083746,Staff,26,0,30,4
1650767560198,MATH 18,B01,083748,Staff,0,15,30,30
1650767560198,MATH 18,B02,083749,Staff,0,12,30,30
1650767560198,MATH 18,B03,083750,Staff,0,12,30,30
1650767560198,MATH 18,B04,083751,Staff,0,12,30,30
1650767566225,MATH 20A,A01,083754,Staff,19,0,40,21
1650767572248,MATH 20B,A01,083756,Staff,0,13,30,30
1650767572248,MATH 20B,A02,083757,Staff,0,12,30,30
1650767578278,MATH 20C,A01,083760,Staff,0,16,30,30
1650767578278,MATH 20C,A02,083761,Staff,0,16,30,30
1650767578278,MATH 20C,B01,083762,Staff,9,0,30,21
1650767578278,MATH 20C,B02,083763,Staff,28,0,30,2
1650767584306,MATH 20D,A01,083765,Staff,2,1,30,28
1650767584306,MATH 20D,A02,083766,Staff,5,0,30,25
1650767584306,MATH 20D,A03,083767,Staff,24,0,30,6
1650767590334,MATH 20E,A01,083771,Staff,3,0,30,27
1650767590334,MATH 20E,A02,083772,Staff,16,0,30,14
1650767590334,MATH 20E,B01,083773,Staff,0,0,30,30
1650767590334,MATH 20E,B02,083774,Staff,5,0,30,25
1650767596358,MATH 103A,A01,083777,Staff,0,16,30,30
1650767596358,MATH 103A,A02,083778,Staff,0,15,30,30
1650767596358,MATH 103A,B01,083779,Staff,0,15,30,30
1650767596358,MATH 103A,B02,083780,Staff,0,15,30,30
1650767602382,MATH 105,A01,085443,Staff,0,22,30,30
1650767608411,MATH 109,A01,083213,Anzaldo; Leesa B,0,7,30,30
1650767608411,MATH 109,A02,083214,Anzaldo; Leesa B,0,7,30,30
1650767608411,MATH 109,B01,083215,Anzaldo; Leesa B,0,8,30,30
1650767608411,MATH 109,B02,083216,Anzaldo; Leesa B,0,7,30,30
1650767614436,MATH 142A,A01,083219,Chow; Bennett,0,16,30,30
1650767614436,MATH 142A,A02,083220,Chow; Bennett,0,15,30,30
1650767614436,MATH 142A,B01,083221,Chow; Bennett,0,15,30,30
1650767614436,MATH 142A,B02,083222,Chow; Bennett,0,14,30,30
1650767620460,MATH 193A,A01,083224,Staff,0,6,30,30
1650767620460,MATH 193A,A02,083225,Staff,0,6,30,30
1650767620460,MATH 193A,A03,083781,Staff,0,6,30,30
1650767620460,MATH 193A,A04,083782,Staff,0,7,30,30
1650767626483,MATH 197,001,091859,McAuley; Julian John,9998,0,9999,1
1650767632542,COGS 9,A01,083615,Staff,1,17,60,59
1650767638575,COGS 11,A01,083617,Boyle; Mary E. T.,16,0,40,24
1650767644602,COGS 13,A01,083071,Staff,0,38,40,40
1650767650629,COGS 14A,A01,092681,Staff,0,36,100,100
1650767656653,COGS 14B,A01,083073,Cheng; Tzu-Han,1,13,50,49
1650767662677,COGS 17,A01,092677,Staff,11,0,75,64
1650767668700,COGS 100,A01,083619,Staff,0,29,60,60
1650767674729,COGS 101A,A01,083621,Davis; Joshua Daniel,0,28,60,60
1650767680753,COGS 101B,A01,091572,Staff,1,4,60,59
1650767686777,COGS 101C,A01,083625,Delgado; Tania,14,0,30,16
1650767692803,COGS 107A,A01,083627,Boyle; Mary E. T.,0,16,60,60
1650767698835,COGS 118A,A01,083075,Staff,0,8,60,60
1650767704860,CSE 3,A50,083646,Miranda; Gregory Joseph,18,0,38,20
1650767704860,CSE 3,A51,083647,Miranda; Gregory Joseph,36,0,37,1
1650767710885,CSE 8A,A50,083650,Miranda; Gregory Joseph,0,30,40,40
1650767716911,CSE 11,A01,083080,Cao; Yingjun,0,96,40,40
1650767722935,CSE 12,A01,083652,Staff,0,21,100,100
1650767728959,CSE 15L,A01,083654,Staff,0,3,50,50
1650767728959,CSE 15L,A02,083655,Staff,0,2,50,50
1650767734985,CSE 20,A01,083657,Staff,49,0,80,31
1650767741008,CSE 30,A01,083084,Eldon; John,0,76,40,40
1650767747031,CSE 100,A01,083659,Cao; Yingjun,0,71,50,50
1650767753053,CSE 134B,A01,083661,Powell; Thomas Allan,0,38,65,65
1650767759081,CSE 140,A01,083663,Staff,0,11,75,75
1650767765105,CSE 140L,A01,083088,Eldon; John,0,20,75,75
1650767771131,CSE 175,A01,083665,Kumar; Rakesh,7,0,25,18
1650767777155,CSE 190,A00,092507,Dubnov; Shlomo,10,0,20,10
1650767783182,ECE 45,A01,083139,Staff,1,2,60,59
1650767789207,ECE 65,A50,083695,Staff,0,5,30,30
1650767795234,ECE 109,A01,091882,Touri; Behrouz,32,0,70,38
1650767801261,ECE 180,A00,083140,Abi Samra; Nicholas Camill,20,0,30,10
1650767801261,ECE 180,B00,083141,Abi Samra; Nicholas Camill,0,0,30,30
1650767807288,MATH 10A,A01,083735,Patchell; Gregory David,2,0,30,28
1650767807288,MATH 10A,A02,083736,Patchell; Gregory David,27,0,30,3
1650767807288,MATH 10A,A03,083737,Patchell; Gregory David,24,0,30,6
1650767813319,MATH 10B,A01,083207,Staff,0,9,30,30
1650767813319,MATH 10B,A02,083208,Staff,1,7,30,29
1650767813319,MATH 10B,B01,083739,Staff,11,0,30,19
1650767813319,MATH 10B,B02,083740,Staff,28,0,30,2
1650767819361,MATH 18,A01,083743,Staff,0,0,30,30
1650767819361,MATH 18,A02,083744,Staff,23,0,30,7
1650767819361,MATH 18,A03,083745,Staff,21,0,30,9
1650767819361,MATH 18,A04,083746,Staff,26,0,30,4
1650767819361,MATH 18,B01,083748,Staff,0,15,30,30
1650767819361,MATH 18,B02,083749,Staff,0,12,30,30
1650767819361,MATH 18,B03,083750,Staff,0,12,30,30
1650767819361,MATH 18,B04,083751,Staff,0,12,30,30
1650767825395,MATH 20A,A01,083754,Staff,19,0,40,21
1650767831422,MATH 20B,A01,083756,Staff,0,13,30,30
1650767831422,MATH 20B,A02,083757,Staff,0,12,30,30
1650767837450,MATH 20C,A01,083760,Staff,0,16,30,30
1650767837450,MATH 20C,A02,083761,Staff,0,16,30,30
1650767837450,MATH 20C,B01,083762,Staff,9,0,30,21
1650767837450,MATH 20C,B02,083763,Staff,28,0,30,2
1650767843475,MATH 20D,A01,083765,Staff,2,1,30,28
1650767843475,MATH 20D,A02,083766,Staff,5,0,30,25
1650767843475,MATH 20D,A03,083767,Staff,24,0,30,6
1650767849500,MATH 20E,A01,083771,Staff,3,0,30,27
1650767849500,MATH 20E,A02,083772,Staff,16,0,30,14
1650767849500,MATH 20E,B01,083773,Staff,0,0,30,30
1650767849500,MATH 20E,B02,083774,Staff,5,0,30,25
1650767855529,MATH 103A,A01,083777,Staff,0,16,30,30
1650767855529,MATH 103A,A02,083778,Staff,0,15,30,30
1650767855529,MATH 103A,B01,083779,Staff,0,15,30,30
1650767855529,MATH 103A,B02,083780,Staff,0,15,30,30
1650767861553,MATH 105,A01,085443,Staff,0,22,30,30
1650767867577,MATH 109,A01,083213,Anzaldo; Leesa B,0,7,30,30
1650767867577,MATH 109,A02,083214,Anzaldo; Leesa B,0,7,30,30
1650767867577,MATH 109,B01,083215,Anzaldo; Leesa B,0,8,30,30
1650767867577,MATH 109,B02,083216,Anzaldo; Leesa B,0,7,30,30
1650767873601,MATH 142A,A01,083219,Chow; Bennett,0,16,30,30
1650767873601,MATH 142A,A02,083220,Chow; Bennett,0,15,30,30
1650767873601,MATH 142A,B01,083221,Chow; Bennett,0,15,30,30
1650767873601,MATH 142A,B02,083222,Chow; Bennett,0,14,30,30
1650767879646,MATH 193A,A01,083224,Staff,0,6,30,30
1650767879646,MATH 193A,A02,083225,Staff,0,6,30,30
1650767879646,MATH 193A,A03,083781,Staff,0,6,30,30
1650767879646,MATH 193A,A04,083782,Staff,0,7,30,30
1650767885675,MATH 197,001,091859,McAuley; Julian John,9998,0,9999,1
1650767891735,COGS 9,A01,083615,Staff,1,17,60,59
1650767897772,COGS 11,A01,083617,Boyle; Mary E. T.,16,0,40,24
1650767903796,COGS 13,A01,083071,Staff,0,38,40,40
1650767909826,COGS 14A,A01,092681,Staff,0,36,100,100
1650767915852,COGS 14B,A01,083073,Cheng; Tzu-Han,1,13,50,49
1650767921879,COGS 17,A01,092677,Staff,11,0,75,64
1650767927906,COGS 100,A01,083619,Staff,0,29,60,60
1650767933934,COGS 101A,A01,083621,Davis; Joshua Daniel,0,28,60,60
1650767939962,COGS 101B,A01,091572,Staff,1,4,60,59
1650767945986,COGS 101C,A01,083625,Delgado; Tania,14,0,30,16
1650767952009,COGS 107A,A01,083627,Boyle; Mary E. T.,0,16,60,60
1650767958033,COGS 118A,A01,083075,Staff,0,8,60,60
1650767964057,CSE 3,A50,083646,Miranda; Gregory Joseph,18,0,38,20
1650767964057,CSE 3,A51,083647,Miranda; Gregory Joseph,36,0,37,1
1650767970081,CSE 8A,A50,083650,Miranda; Gregory Joseph,0,30,40,40
1650767976114,CSE 11,A01,083080,Cao; Yingjun,0,96,40,40
1650767982142,CSE 12,A01,083652,Staff,0,21,100,100
1650767988166,CSE 15L,A01,083654,Staff,0,3,50,50
1650767988166,CSE 15L,A02,083655,Staff,0,2,50,50
1650767994283,CSE 20,A01,083657,Staff,49,0,80,31
1650768000308,CSE 30,A01,083084,Eldon; John,0,76,40,40
1650768006333,CSE 100,A01,083659,Cao; Yingjun,0,71,50,50
1650768012357,CSE 134B,A01,083661,Powell; Thomas Allan,0,38,65,65
1650768018382,CSE 140,A01,083663,Staff,0,11,75,75
1650768024405,CSE 140L,A01,083088,Eldon; John,0,20,75,75
1650768030437,CSE 175,A01,083665,Kumar; Rakesh,7,0,25,18
1650768036463,CSE 190,A00,092507,Dubnov; Shlomo,10,0,20,10
1650768042487,ECE 45,A01,083139,Staff,1,2,60,59
1650768048511,ECE 65,A50,083695,Staff,0,5,30,30
1650768054534,ECE 109,A01,091882,Touri; Behrouz,32,0,70,38
1650768060557,ECE 180,A00,083140,Abi Samra; Nicholas Camill,20,0,30,10
1650768060557,ECE 180,B00,083141,Abi Samra; Nicholas Camill,0,0,30,30
1650768066580,MATH 10A,A01,083735,Patchell; Gregory David,2,0,30,28
1650768066580,MATH 10A,A02,083736,Patchell; Gregory David,27,0,30,3
1650768066580,MATH 10A,A03,083737,Patchell; Gregory David,24,0,30,6
1650768072603,MATH 10B,A01,083207,Staff,0,9,30,30
1650768072603,MATH 10B,A02,083208,Staff,1,7,30,29
1650768072603,MATH 10B,B01,083739,Staff,11,0,30,19
1650768072603,MATH 10B,B02,083740,Staff,28,0,30,2
1650768078634,MATH 18,A01,083743,Staff,0,0,30,30
1650768078634,MATH 18,A02,083744,Staff,23,0,30,7
1650768078634,MATH 18,A03,083745,Staff,21,0,30,9
1650768078634,MATH 18,A04,083746,Staff,26,0,30,4
1650768078634,MATH 18,B01,083748,Staff,0,15,30,30
1650768078634,MATH 18,B02,083749,Staff,0,12,30,30
1650768078634,MATH 18,B03,083750,Staff,0,12,30,30
1650768078634,MATH 18,B04,083751,Staff,0,12,30,30
1650768084663,MATH 20A,A01,083754,Staff,19,0,40,21
1650768090688,MATH 20B,A01,083756,Staff,0,13,30,30
1650768090688,MATH 20B,A02,083757,Staff,0,12,30,30
1650768096716,MATH 20C,A01,083760,Staff,0,16,30,30
1650768096716,MATH 20C,A02,083761,Staff,0,16,30,30
1650768096716,MATH 20C,B01,083762,Staff,9,0,30,21
1650768096716,MATH 20C,B02,083763,Staff,28,0,30,2
1650768102740,MATH 20D,A01,083765,Staff,2,1,30,28
1650768102740,MATH 20D,A02,083766,Staff,5,0,30,25
1650768102740,MATH 20D,A03,083767,Staff,24,0,30,6
1650768108774,MATH 20E,A01,083771,Staff,3,0,30,27
1650768108774,MATH 20E,A02,083772,Staff,16,0,30,14
1650768108774,MATH 20E,B01,083773,Staff,0,0,30,30
1650768108774,MATH 20E,B02,083774,Staff,5,0,30,25
1650768114797,MATH 103A,A01,083777,Staff,0,16,30,30
1650768114797,MATH 103A,A02,083778,Staff,0,15,30,30
1650768114797,MATH 103A,B01,083779,Staff,0,15,30,30
1650768114797,MATH 103A,B02,083780,Staff,0,15,30,30
1650768120819,MATH 105,A01,085443,Staff,0,22,30,30
1650768126844,MATH 109,A01,083213,Anzaldo; Leesa B,0,7,30,30
1650768126844,MATH 109,A02,083214,Anzaldo; Leesa B,0,7,30,30
1650768126844,MATH 109,B01,083215,Anzaldo; Leesa B,0,8,30,30
1650768126844,MATH 109,B02,083216,Anzaldo; Leesa B,0,7,30,30
1650768132873,MATH 142A,A01,083219,Chow; Bennett,0,16,30,30
1650768132873,MATH 142A,A02,083220,Chow; Bennett,0,15,30,30
1650768132873,MATH 142A,B01,083221,Chow; Bennett,0,15,30,30
1650768132873,MATH 142A,B02,083222,Chow; Bennett,0,14,30,30
1650768138910,MATH 193A,A01,083224,Staff,0,6,30,30
1650768138910,MATH 193A,A02,083225,Staff,0,6,30,30
1650768138910,MATH 193A,A03,083781,Staff,0,6,30,30
1650768138910,MATH 193A,A04,083782,Staff,0,7,30,30
1650768144935,MATH 197,001,091859,McAuley; Julian John,9998,0,9999,1
1650768151068,COGS 9,A01,083615,Staff,1,17,60,59
1650768157092,COGS 11,A01,083617,Boyle; Mary E. T.,16,0,40,24
1650768163120,COGS 13,A01,083071,Staff,0,38,40,40
1650768169151,COGS 14A,A01,092681,Staff,0,36,100,100
1650768175183,COGS 14B,A01,083073,Cheng; Tzu-Han,1,13,50,49
1650768181210,COGS 17,A01,092677,Staff,11,0,75,64
1650768187233,COGS 100,A01,083619,Staff,0,29,60,60
1650768193256,COGS 101A,A01,083621,Davis; Joshua Daniel,0,28,60,60
1650768199282,COGS 101B,A01,091572,Staff,1,4,60,59
1650768205308,COGS 101C,A01,083625,Delgado; Tania,14,0,30,16
1650768211332,COGS 107A,A01,083627,Boyle; Mary E. T.,0,16,60,60
1650768217356,COGS 118A,A01,083075,Staff,0,8,60,60
1650768223380,CSE 3,A50,083646,Miranda; Gregory Joseph,18,0,38,20
1650768223380,CSE 3,A51,083647,Miranda; Gregory Joseph,36,0,37,1
1650768229409,CSE 8A,A50,083650,Miranda; Gregory Joseph,0,30,40,40
1650768235447,CSE 11,A01,083080,Cao; Yingjun,0,96,40,40
1650768241474,CSE 12,A01,083652,Staff,0,21,100,100
1650768247499,CSE 15L,A01,083654,Staff,0,3,50,50
1650768247499,CSE 15L,A02,083655,Staff,0,2,50,50
1650768253525,CSE 20,A01,083657,Staff,49,0,80,31
1650768259551,CSE 30,A01,083084,Eldon; John,0,76,40,40
1650768265577,CSE 100,A01,083659,Cao; Yingjun,0,71,50,50
1650768271600,CSE 134B,A01,083661,Powell; Thomas Allan,0,38,65,65
1650768277636,CSE 140,A01,083663,Staff,0,11,75,75
1650768283681,CSE 140L,A01,083088,Eldon; John,0,20,75,75
1650768289707,CSE 175,A01,083665,Kumar; Rakesh,7,0,25,18
1650768295728,CSE 190,A00,092507,Dubnov; Shlomo,10,0,20,10
1650768301753,ECE 45,A01,083139,Staff,1,2,60,59
1650768307793,ECE 65,A50,083695,Staff,0,5,30,30
1650768313819,ECE 109,A01,091882,Touri; Behrouz,32,0,70,38
1650768319841,ECE 180,A00,083140,Abi Samra; Nicholas Camill,20,0,30,10
1650768319841,ECE 180,B00,083141,Abi Samra; Nicholas Camill,0,0,30,30
1650768325870,MATH 10A,A01,083735,Patchell; Gregory David,2,0,30,28
1650768325870,MATH 10A,A02,083736,Patchell; Gregory David,27,0,30,3
1650768325870,MATH 10A,A03,083737,Patchell; Gregory David,24,0,30,6
1650768331897,MATH 10B,A01,083207,Staff,0,9,30,30
1650768331897,MATH 10B,A02,083208,Staff,1,7,30,29
1650768331897,MATH 10B,B01,083739,Staff,11,0,30,19
1650768331897,MATH 10B,B02,083740,Staff,28,0,30,2
1650768337925,MATH 18,A01,083743,Staff,0,0,30,30
1650768337925,MATH 18,A02,083744,Staff,23,0,30,7
1650768337925,MATH 18,A03,083745,Staff,21,0,30,9
1650768337925,MATH 18,A04,083746,Staff,26,0,30,4
1650768337925,MATH 18,B01,083748,Staff,0,15,30,30
1650768337925,MATH 18,B02,083749,Staff,0,12,30,30
1650768337925,MATH 18,B03,083750,Staff,0,12,30,30
1650768337925,MATH 18,B04,083751,Staff,0,12,30,30
1650768343953,MATH 20A,A01,083754,Staff,19,0,40,21
1650768349987,MATH 20B,A01,083756,Staff,0,13,30,30
1650768349987,MATH 20B,A02,083757,Staff,0,12,30,30
1650768356012,MATH 20C,A01,083760,Staff,0,16,30,30
1650768356012,MATH 20C,A02,083761,Staff,0,16,30,30
1650768356012,MATH 20C,B01,083762,Staff,9,0,30,21
1650768356012,MATH 20C,B02,083763,Staff,28,0,30,2
1650768362040,MATH 20D,A01,083765,Staff,2,1,30,28
1650768362040,MATH 20D,A02,083766,Staff,5,0,30,25
1650768362040,MATH 20D,A03,083767,Staff,24,0,30,6
1650768368064,MATH 20E,A01,083771,Staff,3,0,30,27
1650768368064,MATH 20E,A02,083772,Staff,16,0,30,14
1650768368064,MATH 20E,B01,083773,Staff,0,0,30,30
1650768368064,MATH 20E,B02,083774,Staff,5,0,30,25
1650768374093,MATH 103A,A01,083777,Staff,0,16,30,30
1650768374093,MATH 103A,A02,083778,Staff,0,15,30,30
1650768374093,MATH 103A,B01,083779,Staff,0,15,30,30
1650768374093,MATH 103A,B02,083780,Staff,0,15,30,30
1650768380135,MATH 105,A01,085443,Staff,0,22,30,30
1650768386173,MATH 109,A01,083213,Anzaldo; Leesa B,0,7,30,30
1650768386173,MATH 109,A02,083214,Anzaldo; Leesa B,0,7,30,30
1650768386173,MATH 109,B01,083215,Anzaldo; Leesa B,0,8,30,30
1650768386173,MATH 109,B02,083216,Anzaldo; Leesa B,0,7,30,30
1650768392202,MATH 142A,A01,083219,Chow; Bennett,0,16,30,30
1650768392202,MATH 142A,A02,083220,Chow; Bennett,0,15,30,30
1650768392202,MATH 142A,B01,083221,Chow; Bennett,0,15,30,30
1650768392202,MATH 142A,B02,083222,Chow; Bennett,0,14,30,30
1650768398229,MATH 193A,A01,083224,Staff,0,6,30,30
1650768398229,MATH 193A,A02,083225,Staff,0,6,30,30
1650768398229,MATH 193A,A03,083781,Staff,0,6,30,30
1650768398229,MATH 193A,A04,083782,Staff,0,7,30,30
1650768404254,MATH 197,001,091859,McAuley; Julian John,9998,0,9999,1
1650768410310,COGS 9,A01,083615,Staff,1,17,60,59
1650768416336,COGS 11,A01,083617,Boyle; Mary E. T.,16,0,40,24
1650768422372,COGS 13,A01,083071,Staff,0,38,40,40
1650768428394,COGS 14A,A01,092681,Staff,0,36,100,100
1650768434421,COGS 14B,A01,083073,Cheng; Tzu-Han,1,13,50,49
1650768440444,COGS 17,A01,092677,Staff,11,0,75,64
1650768446468,COGS 100,A01,083619,Staff,0,29,60,60
1650768452496,COGS 101A,A01,083621,Davis; Joshua Daniel,0,28,60,60
1650768458530,COGS 101B,A01,091572,Staff,1,4,60,59
1650768464561,COGS 101C,A01,083625,Delgado; Tania,14,0,30,16
1650768470604,COGS 107A,A01,083627,Boyle; Mary E. T.,0,16,60,60
1650768476625,COGS 118A,A01,083075,Staff,0,8,60,60
1650768482656,CSE 3,A50,083646,Miranda; Gregory Joseph,18,0,38,20
1650768482656,CSE 3,A51,083647,Miranda; Gregory Joseph,36,0,37,1
1650768488695,CSE 8A,A50,083650,Miranda; Gregory Joseph,0,30,40,40
1650768494726,CSE 11,A01,083080,Cao; Yingjun,0,96,40,40
1650768500752,CSE 12,A01,083652,Staff,0,21,100,100
1650768506777,CSE 15L,A01,083654,Staff,0,3,50,50
1650768506777,CSE 15L,A02,083655,Staff,0,2,50,50
1650768512799,CSE 20,A01,083657,Staff,49,0,80,31
1650768518824,CSE 30,A01,083084,Eldon; John,0,76,40,40
1650768524846,CSE 100,A01,083659,Cao; Yingjun,0,71,50,50
1650768530880,CSE 134B,A01,083661,Powell; Thomas Allan,0,38,65,65
1650768536907,CSE 140,A01,083663,Staff,0,11,75,75
1650768542937,CSE 140L,A01,083088,Eldon; John,0,20,75,75
1650768548961,CSE 175,A01,083665,Kumar; Rakesh,7,0,25,18
1650768554985,CSE 190,A00,092507,Dubnov; Shlomo,10,0,20,10
1650768561009,ECE 45,A01,083139,Staff,1,2,60,59
1650768567032,ECE 65,A50,083695,Staff,0,5,30,30
1650768573057,ECE 109,A01,091882,Touri; Behrouz,32,0,70,38
1650768579081,ECE 180,A00,083140,Abi Samra; Nicholas Camill,20,0,30,10
1650768579081,ECE 180,B00,083141,Abi Samra; Nicholas Camill,0,0,30,30
1650768585108,MATH 10A,A01,083735,Patchell; Gregory David,2,0,30,28
1650768585108,MATH 10A,A02,083736,Patchell; Gregory David,27,0,30,3
1650768585108,MATH 10A,A03,083737,Patchell; Gregory David,24,0,30,6
1650768591221,MATH 10B,A01,083207,Staff,0,9,30,30
1650768591221,MATH 10B,A02,083208,Staff,1,7,30,29
1650768591221,MATH 10B,B01,083739,Staff,11,0,30,19
1650768591221,MATH 10B,B02,083740,Staff,28,0,30,2
1650768597247,MATH 18,A01,083743,Staff,0,0,30,30
1650768597247,MATH 18,A02,083744,Staff,23,0,30,7
1650768597247,MATH 18,A03,083745,Staff,21,0,30,9
1650768597247,MATH 18,A04,083746,Staff,26,0,30,4
1650768597247,MATH 18,B01,083748,Staff,0,15,30,30
1650768597247,MATH 18,B02,083749,Staff,0,12,30,30
1650768597247,MATH 18,B03,083750,Staff,0,12,30,30
1650768597247,MATH 18,B04,083751,Staff,0,12,30,30
1650768603273,MATH 20A,A01,083754,Staff,19,0,40,21
1650768609301,MATH 20B,A01,083756,Staff,0,13,30,30
1650768609301,MATH 20B,A02,083757,Staff,0,12,30,30
1650768615327,MATH 20C,A01,083760,Staff,0,16,30,30
1650768615327,MATH 20C,A02,083761,Staff,0,16,30,30
1650768615327,MATH 20C,B01,083762,Staff,9,0,30,21
1650768615327,MATH 20C,B02,083763,Staff,28,0,30,2
1650768621353,MATH 20D,A01,083765,Staff,2,1,30,28
1650768621353,MATH 20D,A02,083766,Staff,5,0,30,25
1650768621353,MATH 20D,A03,083767,Staff,24,0,30,6
1650768627379,MATH 20E,A01,083771,Staff,3,0,30,27
1650768627379,MATH 20E,A02,083772,Staff,16,0,30,14
1650768627379,MATH 20E,B01,083773,Staff,0,0,30,30
1650768627379,MATH 20E,B02,083774,Staff,5,0,30,25
1650768633406,MATH 103A,A01,083777,Staff,0,16,30,30
1650768633406,MATH 103A,A02,083778,Staff,0,15,30,30
1650768633406,MATH 103A,B01,083779,Staff,0,15,30,30
1650768633406,MATH 103A,B02,083780,Staff,0,15,30,30
1650768639435,MATH 105,A01,085443,Staff,0,22,30,30
1650768645469,MATH 109,A01,083213,Anzaldo; Leesa B,0,7,30,30
1650768645469,MATH 109,A02,083214,Anzaldo; Leesa B,0,7,30,30
1650768645469,MATH 109,B01,083215,Anzaldo; Leesa B,0,8,30,30
1650768645469,MATH 109,B02,083216,Anzaldo; Leesa B,0,7,30,30
1650768651495,MATH 142A,A01,083219,Chow; Bennett,0,16,30,30
1650768651495,MATH 142A,A02,083220,Chow; Bennett,0,15,30,30
1650768651495,MATH 142A,B01,083221,Chow; Bennett,0,15,30,30
1650768651495,MATH 142A,B02,083222,Chow; Bennett,0,14,30,30
1650768657521,MATH 193A,A01,083224,Staff,0,6,30,30
1650768657521,MATH 193A,A02,083225,Staff,0,6,30,30
1650768657521,MATH 193A,A03,083781,Staff,0,6,30,30
1650768657521,MATH 193A,A04,083782,Staff,0,7,30,30
1650768663547,MATH 197,001,091859,McAuley; Julian John,9998,0,9999,1
1650768669607,COGS 9,A01,083615,Staff,1,17,60,59
1650768675633,COGS 11,A01,083617,Boyle; Mary E. T.,16,0,40,24
1650768681657,COGS 13,A01,083071,Staff,0,38,40,40
1650768687681,COGS 14A,A01,092681,Staff,0,36,100,100
1650768693708,COGS 14B,A01,083073,Cheng; Tzu-Han,1,13,50,49
1650768699732,COGS 17,A01,092677,Staff,11,0,75,64
1650768705758,COGS 100,A01,083619,Staff,0,29,60,60
1650768711785,COGS 101A,A01,083621,Davis; Joshua Daniel,0,28,60,60
1650768717811,COGS 101B,A01,091572,Staff,1,4,60,59
1650768723835,COGS 101C,A01,083625,Delgado; Tania,14,0,30,16
1650768729860,COGS 107A,A01,083627,Boyle; Mary E. T.,0,16,60,60
1650768735888,COGS 118A,A01,083075,Staff,0,8,60,60
1650768741915,CSE 3,A50,083646,Miranda; Gregory Joseph,18,0,38,20
1650768741915,CSE 3,A51,083647,Miranda; Gregory Joseph,36,0,37,1
1650768747940,CSE 8A,A50,083650,Miranda; Gregory Joseph,0,30,40,40
1650768753968,CSE 11,A01,083080,Cao; Yingjun,0,96,40,40
1650768759992,CSE 12,A01,083652,Staff,0,21,100,100
1650768766019,CSE 15L,A01,083654,Staff,0,3,50,50
1650768766019,CSE 15L,A02,083655,Staff,0,2,50,50
1650768772045,CSE 20,A01,083657,Staff,49,0,80,31
1650768778072,CSE 30,A01,083084,Eldon; John,0,76,40,40
1650768784093,CSE 100,A01,083659,Cao; Yingjun,0,71,50,50
1650768790118,CSE 134B,A01,083661,Powell; Thomas Allan,0,38,65,65
1650768796145,CSE 140,A01,083663,Staff,0,11,75,75
1650768802176,CSE 140L,A01,083088,Eldon; John,0,20,75,75
1650768808203,CSE 175,A01,083665,Kumar; Rakesh,7,0,25,18
1650768814226,CSE 190,A00,092507,Dubnov; Shlomo,10,0,20,10
1650768820254,ECE 45,A01,083139,Staff,1,2,60,59
1650768826287,ECE 65,A50,083695,Staff,0,5,30,30
1650768832310,ECE 109,A01,091882,Touri; Behrouz,32,0,70,38
1650768838335,ECE 180,A00,083140,Abi Samra; Nicholas Camill,20,0,30,10
1650768838335,ECE 180,B00,083141,Abi Samra; Nicholas Camill,0,0,30,30
1650768844364,MATH 10A,A01,083735,Patchell; Gregory David,2,0,30,28
1650768844364,MATH 10A,A02,083736,Patchell; Gregory David,27,0,30,3
1650768844364,MATH 10A,A03,083737,Patchell; Gregory David,24,0,30,6
1650768850391,MATH 10B,A01,083207,Staff,0,9,30,30
1650768850391,MATH 10B,A02,083208,Staff,1,7,30,29
1650768850391,MATH 10B,B01,083739,Staff,11,0,30,19
1650768850391,MATH 10B,B02,083740,Staff,28,0,30,2
1650768856431,MATH 18,A01,083743,Staff,0,0,30,30
1650768856431,MATH 18,A02,083744,Staff,23,0,30,7
1650768856431,MATH 18,A03,083745,Staff,21,0,30,9
1650768856431,MATH 18,A04,083746,Staff,26,0,30,4
1650768856431,MATH 18,B01,083748,Staff,0,15,30,30
1650768856431,MATH 18,B02,083749,Staff,0,12,30,30
1650768856431,MATH 18,B03,083750,Staff,0,12,30,30
1650768856431,MATH 18,B04,083751,Staff,0,12,30,30
1650768862460,MATH 20A,A01,083754,Staff,19,0,40,21
1650768868486,MATH 20B,A01,083756,Staff,0,13,30,30
1650768868486,MATH 20B,A02,083757,Staff,0,12,30,30
1650768874510,MATH 20C,A01,083760,Staff,0,16,30,30
1650768874510,MATH 20C,A02,083761,Staff,0,16,30,30
1650768874510,MATH 20C,B01,083762,Staff,9,0,30,21
1650768874510,MATH 20C,B02,083763,Staff,28,0,30,2
1650768880534,MATH 20D,A01,083765,Staff,2,1,30,28
1650768880534,MATH 20D,A02,083766,Staff,5,0,30,25
1650768880534,MATH 20D,A03,083767,Staff,24,0,30,6
1650768886563,MATH 20E,A01,083771,Staff,2,0,30,28
1650768886563,MATH 20E,A02,083772,Staff,16,0,30,14
1650768886563,MATH 20E,B01,083773,Staff,0,0,30,30
1650768886563,MATH 20E,B02,083774,Staff,5,0,30,25
1650768892591,MATH 103A,A01,083777,Staff,0,16,30,30
1650768892591,MATH 103A,A02,083778,Staff,0,15,30,30
1650768892591,MATH 103A,B01,083779,Staff,0,15,30,30
1650768892591,MATH 103A,B02,083780,Staff,0,15,30,30
1650768898626,MATH 105,A01,085443,Staff,0,22,30,30
1650768904652,MATH 109,A01,083213,Anzaldo; Leesa B,0,7,30,30
1650768904652,MATH 109,A02,083214,Anzaldo; Leesa B,0,7,30,30
1650768904652,MATH 109,B01,083215,Anzaldo; Leesa B,0,8,30,30
1650768904652,MATH 109,B02,083216,Anzaldo; Leesa B,0,7,30,30
1650768910676,MATH 142A,A01,083219,Chow; Bennett,0,16,30,30
1650768910676,MATH 142A,A02,083220,Chow; Bennett,0,15,30,30
1650768910676,MATH 142A,B01,083221,Chow; Bennett,0,15,30,30
1650768910676,MATH 142A,B02,083222,Chow; Bennett,0,14,30,30
1650768916704,MATH 193A,A01,083224,Staff,0,6,30,30
1650768916704,MATH 193A,A02,083225,Staff,0,6,30,30
1650768916704,MATH 193A,A03,083781,Staff,0,6,30,30
1650768916704,MATH 193A,A04,083782,Staff,0,7,30,30
1650768922730,MATH 197,001,091859,McAuley; Julian John,9998,0,9999,1
1650768928781,COGS 9,A01,083615,Staff,1,17,60,59
1650768934815,COGS 11,A01,083617,Boyle; Mary E. T.,16,0,40,24
1650768940843,COGS 13,A01,083071,Staff,0,38,40,40
1650768946870,COGS 14A,A01,092681,Staff,0,36,100,100
1650768952893,COGS 14B,A01,083073,Cheng; Tzu-Han,1,13,50,49
1650768958922,COGS 17,A01,092677,Staff,11,0,75,64
1650768964944,COGS 100,A01,083619,Staff,0,29,60,60
1650768970974,COGS 101A,A01,083621,Davis; Joshua Daniel,0,28,60,60
1650768977000,COGS 101B,A01,091572,Staff,1,4,60,59
1650768983024,COGS 101C,A01,083625,Delgado; Tania,14,0,30,16
1650768989051,COGS 107A,A01,083627,Boyle; Mary E. T.,0,16,60,60
1650768995078,COGS 118A,A01,083075,Staff,0,8,60,60
1650769001106,CSE 3,A50,083646,Miranda; Gregory Joseph,18,0,38,20
1650769001106,CSE 3,A51,083647,Miranda; Gregory Joseph,36,0,37,1
1650769007131,CSE 8A,A50,083650,Miranda; Gregory Joseph,0,30,40,40
1650769013154,CSE 11,A01,083080,Cao; Yingjun,0,96,40,40
1650769019177,CSE 12,A01,083652,Staff,0,21,100,100
1650769025202,CSE 15L,A01,083654,Staff,0,3,50,50
1650769025202,CSE 15L,A02,083655,Staff,0,2,50,50
1650769031225,CSE 20,A01,083657,Staff,49,0,80,31
1650769037267,CSE 30,A01,083084,Eldon; John,0,76,40,40
1650769043308,CSE 100,A01,083659,Cao; Yingjun,0,71,50,50
1650769049336,CSE 134B,A01,083661,Powell; Thomas Allan,0,38,65,65
1650769055360,CSE 140,A01,083663,Staff,0,11,75,75
1650769061384,CSE 140L,A01,083088,Eldon; John,0,20,75,75
1650769067408,CSE 175,A01,083665,Kumar; Rakesh,7,0,25,18
1650769073436,CSE 190,A00,092507,Dubnov; Shlomo,10,0,20,10
1650769079463,ECE 45,A01,083139,Staff,1,2,60,59
1650769085486,ECE 65,A50,083695,Staff,0,5,30,30
1650769091515,ECE 109,A01,091882,Touri; Behrouz,32,0,70,38
1650769097539,ECE 180,A00,083140,Abi Samra; Nicholas Camill,20,0,30,10
1650769097539,ECE 180,B00,083141,Abi Samra; Nicholas Camill,0,0,30,30
1650769103565,MATH 10A,A01,083735,Patchell; Gregory David,2,0,30,28
1650769103565,MATH 10A,A02,083736,Patchell; Gregory David,27,0,30,3
1650769103565,MATH 10A,A03,083737,Patchell; Gregory David,24,0,30,6
1650769109589,MATH 10B,A01,083207,Staff,0,9,30,30
1650769109589,MATH 10B,A02,083208,Staff,1,7,30,29
1650769109589,MATH 10B,B01,083739,Staff,11,0,30,19
1650769109589,MATH 10B,B02,083740,Staff,28,0,30,2
1650769115619,MATH 18,A01,083743,Staff,0,0,30,30
1650769115619,MATH 18,A02,083744,Staff,23,0,30,7
1650769115619,MATH 18,A03,083745,Staff,21,0,30,9
1650769115619,MATH 18,A04,083746,Staff,26,0,30,4
1650769115619,MATH 18,B01,083748,Staff,0,15,30,30
1650769115619,MATH 18,B02,083749,Staff,0,12,30,30
1650769115619,MATH 18,B03,083750,Staff,0,12,30,30
1650769115619,MATH 18,B04,083751,Staff,0,12,30,30
1650769121645,MATH 20A,A01,083754,Staff,19,0,40,21
1650769127682,MATH 20B,A01,083756,Staff,0,13,30,30
1650769127682,MATH 20B,A02,083757,Staff,0,12,30,30
1650769133708,MATH 20C,A01,083760,Staff,0,16,30,30
1650769133708,MATH 20C,A02,083761,Staff,0,16,30,30
1650769133708,MATH 20C,B01,083762,Staff,9,0,30,21
1650769133708,MATH 20C,B02,083763,Staff,28,0,30,2
1650769139732,MATH 20D,A01,083765,Staff,2,1,30,28
1650769139732,MATH 20D,A02,083766,Staff,5,0,30,25
1650769139732,MATH 20D,A03,083767,Staff,24,0,30,6
1650769145755,MATH 20E,A01,083771,Staff,2,0,30,28
1650769145755,MATH 20E,A02,083772,Staff,16,0,30,14
1650769145755,MATH 20E,B01,083773,Staff,0,0,30,30
1650769145755,MATH 20E,B02,083774,Staff,5,0,30,25
1650769151781,MATH 103A,A01,083777,Staff,0,16,30,30
1650769151781,MATH 103A,A02,083778,Staff,0,15,30,30
1650769151781,MATH 103A,B01,083779,Staff,0,15,30,30
1650769151781,MATH 103A,B02,083780,Staff,0,15,30,30
1650769157807,MATH 105,A01,085443,Staff,0,22,30,30
1650769163836,MATH 109,A01,083213,Anzaldo; Leesa B,0,7,30,30
1650769163836,MATH 109,A02,083214,Anzaldo; Leesa B,0,7,30,30
1650769163836,MATH 109,B01,083215,Anzaldo; Leesa B,0,8,30,30
1650769163836,MATH 109,B02,083216,Anzaldo; Leesa B,0,7,30,30
1650769169861,MATH 142A,A01,083219,Chow; Bennett,0,16,30,30
1650769169861,MATH 142A,A02,083220,Chow; Bennett,0,15,30,30
1650769169861,MATH 142A,B01,083221,Chow; Bennett,0,15,30,30
1650769169861,MATH 142A,B02,083222,Chow; Bennett,0,14,30,30
1650769175889,MATH 193A,A01,083224,Staff,0,6,30,30
1650769175889,MATH 193A,A02,083225,Staff,0,6,30,30
1650769175889,MATH 193A,A03,083781,Staff,0,6,30,30
1650769175889,MATH 193A,A04,083782,Staff,0,7,30,30
1650769181913,MATH 197,001,091859,McAuley; Julian John,9998,0,9999,1
1650769188061,COGS 9,A01,083615,Staff,1,17,60,59
1650769194088,COGS 11,A01,083617,Boyle; Mary E. T.,16,0,40,24
1650769200120,COGS 13,A01,083071,Staff,0,38,40,40
1650769206146,COGS 14A,A01,092681,Staff,0,36,100,100
1650769212170,COGS 14B,A01,083073,Cheng; Tzu-Han,1,13,50,49
1650769218195,COGS 17,A01,092677,Staff,11,0,75,64
1650769224219,COGS 100,A01,083619,Staff,0,29,60,60
1650769230246,COGS 101A,A01,083621,Davis; Joshua Daniel,0,28,60,60
1650769236273,COGS 101B,A01,091572,Staff,1,4,60,59
1650769242323,COGS 101C,A01,083625,Delgado; Tania,14,0,30,16
1650769248349,COGS 107A,A01,083627,Boyle; Mary E. T.,0,16,60,60
1650769254376,COGS 118A,A01,083075,Staff,0,8,60,60
1650769260402,CSE 3,A50,083646,Miranda; Gregory Joseph,18,0,38,20
1650769260402,CSE 3,A51,083647,Miranda; Gregory Joseph,36,0,37,1
1650769266430,CSE 8A,A50,083650,Miranda; Gregory Joseph,0,30,40,40
1650769272458,CSE 11,A01,083080,Cao; Yingjun,0,96,40,40
1650769278480,CSE 12,A01,083652,Staff,0,21,100,100
1650769284504,CSE 15L,A01,083654,Staff,0,3,50,50
1650769284504,CSE 15L,A02,083655,Staff,0,2,50,50
1650769290533,CSE 20,A01,083657,Staff,49,0,80,31
1650769296561,CSE 30,A01,083084,Eldon; John,0,76,40,40
1650769302583,CSE 100,A01,083659,Cao; Yingjun,0,71,50,50
1650769308607,CSE 134B,A01,083661,Powell; Thomas Allan,0,38,65,65
1650769314631,CSE 140,A01,083663,Staff,0,11,75,75
1650769320658,CSE 140L,A01,083088,Eldon; John,0,20,75,75
1650769326684,CSE 175,A01,083665,Kumar; Rakesh,7,0,25,18
1650769332707,CSE 190,A00,092507,Dubnov; Shlomo,10,0,20,10
1650769338736,ECE 45,A01,083139,Staff,1,2,60,59
1650769344772,ECE 65,A50,083695,Staff,0,5,30,30
1650769350801,ECE 109,A01,091882,Touri; Behrouz,32,0,70,38
1650769356827,ECE 180,A00,083140,Abi Samra; Nicholas Camill,20,0,30,10
1650769356827,ECE 180,B00,083141,Abi Samra; Nicholas Camill,0,0,30,30
1650769362852,MATH 10A,A01,083735,Patchell; Gregory David,2,0,30,28
1650769362852,MATH 10A,A02,083736,Patchell; Gregory David,27,0,30,3
1650769362852,MATH 10A,A03,083737,Patchell; Gregory David,24,0,30,6
1650769368880,MATH 10B,A01,083207,Staff,0,9,30,30
1650769368880,MATH 10B,A02,083208,Staff,1,7,30,29
1650769368880,MATH 10B,B01,083739,Staff,11,0,30,19
1650769368880,MATH 10B,B02,083740,Staff,28,0,30,2
1650769374910,MATH 18,A01,083743,Staff,0,0,30,30
1650769374910,MATH 18,A02,083744,Staff,23,0,30,7
1650769374910,MATH 18,A03,083745,Staff,21,0,30,9
1650769374910,MATH 18,A04,083746,Staff,26,0,30,4
1650769374910,MATH 18,B01,083748,Staff,0,15,30,30
1650769374910,MATH 18,B02,083749,Staff,0,12,30,30
1650769374910,MATH 18,B03,083750,Staff,0,12,30,30
1650769374910,MATH 18,B04,083751,Staff,0,12,30,30
1650769380934,MATH 20A,A01,083754,Staff,19,0,40,21
1650769386959,MATH 20B,A01,083756,Staff,0,13,30,30
1650769386959,MATH 20B,A02,083757,Staff,0,12,30,30
1650769392988,MATH 20C,A01,083760,Staff,0,16,30,30
1650769392988,MATH 20C,A02,083761,Staff,0,16,30,30
1650769392988,MATH 20C,B01,083762,Staff,9,0,30,21
1650769392988,MATH 20C,B02,083763,Staff,28,0,30,2
1650769399012,MATH 20D,A01,083765,Staff,2,1,30,28
1650769399012,MATH 20D,A02,083766,Staff,5,0,30,25
1650769399012,MATH 20D,A03,083767,Staff,24,0,30,6
1650769405039,MATH 20E,A01,083771,Staff,2,0,30,28
1650769405039,MATH 20E,A02,083772,Staff,16,0,30,14
1650769405039,MATH 20E,B01,083773,Staff,0,0,30,30
1650769405039,MATH 20E,B02,083774,Staff,5,0,30,25
1650769411067,MATH 103A,A01,083777,Staff,0,16,30,30
1650769411067,MATH 103A,A02,083778,Staff,0,15,30,30
1650769411067,MATH 103A,B01,083779,Staff,0,15,30,30
1650769411067,MATH 103A,B02,083780,Staff,0,15,30,30
1650769417097,MATH 105,A01,085443,Staff,0,22,30,30
1650769423121,MATH 109,A01,083213,Anzaldo; Leesa B,0,7,30,30
1650769423121,MATH 109,A02,083214,Anzaldo; Leesa B,0,7,30,30
1650769423121,MATH 109,B01,083215,Anzaldo; Leesa B,0,8,30,30
1650769423121,MATH 109,B02,083216,Anzaldo; Leesa B,0,7,30,30
1650769429146,MATH 142A,A01,083219,Chow; Bennett,0,16,30,30
1650769429146,MATH 142A,A02,083220,Chow; Bennett,0,15,30,30
1650769429146,MATH 142A,B01,083221,Chow; Bennett,0,15,30,30
1650769429146,MATH 142A,B02,083222,Chow; Bennett,0,14,30,30
1650769435174,MATH 193A,A01,083224,Staff,0,6,30,30
1650769435174,MATH 193A,A02,083225,Staff,0,6,30,30
1650769435174,MATH 193A,A03,083781,Staff,0,6,30,30
1650769435174,MATH 193A,A04,083782,Staff,0,7,30,30
1650769441196,MATH 197,001,091859,McAuley; Julian John,9998,0,9999,1
1650769447244,COGS 9,A01,083615,Staff,1,17,60,59
1650769453272,COGS 11,A01,083617,Boyle; Mary E. T.,16,0,40,24
1650769459299,COGS 13,A01,083071,Staff,0,38,40,40
1650769465326,COGS 14A,A01,092681,Staff,0,36,100,100
1650769471350,COGS 14B,A01,083073,Cheng; Tzu-Han,1,13,50,49
1650769477377,COGS 17,A01,092677,Staff,11,0,75,64
1650769483401,COGS 100,A01,083619,Staff,0,29,60,60
1650769489424,COGS 101A,A01,083621,Davis; Joshua Daniel,0,28,60,60
1650769495451,COGS 101B,A01,091572,Staff,1,4,60,59
1650769501476,COGS 101C,A01,083625,Delgado; Tania,14,0,30,16
1650769507501,COGS 107A,A01,083627,Boyle; Mary E. T.,0,16,60,60
1650769513523,COGS 118A,A01,083075,Staff,0,8,60,60
1650769519548,CSE 3,A50,083646,Miranda; Gregory Joseph,18,0,38,20
1650769519548,CSE 3,A51,083647,Miranda; Gregory Joseph,36,0,37,1
1650769525578,CSE 8A,A50,083650,Miranda; Gregory Joseph,0,30,40,40
1650769531602,CSE 11,A01,083080,Cao; Yingjun,0,96,40,40
1650769537627,CSE 12,A01,083652,Staff,0,21,100,100
1650769543653,CSE 15L,A01,083654,Staff,0,3,50,50
1650769543653,CSE 15L,A02,083655,Staff,0,2,50,50
1650769549679,CSE 20,A01,083657,Staff,49,0,80,31
1650769555704,CSE 30,A01,083084,Eldon; John,0,76,40,40
1650769561733,CSE 100,A01,083659,Cao; Yingjun,0,71,50,50
1650769567758,CSE 134B,A01,083661,Powell; Thomas Allan,0,38,65,65
1650769573797,CSE 140,A01,083663,Staff,0,11,75,75
1650769579821,CSE 140L,A01,083088,Eldon; John,0,20,75,75
1650769585849,CSE 175,A01,083665,Kumar; Rakesh,7,0,25,18
1650769591875,CSE 190,A00,092507,Dubnov; Shlomo,10,0,20,10
1650769597902,ECE 45,A01,083139,Staff,1,2,60,59
1650769603927,ECE 65,A50,083695,Staff,0,5,30,30
1650769609949,ECE 109,A01,091882,Touri; Behrouz,32,0,70,38
1650769615973,ECE 180,A00,083140,Abi Samra; Nicholas Camill,20,0,30,10
1650769615973,ECE 180,B00,083141,Abi Samra; Nicholas Camill,0,0,30,30
1650769622002,MATH 10A,A01,083735,Patchell; Gregory David,2,0,30,28
1650769622002,MATH 10A,A02,083736,Patchell; Gregory David,27,0,30,3
1650769622002,MATH 10A,A03,083737,Patchell; Gregory David,24,0,30,6
1650769628027,MATH 10B,A01,083207,Staff,0,9,30,30
1650769628027,MATH 10B,A02,083208,Staff,1,7,30,29
1650769628027,MATH 10B,B01,083739,Staff,11,0,30,19
1650769628027,MATH 10B,B02,083740,Staff,28,0,30,2
1650769634057,MATH 18,A01,083743,Staff,0,0,30,30
1650769634057,MATH 18,A02,083744,Staff,23,0,30,7
1650769634057,MATH 18,A03,083745,Staff,21,0,30,9
1650769634057,MATH 18,A04,083746,Staff,26,0,30,4
1650769634057,MATH 18,B01,083748,Staff,0,15,30,30
1650769634057,MATH 18,B02,083749,Staff,0,12,30,30
1650769634057,MATH 18,B03,083750,Staff,0,12,30,30
1650769634057,MATH 18,B04,083751,Staff,0,12,30,30
1650769640081,MATH 20A,A01,083754,Staff,19,0,40,21
1650769646106,MATH 20B,A01,083756,Staff,0,13,30,30
1650769646106,MATH 20B,A02,083757,Staff,0,12,30,30
1650769652131,MATH 20C,A01,083760,Staff,0,16,30,30
1650769652131,MATH 20C,A02,083761,Staff,0,16,30,30
1650769652131,MATH 20C,B01,083762,Staff,9,0,30,21
1650769652131,MATH 20C,B02,083763,Staff,28,0,30,2
1650769658155,MATH 20D,A01,083765,Staff,2,1,30,28
1650769658155,MATH 20D,A02,083766,Staff,5,0,30,25
1650769658155,MATH 20D,A03,083767,Staff,24,0,30,6
1650769664179,MATH 20E,A01,083771,Staff,2,0,30,28
1650769664179,MATH 20E,A02,083772,Staff,16,0,30,14
1650769664179,MATH 20E,B01,083773,Staff,0,0,30,30
1650769664179,MATH 20E,B02,083774,Staff,5,0,30,25
1650769670204,MATH 103A,A01,083777,Staff,0,16,30,30
1650769670204,MATH 103A,A02,083778,Staff,0,15,30,30
1650769670204,MATH 103A,B01,083779,Staff,0,15,30,30
1650769670204,MATH 103A,B02,083780,Staff,0,15,30,30
1650769676228,MATH 105,A01,085443,Staff,0,22,30,30
1650769682253,MATH 109,A01,083213,Anzaldo; Leesa B,0,7,30,30
1650769682253,MATH 109,A02,083214,Anzaldo; Leesa B,0,7,30,30
1650769682253,MATH 109,B01,083215,Anzaldo; Leesa B,0,8,30,30
1650769682253,MATH 109,B02,083216,Anzaldo; Leesa B,0,7,30,30
1650769688282,MATH 142A,A01,083219,Chow; Bennett,0,16,30,30
1650769688282,MATH 142A,A02,083220,Chow; Bennett,0,15,30,30
1650769688282,MATH 142A,B01,083221,Chow; Bennett,0,15,30,30
1650769688282,MATH 142A,B02,083222,Chow; Bennett,0,14,30,30
1650769694309,MATH 193A,A01,083224,Staff,0,6,30,30
1650769694309,MATH 193A,A02,083225,Staff,0,6,30,30
1650769694309,MATH 193A,A03,083781,Staff,0,6,30,30
1650769694309,MATH 193A,A04,083782,Staff,0,7,30,30
1650769700333,MATH 197,001,091859,McAuley; Julian John,9998,0,9999,1
1650769706389,COGS 9,A01,083615,Staff,1,17,60,59
1650769712416,COGS 11,A01,083617,Boyle; Mary E. T.,16,0,40,24
1650769718444,COGS 13,A01,083071,Staff,0,38,40,40
1650769724468,COGS 14A,A01,092681,Staff,0,36,100,100
1650769730501,COGS 14B,A01,083073,Cheng; Tzu-Han,1,13,50,49
1650769736527,COGS 17,A01,092677,Staff,11,0,75,64
1650769742551,COGS 100,A01,083619,Staff,0,29,60,60
1650769748575,COGS 101A,A01,083621,Davis; Joshua Daniel,0,28,60,60
1650769754599,COGS 101B,A01,091572,Staff,1,4,60,59
1650769760625,COGS 101C,A01,083625,Delgado; Tania,14,0,30,16
1650769766652,COGS 107A,A01,083627,Boyle; Mary E. T.,0,16,60,60
1650769772677,COGS 118A,A01,083075,Staff,0,8,60,60
1650769778788,CSE 3,A50,083646,Miranda; Gregory Joseph,18,0,38,20
1650769778788,CSE 3,A51,083647,Miranda; Gregory Joseph,36,0,37,1
1650769784826,CSE 8A,A50,083650,Miranda; Gregory Joseph,0,30,40,40
1650769790854,CSE 11,A01,083080,Cao; Yingjun,0,96,40,40
1650769796881,CSE 12,A01,083652,Staff,0,21,100,100
1650769802904,CSE 15L,A01,083654,Staff,0,3,50,50
1650769802904,CSE 15L,A02,083655,Staff,0,2,50,50
1650769808931,CSE 20,A01,083657,Staff,49,0,80,31
1650769814955,CSE 30,A01,083084,Eldon; John,0,76,40,40
1650769820979,CSE 100,A01,083659,Cao; Yingjun,0,71,50,50
1650769827003,CSE 134B,A01,083661,Powell; Thomas Allan,0,38,65,65
1650769833028,CSE 140,A01,083663,Staff,0,11,75,75
1650769839051,CSE 140L,A01,083088,Eldon; John,0,20,75,75
1650769845078,CSE 175,A01,083665,Kumar; Rakesh,7,0,25,18
1650769851105,CSE 190,A00,092507,Dubnov; Shlomo,10,0,20,10
1650769857134,ECE 45,A01,083139,Staff,1,2,60,59
1650769863161,ECE 65,A50,083695,Staff,0,5,30,30
1650769869188,ECE 109,A01,091882,Touri; Behrouz,32,0,70,38
1650769875213,ECE 180,A00,083140,Abi Samra; Nicholas Camill,20,0,30,10
1650769875213,ECE 180,B00,083141,Abi Samra; Nicholas Camill,0,0,30,30
1650769881240,MATH 10A,A01,083735,Patchell; Gregory David,2,0,30,28
1650769881240,MATH 10A,A02,083736,Patchell; Gregory David,27,0,30,3
1650769881240,MATH 10A,A03,083737,Patchell; Gregory David,24,0,30,6
1650769887265,MATH 10B,A01,083207,Staff,0,9,30,30
1650769887265,MATH 10B,A02,083208,Staff,1,7,30,29
1650769887265,MATH 10B,B01,083739,Staff,11,0,30,19
1650769887265,MATH 10B,B02,083740,Staff,28,0,30,2
1650769893292,MATH 18,A01,083743,Staff,0,0,30,30
1650769893292,MATH 18,A02,083744,Staff,23,0,30,7
1650769893292,MATH 18,A03,083745,Staff,21,0,30,9
1650769893292,MATH 18,A04,083746,Staff,26,0,30,4
1650769893292,MATH 18,B01,083748,Staff,0,15,30,30
1650769893292,MATH 18,B02,083749,Staff,0,12,30,30
1650769893292,MATH 18,B03,083750,Staff,0,12,30,30
1650769893292,MATH 18,B04,083751,Staff,0,12,30,30
1650769899318,MATH 20A,A01,083754,Staff,19,0,40,21
1650769905342,MATH 20B,A01,083756,Staff,0,13,30,30
1650769905342,MATH 20B,A02,083757,Staff,0,12,30,30
1650769911370,MATH 20C,A01,083760,Staff,0,16,30,30
1650769911370,MATH 20C,A02,083761,Staff,0,16,30,30
1650769911370,MATH 20C,B01,083762,Staff,9,0,30,21
1650769911370,MATH 20C,B02,083763,Staff,28,0,30,2
1650769917394,MATH 20D,A01,083765,Staff,2,1,30,28
1650769917394,MATH 20D,A02,083766,Staff,5,0,30,25
1650769917394,MATH 20D,A03,083767,Staff,24,0,30,6
1650769923419,MATH 20E,A01,083771,Staff,2,0,30,28
1650769923419,MATH 20E,A02,083772,Staff,16,0,30,14
1650769923419,MATH 20E,B01,083773,Staff,0,0,30,30
1650769923419,MATH 20E,B02,083774,Staff,5,0,30,25
1650769929448,MATH 103A,A01,083777,Staff,0,16,30,30
1650769929448,MATH 103A,A02,083778,Staff,0,15,30,30
1650769929448,MATH 103A,B01,083779,Staff,0,15,30,30
1650769929448,MATH 103A,B02,083780,Staff,0,15,30,30
1650769935472,MATH 105,A01,085443,Staff,0,22,30,30
1650769941501,MATH 109,A01,083213,Anzaldo; Leesa B,0,7,30,30
1650769941501,MATH 109,A02,083214,Anzaldo; Leesa B,0,7,30,30
1650769941501,MATH 109,B01,083215,Anzaldo; Leesa B,0,8,30,30
1650769941501,MATH 109,B02,083216,Anzaldo; Leesa B,0,7,30,30
1650769947523,MATH 142A,A01,083219,Chow; Bennett,0,16,30,30
1650769947523,MATH 142A,A02,083220,Chow; Bennett,0,15,30,30
1650769947523,MATH 142A,B01,083221,Chow; Bennett,0,15,30,30
1650769947523,MATH 142A,B02,083222,Chow; Bennett,0,14,30,30
1650769953546,MATH 193A,A01,083224,Staff,0,6,30,30
1650769953546,MATH 193A,A02,083225,Staff,0,6,30,30
1650769953546,MATH 193A,A03,083781,Staff,0,6,30,30
1650769953546,MATH 193A,A04,083782,Staff,0,7,30,30
1650769959568,MATH 197,001,091859,McAuley; Julian John,9998,0,9999,1
1650769965630,COGS 9,A01,083615,Staff,1,17,60,59
1650769971656,COGS 11,A01,083617,Boyle; Mary E. T.,16,0,40,24
1650769977679,COGS 13,A01,083071,Staff,0,38,40,40
1650769983707,COGS 14A,A01,092681,Staff,0,36,100,100
1650769989731,COGS 14B,A01,083073,Cheng; Tzu-Han,1,13,50,49
1650769995753,COGS 17,A01,092677,Staff,11,0,75,64
1650770001781,COGS 100,A01,083619,Staff,0,29,60,60
1650770007808,COGS 101A,A01,083621,Davis; Joshua Daniel,0,28,60,60
1650770013830,COGS 101B,A01,091572,Staff,1,4,60,59
1650770019857,COGS 101C,A01,083625,Delgado; Tania,14,0,30,16
1650770025885,COGS 107A,A01,083627,Boyle; Mary E. T.,0,16,60,60
1650770031910,COGS 118A,A01,083075,Staff,0,8,60,60
1650770037934,CSE 3,A50,083646,Miranda; Gregory Joseph,18,0,38,20
1650770037934,CSE 3,A51,083647,Miranda; Gregory Joseph,36,0,37,1
1650770043963,CSE 8A,A50,083650,Miranda; Gregory Joseph,0,30,40,40
1650770049988,CSE 11,A01,083080,Cao; Yingjun,0,96,40,40
1650770056015,CSE 12,A01,083652,Staff,0,21,100,100
1650770062041,CSE 15L,A01,083654,Staff,0,3,50,50
1650770062041,CSE 15L,A02,083655,Staff,0,2,50,50
1650770068068,CSE 20,A01,083657,Staff,49,0,80,31
1650770074096,CSE 30,A01,083084,Eldon; John,0,76,40,40
1650770080121,CSE 100,A01,083659,Cao; Yingjun,0,71,50,50
1650770086145,CSE 134B,A01,083661,Powell; Thomas Allan,0,38,65,65
1650770092169,CSE 140,A01,083663,Staff,0,11,75,75
1650770098196,CSE 140L,A01,083088,Eldon; John,0,20,75,75
1650770104220,CSE 175,A01,083665,Kumar; Rakesh,7,0,25,18
1650770110252,CSE 190,A00,092507,Dubnov; Shlomo,10,0,20,10
1650770116278,ECE 45,A01,083139,Staff,1,2,60,59
1650770122303,ECE 65,A50,083695,Staff,0,5,30,30
1650770128329,ECE 109,A01,091882,Touri; Behrouz,32,0,70,38
1650770134352,ECE 180,A00,083140,Abi Samra; Nicholas Camill,20,0,30,10
1650770134352,ECE 180,B00,083141,Abi Samra; Nicholas Camill,0,0,30,30
1650770140381,MATH 10A,A01,083735,Patchell; Gregory David,2,0,30,28
1650770140381,MATH 10A,A02,083736,Patchell; Gregory David,27,0,30,3
1650770140381,MATH 10A,A03,083737,Patchell; Gregory David,24,0,30,6
1650770146405,MATH 10B,A01,083207,Staff,0,9,30,30
1650770146405,MATH 10B,A02,083208,Staff,1,7,30,29
1650770146405,MATH 10B,B01,083739,Staff,11,0,30,19
1650770146405,MATH 10B,B02,083740,Staff,28,0,30,2
1650770152430,MATH 18,A01,083743,Staff,0,0,30,30
1650770152430,MATH 18,A02,083744,Staff,23,0,30,7
1650770152430,MATH 18,A03,083745,Staff,21,0,30,9
1650770152430,MATH 18,A04,083746,Staff,26,0,30,4
1650770152430,MATH 18,B01,083748,Staff,0,15,30,30
1650770152430,MATH 18,B02,083749,Staff,0,12,30,30
1650770152430,MATH 18,B03,083750,Staff,0,12,30,30
1650770152430,MATH 18,B04,083751,Staff,0,12,30,30
1650770158460,MATH 20A,A01,083754,Staff,19,0,40,21
1650770164485,MATH 20B,A01,083756,Staff,0,13,30,30
1650770164485,MATH 20B,A02,083757,Staff,0,12,30,30
1650770170513,MATH 20C,A01,083760,Staff,0,16,30,30
1650770170513,MATH 20C,A02,083761,Staff,0,16,30,30
1650770170513,MATH 20C,B01,083762,Staff,9,0,30,21
1650770170513,MATH 20C,B02,083763,Staff,28,0,30,2
1650770176540,MATH 20D,A01,083765,Staff,2,1,30,28
1650770176540,MATH 20D,A02,083766,Staff,5,0,30,25
1650770176540,MATH 20D,A03,083767,Staff,24,0,30,6
1650770182564,MATH 20E,A01,083771,Staff,2,0,30,28
1650770182564,MATH 20E,A02,083772,Staff,16,0,30,14
1650770182564,MATH 20E,B01,083773,Staff,0,0,30,30
1650770182564,MATH 20E,B02,083774,Staff,5,0,30,25
1650770188591,MATH 103A,A01,083777,Staff,0,16,30,30
1650770188591,MATH 103A,A02,083778,Staff,0,15,30,30
1650770188591,MATH 103A,B01,083779,Staff,0,15,30,30
1650770188591,MATH 103A,B02,083780,Staff,0,15,30,30
1650770194617,MATH 105,A01,085443,Staff,0,22,30,30
1650770200646,MATH 109,A01,083213,Anzaldo; Leesa B,0,7,30,30
1650770200646,MATH 109,A02,083214,Anzaldo; Leesa B,0,7,30,30
1650770200646,MATH 109,B01,083215,Anzaldo; Leesa B,0,8,30,30
1650770200646,MATH 109,B02,083216,Anzaldo; Leesa B,0,7,30,30
1650770206676,MATH 142A,A01,083219,Chow; Bennett,0,16,30,30
1650770206676,MATH 142A,A02,083220,Chow; Bennett,0,15,30,30
1650770206676,MATH 142A,B01,083221,Chow; Bennett,0,15,30,30
1650770206676,MATH 142A,B02,083222,Chow; Bennett,0,14,30,30
1650770212702,MATH 193A,A01,083224,Staff,0,6,30,30
1650770212702,MATH 193A,A02,083225,Staff,0,6,30,30
1650770212702,MATH 193A,A03,083781,Staff,0,6,30,30
1650770212702,MATH 193A,A04,083782,Staff,0,7,30,30
1650770218731,MATH 197,001,091859,McAuley; Julian John,9998,0,9999,1
1650770224790,COGS 9,A01,083615,Staff,1,17,60,59
1650770230815,COGS 11,A01,083617,Boyle; Mary E. T.,16,0,40,24
1650770236851,COGS 13,A01,083071,Staff,0,38,40,40
1650770242878,COGS 14A,A01,092681,Staff,0,36,100,100
1650770248905,COGS 14B,A01,083073,Cheng; Tzu-Han,1,13,50,49
1650770254934,COGS 17,A01,092677,Staff,11,0,75,64
1650770260972,COGS 100,A01,083619,Staff,0,29,60,60
1650770267000,COGS 101A,A01,083621,Davis; Joshua Daniel,0,28,60,60
1650770273023,COGS 101B,A01,091572,Staff,1,4,60,59
1650770279047,COGS 101C,A01,083625,Delgado; Tania,14,0,30,16
1650770285074,COGS 107A,A01,083627,Boyle; Mary E. T.,0,16,60,60
1650770291098,COGS 118A,A01,083075,Staff,0,8,60,60
1650770297126,CSE 3,A50,083646,Miranda; Gregory Joseph,18,0,38,20
1650770297126,CSE 3,A51,083647,Miranda; Gregory Joseph,36,0,37,1
1650770303150,CSE 8A,A50,083650,Miranda; Gregory Joseph,0,30,40,40
1650770309177,CSE 11,A01,083080,Cao; Yingjun,0,96,40,40
1650770315207,CSE 12,A01,083652,Staff,0,21,100,100
1650770321233,CSE 15L,A01,083654,Staff,0,3,50,50
1650770321233,CSE 15L,A02,083655,Staff,0,2,50,50
1650770327257,CSE 20,A01,083657,Staff,49,0,80,31
1650770333285,CSE 30,A01,083084,Eldon; John,0,76,40,40
1650770339313,CSE 100,A01,083659,Cao; Yingjun,0,71,50,50
1650770345341,CSE 134B,A01,083661,Powell; Thomas Allan,0,38,65,65
1650770351364,CSE 140,A01,083663,Staff,0,11,75,75
1650770357394,CSE 140L,A01,083088,Eldon; John,0,20,75,75
1650770363421,CSE 175,A01,083665,Kumar; Rakesh,7,0,25,18
1650770369446,CSE 190,A00,092507,Dubnov; Shlomo,10,0,20,10
1650770375573,ECE 45,A01,083139,Staff,1,2,60,59
1650770381600,ECE 65,A50,083695,Staff,0,5,30,30
1650770387625,ECE 109,A01,091882,Touri; Behrouz,32,0,70,38
1650770393649,ECE 180,A00,083140,Abi Samra; Nicholas Camill,20,0,30,10
1650770393649,ECE 180,B00,083141,Abi Samra; Nicholas Camill,0,0,30,30
1650770399674,MATH 10A,A01,083735,Patchell; Gregory David,2,0,30,28
1650770399674,MATH 10A,A02,083736,Patchell; Gregory David,27,0,30,3
1650770399674,MATH 10A,A03,083737,Patchell; Gregory David,24,0,30,6
1650770405702,MATH 10B,A01,083207,Staff,0,9,30,30
1650770405702,MATH 10B,A02,083208,Staff,1,7,30,29
1650770405702,MATH 10B,B01,083739,Staff,11,0,30,19
1650770405702,MATH 10B,B02,083740,Staff,28,0,30,2
1650770411731,MATH 18,A01,083743,Staff,0,0,30,30
1650770411731,MATH 18,A02,083744,Staff,23,0,30,7
1650770411731,MATH 18,A03,083745,Staff,21,0,30,9
1650770411731,MATH 18,A04,083746,Staff,26,0,30,4
1650770411731,MATH 18,B01,083748,Staff,0,15,30,30
1650770411731,MATH 18,B02,083749,Staff,0,12,30,30
1650770411731,MATH 18,B03,083750,Staff,0,12,30,30
1650770411731,MATH 18,B04,083751,Staff,0,12,30,30
1650770417757,MATH 20A,A01,083754,Staff,19,0,40,21
1650770423783,MATH 20B,A01,083756,Staff,0,13,30,30
1650770423783,MATH 20B,A02,083757,Staff,0,12,30,30
1650770429817,MATH 20C,A01,083760,Staff,0,16,30,30
1650770429817,MATH 20C,A02,083761,Staff,0,16,30,30
1650770429817,MATH 20C,B01,083762,Staff,9,0,30,21
1650770429817,MATH 20C,B02,083763,Staff,28,0,30,2
1650770435839,MATH 20D,A01,083765,Staff,2,1,30,28
1650770435839,MATH 20D,A02,083766,Staff,5,0,30,25
1650770435839,MATH 20D,A03,083767,Staff,24,0,30,6
1650770441866,MATH 20E,A01,083771,Staff,2,0,30,28
1650770441866,MATH 20E,A02,083772,Staff,16,0,30,14
1650770441866,MATH 20E,B01,083773,Staff,0,0,30,30
1650770441866,MATH 20E,B02,083774,Staff,5,0,30,25
1650770447904,MATH 103A,A01,083777,Staff,0,16,30,30
1650770447904,MATH 103A,A02,083778,Staff,0,15,30,30
1650770447904,MATH 103A,B01,083779,Staff,0,15,30,30
1650770447904,MATH 103A,B02,083780,Staff,0,15,30,30
1650770453932,MATH 105,A01,085443,Staff,0,22,30,30
1650770459961,MATH 109,A01,083213,Anzaldo; Leesa B,0,7,30,30
1650770459961,MATH 109,A02,083214,Anzaldo; Leesa B,0,7,30,30
1650770459961,MATH 109,B01,083215,Anzaldo; Leesa B,0,8,30,30
1650770459961,MATH 109,B02,083216,Anzaldo; Leesa B,0,7,30,30
1650770465989,MATH 142A,A01,083219,Chow; Bennett,0,16,30,30
1650770465989,MATH 142A,A02,083220,Chow; Bennett,0,15,30,30
1650770465989,MATH 142A,B01,083221,Chow; Bennett,0,15,30,30
1650770465989,MATH 142A,B02,083222,Chow; Bennett,0,14,30,30
1650770472017,MATH 193A,A01,083224,Staff,0,6,30,30
1650770472017,MATH 193A,A02,083225,Staff,0,6,30,30
1650770472017,MATH 193A,A03,083781,Staff,0,6,30,30
1650770472017,MATH 193A,A04,083782,Staff,0,7,30,30
1650770478041,MATH 197,001,091859,McAuley; Julian John,9998,0,9999,1
1650770484112,COGS 9,A01,083615,Staff,1,17,60,59
1650770490136,COGS 11,A01,083617,Boyle; Mary E. T.,16,0,40,24
1650770496163,COGS 13,A01,083071,Staff,0,38,40,40
1650770502190,COGS 14A,A01,092681,Staff,0,36,100,100
1650770508217,COGS 14B,A01,083073,Cheng; Tzu-Han,1,13,50,49
1650770514247,COGS 17,A01,092677,Staff,11,0,75,64
1650770520278,COGS 100,A01,083619,Staff,0,29,60,60
1650770526311,COGS 101A,A01,083621,Davis; Joshua Daniel,0,28,60,60
1650770532344,COGS 101B,A01,091572,Staff,1,4,60,59
1650770538368,COGS 101C,A01,083625,Delgado; Tania,14,0,30,16
1650770544391,COGS 107A,A01,083627,Boyle; Mary E. T.,0,16,60,60
1650770550420,COGS 118A,A01,083075,Staff,0,8,60,60
1650770556445,CSE 3,A50,083646,Miranda; Gregory Joseph,18,0,38,20
1650770556445,CSE 3,A51,083647,Miranda; Gregory Joseph,36,0,37,1
1650770562468,CSE 8A,A50,083650,Miranda; Gregory Joseph,0,30,40,40
1650770568493,CSE 11,A01,083080,Cao; Yingjun,0,96,40,40
1650770574516,CSE 12,A01,083652,Staff,0,21,100,100
1650770580538,CSE 15L,A01,083654,Staff,0,3,50,50
1650770580538,CSE 15L,A02,083655,Staff,0,2,50,50
1650770586570,CSE 20,A01,083657,Staff,49,0,80,31
1650770592596,CSE 30,A01,083084,Eldon; John,0,76,40,40
1650770598622,CSE 100,A01,083659,Cao; Yingjun,0,71,50,50
1650770604647,CSE 134B,A01,083661,Powell; Thomas Allan,0,38,65,65
1650770610670,CSE 140,A01,083663,Staff,0,11,75,75
1650770616697,CSE 140L,A01,083088,Eldon; John,0,20,75,75
1650770622723,CSE 175,A01,083665,Kumar; Rakesh,7,0,25,18
1650770628747,CSE 190,A00,092507,Dubnov; Shlomo,10,0,20,10
1650770634771,ECE 45,A01,083139,Staff,1,2,60,59
1650770640795,ECE 65,A50,083695,Staff,0,5,30,30
1650770646818,ECE 109,A01,091882,Touri; Behrouz,32,0,70,38
1650770652842,ECE 180,A00,083140,Abi Samra; Nicholas Camill,20,0,30,10
1650770652842,ECE 180,B00,083141,Abi Samra; Nicholas Camill,0,0,30,30
1650770658867,MATH 10A,A01,083735,Patchell; Gregory David,2,0,30,28
1650770658867,MATH 10A,A02,083736,Patchell; Gregory David,27,0,30,3
1650770658867,MATH 10A,A03,083737,Patchell; Gregory David,24,0,30,6
1650770664892,MATH 10B,A01,083207,Staff,0,9,30,30
1650770664892,MATH 10B,A02,083208,Staff,1,7,30,29
1650770664892,MATH 10B,B01,083739,Staff,11,0,30,19
1650770664892,MATH 10B,B02,083740,Staff,28,0,30,2
1650770670917,MATH 18,A01,083743,Staff,0,0,30,30
1650770670917,MATH 18,A02,083744,Staff,23,0,30,7
1650770670917,MATH 18,A03,083745,Staff,21,0,30,9
1650770670917,MATH 18,A04,083746,Staff,26,0,30,4
1650770670917,MATH 18,B01,083748,Staff,0,15,30,30
1650770670917,MATH 18,B02,083749,Staff,0,12,30,30
1650770670917,MATH 18,B03,083750,Staff,0,12,30,30
1650770670917,MATH 18,B04,083751,Staff,0,12,30,30
1650770676940,MATH 20A,A01,083754,Staff,19,0,40,21
1650770682965,MATH 20B,A01,083756,Staff,0,13,30,30
1650770682965,MATH 20B,A02,083757,Staff,0,12,30,30
1650770689003,MATH 20C,A01,083760,Staff,0,16,30,30
1650770689003,MATH 20C,A02,083761,Staff,0,16,30,30
1650770689003,MATH 20C,B01,083762,Staff,9,0,30,21
1650770689003,MATH 20C,B02,083763,Staff,28,0,30,2
1650770695026,MATH 20D,A01,083765,Staff,2,1,30,28
1650770695026,MATH 20D,A02,083766,Staff,5,0,30,25
1650770695026,MATH 20D,A03,083767,Staff,24,0,30,6
1650770701051,MATH 20E,A01,083771,Staff,2,0,30,28
1650770701051,MATH 20E,A02,083772,Staff,16,0,30,14
1650770701051,MATH 20E,B01,083773,Staff,0,0,30,30
1650770701051,MATH 20E,B02,083774,Staff,5,0,30,25
1650770707083,MATH 103A,A01,083777,Staff,0,16,30,30
1650770707083,MATH 103A,A02,083778,Staff,0,15,30,30
1650770707083,MATH 103A,B01,083779,Staff,0,15,30,30
1650770707083,MATH 103A,B02,083780,Staff,0,15,30,30
1650770713105,MATH 105,A01,085443,Staff,0,22,30,30
1650770719129,MATH 109,A01,083213,Anzaldo; Leesa B,0,7,30,30
1650770719129,MATH 109,A02,083214,Anzaldo; Leesa B,0,7,30,30
1650770719129,MATH 109,B01,083215,Anzaldo; Leesa B,0,8,30,30
1650770719129,MATH 109,B02,083216,Anzaldo; Leesa B,0,7,30,30
1650770725153,MATH 142A,A01,083219,Chow; Bennett,0,16,30,30
1650770725153,MATH 142A,A02,083220,Chow; Bennett,0,15,30,30
1650770725153,MATH 142A,B01,083221,Chow; Bennett,0,15,30,30
1650770725153,MATH 142A,B02,083222,Chow; Bennett,0,14,30,30
1650770731181,MATH 193A,A01,083224,Staff,0,6,30,30
1650770731181,MATH 193A,A02,083225,Staff,0,6,30,30
1650770731181,MATH 193A,A03,083781,Staff,0,6,30,30
1650770731181,MATH 193A,A04,083782,Staff,0,7,30,30
1650770737204,MATH 197,001,091859,McAuley; Julian John,9998,0,9999,1
1650770743376,COGS 9,A01,083615,Staff,1,17,60,59
1650770749400,COGS 11,A01,083617,Boyle; Mary E. T.,16,0,40,24
1650770755427,COGS 13,A01,083071,Staff,0,38,40,40
1650770761455,COGS 14A,A01,092681,Staff,0,36,100,100
1650770767481,COGS 14B,A01,083073,Cheng; Tzu-Han,1,13,50,49
1650770773504,COGS 17,A01,092677,Staff,11,0,75,64
1650770779535,COGS 100,A01,083619,Staff,0,29,60,60
1650770785565,COGS 101A,A01,083621,Davis; Joshua Daniel,0,28,60,60
1650770791589,COGS 101B,A01,091572,Staff,1,4,60,59
1650770797613,COGS 101C,A01,083625,Delgado; Tania,14,0,30,16
1650770803641,COGS 107A,A01,083627,Boyle; Mary E. T.,0,16,60,60
1650770809667,COGS 118A,A01,083075,Staff,0,8,60,60
1650770815691,CSE 3,A50,083646,Miranda; Gregory Joseph,18,0,38,20
1650770815691,CSE 3,A51,083647,Miranda; Gregory Joseph,36,0,37,1
1650770821714,CSE 8A,A50,083650,Miranda; Gregory Joseph,0,30,40,40
1650770827738,CSE 11,A01,083080,Cao; Yingjun,0,96,40,40
1650770833763,CSE 12,A01,083652,Staff,0,21,100,100
1650770839787,CSE 15L,A01,083654,Staff,0,3,50,50
1650770839787,CSE 15L,A02,083655,Staff,0,2,50,50
1650770845813,CSE 20,A01,083657,Staff,49,0,80,31
1650770851836,CSE 30,A01,083084,Eldon; John,0,76,40,40
1650770857872,CSE 100,A01,083659,Cao; Yingjun,0,71,50,50
1650770863893,CSE 134B,A01,083661,Powell; Thomas Allan,0,38,65,65
1650770869919,CSE 140,A01,083663,Staff,0,11,75,75
1650770875944,CSE 140L,A01,083088,Eldon; John,0,20,75,75
1650770881969,CSE 175,A01,083665,Kumar; Rakesh,7,0,25,18
1650770887994,CSE 190,A00,092507,Dubnov; Shlomo,10,0,20,10
1650770894018,ECE 45,A01,083139,Staff,1,2,60,59
1650770900041,ECE 65,A50,083695,Staff,0,5,30,30
1650770906068,ECE 109,A01,091882,Touri; Behrouz,32,0,70,38
1650770912090,ECE 180,A00,083140,Abi Samra; Nicholas Camill,20,0,30,10
1650770912090,ECE 180,B00,083141,Abi Samra; Nicholas Camill,0,0,30,30
1650770918114,MATH 10A,A01,083735,Patchell; Gregory David,2,0,30,28
1650770918114,MATH 10A,A02,083736,Patchell; Gregory David,27,0,30,3
1650770918114,MATH 10A,A03,083737,Patchell; Gregory David,24,0,30,6
1650770924140,MATH 10B,A01,083207,Staff,0,9,30,30
1650770924140,MATH 10B,A02,083208,Staff,1,7,30,29
1650770924140,MATH 10B,B01,083739,Staff,11,0,30,19
1650770924140,MATH 10B,B02,083740,Staff,28,0,30,2
1650770930166,MATH 18,A01,083743,Staff,0,0,30,30
1650770930166,MATH 18,A02,083744,Staff,23,0,30,7
1650770930166,MATH 18,A03,083745,Staff,21,0,30,9
1650770930166,MATH 18,A04,083746,Staff,26,0,30,4
1650770930166,MATH 18,B01,083748,Staff,0,15,30,30
1650770930166,MATH 18,B02,083749,Staff,0,12,30,30
1650770930166,MATH 18,B03,083750,Staff,0,12,30,30
1650770930166,MATH 18,B04,083751,Staff,0,12,30,30
1650770936190,MATH 20A,A01,083754,Staff,19,0,40,21
1650770942214,MATH 20B,A01,083756,Staff,0,13,30,30
1650770942214,MATH 20B,A02,083757,Staff,0,12,30,30
1650770948238,MATH 20C,A01,083760,Staff,0,16,30,30
1650770948238,MATH 20C,A02,083761,Staff,0,16,30,30
1650770948238,MATH 20C,B01,083762,Staff,9,0,30,21
1650770948238,MATH 20C,B02,083763,Staff,28,0,30,2
1650770954262,MATH 20D,A01,083765,Staff,2,1,30,28
1650770954262,MATH 20D,A02,083766,Staff,5,0,30,25
1650770954262,MATH 20D,A03,083767,Staff,24,0,30,6
1650770960290,MATH 20E,A01,083771,Staff,2,0,30,28
1650770960290,MATH 20E,A02,083772,Staff,16,0,30,14
1650770960290,MATH 20E,B01,083773,Staff,0,0,30,30
1650770960290,MATH 20E,B02,083774,Staff,5,0,30,25
1650770966315,MATH 103A,A01,083777,Staff,0,16,30,30
1650770966315,MATH 103A,A02,083778,Staff,0,15,30,30
1650770966315,MATH 103A,B01,083779,Staff,0,15,30,30
1650770966315,MATH 103A,B02,083780,Staff,0,15,30,30
1650770972428,MATH 105,A01,085443,Staff,0,22,30,30
1650770978455,MATH 109,A01,083213,Anzaldo; Leesa B,0,7,30,30
1650770978455,MATH 109,A02,083214,Anzaldo; Leesa B,0,7,30,30
1650770978455,MATH 109,B01,083215,Anzaldo; Leesa B,0,8,30,30
1650770978455,MATH 109,B02,083216,Anzaldo; Leesa B,0,7,30,30
1650770984477,MATH 142A,A01,083219,Chow; Bennett,0,16,30,30
1650770984477,MATH 142A,A02,083220,Chow; Bennett,0,15,30,30
1650770984477,MATH 142A,B01,083221,Chow; Bennett,0,15,30,30
1650770984477,MATH 142A,B02,083222,Chow; Bennett,0,14,30,30
1650770990505,MATH 193A,A01,083224,Staff,0,6,30,30
1650770990505,MATH 193A,A02,083225,Staff,0,6,30,30
1650770990505,MATH 193A,A03,083781,Staff,0,6,30,30
1650770990505,MATH 193A,A04,083782,Staff,0,7,30,30
1650770996531,MATH 197,001,091859,McAuley; Julian John,9998,0,9999,1
1650771002590,COGS 9,A01,083615,Staff,1,17,60,59
1650771008618,COGS 11,A01,083617,Boyle; Mary E. T.,16,0,40,24
1650771014642,COGS 13,A01,083071,Staff,0,38,40,40
1650771020667,COGS 14A,A01,092681,Staff,0,36,100,100
1650771026689,COGS 14B,A01,083073,Cheng; Tzu-Han,1,13,50,49
1650771032712,COGS 17,A01,092677,Staff,11,0,75,64
1650771038736,COGS 100,A01,083619,Staff,0,29,60,60
1650771044763,COGS 101A,A01,083621,Davis; Joshua Daniel,0,28,60,60
1650771050788,COGS 101B,A01,091572,Staff,1,4,60,59
1650771056816,COGS 101C,A01,083625,Delgado; Tania,14,0,30,16
1650771062842,COGS 107A,A01,083627,Boyle; Mary E. T.,0,16,60,60
1650771068866,COGS 118A,A01,083075,Staff,0,8,60,60
1650771074893,CSE 3,A50,083646,Miranda; Gregory Joseph,18,0,38,20
1650771074893,CSE 3,A51,083647,Miranda; Gregory Joseph,36,0,37,1
1650771080917,CSE 8A,A50,083650,Miranda; Gregory Joseph,0,30,40,40
1650771086941,CSE 11,A01,083080,Cao; Yingjun,0,96,40,40
1650771092965,CSE 12,A01,083652,Staff,0,21,100,100
1650771098988,CSE 15L,A01,083654,Staff,0,3,50,50
1650771098988,CSE 15L,A02,083655,Staff,0,2,50,50
1650771105011,CSE 20,A01,083657,Staff,49,0,80,31
1650771111035,CSE 30,A01,083084,Eldon; John,0,76,40,40
1650771117062,CSE 100,A01,083659,Cao; Yingjun,0,71,50,50
1650771123085,CSE 134B,A01,083661,Powell; Thomas Allan,0,38,65,65
1650771129109,CSE 140,A01,083663,Staff,0,11,75,75
1650771135132,CSE 140L,A01,083088,Eldon; John,0,20,75,75
1650771141158,CSE 175,A01,083665,Kumar; Rakesh,7,0,25,18
1650771147180,CSE 190,A00,092507,Dubnov; Shlomo,10,0,20,10
1650771153207,ECE 45,A01,083139,Staff,1,2,60,59
1650771159234,ECE 65,A50,083695,Staff,0,5,30,30
1650771165258,ECE 109,A01,091882,Touri; Behrouz,32,0,70,38
1650771171284,ECE 180,A00,083140,Abi Samra; Nicholas Camill,20,0,30,10
1650771171284,ECE 180,B00,083141,Abi Samra; Nicholas Camill,0,0,30,30
1650771177310,MATH 10A,A01,083735,Patchell; Gregory David,2,0,30,28
1650771177310,MATH 10A,A02,083736,Patchell; Gregory David,27,0,30,3
1650771177310,MATH 10A,A03,083737,Patchell; Gregory David,24,0,30,6
1650771183340,MATH 10B,A01,083207,Staff,0,9,30,30
1650771183340,MATH 10B,A02,083208,Staff,1,7,30,29
1650771183340,MATH 10B,B01,083739,Staff,11,0,30,19
1650771183340,MATH 10B,B02,083740,Staff,28,0,30,2
1650771189364,MATH 18,A01,083743,Staff,0,0,30,30
1650771189364,MATH 18,A02,083744,Staff,23,0,30,7
1650771189364,MATH 18,A03,083745,Staff,21,0,30,9
1650771189364,MATH 18,A04,083746,Staff,26,0,30,4
1650771189364,MATH 18,B01,083748,Staff,0,15,30,30
1650771189364,MATH 18,B02,083749,Staff,0,12,30,30
1650771189364,MATH 18,B03,083750,Staff,0,12,30,30
1650771189364,MATH 18,B04,083751,Staff,0,12,30,30
1650771195388,MATH 20A,A01,083754,Staff,19,0,40,21
1650771201413,MATH 20B,A01,083756,Staff,0,13,30,30
1650771201413,MATH 20B,A02,083757,Staff,0,12,30,30
1650771207439,MATH 20C,A01,083760,Staff,0,16,30,30
1650771207439,MATH 20C,A02,083761,Staff,0,16,30,30
1650771207439,MATH 20C,B01,083762,Staff,9,0,30,21
1650771207439,MATH 20C,B02,083763,Staff,28,0,30,2
1650771213463,MATH 20D,A01,083765,Staff,2,1,30,28
1650771213463,MATH 20D,A02,083766,Staff,5,0,30,25
1650771213463,MATH 20D,A03,083767,Staff,24,0,30,6
1650771219487,MATH 20E,A01,083771,Staff,2,0,30,28
1650771219487,MATH 20E,A02,083772,Staff,16,0,30,14
1650771219487,MATH 20E,B01,083773,Staff,0,0,30,30
1650771219487,MATH 20E,B02,083774,Staff,5,0,30,25
1650771225514,MATH 103A,A01,083777,Staff,0,16,30,30
1650771225514,MATH 103A,A02,083778,Staff,0,15,30,30
1650771225514,MATH 103A,B01,083779,Staff,0,15,30,30
1650771225514,MATH 103A,B02,083780,Staff,0,15,30,30
1650771231539,MATH 105,A01,085443,Staff,0,22,30,30
1650771237565,MATH 109,A01,083213,Anzaldo; Leesa B,0,7,30,30
1650771237565,MATH 109,A02,083214,Anzaldo; Leesa B,0,7,30,30
1650771237565,MATH 109,B01,083215,Anzaldo; Leesa B,0,8,30,30
1650771237565,MATH 109,B02,083216,Anzaldo; Leesa B,0,7,30,30
1650771243590,MATH 142A,A01,083219,Chow; Bennett,0,16,30,30
1650771243590,MATH 142A,A02,083220,Chow; Bennett,0,15,30,30
1650771243590,MATH 142A,B01,083221,Chow; Bennett,0,15,30,30
1650771243590,MATH 142A,B02,083222,Chow; Bennett,0,14,30,30
1650771249612,MATH 193A,A01,083224,Staff,0,6,30,30
1650771249612,MATH 193A,A02,083225,Staff,0,6,30,30
1650771249612,MATH 193A,A03,083781,Staff,0,6,30,30
1650771249612,MATH 193A,A04,083782,Staff,0,7,30,30
1650771255634,MATH 197,001,091859,McAuley; Julian John,9998,0,9999,1
1650771261697,COGS 9,A01,083615,Staff,1,17,60,59
1650771267723,COGS 11,A01,083617,Boyle; Mary E. T.,16,0,40,24
1650771273747,COGS 13,A01,083071,Staff,0,38,40,40
1650771279771,COGS 14A,A01,092681,Staff,0,36,100,100
1650771285793,COGS 14B,A01,083073,Cheng; Tzu-Han,1,13,50,49
1650771291819,COGS 17,A01,092677,Staff,11,0,75,64
1650771297845,COGS 100,A01,083619,Staff,0,29,60,60
1650771303868,COGS 101A,A01,083621,Davis; Joshua Daniel,0,28,60,60
1650771309894,COGS 101B,A01,091572,Staff,1,4,60,59
1650771315922,COGS 101C,A01,083625,Delgado; Tania,14,0,30,16
1650771321950,COGS 107A,A01,083627,Boyle; Mary E. T.,0,16,60,60
1650771327977,COGS 118A,A01,083075,Staff,0,8,60,60
1650771334001,CSE 3,A50,083646,Miranda; Gregory Joseph,18,0,38,20
1650771334001,CSE 3,A51,083647,Miranda; Gregory Joseph,36,0,37,1
1650771340026,CSE 8A,A50,083650,Miranda; Gregory Joseph,0,30,40,40
1650771346052,CSE 11,A01,083080,Cao; Yingjun,0,96,40,40
1650771352077,CSE 12,A01,083652,Staff,0,21,100,100
1650771358101,CSE 15L,A01,083654,Staff,0,3,50,50
1650771358101,CSE 15L,A02,083655,Staff,0,2,50,50
1650771364125,CSE 20,A01,083657,Staff,49,0,80,31
1650771370160,CSE 30,A01,083084,Eldon; John,0,76,40,40
1650771376184,CSE 100,A01,083659,Cao; Yingjun,0,71,50,50
1650771382210,CSE 134B,A01,083661,Powell; Thomas Allan,0,38,65,65
1650771388237,CSE 140,A01,083663,Staff,0,11,75,75
1650771394260,CSE 140L,A01,083088,Eldon; John,0,20,75,75
1650771400283,CSE 175,A01,083665,Kumar; Rakesh,7,0,25,18
1650771406307,CSE 190,A00,092507,Dubnov; Shlomo,10,0,20,10
1650771412333,ECE 45,A01,083139,Staff,1,2,60,59
1650771418360,ECE 65,A50,083695,Staff,0,5,30,30
1650771424384,ECE 109,A01,091882,Touri; Behrouz,32,0,70,38
1650771430411,ECE 180,A00,083140,Abi Samra; Nicholas Camill,20,0,30,10
1650771430411,ECE 180,B00,083141,Abi Samra; Nicholas Camill,0,0,30,30
1650771436438,MATH 10A,A01,083735,Patchell; Gregory David,2,0,30,28
1650771436438,MATH 10A,A02,083736,Patchell; Gregory David,27,0,30,3
1650771436438,MATH 10A,A03,083737,Patchell; Gregory David,24,0,30,6
1650771442463,MATH 10B,A01,083207,Staff,0,9,30,30
1650771442463,MATH 10B,A02,083208,Staff,1,7,30,29
1650771442463,MATH 10B,B01,083739,Staff,11,0,30,19
1650771442463,MATH 10B,B02,083740,Staff,28,0,30,2
1650771448494,MATH 18,A01,083743,Staff,0,0,30,30
1650771448494,MATH 18,A02,083744,Staff,23,0,30,7
1650771448494,MATH 18,A03,083745,Staff,21,0,30,9
1650771448494,MATH 18,A04,083746,Staff,26,0,30,4
1650771448494,MATH 18,B01,083748,Staff,0,15,30,30
1650771448494,MATH 18,B02,083749,Staff,0,12,30,30
1650771448494,MATH 18,B03,083750,Staff,0,12,30,30
1650771448494,MATH 18,B04,083751,Staff,0,12,30,30
1650771454518,MATH 20A,A01,083754,Staff,19,0,40,21
1650771460542,MATH 20B,A01,083756,Staff,0,13,30,30
1650771460542,MATH 20B,A02,083757,Staff,0,12,30,30
1650771466569,MATH 20C,A01,083760,Staff,0,16,30,30
1650771466569,MATH 20C,A02,083761,Staff,0,16,30,30
1650771466569,MATH 20C,B01,083762,Staff,9,0,30,21
1650771466569,MATH 20C,B02,083763,Staff,28,0,30,2
1650771472593,MATH 20D,A01,083765,Staff,2,1,30,28
1650771472593,MATH 20D,A02,083766,Staff,5,0,30,25
1650771472593,MATH 20D,A03,083767,Staff,24,0,30,6
1650771478620,MATH 20E,A01,083771,Staff,2,0,30,28
1650771478620,MATH 20E,A02,083772,Staff,16,0,30,14
1650771478620,MATH 20E,B01,083773,Staff,0,0,30,30
1650771478620,MATH 20E,B02,083774,Staff,5,0,30,25
1650771484662,MATH 103A,A01,083777,Staff,0,16,30,30
1650771484662,MATH 103A,A02,083778,Staff,0,15,30,30
1650771484662,MATH 103A,B01,083779,Staff,0,15,30,30
1650771484662,MATH 103A,B02,083780,Staff,0,15,30,30
1650771490686,MATH 105,A01,085443,Staff,0,22,30,30
1650771496711,MATH 109,A01,083213,Anzaldo; Leesa B,0,7,30,30
1650771496711,MATH 109,A02,083214,Anzaldo; Leesa B,0,7,30,30
1650771496711,MATH 109,B01,083215,Anzaldo; Leesa B,0,8,30,30
1650771496711,MATH 109,B02,083216,Anzaldo; Leesa B,0,7,30,30
1650771502734,MATH 142A,A01,083219,Chow; Bennett,0,16,30,30
1650771502734,MATH 142A,A02,083220,Chow; Bennett,0,15,30,30
1650771502734,MATH 142A,B01,083221,Chow; Bennett,0,15,30,30
1650771502734,MATH 142A,B02,083222,Chow; Bennett,0,14,30,30
1650771508772,MATH 193A,A01,083224,Staff,0,6,30,30
1650771508772,MATH 193A,A02,083225,Staff,0,6,30,30
1650771508772,MATH 193A,A03,083781,Staff,0,6,30,30
1650771508772,MATH 193A,A04,083782,Staff,0,7,30,30
1650771514795,MATH 197,001,091859,McAuley; Julian John,9998,0,9999,1
1650771520849,COGS 9,A01,083615,Staff,1,17,60,59
1650771526878,COGS 11,A01,083617,Boyle; Mary E. T.,16,0,40,24
1650771532901,COGS 13,A01,083071,Staff,0,38,40,40
1650771538927,COGS 14A,A01,092681,Staff,0,36,100,100
1650771544951,COGS 14B,A01,083073,Cheng; Tzu-Han,1,13,50,49
1650771550981,COGS 17,A01,092677,Staff,11,0,75,64
1650771557004,COGS 100,A01,083619,Staff,0,29,60,60
1650771563116,COGS 101A,A01,083621,Davis; Joshua Daniel,0,28,60,60
1650771569138,COGS 101B,A01,091572,Staff,1,4,60,59
1650771575164,COGS 101C,A01,083625,Delgado; Tania,14,0,30,16
1650771581186,COGS 107A,A01,083627,Boyle; Mary E. T.,0,16,60,60
1650771587220,COGS 118A,A01,083075,Staff,0,8,60,60
1650771593245,CSE 3,A50,083646,Miranda; Gregory Joseph,18,0,38,20
1650771593245,CSE 3,A51,083647,Miranda; Gregory Joseph,36,0,37,1
1650771599269,CSE 8A,A50,083650,Miranda; Gregory Joseph,0,30,40,40
1650771605293,CSE 11,A01,083080,Cao; Yingjun,0,96,40,40
1650771611320,CSE 12,A01,083652,Staff,0,21,100,100
1650771617346,CSE 15L,A01,083654,Staff,0,3,50,50
1650771617346,CSE 15L,A02,083655,Staff,0,2,50,50
1650771623370,CSE 20,A01,083657,Staff,49,0,80,31
1650771629392,CSE 30,A01,083084,Eldon; John,0,76,40,40
1650771635421,CSE 100,A01,083659,Cao; Yingjun,0,71,50,50
1650771641449,CSE 134B,A01,083661,Powell; Thomas Allan,0,38,65,65
1650771647482,CSE 140,A01,083663,Staff,0,11,75,75
1650771653511,CSE 140L,A01,083088,Eldon; John,0,20,75,75
1650771659534,CSE 175,A01,083665,Kumar; Rakesh,7,0,25,18
1650771665558,CSE 190,A00,092507,Dubnov; Shlomo,10,0,20,10
1650771671587,ECE 45,A01,083139,Staff,1,2,60,59
1650771677611,ECE 65,A50,083695,Staff,0,5,30,30
1650771683633,ECE 109,A01,091882,Touri; Behrouz,32,0,70,38
1650771689664,ECE 180,A00,083140,Abi Samra; Nicholas Camill,20,0,30,10
1650771689664,ECE 180,B00,083141,Abi Samra; Nicholas Camill,0,0,30,30
1650771695688,MATH 10A,A01,083735,Patchell; Gregory David,2,0,30,28
1650771695688,MATH 10A,A02,083736,Patchell; Gregory David,27,0,30,3
1650771695688,MATH 10A,A03,083737,Patchell; Gregory David,24,0,30,6
1650771701715,MATH 10B,A01,083207,Staff,0,9,30,30
1650771701715,MATH 10B,A02,083208,Staff,1,7,30,29
1650771701715,MATH 10B,B01,083739,Staff,11,0,30,19
1650771701715,MATH 10B,B02,083740,Staff,28,0,30,2
1650771707741,MATH 18,A01,083743,Staff,0,0,30,30
1650771707741,MATH 18,A02,083744,Staff,23,0,30,7
1650771707741,MATH 18,A03,083745,Staff,21,0,30,9
1650771707741,MATH 18,A04,083746,Staff,26,0,30,4
1650771707741,MATH 18,B01,083748,Staff,0,15,30,30
1650771707741,MATH 18,B02,083749,Staff,0,12,30,30
1650771707741,MATH 18,B03,083750,Staff,0,12,30,30
1650771707741,MATH 18,B04,083751,Staff,0,12,30,30
1650771713768,MATH 20A,A01,083754,Staff,19,0,40,21
1650771719792,MATH 20B,A01,083756,Staff,0,13,30,30
1650771719792,MATH 20B,A02,083757,Staff,0,12,30,30
1650771725817,MATH 20C,A01,083760,Staff,0,16,30,30
1650771725817,MATH 20C,A02,083761,Staff,0,16,30,30
1650771725817,MATH 20C,B01,083762,Staff,9,0,30,21
1650771725817,MATH 20C,B02,083763,Staff,28,0,30,2
1650771731847,MATH 20D,A01,083765,Staff,2,1,30,28
1650771731847,MATH 20D,A02,083766,Staff,5,0,30,25
1650771731847,MATH 20D,A03,083767,Staff,24,0,30,6
1650771737872,MATH 20E,A01,083771,Staff,2,0,30,28
1650771737872,MATH 20E,A02,083772,Staff,16,0,30,14
1650771737872,MATH 20E,B01,083773,Staff,0,0,30,30
1650771737872,MATH 20E,B02,083774,Staff,5,0,30,25
1650771743897,MATH 103A,A01,083777,Staff,0,16,30,30
1650771743897,MATH 103A,A02,083778,Staff,0,15,30,30
1650771743897,MATH 103A,B01,083779,Staff,0,15,30,30
1650771743897,MATH 103A,B02,083780,Staff,0,15,30,30
1650771749921,MATH 105,A01,085443,Staff,0,22,30,30
1650771755945,MATH 109,A01,083213,Anzaldo; Leesa B,0,7,30,30
1650771755945,MATH 109,A02,083214,Anzaldo; Leesa B,0,7,30,30
1650771755945,MATH 109,B01,083215,Anzaldo; Leesa B,0,8,30,30
1650771755945,MATH 109,B02,083216,Anzaldo; Leesa B,0,7,30,30
1650771761969,MATH 142A,A01,083219,Chow; Bennett,0,16,30,30
1650771761969,MATH 142A,A02,083220,Chow; Bennett,0,15,30,30
1650771761969,MATH 142A,B01,083221,Chow; Bennett,0,15,30,30
1650771761969,MATH 142A,B02,083222,Chow; Bennett,0,14,30,30
1650771767993,MATH 193A,A01,083224,Staff,0,6,30,30
1650771767993,MATH 193A,A02,083225,Staff,0,6,30,30
1650771767993,MATH 193A,A03,083781,Staff,0,6,30,30
1650771767993,MATH 193A,A04,083782,Staff,0,7,30,30
1650771774018,MATH 197,001,091859,McAuley; Julian John,9998,0,9999,1
1650771780073,COGS 9,A01,083615,Staff,1,17,60,59
1650771786097,COGS 11,A01,083617,Boyle; Mary E. T.,16,0,40,24
1650771792120,COGS 13,A01,083071,Staff,0,38,40,40
1650771798144,COGS 14A,A01,092681,Staff,0,36,100,100
1650771804167,COGS 14B,A01,083073,Cheng; Tzu-Han,1,13,50,49
1650771810193,COGS 17,A01,092677,Staff,11,0,75,64
1650771816219,COGS 100,A01,083619,Staff,0,29,60,60
1650771822245,COGS 101A,A01,083621,Davis; Joshua Daniel,0,28,60,60
1650771828272,COGS 101B,A01,091572,Staff,1,4,60,59
1650771834294,COGS 101C,A01,083625,Delgado; Tania,14,0,30,16
1650771840321,COGS 107A,A01,083627,Boyle; Mary E. T.,0,16,60,60
1650771846344,COGS 118A,A01,083075,Staff,0,8,60,60
1650771852369,CSE 3,A50,083646,Miranda; Gregory Joseph,18,0,38,20
1650771852369,CSE 3,A51,083647,Miranda; Gregory Joseph,36,0,37,1
1650771858392,CSE 8A,A50,083650,Miranda; Gregory Joseph,0,30,40,40
1650771864416,CSE 11,A01,083080,Cao; Yingjun,0,96,40,40
1650771870442,CSE 12,A01,083652,Staff,0,21,100,100
1650771876468,CSE 15L,A01,083654,Staff,0,3,50,50
1650771876468,CSE 15L,A02,083655,Staff,0,2,50,50
1650771882495,CSE 20,A01,083657,Staff,49,0,80,31
1650771888519,CSE 30,A01,083084,Eldon; John,0,76,40,40
1650771894551,CSE 100,A01,083659,Cao; Yingjun,0,71,50,50
1650771900574,CSE 134B,A01,083661,Powell; Thomas Allan,0,38,65,65
1650771906596,CSE 140,A01,083663,Staff,0,11,75,75
1650771912618,CSE 140L,A01,083088,Eldon; John,0,20,75,75
1650771918641,CSE 175,A01,083665,Kumar; Rakesh,7,0,25,18
1650771924671,CSE 190,A00,092507,Dubnov; Shlomo,10,0,20,10
1650771930698,ECE 45,A01,083139,Staff,1,2,60,59
1650771936722,ECE 65,A50,083695,Staff,0,5,30,30
1650771942746,ECE 109,A01,091882,Touri; Behrouz,32,0,70,38
1650771948769,ECE 180,A00,083140,Abi Samra; Nicholas Camill,20,0,30,10
1650771948769,ECE 180,B00,083141,Abi Samra; Nicholas Camill,0,0,30,30
1650771954794,MATH 10A,A01,083735,Patchell; Gregory David,2,0,30,28
1650771954794,MATH 10A,A02,083736,Patchell; Gregory David,27,0,30,3
1650771954794,MATH 10A,A03,083737,Patchell; Gregory David,24,0,30,6
1650771960822,MATH 10B,A01,083207,Staff,0,9,30,30
1650771960822,MATH 10B,A02,083208,Staff,1,7,30,29
1650771960822,MATH 10B,B01,083739,Staff,11,0,30,19
1650771960822,MATH 10B,B02,083740,Staff,28,0,30,2
1650771966847,MATH 18,A01,083743,Staff,0,0,30,30
1650771966847,MATH 18,A02,083744,Staff,23,0,30,7
1650771966847,MATH 18,A03,083745,Staff,21,0,30,9
1650771966847,MATH 18,A04,083746,Staff,26,0,30,4
1650771966847,MATH 18,B01,083748,Staff,0,15,30,30
1650771966847,MATH 18,B02,083749,Staff,0,12,30,30
1650771966847,MATH 18,B03,083750,Staff,0,12,30,30
1650771966847,MATH 18,B04,083751,Staff,0,12,30,30
1650771972874,MATH 20A,A01,083754,Staff,19,0,40,21
1650771978901,MATH 20B,A01,083756,Staff,0,13,30,30
1650771978901,MATH 20B,A02,083757,Staff,0,12,30,30
1650771984925,MATH 20C,A01,083760,Staff,0,16,30,30
1650771984925,MATH 20C,A02,083761,Staff,0,16,30,30
1650771984925,MATH 20C,B01,083762,Staff,9,0,30,21
1650771984925,MATH 20C,B02,083763,Staff,28,0,30,2
1650771990949,MATH 20D,A01,083765,Staff,2,1,30,28
1650771990949,MATH 20D,A02,083766,Staff,5,0,30,25
1650771990949,MATH 20D,A03,083767,Staff,24,0,30,6
1650771996977,MATH 20E,A01,083771,Staff,2,0,30,28
1650771996977,MATH 20E,A02,083772,Staff,16,0,30,14
1650771996977,MATH 20E,B01,083773,Staff,0,0,30,30
1650771996977,MATH 20E,B02,083774,Staff,5,0,30,25
1650772003020,MATH 103A,A01,083777,Staff,0,16,30,30
1650772003020,MATH 103A,A02,083778,Staff,0,15,30,30
1650772003020,MATH 103A,B01,083779,Staff,0,15,30,30
1650772003020,MATH 103A,B02,083780,Staff,0,15,30,30
1650772009043,MATH 105,A01,085443,Staff,0,22,30,30
1650772015071,MATH 109,A01,083213,Anzaldo; Leesa B,0,7,30,30
1650772015071,MATH 109,A02,083214,Anzaldo; Leesa B,0,7,30,30
1650772015071,MATH 109,B01,083215,Anzaldo; Leesa B,0,8,30,30
1650772015071,MATH 109,B02,083216,Anzaldo; Leesa B,0,7,30,30
1650772021098,MATH 142A,A01,083219,Chow; Bennett,0,16,30,30
1650772021098,MATH 142A,A02,083220,Chow; Bennett,0,15,30,30
1650772021098,MATH 142A,B01,083221,Chow; Bennett,0,15,30,30
1650772021098,MATH 142A,B02,083222,Chow; Bennett,0,14,30,30
1650772027125,MATH 193A,A01,083224,Staff,0,6,30,30
1650772027125,MATH 193A,A02,083225,Staff,0,6,30,30
1650772027125,MATH 193A,A03,083781,Staff,0,6,30,30
1650772027125,MATH 193A,A04,083782,Staff,0,7,30,30
1650772033148,MATH 197,001,091859,McAuley; Julian John,9998,0,9999,1
1650772039199,COGS 9,A01,083615,Staff,1,17,60,59
1650772045228,COGS 11,A01,083617,Boyle; Mary E. T.,16,0,40,24
1650772051252,COGS 13,A01,083071,Staff,0,38,40,40
1650772057278,COGS 14A,A01,092681,Staff,0,36,100,100
1650772063304,COGS 14B,A01,083073,Cheng; Tzu-Han,1,13,50,49
1650772069328,COGS 17,A01,092677,Staff,11,0,75,64
1650772075352,COGS 100,A01,083619,Staff,0,29,60,60
1650772081379,COGS 101A,A01,083621,Davis; Joshua Daniel,0,28,60,60
1650772087403,COGS 101B,A01,091572,Staff,1,4,60,59
1650772093425,COGS 101C,A01,083625,Delgado; Tania,14,0,30,16
1650772099453,COGS 107A,A01,083627,Boyle; Mary E. T.,0,16,60,60
1650772105476,COGS 118A,A01,083075,Staff,0,8,60,60
1650772111504,CSE 3,A50,083646,Miranda; Gregory Joseph,18,0,38,20
1650772111504,CSE 3,A51,083647,Miranda; Gregory Joseph,36,0,37,1
1650772117529,CSE 8A,A50,083650,Miranda; Gregory Joseph,0,30,40,40
1650772123556,CSE 11,A01,083080,Cao; Yingjun,0,96,40,40
1650772129580,CSE 12,A01,083652,Staff,0,21,100,100
1650772135612,CSE 15L,A01,083654,Staff,0,3,50,50
1650772135612,CSE 15L,A02,083655,Staff,0,2,50,50
1650772141638,CSE 20,A01,083657,Staff,49,0,80,31
1650772147664,CSE 30,A01,083084,Eldon; John,0,76,40,40
1650772153687,CSE 100,A01,083659,Cao; Yingjun,0,71,50,50
1650772159808,CSE 134B,A01,083661,Powell; Thomas Allan,0,38,65,65
1650772165832,CSE 140,A01,083663,Staff,0,11,75,75
1650772171856,CSE 140L,A01,083088,Eldon; John,0,20,75,75
1650772177896,CSE 175,A01,083665,Kumar; Rakesh,7,0,25,18
1650772183920,CSE 190,A00,092507,Dubnov; Shlomo,10,0,20,10
1650772189947,ECE 45,A01,083139,Staff,1,2,60,59
1650772195974,ECE 65,A50,083695,Staff,0,5,30,30
1650772201998,ECE 109,A01,091882,Touri; Behrouz,32,0,70,38
1650772208021,ECE 180,A00,083140,Abi Samra; Nicholas Camill,20,0,30,10
1650772208021,ECE 180,B00,083141,Abi Samra; Nicholas Camill,0,0,30,30
1650772214049,MATH 10A,A01,083735,Patchell; Gregory David,2,0,30,28
1650772214049,MATH 10A,A02,083736,Patchell; Gregory David,27,0,30,3
1650772214049,MATH 10A,A03,083737,Patchell; Gregory David,24,0,30,6
1650772220073,MATH 10B,A01,083207,Staff,0,9,30,30
1650772220073,MATH 10B,A02,083208,Staff,1,7,30,29
1650772220073,MATH 10B,B01,083739,Staff,11,0,30,19
1650772220073,MATH 10B,B02,083740,Staff,28,0,30,2
1650772226098,MATH 18,A01,083743,Staff,0,0,30,30
1650772226098,MATH 18,A02,083744,Staff,23,0,30,7
1650772226098,MATH 18,A03,083745,Staff,21,0,30,9
1650772226098,MATH 18,A04,083746,Staff,26,0,30,4
1650772226098,MATH 18,B01,083748,Staff,0,15,30,30
1650772226098,MATH 18,B02,083749,Staff,0,12,30,30
1650772226098,MATH 18,B03,083750,Staff,0,12,30,30
1650772226098,MATH 18,B04,083751,Staff,0,12,30,30
1650772232124,MATH 20A,A01,083754,Staff,19,0,40,21
1650772238148,MATH 20B,A01,083756,Staff,0,13,30,30
1650772238148,MATH 20B,A02,083757,Staff,0,12,30,30
1650772244172,MATH 20C,A01,083760,Staff,0,16,30,30
1650772244172,MATH 20C,A02,083761,Staff,0,16,30,30
1650772244172,MATH 20C,B01,083762,Staff,9,0,30,21
1650772244172,MATH 20C,B02,083763,Staff,28,0,30,2
1650772250198,MATH 20D,A01,083765,Staff,2,1,30,28
1650772250198,MATH 20D,A02,083766,Staff,5,0,30,25
1650772250198,MATH 20D,A03,083767,Staff,24,0,30,6
1650772256230,MATH 20E,A01,083771,Staff,2,0,30,28
1650772256230,MATH 20E,A02,083772,Staff,16,0,30,14
1650772256230,MATH 20E,B01,083773,Staff,0,0,30,30
1650772256230,MATH 20E,B02,083774,Staff,5,0,30,25
1650772262267,MATH 103A,A01,083777,Staff,0,16,30,30
1650772262267,MATH 103A,A02,083778,Staff,0,15,30,30
1650772262267,MATH 103A,B01,083779,Staff,0,15,30,30
1650772262267,MATH 103A,B02,083780,Staff,0,15,30,30
1650772268300,MATH 105,A01,085443,Staff,0,22,30,30
1650772274322,MATH 109,A01,083213,Anzaldo; Leesa B,0,7,30,30
1650772274322,MATH 109,A02,083214,Anzaldo; Leesa B,0,7,30,30
1650772274322,MATH 109,B01,083215,Anzaldo; Leesa B,0,8,30,30
1650772274322,MATH 109,B02,083216,Anzaldo; Leesa B,0,7,30,30
1650772280351,MATH 142A,A01,083219,Chow; Bennett,0,16,30,30
1650772280351,MATH 142A,A02,083220,Chow; Bennett,0,15,30,30
1650772280351,MATH 142A,B01,083221,Chow; Bennett,0,15,30,30
1650772280351,MATH 142A,B02,083222,Chow; Bennett,0,14,30,30
1650772286378,MATH 193A,A01,083224,Staff,0,6,30,30
1650772286378,MATH 193A,A02,083225,Staff,0,6,30,30
1650772286378,MATH 193A,A03,083781,Staff,0,6,30,30
1650772286378,MATH 193A,A04,083782,Staff,0,7,30,30
1650772292404,MATH 197,001,091859,McAuley; Julian John,9998,0,9999,1
1650772298456,COGS 9,A01,083615,Staff,1,17,60,59
1650772304484,COGS 11,A01,083617,Boyle; Mary E. T.,16,0,40,24
1650772310508,COGS 13,A01,083071,Staff,0,38,40,40
1650772316533,COGS 14A,A01,092681,Staff,0,36,100,100
1650772322557,COGS 14B,A01,083073,Cheng; Tzu-Han,1,13,50,49
1650772328580,COGS 17,A01,092677,Staff,11,0,75,64
1650772334607,COGS 100,A01,083619,Staff,0,29,60,60
1650772340635,COGS 101A,A01,083621,Davis; Joshua Daniel,0,28,60,60
1650772346659,COGS 101B,A01,091572,Staff,1,4,60,59
1650772352683,COGS 101C,A01,083625,Delgado; Tania,14,0,30,16
1650772358714,COGS 107A,A01,083627,Boyle; Mary E. T.,0,16,60,60
1650772364738,COGS 118A,A01,083075,Staff,0,8,60,60
1650772370763,CSE 3,A50,083646,Miranda; Gregory Joseph,18,0,38,20
1650772370763,CSE 3,A51,083647,Miranda; Gregory Joseph,36,0,37,1
1650772376791,CSE 8A,A50,083650,Miranda; Gregory Joseph,0,30,40,40
1650772382814,CSE 11,A01,083080,Cao; Yingjun,0,96,40,40
1650772388844,CSE 12,A01,083652,Staff,0,21,100,100
1650772394870,CSE 15L,A01,083654,Staff,0,3,50,50
1650772394870,CSE 15L,A02,083655,Staff,0,2,50,50
1650772400893,CSE 20,A01,083657,Staff,49,0,80,31
1650772406921,CSE 30,A01,083084,Eldon; John,0,76,40,40
1650772412946,CSE 100,A01,083659,Cao; Yingjun,0,71,50,50
1650772418971,CSE 134B,A01,083661,Powell; Thomas Allan,0,38,65,65
1650772424994,CSE 140,A01,083663,Staff,0,11,75,75
1650772431022,CSE 140L,A01,083088,Eldon; John,0,20,75,75
1650772437047,CSE 175,A01,083665,Kumar; Rakesh,7,0,25,18
1650772443074,CSE 190,A00,092507,Dubnov; Shlomo,10,0,20,10
1650772449098,ECE 45,A01,083139,Staff,1,2,60,59
1650772455127,ECE 65,A50,083695,Staff,0,5,30,30
1650772461153,ECE 109,A01,091882,Touri; Behrouz,32,0,70,38
1650772467178,ECE 180,A00,083140,Abi Samra; Nicholas Camill,20,0,30,10
1650772467178,ECE 180,B00,083141,Abi Samra; Nicholas Camill,0,0,30,30
1650772473205,MATH 10A,A01,083735,Patchell; Gregory David,2,0,30,28
1650772473205,MATH 10A,A02,083736,Patchell; Gregory David,27,0,30,3
1650772473205,MATH 10A,A03,083737,Patchell; Gregory David,24,0,30,6
1650772479233,MATH 10B,A01,083207,Staff,0,9,30,30
1650772479233,MATH 10B,A02,083208,Staff,1,7,30,29
1650772479233,MATH 10B,B01,083739,Staff,11,0,30,19
1650772479233,MATH 10B,B02,083740,Staff,28,0,30,2
1650772485258,MATH 18,A01,083743,Staff,0,0,30,30
1650772485258,MATH 18,A02,083744,Staff,23,0,30,7
1650772485258,MATH 18,A03,083745,Staff,21,0,30,9
1650772485258,MATH 18,A04,083746,Staff,26,0,30,4
1650772485258,MATH 18,B01,083748,Staff,0,15,30,30
1650772485258,MATH 18,B02,083749,Staff,0,12,30,30
1650772485258,MATH 18,B03,083750,Staff,0,12,30,30
1650772485258,MATH 18,B04,083751,Staff,0,12,30,30
1650772491283,MATH 20A,A01,083754,Staff,19,0,40,21
1650772497306,MATH 20B,A01,083756,Staff,0,13,30,30
1650772497306,MATH 20B,A02,083757,Staff,0,12,30,30
1650772503337,MATH 20C,A01,083760,Staff,0,16,30,30
1650772503337,MATH 20C,A02,083761,Staff,0,16,30,30
1650772503337,MATH 20C,B01,083762,Staff,9,0,30,21
1650772503337,MATH 20C,B02,083763,Staff,28,0,30,2
1650772509364,MATH 20D,A01,083765,Staff,2,1,30,28
1650772509364,MATH 20D,A02,083766,Staff,5,0,30,25
1650772509364,MATH 20D,A03,083767,Staff,24,0,30,6
1650772515388,MATH 20E,A01,083771,Staff,2,0,30,28
1650772515388,MATH 20E,A02,083772,Staff,16,0,30,14
1650772515388,MATH 20E,B01,083773,Staff,0,0,30,30
1650772515388,MATH 20E,B02,083774,Staff,5,0,30,25
1650772521412,MATH 103A,A01,083777,Staff,0,16,30,30
1650772521412,MATH 103A,A02,083778,Staff,0,15,30,30
1650772521412,MATH 103A,B01,083779,Staff,0,15,30,30
1650772521412,MATH 103A,B02,083780,Staff,0,15,30,30
1650772527438,MATH 105,A01,085443,Staff,0,22,30,30
1650772533460,MATH 109,A01,083213,Anzaldo; Leesa B,0,7,30,30
1650772533460,MATH 109,A02,083214,Anzaldo; Leesa B,0,7,30,30
1650772533460,MATH 109,B01,083215,Anzaldo; Leesa B,0,8,30,30
1650772533460,MATH 109,B02,083216,Anzaldo; Leesa B,0,7,30,30
1650772539489,MATH 142A,A01,083219,Chow; Bennett,0,16,30,30
1650772539489,MATH 142A,A02,083220,Chow; Bennett,0,15,30,30
1650772539489,MATH 142A,B01,083221,Chow; Bennett,0,15,30,30
1650772539489,MATH 142A,B02,083222,Chow; Bennett,0,14,30,30
1650772545512,MATH 193A,A01,083224,Staff,0,6,30,30
1650772545512,MATH 193A,A02,083225,Staff,0,6,30,30
1650772545512,MATH 193A,A03,083781,Staff,0,6,30,30
1650772545512,MATH 193A,A04,083782,Staff,0,7,30,30
1650772551534,MATH 197,001,091859,McAuley; Julian John,9998,0,9999,1
1650772557602,COGS 9,A01,083615,Staff,1,18,60,59
1650772563625,COGS 11,A01,083617,Boyle; Mary E. T.,16,0,40,24
1650772569652,COGS 13,A01,083071,Staff,0,38,40,40
1650772575674,COGS 14A,A01,092681,Staff,0,36,100,100
1650772581698,COGS 14B,A01,083073,Cheng; Tzu-Han,1,13,50,49
1650772587722,COGS 17,A01,092677,Staff,11,0,75,64
1650772593747,COGS 100,A01,083619,Staff,0,29,60,60
1650772599773,COGS 101A,A01,083621,Davis; Joshua Daniel,0,28,60,60
1650772605795,COGS 101B,A01,091572,Staff,1,4,60,59
1650772611818,COGS 101C,A01,083625,Delgado; Tania,14,0,30,16
1650772617846,COGS 107A,A01,083627,Boyle; Mary E. T.,0,16,60,60
1650772623873,COGS 118A,A01,083075,Staff,0,8,60,60
1650772629899,CSE 3,A50,083646,Miranda; Gregory Joseph,18,0,38,20
1650772629899,CSE 3,A51,083647,Miranda; Gregory Joseph,36,0,37,1
1650772635922,CSE 8A,A50,083650,Miranda; Gregory Joseph,0,30,40,40
1650772641945,CSE 11,A01,083080,Cao; Yingjun,0,96,40,40
1650772647972,CSE 12,A01,083652,Staff,0,21,100,100
1650772653997,CSE 15L,A01,083654,Staff,0,3,50,50
1650772653997,CSE 15L,A02,083655,Staff,0,2,50,50
1650772660024,CSE 20,A01,083657,Staff,49,0,80,31
1650772666052,CSE 30,A01,083084,Eldon; John,0,76,40,40
1650772672075,CSE 100,A01,083659,Cao; Yingjun,0,71,50,50
1650772678103,CSE 134B,A01,083661,Powell; Thomas Allan,0,38,65,65
1650772684127,CSE 140,A01,083663,Staff,0,11,75,75
1650772690151,CSE 140L,A01,083088,Eldon; John,0,20,75,75
1650772696178,CSE 175,A01,083665,Kumar; Rakesh,7,0,25,18
1650772702202,CSE 190,A00,092507,Dubnov; Shlomo,10,0,20,10
1650772708226,ECE 45,A01,083139,Staff,1,2,60,59
1650772714251,ECE 65,A50,083695,Staff,0,5,30,30
1650772720280,ECE 109,A01,091882,Touri; Behrouz,32,0,70,38
1650772726309,ECE 180,A00,083140,Abi Samra; Nicholas Camill,20,0,30,10
1650772726309,ECE 180,B00,083141,Abi Samra; Nicholas Camill,0,0,30,30
1650772732334,MATH 10A,A01,083735,Patchell; Gregory David,2,0,30,28
1650772732334,MATH 10A,A02,083736,Patchell; Gregory David,27,0,30,3
1650772732334,MATH 10A,A03,083737,Patchell; Gregory David,24,0,30,6
1650772738361,MATH 10B,A01,083207,Staff,0,9,30,30
1650772738361,MATH 10B,A02,083208,Staff,1,7,30,29
1650772738361,MATH 10B,B01,083739,Staff,11,0,30,19
1650772738361,MATH 10B,B02,083740,Staff,28,0,30,2
1650772744387,MATH 18,A01,083743,Staff,0,0,30,30
1650772744387,MATH 18,A02,083744,Staff,23,0,30,7
1650772744387,MATH 18,A03,083745,Staff,21,0,30,9
1650772744387,MATH 18,A04,083746,Staff,26,0,30,4
1650772744387,MATH 18,B01,083748,Staff,0,15,30,30
1650772744387,MATH 18,B02,083749,Staff,0,12,30,30
1650772744387,MATH 18,B03,083750,Staff,0,12,30,30
1650772744387,MATH 18,B04,083751,Staff,0,12,30,30
1650772750410,MATH 20A,A01,083754,Staff,19,0,40,21
1650772756530,MATH 20B,A01,083756,Staff,0,13,30,30
1650772756530,MATH 20B,A02,083757,Staff,0,12,30,30
1650772762555,MATH 20C,A01,083760,Staff,0,16,30,30
1650772762555,MATH 20C,A02,083761,Staff,0,16,30,30
1650772762555,MATH 20C,B01,083762,Staff,9,0,30,21
1650772762555,MATH 20C,B02,083763,Staff,28,0,30,2
1650772768583,MATH 20D,A01,083765,Staff,2,1,30,28
1650772768583,MATH 20D,A02,083766,Staff,5,0,30,25
1650772768583,MATH 20D,A03,083767,Staff,24,0,30,6
1650772774610,MATH 20E,A01,083771,Staff,2,0,30,28
1650772774610,MATH 20E,A02,083772,Staff,16,0,30,14
1650772774610,MATH 20E,B01,083773,Staff,0,0,30,30
1650772774610,MATH 20E,B02,083774,Staff,5,0,30,25
1650772780633,MATH 103A,A01,083777,Staff,0,16,30,30
1650772780633,MATH 103A,A02,083778,Staff,0,15,30,30
1650772780633,MATH 103A,B01,083779,Staff,0,15,30,30
1650772780633,MATH 103A,B02,083780,Staff,0,15,30,30
1650772786655,MATH 105,A01,085443,Staff,0,22,30,30
1650772792682,MATH 109,A01,083213,Anzaldo; Leesa B,0,7,30,30
1650772792682,MATH 109,A02,083214,Anzaldo; Leesa B,0,7,30,30
1650772792682,MATH 109,B01,083215,Anzaldo; Leesa B,0,8,30,30
1650772792682,MATH 109,B02,083216,Anzaldo; Leesa B,0,7,30,30
1650772798710,MATH 142A,A01,083219,Chow; Bennett,0,16,30,30
1650772798710,MATH 142A,A02,083220,Chow; Bennett,0,15,30,30
1650772798710,MATH 142A,B01,083221,Chow; Bennett,0,15,30,30
1650772798710,MATH 142A,B02,083222,Chow; Bennett,0,14,30,30
1650772804738,MATH 193A,A01,083224,Staff,0,6,30,30
1650772804738,MATH 193A,A02,083225,Staff,0,6,30,30
1650772804738,MATH 193A,A03,083781,Staff,0,6,30,30
1650772804738,MATH 193A,A04,083782,Staff,0,7,30,30
1650772810765,MATH 197,001,091859,McAuley; Julian John,9998,0,9999,1
1650772816816,COGS 9,A01,083615,Staff,1,18,60,59
1650772822837,COGS 11,A01,083617,Boyle; Mary E. T.,16,0,40,24
1650772828864,COGS 13,A01,083071,Staff,0,38,40,40
1650772834888,COGS 14A,A01,092681,Staff,0,36,100,100
1650772840911,COGS 14B,A01,083073,Cheng; Tzu-Han,1,13,50,49
1650772846933,COGS 17,A01,092677,Staff,11,0,75,64
1650772852959,COGS 100,A01,083619,Staff,0,29,60,60
1650772858982,COGS 101A,A01,083621,Davis; Joshua Daniel,0,28,60,60
1650772865006,COGS 101B,A01,091572,Staff,1,4,60,59
1650772871035,COGS 101C,A01,083625,Delgado; Tania,14,0,30,16
1650772877059,COGS 107A,A01,083627,Boyle; Mary E. T.,0,16,60,60
1650772883083,COGS 118A,A01,083075,Staff,0,8,60,60
1650772889108,CSE 3,A50,083646,Miranda; Gregory Joseph,18,0,38,20
1650772889108,CSE 3,A51,083647,Miranda; Gregory Joseph,36,0,37,1
1650772895137,CSE 8A,A50,083650,Miranda; Gregory Joseph,0,30,40,40
1650772901160,CSE 11,A01,083080,Cao; Yingjun,0,96,40,40
1650772907184,CSE 12,A01,083652,Staff,0,21,100,100
1650772913209,CSE 15L,A01,083654,Staff,0,3,50,50
1650772913209,CSE 15L,A02,083655,Staff,0,2,50,50
1650772919233,CSE 20,A01,083657,Staff,49,0,80,31
1650772925261,CSE 30,A01,083084,Eldon; John,0,76,40,40
1650772931284,CSE 100,A01,083659,Cao; Yingjun,0,71,50,50
1650772937308,CSE 134B,A01,083661,Powell; Thomas Allan,0,38,65,65
1650772943331,CSE 140,A01,083663,Staff,0,11,75,75
1650772949363,CSE 140L,A01,083088,Eldon; John,0,20,75,75
1650772955386,CSE 175,A01,083665,Kumar; Rakesh,7,0,25,18
1650772961409,CSE 190,A00,092507,Dubnov; Shlomo,10,0,20,10
1650772967432,ECE 45,A01,083139,Staff,1,2,60,59
1650772973460,ECE 65,A50,083695,Staff,0,5,30,30
1650772979497,ECE 109,A01,091882,Touri; Behrouz,32,0,70,38
1650772985523,ECE 180,A00,083140,Abi Samra; Nicholas Camill,20,0,30,10
1650772985523,ECE 180,B00,083141,Abi Samra; Nicholas Camill,0,0,30,30
1650772991551,MATH 10A,A01,083735,Patchell; Gregory David,2,0,30,28
1650772991551,MATH 10A,A02,083736,Patchell; Gregory David,27,0,30,3
1650772991551,MATH 10A,A03,083737,Patchell; Gregory David,24,0,30,6
1650772997593,MATH 10B,A01,083207,Staff,0,9,30,30
1650772997593,MATH 10B,A02,083208,Staff,1,7,30,29
1650772997593,MATH 10B,B01,083739,Staff,11,0,30,19
1650772997593,MATH 10B,B02,083740,Staff,28,0,30,2
1650773003628,MATH 18,A01,083743,Staff,0,0,30,30
1650773003628,MATH 18,A02,083744,Staff,23,0,30,7
1650773003628,MATH 18,A03,083745,Staff,21,0,30,9
1650773003628,MATH 18,A04,083746,Staff,26,0,30,4
1650773003628,MATH 18,B01,083748,Staff,0,15,30,30
1650773003628,MATH 18,B02,083749,Staff,0,12,30,30
1650773003628,MATH 18,B03,083750,Staff,0,12,30,30
1650773003628,MATH 18,B04,083751,Staff,0,12,30,30
1650773009654,MATH 20A,A01,083754,Staff,19,0,40,21
1650773015678,MATH 20B,A01,083756,Staff,0,13,30,30
1650773015678,MATH 20B,A02,083757,Staff,0,12,30,30
1650773021704,MATH 20C,A01,083760,Staff,0,16,30,30
1650773021704,MATH 20C,A02,083761,Staff,0,16,30,30
1650773021704,MATH 20C,B01,083762,Staff,9,0,30,21
1650773021704,MATH 20C,B02,083763,Staff,28,0,30,2
1650773027738,MATH 20D,A01,083765,Staff,2,1,30,28
1650773027738,MATH 20D,A02,083766,Staff,5,0,30,25
1650773027738,MATH 20D,A03,083767,Staff,24,0,30,6
1650773033767,MATH 20E,A01,083771,Staff,2,0,30,28
1650773033767,MATH 20E,A02,083772,Staff,16,0,30,14
1650773033767,MATH 20E,B01,083773,Staff,0,0,30,30
1650773033767,MATH 20E,B02,083774,Staff,5,0,30,25
1650773039796,MATH 103A,A01,083777,Staff,0,16,30,30
1650773039796,MATH 103A,A02,083778,Staff,0,15,30,30
1650773039796,MATH 103A,B01,083779,Staff,0,15,30,30
1650773039796,MATH 103A,B02,083780,Staff,0,15,30,30
1650773045822,MATH 105,A01,085443,Staff,0,22,30,30
1650773051846,MATH 109,A01,083213,Anzaldo; Leesa B,0,7,30,30
1650773051846,MATH 109,A02,083214,Anzaldo; Leesa B,0,7,30,30
1650773051846,MATH 109,B01,083215,Anzaldo; Leesa B,0,8,30,30
1650773051846,MATH 109,B02,083216,Anzaldo; Leesa B,0,7,30,30
1650773057879,MATH 142A,A01,083219,Chow; Bennett,0,16,30,30
1650773057879,MATH 142A,A02,083220,Chow; Bennett,0,15,30,30
1650773057879,MATH 142A,B01,083221,Chow; Bennett,0,15,30,30
1650773057879,MATH 142A,B02,083222,Chow; Bennett,0,14,30,30
1650773063905,MATH 193A,A01,083224,Staff,0,6,30,30
1650773063905,MATH 193A,A02,083225,Staff,0,6,30,30
1650773063905,MATH 193A,A03,083781,Staff,0,6,30,30
1650773063905,MATH 193A,A04,083782,Staff,0,7,30,30
1650773069931,MATH 197,001,091859,McAuley; Julian John,9998,0,9999,1
1650773075982,COGS 9,A01,083615,Staff,1,18,60,59
1650773082007,COGS 11,A01,083617,Boyle; Mary E. T.,16,0,40,24
1650773088036,COGS 13,A01,083071,Staff,0,38,40,40
1650773094062,COGS 14A,A01,092681,Staff,0,36,100,100
1650773100086,COGS 14B,A01,083073,Cheng; Tzu-Han,1,13,50,49
1650773106110,COGS 17,A01,092677,Staff,11,0,75,64
1650773112133,COGS 100,A01,083619,Staff,0,29,60,60
1650773118160,COGS 101A,A01,083621,Davis; Joshua Daniel,0,28,60,60
1650773124193,COGS 101B,A01,091572,Staff,1,4,60,59
1650773130217,COGS 101C,A01,083625,Delgado; Tania,14,0,30,16
1650773136244,COGS 107A,A01,083627,Boyle; Mary E. T.,0,16,60,60
1650773142268,COGS 118A,A01,083075,Staff,0,8,60,60
1650773148297,CSE 3,A50,083646,Miranda; Gregory Joseph,18,0,38,20
1650773148297,CSE 3,A51,083647,Miranda; Gregory Joseph,36,0,37,1
1650773154325,CSE 8A,A50,083650,Miranda; Gregory Joseph,0,30,40,40
1650773160353,CSE 11,A01,083080,Cao; Yingjun,0,96,40,40
1650773166377,CSE 12,A01,083652,Staff,0,21,100,100
1650773172400,CSE 15L,A01,083654,Staff,0,3,50,50
1650773172400,CSE 15L,A02,083655,Staff,0,2,50,50
1650773178424,CSE 20,A01,083657,Staff,49,0,80,31
1650773184447,CSE 30,A01,083084,Eldon; John,0,76,40,40
1650773190471,CSE 100,A01,083659,Cao; Yingjun,0,71,50,50
1650773196500,CSE 134B,A01,083661,Powell; Thomas Allan,0,38,65,65
1650773202524,CSE 140,A01,083663,Staff,0,11,75,75
1650773208550,CSE 140L,A01,083088,Eldon; John,0,20,75,75
1650773214574,CSE 175,A01,083665,Kumar; Rakesh,7,0,25,18
1650773220602,CSE 190,A00,092507,Dubnov; Shlomo,10,0,20,10
1650773226629,ECE 45,A01,083139,Staff,1,2,60,59
1650773232653,ECE 65,A50,083695,Staff,0,5,30,30
1650773238677,ECE 109,A01,091882,Touri; Behrouz,32,0,70,38
1650773244709,ECE 180,A00,083140,Abi Samra; Nicholas Camill,20,0,30,10
1650773244709,ECE 180,B00,083141,Abi Samra; Nicholas Camill,0,0,30,30
1650773250736,MATH 10A,A01,083735,Patchell; Gregory David,2,0,30,28
1650773250736,MATH 10A,A02,083736,Patchell; Gregory David,27,0,30,3
1650773250736,MATH 10A,A03,083737,Patchell; Gregory David,24,0,30,6
1650773256764,MATH 10B,A01,083207,Staff,0,9,30,30
1650773256764,MATH 10B,A02,083208,Staff,1,7,30,29
1650773256764,MATH 10B,B01,083739,Staff,11,0,30,19
1650773256764,MATH 10B,B02,083740,Staff,28,0,30,2
1650773262788,MATH 18,A01,083743,Staff,0,0,30,30
1650773262788,MATH 18,A02,083744,Staff,23,0,30,7
1650773262788,MATH 18,A03,083745,Staff,21,0,30,9
1650773262788,MATH 18,A04,083746,Staff,26,0,30,4
1650773262788,MATH 18,B01,083748,Staff,0,15,30,30
1650773262788,MATH 18,B02,083749,Staff,0,12,30,30
1650773262788,MATH 18,B03,083750,Staff,0,12,30,30
1650773262788,MATH 18,B04,083751,Staff,0,12,30,30
1650773268812,MATH 20A,A01,083754,Staff,19,0,40,21
1650773274836,MATH 20B,A01,083756,Staff,0,13,30,30
1650773274836,MATH 20B,A02,083757,Staff,0,12,30,30
1650773280869,MATH 20C,A01,083760,Staff,0,16,30,30
1650773280869,MATH 20C,A02,083761,Staff,0,16,30,30
1650773280869,MATH 20C,B01,083762,Staff,9,0,30,21
1650773280869,MATH 20C,B02,083763,Staff,28,0,30,2
1650773286901,MATH 20D,A01,083765,Staff,2,1,30,28
1650773286901,MATH 20D,A02,083766,Staff,5,0,30,25
1650773286901,MATH 20D,A03,083767,Staff,24,0,30,6
1650773292923,MATH 20E,A01,083771,Staff,2,0,30,28
1650773292923,MATH 20E,A02,083772,Staff,16,0,30,14
1650773292923,MATH 20E,B01,083773,Staff,0,0,30,30
1650773292923,MATH 20E,B02,083774,Staff,5,0,30,25
1650773298948,MATH 103A,A01,083777,Staff,0,16,30,30
1650773298948,MATH 103A,A02,083778,Staff,0,15,30,30
1650773298948,MATH 103A,B01,083779,Staff,0,15,30,30
1650773298948,MATH 103A,B02,083780,Staff,0,15,30,30
1650773304972,MATH 105,A01,085443,Staff,0,22,30,30
1650773310997,MATH 109,A01,083213,Anzaldo; Leesa B,0,7,30,30
1650773310997,MATH 109,A02,083214,Anzaldo; Leesa B,0,7,30,30
1650773310997,MATH 109,B01,083215,Anzaldo; Leesa B,0,8,30,30
1650773310997,MATH 109,B02,083216,Anzaldo; Leesa B,0,7,30,30
1650773317021,MATH 142A,A01,083219,Chow; Bennett,0,16,30,30
1650773317021,MATH 142A,A02,083220,Chow; Bennett,0,15,30,30
1650773317021,MATH 142A,B01,083221,Chow; Bennett,0,15,30,30
1650773317021,MATH 142A,B02,083222,Chow; Bennett,0,14,30,30
1650773323043,MATH 193A,A01,083224,Staff,0,6,30,30
1650773323043,MATH 193A,A02,083225,Staff,0,6,30,30
1650773323043,MATH 193A,A03,083781,Staff,0,6,30,30
1650773323043,MATH 193A,A04,083782,Staff,0,7,30,30
1650773329077,MATH 197,001,091859,McAuley; Julian John,9998,0,9999,1
1650773335149,COGS 9,A01,083615,Staff,1,18,60,59
1650773341172,COGS 11,A01,083617,Boyle; Mary E. T.,16,0,40,24
1650773347284,COGS 13,A01,083071,Staff,0,38,40,40
1650773353305,COGS 14A,A01,092681,Staff,0,36,100,100
1650773359329,COGS 14B,A01,083073,Cheng; Tzu-Han,1,13,50,49
1650773365354,COGS 17,A01,092677,Staff,11,0,75,64
1650773371380,COGS 100,A01,083619,Staff,0,29,60,60
1650773377405,COGS 101A,A01,083621,Davis; Joshua Daniel,0,28,60,60
1650773383431,COGS 101B,A01,091572,Staff,1,4,60,59
1650773389457,COGS 101C,A01,083625,Delgado; Tania,14,0,30,16
1650773395485,COGS 107A,A01,083627,Boyle; Mary E. T.,0,16,60,60
1650773401510,COGS 118A,A01,083075,Staff,0,8,60,60
1650773407538,CSE 3,A50,083646,Miranda; Gregory Joseph,18,0,38,20
1650773407538,CSE 3,A51,083647,Miranda; Gregory Joseph,36,0,37,1
1650773413563,CSE 8A,A50,083650,Miranda; Gregory Joseph,0,30,40,40
1650773419588,CSE 11,A01,083080,Cao; Yingjun,0,96,40,40
1650773425611,CSE 12,A01,083652,Staff,0,21,100,100
1650773431638,CSE 15L,A01,083654,Staff,0,3,50,50
1650773431638,CSE 15L,A02,083655,Staff,0,2,50,50
1650773437664,CSE 20,A01,083657,Staff,49,0,80,31
1650773443689,CSE 30,A01,083084,Eldon; John,0,76,40,40
1650773449713,CSE 100,A01,083659,Cao; Yingjun,0,71,50,50
1650773455738,CSE 134B,A01,083661,Powell; Thomas Allan,0,38,65,65
1650773461764,CSE 140,A01,083663,Staff,0,11,75,75
1650773467790,CSE 140L,A01,083088,Eldon; John,0,20,75,75
1650773473815,CSE 175,A01,083665,Kumar; Rakesh,7,0,25,18
1650773479838,CSE 190,A00,092507,Dubnov; Shlomo,10,0,20,10
1650773485863,ECE 45,A01,083139,Staff,1,2,60,59
1650773491903,ECE 65,A50,083695,Staff,0,5,30,30
1650773497932,ECE 109,A01,091882,Touri; Behrouz,32,0,70,38
1650773503955,ECE 180,A00,083140,Abi Samra; Nicholas Camill,20,0,30,10
1650773503955,ECE 180,B00,083141,Abi Samra; Nicholas Camill,0,0,30,30
1650773509979,MATH 10A,A01,083735,Patchell; Gregory David,2,0,30,28
1650773509979,MATH 10A,A02,083736,Patchell; Gregory David,27,0,30,3
1650773509979,MATH 10A,A03,083737,Patchell; Gregory David,24,0,30,6
1650773516014,MATH 10B,A01,083207,Staff,0,9,30,30
1650773516014,MATH 10B,A02,083208,Staff,1,7,30,29
1650773516014,MATH 10B,B01,083739,Staff,11,0,30,19
1650773516014,MATH 10B,B02,083740,Staff,28,0,30,2
1650773522044,MATH 18,A01,083743,Staff,0,0,30,30
1650773522044,MATH 18,A02,083744,Staff,23,0,30,7
1650773522044,MATH 18,A03,083745,Staff,21,0,30,9
1650773522044,MATH 18,A04,083746,Staff,26,0,30,4
1650773522044,MATH 18,B01,083748,Staff,0,15,30,30
1650773522044,MATH 18,B02,083749,Staff,0,12,30,30
1650773522044,MATH 18,B03,083750,Staff,0,12,30,30
1650773522044,MATH 18,B04,083751,Staff,0,12,30,30
1650773528069,MATH 20A,A01,083754,Staff,19,0,40,21
1650773534093,MATH 20B,A01,083756,Staff,0,13,30,30
1650773534093,MATH 20B,A02,083757,Staff,0,12,30,30
1650773540117,MATH 20C,A01,083760,Staff,0,16,30,30
1650773540117,MATH 20C,A02,083761,Staff,0,16,30,30
1650773540117,MATH 20C,B01,083762,Staff,9,0,30,21
1650773540117,MATH 20C,B02,083763,Staff,28,0,30,2
1650773546148,MATH 20D,A01,083765,Staff,2,1,30,28
1650773546148,MATH 20D,A02,083766,Staff,5,0,30,25
1650773546148,MATH 20D,A03,083767,Staff,24,0,30,6
1650773552176,MATH 20E,A01,083771,Staff,2,0,30,28
1650773552176,MATH 20E,A02,083772,Staff,16,0,30,14
1650773552176,MATH 20E,B01,083773,Staff,0,0,30,30
1650773552176,MATH 20E,B02,083774,Staff,5,0,30,25
1650773558205,MATH 103A,A01,083777,Staff,0,16,30,30
1650773558205,MATH 103A,A02,083778,Staff,0,15,30,30
1650773558205,MATH 103A,B01,083779,Staff,0,15,30,30
1650773558205,MATH 103A,B02,083780,Staff,0,15,30,30
1650773564228,MATH 105,A01,085443,Staff,0,22,30,30
1650773570253,MATH 109,A01,083213,Anzaldo; Leesa B,0,7,30,30
1650773570253,MATH 109,A02,083214,Anzaldo; Leesa B,0,7,30,30
1650773570253,MATH 109,B01,083215,Anzaldo; Leesa B,0,8,30,30
1650773570253,MATH 109,B02,083216,Anzaldo; Leesa B,0,7,30,30
1650773576282,MATH 142A,A01,083219,Chow; Bennett,0,16,30,30
1650773576282,MATH 142A,A02,083220,Chow; Bennett,0,15,30,30
1650773576282,MATH 142A,B01,083221,Chow; Bennett,0,15,30,30
1650773576282,MATH 142A,B02,083222,Chow; Bennett,0,14,30,30
1650773582309,MATH 193A,A01,083224,Staff,0,6,30,30
1650773582309,MATH 193A,A02,083225,Staff,0,6,30,30
1650773582309,MATH 193A,A03,083781,Staff,0,6,30,30
1650773582309,MATH 193A,A04,083782,Staff,0,7,30,30
1650773588336,MATH 197,001,091859,McAuley; Julian John,9998,0,9999,1
1650773594400,COGS 9,A01,083615,Staff,1,18,60,59
1650773600436,COGS 11,A01,083617,Boyle; Mary E. T.,16,0,40,24
1650773606471,COGS 13,A01,083071,Staff,0,38,40,40
1650773612495,COGS 14A,A01,092681,Staff,0,36,100,100
1650773618523,COGS 14B,A01,083073,Cheng; Tzu-Han,1,13,50,49
1650773624549,COGS 17,A01,092677,Staff,11,0,75,64
1650773630573,COGS 100,A01,083619,Staff,0,29,60,60
1650773636602,COGS 101A,A01,083621,Davis; Joshua Daniel,0,28,60,60
1650773642632,COGS 101B,A01,091572,Staff,1,4,60,59
1650773648657,COGS 101C,A01,083625,Delgado; Tania,14,0,30,16
1650773654682,COGS 107A,A01,083627,Boyle; Mary E. T.,0,16,60,60
1650773660706,COGS 118A,A01,083075,Staff,0,8,60,60
1650773666729,CSE 3,A50,083646,Miranda; Gregory Joseph,18,0,38,20
1650773666729,CSE 3,A51,083647,Miranda; Gregory Joseph,36,0,37,1
1650773672753,CSE 8A,A50,083650,Miranda; Gregory Joseph,0,30,40,40
1650773678790,CSE 11,A01,083080,Cao; Yingjun,0,96,40,40
1650773684817,CSE 12,A01,083652,Staff,0,21,100,100
1650773690845,CSE 15L,A01,083654,Staff,0,3,50,50
1650773690845,CSE 15L,A02,083655,Staff,0,2,50,50
1650773696872,CSE 20,A01,083657,Staff,49,0,80,31
1650773702900,CSE 30,A01,083084,Eldon; John,0,76,40,40
1650773708924,CSE 100,A01,083659,Cao; Yingjun,0,71,50,50
1650773714949,CSE 134B,A01,083661,Powell; Thomas Allan,0,38,65,65
1650773720972,CSE 140,A01,083663,Staff,0,11,75,75
1650773727002,CSE 140L,A01,083088,Eldon; John,0,20,75,75
1650773733030,CSE 175,A01,083665,Kumar; Rakesh,7,0,25,18
1650773739067,CSE 190,A00,092507,Dubnov; Shlomo,10,0,20,10
1650773745099,ECE 45,A01,083139,Staff,1,2,60,59
1650773751126,ECE 65,A50,083695,Staff,0,5,30,30
1650773757150,ECE 109,A01,091882,Touri; Behrouz,32,0,70,38
1650773763179,ECE 180,A00,083140,Abi Samra; Nicholas Camill,20,0,30,10
1650773763179,ECE 180,B00,083141,Abi Samra; Nicholas Camill,0,0,30,30
1650773769203,MATH 10A,A01,083735,Patchell; Gregory David,2,0,30,28
1650773769203,MATH 10A,A02,083736,Patchell; Gregory David,27,0,30,3
1650773769203,MATH 10A,A03,083737,Patchell; Gregory David,24,0,30,6
1650773775232,MATH 10B,A01,083207,Staff,0,9,30,30
1650773775232,MATH 10B,A02,083208,Staff,1,7,30,29
1650773775232,MATH 10B,B01,083739,Staff,11,0,30,19
1650773775232,MATH 10B,B02,083740,Staff,28,0,30,2
1650773781258,MATH 18,A01,083743,Staff,0,0,30,30
1650773781258,MATH 18,A02,083744,Staff,23,0,30,7
1650773781258,MATH 18,A03,083745,Staff,21,0,30,9
1650773781258,MATH 18,A04,083746,Staff,26,0,30,4
1650773781258,MATH 18,B01,083748,Staff,0,15,30,30
1650773781258,MATH 18,B02,083749,Staff,0,12,30,30
1650773781258,MATH 18,B03,083750,Staff,0,12,30,30
1650773781258,MATH 18,B04,083751,Staff,0,12,30,30
1650773787291,MATH 20A,A01,083754,Staff,19,0,40,21
1650773793315,MATH 20B,A01,083756,Staff,0,13,30,30
1650773793315,MATH 20B,A02,083757,Staff,0,12,30,30
1650773799343,MATH 20C,A01,083760,Staff,0,16,30,30
1650773799343,MATH 20C,A02,083761,Staff,0,16,30,30
1650773799343,MATH 20C,B01,083762,Staff,9,0,30,21
1650773799343,MATH 20C,B02,083763,Staff,28,0,30,2
1650773805367,MATH 20D,A01,083765,Staff,2,1,30,28
1650773805367,MATH 20D,A02,083766,Staff,5,0,30,25
1650773805367,MATH 20D,A03,083767,Staff,24,0,30,6
1650773811391,MATH 20E,A01,083771,Staff,2,0,30,28
1650773811391,MATH 20E,A02,083772,Staff,16,0,30,14
1650773811391,MATH 20E,B01,083773,Staff,0,0,30,30
1650773811391,MATH 20E,B02,083774,Staff,5,0,30,25
1650773817433,MATH 103A,A01,083777,Staff,0,16,30,30
1650773817433,MATH 103A,A02,083778,Staff,0,15,30,30
1650773817433,MATH 103A,B01,083779,Staff,0,15,30,30
1650773817433,MATH 103A,B02,083780,Staff,0,15,30,30
1650773823460,MATH 105,A01,085443,Staff,0,22,30,30
1650773829495,MATH 109,A01,083213,Anzaldo; Leesa B,0,7,30,30
1650773829495,MATH 109,A02,083214,Anzaldo; Leesa B,0,7,30,30
1650773829495,MATH 109,B01,083215,Anzaldo; Leesa B,0,8,30,30
1650773829495,MATH 109,B02,083216,Anzaldo; Leesa B,0,7,30,30
1650773835520,MATH 142A,A01,083219,Chow; Bennett,0,16,30,30
1650773835520,MATH 142A,A02,083220,Chow; Bennett,0,15,30,30
1650773835520,MATH 142A,B01,083221,Chow; Bennett,0,15,30,30
1650773835520,MATH 142A,B02,083222,Chow; Bennett,0,14,30,30
1650773841549,MATH 193A,A01,083224,Staff,0,6,30,30
1650773841549,MATH 193A,A02,083225,Staff,0,6,30,30
1650773841549,MATH 193A,A03,083781,Staff,0,6,30,30
1650773841549,MATH 193A,A04,083782,Staff,0,7,30,30
1650773847573,MATH 197,001,091859,McAuley; Julian John,9998,0,9999,1
1650773853625,COGS 9,A01,083615,Staff,1,18,60,59
1650773859648,COGS 11,A01,083617,Boyle; Mary E. T.,16,0,40,24
1650773865671,COGS 13,A01,083071,Staff,0,38,40,40
1650773871698,COGS 14A,A01,092681,Staff,0,36,100,100
1650773877726,COGS 14B,A01,083073,Cheng; Tzu-Han,1,13,50,49
1650773883750,COGS 17,A01,092677,Staff,11,0,75,64
1650773889780,COGS 100,A01,083619,Staff,0,29,60,60
1650773895803,COGS 101A,A01,083621,Davis; Joshua Daniel,0,28,60,60
1650773901825,COGS 101B,A01,091572,Staff,1,4,60,59
1650773907853,COGS 101C,A01,083625,Delgado; Tania,14,0,30,16
1650773913877,COGS 107A,A01,083627,Boyle; Mary E. T.,0,16,60,60
1650773919900,COGS 118A,A01,083075,Staff,0,8,60,60
1650773925937,CSE 3,A50,083646,Miranda; Gregory Joseph,18,0,38,20
1650773925937,CSE 3,A51,083647,Miranda; Gregory Joseph,36,0,37,1
1650773931959,CSE 8A,A50,083650,Miranda; Gregory Joseph,0,30,40,40
1650773937991,CSE 11,A01,083080,Cao; Yingjun,0,96,40,40
1650773944097,CSE 12,A01,083652,Staff,0,21,100,100
1650773950121,CSE 15L,A01,083654,Staff,0,3,50,50
1650773950121,CSE 15L,A02,083655,Staff,0,2,50,50
1650773956145,CSE 20,A01,083657,Staff,49,0,80,31
1650773962170,CSE 30,A01,083084,Eldon; John,0,76,40,40
1650773968194,CSE 100,A01,083659,Cao; Yingjun,0,71,50,50
1650773974217,CSE 134B,A01,083661,Powell; Thomas Allan,0,38,65,65
1650773980244,CSE 140,A01,083663,Staff,0,11,75,75
1650773986268,CSE 140L,A01,083088,Eldon; John,0,20,75,75
1650773992291,CSE 175,A01,083665,Kumar; Rakesh,7,0,25,18
1650773998312,CSE 190,A00,092507,Dubnov; Shlomo,10,0,20,10
1650774004339,ECE 45,A01,083139,Staff,1,2,60,59
1650774010367,ECE 65,A50,083695,Staff,0,5,30,30
1650774016389,ECE 109,A01,091882,Touri; Behrouz,32,0,70,38
1650774022412,ECE 180,A00,083140,Abi Samra; Nicholas Camill,20,0,30,10
1650774022412,ECE 180,B00,083141,Abi Samra; Nicholas Camill,0,0,30,30
1650774028441,MATH 10A,A01,083735,Patchell; Gregory David,2,0,30,28
1650774028441,MATH 10A,A02,083736,Patchell; Gregory David,27,0,30,3
1650774028441,MATH 10A,A03,083737,Patchell; Gregory David,24,0,30,6
1650774034469,MATH 10B,A01,083207,Staff,0,9,30,30
1650774034469,MATH 10B,A02,083208,Staff,1,7,30,29
1650774034469,MATH 10B,B01,083739,Staff,11,0,30,19
1650774034469,MATH 10B,B02,083740,Staff,28,0,30,2
1650774040499,MATH 18,A01,083743,Staff,0,0,30,30
1650774040499,MATH 18,A02,083744,Staff,23,0,30,7
1650774040499,MATH 18,A03,083745,Staff,21,0,30,9
1650774040499,MATH 18,A04,083746,Staff,26,0,30,4
1650774040499,MATH 18,B01,083748,Staff,0,15,30,30
1650774040499,MATH 18,B02,083749,Staff,0,12,30,30
1650774040499,MATH 18,B03,083750,Staff,0,12,30,30
1650774040499,MATH 18,B04,083751,Staff,0,12,30,30
1650774046526,MATH 20A,A01,083754,Staff,19,0,40,21
1650774052548,MATH 20B,A01,083756,Staff,0,13,30,30
1650774052548,MATH 20B,A02,083757,Staff,0,12,30,30
1650774058571,MATH 20C,A01,083760,Staff,0,16,30,30
1650774058571,MATH 20C,A02,083761,Staff,0,16,30,30
1650774058571,MATH 20C,B01,083762,Staff,9,0,30,21
1650774058571,MATH 20C,B02,083763,Staff,28,0,30,2
1650774064597,MATH 20D,A01,083765,Staff,2,1,30,28
1650774064597,MATH 20D,A02,083766,Staff,5,0,30,25
1650774064597,MATH 20D,A03,083767,Staff,24,0,30,6
1650774070626,MATH 20E,A01,083771,Staff,2,0,30,28
1650774070626,MATH 20E,A02,083772,Staff,16,0,30,14
1650774070626,MATH 20E,B01,083773,Staff,0,0,30,30
1650774070626,MATH 20E,B02,083774,Staff,5,0,30,25
1650774076653,MATH 103A,A01,083777,Staff,0,16,30,30
1650774076653,MATH 103A,A02,083778,Staff,0,15,30,30
1650774076653,MATH 103A,B01,083779,Staff,0,15,30,30
1650774076653,MATH 103A,B02,083780,Staff,0,15,30,30
1650774082677,MATH 105,A01,085443,Staff,0,22,30,30
1650774088706,MATH 109,A01,083213,Anzaldo; Leesa B,0,7,30,30
1650774088706,MATH 109,A02,083214,Anzaldo; Leesa B,0,7,30,30
1650774088706,MATH 109,B01,083215,Anzaldo; Leesa B,0,8,30,30
1650774088706,MATH 109,B02,083216,Anzaldo; Leesa B,0,7,30,30
1650774094730,MATH 142A,A01,083219,Chow; Bennett,0,16,30,30
1650774094730,MATH 142A,A02,083220,Chow; Bennett,0,15,30,30
1650774094730,MATH 142A,B01,083221,Chow; Bennett,0,15,30,30
1650774094730,MATH 142A,B02,083222,Chow; Bennett,0,14,30,30
1650774100756,MATH 193A,A01,083224,Staff,0,6,30,30
1650774100756,MATH 193A,A02,083225,Staff,0,6,30,30
1650774100756,MATH 193A,A03,083781,Staff,0,6,30,30
1650774100756,MATH 193A,A04,083782,Staff,0,7,30,30
1650774106780,MATH 197,001,091859,McAuley; Julian John,9998,0,9999,1
1650774112831,COGS 9,A01,083615,Staff,1,18,60,59
1650774118859,COGS 11,A01,083617,Boyle; Mary E. T.,16,0,40,24
1650774124884,COGS 13,A01,083071,Staff,0,38,40,40
1650774130910,COGS 14A,A01,092681,Staff,0,36,100,100
1650774136937,COGS 14B,A01,083073,Cheng; Tzu-Han,1,13,50,49
1650774142963,COGS 17,A01,092677,Staff,11,0,75,64
1650774148994,COGS 100,A01,083619,Staff,0,29,60,60
1650774155018,COGS 101A,A01,083621,Davis; Joshua Daniel,0,28,60,60
1650774161044,COGS 101B,A01,091572,Staff,1,4,60,59
1650774167069,COGS 101C,A01,083625,Delgado; Tania,14,0,30,16
1650774173093,COGS 107A,A01,083627,Boyle; Mary E. T.,0,16,60,60
1650774179120,COGS 118A,A01,083075,Staff,0,8,60,60
1650774185157,CSE 3,A50,083646,Miranda; Gregory Joseph,18,0,38,20
1650774185157,CSE 3,A51,083647,Miranda; Gregory Joseph,36,0,37,1
1650774191179,CSE 8A,A50,083650,Miranda; Gregory Joseph,0,29,40,40
1650774197210,CSE 11,A01,083080,Cao; Yingjun,0,96,40,40
1650774203236,CSE 12,A01,083652,Staff,0,21,100,100
1650774209260,CSE 15L,A01,083654,Staff,0,3,50,50
1650774209260,CSE 15L,A02,083655,Staff,0,2,50,50
1650774215292,CSE 20,A01,083657,Staff,49,0,80,31
1650774221323,CSE 30,A01,083084,Eldon; John,0,76,40,40
1650774227349,CSE 100,A01,083659,Cao; Yingjun,0,71,50,50
1650774233373,CSE 134B,A01,083661,Powell; Thomas Allan,0,38,65,65
1650774239399,CSE 140,A01,083663,Staff,0,11,75,75
1650774245423,CSE 140L,A01,083088,Eldon; John,0,20,75,75
1650774251454,CSE 175,A01,083665,Kumar; Rakesh,7,0,25,18
1650774257478,CSE 190,A00,092507,Dubnov; Shlomo,10,0,20,10
1650774263500,ECE 45,A01,083139,Staff,1,2,60,59
1650774269527,ECE 65,A50,083695,Staff,0,5,30,30
1650774275552,ECE 109,A01,091882,Touri; Behrouz,32,0,70,38
1650774281575,ECE 180,A00,083140,Abi Samra; Nicholas Camill,20,0,30,10
1650774281575,ECE 180,B00,083141,Abi Samra; Nicholas Camill,0,0,30,30
1650774287600,MATH 10A,A01,083735,Patchell; Gregory David,2,0,30,28
1650774287600,MATH 10A,A02,083736,Patchell; Gregory David,27,0,30,3
1650774287600,MATH 10A,A03,083737,Patchell; Gregory David,24,0,30,6
1650774293623,MATH 10B,A01,083207,Staff,0,9,30,30
1650774293623,MATH 10B,A02,083208,Staff,1,7,30,29
1650774293623,MATH 10B,B01,083739,Staff,11,0,30,19
1650774293623,MATH 10B,B02,083740,Staff,28,0,30,2
1650774299651,MATH 18,A01,083743,Staff,0,0,30,30
1650774299651,MATH 18,A02,083744,Staff,23,0,30,7
1650774299651,MATH 18,A03,083745,Staff,21,0,30,9
1650774299651,MATH 18,A04,083746,Staff,26,0,30,4
1650774299651,MATH 18,B01,083748,Staff,0,15,30,30
1650774299651,MATH 18,B02,083749,Staff,0,12,30,30
1650774299651,MATH 18,B03,083750,Staff,0,12,30,30
1650774299651,MATH 18,B04,083751,Staff,0,12,30,30
1650774305675,MATH 20A,A01,083754,Staff,19,0,40,21
1650774311700,MATH 20B,A01,083756,Staff,0,13,30,30
1650774311700,MATH 20B,A02,083757,Staff,0,12,30,30
1650774317725,MATH 20C,A01,083760,Staff,0,16,30,30
1650774317725,MATH 20C,A02,083761,Staff,0,16,30,30
1650774317725,MATH 20C,B01,083762,Staff,9,0,30,21
1650774317725,MATH 20C,B02,083763,Staff,28,0,30,2
1650774323749,MATH 20D,A01,083765,Staff,2,1,30,28
1650774323749,MATH 20D,A02,083766,Staff,5,0,30,25
1650774323749,MATH 20D,A03,083767,Staff,24,0,30,6
1650774329774,MATH 20E,A01,083771,Staff,2,0,30,28
1650774329774,MATH 20E,A02,083772,Staff,16,0,30,14
1650774329774,MATH 20E,B01,083773,Staff,0,0,30,30
1650774329774,MATH 20E,B02,083774,Staff,5,0,30,25
1650774335799,MATH 103A,A01,083777,Staff,0,16,30,30
1650774335799,MATH 103A,A02,083778,Staff,0,15,30,30
1650774335799,MATH 103A,B01,083779,Staff,0,15,30,30
1650774335799,MATH 103A,B02,083780,Staff,0,15,30,30
1650774341825,MATH 105,A01,085443,Staff,0,22,30,30
1650774347849,MATH 109,A01,083213,Anzaldo; Leesa B,0,7,30,30
1650774347849,MATH 109,A02,083214,Anzaldo; Leesa B,0,7,30,30
1650774347849,MATH 109,B01,083215,Anzaldo; Leesa B,0,8,30,30
1650774347849,MATH 109,B02,083216,Anzaldo; Leesa B,0,7,30,30
1650774353885,MATH 142A,A01,083219,Chow; Bennett,0,16,30,30
1650774353885,MATH 142A,A02,083220,Chow; Bennett,0,15,30,30
1650774353885,MATH 142A,B01,083221,Chow; Bennett,0,15,30,30
1650774353885,MATH 142A,B02,083222,Chow; Bennett,0,14,30,30
1650774359908,MATH 193A,A01,083224,Staff,0,6,30,30
1650774359908,MATH 193A,A02,083225,Staff,0,6,30,30
1650774359908,MATH 193A,A03,083781,Staff,0,6,30,30
1650774359908,MATH 193A,A04,083782,Staff,0,7,30,30
1650774365935,MATH 197,001,091859,McAuley; Julian John,9998,0,9999,1
1650774371992,COGS 9,A01,083615,Staff,1,18,60,59
1650774378022,COGS 11,A01,083617,Boyle; Mary E. T.,16,0,40,24
1650774384049,COGS 13,A01,083071,Staff,0,38,40,40
1650774390073,COGS 14A,A01,092681,Staff,0,36,100,100
1650774396099,COGS 14B,A01,083073,Cheng; Tzu-Han,1,13,50,49
1650774402123,COGS 17,A01,092677,Staff,11,0,75,64
1650774408150,COGS 100,A01,083619,Staff,0,29,60,60
1650774414177,COGS 101A,A01,083621,Davis; Joshua Daniel,0,28,60,60
1650774420204,COGS 101B,A01,091572,Staff,1,4,60,59
1650774426228,COGS 101C,A01,083625,Delgado; Tania,14,0,30,16
1650774432255,COGS 107A,A01,083627,Boyle; Mary E. T.,0,16,60,60
1650774438281,COGS 118A,A01,083075,Staff,0,8,60,60
1650774444309,CSE 3,A50,083646,Miranda; Gregory Joseph,18,0,38,20
1650774444309,CSE 3,A51,083647,Miranda; Gregory Joseph,36,0,37,1
1650774450337,CSE 8A,A50,083650,Miranda; Gregory Joseph,0,29,40,40
1650774456364,CSE 11,A01,083080,Cao; Yingjun,0,96,40,40
1650774462390,CSE 12,A01,083652,Staff,0,21,100,100
1650774468419,CSE 15L,A01,083654,Staff,0,3,50,50
1650774468419,CSE 15L,A02,083655,Staff,0,2,50,50
1650774474443,CSE 20,A01,083657,Staff,49,0,80,31
1650774480468,CSE 30,A01,083084,Eldon; John,0,76,40,40
1650774486491,CSE 100,A01,083659,Cao; Yingjun,0,71,50,50
1650774492513,CSE 134B,A01,083661,Powell; Thomas Allan,0,38,65,65
1650774498537,CSE 140,A01,083663,Staff,0,11,75,75
1650774504564,CSE 140L,A01,083088,Eldon; John,0,20,75,75
1650774510588,CSE 175,A01,083665,Kumar; Rakesh,7,0,25,18
1650774516611,CSE 190,A00,092507,Dubnov; Shlomo,10,0,20,10
1650774522635,ECE 45,A01,083139,Staff,1,2,60,59
1650774528658,ECE 65,A50,083695,Staff,0,5,30,30
1650774534691,ECE 109,A01,091882,Touri; Behrouz,32,0,70,38
1650774540814,ECE 180,A00,083140,Abi Samra; Nicholas Camill,20,0,30,10
1650774540814,ECE 180,B00,083141,Abi Samra; Nicholas Camill,0,0,30,30
1650774546837,MATH 10A,A01,083735,Patchell; Gregory David,2,0,30,28
1650774546837,MATH 10A,A02,083736,Patchell; Gregory David,27,0,30,3
1650774546837,MATH 10A,A03,083737,Patchell; Gregory David,24,0,30,6
1650774552866,MATH 10B,A01,083207,Staff,0,9,30,30
1650774552866,MATH 10B,A02,083208,Staff,1,7,30,29
1650774552866,MATH 10B,B01,083739,Staff,11,0,30,19
1650774552866,MATH 10B,B02,083740,Staff,28,0,30,2
1650774558892,MATH 18,A01,083743,Staff,0,0,30,30
1650774558892,MATH 18,A02,083744,Staff,23,0,30,7
1650774558892,MATH 18,A03,083745,Staff,21,0,30,9
1650774558892,MATH 18,A04,083746,Staff,26,0,30,4
1650774558892,MATH 18,B01,083748,Staff,0,15,30,30
1650774558892,MATH 18,B02,083749,Staff,0,12,30,30
1650774558892,MATH 18,B03,083750,Staff,0,12,30,30
1650774558892,MATH 18,B04,083751,Staff,0,12,30,30
1650774564918,MATH 20A,A01,083754,Staff,19,0,40,21
1650774570942,MATH 20B,A01,083756,Staff,0,13,30,30
1650774570942,MATH 20B,A02,083757,Staff,0,12,30,30
1650774576966,MATH 20C,A01,083760,Staff,0,16,30,30
1650774576966,MATH 20C,A02,083761,Staff,0,16,30,30
1650774576966,MATH 20C,B01,083762,Staff,9,0,30,21
1650774576966,MATH 20C,B02,083763,Staff,28,0,30,2
1650774582993,MATH 20D,A01,083765,Staff,2,1,30,28
1650774582993,MATH 20D,A02,083766,Staff,5,0,30,25
1650774582993,MATH 20D,A03,083767,Staff,24,0,30,6
1650774589016,MATH 20E,A01,083771,Staff,2,0,30,28
1650774589016,MATH 20E,A02,083772,Staff,16,0,30,14
1650774589016,MATH 20E,B01,083773,Staff,0,0,30,30
1650774589016,MATH 20E,B02,083774,Staff,5,0,30,25
1650774595039,MATH 103A,A01,083777,Staff,0,16,30,30
1650774595039,MATH 103A,A02,083778,Staff,0,15,30,30
1650774595039,MATH 103A,B01,083779,Staff,0,15,30,30
1650774595039,MATH 103A,B02,083780,Staff,0,15,30,30
1650774601064,MATH 105,A01,085443,Staff,0,22,30,30
1650774607089,MATH 109,A01,083213,Anzaldo; Leesa B,0,7,30,30
1650774607089,MATH 109,A02,083214,Anzaldo; Leesa B,0,7,30,30
1650774607089,MATH 109,B01,083215,Anzaldo; Leesa B,0,8,30,30
1650774607089,MATH 109,B02,083216,Anzaldo; Leesa B,0,7,30,30
1650774613116,MATH 142A,A01,083219,Chow; Bennett,0,16,30,30
1650774613116,MATH 142A,A02,083220,Chow; Bennett,0,15,30,30
1650774613116,MATH 142A,B01,083221,Chow; Bennett,0,15,30,30
1650774613116,MATH 142A,B02,083222,Chow; Bennett,0,14,30,30
1650774619151,MATH 193A,A01,083224,Staff,0,6,30,30
1650774619151,MATH 193A,A02,083225,Staff,0,6,30,30
1650774619151,MATH 193A,A03,083781,Staff,0,6,30,30
1650774619151,MATH 193A,A04,083782,Staff,0,7,30,30
1650774625175,MATH 197,001,091859,McAuley; Julian John,9998,0,9999,1
1650774631235,COGS 9,A01,083615,Staff,1,18,60,59
1650774637262,COGS 11,A01,083617,Boyle; Mary E. T.,16,0,40,24
1650774643286,COGS 13,A01,083071,Staff,0,38,40,40
1650774649323,COGS 14A,A01,092681,Staff,0,36,100,100
1650774655346,COGS 14B,A01,083073,Cheng; Tzu-Han,1,13,50,49
1650774661377,COGS 17,A01,092677,Staff,11,0,75,64
1650774667401,COGS 100,A01,083619,Staff,0,29,60,60
1650774673435,COGS 101A,A01,083621,Davis; Joshua Daniel,0,28,60,60
1650774679459,COGS 101B,A01,091572,Staff,1,4,60,59
1650774685486,COGS 101C,A01,083625,Delgado; Tania,14,0,30,16
1650774691510,COGS 107A,A01,083627,Boyle; Mary E. T.,0,16,60,60
1650774697534,COGS 118A,A01,083075,Staff,0,8,60,60
1650774703566,CSE 3,A50,083646,Miranda; Gregory Joseph,18,0,38,20
1650774703566,CSE 3,A51,083647,Miranda; Gregory Joseph,36,0,37,1
1650774709591,CSE 8A,A50,083650,Miranda; Gregory Joseph,0,29,40,40
1650774715616,CSE 11,A01,083080,Cao; Yingjun,0,96,40,40
1650774721642,CSE 12,A01,083652,Staff,0,21,100,100
1650774727667,CSE 15L,A01,083654,Staff,0,3,50,50
1650774727667,CSE 15L,A02,083655,Staff,0,2,50,50
1650774733695,CSE 20,A01,083657,Staff,49,0,80,31
1650774739719,CSE 30,A01,083084,Eldon; John,0,76,40,40
1650774745746,CSE 100,A01,083659,Cao; Yingjun,0,71,50,50
1650774751773,CSE 134B,A01,083661,Powell; Thomas Allan,0,38,65,65
1650774757811,CSE 140,A01,083663,Staff,0,11,75,75
1650774763838,CSE 140L,A01,083088,Eldon; John,0,20,75,75
1650774769861,CSE 175,A01,083665,Kumar; Rakesh,7,0,25,18
1650774775894,CSE 190,A00,092507,Dubnov; Shlomo,10,0,20,10
1650774781920,ECE 45,A01,083139,Staff,1,2,60,59
1650774787946,ECE 65,A50,083695,Staff,0,5,30,30
1650774793971,ECE 109,A01,091882,Touri; Behrouz,32,0,70,38
1650774800002,ECE 180,A00,083140,Abi Samra; Nicholas Camill,20,0,30,10
1650774800002,ECE 180,B00,083141,Abi Samra; Nicholas Camill,0,0,30,30
1650774806025,MATH 10A,A01,083735,Patchell; Gregory David,2,0,30,28
1650774806025,MATH 10A,A02,083736,Patchell; Gregory David,27,0,30,3
1650774806025,MATH 10A,A03,083737,Patchell; Gregory David,24,0,30,6
1650774812052,MATH 10B,A01,083207,Staff,0,9,30,30
1650774812052,MATH 10B,A02,083208,Staff,1,7,30,29
1650774812052,MATH 10B,B01,083739,Staff,11,0,30,19
1650774812052,MATH 10B,B02,083740,Staff,28,0,30,2
1650774818077,MATH 18,A01,083743,Staff,0,0,30,30
1650774818077,MATH 18,A02,083744,Staff,23,0,30,7
1650774818077,MATH 18,A03,083745,Staff,21,0,30,9
1650774818077,MATH 18,A04,083746,Staff,26,0,30,4
1650774818077,MATH 18,B01,083748,Staff,0,15,30,30
1650774818077,MATH 18,B02,083749,Staff,0,12,30,30
1650774818077,MATH 18,B03,083750,Staff,0,12,30,30
1650774818077,MATH 18,B04,083751,Staff,0,12,30,30
1650774824101,MATH 20A,A01,083754,Staff,19,0,40,21
1650774830124,MATH 20B,A01,083756,Staff,0,13,30,30
1650774830124,MATH 20B,A02,083757,Staff,0,12,30,30
1650774836150,MATH 20C,A01,083760,Staff,0,16,30,30
1650774836150,MATH 20C,A02,083761,Staff,0,16,30,30
1650774836150,MATH 20C,B01,083762,Staff,9,0,30,21
1650774836150,MATH 20C,B02,083763,Staff,28,0,30,2
1650774842175,MATH 20D,A01,083765,Staff,2,1,30,28
1650774842175,MATH 20D,A02,083766,Staff,5,0,30,25
1650774842175,MATH 20D,A03,083767,Staff,24,0,30,6
1650774848199,MATH 20E,A01,083771,Staff,2,0,30,28
1650774848199,MATH 20E,A02,083772,Staff,16,0,30,14
1650774848199,MATH 20E,B01,083773,Staff,0,0,30,30
1650774848199,MATH 20E,B02,083774,Staff,5,0,30,25
1650774854223,MATH 103A,A01,083777,Staff,0,16,30,30
1650774854223,MATH 103A,A02,083778,Staff,0,15,30,30
1650774854223,MATH 103A,B01,083779,Staff,0,15,30,30
1650774854223,MATH 103A,B02,083780,Staff,0,15,30,30
1650774860247,MATH 105,A01,085443,Staff,0,22,30,30
1650774866277,MATH 109,A01,083213,Anzaldo; Leesa B,0,7,30,30
1650774866277,MATH 109,A02,083214,Anzaldo; Leesa B,0,7,30,30
1650774866277,MATH 109,B01,083215,Anzaldo; Leesa B,0,8,30,30
1650774866277,MATH 109,B02,083216,Anzaldo; Leesa B,0,7,30,30
1650774872309,MATH 142A,A01,083219,Chow; Bennett,0,16,30,30
1650774872309,MATH 142A,A02,083220,Chow; Bennett,0,15,30,30
1650774872309,MATH 142A,B01,083221,Chow; Bennett,0,15,30,30
1650774872309,MATH 142A,B02,083222,Chow; Bennett,0,14,30,30
1650774878347,MATH 193A,A01,083224,Staff,0,6,30,30
1650774878347,MATH 193A,A02,083225,Staff,0,6,30,30
1650774878347,MATH 193A,A03,083781,Staff,0,6,30,30
1650774878347,MATH 193A,A04,083782,Staff,0,7,30,30
1650774884373,MATH 197,001,091859,McAuley; Julian John,9998,0,9999,1
1650774890432,COGS 9,A01,083615,Staff,1,18,60,59
1650774896459,COGS 11,A01,083617,Boyle; Mary E. T.,16,0,40,24
1650774902491,COGS 13,A01,083071,Staff,0,38,40,40
1650774908517,COGS 14A,A01,092681,Staff,0,36,100,100
1650774914547,COGS 14B,A01,083073,Cheng; Tzu-Han,1,13,50,49
1650774920574,COGS 17,A01,092677,Staff,11,0,75,64
1650774926602,COGS 100,A01,083619,Staff,0,29,60,60
1650774932628,COGS 101A,A01,083621,Davis; Joshua Daniel,0,28,60,60
1650774938652,COGS 101B,A01,091572,Staff,1,4,60,59
1650774944676,COGS 101C,A01,083625,Delgado; Tania,14,0,30,16
1650774950703,COGS 107A,A01,083627,Boyle; Mary E. T.,0,16,60,60
1650774956729,COGS 118A,A01,083075,Staff,0,8,60,60
1650774962756,CSE 3,A50,083646,Miranda; Gregory Joseph,18,0,38,20
1650774962756,CSE 3,A51,083647,Miranda; Gregory Joseph,36,0,37,1
1650774968781,CSE 8A,A50,083650,Miranda; Gregory Joseph,0,29,40,40
1650774974806,CSE 11,A01,083080,Cao; Yingjun,0,96,40,40
1650774980833,CSE 12,A01,083652,Staff,0,21,100,100
1650774986858,CSE 15L,A01,083654,Staff,0,3,50,50
1650774986858,CSE 15L,A02,083655,Staff,0,2,50,50
1650774992885,CSE 20,A01,083657,Staff,49,0,80,31
1650774998909,CSE 30,A01,083084,Eldon; John,0,76,40,40
1650775004945,CSE 100,A01,083659,Cao; Yingjun,0,71,50,50
1650775010968,CSE 134B,A01,083661,Powell; Thomas Allan,0,38,65,65
1650775016990,CSE 140,A01,083663,Staff,0,11,75,75
1650775023018,CSE 140L,A01,083088,Eldon; John,0,20,75,75
1650775029051,CSE 175,A01,083665,Kumar; Rakesh,7,0,25,18
1650775035088,CSE 190,A00,092507,Dubnov; Shlomo,10,0,20,10
1650775041112,ECE 45,A01,083139,Staff,1,2,60,59
1650775047134,ECE 65,A50,083695,Staff,0,5,30,30
1650775053157,ECE 109,A01,091882,Touri; Behrouz,32,0,70,38
1650775059180,ECE 180,A00,083140,Abi Samra; Nicholas Camill,20,0,30,10
1650775059180,ECE 180,B00,083141,Abi Samra; Nicholas Camill,0,0,30,30
1650775065208,MATH 10A,A01,083735,Patchell; Gregory David,2,0,30,28
1650775065208,MATH 10A,A02,083736,Patchell; Gregory David,27,0,30,3
1650775065208,MATH 10A,A03,083737,Patchell; Gregory David,24,0,30,6
1650775071233,MATH 10B,A01,083207,Staff,0,9,30,30
1650775071233,MATH 10B,A02,083208,Staff,1,7,30,29
1650775071233,MATH 10B,B01,083739,Staff,11,0,30,19
1650775071233,MATH 10B,B02,083740,Staff,28,0,30,2
1650775077258,MATH 18,A01,083743,Staff,0,0,30,30
1650775077258,MATH 18,A02,083744,Staff,23,0,30,7
1650775077258,MATH 18,A03,083745,Staff,21,0,30,9
1650775077258,MATH 18,A04,083746,Staff,26,0,30,4
1650775077258,MATH 18,B01,083748,Staff,0,15,30,30
1650775077258,MATH 18,B02,083749,Staff,0,12,30,30
1650775077258,MATH 18,B03,083750,Staff,0,12,30,30
1650775077258,MATH 18,B04,083751,Staff,0,12,30,30
1650775083284,MATH 20A,A01,083754,Staff,19,0,40,21
1650775089312,MATH 20B,A01,083756,Staff,0,13,30,30
1650775089312,MATH 20B,A02,083757,Staff,0,12,30,30
1650775095336,MATH 20C,A01,083760,Staff,0,16,30,30
1650775095336,MATH 20C,A02,083761,Staff,0,16,30,30
1650775095336,MATH 20C,B01,083762,Staff,9,0,30,21
1650775095336,MATH 20C,B02,083763,Staff,28,0,30,2
1650775101363,MATH 20D,A01,083765,Staff,2,1,30,28
1650775101363,MATH 20D,A02,083766,Staff,5,0,30,25
1650775101363,MATH 20D,A03,083767,Staff,24,0,30,6
1650775107386,MATH 20E,A01,083771,Staff,2,0,30,28
1650775107386,MATH 20E,A02,083772,Staff,16,0,30,14
1650775107386,MATH 20E,B01,083773,Staff,0,0,30,30
1650775107386,MATH 20E,B02,083774,Staff,5,0,30,25
1650775113418,MATH 103A,A01,083777,Staff,0,16,30,30
1650775113418,MATH 103A,A02,083778,Staff,0,15,30,30
1650775113418,MATH 103A,B01,083779,Staff,0,15,30,30
1650775113418,MATH 103A,B02,083780,Staff,0,15,30,30
1650775119440,MATH 105,A01,085443,Staff,0,22,30,30
1650775125464,MATH 109,A01,083213,Anzaldo; Leesa B,0,7,30,30
1650775125464,MATH 109,A02,083214,Anzaldo; Leesa B,0,7,30,30
1650775125464,MATH 109,B01,083215,Anzaldo; Leesa B,0,8,30,30
1650775125464,MATH 109,B02,083216,Anzaldo; Leesa B,0,7,30,30
1650775131493,MATH 142A,A01,083219,Chow; Bennett,0,16,30,30
1650775131493,MATH 142A,A02,083220,Chow; Bennett,0,15,30,30
1650775131493,MATH 142A,B01,083221,Chow; Bennett,0,15,30,30
1650775131493,MATH 142A,B02,083222,Chow; Bennett,0,14,30,30
1650775137605,MATH 193A,A01,083224,Staff,0,6,30,30
1650775137605,MATH 193A,A02,083225,Staff,0,6,30,30
1650775137605,MATH 193A,A03,083781,Staff,0,6,30,30
1650775137605,MATH 193A,A04,083782,Staff,0,7,30,30
1650775143628,MATH 197,001,091859,McAuley; Julian John,9998,0,9999,1
1650775149689,COGS 9,A01,083615,Staff,1,18,60,59
1650775155717,COGS 11,A01,083617,Boyle; Mary E. T.,16,0,40,24
1650775161740,COGS 13,A01,083071,Staff,0,38,40,40
1650775167762,COGS 14A,A01,092681,Staff,0,36,100,100
1650775173785,COGS 14B,A01,083073,Cheng; Tzu-Han,1,13,50,49
1650775179809,COGS 17,A01,092677,Staff,11,0,75,64
1650775185832,COGS 100,A01,083619,Staff,0,29,60,60
1650775191859,COGS 101A,A01,083621,Davis; Joshua Daniel,0,28,60,60
1650775197883,COGS 101B,A01,091572,Staff,1,4,60,59
1650775203912,COGS 101C,A01,083625,Delgado; Tania,14,0,30,16
1650775209948,COGS 107A,A01,083627,Boyle; Mary E. T.,0,16,60,60
1650775215972,COGS 118A,A01,083075,Staff,0,8,60,60
1650775222000,CSE 3,A50,083646,Miranda; Gregory Joseph,18,0,38,20
1650775222000,CSE 3,A51,083647,Miranda; Gregory Joseph,36,0,37,1
1650775228024,CSE 8A,A50,083650,Miranda; Gregory Joseph,0,29,40,40
1650775234054,CSE 11,A01,083080,Cao; Yingjun,0,96,40,40
1650775240086,CSE 12,A01,083652,Staff,0,21,100,100
1650775246113,CSE 15L,A01,083654,Staff,0,3,50,50
1650775246113,CSE 15L,A02,083655,Staff,0,2,50,50
1650775252141,CSE 20,A01,083657,Staff,49,0,80,31
1650775258175,CSE 30,A01,083084,Eldon; John,0,76,40,40
1650775264205,CSE 100,A01,083659,Cao; Yingjun,0,71,50,50
1650775270228,CSE 134B,A01,083661,Powell; Thomas Allan,0,38,65,65
1650775276252,CSE 140,A01,083663,Staff,0,11,75,75
1650775282286,CSE 140L,A01,083088,Eldon; John,0,20,75,75
1650775288310,CSE 175,A01,083665,Kumar; Rakesh,7,0,25,18
1650775294335,CSE 190,A00,092507,Dubnov; Shlomo,10,0,20,10
1650775300371,ECE 45,A01,083139,Staff,1,2,60,59
1650775306394,ECE 65,A50,083695,Staff,0,5,30,30
1650775312421,ECE 109,A01,091882,Touri; Behrouz,32,0,70,38
1650775318452,ECE 180,A00,083140,Abi Samra; Nicholas Camill,20,0,30,10
1650775318452,ECE 180,B00,083141,Abi Samra; Nicholas Camill,0,0,30,30
1650775324479,MATH 10A,A01,083735,Patchell; Gregory David,2,0,30,28
1650775324479,MATH 10A,A02,083736,Patchell; Gregory David,27,0,30,3
1650775324479,MATH 10A,A03,083737,Patchell; Gregory David,24,0,30,6
1650775330503,MATH 10B,A01,083207,Staff,0,9,30,30
1650775330503,MATH 10B,A02,083208,Staff,1,7,30,29
1650775330503,MATH 10B,B01,083739,Staff,11,0,30,19
1650775330503,MATH 10B,B02,083740,Staff,28,0,30,2
1650775336530,MATH 18,A01,083743,Staff,0,0,30,30
1650775336530,MATH 18,A02,083744,Staff,23,0,30,7
1650775336530,MATH 18,A03,083745,Staff,21,0,30,9
1650775336530,MATH 18,A04,083746,Staff,26,0,30,4
1650775336530,MATH 18,B01,083748,Staff,0,15,30,30
1650775336530,MATH 18,B02,083749,Staff,0,12,30,30
1650775336530,MATH 18,B03,083750,Staff,0,12,30,30
1650775336530,MATH 18,B04,083751,Staff,0,12,30,30
1650775342553,MATH 20A,A01,083754,Staff,19,0,40,21
1650775348577,MATH 20B,A01,083756,Staff,0,13,30,30
1650775348577,MATH 20B,A02,083757,Staff,0,12,30,30
1650775354603,MATH 20C,A01,083760,Staff,0,16,30,30
1650775354603,MATH 20C,A02,083761,Staff,0,16,30,30
1650775354603,MATH 20C,B01,083762,Staff,9,0,30,21
1650775354603,MATH 20C,B02,083763,Staff,28,0,30,2
1650775360632,MATH 20D,A01,083765,Staff,2,1,30,28
1650775360632,MATH 20D,A02,083766,Staff,5,0,30,25
1650775360632,MATH 20D,A03,083767,Staff,24,0,30,6
1650775366657,MATH 20E,A01,083771,Staff,2,0,30,28
1650775366657,MATH 20E,A02,083772,Staff,16,0,30,14
1650775366657,MATH 20E,B01,083773,Staff,0,0,30,30
1650775366657,MATH 20E,B02,083774,Staff,5,0,30,25
1650775372681,MATH 103A,A01,083777,Staff,0,16,30,30
1650775372681,MATH 103A,A02,083778,Staff,0,15,30,30
1650775372681,MATH 103A,B01,083779,Staff,0,15,30,30
1650775372681,MATH 103A,B02,083780,Staff,0,15,30,30
1650775378705,MATH 105,A01,085443,Staff,0,22,30,30
1650775384733,MATH 109,A01,083213,Anzaldo; Leesa B,0,7,30,30
1650775384733,MATH 109,A02,083214,Anzaldo; Leesa B,0,7,30,30
1650775384733,MATH 109,B01,083215,Anzaldo; Leesa B,0,8,30,30
1650775384733,MATH 109,B02,083216,Anzaldo; Leesa B,0,7,30,30
1650775390759,MATH 142A,A01,083219,Chow; Bennett,0,16,30,30
1650775390759,MATH 142A,A02,083220,Chow; Bennett,0,15,30,30
1650775390759,MATH 142A,B01,083221,Chow; Bennett,0,15,30,30
1650775390759,MATH 142A,B02,083222,Chow; Bennett,0,14,30,30
1650775396787,MATH 193A,A01,083224,Staff,0,6,30,30
1650775396787,MATH 193A,A02,083225,Staff,0,6,30,30
1650775396787,MATH 193A,A03,083781,Staff,0,6,30,30
1650775396787,MATH 193A,A04,083782,Staff,0,7,30,30
1650775402815,MATH 197,001,091859,McAuley; Julian John,9998,0,9999,1
1650775408869,COGS 9,A01,083615,Staff,1,18,60,59
1650775414890,COGS 11,A01,083617,Boyle; Mary E. T.,16,0,40,24
1650775420916,COGS 13,A01,083071,Staff,0,38,40,40
1650775426945,COGS 14A,A01,092681,Staff,0,36,100,100
1650775432974,COGS 14B,A01,083073,Cheng; Tzu-Han,1,13,50,49
1650775439004,COGS 17,A01,092677,Staff,11,0,75,64
1650775445028,COGS 100,A01,083619,Staff,0,29,60,60
1650775451055,COGS 101A,A01,083621,Davis; Joshua Daniel,0,28,60,60
1650775457088,COGS 101B,A01,091572,Staff,1,4,60,59
1650775463121,COGS 101C,A01,083625,Delgado; Tania,14,0,30,16
1650775469148,COGS 107A,A01,083627,Boyle; Mary E. T.,0,16,60,60
1650775475171,COGS 118A,A01,083075,Staff,0,8,60,60
1650775481195,CSE 3,A50,083646,Miranda; Gregory Joseph,18,0,38,20
1650775481195,CSE 3,A51,083647,Miranda; Gregory Joseph,36,0,37,1
1650775487220,CSE 8A,A50,083650,Miranda; Gregory Joseph,0,29,40,40
1650775493245,CSE 11,A01,083080,Cao; Yingjun,0,96,40,40
1650775499269,CSE 12,A01,083652,Staff,0,21,100,100
1650775505300,CSE 15L,A01,083654,Staff,0,3,50,50
1650775505300,CSE 15L,A02,083655,Staff,0,2,50,50
1650775511324,CSE 20,A01,083657,Staff,49,0,80,31
1650775517350,CSE 30,A01,083084,Eldon; John,0,75,40,40
1650775523372,CSE 100,A01,083659,Cao; Yingjun,0,71,50,50
1650775529400,CSE 134B,A01,083661,Powell; Thomas Allan,0,38,65,65
1650775535426,CSE 140,A01,083663,Staff,0,11,75,75
1650775541458,CSE 140L,A01,083088,Eldon; John,0,20,75,75
1650775547485,CSE 175,A01,083665,Kumar; Rakesh,7,0,25,18
1650775553520,CSE 190,A00,092507,Dubnov; Shlomo,10,0,20,10
1650775559546,ECE 45,A01,083139,Staff,1,2,60,59
1650775565570,ECE 65,A50,083695,Staff,0,5,30,30
1650775571594,ECE 109,A01,091882,Touri; Behrouz,32,0,70,38
1650775577621,ECE 180,A00,083140,Abi Samra; Nicholas Camill,20,0,30,10
1650775577621,ECE 180,B00,083141,Abi Samra; Nicholas Camill,0,0,30,30
1650775583659,MATH 10A,A01,083735,Patchell; Gregory David,2,0,30,28
1650775583659,MATH 10A,A02,083736,Patchell; Gregory David,27,0,30,3
1650775583659,MATH 10A,A03,083737,Patchell; Gregory David,24,0,30,6
1650775589686,MATH 10B,A01,083207,Staff,0,9,30,30
1650775589686,MATH 10B,A02,083208,Staff,1,7,30,29
1650775589686,MATH 10B,B01,083739,Staff,11,0,30,19
1650775589686,MATH 10B,B02,083740,Staff,28,0,30,2
1650775595710,MATH 18,A01,083743,Staff,0,0,30,30
1650775595710,MATH 18,A02,083744,Staff,23,0,30,7
1650775595710,MATH 18,A03,083745,Staff,21,0,30,9
1650775595710,MATH 18,A04,083746,Staff,26,0,30,4
1650775595710,MATH 18,B01,083748,Staff,0,15,30,30
1650775595710,MATH 18,B02,083749,Staff,0,12,30,30
1650775595710,MATH 18,B03,083750,Staff,0,12,30,30
1650775595710,MATH 18,B04,083751,Staff,0,12,30,30
1650775601734,MATH 20A,A01,083754,Staff,19,0,40,21
1650775607761,MATH 20B,A01,083756,Staff,0,13,30,30
1650775607761,MATH 20B,A02,083757,Staff,0,12,30,30
1650775613785,MATH 20C,A01,083760,Staff,0,16,30,30
1650775613785,MATH 20C,A02,083761,Staff,0,16,30,30
1650775613785,MATH 20C,B01,083762,Staff,9,0,30,21
1650775613785,MATH 20C,B02,083763,Staff,28,0,30,2
1650775619809,MATH 20D,A01,083765,Staff,2,1,30,28
1650775619809,MATH 20D,A02,083766,Staff,5,0,30,25
1650775619809,MATH 20D,A03,083767,Staff,24,0,30,6
1650775625833,MATH 20E,A01,083771,Staff,2,0,30,28
1650775625833,MATH 20E,A02,083772,Staff,16,0,30,14
1650775625833,MATH 20E,B01,083773,Staff,0,0,30,30
1650775625833,MATH 20E,B02,083774,Staff,5,0,30,25
1650775631858,MATH 103A,A01,083777,Staff,0,16,30,30
1650775631858,MATH 103A,A02,083778,Staff,0,15,30,30
1650775631858,MATH 103A,B01,083779,Staff,0,15,30,30
1650775631858,MATH 103A,B02,083780,Staff,0,15,30,30
1650775637883,MATH 105,A01,085443,Staff,0,22,30,30
1650775643912,MATH 109,A01,083213,Anzaldo; Leesa B,0,7,30,30
1650775643912,MATH 109,A02,083214,Anzaldo; Leesa B,0,7,30,30
1650775643912,MATH 109,B01,083215,Anzaldo; Leesa B,0,8,30,30
1650775643912,MATH 109,B02,083216,Anzaldo; Leesa B,0,7,30,30
1650775649935,MATH 142A,A01,083219,Chow; Bennett,0,16,30,30
1650775649935,MATH 142A,A02,083220,Chow; Bennett,0,15,30,30
1650775649935,MATH 142A,B01,083221,Chow; Bennett,0,15,30,30
1650775649935,MATH 142A,B02,083222,Chow; Bennett,0,14,30,30
1650775655958,MATH 193A,A01,083224,Staff,0,6,30,30
1650775655958,MATH 193A,A02,083225,Staff,0,6,30,30
1650775655958,MATH 193A,A03,083781,Staff,0,6,30,30
1650775655958,MATH 193A,A04,083782,Staff,0,7,30,30
1650775661983,MATH 197,001,091859,McAuley; Julian John,9998,0,9999,1
1650775668040,COGS 9,A01,083615,Staff,1,18,60,59
1650775674063,COGS 11,A01,083617,Boyle; Mary E. T.,16,0,40,24
1650775680088,COGS 13,A01,083071,Staff,0,38,40,40
1650775686112,COGS 14A,A01,092681,Staff,0,36,100,100
1650775692137,COGS 14B,A01,083073,Cheng; Tzu-Han,1,13,50,49
1650775698160,COGS 17,A01,092677,Staff,11,0,75,64
1650775704184,COGS 100,A01,083619,Staff,0,29,60,60
1650775710211,COGS 101A,A01,083621,Davis; Joshua Daniel,0,28,60,60
1650775716237,COGS 101B,A01,091572,Staff,1,4,60,59
1650775722262,COGS 101C,A01,083625,Delgado; Tania,14,0,30,16
1650775728365,COGS 107A,A01,083627,Boyle; Mary E. T.,0,16,60,60
1650775734389,COGS 118A,A01,083075,Staff,0,8,60,60
1650775740414,CSE 3,A50,083646,Miranda; Gregory Joseph,18,0,38,20
1650775740414,CSE 3,A51,083647,Miranda; Gregory Joseph,36,0,37,1
1650775746441,CSE 8A,A50,083650,Miranda; Gregory Joseph,0,29,40,40
1650775752467,CSE 11,A01,083080,Cao; Yingjun,0,96,40,40
1650775758490,CSE 12,A01,083652,Staff,0,21,100,100
1650775764513,CSE 15L,A01,083654,Staff,0,3,50,50
1650775764513,CSE 15L,A02,083655,Staff,0,2,50,50
1650775770546,CSE 20,A01,083657,Staff,49,0,80,31
1650775776568,CSE 30,A01,083084,Eldon; John,0,75,40,40
1650775782590,CSE 100,A01,083659,Cao; Yingjun,0,71,50,50
1650775788613,CSE 134B,A01,083661,Powell; Thomas Allan,0,38,65,65
1650775794635,CSE 140,A01,083663,Staff,0,11,75,75
1650775800659,CSE 140L,A01,083088,Eldon; John,0,20,75,75
1650775806695,CSE 175,A01,083665,Kumar; Rakesh,7,0,25,18
1650775812718,CSE 190,A00,092507,Dubnov; Shlomo,10,0,20,10
1650775818741,ECE 45,A01,083139,Staff,1,2,60,59
1650775824764,ECE 65,A50,083695,Staff,0,5,30,30
1650775830788,ECE 109,A01,091882,Touri; Behrouz,32,0,70,38
1650775836814,ECE 180,A00,083140,Abi Samra; Nicholas Camill,20,0,30,10
1650775836814,ECE 180,B00,083141,Abi Samra; Nicholas Camill,0,0,30,30
1650775842842,MATH 10A,A01,083735,Patchell; Gregory David,2,0,30,28
1650775842842,MATH 10A,A02,083736,Patchell; Gregory David,27,0,30,3
1650775842842,MATH 10A,A03,083737,Patchell; Gregory David,24,0,30,6
1650775848869,MATH 10B,A01,083207,Staff,0,9,30,30
1650775848869,MATH 10B,A02,083208,Staff,1,7,30,29
1650775848869,MATH 10B,B01,083739,Staff,11,0,30,19
1650775848869,MATH 10B,B02,083740,Staff,28,0,30,2
1650775854900,MATH 18,A01,083743,Staff,0,0,30,30
1650775854900,MATH 18,A02,083744,Staff,23,0,30,7
1650775854900,MATH 18,A03,083745,Staff,21,0,30,9
1650775854900,MATH 18,A04,083746,Staff,26,0,30,4
1650775854900,MATH 18,B01,083748,Staff,0,15,30,30
1650775854900,MATH 18,B02,083749,Staff,0,12,30,30
1650775854900,MATH 18,B03,083750,Staff,0,12,30,30
1650775854900,MATH 18,B04,083751,Staff,0,12,30,30
1650775860927,MATH 20A,A01,083754,Staff,19,0,40,21
1650775866954,MATH 20B,A01,083756,Staff,0,13,30,30
1650775866954,MATH 20B,A02,083757,Staff,0,12,30,30
1650775872982,MATH 20C,A01,083760,Staff,0,16,30,30
1650775872982,MATH 20C,A02,083761,Staff,0,16,30,30
1650775872982,MATH 20C,B01,083762,Staff,9,0,30,21
1650775872982,MATH 20C,B02,083763,Staff,28,0,30,2
1650775879006,MATH 20D,A01,083765,Staff,2,1,30,28
1650775879006,MATH 20D,A02,083766,Staff,5,0,30,25
1650775879006,MATH 20D,A03,083767,Staff,24,0,30,6
1650775885034,MATH 20E,A01,083771,Staff,2,0,30,28
1650775885034,MATH 20E,A02,083772,Staff,15,0,30,15
1650775885034,MATH 20E,B01,083773,Staff,0,0,30,30
1650775885034,MATH 20E,B02,083774,Staff,5,0,30,25
1650775891059,MATH 103A,A01,083777,Staff,0,16,30,30
1650775891059,MATH 103A,A02,083778,Staff,0,15,30,30
1650775891059,MATH 103A,B01,083779,Staff,0,15,30,30
1650775891059,MATH 103A,B02,083780,Staff,0,15,30,30
1650775897082,MATH 105,A01,085443,Staff,0,22,30,30
1650775903109,MATH 109,A01,083213,Anzaldo; Leesa B,0,7,30,30
1650775903109,MATH 109,A02,083214,Anzaldo; Leesa B,0,7,30,30
1650775903109,MATH 109,B01,083215,Anzaldo; Leesa B,0,8,30,30
1650775903109,MATH 109,B02,083216,Anzaldo; Leesa B,0,7,30,30
1650775909133,MATH 142A,A01,083219,Chow; Bennett,0,16,30,30
1650775909133,MATH 142A,A02,083220,Chow; Bennett,0,15,30,30
1650775909133,MATH 142A,B01,083221,Chow; Bennett,0,15,30,30
1650775909133,MATH 142A,B02,083222,Chow; Bennett,0,14,30,30
1650775915156,MATH 193A,A01,083224,Staff,0,6,30,30
1650775915156,MATH 193A,A02,083225,Staff,0,6,30,30
1650775915156,MATH 193A,A03,083781,Staff,0,6,30,30
1650775915156,MATH 193A,A04,083782,Staff,0,7,30,30
1650775921179,MATH 197,001,091859,McAuley; Julian John,9998,0,9999,1
1650775927230,COGS 9,A01,083615,Staff,1,18,60,59
1650775933254,COGS 11,A01,083617,Boyle; Mary E. T.,16,0,40,24
1650775939287,COGS 13,A01,083071,Staff,0,38,40,40
1650775945315,COGS 14A,A01,092681,Staff,0,36,100,100
1650775951340,COGS 14B,A01,083073,Cheng; Tzu-Han,1,13,50,49
1650775957367,COGS 17,A01,092677,Staff,11,0,75,64
1650775963391,COGS 100,A01,083619,Staff,0,29,60,60
1650775969424,COGS 101A,A01,083621,Davis; Joshua Daniel,0,28,60,60
1650775975450,COGS 101B,A01,091572,Staff,1,4,60,59
1650775981477,COGS 101C,A01,083625,Delgado; Tania,14,0,30,16
1650775987500,COGS 107A,A01,083627,Boyle; Mary E. T.,0,16,60,60
1650775993526,COGS 118A,A01,083075,Staff,0,8,60,60
1650775999551,CSE 3,A50,083646,Miranda; Gregory Joseph,18,0,38,20
1650775999551,CSE 3,A51,083647,Miranda; Gregory Joseph,36,0,37,1
1650776005578,CSE 8A,A50,083650,Miranda; Gregory Joseph,0,29,40,40
1650776011601,CSE 11,A01,083080,Cao; Yingjun,0,96,40,40
1650776017625,CSE 12,A01,083652,Staff,0,21,100,100
1650776023647,CSE 15L,A01,083654,Staff,0,3,50,50
1650776023647,CSE 15L,A02,083655,Staff,0,2,50,50
1650776029671,CSE 20,A01,083657,Staff,49,0,80,31
1650776035697,CSE 30,A01,083084,Eldon; John,0,75,40,40
1650776041724,CSE 100,A01,083659,Cao; Yingjun,0,71,50,50
1650776047750,CSE 134B,A01,083661,Powell; Thomas Allan,0,38,65,65
1650776053777,CSE 140,A01,083663,Staff,0,11,75,75
1650776059800,CSE 140L,A01,083088,Eldon; John,0,20,75,75
1650776065826,CSE 175,A01,083665,Kumar; Rakesh,7,0,25,18
1650776071856,CSE 190,A00,092507,Dubnov; Shlomo,10,0,20,10
1650776077880,ECE 45,A01,083139,Staff,1,2,60,59
1650776083907,ECE 65,A50,083695,Staff,0,5,30,30
1650776089932,ECE 109,A01,091882,Touri; Behrouz,32,0,70,38
1650776095959,ECE 180,A00,083140,Abi Samra; Nicholas Camill,20,0,30,10
1650776095959,ECE 180,B00,083141,Abi Samra; Nicholas Camill,0,0,30,30
1650776101993,MATH 10A,A01,083735,Patchell; Gregory David,2,0,30,28
1650776101993,MATH 10A,A02,083736,Patchell; Gregory David,27,0,30,3
1650776101993,MATH 10A,A03,083737,Patchell; Gregory David,24,0,30,6
1650776108021,MATH 10B,A01,083207,Staff,0,9,30,30
1650776108021,MATH 10B,A02,083208,Staff,1,7,30,29
1650776108021,MATH 10B,B01,083739,Staff,11,0,30,19
1650776108021,MATH 10B,B02,083740,Staff,28,0,30,2
1650776114048,MATH 18,A01,083743,Staff,0,0,30,30
1650776114048,MATH 18,A02,083744,Staff,23,0,30,7
1650776114048,MATH 18,A03,083745,Staff,21,0,30,9
1650776114048,MATH 18,A04,083746,Staff,26,0,30,4
1650776114048,MATH 18,B01,083748,Staff,0,15,30,30
1650776114048,MATH 18,B02,083749,Staff,0,12,30,30
1650776114048,MATH 18,B03,083750,Staff,0,12,30,30
1650776114048,MATH 18,B04,083751,Staff,0,12,30,30
1650776120076,MATH 20A,A01,083754,Staff,19,0,40,21
1650776126100,MATH 20B,A01,083756,Staff,0,13,30,30
1650776126100,MATH 20B,A02,083757,Staff,0,12,30,30
1650776132129,MATH 20C,A01,083760,Staff,0,16,30,30
1650776132129,MATH 20C,A02,083761,Staff,0,16,30,30
1650776132129,MATH 20C,B01,083762,Staff,9,0,30,21
1650776132129,MATH 20C,B02,083763,Staff,28,0,30,2
1650776138156,MATH 20D,A01,083765,Staff,2,1,30,28
1650776138156,MATH 20D,A02,083766,Staff,6,0,30,24
1650776138156,MATH 20D,A03,083767,Staff,24,0,30,6
1650776144190,MATH 20E,A01,083771,Staff,2,0,30,28
1650776144190,MATH 20E,A02,083772,Staff,15,0,30,15
1650776144190,MATH 20E,B01,083773,Staff,0,0,30,30
1650776144190,MATH 20E,B02,083774,Staff,5,0,30,25
1650776150218,MATH 103A,A01,083777,Staff,0,16,30,30
1650776150218,MATH 103A,A02,083778,Staff,0,15,30,30
1650776150218,MATH 103A,B01,083779,Staff,0,15,30,30
1650776150218,MATH 103A,B02,083780,Staff,0,15,30,30
1650776156240,MATH 105,A01,085443,Staff,0,22,30,30
1650776162267,MATH 109,A01,083213,Anzaldo; Leesa B,0,7,30,30
1650776162267,MATH 109,A02,083214,Anzaldo; Leesa B,0,7,30,30
1650776162267,MATH 109,B01,083215,Anzaldo; Leesa B,0,8,30,30
1650776162267,MATH 109,B02,083216,Anzaldo; Leesa B,0,7,30,30
1650776168291,MATH 142A,A01,083219,Chow; Bennett,0,16,30,30
1650776168291,MATH 142A,A02,083220,Chow; Bennett,0,15,30,30
1650776168291,MATH 142A,B01,083221,Chow; Bennett,0,15,30,30
1650776168291,MATH 142A,B02,083222,Chow; Bennett,0,14,30,30
1650776174315,MATH 193A,A01,083224,Staff,0,6,30,30
1650776174315,MATH 193A,A02,083225,Staff,0,6,30,30
1650776174315,MATH 193A,A03,083781,Staff,0,6,30,30
1650776174315,MATH 193A,A04,083782,Staff,0,7,30,30
1650776180341,MATH 197,001,091859,McAuley; Julian John,9998,0,9999,1
1650776186424,COGS 9,A01,083615,Staff,1,18,60,59
1650776192450,COGS 11,A01,083617,Boyle; Mary E. T.,16,0,40,24
1650776198477,COGS 13,A01,083071,Staff,0,38,40,40
1650776204503,COGS 14A,A01,092681,Staff,0,36,100,100
1650776210527,COGS 14B,A01,083073,Cheng; Tzu-Han,1,13,50,49
1650776216553,COGS 17,A01,092677,Staff,11,0,75,64
1650776222584,COGS 100,A01,083619,Staff,0,29,60,60
1650776228608,COGS 101A,A01,083621,Davis; Joshua Daniel,0,28,60,60
1650776234634,COGS 101B,A01,091572,Staff,1,4,60,59
1650776240661,COGS 101C,A01,083625,Delgado; Tania,14,0,30,16
1650776246684,COGS 107A,A01,083627,Boyle; Mary E. T.,0,16,60,60
1650776252707,COGS 118A,A01,083075,Staff,0,8,60,60
1650776258732,CSE 3,A50,083646,Miranda; Gregory Joseph,18,0,38,20
1650776258732,CSE 3,A51,083647,Miranda; Gregory Joseph,36,0,37,1
1650776264759,CSE 8A,A50,083650,Miranda; Gregory Joseph,0,29,40,40
1650776270785,CSE 11,A01,083080,Cao; Yingjun,0,96,40,40
1650776276805,CSE 12,A01,083652,Staff,0,21,100,100
1650776282832,CSE 15L,A01,083654,Staff,0,3,50,50
1650776282832,CSE 15L,A02,083655,Staff,0,2,50,50
1650776288856,CSE 20,A01,083657,Staff,49,0,80,31
1650776294882,CSE 30,A01,083084,Eldon; John,0,75,40,40
1650776300908,CSE 100,A01,083659,Cao; Yingjun,0,71,50,50
1650776306934,CSE 134B,A01,083661,Powell; Thomas Allan,0,38,65,65
1650776312958,CSE 140,A01,083663,Staff,0,11,75,75
1650776318982,CSE 140L,A01,083088,Eldon; John,0,20,75,75
1650776325087,CSE 175,A01,083665,Kumar; Rakesh,7,0,25,18
1650776331111,CSE 190,A00,092507,Dubnov; Shlomo,10,0,20,10
1650776337147,ECE 45,A01,083139,Staff,1,2,60,59
1650776343180,ECE 65,A50,083695,Staff,0,5,30,30
1650776349216,ECE 109,A01,091882,Touri; Behrouz,32,0,70,38
1650776355240,ECE 180,A00,083140,Abi Samra; Nicholas Camill,20,0,30,10
1650776355240,ECE 180,B00,083141,Abi Samra; Nicholas Camill,0,0,30,30
1650776361264,MATH 10A,A01,083735,Patchell; Gregory David,2,0,30,28
1650776361264,MATH 10A,A02,083736,Patchell; Gregory David,27,0,30,3
1650776361264,MATH 10A,A03,083737,Patchell; Gregory David,24,0,30,6
1650776367294,MATH 10B,A01,083207,Staff,0,9,30,30
1650776367294,MATH 10B,A02,083208,Staff,1,7,30,29
1650776367294,MATH 10B,B01,083739,Staff,11,0,30,19
1650776367294,MATH 10B,B02,083740,Staff,28,0,30,2
1650776373325,MATH 18,A01,083743,Staff,0,0,30,30
1650776373325,MATH 18,A02,083744,Staff,23,0,30,7
1650776373325,MATH 18,A03,083745,Staff,21,0,30,9
1650776373325,MATH 18,A04,083746,Staff,26,0,30,4
1650776373325,MATH 18,B01,083748,Staff,0,15,30,30
1650776373325,MATH 18,B02,083749,Staff,0,12,30,30
1650776373325,MATH 18,B03,083750,Staff,0,12,30,30
1650776373325,MATH 18,B04,083751,Staff,0,12,30,30
1650776379351,MATH 20A,A01,083754,Staff,19,0,40,21
1650776385379,MATH 20B,A01,083756,Staff,0,13,30,30
1650776385379,MATH 20B,A02,083757,Staff,0,12,30,30
1650776391405,MATH 20C,A01,083760,Staff,0,16,30,30
1650776391405,MATH 20C,A02,083761,Staff,0,16,30,30
1650776391405,MATH 20C,B01,083762,Staff,9,0,30,21
1650776391405,MATH 20C,B02,083763,Staff,28,0,30,2
1650776397435,MATH 20D,A01,083765,Staff,2,1,30,28
1650776397435,MATH 20D,A02,083766,Staff,6,0,30,24
1650776397435,MATH 20D,A03,083767,Staff,24,0,30,6
1650776403467,MATH 20E,A01,083771,Staff,2,0,30,28
1650776403467,MATH 20E,A02,083772,Staff,15,0,30,15
1650776403467,MATH 20E,B01,083773,Staff,0,0,30,30
1650776403467,MATH 20E,B02,083774,Staff,5,0,30,25
1650776409490,MATH 103A,A01,083777,Staff,0,16,30,30
1650776409490,MATH 103A,A02,083778,Staff,0,15,30,30
1650776409490,MATH 103A,B01,083779,Staff,0,15,30,30
1650776409490,MATH 103A,B02,083780,Staff,0,15,30,30
1650776415512,MATH 105,A01,085443,Staff,0,22,30,30
1650776421538,MATH 109,A01,083213,Anzaldo; Leesa B,0,7,30,30
1650776421538,MATH 109,A02,083214,Anzaldo; Leesa B,0,7,30,30
1650776421538,MATH 109,B01,083215,Anzaldo; Leesa B,0,8,30,30
1650776421538,MATH 109,B02,083216,Anzaldo; Leesa B,0,7,30,30
1650776427565,MATH 142A,A01,083219,Chow; Bennett,0,16,30,30
1650776427565,MATH 142A,A02,083220,Chow; Bennett,0,15,30,30
1650776427565,MATH 142A,B01,083221,Chow; Bennett,0,15,30,30
1650776427565,MATH 142A,B02,083222,Chow; Bennett,0,14,30,30
1650776433596,MATH 193A,A01,083224,Staff,0,6,30,30
1650776433596,MATH 193A,A02,083225,Staff,0,6,30,30
1650776433596,MATH 193A,A03,083781,Staff,0,6,30,30
1650776433596,MATH 193A,A04,083782,Staff,0,7,30,30
1650776439619,MATH 197,001,091859,McAuley; Julian John,9998,0,9999,1
1650776445667,COGS 9,A01,083615,Staff,1,18,60,59
1650776451694,COGS 11,A01,083617,Boyle; Mary E. T.,16,0,40,24
1650776457718,COGS 13,A01,083071,Staff,0,38,40,40
1650776463743,COGS 14A,A01,092681,Staff,0,36,100,100
1650776469769,COGS 14B,A01,083073,Cheng; Tzu-Han,1,13,50,49
1650776475797,COGS 17,A01,092677,Staff,11,0,75,64
1650776481828,COGS 100,A01,083619,Staff,0,29,60,60
1650776487855,COGS 101A,A01,083621,Davis; Joshua Daniel,0,28,60,60
1650776493889,COGS 101B,A01,091572,Staff,1,4,60,59
1650776499923,COGS 101C,A01,083625,Delgado; Tania,14,0,30,16
1650776505951,COGS 107A,A01,083627,Boyle; Mary E. T.,0,16,60,60
1650776511985,COGS 118A,A01,083075,Staff,0,8,60,60
1650776518009,CSE 3,A50,083646,Miranda; Gregory Joseph,18,0,38,20
1650776518009,CSE 3,A51,083647,Miranda; Gregory Joseph,36,0,37,1
1650776524042,CSE 8A,A50,083650,Miranda; Gregory Joseph,0,29,40,40
1650776530067,CSE 11,A01,083080,Cao; Yingjun,0,96,40,40
1650776536091,CSE 12,A01,083652,Staff,0,21,100,100
1650776542119,CSE 15L,A01,083654,Staff,0,3,50,50
1650776542119,CSE 15L,A02,083655,Staff,0,2,50,50
1650776548145,CSE 20,A01,083657,Staff,49,0,80,31
1650776554171,CSE 30,A01,083084,Eldon; John,0,75,40,40
1650776560192,CSE 100,A01,083659,Cao; Yingjun,0,71,50,50
1650776566215,CSE 134B,A01,083661,Powell; Thomas Allan,0,38,65,65
1650776572238,CSE 140,A01,083663,Staff,0,11,75,75
1650776578264,CSE 140L,A01,083088,Eldon; John,0,20,75,75
1650776584288,CSE 175,A01,083665,Kumar; Rakesh,7,0,25,18
1650776590312,CSE 190,A00,092507,Dubnov; Shlomo,10,0,20,10
1650776596349,ECE 45,A01,083139,Staff,1,2,60,59
1650776602376,ECE 65,A50,083695,Staff,0,5,30,30
1650776608407,ECE 109,A01,091882,Touri; Behrouz,32,0,70,38
1650776614450,ECE 180,A00,083140,Abi Samra; Nicholas Camill,20,0,30,10
1650776614450,ECE 180,B00,083141,Abi Samra; Nicholas Camill,0,0,30,30
1650776620477,MATH 10A,A01,083735,Patchell; Gregory David,2,0,30,28
1650776620477,MATH 10A,A02,083736,Patchell; Gregory David,27,0,30,3
1650776620477,MATH 10A,A03,083737,Patchell; Gregory David,24,0,30,6
1650776626502,MATH 10B,A01,083207,Staff,0,9,30,30
1650776626502,MATH 10B,A02,083208,Staff,1,7,30,29
1650776626502,MATH 10B,B01,083739,Staff,11,0,30,19
1650776626502,MATH 10B,B02,083740,Staff,28,0,30,2
1650776632527,MATH 18,A01,083743,Staff,0,0,30,30
1650776632527,MATH 18,A02,083744,Staff,23,0,30,7
1650776632527,MATH 18,A03,083745,Staff,21,0,30,9
1650776632527,MATH 18,A04,083746,Staff,26,0,30,4
1650776632527,MATH 18,B01,083748,Staff,0,15,30,30
1650776632527,MATH 18,B02,083749,Staff,0,12,30,30
1650776632527,MATH 18,B03,083750,Staff,0,12,30,30
1650776632527,MATH 18,B04,083751,Staff,0,12,30,30
1650776638550,MATH 20A,A01,083754,Staff,19,0,40,21
1650776644578,MATH 20B,A01,083756,Staff,0,13,30,30
1650776644578,MATH 20B,A02,083757,Staff,0,12,30,30
1650776650603,MATH 20C,A01,083760,Staff,0,16,30,30
1650776650603,MATH 20C,A02,083761,Staff,0,16,30,30
1650776650603,MATH 20C,B01,083762,Staff,9,0,30,21
1650776650603,MATH 20C,B02,083763,Staff,28,0,30,2
1650776656627,MATH 20D,A01,083765,Staff,2,1,30,28
1650776656627,MATH 20D,A02,083766,Staff,6,0,30,24
1650776656627,MATH 20D,A03,083767,Staff,24,0,30,6
1650776662651,MATH 20E,A01,083771,Staff,2,0,30,28
1650776662651,MATH 20E,A02,083772,Staff,15,0,30,15
1650776662651,MATH 20E,B01,083773,Staff,0,0,30,30
1650776662651,MATH 20E,B02,083774,Staff,5,0,30,25
1650776668676,MATH 103A,A01,083777,Staff,0,16,30,30
1650776668676,MATH 103A,A02,083778,Staff,0,15,30,30
1650776668676,MATH 103A,B01,083779,Staff,0,15,30,30
1650776668676,MATH 103A,B02,083780,Staff,0,15,30,30
1650776674702,MATH 105,A01,085443,Staff,0,22,30,30
1650776680736,MATH 109,A01,083213,Anzaldo; Leesa B,0,7,30,30
1650776680736,MATH 109,A02,083214,Anzaldo; Leesa B,0,7,30,30
1650776680736,MATH 109,B01,083215,Anzaldo; Leesa B,0,8,30,30
1650776680736,MATH 109,B02,083216,Anzaldo; Leesa B,0,7,30,30
1650776686771,MATH 142A,A01,083219,Chow; Bennett,0,16,30,30
1650776686771,MATH 142A,A02,083220,Chow; Bennett,0,15,30,30
1650776686771,MATH 142A,B01,083221,Chow; Bennett,0,15,30,30
1650776686771,MATH 142A,B02,083222,Chow; Bennett,0,14,30,30
1650776692795,MATH 193A,A01,083224,Staff,0,6,30,30
1650776692795,MATH 193A,A02,083225,Staff,0,6,30,30
1650776692795,MATH 193A,A03,083781,Staff,0,6,30,30
1650776692795,MATH 193A,A04,083782,Staff,0,7,30,30
1650776698822,MATH 197,001,091859,McAuley; Julian John,9998,0,9999,1
1650776704898,COGS 9,A01,083615,Staff,1,18,60,59
1650776710921,COGS 11,A01,083617,Boyle; Mary E. T.,16,0,40,24
1650776716947,COGS 13,A01,083071,Staff,0,38,40,40
1650776722969,COGS 14A,A01,092681,Staff,0,36,100,100
1650776729007,COGS 14B,A01,083073,Cheng; Tzu-Han,1,13,50,49
1650776735031,COGS 17,A01,092677,Staff,11,0,75,64
1650776741058,COGS 100,A01,083619,Staff,0,29,60,60
1650776747085,COGS 101A,A01,083621,Davis; Joshua Daniel,0,28,60,60
1650776753108,COGS 101B,A01,091572,Staff,1,4,60,59
1650776759136,COGS 101C,A01,083625,Delgado; Tania,14,0,30,16
1650776765160,COGS 107A,A01,083627,Boyle; Mary E. T.,0,16,60,60
1650776771187,COGS 118A,A01,083075,Staff,0,8,60,60
1650776777218,CSE 3,A50,083646,Miranda; Gregory Joseph,18,0,38,20
1650776777218,CSE 3,A51,083647,Miranda; Gregory Joseph,36,0,37,1
1650776783244,CSE 8A,A50,083650,Miranda; Gregory Joseph,0,29,40,40
1650776789271,CSE 11,A01,083080,Cao; Yingjun,0,96,40,40
1650776795294,CSE 12,A01,083652,Staff,0,21,100,100
1650776801326,CSE 15L,A01,083654,Staff,0,3,50,50
1650776801326,CSE 15L,A02,083655,Staff,0,2,50,50
1650776807367,CSE 20,A01,083657,Staff,49,0,80,31
1650776813390,CSE 30,A01,083084,Eldon; John,0,75,40,40
1650776819421,CSE 100,A01,083659,Cao; Yingjun,0,71,50,50
1650776825450,CSE 134B,A01,083661,Powell; Thomas Allan,0,38,65,65
1650776831474,CSE 140,A01,083663,Staff,0,11,75,75
1650776837502,CSE 140L,A01,083088,Eldon; John,0,20,75,75
1650776843528,CSE 175,A01,083665,Kumar; Rakesh,7,0,25,18
1650776849551,CSE 190,A00,092507,Dubnov; Shlomo,10,0,20,10
1650776855587,ECE 45,A01,083139,Staff,1,2,60,59
1650776861613,ECE 65,A50,083695,Staff,0,5,30,30
1650776867643,ECE 109,A01,091882,Touri; Behrouz,32,0,70,38
1650776873666,ECE 180,A00,083140,Abi Samra; Nicholas Camill,20,0,30,10
1650776873666,ECE 180,B00,083141,Abi Samra; Nicholas Camill,0,0,30,30
1650776879691,MATH 10A,A01,083735,Patchell; Gregory David,2,0,30,28
1650776879691,MATH 10A,A02,083736,Patchell; Gregory David,27,0,30,3
1650776879691,MATH 10A,A03,083737,Patchell; Gregory David,24,0,30,6
1650776885714,MATH 10B,A01,083207,Staff,0,9,30,30
1650776885714,MATH 10B,A02,083208,Staff,1,7,30,29
1650776885714,MATH 10B,B01,083739,Staff,11,0,30,19
1650776885714,MATH 10B,B02,083740,Staff,28,0,30,2
1650776891740,MATH 18,A01,083743,Staff,0,0,30,30
1650776891740,MATH 18,A02,083744,Staff,23,0,30,7
1650776891740,MATH 18,A03,083745,Staff,21,0,30,9
1650776891740,MATH 18,A04,083746,Staff,26,0,30,4
1650776891740,MATH 18,B01,083748,Staff,0,15,30,30
1650776891740,MATH 18,B02,083749,Staff,0,12,30,30
1650776891740,MATH 18,B03,083750,Staff,0,12,30,30
1650776891740,MATH 18,B04,083751,Staff,0,12,30,30
1650776897767,MATH 20A,A01,083754,Staff,19,0,40,21
1650776903790,MATH 20B,A01,083756,Staff,0,13,30,30
1650776903790,MATH 20B,A02,083757,Staff,0,12,30,30
1650776909814,MATH 20C,A01,083760,Staff,0,16,30,30
1650776909814,MATH 20C,A02,083761,Staff,0,16,30,30
1650776909814,MATH 20C,B01,083762,Staff,9,0,30,21
1650776909814,MATH 20C,B02,083763,Staff,28,0,30,2
1650776915837,MATH 20D,A01,083765,Staff,2,1,30,28
1650776915837,MATH 20D,A02,083766,Staff,6,0,30,24
1650776915837,MATH 20D,A03,083767,Staff,24,0,30,6
1650776921935,MATH 20E,A01,083771,Staff,2,0,30,28
1650776921935,MATH 20E,A02,083772,Staff,15,0,30,15
1650776921935,MATH 20E,B01,083773,Staff,0,0,30,30
1650776921935,MATH 20E,B02,083774,Staff,5,0,30,25
1650776927963,MATH 103A,A01,083777,Staff,0,16,30,30
1650776927963,MATH 103A,A02,083778,Staff,0,15,30,30
1650776927963,MATH 103A,B01,083779,Staff,0,15,30,30
1650776927963,MATH 103A,B02,083780,Staff,0,15,30,30
1650776933997,MATH 105,A01,085443,Staff,0,22,30,30
1650776940027,MATH 109,A01,083213,Anzaldo; Leesa B,0,7,30,30
1650776940027,MATH 109,A02,083214,Anzaldo; Leesa B,0,7,30,30
1650776940027,MATH 109,B01,083215,Anzaldo; Leesa B,0,8,30,30
1650776940027,MATH 109,B02,083216,Anzaldo; Leesa B,0,7,30,30
1650776946055,MATH 142A,A01,083219,Chow; Bennett,0,16,30,30
1650776946055,MATH 142A,A02,083220,Chow; Bennett,0,15,30,30
1650776946055,MATH 142A,B01,083221,Chow; Bennett,0,15,30,30
1650776946055,MATH 142A,B02,083222,Chow; Bennett,0,14,30,30
1650776952082,MATH 193A,A01,083224,Staff,0,6,30,30
1650776952082,MATH 193A,A02,083225,Staff,0,6,30,30
1650776952082,MATH 193A,A03,083781,Staff,0,6,30,30
1650776952082,MATH 193A,A04,083782,Staff,0,7,30,30
1650776958107,MATH 197,001,091859,McAuley; Julian John,9998,0,9999,1
1650776964160,COGS 9,A01,083615,Staff,1,18,60,59
1650776970185,COGS 11,A01,083617,Boyle; Mary E. T.,16,0,40,24
1650776976209,COGS 13,A01,083071,Staff,0,38,40,40
1650776982233,COGS 14A,A01,092681,Staff,0,36,100,100
1650776988261,COGS 14B,A01,083073,Cheng; Tzu-Han,1,13,50,49
1650776994288,COGS 17,A01,092677,Staff,11,0,75,64
1650777000314,COGS 100,A01,083619,Staff,0,29,60,60
1650777006342,COGS 101A,A01,083621,Davis; Joshua Daniel,0,28,60,60
1650777012367,COGS 101B,A01,091572,Staff,1,4,60,59
1650777018391,COGS 101C,A01,083625,Delgado; Tania,14,0,30,16
1650777024415,COGS 107A,A01,083627,Boyle; Mary E. T.,0,16,60,60
1650777030440,COGS 118A,A01,083075,Staff,0,8,60,60
1650777036463,CSE 3,A50,083646,Miranda; Gregory Joseph,18,0,38,20
1650777036463,CSE 3,A51,083647,Miranda; Gregory Joseph,36,0,37,1
1650777042487,CSE 8A,A50,083650,Miranda; Gregory Joseph,0,29,40,40
1650777048514,CSE 11,A01,083080,Cao; Yingjun,0,96,40,40
1650777054539,CSE 12,A01,083652,Staff,0,21,100,100
1650777060573,CSE 15L,A01,083654,Staff,0,3,50,50
1650777060573,CSE 15L,A02,083655,Staff,0,2,50,50
1650777066595,CSE 20,A01,083657,Staff,49,0,80,31
1650777072617,CSE 30,A01,083084,Eldon; John,0,75,40,40
1650777078640,CSE 100,A01,083659,Cao; Yingjun,0,71,50,50
1650777084663,CSE 134B,A01,083661,Powell; Thomas Allan,0,38,65,65
1650777090687,CSE 140,A01,083663,Staff,0,11,75,75
1650777096713,CSE 140L,A01,083088,Eldon; John,0,20,75,75
1650777102734,CSE 175,A01,083665,Kumar; Rakesh,7,0,25,18
1650777108757,CSE 190,A00,092507,Dubnov; Shlomo,10,0,20,10
1650777114781,ECE 45,A01,083139,Staff,1,2,60,59
1650777120803,ECE 65,A50,083695,Staff,0,5,30,30
1650777126827,ECE 109,A01,091882,Touri; Behrouz,32,0,70,38
1650777132854,ECE 180,A00,083140,Abi Samra; Nicholas Camill,20,0,30,10
1650777132854,ECE 180,B00,083141,Abi Samra; Nicholas Camill,0,0,30,30
1650777138881,MATH 10A,A01,083735,Patchell; Gregory David,2,0,30,28
1650777138881,MATH 10A,A02,083736,Patchell; Gregory David,27,0,30,3
1650777138881,MATH 10A,A03,083737,Patchell; Gregory David,24,0,30,6
1650777144908,MATH 10B,A01,083207,Staff,0,9,30,30
1650777144908,MATH 10B,A02,083208,Staff,1,7,30,29
1650777144908,MATH 10B,B01,083739,Staff,10,0,30,20
1650777144908,MATH 10B,B02,083740,Staff,28,0,30,2
1650777150934,MATH 18,A01,083743,Staff,0,0,30,30
1650777150934,MATH 18,A02,083744,Staff,23,0,30,7
1650777150934,MATH 18,A03,083745,Staff,21,0,30,9
1650777150934,MATH 18,A04,083746,Staff,26,0,30,4
1650777150934,MATH 18,B01,083748,Staff,0,15,30,30
1650777150934,MATH 18,B02,083749,Staff,0,12,30,30
1650777150934,MATH 18,B03,083750,Staff,0,12,30,30
1650777150934,MATH 18,B04,083751,Staff,0,12,30,30
1650777156960,MATH 20A,A01,083754,Staff,19,0,40,21
1650777162985,MATH 20B,A01,083756,Staff,0,13,30,30
1650777162985,MATH 20B,A02,083757,Staff,0,12,30,30
1650777169010,MATH 20C,A01,083760,Staff,0,16,30,30
1650777169010,MATH 20C,A02,083761,Staff,0,16,30,30
1650777169010,MATH 20C,B01,083762,Staff,9,0,30,21
1650777169010,MATH 20C,B02,083763,Staff,28,0,30,2
1650777175041,MATH 20D,A01,083765,Staff,2,1,30,28
1650777175041,MATH 20D,A02,083766,Staff,6,0,30,24
1650777175041,MATH 20D,A03,083767,Staff,24,0,30,6
1650777181065,MATH 20E,A01,083771,Staff,2,0,30,28
1650777181065,MATH 20E,A02,083772,Staff,15,0,30,15
1650777181065,MATH 20E,B01,083773,Staff,0,0,30,30
1650777181065,MATH 20E,B02,083774,Staff,5,0,30,25
1650777187094,MATH 103A,A01,083777,Staff,0,16,30,30
1650777187094,MATH 103A,A02,083778,Staff,0,15,30,30
1650777187094,MATH 103A,B01,083779,Staff,0,15,30,30
1650777187094,MATH 103A,B02,083780,Staff,0,15,30,30
1650777193117,MATH 105,A01,085443,Staff,0,22,30,30
1650777199141,MATH 109,A01,083213,Anzaldo; Leesa B,0,7,30,30
1650777199141,MATH 109,A02,083214,Anzaldo; Leesa B,0,7,30,30
1650777199141,MATH 109,B01,083215,Anzaldo; Leesa B,0,8,30,30
1650777199141,MATH 109,B02,083216,Anzaldo; Leesa B,0,7,30,30
1650777205170,MATH 142A,A01,083219,Chow; Bennett,0,16,30,30
1650777205170,MATH 142A,A02,083220,Chow; Bennett,0,15,30,30
1650777205170,MATH 142A,B01,083221,Chow; Bennett,0,15,30,30
1650777205170,MATH 142A,B02,083222,Chow; Bennett,0,14,30,30
1650777211195,MATH 193A,A01,083224,Staff,0,6,30,30
1650777211195,MATH 193A,A02,083225,Staff,0,6,30,30
1650777211195,MATH 193A,A03,083781,Staff,0,6,30,30
1650777211195,MATH 193A,A04,083782,Staff,0,7,30,30
1650777217224,MATH 197,001,091859,McAuley; Julian John,9998,0,9999,1
1650777223292,COGS 9,A01,083615,Staff,1,18,60,59
1650777229320,COGS 11,A01,083617,Boyle; Mary E. T.,16,0,40,24
1650777235352,COGS 13,A01,083071,Staff,0,38,40,40
1650777241389,COGS 14A,A01,092681,Staff,0,36,100,100
1650777247422,COGS 14B,A01,083073,Cheng; Tzu-Han,1,13,50,49
1650777253455,COGS 17,A01,092677,Staff,11,0,75,64
1650777259479,COGS 100,A01,083619,Staff,0,29,60,60
1650777265506,COGS 101A,A01,083621,Davis; Joshua Daniel,0,28,60,60
1650777271529,COGS 101B,A01,091572,Staff,1,4,60,59
1650777277554,COGS 101C,A01,083625,Delgado; Tania,14,0,30,16
1650777283577,COGS 107A,A01,083627,Boyle; Mary E. T.,0,16,60,60
1650777289601,COGS 118A,A01,083075,Staff,0,8,60,60
1650777295627,CSE 3,A50,083646,Miranda; Gregory Joseph,18,0,38,20
1650777295627,CSE 3,A51,083647,Miranda; Gregory Joseph,36,0,37,1
1650777301658,CSE 8A,A50,083650,Miranda; Gregory Joseph,0,29,40,40
1650777307685,CSE 11,A01,083080,Cao; Yingjun,0,96,40,40
1650777313712,CSE 12,A01,083652,Staff,0,21,100,100
1650777319736,CSE 15L,A01,083654,Staff,0,3,50,50
1650777319736,CSE 15L,A02,083655,Staff,0,2,50,50
1650777325761,CSE 20,A01,083657,Staff,49,0,80,31
1650777331784,CSE 30,A01,083084,Eldon; John,0,75,40,40
1650777337808,CSE 100,A01,083659,Cao; Yingjun,0,71,50,50
1650777343832,CSE 134B,A01,083661,Powell; Thomas Allan,0,38,65,65
1650777349855,CSE 140,A01,083663,Staff,0,11,75,75
1650777355878,CSE 140L,A01,083088,Eldon; John,0,20,75,75
1650777361902,CSE 175,A01,083665,Kumar; Rakesh,7,0,25,18
1650777367929,CSE 190,A00,092507,Dubnov; Shlomo,10,0,20,10
1650777373953,ECE 45,A01,083139,Staff,1,2,60,59
1650777379977,ECE 65,A50,083695,Staff,0,5,30,30
1650777386003,ECE 109,A01,091882,Touri; Behrouz,32,0,70,38
1650777392027,ECE 180,A00,083140,Abi Samra; Nicholas Camill,20,0,30,10
1650777392027,ECE 180,B00,083141,Abi Samra; Nicholas Camill,0,0,30,30
1650777398055,MATH 10A,A01,083735,Patchell; Gregory David,2,0,30,28
1650777398055,MATH 10A,A02,083736,Patchell; Gregory David,27,0,30,3
1650777398055,MATH 10A,A03,083737,Patchell; Gregory David,24,0,30,6
1650777404099,MATH 10B,A01,083207,Staff,0,9,30,30
1650777404099,MATH 10B,A02,083208,Staff,1,7,30,29
1650777404099,MATH 10B,B01,083739,Staff,10,0,30,20
1650777404099,MATH 10B,B02,083740,Staff,28,0,30,2
1650777410125,MATH 18,A01,083743,Staff,0,0,30,30
1650777410125,MATH 18,A02,083744,Staff,23,0,30,7
1650777410125,MATH 18,A03,083745,Staff,21,0,30,9
1650777410125,MATH 18,A04,083746,Staff,26,0,30,4
1650777410125,MATH 18,B01,083748,Staff,0,15,30,30
1650777410125,MATH 18,B02,083749,Staff,0,12,30,30
1650777410125,MATH 18,B03,083750,Staff,0,12,30,30
1650777410125,MATH 18,B04,083751,Staff,0,12,30,30
1650777416150,MATH 20A,A01,083754,Staff,19,0,40,21
1650777422175,MATH 20B,A01,083756,Staff,0,13,30,30
1650777422175,MATH 20B,A02,083757,Staff,0,12,30,30
1650777428199,MATH 20C,A01,083760,Staff,0,16,30,30
1650777428199,MATH 20C,A02,083761,Staff,0,16,30,30
1650777428199,MATH 20C,B01,083762,Staff,9,0,30,21
1650777428199,MATH 20C,B02,083763,Staff,28,0,30,2
1650777434224,MATH 20D,A01,083765,Staff,2,1,30,28
1650777434224,MATH 20D,A02,083766,Staff,6,0,30,24
1650777434224,MATH 20D,A03,083767,Staff,24,0,30,6
1650777440251,MATH 20E,A01,083771,Staff,2,0,30,28
1650777440251,MATH 20E,A02,083772,Staff,15,0,30,15
1650777440251,MATH 20E,B01,083773,Staff,0,0,30,30
1650777440251,MATH 20E,B02,083774,Staff,5,0,30,25
1650777446279,MATH 103A,A01,083777,Staff,0,16,30,30
1650777446279,MATH 103A,A02,083778,Staff,0,15,30,30
1650777446279,MATH 103A,B01,083779,Staff,0,15,30,30
1650777446279,MATH 103A,B02,083780,Staff,0,15,30,30
1650777452303,MATH 105,A01,085443,Staff,0,22,30,30
1650777458331,MATH 109,A01,083213,Anzaldo; Leesa B,0,7,30,30
1650777458331,MATH 109,A02,083214,Anzaldo; Leesa B,0,7,30,30
1650777458331,MATH 109,B01,083215,Anzaldo; Leesa B,0,8,30,30
1650777458331,MATH 109,B02,083216,Anzaldo; Leesa B,0,7,30,30
1650777464355,MATH 142A,A01,083219,Chow; Bennett,0,16,30,30
1650777464355,MATH 142A,A02,083220,Chow; Bennett,0,15,30,30
1650777464355,MATH 142A,B01,083221,Chow; Bennett,0,15,30,30
1650777464355,MATH 142A,B02,083222,Chow; Bennett,0,14,30,30
1650777470384,MATH 193A,A01,083224,Staff,0,6,30,30
1650777470384,MATH 193A,A02,083225,Staff,0,6,30,30
1650777470384,MATH 193A,A03,083781,Staff,0,6,30,30
1650777470384,MATH 193A,A04,083782,Staff,0,7,30,30
1650777476406,MATH 197,001,091859,McAuley; Julian John,9998,0,9999,1
1650777482460,COGS 9,A01,083615,Staff,1,18,60,59
1650777488487,COGS 11,A01,083617,Boyle; Mary E. T.,16,0,40,24
1650777494514,COGS 13,A01,083071,Staff,0,38,40,40
1650777500541,COGS 14A,A01,092681,Staff,0,36,100,100
1650777506565,COGS 14B,A01,083073,Cheng; Tzu-Han,1,13,50,49
1650777512666,COGS 17,A01,092677,Staff,11,0,75,64
1650777518689,COGS 100,A01,083619,Staff,0,29,60,60
1650777524713,COGS 101A,A01,083621,Davis; Joshua Daniel,0,28,60,60
1650777530737,COGS 101B,A01,091572,Staff,1,4,60,59
1650777536763,COGS 101C,A01,083625,Delgado; Tania,14,0,30,16
1650777542790,COGS 107A,A01,083627,Boyle; Mary E. T.,0,16,60,60
1650777548821,COGS 118A,A01,083075,Staff,0,8,60,60
1650777554856,CSE 3,A50,083646,Miranda; Gregory Joseph,18,0,38,20
1650777554856,CSE 3,A51,083647,Miranda; Gregory Joseph,36,0,37,1
1650777560882,CSE 8A,A50,083650,Miranda; Gregory Joseph,0,29,40,40
1650777566906,CSE 11,A01,083080,Cao; Yingjun,0,96,40,40
1650777572929,CSE 12,A01,083652,Staff,0,21,100,100
1650777578956,CSE 15L,A01,083654,Staff,0,3,50,50
1650777578956,CSE 15L,A02,083655,Staff,0,2,50,50
1650777584986,CSE 20,A01,083657,Staff,49,0,80,31
1650777591011,CSE 30,A01,083084,Eldon; John,0,75,40,40
1650777597041,CSE 100,A01,083659,Cao; Yingjun,0,71,50,50
1650777603066,CSE 134B,A01,083661,Powell; Thomas Allan,0,38,65,65
1650777609089,CSE 140,A01,083663,Staff,0,11,75,75
1650777615113,CSE 140L,A01,083088,Eldon; John,0,20,75,75
1650777621137,CSE 175,A01,083665,Kumar; Rakesh,7,0,25,18
1650777627164,CSE 190,A00,092507,Dubnov; Shlomo,10,0,20,10
1650777633188,ECE 45,A01,083139,Staff,1,2,60,59
1650777639210,ECE 65,A50,083695,Staff,0,5,30,30
1650777645234,ECE 109,A01,091882,Touri; Behrouz,32,0,70,38
1650777651265,ECE 180,A00,083140,Abi Samra; Nicholas Camill,20,0,30,10
1650777651265,ECE 180,B00,083141,Abi Samra; Nicholas Camill,0,0,30,30
1650777657289,MATH 10A,A01,083735,Patchell; Gregory David,2,0,30,28
1650777657289,MATH 10A,A02,083736,Patchell; Gregory David,27,0,30,3
1650777657289,MATH 10A,A03,083737,Patchell; Gregory David,24,0,30,6
1650777663322,MATH 10B,A01,083207,Staff,0,9,30,30
1650777663322,MATH 10B,A02,083208,Staff,1,7,30,29
1650777663322,MATH 10B,B01,083739,Staff,10,0,30,20
1650777663322,MATH 10B,B02,083740,Staff,28,0,30,2
1650777669352,MATH 18,A01,083743,Staff,0,0,30,30
1650777669352,MATH 18,A02,083744,Staff,23,0,30,7
1650777669352,MATH 18,A03,083745,Staff,21,0,30,9
1650777669352,MATH 18,A04,083746,Staff,26,0,30,4
1650777669352,MATH 18,B01,083748,Staff,0,15,30,30
1650777669352,MATH 18,B02,083749,Staff,0,12,30,30
1650777669352,MATH 18,B03,083750,Staff,0,12,30,30
1650777669352,MATH 18,B04,083751,Staff,0,12,30,30
1650777675376,MATH 20A,A01,083754,Staff,19,0,40,21
1650777681400,MATH 20B,A01,083756,Staff,0,13,30,30
1650777681400,MATH 20B,A02,083757,Staff,0,12,30,30
1650777687427,MATH 20C,A01,083760,Staff,0,16,30,30
1650777687427,MATH 20C,A02,083761,Staff,0,16,30,30
1650777687427,MATH 20C,B01,083762,Staff,9,0,30,21
1650777687427,MATH 20C,B02,083763,Staff,28,0,30,2
1650777693453,MATH 20D,A01,083765,Staff,2,1,30,28
1650777693453,MATH 20D,A02,083766,Staff,6,0,30,24
1650777693453,MATH 20D,A03,083767,Staff,24,0,30,6
1650777699477,MATH 20E,A01,083771,Staff,2,0,30,28
1650777699477,MATH 20E,A02,083772,Staff,15,0,30,15
1650777699477,MATH 20E,B01,083773,Staff,0,0,30,30
1650777699477,MATH 20E,B02,083774,Staff,5,0,30,25
1650777705502,MATH 103A,A01,083777,Staff,0,16,30,30
1650777705502,MATH 103A,A02,083778,Staff,0,15,30,30
1650777705502,MATH 103A,B01,083779,Staff,0,15,30,30
1650777705502,MATH 103A,B02,083780,Staff,0,15,30,30
1650777711524,MATH 105,A01,085443,Staff,0,22,30,30
1650777717548,MATH 109,A01,083213,Anzaldo; Leesa B,0,7,30,30
1650777717548,MATH 109,A02,083214,Anzaldo; Leesa B,0,7,30,30
1650777717548,MATH 109,B01,083215,Anzaldo; Leesa B,0,8,30,30
1650777717548,MATH 109,B02,083216,Anzaldo; Leesa B,0,7,30,30
1650777723576,MATH 142A,A01,083219,Chow; Bennett,0,16,30,30
1650777723576,MATH 142A,A02,083220,Chow; Bennett,0,15,30,30
1650777723576,MATH 142A,B01,083221,Chow; Bennett,0,15,30,30
1650777723576,MATH 142A,B02,083222,Chow; Bennett,0,14,30,30
1650777729601,MATH 193A,A01,083224,Staff,0,6,30,30
1650777729601,MATH 193A,A02,083225,Staff,0,6,30,30
1650777729601,MATH 193A,A03,083781,Staff,0,6,30,30
1650777729601,MATH 193A,A04,083782,Staff,0,7,30,30
1650777735623,MATH 197,001,091859,McAuley; Julian John,9998,0,9999,1
1650777741676,COGS 9,A01,083615,Staff,1,18,60,59
1650777747701,COGS 11,A01,083617,Boyle; Mary E. T.,16,0,40,24
1650777753725,COGS 13,A01,083071,Staff,0,38,40,40
1650777765230,COGS 14A,A01,092681,Staff,0,36,100,100
1650777771256,COGS 14B,A01,083073,Cheng; Tzu-Han,1,13,50,49
1650777777283,COGS 17,A01,092677,Staff,11,0,75,64
1650777783310,COGS 100,A01,083619,Staff,0,29,60,60
1650777789334,COGS 101A,A01,083621,Davis; Joshua Daniel,0,28,60,60
1650777795375,COGS 101B,A01,091572,Staff,1,4,60,59
1650777801399,COGS 101C,A01,083625,Delgado; Tania,14,0,30,16
1650777807424,COGS 107A,A01,083627,Boyle; Mary E. T.,0,16,60,60
1650777813447,COGS 118A,A01,083075,Staff,0,8,60,60
1650777819471,CSE 3,A50,083646,Miranda; Gregory Joseph,18,0,38,20
1650777819471,CSE 3,A51,083647,Miranda; Gregory Joseph,36,0,37,1
1650777825494,CSE 8A,A50,083650,Miranda; Gregory Joseph,0,29,40,40
1650777831518,CSE 11,A01,083080,Cao; Yingjun,0,96,40,40
1650777837541,CSE 12,A01,083652,Staff,0,21,100,100
1650777843565,CSE 15L,A01,083654,Staff,0,3,50,50
1650777843565,CSE 15L,A02,083655,Staff,0,2,50,50
1650777849587,CSE 20,A01,083657,Staff,49,0,80,31
1650777855610,CSE 30,A01,083084,Eldon; John,0,75,40,40
1650777861635,CSE 100,A01,083659,Cao; Yingjun,0,71,50,50
1650777867662,CSE 134B,A01,083661,Powell; Thomas Allan,0,38,65,65
1650777873687,CSE 140,A01,083663,Staff,0,11,75,75
1650777879709,CSE 140L,A01,083088,Eldon; John,0,20,75,75
1650777885736,CSE 175,A01,083665,Kumar; Rakesh,7,0,25,18
1650777891759,CSE 190,A00,092507,Dubnov; Shlomo,10,0,20,10
1650777897802,ECE 45,A01,083139,Staff,1,2,60,59
1650777903825,ECE 65,A50,083695,Staff,0,5,30,30
1650777909850,ECE 109,A01,091882,Touri; Behrouz,32,0,70,38
1650777915881,ECE 180,A00,083140,Abi Samra; Nicholas Camill,20,0,30,10
1650777915881,ECE 180,B00,083141,Abi Samra; Nicholas Camill,0,0,30,30
1650777921914,MATH 10A,A01,083735,Patchell; Gregory David,2,0,30,28
1650777921914,MATH 10A,A02,083736,Patchell; Gregory David,27,0,30,3
1650777921914,MATH 10A,A03,083737,Patchell; Gregory David,24,0,30,6
1650777927938,MATH 10B,A01,083207,Staff,0,9,30,30
1650777927938,MATH 10B,A02,083208,Staff,1,7,30,29
1650777927938,MATH 10B,B01,083739,Staff,11,0,30,19
1650777927938,MATH 10B,B02,083740,Staff,28,0,30,2
1650777933963,MATH 18,A01,083743,Staff,0,0,30,30
1650777933963,MATH 18,A02,083744,Staff,23,0,30,7
1650777933963,MATH 18,A03,083745,Staff,21,0,30,9
1650777933963,MATH 18,A04,083746,Staff,26,0,30,4
1650777933963,MATH 18,B01,083748,Staff,0,15,30,30
1650777933963,MATH 18,B02,083749,Staff,0,12,30,30
1650777933963,MATH 18,B03,083750,Staff,0,12,30,30
1650777933963,MATH 18,B04,083751,Staff,0,12,30,30
1650777939990,MATH 20A,A01,083754,Staff,19,0,40,21
1650777946026,MATH 20B,A01,083756,Staff,0,13,30,30
1650777946026,MATH 20B,A02,083757,Staff,0,12,30,30
1650777952054,MATH 20C,A01,083760,Staff,0,16,30,30
1650777952054,MATH 20C,A02,083761,Staff,0,16,30,30
1650777952054,MATH 20C,B01,083762,Staff,9,0,30,21
1650777952054,MATH 20C,B02,083763,Staff,28,0,30,2
1650777958078,MATH 20D,A01,083765,Staff,2,1,30,28
1650777958078,MATH 20D,A02,083766,Staff,6,0,30,24
1650777958078,MATH 20D,A03,083767,Staff,24,0,30,6
1650777964114,MATH 20E,A01,083771,Staff,2,0,30,28
1650777964114,MATH 20E,A02,083772,Staff,15,0,30,15
1650777964114,MATH 20E,B01,083773,Staff,0,0,30,30
1650777964114,MATH 20E,B02,083774,Staff,5,0,30,25
1650777970140,MATH 103A,A01,083777,Staff,0,16,30,30
1650777970140,MATH 103A,A02,083778,Staff,0,15,30,30
1650777970140,MATH 103A,B01,083779,Staff,0,15,30,30
1650777970140,MATH 103A,B02,083780,Staff,0,15,30,30
1650777976164,MATH 105,A01,085443,Staff,0,22,30,30
1650777982203,MATH 109,A01,083213,Anzaldo; Leesa B,0,7,30,30
1650777982203,MATH 109,A02,083214,Anzaldo; Leesa B,0,7,30,30
1650777982203,MATH 109,B01,083215,Anzaldo; Leesa B,0,8,30,30
1650777982203,MATH 109,B02,083216,Anzaldo; Leesa B,0,7,30,30
1650777988230,MATH 142A,A01,083219,Chow; Bennett,0,16,30,30
1650777988230,MATH 142A,A02,083220,Chow; Bennett,0,15,30,30
1650777988230,MATH 142A,B01,083221,Chow; Bennett,0,15,30,30
1650777988230,MATH 142A,B02,083222,Chow; Bennett,0,14,30,30
1650777994252,MATH 193A,A01,083224,Staff,0,6,30,30
1650777994252,MATH 193A,A02,083225,Staff,0,6,30,30
1650777994252,MATH 193A,A03,083781,Staff,0,6,30,30
1650777994252,MATH 193A,A04,083782,Staff,0,7,30,30
1650778000279,MATH 197,001,091859,McAuley; Julian John,9998,0,9999,1
1650778006333,COGS 9,A01,083615,Staff,0,17,60,60
1650778012360,COGS 11,A01,083617,Boyle; Mary E. T.,16,0,40,24
1650778018384,COGS 13,A01,083071,Staff,0,38,40,40
1650778024410,COGS 14A,A01,092681,Staff,0,36,100,100
1650778030435,COGS 14B,A01,083073,Cheng; Tzu-Han,0,12,50,50
1650778036459,COGS 17,A01,092677,Staff,11,0,75,64
1650778042484,COGS 100,A01,083619,Staff,0,29,60,60
1650778048508,COGS 101A,A01,083621,Davis; Joshua Daniel,0,28,60,60
1650778054532,COGS 101B,A01,091572,Staff,0,3,60,60
1650778060557,COGS 101C,A01,083625,Delgado; Tania,14,0,30,16
1650778066586,COGS 107A,A01,083627,Boyle; Mary E. T.,0,16,60,60
1650778072616,COGS 118A,A01,083075,Staff,0,8,60,60
1650778078645,CSE 3,A50,083646,Miranda; Gregory Joseph,18,0,38,20
1650778078645,CSE 3,A51,083647,Miranda; Gregory Joseph,36,0,37,1
1650778084682,CSE 8A,A50,083650,Miranda; Gregory Joseph,0,29,40,40
1650778090705,CSE 11,A01,083080,Cao; Yingjun,0,96,40,40
1650778096731,CSE 12,A01,083652,Staff,0,21,100,100
1650778102759,CSE 15L,A01,083654,Staff,0,3,50,50
1650778102759,CSE 15L,A02,083655,Staff,0,2,50,50
1650778108786,CSE 20,A01,083657,Staff,49,0,80,31
1650778114898,CSE 30,A01,083084,Eldon; John,0,75,40,40
1650778120927,CSE 100,A01,083659,Cao; Yingjun,0,71,50,50
1650778126960,CSE 134B,A01,083661,Powell; Thomas Allan,0,38,65,65
1650778132984,CSE 140,A01,083663,Staff,0,11,75,75
1650778139013,CSE 140L,A01,083088,Eldon; John,0,20,75,75
1650778145047,CSE 175,A01,083665,Kumar; Rakesh,7,0,25,18
1650778151071,CSE 190,A00,092507,Dubnov; Shlomo,10,0,20,10
1650778157097,ECE 45,A01,083139,Staff,0,1,60,60
1650778163120,ECE 65,A50,083695,Staff,0,5,30,30
1650778169142,ECE 109,A01,091882,Touri; Behrouz,32,0,70,38
1650778175179,ECE 180,A00,083140,Abi Samra; Nicholas Camill,20,0,30,10
1650778175179,ECE 180,B00,083141,Abi Samra; Nicholas Camill,0,0,30,30
1650778181212,MATH 10A,A01,083735,Patchell; Gregory David,2,0,30,28
1650778181212,MATH 10A,A02,083736,Patchell; Gregory David,27,0,30,3
1650778181212,MATH 10A,A03,083737,Patchell; Gregory David,24,0,30,6
1650778187237,MATH 10B,A01,083207,Staff,0,9,30,30
1650778187237,MATH 10B,A02,083208,Staff,0,6,30,30
1650778187237,MATH 10B,B01,083739,Staff,11,0,30,19
1650778187237,MATH 10B,B02,083740,Staff,28,0,30,2
1650778193266,MATH 18,A01,083743,Staff,0,0,30,30
1650778193266,MATH 18,A02,083744,Staff,23,0,30,7
1650778193266,MATH 18,A03,083745,Staff,21,0,30,9
1650778193266,MATH 18,A04,083746,Staff,26,0,30,4
1650778193266,MATH 18,B01,083748,Staff,0,15,30,30
1650778193266,MATH 18,B02,083749,Staff,0,12,30,30
1650778193266,MATH 18,B03,083750,Staff,0,12,30,30
1650778193266,MATH 18,B04,083751,Staff,0,12,30,30
1650778199291,MATH 20A,A01,083754,Staff,19,0,40,21
1650778205337,MATH 20B,A01,083756,Staff,0,13,30,30
1650778205337,MATH 20B,A02,083757,Staff,0,12,30,30
1650778211374,MATH 20C,A01,083760,Staff,0,16,30,30
1650778211374,MATH 20C,A02,083761,Staff,0,16,30,30
1650778211374,MATH 20C,B01,083762,Staff,9,0,30,21
1650778211374,MATH 20C,B02,083763,Staff,28,0,30,2
1650778217399,MATH 20D,A01,083765,Staff,2,1,30,28
1650778217399,MATH 20D,A02,083766,Staff,6,0,30,24
1650778217399,MATH 20D,A03,083767,Staff,24,0,30,6
1650778223425,MATH 20E,A01,083771,Staff,2,0,30,28
1650778223425,MATH 20E,A02,083772,Staff,15,0,30,15
1650778223425,MATH 20E,B01,083773,Staff,0,0,30,30
1650778223425,MATH 20E,B02,083774,Staff,5,0,30,25
1650778229450,MATH 103A,A01,083777,Staff,0,16,30,30
1650778229450,MATH 103A,A02,083778,Staff,0,15,30,30
1650778229450,MATH 103A,B01,083779,Staff,0,15,30,30
1650778229450,MATH 103A,B02,083780,Staff,0,15,30,30
1650778235472,MATH 105,A01,085443,Staff,0,22,30,30
1650778241500,MATH 109,A01,083213,Anzaldo; Leesa B,0,7,30,30
1650778241500,MATH 109,A02,083214,Anzaldo; Leesa B,0,7,30,30
1650778241500,MATH 109,B01,083215,Anzaldo; Leesa B,0,8,30,30
1650778241500,MATH 109,B02,083216,Anzaldo; Leesa B,0,7,30,30
1650778247527,MATH 142A,A01,083219,Chow; Bennett,0,16,30,30
1650778247527,MATH 142A,A02,083220,Chow; Bennett,0,15,30,30
1650778247527,MATH 142A,B01,083221,Chow; Bennett,0,15,30,30
1650778247527,MATH 142A,B02,083222,Chow; Bennett,0,14,30,30
1650778253552,MATH 193A,A01,083224,Staff,0,6,30,30
1650778253552,MATH 193A,A02,083225,Staff,0,6,30,30
1650778253552,MATH 193A,A03,083781,Staff,0,6,30,30
1650778253552,MATH 193A,A04,083782,Staff,0,7,30,30
1650778259578,MATH 197,001,091859,McAuley; Julian John,9998,0,9999,1
1650778265637,COGS 9,A01,083615,Staff,0,17,60,60
1650778271664,COGS 11,A01,083617,Boyle; Mary E. T.,16,0,40,24
1650778277691,COGS 13,A01,083071,Staff,0,38,40,40
1650778283715,COGS 14A,A01,092681,Staff,0,36,100,100
1650778289740,COGS 14B,A01,083073,Cheng; Tzu-Han,0,12,50,50
1650778295763,COGS 17,A01,092677,Staff,11,0,75,64
1650778301794,COGS 100,A01,083619,Staff,0,29,60,60
1650778307819,COGS 101A,A01,083621,Davis; Joshua Daniel,0,28,60,60
1650778313843,COGS 101B,A01,091572,Staff,0,3,60,60
1650778319868,COGS 101C,A01,083625,Delgado; Tania,14,0,30,16
1650778325892,COGS 107A,A01,083627,Boyle; Mary E. T.,0,16,60,60
1650778331916,COGS 118A,A01,083075,Staff,0,8,60,60
1650778337951,CSE 3,A50,083646,Miranda; Gregory Joseph,18,0,38,20
1650778337951,CSE 3,A51,083647,Miranda; Gregory Joseph,36,0,37,1
1650778343982,CSE 8A,A50,083650,Miranda; Gregory Joseph,0,29,40,40
1650778350014,CSE 11,A01,083080,Cao; Yingjun,0,96,40,40
1650778356037,CSE 12,A01,083652,Staff,0,21,100,100
1650778362064,CSE 15L,A01,083654,Staff,0,3,50,50
1650778362064,CSE 15L,A02,083655,Staff,0,2,50,50
1650778368088,CSE 20,A01,083657,Staff,49,0,80,31
1650778374122,CSE 30,A01,083084,Eldon; John,0,75,40,40
1650778380148,CSE 100,A01,083659,Cao; Yingjun,0,71,50,50
1650778386173,CSE 134B,A01,083661,Powell; Thomas Allan,0,38,65,65
1650778392210,CSE 140,A01,083663,Staff,0,11,75,75
1650778398235,CSE 140L,A01,083088,Eldon; John,0,20,75,75
1650778404261,CSE 175,A01,083665,Kumar; Rakesh,7,0,25,18
1650778410291,CSE 190,A00,092507,Dubnov; Shlomo,10,0,20,10
1650778416315,ECE 45,A01,083139,Staff,0,1,60,60
1650778422338,ECE 65,A50,083695,Staff,0,5,30,30
1650778428362,ECE 109,A01,091882,Touri; Behrouz,32,0,70,38
1650778434390,ECE 180,A00,083140,Abi Samra; Nicholas Camill,20,0,30,10
1650778434390,ECE 180,B00,083141,Abi Samra; Nicholas Camill,0,0,30,30
1650778440415,MATH 10A,A01,083735,Patchell; Gregory David,2,0,30,28
1650778440415,MATH 10A,A02,083736,Patchell; Gregory David,27,0,30,3
1650778440415,MATH 10A,A03,083737,Patchell; Gregory David,24,0,30,6
1650778446439,MATH 10B,A01,083207,Staff,0,9,30,30
1650778446439,MATH 10B,A02,083208,Staff,0,6,30,30
1650778446439,MATH 10B,B01,083739,Staff,11,0,30,19
1650778446439,MATH 10B,B02,083740,Staff,28,0,30,2
1650778452480,MATH 18,A01,083743,Staff,0,0,30,30
1650778452480,MATH 18,A02,083744,Staff,23,0,30,7
1650778452480,MATH 18,A03,083745,Staff,21,0,30,9
1650778452480,MATH 18,A04,083746,Staff,26,0,30,4
1650778452480,MATH 18,B01,083748,Staff,0,15,30,30
1650778452480,MATH 18,B02,083749,Staff,0,12,30,30
1650778452480,MATH 18,B03,083750,Staff,0,12,30,30
1650778452480,MATH 18,B04,083751,Staff,0,12,30,30
1650778458511,MATH 20A,A01,083754,Staff,19,0,40,21
1650778464535,MATH 20B,A01,083756,Staff,0,13,30,30
1650778464535,MATH 20B,A02,083757,Staff,0,12,30,30
1650778470559,MATH 20C,A01,083760,Staff,0,16,30,30
1650778470559,MATH 20C,A02,083761,Staff,0,16,30,30
1650778470559,MATH 20C,B01,083762,Staff,9,0,30,21
1650778470559,MATH 20C,B02,083763,Staff,28,0,30,2
1650778476600,MATH 20D,A01,083765,Staff,2,1,30,28
1650778476600,MATH 20D,A02,083766,Staff,6,0,30,24
1650778476600,MATH 20D,A03,083767,Staff,24,0,30,6
1650778482627,MATH 20E,A01,083771,Staff,2,0,30,28
1650778482627,MATH 20E,A02,083772,Staff,15,0,30,15
1650778482627,MATH 20E,B01,083773,Staff,0,0,30,30
1650778482627,MATH 20E,B02,083774,Staff,5,0,30,25
1650778488655,MATH 103A,A01,083777,Staff,0,16,30,30
1650778488655,MATH 103A,A02,083778,Staff,0,15,30,30
1650778488655,MATH 103A,B01,083779,Staff,0,15,30,30
1650778488655,MATH 103A,B02,083780,Staff,0,15,30,30
1650778494677,MATH 105,A01,085443,Staff,0,22,30,30
1650778500705,MATH 109,A01,083213,Anzaldo; Leesa B,0,7,30,30
1650778500705,MATH 109,A02,083214,Anzaldo; Leesa B,0,7,30,30
1650778500705,MATH 109,B01,083215,Anzaldo; Leesa B,0,8,30,30
1650778500705,MATH 109,B02,083216,Anzaldo; Leesa B,0,7,30,30
1650778506735,MATH 142A,A01,083219,Chow; Bennett,0,16,30,30
1650778506735,MATH 142A,A02,083220,Chow; Bennett,0,15,30,30
1650778506735,MATH 142A,B01,083221,Chow; Bennett,0,15,30,30
1650778506735,MATH 142A,B02,083222,Chow; Bennett,0,14,30,30
1650778512759,MATH 193A,A01,083224,Staff,0,6,30,30
1650778512759,MATH 193A,A02,083225,Staff,0,6,30,30
1650778512759,MATH 193A,A03,083781,Staff,0,6,30,30
1650778512759,MATH 193A,A04,083782,Staff,0,7,30,30
1650778518785,MATH 197,001,091859,McAuley; Julian John,9998,0,9999,1
1650778524841,COGS 9,A01,083615,Staff,0,17,60,60
1650778530868,COGS 11,A01,083617,Boyle; Mary E. T.,16,0,40,24
1650778536891,COGS 13,A01,083071,Staff,0,38,40,40
1650778542916,COGS 14A,A01,092681,Staff,0,36,100,100
1650778548942,COGS 14B,A01,083073,Cheng; Tzu-Han,0,12,50,50
1650778554966,COGS 17,A01,092677,Staff,11,0,75,64
1650778560989,COGS 100,A01,083619,Staff,0,29,60,60
1650778567013,COGS 101A,A01,083621,Davis; Joshua Daniel,0,28,60,60
1650778573040,COGS 101B,A01,091572,Staff,0,3,60,60
1650778579067,COGS 101C,A01,083625,Delgado; Tania,14,0,30,16
1650778585098,COGS 107A,A01,083627,Boyle; Mary E. T.,0,16,60,60
1650778591120,COGS 118A,A01,083075,Staff,0,8,60,60
1650778597147,CSE 3,A50,083646,Miranda; Gregory Joseph,18,0,38,20
1650778597147,CSE 3,A51,083647,Miranda; Gregory Joseph,36,0,37,1
1650778603172,CSE 8A,A50,083650,Miranda; Gregory Joseph,0,29,40,40
1650778609198,CSE 11,A01,083080,Cao; Yingjun,0,96,40,40
1650778615221,CSE 12,A01,083652,Staff,0,21,100,100
1650778621247,CSE 15L,A01,083654,Staff,0,3,50,50
1650778621247,CSE 15L,A02,083655,Staff,0,2,50,50
1650778627271,CSE 20,A01,083657,Staff,49,0,80,31
1650778633296,CSE 30,A01,083084,Eldon; John,0,75,40,40
1650778639328,CSE 100,A01,083659,Cao; Yingjun,0,71,50,50
1650778645352,CSE 134B,A01,083661,Powell; Thomas Allan,0,38,65,65
1650778651386,CSE 140,A01,083663,Staff,0,11,75,75
1650778657410,CSE 140L,A01,083088,Eldon; John,0,20,75,75
1650778663432,CSE 175,A01,083665,Kumar; Rakesh,7,0,25,18
1650778669459,CSE 190,A00,092507,Dubnov; Shlomo,10,0,20,10
1650778675483,ECE 45,A01,083139,Staff,0,1,60,60
1650778681508,ECE 65,A50,083695,Staff,0,5,30,30
1650778687533,ECE 109,A01,091882,Touri; Behrouz,32,0,70,38
1650778693557,ECE 180,A00,083140,Abi Samra; Nicholas Camill,20,0,30,10
1650778693557,ECE 180,B00,083141,Abi Samra; Nicholas Camill,0,0,30,30
1650778699580,MATH 10A,A01,083735,Patchell; Gregory David,2,0,30,28
1650778699580,MATH 10A,A02,083736,Patchell; Gregory David,27,0,30,3
1650778699580,MATH 10A,A03,083737,Patchell; Gregory David,24,0,30,6
1650778705609,MATH 10B,A01,083207,Staff,0,9,30,30
1650778705609,MATH 10B,A02,083208,Staff,0,6,30,30
1650778705609,MATH 10B,B01,083739,Staff,11,0,30,19
1650778705609,MATH 10B,B02,083740,Staff,28,0,30,2
1650778711734,MATH 18,A01,083743,Staff,0,0,30,30
1650778711734,MATH 18,A02,083744,Staff,23,0,30,7
1650778711734,MATH 18,A03,083745,Staff,21,0,30,9
1650778711734,MATH 18,A04,083746,Staff,26,0,30,4
1650778711734,MATH 18,B01,083748,Staff,0,15,30,30
1650778711734,MATH 18,B02,083749,Staff,0,12,30,30
1650778711734,MATH 18,B03,083750,Staff,0,12,30,30
1650778711734,MATH 18,B04,083751,Staff,0,12,30,30
1650778717762,MATH 20A,A01,083754,Staff,19,0,40,21
1650778723795,MATH 20B,A01,083756,Staff,0,13,30,30
1650778723795,MATH 20B,A02,083757,Staff,0,12,30,30
1650778729827,MATH 20C,A01,083760,Staff,0,16,30,30
1650778729827,MATH 20C,A02,083761,Staff,0,16,30,30
1650778729827,MATH 20C,B01,083762,Staff,9,0,30,21
1650778729827,MATH 20C,B02,083763,Staff,28,0,30,2
1650778735851,MATH 20D,A01,083765,Staff,2,1,30,28
1650778735851,MATH 20D,A02,083766,Staff,6,0,30,24
1650778735851,MATH 20D,A03,083767,Staff,24,0,30,6
1650778741876,MATH 20E,A01,083771,Staff,2,0,30,28
1650778741876,MATH 20E,A02,083772,Staff,15,0,30,15
1650778741876,MATH 20E,B01,083773,Staff,0,0,30,30
1650778741876,MATH 20E,B02,083774,Staff,5,0,30,25
1650778747904,MATH 103A,A01,083777,Staff,0,16,30,30
1650778747904,MATH 103A,A02,083778,Staff,0,15,30,30
1650778747904,MATH 103A,B01,083779,Staff,0,15,30,30
1650778747904,MATH 103A,B02,083780,Staff,0,15,30,30
1650778753928,MATH 105,A01,085443,Staff,0,22,30,30
1650778759952,MATH 109,A01,083213,Anzaldo; Leesa B,0,7,30,30
1650778759952,MATH 109,A02,083214,Anzaldo; Leesa B,0,7,30,30
1650778759952,MATH 109,B01,083215,Anzaldo; Leesa B,0,8,30,30
1650778759952,MATH 109,B02,083216,Anzaldo; Leesa B,0,7,30,30
1650778765978,MATH 142A,A01,083219,Chow; Bennett,0,16,30,30
1650778765978,MATH 142A,A02,083220,Chow; Bennett,0,15,30,30
1650778765978,MATH 142A,B01,083221,Chow; Bennett,0,15,30,30
1650778765978,MATH 142A,B02,083222,Chow; Bennett,0,14,30,30
1650778772004,MATH 193A,A01,083224,Staff,0,6,30,30
1650778772004,MATH 193A,A02,083225,Staff,0,6,30,30
1650778772004,MATH 193A,A03,083781,Staff,0,6,30,30
1650778772004,MATH 193A,A04,083782,Staff,0,7,30,30
1650778778029,MATH 197,001,091859,McAuley; Julian John,9998,0,9999,1
1650778784079,COGS 9,A01,083615,Staff,0,17,60,60
1650778790105,COGS 11,A01,083617,Boyle; Mary E. T.,16,0,40,24
1650778796132,COGS 13,A01,083071,Staff,0,38,40,40
1650778802156,COGS 14A,A01,092681,Staff,0,36,100,100
1650778808180,COGS 14B,A01,083073,Cheng; Tzu-Han,0,12,50,50
1650778814204,COGS 17,A01,092677,Staff,11,0,75,64
1650778820232,COGS 100,A01,083619,Staff,0,29,60,60
1650778826260,COGS 101A,A01,083621,Davis; Joshua Daniel,0,28,60,60
1650778832288,COGS 101B,A01,091572,Staff,0,3,60,60
1650778838324,COGS 101C,A01,083625,Delgado; Tania,14,0,30,16
1650778844347,COGS 107A,A01,083627,Boyle; Mary E. T.,0,16,60,60
1650778850371,COGS 118A,A01,083075,Staff,0,8,60,60
1650778856395,CSE 3,A50,083646,Miranda; Gregory Joseph,18,0,38,20
1650778856395,CSE 3,A51,083647,Miranda; Gregory Joseph,36,0,37,1
1650778862422,CSE 8A,A50,083650,Miranda; Gregory Joseph,0,29,40,40
1650778868449,CSE 11,A01,083080,Cao; Yingjun,0,96,40,40
1650778874480,CSE 12,A01,083652,Staff,0,21,100,100
1650778880507,CSE 15L,A01,083654,Staff,0,3,50,50
1650778880507,CSE 15L,A02,083655,Staff,0,2,50,50
1650778886534,CSE 20,A01,083657,Staff,49,0,80,31
1650778892561,CSE 30,A01,083084,Eldon; John,0,75,40,40
1650778898586,CSE 100,A01,083659,Cao; Yingjun,0,71,50,50
1650778904610,CSE 134B,A01,083661,Powell; Thomas Allan,0,38,65,65
1650778910635,CSE 140,A01,083663,Staff,0,11,75,75
1650778916662,CSE 140L,A01,083088,Eldon; John,0,20,75,75
1650778922686,CSE 175,A01,083665,Kumar; Rakesh,7,0,25,18
1650778928710,CSE 190,A00,092507,Dubnov; Shlomo,10,0,20,10
1650778934739,ECE 45,A01,083139,Staff,0,1,60,60
1650778940764,ECE 65,A50,083695,Staff,0,5,30,30
1650778946795,ECE 109,A01,091882,Touri; Behrouz,32,0,70,38
1650778952822,ECE 180,A00,083140,Abi Samra; Nicholas Camill,20,0,30,10
1650778952822,ECE 180,B00,083141,Abi Samra; Nicholas Camill,0,0,30,30
1650778958850,MATH 10A,A01,083735,Patchell; Gregory David,2,0,30,28
1650778958850,MATH 10A,A02,083736,Patchell; Gregory David,27,0,30,3
1650778958850,MATH 10A,A03,083737,Patchell; Gregory David,24,0,30,6
1650778964875,MATH 10B,A01,083207,Staff,0,9,30,30
1650778964875,MATH 10B,A02,083208,Staff,0,6,30,30
1650778964875,MATH 10B,B01,083739,Staff,10,0,30,20
1650778964875,MATH 10B,B02,083740,Staff,28,0,30,2
1650778970901,MATH 18,A01,083743,Staff,0,0,30,30
1650778970901,MATH 18,A02,083744,Staff,23,0,30,7
1650778970901,MATH 18,A03,083745,Staff,21,0,30,9
1650778970901,MATH 18,A04,083746,Staff,26,0,30,4
1650778970901,MATH 18,B01,083748,Staff,0,15,30,30
1650778970901,MATH 18,B02,083749,Staff,0,12,30,30
1650778970901,MATH 18,B03,083750,Staff,0,12,30,30
1650778970901,MATH 18,B04,083751,Staff,0,12,30,30
1650778976925,MATH 20A,A01,083754,Staff,19,0,40,21
1650778982954,MATH 20B,A01,083756,Staff,0,13,30,30
1650778982954,MATH 20B,A02,083757,Staff,0,12,30,30
1650778988981,MATH 20C,A01,083760,Staff,0,16,30,30
1650778988981,MATH 20C,A02,083761,Staff,0,16,30,30
1650778988981,MATH 20C,B01,083762,Staff,9,0,30,21
1650778988981,MATH 20C,B02,083763,Staff,28,0,30,2
1650778995014,MATH 20D,A01,083765,Staff,2,1,30,28
1650778995014,MATH 20D,A02,083766,Staff,6,0,30,24
1650778995014,MATH 20D,A03,083767,Staff,24,0,30,6
1650779001056,MATH 20E,A01,083771,Staff,2,0,30,28
1650779001056,MATH 20E,A02,083772,Staff,15,0,30,15
1650779001056,MATH 20E,B01,083773,Staff,0,0,30,30
1650779001056,MATH 20E,B02,083774,Staff,5,0,30,25
1650779007089,MATH 103A,A01,083777,Staff,0,16,30,30
1650779007089,MATH 103A,A02,083778,Staff,0,15,30,30
1650779007089,MATH 103A,B01,083779,Staff,0,15,30,30
1650779007089,MATH 103A,B02,083780,Staff,0,15,30,30
1650779013112,MATH 105,A01,085443,Staff,0,22,30,30
1650779019137,MATH 109,A01,083213,Anzaldo; Leesa B,0,7,30,30
1650779019137,MATH 109,A02,083214,Anzaldo; Leesa B,0,7,30,30
1650779019137,MATH 109,B01,083215,Anzaldo; Leesa B,0,8,30,30
1650779019137,MATH 109,B02,083216,Anzaldo; Leesa B,0,7,30,30
1650779025161,MATH 142A,A01,083219,Chow; Bennett,0,16,30,30
1650779025161,MATH 142A,A02,083220,Chow; Bennett,0,15,30,30
1650779025161,MATH 142A,B01,083221,Chow; Bennett,0,15,30,30
1650779025161,MATH 142A,B02,083222,Chow; Bennett,0,14,30,30
1650779031196,MATH 193A,A01,083224,Staff,0,6,30,30
1650779031196,MATH 193A,A02,083225,Staff,0,6,30,30
1650779031196,MATH 193A,A03,083781,Staff,0,6,30,30
1650779031196,MATH 193A,A04,083782,Staff,0,7,30,30
1650779037222,MATH 197,001,091859,McAuley; Julian John,9998,0,9999,1
1650779043293,COGS 9,A01,083615,Staff,0,17,60,60
1650779049321,COGS 11,A01,083617,Boyle; Mary E. T.,16,0,40,24
1650779055349,COGS 13,A01,083071,Staff,0,38,40,40
1650779061376,COGS 14A,A01,092681,Staff,0,36,100,100
1650779067400,COGS 14B,A01,083073,Cheng; Tzu-Han,0,12,50,50
1650779073425,COGS 17,A01,092677,Staff,11,0,75,64
1650779079449,COGS 100,A01,083619,Staff,0,29,60,60
1650779085470,COGS 101A,A01,083621,Davis; Joshua Daniel,0,28,60,60
1650779091499,COGS 101B,A01,091572,Staff,0,3,60,60
1650779097523,COGS 101C,A01,083625,Delgado; Tania,14,0,30,16
1650779103577,COGS 107A,A01,083627,Boyle; Mary E. T.,0,16,60,60
1650779109606,COGS 118A,A01,083075,Staff,0,8,60,60
1650779115639,CSE 3,A50,083646,Miranda; Gregory Joseph,18,0,38,20
1650779115639,CSE 3,A51,083647,Miranda; Gregory Joseph,36,0,37,1
1650779121666,CSE 8A,A50,083650,Miranda; Gregory Joseph,0,29,40,40
1650779127690,CSE 11,A01,083080,Cao; Yingjun,0,96,40,40
1650779133714,CSE 12,A01,083652,Staff,0,21,100,100
1650779139736,CSE 15L,A01,083654,Staff,0,3,50,50
1650779139736,CSE 15L,A02,083655,Staff,0,2,50,50
1650779145760,CSE 20,A01,083657,Staff,49,0,80,31
1650779151783,CSE 30,A01,083084,Eldon; John,0,75,40,40
1650779157807,CSE 100,A01,083659,Cao; Yingjun,0,71,50,50
1650779163833,CSE 134B,A01,083661,Powell; Thomas Allan,0,38,65,65
1650779169856,CSE 140,A01,083663,Staff,0,11,75,75
1650779175880,CSE 140L,A01,083088,Eldon; John,0,20,75,75
1650779181904,CSE 175,A01,083665,Kumar; Rakesh,7,0,25,18
1650779187927,CSE 190,A00,092507,Dubnov; Shlomo,10,0,20,10
1650779193949,ECE 45,A01,083139,Staff,0,1,60,60
1650779199972,ECE 65,A50,083695,Staff,0,5,30,30
1650779205999,ECE 109,A01,091882,Touri; Behrouz,32,0,70,38
1650779212022,ECE 180,A00,083140,Abi Samra; Nicholas Camill,20,0,30,10
1650779212022,ECE 180,B00,083141,Abi Samra; Nicholas Camill,0,0,30,30
1650779218052,MATH 10A,A01,083735,Patchell; Gregory David,2,0,30,28
1650779218052,MATH 10A,A02,083736,Patchell; Gregory David,27,0,30,3
1650779218052,MATH 10A,A03,083737,Patchell; Gregory David,24,0,30,6
1650779224074,MATH 10B,A01,083207,Staff,0,9,30,30
1650779224074,MATH 10B,A02,083208,Staff,0,6,30,30
1650779224074,MATH 10B,B01,083739,Staff,10,0,30,20
1650779224074,MATH 10B,B02,083740,Staff,28,0,30,2
1650779230108,MATH 18,A01,083743,Staff,0,0,30,30
1650779230108,MATH 18,A02,083744,Staff,23,0,30,7
1650779230108,MATH 18,A03,083745,Staff,21,0,30,9
1650779230108,MATH 18,A04,083746,Staff,26,0,30,4
1650779230108,MATH 18,B01,083748,Staff,0,15,30,30
1650779230108,MATH 18,B02,083749,Staff,0,12,30,30
1650779230108,MATH 18,B03,083750,Staff,0,12,30,30
1650779230108,MATH 18,B04,083751,Staff,0,12,30,30
1650779236133,MATH 20A,A01,083754,Staff,19,0,40,21
1650779242158,MATH 20B,A01,083756,Staff,0,13,30,30
1650779242158,MATH 20B,A02,083757,Staff,0,12,30,30
1650779248186,MATH 20C,A01,083760,Staff,0,16,30,30
1650779248186,MATH 20C,A02,083761,Staff,0,16,30,30
1650779248186,MATH 20C,B01,083762,Staff,9,0,30,21
1650779248186,MATH 20C,B02,083763,Staff,28,0,30,2
1650779254218,MATH 20D,A01,083765,Staff,2,1,30,28
1650779254218,MATH 20D,A02,083766,Staff,6,0,30,24
1650779254218,MATH 20D,A03,083767,Staff,24,0,30,6
1650779260241,MATH 20E,A01,083771,Staff,2,0,30,28
1650779260241,MATH 20E,A02,083772,Staff,15,0,30,15
1650779260241,MATH 20E,B01,083773,Staff,0,0,30,30
1650779260241,MATH 20E,B02,083774,Staff,5,0,30,25
1650779266274,MATH 103A,A01,083777,Staff,0,16,30,30
1650779266274,MATH 103A,A02,083778,Staff,0,15,30,30
1650779266274,MATH 103A,B01,083779,Staff,0,15,30,30
1650779266274,MATH 103A,B02,083780,Staff,0,15,30,30
1650779272296,MATH 105,A01,085443,Staff,0,22,30,30
1650779278321,MATH 109,A01,083213,Anzaldo; Leesa B,0,7,30,30
1650779278321,MATH 109,A02,083214,Anzaldo; Leesa B,0,7,30,30
1650779278321,MATH 109,B01,083215,Anzaldo; Leesa B,0,8,30,30
1650779278321,MATH 109,B02,083216,Anzaldo; Leesa B,0,7,30,30
1650779284346,MATH 142A,A01,083219,Chow; Bennett,0,16,30,30
1650779284346,MATH 142A,A02,083220,Chow; Bennett,0,15,30,30
1650779284346,MATH 142A,B01,083221,Chow; Bennett,0,15,30,30
1650779284346,MATH 142A,B02,083222,Chow; Bennett,0,14,30,30
1650779290370,MATH 193A,A01,083224,Staff,0,6,30,30
1650779290370,MATH 193A,A02,083225,Staff,0,6,30,30
1650779290370,MATH 193A,A03,083781,Staff,0,6,30,30
1650779290370,MATH 193A,A04,083782,Staff,0,7,30,30
1650779296397,MATH 197,001,091859,McAuley; Julian John,9998,0,9999,1
1650779302553,COGS 9,A01,083615,Staff,0,17,60,60
1650779308577,COGS 11,A01,083617,Boyle; Mary E. T.,16,0,40,24
1650779314604,COGS 13,A01,083071,Staff,0,38,40,40
1650779320628,COGS 14A,A01,092681,Staff,0,36,100,100
1650779326652,COGS 14B,A01,083073,Cheng; Tzu-Han,0,12,50,50
1650779332674,COGS 17,A01,092677,Staff,11,0,75,64
1650779338698,COGS 100,A01,083619,Staff,0,29,60,60
1650779344727,COGS 101A,A01,083621,Davis; Joshua Daniel,0,28,60,60
1650779350752,COGS 101B,A01,091572,Staff,0,3,60,60
1650779356780,COGS 101C,A01,083625,Delgado; Tania,14,0,30,16
1650779362806,COGS 107A,A01,083627,Boyle; Mary E. T.,0,16,60,60
1650779368829,COGS 118A,A01,083075,Staff,0,8,60,60
1650779374854,CSE 3,A50,083646,Miranda; Gregory Joseph,18,0,38,20
1650779374854,CSE 3,A51,083647,Miranda; Gregory Joseph,36,0,37,1
1650779380878,CSE 8A,A50,083650,Miranda; Gregory Joseph,0,29,40,40
1650779386904,CSE 11,A01,083080,Cao; Yingjun,0,96,40,40
1650779392927,CSE 12,A01,083652,Staff,0,21,100,100
1650779398956,CSE 15L,A01,083654,Staff,0,3,50,50
1650779398956,CSE 15L,A02,083655,Staff,0,2,50,50
1650779404979,CSE 20,A01,083657,Staff,49,0,80,31
1650779411004,CSE 30,A01,083084,Eldon; John,0,75,40,40
1650779417030,CSE 100,A01,083659,Cao; Yingjun,0,71,50,50
1650779423055,CSE 134B,A01,083661,Powell; Thomas Allan,0,38,65,65
1650779429079,CSE 140,A01,083663,Staff,0,11,75,75
1650779435106,CSE 140L,A01,083088,Eldon; John,0,20,75,75
1650779441133,CSE 175,A01,083665,Kumar; Rakesh,7,0,25,18
1650779447157,CSE 190,A00,092507,Dubnov; Shlomo,10,0,20,10
1650779453181,ECE 45,A01,083139,Staff,0,1,60,60
1650779459208,ECE 65,A50,083695,Staff,0,5,30,30
1650779465234,ECE 109,A01,091882,Touri; Behrouz,32,0,70,38
1650779471261,ECE 180,A00,083140,Abi Samra; Nicholas Camill,20,0,30,10
1650779471261,ECE 180,B00,083141,Abi Samra; Nicholas Camill,0,0,30,30
1650779477289,MATH 10A,A01,083735,Patchell; Gregory David,2,0,30,28
1650779477289,MATH 10A,A02,083736,Patchell; Gregory David,27,0,30,3
1650779477289,MATH 10A,A03,083737,Patchell; Gregory David,24,0,30,6
1650779483313,MATH 10B,A01,083207,Staff,0,9,30,30
1650779483313,MATH 10B,A02,083208,Staff,0,6,30,30
1650779483313,MATH 10B,B01,083739,Staff,10,0,30,20
1650779483313,MATH 10B,B02,083740,Staff,28,0,30,2
1650779489344,MATH 18,A01,083743,Staff,0,0,30,30
1650779489344,MATH 18,A02,083744,Staff,23,0,30,7
1650779489344,MATH 18,A03,083745,Staff,21,0,30,9
1650779489344,MATH 18,A04,083746,Staff,26,0,30,4
1650779489344,MATH 18,B01,083748,Staff,0,15,30,30
1650779489344,MATH 18,B02,083749,Staff,0,12,30,30
1650779489344,MATH 18,B03,083750,Staff,0,12,30,30
1650779489344,MATH 18,B04,083751,Staff,0,12,30,30
1650779495368,MATH 20A,A01,083754,Staff,19,0,40,21
1650779501395,MATH 20B,A01,083756,Staff,0,13,30,30
1650779501395,MATH 20B,A02,083757,Staff,0,12,30,30
1650779507420,MATH 20C,A01,083760,Staff,0,16,30,30
1650779507420,MATH 20C,A02,083761,Staff,0,16,30,30
1650779507420,MATH 20C,B01,083762,Staff,9,0,30,21
1650779507420,MATH 20C,B02,083763,Staff,28,0,30,2
1650779513448,MATH 20D,A01,083765,Staff,2,1,30,28
1650779513448,MATH 20D,A02,083766,Staff,6,0,30,24
1650779513448,MATH 20D,A03,083767,Staff,24,0,30,6
1650779519471,MATH 20E,A01,083771,Staff,2,0,30,28
1650779519471,MATH 20E,A02,083772,Staff,15,0,30,15
1650779519471,MATH 20E,B01,083773,Staff,0,0,30,30
1650779519471,MATH 20E,B02,083774,Staff,5,0,30,25
1650779525505,MATH 103A,A01,083777,Staff,0,16,30,30
1650779525505,MATH 103A,A02,083778,Staff,0,15,30,30
1650779525505,MATH 103A,B01,083779,Staff,0,15,30,30
1650779525505,MATH 103A,B02,083780,Staff,0,15,30,30
1650779531531,MATH 105,A01,085443,Staff,0,22,30,30
1650779537558,MATH 109,A01,083213,Anzaldo; Leesa B,0,7,30,30
1650779537558,MATH 109,A02,083214,Anzaldo; Leesa B,0,7,30,30
1650779537558,MATH 109,B01,083215,Anzaldo; Leesa B,0,8,30,30
1650779537558,MATH 109,B02,083216,Anzaldo; Leesa B,0,7,30,30
1650779543588,MATH 142A,A01,083219,Chow; Bennett,0,16,30,30
1650779543588,MATH 142A,A02,083220,Chow; Bennett,0,15,30,30
1650779543588,MATH 142A,B01,083221,Chow; Bennett,0,15,30,30
1650779543588,MATH 142A,B02,083222,Chow; Bennett,0,14,30,30
1650779549611,MATH 193A,A01,083224,Staff,0,6,30,30
1650779549611,MATH 193A,A02,083225,Staff,0,6,30,30
1650779549611,MATH 193A,A03,083781,Staff,0,6,30,30
1650779549611,MATH 193A,A04,083782,Staff,0,7,30,30
1650779555633,MATH 197,001,091859,McAuley; Julian John,9998,0,9999,1
1650779561698,COGS 9,A01,083615,Staff,0,17,60,60
1650779567724,COGS 11,A01,083617,Boyle; Mary E. T.,16,0,40,24
1650779573748,COGS 13,A01,083071,Staff,0,38,40,40
1650779579771,COGS 14A,A01,092681,Staff,0,36,100,100
1650779585796,COGS 14B,A01,083073,Cheng; Tzu-Han,0,12,50,50
1650779591826,COGS 17,A01,092677,Staff,11,0,75,64
1650779597858,COGS 100,A01,083619,Staff,0,29,60,60
1650779603881,COGS 101A,A01,083621,Davis; Joshua Daniel,0,28,60,60
1650779609911,COGS 101B,A01,091572,Staff,0,3,60,60
1650779615940,COGS 101C,A01,083625,Delgado; Tania,14,0,30,16
1650779621963,COGS 107A,A01,083627,Boyle; Mary E. T.,0,16,60,60
1650779627997,COGS 118A,A01,083075,Staff,0,8,60,60
1650779634024,CSE 3,A50,083646,Miranda; Gregory Joseph,18,0,38,20
1650779634024,CSE 3,A51,083647,Miranda; Gregory Joseph,36,0,37,1
1650779640053,CSE 8A,A50,083650,Miranda; Gregory Joseph,0,29,40,40
1650779646077,CSE 11,A01,083080,Cao; Yingjun,0,96,40,40
1650779652110,CSE 12,A01,083652,Staff,0,21,100,100
1650779658136,CSE 15L,A01,083654,Staff,0,3,50,50
1650779658136,CSE 15L,A02,083655,Staff,0,2,50,50
1650779664178,CSE 20,A01,083657,Staff,49,0,80,31
1650779670203,CSE 30,A01,083084,Eldon; John,0,75,40,40
1650779676238,CSE 100,A01,083659,Cao; Yingjun,0,71,50,50
1650779682263,CSE 134B,A01,083661,Powell; Thomas Allan,0,38,65,65
1650779688287,CSE 140,A01,083663,Staff,0,11,75,75
1650779694313,CSE 140L,A01,083088,Eldon; John,0,20,75,75
1650779700340,CSE 175,A01,083665,Kumar; Rakesh,7,0,25,18
1650779706365,CSE 190,A00,092507,Dubnov; Shlomo,10,0,20,10
1650779712404,ECE 45,A01,083139,Staff,0,1,60,60
1650779718431,ECE 65,A50,083695,Staff,0,5,30,30
1650779724456,ECE 109,A01,091882,Touri; Behrouz,32,0,70,38
1650779730483,ECE 180,A00,083140,Abi Samra; Nicholas Camill,20,0,30,10
1650779730483,ECE 180,B00,083141,Abi Samra; Nicholas Camill,0,0,30,30
1650779736506,MATH 10A,A01,083735,Patchell; Gregory David,2,0,30,28
1650779736506,MATH 10A,A02,083736,Patchell; Gregory David,27,0,30,3
1650779736506,MATH 10A,A03,083737,Patchell; Gregory David,24,0,30,6
1650779742533,MATH 10B,A01,083207,Staff,0,9,30,30
1650779742533,MATH 10B,A02,083208,Staff,0,6,30,30
1650779742533,MATH 10B,B01,083739,Staff,10,0,30,20
1650779742533,MATH 10B,B02,083740,Staff,28,0,30,2
1650779748555,MATH 18,A01,083743,Staff,0,0,30,30
1650779748555,MATH 18,A02,083744,Staff,23,0,30,7
1650779748555,MATH 18,A03,083745,Staff,21,0,30,9
1650779748555,MATH 18,A04,083746,Staff,26,0,30,4
1650779748555,MATH 18,B01,083748,Staff,0,15,30,30
1650779748555,MATH 18,B02,083749,Staff,0,12,30,30
1650779748555,MATH 18,B03,083750,Staff,0,12,30,30
1650779748555,MATH 18,B04,083751,Staff,0,12,30,30
1650779754608,MATH 20A,A01,083754,Staff,19,0,40,21
1650779760634,MATH 20B,A01,083756,Staff,0,13,30,30
1650779760634,MATH 20B,A02,083757,Staff,0,12,30,30
1650779766659,MATH 20C,A01,083760,Staff,0,16,30,30
1650779766659,MATH 20C,A02,083761,Staff,0,16,30,30
1650779766659,MATH 20C,B01,083762,Staff,9,0,30,21
1650779766659,MATH 20C,B02,083763,Staff,28,0,30,2
1650779772689,MATH 20D,A01,083765,Staff,2,1,30,28
1650779772689,MATH 20D,A02,083766,Staff,6,0,30,24
1650779772689,MATH 20D,A03,083767,Staff,24,0,30,6
1650779778713,MATH 20E,A01,083771,Staff,2,0,30,28
1650779778713,MATH 20E,A02,083772,Staff,15,0,30,15
1650779778713,MATH 20E,B01,083773,Staff,0,0,30,30
1650779778713,MATH 20E,B02,083774,Staff,5,0,30,25
1650779784736,MATH 103A,A01,083777,Staff,0,16,30,30
1650779784736,MATH 103A,A02,083778,Staff,0,15,30,30
1650779784736,MATH 103A,B01,083779,Staff,0,15,30,30
1650779784736,MATH 103A,B02,083780,Staff,0,15,30,30
1650779790763,MATH 105,A01,085443,Staff,0,22,30,30
1650779796798,MATH 109,A01,083213,Anzaldo; Leesa B,0,7,30,30
1650779796798,MATH 109,A02,083214,Anzaldo; Leesa B,0,7,30,30
1650779796798,MATH 109,B01,083215,Anzaldo; Leesa B,0,8,30,30
1650779796798,MATH 109,B02,083216,Anzaldo; Leesa B,0,7,30,30
1650779802835,MATH 142A,A01,083219,Chow; Bennett,0,16,30,30
1650779802835,MATH 142A,A02,083220,Chow; Bennett,0,15,30,30
1650779802835,MATH 142A,B01,083221,Chow; Bennett,0,15,30,30
1650779802835,MATH 142A,B02,083222,Chow; Bennett,0,14,30,30
1650779808859,MATH 193A,A01,083224,Staff,0,6,30,30
1650779808859,MATH 193A,A02,083225,Staff,0,6,30,30
1650779808859,MATH 193A,A03,083781,Staff,0,6,30,30
1650779808859,MATH 193A,A04,083782,Staff,0,7,30,30
1650779814894,MATH 197,001,091859,McAuley; Julian John,9998,0,9999,1
1650779820965,COGS 9,A01,083615,Staff,0,17,60,60
1650779826992,COGS 11,A01,083617,Boyle; Mary E. T.,16,0,40,24
1650779833018,COGS 13,A01,083071,Staff,0,38,40,40
1650779839042,COGS 14A,A01,092681,Staff,0,36,100,100
1650779845066,COGS 14B,A01,083073,Cheng; Tzu-Han,0,12,50,50
1650779851092,COGS 17,A01,092677,Staff,11,0,75,64
1650779857116,COGS 100,A01,083619,Staff,0,29,60,60
1650779863143,COGS 101A,A01,083621,Davis; Joshua Daniel,0,28,60,60
1650779869168,COGS 101B,A01,091572,Staff,0,3,60,60
1650779875198,COGS 101C,A01,083625,Delgado; Tania,14,0,30,16
1650779881223,COGS 107A,A01,083627,Boyle; Mary E. T.,0,16,60,60
1650779887247,COGS 118A,A01,083075,Staff,0,8,60,60
1650779893276,CSE 3,A50,083646,Miranda; Gregory Joseph,18,0,38,20
1650779893276,CSE 3,A51,083647,Miranda; Gregory Joseph,36,0,37,1
1650779899371,CSE 8A,A50,083650,Miranda; Gregory Joseph,0,29,40,40
1650779905395,CSE 11,A01,083080,Cao; Yingjun,0,96,40,40
1650779911422,CSE 12,A01,083652,Staff,0,21,100,100
1650779917447,CSE 15L,A01,083654,Staff,0,3,50,50
1650779917447,CSE 15L,A02,083655,Staff,0,2,50,50
1650779923470,CSE 20,A01,083657,Staff,49,0,80,31
1650779929497,CSE 30,A01,083084,Eldon; John,0,75,40,40
1650779935521,CSE 100,A01,083659,Cao; Yingjun,0,71,50,50
1650779941549,CSE 134B,A01,083661,Powell; Thomas Allan,0,38,65,65
1650779947580,CSE 140,A01,083663,Staff,0,11,75,75
1650779953606,CSE 140L,A01,083088,Eldon; John,0,20,75,75
1650779959632,CSE 175,A01,083665,Kumar; Rakesh,7,0,25,18
1650779965663,CSE 190,A00,092507,Dubnov; Shlomo,10,0,20,10
1650779971695,ECE 45,A01,083139,Staff,0,1,60,60
1650779977733,ECE 65,A50,083695,Staff,0,5,30,30
1650779983770,ECE 109,A01,091882,Touri; Behrouz,32,0,70,38
1650779989797,ECE 180,A00,083140,Abi Samra; Nicholas Camill,20,0,30,10
1650779989797,ECE 180,B00,083141,Abi Samra; Nicholas Camill,0,0,30,30
1650779995821,MATH 10A,A01,083735,Patchell; Gregory David,2,0,30,28
1650779995821,MATH 10A,A02,083736,Patchell; Gregory David,27,0,30,3
1650779995821,MATH 10A,A03,083737,Patchell; Gregory David,24,0,30,6
1650780001851,MATH 10B,A01,083207,Staff,0,9,30,30
1650780001851,MATH 10B,A02,083208,Staff,0,6,30,30
1650780001851,MATH 10B,B01,083739,Staff,10,0,30,20
1650780001851,MATH 10B,B02,083740,Staff,28,0,30,2
1650780007887,MATH 18,A01,083743,Staff,0,0,30,30
1650780007887,MATH 18,A02,083744,Staff,23,0,30,7
1650780007887,MATH 18,A03,083745,Staff,21,0,30,9
1650780007887,MATH 18,A04,083746,Staff,26,0,30,4
1650780007887,MATH 18,B01,083748,Staff,0,15,30,30
1650780007887,MATH 18,B02,083749,Staff,0,12,30,30
1650780007887,MATH 18,B03,083750,Staff,0,12,30,30
1650780007887,MATH 18,B04,083751,Staff,0,12,30,30
1650780013911,MATH 20A,A01,083754,Staff,19,0,40,21
1650780019943,MATH 20B,A01,083756,Staff,0,13,30,30
1650780019943,MATH 20B,A02,083757,Staff,0,12,30,30
1650780025971,MATH 20C,A01,083760,Staff,0,16,30,30
1650780025971,MATH 20C,A02,083761,Staff,0,16,30,30
1650780025971,MATH 20C,B01,083762,Staff,9,0,30,21
1650780025971,MATH 20C,B02,083763,Staff,28,0,30,2
1650780032008,MATH 20D,A01,083765,Staff,2,1,30,28
1650780032008,MATH 20D,A02,083766,Staff,6,0,30,24
1650780032008,MATH 20D,A03,083767,Staff,24,0,30,6
1650780038046,MATH 20E,A01,083771,Staff,2,0,30,28
1650780038046,MATH 20E,A02,083772,Staff,15,0,30,15
1650780038046,MATH 20E,B01,083773,Staff,0,0,30,30
1650780038046,MATH 20E,B02,083774,Staff,5,0,30,25
1650780044077,MATH 103A,A01,083777,Staff,0,16,30,30
1650780044077,MATH 103A,A02,083778,Staff,0,15,30,30
1650780044077,MATH 103A,B01,083779,Staff,0,15,30,30
1650780044077,MATH 103A,B02,083780,Staff,0,15,30,30
1650780050105,MATH 105,A01,085443,Staff,0,22,30,30
1650780056132,MATH 109,A01,083213,Anzaldo; Leesa B,0,7,30,30
1650780056132,MATH 109,A02,083214,Anzaldo; Leesa B,0,7,30,30
1650780056132,MATH 109,B01,083215,Anzaldo; Leesa B,0,8,30,30
1650780056132,MATH 109,B02,083216,Anzaldo; Leesa B,0,7,30,30
1650780062159,MATH 142A,A01,083219,Chow; Bennett,0,16,30,30
1650780062159,MATH 142A,A02,083220,Chow; Bennett,0,15,30,30
1650780062159,MATH 142A,B01,083221,Chow; Bennett,0,15,30,30
1650780062159,MATH 142A,B02,083222,Chow; Bennett,0,14,30,30
1650780068186,MATH 193A,A01,083224,Staff,0,6,30,30
1650780068186,MATH 193A,A02,083225,Staff,0,6,30,30
1650780068186,MATH 193A,A03,083781,Staff,0,6,30,30
1650780068186,MATH 193A,A04,083782,Staff,0,7,30,30
1650780074221,MATH 197,001,091859,McAuley; Julian John,9998,0,9999,1
1650780080330,COGS 9,A01,083615,Staff,0,17,60,60
1650780086354,COGS 11,A01,083617,Boyle; Mary E. T.,16,0,40,24
1650780092378,COGS 13,A01,083071,Staff,0,38,40,40
1650780098405,COGS 14A,A01,092681,Staff,0,36,100,100
1650780104437,COGS 14B,A01,083073,Cheng; Tzu-Han,0,12,50,50
1650780110462,COGS 17,A01,092677,Staff,11,0,75,64
1650780116488,COGS 100,A01,083619,Staff,0,29,60,60
1650780122516,COGS 101A,A01,083621,Davis; Joshua Daniel,0,28,60,60
1650780128542,COGS 101B,A01,091572,Staff,0,3,60,60
1650780134564,COGS 101C,A01,083625,Delgado; Tania,14,0,30,16
1650780140586,COGS 107A,A01,083627,Boyle; Mary E. T.,0,16,60,60
1650780146616,COGS 118A,A01,083075,Staff,0,8,60,60
1650780152642,CSE 3,A50,083646,Miranda; Gregory Joseph,18,0,38,20
1650780152642,CSE 3,A51,083647,Miranda; Gregory Joseph,36,0,37,1
1650780158672,CSE 8A,A50,083650,Miranda; Gregory Joseph,0,29,40,40
1650780164701,CSE 11,A01,083080,Cao; Yingjun,0,96,40,40
1650780170726,CSE 12,A01,083652,Staff,0,21,100,100
1650780176749,CSE 15L,A01,083654,Staff,0,3,50,50
1650780176749,CSE 15L,A02,083655,Staff,0,2,50,50
1650780182785,CSE 20,A01,083657,Staff,49,0,80,31
1650780188811,CSE 30,A01,083084,Eldon; John,0,75,40,40
1650780194836,CSE 100,A01,083659,Cao; Yingjun,0,71,50,50
1650780200868,CSE 134B,A01,083661,Powell; Thomas Allan,0,38,65,65
1650780206891,CSE 140,A01,083663,Staff,0,11,75,75
1650780212920,CSE 140L,A01,083088,Eldon; John,0,20,75,75
1650780218948,CSE 175,A01,083665,Kumar; Rakesh,7,0,25,18
1650780224981,CSE 190,A00,092507,Dubnov; Shlomo,10,0,20,10
1650780231007,ECE 45,A01,083139,Staff,0,1,60,60
1650780237037,ECE 65,A50,083695,Staff,0,5,30,30
1650780243062,ECE 109,A01,091882,Touri; Behrouz,32,0,70,38
1650780249086,ECE 180,A00,083140,Abi Samra; Nicholas Camill,20,0,30,10
1650780249086,ECE 180,B00,083141,Abi Samra; Nicholas Camill,0,0,30,30
1650780255111,MATH 10A,A01,083735,Patchell; Gregory David,2,0,30,28
1650780255111,MATH 10A,A02,083736,Patchell; Gregory David,27,0,30,3
1650780255111,MATH 10A,A03,083737,Patchell; Gregory David,24,0,30,6
1650780261141,MATH 10B,A01,083207,Staff,0,9,30,30
1650780261141,MATH 10B,A02,083208,Staff,0,6,30,30
1650780261141,MATH 10B,B01,083739,Staff,10,0,30,20
1650780261141,MATH 10B,B02,083740,Staff,28,0,30,2
1650780267171,MATH 18,A01,083743,Staff,0,0,30,30
1650780267171,MATH 18,A02,083744,Staff,23,0,30,7
1650780267171,MATH 18,A03,083745,Staff,21,0,30,9
1650780267171,MATH 18,A04,083746,Staff,26,0,30,4
1650780267171,MATH 18,B01,083748,Staff,0,15,30,30
1650780267171,MATH 18,B02,083749,Staff,0,12,30,30
1650780267171,MATH 18,B03,083750,Staff,0,12,30,30
1650780267171,MATH 18,B04,083751,Staff,0,12,30,30
1650780273198,MATH 20A,A01,083754,Staff,19,0,40,21
1650780279226,MATH 20B,A01,083756,Staff,0,13,30,30
1650780279226,MATH 20B,A02,083757,Staff,0,12,30,30
1650780285249,MATH 20C,A01,083760,Staff,0,16,30,30
1650780285249,MATH 20C,A02,083761,Staff,0,16,30,30
1650780285249,MATH 20C,B01,083762,Staff,9,0,30,21
1650780285249,MATH 20C,B02,083763,Staff,28,0,30,2
1650780291276,MATH 20D,A01,083765,Staff,2,1,30,28
1650780291276,MATH 20D,A02,083766,Staff,6,0,30,24
1650780291276,MATH 20D,A03,083767,Staff,24,0,30,6
1650780297316,MATH 20E,A01,083771,Staff,2,0,30,28
1650780297316,MATH 20E,A02,083772,Staff,15,0,30,15
1650780297316,MATH 20E,B01,083773,Staff,0,0,30,30
1650780297316,MATH 20E,B02,083774,Staff,5,0,30,25
1650780303347,MATH 103A,A01,083777,Staff,0,16,30,30
1650780303347,MATH 103A,A02,083778,Staff,0,15,30,30
1650780303347,MATH 103A,B01,083779,Staff,0,15,30,30
1650780303347,MATH 103A,B02,083780,Staff,0,15,30,30
1650780309372,MATH 105,A01,085443,Staff,0,22,30,30
1650780315397,MATH 109,A01,083213,Anzaldo; Leesa B,0,7,30,30
1650780315397,MATH 109,A02,083214,Anzaldo; Leesa B,0,7,30,30
1650780315397,MATH 109,B01,083215,Anzaldo; Leesa B,0,8,30,30
1650780315397,MATH 109,B02,083216,Anzaldo; Leesa B,0,7,30,30
1650780321438,MATH 142A,A01,083219,Chow; Bennett,0,16,30,30
1650780321438,MATH 142A,A02,083220,Chow; Bennett,0,15,30,30
1650780321438,MATH 142A,B01,083221,Chow; Bennett,0,15,30,30
1650780321438,MATH 142A,B02,083222,Chow; Bennett,0,14,30,30
1650780327460,MATH 193A,A01,083224,Staff,0,6,30,30
1650780327460,MATH 193A,A02,083225,Staff,0,6,30,30
1650780327460,MATH 193A,A03,083781,Staff,0,6,30,30
1650780327460,MATH 193A,A04,083782,Staff,0,7,30,30
1650780333482,MATH 197,001,091859,McAuley; Julian John,9998,0,9999,1
1650780339538,COGS 9,A01,083615,Staff,0,17,60,60
1650780345565,COGS 11,A01,083617,Boyle; Mary E. T.,16,0,40,24
1650780351587,COGS 13,A01,083071,Staff,0,38,40,40
1650780357610,COGS 14A,A01,092681,Staff,0,36,100,100
1650780363633,COGS 14B,A01,083073,Cheng; Tzu-Han,0,12,50,50
1650780369658,COGS 17,A01,092677,Staff,11,0,75,64
1650780375682,COGS 100,A01,083619,Staff,0,29,60,60
1650780381706,COGS 101A,A01,083621,Davis; Joshua Daniel,0,28,60,60
1650780387733,COGS 101B,A01,091572,Staff,0,3,60,60
1650780393756,COGS 101C,A01,083625,Delgado; Tania,14,0,30,16
1650780399782,COGS 107A,A01,083627,Boyle; Mary E. T.,0,16,60,60
1650780405806,COGS 118A,A01,083075,Staff,0,8,60,60
1650780411833,CSE 3,A50,083646,Miranda; Gregory Joseph,18,0,38,20
1650780411833,CSE 3,A51,083647,Miranda; Gregory Joseph,36,0,37,1
1650780417857,CSE 8A,A50,083650,Miranda; Gregory Joseph,0,29,40,40
1650780423881,CSE 11,A01,083080,Cao; Yingjun,0,96,40,40
1650780429908,CSE 12,A01,083652,Staff,0,21,100,100
1650780435936,CSE 15L,A01,083654,Staff,0,3,50,50
1650780435936,CSE 15L,A02,083655,Staff,0,2,50,50
1650780441974,CSE 20,A01,083657,Staff,49,0,80,31
1650780447997,CSE 30,A01,083084,Eldon; John,0,75,40,40
1650780454026,CSE 100,A01,083659,Cao; Yingjun,0,71,50,50
1650780460049,CSE 134B,A01,083661,Powell; Thomas Allan,0,38,65,65
1650780466080,CSE 140,A01,083663,Staff,0,11,75,75
1650780472107,CSE 140L,A01,083088,Eldon; John,0,20,75,75
1650780478143,CSE 175,A01,083665,Kumar; Rakesh,7,0,25,18
1650780484171,CSE 190,A00,092507,Dubnov; Shlomo,10,0,20,10
1650780490209,ECE 45,A01,083139,Staff,0,1,60,60
1650780496336,ECE 65,A50,083695,Staff,0,5,30,30
1650780502360,ECE 109,A01,091882,Touri; Behrouz,32,0,70,38
1650780508391,ECE 180,A00,083140,Abi Samra; Nicholas Camill,20,0,30,10
1650780508391,ECE 180,B00,083141,Abi Samra; Nicholas Camill,0,0,30,30
1650780514424,MATH 10A,A01,083735,Patchell; Gregory David,2,0,30,28
1650780514424,MATH 10A,A02,083736,Patchell; Gregory David,27,0,30,3
1650780514424,MATH 10A,A03,083737,Patchell; Gregory David,24,0,30,6
1650780520454,MATH 10B,A01,083207,Staff,0,9,30,30
1650780520454,MATH 10B,A02,083208,Staff,0,6,30,30
1650780520454,MATH 10B,B01,083739,Staff,10,0,30,20
1650780520454,MATH 10B,B02,083740,Staff,28,0,30,2
1650780526478,MATH 18,A01,083743,Staff,0,0,30,30
1650780526478,MATH 18,A02,083744,Staff,23,0,30,7
1650780526478,MATH 18,A03,083745,Staff,21,0,30,9
1650780526478,MATH 18,A04,083746,Staff,26,0,30,4
1650780526478,MATH 18,B01,083748,Staff,0,15,30,30
1650780526478,MATH 18,B02,083749,Staff,0,12,30,30
1650780526478,MATH 18,B03,083750,Staff,0,12,30,30
1650780526478,MATH 18,B04,083751,Staff,0,12,30,30
1650780532509,MATH 20A,A01,083754,Staff,19,0,40,21
1650780538533,MATH 20B,A01,083756,Staff,0,13,30,30
1650780538533,MATH 20B,A02,083757,Staff,0,12,30,30
1650780544560,MATH 20C,A01,083760,Staff,0,16,30,30
1650780544560,MATH 20C,A02,083761,Staff,0,17,30,30
1650780544560,MATH 20C,B01,083762,Staff,9,0,30,21
1650780544560,MATH 20C,B02,083763,Staff,28,0,30,2
1650780550583,MATH 20D,A01,083765,Staff,2,1,30,28
1650780550583,MATH 20D,A02,083766,Staff,6,0,30,24
1650780550583,MATH 20D,A03,083767,Staff,24,0,30,6
1650780556607,MATH 20E,A01,083771,Staff,2,0,30,28
1650780556607,MATH 20E,A02,083772,Staff,15,0,30,15
1650780556607,MATH 20E,B01,083773,Staff,0,0,30,30
1650780556607,MATH 20E,B02,083774,Staff,5,0,30,25
1650780562631,MATH 103A,A01,083777,Staff,0,16,30,30
1650780562631,MATH 103A,A02,083778,Staff,0,15,30,30
1650780562631,MATH 103A,B01,083779,Staff,0,15,30,30
1650780562631,MATH 103A,B02,083780,Staff,0,15,30,30
1650780568655,MATH 105,A01,085443,Staff,0,22,30,30
1650780574684,MATH 109,A01,083213,Anzaldo; Leesa B,0,7,30,30
1650780574684,MATH 109,A02,083214,Anzaldo; Leesa B,0,7,30,30
1650780574684,MATH 109,B01,083215,Anzaldo; Leesa B,0,8,30,30
1650780574684,MATH 109,B02,083216,Anzaldo; Leesa B,0,7,30,30
1650780580708,MATH 142A,A01,083219,Chow; Bennett,0,16,30,30
1650780580708,MATH 142A,A02,083220,Chow; Bennett,0,15,30,30
1650780580708,MATH 142A,B01,083221,Chow; Bennett,0,15,30,30
1650780580708,MATH 142A,B02,083222,Chow; Bennett,0,14,30,30
1650780586733,MATH 193A,A01,083224,Staff,0,6,30,30
1650780586733,MATH 193A,A02,083225,Staff,0,6,30,30
1650780586733,MATH 193A,A03,083781,Staff,0,6,30,30
1650780586733,MATH 193A,A04,083782,Staff,0,7,30,30
1650780592755,MATH 197,001,091859,McAuley; Julian John,9998,0,9999,1
1650780598812,COGS 9,A01,083615,Staff,0,17,60,60
1650780604836,COGS 11,A01,083617,Boyle; Mary E. T.,16,0,40,24
1650780610863,COGS 13,A01,083071,Staff,0,38,40,40
1650780616885,COGS 14A,A01,092681,Staff,0,36,100,100
1650780622909,COGS 14B,A01,083073,Cheng; Tzu-Han,0,12,50,50
1650780628931,COGS 17,A01,092677,Staff,11,0,75,64
1650780634955,COGS 100,A01,083619,Staff,0,29,60,60
1650780640979,COGS 101A,A01,083621,Davis; Joshua Daniel,0,28,60,60
1650780647007,COGS 101B,A01,091572,Staff,0,3,60,60
1650780653034,COGS 101C,A01,083625,Delgado; Tania,14,0,30,16
1650780659058,COGS 107A,A01,083627,Boyle; Mary E. T.,0,16,60,60
1650780665083,COGS 118A,A01,083075,Staff,0,8,60,60
1650780671107,CSE 3,A50,083646,Miranda; Gregory Joseph,18,0,38,20
1650780671107,CSE 3,A51,083647,Miranda; Gregory Joseph,36,0,37,1
1650780677132,CSE 8A,A50,083650,Miranda; Gregory Joseph,0,29,40,40
1650780683158,CSE 11,A01,083080,Cao; Yingjun,0,96,40,40
1650780689186,CSE 12,A01,083652,Staff,0,21,100,100
1650780695212,CSE 15L,A01,083654,Staff,0,3,50,50
1650780695212,CSE 15L,A02,083655,Staff,0,2,50,50
1650780701235,CSE 20,A01,083657,Staff,49,0,80,31
1650780707270,CSE 30,A01,083084,Eldon; John,0,75,40,40
1650780713301,CSE 100,A01,083659,Cao; Yingjun,0,71,50,50
1650780719323,CSE 134B,A01,083661,Powell; Thomas Allan,0,38,65,65
1650780725350,CSE 140,A01,083663,Staff,0,11,75,75
1650780731374,CSE 140L,A01,083088,Eldon; John,0,20,75,75
1650780737398,CSE 175,A01,083665,Kumar; Rakesh,7,0,25,18
1650780743422,CSE 190,A00,092507,Dubnov; Shlomo,10,0,20,10
1650780749445,ECE 45,A01,083139,Staff,0,1,60,60
1650780755471,ECE 65,A50,083695,Staff,0,5,30,30
1650780761498,ECE 109,A01,091882,Touri; Behrouz,32,0,70,38
1650780767525,ECE 180,A00,083140,Abi Samra; Nicholas Camill,20,0,30,10
1650780767525,ECE 180,B00,083141,Abi Samra; Nicholas Camill,0,0,30,30
1650780773550,MATH 10A,A01,083735,Patchell; Gregory David,2,0,30,28
1650780773550,MATH 10A,A02,083736,Patchell; Gregory David,27,0,30,3
1650780773550,MATH 10A,A03,083737,Patchell; Gregory David,24,0,30,6
1650780779575,MATH 10B,A01,083207,Staff,0,9,30,30
1650780779575,MATH 10B,A02,083208,Staff,0,6,30,30
1650780779575,MATH 10B,B01,083739,Staff,10,0,30,20
1650780779575,MATH 10B,B02,083740,Staff,28,0,30,2
1650780785607,MATH 18,A01,083743,Staff,0,0,30,30
1650780785607,MATH 18,A02,083744,Staff,23,0,30,7
1650780785607,MATH 18,A03,083745,Staff,21,0,30,9
1650780785607,MATH 18,A04,083746,Staff,26,0,30,4
1650780785607,MATH 18,B01,083748,Staff,0,15,30,30
1650780785607,MATH 18,B02,083749,Staff,0,12,30,30
1650780785607,MATH 18,B03,083750,Staff,0,12,30,30
1650780785607,MATH 18,B04,083751,Staff,0,12,30,30
1650780791634,MATH 20A,A01,083754,Staff,19,0,40,21
1650780797657,MATH 20B,A01,083756,Staff,0,13,30,30
1650780797657,MATH 20B,A02,083757,Staff,0,12,30,30
1650780803685,MATH 20C,A01,083760,Staff,0,17,30,30
1650780803685,MATH 20C,A02,083761,Staff,0,16,30,30
1650780803685,MATH 20C,B01,083762,Staff,9,0,30,21
1650780803685,MATH 20C,B02,083763,Staff,28,0,30,2
1650780809712,MATH 20D,A01,083765,Staff,2,1,30,28
1650780809712,MATH 20D,A02,083766,Staff,6,0,30,24
1650780809712,MATH 20D,A03,083767,Staff,24,0,30,6
1650780815735,MATH 20E,A01,083771,Staff,2,0,30,28
1650780815735,MATH 20E,A02,083772,Staff,15,0,30,15
1650780815735,MATH 20E,B01,083773,Staff,0,0,30,30
1650780815735,MATH 20E,B02,083774,Staff,5,0,30,25
1650780821760,MATH 103A,A01,083777,Staff,0,16,30,30
1650780821760,MATH 103A,A02,083778,Staff,0,15,30,30
1650780821760,MATH 103A,B01,083779,Staff,0,15,30,30
1650780821760,MATH 103A,B02,083780,Staff,0,15,30,30
1650780827782,MATH 105,A01,085443,Staff,0,22,30,30
1650780833805,MATH 109,A01,083213,Anzaldo; Leesa B,0,7,30,30
1650780833805,MATH 109,A02,083214,Anzaldo; Leesa B,0,7,30,30
1650780833805,MATH 109,B01,083215,Anzaldo; Leesa B,0,8,30,30
1650780833805,MATH 109,B02,083216,Anzaldo; Leesa B,0,7,30,30
1650780839834,MATH 142A,A01,083219,Chow; Bennett,0,16,30,30
1650780839834,MATH 142A,A02,083220,Chow; Bennett,0,15,30,30
1650780839834,MATH 142A,B01,083221,Chow; Bennett,0,15,30,30
1650780839834,MATH 142A,B02,083222,Chow; Bennett,0,14,30,30
1650780845859,MATH 193A,A01,083224,Staff,0,6,30,30
1650780845859,MATH 193A,A02,083225,Staff,0,6,30,30
1650780845859,MATH 193A,A03,083781,Staff,0,6,30,30
1650780845859,MATH 193A,A04,083782,Staff,0,7,30,30
1650780851883,MATH 197,001,091859,McAuley; Julian John,9998,0,9999,1
1650780857940,COGS 9,A01,083615,Staff,0,17,60,60
1650780863963,COGS 11,A01,083617,Boyle; Mary E. T.,16,0,40,24
1650780869994,COGS 13,A01,083071,Staff,0,38,40,40
1650780876021,COGS 14A,A01,092681,Staff,0,36,100,100
1650780882048,COGS 14B,A01,083073,Cheng; Tzu-Han,0,12,50,50
1650780888070,COGS 17,A01,092677,Staff,11,0,75,64
1650780894096,COGS 100,A01,083619,Staff,0,29,60,60
1650780900123,COGS 101A,A01,083621,Davis; Joshua Daniel,0,28,60,60
1650780906147,COGS 101B,A01,091572,Staff,0,3,60,60
1650780912172,COGS 101C,A01,083625,Delgado; Tania,14,0,30,16
1650780918199,COGS 107A,A01,083627,Boyle; Mary E. T.,0,16,60,60
1650780924225,COGS 118A,A01,083075,Staff,0,8,60,60
1650780930255,CSE 3,A50,083646,Miranda; Gregory Joseph,18,0,38,20
1650780930255,CSE 3,A51,083647,Miranda; Gregory Joseph,36,0,37,1
1650780936282,CSE 8A,A50,083650,Miranda; Gregory Joseph,0,29,40,40
1650780942312,CSE 11,A01,083080,Cao; Yingjun,0,96,40,40
1650780948342,CSE 12,A01,083652,Staff,0,21,100,100
1650780954369,CSE 15L,A01,083654,Staff,0,3,50,50
1650780954369,CSE 15L,A02,083655,Staff,0,2,50,50
1650780960395,CSE 20,A01,083657,Staff,49,0,80,31
1650780966418,CSE 30,A01,083084,Eldon; John,0,75,40,40
1650780972442,CSE 100,A01,083659,Cao; Yingjun,0,71,50,50
1650780978466,CSE 134B,A01,083661,Powell; Thomas Allan,0,38,65,65
1650780984494,CSE 140,A01,083663,Staff,0,11,75,75
1650780990520,CSE 140L,A01,083088,Eldon; John,0,20,75,75
1650780996543,CSE 175,A01,083665,Kumar; Rakesh,7,0,25,18
1650781002570,CSE 190,A00,092507,Dubnov; Shlomo,10,0,20,10
1650781008608,ECE 45,A01,083139,Staff,0,1,60,60
1650781014632,ECE 65,A50,083695,Staff,0,5,30,30
1650781020660,ECE 109,A01,091882,Touri; Behrouz,32,0,70,38
1650781026700,ECE 180,A00,083140,Abi Samra; Nicholas Camill,20,0,30,10
1650781026700,ECE 180,B00,083141,Abi Samra; Nicholas Camill,0,0,30,30
1650781032724,MATH 10A,A01,083735,Patchell; Gregory David,2,0,30,28
1650781032724,MATH 10A,A02,083736,Patchell; Gregory David,27,0,30,3
1650781032724,MATH 10A,A03,083737,Patchell; Gregory David,24,0,30,6
1650781038749,MATH 10B,A01,083207,Staff,0,9,30,30
1650781038749,MATH 10B,A02,083208,Staff,0,6,30,30
1650781038749,MATH 10B,B01,083739,Staff,10,0,30,20
1650781038749,MATH 10B,B02,083740,Staff,28,0,30,2
1650781044773,MATH 18,A01,083743,Staff,0,0,30,30
1650781044773,MATH 18,A02,083744,Staff,23,0,30,7
1650781044773,MATH 18,A03,083745,Staff,21,0,30,9
1650781044773,MATH 18,A04,083746,Staff,26,0,30,4
1650781044773,MATH 18,B01,083748,Staff,0,15,30,30
1650781044773,MATH 18,B02,083749,Staff,0,12,30,30
1650781044773,MATH 18,B03,083750,Staff,0,12,30,30
1650781044773,MATH 18,B04,083751,Staff,0,12,30,30
1650781050797,MATH 20A,A01,083754,Staff,19,0,40,21
1650781056822,MATH 20B,A01,083756,Staff,0,13,30,30
1650781056822,MATH 20B,A02,083757,Staff,0,12,30,30
1650781062845,MATH 20C,A01,083760,Staff,0,17,30,30
1650781062845,MATH 20C,A02,083761,Staff,0,16,30,30
1650781062845,MATH 20C,B01,083762,Staff,9,0,30,21
1650781062845,MATH 20C,B02,083763,Staff,28,0,30,2
1650781068869,MATH 20D,A01,083765,Staff,2,1,30,28
1650781068869,MATH 20D,A02,083766,Staff,6,0,30,24
1650781068869,MATH 20D,A03,083767,Staff,24,0,30,6
1650781074898,MATH 20E,A01,083771,Staff,2,0,30,28
1650781074898,MATH 20E,A02,083772,Staff,15,0,30,15
1650781074898,MATH 20E,B01,083773,Staff,0,0,30,30
1650781074898,MATH 20E,B02,083774,Staff,5,0,30,25
1650781080924,MATH 103A,A01,083777,Staff,0,16,30,30
1650781080924,MATH 103A,A02,083778,Staff,0,15,30,30
1650781080924,MATH 103A,B01,083779,Staff,0,15,30,30
1650781080924,MATH 103A,B02,083780,Staff,0,15,30,30
1650781086950,MATH 105,A01,085443,Staff,0,22,30,30
1650781093081,MATH 109,A01,083213,Anzaldo; Leesa B,0,7,30,30
1650781093081,MATH 109,A02,083214,Anzaldo; Leesa B,0,7,30,30
1650781093081,MATH 109,B01,083215,Anzaldo; Leesa B,0,8,30,30
1650781093081,MATH 109,B02,083216,Anzaldo; Leesa B,0,7,30,30
1650781099105,MATH 142A,A01,083219,Chow; Bennett,0,16,30,30
1650781099105,MATH 142A,A02,083220,Chow; Bennett,0,15,30,30
1650781099105,MATH 142A,B01,083221,Chow; Bennett,0,15,30,30
1650781099105,MATH 142A,B02,083222,Chow; Bennett,0,14,30,30
1650781105129,MATH 193A,A01,083224,Staff,0,6,30,30
1650781105129,MATH 193A,A02,083225,Staff,0,6,30,30
1650781105129,MATH 193A,A03,083781,Staff,0,6,30,30
1650781105129,MATH 193A,A04,083782,Staff,0,7,30,30
1650781111155,MATH 197,001,091859,McAuley; Julian John,9998,0,9999,1
1650781117212,COGS 9,A01,083615,Staff,0,17,60,60
1650781123242,COGS 11,A01,083617,Boyle; Mary E. T.,16,0,40,24
1650781129265,COGS 13,A01,083071,Staff,0,38,40,40
1650781135295,COGS 14A,A01,092681,Staff,0,36,100,100
1650781141330,COGS 14B,A01,083073,Cheng; Tzu-Han,0,12,50,50
1650781147353,COGS 17,A01,092677,Staff,11,0,75,64
1650781153377,COGS 100,A01,083619,Staff,0,29,60,60
1650781159405,COGS 101A,A01,083621,Davis; Joshua Daniel,0,28,60,60
1650781165429,COGS 101B,A01,091572,Staff,0,3,60,60
1650781171453,COGS 101C,A01,083625,Delgado; Tania,14,0,30,16
1650781177476,COGS 107A,A01,083627,Boyle; Mary E. T.,0,16,60,60
1650781183499,COGS 118A,A01,083075,Staff,0,8,60,60
1650781189529,CSE 3,A50,083646,Miranda; Gregory Joseph,18,0,38,20
1650781189529,CSE 3,A51,083647,Miranda; Gregory Joseph,36,0,37,1
1650781195553,CSE 8A,A50,083650,Miranda; Gregory Joseph,0,29,40,40
1650781201576,CSE 11,A01,083080,Cao; Yingjun,0,96,40,40
1650781207609,CSE 12,A01,083652,Staff,0,21,100,100
1650781213635,CSE 15L,A01,083654,Staff,0,3,50,50
1650781213635,CSE 15L,A02,083655,Staff,0,2,50,50
1650781219664,CSE 20,A01,083657,Staff,49,0,80,31
1650781225695,CSE 30,A01,083084,Eldon; John,0,75,40,40
1650781231728,CSE 100,A01,083659,Cao; Yingjun,0,71,50,50
1650781237752,CSE 134B,A01,083661,Powell; Thomas Allan,0,38,65,65
1650781243776,CSE 140,A01,083663,Staff,0,11,75,75
1650781249801,CSE 140L,A01,083088,Eldon; John,0,20,75,75
1650781255826,CSE 175,A01,083665,Kumar; Rakesh,7,0,25,18
1650781261850,CSE 190,A00,092507,Dubnov; Shlomo,10,0,20,10
1650781267874,ECE 45,A01,083139,Staff,0,1,60,60
1650781273898,ECE 65,A50,083695,Staff,0,5,30,30
1650781279927,ECE 109,A01,091882,Touri; Behrouz,32,0,70,38
1650781285956,ECE 180,A00,083140,Abi Samra; Nicholas Camill,20,0,30,10
1650781285956,ECE 180,B00,083141,Abi Samra; Nicholas Camill,0,0,30,30
1650781291982,MATH 10A,A01,083735,Patchell; Gregory David,2,0,30,28
1650781291982,MATH 10A,A02,083736,Patchell; Gregory David,27,0,30,3
1650781291982,MATH 10A,A03,083737,Patchell; Gregory David,24,0,30,6
1650781298009,MATH 10B,A01,083207,Staff,0,9,30,30
1650781298009,MATH 10B,A02,083208,Staff,0,6,30,30
1650781298009,MATH 10B,B01,083739,Staff,10,0,30,20
1650781298009,MATH 10B,B02,083740,Staff,28,0,30,2
1650781304039,MATH 18,A01,083743,Staff,0,0,30,30
1650781304039,MATH 18,A02,083744,Staff,23,0,30,7
1650781304039,MATH 18,A03,083745,Staff,21,0,30,9
1650781304039,MATH 18,A04,083746,Staff,26,0,30,4
1650781304039,MATH 18,B01,083748,Staff,0,15,30,30
1650781304039,MATH 18,B02,083749,Staff,0,12,30,30
1650781304039,MATH 18,B03,083750,Staff,0,12,30,30
1650781304039,MATH 18,B04,083751,Staff,0,12,30,30
1650781310065,MATH 20A,A01,083754,Staff,19,0,40,21
1650781316092,MATH 20B,A01,083756,Staff,0,13,30,30
1650781316092,MATH 20B,A02,083757,Staff,0,12,30,30
1650781322117,MATH 20C,A01,083760,Staff,0,17,30,30
1650781322117,MATH 20C,A02,083761,Staff,0,16,30,30
1650781322117,MATH 20C,B01,083762,Staff,9,0,30,21
1650781322117,MATH 20C,B02,083763,Staff,28,0,30,2
1650781328149,MATH 20D,A01,083765,Staff,2,1,30,28
1650781328149,MATH 20D,A02,083766,Staff,6,0,30,24
1650781328149,MATH 20D,A03,083767,Staff,24,0,30,6
1650781334184,MATH 20E,A01,083771,Staff,2,0,30,28
1650781334184,MATH 20E,A02,083772,Staff,15,0,30,15
1650781334184,MATH 20E,B01,083773,Staff,0,0,30,30
1650781334184,MATH 20E,B02,083774,Staff,5,0,30,25
1650781340210,MATH 103A,A01,083777,Staff,0,16,30,30
1650781340210,MATH 103A,A02,083778,Staff,0,15,30,30
1650781340210,MATH 103A,B01,083779,Staff,0,15,30,30
1650781340210,MATH 103A,B02,083780,Staff,0,15,30,30
1650781346235,MATH 105,A01,085443,Staff,0,22,30,30
1650781352260,MATH 109,A01,083213,Anzaldo; Leesa B,0,7,30,30
1650781352260,MATH 109,A02,083214,Anzaldo; Leesa B,0,7,30,30
1650781352260,MATH 109,B01,083215,Anzaldo; Leesa B,0,8,30,30
1650781352260,MATH 109,B02,083216,Anzaldo; Leesa B,0,7,30,30
1650781358283,MATH 142A,A01,083219,Chow; Bennett,0,16,30,30
1650781358283,MATH 142A,A02,083220,Chow; Bennett,0,15,30,30
1650781358283,MATH 142A,B01,083221,Chow; Bennett,0,15,30,30
1650781358283,MATH 142A,B02,083222,Chow; Bennett,0,14,30,30
1650781364331,MATH 193A,A01,083224,Staff,0,6,30,30
1650781364331,MATH 193A,A02,083225,Staff,0,6,30,30
1650781364331,MATH 193A,A03,083781,Staff,0,6,30,30
1650781364331,MATH 193A,A04,083782,Staff,0,7,30,30
1650781370355,MATH 197,001,091859,McAuley; Julian John,9998,0,9999,1
1650781376405,COGS 9,A01,083615,Staff,0,17,60,60
1650781382432,COGS 11,A01,083617,Boyle; Mary E. T.,16,0,40,24
1650781388457,COGS 13,A01,083071,Staff,0,38,40,40
1650781394485,COGS 14A,A01,092681,Staff,0,36,100,100
1650781400519,COGS 14B,A01,083073,Cheng; Tzu-Han,0,12,50,50
1650781406550,COGS 17,A01,092677,Staff,11,0,75,64
1650781412578,COGS 100,A01,083619,Staff,0,29,60,60
1650781418600,COGS 101A,A01,083621,Davis; Joshua Daniel,0,28,60,60
1650781424632,COGS 101B,A01,091572,Staff,0,3,60,60
1650781430656,COGS 101C,A01,083625,Delgado; Tania,14,0,30,16
1650781436690,COGS 107A,A01,083627,Boyle; Mary E. T.,0,16,60,60
1650781442715,COGS 118A,A01,083075,Staff,0,8,60,60
1650781448749,CSE 3,A50,083646,Miranda; Gregory Joseph,18,0,38,20
1650781448749,CSE 3,A51,083647,Miranda; Gregory Joseph,36,0,37,1
1650781454777,CSE 8A,A50,083650,Miranda; Gregory Joseph,0,29,40,40
1650781460801,CSE 11,A01,083080,Cao; Yingjun,0,96,40,40
1650781466827,CSE 12,A01,083652,Staff,0,21,100,100
1650781472850,CSE 15L,A01,083654,Staff,0,3,50,50
1650781472850,CSE 15L,A02,083655,Staff,0,2,50,50
1650781478876,CSE 20,A01,083657,Staff,49,0,80,31
1650781484898,CSE 30,A01,083084,Eldon; John,0,75,40,40
1650781490932,CSE 100,A01,083659,Cao; Yingjun,0,71,50,50
1650781496956,CSE 134B,A01,083661,Powell; Thomas Allan,0,38,65,65
1650781502984,CSE 140,A01,083663,Staff,0,11,75,75
1650781509017,CSE 140L,A01,083088,Eldon; John,0,20,75,75
1650781515044,CSE 175,A01,083665,Kumar; Rakesh,7,0,25,18
1650781521070,CSE 190,A00,092507,Dubnov; Shlomo,10,0,20,10
1650781527105,ECE 45,A01,083139,Staff,0,1,60,60
1650781533136,ECE 65,A50,083695,Staff,0,5,30,30
1650781539179,ECE 109,A01,091882,Touri; Behrouz,32,0,70,38
1650781545203,ECE 180,A00,083140,Abi Samra; Nicholas Camill,20,0,30,10
1650781545203,ECE 180,B00,083141,Abi Samra; Nicholas Camill,0,0,30,30
1650781551226,MATH 10A,A01,083735,Patchell; Gregory David,2,0,30,28
1650781551226,MATH 10A,A02,083736,Patchell; Gregory David,27,0,30,3
1650781551226,MATH 10A,A03,083737,Patchell; Gregory David,24,0,30,6
1650781557250,MATH 10B,A01,083207,Staff,0,9,30,30
1650781557250,MATH 10B,A02,083208,Staff,0,6,30,30
1650781557250,MATH 10B,B01,083739,Staff,10,0,30,20
1650781557250,MATH 10B,B02,083740,Staff,28,0,30,2
1650781563276,MATH 18,A01,083743,Staff,0,0,30,30
1650781563276,MATH 18,A02,083744,Staff,23,0,30,7
1650781563276,MATH 18,A03,083745,Staff,21,0,30,9
1650781563276,MATH 18,A04,083746,Staff,26,0,30,4
1650781563276,MATH 18,B01,083748,Staff,0,15,30,30
1650781563276,MATH 18,B02,083749,Staff,0,12,30,30
1650781563276,MATH 18,B03,083750,Staff,0,12,30,30
1650781563276,MATH 18,B04,083751,Staff,0,12,30,30
1650781569303,MATH 20A,A01,083754,Staff,19,0,40,21
1650781575331,MATH 20B,A01,083756,Staff,0,13,30,30
1650781575331,MATH 20B,A02,083757,Staff,0,12,30,30
1650781581362,MATH 20C,A01,083760,Staff,0,17,30,30
1650781581362,MATH 20C,A02,083761,Staff,0,16,30,30
1650781581362,MATH 20C,B01,083762,Staff,9,0,30,21
1650781581362,MATH 20C,B02,083763,Staff,28,0,30,2
1650781587389,MATH 20D,A01,083765,Staff,2,1,30,28
1650781587389,MATH 20D,A02,083766,Staff,6,0,30,24
1650781587389,MATH 20D,A03,083767,Staff,24,0,30,6
1650781593414,MATH 20E,A01,083771,Staff,2,0,30,28
1650781593414,MATH 20E,A02,083772,Staff,15,0,30,15
1650781593414,MATH 20E,B01,083773,Staff,0,0,30,30
1650781593414,MATH 20E,B02,083774,Staff,5,0,30,25
1650781599438,MATH 103A,A01,083777,Staff,0,16,30,30
1650781599438,MATH 103A,A02,083778,Staff,0,15,30,30
1650781599438,MATH 103A,B01,083779,Staff,0,15,30,30
1650781599438,MATH 103A,B02,083780,Staff,0,15,30,30
1650781605465,MATH 105,A01,085443,Staff,0,22,30,30
1650781611489,MATH 109,A01,083213,Anzaldo; Leesa B,0,7,30,30
1650781611489,MATH 109,A02,083214,Anzaldo; Leesa B,0,7,30,30
1650781611489,MATH 109,B01,083215,Anzaldo; Leesa B,0,8,30,30
1650781611489,MATH 109,B02,083216,Anzaldo; Leesa B,0,7,30,30
1650781617520,MATH 142A,A01,083219,Chow; Bennett,0,16,30,30
1650781617520,MATH 142A,A02,083220,Chow; Bennett,0,15,30,30
1650781617520,MATH 142A,B01,083221,Chow; Bennett,0,15,30,30
1650781617520,MATH 142A,B02,083222,Chow; Bennett,0,14,30,30
1650781623545,MATH 193A,A01,083224,Staff,0,6,30,30
1650781623545,MATH 193A,A02,083225,Staff,0,6,30,30
1650781623545,MATH 193A,A03,083781,Staff,0,6,30,30
1650781623545,MATH 193A,A04,083782,Staff,0,7,30,30
1650781629568,MATH 197,001,091859,McAuley; Julian John,9998,0,9999,1
1650781635631,COGS 9,A01,083615,Staff,0,17,60,60
1650781641655,COGS 11,A01,083617,Boyle; Mary E. T.,16,0,40,24
1650781647689,COGS 13,A01,083071,Staff,0,38,40,40
1650781653726,COGS 14A,A01,092681,Staff,0,36,100,100
1650781659751,COGS 14B,A01,083073,Cheng; Tzu-Han,0,12,50,50
1650781665780,COGS 17,A01,092677,Staff,11,0,75,64
1650781671803,COGS 100,A01,083619,Staff,0,29,60,60
1650781677826,COGS 101A,A01,083621,Davis; Joshua Daniel,0,28,60,60
1650781683927,COGS 101B,A01,091572,Staff,0,3,60,60
1650781689953,COGS 101C,A01,083625,Delgado; Tania,14,0,30,16
1650781695980,COGS 107A,A01,083627,Boyle; Mary E. T.,0,16,60,60
1650781702004,COGS 118A,A01,083075,Staff,0,8,60,60
1650781708036,CSE 3,A50,083646,Miranda; Gregory Joseph,18,0,38,20
1650781708036,CSE 3,A51,083647,Miranda; Gregory Joseph,36,0,37,1
1650781714061,CSE 8A,A50,083650,Miranda; Gregory Joseph,0,29,40,40
1650781720085,CSE 11,A01,083080,Cao; Yingjun,0,96,40,40
1650781726113,CSE 12,A01,083652,Staff,0,21,100,100
1650781732136,CSE 15L,A01,083654,Staff,0,3,50,50
1650781732136,CSE 15L,A02,083655,Staff,0,2,50,50
1650781738157,CSE 20,A01,083657,Staff,49,0,80,31
1650781744184,CSE 30,A01,083084,Eldon; John,0,75,40,40
1650781750215,CSE 100,A01,083659,Cao; Yingjun,0,71,50,50
1650781756243,CSE 134B,A01,083661,Powell; Thomas Allan,0,38,65,65
1650781762266,CSE 140,A01,083663,Staff,0,11,75,75
1650781768291,CSE 140L,A01,083088,Eldon; John,0,20,75,75
1650781774316,CSE 175,A01,083665,Kumar; Rakesh,7,0,25,18
1650781780350,CSE 190,A00,092507,Dubnov; Shlomo,10,0,20,10
1650781786375,ECE 45,A01,083139,Staff,0,1,60,60
1650781792399,ECE 65,A50,083695,Staff,0,5,30,30
1650781798425,ECE 109,A01,091882,Touri; Behrouz,32,0,70,38
1650781804451,ECE 180,A00,083140,Abi Samra; Nicholas Camill,20,0,30,10
1650781804451,ECE 180,B00,083141,Abi Samra; Nicholas Camill,0,0,30,30
1650781810474,MATH 10A,A01,083735,Patchell; Gregory David,2,0,30,28
1650781810474,MATH 10A,A02,083736,Patchell; Gregory David,27,0,30,3
1650781810474,MATH 10A,A03,083737,Patchell; Gregory David,24,0,30,6
1650781816505,MATH 10B,A01,083207,Staff,0,9,30,30
1650781816505,MATH 10B,A02,083208,Staff,0,6,30,30
1650781816505,MATH 10B,B01,083739,Staff,11,0,30,19
1650781816505,MATH 10B,B02,083740,Staff,28,0,30,2
1650781822533,MATH 18,A01,083743,Staff,0,0,30,30
1650781822533,MATH 18,A02,083744,Staff,23,0,30,7
1650781822533,MATH 18,A03,083745,Staff,21,0,30,9
1650781822533,MATH 18,A04,083746,Staff,26,0,30,4
1650781822533,MATH 18,B01,083748,Staff,0,15,30,30
1650781822533,MATH 18,B02,083749,Staff,0,12,30,30
1650781822533,MATH 18,B03,083750,Staff,0,12,30,30
1650781822533,MATH 18,B04,083751,Staff,0,12,30,30
1650781828561,MATH 20A,A01,083754,Staff,19,0,40,21
1650781834584,MATH 20B,A01,083756,Staff,0,13,30,30
1650781834584,MATH 20B,A02,083757,Staff,0,12,30,30
1650781840616,MATH 20C,A01,083760,Staff,0,17,30,30
1650781840616,MATH 20C,A02,083761,Staff,0,16,30,30
1650781840616,MATH 20C,B01,083762,Staff,9,0,30,21
1650781840616,MATH 20C,B02,083763,Staff,28,0,30,2
1650781846644,MATH 20D,A01,083765,Staff,2,1,30,28
1650781846644,MATH 20D,A02,083766,Staff,6,0,30,24
1650781846644,MATH 20D,A03,083767,Staff,24,0,30,6
1650781852668,MATH 20E,A01,083771,Staff,2,0,30,28
1650781852668,MATH 20E,A02,083772,Staff,15,0,30,15
1650781852668,MATH 20E,B01,083773,Staff,0,0,30,30
1650781852668,MATH 20E,B02,083774,Staff,5,0,30,25
1650781858693,MATH 103A,A01,083777,Staff,0,16,30,30
1650781858693,MATH 103A,A02,083778,Staff,0,15,30,30
1650781858693,MATH 103A,B01,083779,Staff,0,15,30,30
1650781858693,MATH 103A,B02,083780,Staff,0,15,30,30
1650781864726,MATH 105,A01,085443,Staff,0,22,30,30
1650781870762,MATH 109,A01,083213,Anzaldo; Leesa B,0,7,30,30
1650781870762,MATH 109,A02,083214,Anzaldo; Leesa B,0,7,30,30
1650781870762,MATH 109,B01,083215,Anzaldo; Leesa B,0,8,30,30
1650781870762,MATH 109,B02,083216,Anzaldo; Leesa B,0,7,30,30
1650781876786,MATH 142A,A01,083219,Chow; Bennett,0,16,30,30
1650781876786,MATH 142A,A02,083220,Chow; Bennett,0,15,30,30
1650781876786,MATH 142A,B01,083221,Chow; Bennett,0,15,30,30
1650781876786,MATH 142A,B02,083222,Chow; Bennett,0,14,30,30
1650781882816,MATH 193A,A01,083224,Staff,0,6,30,30
1650781882816,MATH 193A,A02,083225,Staff,0,6,30,30
1650781882816,MATH 193A,A03,083781,Staff,0,6,30,30
1650781882816,MATH 193A,A04,083782,Staff,0,7,30,30
1650781888839,MATH 197,001,091859,McAuley; Julian John,9998,0,9999,1
1650781894904,COGS 9,A01,083615,Staff,0,17,60,60
1650781900938,COGS 11,A01,083617,Boyle; Mary E. T.,16,0,40,24
1650781906962,COGS 13,A01,083071,Staff,0,38,40,40
1650781912993,COGS 14A,A01,092681,Staff,0,36,100,100
1650781919021,COGS 14B,A01,083073,Cheng; Tzu-Han,0,12,50,50
1650781925045,COGS 17,A01,092677,Staff,11,0,75,64
1650781931070,COGS 100,A01,083619,Staff,0,29,60,60
1650781937094,COGS 101A,A01,083621,Davis; Joshua Daniel,0,28,60,60
1650781943119,COGS 101B,A01,091572,Staff,0,3,60,60
1650781949143,COGS 101C,A01,083625,Delgado; Tania,14,0,30,16
1650781955166,COGS 107A,A01,083627,Boyle; Mary E. T.,0,16,60,60
1650781961205,COGS 118A,A01,083075,Staff,0,8,60,60
1650781967237,CSE 3,A50,083646,Miranda; Gregory Joseph,18,0,38,20
1650781967237,CSE 3,A51,083647,Miranda; Gregory Joseph,36,0,37,1
1650781973263,CSE 8A,A50,083650,Miranda; Gregory Joseph,0,29,40,40
1650781979289,CSE 11,A01,083080,Cao; Yingjun,0,96,40,40
1650781985314,CSE 12,A01,083652,Staff,0,21,100,100
1650781991338,CSE 15L,A01,083654,Staff,0,3,50,50
1650781991338,CSE 15L,A02,083655,Staff,0,2,50,50
1650781997365,CSE 20,A01,083657,Staff,49,0,80,31
1650782003393,CSE 30,A01,083084,Eldon; John,0,75,40,40
1650782009430,CSE 100,A01,083659,Cao; Yingjun,0,71,50,50
1650782015455,CSE 134B,A01,083661,Powell; Thomas Allan,0,38,65,65
1650782021481,CSE 140,A01,083663,Staff,0,11,75,75
1650782027507,CSE 140L,A01,083088,Eldon; John,0,20,75,75
1650782033530,CSE 175,A01,083665,Kumar; Rakesh,7,0,25,18
1650782039561,CSE 190,A00,092507,Dubnov; Shlomo,10,0,20,10
1650782045586,ECE 45,A01,083139,Staff,0,1,60,60
1650782051620,ECE 65,A50,083695,Staff,0,5,30,30
1650782057658,ECE 109,A01,091882,Touri; Behrouz,32,0,70,38
1650782063686,ECE 180,A00,083140,Abi Samra; Nicholas Camill,20,0,30,10
1650782063686,ECE 180,B00,083141,Abi Samra; Nicholas Camill,0,0,30,30
1650782069718,MATH 10A,A01,083735,Patchell; Gregory David,2,0,30,28
1650782069718,MATH 10A,A02,083736,Patchell; Gregory David,27,0,30,3
1650782069718,MATH 10A,A03,083737,Patchell; Gregory David,24,0,30,6
1650782075744,MATH 10B,A01,083207,Staff,0,9,30,30
1650782075744,MATH 10B,A02,083208,Staff,0,6,30,30
1650782075744,MATH 10B,B01,083739,Staff,11,0,30,19
1650782075744,MATH 10B,B02,083740,Staff,28,0,30,2
1650782081780,MATH 18,A01,083743,Staff,0,0,30,30
1650782081780,MATH 18,A02,083744,Staff,23,0,30,7
1650782081780,MATH 18,A03,083745,Staff,21,0,30,9
1650782081780,MATH 18,A04,083746,Staff,26,0,30,4
1650782081780,MATH 18,B01,083748,Staff,0,15,30,30
1650782081780,MATH 18,B02,083749,Staff,0,12,30,30
1650782081780,MATH 18,B03,083750,Staff,0,12,30,30
1650782081780,MATH 18,B04,083751,Staff,0,12,30,30
1650782087808,MATH 20A,A01,083754,Staff,19,0,40,21
1650782093853,MATH 20B,A01,083756,Staff,0,13,30,30
1650782093853,MATH 20B,A02,083757,Staff,0,12,30,30
1650782099888,MATH 20C,A01,083760,Staff,0,17,30,30
1650782099888,MATH 20C,A02,083761,Staff,0,16,30,30
1650782099888,MATH 20C,B01,083762,Staff,9,0,30,21
1650782099888,MATH 20C,B02,083763,Staff,28,0,30,2
1650782105915,MATH 20D,A01,083765,Staff,2,1,30,28
1650782105915,MATH 20D,A02,083766,Staff,6,0,30,24
1650782105915,MATH 20D,A03,083767,Staff,24,0,30,6
1650782111951,MATH 20E,A01,083771,Staff,2,0,30,28
1650782111951,MATH 20E,A02,083772,Staff,15,0,30,15
1650782111951,MATH 20E,B01,083773,Staff,0,0,30,30
1650782111951,MATH 20E,B02,083774,Staff,5,0,30,25
1650782117985,MATH 103A,A01,083777,Staff,0,16,30,30
1650782117985,MATH 103A,A02,083778,Staff,0,15,30,30
1650782117985,MATH 103A,B01,083779,Staff,0,15,30,30
1650782117985,MATH 103A,B02,083780,Staff,0,15,30,30
1650782124012,MATH 105,A01,085443,Staff,0,22,30,30
1650782130053,MATH 109,A01,083213,Anzaldo; Leesa B,0,7,30,30
1650782130053,MATH 109,A02,083214,Anzaldo; Leesa B,0,7,30,30
1650782130053,MATH 109,B01,083215,Anzaldo; Leesa B,0,8,30,30
1650782130053,MATH 109,B02,083216,Anzaldo; Leesa B,0,7,30,30
1650782136078,MATH 142A,A01,083219,Chow; Bennett,0,16,30,30
1650782136078,MATH 142A,A02,083220,Chow; Bennett,0,15,30,30
1650782136078,MATH 142A,B01,083221,Chow; Bennett,0,15,30,30
1650782136078,MATH 142A,B02,083222,Chow; Bennett,0,14,30,30
1650782142106,MATH 193A,A01,083224,Staff,0,6,30,30
1650782142106,MATH 193A,A02,083225,Staff,0,6,30,30
1650782142106,MATH 193A,A03,083781,Staff,0,6,30,30
1650782142106,MATH 193A,A04,083782,Staff,0,7,30,30
1650782148138,MATH 197,001,091859,McAuley; Julian John,9998,0,9999,1
1650782154211,COGS 9,A01,083615,Staff,0,17,60,60
1650782160237,COGS 11,A01,083617,Boyle; Mary E. T.,16,0,40,24
1650782166262,COGS 13,A01,083071,Staff,0,38,40,40
1650782172294,COGS 14A,A01,092681,Staff,0,36,100,100
1650782178320,COGS 14B,A01,083073,Cheng; Tzu-Han,0,12,50,50
1650782184348,COGS 17,A01,092677,Staff,11,0,75,64
1650782190373,COGS 100,A01,083619,Staff,0,29,60,60
1650782196397,COGS 101A,A01,083621,Davis; Joshua Daniel,0,28,60,60
1650782202421,COGS 101B,A01,091572,Staff,0,3,60,60
1650782208446,COGS 101C,A01,083625,Delgado; Tania,14,0,30,16
1650782214472,COGS 107A,A01,083627,Boyle; Mary E. T.,0,16,60,60
1650782220495,COGS 118A,A01,083075,Staff,0,8,60,60
1650782226519,CSE 3,A50,083646,Miranda; Gregory Joseph,18,0,38,20
1650782226519,CSE 3,A51,083647,Miranda; Gregory Joseph,36,0,37,1
1650782232544,CSE 8A,A50,083650,Miranda; Gregory Joseph,0,29,40,40
1650782238568,CSE 11,A01,083080,Cao; Yingjun,0,96,40,40
1650782244592,CSE 12,A01,083652,Staff,0,21,100,100
1650782250616,CSE 15L,A01,083654,Staff,0,3,50,50
1650782250616,CSE 15L,A02,083655,Staff,0,2,50,50
1650782256640,CSE 20,A01,083657,Staff,49,0,80,31
1650782262666,CSE 30,A01,083084,Eldon; John,0,75,40,40
1650782268691,CSE 100,A01,083659,Cao; Yingjun,0,71,50,50
1650782274718,CSE 134B,A01,083661,Powell; Thomas Allan,0,38,65,65
1650782280821,CSE 140,A01,083663,Staff,0,11,75,75
1650782286849,CSE 140L,A01,083088,Eldon; John,0,20,75,75
1650782292872,CSE 175,A01,083665,Kumar; Rakesh,7,0,25,18
1650782298901,CSE 190,A00,092507,Dubnov; Shlomo,10,0,20,10
1650782304924,ECE 45,A01,083139,Staff,0,1,60,60
1650782310948,ECE 65,A50,083695,Staff,0,5,30,30
1650782316971,ECE 109,A01,091882,Touri; Behrouz,32,0,70,38
1650782322996,ECE 180,A00,083140,Abi Samra; Nicholas Camill,20,0,30,10
1650782322996,ECE 180,B00,083141,Abi Samra; Nicholas Camill,0,0,30,30
1650782329020,MATH 10A,A01,083735,Patchell; Gregory David,2,0,30,28
1650782329020,MATH 10A,A02,083736,Patchell; Gregory David,27,0,30,3
1650782329020,MATH 10A,A03,083737,Patchell; Gregory David,24,0,30,6
1650782335048,MATH 10B,A01,083207,Staff,0,9,30,30
1650782335048,MATH 10B,A02,083208,Staff,0,6,30,30
1650782335048,MATH 10B,B01,083739,Staff,11,0,30,19
1650782335048,MATH 10B,B02,083740,Staff,28,0,30,2
1650782341078,MATH 18,A01,083743,Staff,0,0,30,30
1650782341078,MATH 18,A02,083744,Staff,23,0,30,7
1650782341078,MATH 18,A03,083745,Staff,21,0,30,9
1650782341078,MATH 18,A04,083746,Staff,26,0,30,4
1650782341078,MATH 18,B01,083748,Staff,0,15,30,30
1650782341078,MATH 18,B02,083749,Staff,0,12,30,30
1650782341078,MATH 18,B03,083750,Staff,0,12,30,30
1650782341078,MATH 18,B04,083751,Staff,0,12,30,30
1650782347127,MATH 20A,A01,083754,Staff,19,0,40,21
1650782353165,MATH 20B,A01,083756,Staff,0,13,30,30
1650782353165,MATH 20B,A02,083757,Staff,0,12,30,30
1650782359189,MATH 20C,A01,083760,Staff,0,17,30,30
1650782359189,MATH 20C,A02,083761,Staff,0,16,30,30
1650782359189,MATH 20C,B01,083762,Staff,9,0,30,21
1650782359189,MATH 20C,B02,083763,Staff,28,0,30,2
1650782365228,MATH 20D,A01,083765,Staff,2,1,30,28
1650782365228,MATH 20D,A02,083766,Staff,6,0,30,24
1650782365228,MATH 20D,A03,083767,Staff,24,0,30,6
1650782371253,MATH 20E,A01,083771,Staff,2,0,30,28
1650782371253,MATH 20E,A02,083772,Staff,15,0,30,15
1650782371253,MATH 20E,B01,083773,Staff,0,0,30,30
1650782371253,MATH 20E,B02,083774,Staff,5,0,30,25
1650782377279,MATH 103A,A01,083777,Staff,0,16,30,30
1650782377279,MATH 103A,A02,083778,Staff,0,15,30,30
1650782377279,MATH 103A,B01,083779,Staff,0,15,30,30
1650782377279,MATH 103A,B02,083780,Staff,0,15,30,30
1650782383302,MATH 105,A01,085443,Staff,0,22,30,30
1650782389334,MATH 109,A01,083213,Anzaldo; Leesa B,0,7,30,30
1650782389334,MATH 109,A02,083214,Anzaldo; Leesa B,0,7,30,30
1650782389334,MATH 109,B01,083215,Anzaldo; Leesa B,0,8,30,30
1650782389334,MATH 109,B02,083216,Anzaldo; Leesa B,0,7,30,30
1650782395358,MATH 142A,A01,083219,Chow; Bennett,0,16,30,30
1650782395358,MATH 142A,A02,083220,Chow; Bennett,0,15,30,30
1650782395358,MATH 142A,B01,083221,Chow; Bennett,0,15,30,30
1650782395358,MATH 142A,B02,083222,Chow; Bennett,0,14,30,30
1650782401390,MATH 193A,A01,083224,Staff,0,6,30,30
1650782401390,MATH 193A,A02,083225,Staff,0,6,30,30
1650782401390,MATH 193A,A03,083781,Staff,0,6,30,30
1650782401390,MATH 193A,A04,083782,Staff,0,7,30,30
1650782407412,MATH 197,001,091859,McAuley; Julian John,9998,0,9999,1
1650782413465,COGS 9,A01,083615,Staff,0,17,60,60
1650782419492,COGS 11,A01,083617,Boyle; Mary E. T.,16,0,40,24
1650782425516,COGS 13,A01,083071,Staff,0,38,40,40
1650782431540,COGS 14A,A01,092681,Staff,0,36,100,100
1650782437567,COGS 14B,A01,083073,Cheng; Tzu-Han,0,12,50,50
1650782443591,COGS 17,A01,092677,Staff,11,0,75,64
1650782449615,COGS 100,A01,083619,Staff,0,29,60,60
1650782455643,COGS 101A,A01,083621,Davis; Joshua Daniel,0,28,60,60
1650782461671,COGS 101B,A01,091572,Staff,0,3,60,60
1650782467694,COGS 101C,A01,083625,Delgado; Tania,14,0,30,16
1650782473718,COGS 107A,A01,083627,Boyle; Mary E. T.,0,16,60,60
1650782479744,COGS 118A,A01,083075,Staff,0,8,60,60
1650782485767,CSE 3,A50,083646,Miranda; Gregory Joseph,18,0,38,20
1650782485767,CSE 3,A51,083647,Miranda; Gregory Joseph,36,0,37,1
1650782491794,CSE 8A,A50,083650,Miranda; Gregory Joseph,0,29,40,40
1650782497816,CSE 11,A01,083080,Cao; Yingjun,0,96,40,40
1650782503843,CSE 12,A01,083652,Staff,0,21,100,100
1650782509900,CSE 15L,A01,083654,Staff,0,3,50,50
1650782509900,CSE 15L,A02,083655,Staff,0,2,50,50
1650782515925,CSE 20,A01,083657,Staff,49,0,80,31
1650782521952,CSE 30,A01,083084,Eldon; John,0,75,40,40
1650782527979,CSE 100,A01,083659,Cao; Yingjun,0,71,50,50
1650782534003,CSE 134B,A01,083661,Powell; Thomas Allan,0,38,65,65
1650782540030,CSE 140,A01,083663,Staff,0,11,75,75
1650782546055,CSE 140L,A01,083088,Eldon; John,0,20,75,75
1650782552078,CSE 175,A01,083665,Kumar; Rakesh,7,0,25,18
1650782558102,CSE 190,A00,092507,Dubnov; Shlomo,10,0,20,10
1650782564128,ECE 45,A01,083139,Staff,0,1,60,60
1650782570155,ECE 65,A50,083695,Staff,0,5,30,30
1650782576178,ECE 109,A01,091882,Touri; Behrouz,32,0,70,38
1650782582205,ECE 180,A00,083140,Abi Samra; Nicholas Camill,20,0,30,10
1650782582205,ECE 180,B00,083141,Abi Samra; Nicholas Camill,0,0,30,30
1650782588231,MATH 10A,A01,083735,Patchell; Gregory David,2,0,30,28
1650782588231,MATH 10A,A02,083736,Patchell; Gregory David,27,0,30,3
1650782588231,MATH 10A,A03,083737,Patchell; Gregory David,24,0,30,6
1650782594255,MATH 10B,A01,083207,Staff,0,9,30,30
1650782594255,MATH 10B,A02,083208,Staff,0,6,30,30
1650782594255,MATH 10B,B01,083739,Staff,11,0,30,19
1650782594255,MATH 10B,B02,083740,Staff,28,0,30,2
1650782600280,MATH 18,A01,083743,Staff,0,0,30,30
1650782600280,MATH 18,A02,083744,Staff,23,0,30,7
1650782600280,MATH 18,A03,083745,Staff,21,0,30,9
1650782600280,MATH 18,A04,083746,Staff,26,0,30,4
1650782600280,MATH 18,B01,083748,Staff,0,15,30,30
1650782600280,MATH 18,B02,083749,Staff,0,12,30,30
1650782600280,MATH 18,B03,083750,Staff,0,12,30,30
1650782600280,MATH 18,B04,083751,Staff,0,12,30,30
1650782606306,MATH 20A,A01,083754,Staff,19,0,40,21
1650782612350,MATH 20B,A01,083756,Staff,0,13,30,30
1650782612350,MATH 20B,A02,083757,Staff,0,12,30,30
1650782618374,MATH 20C,A01,083760,Staff,0,17,30,30
1650782618374,MATH 20C,A02,083761,Staff,0,16,30,30
1650782618374,MATH 20C,B01,083762,Staff,9,0,30,21
1650782618374,MATH 20C,B02,083763,Staff,28,0,30,2
1650782624403,MATH 20D,A01,083765,Staff,2,1,30,28
1650782624403,MATH 20D,A02,083766,Staff,6,0,30,24
1650782624403,MATH 20D,A03,083767,Staff,24,0,30,6
1650782630431,MATH 20E,A01,083771,Staff,2,0,30,28
1650782630431,MATH 20E,A02,083772,Staff,15,0,30,15
1650782630431,MATH 20E,B01,083773,Staff,0,0,30,30
1650782630431,MATH 20E,B02,083774,Staff,5,0,30,25
1650782636456,MATH 103A,A01,083777,Staff,0,16,30,30
1650782636456,MATH 103A,A02,083778,Staff,0,15,30,30
1650782636456,MATH 103A,B01,083779,Staff,0,15,30,30
1650782636456,MATH 103A,B02,083780,Staff,0,15,30,30
1650782642484,MATH 105,A01,085443,Staff,0,22,30,30
1650782648513,MATH 109,A01,083213,Anzaldo; Leesa B,0,7,30,30
1650782648513,MATH 109,A02,083214,Anzaldo; Leesa B,0,7,30,30
1650782648513,MATH 109,B01,083215,Anzaldo; Leesa B,0,8,30,30
1650782648513,MATH 109,B02,083216,Anzaldo; Leesa B,0,7,30,30
1650782654537,MATH 142A,A01,083219,Chow; Bennett,0,16,30,30
1650782654537,MATH 142A,A02,083220,Chow; Bennett,0,15,30,30
1650782654537,MATH 142A,B01,083221,Chow; Bennett,0,16,30,30
1650782654537,MATH 142A,B02,083222,Chow; Bennett,0,14,30,30
1650782660633,MATH 193A,A01,083224,Staff,0,6,30,30
1650782660633,MATH 193A,A02,083225,Staff,0,6,30,30
1650782660633,MATH 193A,A03,083781,Staff,0,6,30,30
1650782660633,MATH 193A,A04,083782,Staff,0,7,30,30
1650782666657,MATH 197,001,091859,McAuley; Julian John,9998,0,9999,1
1650782672708,COGS 9,A01,083615,Staff,0,17,60,60
1650782678743,COGS 11,A01,083617,Boyle; Mary E. T.,16,0,40,24
1650782684780,COGS 13,A01,083071,Staff,0,38,40,40
1650782690802,COGS 14A,A01,092681,Staff,0,36,100,100
1650782696824,COGS 14B,A01,083073,Cheng; Tzu-Han,0,12,50,50
1650782702853,COGS 17,A01,092677,Staff,11,0,75,64
1650782708901,COGS 100,A01,083619,Staff,0,29,60,60
1650782714927,COGS 101A,A01,083621,Davis; Joshua Daniel,0,28,60,60
1650782720951,COGS 101B,A01,091572,Staff,0,3,60,60
1650782726975,COGS 101C,A01,083625,Delgado; Tania,14,0,30,16
1650782733001,COGS 107A,A01,083627,Boyle; Mary E. T.,0,16,60,60
1650782739029,COGS 118A,A01,083075,Staff,0,8,60,60
1650782745058,CSE 3,A50,083646,Miranda; Gregory Joseph,18,0,38,20
1650782745058,CSE 3,A51,083647,Miranda; Gregory Joseph,36,0,37,1
1650782751087,CSE 8A,A50,083650,Miranda; Gregory Joseph,0,29,40,40
1650782757111,CSE 11,A01,083080,Cao; Yingjun,0,96,40,40
1650782763137,CSE 12,A01,083652,Staff,0,21,100,100
1650782769161,CSE 15L,A01,083654,Staff,0,3,50,50
1650782769161,CSE 15L,A02,083655,Staff,0,2,50,50
1650782775184,CSE 20,A01,083657,Staff,49,0,80,31
1650782781207,CSE 30,A01,083084,Eldon; John,0,75,40,40
1650782787228,CSE 100,A01,083659,Cao; Yingjun,0,71,50,50
1650782793256,CSE 134B,A01,083661,Powell; Thomas Allan,0,38,65,65
1650782799278,CSE 140,A01,083663,Staff,0,11,75,75
1650782805301,CSE 140L,A01,083088,Eldon; John,0,20,75,75
1650782811324,CSE 175,A01,083665,Kumar; Rakesh,7,0,25,18
1650782817346,CSE 190,A00,092507,Dubnov; Shlomo,10,0,20,10
1650782823373,ECE 45,A01,083139,Staff,0,1,60,60
1650782829400,ECE 65,A50,083695,Staff,0,5,30,30
1650782835423,ECE 109,A01,091882,Touri; Behrouz,32,0,70,38
1650782841449,ECE 180,A00,083140,Abi Samra; Nicholas Camill,20,0,30,10
1650782841449,ECE 180,B00,083141,Abi Samra; Nicholas Camill,0,0,30,30
1650782847473,MATH 10A,A01,083735,Patchell; Gregory David,2,0,30,28
1650782847473,MATH 10A,A02,083736,Patchell; Gregory David,27,0,30,3
1650782847473,MATH 10A,A03,083737,Patchell; Gregory David,24,0,30,6
1650782853499,MATH 10B,A01,083207,Staff,0,9,30,30
1650782853499,MATH 10B,A02,083208,Staff,0,6,30,30
1650782853499,MATH 10B,B01,083739,Staff,11,0,30,19
1650782853499,MATH 10B,B02,083740,Staff,28,0,30,2
1650782859538,MATH 18,A01,083743,Staff,0,0,30,30
1650782859538,MATH 18,A02,083744,Staff,23,0,30,7
1650782859538,MATH 18,A03,083745,Staff,21,0,30,9
1650782859538,MATH 18,A04,083746,Staff,26,0,30,4
1650782859538,MATH 18,B01,083748,Staff,0,15,30,30
1650782859538,MATH 18,B02,083749,Staff,0,12,30,30
1650782859538,MATH 18,B03,083750,Staff,0,12,30,30
1650782859538,MATH 18,B04,083751,Staff,0,12,30,30
1650782865565,MATH 20A,A01,083754,Staff,19,0,40,21
1650782871588,MATH 20B,A01,083756,Staff,0,13,30,30
1650782871588,MATH 20B,A02,083757,Staff,0,12,30,30
1650782877711,MATH 20C,A01,083760,Staff,0,17,30,30
1650782877711,MATH 20C,A02,083761,Staff,0,16,30,30
1650782877711,MATH 20C,B01,083762,Staff,9,0,30,21
1650782877711,MATH 20C,B02,083763,Staff,28,0,30,2
1650782883738,MATH 20D,A01,083765,Staff,2,1,30,28
1650782883738,MATH 20D,A02,083766,Staff,6,0,30,24
1650782883738,MATH 20D,A03,083767,Staff,24,0,30,6
1650782889761,MATH 20E,A01,083771,Staff,2,0,30,28
1650782889761,MATH 20E,A02,083772,Staff,15,0,30,15
1650782889761,MATH 20E,B01,083773,Staff,0,0,30,30
1650782889761,MATH 20E,B02,083774,Staff,5,0,30,25
1650782895783,MATH 103A,A01,083777,Staff,0,16,30,30
1650782895783,MATH 103A,A02,083778,Staff,0,15,30,30
1650782895783,MATH 103A,B01,083779,Staff,0,15,30,30
1650782895783,MATH 103A,B02,083780,Staff,0,15,30,30
1650782901808,MATH 105,A01,085443,Staff,0,22,30,30
1650782907837,MATH 109,A01,083213,Anzaldo; Leesa B,0,7,30,30
1650782907837,MATH 109,A02,083214,Anzaldo; Leesa B,0,7,30,30
1650782907837,MATH 109,B01,083215,Anzaldo; Leesa B,0,8,30,30
1650782907837,MATH 109,B02,083216,Anzaldo; Leesa B,0,7,30,30
1650782913861,MATH 142A,A01,083219,Chow; Bennett,0,16,30,30
1650782913861,MATH 142A,A02,083220,Chow; Bennett,0,15,30,30
1650782913861,MATH 142A,B01,083221,Chow; Bennett,0,16,30,30
1650782913861,MATH 142A,B02,083222,Chow; Bennett,0,14,30,30
1650782919885,MATH 193A,A01,083224,Staff,0,6,30,30
1650782919885,MATH 193A,A02,083225,Staff,0,6,30,30
1650782919885,MATH 193A,A03,083781,Staff,0,6,30,30
1650782919885,MATH 193A,A04,083782,Staff,0,7,30,30
1650782925919,MATH 197,001,091859,McAuley; Julian John,9998,0,9999,1
1650782931979,COGS 9,A01,083615,Staff,0,17,60,60
1650782938006,COGS 11,A01,083617,Boyle; Mary E. T.,16,0,40,24
1650782944031,COGS 13,A01,083071,Staff,0,38,40,40
1650782950058,COGS 14A,A01,092681,Staff,0,36,100,100
1650782956092,COGS 14B,A01,083073,Cheng; Tzu-Han,0,12,50,50
1650782962119,COGS 17,A01,092677,Staff,11,0,75,64
1650782968145,COGS 100,A01,083619,Staff,0,29,60,60
1650782974168,COGS 101A,A01,083621,Davis; Joshua Daniel,0,28,60,60
1650782980193,COGS 101B,A01,091572,Staff,0,3,60,60
1650782986217,COGS 101C,A01,083625,Delgado; Tania,14,0,30,16
1650782992242,COGS 107A,A01,083627,Boyle; Mary E. T.,0,16,60,60
1650782998276,COGS 118A,A01,083075,Staff,0,8,60,60
1650783004303,CSE 3,A50,083646,Miranda; Gregory Joseph,18,0,38,20
1650783004303,CSE 3,A51,083647,Miranda; Gregory Joseph,36,0,37,1
1650783010330,CSE 8A,A50,083650,Miranda; Gregory Joseph,0,29,40,40
1650783016354,CSE 11,A01,083080,Cao; Yingjun,0,96,40,40
1650783022379,CSE 12,A01,083652,Staff,0,21,100,100
1650783028403,CSE 15L,A01,083654,Staff,0,3,50,50
1650783028403,CSE 15L,A02,083655,Staff,0,2,50,50
1650783034436,CSE 20,A01,083657,Staff,49,0,80,31
1650783040461,CSE 30,A01,083084,Eldon; John,0,75,40,40
1650783046487,CSE 100,A01,083659,Cao; Yingjun,0,71,50,50
1650783052521,CSE 134B,A01,083661,Powell; Thomas Allan,0,38,65,65
1650783058547,CSE 140,A01,083663,Staff,0,11,75,75
1650783064572,CSE 140L,A01,083088,Eldon; John,0,20,75,75
1650783070602,CSE 175,A01,083665,Kumar; Rakesh,7,0,25,18
1650783076624,CSE 190,A00,092507,Dubnov; Shlomo,10,0,20,10
1650783082650,ECE 45,A01,083139,Staff,0,1,60,60
1650783088678,ECE 65,A50,083695,Staff,0,5,30,30
1650783094708,ECE 109,A01,091882,Touri; Behrouz,32,0,70,38
1650783100733,ECE 180,A00,083140,Abi Samra; Nicholas Camill,20,0,30,10
1650783100733,ECE 180,B00,083141,Abi Samra; Nicholas Camill,0,0,30,30
1650783106761,MATH 10A,A01,083735,Patchell; Gregory David,2,0,30,28
1650783106761,MATH 10A,A02,083736,Patchell; Gregory David,27,0,30,3
1650783106761,MATH 10A,A03,083737,Patchell; Gregory David,24,0,30,6
1650783112785,MATH 10B,A01,083207,Staff,0,9,30,30
1650783112785,MATH 10B,A02,083208,Staff,0,6,30,30
1650783112785,MATH 10B,B01,083739,Staff,11,0,30,19
1650783112785,MATH 10B,B02,083740,Staff,28,0,30,2
1650783118811,MATH 18,A01,083743,Staff,0,0,30,30
1650783118811,MATH 18,A02,083744,Staff,23,0,30,7
1650783118811,MATH 18,A03,083745,Staff,21,0,30,9
1650783118811,MATH 18,A04,083746,Staff,26,0,30,4
1650783118811,MATH 18,B01,083748,Staff,0,15,30,30
1650783118811,MATH 18,B02,083749,Staff,0,12,30,30
1650783118811,MATH 18,B03,083750,Staff,0,12,30,30
1650783118811,MATH 18,B04,083751,Staff,0,12,30,30
1650783124838,MATH 20A,A01,083754,Staff,19,0,40,21
1650783130864,MATH 20B,A01,083756,Staff,0,13,30,30
1650783130864,MATH 20B,A02,083757,Staff,0,12,30,30
1650783136890,MATH 20C,A01,083760,Staff,0,17,30,30
1650783136890,MATH 20C,A02,083761,Staff,0,16,30,30
1650783136890,MATH 20C,B01,083762,Staff,9,0,30,21
1650783136890,MATH 20C,B02,083763,Staff,28,0,30,2
1650783142920,MATH 20D,A01,083765,Staff,2,1,30,28
1650783142920,MATH 20D,A02,083766,Staff,6,0,30,24
1650783142920,MATH 20D,A03,083767,Staff,24,0,30,6
1650783148944,MATH 20E,A01,083771,Staff,2,0,30,28
1650783148944,MATH 20E,A02,083772,Staff,15,0,30,15
1650783148944,MATH 20E,B01,083773,Staff,0,0,30,30
1650783148944,MATH 20E,B02,083774,Staff,5,0,30,25
1650783154968,MATH 103A,A01,083777,Staff,0,16,30,30
1650783154968,MATH 103A,A02,083778,Staff,0,15,30,30
1650783154968,MATH 103A,B01,083779,Staff,0,15,30,30
1650783154968,MATH 103A,B02,083780,Staff,0,15,30,30
1650783160996,MATH 105,A01,085443,Staff,0,22,30,30
1650783167024,MATH 109,A01,083213,Anzaldo; Leesa B,0,7,30,30
1650783167024,MATH 109,A02,083214,Anzaldo; Leesa B,0,7,30,30
1650783167024,MATH 109,B01,083215,Anzaldo; Leesa B,0,8,30,30
1650783167024,MATH 109,B02,083216,Anzaldo; Leesa B,0,7,30,30
1650783173050,MATH 142A,A01,083219,Chow; Bennett,0,16,30,30
1650783173050,MATH 142A,A02,083220,Chow; Bennett,0,15,30,30
1650783173050,MATH 142A,B01,083221,Chow; Bennett,0,16,30,30
1650783173050,MATH 142A,B02,083222,Chow; Bennett,0,14,30,30
1650783179075,MATH 193A,A01,083224,Staff,0,6,30,30
1650783179075,MATH 193A,A02,083225,Staff,0,6,30,30
1650783179075,MATH 193A,A03,083781,Staff,0,6,30,30
1650783179075,MATH 193A,A04,083782,Staff,0,7,30,30
1650783185099,MATH 197,001,091859,McAuley; Julian John,9998,0,9999,1
1650783191161,COGS 9,A01,083615,Staff,0,17,60,60
1650783197186,COGS 11,A01,083617,Boyle; Mary E. T.,16,0,40,24
1650783203210,COGS 13,A01,083071,Staff,0,38,40,40
1650783209233,COGS 14A,A01,092681,Staff,0,36,100,100
1650783215262,COGS 14B,A01,083073,Cheng; Tzu-Han,0,12,50,50
1650783221286,COGS 17,A01,092677,Staff,11,0,75,64
1650783227315,COGS 100,A01,083619,Staff,0,29,60,60
1650783233339,COGS 101A,A01,083621,Davis; Joshua Daniel,0,28,60,60
1650783239362,COGS 101B,A01,091572,Staff,0,3,60,60
1650783245388,COGS 101C,A01,083625,Delgado; Tania,14,0,30,16
1650783251417,COGS 107A,A01,083627,Boyle; Mary E. T.,0,16,60,60
1650783257446,COGS 118A,A01,083075,Staff,0,8,60,60
1650783263474,CSE 3,A50,083646,Miranda; Gregory Joseph,18,0,38,20
1650783263474,CSE 3,A51,083647,Miranda; Gregory Joseph,36,0,37,1
1650783269497,CSE 8A,A50,083650,Miranda; Gregory Joseph,0,29,40,40
1650783275523,CSE 11,A01,083080,Cao; Yingjun,0,96,40,40
1650783281547,CSE 12,A01,083652,Staff,0,21,100,100
1650783287573,CSE 15L,A01,083654,Staff,0,3,50,50
1650783287573,CSE 15L,A02,083655,Staff,0,2,50,50
1650783293608,CSE 20,A01,083657,Staff,49,0,80,31
1650783299642,CSE 30,A01,083084,Eldon; John,0,75,40,40
1650783305665,CSE 100,A01,083659,Cao; Yingjun,0,71,50,50
1650783311693,CSE 134B,A01,083661,Powell; Thomas Allan,0,38,65,65
1650783317719,CSE 140,A01,083663,Staff,0,11,75,75
1650783323746,CSE 140L,A01,083088,Eldon; John,0,20,75,75
1650783329772,CSE 175,A01,083665,Kumar; Rakesh,7,0,25,18
1650783335799,CSE 190,A00,092507,Dubnov; Shlomo,10,0,20,10
1650783341826,ECE 45,A01,083139,Staff,0,1,60,60
1650783347854,ECE 65,A50,083695,Staff,0,5,30,30
1650783353879,ECE 109,A01,091882,Touri; Behrouz,32,0,70,38
1650783359906,ECE 180,A00,083140,Abi Samra; Nicholas Camill,20,0,30,10
1650783359906,ECE 180,B00,083141,Abi Samra; Nicholas Camill,0,0,30,30
1650783365932,MATH 10A,A01,083735,Patchell; Gregory David,2,0,30,28
1650783365932,MATH 10A,A02,083736,Patchell; Gregory David,27,0,30,3
1650783365932,MATH 10A,A03,083737,Patchell; Gregory David,24,0,30,6
1650783371957,MATH 10B,A01,083207,Staff,0,9,30,30
1650783371957,MATH 10B,A02,083208,Staff,0,6,30,30
1650783371957,MATH 10B,B01,083739,Staff,11,0,30,19
1650783371957,MATH 10B,B02,083740,Staff,28,0,30,2
1650783377983,MATH 18,A01,083743,Staff,0,0,30,30
1650783377983,MATH 18,A02,083744,Staff,23,0,30,7
1650783377983,MATH 18,A03,083745,Staff,21,0,30,9
1650783377983,MATH 18,A04,083746,Staff,26,0,30,4
1650783377983,MATH 18,B01,083748,Staff,0,15,30,30
1650783377983,MATH 18,B02,083749,Staff,0,12,30,30
1650783377983,MATH 18,B03,083750,Staff,0,12,30,30
1650783377983,MATH 18,B04,083751,Staff,0,12,30,30
1650783384008,MATH 20A,A01,083754,Staff,19,0,40,21
1650783390032,MATH 20B,A01,083756,Staff,0,13,30,30
1650783390032,MATH 20B,A02,083757,Staff,0,12,30,30
1650783396060,MATH 20C,A01,083760,Staff,0,17,30,30
1650783396060,MATH 20C,A02,083761,Staff,0,16,30,30
1650783396060,MATH 20C,B01,083762,Staff,9,0,30,21
1650783396060,MATH 20C,B02,083763,Staff,28,0,30,2
1650783402088,MATH 20D,A01,083765,Staff,2,1,30,28
1650783402088,MATH 20D,A02,083766,Staff,6,0,30,24
1650783402088,MATH 20D,A03,083767,Staff,24,0,30,6
1650783408112,MATH 20E,A01,083771,Staff,2,0,30,28
1650783408112,MATH 20E,A02,083772,Staff,15,0,30,15
1650783408112,MATH 20E,B01,083773,Staff,0,0,30,30
1650783408112,MATH 20E,B02,083774,Staff,5,0,30,25
1650783414137,MATH 103A,A01,083777,Staff,0,16,30,30
1650783414137,MATH 103A,A02,083778,Staff,0,15,30,30
1650783414137,MATH 103A,B01,083779,Staff,0,15,30,30
1650783414137,MATH 103A,B02,083780,Staff,0,15,30,30
1650783420167,MATH 105,A01,085443,Staff,0,22,30,30
1650783426192,MATH 109,A01,083213,Anzaldo; Leesa B,0,7,30,30
1650783426192,MATH 109,A02,083214,Anzaldo; Leesa B,0,7,30,30
1650783426192,MATH 109,B01,083215,Anzaldo; Leesa B,0,8,30,30
1650783426192,MATH 109,B02,083216,Anzaldo; Leesa B,0,7,30,30
1650783432222,MATH 142A,A01,083219,Chow; Bennett,0,16,30,30
1650783432222,MATH 142A,A02,083220,Chow; Bennett,0,15,30,30
1650783432222,MATH 142A,B01,083221,Chow; Bennett,0,16,30,30
1650783432222,MATH 142A,B02,083222,Chow; Bennett,0,14,30,30
1650783438250,MATH 193A,A01,083224,Staff,0,6,30,30
1650783438250,MATH 193A,A02,083225,Staff,0,6,30,30
1650783438250,MATH 193A,A03,083781,Staff,0,6,30,30
1650783438250,MATH 193A,A04,083782,Staff,0,7,30,30
1650783444274,MATH 197,001,091859,McAuley; Julian John,9998,0,9999,1
1650783450330,COGS 9,A01,083615,Staff,0,17,60,60
1650783456356,COGS 11,A01,083617,Boyle; Mary E. T.,16,0,40,24
1650783462380,COGS 13,A01,083071,Staff,0,38,40,40
1650783468482,COGS 14A,A01,092681,Staff,0,36,100,100
1650783474506,COGS 14B,A01,083073,Cheng; Tzu-Han,0,12,50,50
1650783480540,COGS 17,A01,092677,Staff,11,0,75,64
1650783486564,COGS 100,A01,083619,Staff,0,29,60,60
1650783492589,COGS 101A,A01,083621,Davis; Joshua Daniel,0,28,60,60
1650783498615,COGS 101B,A01,091572,Staff,0,3,60,60
1650783504642,COGS 101C,A01,083625,Delgado; Tania,14,0,30,16
1650783510670,COGS 107A,A01,083627,Boyle; Mary E. T.,0,16,60,60
1650783516704,COGS 118A,A01,083075,Staff,0,8,60,60
1650783522731,CSE 3,A50,083646,Miranda; Gregory Joseph,18,0,38,20
1650783522731,CSE 3,A51,083647,Miranda; Gregory Joseph,36,0,37,1
1650783528754,CSE 8A,A50,083650,Miranda; Gregory Joseph,0,29,40,40
1650783534780,CSE 11,A01,083080,Cao; Yingjun,0,96,40,40
1650783540806,CSE 12,A01,083652,Staff,0,21,100,100
1650783546832,CSE 15L,A01,083654,Staff,0,3,50,50
1650783546832,CSE 15L,A02,083655,Staff,0,2,50,50
1650783552856,CSE 20,A01,083657,Staff,49,0,80,31
1650783558890,CSE 30,A01,083084,Eldon; John,0,75,40,40
1650783564917,CSE 100,A01,083659,Cao; Yingjun,0,71,50,50
1650783570939,CSE 134B,A01,083661,Powell; Thomas Allan,0,38,65,65
1650783576963,CSE 140,A01,083663,Staff,0,11,75,75
1650783582990,CSE 140L,A01,083088,Eldon; John,0,20,75,75
1650783589022,CSE 175,A01,083665,Kumar; Rakesh,7,0,25,18
1650783595045,CSE 190,A00,092507,Dubnov; Shlomo,10,0,20,10
1650783601072,ECE 45,A01,083139,Staff,0,1,60,60
1650783607104,ECE 65,A50,083695,Staff,0,5,30,30
1650783613138,ECE 109,A01,091882,Touri; Behrouz,32,0,70,38
1650783619166,ECE 180,A00,083140,Abi Samra; Nicholas Camill,20,0,30,10
1650783619166,ECE 180,B00,083141,Abi Samra; Nicholas Camill,0,0,30,30
1650783625190,MATH 10A,A01,083735,Patchell; Gregory David,2,0,30,28
1650783625190,MATH 10A,A02,083736,Patchell; Gregory David,27,0,30,3
1650783625190,MATH 10A,A03,083737,Patchell; Gregory David,24,0,30,6
1650783631214,MATH 10B,A01,083207,Staff,0,9,30,30
1650783631214,MATH 10B,A02,083208,Staff,0,6,30,30
1650783631214,MATH 10B,B01,083739,Staff,11,0,30,19
1650783631214,MATH 10B,B02,083740,Staff,28,0,30,2
1650783637240,MATH 18,A01,083743,Staff,0,0,30,30
1650783637240,MATH 18,A02,083744,Staff,23,0,30,7
1650783637240,MATH 18,A03,083745,Staff,21,0,30,9
1650783637240,MATH 18,A04,083746,Staff,26,0,30,4
1650783637240,MATH 18,B01,083748,Staff,0,15,30,30
1650783637240,MATH 18,B02,083749,Staff,0,12,30,30
1650783637240,MATH 18,B03,083750,Staff,0,12,30,30
1650783637240,MATH 18,B04,083751,Staff,0,12,30,30
1650783643272,MATH 20A,A01,083754,Staff,19,0,40,21
1650783649295,MATH 20B,A01,083756,Staff,0,13,30,30
1650783649295,MATH 20B,A02,083757,Staff,0,12,30,30
1650783655320,MATH 20C,A01,083760,Staff,0,17,30,30
1650783655320,MATH 20C,A02,083761,Staff,0,16,30,30
1650783655320,MATH 20C,B01,083762,Staff,9,0,30,21
1650783655320,MATH 20C,B02,083763,Staff,28,0,30,2
1650783661343,MATH 20D,A01,083765,Staff,2,1,30,28
1650783661343,MATH 20D,A02,083766,Staff,6,0,30,24
1650783661343,MATH 20D,A03,083767,Staff,24,0,30,6
1650783667370,MATH 20E,A01,083771,Staff,2,0,30,28
1650783667370,MATH 20E,A02,083772,Staff,15,0,30,15
1650783667370,MATH 20E,B01,083773,Staff,0,0,30,30
1650783667370,MATH 20E,B02,083774,Staff,5,0,30,25
1650783673395,MATH 103A,A01,083777,Staff,0,16,30,30
1650783673395,MATH 103A,A02,083778,Staff,0,15,30,30
1650783673395,MATH 103A,B01,083779,Staff,0,15,30,30
1650783673395,MATH 103A,B02,083780,Staff,0,15,30,30
1650783679433,MATH 105,A01,085443,Staff,0,22,30,30
1650783685460,MATH 109,A01,083213,Anzaldo; Leesa B,0,7,30,30
1650783685460,MATH 109,A02,083214,Anzaldo; Leesa B,0,7,30,30
1650783685460,MATH 109,B01,083215,Anzaldo; Leesa B,0,8,30,30
1650783685460,MATH 109,B02,083216,Anzaldo; Leesa B,0,7,30,30
1650783691485,MATH 142A,A01,083219,Chow; Bennett,0,16,30,30
1650783691485,MATH 142A,A02,083220,Chow; Bennett,0,15,30,30
1650783691485,MATH 142A,B01,083221,Chow; Bennett,0,16,30,30
1650783691485,MATH 142A,B02,083222,Chow; Bennett,0,14,30,30
1650783697514,MATH 193A,A01,083224,Staff,0,6,30,30
1650783697514,MATH 193A,A02,083225,Staff,0,6,30,30
1650783697514,MATH 193A,A03,083781,Staff,0,6,30,30
1650783697514,MATH 193A,A04,083782,Staff,0,7,30,30
1650783703542,MATH 197,001,091859,McAuley; Julian John,9998,0,9999,1
1650783709608,COGS 9,A01,083615,Staff,0,17,60,60
1650783715641,COGS 11,A01,083617,Boyle; Mary E. T.,16,0,40,24
1650783721668,COGS 13,A01,083071,Staff,0,38,40,40
1650783727695,COGS 14A,A01,092681,Staff,0,36,100,100
1650783733719,COGS 14B,A01,083073,Cheng; Tzu-Han,0,12,50,50
1650783739743,COGS 17,A01,092677,Staff,11,0,75,64
1650783745771,COGS 100,A01,083619,Staff,0,29,60,60
1650783751797,COGS 101A,A01,083621,Davis; Joshua Daniel,0,28,60,60
1650783757824,COGS 101B,A01,091572,Staff,0,3,60,60
1650783763849,COGS 101C,A01,083625,Delgado; Tania,14,0,30,16
1650783769873,COGS 107A,A01,083627,Boyle; Mary E. T.,0,16,60,60
1650783775896,COGS 118A,A01,083075,Staff,0,8,60,60
1650783781922,CSE 3,A50,083646,Miranda; Gregory Joseph,18,0,38,20
1650783781922,CSE 3,A51,083647,Miranda; Gregory Joseph,36,0,37,1
1650783787946,CSE 8A,A50,083650,Miranda; Gregory Joseph,0,29,40,40
1650783793975,CSE 11,A01,083080,Cao; Yingjun,0,96,40,40
1650783800003,CSE 12,A01,083652,Staff,0,21,100,100
1650783806033,CSE 15L,A01,083654,Staff,0,3,50,50
1650783806033,CSE 15L,A02,083655,Staff,0,2,50,50
1650783812061,CSE 20,A01,083657,Staff,49,0,80,31
1650783818086,CSE 30,A01,083084,Eldon; John,0,75,40,40
1650783824120,CSE 100,A01,083659,Cao; Yingjun,0,71,50,50
1650783830143,CSE 134B,A01,083661,Powell; Thomas Allan,0,38,65,65
1650783836167,CSE 140,A01,083663,Staff,0,11,75,75
1650783842195,CSE 140L,A01,083088,Eldon; John,0,20,75,75
1650783848223,CSE 175,A01,083665,Kumar; Rakesh,7,0,25,18
1650783854250,CSE 190,A00,092507,Dubnov; Shlomo,10,0,20,10
1650783860274,ECE 45,A01,083139,Staff,0,1,60,60
1650783866299,ECE 65,A50,083695,Staff,0,5,30,30
1650783872323,ECE 109,A01,091882,Touri; Behrouz,32,0,70,38
1650783878360,ECE 180,A00,083140,Abi Samra; Nicholas Camill,20,0,30,10
1650783878360,ECE 180,B00,083141,Abi Samra; Nicholas Camill,0,0,30,30
1650783884389,MATH 10A,A01,083735,Patchell; Gregory David,2,0,30,28
1650783884389,MATH 10A,A02,083736,Patchell; Gregory David,27,0,30,3
1650783884389,MATH 10A,A03,083737,Patchell; Gregory David,24,0,30,6
1650783890412,MATH 10B,A01,083207,Staff,0,9,30,30
1650783890412,MATH 10B,A02,083208,Staff,0,6,30,30
1650783890412,MATH 10B,B01,083739,Staff,11,0,30,19
1650783890412,MATH 10B,B02,083740,Staff,28,0,30,2
1650783896438,MATH 18,A01,083743,Staff,0,0,30,30
1650783896438,MATH 18,A02,083744,Staff,23,0,30,7
1650783896438,MATH 18,A03,083745,Staff,21,0,30,9
1650783896438,MATH 18,A04,083746,Staff,26,0,30,4
1650783896438,MATH 18,B01,083748,Staff,0,15,30,30
1650783896438,MATH 18,B02,083749,Staff,0,12,30,30
1650783896438,MATH 18,B03,083750,Staff,0,12,30,30
1650783896438,MATH 18,B04,083751,Staff,0,12,30,30
1650783902462,MATH 20A,A01,083754,Staff,19,0,40,21
1650783908487,MATH 20B,A01,083756,Staff,0,13,30,30
1650783908487,MATH 20B,A02,083757,Staff,0,12,30,30
1650783914518,MATH 20C,A01,083760,Staff,0,17,30,30
1650783914518,MATH 20C,A02,083761,Staff,0,16,30,30
1650783914518,MATH 20C,B01,083762,Staff,9,0,30,21
1650783914518,MATH 20C,B02,083763,Staff,28,0,30,2
1650783920542,MATH 20D,A01,083765,Staff,2,1,30,28
1650783920542,MATH 20D,A02,083766,Staff,6,0,30,24
1650783920542,MATH 20D,A03,083767,Staff,24,0,30,6
1650783926582,MATH 20E,A01,083771,Staff,2,0,30,28
1650783926582,MATH 20E,A02,083772,Staff,15,0,30,15
1650783926582,MATH 20E,B01,083773,Staff,0,0,30,30
1650783926582,MATH 20E,B02,083774,Staff,5,0,30,25
1650783932605,MATH 103A,A01,083777,Staff,0,16,30,30
1650783932605,MATH 103A,A02,083778,Staff,0,15,30,30
1650783932605,MATH 103A,B01,083779,Staff,0,15,30,30
1650783932605,MATH 103A,B02,083780,Staff,0,15,30,30
1650783938630,MATH 105,A01,085443,Staff,0,22,30,30
1650783944656,MATH 109,A01,083213,Anzaldo; Leesa B,0,7,30,30
1650783944656,MATH 109,A02,083214,Anzaldo; Leesa B,0,7,30,30
1650783944656,MATH 109,B01,083215,Anzaldo; Leesa B,0,8,30,30
1650783944656,MATH 109,B02,083216,Anzaldo; Leesa B,0,7,30,30
1650783950685,MATH 142A,A01,083219,Chow; Bennett,0,16,30,30
1650783950685,MATH 142A,A02,083220,Chow; Bennett,0,15,30,30
1650783950685,MATH 142A,B01,083221,Chow; Bennett,0,16,30,30
1650783950685,MATH 142A,B02,083222,Chow; Bennett,0,14,30,30
1650783956714,MATH 193A,A01,083224,Staff,0,6,30,30
1650783956714,MATH 193A,A02,083225,Staff,0,6,30,30
1650783956714,MATH 193A,A03,083781,Staff,0,6,30,30
1650783956714,MATH 193A,A04,083782,Staff,0,7,30,30
1650783962738,MATH 197,001,091859,McAuley; Julian John,9998,0,9999,1
1650783968790,COGS 9,A01,083615,Staff,0,17,60,60
1650783974815,COGS 11,A01,083617,Boyle; Mary E. T.,16,0,40,24
1650783980840,COGS 13,A01,083071,Staff,0,38,40,40
1650783986863,COGS 14A,A01,092681,Staff,0,36,100,100
1650783992894,COGS 14B,A01,083073,Cheng; Tzu-Han,0,12,50,50
1650783998922,COGS 17,A01,092677,Staff,11,0,75,64
1650784004945,COGS 100,A01,083619,Staff,0,29,60,60
1650784010972,COGS 101A,A01,083621,Davis; Joshua Daniel,0,28,60,60
1650784017003,COGS 101B,A01,091572,Staff,0,3,60,60
1650784023033,COGS 101C,A01,083625,Delgado; Tania,14,0,30,16
1650784029058,COGS 107A,A01,083627,Boyle; Mary E. T.,0,16,60,60
1650784035082,COGS 118A,A01,083075,Staff,0,8,60,60
1650784041132,CSE 3,A50,083646,Miranda; Gregory Joseph,18,0,38,20
1650784041132,CSE 3,A51,083647,Miranda; Gregory Joseph,36,0,37,1
1650784047154,CSE 8A,A50,083650,Miranda; Gregory Joseph,0,29,40,40
1650784053180,CSE 11,A01,083080,Cao; Yingjun,0,96,40,40
1650784059207,CSE 12,A01,083652,Staff,0,21,100,100
1650784065326,CSE 15L,A01,083654,Staff,0,3,50,50
1650784065326,CSE 15L,A02,083655,Staff,0,2,50,50
1650784071350,CSE 20,A01,083657,Staff,49,0,80,31
1650784077379,CSE 30,A01,083084,Eldon; John,0,75,40,40
1650784083410,CSE 100,A01,083659,Cao; Yingjun,0,71,50,50
1650784089434,CSE 134B,A01,083661,Powell; Thomas Allan,0,38,65,65
1650784095457,CSE 140,A01,083663,Staff,0,11,75,75
1650784101484,CSE 140L,A01,083088,Eldon; John,0,20,75,75
1650784107505,CSE 175,A01,083665,Kumar; Rakesh,7,0,25,18
1650784113528,CSE 190,A00,092507,Dubnov; Shlomo,10,0,20,10
1650784119556,ECE 45,A01,083139,Staff,0,1,60,60
1650784125584,ECE 65,A50,083695,Staff,0,5,30,30
1650784131607,ECE 109,A01,091882,Touri; Behrouz,32,0,70,38
1650784137633,ECE 180,A00,083140,Abi Samra; Nicholas Camill,20,0,30,10
1650784137633,ECE 180,B00,083141,Abi Samra; Nicholas Camill,0,0,30,30
1650784143663,MATH 10A,A01,083735,Patchell; Gregory David,2,0,30,28
1650784143663,MATH 10A,A02,083736,Patchell; Gregory David,27,0,30,3
1650784143663,MATH 10A,A03,083737,Patchell; Gregory David,24,0,30,6
1650784149693,MATH 10B,A01,083207,Staff,0,9,30,30
1650784149693,MATH 10B,A02,083208,Staff,0,6,30,30
1650784149693,MATH 10B,B01,083739,Staff,11,0,30,19
1650784149693,MATH 10B,B02,083740,Staff,28,0,30,2
1650784155722,MATH 18,A01,083743,Staff,0,0,30,30
1650784155722,MATH 18,A02,083744,Staff,23,0,30,7
1650784155722,MATH 18,A03,083745,Staff,21,0,30,9
1650784155722,MATH 18,A04,083746,Staff,26,0,30,4
1650784155722,MATH 18,B01,083748,Staff,0,15,30,30
1650784155722,MATH 18,B02,083749,Staff,0,12,30,30
1650784155722,MATH 18,B03,083750,Staff,0,12,30,30
1650784155722,MATH 18,B04,083751,Staff,0,12,30,30
1650784161750,MATH 20A,A01,083754,Staff,19,0,40,21
1650784167781,MATH 20B,A01,083756,Staff,0,13,30,30
1650784167781,MATH 20B,A02,083757,Staff,0,12,30,30
1650784173803,MATH 20C,A01,083760,Staff,0,17,30,30
1650784173803,MATH 20C,A02,083761,Staff,0,16,30,30
1650784173803,MATH 20C,B01,083762,Staff,9,0,30,21
1650784173803,MATH 20C,B02,083763,Staff,28,0,30,2
1650784179831,MATH 20D,A01,083765,Staff,2,1,30,28
1650784179831,MATH 20D,A02,083766,Staff,6,0,30,24
1650784179831,MATH 20D,A03,083767,Staff,24,0,30,6
1650784185856,MATH 20E,A01,083771,Staff,2,0,30,28
1650784185856,MATH 20E,A02,083772,Staff,15,0,30,15
1650784185856,MATH 20E,B01,083773,Staff,0,0,30,30
1650784185856,MATH 20E,B02,083774,Staff,5,0,30,25
1650784191885,MATH 103A,A01,083777,Staff,0,16,30,30
1650784191885,MATH 103A,A02,083778,Staff,0,15,30,30
1650784191885,MATH 103A,B01,083779,Staff,0,15,30,30
1650784191885,MATH 103A,B02,083780,Staff,0,15,30,30
1650784197912,MATH 105,A01,085443,Staff,0,22,30,30
1650784203942,MATH 109,A01,083213,Anzaldo; Leesa B,0,7,30,30
1650784203942,MATH 109,A02,083214,Anzaldo; Leesa B,0,7,30,30
1650784203942,MATH 109,B01,083215,Anzaldo; Leesa B,0,8,30,30
1650784203942,MATH 109,B02,083216,Anzaldo; Leesa B,0,7,30,30
1650784209971,MATH 142A,A01,083219,Chow; Bennett,0,16,30,30
1650784209971,MATH 142A,A02,083220,Chow; Bennett,0,15,30,30
1650784209971,MATH 142A,B01,083221,Chow; Bennett,0,16,30,30
1650784209971,MATH 142A,B02,083222,Chow; Bennett,0,14,30,30
1650784215994,MATH 193A,A01,083224,Staff,0,6,30,30
1650784215994,MATH 193A,A02,083225,Staff,0,6,30,30
1650784215994,MATH 193A,A03,083781,Staff,0,6,30,30
1650784215994,MATH 193A,A04,083782,Staff,0,7,30,30
1650784222018,MATH 197,001,091859,McAuley; Julian John,9998,0,9999,1
1650784228084,COGS 9,A01,083615,Staff,0,17,60,60
1650784234109,COGS 11,A01,083617,Boyle; Mary E. T.,16,0,40,24
1650784240136,COGS 13,A01,083071,Staff,0,38,40,40
1650784246163,COGS 14A,A01,092681,Staff,0,36,100,100
1650784252194,COGS 14B,A01,083073,Cheng; Tzu-Han,0,12,50,50
1650784258221,COGS 17,A01,092677,Staff,11,0,75,64
1650784264250,COGS 100,A01,083619,Staff,0,29,60,60
1650784270279,COGS 101A,A01,083621,Davis; Joshua Daniel,0,28,60,60
1650784276314,COGS 101B,A01,091572,Staff,0,3,60,60
1650784282356,COGS 101C,A01,083625,Delgado; Tania,14,0,30,16
1650784288382,COGS 107A,A01,083627,Boyle; Mary E. T.,0,16,60,60
1650784294411,COGS 118A,A01,083075,Staff,0,8,60,60
1650784300441,CSE 3,A50,083646,Miranda; Gregory Joseph,18,0,38,20
1650784300441,CSE 3,A51,083647,Miranda; Gregory Joseph,36,0,37,1
1650784306470,CSE 8A,A50,083650,Miranda; Gregory Joseph,0,29,40,40
1650784312511,CSE 11,A01,083080,Cao; Yingjun,0,96,40,40
1650784318536,CSE 12,A01,083652,Staff,0,21,100,100
1650784324562,CSE 15L,A01,083654,Staff,0,3,50,50
1650784324562,CSE 15L,A02,083655,Staff,0,2,50,50
1650784330588,CSE 20,A01,083657,Staff,49,0,80,31
1650784336614,CSE 30,A01,083084,Eldon; John,0,75,40,40
1650784342637,CSE 100,A01,083659,Cao; Yingjun,0,71,50,50
1650784348667,CSE 134B,A01,083661,Powell; Thomas Allan,0,38,65,65
1650784354709,CSE 140,A01,083663,Staff,0,11,75,75
1650784360735,CSE 140L,A01,083088,Eldon; John,0,20,75,75
1650784366767,CSE 175,A01,083665,Kumar; Rakesh,7,0,25,18
1650784372792,CSE 190,A00,092507,Dubnov; Shlomo,10,0,20,10
1650784378820,ECE 45,A01,083139,Staff,0,1,60,60
1650784384851,ECE 65,A50,083695,Staff,0,5,30,30
1650784390882,ECE 109,A01,091882,Touri; Behrouz,32,0,70,38
1650784396915,ECE 180,A00,083140,Abi Samra; Nicholas Camill,20,0,30,10
1650784396915,ECE 180,B00,083141,Abi Samra; Nicholas Camill,0,0,30,30
1650784402958,MATH 10A,A01,083735,Patchell; Gregory David,2,0,30,28
1650784402958,MATH 10A,A02,083736,Patchell; Gregory David,27,0,30,3
1650784402958,MATH 10A,A03,083737,Patchell; Gregory David,24,0,30,6
1650784408983,MATH 10B,A01,083207,Staff,0,9,30,30
1650784408983,MATH 10B,A02,083208,Staff,0,6,30,30
1650784408983,MATH 10B,B01,083739,Staff,11,0,30,19
1650784408983,MATH 10B,B02,083740,Staff,28,0,30,2
1650784415017,MATH 18,A01,083743,Staff,0,0,30,30
1650784415017,MATH 18,A02,083744,Staff,23,0,30,7
1650784415017,MATH 18,A03,083745,Staff,21,0,30,9
1650784415017,MATH 18,A04,083746,Staff,26,0,30,4
1650784415017,MATH 18,B01,083748,Staff,0,15,30,30
1650784415017,MATH 18,B02,083749,Staff,0,12,30,30
1650784415017,MATH 18,B03,083750,Staff,0,12,30,30
1650784415017,MATH 18,B04,083751,Staff,0,12,30,30
1650784421042,MATH 20A,A01,083754,Staff,19,0,40,21
1650784427064,MATH 20B,A01,083756,Staff,0,13,30,30
1650784427064,MATH 20B,A02,083757,Staff,0,12,30,30
1650784433089,MATH 20C,A01,083760,Staff,0,17,30,30
1650784433089,MATH 20C,A02,083761,Staff,0,16,30,30
1650784433089,MATH 20C,B01,083762,Staff,9,0,30,21
1650784433089,MATH 20C,B02,083763,Staff,28,0,30,2
1650784439129,MATH 20D,A01,083765,Staff,2,1,30,28
1650784439129,MATH 20D,A02,083766,Staff,6,0,30,24
1650784439129,MATH 20D,A03,083767,Staff,24,0,30,6
1650784445183,MATH 20E,A01,083771,Staff,2,0,30,28
1650784445183,MATH 20E,A02,083772,Staff,15,0,30,15
1650784445183,MATH 20E,B01,083773,Staff,0,0,30,30
1650784445183,MATH 20E,B02,083774,Staff,5,0,30,25
1650784451214,MATH 103A,A01,083777,Staff,0,16,30,30
1650784451214,MATH 103A,A02,083778,Staff,0,15,30,30
1650784451214,MATH 103A,B01,083779,Staff,0,15,30,30
1650784451214,MATH 103A,B02,083780,Staff,0,15,30,30
1650784457239,MATH 105,A01,085443,Staff,0,22,30,30
1650784463272,MATH 109,A01,083213,Anzaldo; Leesa B,0,7,30,30
1650784463272,MATH 109,A02,083214,Anzaldo; Leesa B,0,7,30,30
1650784463272,MATH 109,B01,083215,Anzaldo; Leesa B,0,8,30,30
1650784463272,MATH 109,B02,083216,Anzaldo; Leesa B,0,7,30,30
1650784469303,MATH 142A,A01,083219,Chow; Bennett,0,16,30,30
1650784469303,MATH 142A,A02,083220,Chow; Bennett,0,15,30,30
1650784469303,MATH 142A,B01,083221,Chow; Bennett,0,16,30,30
1650784469303,MATH 142A,B02,083222,Chow; Bennett,0,14,30,30
1650784475329,MATH 193A,A01,083224,Staff,0,6,30,30
1650784475329,MATH 193A,A02,083225,Staff,0,6,30,30
1650784475329,MATH 193A,A03,083781,Staff,0,6,30,30
1650784475329,MATH 193A,A04,083782,Staff,0,7,30,30
1650784481354,MATH 197,001,091859,McAuley; Julian John,9998,0,9999,1
1650784487412,COGS 9,A01,083615,Staff,0,17,60,60
1650784493437,COGS 11,A01,083617,Boyle; Mary E. T.,16,0,40,24
1650784499465,COGS 13,A01,083071,Staff,0,38,40,40
1650784505504,COGS 14A,A01,092681,Staff,0,36,100,100
1650784511530,COGS 14B,A01,083073,Cheng; Tzu-Han,0,12,50,50
1650784517553,COGS 17,A01,092677,Staff,11,0,75,64
1650784523578,COGS 100,A01,083619,Staff,0,29,60,60
1650784529602,COGS 101A,A01,083621,Davis; Joshua Daniel,0,28,60,60
1650784535633,COGS 101B,A01,091572,Staff,0,3,60,60
1650784541657,COGS 101C,A01,083625,Delgado; Tania,14,0,30,16
1650784547682,COGS 107A,A01,083627,Boyle; Mary E. T.,0,16,60,60
1650784553722,COGS 118A,A01,083075,Staff,0,8,60,60
1650784559749,CSE 3,A50,083646,Miranda; Gregory Joseph,18,0,38,20
1650784559749,CSE 3,A51,083647,Miranda; Gregory Joseph,36,0,37,1
1650784565785,CSE 8A,A50,083650,Miranda; Gregory Joseph,0,29,40,40
1650784571814,CSE 11,A01,083080,Cao; Yingjun,0,96,40,40
1650784577840,CSE 12,A01,083652,Staff,0,21,100,100
1650784583868,CSE 15L,A01,083654,Staff,0,3,50,50
1650784583868,CSE 15L,A02,083655,Staff,0,2,50,50
1650784589894,CSE 20,A01,083657,Staff,49,0,80,31
1650784595932,CSE 30,A01,083084,Eldon; John,0,75,40,40
1650784601957,CSE 100,A01,083659,Cao; Yingjun,0,71,50,50
1650784608012,CSE 134B,A01,083661,Powell; Thomas Allan,0,38,65,65
1650784614040,CSE 140,A01,083663,Staff,0,11,75,75
1650784620087,CSE 140L,A01,083088,Eldon; John,0,20,75,75
1650784626115,CSE 175,A01,083665,Kumar; Rakesh,7,0,25,18
1650784632149,CSE 190,A00,092507,Dubnov; Shlomo,10,0,20,10
1650784638174,ECE 45,A01,083139,Staff,0,1,60,60
1650784644205,ECE 65,A50,083695,Staff,0,5,30,30
1650784650248,ECE 109,A01,091882,Touri; Behrouz,32,0,70,38
1650784656275,ECE 180,A00,083140,Abi Samra; Nicholas Camill,20,0,30,10
1650784656275,ECE 180,B00,083141,Abi Samra; Nicholas Camill,0,0,30,30
1650784662373,MATH 10A,A01,083735,Patchell; Gregory David,2,0,30,28
1650784662373,MATH 10A,A02,083736,Patchell; Gregory David,27,0,30,3
1650784662373,MATH 10A,A03,083737,Patchell; Gregory David,24,0,30,6
1650784668403,MATH 10B,A01,083207,Staff,0,9,30,30
1650784668403,MATH 10B,A02,083208,Staff,0,6,30,30
1650784668403,MATH 10B,B01,083739,Staff,11,0,30,19
1650784668403,MATH 10B,B02,083740,Staff,28,0,30,2
1650784674432,MATH 18,A01,083743,Staff,0,0,30,30
1650784674432,MATH 18,A02,083744,Staff,23,0,30,7
1650784674432,MATH 18,A03,083745,Staff,21,0,30,9
1650784674432,MATH 18,A04,083746,Staff,26,0,30,4
1650784674432,MATH 18,B01,083748,Staff,0,15,30,30
1650784674432,MATH 18,B02,083749,Staff,0,12,30,30
1650784674432,MATH 18,B03,083750,Staff,0,12,30,30
1650784674432,MATH 18,B04,083751,Staff,0,12,30,30
1650784680462,MATH 20A,A01,083754,Staff,19,0,40,21
1650784686493,MATH 20B,A01,083756,Staff,0,13,30,30
1650784686493,MATH 20B,A02,083757,Staff,0,12,30,30
1650784692515,MATH 20C,A01,083760,Staff,0,17,30,30
1650784692515,MATH 20C,A02,083761,Staff,0,16,30,30
1650784692515,MATH 20C,B01,083762,Staff,9,0,30,21
1650784692515,MATH 20C,B02,083763,Staff,28,0,30,2
1650784698540,MATH 20D,A01,083765,Staff,2,1,30,28
1650784698540,MATH 20D,A02,083766,Staff,6,0,30,24
1650784698540,MATH 20D,A03,083767,Staff,24,0,30,6
1650784704565,MATH 20E,A01,083771,Staff,2,0,30,28
1650784704565,MATH 20E,A02,083772,Staff,15,0,30,15
1650784704565,MATH 20E,B01,083773,Staff,0,0,30,30
1650784704565,MATH 20E,B02,083774,Staff,5,0,30,25
1650784710594,MATH 103A,A01,083777,Staff,0,16,30,30
1650784710594,MATH 103A,A02,083778,Staff,0,15,30,30
1650784710594,MATH 103A,B01,083779,Staff,0,15,30,30
1650784710594,MATH 103A,B02,083780,Staff,0,15,30,30
1650784716616,MATH 105,A01,085443,Staff,0,22,30,30
1650784722648,MATH 109,A01,083213,Anzaldo; Leesa B,0,7,30,30
1650784722648,MATH 109,A02,083214,Anzaldo; Leesa B,0,7,30,30
1650784722648,MATH 109,B01,083215,Anzaldo; Leesa B,0,8,30,30
1650784722648,MATH 109,B02,083216,Anzaldo; Leesa B,0,7,30,30
1650784728678,MATH 142A,A01,083219,Chow; Bennett,0,16,30,30
1650784728678,MATH 142A,A02,083220,Chow; Bennett,0,15,30,30
1650784728678,MATH 142A,B01,083221,Chow; Bennett,0,16,30,30
1650784728678,MATH 142A,B02,083222,Chow; Bennett,0,14,30,30
1650784734703,MATH 193A,A01,083224,Staff,0,6,30,30
1650784734703,MATH 193A,A02,083225,Staff,0,6,30,30
1650784734703,MATH 193A,A03,083781,Staff,0,6,30,30
1650784734703,MATH 193A,A04,083782,Staff,0,7,30,30
1650784740725,MATH 197,001,091859,McAuley; Julian John,9998,0,9999,1
1650784746790,COGS 9,A01,083615,Staff,0,17,60,60
1650784752826,COGS 11,A01,083617,Boyle; Mary E. T.,16,0,40,24
1650784758866,COGS 13,A01,083071,Staff,0,38,40,40
1650784764894,COGS 14A,A01,092681,Staff,0,36,100,100
1650784770920,COGS 14B,A01,083073,Cheng; Tzu-Han,0,12,50,50
1650784776945,COGS 17,A01,092677,Staff,11,0,75,64
1650784782968,COGS 100,A01,083619,Staff,0,29,60,60
1650784788996,COGS 101A,A01,083621,Davis; Joshua Daniel,0,28,60,60
1650784795026,COGS 101B,A01,091572,Staff,0,3,60,60
1650784801053,COGS 101C,A01,083625,Delgado; Tania,14,0,30,16
1650784807080,COGS 107A,A01,083627,Boyle; Mary E. T.,0,16,60,60
1650784813110,COGS 118A,A01,083075,Staff,0,8,60,60
1650784819145,CSE 3,A50,083646,Miranda; Gregory Joseph,18,0,38,20
1650784819145,CSE 3,A51,083647,Miranda; Gregory Joseph,36,0,37,1
1650784825188,CSE 8A,A50,083650,Miranda; Gregory Joseph,0,29,40,40
1650784831216,CSE 11,A01,083080,Cao; Yingjun,0,96,40,40
1650784837242,CSE 12,A01,083652,Staff,0,21,100,100
1650784843269,CSE 15L,A01,083654,Staff,0,3,50,50
1650784843269,CSE 15L,A02,083655,Staff,0,2,50,50
1650784849292,CSE 20,A01,083657,Staff,49,0,80,31
1650784855324,CSE 30,A01,083084,Eldon; John,0,75,40,40
1650784861360,CSE 100,A01,083659,Cao; Yingjun,0,71,50,50
1650784867386,CSE 134B,A01,083661,Powell; Thomas Allan,0,38,65,65
1650784873410,CSE 140,A01,083663,Staff,0,11,75,75
1650784879435,CSE 140L,A01,083088,Eldon; John,0,20,75,75
1650784885461,CSE 175,A01,083665,Kumar; Rakesh,7,0,25,18
1650784891489,CSE 190,A00,092507,Dubnov; Shlomo,10,0,20,10
1650784897513,ECE 45,A01,083139,Staff,0,1,60,60
1650784903558,ECE 65,A50,083695,Staff,0,5,30,30
1650784909593,ECE 109,A01,091882,Touri; Behrouz,32,0,70,38
1650784915628,ECE 180,A00,083140,Abi Samra; Nicholas Camill,20,0,30,10
1650784915628,ECE 180,B00,083141,Abi Samra; Nicholas Camill,0,0,30,30
1650784921654,MATH 10A,A01,083735,Patchell; Gregory David,2,0,30,28
1650784921654,MATH 10A,A02,083736,Patchell; Gregory David,27,0,30,3
1650784921654,MATH 10A,A03,083737,Patchell; Gregory David,24,0,30,6
1650784927681,MATH 10B,A01,083207,Staff,0,9,30,30
1650784927681,MATH 10B,A02,083208,Staff,0,6,30,30
1650784927681,MATH 10B,B01,083739,Staff,11,0,30,19
1650784927681,MATH 10B,B02,083740,Staff,28,0,30,2
1650784933707,MATH 18,A01,083743,Staff,0,0,30,30
1650784933707,MATH 18,A02,083744,Staff,23,0,30,7
1650784933707,MATH 18,A03,083745,Staff,21,0,30,9
1650784933707,MATH 18,A04,083746,Staff,26,0,30,4
1650784933707,MATH 18,B01,083748,Staff,0,15,30,30
1650784933707,MATH 18,B02,083749,Staff,0,12,30,30
1650784933707,MATH 18,B03,083750,Staff,0,12,30,30
1650784933707,MATH 18,B04,083751,Staff,0,12,30,30
1650784939731,MATH 20A,A01,083754,Staff,19,0,40,21
1650784945756,MATH 20B,A01,083756,Staff,0,13,30,30
1650784945756,MATH 20B,A02,083757,Staff,0,12,30,30
1650784951782,MATH 20C,A01,083760,Staff,0,17,30,30
1650784951782,MATH 20C,A02,083761,Staff,0,16,30,30
1650784951782,MATH 20C,B01,083762,Staff,9,0,30,21
1650784951782,MATH 20C,B02,083763,Staff,28,0,30,2
1650784957805,MATH 20D,A01,083765,Staff,2,1,30,28
1650784957805,MATH 20D,A02,083766,Staff,6,0,30,24
1650784957805,MATH 20D,A03,083767,Staff,24,0,30,6
1650784963829,MATH 20E,A01,083771,Staff,2,0,30,28
1650784963829,MATH 20E,A02,083772,Staff,15,0,30,15
1650784963829,MATH 20E,B01,083773,Staff,0,0,30,30
1650784963829,MATH 20E,B02,083774,Staff,5,0,30,25
1650784969867,MATH 103A,A01,083777,Staff,0,16,30,30
1650784969867,MATH 103A,A02,083778,Staff,0,15,30,30
1650784969867,MATH 103A,B01,083779,Staff,0,15,30,30
1650784969867,MATH 103A,B02,083780,Staff,0,15,30,30
1650784975892,MATH 105,A01,085443,Staff,0,22,30,30
1650784981921,MATH 109,A01,083213,Anzaldo; Leesa B,0,7,30,30
1650784981921,MATH 109,A02,083214,Anzaldo; Leesa B,0,7,30,30
1650784981921,MATH 109,B01,083215,Anzaldo; Leesa B,0,8,30,30
1650784981921,MATH 109,B02,083216,Anzaldo; Leesa B,0,7,30,30
1650784987951,MATH 142A,A01,083219,Chow; Bennett,0,16,30,30
1650784987951,MATH 142A,A02,083220,Chow; Bennett,0,15,30,30
1650784987951,MATH 142A,B01,083221,Chow; Bennett,0,16,30,30
1650784987951,MATH 142A,B02,083222,Chow; Bennett,0,14,30,30
1650784993977,MATH 193A,A01,083224,Staff,0,6,30,30
1650784993977,MATH 193A,A02,083225,Staff,0,6,30,30
1650784993977,MATH 193A,A03,083781,Staff,0,6,30,30
1650784993977,MATH 193A,A04,083782,Staff,0,7,30,30
1650784999999,MATH 197,001,091859,McAuley; Julian John,9998,0,9999,1
1650785006072,COGS 9,A01,083615,Staff,0,17,60,60
1650785012100,COGS 11,A01,083617,Boyle; Mary E. T.,16,0,40,24
1650785018125,COGS 13,A01,083071,Staff,0,38,40,40
1650785024153,COGS 14A,A01,092681,Staff,0,36,100,100
1650785030181,COGS 14B,A01,083073,Cheng; Tzu-Han,0,12,50,50
1650785036219,COGS 17,A01,092677,Staff,11,0,75,64
1650785042244,COGS 100,A01,083619,Staff,0,29,60,60
1650785048289,COGS 101A,A01,083621,Davis; Joshua Daniel,0,28,60,60
1650785054316,COGS 101B,A01,091572,Staff,0,3,60,60
1650785060341,COGS 101C,A01,083625,Delgado; Tania,14,0,30,16
1650785066366,COGS 107A,A01,083627,Boyle; Mary E. T.,0,16,60,60
1650785072394,COGS 118A,A01,083075,Staff,0,8,60,60
1650785078418,CSE 3,A50,083646,Miranda; Gregory Joseph,18,0,38,20
1650785078418,CSE 3,A51,083647,Miranda; Gregory Joseph,36,0,37,1
1650785084448,CSE 8A,A50,083650,Miranda; Gregory Joseph,0,29,40,40
1650785090475,CSE 11,A01,083080,Cao; Yingjun,0,96,40,40
1650785096505,CSE 12,A01,083652,Staff,0,21,100,100
1650785102531,CSE 15L,A01,083654,Staff,0,3,50,50
1650785102531,CSE 15L,A02,083655,Staff,0,2,50,50
1650785108560,CSE 20,A01,083657,Staff,49,0,80,31
1650785114589,CSE 30,A01,083084,Eldon; John,0,75,40,40
1650785120617,CSE 100,A01,083659,Cao; Yingjun,0,71,50,50
1650785126641,CSE 134B,A01,083661,Powell; Thomas Allan,0,38,65,65
1650785132664,CSE 140,A01,083663,Staff,0,11,75,75
1650785138693,CSE 140L,A01,083088,Eldon; John,0,20,75,75
1650785144720,CSE 175,A01,083665,Kumar; Rakesh,7,0,25,18
1650785150750,CSE 190,A00,092507,Dubnov; Shlomo,10,0,20,10
1650785156781,ECE 45,A01,083139,Staff,0,1,60,60
1650785162806,ECE 65,A50,083695,Staff,0,5,30,30
1650785168837,ECE 109,A01,091882,Touri; Behrouz,32,0,70,38
1650785174862,ECE 180,A00,083140,Abi Samra; Nicholas Camill,20,0,30,10
1650785174862,ECE 180,B00,083141,Abi Samra; Nicholas Camill,0,0,30,30
1650785180888,MATH 10A,A01,083735,Patchell; Gregory David,2,0,30,28
1650785180888,MATH 10A,A02,083736,Patchell; Gregory David,27,0,30,3
1650785180888,MATH 10A,A03,083737,Patchell; Gregory David,24,0,30,6
1650785186918,MATH 10B,A01,083207,Staff,0,9,30,30
1650785186918,MATH 10B,A02,083208,Staff,0,6,30,30
1650785186918,MATH 10B,B01,083739,Staff,11,0,30,19
1650785186918,MATH 10B,B02,083740,Staff,28,0,30,2
1650785192952,MATH 18,A01,083743,Staff,0,0,30,30
1650785192952,MATH 18,A02,083744,Staff,23,0,30,7
1650785192952,MATH 18,A03,083745,Staff,21,0,30,9
1650785192952,MATH 18,A04,083746,Staff,26,0,30,4
1650785192952,MATH 18,B01,083748,Staff,0,15,30,30
1650785192952,MATH 18,B02,083749,Staff,0,12,30,30
1650785192952,MATH 18,B03,083750,Staff,0,12,30,30
1650785192952,MATH 18,B04,083751,Staff,0,12,30,30
1650785198977,MATH 20A,A01,083754,Staff,19,0,40,21
1650785205002,MATH 20B,A01,083756,Staff,0,13,30,30
1650785205002,MATH 20B,A02,083757,Staff,0,12,30,30
1650785211026,MATH 20C,A01,083760,Staff,0,17,30,30
1650785211026,MATH 20C,A02,083761,Staff,0,16,30,30
1650785211026,MATH 20C,B01,083762,Staff,9,0,30,21
1650785211026,MATH 20C,B02,083763,Staff,28,0,30,2
1650785217056,MATH 20D,A01,083765,Staff,2,1,30,28
1650785217056,MATH 20D,A02,083766,Staff,6,0,30,24
1650785217056,MATH 20D,A03,083767,Staff,24,0,30,6
1650785223083,MATH 20E,A01,083771,Staff,2,0,30,28
1650785223083,MATH 20E,A02,083772,Staff,15,0,30,15
1650785223083,MATH 20E,B01,083773,Staff,0,0,30,30
1650785223083,MATH 20E,B02,083774,Staff,5,0,30,25
1650785229115,MATH 103A,A01,083777,Staff,0,16,30,30
1650785229115,MATH 103A,A02,083778,Staff,0,15,30,30
1650785229115,MATH 103A,B01,083779,Staff,0,15,30,30
1650785229115,MATH 103A,B02,083780,Staff,0,15,30,30
1650785235139,MATH 105,A01,085443,Staff,0,22,30,30
1650785241164,MATH 109,A01,083213,Anzaldo; Leesa B,0,7,30,30
1650785241164,MATH 109,A02,083214,Anzaldo; Leesa B,0,7,30,30
1650785241164,MATH 109,B01,083215,Anzaldo; Leesa B,0,8,30,30
1650785241164,MATH 109,B02,083216,Anzaldo; Leesa B,0,7,30,30
1650785247211,MATH 142A,A01,083219,Chow; Bennett,0,16,30,30
1650785247211,MATH 142A,A02,083220,Chow; Bennett,0,15,30,30
1650785247211,MATH 142A,B01,083221,Chow; Bennett,0,16,30,30
1650785247211,MATH 142A,B02,083222,Chow; Bennett,0,14,30,30
1650785253237,MATH 193A,A01,083224,Staff,0,6,30,30
1650785253237,MATH 193A,A02,083225,Staff,0,6,30,30
1650785253237,MATH 193A,A03,083781,Staff,0,6,30,30
1650785253237,MATH 193A,A04,083782,Staff,0,7,30,30
1650785259332,MATH 197,001,091859,McAuley; Julian John,9998,0,9999,1
1650785265402,COGS 9,A01,083615,Staff,0,17,60,60
1650785271443,COGS 11,A01,083617,Boyle; Mary E. T.,16,0,40,24
1650785277467,COGS 13,A01,083071,Staff,0,38,40,40
1650785283491,COGS 14A,A01,092681,Staff,0,36,100,100
1650785289519,COGS 14B,A01,083073,Cheng; Tzu-Han,0,12,50,50
1650785295549,COGS 17,A01,092677,Staff,11,0,75,64
1650785301587,COGS 100,A01,083619,Staff,0,29,60,60
1650785307609,COGS 101A,A01,083621,Davis; Joshua Daniel,0,28,60,60
1650785313633,COGS 101B,A01,091572,Staff,0,3,60,60
1650785319661,COGS 101C,A01,083625,Delgado; Tania,14,0,30,16
1650785325686,COGS 107A,A01,083627,Boyle; Mary E. T.,0,16,60,60
1650785331709,COGS 118A,A01,083075,Staff,0,8,60,60
1650785337732,CSE 3,A50,083646,Miranda; Gregory Joseph,18,0,38,20
1650785337732,CSE 3,A51,083647,Miranda; Gregory Joseph,36,0,37,1
1650785343757,CSE 8A,A50,083650,Miranda; Gregory Joseph,0,29,40,40
1650785349788,CSE 11,A01,083080,Cao; Yingjun,0,96,40,40
1650785355817,CSE 12,A01,083652,Staff,0,21,100,100
1650785361847,CSE 15L,A01,083654,Staff,0,3,50,50
1650785361847,CSE 15L,A02,083655,Staff,0,2,50,50
1650785367871,CSE 20,A01,083657,Staff,49,0,80,31
1650785373896,CSE 30,A01,083084,Eldon; John,0,75,40,40
1650785379922,CSE 100,A01,083659,Cao; Yingjun,0,71,50,50
1650785385947,CSE 134B,A01,083661,Powell; Thomas Allan,0,38,65,65
1650785391970,CSE 140,A01,083663,Staff,0,11,75,75
1650785397998,CSE 140L,A01,083088,Eldon; John,0,20,75,75
1650785404025,CSE 175,A01,083665,Kumar; Rakesh,7,0,25,18
1650785410049,CSE 190,A00,092507,Dubnov; Shlomo,10,0,20,10
1650785416075,ECE 45,A01,083139,Staff,0,1,60,60
1650785422099,ECE 65,A50,083695,Staff,0,5,30,30
1650785428124,ECE 109,A01,091882,Touri; Behrouz,32,0,70,38
1650785434148,ECE 180,A00,083140,Abi Samra; Nicholas Camill,20,0,30,10
1650785434148,ECE 180,B00,083141,Abi Samra; Nicholas Camill,0,0,30,30
1650785440174,MATH 10A,A01,083735,Patchell; Gregory David,2,0,30,28
1650785440174,MATH 10A,A02,083736,Patchell; Gregory David,27,0,30,3
1650785440174,MATH 10A,A03,083737,Patchell; Gregory David,24,0,30,6
1650785446199,MATH 10B,A01,083207,Staff,0,9,30,30
1650785446199,MATH 10B,A02,083208,Staff,0,6,30,30
1650785446199,MATH 10B,B01,083739,Staff,11,0,30,19
1650785446199,MATH 10B,B02,083740,Staff,28,0,30,2
1650785452242,MATH 18,A01,083743,Staff,0,0,30,30
1650785452242,MATH 18,A02,083744,Staff,23,0,30,7
1650785452242,MATH 18,A03,083745,Staff,21,0,30,9
1650785452242,MATH 18,A04,083746,Staff,26,0,30,4
1650785452242,MATH 18,B01,083748,Staff,0,15,30,30
1650785452242,MATH 18,B02,083749,Staff,0,12,30,30
1650785452242,MATH 18,B03,083750,Staff,0,12,30,30
1650785452242,MATH 18,B04,083751,Staff,0,12,30,30
1650785458278,MATH 20A,A01,083754,Staff,19,0,40,21
1650785464304,MATH 20B,A01,083756,Staff,0,13,30,30
1650785464304,MATH 20B,A02,083757,Staff,0,12,30,30
1650785470331,MATH 20C,A01,083760,Staff,0,17,30,30
1650785470331,MATH 20C,A02,083761,Staff,0,16,30,30
1650785470331,MATH 20C,B01,083762,Staff,9,0,30,21
1650785470331,MATH 20C,B02,083763,Staff,28,0,30,2
1650785476356,MATH 20D,A01,083765,Staff,2,1,30,28
1650785476356,MATH 20D,A02,083766,Staff,6,0,30,24
1650785476356,MATH 20D,A03,083767,Staff,24,0,30,6
1650785482380,MATH 20E,A01,083771,Staff,2,0,30,28
1650785482380,MATH 20E,A02,083772,Staff,15,0,30,15
1650785482380,MATH 20E,B01,083773,Staff,0,0,30,30
1650785482380,MATH 20E,B02,083774,Staff,5,0,30,25
1650785488405,MATH 103A,A01,083777,Staff,0,16,30,30
1650785488405,MATH 103A,A02,083778,Staff,0,15,30,30
1650785488405,MATH 103A,B01,083779,Staff,0,15,30,30
1650785488405,MATH 103A,B02,083780,Staff,0,15,30,30
1650785494428,MATH 105,A01,085443,Staff,0,22,30,30
1650785500453,MATH 109,A01,083213,Anzaldo; Leesa B,0,7,30,30
1650785500453,MATH 109,A02,083214,Anzaldo; Leesa B,0,7,30,30
1650785500453,MATH 109,B01,083215,Anzaldo; Leesa B,0,8,30,30
1650785500453,MATH 109,B02,083216,Anzaldo; Leesa B,0,7,30,30
1650785506478,MATH 142A,A01,083219,Chow; Bennett,0,16,30,30
1650785506478,MATH 142A,A02,083220,Chow; Bennett,0,15,30,30
1650785506478,MATH 142A,B01,083221,Chow; Bennett,0,16,30,30
1650785506478,MATH 142A,B02,083222,Chow; Bennett,0,14,30,30
1650785512514,MATH 193A,A01,083224,Staff,0,6,30,30
1650785512514,MATH 193A,A02,083225,Staff,0,6,30,30
1650785512514,MATH 193A,A03,083781,Staff,0,6,30,30
1650785512514,MATH 193A,A04,083782,Staff,0,7,30,30
1650785518543,MATH 197,001,091859,McAuley; Julian John,9998,0,9999,1
1650785524594,COGS 9,A01,083615,Staff,0,17,60,60
1650785530619,COGS 11,A01,083617,Boyle; Mary E. T.,16,0,40,24
1650785536658,COGS 13,A01,083071,Staff,0,38,40,40
1650785542685,COGS 14A,A01,092681,Staff,0,36,100,100
1650785548714,COGS 14B,A01,083073,Cheng; Tzu-Han,0,12,50,50
1650785554742,COGS 17,A01,092677,Staff,11,0,75,64
1650785560771,COGS 100,A01,083619,Staff,0,29,60,60
1650785566796,COGS 101A,A01,083621,Davis; Joshua Daniel,0,28,60,60
1650785572821,COGS 101B,A01,091572,Staff,0,3,60,60
1650785578850,COGS 101C,A01,083625,Delgado; Tania,14,0,30,16
1650785584874,COGS 107A,A01,083627,Boyle; Mary E. T.,0,16,60,60
1650785590901,COGS 118A,A01,083075,Staff,0,8,60,60
1650785596928,CSE 3,A50,083646,Miranda; Gregory Joseph,18,0,38,20
1650785596928,CSE 3,A51,083647,Miranda; Gregory Joseph,36,0,37,1
1650785602951,CSE 8A,A50,083650,Miranda; Gregory Joseph,0,29,40,40
1650785608982,CSE 11,A01,083080,Cao; Yingjun,0,96,40,40
1650785615006,CSE 12,A01,083652,Staff,0,21,100,100
1650785621032,CSE 15L,A01,083654,Staff,0,3,50,50
1650785621032,CSE 15L,A02,083655,Staff,0,2,50,50
1650785627067,CSE 20,A01,083657,Staff,49,0,80,31
1650785633100,CSE 30,A01,083084,Eldon; John,0,75,40,40
1650785639129,CSE 100,A01,083659,Cao; Yingjun,0,71,50,50
1650785645157,CSE 134B,A01,083661,Powell; Thomas Allan,0,38,65,65
1650785651215,CSE 140,A01,083663,Staff,0,11,75,75
1650785657254,CSE 140L,A01,083088,Eldon; John,0,20,75,75
1650785663281,CSE 175,A01,083665,Kumar; Rakesh,7,0,25,18
1650785669316,CSE 190,A00,092507,Dubnov; Shlomo,10,0,20,10
1650785675344,ECE 45,A01,083139,Staff,0,1,60,60
1650785681377,ECE 65,A50,083695,Staff,0,5,30,30
1650785687407,ECE 109,A01,091882,Touri; Behrouz,32,0,70,38
1650785693440,ECE 180,A00,083140,Abi Samra; Nicholas Camill,20,0,30,10
1650785693440,ECE 180,B00,083141,Abi Samra; Nicholas Camill,0,0,30,30
1650785699466,MATH 10A,A01,083735,Patchell; Gregory David,2,0,30,28
1650785699466,MATH 10A,A02,083736,Patchell; Gregory David,27,0,30,3
1650785699466,MATH 10A,A03,083737,Patchell; Gregory David,24,0,30,6
1650785705491,MATH 10B,A01,083207,Staff,0,9,30,30
1650785705491,MATH 10B,A02,083208,Staff,0,6,30,30
1650785705491,MATH 10B,B01,083739,Staff,11,0,30,19
1650785705491,MATH 10B,B02,083740,Staff,28,0,30,2
1650785711535,MATH 18,A01,083743,Staff,0,0,30,30
1650785711535,MATH 18,A02,083744,Staff,23,0,30,7
1650785711535,MATH 18,A03,083745,Staff,21,0,30,9
1650785711535,MATH 18,A04,083746,Staff,26,0,30,4
1650785711535,MATH 18,B01,083748,Staff,0,15,30,30
1650785711535,MATH 18,B02,083749,Staff,0,12,30,30
1650785711535,MATH 18,B03,083750,Staff,0,12,30,30
1650785711535,MATH 18,B04,083751,Staff,0,12,30,30
1650785717563,MATH 20A,A01,083754,Staff,19,0,40,21
1650785723586,MATH 20B,A01,083756,Staff,0,13,30,30
1650785723586,MATH 20B,A02,083757,Staff,0,12,30,30
1650785729611,MATH 20C,A01,083760,Staff,0,17,30,30
1650785729611,MATH 20C,A02,083761,Staff,0,16,30,30
1650785729611,MATH 20C,B01,083762,Staff,9,0,30,21
1650785729611,MATH 20C,B02,083763,Staff,28,0,30,2
1650785735644,MATH 20D,A01,083765,Staff,2,1,30,28
1650785735644,MATH 20D,A02,083766,Staff,6,0,30,24
1650785735644,MATH 20D,A03,083767,Staff,24,0,30,6
1650785741677,MATH 20E,A01,083771,Staff,2,0,30,28
1650785741677,MATH 20E,A02,083772,Staff,15,0,30,15
1650785741677,MATH 20E,B01,083773,Staff,0,0,30,30
1650785741677,MATH 20E,B02,083774,Staff,5,0,30,25
1650785747708,MATH 103A,A01,083777,Staff,0,16,30,30
1650785747708,MATH 103A,A02,083778,Staff,0,15,30,30
1650785747708,MATH 103A,B01,083779,Staff,0,15,30,30
1650785747708,MATH 103A,B02,083780,Staff,0,15,30,30
1650785753734,MATH 105,A01,085443,Staff,0,22,30,30
1650785759781,MATH 109,A01,083213,Anzaldo; Leesa B,0,7,30,30
1650785759781,MATH 109,A02,083214,Anzaldo; Leesa B,0,7,30,30
1650785759781,MATH 109,B01,083215,Anzaldo; Leesa B,0,8,30,30
1650785759781,MATH 109,B02,083216,Anzaldo; Leesa B,0,7,30,30
1650785765812,MATH 142A,A01,083219,Chow; Bennett,0,16,30,30
1650785765812,MATH 142A,A02,083220,Chow; Bennett,0,15,30,30
1650785765812,MATH 142A,B01,083221,Chow; Bennett,0,16,30,30
1650785765812,MATH 142A,B02,083222,Chow; Bennett,0,14,30,30
1650785771841,MATH 193A,A01,083224,Staff,0,6,30,30
1650785771841,MATH 193A,A02,083225,Staff,0,6,30,30
1650785771841,MATH 193A,A03,083781,Staff,0,6,30,30
1650785771841,MATH 193A,A04,083782,Staff,0,7,30,30
1650785777875,MATH 197,001,091859,McAuley; Julian John,9998,0,9999,1
1650785783952,COGS 9,A01,083615,Staff,0,17,60,60
1650785789983,COGS 11,A01,083617,Boyle; Mary E. T.,16,0,40,24
1650785796016,COGS 13,A01,083071,Staff,0,38,40,40
1650785802047,COGS 14A,A01,092681,Staff,0,36,100,100
1650785808076,COGS 14B,A01,083073,Cheng; Tzu-Han,0,12,50,50
1650785814101,COGS 17,A01,092677,Staff,11,0,75,64
1650785820128,COGS 100,A01,083619,Staff,0,29,60,60
1650785826153,COGS 101A,A01,083621,Davis; Joshua Daniel,0,28,60,60
1650785832179,COGS 101B,A01,091572,Staff,0,3,60,60
1650785838211,COGS 101C,A01,083625,Delgado; Tania,14,0,30,16
1650785844235,COGS 107A,A01,083627,Boyle; Mary E. T.,0,16,60,60
1650785850341,COGS 118A,A01,083075,Staff,0,8,60,60
1650785856377,CSE 3,A50,083646,Miranda; Gregory Joseph,18,0,38,20
1650785856377,CSE 3,A51,083647,Miranda; Gregory Joseph,36,0,37,1
1650785862404,CSE 8A,A50,083650,Miranda; Gregory Joseph,0,29,40,40
1650785868433,CSE 11,A01,083080,Cao; Yingjun,0,96,40,40
1650785874456,CSE 12,A01,083652,Staff,0,21,100,100
1650785880484,CSE 15L,A01,083654,Staff,0,3,50,50
1650785880484,CSE 15L,A02,083655,Staff,0,2,50,50
1650785886518,CSE 20,A01,083657,Staff,49,0,80,31
1650785892549,CSE 30,A01,083084,Eldon; John,0,75,40,40
1650785898577,CSE 100,A01,083659,Cao; Yingjun,0,71,50,50
1650785904604,CSE 134B,A01,083661,Powell; Thomas Allan,0,38,65,65
1650785910626,CSE 140,A01,083663,Staff,0,11,75,75
1650785916656,CSE 140L,A01,083088,Eldon; John,0,20,75,75
1650785922681,CSE 175,A01,083665,Kumar; Rakesh,7,0,25,18
1650785928732,CSE 190,A00,092507,Dubnov; Shlomo,10,0,20,10
1650785934756,ECE 45,A01,083139,Staff,0,1,60,60
1650785940782,ECE 65,A50,083695,Staff,0,5,30,30
1650785946807,ECE 109,A01,091882,Touri; Behrouz,32,0,70,38
1650785952829,ECE 180,A00,083140,Abi Samra; Nicholas Camill,20,0,30,10
1650785952829,ECE 180,B00,083141,Abi Samra; Nicholas Camill,0,0,30,30
1650785958856,MATH 10A,A01,083735,Patchell; Gregory David,2,0,30,28
1650785958856,MATH 10A,A02,083736,Patchell; Gregory David,27,0,30,3
1650785958856,MATH 10A,A03,083737,Patchell; Gregory David,24,0,30,6
1650785964882,MATH 10B,A01,083207,Staff,0,9,30,30
1650785964882,MATH 10B,A02,083208,Staff,0,6,30,30
1650785964882,MATH 10B,B01,083739,Staff,11,0,30,19
1650785964882,MATH 10B,B02,083740,Staff,28,0,30,2
1650785970923,MATH 18,A01,083743,Staff,0,0,30,30
1650785970923,MATH 18,A02,083744,Staff,23,0,30,7
1650785970923,MATH 18,A03,083745,Staff,21,0,30,9
1650785970923,MATH 18,A04,083746,Staff,26,0,30,4
1650785970923,MATH 18,B01,083748,Staff,0,15,30,30
1650785970923,MATH 18,B02,083749,Staff,0,12,30,30
1650785970923,MATH 18,B03,083750,Staff,0,12,30,30
1650785970923,MATH 18,B04,083751,Staff,0,12,30,30
1650785976947,MATH 20A,A01,083754,Staff,19,0,40,21
1650785982972,MATH 20B,A01,083756,Staff,0,13,30,30
1650785982972,MATH 20B,A02,083757,Staff,0,12,30,30
1650785988997,MATH 20C,A01,083760,Staff,0,17,30,30
1650785988997,MATH 20C,A02,083761,Staff,0,16,30,30
1650785988997,MATH 20C,B01,083762,Staff,9,0,30,21
1650785988997,MATH 20C,B02,083763,Staff,28,0,30,2
1650785995022,MATH 20D,A01,083765,Staff,2,1,30,28
1650785995022,MATH 20D,A02,083766,Staff,6,0,30,24
1650785995022,MATH 20D,A03,083767,Staff,24,0,30,6
1650786001048,MATH 20E,A01,083771,Staff,2,0,30,28
1650786001048,MATH 20E,A02,083772,Staff,15,0,30,15
1650786001048,MATH 20E,B01,083773,Staff,0,0,30,30
1650786001048,MATH 20E,B02,083774,Staff,5,0,30,25
1650786007074,MATH 103A,A01,083777,Staff,0,16,30,30
1650786007074,MATH 103A,A02,083778,Staff,0,15,30,30
1650786007074,MATH 103A,B01,083779,Staff,0,15,30,30
1650786007074,MATH 103A,B02,083780,Staff,0,15,30,30
1650786013099,MATH 105,A01,085443,Staff,0,22,30,30
1650786019124,MATH 109,A01,083213,Anzaldo; Leesa B,0,7,30,30
1650786019124,MATH 109,A02,083214,Anzaldo; Leesa B,0,7,30,30
1650786019124,MATH 109,B01,083215,Anzaldo; Leesa B,0,8,30,30
1650786019124,MATH 109,B02,083216,Anzaldo; Leesa B,0,7,30,30
1650786025167,MATH 142A,A01,083219,Chow; Bennett,0,16,30,30
1650786025167,MATH 142A,A02,083220,Chow; Bennett,0,15,30,30
1650786025167,MATH 142A,B01,083221,Chow; Bennett,0,16,30,30
1650786025167,MATH 142A,B02,083222,Chow; Bennett,0,14,30,30
1650786031202,MATH 193A,A01,083224,Staff,0,6,30,30
1650786031202,MATH 193A,A02,083225,Staff,0,6,30,30
1650786031202,MATH 193A,A03,083781,Staff,0,6,30,30
1650786031202,MATH 193A,A04,083782,Staff,0,7,30,30
1650786037230,MATH 197,001,091859,McAuley; Julian John,9998,0,9999,1
1650786043318,COGS 9,A01,083615,Staff,0,17,60,60
1650786049346,COGS 11,A01,083617,Boyle; Mary E. T.,16,0,40,24
1650786055378,COGS 13,A01,083071,Staff,0,38,40,40
1650786061409,COGS 14A,A01,092681,Staff,0,36,100,100
1650786067433,COGS 14B,A01,083073,Cheng; Tzu-Han,0,12,50,50
1650786073456,COGS 17,A01,092677,Staff,11,0,75,64
1650786079484,COGS 100,A01,083619,Staff,0,29,60,60
1650786085510,COGS 101A,A01,083621,Davis; Joshua Daniel,0,28,60,60
1650786091543,COGS 101B,A01,091572,Staff,0,3,60,60
1650786097566,COGS 101C,A01,083625,Delgado; Tania,14,0,30,16
1650786103596,COGS 107A,A01,083627,Boyle; Mary E. T.,0,16,60,60
1650786109621,COGS 118A,A01,083075,Staff,0,8,60,60
1650786115652,CSE 3,A50,083646,Miranda; Gregory Joseph,18,0,38,20
1650786115652,CSE 3,A51,083647,Miranda; Gregory Joseph,36,0,37,1
1650786121690,CSE 8A,A50,083650,Miranda; Gregory Joseph,0,29,40,40
1650786127719,CSE 11,A01,083080,Cao; Yingjun,0,96,40,40
1650786133743,CSE 12,A01,083652,Staff,0,21,100,100
1650786139768,CSE 15L,A01,083654,Staff,0,3,50,50
1650786139768,CSE 15L,A02,083655,Staff,0,2,50,50
1650786145794,CSE 20,A01,083657,Staff,49,0,80,31
1650786151817,CSE 30,A01,083084,Eldon; John,0,75,40,40
1650786157839,CSE 100,A01,083659,Cao; Yingjun,0,71,50,50
1650786163864,CSE 134B,A01,083661,Powell; Thomas Allan,0,38,65,65
1650786169888,CSE 140,A01,083663,Staff,0,11,75,75
1650786175916,CSE 140L,A01,083088,Eldon; John,0,20,75,75
1650786181944,CSE 175,A01,083665,Kumar; Rakesh,7,0,25,18
1650786187970,CSE 190,A00,092507,Dubnov; Shlomo,10,0,20,10
1650786193994,ECE 45,A01,083139,Staff,0,1,60,60
1650786200020,ECE 65,A50,083695,Staff,0,5,30,30
1650786206043,ECE 109,A01,091882,Touri; Behrouz,32,0,70,38
1650786212072,ECE 180,A00,083140,Abi Samra; Nicholas Camill,20,0,30,10
1650786212072,ECE 180,B00,083141,Abi Samra; Nicholas Camill,0,0,30,30
1650786218101,MATH 10A,A01,083735,Patchell; Gregory David,2,0,30,28
1650786218101,MATH 10A,A02,083736,Patchell; Gregory David,27,0,30,3
1650786218101,MATH 10A,A03,083737,Patchell; Gregory David,24,0,30,6
1650786224128,MATH 10B,A01,083207,Staff,0,9,30,30
1650786224128,MATH 10B,A02,083208,Staff,0,6,30,30
1650786224128,MATH 10B,B01,083739,Staff,11,0,30,19
1650786224128,MATH 10B,B02,083740,Staff,28,0,30,2
1650786230154,MATH 18,A01,083743,Staff,0,0,30,30
1650786230154,MATH 18,A02,083744,Staff,23,0,30,7
1650786230154,MATH 18,A03,083745,Staff,21,0,30,9
1650786230154,MATH 18,A04,083746,Staff,26,0,30,4
1650786230154,MATH 18,B01,083748,Staff,0,15,30,30
1650786230154,MATH 18,B02,083749,Staff,0,12,30,30
1650786230154,MATH 18,B03,083750,Staff,0,12,30,30
1650786230154,MATH 18,B04,083751,Staff,0,12,30,30
1650786236180,MATH 20A,A01,083754,Staff,19,0,40,21
1650786242233,MATH 20B,A01,083756,Staff,0,13,30,30
1650786242233,MATH 20B,A02,083757,Staff,0,12,30,30
1650786248257,MATH 20C,A01,083760,Staff,0,17,30,30
1650786248257,MATH 20C,A02,083761,Staff,0,16,30,30
1650786248257,MATH 20C,B01,083762,Staff,9,0,30,21
1650786248257,MATH 20C,B02,083763,Staff,28,0,30,2
1650786254283,MATH 20D,A01,083765,Staff,2,1,30,28
1650786254283,MATH 20D,A02,083766,Staff,6,0,30,24
1650786254283,MATH 20D,A03,083767,Staff,24,0,30,6
1650786260314,MATH 20E,A01,083771,Staff,2,0,30,28
1650786260314,MATH 20E,A02,083772,Staff,15,0,30,15
1650786260314,MATH 20E,B01,083773,Staff,0,0,30,30
1650786260314,MATH 20E,B02,083774,Staff,5,0,30,25
1650786266345,MATH 103A,A01,083777,Staff,0,16,30,30
1650786266345,MATH 103A,A02,083778,Staff,0,15,30,30
1650786266345,MATH 103A,B01,083779,Staff,0,15,30,30
1650786266345,MATH 103A,B02,083780,Staff,0,15,30,30
1650786272390,MATH 105,A01,085443,Staff,0,22,30,30
1650786278415,MATH 109,A01,083213,Anzaldo; Leesa B,0,7,30,30
1650786278415,MATH 109,A02,083214,Anzaldo; Leesa B,0,7,30,30
1650786278415,MATH 109,B01,083215,Anzaldo; Leesa B,0,8,30,30
1650786278415,MATH 109,B02,083216,Anzaldo; Leesa B,0,7,30,30
1650786284447,MATH 142A,A01,083219,Chow; Bennett,0,16,30,30
1650786284447,MATH 142A,A02,083220,Chow; Bennett,0,15,30,30
1650786284447,MATH 142A,B01,083221,Chow; Bennett,0,16,30,30
1650786284447,MATH 142A,B02,083222,Chow; Bennett,0,14,30,30
1650786290472,MATH 193A,A01,083224,Staff,0,6,30,30
1650786290472,MATH 193A,A02,083225,Staff,0,6,30,30
1650786290472,MATH 193A,A03,083781,Staff,0,6,30,30
1650786290472,MATH 193A,A04,083782,Staff,0,7,30,30
1650786296498,MATH 197,001,091859,McAuley; Julian John,9998,0,9999,1
1650786302558,COGS 9,A01,083615,Staff,0,17,60,60
1650786308590,COGS 11,A01,083617,Boyle; Mary E. T.,16,0,40,24
1650786314622,COGS 13,A01,083071,Staff,0,38,40,40
1650786320663,COGS 14A,A01,092681,Staff,0,36,100,100
1650786326688,COGS 14B,A01,083073,Cheng; Tzu-Han,0,12,50,50
1650786332721,COGS 17,A01,092677,Staff,11,0,75,64
1650786338743,COGS 100,A01,083619,Staff,0,29,60,60
1650786344857,COGS 101A,A01,083621,Davis; Joshua Daniel,0,28,60,60
1650786350894,COGS 101B,A01,091572,Staff,0,3,60,60
1650786356925,COGS 101C,A01,083625,Delgado; Tania,14,0,30,16
1650786362947,COGS 107A,A01,083627,Boyle; Mary E. T.,0,16,60,60
1650786368976,COGS 118A,A01,083075,Staff,0,8,60,60
1650786375013,CSE 3,A50,083646,Miranda; Gregory Joseph,18,0,38,20
1650786375013,CSE 3,A51,083647,Miranda; Gregory Joseph,36,0,37,1
1650786381045,CSE 8A,A50,083650,Miranda; Gregory Joseph,0,29,40,40
1650786387075,CSE 11,A01,083080,Cao; Yingjun,0,96,40,40
1650786393113,CSE 12,A01,083652,Staff,0,21,100,100
1650786399140,CSE 15L,A01,083654,Staff,0,3,50,50
1650786399140,CSE 15L,A02,083655,Staff,0,2,50,50
1650786405166,CSE 20,A01,083657,Staff,49,0,80,31
1650786411189,CSE 30,A01,083084,Eldon; John,0,75,40,40
1650786417213,CSE 100,A01,083659,Cao; Yingjun,0,71,50,50
1650786423241,CSE 134B,A01,083661,Powell; Thomas Allan,0,38,65,65
1650786429265,CSE 140,A01,083663,Staff,0,11,75,75
1650786435289,CSE 140L,A01,083088,Eldon; John,0,20,75,75
1650786441320,CSE 175,A01,083665,Kumar; Rakesh,7,0,25,18
1650786447420,CSE 190,A00,092507,Dubnov; Shlomo,10,0,20,10
1650786453448,ECE 45,A01,083139,Staff,0,1,60,60
1650786459472,ECE 65,A50,083695,Staff,0,5,30,30
1650786465501,ECE 109,A01,091882,Touri; Behrouz,32,0,70,38
1650786471537,ECE 180,A00,083140,Abi Samra; Nicholas Camill,20,0,30,10
1650786471537,ECE 180,B00,083141,Abi Samra; Nicholas Camill,0,0,30,30
1650786477571,MATH 10A,A01,083735,Patchell; Gregory David,2,0,30,28
1650786477571,MATH 10A,A02,083736,Patchell; Gregory David,27,0,30,3
1650786477571,MATH 10A,A03,083737,Patchell; Gregory David,24,0,30,6
1650786483607,MATH 10B,A01,083207,Staff,0,9,30,30
1650786483607,MATH 10B,A02,083208,Staff,0,6,30,30
1650786483607,MATH 10B,B01,083739,Staff,11,0,30,19
1650786483607,MATH 10B,B02,083740,Staff,28,0,30,2
1650786489634,MATH 18,A01,083743,Staff,0,0,30,30
1650786489634,MATH 18,A02,083744,Staff,23,0,30,7
1650786489634,MATH 18,A03,083745,Staff,21,0,30,9
1650786489634,MATH 18,A04,083746,Staff,26,0,30,4
1650786489634,MATH 18,B01,083748,Staff,0,15,30,30
1650786489634,MATH 18,B02,083749,Staff,0,12,30,30
1650786489634,MATH 18,B03,083750,Staff,0,12,30,30
1650786489634,MATH 18,B04,083751,Staff,0,12,30,30
1650786495666,MATH 20A,A01,083754,Staff,19,0,40,21
1650786501689,MATH 20B,A01,083756,Staff,0,13,30,30
1650786501689,MATH 20B,A02,083757,Staff,0,12,30,30
1650786507717,MATH 20C,A01,083760,Staff,0,17,30,30
1650786507717,MATH 20C,A02,083761,Staff,0,16,30,30
1650786507717,MATH 20C,B01,083762,Staff,9,0,30,21
1650786507717,MATH 20C,B02,083763,Staff,28,0,30,2
1650786513741,MATH 20D,A01,083765,Staff,2,1,30,28
1650786513741,MATH 20D,A02,083766,Staff,6,0,30,24
1650786513741,MATH 20D,A03,083767,Staff,24,0,30,6
1650786519769,MATH 20E,A01,083771,Staff,2,0,30,28
1650786519769,MATH 20E,A02,083772,Staff,15,0,30,15
1650786519769,MATH 20E,B01,083773,Staff,0,0,30,30
1650786519769,MATH 20E,B02,083774,Staff,5,0,30,25
1650786525796,MATH 103A,A01,083777,Staff,0,16,30,30
1650786525796,MATH 103A,A02,083778,Staff,0,15,30,30
1650786525796,MATH 103A,B01,083779,Staff,0,15,30,30
1650786525796,MATH 103A,B02,083780,Staff,0,15,30,30
1650786531825,MATH 105,A01,085443,Staff,0,22,30,30
1650786537865,MATH 109,A01,083213,Anzaldo; Leesa B,0,7,30,30
1650786537865,MATH 109,A02,083214,Anzaldo; Leesa B,0,7,30,30
1650786537865,MATH 109,B01,083215,Anzaldo; Leesa B,0,8,30,30
1650786537865,MATH 109,B02,083216,Anzaldo; Leesa B,0,7,30,30
1650786543894,MATH 142A,A01,083219,Chow; Bennett,0,16,30,30
1650786543894,MATH 142A,A02,083220,Chow; Bennett,0,15,30,30
1650786543894,MATH 142A,B01,083221,Chow; Bennett,0,16,30,30
1650786543894,MATH 142A,B02,083222,Chow; Bennett,0,14,30,30
1650786549919,MATH 193A,A01,083224,Staff,0,6,30,30
1650786549919,MATH 193A,A02,083225,Staff,0,6,30,30
1650786549919,MATH 193A,A03,083781,Staff,0,6,30,30
1650786549919,MATH 193A,A04,083782,Staff,0,7,30,30
1650786555944,MATH 197,001,091859,McAuley; Julian John,9998,0,9999,1
1650786562002,COGS 9,A01,083615,Staff,0,17,60,60
1650786568027,COGS 11,A01,083617,Boyle; Mary E. T.,16,0,40,24
1650786574052,COGS 13,A01,083071,Staff,0,38,40,40
1650786580080,COGS 14A,A01,092681,Staff,0,36,100,100
1650786586104,COGS 14B,A01,083073,Cheng; Tzu-Han,0,12,50,50
1650786592130,COGS 17,A01,092677,Staff,11,0,75,64
1650786598154,COGS 100,A01,083619,Staff,0,29,60,60
1650786604184,COGS 101A,A01,083621,Davis; Joshua Daniel,0,28,60,60
1650786610208,COGS 101B,A01,091572,Staff,0,3,60,60
1650786616241,COGS 101C,A01,083625,Delgado; Tania,14,0,30,16
1650786622268,COGS 107A,A01,083627,Boyle; Mary E. T.,0,16,60,60
1650786628291,COGS 118A,A01,083075,Staff,0,8,60,60
1650786634321,CSE 3,A50,083646,Miranda; Gregory Joseph,18,0,38,20
1650786634321,CSE 3,A51,083647,Miranda; Gregory Joseph,36,0,37,1
1650786640346,CSE 8A,A50,083650,Miranda; Gregory Joseph,0,29,40,40
1650786646371,CSE 11,A01,083080,Cao; Yingjun,0,96,40,40
1650786652400,CSE 12,A01,083652,Staff,0,21,100,100
1650786658426,CSE 15L,A01,083654,Staff,0,3,50,50
1650786658426,CSE 15L,A02,083655,Staff,0,2,50,50
1650786664462,CSE 20,A01,083657,Staff,49,0,80,31
1650786670490,CSE 30,A01,083084,Eldon; John,0,75,40,40
1650786676515,CSE 100,A01,083659,Cao; Yingjun,0,71,50,50
1650786682539,CSE 134B,A01,083661,Powell; Thomas Allan,0,38,65,65
1650786688563,CSE 140,A01,083663,Staff,0,11,75,75
1650786694589,CSE 140L,A01,083088,Eldon; John,0,20,75,75
1650786700613,CSE 175,A01,083665,Kumar; Rakesh,7,0,25,18
1650786706636,CSE 190,A00,092507,Dubnov; Shlomo,10,0,20,10
1650786712663,ECE 45,A01,083139,Staff,0,1,60,60
1650786718688,ECE 65,A50,083695,Staff,0,5,30,30
1650786724713,ECE 109,A01,091882,Touri; Behrouz,32,0,70,38
1650786730738,ECE 180,A00,083140,Abi Samra; Nicholas Camill,20,0,30,10
1650786730738,ECE 180,B00,083141,Abi Samra; Nicholas Camill,0,0,30,30
1650786736765,MATH 10A,A01,083735,Patchell; Gregory David,2,0,30,28
1650786736765,MATH 10A,A02,083736,Patchell; Gregory David,27,0,30,3
1650786736765,MATH 10A,A03,083737,Patchell; Gregory David,24,0,30,6
1650786742793,MATH 10B,A01,083207,Staff,0,9,30,30
1650786742793,MATH 10B,A02,083208,Staff,0,6,30,30
1650786742793,MATH 10B,B01,083739,Staff,11,0,30,19
1650786742793,MATH 10B,B02,083740,Staff,28,0,30,2
1650786748824,MATH 18,A01,083743,Staff,0,0,30,30
1650786748824,MATH 18,A02,083744,Staff,23,0,30,7
1650786748824,MATH 18,A03,083745,Staff,21,0,30,9
1650786748824,MATH 18,A04,083746,Staff,26,0,30,4
1650786748824,MATH 18,B01,083748,Staff,0,15,30,30
1650786748824,MATH 18,B02,083749,Staff,0,12,30,30
1650786748824,MATH 18,B03,083750,Staff,0,12,30,30
1650786748824,MATH 18,B04,083751,Staff,0,12,30,30
1650786754848,MATH 20A,A01,083754,Staff,19,0,40,21
1650786760872,MATH 20B,A01,083756,Staff,0,13,30,30
1650786760872,MATH 20B,A02,083757,Staff,0,12,30,30
1650786766899,MATH 20C,A01,083760,Staff,0,17,30,30
1650786766899,MATH 20C,A02,083761,Staff,0,16,30,30
1650786766899,MATH 20C,B01,083762,Staff,9,0,30,21
1650786766899,MATH 20C,B02,083763,Staff,28,0,30,2
1650786772931,MATH 20D,A01,083765,Staff,2,1,30,28
1650786772931,MATH 20D,A02,083766,Staff,6,0,30,24
1650786772931,MATH 20D,A03,083767,Staff,24,0,30,6
1650786778957,MATH 20E,A01,083771,Staff,2,0,30,28
1650786778957,MATH 20E,A02,083772,Staff,15,0,30,15
1650786778957,MATH 20E,B01,083773,Staff,0,0,30,30
1650786778957,MATH 20E,B02,083774,Staff,5,0,30,25
1650786784983,MATH 103A,A01,083777,Staff,0,16,30,30
1650786784983,MATH 103A,A02,083778,Staff,0,15,30,30
1650786784983,MATH 103A,B01,083779,Staff,0,15,30,30
1650786784983,MATH 103A,B02,083780,Staff,0,15,30,30
1650786791007,MATH 105,A01,085443,Staff,0,22,30,30
1650786797033,MATH 109,A01,083213,Anzaldo; Leesa B,0,7,30,30
1650786797033,MATH 109,A02,083214,Anzaldo; Leesa B,0,7,30,30
1650786797033,MATH 109,B01,083215,Anzaldo; Leesa B,0,8,30,30
1650786797033,MATH 109,B02,083216,Anzaldo; Leesa B,0,7,30,30
1650786803058,MATH 142A,A01,083219,Chow; Bennett,0,16,30,30
1650786803058,MATH 142A,A02,083220,Chow; Bennett,0,15,30,30
1650786803058,MATH 142A,B01,083221,Chow; Bennett,0,16,30,30
1650786803058,MATH 142A,B02,083222,Chow; Bennett,0,14,30,30
1650786809080,MATH 193A,A01,083224,Staff,0,6,30,30
1650786809080,MATH 193A,A02,083225,Staff,0,6,30,30
1650786809080,MATH 193A,A03,083781,Staff,0,6,30,30
1650786809080,MATH 193A,A04,083782,Staff,0,7,30,30
1650786815104,MATH 197,001,091859,McAuley; Julian John,9998,0,9999,1
1650786821158,COGS 9,A01,083615,Staff,0,17,60,60
1650786827182,COGS 11,A01,083617,Boyle; Mary E. T.,16,0,40,24
1650786833205,COGS 13,A01,083071,Staff,0,38,40,40
1650786839228,COGS 14A,A01,092681,Staff,0,36,100,100
1650786845257,COGS 14B,A01,083073,Cheng; Tzu-Han,0,12,50,50
1650786851281,COGS 17,A01,092677,Staff,11,0,75,64
1650786857314,COGS 100,A01,083619,Staff,0,29,60,60
1650786863337,COGS 101A,A01,083621,Davis; Joshua Daniel,0,28,60,60
1650786869361,COGS 101B,A01,091572,Staff,0,3,60,60
1650786875390,COGS 101C,A01,083625,Delgado; Tania,14,0,30,16
1650786881417,COGS 107A,A01,083627,Boyle; Mary E. T.,0,16,60,60
1650786887441,COGS 118A,A01,083075,Staff,0,8,60,60
1650786893467,CSE 3,A50,083646,Miranda; Gregory Joseph,18,0,38,20
1650786893467,CSE 3,A51,083647,Miranda; Gregory Joseph,36,0,37,1
1650786899489,CSE 8A,A50,083650,Miranda; Gregory Joseph,0,29,40,40
1650786905516,CSE 11,A01,083080,Cao; Yingjun,0,96,40,40
1650786911539,CSE 12,A01,083652,Staff,0,21,100,100
1650786917564,CSE 15L,A01,083654,Staff,0,3,50,50
1650786917564,CSE 15L,A02,083655,Staff,0,2,50,50
1650786923589,CSE 20,A01,083657,Staff,49,0,80,31
1650786929616,CSE 30,A01,083084,Eldon; John,0,75,40,40
1650786935641,CSE 100,A01,083659,Cao; Yingjun,0,71,50,50
1650786941668,CSE 134B,A01,083661,Powell; Thomas Allan,0,38,65,65
1650786947700,CSE 140,A01,083663,Staff,0,11,75,75
1650786953723,CSE 140L,A01,083088,Eldon; John,0,20,75,75
1650786959748,CSE 175,A01,083665,Kumar; Rakesh,7,0,25,18
1650786965775,CSE 190,A00,092507,Dubnov; Shlomo,10,0,20,10
1650786971802,ECE 45,A01,083139,Staff,0,1,60,60
1650786977829,ECE 65,A50,083695,Staff,0,5,30,30
1650786983853,ECE 109,A01,091882,Touri; Behrouz,32,0,70,38
1650786989877,ECE 180,A00,083140,Abi Samra; Nicholas Camill,20,0,30,10
1650786989877,ECE 180,B00,083141,Abi Samra; Nicholas Camill,0,0,30,30
1650786995904,MATH 10A,A01,083735,Patchell; Gregory David,2,0,30,28
1650786995904,MATH 10A,A02,083736,Patchell; Gregory David,27,0,30,3
1650786995904,MATH 10A,A03,083737,Patchell; Gregory David,24,0,30,6
1650787001929,MATH 10B,A01,083207,Staff,0,9,30,30
1650787001929,MATH 10B,A02,083208,Staff,0,6,30,30
1650787001929,MATH 10B,B01,083739,Staff,11,0,30,19
1650787001929,MATH 10B,B02,083740,Staff,28,0,30,2
1650787007959,MATH 18,A01,083743,Staff,0,0,30,30
1650787007959,MATH 18,A02,083744,Staff,23,0,30,7
1650787007959,MATH 18,A03,083745,Staff,21,0,30,9
1650787007959,MATH 18,A04,083746,Staff,26,0,30,4
1650787007959,MATH 18,B01,083748,Staff,0,15,30,30
1650787007959,MATH 18,B02,083749,Staff,0,12,30,30
1650787007959,MATH 18,B03,083750,Staff,0,12,30,30
1650787007959,MATH 18,B04,083751,Staff,0,12,30,30
1650787013986,MATH 20A,A01,083754,Staff,19,0,40,21
1650787020010,MATH 20B,A01,083756,Staff,0,13,30,30
1650787020010,MATH 20B,A02,083757,Staff,0,12,30,30
1650787026034,MATH 20C,A01,083760,Staff,0,17,30,30
1650787026034,MATH 20C,A02,083761,Staff,0,16,30,30
1650787026034,MATH 20C,B01,083762,Staff,9,0,30,21
1650787026034,MATH 20C,B02,083763,Staff,28,0,30,2
1650787032058,MATH 20D,A01,083765,Staff,2,1,30,28
1650787032058,MATH 20D,A02,083766,Staff,6,0,30,24
1650787032058,MATH 20D,A03,083767,Staff,24,0,30,6
1650787038186,MATH 20E,A01,083771,Staff,2,0,30,28
1650787038186,MATH 20E,A02,083772,Staff,15,0,30,15
1650787038186,MATH 20E,B01,083773,Staff,0,0,30,30
1650787038186,MATH 20E,B02,083774,Staff,5,0,30,25
1650787044283,MATH 103A,A01,083777,Staff,0,16,30,30
1650787044283,MATH 103A,A02,083778,Staff,0,15,30,30
1650787044283,MATH 103A,B01,083779,Staff,0,15,30,30
1650787044283,MATH 103A,B02,083780,Staff,0,15,30,30
1650787050307,MATH 105,A01,085443,Staff,0,22,30,30
1650787056331,MATH 109,A01,083213,Anzaldo; Leesa B,0,7,30,30
1650787056331,MATH 109,A02,083214,Anzaldo; Leesa B,0,7,30,30
1650787056331,MATH 109,B01,083215,Anzaldo; Leesa B,0,8,30,30
1650787056331,MATH 109,B02,083216,Anzaldo; Leesa B,0,7,30,30
1650787062370,MATH 142A,A01,083219,Chow; Bennett,0,16,30,30
1650787062370,MATH 142A,A02,083220,Chow; Bennett,0,15,30,30
1650787062370,MATH 142A,B01,083221,Chow; Bennett,0,16,30,30
1650787062370,MATH 142A,B02,083222,Chow; Bennett,0,14,30,30
1650787068397,MATH 193A,A01,083224,Staff,0,6,30,30
1650787068397,MATH 193A,A02,083225,Staff,0,6,30,30
1650787068397,MATH 193A,A03,083781,Staff,0,6,30,30
1650787068397,MATH 193A,A04,083782,Staff,0,7,30,30
1650787074420,MATH 197,001,091859,McAuley; Julian John,9998,0,9999,1
1650787080474,COGS 9,A01,083615,Staff,0,17,60,60
1650787086497,COGS 11,A01,083617,Boyle; Mary E. T.,16,0,40,24
1650787092527,COGS 13,A01,083071,Staff,0,38,40,40
1650787098550,COGS 14A,A01,092681,Staff,0,36,100,100
1650787104573,COGS 14B,A01,083073,Cheng; Tzu-Han,0,12,50,50
1650787110596,COGS 17,A01,092677,Staff,11,0,75,64
1650787116622,COGS 100,A01,083619,Staff,0,29,60,60
1650787122643,COGS 101A,A01,083621,Davis; Joshua Daniel,0,28,60,60
1650787128667,COGS 101B,A01,091572,Staff,0,3,60,60
1650787134697,COGS 101C,A01,083625,Delgado; Tania,14,0,30,16
1650787140721,COGS 107A,A01,083627,Boyle; Mary E. T.,0,16,60,60
1650787146744,COGS 118A,A01,083075,Staff,0,8,60,60
1650787152769,CSE 3,A50,083646,Miranda; Gregory Joseph,18,0,38,20
1650787152769,CSE 3,A51,083647,Miranda; Gregory Joseph,36,0,37,1
1650787158794,CSE 8A,A50,083650,Miranda; Gregory Joseph,0,29,40,40
1650787164819,CSE 11,A01,083080,Cao; Yingjun,0,96,40,40
1650787170845,CSE 12,A01,083652,Staff,0,21,100,100
1650787176873,CSE 15L,A01,083654,Staff,0,3,50,50
1650787176873,CSE 15L,A02,083655,Staff,0,2,50,50
1650787182896,CSE 20,A01,083657,Staff,49,0,80,31
1650787188938,CSE 30,A01,083084,Eldon; John,0,75,40,40
1650787194962,CSE 100,A01,083659,Cao; Yingjun,0,71,50,50
1650787200991,CSE 134B,A01,083661,Powell; Thomas Allan,0,38,65,65
1650787207022,CSE 140,A01,083663,Staff,0,11,75,75
1650787213048,CSE 140L,A01,083088,Eldon; John,0,20,75,75
1650787219080,CSE 175,A01,083665,Kumar; Rakesh,7,0,25,18
1650787225103,CSE 190,A00,092507,Dubnov; Shlomo,10,0,20,10
1650787231130,ECE 45,A01,083139,Staff,0,1,60,60
1650787237155,ECE 65,A50,083695,Staff,0,5,30,30
1650787243180,ECE 109,A01,091882,Touri; Behrouz,32,0,70,38
1650787249205,ECE 180,A00,083140,Abi Samra; Nicholas Camill,20,0,30,10
1650787249205,ECE 180,B00,083141,Abi Samra; Nicholas Camill,0,0,30,30
1650787255230,MATH 10A,A01,083735,Patchell; Gregory David,2,0,30,28
1650787255230,MATH 10A,A02,083736,Patchell; Gregory David,27,0,30,3
1650787255230,MATH 10A,A03,083737,Patchell; Gregory David,24,0,30,6
1650787261257,MATH 10B,A01,083207,Staff,0,9,30,30
1650787261257,MATH 10B,A02,083208,Staff,0,6,30,30
1650787261257,MATH 10B,B01,083739,Staff,11,0,30,19
1650787261257,MATH 10B,B02,083740,Staff,28,0,30,2
1650787267284,MATH 18,A01,083743,Staff,0,0,30,30
1650787267284,MATH 18,A02,083744,Staff,23,0,30,7
1650787267284,MATH 18,A03,083745,Staff,21,0,30,9
1650787267284,MATH 18,A04,083746,Staff,26,0,30,4
1650787267284,MATH 18,B01,083748,Staff,0,15,30,30
1650787267284,MATH 18,B02,083749,Staff,0,12,30,30
1650787267284,MATH 18,B03,083750,Staff,0,12,30,30
1650787267284,MATH 18,B04,083751,Staff,0,12,30,30
1650787273310,MATH 20A,A01,083754,Staff,19,0,40,21
1650787279339,MATH 20B,A01,083756,Staff,0,13,30,30
1650787279339,MATH 20B,A02,083757,Staff,0,12,30,30
1650787285365,MATH 20C,A01,083760,Staff,0,17,30,30
1650787285365,MATH 20C,A02,083761,Staff,0,16,30,30
1650787285365,MATH 20C,B01,083762,Staff,9,0,30,21
1650787285365,MATH 20C,B02,083763,Staff,28,0,30,2
1650787291389,MATH 20D,A01,083765,Staff,2,1,30,28
1650787291389,MATH 20D,A02,083766,Staff,6,0,30,24
1650787291389,MATH 20D,A03,083767,Staff,24,0,30,6
1650787297415,MATH 20E,A01,083771,Staff,2,0,30,28
1650787297415,MATH 20E,A02,083772,Staff,15,0,30,15
1650787297415,MATH 20E,B01,083773,Staff,0,0,30,30
1650787297415,MATH 20E,B02,083774,Staff,5,0,30,25
1650787303444,MATH 103A,A01,083777,Staff,0,16,30,30
1650787303444,MATH 103A,A02,083778,Staff,0,15,30,30
1650787303444,MATH 103A,B01,083779,Staff,0,15,30,30
1650787303444,MATH 103A,B02,083780,Staff,0,15,30,30
1650787309468,MATH 105,A01,085443,Staff,0,22,30,30
1650787315492,MATH 109,A01,083213,Anzaldo; Leesa B,0,7,30,30
1650787315492,MATH 109,A02,083214,Anzaldo; Leesa B,0,7,30,30
1650787315492,MATH 109,B01,083215,Anzaldo; Leesa B,0,8,30,30
1650787315492,MATH 109,B02,083216,Anzaldo; Leesa B,0,7,30,30
1650787321521,MATH 142A,A01,083219,Chow; Bennett,0,16,30,30
1650787321521,MATH 142A,A02,083220,Chow; Bennett,0,15,30,30
1650787321521,MATH 142A,B01,083221,Chow; Bennett,0,16,30,30
1650787321521,MATH 142A,B02,083222,Chow; Bennett,0,14,30,30
1650787327545,MATH 193A,A01,083224,Staff,0,6,30,30
1650787327545,MATH 193A,A02,083225,Staff,0,6,30,30
1650787327545,MATH 193A,A03,083781,Staff,0,6,30,30
1650787327545,MATH 193A,A04,083782,Staff,0,7,30,30
1650787333568,MATH 197,001,091859,McAuley; Julian John,9998,0,9999,1
1650787339644,COGS 9,A01,083615,Staff,0,17,60,60
1650787345671,COGS 11,A01,083617,Boyle; Mary E. T.,16,0,40,24
1650787351698,COGS 13,A01,083071,Staff,0,38,40,40
1650787357735,COGS 14A,A01,092681,Staff,0,36,100,100
1650787363763,COGS 14B,A01,083073,Cheng; Tzu-Han,0,12,50,50
1650787369786,COGS 17,A01,092677,Staff,11,0,75,64
1650787375814,COGS 100,A01,083619,Staff,0,29,60,60
1650787381841,COGS 101A,A01,083621,Davis; Joshua Daniel,0,28,60,60
1650787387871,COGS 101B,A01,091572,Staff,0,3,60,60
1650787393895,COGS 101C,A01,083625,Delgado; Tania,14,0,30,16
1650787399918,COGS 107A,A01,083627,Boyle; Mary E. T.,0,16,60,60
1650787405944,COGS 118A,A01,083075,Staff,0,8,60,60
1650787411971,CSE 3,A50,083646,Miranda; Gregory Joseph,18,0,38,20
1650787411971,CSE 3,A51,083647,Miranda; Gregory Joseph,36,0,37,1
1650787417998,CSE 8A,A50,083650,Miranda; Gregory Joseph,0,29,40,40
1650787424023,CSE 11,A01,083080,Cao; Yingjun,0,96,40,40
1650787430050,CSE 12,A01,083652,Staff,0,21,100,100
1650787436074,CSE 15L,A01,083654,Staff,0,3,50,50
1650787436074,CSE 15L,A02,083655,Staff,0,2,50,50
1650787442098,CSE 20,A01,083657,Staff,49,0,80,31
1650787448122,CSE 30,A01,083084,Eldon; John,0,75,40,40
1650787454150,CSE 100,A01,083659,Cao; Yingjun,0,71,50,50
1650787460174,CSE 134B,A01,083661,Powell; Thomas Allan,0,38,65,65
1650787466201,CSE 140,A01,083663,Staff,0,11,75,75
1650787472228,CSE 140L,A01,083088,Eldon; John,0,20,75,75
1650787478251,CSE 175,A01,083665,Kumar; Rakesh,7,0,25,18
1650787484277,CSE 190,A00,092507,Dubnov; Shlomo,10,0,20,10
1650787490303,ECE 45,A01,083139,Staff,0,1,60,60
1650787496329,ECE 65,A50,083695,Staff,0,5,30,30
1650787502356,ECE 109,A01,091882,Touri; Behrouz,32,0,70,38
1650787508381,ECE 180,A00,083140,Abi Samra; Nicholas Camill,20,0,30,10
1650787508381,ECE 180,B00,083141,Abi Samra; Nicholas Camill,0,0,30,30
1650787514409,MATH 10A,A01,083735,Patchell; Gregory David,2,0,30,28
1650787514409,MATH 10A,A02,083736,Patchell; Gregory David,27,0,30,3
1650787514409,MATH 10A,A03,083737,Patchell; Gregory David,24,0,30,6
1650787520437,MATH 10B,A01,083207,Staff,0,9,30,30
1650787520437,MATH 10B,A02,083208,Staff,0,6,30,30
1650787520437,MATH 10B,B01,083739,Staff,11,0,30,19
1650787520437,MATH 10B,B02,083740,Staff,28,0,30,2
1650787526468,MATH 18,A01,083743,Staff,0,0,30,30
1650787526468,MATH 18,A02,083744,Staff,23,0,30,7
1650787526468,MATH 18,A03,083745,Staff,21,0,30,9
1650787526468,MATH 18,A04,083746,Staff,26,0,30,4
1650787526468,MATH 18,B01,083748,Staff,0,15,30,30
1650787526468,MATH 18,B02,083749,Staff,0,12,30,30
1650787526468,MATH 18,B03,083750,Staff,0,12,30,30
1650787526468,MATH 18,B04,083751,Staff,0,12,30,30
1650787532492,MATH 20A,A01,083754,Staff,19,0,40,21
1650787538524,MATH 20B,A01,083756,Staff,0,13,30,30
1650787538524,MATH 20B,A02,083757,Staff,0,12,30,30
1650787544551,MATH 20C,A01,083760,Staff,0,17,30,30
1650787544551,MATH 20C,A02,083761,Staff,0,16,30,30
1650787544551,MATH 20C,B01,083762,Staff,9,0,30,21
1650787544551,MATH 20C,B02,083763,Staff,28,0,30,2
1650787550578,MATH 20D,A01,083765,Staff,2,1,30,28
1650787550578,MATH 20D,A02,083766,Staff,6,0,30,24
1650787550578,MATH 20D,A03,083767,Staff,24,0,30,6
1650787556604,MATH 20E,A01,083771,Staff,2,0,30,28
1650787556604,MATH 20E,A02,083772,Staff,15,0,30,15
1650787556604,MATH 20E,B01,083773,Staff,0,0,30,30
1650787556604,MATH 20E,B02,083774,Staff,5,0,30,25
1650787562637,MATH 103A,A01,083777,Staff,0,16,30,30
1650787562637,MATH 103A,A02,083778,Staff,0,15,30,30
1650787562637,MATH 103A,B01,083779,Staff,0,15,30,30
1650787562637,MATH 103A,B02,083780,Staff,0,15,30,30
1650787568662,MATH 105,A01,085443,Staff,0,22,30,30
1650787574688,MATH 109,A01,083213,Anzaldo; Leesa B,0,7,30,30
1650787574688,MATH 109,A02,083214,Anzaldo; Leesa B,0,7,30,30
1650787574688,MATH 109,B01,083215,Anzaldo; Leesa B,0,8,30,30
1650787574688,MATH 109,B02,083216,Anzaldo; Leesa B,0,7,30,30
1650787580716,MATH 142A,A01,083219,Chow; Bennett,0,16,30,30
1650787580716,MATH 142A,A02,083220,Chow; Bennett,0,15,30,30
1650787580716,MATH 142A,B01,083221,Chow; Bennett,0,16,30,30
1650787580716,MATH 142A,B02,083222,Chow; Bennett,0,14,30,30
1650787586742,MATH 193A,A01,083224,Staff,0,6,30,30
1650787586742,MATH 193A,A02,083225,Staff,0,6,30,30
1650787586742,MATH 193A,A03,083781,Staff,0,6,30,30
1650787586742,MATH 193A,A04,083782,Staff,0,7,30,30
1650787592766,MATH 197,001,091859,McAuley; Julian John,9998,0,9999,1
1650787598830,COGS 9,A01,083615,Staff,0,17,60,60
1650787604860,COGS 11,A01,083617,Boyle; Mary E. T.,16,0,40,24
1650787610883,COGS 13,A01,083071,Staff,0,38,40,40
1650787616910,COGS 14A,A01,092681,Staff,0,36,100,100
1650787622942,COGS 14B,A01,083073,Cheng; Tzu-Han,0,12,50,50
1650787628966,COGS 17,A01,092677,Staff,11,0,75,64
1650787635065,COGS 100,A01,083619,Staff,0,29,60,60
1650787641093,COGS 101A,A01,083621,Davis; Joshua Daniel,0,28,60,60
1650787647122,COGS 101B,A01,091572,Staff,0,3,60,60
1650787653145,COGS 101C,A01,083625,Delgado; Tania,14,0,30,16
1650787659169,COGS 107A,A01,083627,Boyle; Mary E. T.,0,16,60,60
1650787665196,COGS 118A,A01,083075,Staff,0,8,60,60
1650787671224,CSE 3,A50,083646,Miranda; Gregory Joseph,18,0,38,20
1650787671224,CSE 3,A51,083647,Miranda; Gregory Joseph,36,0,37,1
1650787677249,CSE 8A,A50,083650,Miranda; Gregory Joseph,0,29,40,40
1650787683278,CSE 11,A01,083080,Cao; Yingjun,0,96,40,40
1650787689302,CSE 12,A01,083652,Staff,0,21,100,100
1650787695325,CSE 15L,A01,083654,Staff,0,3,50,50
1650787695325,CSE 15L,A02,083655,Staff,0,2,50,50
1650787701349,CSE 20,A01,083657,Staff,49,0,80,31
1650787707373,CSE 30,A01,083084,Eldon; John,0,75,40,40
1650787713399,CSE 100,A01,083659,Cao; Yingjun,0,71,50,50
1650787719428,CSE 134B,A01,083661,Powell; Thomas Allan,0,38,65,65
1650787725459,CSE 140,A01,083663,Staff,0,11,75,75
1650787731486,CSE 140L,A01,083088,Eldon; John,0,20,75,75
1650787737511,CSE 175,A01,083665,Kumar; Rakesh,7,0,25,18
1650787743539,CSE 190,A00,092507,Dubnov; Shlomo,10,0,20,10
1650787749568,ECE 45,A01,083139,Staff,0,1,60,60
1650787755594,ECE 65,A50,083695,Staff,0,5,30,30
1650787761619,ECE 109,A01,091882,Touri; Behrouz,32,0,70,38
1650787767647,ECE 180,A00,083140,Abi Samra; Nicholas Camill,20,0,30,10
1650787767647,ECE 180,B00,083141,Abi Samra; Nicholas Camill,0,0,30,30
1650787773674,MATH 10A,A01,083735,Patchell; Gregory David,2,0,30,28
1650787773674,MATH 10A,A02,083736,Patchell; Gregory David,27,0,30,3
1650787773674,MATH 10A,A03,083737,Patchell; Gregory David,24,0,30,6
1650787779699,MATH 10B,A01,083207,Staff,0,9,30,30
1650787779699,MATH 10B,A02,083208,Staff,0,6,30,30
1650787779699,MATH 10B,B01,083739,Staff,11,0,30,19
1650787779699,MATH 10B,B02,083740,Staff,28,0,30,2
1650787785728,MATH 18,A01,083743,Staff,0,0,30,30
1650787785728,MATH 18,A02,083744,Staff,23,0,30,7
1650787785728,MATH 18,A03,083745,Staff,21,0,30,9
1650787785728,MATH 18,A04,083746,Staff,26,0,30,4
1650787785728,MATH 18,B01,083748,Staff,0,15,30,30
1650787785728,MATH 18,B02,083749,Staff,0,12,30,30
1650787785728,MATH 18,B03,083750,Staff,0,12,30,30
1650787785728,MATH 18,B04,083751,Staff,0,12,30,30
1650787791752,MATH 20A,A01,083754,Staff,19,0,40,21
1650787797778,MATH 20B,A01,083756,Staff,0,13,30,30
1650787797778,MATH 20B,A02,083757,Staff,0,12,30,30
1650787803801,MATH 20C,A01,083760,Staff,0,17,30,30
1650787803801,MATH 20C,A02,083761,Staff,0,16,30,30
1650787803801,MATH 20C,B01,083762,Staff,9,0,30,21
1650787803801,MATH 20C,B02,083763,Staff,28,0,30,2
1650787809826,MATH 20D,A01,083765,Staff,2,1,30,28
1650787809826,MATH 20D,A02,083766,Staff,6,0,30,24
1650787809826,MATH 20D,A03,083767,Staff,24,0,30,6
1650787815850,MATH 20E,A01,083771,Staff,2,0,30,28
1650787815850,MATH 20E,A02,083772,Staff,15,0,30,15
1650787815850,MATH 20E,B01,083773,Staff,0,0,30,30
1650787815850,MATH 20E,B02,083774,Staff,5,0,30,25
1650787821880,MATH 103A,A01,083777,Staff,0,16,30,30
1650787821880,MATH 103A,A02,083778,Staff,0,15,30,30
1650787821880,MATH 103A,B01,083779,Staff,0,15,30,30
1650787821880,MATH 103A,B02,083780,Staff,0,15,30,30
1650787827908,MATH 105,A01,085443,Staff,0,22,30,30
1650787833933,MATH 109,A01,083213,Anzaldo; Leesa B,0,7,30,30
1650787833933,MATH 109,A02,083214,Anzaldo; Leesa B,0,7,30,30
1650787833933,MATH 109,B01,083215,Anzaldo; Leesa B,0,8,30,30
1650787833933,MATH 109,B02,083216,Anzaldo; Leesa B,0,7,30,30
1650787839976,MATH 142A,A01,083219,Chow; Bennett,0,16,30,30
1650787839976,MATH 142A,A02,083220,Chow; Bennett,0,15,30,30
1650787839976,MATH 142A,B01,083221,Chow; Bennett,0,16,30,30
1650787839976,MATH 142A,B02,083222,Chow; Bennett,0,14,30,30
1650787846006,MATH 193A,A01,083224,Staff,0,6,30,30
1650787846006,MATH 193A,A02,083225,Staff,0,6,30,30
1650787846006,MATH 193A,A03,083781,Staff,0,6,30,30
1650787846006,MATH 193A,A04,083782,Staff,0,7,30,30
1650787852030,MATH 197,001,091859,McAuley; Julian John,9998,0,9999,1
1650787858103,COGS 9,A01,083615,Staff,0,17,60,60
1650787864128,COGS 11,A01,083617,Boyle; Mary E. T.,16,0,40,24
1650787870161,COGS 13,A01,083071,Staff,0,38,40,40
1650787876188,COGS 14A,A01,092681,Staff,0,36,100,100
1650787882216,COGS 14B,A01,083073,Cheng; Tzu-Han,0,12,50,50
1650787888265,COGS 17,A01,092677,Staff,11,0,75,64
1650787894286,COGS 100,A01,083619,Staff,0,29,60,60
1650787900321,COGS 101A,A01,083621,Davis; Joshua Daniel,0,28,60,60
1650787906344,COGS 101B,A01,091572,Staff,0,3,60,60
1650787912371,COGS 101C,A01,083625,Delgado; Tania,14,0,30,16
1650787918408,COGS 107A,A01,083627,Boyle; Mary E. T.,0,16,60,60
1650787924436,COGS 118A,A01,083075,Staff,0,8,60,60
1650787930460,CSE 3,A50,083646,Miranda; Gregory Joseph,18,0,38,20
1650787930460,CSE 3,A51,083647,Miranda; Gregory Joseph,36,0,37,1
1650787936484,CSE 8A,A50,083650,Miranda; Gregory Joseph,0,29,40,40
1650787942508,CSE 11,A01,083080,Cao; Yingjun,0,96,40,40
1650787948531,CSE 12,A01,083652,Staff,0,21,100,100
1650787954555,CSE 15L,A01,083654,Staff,0,3,50,50
1650787954555,CSE 15L,A02,083655,Staff,0,2,50,50
1650787960582,CSE 20,A01,083657,Staff,49,0,80,31
1650787966606,CSE 30,A01,083084,Eldon; John,0,75,40,40
1650787972630,CSE 100,A01,083659,Cao; Yingjun,0,71,50,50
1650787978679,CSE 134B,A01,083661,Powell; Thomas Allan,0,38,65,65
1650787984704,CSE 140,A01,083663,Staff,0,11,75,75
1650787990728,CSE 140L,A01,083088,Eldon; John,0,20,75,75
1650787996756,CSE 175,A01,083665,Kumar; Rakesh,7,0,25,18
1650788002781,CSE 190,A00,092507,Dubnov; Shlomo,10,0,20,10
1650788008806,ECE 45,A01,083139,Staff,0,1,60,60
1650788014829,ECE 65,A50,083695,Staff,0,5,30,30
1650788020856,ECE 109,A01,091882,Touri; Behrouz,32,0,70,38
1650788026880,ECE 180,A00,083140,Abi Samra; Nicholas Camill,20,0,30,10
1650788026880,ECE 180,B00,083141,Abi Samra; Nicholas Camill,0,0,30,30
1650788032906,MATH 10A,A01,083735,Patchell; Gregory David,2,0,30,28
1650788032906,MATH 10A,A02,083736,Patchell; Gregory David,27,0,30,3
1650788032906,MATH 10A,A03,083737,Patchell; Gregory David,24,0,30,6
1650788038932,MATH 10B,A01,083207,Staff,0,9,30,30
1650788038932,MATH 10B,A02,083208,Staff,0,6,30,30
1650788038932,MATH 10B,B01,083739,Staff,11,0,30,19
1650788038932,MATH 10B,B02,083740,Staff,28,0,30,2
1650788044962,MATH 18,A01,083743,Staff,0,0,30,30
1650788044962,MATH 18,A02,083744,Staff,23,0,30,7
1650788044962,MATH 18,A03,083745,Staff,21,0,30,9
1650788044962,MATH 18,A04,083746,Staff,26,0,30,4
1650788044962,MATH 18,B01,083748,Staff,0,15,30,30
1650788044962,MATH 18,B02,083749,Staff,0,12,30,30
1650788044962,MATH 18,B03,083750,Staff,0,12,30,30
1650788044962,MATH 18,B04,083751,Staff,0,12,30,30
1650788050990,MATH 20A,A01,083754,Staff,19,0,40,21
1650788057018,MATH 20B,A01,083756,Staff,0,13,30,30
1650788057018,MATH 20B,A02,083757,Staff,0,12,30,30
1650788063047,MATH 20C,A01,083760,Staff,0,17,30,30
1650788063047,MATH 20C,A02,083761,Staff,0,16,30,30
1650788063047,MATH 20C,B01,083762,Staff,9,0,30,21
1650788063047,MATH 20C,B02,083763,Staff,28,0,30,2
1650788069077,MATH 20D,A01,083765,Staff,2,1,30,28
1650788069077,MATH 20D,A02,083766,Staff,6,0,30,24
1650788069077,MATH 20D,A03,083767,Staff,24,0,30,6
1650788075110,MATH 20E,A01,083771,Staff,2,0,30,28
1650788075110,MATH 20E,A02,083772,Staff,15,0,30,15
1650788075110,MATH 20E,B01,083773,Staff,0,0,30,30
1650788075110,MATH 20E,B02,083774,Staff,5,0,30,25
1650788081138,MATH 103A,A01,083777,Staff,0,16,30,30
1650788081138,MATH 103A,A02,083778,Staff,0,15,30,30
1650788081138,MATH 103A,B01,083779,Staff,0,15,30,30
1650788081138,MATH 103A,B02,083780,Staff,0,15,30,30
1650788087163,MATH 105,A01,085443,Staff,0,22,30,30
1650788093189,MATH 109,A01,083213,Anzaldo; Leesa B,0,7,30,30
1650788093189,MATH 109,A02,083214,Anzaldo; Leesa B,0,7,30,30
1650788093189,MATH 109,B01,083215,Anzaldo; Leesa B,0,8,30,30
1650788093189,MATH 109,B02,083216,Anzaldo; Leesa B,0,7,30,30
1650788099215,MATH 142A,A01,083219,Chow; Bennett,0,16,30,30
1650788099215,MATH 142A,A02,083220,Chow; Bennett,0,15,30,30
1650788099215,MATH 142A,B01,083221,Chow; Bennett,0,16,30,30
1650788099215,MATH 142A,B02,083222,Chow; Bennett,0,14,30,30
1650788105238,MATH 193A,A01,083224,Staff,0,6,30,30
1650788105238,MATH 193A,A02,083225,Staff,0,6,30,30
1650788105238,MATH 193A,A03,083781,Staff,0,6,30,30
1650788105238,MATH 193A,A04,083782,Staff,0,7,30,30
1650788111260,MATH 197,001,091859,McAuley; Julian John,9998,0,9999,1
1650788117327,COGS 9,A01,083615,Staff,0,17,60,60
1650788123354,COGS 11,A01,083617,Boyle; Mary E. T.,16,0,40,24
1650788129384,COGS 13,A01,083071,Staff,0,38,40,40
1650788135411,COGS 14A,A01,092681,Staff,0,36,100,100
1650788141434,COGS 14B,A01,083073,Cheng; Tzu-Han,0,12,50,50
1650788147461,COGS 17,A01,092677,Staff,11,0,75,64
1650788153495,COGS 100,A01,083619,Staff,0,29,60,60
1650788159524,COGS 101A,A01,083621,Davis; Joshua Daniel,0,28,60,60
1650788165548,COGS 101B,A01,091572,Staff,0,3,60,60
1650788171572,COGS 101C,A01,083625,Delgado; Tania,14,0,30,16
1650788177599,COGS 107A,A01,083627,Boyle; Mary E. T.,0,16,60,60
1650788183622,COGS 118A,A01,083075,Staff,0,8,60,60
1650788189646,CSE 3,A50,083646,Miranda; Gregory Joseph,18,0,38,20
1650788189646,CSE 3,A51,083647,Miranda; Gregory Joseph,36,0,37,1
1650788195675,CSE 8A,A50,083650,Miranda; Gregory Joseph,0,29,40,40
1650788201720,CSE 11,A01,083080,Cao; Yingjun,0,96,40,40
1650788207745,CSE 12,A01,083652,Staff,0,21,100,100
1650788213773,CSE 15L,A01,083654,Staff,0,3,50,50
1650788213773,CSE 15L,A02,083655,Staff,0,2,50,50
1650788219799,CSE 20,A01,083657,Staff,49,0,80,31
1650788225822,CSE 30,A01,083084,Eldon; John,0,75,40,40
1650788231939,CSE 100,A01,083659,Cao; Yingjun,0,71,50,50
1650788237962,CSE 134B,A01,083661,Powell; Thomas Allan,0,38,65,65
1650788243985,CSE 140,A01,083663,Staff,0,11,75,75
1650788250011,CSE 140L,A01,083088,Eldon; John,0,20,75,75
1650788256041,CSE 175,A01,083665,Kumar; Rakesh,7,0,25,18
1650788262064,CSE 190,A00,092507,Dubnov; Shlomo,10,0,20,10
1650788268091,ECE 45,A01,083139,Staff,0,1,60,60
1650788274118,ECE 65,A50,083695,Staff,0,5,30,30
1650788280153,ECE 109,A01,091882,Touri; Behrouz,32,0,70,38
1650788286177,ECE 180,A00,083140,Abi Samra; Nicholas Camill,20,0,30,10
1650788286177,ECE 180,B00,083141,Abi Samra; Nicholas Camill,0,0,30,30
1650788292205,MATH 10A,A01,083735,Patchell; Gregory David,2,0,30,28
1650788292205,MATH 10A,A02,083736,Patchell; Gregory David,27,0,30,3
1650788292205,MATH 10A,A03,083737,Patchell; Gregory David,24,0,30,6
1650788298228,MATH 10B,A01,083207,Staff,0,9,30,30
1650788298228,MATH 10B,A02,083208,Staff,0,6,30,30
1650788298228,MATH 10B,B01,083739,Staff,11,0,30,19
1650788298228,MATH 10B,B02,083740,Staff,28,0,30,2
1650788304253,MATH 18,A01,083743,Staff,0,0,30,30
1650788304253,MATH 18,A02,083744,Staff,23,0,30,7
1650788304253,MATH 18,A03,083745,Staff,21,0,30,9
1650788304253,MATH 18,A04,083746,Staff,26,0,30,4
1650788304253,MATH 18,B01,083748,Staff,0,15,30,30
1650788304253,MATH 18,B02,083749,Staff,0,12,30,30
1650788304253,MATH 18,B03,083750,Staff,0,12,30,30
1650788304253,MATH 18,B04,083751,Staff,0,12,30,30
1650788310276,MATH 20A,A01,083754,Staff,19,0,40,21
1650788316301,MATH 20B,A01,083756,Staff,0,13,30,30
1650788316301,MATH 20B,A02,083757,Staff,0,12,30,30
1650788322328,MATH 20C,A01,083760,Staff,0,17,30,30
1650788322328,MATH 20C,A02,083761,Staff,0,16,30,30
1650788322328,MATH 20C,B01,083762,Staff,9,0,30,21
1650788322328,MATH 20C,B02,083763,Staff,28,0,30,2
1650788328354,MATH 20D,A01,083765,Staff,2,1,30,28
1650788328354,MATH 20D,A02,083766,Staff,6,0,30,24
1650788328354,MATH 20D,A03,083767,Staff,24,0,30,6
1650788334379,MATH 20E,A01,083771,Staff,2,0,30,28
1650788334379,MATH 20E,A02,083772,Staff,15,0,30,15
1650788334379,MATH 20E,B01,083773,Staff,0,0,30,30
1650788334379,MATH 20E,B02,083774,Staff,5,0,30,25
1650788340408,MATH 103A,A01,083777,Staff,0,16,30,30
1650788340408,MATH 103A,A02,083778,Staff,0,15,30,30
1650788340408,MATH 103A,B01,083779,Staff,0,15,30,30
1650788340408,MATH 103A,B02,083780,Staff,0,15,30,30
1650788346434,MATH 105,A01,085443,Staff,0,22,30,30
1650788352464,MATH 109,A01,083213,Anzaldo; Leesa B,0,7,30,30
1650788352464,MATH 109,A02,083214,Anzaldo; Leesa B,0,7,30,30
1650788352464,MATH 109,B01,083215,Anzaldo; Leesa B,0,8,30,30
1650788352464,MATH 109,B02,083216,Anzaldo; Leesa B,0,7,30,30
1650788358491,MATH 142A,A01,083219,Chow; Bennett,0,16,30,30
1650788358491,MATH 142A,A02,083220,Chow; Bennett,0,15,30,30
1650788358491,MATH 142A,B01,083221,Chow; Bennett,0,16,30,30
1650788358491,MATH 142A,B02,083222,Chow; Bennett,0,14,30,30
1650788364514,MATH 193A,A01,083224,Staff,0,6,30,30
1650788364514,MATH 193A,A02,083225,Staff,0,6,30,30
1650788364514,MATH 193A,A03,083781,Staff,0,6,30,30
1650788364514,MATH 193A,A04,083782,Staff,0,7,30,30
1650788370535,MATH 197,001,091859,McAuley; Julian John,9998,0,9999,1
1650788376590,COGS 9,A01,083615,Staff,0,17,60,60
1650788382616,COGS 11,A01,083617,Boyle; Mary E. T.,16,0,40,24
1650788388658,COGS 13,A01,083071,Staff,0,38,40,40
1650788394691,COGS 14A,A01,092681,Staff,0,36,100,100
1650788400719,COGS 14B,A01,083073,Cheng; Tzu-Han,0,12,50,50
1650788406753,COGS 17,A01,092677,Staff,11,0,75,64
1650788412780,COGS 100,A01,083619,Staff,0,29,60,60
1650788418807,COGS 101A,A01,083621,Davis; Joshua Daniel,0,28,60,60
1650788424831,COGS 101B,A01,091572,Staff,0,3,60,60
1650788430866,COGS 101C,A01,083625,Delgado; Tania,14,0,30,16
1650788436890,COGS 107A,A01,083627,Boyle; Mary E. T.,0,16,60,60
1650788442914,COGS 118A,A01,083075,Staff,0,8,60,60
1650788448939,CSE 3,A50,083646,Miranda; Gregory Joseph,18,0,38,20
1650788448939,CSE 3,A51,083647,Miranda; Gregory Joseph,36,0,37,1
1650788454966,CSE 8A,A50,083650,Miranda; Gregory Joseph,0,29,40,40
1650788460992,CSE 11,A01,083080,Cao; Yingjun,0,96,40,40
1650788467018,CSE 12,A01,083652,Staff,0,21,100,100
1650788473046,CSE 15L,A01,083654,Staff,0,3,50,50
1650788473046,CSE 15L,A02,083655,Staff,0,2,50,50
1650788479075,CSE 20,A01,083657,Staff,49,0,80,31
1650788485099,CSE 30,A01,083084,Eldon; John,0,75,40,40
1650788491133,CSE 100,A01,083659,Cao; Yingjun,0,71,50,50
1650788497158,CSE 134B,A01,083661,Powell; Thomas Allan,0,38,65,65
1650788503185,CSE 140,A01,083663,Staff,0,11,75,75
1650788509211,CSE 140L,A01,083088,Eldon; John,0,20,75,75
1650788515235,CSE 175,A01,083665,Kumar; Rakesh,7,0,25,18
1650788521261,CSE 190,A00,092507,Dubnov; Shlomo,10,0,20,10
1650788527289,ECE 45,A01,083139,Staff,0,1,60,60
1650788533314,ECE 65,A50,083695,Staff,0,5,30,30
1650788539338,ECE 109,A01,091882,Touri; Behrouz,32,0,70,38
1650788545362,ECE 180,A00,083140,Abi Samra; Nicholas Camill,20,0,30,10
1650788545362,ECE 180,B00,083141,Abi Samra; Nicholas Camill,0,0,30,30
1650788551386,MATH 10A,A01,083735,Patchell; Gregory David,2,0,30,28
1650788551386,MATH 10A,A02,083736,Patchell; Gregory David,27,0,30,3
1650788551386,MATH 10A,A03,083737,Patchell; Gregory David,24,0,30,6
1650788557418,MATH 10B,A01,083207,Staff,0,9,30,30
1650788557418,MATH 10B,A02,083208,Staff,0,6,30,30
1650788557418,MATH 10B,B01,083739,Staff,11,0,30,19
1650788557418,MATH 10B,B02,083740,Staff,28,0,30,2
1650788563444,MATH 18,A01,083743,Staff,0,0,30,30
1650788563444,MATH 18,A02,083744,Staff,23,0,30,7
1650788563444,MATH 18,A03,083745,Staff,21,0,30,9
1650788563444,MATH 18,A04,083746,Staff,26,0,30,4
1650788563444,MATH 18,B01,083748,Staff,0,15,30,30
1650788563444,MATH 18,B02,083749,Staff,0,12,30,30
1650788563444,MATH 18,B03,083750,Staff,0,12,30,30
1650788563444,MATH 18,B04,083751,Staff,0,12,30,30
1650788569465,MATH 20A,A01,083754,Staff,19,0,40,21
1650788575493,MATH 20B,A01,083756,Staff,0,13,30,30
1650788575493,MATH 20B,A02,083757,Staff,0,12,30,30
1650788581531,MATH 20C,A01,083760,Staff,0,17,30,30
1650788581531,MATH 20C,A02,083761,Staff,0,16,30,30
1650788581531,MATH 20C,B01,083762,Staff,9,0,30,21
1650788581531,MATH 20C,B02,083763,Staff,28,0,30,2
1650788587554,MATH 20D,A01,083765,Staff,2,1,30,28
1650788587554,MATH 20D,A02,083766,Staff,6,0,30,24
1650788587554,MATH 20D,A03,083767,Staff,24,0,30,6
1650788593582,MATH 20E,A01,083771,Staff,2,0,30,28
1650788593582,MATH 20E,A02,083772,Staff,15,0,30,15
1650788593582,MATH 20E,B01,083773,Staff,0,0,30,30
1650788593582,MATH 20E,B02,083774,Staff,5,0,30,25
1650788599611,MATH 103A,A01,083777,Staff,0,16,30,30
1650788599611,MATH 103A,A02,083778,Staff,0,15,30,30
1650788599611,MATH 103A,B01,083779,Staff,0,15,30,30
1650788599611,MATH 103A,B02,083780,Staff,0,15,30,30
1650788605644,MATH 105,A01,085443,Staff,0,22,30,30
1650788611668,MATH 109,A01,083213,Anzaldo; Leesa B,0,7,30,30
1650788611668,MATH 109,A02,083214,Anzaldo; Leesa B,0,7,30,30
1650788611668,MATH 109,B01,083215,Anzaldo; Leesa B,0,8,30,30
1650788611668,MATH 109,B02,083216,Anzaldo; Leesa B,0,7,30,30
1650788617693,MATH 142A,A01,083219,Chow; Bennett,0,16,30,30
1650788617693,MATH 142A,A02,083220,Chow; Bennett,0,15,30,30
1650788617693,MATH 142A,B01,083221,Chow; Bennett,0,16,30,30
1650788617693,MATH 142A,B02,083222,Chow; Bennett,0,14,30,30
1650788623728,MATH 193A,A01,083224,Staff,0,6,30,30
1650788623728,MATH 193A,A02,083225,Staff,0,6,30,30
1650788623728,MATH 193A,A03,083781,Staff,0,6,30,30
1650788623728,MATH 193A,A04,083782,Staff,0,7,30,30
1650788629755,MATH 197,001,091859,McAuley; Julian John,9998,0,9999,1
1650788635807,COGS 9,A01,083615,Staff,0,17,60,60
1650788641832,COGS 11,A01,083617,Boyle; Mary E. T.,16,0,40,24
1650788647857,COGS 13,A01,083071,Staff,0,38,40,40
1650788653883,COGS 14A,A01,092681,Staff,0,36,100,100
1650788659906,COGS 14B,A01,083073,Cheng; Tzu-Han,0,12,50,50
1650788665933,COGS 17,A01,092677,Staff,11,0,75,64
1650788671960,COGS 100,A01,083619,Staff,0,29,60,60
1650788678002,COGS 101A,A01,083621,Davis; Joshua Daniel,0,28,60,60
1650788684027,COGS 101B,A01,091572,Staff,0,3,60,60
1650788690050,COGS 101C,A01,083625,Delgado; Tania,14,0,30,16
1650788696077,COGS 107A,A01,083627,Boyle; Mary E. T.,0,16,60,60
1650788702103,COGS 118A,A01,083075,Staff,0,8,60,60
1650788708133,CSE 3,A50,083646,Miranda; Gregory Joseph,18,0,38,20
1650788708133,CSE 3,A51,083647,Miranda; Gregory Joseph,36,0,37,1
1650788714157,CSE 8A,A50,083650,Miranda; Gregory Joseph,0,29,40,40
1650788720179,CSE 11,A01,083080,Cao; Yingjun,0,96,40,40
1650788726203,CSE 12,A01,083652,Staff,0,21,100,100
1650788732227,CSE 15L,A01,083654,Staff,0,3,50,50
1650788732227,CSE 15L,A02,083655,Staff,0,2,50,50
1650788738251,CSE 20,A01,083657,Staff,49,0,80,31
1650788744277,CSE 30,A01,083084,Eldon; John,0,75,40,40
1650788750302,CSE 100,A01,083659,Cao; Yingjun,0,71,50,50
1650788756327,CSE 134B,A01,083661,Powell; Thomas Allan,0,38,65,65
1650788762351,CSE 140,A01,083663,Staff,0,11,75,75
1650788768374,CSE 140L,A01,083088,Eldon; John,0,20,75,75
1650788774408,CSE 175,A01,083665,Kumar; Rakesh,7,0,25,18
1650788780433,CSE 190,A00,092507,Dubnov; Shlomo,10,0,20,10
1650788786462,ECE 45,A01,083139,Staff,0,1,60,60
1650788792487,ECE 65,A50,083695,Staff,0,5,30,30
1650788798516,ECE 109,A01,091882,Touri; Behrouz,32,0,70,38
1650788804542,ECE 180,A00,083140,Abi Samra; Nicholas Camill,20,0,30,10
1650788804542,ECE 180,B00,083141,Abi Samra; Nicholas Camill,0,0,30,30
1650788810572,MATH 10A,A01,083735,Patchell; Gregory David,2,0,30,28
1650788810572,MATH 10A,A02,083736,Patchell; Gregory David,27,0,30,3
1650788810572,MATH 10A,A03,083737,Patchell; Gregory David,24,0,30,6
1650788816598,MATH 10B,A01,083207,Staff,0,9,30,30
1650788816598,MATH 10B,A02,083208,Staff,0,6,30,30
1650788816598,MATH 10B,B01,083739,Staff,11,0,30,19
1650788816598,MATH 10B,B02,083740,Staff,28,0,30,2
1650788822638,MATH 18,A01,083743,Staff,0,0,30,30
1650788822638,MATH 18,A02,083744,Staff,23,0,30,7
1650788822638,MATH 18,A03,083745,Staff,21,0,30,9
1650788822638,MATH 18,A04,083746,Staff,26,0,30,4
1650788822638,MATH 18,B01,083748,Staff,0,15,30,30
1650788822638,MATH 18,B02,083749,Staff,0,12,30,30
1650788822638,MATH 18,B03,083750,Staff,0,12,30,30
1650788822638,MATH 18,B04,083751,Staff,0,12,30,30
1650788828753,MATH 20A,A01,083754,Staff,19,0,40,21
1650788834778,MATH 20B,A01,083756,Staff,0,13,30,30
1650788834778,MATH 20B,A02,083757,Staff,0,12,30,30
1650788840803,MATH 20C,A01,083760,Staff,0,17,30,30
1650788840803,MATH 20C,A02,083761,Staff,0,16,30,30
1650788840803,MATH 20C,B01,083762,Staff,9,0,30,21
1650788840803,MATH 20C,B02,083763,Staff,28,0,30,2
1650788846830,MATH 20D,A01,083765,Staff,2,1,30,28
1650788846830,MATH 20D,A02,083766,Staff,6,0,30,24
1650788846830,MATH 20D,A03,083767,Staff,24,0,30,6
1650788852862,MATH 20E,A01,083771,Staff,2,0,30,28
1650788852862,MATH 20E,A02,083772,Staff,15,0,30,15
1650788852862,MATH 20E,B01,083773,Staff,0,0,30,30
1650788852862,MATH 20E,B02,083774,Staff,5,0,30,25
1650788858897,MATH 103A,A01,083777,Staff,0,16,30,30
1650788858897,MATH 103A,A02,083778,Staff,0,15,30,30
1650788858897,MATH 103A,B01,083779,Staff,0,15,30,30
1650788858897,MATH 103A,B02,083780,Staff,0,15,30,30
1650788864922,MATH 105,A01,085443,Staff,0,22,30,30
1650788870947,MATH 109,A01,083213,Anzaldo; Leesa B,0,7,30,30
1650788870947,MATH 109,A02,083214,Anzaldo; Leesa B,0,7,30,30
1650788870947,MATH 109,B01,083215,Anzaldo; Leesa B,0,8,30,30
1650788870947,MATH 109,B02,083216,Anzaldo; Leesa B,0,7,30,30
1650788876976,MATH 142A,A01,083219,Chow; Bennett,0,16,30,30
1650788876976,MATH 142A,A02,083220,Chow; Bennett,0,15,30,30
1650788876976,MATH 142A,B01,083221,Chow; Bennett,0,16,30,30
1650788876976,MATH 142A,B02,083222,Chow; Bennett,0,14,30,30
1650788883004,MATH 193A,A01,083224,Staff,0,6,30,30
1650788883004,MATH 193A,A02,083225,Staff,0,6,30,30
1650788883004,MATH 193A,A03,083781,Staff,0,6,30,30
1650788883004,MATH 193A,A04,083782,Staff,0,7,30,30
1650788889028,MATH 197,001,091859,McAuley; Julian John,9998,0,9999,1
1650788895097,COGS 9,A01,083615,Staff,0,17,60,60
1650788901120,COGS 11,A01,083617,Boyle; Mary E. T.,16,0,40,24
1650788907143,COGS 13,A01,083071,Staff,0,38,40,40
1650788913166,COGS 14A,A01,092681,Staff,0,36,100,100
1650788919202,COGS 14B,A01,083073,Cheng; Tzu-Han,0,12,50,50
1650788925231,COGS 17,A01,092677,Staff,11,0,75,64
1650788931256,COGS 100,A01,083619,Staff,0,29,60,60
1650788937284,COGS 101A,A01,083621,Davis; Joshua Daniel,0,28,60,60
1650788943312,COGS 101B,A01,091572,Staff,0,3,60,60
1650788949340,COGS 101C,A01,083625,Delgado; Tania,14,0,30,16
1650788955364,COGS 107A,A01,083627,Boyle; Mary E. T.,0,16,60,60
1650788961393,COGS 118A,A01,083075,Staff,0,8,60,60
1650788967420,CSE 3,A50,083646,Miranda; Gregory Joseph,18,0,38,20
1650788967420,CSE 3,A51,083647,Miranda; Gregory Joseph,36,0,37,1
1650788973447,CSE 8A,A50,083650,Miranda; Gregory Joseph,0,29,40,40
1650788979472,CSE 11,A01,083080,Cao; Yingjun,0,96,40,40
1650788985499,CSE 12,A01,083652,Staff,0,21,100,100
1650788991523,CSE 15L,A01,083654,Staff,0,3,50,50
1650788991523,CSE 15L,A02,083655,Staff,0,2,50,50
1650788997546,CSE 20,A01,083657,Staff,49,0,80,31
1650789003570,CSE 30,A01,083084,Eldon; John,0,75,40,40
1650789009597,CSE 100,A01,083659,Cao; Yingjun,0,71,50,50
1650789015626,CSE 134B,A01,083661,Powell; Thomas Allan,0,38,65,65
1650789021650,CSE 140,A01,083663,Staff,0,11,75,75
1650789027674,CSE 140L,A01,083088,Eldon; John,0,20,75,75
1650789033698,CSE 175,A01,083665,Kumar; Rakesh,7,0,25,18
1650789039723,CSE 190,A00,092507,Dubnov; Shlomo,10,0,20,10
1650789045747,ECE 45,A01,083139,Staff,0,1,60,60
1650789055274,ECE 65,A50,083695,Staff,0,5,30,30
1650789061302,ECE 109,A01,091882,Touri; Behrouz,32,0,70,38
1650789067333,ECE 180,A00,083140,Abi Samra; Nicholas Camill,20,0,30,10
1650789067333,ECE 180,B00,083141,Abi Samra; Nicholas Camill,0,0,30,30
1650789073358,MATH 10A,A01,083735,Patchell; Gregory David,2,0,30,28
1650789073358,MATH 10A,A02,083736,Patchell; Gregory David,27,0,30,3
1650789073358,MATH 10A,A03,083737,Patchell; Gregory David,24,0,30,6
1650789079387,MATH 10B,A01,083207,Staff,0,9,30,30
1650789079387,MATH 10B,A02,083208,Staff,0,6,30,30
1650789079387,MATH 10B,B01,083739,Staff,11,0,30,19
1650789079387,MATH 10B,B02,083740,Staff,28,0,30,2
1650789085415,MATH 18,A01,083743,Staff,0,0,30,30
1650789085415,MATH 18,A02,083744,Staff,23,0,30,7
1650789085415,MATH 18,A03,083745,Staff,21,0,30,9
1650789085415,MATH 18,A04,083746,Staff,26,0,30,4
1650789085415,MATH 18,B01,083748,Staff,0,15,30,30
1650789085415,MATH 18,B02,083749,Staff,0,12,30,30
1650789085415,MATH 18,B03,083750,Staff,0,12,30,30
1650789085415,MATH 18,B04,083751,Staff,0,12,30,30
1650789091441,MATH 20A,A01,083754,Staff,19,0,40,21
1650789097465,MATH 20B,A01,083756,Staff,0,13,30,30
1650789097465,MATH 20B,A02,083757,Staff,0,12,30,30
1650789103494,MATH 20C,A01,083760,Staff,0,17,30,30
1650789103494,MATH 20C,A02,083761,Staff,0,16,30,30
1650789103494,MATH 20C,B01,083762,Staff,9,0,30,21
1650789103494,MATH 20C,B02,083763,Staff,28,0,30,2
1650789109524,MATH 20D,A01,083765,Staff,2,1,30,28
1650789109524,MATH 20D,A02,083766,Staff,6,0,30,24
1650789109524,MATH 20D,A03,083767,Staff,24,0,30,6
1650789115554,MATH 20E,A01,083771,Staff,2,0,30,28
1650789115554,MATH 20E,A02,083772,Staff,15,0,30,15
1650789115554,MATH 20E,B01,083773,Staff,0,0,30,30
1650789115554,MATH 20E,B02,083774,Staff,5,0,30,25
1650789121579,MATH 103A,A01,083777,Staff,0,16,30,30
1650789121579,MATH 103A,A02,083778,Staff,0,15,30,30
1650789121579,MATH 103A,B01,083779,Staff,0,15,30,30
1650789121579,MATH 103A,B02,083780,Staff,0,15,30,30
1650789127603,MATH 105,A01,085443,Staff,0,22,30,30
1650789133628,MATH 109,A01,083213,Anzaldo; Leesa B,0,7,30,30
1650789133628,MATH 109,A02,083214,Anzaldo; Leesa B,0,7,30,30
1650789133628,MATH 109,B01,083215,Anzaldo; Leesa B,0,8,30,30
1650789133628,MATH 109,B02,083216,Anzaldo; Leesa B,0,7,30,30
1650789139659,MATH 142A,A01,083219,Chow; Bennett,0,16,30,30
1650789139659,MATH 142A,A02,083220,Chow; Bennett,0,15,30,30
1650789139659,MATH 142A,B01,083221,Chow; Bennett,0,16,30,30
1650789139659,MATH 142A,B02,083222,Chow; Bennett,0,14,30,30
1650789145688,MATH 193A,A01,083224,Staff,0,6,30,30
1650789145688,MATH 193A,A02,083225,Staff,0,6,30,30
1650789145688,MATH 193A,A03,083781,Staff,0,6,30,30
1650789145688,MATH 193A,A04,083782,Staff,0,7,30,30
1650789151714,MATH 197,001,091859,McAuley; Julian John,9998,0,9999,1
1650789157783,COGS 9,A01,083615,Staff,0,17,60,60
1650789163809,COGS 11,A01,083617,Boyle; Mary E. T.,16,0,40,24
1650789169841,COGS 13,A01,083071,Staff,0,38,40,40
1650789175868,COGS 14A,A01,092681,Staff,0,36,100,100
1650789181892,COGS 14B,A01,083073,Cheng; Tzu-Han,0,12,50,50
1650789187915,COGS 17,A01,092677,Staff,11,0,75,64
1650789193944,COGS 100,A01,083619,Staff,0,29,60,60
1650789199972,COGS 101A,A01,083621,Davis; Joshua Daniel,0,28,60,60
1650789205997,COGS 101B,A01,091572,Staff,0,3,60,60
1650789212022,COGS 101C,A01,083625,Delgado; Tania,14,0,30,16
1650789218051,COGS 107A,A01,083627,Boyle; Mary E. T.,0,16,60,60
1650789224086,COGS 118A,A01,083075,Staff,0,8,60,60
1650789230115,CSE 3,A50,083646,Miranda; Gregory Joseph,18,0,38,20
1650789230115,CSE 3,A51,083647,Miranda; Gregory Joseph,36,0,37,1
1650789236143,CSE 8A,A50,083650,Miranda; Gregory Joseph,0,29,40,40
1650789242168,CSE 11,A01,083080,Cao; Yingjun,0,96,40,40
1650789248192,CSE 12,A01,083652,Staff,0,21,100,100
1650789254215,CSE 15L,A01,083654,Staff,0,3,50,50
1650789254215,CSE 15L,A02,083655,Staff,0,2,50,50
1650789260240,CSE 20,A01,083657,Staff,49,0,80,31
1650789266265,CSE 30,A01,083084,Eldon; John,0,75,40,40
1650789272295,CSE 100,A01,083659,Cao; Yingjun,0,71,50,50
1650789278319,CSE 134B,A01,083661,Powell; Thomas Allan,0,38,65,65
1650789284342,CSE 140,A01,083663,Staff,0,11,75,75
1650789290367,CSE 140L,A01,083088,Eldon; John,0,20,75,75
1650789296393,CSE 175,A01,083665,Kumar; Rakesh,7,0,25,18
1650789302421,CSE 190,A00,092507,Dubnov; Shlomo,10,0,20,10
1650789308445,ECE 45,A01,083139,Staff,0,1,60,60
1650789314471,ECE 65,A50,083695,Staff,0,5,30,30
1650789320495,ECE 109,A01,091882,Touri; Behrouz,32,0,70,38
1650789326527,ECE 180,A00,083140,Abi Samra; Nicholas Camill,20,0,30,10
1650789326527,ECE 180,B00,083141,Abi Samra; Nicholas Camill,0,0,30,30
1650789332564,MATH 10A,A01,083735,Patchell; Gregory David,2,0,30,28
1650789332564,MATH 10A,A02,083736,Patchell; Gregory David,27,0,30,3
1650789332564,MATH 10A,A03,083737,Patchell; Gregory David,24,0,30,6
1650789338591,MATH 10B,A01,083207,Staff,0,9,30,30
1650789338591,MATH 10B,A02,083208,Staff,0,6,30,30
1650789338591,MATH 10B,B01,083739,Staff,11,0,30,19
1650789338591,MATH 10B,B02,083740,Staff,28,0,30,2
1650789344619,MATH 18,A01,083743,Staff,0,0,30,30
1650789344619,MATH 18,A02,083744,Staff,23,0,30,7
1650789344619,MATH 18,A03,083745,Staff,21,0,30,9
1650789344619,MATH 18,A04,083746,Staff,26,0,30,4
1650789344619,MATH 18,B01,083748,Staff,0,15,30,30
1650789344619,MATH 18,B02,083749,Staff,0,12,30,30
1650789344619,MATH 18,B03,083750,Staff,0,12,30,30
1650789344619,MATH 18,B04,083751,Staff,0,12,30,30
1650789350648,MATH 20A,A01,083754,Staff,19,0,40,21
1650789356679,MATH 20B,A01,083756,Staff,0,13,30,30
1650789356679,MATH 20B,A02,083757,Staff,0,12,30,30
1650789362708,MATH 20C,A01,083760,Staff,0,17,30,30
1650789362708,MATH 20C,A02,083761,Staff,0,16,30,30
1650789362708,MATH 20C,B01,083762,Staff,9,0,30,21
1650789362708,MATH 20C,B02,083763,Staff,28,0,30,2
1650789368733,MATH 20D,A01,083765,Staff,2,1,30,28
1650789368733,MATH 20D,A02,083766,Staff,6,0,30,24
1650789368733,MATH 20D,A03,083767,Staff,24,0,30,6
1650789374765,MATH 20E,A01,083771,Staff,2,0,30,28
1650789374765,MATH 20E,A02,083772,Staff,15,0,30,15
1650789374765,MATH 20E,B01,083773,Staff,0,0,30,30
1650789374765,MATH 20E,B02,083774,Staff,5,0,30,25
1650789380791,MATH 103A,A01,083777,Staff,0,16,30,30
1650789380791,MATH 103A,A02,083778,Staff,0,15,30,30
1650789380791,MATH 103A,B01,083779,Staff,0,15,30,30
1650789380791,MATH 103A,B02,083780,Staff,0,15,30,30
1650789386816,MATH 105,A01,085443,Staff,0,22,30,30
1650789392847,MATH 109,A01,083213,Anzaldo; Leesa B,0,7,30,30
1650789392847,MATH 109,A02,083214,Anzaldo; Leesa B,0,7,30,30
1650789392847,MATH 109,B01,083215,Anzaldo; Leesa B,0,8,30,30
1650789392847,MATH 109,B02,083216,Anzaldo; Leesa B,0,7,30,30
1650789398878,MATH 142A,A01,083219,Chow; Bennett,0,16,30,30
1650789398878,MATH 142A,A02,083220,Chow; Bennett,0,15,30,30
1650789398878,MATH 142A,B01,083221,Chow; Bennett,0,16,30,30
1650789398878,MATH 142A,B02,083222,Chow; Bennett,0,14,30,30
1650789404904,MATH 193A,A01,083224,Staff,0,6,30,30
1650789404904,MATH 193A,A02,083225,Staff,0,6,30,30
1650789404904,MATH 193A,A03,083781,Staff,0,6,30,30
1650789404904,MATH 193A,A04,083782,Staff,0,7,30,30
1650789410931,MATH 197,001,091859,McAuley; Julian John,9998,0,9999,1
1650789416992,COGS 9,A01,083615,Staff,0,17,60,60
1650789423108,COGS 11,A01,083617,Boyle; Mary E. T.,16,0,40,24
1650789429133,COGS 13,A01,083071,Staff,0,38,40,40
1650789435162,COGS 14A,A01,092681,Staff,0,36,100,100
1650789441186,COGS 14B,A01,083073,Cheng; Tzu-Han,0,12,50,50
1650789447209,COGS 17,A01,092677,Staff,11,0,75,64
1650789453238,COGS 100,A01,083619,Staff,0,29,60,60
1650789459268,COGS 101A,A01,083621,Davis; Joshua Daniel,0,28,60,60
1650789465292,COGS 101B,A01,091572,Staff,0,3,60,60
1650789471316,COGS 101C,A01,083625,Delgado; Tania,14,0,30,16
1650789477345,COGS 107A,A01,083627,Boyle; Mary E. T.,0,16,60,60
1650789483373,COGS 118A,A01,083075,Staff,0,8,60,60
1650789489404,CSE 3,A50,083646,Miranda; Gregory Joseph,18,0,38,20
1650789489404,CSE 3,A51,083647,Miranda; Gregory Joseph,36,0,37,1
1650789495429,CSE 8A,A50,083650,Miranda; Gregory Joseph,0,29,40,40
1650789501456,CSE 11,A01,083080,Cao; Yingjun,0,96,40,40
1650789507480,CSE 12,A01,083652,Staff,0,21,100,100
1650789513503,CSE 15L,A01,083654,Staff,0,3,50,50
1650789513503,CSE 15L,A02,083655,Staff,0,2,50,50
1650789519531,CSE 20,A01,083657,Staff,49,0,80,31
1650789525559,CSE 30,A01,083084,Eldon; John,0,75,40,40
1650789531583,CSE 100,A01,083659,Cao; Yingjun,0,71,50,50
1650789537610,CSE 134B,A01,083661,Powell; Thomas Allan,0,38,65,65
1650789543639,CSE 140,A01,083663,Staff,0,11,75,75
1650789549667,CSE 140L,A01,083088,Eldon; John,0,20,75,75
1650789555695,CSE 175,A01,083665,Kumar; Rakesh,7,0,25,18
1650789561722,CSE 190,A00,092507,Dubnov; Shlomo,10,0,20,10
1650789567750,ECE 45,A01,083139,Staff,0,1,60,60
1650789573779,ECE 65,A50,083695,Staff,0,5,30,30
1650789579803,ECE 109,A01,091882,Touri; Behrouz,32,0,70,38
1650789585828,ECE 180,A00,083140,Abi Samra; Nicholas Camill,20,0,30,10
1650789585828,ECE 180,B00,083141,Abi Samra; Nicholas Camill,0,0,30,30
1650789591859,MATH 10A,A01,083735,Patchell; Gregory David,2,0,30,28
1650789591859,MATH 10A,A02,083736,Patchell; Gregory David,27,0,30,3
1650789591859,MATH 10A,A03,083737,Patchell; Gregory David,24,0,30,6
1650789597887,MATH 10B,A01,083207,Staff,0,9,30,30
1650789597887,MATH 10B,A02,083208,Staff,0,6,30,30
1650789597887,MATH 10B,B01,083739,Staff,11,0,30,19
1650789597887,MATH 10B,B02,083740,Staff,28,0,30,2
1650789603921,MATH 18,A01,083743,Staff,0,0,30,30
1650789603921,MATH 18,A02,083744,Staff,23,0,30,7
1650789603921,MATH 18,A03,083745,Staff,21,0,30,9
1650789603921,MATH 18,A04,083746,Staff,26,0,30,4
1650789603921,MATH 18,B01,083748,Staff,0,15,30,30
1650789603921,MATH 18,B02,083749,Staff,0,12,30,30
1650789603921,MATH 18,B03,083750,Staff,0,12,30,30
1650789603921,MATH 18,B04,083751,Staff,0,12,30,30
1650789609945,MATH 20A,A01,083754,Staff,19,0,40,21
1650789615970,MATH 20B,A01,083756,Staff,0,13,30,30
1650789615970,MATH 20B,A02,083757,Staff,0,12,30,30
1650789622000,MATH 20C,A01,083760,Staff,0,17,30,30
1650789622000,MATH 20C,A02,083761,Staff,0,16,30,30
1650789622000,MATH 20C,B01,083762,Staff,9,0,30,21
1650789622000,MATH 20C,B02,083763,Staff,28,0,30,2
1650789628028,MATH 20D,A01,083765,Staff,2,1,30,28
1650789628028,MATH 20D,A02,083766,Staff,6,0,30,24
1650789628028,MATH 20D,A03,083767,Staff,24,0,30,6
1650789634062,MATH 20E,A01,083771,Staff,2,0,30,28
1650789634062,MATH 20E,A02,083772,Staff,15,0,30,15
1650789634062,MATH 20E,B01,083773,Staff,0,0,30,30
1650789634062,MATH 20E,B02,083774,Staff,5,0,30,25
1650789640087,MATH 103A,A01,083777,Staff,0,16,30,30
1650789640087,MATH 103A,A02,083778,Staff,0,15,30,30
1650789640087,MATH 103A,B01,083779,Staff,0,15,30,30
1650789640087,MATH 103A,B02,083780,Staff,0,15,30,30
1650789646111,MATH 105,A01,085443,Staff,0,22,30,30
1650789652139,MATH 109,A01,083213,Anzaldo; Leesa B,0,7,30,30
1650789652139,MATH 109,A02,083214,Anzaldo; Leesa B,0,7,30,30
1650789652139,MATH 109,B01,083215,Anzaldo; Leesa B,0,8,30,30
1650789652139,MATH 109,B02,083216,Anzaldo; Leesa B,0,7,30,30
1650789658170,MATH 142A,A01,083219,Chow; Bennett,0,16,30,30
1650789658170,MATH 142A,A02,083220,Chow; Bennett,0,15,30,30
1650789658170,MATH 142A,B01,083221,Chow; Bennett,0,16,30,30
1650789658170,MATH 142A,B02,083222,Chow; Bennett,0,14,30,30
1650789664194,MATH 193A,A01,083224,Staff,0,6,30,30
1650789664194,MATH 193A,A02,083225,Staff,0,6,30,30
1650789664194,MATH 193A,A03,083781,Staff,0,6,30,30
1650789664194,MATH 193A,A04,083782,Staff,0,7,30,30
1650789670222,MATH 197,001,091859,McAuley; Julian John,9998,0,9999,1
1650789676282,COGS 9,A01,083615,Staff,0,17,60,60
1650789682309,COGS 11,A01,083617,Boyle; Mary E. T.,16,0,40,24
1650789688342,COGS 13,A01,083071,Staff,0,38,40,40
1650789694368,COGS 14A,A01,092681,Staff,0,36,100,100
1650789700392,COGS 14B,A01,083073,Cheng; Tzu-Han,0,12,50,50
1650789706426,COGS 17,A01,092677,Staff,11,0,75,64
1650789712454,COGS 100,A01,083619,Staff,0,29,60,60
1650789718484,COGS 101A,A01,083621,Davis; Joshua Daniel,0,28,60,60
1650789724513,COGS 101B,A01,091572,Staff,0,3,60,60
1650789730541,COGS 101C,A01,083625,Delgado; Tania,14,0,30,16
1650789736568,COGS 107A,A01,083627,Boyle; Mary E. T.,0,16,60,60
1650789742593,COGS 118A,A01,083075,Staff,0,8,60,60
1650789748621,CSE 3,A50,083646,Miranda; Gregory Joseph,18,0,38,20
1650789748621,CSE 3,A51,083647,Miranda; Gregory Joseph,36,0,37,1
1650789754645,CSE 8A,A50,083650,Miranda; Gregory Joseph,0,29,40,40
1650789760673,CSE 11,A01,083080,Cao; Yingjun,0,96,40,40
1650789766701,CSE 12,A01,083652,Staff,0,21,100,100
1650789772724,CSE 15L,A01,083654,Staff,0,3,50,50
1650789772724,CSE 15L,A02,083655,Staff,0,2,50,50
1650789778748,CSE 20,A01,083657,Staff,49,0,80,31
1650789784773,CSE 30,A01,083084,Eldon; John,0,75,40,40
1650789790804,CSE 100,A01,083659,Cao; Yingjun,0,71,50,50
1650789796831,CSE 134B,A01,083661,Powell; Thomas Allan,0,38,65,65
1650789802856,CSE 140,A01,083663,Staff,0,11,75,75
1650789808890,CSE 140L,A01,083088,Eldon; John,0,20,75,75
1650789814914,CSE 175,A01,083665,Kumar; Rakesh,7,0,25,18
1650789820942,CSE 190,A00,092507,Dubnov; Shlomo,10,0,20,10
1650789826970,ECE 45,A01,083139,Staff,0,1,60,60
1650789832996,ECE 65,A50,083695,Staff,0,5,30,30
1650789839022,ECE 109,A01,091882,Touri; Behrouz,32,0,70,38
1650789845054,ECE 180,A00,083140,Abi Samra; Nicholas Camill,20,0,30,10
1650789845054,ECE 180,B00,083141,Abi Samra; Nicholas Camill,0,0,30,30
1650789851087,MATH 10A,A01,083735,Patchell; Gregory David,2,0,30,28
1650789851087,MATH 10A,A02,083736,Patchell; Gregory David,27,0,30,3
1650789851087,MATH 10A,A03,083737,Patchell; Gregory David,24,0,30,6
1650789857118,MATH 10B,A01,083207,Staff,0,9,30,30
1650789857118,MATH 10B,A02,083208,Staff,0,6,30,30
1650789857118,MATH 10B,B01,083739,Staff,11,0,30,19
1650789857118,MATH 10B,B02,083740,Staff,28,0,30,2
1650789863145,MATH 18,A01,083743,Staff,0,0,30,30
1650789863145,MATH 18,A02,083744,Staff,23,0,30,7
1650789863145,MATH 18,A03,083745,Staff,21,0,30,9
1650789863145,MATH 18,A04,083746,Staff,26,0,30,4
1650789863145,MATH 18,B01,083748,Staff,0,15,30,30
1650789863145,MATH 18,B02,083749,Staff,0,12,30,30
1650789863145,MATH 18,B03,083750,Staff,0,12,30,30
1650789863145,MATH 18,B04,083751,Staff,0,12,30,30
1650789869174,MATH 20A,A01,083754,Staff,19,0,40,21
1650789875201,MATH 20B,A01,083756,Staff,0,13,30,30
1650789875201,MATH 20B,A02,083757,Staff,0,12,30,30
1650789881227,MATH 20C,A01,083760,Staff,0,17,30,30
1650789881227,MATH 20C,A02,083761,Staff,0,16,30,30
1650789881227,MATH 20C,B01,083762,Staff,9,0,30,21
1650789881227,MATH 20C,B02,083763,Staff,28,0,30,2
1650789887250,MATH 20D,A01,083765,Staff,2,1,30,28
1650789887250,MATH 20D,A02,083766,Staff,6,0,30,24
1650789887250,MATH 20D,A03,083767,Staff,24,0,30,6
1650789893278,MATH 20E,A01,083771,Staff,2,0,30,28
1650789893278,MATH 20E,A02,083772,Staff,15,0,30,15
1650789893278,MATH 20E,B01,083773,Staff,0,0,30,30
1650789893278,MATH 20E,B02,083774,Staff,5,0,30,25
1650789899303,MATH 103A,A01,083777,Staff,0,16,30,30
1650789899303,MATH 103A,A02,083778,Staff,0,15,30,30
1650789899303,MATH 103A,B01,083779,Staff,0,15,30,30
1650789899303,MATH 103A,B02,083780,Staff,0,15,30,30
1650789905329,MATH 105,A01,085443,Staff,0,22,30,30
1650789911353,MATH 109,A01,083213,Anzaldo; Leesa B,0,7,30,30
1650789911353,MATH 109,A02,083214,Anzaldo; Leesa B,0,7,30,30
1650789911353,MATH 109,B01,083215,Anzaldo; Leesa B,0,8,30,30
1650789911353,MATH 109,B02,083216,Anzaldo; Leesa B,0,7,30,30
1650789917383,MATH 142A,A01,083219,Chow; Bennett,0,16,30,30
1650789917383,MATH 142A,A02,083220,Chow; Bennett,0,15,30,30
1650789917383,MATH 142A,B01,083221,Chow; Bennett,0,16,30,30
1650789917383,MATH 142A,B02,083222,Chow; Bennett,0,14,30,30
1650789923410,MATH 193A,A01,083224,Staff,0,6,30,30
1650789923410,MATH 193A,A02,083225,Staff,0,6,30,30
1650789923410,MATH 193A,A03,083781,Staff,0,6,30,30
1650789923410,MATH 193A,A04,083782,Staff,0,7,30,30
1650789929436,MATH 197,001,091859,McAuley; Julian John,9998,0,9999,1
1650789935497,COGS 9,A01,083615,Staff,0,17,60,60
1650789941522,COGS 11,A01,083617,Boyle; Mary E. T.,16,0,40,24
1650789947544,COGS 13,A01,083071,Staff,0,38,40,40
1650789953569,COGS 14A,A01,092681,Staff,0,36,100,100
1650789959597,COGS 14B,A01,083073,Cheng; Tzu-Han,0,12,50,50
1650789965637,COGS 17,A01,092677,Staff,11,0,75,64
1650789971663,COGS 100,A01,083619,Staff,0,29,60,60
1650789977691,COGS 101A,A01,083621,Davis; Joshua Daniel,0,28,60,60
1650789983722,COGS 101B,A01,091572,Staff,0,3,60,60
1650789989747,COGS 101C,A01,083625,Delgado; Tania,14,0,30,16
1650789995771,COGS 107A,A01,083627,Boyle; Mary E. T.,0,16,60,60
1650790001798,COGS 118A,A01,083075,Staff,0,8,60,60
1650790007827,CSE 3,A50,083646,Miranda; Gregory Joseph,18,0,38,20
1650790007827,CSE 3,A51,083647,Miranda; Gregory Joseph,36,0,37,1
1650790013852,CSE 8A,A50,083650,Miranda; Gregory Joseph,0,29,40,40
1650790019949,CSE 11,A01,083080,Cao; Yingjun,0,96,40,40
1650790025976,CSE 12,A01,083652,Staff,0,21,100,100
1650790032000,CSE 15L,A01,083654,Staff,0,3,50,50
1650790032000,CSE 15L,A02,083655,Staff,0,2,50,50
1650790038025,CSE 20,A01,083657,Staff,49,0,80,31
1650790044052,CSE 30,A01,083084,Eldon; John,0,75,40,40
1650790050077,CSE 100,A01,083659,Cao; Yingjun,0,71,50,50
1650790056100,CSE 134B,A01,083661,Powell; Thomas Allan,0,38,65,65
1650790062123,CSE 140,A01,083663,Staff,0,11,75,75
1650790068147,CSE 140L,A01,083088,Eldon; John,0,20,75,75
1650790074172,CSE 175,A01,083665,Kumar; Rakesh,7,0,25,18
1650790080196,CSE 190,A00,092507,Dubnov; Shlomo,10,0,20,10
1650790086220,ECE 45,A01,083139,Staff,0,1,60,60
1650790092243,ECE 65,A50,083695,Staff,0,5,30,30
1650790098266,ECE 109,A01,091882,Touri; Behrouz,32,0,70,38
1650790104293,ECE 180,A00,083140,Abi Samra; Nicholas Camill,20,0,30,10
1650790104293,ECE 180,B00,083141,Abi Samra; Nicholas Camill,0,0,30,30
1650790110320,MATH 10A,A01,083735,Patchell; Gregory David,2,0,30,28
1650790110320,MATH 10A,A02,083736,Patchell; Gregory David,27,0,30,3
1650790110320,MATH 10A,A03,083737,Patchell; Gregory David,24,0,30,6
1650790116347,MATH 10B,A01,083207,Staff,0,9,30,30
1650790116347,MATH 10B,A02,083208,Staff,0,6,30,30
1650790116347,MATH 10B,B01,083739,Staff,11,0,30,19
1650790116347,MATH 10B,B02,083740,Staff,28,0,30,2
1650790122377,MATH 18,A01,083743,Staff,0,0,30,30
1650790122377,MATH 18,A02,083744,Staff,23,0,30,7
1650790122377,MATH 18,A03,083745,Staff,21,0,30,9
1650790122377,MATH 18,A04,083746,Staff,26,0,30,4
1650790122377,MATH 18,B01,083748,Staff,0,15,30,30
1650790122377,MATH 18,B02,083749,Staff,0,12,30,30
1650790122377,MATH 18,B03,083750,Staff,0,12,30,30
1650790122377,MATH 18,B04,083751,Staff,0,12,30,30
1650790128403,MATH 20A,A01,083754,Staff,19,0,40,21
1650790134426,MATH 20B,A01,083756,Staff,0,13,30,30
1650790134426,MATH 20B,A02,083757,Staff,0,12,30,30
1650790140450,MATH 20C,A01,083760,Staff,0,17,30,30
1650790140450,MATH 20C,A02,083761,Staff,0,16,30,30
1650790140450,MATH 20C,B01,083762,Staff,9,0,30,21
1650790140450,MATH 20C,B02,083763,Staff,28,0,30,2
1650790146474,MATH 20D,A01,083765,Staff,2,1,30,28
1650790146474,MATH 20D,A02,083766,Staff,6,0,30,24
1650790146474,MATH 20D,A03,083767,Staff,24,0,30,6
1650790152498,MATH 20E,A01,083771,Staff,2,0,30,28
1650790152498,MATH 20E,A02,083772,Staff,15,0,30,15
1650790152498,MATH 20E,B01,083773,Staff,0,0,30,30
1650790152498,MATH 20E,B02,083774,Staff,5,0,30,25
1650790158520,MATH 103A,A01,083777,Staff,0,16,30,30
1650790158520,MATH 103A,A02,083778,Staff,0,15,30,30
1650790158520,MATH 103A,B01,083779,Staff,0,15,30,30
1650790158520,MATH 103A,B02,083780,Staff,0,15,30,30
1650790164545,MATH 105,A01,085443,Staff,0,22,30,30
1650790170571,MATH 109,A01,083213,Anzaldo; Leesa B,0,7,30,30
1650790170571,MATH 109,A02,083214,Anzaldo; Leesa B,0,7,30,30
1650790170571,MATH 109,B01,083215,Anzaldo; Leesa B,0,8,30,30
1650790170571,MATH 109,B02,083216,Anzaldo; Leesa B,0,7,30,30
1650790176599,MATH 142A,A01,083219,Chow; Bennett,0,16,30,30
1650790176599,MATH 142A,A02,083220,Chow; Bennett,0,15,30,30
1650790176599,MATH 142A,B01,083221,Chow; Bennett,0,16,30,30
1650790176599,MATH 142A,B02,083222,Chow; Bennett,0,14,30,30
1650790182621,MATH 193A,A01,083224,Staff,0,6,30,30
1650790182621,MATH 193A,A02,083225,Staff,0,6,30,30
1650790182621,MATH 193A,A03,083781,Staff,0,6,30,30
1650790182621,MATH 193A,A04,083782,Staff,0,7,30,30
1650790188647,MATH 197,001,091859,McAuley; Julian John,9998,0,9999,1
1650790194707,COGS 9,A01,083615,Staff,0,17,60,60
1650790200730,COGS 11,A01,083617,Boyle; Mary E. T.,16,0,40,24
1650790206754,COGS 13,A01,083071,Staff,0,38,40,40
1650790212777,COGS 14A,A01,092681,Staff,0,36,100,100
1650790218803,COGS 14B,A01,083073,Cheng; Tzu-Han,0,12,50,50
1650790224825,COGS 17,A01,092677,Staff,11,0,75,64
1650790230849,COGS 100,A01,083619,Staff,0,29,60,60
1650790236875,COGS 101A,A01,083621,Davis; Joshua Daniel,0,28,60,60
1650790242899,COGS 101B,A01,091572,Staff,0,3,60,60
1650790248926,COGS 101C,A01,083625,Delgado; Tania,14,0,30,16
1650790254951,COGS 107A,A01,083627,Boyle; Mary E. T.,0,16,60,60
1650790260974,COGS 118A,A01,083075,Staff,0,8,60,60
1650790267002,CSE 3,A50,083646,Miranda; Gregory Joseph,18,0,38,20
1650790267002,CSE 3,A51,083647,Miranda; Gregory Joseph,36,0,37,1
1650790273026,CSE 8A,A50,083650,Miranda; Gregory Joseph,0,29,40,40
1650790279050,CSE 11,A01,083080,Cao; Yingjun,0,96,40,40
1650790285079,CSE 12,A01,083652,Staff,0,21,100,100
1650790291103,CSE 15L,A01,083654,Staff,0,3,50,50
1650790291103,CSE 15L,A02,083655,Staff,0,2,50,50
1650790297130,CSE 20,A01,083657,Staff,49,0,80,31
1650790303158,CSE 30,A01,083084,Eldon; John,0,75,40,40
1650790309186,CSE 100,A01,083659,Cao; Yingjun,0,71,50,50
1650790315211,CSE 134B,A01,083661,Powell; Thomas Allan,0,38,65,65
1650790321239,CSE 140,A01,083663,Staff,0,11,75,75
1650790327264,CSE 140L,A01,083088,Eldon; John,0,20,75,75
1650790333286,CSE 175,A01,083665,Kumar; Rakesh,7,0,25,18
1650790339311,CSE 190,A00,092507,Dubnov; Shlomo,10,0,20,10
1650790345336,ECE 45,A01,083139,Staff,0,1,60,60
1650790351361,ECE 65,A50,083695,Staff,0,5,30,30
1650790357386,ECE 109,A01,091882,Touri; Behrouz,32,0,70,38
1650790363410,ECE 180,A00,083140,Abi Samra; Nicholas Camill,20,0,30,10
1650790363410,ECE 180,B00,083141,Abi Samra; Nicholas Camill,0,0,30,30
1650790369434,MATH 10A,A01,083735,Patchell; Gregory David,2,0,30,28
1650790369434,MATH 10A,A02,083736,Patchell; Gregory David,27,0,30,3
1650790369434,MATH 10A,A03,083737,Patchell; Gregory David,24,0,30,6
1650790375459,MATH 10B,A01,083207,Staff,0,9,30,30
1650790375459,MATH 10B,A02,083208,Staff,0,6,30,30
1650790375459,MATH 10B,B01,083739,Staff,11,0,30,19
1650790375459,MATH 10B,B02,083740,Staff,28,0,30,2
1650790381486,MATH 18,A01,083743,Staff,0,0,30,30
1650790381486,MATH 18,A02,083744,Staff,23,0,30,7
1650790381486,MATH 18,A03,083745,Staff,21,0,30,9
1650790381486,MATH 18,A04,083746,Staff,26,0,30,4
1650790381486,MATH 18,B01,083748,Staff,0,15,30,30
1650790381486,MATH 18,B02,083749,Staff,0,12,30,30
1650790381486,MATH 18,B03,083750,Staff,0,12,30,30
1650790381486,MATH 18,B04,083751,Staff,0,12,30,30
1650790387511,MATH 20A,A01,083754,Staff,19,0,40,21
1650790393532,MATH 20B,A01,083756,Staff,0,13,30,30
1650790393532,MATH 20B,A02,083757,Staff,0,12,30,30
1650790399556,MATH 20C,A01,083760,Staff,0,17,30,30
1650790399556,MATH 20C,A02,083761,Staff,0,16,30,30
1650790399556,MATH 20C,B01,083762,Staff,9,0,30,21
1650790399556,MATH 20C,B02,083763,Staff,28,0,30,2
1650790405585,MATH 20D,A01,083765,Staff,2,1,30,28
1650790405585,MATH 20D,A02,083766,Staff,6,0,30,24
1650790405585,MATH 20D,A03,083767,Staff,24,0,30,6
1650790411612,MATH 20E,A01,083771,Staff,2,0,30,28
1650790411612,MATH 20E,A02,083772,Staff,15,0,30,15
1650790411612,MATH 20E,B01,083773,Staff,0,0,30,30
1650790411612,MATH 20E,B02,083774,Staff,5,0,30,25
1650790417641,MATH 103A,A01,083777,Staff,0,16,30,30
1650790417641,MATH 103A,A02,083778,Staff,0,15,30,30
1650790417641,MATH 103A,B01,083779,Staff,0,15,30,30
1650790417641,MATH 103A,B02,083780,Staff,0,15,30,30
1650790423670,MATH 105,A01,085443,Staff,0,22,30,30
1650790429700,MATH 109,A01,083213,Anzaldo; Leesa B,0,7,30,30
1650790429700,MATH 109,A02,083214,Anzaldo; Leesa B,0,7,30,30
1650790429700,MATH 109,B01,083215,Anzaldo; Leesa B,0,8,30,30
1650790429700,MATH 109,B02,083216,Anzaldo; Leesa B,0,7,30,30
1650790435725,MATH 142A,A01,083219,Chow; Bennett,0,16,30,30
1650790435725,MATH 142A,A02,083220,Chow; Bennett,0,15,30,30
1650790435725,MATH 142A,B01,083221,Chow; Bennett,0,16,30,30
1650790435725,MATH 142A,B02,083222,Chow; Bennett,0,14,30,30
1650790441749,MATH 193A,A01,083224,Staff,0,6,30,30
1650790441749,MATH 193A,A02,083225,Staff,0,6,30,30
1650790441749,MATH 193A,A03,083781,Staff,0,6,30,30
1650790441749,MATH 193A,A04,083782,Staff,0,7,30,30
1650790447774,MATH 197,001,091859,McAuley; Julian John,9998,0,9999,1
1650790453839,COGS 9,A01,083615,Staff,0,17,60,60
1650790459869,COGS 11,A01,083617,Boyle; Mary E. T.,16,0,40,24
1650790465898,COGS 13,A01,083071,Staff,0,38,40,40
1650790471924,COGS 14A,A01,092681,Staff,0,36,100,100
1650790477948,COGS 14B,A01,083073,Cheng; Tzu-Han,0,12,50,50
1650790483973,COGS 17,A01,092677,Staff,11,0,75,64
1650790490000,COGS 100,A01,083619,Staff,0,29,60,60
1650790496030,COGS 101A,A01,083621,Davis; Joshua Daniel,0,28,60,60
1650790502061,COGS 101B,A01,091572,Staff,0,3,60,60
1650790508098,COGS 101C,A01,083625,Delgado; Tania,14,0,30,16
1650790514127,COGS 107A,A01,083627,Boyle; Mary E. T.,0,16,60,60
1650790520155,COGS 118A,A01,083075,Staff,0,8,60,60
1650790526183,CSE 3,A50,083646,Miranda; Gregory Joseph,18,0,38,20
1650790526183,CSE 3,A51,083647,Miranda; Gregory Joseph,36,0,37,1
1650790532208,CSE 8A,A50,083650,Miranda; Gregory Joseph,0,29,40,40
1650790538238,CSE 11,A01,083080,Cao; Yingjun,0,96,40,40
1650790544264,CSE 12,A01,083652,Staff,0,21,100,100
1650790550293,CSE 15L,A01,083654,Staff,0,3,50,50
1650790550293,CSE 15L,A02,083655,Staff,0,2,50,50
1650790556324,CSE 20,A01,083657,Staff,49,0,80,31
1650790562355,CSE 30,A01,083084,Eldon; John,0,75,40,40
1650790568386,CSE 100,A01,083659,Cao; Yingjun,0,71,50,50
1650790574415,CSE 134B,A01,083661,Powell; Thomas Allan,0,38,65,65
1650790580439,CSE 140,A01,083663,Staff,0,11,75,75
1650790586465,CSE 140L,A01,083088,Eldon; John,0,20,75,75
1650790592491,CSE 175,A01,083665,Kumar; Rakesh,7,0,25,18
1650790598522,CSE 190,A00,092507,Dubnov; Shlomo,10,0,20,10
1650790604552,ECE 45,A01,083139,Staff,0,1,60,60
1650790610577,ECE 65,A50,083695,Staff,0,5,30,30
1650790616676,ECE 109,A01,091882,Touri; Behrouz,32,0,70,38
1650790622716,ECE 180,A00,083140,Abi Samra; Nicholas Camill,20,0,30,10
1650790622716,ECE 180,B00,083141,Abi Samra; Nicholas Camill,0,0,30,30
1650790628744,MATH 10A,A01,083735,Patchell; Gregory David,2,0,30,28
1650790628744,MATH 10A,A02,083736,Patchell; Gregory David,27,0,30,3
1650790628744,MATH 10A,A03,083737,Patchell; Gregory David,24,0,30,6
1650790634772,MATH 10B,A01,083207,Staff,0,9,30,30
1650790634772,MATH 10B,A02,083208,Staff,0,6,30,30
1650790634772,MATH 10B,B01,083739,Staff,11,0,30,19
1650790634772,MATH 10B,B02,083740,Staff,28,0,30,2
1650790640806,MATH 18,A01,083743,Staff,0,0,30,30
1650790640806,MATH 18,A02,083744,Staff,23,0,30,7
1650790640806,MATH 18,A03,083745,Staff,21,0,30,9
1650790640806,MATH 18,A04,083746,Staff,26,0,30,4
1650790640806,MATH 18,B01,083748,Staff,0,15,30,30
1650790640806,MATH 18,B02,083749,Staff,0,12,30,30
1650790640806,MATH 18,B03,083750,Staff,0,12,30,30
1650790640806,MATH 18,B04,083751,Staff,0,12,30,30
1650790646835,MATH 20A,A01,083754,Staff,19,0,40,21
1650790652860,MATH 20B,A01,083756,Staff,0,13,30,30
1650790652860,MATH 20B,A02,083757,Staff,0,12,30,30
1650790658886,MATH 20C,A01,083760,Staff,0,17,30,30
1650790658886,MATH 20C,A02,083761,Staff,0,16,30,30
1650790658886,MATH 20C,B01,083762,Staff,9,0,30,21
1650790658886,MATH 20C,B02,083763,Staff,28,0,30,2
1650790664914,MATH 20D,A01,083765,Staff,2,1,30,28
1650790664914,MATH 20D,A02,083766,Staff,6,0,30,24
1650790664914,MATH 20D,A03,083767,Staff,24,0,30,6
1650790670946,MATH 20E,A01,083771,Staff,2,0,30,28
1650790670946,MATH 20E,A02,083772,Staff,15,0,30,15
1650790670946,MATH 20E,B01,083773,Staff,0,0,30,30
1650790670946,MATH 20E,B02,083774,Staff,5,0,30,25
1650790676977,MATH 103A,A01,083777,Staff,0,16,30,30
1650790676977,MATH 103A,A02,083778,Staff,0,15,30,30
1650790676977,MATH 103A,B01,083779,Staff,0,15,30,30
1650790676977,MATH 103A,B02,083780,Staff,0,15,30,30
1650790683003,MATH 105,A01,085443,Staff,0,22,30,30
1650790689034,MATH 109,A01,083213,Anzaldo; Leesa B,0,7,30,30
1650790689034,MATH 109,A02,083214,Anzaldo; Leesa B,0,7,30,30
1650790689034,MATH 109,B01,083215,Anzaldo; Leesa B,0,8,30,30
1650790689034,MATH 109,B02,083216,Anzaldo; Leesa B,0,7,30,30
1650790695060,MATH 142A,A01,083219,Chow; Bennett,0,16,30,30
1650790695060,MATH 142A,A02,083220,Chow; Bennett,0,15,30,30
1650790695060,MATH 142A,B01,083221,Chow; Bennett,0,16,30,30
1650790695060,MATH 142A,B02,083222,Chow; Bennett,0,14,30,30
1650790701089,MATH 193A,A01,083224,Staff,0,6,30,30
1650790701089,MATH 193A,A02,083225,Staff,0,6,30,30
1650790701089,MATH 193A,A03,083781,Staff,0,6,30,30
1650790701089,MATH 193A,A04,083782,Staff,0,7,30,30
1650790707114,MATH 197,001,091859,McAuley; Julian John,9998,0,9999,1
1650790713193,COGS 9,A01,083615,Staff,0,17,60,60
1650790719219,COGS 11,A01,083617,Boyle; Mary E. T.,16,0,40,24
1650790725250,COGS 13,A01,083071,Staff,0,38,40,40
1650790731276,COGS 14A,A01,092681,Staff,0,36,100,100
1650790737303,COGS 14B,A01,083073,Cheng; Tzu-Han,0,12,50,50
1650790743327,COGS 17,A01,092677,Staff,11,0,75,64
1650790749357,COGS 100,A01,083619,Staff,0,29,60,60
1650790755382,COGS 101A,A01,083621,Davis; Joshua Daniel,0,28,60,60
1650790761406,COGS 101B,A01,091572,Staff,0,3,60,60
1650790767433,COGS 101C,A01,083625,Delgado; Tania,14,0,30,16
1650790773460,COGS 107A,A01,083627,Boyle; Mary E. T.,0,16,60,60
1650790779490,COGS 118A,A01,083075,Staff,0,8,60,60
1650790785522,CSE 3,A50,083646,Miranda; Gregory Joseph,18,0,38,20
1650790785522,CSE 3,A51,083647,Miranda; Gregory Joseph,36,0,37,1
1650790791552,CSE 8A,A50,083650,Miranda; Gregory Joseph,0,29,40,40
1650790797583,CSE 11,A01,083080,Cao; Yingjun,0,96,40,40
1650790803607,CSE 12,A01,083652,Staff,0,21,100,100
1650790809630,CSE 15L,A01,083654,Staff,0,3,50,50
1650790809630,CSE 15L,A02,083655,Staff,0,2,50,50
1650790815656,CSE 20,A01,083657,Staff,49,0,80,31
1650790821688,CSE 30,A01,083084,Eldon; John,0,75,40,40
1650790827712,CSE 100,A01,083659,Cao; Yingjun,0,71,50,50
1650790833737,CSE 134B,A01,083661,Powell; Thomas Allan,0,38,65,65
1650790839762,CSE 140,A01,083663,Staff,0,11,75,75
1650790845788,CSE 140L,A01,083088,Eldon; John,0,20,75,75
1650790851821,CSE 175,A01,083665,Kumar; Rakesh,7,0,25,18
1650790857853,CSE 190,A00,092507,Dubnov; Shlomo,10,0,20,10
1650790863880,ECE 45,A01,083139,Staff,0,1,60,60
1650790869904,ECE 65,A50,083695,Staff,0,5,30,30
1650790875938,ECE 109,A01,091882,Touri; Behrouz,32,0,70,38
1650790881963,ECE 180,A00,083140,Abi Samra; Nicholas Camill,20,0,30,10
1650790881963,ECE 180,B00,083141,Abi Samra; Nicholas Camill,0,0,30,30
1650790887987,MATH 10A,A01,083735,Patchell; Gregory David,2,0,30,28
1650790887987,MATH 10A,A02,083736,Patchell; Gregory David,27,0,30,3
1650790887987,MATH 10A,A03,083737,Patchell; Gregory David,24,0,30,6
1650790894018,MATH 10B,A01,083207,Staff,0,9,30,30
1650790894018,MATH 10B,A02,083208,Staff,0,6,30,30
1650790894018,MATH 10B,B01,083739,Staff,11,0,30,19
1650790894018,MATH 10B,B02,083740,Staff,28,0,30,2
1650790900056,MATH 18,A01,083743,Staff,0,0,30,30
1650790900056,MATH 18,A02,083744,Staff,23,0,30,7
1650790900056,MATH 18,A03,083745,Staff,21,0,30,9
1650790900056,MATH 18,A04,083746,Staff,26,0,30,4
1650790900056,MATH 18,B01,083748,Staff,0,15,30,30
1650790900056,MATH 18,B02,083749,Staff,0,12,30,30
1650790900056,MATH 18,B03,083750,Staff,0,12,30,30
1650790900056,MATH 18,B04,083751,Staff,0,12,30,30
1650790906086,MATH 20A,A01,083754,Staff,19,0,40,21
1650790912112,MATH 20B,A01,083756,Staff,0,13,30,30
1650790912112,MATH 20B,A02,083757,Staff,0,12,30,30
1650790918141,MATH 20C,A01,083760,Staff,0,17,30,30
1650790918141,MATH 20C,A02,083761,Staff,0,16,30,30
1650790918141,MATH 20C,B01,083762,Staff,9,0,30,21
1650790918141,MATH 20C,B02,083763,Staff,28,0,30,2
1650790924183,MATH 20D,A01,083765,Staff,2,1,30,28
1650790924183,MATH 20D,A02,083766,Staff,6,0,30,24
1650790924183,MATH 20D,A03,083767,Staff,24,0,30,6
1650790930219,MATH 20E,A01,083771,Staff,2,0,30,28
1650790930219,MATH 20E,A02,083772,Staff,15,0,30,15
1650790930219,MATH 20E,B01,083773,Staff,0,0,30,30
1650790930219,MATH 20E,B02,083774,Staff,5,0,30,25
1650790936244,MATH 103A,A01,083777,Staff,0,16,30,30
1650790936244,MATH 103A,A02,083778,Staff,0,15,30,30
1650790936244,MATH 103A,B01,083779,Staff,0,15,30,30
1650790936244,MATH 103A,B02,083780,Staff,0,15,30,30
1650790942274,MATH 105,A01,085443,Staff,0,22,30,30
1650790948304,MATH 109,A01,083213,Anzaldo; Leesa B,0,7,30,30
1650790948304,MATH 109,A02,083214,Anzaldo; Leesa B,0,7,30,30
1650790948304,MATH 109,B01,083215,Anzaldo; Leesa B,0,8,30,30
1650790948304,MATH 109,B02,083216,Anzaldo; Leesa B,0,7,30,30
1650790954337,MATH 142A,A01,083219,Chow; Bennett,0,16,30,30
1650790954337,MATH 142A,A02,083220,Chow; Bennett,0,15,30,30
1650790954337,MATH 142A,B01,083221,Chow; Bennett,0,16,30,30
1650790954337,MATH 142A,B02,083222,Chow; Bennett,0,14,30,30
1650790960361,MATH 193A,A01,083224,Staff,0,6,30,30
1650790960361,MATH 193A,A02,083225,Staff,0,6,30,30
1650790960361,MATH 193A,A03,083781,Staff,0,6,30,30
1650790960361,MATH 193A,A04,083782,Staff,0,7,30,30
1650790966388,MATH 197,001,091859,McAuley; Julian John,9998,0,9999,1
1650790972462,COGS 9,A01,083615,Staff,0,17,60,60
1650790978486,COGS 11,A01,083617,Boyle; Mary E. T.,16,0,40,24
1650790984517,COGS 13,A01,083071,Staff,0,38,40,40
1650790990545,COGS 14A,A01,092681,Staff,0,36,100,100
1650790996568,COGS 14B,A01,083073,Cheng; Tzu-Han,0,12,50,50
1650791002591,COGS 17,A01,092677,Staff,11,0,75,64
1650791008631,COGS 100,A01,083619,Staff,0,29,60,60
1650791014654,COGS 101A,A01,083621,Davis; Joshua Daniel,0,28,60,60
1650791020690,COGS 101B,A01,091572,Staff,0,3,60,60
1650791026722,COGS 101C,A01,083625,Delgado; Tania,14,0,30,16
1650791032747,COGS 107A,A01,083627,Boyle; Mary E. T.,0,16,60,60
1650791038774,COGS 118A,A01,083075,Staff,0,8,60,60
1650791044800,CSE 3,A50,083646,Miranda; Gregory Joseph,18,0,38,20
1650791044800,CSE 3,A51,083647,Miranda; Gregory Joseph,36,0,37,1
1650791050824,CSE 8A,A50,083650,Miranda; Gregory Joseph,0,29,40,40
1650791056848,CSE 11,A01,083080,Cao; Yingjun,0,96,40,40
1650791062878,CSE 12,A01,083652,Staff,0,21,100,100
1650791068912,CSE 15L,A01,083654,Staff,0,3,50,50
1650791068912,CSE 15L,A02,083655,Staff,0,2,50,50
1650791074936,CSE 20,A01,083657,Staff,49,0,80,31
1650791080961,CSE 30,A01,083084,Eldon; John,0,75,40,40
1650791087014,CSE 100,A01,083659,Cao; Yingjun,0,71,50,50
1650791093040,CSE 134B,A01,083661,Powell; Thomas Allan,0,38,65,65
1650791099063,CSE 140,A01,083663,Staff,0,11,75,75
1650791105090,CSE 140L,A01,083088,Eldon; John,0,20,75,75
1650791111118,CSE 175,A01,083665,Kumar; Rakesh,7,0,25,18
1650791117148,CSE 190,A00,092507,Dubnov; Shlomo,10,0,20,10
1650791123178,ECE 45,A01,083139,Staff,0,1,60,60
1650791129204,ECE 65,A50,083695,Staff,0,5,30,30
1650791135246,ECE 109,A01,091882,Touri; Behrouz,32,0,70,38
1650791141275,ECE 180,A00,083140,Abi Samra; Nicholas Camill,20,0,30,10
1650791141275,ECE 180,B00,083141,Abi Samra; Nicholas Camill,0,0,30,30
1650791147301,MATH 10A,A01,083735,Patchell; Gregory David,2,0,30,28
1650791147301,MATH 10A,A02,083736,Patchell; Gregory David,27,0,30,3
1650791147301,MATH 10A,A03,083737,Patchell; Gregory David,24,0,30,6
1650791153331,MATH 10B,A01,083207,Staff,0,9,30,30
1650791153331,MATH 10B,A02,083208,Staff,0,6,30,30
1650791153331,MATH 10B,B01,083739,Staff,11,0,30,19
1650791153331,MATH 10B,B02,083740,Staff,28,0,30,2
1650791159363,MATH 18,A01,083743,Staff,0,0,30,30
1650791159363,MATH 18,A02,083744,Staff,23,0,30,7
1650791159363,MATH 18,A03,083745,Staff,21,0,30,9
1650791159363,MATH 18,A04,083746,Staff,26,0,30,4
1650791159363,MATH 18,B01,083748,Staff,0,15,30,30
1650791159363,MATH 18,B02,083749,Staff,0,12,30,30
1650791159363,MATH 18,B03,083750,Staff,0,12,30,30
1650791159363,MATH 18,B04,083751,Staff,0,12,30,30
1650791165389,MATH 20A,A01,083754,Staff,19,0,40,21
1650791171413,MATH 20B,A01,083756,Staff,0,13,30,30
1650791171413,MATH 20B,A02,083757,Staff,0,12,30,30
1650791177443,MATH 20C,A01,083760,Staff,0,17,30,30
1650791177443,MATH 20C,A02,083761,Staff,0,16,30,30
1650791177443,MATH 20C,B01,083762,Staff,9,0,30,21
1650791177443,MATH 20C,B02,083763,Staff,28,0,30,2
1650791183468,MATH 20D,A01,083765,Staff,2,1,30,28
1650791183468,MATH 20D,A02,083766,Staff,6,0,30,24
1650791183468,MATH 20D,A03,083767,Staff,24,0,30,6
1650791189492,MATH 20E,A01,083771,Staff,2,0,30,28
1650791189492,MATH 20E,A02,083772,Staff,15,0,30,15
1650791189492,MATH 20E,B01,083773,Staff,0,0,30,30
1650791189492,MATH 20E,B02,083774,Staff,5,0,30,25
1650791195518,MATH 103A,A01,083777,Staff,0,16,30,30
1650791195518,MATH 103A,A02,083778,Staff,0,15,30,30
1650791195518,MATH 103A,B01,083779,Staff,0,15,30,30
1650791195518,MATH 103A,B02,083780,Staff,0,15,30,30
1650791201543,MATH 105,A01,085443,Staff,0,22,30,30
1650791207597,MATH 109,A01,083213,Anzaldo; Leesa B,0,7,30,30
1650791207597,MATH 109,A02,083214,Anzaldo; Leesa B,0,7,30,30
1650791207597,MATH 109,B01,083215,Anzaldo; Leesa B,0,8,30,30
1650791207597,MATH 109,B02,083216,Anzaldo; Leesa B,0,7,30,30
1650791213700,MATH 142A,A01,083219,Chow; Bennett,0,16,30,30
1650791213700,MATH 142A,A02,083220,Chow; Bennett,0,15,30,30
1650791213700,MATH 142A,B01,083221,Chow; Bennett,0,16,30,30
1650791213700,MATH 142A,B02,083222,Chow; Bennett,0,14,30,30
1650791219726,MATH 193A,A01,083224,Staff,0,6,30,30
1650791219726,MATH 193A,A02,083225,Staff,0,6,30,30
1650791219726,MATH 193A,A03,083781,Staff,0,6,30,30
1650791219726,MATH 193A,A04,083782,Staff,0,7,30,30
1650791225757,MATH 197,001,091859,McAuley; Julian John,9998,0,9999,1
1650791231822,COGS 9,A01,083615,Staff,0,17,60,60
1650791237847,COGS 11,A01,083617,Boyle; Mary E. T.,16,0,40,24
1650791243872,COGS 13,A01,083071,Staff,0,38,40,40
1650791249898,COGS 14A,A01,092681,Staff,0,36,100,100
1650791255922,COGS 14B,A01,083073,Cheng; Tzu-Han,0,12,50,50
1650791261945,COGS 17,A01,092677,Staff,11,0,75,64
1650791267973,COGS 100,A01,083619,Staff,0,29,60,60
1650791273996,COGS 101A,A01,083621,Davis; Joshua Daniel,0,28,60,60
1650791280046,COGS 101B,A01,091572,Staff,0,3,60,60
1650791286071,COGS 101C,A01,083625,Delgado; Tania,14,0,30,16
1650791292098,COGS 107A,A01,083627,Boyle; Mary E. T.,0,16,60,60
1650791298122,COGS 118A,A01,083075,Staff,0,8,60,60
1650791304151,CSE 3,A50,083646,Miranda; Gregory Joseph,18,0,38,20
1650791304151,CSE 3,A51,083647,Miranda; Gregory Joseph,36,0,37,1
1650791310185,CSE 8A,A50,083650,Miranda; Gregory Joseph,0,29,40,40
1650791316210,CSE 11,A01,083080,Cao; Yingjun,0,96,40,40
1650791322234,CSE 12,A01,083652,Staff,0,21,100,100
1650791328260,CSE 15L,A01,083654,Staff,0,3,50,50
1650791328260,CSE 15L,A02,083655,Staff,0,2,50,50
1650791334285,CSE 20,A01,083657,Staff,49,0,80,31
1650791340320,CSE 30,A01,083084,Eldon; John,0,75,40,40
1650791346350,CSE 100,A01,083659,Cao; Yingjun,0,71,50,50
1650791352374,CSE 134B,A01,083661,Powell; Thomas Allan,0,38,65,65
1650791358404,CSE 140,A01,083663,Staff,0,11,75,75
1650791364429,CSE 140L,A01,083088,Eldon; John,0,20,75,75
1650791370455,CSE 175,A01,083665,Kumar; Rakesh,7,0,25,18
1650791376483,CSE 190,A00,092507,Dubnov; Shlomo,10,0,20,10
1650791382506,ECE 45,A01,083139,Staff,0,1,60,60
1650791388532,ECE 65,A50,083695,Staff,0,5,30,30
1650791394566,ECE 109,A01,091882,Touri; Behrouz,32,0,70,38
1650791400596,ECE 180,A00,083140,Abi Samra; Nicholas Camill,20,0,30,10
1650791400596,ECE 180,B00,083141,Abi Samra; Nicholas Camill,0,0,30,30
1650791406622,MATH 10A,A01,083735,Patchell; Gregory David,2,0,30,28
1650791406622,MATH 10A,A02,083736,Patchell; Gregory David,27,0,30,3
1650791406622,MATH 10A,A03,083737,Patchell; Gregory David,24,0,30,6
1650791412648,MATH 10B,A01,083207,Staff,0,9,30,30
1650791412648,MATH 10B,A02,083208,Staff,0,6,30,30
1650791412648,MATH 10B,B01,083739,Staff,11,0,30,19
1650791412648,MATH 10B,B02,083740,Staff,28,0,30,2
1650791418685,MATH 18,A01,083743,Staff,0,0,30,30
1650791418685,MATH 18,A02,083744,Staff,23,0,30,7
1650791418685,MATH 18,A03,083745,Staff,21,0,30,9
1650791418685,MATH 18,A04,083746,Staff,26,0,30,4
1650791418685,MATH 18,B01,083748,Staff,0,15,30,30
1650791418685,MATH 18,B02,083749,Staff,0,12,30,30
1650791418685,MATH 18,B03,083750,Staff,0,12,30,30
1650791418685,MATH 18,B04,083751,Staff,0,12,30,30
1650791424738,MATH 20A,A01,083754,Staff,19,0,40,21
1650791430767,MATH 20B,A01,083756,Staff,0,13,30,30
1650791430767,MATH 20B,A02,083757,Staff,0,12,30,30
1650791436791,MATH 20C,A01,083760,Staff,0,17,30,30
1650791436791,MATH 20C,A02,083761,Staff,0,16,30,30
1650791436791,MATH 20C,B01,083762,Staff,9,0,30,21
1650791436791,MATH 20C,B02,083763,Staff,28,0,30,2
1650791442817,MATH 20D,A01,083765,Staff,2,1,30,28
1650791442817,MATH 20D,A02,083766,Staff,6,0,30,24
1650791442817,MATH 20D,A03,083767,Staff,24,0,30,6
1650791448848,MATH 20E,A01,083771,Staff,2,0,30,28
1650791448848,MATH 20E,A02,083772,Staff,15,0,30,15
1650791448848,MATH 20E,B01,083773,Staff,0,0,30,30
1650791448848,MATH 20E,B02,083774,Staff,5,0,30,25
1650791454881,MATH 103A,A01,083777,Staff,0,16,30,30
1650791454881,MATH 103A,A02,083778,Staff,0,15,30,30
1650791454881,MATH 103A,B01,083779,Staff,0,15,30,30
1650791454881,MATH 103A,B02,083780,Staff,0,15,30,30
1650791460905,MATH 105,A01,085443,Staff,0,22,30,30
1650791466945,MATH 109,A01,083213,Anzaldo; Leesa B,0,7,30,30
1650791466945,MATH 109,A02,083214,Anzaldo; Leesa B,0,7,30,30
1650791466945,MATH 109,B01,083215,Anzaldo; Leesa B,0,8,30,30
1650791466945,MATH 109,B02,083216,Anzaldo; Leesa B,0,7,30,30
1650791472972,MATH 142A,A01,083219,Chow; Bennett,0,16,30,30
1650791472972,MATH 142A,A02,083220,Chow; Bennett,0,15,30,30
1650791472972,MATH 142A,B01,083221,Chow; Bennett,0,16,30,30
1650791472972,MATH 142A,B02,083222,Chow; Bennett,0,14,30,30
1650791479004,MATH 193A,A01,083224,Staff,0,6,30,30
1650791479004,MATH 193A,A02,083225,Staff,0,6,30,30
1650791479004,MATH 193A,A03,083781,Staff,0,6,30,30
1650791479004,MATH 193A,A04,083782,Staff,0,7,30,30
1650791485029,MATH 197,001,091859,McAuley; Julian John,9998,0,9999,1
1650791491085,COGS 9,A01,083615,Staff,0,17,60,60
1650791497110,COGS 11,A01,083617,Boyle; Mary E. T.,16,0,40,24
1650791503135,COGS 13,A01,083071,Staff,0,38,40,40
1650791509165,COGS 14A,A01,092681,Staff,0,36,100,100
1650791515189,COGS 14B,A01,083073,Cheng; Tzu-Han,0,12,50,50
1650791521214,COGS 17,A01,092677,Staff,11,0,75,64
1650791527243,COGS 100,A01,083619,Staff,0,29,60,60
1650791533269,COGS 101A,A01,083621,Davis; Joshua Daniel,0,28,60,60
1650791539305,COGS 101B,A01,091572,Staff,0,3,60,60
1650791545331,COGS 101C,A01,083625,Delgado; Tania,14,0,30,16
1650791551361,COGS 107A,A01,083627,Boyle; Mary E. T.,0,16,60,60
1650791557385,COGS 118A,A01,083075,Staff,0,8,60,60
1650791563418,CSE 3,A50,083646,Miranda; Gregory Joseph,18,0,38,20
1650791563418,CSE 3,A51,083647,Miranda; Gregory Joseph,36,0,37,1
1650791569447,CSE 8A,A50,083650,Miranda; Gregory Joseph,0,29,40,40
1650791575474,CSE 11,A01,083080,Cao; Yingjun,0,96,40,40
1650791581502,CSE 12,A01,083652,Staff,0,21,100,100
1650791587530,CSE 15L,A01,083654,Staff,0,3,50,50
1650791587530,CSE 15L,A02,083655,Staff,0,2,50,50
1650791593558,CSE 20,A01,083657,Staff,49,0,80,31
1650791599586,CSE 30,A01,083084,Eldon; John,0,75,40,40
1650791605615,CSE 100,A01,083659,Cao; Yingjun,0,71,50,50
1650791611645,CSE 134B,A01,083661,Powell; Thomas Allan,0,38,65,65
1650791617670,CSE 140,A01,083663,Staff,0,11,75,75
1650791623692,CSE 140L,A01,083088,Eldon; John,0,20,75,75
1650791629717,CSE 175,A01,083665,Kumar; Rakesh,7,0,25,18
1650791635749,CSE 190,A00,092507,Dubnov; Shlomo,10,0,20,10
1650791641779,ECE 45,A01,083139,Staff,0,1,60,60
1650791647808,ECE 65,A50,083695,Staff,0,5,30,30
1650791653833,ECE 109,A01,091882,Touri; Behrouz,32,0,70,38
1650791659861,ECE 180,A00,083140,Abi Samra; Nicholas Camill,20,0,30,10
1650791659861,ECE 180,B00,083141,Abi Samra; Nicholas Camill,0,0,30,30
1650791665886,MATH 10A,A01,083735,Patchell; Gregory David,2,0,30,28
1650791665886,MATH 10A,A02,083736,Patchell; Gregory David,27,0,30,3
1650791665886,MATH 10A,A03,083737,Patchell; Gregory David,24,0,30,6
1650791671909,MATH 10B,A01,083207,Staff,0,9,30,30
1650791671909,MATH 10B,A02,083208,Staff,0,6,30,30
1650791671909,MATH 10B,B01,083739,Staff,11,0,30,19
1650791671909,MATH 10B,B02,083740,Staff,28,0,30,2
1650791677941,MATH 18,A01,083743,Staff,0,0,30,30
1650791677941,MATH 18,A02,083744,Staff,23,0,30,7
1650791677941,MATH 18,A03,083745,Staff,21,0,30,9
1650791677941,MATH 18,A04,083746,Staff,26,0,30,4
1650791677941,MATH 18,B01,083748,Staff,0,15,30,30
1650791677941,MATH 18,B02,083749,Staff,0,12,30,30
1650791677941,MATH 18,B03,083750,Staff,0,12,30,30
1650791677941,MATH 18,B04,083751,Staff,0,12,30,30
1650791683965,MATH 20A,A01,083754,Staff,19,0,40,21
1650791689990,MATH 20B,A01,083756,Staff,0,13,30,30
1650791689990,MATH 20B,A02,083757,Staff,0,12,30,30
1650791696019,MATH 20C,A01,083760,Staff,0,17,30,30
1650791696019,MATH 20C,A02,083761,Staff,0,16,30,30
1650791696019,MATH 20C,B01,083762,Staff,9,0,30,21
1650791696019,MATH 20C,B02,083763,Staff,28,0,30,2
1650791702046,MATH 20D,A01,083765,Staff,2,1,30,28
1650791702046,MATH 20D,A02,083766,Staff,6,0,30,24
1650791702046,MATH 20D,A03,083767,Staff,24,0,30,6
1650791708070,MATH 20E,A01,083771,Staff,2,0,30,28
1650791708070,MATH 20E,A02,083772,Staff,15,0,30,15
1650791708070,MATH 20E,B01,083773,Staff,0,0,30,30
1650791708070,MATH 20E,B02,083774,Staff,5,0,30,25
1650791714107,MATH 103A,A01,083777,Staff,0,16,30,30
1650791714107,MATH 103A,A02,083778,Staff,0,15,30,30
1650791714107,MATH 103A,B01,083779,Staff,0,15,30,30
1650791714107,MATH 103A,B02,083780,Staff,0,15,30,30
1650791720131,MATH 105,A01,085443,Staff,0,22,30,30
1650791726157,MATH 109,A01,083213,Anzaldo; Leesa B,0,7,30,30
1650791726157,MATH 109,A02,083214,Anzaldo; Leesa B,0,7,30,30
1650791726157,MATH 109,B01,083215,Anzaldo; Leesa B,0,8,30,30
1650791726157,MATH 109,B02,083216,Anzaldo; Leesa B,0,7,30,30
1650791732183,MATH 142A,A01,083219,Chow; Bennett,0,16,30,30
1650791732183,MATH 142A,A02,083220,Chow; Bennett,0,15,30,30
1650791732183,MATH 142A,B01,083221,Chow; Bennett,0,16,30,30
1650791732183,MATH 142A,B02,083222,Chow; Bennett,0,14,30,30
1650791738209,MATH 193A,A01,083224,Staff,0,6,30,30
1650791738209,MATH 193A,A02,083225,Staff,0,6,30,30
1650791738209,MATH 193A,A03,083781,Staff,0,6,30,30
1650791738209,MATH 193A,A04,083782,Staff,0,7,30,30
1650791744233,MATH 197,001,091859,McAuley; Julian John,9998,0,9999,1
1650791750310,COGS 9,A01,083615,Staff,0,17,60,60
1650791756335,COGS 11,A01,083617,Boyle; Mary E. T.,16,0,40,24
1650791762363,COGS 13,A01,083071,Staff,0,38,40,40
1650791768388,COGS 14A,A01,092681,Staff,0,36,100,100
1650791774413,COGS 14B,A01,083073,Cheng; Tzu-Han,0,12,50,50
1650791780437,COGS 17,A01,092677,Staff,11,0,75,64
1650791786463,COGS 100,A01,083619,Staff,0,29,60,60
1650791792493,COGS 101A,A01,083621,Davis; Joshua Daniel,0,28,60,60
1650791798517,COGS 101B,A01,091572,Staff,0,3,60,60
1650791804616,COGS 101C,A01,083625,Delgado; Tania,14,0,30,16
1650791810641,COGS 107A,A01,083627,Boyle; Mary E. T.,0,16,60,60
1650791816665,COGS 118A,A01,083075,Staff,0,8,60,60
1650791822691,CSE 3,A50,083646,Miranda; Gregory Joseph,18,0,38,20
1650791822691,CSE 3,A51,083647,Miranda; Gregory Joseph,36,0,37,1
1650791828715,CSE 8A,A50,083650,Miranda; Gregory Joseph,0,29,40,40
1650791834740,CSE 11,A01,083080,Cao; Yingjun,0,96,40,40
1650791840764,CSE 12,A01,083652,Staff,0,21,100,100
1650791846790,CSE 15L,A01,083654,Staff,0,3,50,50
1650791846790,CSE 15L,A02,083655,Staff,0,2,50,50
1650791852816,CSE 20,A01,083657,Staff,49,0,80,31
1650791858841,CSE 30,A01,083084,Eldon; John,0,75,40,40
1650791864869,CSE 100,A01,083659,Cao; Yingjun,0,71,50,50
1650791870892,CSE 134B,A01,083661,Powell; Thomas Allan,0,38,65,65
1650791876918,CSE 140,A01,083663,Staff,0,11,75,75
1650791882942,CSE 140L,A01,083088,Eldon; John,0,20,75,75
1650791888968,CSE 175,A01,083665,Kumar; Rakesh,7,0,25,18
1650791894992,CSE 190,A00,092507,Dubnov; Shlomo,10,0,20,10
1650791901016,ECE 45,A01,083139,Staff,0,1,60,60
1650791907057,ECE 65,A50,083695,Staff,0,5,30,30
1650791913082,ECE 109,A01,091882,Touri; Behrouz,32,0,70,38
1650791919106,ECE 180,A00,083140,Abi Samra; Nicholas Camill,20,0,30,10
1650791919106,ECE 180,B00,083141,Abi Samra; Nicholas Camill,0,0,30,30
1650791925131,MATH 10A,A01,083735,Patchell; Gregory David,2,0,30,28
1650791925131,MATH 10A,A02,083736,Patchell; Gregory David,27,0,30,3
1650791925131,MATH 10A,A03,083737,Patchell; Gregory David,24,0,30,6
1650791931158,MATH 10B,A01,083207,Staff,0,9,30,30
1650791931158,MATH 10B,A02,083208,Staff,0,6,30,30
1650791931158,MATH 10B,B01,083739,Staff,11,0,30,19
1650791931158,MATH 10B,B02,083740,Staff,28,0,30,2
1650791937190,MATH 18,A01,083743,Staff,0,0,30,30
1650791937190,MATH 18,A02,083744,Staff,23,0,30,7
1650791937190,MATH 18,A03,083745,Staff,21,0,30,9
1650791937190,MATH 18,A04,083746,Staff,26,0,30,4
1650791937190,MATH 18,B01,083748,Staff,0,15,30,30
1650791937190,MATH 18,B02,083749,Staff,0,12,30,30
1650791937190,MATH 18,B03,083750,Staff,0,12,30,30
1650791937190,MATH 18,B04,083751,Staff,0,12,30,30
1650791943217,MATH 20A,A01,083754,Staff,19,0,40,21
1650791949253,MATH 20B,A01,083756,Staff,0,13,30,30
1650791949253,MATH 20B,A02,083757,Staff,0,12,30,30
1650791955277,MATH 20C,A01,083760,Staff,0,17,30,30
1650791955277,MATH 20C,A02,083761,Staff,0,16,30,30
1650791955277,MATH 20C,B01,083762,Staff,9,0,30,21
1650791955277,MATH 20C,B02,083763,Staff,28,0,30,2
1650791961305,MATH 20D,A01,083765,Staff,2,1,30,28
1650791961305,MATH 20D,A02,083766,Staff,6,0,30,24
1650791961305,MATH 20D,A03,083767,Staff,24,0,30,6
1650791967334,MATH 20E,A01,083771,Staff,2,0,30,28
1650791967334,MATH 20E,A02,083772,Staff,15,0,30,15
1650791967334,MATH 20E,B01,083773,Staff,0,0,30,30
1650791967334,MATH 20E,B02,083774,Staff,5,0,30,25
1650791973359,MATH 103A,A01,083777,Staff,0,16,30,30
1650791973359,MATH 103A,A02,083778,Staff,0,15,30,30
1650791973359,MATH 103A,B01,083779,Staff,0,15,30,30
1650791973359,MATH 103A,B02,083780,Staff,0,15,30,30
1650791979388,MATH 105,A01,085443,Staff,0,22,30,30
1650791985417,MATH 109,A01,083213,Anzaldo; Leesa B,0,7,30,30
1650791985417,MATH 109,A02,083214,Anzaldo; Leesa B,0,7,30,30
1650791985417,MATH 109,B01,083215,Anzaldo; Leesa B,0,8,30,30
1650791985417,MATH 109,B02,083216,Anzaldo; Leesa B,0,7,30,30
1650791991442,MATH 142A,A01,083219,Chow; Bennett,0,16,30,30
1650791991442,MATH 142A,A02,083220,Chow; Bennett,0,15,30,30
1650791991442,MATH 142A,B01,083221,Chow; Bennett,0,16,30,30
1650791991442,MATH 142A,B02,083222,Chow; Bennett,0,14,30,30
1650791997468,MATH 193A,A01,083224,Staff,0,6,30,30
1650791997468,MATH 193A,A02,083225,Staff,0,6,30,30
1650791997468,MATH 193A,A03,083781,Staff,0,6,30,30
1650791997468,MATH 193A,A04,083782,Staff,0,7,30,30
1650792003493,MATH 197,001,091859,McAuley; Julian John,9998,0,9999,1
1650792009551,COGS 9,A01,083615,Staff,0,17,60,60
1650792015574,COGS 11,A01,083617,Boyle; Mary E. T.,16,0,40,24
1650792021597,COGS 13,A01,083071,Staff,0,38,40,40
1650792027622,COGS 14A,A01,092681,Staff,0,36,100,100
1650792033650,COGS 14B,A01,083073,Cheng; Tzu-Han,0,12,50,50
1650792039672,COGS 17,A01,092677,Staff,11,0,75,64
1650792045699,COGS 100,A01,083619,Staff,0,29,60,60
1650792051723,COGS 101A,A01,083621,Davis; Joshua Daniel,0,28,60,60
1650792057750,COGS 101B,A01,091572,Staff,0,3,60,60
1650792063775,COGS 101C,A01,083625,Delgado; Tania,14,0,30,16
1650792069798,COGS 107A,A01,083627,Boyle; Mary E. T.,0,16,60,60
1650792075821,COGS 118A,A01,083075,Staff,0,8,60,60
1650792081847,CSE 3,A50,083646,Miranda; Gregory Joseph,18,0,38,20
1650792081847,CSE 3,A51,083647,Miranda; Gregory Joseph,36,0,37,1
1650792087870,CSE 8A,A50,083650,Miranda; Gregory Joseph,0,29,40,40
1650792093894,CSE 11,A01,083080,Cao; Yingjun,0,96,40,40
1650792099919,CSE 12,A01,083652,Staff,0,21,100,100
1650792105942,CSE 15L,A01,083654,Staff,0,3,50,50
1650792105942,CSE 15L,A02,083655,Staff,0,2,50,50
1650792111972,CSE 20,A01,083657,Staff,49,0,80,31
1650792117997,CSE 30,A01,083084,Eldon; John,0,75,40,40
1650792124021,CSE 100,A01,083659,Cao; Yingjun,0,71,50,50
1650792130052,CSE 134B,A01,083661,Powell; Thomas Allan,0,38,65,65
1650792136080,CSE 140,A01,083663,Staff,0,11,75,75
1650792142105,CSE 140L,A01,083088,Eldon; John,0,20,75,75
1650792148134,CSE 175,A01,083665,Kumar; Rakesh,7,0,25,18
1650792154174,CSE 190,A00,092507,Dubnov; Shlomo,10,0,20,10
1650792160200,ECE 45,A01,083139,Staff,0,1,60,60
1650792166225,ECE 65,A50,083695,Staff,0,5,30,30
1650792172252,ECE 109,A01,091882,Touri; Behrouz,32,0,70,38
1650792178277,ECE 180,A00,083140,Abi Samra; Nicholas Camill,20,0,30,10
1650792178277,ECE 180,B00,083141,Abi Samra; Nicholas Camill,0,0,30,30
1650792184303,MATH 10A,A01,083735,Patchell; Gregory David,2,0,30,28
1650792184303,MATH 10A,A02,083736,Patchell; Gregory David,27,0,30,3
1650792184303,MATH 10A,A03,083737,Patchell; Gregory David,24,0,30,6
1650792190327,MATH 10B,A01,083207,Staff,0,9,30,30
1650792190327,MATH 10B,A02,083208,Staff,0,6,30,30
1650792190327,MATH 10B,B01,083739,Staff,11,0,30,19
1650792190327,MATH 10B,B02,083740,Staff,28,0,30,2
1650792196358,MATH 18,A01,083743,Staff,0,0,30,30
1650792196358,MATH 18,A02,083744,Staff,23,0,30,7
1650792196358,MATH 18,A03,083745,Staff,21,0,30,9
1650792196358,MATH 18,A04,083746,Staff,26,0,30,4
1650792196358,MATH 18,B01,083748,Staff,0,15,30,30
1650792196358,MATH 18,B02,083749,Staff,0,12,30,30
1650792196358,MATH 18,B03,083750,Staff,0,12,30,30
1650792196358,MATH 18,B04,083751,Staff,0,12,30,30
1650792202386,MATH 20A,A01,083754,Staff,19,0,40,21
1650792208410,MATH 20B,A01,083756,Staff,0,13,30,30
1650792208410,MATH 20B,A02,083757,Staff,0,12,30,30
1650792214437,MATH 20C,A01,083760,Staff,0,17,30,30
1650792214437,MATH 20C,A02,083761,Staff,0,16,30,30
1650792214437,MATH 20C,B01,083762,Staff,9,0,30,21
1650792214437,MATH 20C,B02,083763,Staff,28,0,30,2
1650792220462,MATH 20D,A01,083765,Staff,2,1,30,28
1650792220462,MATH 20D,A02,083766,Staff,6,0,30,24
1650792220462,MATH 20D,A03,083767,Staff,24,0,30,6
1650792226487,MATH 20E,A01,083771,Staff,2,0,30,28
1650792226487,MATH 20E,A02,083772,Staff,15,0,30,15
1650792226487,MATH 20E,B01,083773,Staff,0,0,30,30
1650792226487,MATH 20E,B02,083774,Staff,5,0,30,25
1650792232511,MATH 103A,A01,083777,Staff,0,16,30,30
1650792232511,MATH 103A,A02,083778,Staff,0,15,30,30
1650792232511,MATH 103A,B01,083779,Staff,0,15,30,30
1650792232511,MATH 103A,B02,083780,Staff,0,15,30,30
1650792238536,MATH 105,A01,085443,Staff,0,22,30,30
1650792244561,MATH 109,A01,083213,Anzaldo; Leesa B,0,7,30,30
1650792244561,MATH 109,A02,083214,Anzaldo; Leesa B,0,7,30,30
1650792244561,MATH 109,B01,083215,Anzaldo; Leesa B,0,8,30,30
1650792244561,MATH 109,B02,083216,Anzaldo; Leesa B,0,7,30,30
1650792250596,MATH 142A,A01,083219,Chow; Bennett,0,16,30,30
1650792250596,MATH 142A,A02,083220,Chow; Bennett,0,15,30,30
1650792250596,MATH 142A,B01,083221,Chow; Bennett,0,16,30,30
1650792250596,MATH 142A,B02,083222,Chow; Bennett,0,14,30,30
1650792256635,MATH 193A,A01,083224,Staff,0,6,30,30
1650792256635,MATH 193A,A02,083225,Staff,0,6,30,30
1650792256635,MATH 193A,A03,083781,Staff,0,6,30,30
1650792256635,MATH 193A,A04,083782,Staff,0,7,30,30
1650792262659,MATH 197,001,091859,McAuley; Julian John,9998,0,9999,1
1650792268738,COGS 9,A01,083615,Staff,0,17,60,60
1650792274763,COGS 11,A01,083617,Boyle; Mary E. T.,16,0,40,24
1650792280790,COGS 13,A01,083071,Staff,0,38,40,40
1650792286819,COGS 14A,A01,092681,Staff,0,36,100,100
1650792292844,COGS 14B,A01,083073,Cheng; Tzu-Han,0,12,50,50
1650792298868,COGS 17,A01,092677,Staff,11,0,75,64
1650792304894,COGS 100,A01,083619,Staff,0,29,60,60
1650792310924,COGS 101A,A01,083621,Davis; Joshua Daniel,0,28,60,60
1650792316951,COGS 101B,A01,091572,Staff,0,3,60,60
1650792322980,COGS 101C,A01,083625,Delgado; Tania,14,0,30,16
1650792329005,COGS 107A,A01,083627,Boyle; Mary E. T.,0,16,60,60
1650792335031,COGS 118A,A01,083075,Staff,0,8,60,60
1650792341055,CSE 3,A50,083646,Miranda; Gregory Joseph,18,0,38,20
1650792341055,CSE 3,A51,083647,Miranda; Gregory Joseph,36,0,37,1
1650792347079,CSE 8A,A50,083650,Miranda; Gregory Joseph,0,29,40,40
1650792353106,CSE 11,A01,083080,Cao; Yingjun,0,96,40,40
1650792359132,CSE 12,A01,083652,Staff,0,21,100,100
1650792365157,CSE 15L,A01,083654,Staff,0,3,50,50
1650792365157,CSE 15L,A02,083655,Staff,0,2,50,50
1650792371181,CSE 20,A01,083657,Staff,49,0,80,31
1650792377210,CSE 30,A01,083084,Eldon; John,0,75,40,40
1650792383234,CSE 100,A01,083659,Cao; Yingjun,0,71,50,50
1650792389264,CSE 134B,A01,083661,Powell; Thomas Allan,0,38,65,65
1650792395289,CSE 140,A01,083663,Staff,0,11,75,75
1650792401387,CSE 140L,A01,083088,Eldon; John,0,20,75,75
1650792407412,CSE 175,A01,083665,Kumar; Rakesh,7,0,25,18
1650792413440,CSE 190,A00,092507,Dubnov; Shlomo,10,0,20,10
1650792419465,ECE 45,A01,083139,Staff,0,1,60,60
1650792425489,ECE 65,A50,083695,Staff,0,5,30,30
1650792431514,ECE 109,A01,091882,Touri; Behrouz,32,0,70,38
1650792437539,ECE 180,A00,083140,Abi Samra; Nicholas Camill,20,0,30,10
1650792437539,ECE 180,B00,083141,Abi Samra; Nicholas Camill,0,0,30,30
1650792443564,MATH 10A,A01,083735,Patchell; Gregory David,2,0,30,28
1650792443564,MATH 10A,A02,083736,Patchell; Gregory David,27,0,30,3
1650792443564,MATH 10A,A03,083737,Patchell; Gregory David,24,0,30,6
1650792449593,MATH 10B,A01,083207,Staff,0,9,30,30
1650792449593,MATH 10B,A02,083208,Staff,0,6,30,30
1650792449593,MATH 10B,B01,083739,Staff,11,0,30,19
1650792449593,MATH 10B,B02,083740,Staff,28,0,30,2
1650792455624,MATH 18,A01,083743,Staff,0,0,30,30
1650792455624,MATH 18,A02,083744,Staff,23,0,30,7
1650792455624,MATH 18,A03,083745,Staff,21,0,30,9
1650792455624,MATH 18,A04,083746,Staff,26,0,30,4
1650792455624,MATH 18,B01,083748,Staff,0,15,30,30
1650792455624,MATH 18,B02,083749,Staff,0,12,30,30
1650792455624,MATH 18,B03,083750,Staff,0,12,30,30
1650792455624,MATH 18,B04,083751,Staff,0,12,30,30
1650792461648,MATH 20A,A01,083754,Staff,19,0,40,21
1650792467673,MATH 20B,A01,083756,Staff,0,13,30,30
1650792467673,MATH 20B,A02,083757,Staff,0,12,30,30
1650792473699,MATH 20C,A01,083760,Staff,0,17,30,30
1650792473699,MATH 20C,A02,083761,Staff,0,16,30,30
1650792473699,MATH 20C,B01,083762,Staff,9,0,30,21
1650792473699,MATH 20C,B02,083763,Staff,28,0,30,2
1650792479723,MATH 20D,A01,083765,Staff,2,1,30,28
1650792479723,MATH 20D,A02,083766,Staff,6,0,30,24
1650792479723,MATH 20D,A03,083767,Staff,24,0,30,6
1650792485753,MATH 20E,A01,083771,Staff,2,0,30,28
1650792485753,MATH 20E,A02,083772,Staff,15,0,30,15
1650792485753,MATH 20E,B01,083773,Staff,0,0,30,30
1650792485753,MATH 20E,B02,083774,Staff,5,0,30,25
1650792491783,MATH 103A,A01,083777,Staff,0,16,30,30
1650792491783,MATH 103A,A02,083778,Staff,0,15,30,30
1650792491783,MATH 103A,B01,083779,Staff,0,15,30,30
1650792491783,MATH 103A,B02,083780,Staff,0,15,30,30
1650792497810,MATH 105,A01,085443,Staff,0,22,30,30
1650792503835,MATH 109,A01,083213,Anzaldo; Leesa B,0,7,30,30
1650792503835,MATH 109,A02,083214,Anzaldo; Leesa B,0,7,30,30
1650792503835,MATH 109,B01,083215,Anzaldo; Leesa B,0,8,30,30
1650792503835,MATH 109,B02,083216,Anzaldo; Leesa B,0,7,30,30
1650792509865,MATH 142A,A01,083219,Chow; Bennett,0,16,30,30
1650792509865,MATH 142A,A02,083220,Chow; Bennett,0,15,30,30
1650792509865,MATH 142A,B01,083221,Chow; Bennett,0,16,30,30
1650792509865,MATH 142A,B02,083222,Chow; Bennett,0,14,30,30
1650792515893,MATH 193A,A01,083224,Staff,0,6,30,30
1650792515893,MATH 193A,A02,083225,Staff,0,6,30,30
1650792515893,MATH 193A,A03,083781,Staff,0,6,30,30
1650792515893,MATH 193A,A04,083782,Staff,0,7,30,30
1650792521916,MATH 197,001,091859,McAuley; Julian John,9998,0,9999,1
1650792527986,COGS 9,A01,083615,Staff,0,17,60,60
1650792534010,COGS 11,A01,083617,Boyle; Mary E. T.,16,0,40,24
1650792540038,COGS 13,A01,083071,Staff,0,38,40,40
1650792546067,COGS 14A,A01,092681,Staff,0,36,100,100
1650792552095,COGS 14B,A01,083073,Cheng; Tzu-Han,0,12,50,50
1650792558121,COGS 17,A01,092677,Staff,11,0,75,64
1650792564146,COGS 100,A01,083619,Staff,0,29,60,60
1650792570173,COGS 101A,A01,083621,Davis; Joshua Daniel,0,28,60,60
1650792576198,COGS 101B,A01,091572,Staff,0,3,60,60
1650792582227,COGS 101C,A01,083625,Delgado; Tania,14,0,30,16
1650792588252,COGS 107A,A01,083627,Boyle; Mary E. T.,0,16,60,60
1650792594279,COGS 118A,A01,083075,Staff,0,8,60,60
1650792600309,CSE 3,A50,083646,Miranda; Gregory Joseph,18,0,38,20
1650792600309,CSE 3,A51,083647,Miranda; Gregory Joseph,36,0,37,1
1650792606338,CSE 8A,A50,083650,Miranda; Gregory Joseph,0,29,40,40
1650792612363,CSE 11,A01,083080,Cao; Yingjun,0,96,40,40
1650792618401,CSE 12,A01,083652,Staff,0,21,100,100
1650792624425,CSE 15L,A01,083654,Staff,0,3,50,50
1650792624425,CSE 15L,A02,083655,Staff,0,2,50,50
1650792630453,CSE 20,A01,083657,Staff,49,0,80,31
1650792636477,CSE 30,A01,083084,Eldon; John,0,75,40,40
1650792642499,CSE 100,A01,083659,Cao; Yingjun,0,71,50,50
1650792648529,CSE 134B,A01,083661,Powell; Thomas Allan,0,38,65,65
1650792654552,CSE 140,A01,083663,Staff,0,11,75,75
1650792660582,CSE 140L,A01,083088,Eldon; John,0,20,75,75
1650792666606,CSE 175,A01,083665,Kumar; Rakesh,7,0,25,18
1650792672629,CSE 190,A00,092507,Dubnov; Shlomo,10,0,20,10
1650792678653,ECE 45,A01,083139,Staff,0,1,60,60
1650792684680,ECE 65,A50,083695,Staff,0,5,30,30
1650792690704,ECE 109,A01,091882,Touri; Behrouz,32,0,70,38
1650792696728,ECE 180,A00,083140,Abi Samra; Nicholas Camill,20,0,30,10
1650792696728,ECE 180,B00,083141,Abi Samra; Nicholas Camill,0,0,30,30
1650792702755,MATH 10A,A01,083735,Patchell; Gregory David,2,0,30,28
1650792702755,MATH 10A,A02,083736,Patchell; Gregory David,27,0,30,3
1650792702755,MATH 10A,A03,083737,Patchell; Gregory David,24,0,30,6
1650792708790,MATH 10B,A01,083207,Staff,0,9,30,30
1650792708790,MATH 10B,A02,083208,Staff,0,6,30,30
1650792708790,MATH 10B,B01,083739,Staff,11,0,30,19
1650792708790,MATH 10B,B02,083740,Staff,28,0,30,2
1650792714817,MATH 18,A01,083743,Staff,0,0,30,30
1650792714817,MATH 18,A02,083744,Staff,23,0,30,7
1650792714817,MATH 18,A03,083745,Staff,21,0,30,9
1650792714817,MATH 18,A04,083746,Staff,26,0,30,4
1650792714817,MATH 18,B01,083748,Staff,0,15,30,30
1650792714817,MATH 18,B02,083749,Staff,0,12,30,30
1650792714817,MATH 18,B03,083750,Staff,0,12,30,30
1650792714817,MATH 18,B04,083751,Staff,0,12,30,30
1650792720862,MATH 20A,A01,083754,Staff,19,0,40,21
1650792726887,MATH 20B,A01,083756,Staff,0,13,30,30
1650792726887,MATH 20B,A02,083757,Staff,0,12,30,30
1650792732911,MATH 20C,A01,083760,Staff,0,17,30,30
1650792732911,MATH 20C,A02,083761,Staff,0,16,30,30
1650792732911,MATH 20C,B01,083762,Staff,9,0,30,21
1650792732911,MATH 20C,B02,083763,Staff,28,0,30,2
1650792738935,MATH 20D,A01,083765,Staff,2,1,30,28
1650792738935,MATH 20D,A02,083766,Staff,6,0,30,24
1650792738935,MATH 20D,A03,083767,Staff,24,0,30,6
1650792744959,MATH 20E,A01,083771,Staff,2,0,30,28
1650792744959,MATH 20E,A02,083772,Staff,15,0,30,15
1650792744959,MATH 20E,B01,083773,Staff,0,0,30,30
1650792744959,MATH 20E,B02,083774,Staff,5,0,30,25
1650792750996,MATH 103A,A01,083777,Staff,0,16,30,30
1650792750996,MATH 103A,A02,083778,Staff,0,15,30,30
1650792750996,MATH 103A,B01,083779,Staff,0,15,30,30
1650792750996,MATH 103A,B02,083780,Staff,0,15,30,30
1650792757031,MATH 105,A01,085443,Staff,0,22,30,30
1650792763086,MATH 109,A01,083213,Anzaldo; Leesa B,0,7,30,30
1650792763086,MATH 109,A02,083214,Anzaldo; Leesa B,0,7,30,30
1650792763086,MATH 109,B01,083215,Anzaldo; Leesa B,0,8,30,30
1650792763086,MATH 109,B02,083216,Anzaldo; Leesa B,0,7,30,30
1650792769124,MATH 142A,A01,083219,Chow; Bennett,0,16,30,30
1650792769124,MATH 142A,A02,083220,Chow; Bennett,0,15,30,30
1650792769124,MATH 142A,B01,083221,Chow; Bennett,0,16,30,30
1650792769124,MATH 142A,B02,083222,Chow; Bennett,0,14,30,30
1650792775176,MATH 193A,A01,083224,Staff,0,6,30,30
1650792775176,MATH 193A,A02,083225,Staff,0,6,30,30
1650792775176,MATH 193A,A03,083781,Staff,0,6,30,30
1650792775176,MATH 193A,A04,083782,Staff,0,7,30,30
1650792781200,MATH 197,001,091859,McAuley; Julian John,9998,0,9999,1
1650792787259,COGS 9,A01,083615,Staff,0,17,60,60
1650792793292,COGS 11,A01,083617,Boyle; Mary E. T.,16,0,40,24
1650792799340,COGS 13,A01,083071,Staff,0,38,40,40
1650792805370,COGS 14A,A01,092681,Staff,0,36,100,100
1650792811395,COGS 14B,A01,083073,Cheng; Tzu-Han,0,12,50,50
1650792817419,COGS 17,A01,092677,Staff,11,0,75,64
1650792823447,COGS 100,A01,083619,Staff,0,29,60,60
1650792829472,COGS 101A,A01,083621,Davis; Joshua Daniel,0,28,60,60
1650792835512,COGS 101B,A01,091572,Staff,0,3,60,60
1650792841535,COGS 101C,A01,083625,Delgado; Tania,14,0,30,16
1650792847572,COGS 107A,A01,083627,Boyle; Mary E. T.,0,16,60,60
1650792853613,COGS 118A,A01,083075,Staff,0,8,60,60
1650792859640,CSE 3,A50,083646,Miranda; Gregory Joseph,18,0,38,20
1650792859640,CSE 3,A51,083647,Miranda; Gregory Joseph,36,0,37,1
1650792865665,CSE 8A,A50,083650,Miranda; Gregory Joseph,0,29,40,40
1650792871706,CSE 11,A01,083080,Cao; Yingjun,0,96,40,40
1650792877740,CSE 12,A01,083652,Staff,0,21,100,100
1650792883775,CSE 15L,A01,083654,Staff,0,3,50,50
1650792883775,CSE 15L,A02,083655,Staff,0,2,50,50
1650792889811,CSE 20,A01,083657,Staff,49,0,80,31
1650792895852,CSE 30,A01,083084,Eldon; John,0,75,40,40
1650792901877,CSE 100,A01,083659,Cao; Yingjun,0,71,50,50
1650792907927,CSE 134B,A01,083661,Powell; Thomas Allan,0,38,65,65
1650792913955,CSE 140,A01,083663,Staff,0,11,75,75
1650792919980,CSE 140L,A01,083088,Eldon; John,0,20,75,75
1650792926004,CSE 175,A01,083665,Kumar; Rakesh,7,0,25,18
1650792932031,CSE 190,A00,092507,Dubnov; Shlomo,10,0,20,10
1650792938060,ECE 45,A01,083139,Staff,0,1,60,60
1650792944102,ECE 65,A50,083695,Staff,0,5,30,30
1650792950150,ECE 109,A01,091882,Touri; Behrouz,32,0,70,38
1650792956173,ECE 180,A00,083140,Abi Samra; Nicholas Camill,20,0,30,10
1650792956173,ECE 180,B00,083141,Abi Samra; Nicholas Camill,0,0,30,30
1650792962202,MATH 10A,A01,083735,Patchell; Gregory David,2,0,30,28
1650792962202,MATH 10A,A02,083736,Patchell; Gregory David,27,0,30,3
1650792962202,MATH 10A,A03,083737,Patchell; Gregory David,24,0,30,6
1650792968227,MATH 10B,A01,083207,Staff,0,9,30,30
1650792968227,MATH 10B,A02,083208,Staff,0,6,30,30
1650792968227,MATH 10B,B01,083739,Staff,11,0,30,19
1650792968227,MATH 10B,B02,083740,Staff,28,0,30,2
1650792974262,MATH 18,A01,083743,Staff,0,0,30,30
1650792974262,MATH 18,A02,083744,Staff,23,0,30,7
1650792974262,MATH 18,A03,083745,Staff,21,0,30,9
1650792974262,MATH 18,A04,083746,Staff,26,0,30,4
1650792974262,MATH 18,B01,083748,Staff,0,15,30,30
1650792974262,MATH 18,B02,083749,Staff,0,12,30,30
1650792974262,MATH 18,B03,083750,Staff,0,12,30,30
1650792974262,MATH 18,B04,083751,Staff,0,12,30,30
1650792980289,MATH 20A,A01,083754,Staff,19,0,40,21
1650792986338,MATH 20B,A01,083756,Staff,0,13,30,30
1650792986338,MATH 20B,A02,083757,Staff,0,12,30,30
1650792992378,MATH 20C,A01,083760,Staff,0,17,30,30
1650792992378,MATH 20C,A02,083761,Staff,0,16,30,30
1650792992378,MATH 20C,B01,083762,Staff,9,0,30,21
1650792992378,MATH 20C,B02,083763,Staff,28,0,30,2
1650792998476,MATH 20D,A01,083765,Staff,2,1,30,28
1650792998476,MATH 20D,A02,083766,Staff,6,0,30,24
1650792998476,MATH 20D,A03,083767,Staff,24,0,30,6
1650793004500,MATH 20E,A01,083771,Staff,2,0,30,28
1650793004500,MATH 20E,A02,083772,Staff,15,0,30,15
1650793004500,MATH 20E,B01,083773,Staff,0,0,30,30
1650793004500,MATH 20E,B02,083774,Staff,5,0,30,25
1650793010526,MATH 103A,A01,083777,Staff,0,16,30,30
1650793010526,MATH 103A,A02,083778,Staff,0,15,30,30
1650793010526,MATH 103A,B01,083779,Staff,0,15,30,30
1650793010526,MATH 103A,B02,083780,Staff,0,15,30,30
1650793016576,MATH 105,A01,085443,Staff,0,22,30,30
1650793022628,MATH 109,A01,083213,Anzaldo; Leesa B,0,7,30,30
1650793022628,MATH 109,A02,083214,Anzaldo; Leesa B,0,7,30,30
1650793022628,MATH 109,B01,083215,Anzaldo; Leesa B,0,8,30,30
1650793022628,MATH 109,B02,083216,Anzaldo; Leesa B,0,7,30,30
1650793028653,MATH 142A,A01,083219,Chow; Bennett,0,16,30,30
1650793028653,MATH 142A,A02,083220,Chow; Bennett,0,15,30,30
1650793028653,MATH 142A,B01,083221,Chow; Bennett,0,16,30,30
1650793028653,MATH 142A,B02,083222,Chow; Bennett,0,14,30,30
1650793034677,MATH 193A,A01,083224,Staff,0,6,30,30
1650793034677,MATH 193A,A02,083225,Staff,0,6,30,30
1650793034677,MATH 193A,A03,083781,Staff,0,6,30,30
1650793034677,MATH 193A,A04,083782,Staff,0,7,30,30
1650793040701,MATH 197,001,091859,McAuley; Julian John,9998,0,9999,1
1650793046779,COGS 9,A01,083615,Staff,0,17,60,60
1650793052806,COGS 11,A01,083617,Boyle; Mary E. T.,16,0,40,24
1650793058829,COGS 13,A01,083071,Staff,0,38,40,40
1650793064865,COGS 14A,A01,092681,Staff,0,36,100,100
1650793070889,COGS 14B,A01,083073,Cheng; Tzu-Han,0,12,50,50
1650793076915,COGS 17,A01,092677,Staff,11,0,75,64
1650793082939,COGS 100,A01,083619,Staff,0,29,60,60
1650793088964,COGS 101A,A01,083621,Davis; Joshua Daniel,0,28,60,60
1650793094991,COGS 101B,A01,091572,Staff,0,3,60,60
1650793101023,COGS 101C,A01,083625,Delgado; Tania,14,0,30,16
1650793107046,COGS 107A,A01,083627,Boyle; Mary E. T.,0,16,60,60
1650793113070,COGS 118A,A01,083075,Staff,0,8,60,60
1650793119105,CSE 3,A50,083646,Miranda; Gregory Joseph,18,0,38,20
1650793119105,CSE 3,A51,083647,Miranda; Gregory Joseph,36,0,37,1
1650793125160,CSE 8A,A50,083650,Miranda; Gregory Joseph,0,29,40,40
1650793131215,CSE 11,A01,083080,Cao; Yingjun,0,96,40,40
1650793137264,CSE 12,A01,083652,Staff,0,21,100,100
1650793143288,CSE 15L,A01,083654,Staff,0,3,50,50
1650793143288,CSE 15L,A02,083655,Staff,0,2,50,50
1650793149316,CSE 20,A01,083657,Staff,49,0,80,31
1650793155342,CSE 30,A01,083084,Eldon; John,0,75,40,40
1650793161366,CSE 100,A01,083659,Cao; Yingjun,0,71,50,50
1650793167401,CSE 134B,A01,083661,Powell; Thomas Allan,0,38,65,65
1650793173440,CSE 140,A01,083663,Staff,0,11,75,75
1650793179479,CSE 140L,A01,083088,Eldon; John,0,20,75,75
1650793185511,CSE 175,A01,083665,Kumar; Rakesh,7,0,25,18
1650793191536,CSE 190,A00,092507,Dubnov; Shlomo,10,0,20,10
1650793197559,ECE 45,A01,083139,Staff,0,1,60,60
1650793203584,ECE 65,A50,083695,Staff,0,5,30,30
1650793209607,ECE 109,A01,091882,Touri; Behrouz,32,0,70,38
1650793215634,ECE 180,A00,083140,Abi Samra; Nicholas Camill,20,0,30,10
1650793215634,ECE 180,B00,083141,Abi Samra; Nicholas Camill,0,0,30,30
1650793221664,MATH 10A,A01,083735,Patchell; Gregory David,2,0,30,28
1650793221664,MATH 10A,A02,083736,Patchell; Gregory David,27,0,30,3
1650793221664,MATH 10A,A03,083737,Patchell; Gregory David,24,0,30,6
1650793227705,MATH 10B,A01,083207,Staff,0,9,30,30
1650793227705,MATH 10B,A02,083208,Staff,0,6,30,30
1650793227705,MATH 10B,B01,083739,Staff,11,0,30,19
1650793227705,MATH 10B,B02,083740,Staff,28,0,30,2
1650793233757,MATH 18,A01,083743,Staff,0,0,30,30
1650793233757,MATH 18,A02,083744,Staff,23,0,30,7
1650793233757,MATH 18,A03,083745,Staff,21,0,30,9
1650793233757,MATH 18,A04,083746,Staff,26,0,30,4
1650793233757,MATH 18,B01,083748,Staff,0,15,30,30
1650793233757,MATH 18,B02,083749,Staff,0,12,30,30
1650793233757,MATH 18,B03,083750,Staff,0,12,30,30
1650793233757,MATH 18,B04,083751,Staff,0,12,30,30
1650793239780,MATH 20A,A01,083754,Staff,19,0,40,21
1650793245820,MATH 20B,A01,083756,Staff,0,13,30,30
1650793245820,MATH 20B,A02,083757,Staff,0,12,30,30
1650793251868,MATH 20C,A01,083760,Staff,0,17,30,30
1650793251868,MATH 20C,A02,083761,Staff,0,16,30,30
1650793251868,MATH 20C,B01,083762,Staff,9,0,30,21
1650793251868,MATH 20C,B02,083763,Staff,28,0,30,2
1650793257895,MATH 20D,A01,083765,Staff,2,1,30,28
1650793257895,MATH 20D,A02,083766,Staff,6,0,30,24
1650793257895,MATH 20D,A03,083767,Staff,24,0,30,6
1650793263940,MATH 20E,A01,083771,Staff,2,0,30,28
1650793263940,MATH 20E,A02,083772,Staff,15,0,30,15
1650793263940,MATH 20E,B01,083773,Staff,0,0,30,30
1650793263940,MATH 20E,B02,083774,Staff,5,0,30,25
1650793269978,MATH 103A,A01,083777,Staff,0,16,30,30
1650793269978,MATH 103A,A02,083778,Staff,0,15,30,30
1650793269978,MATH 103A,B01,083779,Staff,0,15,30,30
1650793269978,MATH 103A,B02,083780,Staff,0,15,30,30
1650793276029,MATH 105,A01,085443,Staff,0,22,30,30
1650793282056,MATH 109,A01,083213,Anzaldo; Leesa B,0,7,30,30
1650793282056,MATH 109,A02,083214,Anzaldo; Leesa B,0,7,30,30
1650793282056,MATH 109,B01,083215,Anzaldo; Leesa B,0,8,30,30
1650793282056,MATH 109,B02,083216,Anzaldo; Leesa B,0,7,30,30
1650793288085,MATH 142A,A01,083219,Chow; Bennett,0,16,30,30
1650793288085,MATH 142A,A02,083220,Chow; Bennett,0,15,30,30
1650793288085,MATH 142A,B01,083221,Chow; Bennett,0,16,30,30
1650793288085,MATH 142A,B02,083222,Chow; Bennett,0,14,30,30
1650793294108,MATH 193A,A01,083224,Staff,0,6,30,30
1650793294108,MATH 193A,A02,083225,Staff,0,6,30,30
1650793294108,MATH 193A,A03,083781,Staff,0,6,30,30
1650793294108,MATH 193A,A04,083782,Staff,0,7,30,30
1650793300136,MATH 197,001,091859,McAuley; Julian John,9998,0,9999,1
1650793306206,COGS 9,A01,083615,Staff,0,17,60,60
1650793312234,COGS 11,A01,083617,Boyle; Mary E. T.,16,0,40,24
1650793318269,COGS 13,A01,083071,Staff,0,38,40,40
1650793324308,COGS 14A,A01,092681,Staff,0,36,100,100
1650793330337,COGS 14B,A01,083073,Cheng; Tzu-Han,0,12,50,50
1650793336365,COGS 17,A01,092677,Staff,11,0,75,64
1650793342394,COGS 100,A01,083619,Staff,0,29,60,60
1650793348440,COGS 101A,A01,083621,Davis; Joshua Daniel,0,28,60,60
1650793354484,COGS 101B,A01,091572,Staff,0,3,60,60
1650793360526,COGS 101C,A01,083625,Delgado; Tania,14,0,30,16
1650793366550,COGS 107A,A01,083627,Boyle; Mary E. T.,0,16,60,60
1650793372578,COGS 118A,A01,083075,Staff,0,8,60,60
1650793378618,CSE 3,A50,083646,Miranda; Gregory Joseph,18,0,38,20
1650793378618,CSE 3,A51,083647,Miranda; Gregory Joseph,36,0,37,1
1650793384643,CSE 8A,A50,083650,Miranda; Gregory Joseph,0,29,40,40
1650793390680,CSE 11,A01,083080,Cao; Yingjun,0,96,40,40
1650793396723,CSE 12,A01,083652,Staff,0,21,100,100
1650793402748,CSE 15L,A01,083654,Staff,0,3,50,50
1650793402748,CSE 15L,A02,083655,Staff,0,2,50,50
1650793408776,CSE 20,A01,083657,Staff,49,0,80,31
1650793414805,CSE 30,A01,083084,Eldon; John,0,75,40,40
1650793420843,CSE 100,A01,083659,Cao; Yingjun,0,71,50,50
1650793426892,CSE 134B,A01,083661,Powell; Thomas Allan,0,38,65,65
1650793432937,CSE 140,A01,083663,Staff,0,11,75,75
1650793438961,CSE 140L,A01,083088,Eldon; John,0,20,75,75
1650793444992,CSE 175,A01,083665,Kumar; Rakesh,7,0,25,18
1650793451046,CSE 190,A00,092507,Dubnov; Shlomo,10,0,20,10
1650793457102,ECE 45,A01,083139,Staff,0,1,60,60
1650793463158,ECE 65,A50,083695,Staff,0,5,30,30
1650793469201,ECE 109,A01,091882,Touri; Behrouz,32,0,70,38
1650793475234,ECE 180,A00,083140,Abi Samra; Nicholas Camill,20,0,30,10
1650793475234,ECE 180,B00,083141,Abi Samra; Nicholas Camill,0,0,30,30
1650793481261,MATH 10A,A01,083735,Patchell; Gregory David,2,0,30,28
1650793481261,MATH 10A,A02,083736,Patchell; Gregory David,27,0,30,3
1650793481261,MATH 10A,A03,083737,Patchell; Gregory David,24,0,30,6
1650793487286,MATH 10B,A01,083207,Staff,0,9,30,30
1650793487286,MATH 10B,A02,083208,Staff,0,6,30,30
1650793487286,MATH 10B,B01,083739,Staff,11,0,30,19
1650793487286,MATH 10B,B02,083740,Staff,28,0,30,2
1650793493320,MATH 18,A01,083743,Staff,0,0,30,30
1650793493320,MATH 18,A02,083744,Staff,23,0,30,7
1650793493320,MATH 18,A03,083745,Staff,21,0,30,9
1650793493320,MATH 18,A04,083746,Staff,26,0,30,4
1650793493320,MATH 18,B01,083748,Staff,0,15,30,30
1650793493320,MATH 18,B02,083749,Staff,0,12,30,30
1650793493320,MATH 18,B03,083750,Staff,0,12,30,30
1650793493320,MATH 18,B04,083751,Staff,0,12,30,30
1650793499366,MATH 20A,A01,083754,Staff,19,0,40,21
1650793505419,MATH 20B,A01,083756,Staff,0,13,30,30
1650793505419,MATH 20B,A02,083757,Staff,0,12,30,30
1650793511443,MATH 20C,A01,083760,Staff,0,17,30,30
1650793511443,MATH 20C,A02,083761,Staff,0,16,30,30
1650793511443,MATH 20C,B01,083762,Staff,9,0,30,21
1650793511443,MATH 20C,B02,083763,Staff,28,0,30,2
1650793517472,MATH 20D,A01,083765,Staff,2,1,30,28
1650793517472,MATH 20D,A02,083766,Staff,6,0,30,24
1650793517472,MATH 20D,A03,083767,Staff,24,0,30,6
1650793523507,MATH 20E,A01,083771,Staff,2,0,30,28
1650793523507,MATH 20E,A02,083772,Staff,15,0,30,15
1650793523507,MATH 20E,B01,083773,Staff,0,0,30,30
1650793523507,MATH 20E,B02,083774,Staff,5,0,30,25
1650793529553,MATH 103A,A01,083777,Staff,0,16,30,30
1650793529553,MATH 103A,A02,083778,Staff,0,15,30,30
1650793529553,MATH 103A,B01,083779,Staff,0,15,30,30
1650793529553,MATH 103A,B02,083780,Staff,0,15,30,30
1650793535585,MATH 105,A01,085443,Staff,0,22,30,30
1650793541614,MATH 109,A01,083213,Anzaldo; Leesa B,0,7,30,30
1650793541614,MATH 109,A02,083214,Anzaldo; Leesa B,0,7,30,30
1650793541614,MATH 109,B01,083215,Anzaldo; Leesa B,0,8,30,30
1650793541614,MATH 109,B02,083216,Anzaldo; Leesa B,0,7,30,30
1650793547646,MATH 142A,A01,083219,Chow; Bennett,0,16,30,30
1650793547646,MATH 142A,A02,083220,Chow; Bennett,0,15,30,30
1650793547646,MATH 142A,B01,083221,Chow; Bennett,0,16,30,30
1650793547646,MATH 142A,B02,083222,Chow; Bennett,0,14,30,30
1650793553671,MATH 193A,A01,083224,Staff,0,6,30,30
1650793553671,MATH 193A,A02,083225,Staff,0,6,30,30
1650793553671,MATH 193A,A03,083781,Staff,0,6,30,30
1650793553671,MATH 193A,A04,083782,Staff,0,7,30,30
1650793559696,MATH 197,001,091859,McAuley; Julian John,9998,0,9999,1
1650793565748,COGS 9,A01,083615,Staff,0,17,60,60
1650793571776,COGS 11,A01,083617,Boyle; Mary E. T.,16,0,40,24
1650793577804,COGS 13,A01,083071,Staff,0,38,40,40
1650793583832,COGS 14A,A01,092681,Staff,0,36,100,100
1650793589956,COGS 14B,A01,083073,Cheng; Tzu-Han,0,12,50,50
1650793595982,COGS 17,A01,092677,Staff,11,0,75,64
1650793602018,COGS 100,A01,083619,Staff,0,29,60,60
1650793608054,COGS 101A,A01,083621,Davis; Joshua Daniel,0,28,60,60
1650793614080,COGS 101B,A01,091572,Staff,0,3,60,60
1650793620113,COGS 101C,A01,083625,Delgado; Tania,14,0,30,16
1650793626160,COGS 107A,A01,083627,Boyle; Mary E. T.,0,16,60,60
1650793632187,COGS 118A,A01,083075,Staff,0,8,60,60
1650793638228,CSE 3,A50,083646,Miranda; Gregory Joseph,18,0,38,20
1650793638228,CSE 3,A51,083647,Miranda; Gregory Joseph,36,0,37,1
1650793644254,CSE 8A,A50,083650,Miranda; Gregory Joseph,0,29,40,40
1650793650298,CSE 11,A01,083080,Cao; Yingjun,0,96,40,40
1650793656334,CSE 12,A01,083652,Staff,0,21,100,100
1650793662368,CSE 15L,A01,083654,Staff,0,3,50,50
1650793662368,CSE 15L,A02,083655,Staff,0,2,50,50
1650793668392,CSE 20,A01,083657,Staff,49,0,80,31
1650793674422,CSE 30,A01,083084,Eldon; John,0,75,40,40
1650793680445,CSE 100,A01,083659,Cao; Yingjun,0,71,50,50
1650793686472,CSE 134B,A01,083661,Powell; Thomas Allan,0,38,65,65
1650793692496,CSE 140,A01,083663,Staff,0,11,75,75
1650793698522,CSE 140L,A01,083088,Eldon; John,0,20,75,75
1650793704558,CSE 175,A01,083665,Kumar; Rakesh,7,0,25,18
1650793710581,CSE 190,A00,092507,Dubnov; Shlomo,10,0,20,10
1650793716606,ECE 45,A01,083139,Staff,0,1,60,60
1650793722629,ECE 65,A50,083695,Staff,0,5,30,30
1650793728661,ECE 109,A01,091882,Touri; Behrouz,32,0,70,38
1650793734685,ECE 180,A00,083140,Abi Samra; Nicholas Camill,20,0,30,10
1650793734685,ECE 180,B00,083141,Abi Samra; Nicholas Camill,0,0,30,30
1650793740716,MATH 10A,A01,083735,Patchell; Gregory David,2,0,30,28
1650793740716,MATH 10A,A02,083736,Patchell; Gregory David,27,0,30,3
1650793740716,MATH 10A,A03,083737,Patchell; Gregory David,24,0,30,6
1650793746745,MATH 10B,A01,083207,Staff,0,9,30,30
1650793746745,MATH 10B,A02,083208,Staff,0,6,30,30
1650793746745,MATH 10B,B01,083739,Staff,11,0,30,19
1650793746745,MATH 10B,B02,083740,Staff,28,0,30,2
1650793752788,MATH 18,A01,083743,Staff,0,0,30,30
1650793752788,MATH 18,A02,083744,Staff,23,0,30,7
1650793752788,MATH 18,A03,083745,Staff,21,0,30,9
1650793752788,MATH 18,A04,083746,Staff,26,0,30,4
1650793752788,MATH 18,B01,083748,Staff,0,15,30,30
1650793752788,MATH 18,B02,083749,Staff,0,12,30,30
1650793752788,MATH 18,B03,083750,Staff,0,12,30,30
1650793752788,MATH 18,B04,083751,Staff,0,12,30,30
1650793758828,MATH 20A,A01,083754,Staff,19,0,40,21
1650793764859,MATH 20B,A01,083756,Staff,0,13,30,30
1650793764859,MATH 20B,A02,083757,Staff,0,12,30,30
1650793770898,MATH 20C,A01,083760,Staff,0,17,30,30
1650793770898,MATH 20C,A02,083761,Staff,0,16,30,30
1650793770898,MATH 20C,B01,083762,Staff,9,0,30,21
1650793770898,MATH 20C,B02,083763,Staff,28,0,30,2
1650793776949,MATH 20D,A01,083765,Staff,2,1,30,28
1650793776949,MATH 20D,A02,083766,Staff,6,0,30,24
1650793776949,MATH 20D,A03,083767,Staff,24,0,30,6
1650793782974,MATH 20E,A01,083771,Staff,2,0,30,28
1650793782974,MATH 20E,A02,083772,Staff,15,0,30,15
1650793782974,MATH 20E,B01,083773,Staff,0,0,30,30
1650793782974,MATH 20E,B02,083774,Staff,5,0,30,25
1650793789005,MATH 103A,A01,083777,Staff,0,16,30,30
1650793789005,MATH 103A,A02,083778,Staff,0,15,30,30
1650793789005,MATH 103A,B01,083779,Staff,0,15,30,30
1650793789005,MATH 103A,B02,083780,Staff,0,15,30,30
1650793795032,MATH 105,A01,085443,Staff,0,22,30,30
1650793801057,MATH 109,A01,083213,Anzaldo; Leesa B,0,7,30,30
1650793801057,MATH 109,A02,083214,Anzaldo; Leesa B,0,7,30,30
1650793801057,MATH 109,B01,083215,Anzaldo; Leesa B,0,8,30,30
1650793801057,MATH 109,B02,083216,Anzaldo; Leesa B,0,7,30,30
1650793807083,MATH 142A,A01,083219,Chow; Bennett,0,16,30,30
1650793807083,MATH 142A,A02,083220,Chow; Bennett,0,15,30,30
1650793807083,MATH 142A,B01,083221,Chow; Bennett,0,16,30,30
1650793807083,MATH 142A,B02,083222,Chow; Bennett,0,14,30,30
1650793813108,MATH 193A,A01,083224,Staff,0,6,30,30
1650793813108,MATH 193A,A02,083225,Staff,0,6,30,30
1650793813108,MATH 193A,A03,083781,Staff,0,6,30,30
1650793813108,MATH 193A,A04,083782,Staff,0,7,30,30
1650793819137,MATH 197,001,091859,McAuley; Julian John,9998,0,9999,1
1650793825211,COGS 9,A01,083615,Staff,0,17,60,60
1650793831243,COGS 11,A01,083617,Boyle; Mary E. T.,16,0,40,24
1650793837277,COGS 13,A01,083071,Staff,0,38,40,40
1650793843302,COGS 14A,A01,092681,Staff,0,36,100,100
1650793849351,COGS 14B,A01,083073,Cheng; Tzu-Han,0,12,50,50
1650793855378,COGS 17,A01,092677,Staff,11,0,75,64
1650793861403,COGS 100,A01,083619,Staff,0,29,60,60
1650793867437,COGS 101A,A01,083621,Davis; Joshua Daniel,0,28,60,60
1650793873471,COGS 101B,A01,091572,Staff,0,3,60,60
1650793879499,COGS 101C,A01,083625,Delgado; Tania,14,0,30,16
1650793885524,COGS 107A,A01,083627,Boyle; Mary E. T.,0,16,60,60
1650793891548,COGS 118A,A01,083075,Staff,0,8,60,60
1650793897573,CSE 3,A50,083646,Miranda; Gregory Joseph,18,0,38,20
1650793897573,CSE 3,A51,083647,Miranda; Gregory Joseph,36,0,37,1
1650793903596,CSE 8A,A50,083650,Miranda; Gregory Joseph,0,29,40,40
1650793909623,CSE 11,A01,083080,Cao; Yingjun,0,96,40,40
1650793915661,CSE 12,A01,083652,Staff,0,21,100,100
1650793921711,CSE 15L,A01,083654,Staff,0,3,50,50
1650793921711,CSE 15L,A02,083655,Staff,0,2,50,50
1650793927758,CSE 20,A01,083657,Staff,49,0,80,31
1650793933783,CSE 30,A01,083084,Eldon; John,0,75,40,40
1650793939811,CSE 100,A01,083659,Cao; Yingjun,0,71,50,50
1650793945838,CSE 134B,A01,083661,Powell; Thomas Allan,0,38,65,65
1650793951870,CSE 140,A01,083663,Staff,0,11,75,75
1650793957897,CSE 140L,A01,083088,Eldon; John,0,20,75,75
1650793963921,CSE 175,A01,083665,Kumar; Rakesh,7,0,25,18
1650793969966,CSE 190,A00,092507,Dubnov; Shlomo,10,0,20,10
1650793976007,ECE 45,A01,083139,Staff,0,1,60,60
1650793982050,ECE 65,A50,083695,Staff,0,5,30,30
1650793988089,ECE 109,A01,091882,Touri; Behrouz,32,0,70,38
1650793994129,ECE 180,A00,083140,Abi Samra; Nicholas Camill,20,0,30,10
1650793994129,ECE 180,B00,083141,Abi Samra; Nicholas Camill,0,0,30,30
1650794000164,MATH 10A,A01,083735,Patchell; Gregory David,2,0,30,28
1650794000164,MATH 10A,A02,083736,Patchell; Gregory David,27,0,30,3
1650794000164,MATH 10A,A03,083737,Patchell; Gregory David,24,0,30,6
1650794006190,MATH 10B,A01,083207,Staff,0,9,30,30
1650794006190,MATH 10B,A02,083208,Staff,0,6,30,30
1650794006190,MATH 10B,B01,083739,Staff,11,0,30,19
1650794006190,MATH 10B,B02,083740,Staff,28,0,30,2
1650794012219,MATH 18,A01,083743,Staff,0,0,30,30
1650794012219,MATH 18,A02,083744,Staff,23,0,30,7
1650794012219,MATH 18,A03,083745,Staff,21,0,30,9
1650794012219,MATH 18,A04,083746,Staff,26,0,30,4
1650794012219,MATH 18,B01,083748,Staff,0,15,30,30
1650794012219,MATH 18,B02,083749,Staff,0,12,30,30
1650794012219,MATH 18,B03,083750,Staff,0,12,30,30
1650794012219,MATH 18,B04,083751,Staff,0,12,30,30
1650794018244,MATH 20A,A01,083754,Staff,19,0,40,21
1650794024275,MATH 20B,A01,083756,Staff,0,13,30,30
1650794024275,MATH 20B,A02,083757,Staff,0,12,30,30
1650794030314,MATH 20C,A01,083760,Staff,0,17,30,30
1650794030314,MATH 20C,A02,083761,Staff,0,16,30,30
1650794030314,MATH 20C,B01,083762,Staff,9,0,30,21
1650794030314,MATH 20C,B02,083763,Staff,28,0,30,2
1650794036341,MATH 20D,A01,083765,Staff,2,1,30,28
1650794036341,MATH 20D,A02,083766,Staff,6,0,30,24
1650794036341,MATH 20D,A03,083767,Staff,24,0,30,6
1650794042366,MATH 20E,A01,083771,Staff,2,0,30,28
1650794042366,MATH 20E,A02,083772,Staff,15,0,30,15
1650794042366,MATH 20E,B01,083773,Staff,0,0,30,30
1650794042366,MATH 20E,B02,083774,Staff,5,0,30,25
1650794048410,MATH 103A,A01,083777,Staff,0,16,30,30
1650794048410,MATH 103A,A02,083778,Staff,0,15,30,30
1650794048410,MATH 103A,B01,083779,Staff,0,15,30,30
1650794048410,MATH 103A,B02,083780,Staff,0,15,30,30
1650794054441,MATH 105,A01,085443,Staff,0,22,30,30
1650794060472,MATH 109,A01,083213,Anzaldo; Leesa B,0,7,30,30
1650794060472,MATH 109,A02,083214,Anzaldo; Leesa B,0,7,30,30
1650794060472,MATH 109,B01,083215,Anzaldo; Leesa B,0,8,30,30
1650794060472,MATH 109,B02,083216,Anzaldo; Leesa B,0,7,30,30
1650794066508,MATH 142A,A01,083219,Chow; Bennett,0,16,30,30
1650794066508,MATH 142A,A02,083220,Chow; Bennett,0,15,30,30
1650794066508,MATH 142A,B01,083221,Chow; Bennett,0,16,30,30
1650794066508,MATH 142A,B02,083222,Chow; Bennett,0,14,30,30
1650794072553,MATH 193A,A01,083224,Staff,0,6,30,30
1650794072553,MATH 193A,A02,083225,Staff,0,6,30,30
1650794072553,MATH 193A,A03,083781,Staff,0,6,30,30
1650794072553,MATH 193A,A04,083782,Staff,0,7,30,30
1650794078588,MATH 197,001,091859,McAuley; Julian John,9998,0,9999,1
1650794084681,COGS 9,A01,083615,Staff,0,17,60,60
1650794090724,COGS 11,A01,083617,Boyle; Mary E. T.,16,0,40,24
1650794096758,COGS 13,A01,083071,Staff,0,38,40,40
1650794102814,COGS 14A,A01,092681,Staff,0,36,100,100
1650794108861,COGS 14B,A01,083073,Cheng; Tzu-Han,0,12,50,50
1650794114895,COGS 17,A01,092677,Staff,11,0,75,64
1650794120925,COGS 100,A01,083619,Staff,0,29,60,60
1650794126955,COGS 101A,A01,083621,Davis; Joshua Daniel,0,28,60,60
1650794132982,COGS 101B,A01,091572,Staff,0,3,60,60
1650794139018,COGS 101C,A01,083625,Delgado; Tania,14,0,30,16
1650794145067,COGS 107A,A01,083627,Boyle; Mary E. T.,0,16,60,60
1650794151094,COGS 118A,A01,083075,Staff,0,8,60,60
1650794157123,CSE 3,A50,083646,Miranda; Gregory Joseph,18,0,38,20
1650794157123,CSE 3,A51,083647,Miranda; Gregory Joseph,36,0,37,1
1650794163152,CSE 8A,A50,083650,Miranda; Gregory Joseph,0,29,40,40
1650794169177,CSE 11,A01,083080,Cao; Yingjun,0,96,40,40
1650794175199,CSE 12,A01,083652,Staff,0,21,100,100
1650794181234,CSE 15L,A01,083654,Staff,0,3,50,50
1650794181234,CSE 15L,A02,083655,Staff,0,2,50,50
1650794187380,CSE 20,A01,083657,Staff,49,0,80,31
1650794193430,CSE 30,A01,083084,Eldon; John,0,75,40,40
1650794199457,CSE 100,A01,083659,Cao; Yingjun,0,71,50,50
1650794205499,CSE 134B,A01,083661,Powell; Thomas Allan,0,38,65,65
1650794211521,CSE 140,A01,083663,Staff,0,11,75,75
1650794217544,CSE 140L,A01,083088,Eldon; John,0,20,75,75
1650794223568,CSE 175,A01,083665,Kumar; Rakesh,7,0,25,18
1650794229593,CSE 190,A00,092507,Dubnov; Shlomo,10,0,20,10
1650794235622,ECE 45,A01,083139,Staff,0,1,60,60
1650794241676,ECE 65,A50,083695,Staff,0,5,30,30
1650794247701,ECE 109,A01,091882,Touri; Behrouz,32,0,70,38
1650794253728,ECE 180,A00,083140,Abi Samra; Nicholas Camill,20,0,30,10
1650794253728,ECE 180,B00,083141,Abi Samra; Nicholas Camill,0,0,30,30
1650794259754,MATH 10A,A01,083735,Patchell; Gregory David,2,0,30,28
1650794259754,MATH 10A,A02,083736,Patchell; Gregory David,27,0,30,3
1650794259754,MATH 10A,A03,083737,Patchell; Gregory David,24,0,30,6
1650794265808,MATH 10B,A01,083207,Staff,0,9,30,30
1650794265808,MATH 10B,A02,083208,Staff,0,6,30,30
1650794265808,MATH 10B,B01,083739,Staff,11,0,30,19
1650794265808,MATH 10B,B02,083740,Staff,28,0,30,2
1650794271833,MATH 18,A01,083743,Staff,0,0,30,30
1650794271833,MATH 18,A02,083744,Staff,23,0,30,7
1650794271833,MATH 18,A03,083745,Staff,21,0,30,9
1650794271833,MATH 18,A04,083746,Staff,26,0,30,4
1650794271833,MATH 18,B01,083748,Staff,0,15,30,30
1650794271833,MATH 18,B02,083749,Staff,0,12,30,30
1650794271833,MATH 18,B03,083750,Staff,0,12,30,30
1650794271833,MATH 18,B04,083751,Staff,0,12,30,30
1650794277871,MATH 20A,A01,083754,Staff,19,0,40,21
1650794283903,MATH 20B,A01,083756,Staff,0,13,30,30
1650794283903,MATH 20B,A02,083757,Staff,0,12,30,30
1650794289939,MATH 20C,A01,083760,Staff,0,17,30,30
1650794289939,MATH 20C,A02,083761,Staff,0,16,30,30
1650794289939,MATH 20C,B01,083762,Staff,9,0,30,21
1650794289939,MATH 20C,B02,083763,Staff,28,0,30,2
1650794295977,MATH 20D,A01,083765,Staff,2,1,30,28
1650794295977,MATH 20D,A02,083766,Staff,6,0,30,24
1650794295977,MATH 20D,A03,083767,Staff,24,0,30,6
1650794302023,MATH 20E,A01,083771,Staff,2,0,30,28
1650794302023,MATH 20E,A02,083772,Staff,15,0,30,15
1650794302023,MATH 20E,B01,083773,Staff,0,0,30,30
1650794302023,MATH 20E,B02,083774,Staff,5,0,30,25
1650794308076,MATH 103A,A01,083777,Staff,0,16,30,30
1650794308076,MATH 103A,A02,083778,Staff,0,15,30,30
1650794308076,MATH 103A,B01,083779,Staff,0,15,30,30
1650794308076,MATH 103A,B02,083780,Staff,0,15,30,30
1650794314121,MATH 105,A01,085443,Staff,0,22,30,30
1650794320170,MATH 109,A01,083213,Anzaldo; Leesa B,0,7,30,30
1650794320170,MATH 109,A02,083214,Anzaldo; Leesa B,0,7,30,30
1650794320170,MATH 109,B01,083215,Anzaldo; Leesa B,0,8,30,30
1650794320170,MATH 109,B02,083216,Anzaldo; Leesa B,0,7,30,30
1650794326217,MATH 142A,A01,083219,Chow; Bennett,0,16,30,30
1650794326217,MATH 142A,A02,083220,Chow; Bennett,0,15,30,30
1650794326217,MATH 142A,B01,083221,Chow; Bennett,0,16,30,30
1650794326217,MATH 142A,B02,083222,Chow; Bennett,0,14,30,30
1650794332240,MATH 193A,A01,083224,Staff,0,6,30,30
1650794332240,MATH 193A,A02,083225,Staff,0,6,30,30
1650794332240,MATH 193A,A03,083781,Staff,0,6,30,30
1650794332240,MATH 193A,A04,083782,Staff,0,7,30,30
1650794338266,MATH 197,001,091859,McAuley; Julian John,9998,0,9999,1
1650794344331,COGS 9,A01,083615,Staff,0,17,60,60
1650794350368,COGS 11,A01,083617,Boyle; Mary E. T.,16,0,40,24
1650794356396,COGS 13,A01,083071,Staff,0,38,40,40
1650794362423,COGS 14A,A01,092681,Staff,0,36,100,100
1650794368461,COGS 14B,A01,083073,Cheng; Tzu-Han,0,12,50,50
1650794374498,COGS 17,A01,092677,Staff,11,0,75,64
1650794380521,COGS 100,A01,083619,Staff,0,29,60,60
1650794386549,COGS 101A,A01,083621,Davis; Joshua Daniel,0,28,60,60
1650794392574,COGS 101B,A01,091572,Staff,0,3,60,60
1650794398601,COGS 101C,A01,083625,Delgado; Tania,14,0,30,16
1650794404638,COGS 107A,A01,083627,Boyle; Mary E. T.,0,16,60,60
1650794410682,COGS 118A,A01,083075,Staff,0,8,60,60
1650794416709,CSE 3,A50,083646,Miranda; Gregory Joseph,18,0,38,20
1650794416709,CSE 3,A51,083647,Miranda; Gregory Joseph,36,0,37,1
1650794422746,CSE 8A,A50,083650,Miranda; Gregory Joseph,0,29,40,40
1650794428785,CSE 11,A01,083080,Cao; Yingjun,0,96,40,40
1650794434826,CSE 12,A01,083652,Staff,0,21,100,100
1650794440865,CSE 15L,A01,083654,Staff,0,3,50,50
1650794440865,CSE 15L,A02,083655,Staff,0,2,50,50
1650794446890,CSE 20,A01,083657,Staff,49,0,80,31
1650794452927,CSE 30,A01,083084,Eldon; John,0,75,40,40
1650794458954,CSE 100,A01,083659,Cao; Yingjun,0,71,50,50
1650794464983,CSE 134B,A01,083661,Powell; Thomas Allan,0,38,65,65
1650794471018,CSE 140,A01,083663,Staff,0,11,75,75
1650794477059,CSE 140L,A01,083088,Eldon; John,0,20,75,75
1650794483086,CSE 175,A01,083665,Kumar; Rakesh,7,0,25,18
1650794489125,CSE 190,A00,092507,Dubnov; Shlomo,10,0,20,10
1650794495158,ECE 45,A01,083139,Staff,0,1,60,60
1650794501194,ECE 65,A50,083695,Staff,0,5,30,30
1650794507220,ECE 109,A01,091882,Touri; Behrouz,32,0,70,38
1650794513249,ECE 180,A00,083140,Abi Samra; Nicholas Camill,20,0,30,10
1650794513249,ECE 180,B00,083141,Abi Samra; Nicholas Camill,0,0,30,30
1650794519287,MATH 10A,A01,083735,Patchell; Gregory David,2,0,30,28
1650794519287,MATH 10A,A02,083736,Patchell; Gregory David,27,0,30,3
1650794519287,MATH 10A,A03,083737,Patchell; Gregory David,24,0,30,6
1650794525325,MATH 10B,A01,083207,Staff,0,9,30,30
1650794525325,MATH 10B,A02,083208,Staff,0,6,30,30
1650794525325,MATH 10B,B01,083739,Staff,11,0,30,19
1650794525325,MATH 10B,B02,083740,Staff,28,0,30,2
1650794531358,MATH 18,A01,083743,Staff,0,0,30,30
1650794531358,MATH 18,A02,083744,Staff,23,0,30,7
1650794531358,MATH 18,A03,083745,Staff,21,0,30,9
1650794531358,MATH 18,A04,083746,Staff,26,0,30,4
1650794531358,MATH 18,B01,083748,Staff,0,15,30,30
1650794531358,MATH 18,B02,083749,Staff,0,12,30,30
1650794531358,MATH 18,B03,083750,Staff,0,12,30,30
1650794531358,MATH 18,B04,083751,Staff,0,12,30,30
1650794537392,MATH 20A,A01,083754,Staff,19,0,40,21
1650794543419,MATH 20B,A01,083756,Staff,0,13,30,30
1650794543419,MATH 20B,A02,083757,Staff,0,12,30,30
1650794549444,MATH 20C,A01,083760,Staff,0,17,30,30
1650794549444,MATH 20C,A02,083761,Staff,0,16,30,30
1650794549444,MATH 20C,B01,083762,Staff,9,0,30,21
1650794549444,MATH 20C,B02,083763,Staff,28,0,30,2
1650794555493,MATH 20D,A01,083765,Staff,2,1,30,28
1650794555493,MATH 20D,A02,083766,Staff,6,0,30,24
1650794555493,MATH 20D,A03,083767,Staff,24,0,30,6
1650794561530,MATH 20E,A01,083771,Staff,2,0,30,28
1650794561530,MATH 20E,A02,083772,Staff,15,0,30,15
1650794561530,MATH 20E,B01,083773,Staff,0,0,30,30
1650794561530,MATH 20E,B02,083774,Staff,5,0,30,25
1650794567583,MATH 103A,A01,083777,Staff,0,16,30,30
1650794567583,MATH 103A,A02,083778,Staff,0,15,30,30
1650794567583,MATH 103A,B01,083779,Staff,0,15,30,30
1650794567583,MATH 103A,B02,083780,Staff,0,15,30,30
1650794573619,MATH 105,A01,085443,Staff,0,22,30,30
1650794579657,MATH 109,A01,083213,Anzaldo; Leesa B,0,7,30,30
1650794579657,MATH 109,A02,083214,Anzaldo; Leesa B,0,7,30,30
1650794579657,MATH 109,B01,083215,Anzaldo; Leesa B,0,8,30,30
1650794579657,MATH 109,B02,083216,Anzaldo; Leesa B,0,7,30,30
1650794585691,MATH 142A,A01,083219,Chow; Bennett,0,16,30,30
1650794585691,MATH 142A,A02,083220,Chow; Bennett,0,15,30,30
1650794585691,MATH 142A,B01,083221,Chow; Bennett,0,16,30,30
1650794585691,MATH 142A,B02,083222,Chow; Bennett,0,14,30,30
1650794591736,MATH 193A,A01,083224,Staff,0,6,30,30
1650794591736,MATH 193A,A02,083225,Staff,0,6,30,30
1650794591736,MATH 193A,A03,083781,Staff,0,6,30,30
1650794591736,MATH 193A,A04,083782,Staff,0,7,30,30
1650794597762,MATH 197,001,091859,McAuley; Julian John,9998,0,9999,1
1650794603838,COGS 9,A01,083615,Staff,0,17,60,60
1650794609873,COGS 11,A01,083617,Boyle; Mary E. T.,16,0,40,24
1650794615897,COGS 13,A01,083071,Staff,0,38,40,40
1650794621936,COGS 14A,A01,092681,Staff,0,36,100,100
1650794627973,COGS 14B,A01,083073,Cheng; Tzu-Han,0,12,50,50
1650794633999,COGS 17,A01,092677,Staff,11,0,75,64
1650794640022,COGS 100,A01,083619,Staff,0,29,60,60
1650794646069,COGS 101A,A01,083621,Davis; Joshua Daniel,0,28,60,60
1650794652101,COGS 101B,A01,091572,Staff,0,3,60,60
1650794658131,COGS 101C,A01,083625,Delgado; Tania,14,0,30,16
1650794664182,COGS 107A,A01,083627,Boyle; Mary E. T.,0,16,60,60
1650794670221,COGS 118A,A01,083075,Staff,0,8,60,60
1650794676246,CSE 3,A50,083646,Miranda; Gregory Joseph,18,0,38,20
1650794676246,CSE 3,A51,083647,Miranda; Gregory Joseph,36,0,37,1
1650794682270,CSE 8A,A50,083650,Miranda; Gregory Joseph,0,29,40,40
1650794688297,CSE 11,A01,083080,Cao; Yingjun,0,96,40,40
1650794694334,CSE 12,A01,083652,Staff,0,21,100,100
1650794700382,CSE 15L,A01,083654,Staff,0,3,50,50
1650794700382,CSE 15L,A02,083655,Staff,0,2,50,50
1650794706421,CSE 20,A01,083657,Staff,49,0,80,31
1650794712459,CSE 30,A01,083084,Eldon; John,0,75,40,40
1650794718494,CSE 100,A01,083659,Cao; Yingjun,0,71,50,50
1650794724534,CSE 134B,A01,083661,Powell; Thomas Allan,0,38,65,65
1650794730561,CSE 140,A01,083663,Staff,0,11,75,75
1650794736589,CSE 140L,A01,083088,Eldon; John,0,20,75,75
1650794742615,CSE 175,A01,083665,Kumar; Rakesh,7,0,25,18
1650794748643,CSE 190,A00,092507,Dubnov; Shlomo,10,0,20,10
1650794754694,ECE 45,A01,083139,Staff,0,1,60,60
1650794760726,ECE 65,A50,083695,Staff,0,5,30,30
1650794766757,ECE 109,A01,091882,Touri; Behrouz,32,0,70,38
1650794772785,ECE 180,A00,083140,Abi Samra; Nicholas Camill,20,0,30,10
1650794772785,ECE 180,B00,083141,Abi Samra; Nicholas Camill,0,0,30,30
1650794778810,MATH 10A,A01,083735,Patchell; Gregory David,2,0,30,28
1650794778810,MATH 10A,A02,083736,Patchell; Gregory David,27,0,30,3
1650794778810,MATH 10A,A03,083737,Patchell; Gregory David,24,0,30,6
1650794784918,MATH 10B,A01,083207,Staff,0,9,30,30
1650794784918,MATH 10B,A02,083208,Staff,0,6,30,30
1650794784918,MATH 10B,B01,083739,Staff,11,0,30,19
1650794784918,MATH 10B,B02,083740,Staff,28,0,30,2
1650794790965,MATH 18,A01,083743,Staff,0,0,30,30
1650794790965,MATH 18,A02,083744,Staff,23,0,30,7
1650794790965,MATH 18,A03,083745,Staff,21,0,30,9
1650794790965,MATH 18,A04,083746,Staff,26,0,30,4
1650794790965,MATH 18,B01,083748,Staff,0,15,30,30
1650794790965,MATH 18,B02,083749,Staff,0,12,30,30
1650794790965,MATH 18,B03,083750,Staff,0,12,30,30
1650794790965,MATH 18,B04,083751,Staff,0,12,30,30
1650794797012,MATH 20A,A01,083754,Staff,19,0,40,21
1650794803049,MATH 20B,A01,083756,Staff,0,13,30,30
1650794803049,MATH 20B,A02,083757,Staff,0,12,30,30
1650794809082,MATH 20C,A01,083760,Staff,0,17,30,30
1650794809082,MATH 20C,A02,083761,Staff,0,16,30,30
1650794809082,MATH 20C,B01,083762,Staff,9,0,30,21
1650794809082,MATH 20C,B02,083763,Staff,28,0,30,2
1650794815108,MATH 20D,A01,083765,Staff,2,1,30,28
1650794815108,MATH 20D,A02,083766,Staff,6,0,30,24
1650794815108,MATH 20D,A03,083767,Staff,24,0,30,6
1650794821142,MATH 20E,A01,083771,Staff,2,0,30,28
1650794821142,MATH 20E,A02,083772,Staff,15,0,30,15
1650794821142,MATH 20E,B01,083773,Staff,0,0,30,30
1650794821142,MATH 20E,B02,083774,Staff,5,0,30,25
1650794827183,MATH 103A,A01,083777,Staff,0,16,30,30
1650794827183,MATH 103A,A02,083778,Staff,0,15,30,30
1650794827183,MATH 103A,B01,083779,Staff,0,15,30,30
1650794827183,MATH 103A,B02,083780,Staff,0,15,30,30
1650794833213,MATH 105,A01,085443,Staff,0,22,30,30
1650794839269,MATH 109,A01,083213,Anzaldo; Leesa B,0,7,30,30
1650794839269,MATH 109,A02,083214,Anzaldo; Leesa B,0,7,30,30
1650794839269,MATH 109,B01,083215,Anzaldo; Leesa B,0,8,30,30
1650794839269,MATH 109,B02,083216,Anzaldo; Leesa B,0,7,30,30
1650794845306,MATH 142A,A01,083219,Chow; Bennett,0,16,30,30
1650794845306,MATH 142A,A02,083220,Chow; Bennett,0,15,30,30
1650794845306,MATH 142A,B01,083221,Chow; Bennett,0,16,30,30
1650794845306,MATH 142A,B02,083222,Chow; Bennett,0,14,30,30
1650794851354,MATH 193A,A01,083224,Staff,0,6,30,30
1650794851354,MATH 193A,A02,083225,Staff,0,6,30,30
1650794851354,MATH 193A,A03,083781,Staff,0,6,30,30
1650794851354,MATH 193A,A04,083782,Staff,0,7,30,30
1650794857395,MATH 197,001,091859,McAuley; Julian John,9998,0,9999,1
1650794863510,COGS 9,A01,083615,Staff,0,17,60,60
1650794869541,COGS 11,A01,083617,Boyle; Mary E. T.,16,0,40,24
1650794875571,COGS 13,A01,083071,Staff,0,38,40,40
1650794881599,COGS 14A,A01,092681,Staff,0,36,100,100
1650794887646,COGS 14B,A01,083073,Cheng; Tzu-Han,0,12,50,50
1650794893669,COGS 17,A01,092677,Staff,11,0,75,64
1650794899705,COGS 100,A01,083619,Staff,0,29,60,60
1650794905744,COGS 101A,A01,083621,Davis; Joshua Daniel,0,28,60,60
1650794911806,COGS 101B,A01,091572,Staff,0,3,60,60
1650794917844,COGS 101C,A01,083625,Delgado; Tania,14,0,30,16
1650794923879,COGS 107A,A01,083627,Boyle; Mary E. T.,0,16,60,60
1650794929926,COGS 118A,A01,083075,Staff,0,8,60,60
1650794935956,CSE 3,A50,083646,Miranda; Gregory Joseph,18,0,38,20
1650794935956,CSE 3,A51,083647,Miranda; Gregory Joseph,36,0,37,1
1650794941990,CSE 8A,A50,083650,Miranda; Gregory Joseph,0,29,40,40
1650794948031,CSE 11,A01,083080,Cao; Yingjun,0,96,40,40
1650794954059,CSE 12,A01,083652,Staff,0,21,100,100
1650794960106,CSE 15L,A01,083654,Staff,0,3,50,50
1650794960106,CSE 15L,A02,083655,Staff,0,2,50,50
1650794966129,CSE 20,A01,083657,Staff,49,0,80,31
1650794972154,CSE 30,A01,083084,Eldon; John,0,75,40,40
1650794978193,CSE 100,A01,083659,Cao; Yingjun,0,71,50,50
1650794984216,CSE 134B,A01,083661,Powell; Thomas Allan,0,38,65,65
1650794990241,CSE 140,A01,083663,Staff,0,11,75,75
1650794996268,CSE 140L,A01,083088,Eldon; John,0,20,75,75
1650795002317,CSE 175,A01,083665,Kumar; Rakesh,7,0,25,18
1650795008371,CSE 190,A00,092507,Dubnov; Shlomo,10,0,20,10
1650795014415,ECE 45,A01,083139,Staff,0,1,60,60
1650795020471,ECE 65,A50,083695,Staff,0,5,30,30
1650795026505,ECE 109,A01,091882,Touri; Behrouz,32,0,70,38
1650795032548,ECE 180,A00,083140,Abi Samra; Nicholas Camill,20,0,30,10
1650795032548,ECE 180,B00,083141,Abi Samra; Nicholas Camill,0,0,30,30
1650795038586,MATH 10A,A01,083735,Patchell; Gregory David,2,0,30,28
1650795038586,MATH 10A,A02,083736,Patchell; Gregory David,27,0,30,3
1650795038586,MATH 10A,A03,083737,Patchell; Gregory David,24,0,30,6
1650795044626,MATH 10B,A01,083207,Staff,0,9,30,30
1650795044626,MATH 10B,A02,083208,Staff,0,6,30,30
1650795044626,MATH 10B,B01,083739,Staff,11,0,30,19
1650795044626,MATH 10B,B02,083740,Staff,28,0,30,2
1650795050673,MATH 18,A01,083743,Staff,0,0,30,30
1650795050673,MATH 18,A02,083744,Staff,23,0,30,7
1650795050673,MATH 18,A03,083745,Staff,21,0,30,9
1650795050673,MATH 18,A04,083746,Staff,26,0,30,4
1650795050673,MATH 18,B01,083748,Staff,0,15,30,30
1650795050673,MATH 18,B02,083749,Staff,0,12,30,30
1650795050673,MATH 18,B03,083750,Staff,0,12,30,30
1650795050673,MATH 18,B04,083751,Staff,0,12,30,30
1650795056700,MATH 20A,A01,083754,Staff,19,0,40,21
1650795062726,MATH 20B,A01,083756,Staff,0,13,30,30
1650795062726,MATH 20B,A02,083757,Staff,0,12,30,30
1650795068750,MATH 20C,A01,083760,Staff,0,17,30,30
1650795068750,MATH 20C,A02,083761,Staff,0,16,30,30
1650795068750,MATH 20C,B01,083762,Staff,9,0,30,21
1650795068750,MATH 20C,B02,083763,Staff,28,0,30,2
1650795074775,MATH 20D,A01,083765,Staff,2,1,30,28
1650795074775,MATH 20D,A02,083766,Staff,6,0,30,24
1650795074775,MATH 20D,A03,083767,Staff,24,0,30,6
1650795080807,MATH 20E,A01,083771,Staff,2,0,30,28
1650795080807,MATH 20E,A02,083772,Staff,15,0,30,15
1650795080807,MATH 20E,B01,083773,Staff,0,0,30,30
1650795080807,MATH 20E,B02,083774,Staff,5,0,30,25
1650795086832,MATH 103A,A01,083777,Staff,0,16,30,30
1650795086832,MATH 103A,A02,083778,Staff,0,15,30,30
1650795086832,MATH 103A,B01,083779,Staff,0,15,30,30
1650795086832,MATH 103A,B02,083780,Staff,0,15,30,30
1650795092870,MATH 105,A01,085443,Staff,0,22,30,30
1650795098896,MATH 109,A01,083213,Anzaldo; Leesa B,0,7,30,30
1650795098896,MATH 109,A02,083214,Anzaldo; Leesa B,0,7,30,30
1650795098896,MATH 109,B01,083215,Anzaldo; Leesa B,0,8,30,30
1650795098896,MATH 109,B02,083216,Anzaldo; Leesa B,0,7,30,30
1650795104922,MATH 142A,A01,083219,Chow; Bennett,0,16,30,30
1650795104922,MATH 142A,A02,083220,Chow; Bennett,0,15,30,30
1650795104922,MATH 142A,B01,083221,Chow; Bennett,0,16,30,30
1650795104922,MATH 142A,B02,083222,Chow; Bennett,0,14,30,30
1650795110945,MATH 193A,A01,083224,Staff,0,6,30,30
1650795110945,MATH 193A,A02,083225,Staff,0,6,30,30
1650795110945,MATH 193A,A03,083781,Staff,0,6,30,30
1650795110945,MATH 193A,A04,083782,Staff,0,7,30,30
1650795116969,MATH 197,001,091859,McAuley; Julian John,9998,0,9999,1
1650795123036,COGS 9,A01,083615,Staff,0,17,60,60
1650795129066,COGS 11,A01,083617,Boyle; Mary E. T.,16,0,40,24
1650795135090,COGS 13,A01,083071,Staff,0,38,40,40
1650795141125,COGS 14A,A01,092681,Staff,0,36,100,100
1650795147158,COGS 14B,A01,083073,Cheng; Tzu-Han,0,12,50,50
1650795153207,COGS 17,A01,092677,Staff,11,0,75,64
1650795159237,COGS 100,A01,083619,Staff,0,29,60,60
1650795165284,COGS 101A,A01,083621,Davis; Joshua Daniel,0,28,60,60
1650795171313,COGS 101B,A01,091572,Staff,0,3,60,60
1650795177341,COGS 101C,A01,083625,Delgado; Tania,14,0,30,16
1650795183365,COGS 107A,A01,083627,Boyle; Mary E. T.,0,16,60,60
1650795189397,COGS 118A,A01,083075,Staff,0,8,60,60
1650795195439,CSE 3,A50,083646,Miranda; Gregory Joseph,18,0,38,20
1650795195439,CSE 3,A51,083647,Miranda; Gregory Joseph,36,0,37,1
1650795201466,CSE 8A,A50,083650,Miranda; Gregory Joseph,0,29,40,40
1650795207496,CSE 11,A01,083080,Cao; Yingjun,0,96,40,40
1650795213532,CSE 12,A01,083652,Staff,0,21,100,100
1650795219568,CSE 15L,A01,083654,Staff,0,3,50,50
1650795219568,CSE 15L,A02,083655,Staff,0,2,50,50
1650795225595,CSE 20,A01,083657,Staff,49,0,80,31
1650795231631,CSE 30,A01,083084,Eldon; John,0,75,40,40
1650795237656,CSE 100,A01,083659,Cao; Yingjun,0,71,50,50
1650795243680,CSE 134B,A01,083661,Powell; Thomas Allan,0,38,65,65
1650795249707,CSE 140,A01,083663,Staff,0,11,75,75
1650795255732,CSE 140L,A01,083088,Eldon; John,0,20,75,75
1650795261762,CSE 175,A01,083665,Kumar; Rakesh,7,0,25,18
1650795267785,CSE 190,A00,092507,Dubnov; Shlomo,10,0,20,10
1650795273811,ECE 45,A01,083139,Staff,0,1,60,60
1650795279839,ECE 65,A50,083695,Staff,0,5,30,30
1650795285870,ECE 109,A01,091882,Touri; Behrouz,32,0,70,38
1650795291899,ECE 180,A00,083140,Abi Samra; Nicholas Camill,20,0,30,10
1650795291899,ECE 180,B00,083141,Abi Samra; Nicholas Camill,0,0,30,30
1650795297931,MATH 10A,A01,083735,Patchell; Gregory David,2,0,30,28
1650795297931,MATH 10A,A02,083736,Patchell; Gregory David,27,0,30,3
1650795297931,MATH 10A,A03,083737,Patchell; Gregory David,24,0,30,6
1650795303958,MATH 10B,A01,083207,Staff,0,9,30,30
1650795303958,MATH 10B,A02,083208,Staff,0,6,30,30
1650795303958,MATH 10B,B01,083739,Staff,11,0,30,19
1650795303958,MATH 10B,B02,083740,Staff,28,0,30,2
1650795310003,MATH 18,A01,083743,Staff,0,0,30,30
1650795310003,MATH 18,A02,083744,Staff,23,0,30,7
1650795310003,MATH 18,A03,083745,Staff,21,0,30,9
1650795310003,MATH 18,A04,083746,Staff,26,0,30,4
1650795310003,MATH 18,B01,083748,Staff,0,15,30,30
1650795310003,MATH 18,B02,083749,Staff,0,12,30,30
1650795310003,MATH 18,B03,083750,Staff,0,12,30,30
1650795310003,MATH 18,B04,083751,Staff,0,12,30,30
1650795316032,MATH 20A,A01,083754,Staff,19,0,40,21
1650795322063,MATH 20B,A01,083756,Staff,0,13,30,30
1650795322063,MATH 20B,A02,083757,Staff,0,12,30,30
1650795328087,MATH 20C,A01,083760,Staff,0,17,30,30
1650795328087,MATH 20C,A02,083761,Staff,0,16,30,30
1650795328087,MATH 20C,B01,083762,Staff,9,0,30,21
1650795328087,MATH 20C,B02,083763,Staff,28,0,30,2
1650795334133,MATH 20D,A01,083765,Staff,2,1,30,28
1650795334133,MATH 20D,A02,083766,Staff,6,0,30,24
1650795334133,MATH 20D,A03,083767,Staff,24,0,30,6
1650795340168,MATH 20E,A01,083771,Staff,2,0,30,28
1650795340168,MATH 20E,A02,083772,Staff,15,0,30,15
1650795340168,MATH 20E,B01,083773,Staff,0,0,30,30
1650795340168,MATH 20E,B02,083774,Staff,5,0,30,25
1650795346194,MATH 103A,A01,083777,Staff,0,16,30,30
1650795346194,MATH 103A,A02,083778,Staff,0,15,30,30
1650795346194,MATH 103A,B01,083779,Staff,0,15,30,30
1650795346194,MATH 103A,B02,083780,Staff,0,15,30,30
1650795352233,MATH 105,A01,085443,Staff,0,22,30,30
1650795358291,MATH 109,A01,083213,Anzaldo; Leesa B,0,7,30,30
1650795358291,MATH 109,A02,083214,Anzaldo; Leesa B,0,7,30,30
1650795358291,MATH 109,B01,083215,Anzaldo; Leesa B,0,8,30,30
1650795358291,MATH 109,B02,083216,Anzaldo; Leesa B,0,7,30,30
1650795364323,MATH 142A,A01,083219,Chow; Bennett,0,16,30,30
1650795364323,MATH 142A,A02,083220,Chow; Bennett,0,15,30,30
1650795364323,MATH 142A,B01,083221,Chow; Bennett,0,16,30,30
1650795364323,MATH 142A,B02,083222,Chow; Bennett,0,14,30,30
1650795370374,MATH 193A,A01,083224,Staff,0,6,30,30
1650795370374,MATH 193A,A02,083225,Staff,0,6,30,30
1650795370374,MATH 193A,A03,083781,Staff,0,6,30,30
1650795370374,MATH 193A,A04,083782,Staff,0,7,30,30
1650795376421,MATH 197,001,091859,McAuley; Julian John,9998,0,9999,1
1650795382579,COGS 9,A01,083615,Staff,0,17,60,60
1650795388614,COGS 11,A01,083617,Boyle; Mary E. T.,16,0,40,24
1650795394640,COGS 13,A01,083071,Staff,0,38,40,40
1650795400664,COGS 14A,A01,092681,Staff,0,36,100,100
1650795406708,COGS 14B,A01,083073,Cheng; Tzu-Han,0,12,50,50
1650795412738,COGS 17,A01,092677,Staff,11,0,75,64
1650795418762,COGS 100,A01,083619,Staff,0,29,60,60
1650795424802,COGS 101A,A01,083621,Davis; Joshua Daniel,0,28,60,60
1650795430839,COGS 101B,A01,091572,Staff,0,3,60,60
1650795436866,COGS 101C,A01,083625,Delgado; Tania,14,0,30,16
1650795442915,COGS 107A,A01,083627,Boyle; Mary E. T.,0,16,60,60
1650795448952,COGS 118A,A01,083075,Staff,0,8,60,60
1650795454995,CSE 3,A50,083646,Miranda; Gregory Joseph,18,0,38,20
1650795454995,CSE 3,A51,083647,Miranda; Gregory Joseph,36,0,37,1
1650795461031,CSE 8A,A50,083650,Miranda; Gregory Joseph,0,29,40,40
1650795467060,CSE 11,A01,083080,Cao; Yingjun,0,96,40,40
1650795473085,CSE 12,A01,083652,Staff,0,21,100,100
1650795479115,CSE 15L,A01,083654,Staff,0,3,50,50
1650795479115,CSE 15L,A02,083655,Staff,0,2,50,50
1650795485149,CSE 20,A01,083657,Staff,49,0,80,31
1650795491198,CSE 30,A01,083084,Eldon; John,0,75,40,40
1650795497233,CSE 100,A01,083659,Cao; Yingjun,0,71,50,50
1650795503259,CSE 134B,A01,083661,Powell; Thomas Allan,0,38,65,65
1650795509291,CSE 140,A01,083663,Staff,0,11,75,75
1650795515337,CSE 140L,A01,083088,Eldon; John,0,20,75,75
1650795521362,CSE 175,A01,083665,Kumar; Rakesh,7,0,25,18
1650795527414,CSE 190,A00,092507,Dubnov; Shlomo,10,0,20,10
1650795533439,ECE 45,A01,083139,Staff,0,1,60,60
1650795539476,ECE 65,A50,083695,Staff,0,5,30,30
1650795545502,ECE 109,A01,091882,Touri; Behrouz,32,0,70,38
1650795551531,ECE 180,A00,083140,Abi Samra; Nicholas Camill,20,0,30,10
1650795551531,ECE 180,B00,083141,Abi Samra; Nicholas Camill,0,0,30,30
1650795557562,MATH 10A,A01,083735,Patchell; Gregory David,2,0,30,28
1650795557562,MATH 10A,A02,083736,Patchell; Gregory David,27,0,30,3
1650795557562,MATH 10A,A03,083737,Patchell; Gregory David,24,0,30,6
1650795563587,MATH 10B,A01,083207,Staff,0,9,30,30
1650795563587,MATH 10B,A02,083208,Staff,0,6,30,30
1650795563587,MATH 10B,B01,083739,Staff,11,0,30,19
1650795563587,MATH 10B,B02,083740,Staff,28,0,30,2
1650795569626,MATH 18,A01,083743,Staff,0,0,30,30
1650795569626,MATH 18,A02,083744,Staff,23,0,30,7
1650795569626,MATH 18,A03,083745,Staff,21,0,30,9
1650795569626,MATH 18,A04,083746,Staff,26,0,30,4
1650795569626,MATH 18,B01,083748,Staff,0,15,30,30
1650795569626,MATH 18,B02,083749,Staff,0,12,30,30
1650795569626,MATH 18,B03,083750,Staff,0,12,30,30
1650795569626,MATH 18,B04,083751,Staff,0,12,30,30
1650795575671,MATH 20A,A01,083754,Staff,19,0,40,21
1650795581699,MATH 20B,A01,083756,Staff,0,13,30,30
1650795581699,MATH 20B,A02,083757,Staff,0,12,30,30
1650795587744,MATH 20C,A01,083760,Staff,0,17,30,30
1650795587744,MATH 20C,A02,083761,Staff,0,16,30,30
1650795587744,MATH 20C,B01,083762,Staff,9,0,30,21
1650795587744,MATH 20C,B02,083763,Staff,28,0,30,2
1650795593787,MATH 20D,A01,083765,Staff,2,1,30,28
1650795593787,MATH 20D,A02,083766,Staff,6,0,30,24
1650795593787,MATH 20D,A03,083767,Staff,24,0,30,6
1650795599822,MATH 20E,A01,083771,Staff,2,0,30,28
1650795599822,MATH 20E,A02,083772,Staff,15,0,30,15
1650795599822,MATH 20E,B01,083773,Staff,0,0,30,30
1650795599822,MATH 20E,B02,083774,Staff,5,0,30,25
1650795605870,MATH 103A,A01,083777,Staff,0,16,30,30
1650795605870,MATH 103A,A02,083778,Staff,0,15,30,30
1650795605870,MATH 103A,B01,083779,Staff,0,15,30,30
1650795605870,MATH 103A,B02,083780,Staff,0,15,30,30
1650795611899,MATH 105,A01,085443,Staff,0,22,30,30
1650795617936,MATH 109,A01,083213,Anzaldo; Leesa B,0,7,30,30
1650795617936,MATH 109,A02,083214,Anzaldo; Leesa B,0,7,30,30
1650795617936,MATH 109,B01,083215,Anzaldo; Leesa B,0,8,30,30
1650795617936,MATH 109,B02,083216,Anzaldo; Leesa B,0,7,30,30
1650795623971,MATH 142A,A01,083219,Chow; Bennett,0,16,30,30
1650795623971,MATH 142A,A02,083220,Chow; Bennett,0,15,30,30
1650795623971,MATH 142A,B01,083221,Chow; Bennett,0,16,30,30
1650795623971,MATH 142A,B02,083222,Chow; Bennett,0,14,30,30
1650795630002,MATH 193A,A01,083224,Staff,0,6,30,30
1650795630002,MATH 193A,A02,083225,Staff,0,6,30,30
1650795630002,MATH 193A,A03,083781,Staff,0,6,30,30
1650795630002,MATH 193A,A04,083782,Staff,0,7,30,30
1650795636025,MATH 197,001,091859,McAuley; Julian John,9998,0,9999,1
1650795642083,COGS 9,A01,083615,Staff,0,17,60,60
1650795648131,COGS 11,A01,083617,Boyle; Mary E. T.,16,0,40,24
1650795654179,COGS 13,A01,083071,Staff,0,38,40,40
1650795660220,COGS 14A,A01,092681,Staff,0,36,100,100
1650795666248,COGS 14B,A01,083073,Cheng; Tzu-Han,0,12,50,50
1650795672275,COGS 17,A01,092677,Staff,11,0,75,64
1650795678301,COGS 100,A01,083619,Staff,0,29,60,60
1650795684325,COGS 101A,A01,083621,Davis; Joshua Daniel,0,28,60,60
1650795690373,COGS 101B,A01,091572,Staff,0,3,60,60
1650795696404,COGS 101C,A01,083625,Delgado; Tania,14,0,30,16
1650795702428,COGS 107A,A01,083627,Boyle; Mary E. T.,0,16,60,60
1650795708451,COGS 118A,A01,083075,Staff,0,8,60,60
1650795714477,CSE 3,A50,083646,Miranda; Gregory Joseph,18,0,38,20
1650795714477,CSE 3,A51,083647,Miranda; Gregory Joseph,36,0,37,1
1650795720502,CSE 8A,A50,083650,Miranda; Gregory Joseph,0,29,40,40
1650795726531,CSE 11,A01,083080,Cao; Yingjun,0,96,40,40
1650795732555,CSE 12,A01,083652,Staff,0,21,100,100
1650795738578,CSE 15L,A01,083654,Staff,0,3,50,50
1650795738578,CSE 15L,A02,083655,Staff,0,2,50,50
1650795744601,CSE 20,A01,083657,Staff,49,0,80,31
1650795750629,CSE 30,A01,083084,Eldon; John,0,75,40,40
1650795756652,CSE 100,A01,083659,Cao; Yingjun,0,71,50,50
1650795762700,CSE 134B,A01,083661,Powell; Thomas Allan,0,38,65,65
1650795768733,CSE 140,A01,083663,Staff,0,11,75,75
1650795774761,CSE 140L,A01,083088,Eldon; John,0,20,75,75
1650795780795,CSE 175,A01,083665,Kumar; Rakesh,7,0,25,18
1650795786826,CSE 190,A00,092507,Dubnov; Shlomo,10,0,20,10
1650795792857,ECE 45,A01,083139,Staff,0,1,60,60
1650795798892,ECE 65,A50,083695,Staff,0,5,30,30
1650795804922,ECE 109,A01,091882,Touri; Behrouz,32,0,70,38
1650795810946,ECE 180,A00,083140,Abi Samra; Nicholas Camill,20,0,30,10
1650795810946,ECE 180,B00,083141,Abi Samra; Nicholas Camill,0,0,30,30
1650795816978,MATH 10A,A01,083735,Patchell; Gregory David,2,0,30,28
1650795816978,MATH 10A,A02,083736,Patchell; Gregory David,27,0,30,3
1650795816978,MATH 10A,A03,083737,Patchell; Gregory David,24,0,30,6
1650795823005,MATH 10B,A01,083207,Staff,0,9,30,30
1650795823005,MATH 10B,A02,083208,Staff,0,6,30,30
1650795823005,MATH 10B,B01,083739,Staff,11,0,30,19
1650795823005,MATH 10B,B02,083740,Staff,28,0,30,2
1650795829037,MATH 18,A01,083743,Staff,0,0,30,30
1650795829037,MATH 18,A02,083744,Staff,23,0,30,7
1650795829037,MATH 18,A03,083745,Staff,21,0,30,9
1650795829037,MATH 18,A04,083746,Staff,26,0,30,4
1650795829037,MATH 18,B01,083748,Staff,0,15,30,30
1650795829037,MATH 18,B02,083749,Staff,0,12,30,30
1650795829037,MATH 18,B03,083750,Staff,0,12,30,30
1650795829037,MATH 18,B04,083751,Staff,0,12,30,30
1650795835064,MATH 20A,A01,083754,Staff,19,0,40,21
1650795841094,MATH 20B,A01,083756,Staff,0,13,30,30
1650795841094,MATH 20B,A02,083757,Staff,0,12,30,30
1650795847120,MATH 20C,A01,083760,Staff,0,17,30,30
1650795847120,MATH 20C,A02,083761,Staff,0,16,30,30
1650795847120,MATH 20C,B01,083762,Staff,9,0,30,21
1650795847120,MATH 20C,B02,083763,Staff,28,0,30,2
1650795853151,MATH 20D,A01,083765,Staff,2,1,30,28
1650795853151,MATH 20D,A02,083766,Staff,6,0,30,24
1650795853151,MATH 20D,A03,083767,Staff,24,0,30,6
1650795859177,MATH 20E,A01,083771,Staff,2,0,30,28
1650795859177,MATH 20E,A02,083772,Staff,15,0,30,15
1650795859177,MATH 20E,B01,083773,Staff,0,0,30,30
1650795859177,MATH 20E,B02,083774,Staff,5,0,30,25
1650795865206,MATH 103A,A01,083777,Staff,0,16,30,30
1650795865206,MATH 103A,A02,083778,Staff,0,15,30,30
1650795865206,MATH 103A,B01,083779,Staff,0,15,30,30
1650795865206,MATH 103A,B02,083780,Staff,0,15,30,30
1650795871238,MATH 105,A01,085443,Staff,0,22,30,30
1650795877262,MATH 109,A01,083213,Anzaldo; Leesa B,0,7,30,30
1650795877262,MATH 109,A02,083214,Anzaldo; Leesa B,0,7,30,30
1650795877262,MATH 109,B01,083215,Anzaldo; Leesa B,0,8,30,30
1650795877262,MATH 109,B02,083216,Anzaldo; Leesa B,0,7,30,30
1650795883289,MATH 142A,A01,083219,Chow; Bennett,0,16,30,30
1650795883289,MATH 142A,A02,083220,Chow; Bennett,0,15,30,30
1650795883289,MATH 142A,B01,083221,Chow; Bennett,0,16,30,30
1650795883289,MATH 142A,B02,083222,Chow; Bennett,0,14,30,30
1650795889315,MATH 193A,A01,083224,Staff,0,6,30,30
1650795889315,MATH 193A,A02,083225,Staff,0,6,30,30
1650795889315,MATH 193A,A03,083781,Staff,0,6,30,30
1650795889315,MATH 193A,A04,083782,Staff,0,7,30,30
1650795895343,MATH 197,001,091859,McAuley; Julian John,9998,0,9999,1
1650795901420,COGS 9,A01,083615,Staff,0,17,60,60
1650795907445,COGS 11,A01,083617,Boyle; Mary E. T.,16,0,40,24
1650795913492,COGS 13,A01,083071,Staff,0,38,40,40
1650795919516,COGS 14A,A01,092681,Staff,0,36,100,100
1650795925540,COGS 14B,A01,083073,Cheng; Tzu-Han,0,12,50,50
1650795931567,COGS 17,A01,092677,Staff,11,0,75,64
1650795937611,COGS 100,A01,083619,Staff,0,29,60,60
1650795943647,COGS 101A,A01,083621,Davis; Joshua Daniel,0,28,60,60
1650795949679,COGS 101B,A01,091572,Staff,0,3,60,60
1650795955705,COGS 101C,A01,083625,Delgado; Tania,14,0,30,16
1650795961730,COGS 107A,A01,083627,Boyle; Mary E. T.,0,16,60,60
1650795967754,COGS 118A,A01,083075,Staff,0,8,60,60
1650795973852,CSE 3,A50,083646,Miranda; Gregory Joseph,18,0,38,20
1650795973852,CSE 3,A51,083647,Miranda; Gregory Joseph,36,0,37,1
1650795979888,CSE 8A,A50,083650,Miranda; Gregory Joseph,0,29,40,40
1650795985921,CSE 11,A01,083080,Cao; Yingjun,0,96,40,40
1650795991946,CSE 12,A01,083652,Staff,0,21,100,100
1650795997982,CSE 15L,A01,083654,Staff,0,3,50,50
1650795997982,CSE 15L,A02,083655,Staff,0,2,50,50
1650796004014,CSE 20,A01,083657,Staff,49,0,80,31
1650796010067,CSE 30,A01,083084,Eldon; John,0,75,40,40
1650796016092,CSE 100,A01,083659,Cao; Yingjun,0,71,50,50
1650796022131,CSE 134B,A01,083661,Powell; Thomas Allan,0,38,65,65
1650796028155,CSE 140,A01,083663,Staff,0,11,75,75
1650796034190,CSE 140L,A01,083088,Eldon; John,0,20,75,75
1650796040217,CSE 175,A01,083665,Kumar; Rakesh,7,0,25,18
1650796046243,CSE 190,A00,092507,Dubnov; Shlomo,10,0,20,10
1650796052297,ECE 45,A01,083139,Staff,0,1,60,60
1650796058325,ECE 65,A50,083695,Staff,0,5,30,30
1650796064347,ECE 109,A01,091882,Touri; Behrouz,32,0,70,38
1650796070369,ECE 180,A00,083140,Abi Samra; Nicholas Camill,20,0,30,10
1650796070369,ECE 180,B00,083141,Abi Samra; Nicholas Camill,0,0,30,30
1650796076402,MATH 10A,A01,083735,Patchell; Gregory David,2,0,30,28
1650796076402,MATH 10A,A02,083736,Patchell; Gregory David,27,0,30,3
1650796076402,MATH 10A,A03,083737,Patchell; Gregory David,24,0,30,6
1650796082430,MATH 10B,A01,083207,Staff,0,9,30,30
1650796082430,MATH 10B,A02,083208,Staff,0,6,30,30
1650796082430,MATH 10B,B01,083739,Staff,11,0,30,19
1650796082430,MATH 10B,B02,083740,Staff,28,0,30,2
1650796088460,MATH 18,A01,083743,Staff,0,0,30,30
1650796088460,MATH 18,A02,083744,Staff,23,0,30,7
1650796088460,MATH 18,A03,083745,Staff,21,0,30,9
1650796088460,MATH 18,A04,083746,Staff,26,0,30,4
1650796088460,MATH 18,B01,083748,Staff,0,15,30,30
1650796088460,MATH 18,B02,083749,Staff,0,12,30,30
1650796088460,MATH 18,B03,083750,Staff,0,12,30,30
1650796088460,MATH 18,B04,083751,Staff,0,12,30,30
1650796094492,MATH 20A,A01,083754,Staff,19,0,40,21
1650796100516,MATH 20B,A01,083756,Staff,0,13,30,30
1650796100516,MATH 20B,A02,083757,Staff,0,12,30,30
1650796106540,MATH 20C,A01,083760,Staff,0,17,30,30
1650796106540,MATH 20C,A02,083761,Staff,0,16,30,30
1650796106540,MATH 20C,B01,083762,Staff,9,0,30,21
1650796106540,MATH 20C,B02,083763,Staff,28,0,30,2
1650796112568,MATH 20D,A01,083765,Staff,2,1,30,28
1650796112568,MATH 20D,A02,083766,Staff,6,0,30,24
1650796112568,MATH 20D,A03,083767,Staff,24,0,30,6
1650796118593,MATH 20E,A01,083771,Staff,2,0,30,28
1650796118593,MATH 20E,A02,083772,Staff,15,0,30,15
1650796118593,MATH 20E,B01,083773,Staff,0,0,30,30
1650796118593,MATH 20E,B02,083774,Staff,5,0,30,25
1650796124639,MATH 103A,A01,083777,Staff,0,16,30,30
1650796124639,MATH 103A,A02,083778,Staff,0,15,30,30
1650796124639,MATH 103A,B01,083779,Staff,0,15,30,30
1650796124639,MATH 103A,B02,083780,Staff,0,15,30,30
1650796130686,MATH 105,A01,085443,Staff,0,22,30,30
1650796136711,MATH 109,A01,083213,Anzaldo; Leesa B,0,7,30,30
1650796136711,MATH 109,A02,083214,Anzaldo; Leesa B,0,7,30,30
1650796136711,MATH 109,B01,083215,Anzaldo; Leesa B,0,8,30,30
1650796136711,MATH 109,B02,083216,Anzaldo; Leesa B,0,7,30,30
1650796142736,MATH 142A,A01,083219,Chow; Bennett,0,16,30,30
1650796142736,MATH 142A,A02,083220,Chow; Bennett,0,15,30,30
1650796142736,MATH 142A,B01,083221,Chow; Bennett,0,16,30,30
1650796142736,MATH 142A,B02,083222,Chow; Bennett,0,14,30,30
1650796148777,MATH 193A,A01,083224,Staff,0,6,30,30
1650796148777,MATH 193A,A02,083225,Staff,0,6,30,30
1650796148777,MATH 193A,A03,083781,Staff,0,6,30,30
1650796148777,MATH 193A,A04,083782,Staff,0,7,30,30
1650796154810,MATH 197,001,091859,McAuley; Julian John,9998,0,9999,1
1650796160881,COGS 9,A01,083615,Staff,0,17,60,60
1650796166929,COGS 11,A01,083617,Boyle; Mary E. T.,16,0,40,24
1650796172964,COGS 13,A01,083071,Staff,0,38,40,40
1650796178989,COGS 14A,A01,092681,Staff,0,36,100,100
1650796185017,COGS 14B,A01,083073,Cheng; Tzu-Han,0,12,50,50
1650796191043,COGS 17,A01,092677,Staff,11,0,75,64
1650796197074,COGS 100,A01,083619,Staff,0,29,60,60
1650796203109,COGS 101A,A01,083621,Davis; Joshua Daniel,0,28,60,60
1650796209151,COGS 101B,A01,091572,Staff,0,3,60,60
1650796215179,COGS 101C,A01,083625,Delgado; Tania,14,0,30,16
1650796221207,COGS 107A,A01,083627,Boyle; Mary E. T.,0,16,60,60
1650796227241,COGS 118A,A01,083075,Staff,0,8,60,60
1650796233270,CSE 3,A50,083646,Miranda; Gregory Joseph,18,0,38,20
1650796233270,CSE 3,A51,083647,Miranda; Gregory Joseph,36,0,37,1
1650796239294,CSE 8A,A50,083650,Miranda; Gregory Joseph,0,29,40,40
1650796245319,CSE 11,A01,083080,Cao; Yingjun,0,96,40,40
1650796251346,CSE 12,A01,083652,Staff,0,21,100,100
1650796257379,CSE 15L,A01,083654,Staff,0,3,50,50
1650796257379,CSE 15L,A02,083655,Staff,0,2,50,50
1650796263415,CSE 20,A01,083657,Staff,49,0,80,31
1650796269459,CSE 30,A01,083084,Eldon; John,0,75,40,40
1650796275499,CSE 100,A01,083659,Cao; Yingjun,0,71,50,50
1650796281523,CSE 134B,A01,083661,Powell; Thomas Allan,0,38,65,65
1650796287549,CSE 140,A01,083663,Staff,0,11,75,75
1650796293574,CSE 140L,A01,083088,Eldon; John,0,20,75,75
1650796299614,CSE 175,A01,083665,Kumar; Rakesh,7,0,25,18
1650796305667,CSE 190,A00,092507,Dubnov; Shlomo,10,0,20,10
1650796311697,ECE 45,A01,083139,Staff,0,1,60,60
1650796317726,ECE 65,A50,083695,Staff,0,5,30,30
1650796323754,ECE 109,A01,091882,Touri; Behrouz,32,0,70,38
1650796329805,ECE 180,A00,083140,Abi Samra; Nicholas Camill,20,0,30,10
1650796329805,ECE 180,B00,083141,Abi Samra; Nicholas Camill,0,0,30,30
1650796335836,MATH 10A,A01,083735,Patchell; Gregory David,2,0,30,28
1650796335836,MATH 10A,A02,083736,Patchell; Gregory David,27,0,30,3
1650796335836,MATH 10A,A03,083737,Patchell; Gregory David,24,0,30,6
1650796341860,MATH 10B,A01,083207,Staff,0,9,30,30
1650796341860,MATH 10B,A02,083208,Staff,0,6,30,30
1650796341860,MATH 10B,B01,083739,Staff,11,0,30,19
1650796341860,MATH 10B,B02,083740,Staff,28,0,30,2
1650796347910,MATH 18,A01,083743,Staff,0,0,30,30
1650796347910,MATH 18,A02,083744,Staff,23,0,30,7
1650796347910,MATH 18,A03,083745,Staff,21,0,30,9
1650796347910,MATH 18,A04,083746,Staff,26,0,30,4
1650796347910,MATH 18,B01,083748,Staff,0,15,30,30
1650796347910,MATH 18,B02,083749,Staff,0,12,30,30
1650796347910,MATH 18,B03,083750,Staff,0,12,30,30
1650796347910,MATH 18,B04,083751,Staff,0,12,30,30
1650796353938,MATH 20A,A01,083754,Staff,19,0,40,21
1650796359964,MATH 20B,A01,083756,Staff,0,13,30,30
1650796359964,MATH 20B,A02,083757,Staff,0,12,30,30
1650796365998,MATH 20C,A01,083760,Staff,0,17,30,30
1650796365998,MATH 20C,A02,083761,Staff,0,16,30,30
1650796365998,MATH 20C,B01,083762,Staff,9,0,30,21
1650796365998,MATH 20C,B02,083763,Staff,28,0,30,2
1650796372025,MATH 20D,A01,083765,Staff,2,1,30,28
1650796372025,MATH 20D,A02,083766,Staff,6,0,30,24
1650796372025,MATH 20D,A03,083767,Staff,24,0,30,6
1650796378065,MATH 20E,A01,083771,Staff,2,0,30,28
1650796378065,MATH 20E,A02,083772,Staff,15,0,30,15
1650796378065,MATH 20E,B01,083773,Staff,0,0,30,30
1650796378065,MATH 20E,B02,083774,Staff,5,0,30,25
1650796384093,MATH 103A,A01,083777,Staff,0,16,30,30
1650796384093,MATH 103A,A02,083778,Staff,0,15,30,30
1650796384093,MATH 103A,B01,083779,Staff,0,15,30,30
1650796384093,MATH 103A,B02,083780,Staff,0,15,30,30
1650796390121,MATH 105,A01,085443,Staff,0,22,30,30
1650796396157,MATH 109,A01,083213,Anzaldo; Leesa B,0,7,30,30
1650796396157,MATH 109,A02,083214,Anzaldo; Leesa B,0,7,30,30
1650796396157,MATH 109,B01,083215,Anzaldo; Leesa B,0,8,30,30
1650796396157,MATH 109,B02,083216,Anzaldo; Leesa B,0,7,30,30
1650796402188,MATH 142A,A01,083219,Chow; Bennett,0,16,30,30
1650796402188,MATH 142A,A02,083220,Chow; Bennett,0,15,30,30
1650796402188,MATH 142A,B01,083221,Chow; Bennett,0,16,30,30
1650796402188,MATH 142A,B02,083222,Chow; Bennett,0,14,30,30
1650796408231,MATH 193A,A01,083224,Staff,0,6,30,30
1650796408231,MATH 193A,A02,083225,Staff,0,6,30,30
1650796408231,MATH 193A,A03,083781,Staff,0,6,30,30
1650796408231,MATH 193A,A04,083782,Staff,0,7,30,30
1650796414264,MATH 197,001,091859,McAuley; Julian John,9998,0,9999,1
1650796420323,COGS 9,A01,083615,Staff,0,17,60,60
1650796426347,COGS 11,A01,083617,Boyle; Mary E. T.,16,0,40,24
1650796432376,COGS 13,A01,083071,Staff,0,38,40,40
1650796438401,COGS 14A,A01,092681,Staff,0,36,100,100
1650796444429,COGS 14B,A01,083073,Cheng; Tzu-Han,0,12,50,50
1650796450455,COGS 17,A01,092677,Staff,11,0,75,64
1650796456491,COGS 100,A01,083619,Staff,0,29,60,60
1650796462528,COGS 101A,A01,083621,Davis; Joshua Daniel,0,28,60,60
1650796468553,COGS 101B,A01,091572,Staff,0,3,60,60
1650796474582,COGS 101C,A01,083625,Delgado; Tania,14,0,30,16
1650796480612,COGS 107A,A01,083627,Boyle; Mary E. T.,0,16,60,60
1650796486646,COGS 118A,A01,083075,Staff,0,8,60,60
1650796492685,CSE 3,A50,083646,Miranda; Gregory Joseph,18,0,38,20
1650796492685,CSE 3,A51,083647,Miranda; Gregory Joseph,36,0,37,1
1650796498738,CSE 8A,A50,083650,Miranda; Gregory Joseph,0,29,40,40
1650796504763,CSE 11,A01,083080,Cao; Yingjun,0,96,40,40
1650796510801,CSE 12,A01,083652,Staff,0,21,100,100
1650796516839,CSE 15L,A01,083654,Staff,0,3,50,50
1650796516839,CSE 15L,A02,083655,Staff,0,2,50,50
1650796522865,CSE 20,A01,083657,Staff,49,0,80,31
1650796528890,CSE 30,A01,083084,Eldon; John,0,75,40,40
1650796534914,CSE 100,A01,083659,Cao; Yingjun,0,71,50,50
1650796540947,CSE 134B,A01,083661,Powell; Thomas Allan,0,38,65,65
1650796547002,CSE 140,A01,083663,Staff,0,11,75,75
1650796553044,CSE 140L,A01,083088,Eldon; John,0,20,75,75
1650796559076,CSE 175,A01,083665,Kumar; Rakesh,7,0,25,18
1650796565100,CSE 190,A00,092507,Dubnov; Shlomo,10,0,20,10
1650796571211,ECE 45,A01,083139,Staff,0,1,60,60
1650796577249,ECE 65,A50,083695,Staff,0,5,30,30
1650796583282,ECE 109,A01,091882,Touri; Behrouz,32,0,70,38
1650796589327,ECE 180,A00,083140,Abi Samra; Nicholas Camill,20,0,30,10
1650796589327,ECE 180,B00,083141,Abi Samra; Nicholas Camill,0,0,30,30
1650796595376,MATH 10A,A01,083735,Patchell; Gregory David,2,0,30,28
1650796595376,MATH 10A,A02,083736,Patchell; Gregory David,27,0,30,3
1650796595376,MATH 10A,A03,083737,Patchell; Gregory David,24,0,30,6
1650796601420,MATH 10B,A01,083207,Staff,0,9,30,30
1650796601420,MATH 10B,A02,083208,Staff,0,6,30,30
1650796601420,MATH 10B,B01,083739,Staff,11,0,30,19
1650796601420,MATH 10B,B02,083740,Staff,28,0,30,2
1650796607474,MATH 18,A01,083743,Staff,0,0,30,30
1650796607474,MATH 18,A02,083744,Staff,23,0,30,7
1650796607474,MATH 18,A03,083745,Staff,21,0,30,9
1650796607474,MATH 18,A04,083746,Staff,26,0,30,4
1650796607474,MATH 18,B01,083748,Staff,0,15,30,30
1650796607474,MATH 18,B02,083749,Staff,0,12,30,30
1650796607474,MATH 18,B03,083750,Staff,0,12,30,30
1650796607474,MATH 18,B04,083751,Staff,0,12,30,30
1650796613512,MATH 20A,A01,083754,Staff,19,0,40,21
1650796619544,MATH 20B,A01,083756,Staff,0,13,30,30
1650796619544,MATH 20B,A02,083757,Staff,0,12,30,30
1650796625572,MATH 20C,A01,083760,Staff,0,17,30,30
1650796625572,MATH 20C,A02,083761,Staff,0,16,30,30
1650796625572,MATH 20C,B01,083762,Staff,9,0,30,21
1650796625572,MATH 20C,B02,083763,Staff,28,0,30,2
1650796631598,MATH 20D,A01,083765,Staff,2,1,30,28
1650796631598,MATH 20D,A02,083766,Staff,6,0,30,24
1650796631598,MATH 20D,A03,083767,Staff,24,0,30,6
1650796637625,MATH 20E,A01,083771,Staff,2,0,30,28
1650796637625,MATH 20E,A02,083772,Staff,15,0,30,15
1650796637625,MATH 20E,B01,083773,Staff,0,0,30,30
1650796637625,MATH 20E,B02,083774,Staff,5,0,30,25
1650796643674,MATH 103A,A01,083777,Staff,0,16,30,30
1650796643674,MATH 103A,A02,083778,Staff,0,15,30,30
1650796643674,MATH 103A,B01,083779,Staff,0,15,30,30
1650796643674,MATH 103A,B02,083780,Staff,0,15,30,30
1650796649703,MATH 105,A01,085443,Staff,0,22,30,30
1650796655733,MATH 109,A01,083213,Anzaldo; Leesa B,0,7,30,30
1650796655733,MATH 109,A02,083214,Anzaldo; Leesa B,0,7,30,30
1650796655733,MATH 109,B01,083215,Anzaldo; Leesa B,0,8,30,30
1650796655733,MATH 109,B02,083216,Anzaldo; Leesa B,0,7,30,30
1650796661780,MATH 142A,A01,083219,Chow; Bennett,0,16,30,30
1650796661780,MATH 142A,A02,083220,Chow; Bennett,0,15,30,30
1650796661780,MATH 142A,B01,083221,Chow; Bennett,0,16,30,30
1650796661780,MATH 142A,B02,083222,Chow; Bennett,0,14,30,30
1650796667806,MATH 193A,A01,083224,Staff,0,6,30,30
1650796667806,MATH 193A,A02,083225,Staff,0,6,30,30
1650796667806,MATH 193A,A03,083781,Staff,0,6,30,30
1650796667806,MATH 193A,A04,083782,Staff,0,7,30,30
1650796673835,MATH 197,001,091859,McAuley; Julian John,9998,0,9999,1
1650796679918,COGS 9,A01,083615,Staff,0,17,60,60
1650796685949,COGS 11,A01,083617,Boyle; Mary E. T.,16,0,40,24
1650796691979,COGS 13,A01,083071,Staff,0,38,40,40
1650796698013,COGS 14A,A01,092681,Staff,0,36,100,100
1650796704045,COGS 14B,A01,083073,Cheng; Tzu-Han,0,12,50,50
1650796710069,COGS 17,A01,092677,Staff,11,0,75,64
1650796716097,COGS 100,A01,083619,Staff,0,29,60,60
1650796722146,COGS 101A,A01,083621,Davis; Joshua Daniel,0,28,60,60
1650796728171,COGS 101B,A01,091572,Staff,0,3,60,60
1650796734198,COGS 101C,A01,083625,Delgado; Tania,14,0,30,16
1650796740238,COGS 107A,A01,083627,Boyle; Mary E. T.,0,16,60,60
1650796746273,COGS 118A,A01,083075,Staff,0,8,60,60
1650796752309,CSE 3,A50,083646,Miranda; Gregory Joseph,18,0,38,20
1650796752309,CSE 3,A51,083647,Miranda; Gregory Joseph,36,0,37,1
1650796758362,CSE 8A,A50,083650,Miranda; Gregory Joseph,0,29,40,40
1650796764404,CSE 11,A01,083080,Cao; Yingjun,0,96,40,40
1650796770437,CSE 12,A01,083652,Staff,0,21,100,100
1650796776462,CSE 15L,A01,083654,Staff,0,3,50,50
1650796776462,CSE 15L,A02,083655,Staff,0,2,50,50
1650796782489,CSE 20,A01,083657,Staff,49,0,80,31
1650796788513,CSE 30,A01,083084,Eldon; John,0,75,40,40
1650796794550,CSE 100,A01,083659,Cao; Yingjun,0,71,50,50
1650796800580,CSE 134B,A01,083661,Powell; Thomas Allan,0,38,65,65
1650796806619,CSE 140,A01,083663,Staff,0,11,75,75
1650796812643,CSE 140L,A01,083088,Eldon; John,0,20,75,75
1650796818668,CSE 175,A01,083665,Kumar; Rakesh,7,0,25,18
1650796824695,CSE 190,A00,092507,Dubnov; Shlomo,10,0,20,10
1650796830726,ECE 45,A01,083139,Staff,0,1,60,60
1650796836760,ECE 65,A50,083695,Staff,0,5,30,30
1650796842799,ECE 109,A01,091882,Touri; Behrouz,32,0,70,38
1650796848839,ECE 180,A00,083140,Abi Samra; Nicholas Camill,20,0,30,10
1650796848839,ECE 180,B00,083141,Abi Samra; Nicholas Camill,0,0,30,30
1650796854875,MATH 10A,A01,083735,Patchell; Gregory David,2,0,30,28
1650796854875,MATH 10A,A02,083736,Patchell; Gregory David,27,0,30,3
1650796854875,MATH 10A,A03,083737,Patchell; Gregory David,24,0,30,6
1650796860902,MATH 10B,A01,083207,Staff,0,9,30,30
1650796860902,MATH 10B,A02,083208,Staff,0,6,30,30
1650796860902,MATH 10B,B01,083739,Staff,11,0,30,19
1650796860902,MATH 10B,B02,083740,Staff,28,0,30,2
1650796866957,MATH 18,A01,083743,Staff,0,0,30,30
1650796866957,MATH 18,A02,083744,Staff,23,0,30,7
1650796866957,MATH 18,A03,083745,Staff,21,0,30,9
1650796866957,MATH 18,A04,083746,Staff,26,0,30,4
1650796866957,MATH 18,B01,083748,Staff,0,15,30,30
1650796866957,MATH 18,B02,083749,Staff,0,12,30,30
1650796866957,MATH 18,B03,083750,Staff,0,12,30,30
1650796866957,MATH 18,B04,083751,Staff,0,12,30,30
1650796872982,MATH 20A,A01,083754,Staff,19,0,40,21
1650796879030,MATH 20B,A01,083756,Staff,0,13,30,30
1650796879030,MATH 20B,A02,083757,Staff,0,12,30,30
1650796885060,MATH 20C,A01,083760,Staff,0,17,30,30
1650796885060,MATH 20C,A02,083761,Staff,0,16,30,30
1650796885060,MATH 20C,B01,083762,Staff,9,0,30,21
1650796885060,MATH 20C,B02,083763,Staff,28,0,30,2
1650796891088,MATH 20D,A01,083765,Staff,2,1,30,28
1650796891088,MATH 20D,A02,083766,Staff,6,0,30,24
1650796891088,MATH 20D,A03,083767,Staff,24,0,30,6
1650796897119,MATH 20E,A01,083771,Staff,2,0,30,28
1650796897119,MATH 20E,A02,083772,Staff,15,0,30,15
1650796897119,MATH 20E,B01,083773,Staff,0,0,30,30
1650796897119,MATH 20E,B02,083774,Staff,5,0,30,25
1650796903151,MATH 103A,A01,083777,Staff,0,16,30,30
1650796903151,MATH 103A,A02,083778,Staff,0,15,30,30
1650796903151,MATH 103A,B01,083779,Staff,0,15,30,30
1650796903151,MATH 103A,B02,083780,Staff,0,15,30,30
1650796909184,MATH 105,A01,085443,Staff,0,22,30,30
1650796915211,MATH 109,A01,083213,Anzaldo; Leesa B,0,7,30,30
1650796915211,MATH 109,A02,083214,Anzaldo; Leesa B,0,7,30,30
1650796915211,MATH 109,B01,083215,Anzaldo; Leesa B,0,8,30,30
1650796915211,MATH 109,B02,083216,Anzaldo; Leesa B,0,7,30,30
1650796921243,MATH 142A,A01,083219,Chow; Bennett,0,16,30,30
1650796921243,MATH 142A,A02,083220,Chow; Bennett,0,15,30,30
1650796921243,MATH 142A,B01,083221,Chow; Bennett,0,16,30,30
1650796921243,MATH 142A,B02,083222,Chow; Bennett,0,14,30,30
1650796927281,MATH 193A,A01,083224,Staff,0,6,30,30
1650796927281,MATH 193A,A02,083225,Staff,0,6,30,30
1650796927281,MATH 193A,A03,083781,Staff,0,6,30,30
1650796927281,MATH 193A,A04,083782,Staff,0,7,30,30
1650796933323,MATH 197,001,091859,McAuley; Julian John,9998,0,9999,1
1650796939386,COGS 9,A01,083615,Staff,0,17,60,60
1650796945416,COGS 11,A01,083617,Boyle; Mary E. T.,16,0,40,24
1650796951441,COGS 13,A01,083071,Staff,0,38,40,40
1650796957465,COGS 14A,A01,092681,Staff,0,36,100,100
1650796963501,COGS 14B,A01,083073,Cheng; Tzu-Han,0,12,50,50
1650796969534,COGS 17,A01,092677,Staff,11,0,75,64
1650796975570,COGS 100,A01,083619,Staff,0,29,60,60
1650796981596,COGS 101A,A01,083621,Davis; Joshua Daniel,0,28,60,60
1650796987641,COGS 101B,A01,091572,Staff,0,3,60,60
1650796993693,COGS 101C,A01,083625,Delgado; Tania,14,0,30,16
1650796999733,COGS 107A,A01,083627,Boyle; Mary E. T.,0,16,60,60
1650797005759,COGS 118A,A01,083075,Staff,0,8,60,60
1650797011787,CSE 3,A50,083646,Miranda; Gregory Joseph,18,0,38,20
1650797011787,CSE 3,A51,083647,Miranda; Gregory Joseph,36,0,37,1
1650797017820,CSE 8A,A50,083650,Miranda; Gregory Joseph,0,29,40,40
1650797023846,CSE 11,A01,083080,Cao; Yingjun,0,96,40,40
1650797029872,CSE 12,A01,083652,Staff,0,21,100,100
1650797035895,CSE 15L,A01,083654,Staff,0,3,50,50
1650797035895,CSE 15L,A02,083655,Staff,0,2,50,50
1650797041933,CSE 20,A01,083657,Staff,49,0,80,31
1650797047966,CSE 30,A01,083084,Eldon; John,0,75,40,40
1650797053997,CSE 100,A01,083659,Cao; Yingjun,0,71,50,50
1650797060036,CSE 134B,A01,083661,Powell; Thomas Allan,0,38,65,65
1650797066062,CSE 140,A01,083663,Staff,0,11,75,75
1650797072108,CSE 140L,A01,083088,Eldon; John,0,20,75,75
1650797078132,CSE 175,A01,083665,Kumar; Rakesh,7,0,25,18
1650797084157,CSE 190,A00,092507,Dubnov; Shlomo,10,0,20,10
1650797090189,ECE 45,A01,083139,Staff,0,1,60,60
1650797096221,ECE 65,A50,083695,Staff,0,5,30,30
1650797102254,ECE 109,A01,091882,Touri; Behrouz,32,0,70,38
1650797108286,ECE 180,A00,083140,Abi Samra; Nicholas Camill,20,0,30,10
1650797108286,ECE 180,B00,083141,Abi Samra; Nicholas Camill,0,0,30,30
1650797114320,MATH 10A,A01,083735,Patchell; Gregory David,2,0,30,28
1650797114320,MATH 10A,A02,083736,Patchell; Gregory David,27,0,30,3
1650797114320,MATH 10A,A03,083737,Patchell; Gregory David,24,0,30,6
1650797120346,MATH 10B,A01,083207,Staff,0,9,30,30
1650797120346,MATH 10B,A02,083208,Staff,0,6,30,30
1650797120346,MATH 10B,B01,083739,Staff,11,0,30,19
1650797120346,MATH 10B,B02,083740,Staff,28,0,30,2
1650797126375,MATH 18,A01,083743,Staff,0,0,30,30
1650797126375,MATH 18,A02,083744,Staff,23,0,30,7
1650797126375,MATH 18,A03,083745,Staff,21,0,30,9
1650797126375,MATH 18,A04,083746,Staff,26,0,30,4
1650797126375,MATH 18,B01,083748,Staff,0,15,30,30
1650797126375,MATH 18,B02,083749,Staff,0,12,30,30
1650797126375,MATH 18,B03,083750,Staff,0,12,30,30
1650797126375,MATH 18,B04,083751,Staff,0,12,30,30
1650797132412,MATH 20A,A01,083754,Staff,19,0,40,21
1650797138441,MATH 20B,A01,083756,Staff,0,13,30,30
1650797138441,MATH 20B,A02,083757,Staff,0,12,30,30
1650797144467,MATH 20C,A01,083760,Staff,0,17,30,30
1650797144467,MATH 20C,A02,083761,Staff,0,16,30,30
1650797144467,MATH 20C,B01,083762,Staff,9,0,30,21
1650797144467,MATH 20C,B02,083763,Staff,28,0,30,2
1650797150506,MATH 20D,A01,083765,Staff,2,1,30,28
1650797150506,MATH 20D,A02,083766,Staff,6,0,30,24
1650797150506,MATH 20D,A03,083767,Staff,24,0,30,6
1650797156546,MATH 20E,A01,083771,Staff,2,0,30,28
1650797156546,MATH 20E,A02,083772,Staff,15,0,30,15
1650797156546,MATH 20E,B01,083773,Staff,0,0,30,30
1650797156546,MATH 20E,B02,083774,Staff,5,0,30,25
1650797162574,MATH 103A,A01,083777,Staff,0,16,30,30
1650797162574,MATH 103A,A02,083778,Staff,0,15,30,30
1650797162574,MATH 103A,B01,083779,Staff,0,15,30,30
1650797162574,MATH 103A,B02,083780,Staff,0,15,30,30
1650797168700,MATH 105,A01,085443,Staff,0,22,30,30
1650797174725,MATH 109,A01,083213,Anzaldo; Leesa B,0,7,30,30
1650797174725,MATH 109,A02,083214,Anzaldo; Leesa B,0,7,30,30
1650797174725,MATH 109,B01,083215,Anzaldo; Leesa B,0,8,30,30
1650797174725,MATH 109,B02,083216,Anzaldo; Leesa B,0,7,30,30
1650797180767,MATH 142A,A01,083219,Chow; Bennett,0,16,30,30
1650797180767,MATH 142A,A02,083220,Chow; Bennett,0,15,30,30
1650797180767,MATH 142A,B01,083221,Chow; Bennett,0,16,30,30
1650797180767,MATH 142A,B02,083222,Chow; Bennett,0,14,30,30
1650797186800,MATH 193A,A01,083224,Staff,0,6,30,30
1650797186800,MATH 193A,A02,083225,Staff,0,6,30,30
1650797186800,MATH 193A,A03,083781,Staff,0,6,30,30
1650797186800,MATH 193A,A04,083782,Staff,0,7,30,30
1650797192843,MATH 197,001,091859,McAuley; Julian John,9998,0,9999,1
1650797198911,COGS 9,A01,083615,Staff,0,17,60,60
1650797204939,COGS 11,A01,083617,Boyle; Mary E. T.,16,0,40,24
1650797210963,COGS 13,A01,083071,Staff,0,38,40,40
1650797216988,COGS 14A,A01,092681,Staff,0,36,100,100
1650797223014,COGS 14B,A01,083073,Cheng; Tzu-Han,0,12,50,50
1650797229049,COGS 17,A01,092677,Staff,11,0,75,64
1650797235077,COGS 100,A01,083619,Staff,0,29,60,60
1650797241105,COGS 101A,A01,083621,Davis; Joshua Daniel,0,28,60,60
1650797247148,COGS 101B,A01,091572,Staff,0,3,60,60
1650797253178,COGS 101C,A01,083625,Delgado; Tania,14,0,30,16
1650797259204,COGS 107A,A01,083627,Boyle; Mary E. T.,0,16,60,60
1650797265247,COGS 118A,A01,083075,Staff,0,8,60,60
1650797271279,CSE 3,A50,083646,Miranda; Gregory Joseph,18,0,38,20
1650797271279,CSE 3,A51,083647,Miranda; Gregory Joseph,36,0,37,1
1650797277313,CSE 8A,A50,083650,Miranda; Gregory Joseph,0,29,40,40
1650797283346,CSE 11,A01,083080,Cao; Yingjun,0,96,40,40
1650797289372,CSE 12,A01,083652,Staff,0,21,100,100
1650797295396,CSE 15L,A01,083654,Staff,0,3,50,50
1650797295396,CSE 15L,A02,083655,Staff,0,2,50,50
1650797301421,CSE 20,A01,083657,Staff,49,0,80,31
1650797307462,CSE 30,A01,083084,Eldon; John,0,75,40,40
1650797313505,CSE 100,A01,083659,Cao; Yingjun,0,71,50,50
1650797319544,CSE 134B,A01,083661,Powell; Thomas Allan,0,38,65,65
1650797325570,CSE 140,A01,083663,Staff,0,11,75,75
1650797331605,CSE 140L,A01,083088,Eldon; John,0,20,75,75
1650797337640,CSE 175,A01,083665,Kumar; Rakesh,7,0,25,18
1650797343667,CSE 190,A00,092507,Dubnov; Shlomo,10,0,20,10
1650797349694,ECE 45,A01,083139,Staff,0,1,60,60
1650797355725,ECE 65,A50,083695,Staff,0,5,30,30
1650797361752,ECE 109,A01,091882,Touri; Behrouz,32,0,70,38
1650797367783,ECE 180,A00,083140,Abi Samra; Nicholas Camill,20,0,30,10
1650797367783,ECE 180,B00,083141,Abi Samra; Nicholas Camill,0,0,30,30
1650797373841,MATH 10A,A01,083735,Patchell; Gregory David,2,0,30,28
1650797373841,MATH 10A,A02,083736,Patchell; Gregory David,27,0,30,3
1650797373841,MATH 10A,A03,083737,Patchell; Gregory David,24,0,30,6
1650797379866,MATH 10B,A01,083207,Staff,0,9,30,30
1650797379866,MATH 10B,A02,083208,Staff,0,6,30,30
1650797379866,MATH 10B,B01,083739,Staff,11,0,30,19
1650797379866,MATH 10B,B02,083740,Staff,28,0,30,2
1650797385904,MATH 18,A01,083743,Staff,0,0,30,30
1650797385904,MATH 18,A02,083744,Staff,23,0,30,7
1650797385904,MATH 18,A03,083745,Staff,21,0,30,9
1650797385904,MATH 18,A04,083746,Staff,26,0,30,4
1650797385904,MATH 18,B01,083748,Staff,0,15,30,30
1650797385904,MATH 18,B02,083749,Staff,0,12,30,30
1650797385904,MATH 18,B03,083750,Staff,0,12,30,30
1650797385904,MATH 18,B04,083751,Staff,0,12,30,30
1650797391929,MATH 20A,A01,083754,Staff,19,0,40,21
1650797397955,MATH 20B,A01,083756,Staff,0,13,30,30
1650797397955,MATH 20B,A02,083757,Staff,0,12,30,30
1650797403980,MATH 20C,A01,083760,Staff,0,17,30,30
1650797403980,MATH 20C,A02,083761,Staff,0,16,30,30
1650797403980,MATH 20C,B01,083762,Staff,9,0,30,21
1650797403980,MATH 20C,B02,083763,Staff,28,0,30,2
1650797410031,MATH 20D,A01,083765,Staff,2,1,30,28
1650797410031,MATH 20D,A02,083766,Staff,6,0,30,24
1650797410031,MATH 20D,A03,083767,Staff,24,0,30,6
1650797416073,MATH 20E,A01,083771,Staff,2,0,30,28
1650797416073,MATH 20E,A02,083772,Staff,15,0,30,15
1650797416073,MATH 20E,B01,083773,Staff,0,0,30,30
1650797416073,MATH 20E,B02,083774,Staff,5,0,30,25
1650797422108,MATH 103A,A01,083777,Staff,0,16,30,30
1650797422108,MATH 103A,A02,083778,Staff,0,15,30,30
1650797422108,MATH 103A,B01,083779,Staff,0,15,30,30
1650797422108,MATH 103A,B02,083780,Staff,0,15,30,30
1650797428145,MATH 105,A01,085443,Staff,0,22,30,30
1650797434187,MATH 109,A01,083213,Anzaldo; Leesa B,0,7,30,30
1650797434187,MATH 109,A02,083214,Anzaldo; Leesa B,0,7,30,30
1650797434187,MATH 109,B01,083215,Anzaldo; Leesa B,0,8,30,30
1650797434187,MATH 109,B02,083216,Anzaldo; Leesa B,0,7,30,30
1650797440214,MATH 142A,A01,083219,Chow; Bennett,0,16,30,30
1650797440214,MATH 142A,A02,083220,Chow; Bennett,0,15,30,30
1650797440214,MATH 142A,B01,083221,Chow; Bennett,0,16,30,30
1650797440214,MATH 142A,B02,083222,Chow; Bennett,0,14,30,30
1650797446262,MATH 193A,A01,083224,Staff,0,6,30,30
1650797446262,MATH 193A,A02,083225,Staff,0,6,30,30
1650797446262,MATH 193A,A03,083781,Staff,0,6,30,30
1650797446262,MATH 193A,A04,083782,Staff,0,7,30,30
1650797452287,MATH 197,001,091859,McAuley; Julian John,9998,0,9999,1
1650797458370,COGS 9,A01,083615,Staff,0,17,60,60
1650797464406,COGS 11,A01,083617,Boyle; Mary E. T.,16,0,40,24
1650797470438,COGS 13,A01,083071,Staff,0,38,40,40
1650797476465,COGS 14A,A01,092681,Staff,0,36,100,100
1650797482509,COGS 14B,A01,083073,Cheng; Tzu-Han,0,12,50,50
1650797488541,COGS 17,A01,092677,Staff,11,0,75,64
1650797494577,COGS 100,A01,083619,Staff,0,29,60,60
1650797500603,COGS 101A,A01,083621,Davis; Joshua Daniel,0,28,60,60
1650797506633,COGS 101B,A01,091572,Staff,0,3,60,60
1650797512665,COGS 101C,A01,083625,Delgado; Tania,14,0,30,16
1650797518696,COGS 107A,A01,083627,Boyle; Mary E. T.,0,16,60,60
1650797524721,COGS 118A,A01,083075,Staff,0,8,60,60
1650797530760,CSE 3,A50,083646,Miranda; Gregory Joseph,18,0,38,20
1650797530760,CSE 3,A51,083647,Miranda; Gregory Joseph,36,0,37,1
1650797536784,CSE 8A,A50,083650,Miranda; Gregory Joseph,0,29,40,40
1650797542815,CSE 11,A01,083080,Cao; Yingjun,0,96,40,40
1650797548846,CSE 12,A01,083652,Staff,0,21,100,100
1650797554870,CSE 15L,A01,083654,Staff,0,3,50,50
1650797554870,CSE 15L,A02,083655,Staff,0,2,50,50
1650797560910,CSE 20,A01,083657,Staff,49,0,80,31
1650797566952,CSE 30,A01,083084,Eldon; John,0,75,40,40
1650797572976,CSE 100,A01,083659,Cao; Yingjun,0,71,50,50
1650797579007,CSE 134B,A01,083661,Powell; Thomas Allan,0,38,65,65
1650797585060,CSE 140,A01,083663,Staff,0,11,75,75
1650797591088,CSE 140L,A01,083088,Eldon; John,0,20,75,75
1650797597128,CSE 175,A01,083665,Kumar; Rakesh,7,0,25,18
1650797603161,CSE 190,A00,092507,Dubnov; Shlomo,10,0,20,10
1650797609214,ECE 45,A01,083139,Staff,0,1,60,60
1650797615244,ECE 65,A50,083695,Staff,0,5,30,30
1650797621293,ECE 109,A01,091882,Touri; Behrouz,32,0,70,38
1650797627340,ECE 180,A00,083140,Abi Samra; Nicholas Camill,20,0,30,10
1650797627340,ECE 180,B00,083141,Abi Samra; Nicholas Camill,0,0,30,30
1650797633390,MATH 10A,A01,083735,Patchell; Gregory David,2,0,30,28
1650797633390,MATH 10A,A02,083736,Patchell; Gregory David,27,0,30,3
1650797633390,MATH 10A,A03,083737,Patchell; Gregory David,24,0,30,6
1650797639430,MATH 10B,A01,083207,Staff,0,9,30,30
1650797639430,MATH 10B,A02,083208,Staff,0,6,30,30
1650797639430,MATH 10B,B01,083739,Staff,11,0,30,19
1650797639430,MATH 10B,B02,083740,Staff,28,0,30,2
1650797645466,MATH 18,A01,083743,Staff,0,0,30,30
1650797645466,MATH 18,A02,083744,Staff,23,0,30,7
1650797645466,MATH 18,A03,083745,Staff,21,0,30,9
1650797645466,MATH 18,A04,083746,Staff,26,0,30,4
1650797645466,MATH 18,B01,083748,Staff,0,15,30,30
1650797645466,MATH 18,B02,083749,Staff,0,12,30,30
1650797645466,MATH 18,B03,083750,Staff,0,12,30,30
1650797645466,MATH 18,B04,083751,Staff,0,12,30,30
1650797651501,MATH 20A,A01,083754,Staff,19,0,40,21
1650797657532,MATH 20B,A01,083756,Staff,0,13,30,30
1650797657532,MATH 20B,A02,083757,Staff,0,12,30,30
1650797663585,MATH 20C,A01,083760,Staff,0,17,30,30
1650797663585,MATH 20C,A02,083761,Staff,0,16,30,30
1650797663585,MATH 20C,B01,083762,Staff,9,0,30,21
1650797663585,MATH 20C,B02,083763,Staff,28,0,30,2
1650797669612,MATH 20D,A01,083765,Staff,2,1,30,28
1650797669612,MATH 20D,A02,083766,Staff,6,0,30,24
1650797669612,MATH 20D,A03,083767,Staff,24,0,30,6
1650797675638,MATH 20E,A01,083771,Staff,2,0,30,28
1650797675638,MATH 20E,A02,083772,Staff,15,0,30,15
1650797675638,MATH 20E,B01,083773,Staff,0,0,30,30
1650797675638,MATH 20E,B02,083774,Staff,5,0,30,25
1650797681677,MATH 103A,A01,083777,Staff,0,16,30,30
1650797681677,MATH 103A,A02,083778,Staff,0,15,30,30
1650797681677,MATH 103A,B01,083779,Staff,0,15,30,30
1650797681677,MATH 103A,B02,083780,Staff,0,15,30,30
1650797687710,MATH 105,A01,085443,Staff,0,22,30,30
1650797693740,MATH 109,A01,083213,Anzaldo; Leesa B,0,7,30,30
1650797693740,MATH 109,A02,083214,Anzaldo; Leesa B,0,7,30,30
1650797693740,MATH 109,B01,083215,Anzaldo; Leesa B,0,8,30,30
1650797693740,MATH 109,B02,083216,Anzaldo; Leesa B,0,7,30,30
1650797699796,MATH 142A,A01,083219,Chow; Bennett,0,16,30,30
1650797699796,MATH 142A,A02,083220,Chow; Bennett,0,15,30,30
1650797699796,MATH 142A,B01,083221,Chow; Bennett,0,16,30,30
1650797699796,MATH 142A,B02,083222,Chow; Bennett,0,14,30,30
1650797705834,MATH 193A,A01,083224,Staff,0,6,30,30
1650797705834,MATH 193A,A02,083225,Staff,0,6,30,30
1650797705834,MATH 193A,A03,083781,Staff,0,6,30,30
1650797705834,MATH 193A,A04,083782,Staff,0,7,30,30
1650797711873,MATH 197,001,091859,McAuley; Julian John,9998,0,9999,1
1650797717948,COGS 9,A01,083615,Staff,0,17,60,60
1650797723973,COGS 11,A01,083617,Boyle; Mary E. T.,16,0,40,24
1650797729999,COGS 13,A01,083071,Staff,0,38,40,40
1650797736045,COGS 14A,A01,092681,Staff,0,36,100,100
1650797742068,COGS 14B,A01,083073,Cheng; Tzu-Han,0,12,50,50
1650797748114,COGS 17,A01,092677,Staff,11,0,75,64
1650797754154,COGS 100,A01,083619,Staff,0,29,60,60
1650797760292,COGS 101A,A01,083621,Davis; Joshua Daniel,0,28,60,60
1650797766332,COGS 101B,A01,091572,Staff,0,3,60,60
1650797772389,COGS 101C,A01,083625,Delgado; Tania,14,0,30,16
1650797778417,COGS 107A,A01,083627,Boyle; Mary E. T.,0,16,60,60
1650797784445,COGS 118A,A01,083075,Staff,0,8,60,60
1650797790495,CSE 3,A50,083646,Miranda; Gregory Joseph,18,0,38,20
1650797790495,CSE 3,A51,083647,Miranda; Gregory Joseph,36,0,37,1
1650797796527,CSE 8A,A50,083650,Miranda; Gregory Joseph,0,29,40,40
1650797802558,CSE 11,A01,083080,Cao; Yingjun,0,96,40,40
1650797808585,CSE 12,A01,083652,Staff,0,21,100,100
1650797814609,CSE 15L,A01,083654,Staff,0,3,50,50
1650797814609,CSE 15L,A02,083655,Staff,0,2,50,50
1650797820646,CSE 20,A01,083657,Staff,49,0,80,31
1650797826682,CSE 30,A01,083084,Eldon; John,0,75,40,40
1650797832721,CSE 100,A01,083659,Cao; Yingjun,0,71,50,50
1650797838744,CSE 134B,A01,083661,Powell; Thomas Allan,0,38,65,65
1650797844770,CSE 140,A01,083663,Staff,0,11,75,75
1650797850795,CSE 140L,A01,083088,Eldon; John,0,20,75,75
1650797856821,CSE 175,A01,083665,Kumar; Rakesh,7,0,25,18
1650797862853,CSE 190,A00,092507,Dubnov; Shlomo,10,0,20,10
1650797868887,ECE 45,A01,083139,Staff,0,1,60,60
1650797874936,ECE 65,A50,083695,Staff,0,5,30,30
1650797880974,ECE 109,A01,091882,Touri; Behrouz,32,0,70,38
1650797887003,ECE 180,A00,083140,Abi Samra; Nicholas Camill,20,0,30,10
1650797887003,ECE 180,B00,083141,Abi Samra; Nicholas Camill,0,0,30,30
1650797893046,MATH 10A,A01,083735,Patchell; Gregory David,2,0,30,28
1650797893046,MATH 10A,A02,083736,Patchell; Gregory David,27,0,30,3
1650797893046,MATH 10A,A03,083737,Patchell; Gregory David,24,0,30,6
1650797899070,MATH 10B,A01,083207,Staff,0,9,30,30
1650797899070,MATH 10B,A02,083208,Staff,0,6,30,30
1650797899070,MATH 10B,B01,083739,Staff,11,0,30,19
1650797899070,MATH 10B,B02,083740,Staff,28,0,30,2
1650797905115,MATH 18,A01,083743,Staff,0,0,30,30
1650797905115,MATH 18,A02,083744,Staff,23,0,30,7
1650797905115,MATH 18,A03,083745,Staff,21,0,30,9
1650797905115,MATH 18,A04,083746,Staff,26,0,30,4
1650797905115,MATH 18,B01,083748,Staff,0,15,30,30
1650797905115,MATH 18,B02,083749,Staff,0,12,30,30
1650797905115,MATH 18,B03,083750,Staff,0,12,30,30
1650797905115,MATH 18,B04,083751,Staff,0,12,30,30
1650797911140,MATH 20A,A01,083754,Staff,19,0,40,21
1650797917170,MATH 20B,A01,083756,Staff,0,13,30,30
1650797917170,MATH 20B,A02,083757,Staff,0,12,30,30
1650797923212,MATH 20C,A01,083760,Staff,0,17,30,30
1650797923212,MATH 20C,A02,083761,Staff,0,16,30,30
1650797923212,MATH 20C,B01,083762,Staff,9,0,30,21
1650797923212,MATH 20C,B02,083763,Staff,28,0,30,2
1650797929240,MATH 20D,A01,083765,Staff,2,1,30,28
1650797929240,MATH 20D,A02,083766,Staff,6,0,30,24
1650797929240,MATH 20D,A03,083767,Staff,24,0,30,6
1650797935268,MATH 20E,A01,083771,Staff,2,0,30,28
1650797935268,MATH 20E,A02,083772,Staff,15,0,30,15
1650797935268,MATH 20E,B01,083773,Staff,0,0,30,30
1650797935268,MATH 20E,B02,083774,Staff,5,0,30,25
1650797941300,MATH 103A,A01,083777,Staff,0,16,30,30
1650797941300,MATH 103A,A02,083778,Staff,0,15,30,30
1650797941300,MATH 103A,B01,083779,Staff,0,15,30,30
1650797941300,MATH 103A,B02,083780,Staff,0,15,30,30
1650797947335,MATH 105,A01,085443,Staff,0,22,30,30
1650797953376,MATH 109,A01,083213,Anzaldo; Leesa B,0,7,30,30
1650797953376,MATH 109,A02,083214,Anzaldo; Leesa B,0,7,30,30
1650797953376,MATH 109,B01,083215,Anzaldo; Leesa B,0,8,30,30
1650797953376,MATH 109,B02,083216,Anzaldo; Leesa B,0,7,30,30
1650797959401,MATH 142A,A01,083219,Chow; Bennett,0,16,30,30
1650797959401,MATH 142A,A02,083220,Chow; Bennett,0,15,30,30
1650797959401,MATH 142A,B01,083221,Chow; Bennett,0,16,30,30
1650797959401,MATH 142A,B02,083222,Chow; Bennett,0,14,30,30
1650797965431,MATH 193A,A01,083224,Staff,0,6,30,30
1650797965431,MATH 193A,A02,083225,Staff,0,6,30,30
1650797965431,MATH 193A,A03,083781,Staff,0,6,30,30
1650797965431,MATH 193A,A04,083782,Staff,0,7,30,30
1650797971464,MATH 197,001,091859,McAuley; Julian John,9998,0,9999,1
1650797977541,COGS 9,A01,083615,Staff,0,17,60,60
1650797983586,COGS 11,A01,083617,Boyle; Mary E. T.,16,0,40,24
1650797989611,COGS 13,A01,083071,Staff,0,38,40,40
1650797995636,COGS 14A,A01,092681,Staff,0,36,100,100
1650798001660,COGS 14B,A01,083073,Cheng; Tzu-Han,0,12,50,50
1650798007692,COGS 17,A01,092677,Staff,11,0,75,64
1650798013716,COGS 100,A01,083619,Staff,0,29,60,60
1650798019741,COGS 101A,A01,083621,Davis; Joshua Daniel,0,28,60,60
1650798025769,COGS 101B,A01,091572,Staff,0,3,60,60
1650798031796,COGS 101C,A01,083625,Delgado; Tania,14,0,30,16
1650798037827,COGS 107A,A01,083627,Boyle; Mary E. T.,0,16,60,60
1650798043856,COGS 118A,A01,083075,Staff,0,8,60,60
1650798049897,CSE 3,A50,083646,Miranda; Gregory Joseph,18,0,38,20
1650798049897,CSE 3,A51,083647,Miranda; Gregory Joseph,36,0,37,1
1650798055925,CSE 8A,A50,083650,Miranda; Gregory Joseph,0,29,40,40
1650798061949,CSE 11,A01,083080,Cao; Yingjun,0,96,40,40
1650798067973,CSE 12,A01,083652,Staff,0,21,100,100
1650798073999,CSE 15L,A01,083654,Staff,0,3,50,50
1650798073999,CSE 15L,A02,083655,Staff,0,2,50,50
1650798080056,CSE 20,A01,083657,Staff,49,0,80,31
1650798086089,CSE 30,A01,083084,Eldon; John,0,75,40,40
1650798092118,CSE 100,A01,083659,Cao; Yingjun,0,71,50,50
1650798098169,CSE 134B,A01,083661,Powell; Thomas Allan,0,38,65,65
1650798104201,CSE 140,A01,083663,Staff,0,11,75,75
1650798110236,CSE 140L,A01,083088,Eldon; John,0,20,75,75
1650798116265,CSE 175,A01,083665,Kumar; Rakesh,7,0,25,18
1650798122304,CSE 190,A00,092507,Dubnov; Shlomo,10,0,20,10
1650798128335,ECE 45,A01,083139,Staff,0,1,60,60
1650798134361,ECE 65,A50,083695,Staff,0,5,30,30
1650798140389,ECE 109,A01,091882,Touri; Behrouz,32,0,70,38
1650798146413,ECE 180,A00,083140,Abi Samra; Nicholas Camill,20,0,30,10
1650798146413,ECE 180,B00,083141,Abi Samra; Nicholas Camill,0,0,30,30
1650798152446,MATH 10A,A01,083735,Patchell; Gregory David,2,0,30,28
1650798152446,MATH 10A,A02,083736,Patchell; Gregory David,27,0,30,3
1650798152446,MATH 10A,A03,083737,Patchell; Gregory David,24,0,30,6
1650798158471,MATH 10B,A01,083207,Staff,0,9,30,30
1650798158471,MATH 10B,A02,083208,Staff,0,6,30,30
1650798158471,MATH 10B,B01,083739,Staff,11,0,30,19
1650798158471,MATH 10B,B02,083740,Staff,28,0,30,2
1650798164500,MATH 18,A01,083743,Staff,0,0,30,30
1650798164500,MATH 18,A02,083744,Staff,23,0,30,7
1650798164500,MATH 18,A03,083745,Staff,21,0,30,9
1650798164500,MATH 18,A04,083746,Staff,26,0,30,4
1650798164500,MATH 18,B01,083748,Staff,0,15,30,30
1650798164500,MATH 18,B02,083749,Staff,0,12,30,30
1650798164500,MATH 18,B03,083750,Staff,0,12,30,30
1650798164500,MATH 18,B04,083751,Staff,0,12,30,30
1650798170522,MATH 20A,A01,083754,Staff,19,0,40,21
1650798176882,MATH 20B,A01,083756,Staff,0,13,30,30
1650798176882,MATH 20B,A02,083757,Staff,0,12,30,30
1650798182923,MATH 20C,A01,083760,Staff,0,17,30,30
1650798182923,MATH 20C,A02,083761,Staff,0,16,30,30
1650798182923,MATH 20C,B01,083762,Staff,9,0,30,21
1650798182923,MATH 20C,B02,083763,Staff,28,0,30,2
1650798188949,MATH 20D,A01,083765,Staff,2,1,30,28
1650798188949,MATH 20D,A02,083766,Staff,6,0,30,24
1650798188949,MATH 20D,A03,083767,Staff,24,0,30,6
1650798194980,MATH 20E,A01,083771,Staff,2,0,30,28
1650798194980,MATH 20E,A02,083772,Staff,15,0,30,15
1650798194980,MATH 20E,B01,083773,Staff,0,0,30,30
1650798194980,MATH 20E,B02,083774,Staff,5,0,30,25
1650798201016,MATH 103A,A01,083777,Staff,0,16,30,30
1650798201016,MATH 103A,A02,083778,Staff,0,15,30,30
1650798201016,MATH 103A,B01,083779,Staff,0,15,30,30
1650798201016,MATH 103A,B02,083780,Staff,0,15,30,30
1650798207056,MATH 105,A01,085443,Staff,0,22,30,30
1650798213081,MATH 109,A01,083213,Anzaldo; Leesa B,0,7,30,30
1650798213081,MATH 109,A02,083214,Anzaldo; Leesa B,0,7,30,30
1650798213081,MATH 109,B01,083215,Anzaldo; Leesa B,0,8,30,30
1650798213081,MATH 109,B02,083216,Anzaldo; Leesa B,0,7,30,30
1650798219116,MATH 142A,A01,083219,Chow; Bennett,0,16,30,30
1650798219116,MATH 142A,A02,083220,Chow; Bennett,0,15,30,30
1650798219116,MATH 142A,B01,083221,Chow; Bennett,0,16,30,30
1650798219116,MATH 142A,B02,083222,Chow; Bennett,0,14,30,30
