time,subj_course_id,sec_code,sec_id,prof,available,waitlist,total,enrolled_ct
1650626919776,COGS 9,A01,083615,Staff,0,15,60,60
1650626925827,COGS 11,A01,083617,Boyle; Mary E. T.,18,0,40,22
1650626931880,COGS 13,A01,083071,Staff,0,38,40,40
1650626937946,COGS 14A,A01,092681,Staff,0,31,100,100
1650626943975,COGS 14B,A01,083073,Cheng; Tzu-Han,0,13,50,50
1650626950004,COGS 17,A01,092677,Staff,17,0,75,58
1650626956037,COGS 100,A01,083619,Staff,0,26,60,60
1650626962091,COGS 101A,A01,083621,Davis; Joshua Daniel,0,26,60,60
1650626968134,COGS 101B,A01,091572,Staff,0,4,60,60
1650626974195,COGS 101C,A01,083625,Delgado; Tania,15,0,30,15
1650626980232,COGS 107A,A01,083627,Boyle; Mary E. T.,1,15,60,59
1650626986260,COGS 118A,A01,083075,Staff,0,6,60,60
1650626992301,CSE 3,A50,083646,Miranda; Gregory Joseph,19,0,38,19
1650626992301,CSE 3,A51,083647,Miranda; Gregory Joseph,36,0,37,1
1650626998347,CSE 8A,A50,083650,Miranda; Gregory Joseph,0,30,40,40
1650627004378,CSE 11,A01,083080,Cao; Yingjun,0,95,40,40
1650627010424,CSE 12,A01,083652,Staff,0,19,100,100
1650627016457,CSE 15L,A01,083654,Staff,0,2,50,50
1650627016457,CSE 15L,A02,083655,Staff,0,1,50,50
1650627022490,CSE 20,A01,083657,Staff,51,0,80,29
1650627028526,CSE 30,A01,083084,Eldon; John,0,77,40,40
1650627034554,CSE 100,A01,083659,Cao; Yingjun,0,68,50,50
1650627040594,CSE 134B,A01,083661,Powell; Thomas Allan,0,35,65,65
1650627046641,CSE 140,A01,083663,Staff,0,8,75,75
1650627052672,CSE 140L,A01,083088,Eldon; John,0,16,75,75
1650627058723,CSE 175,A01,083665,Kumar; Rakesh,7,0,25,18
1650627064772,CSE 190,A00,092507,Dubnov; Shlomo,10,0,20,10
1650627070805,ECE 45,A01,083139,Staff,0,1,60,60
1650627076854,ECE 65,A50,083695,Staff,0,5,30,30
1650627082888,ECE 109,A01,091882,Touri; Behrouz,33,0,70,37
1650627088930,ECE 180,A00,083140,Abi Samra; Nicholas Camill,21,0,30,9
1650627088930,ECE 180,B00,083141,Abi Samra; Nicholas Camill,0,0,30,30
1650627094959,MATH 10A,A01,083735,Patchell; Gregory David,4,0,30,26
1650627094959,MATH 10A,A02,083736,Patchell; Gregory David,27,0,30,3
1650627094959,MATH 10A,A03,083737,Patchell; Gregory David,24,0,30,6
1650627100993,MATH 10B,A01,083207,Staff,0,8,30,30
1650627100993,MATH 10B,A02,083208,Staff,0,8,30,30
1650627100993,MATH 10B,B01,083739,Staff,11,0,30,19
1650627100993,MATH 10B,B02,083740,Staff,28,0,30,2
1650627107023,MATH 18,A01,083743,Staff,0,0,30,30
1650627107023,MATH 18,A02,083744,Staff,23,0,30,7
1650627107023,MATH 18,A03,083745,Staff,21,0,30,9
1650627107023,MATH 18,A04,083746,Staff,26,0,30,4
1650627107023,MATH 18,B01,083748,Staff,0,15,30,30
1650627107023,MATH 18,B02,083749,Staff,0,11,30,30
1650627107023,MATH 18,B03,083750,Staff,0,12,30,30
1650627107023,MATH 18,B04,083751,Staff,0,12,30,30
1650627113053,MATH 20A,A01,083754,Staff,19,0,40,21
1650627119085,MATH 20B,A01,083756,Staff,0,12,30,30
1650627119085,MATH 20B,A02,083757,Staff,0,12,30,30
1650627125110,MATH 20C,A01,083760,Staff,0,15,30,30
1650627125110,MATH 20C,A02,083761,Staff,1,13,30,29
1650627125110,MATH 20C,B01,083762,Staff,11,0,30,19
1650627125110,MATH 20C,B02,083763,Staff,28,0,30,2
1650627131146,MATH 20D,A01,083765,Staff,1,1,30,29
1650627131146,MATH 20D,A02,083766,Staff,7,0,30,23
1650627131146,MATH 20D,A03,083767,Staff,24,0,30,6
1650627137187,MATH 20E,A01,083771,Staff,3,0,30,27
1650627137187,MATH 20E,A02,083772,Staff,17,0,30,13
1650627137187,MATH 20E,B01,083773,Staff,0,0,30,30
1650627137187,MATH 20E,B02,083774,Staff,9,0,30,21
1650627143226,MATH 103A,A01,083777,Staff,0,15,30,30
1650627143226,MATH 103A,A02,083778,Staff,0,15,30,30
1650627143226,MATH 103A,B01,083779,Staff,0,14,30,30
1650627143226,MATH 103A,B02,083780,Staff,0,14,30,30
1650627149257,MATH 105,A01,085443,Staff,0,21,30,30
1650627155301,MATH 109,A01,083213,Anzaldo; Leesa B,0,6,30,30
1650627155301,MATH 109,A02,083214,Anzaldo; Leesa B,0,7,30,30
1650627155301,MATH 109,B01,083215,Anzaldo; Leesa B,0,6,30,30
1650627155301,MATH 109,B02,083216,Anzaldo; Leesa B,0,6,30,30
1650627161346,MATH 142A,A01,083219,Chow; Bennett,0,16,30,30
1650627161346,MATH 142A,A02,083220,Chow; Bennett,0,15,30,30
1650627161346,MATH 142A,B01,083221,Chow; Bennett,0,14,30,30
1650627161346,MATH 142A,B02,083222,Chow; Bennett,0,13,30,30
1650627167407,MATH 193A,A01,083224,Staff,0,5,30,30
1650627167407,MATH 193A,A02,083225,Staff,0,6,30,30
1650627167407,MATH 193A,A03,083781,Staff,0,6,30,30
1650627167407,MATH 193A,A04,083782,Staff,0,7,30,30
1650627173432,MATH 197,001,091859,McAuley; Julian John,9998,0,9999,1
1650627179542,COGS 9,A01,083615,Staff,0,15,60,60
1650627185585,COGS 11,A01,083617,Boyle; Mary E. T.,18,0,40,22
1650627191630,COGS 13,A01,083071,Staff,0,38,40,40
1650627209163,COGS 14A,A01,092681,Staff,0,31,100,100
1650627215209,COGS 14B,A01,083073,Cheng; Tzu-Han,0,13,50,50
1650627231554,COGS 17,A01,092677,Staff,17,0,75,58
1650627237581,COGS 100,A01,083619,Staff,0,26,60,60
1650627243687,COGS 101A,A01,083621,Davis; Joshua Daniel,0,26,60,60
1650627249742,COGS 101B,A01,091572,Staff,0,4,60,60
1650627255798,COGS 101C,A01,083625,Delgado; Tania,15,0,30,15
1650627261842,COGS 107A,A01,083627,Boyle; Mary E. T.,1,15,60,59
1650627267882,COGS 118A,A01,083075,Staff,0,6,60,60
1650627273919,CSE 3,A50,083646,Miranda; Gregory Joseph,19,0,38,19
1650627273919,CSE 3,A51,083647,Miranda; Gregory Joseph,36,0,37,1
1650627279965,CSE 8A,A50,083650,Miranda; Gregory Joseph,0,30,40,40
1650627285996,CSE 11,A01,083080,Cao; Yingjun,0,95,40,40
1650627292029,CSE 12,A01,083652,Staff,0,19,100,100
1650627298088,CSE 15L,A01,083654,Staff,0,2,50,50
1650627298088,CSE 15L,A02,083655,Staff,0,1,50,50
1650627304124,CSE 20,A01,083657,Staff,51,0,80,29
1650627310172,CSE 30,A01,083084,Eldon; John,0,77,40,40
1650627316215,CSE 100,A01,083659,Cao; Yingjun,0,68,50,50
1650627322251,CSE 134B,A01,083661,Powell; Thomas Allan,0,35,65,65
1650627328286,CSE 140,A01,083663,Staff,0,8,75,75
1650627334340,CSE 140L,A01,083088,Eldon; John,0,16,75,75
1650627340384,CSE 175,A01,083665,Kumar; Rakesh,7,0,25,18
1650627346423,CSE 190,A00,092507,Dubnov; Shlomo,10,0,20,10
1650627352451,ECE 45,A01,083139,Staff,0,1,60,60
1650627358495,ECE 65,A50,083695,Staff,0,5,30,30
1650627364537,ECE 109,A01,091882,Touri; Behrouz,33,0,70,37
1650627370574,ECE 180,A00,083140,Abi Samra; Nicholas Camill,21,0,30,9
1650627370574,ECE 180,B00,083141,Abi Samra; Nicholas Camill,0,0,30,30
1650627376612,MATH 10A,A01,083735,Patchell; Gregory David,4,0,30,26
1650627376612,MATH 10A,A02,083736,Patchell; Gregory David,27,0,30,3
1650627376612,MATH 10A,A03,083737,Patchell; Gregory David,24,0,30,6
1650627382645,MATH 10B,A01,083207,Staff,0,8,30,30
1650627382645,MATH 10B,A02,083208,Staff,0,8,30,30
1650627382645,MATH 10B,B01,083739,Staff,11,0,30,19
1650627382645,MATH 10B,B02,083740,Staff,28,0,30,2
1650627388701,MATH 18,A01,083743,Staff,0,0,30,30
1650627388701,MATH 18,A02,083744,Staff,23,0,30,7
1650627388701,MATH 18,A03,083745,Staff,21,0,30,9
1650627388701,MATH 18,A04,083746,Staff,26,0,30,4
1650627388701,MATH 18,B01,083748,Staff,0,15,30,30
1650627388701,MATH 18,B02,083749,Staff,0,11,30,30
1650627388701,MATH 18,B03,083750,Staff,0,12,30,30
1650627388701,MATH 18,B04,083751,Staff,0,12,30,30
1650627394737,MATH 20A,A01,083754,Staff,19,0,40,21
1650627400792,MATH 20B,A01,083756,Staff,0,12,30,30
1650627400792,MATH 20B,A02,083757,Staff,0,12,30,30
1650627406837,MATH 20C,A01,083760,Staff,0,15,30,30
1650627406837,MATH 20C,A02,083761,Staff,1,13,30,29
1650627406837,MATH 20C,B01,083762,Staff,11,0,30,19
1650627406837,MATH 20C,B02,083763,Staff,28,0,30,2
1650627412871,MATH 20D,A01,083765,Staff,1,1,30,29
1650627412871,MATH 20D,A02,083766,Staff,7,0,30,23
1650627412871,MATH 20D,A03,083767,Staff,24,0,30,6
1650627418922,MATH 20E,A01,083771,Staff,3,0,30,27
1650627418922,MATH 20E,A02,083772,Staff,17,0,30,13
1650627418922,MATH 20E,B01,083773,Staff,0,0,30,30
1650627418922,MATH 20E,B02,083774,Staff,9,0,30,21
1650627424987,MATH 103A,A01,083777,Staff,0,15,30,30
1650627424987,MATH 103A,A02,083778,Staff,0,15,30,30
1650627424987,MATH 103A,B01,083779,Staff,0,14,30,30
1650627424987,MATH 103A,B02,083780,Staff,0,14,30,30
1650627431019,MATH 105,A01,085443,Staff,0,22,30,30
1650627437055,MATH 109,A01,083213,Anzaldo; Leesa B,0,6,30,30
1650627437055,MATH 109,A02,083214,Anzaldo; Leesa B,0,7,30,30
1650627437055,MATH 109,B01,083215,Anzaldo; Leesa B,0,6,30,30
1650627437055,MATH 109,B02,083216,Anzaldo; Leesa B,0,6,30,30
1650627443098,MATH 142A,A01,083219,Chow; Bennett,0,16,30,30
1650627443098,MATH 142A,A02,083220,Chow; Bennett,0,15,30,30
1650627443098,MATH 142A,B01,083221,Chow; Bennett,0,14,30,30
1650627443098,MATH 142A,B02,083222,Chow; Bennett,0,13,30,30
1650627449154,MATH 193A,A01,083224,Staff,0,5,30,30
1650627449154,MATH 193A,A02,083225,Staff,0,6,30,30
1650627449154,MATH 193A,A03,083781,Staff,0,6,30,30
1650627449154,MATH 193A,A04,083782,Staff,0,7,30,30
1650627455209,MATH 197,001,091859,McAuley; Julian John,9998,0,9999,1
1650627461323,COGS 9,A01,083615,Staff,0,15,60,60
1650627467358,COGS 11,A01,083617,Boyle; Mary E. T.,18,0,40,22
1650627473388,COGS 13,A01,083071,Staff,0,38,40,40
1650627479415,COGS 14A,A01,092681,Staff,0,31,100,100
1650627485456,COGS 14B,A01,083073,Cheng; Tzu-Han,0,13,50,50
1650627491487,COGS 17,A01,092677,Staff,17,0,75,58
1650627497514,COGS 100,A01,083619,Staff,0,26,60,60
1650627503555,COGS 101A,A01,083621,Davis; Joshua Daniel,0,26,60,60
1650627509600,COGS 101B,A01,091572,Staff,0,4,60,60
1650627515742,COGS 101C,A01,083625,Delgado; Tania,15,0,30,15
1650627521799,COGS 107A,A01,083627,Boyle; Mary E. T.,1,15,60,59
1650627527838,COGS 118A,A01,083075,Staff,0,6,60,60
1650627533903,CSE 3,A50,083646,Miranda; Gregory Joseph,19,0,38,19
1650627533903,CSE 3,A51,083647,Miranda; Gregory Joseph,36,0,37,1
1650627539959,CSE 8A,A50,083650,Miranda; Gregory Joseph,0,30,40,40
1650627546010,CSE 11,A01,083080,Cao; Yingjun,0,95,40,40
1650627552056,CSE 12,A01,083652,Staff,0,19,100,100
1650627558116,CSE 15L,A01,083654,Staff,0,2,50,50
1650627558116,CSE 15L,A02,083655,Staff,0,1,50,50
1650627564166,CSE 20,A01,083657,Staff,51,0,80,29
1650627570217,CSE 30,A01,083084,Eldon; John,0,77,40,40
1650627576281,CSE 100,A01,083659,Cao; Yingjun,0,68,50,50
1650627582339,CSE 134B,A01,083661,Powell; Thomas Allan,0,35,65,65
1650627588376,CSE 140,A01,083663,Staff,0,8,75,75
1650627594433,CSE 140L,A01,083088,Eldon; John,0,16,75,75
1650627600477,CSE 175,A01,083665,Kumar; Rakesh,7,0,25,18
1650627606507,CSE 190,A00,092507,Dubnov; Shlomo,10,0,20,10
1650627612540,ECE 45,A01,083139,Staff,0,1,60,60
1650627618594,ECE 65,A50,083695,Staff,0,5,30,30
1650627624638,ECE 109,A01,091882,Touri; Behrouz,33,0,70,37
1650627630674,ECE 180,A00,083140,Abi Samra; Nicholas Camill,21,0,30,9
1650627630674,ECE 180,B00,083141,Abi Samra; Nicholas Camill,0,0,30,30
1650627636732,MATH 10A,A01,083735,Patchell; Gregory David,4,0,30,26
1650627636732,MATH 10A,A02,083736,Patchell; Gregory David,27,0,30,3
1650627636732,MATH 10A,A03,083737,Patchell; Gregory David,24,0,30,6
1650627642777,MATH 10B,A01,083207,Staff,0,8,30,30
1650627642777,MATH 10B,A02,083208,Staff,0,8,30,30
1650627642777,MATH 10B,B01,083739,Staff,11,0,30,19
1650627642777,MATH 10B,B02,083740,Staff,28,0,30,2
1650627648817,MATH 18,A01,083743,Staff,0,0,30,30
1650627648817,MATH 18,A02,083744,Staff,23,0,30,7
1650627648817,MATH 18,A03,083745,Staff,21,0,30,9
1650627648817,MATH 18,A04,083746,Staff,26,0,30,4
1650627648817,MATH 18,B01,083748,Staff,0,15,30,30
1650627648817,MATH 18,B02,083749,Staff,0,11,30,30
1650627648817,MATH 18,B03,083750,Staff,0,12,30,30
1650627648817,MATH 18,B04,083751,Staff,0,12,30,30
1650627654873,MATH 20A,A01,083754,Staff,19,0,40,21
1650627660915,MATH 20B,A01,083756,Staff,0,12,30,30
1650627660915,MATH 20B,A02,083757,Staff,0,12,30,30
1650627666943,MATH 20C,A01,083760,Staff,0,15,30,30
1650627666943,MATH 20C,A02,083761,Staff,1,13,30,29
1650627666943,MATH 20C,B01,083762,Staff,11,0,30,19
1650627666943,MATH 20C,B02,083763,Staff,28,0,30,2
1650627672980,MATH 20D,A01,083765,Staff,1,1,30,29
1650627672980,MATH 20D,A02,083766,Staff,7,0,30,23
1650627672980,MATH 20D,A03,083767,Staff,24,0,30,6
1650627679027,MATH 20E,A01,083771,Staff,3,0,30,27
1650627679027,MATH 20E,A02,083772,Staff,17,0,30,13
1650627679027,MATH 20E,B01,083773,Staff,0,0,30,30
1650627679027,MATH 20E,B02,083774,Staff,9,0,30,21
1650627685082,MATH 103A,A01,083777,Staff,0,15,30,30
1650627685082,MATH 103A,A02,083778,Staff,0,15,30,30
1650627685082,MATH 103A,B01,083779,Staff,0,14,30,30
1650627685082,MATH 103A,B02,083780,Staff,0,14,30,30
1650627691133,MATH 105,A01,085443,Staff,0,22,30,30
1650627697172,MATH 109,A01,083213,Anzaldo; Leesa B,0,6,30,30
1650627697172,MATH 109,A02,083214,Anzaldo; Leesa B,0,7,30,30
1650627697172,MATH 109,B01,083215,Anzaldo; Leesa B,0,6,30,30
1650627697172,MATH 109,B02,083216,Anzaldo; Leesa B,0,6,30,30
1650627703219,MATH 142A,A01,083219,Chow; Bennett,0,16,30,30
1650627703219,MATH 142A,A02,083220,Chow; Bennett,0,15,30,30
1650627703219,MATH 142A,B01,083221,Chow; Bennett,0,14,30,30
1650627703219,MATH 142A,B02,083222,Chow; Bennett,0,13,30,30
1650627709259,MATH 193A,A01,083224,Staff,0,5,30,30
1650627709259,MATH 193A,A02,083225,Staff,0,6,30,30
1650627709259,MATH 193A,A03,083781,Staff,0,6,30,30
1650627709259,MATH 193A,A04,083782,Staff,0,7,30,30
1650627715307,MATH 197,001,091859,McAuley; Julian John,9998,0,9999,1
1650627721449,COGS 9,A01,083615,Staff,0,15,60,60
1650627727496,COGS 11,A01,083617,Boyle; Mary E. T.,18,0,40,22
1650627733544,COGS 13,A01,083071,Staff,0,38,40,40
1650627739601,COGS 14A,A01,092681,Staff,0,31,100,100
1650627745669,COGS 14B,A01,083073,Cheng; Tzu-Han,0,13,50,50
1650627751719,COGS 17,A01,092677,Staff,17,0,75,58
1650627757747,COGS 100,A01,083619,Staff,0,26,60,60
1650627763786,COGS 101A,A01,083621,Davis; Joshua Daniel,0,26,60,60
1650627769827,COGS 101B,A01,091572,Staff,0,4,60,60
1650627775894,COGS 101C,A01,083625,Delgado; Tania,15,0,30,15
1650627781930,COGS 107A,A01,083627,Boyle; Mary E. T.,1,15,60,59
1650627787968,COGS 118A,A01,083075,Staff,0,6,60,60
1650627794024,CSE 3,A50,083646,Miranda; Gregory Joseph,19,0,38,19
1650627794024,CSE 3,A51,083647,Miranda; Gregory Joseph,36,0,37,1
1650627800051,CSE 8A,A50,083650,Miranda; Gregory Joseph,0,30,40,40
1650627806102,CSE 11,A01,083080,Cao; Yingjun,0,95,40,40
1650627812144,CSE 12,A01,083652,Staff,0,19,100,100
1650627818201,CSE 15L,A01,083654,Staff,0,2,50,50
1650627818201,CSE 15L,A02,083655,Staff,0,1,50,50
1650627824233,CSE 20,A01,083657,Staff,51,0,80,29
1650627830300,CSE 30,A01,083084,Eldon; John,0,77,40,40
1650627836345,CSE 100,A01,083659,Cao; Yingjun,0,68,50,50
1650627842408,CSE 134B,A01,083661,Powell; Thomas Allan,0,35,65,65
1650627848450,CSE 140,A01,083663,Staff,0,8,75,75
1650627854520,CSE 140L,A01,083088,Eldon; John,0,16,75,75
1650627860576,CSE 175,A01,083665,Kumar; Rakesh,7,0,25,18
1650627866657,CSE 190,A00,092507,Dubnov; Shlomo,10,0,20,10
1650627872690,ECE 45,A01,083139,Staff,0,1,60,60
1650627878763,ECE 65,A50,083695,Staff,0,5,30,30
1650627884803,ECE 109,A01,091882,Touri; Behrouz,33,0,70,37
1650627890846,ECE 180,A00,083140,Abi Samra; Nicholas Camill,21,0,30,9
1650627890846,ECE 180,B00,083141,Abi Samra; Nicholas Camill,0,0,30,30
1650627896909,MATH 10A,A01,083735,Patchell; Gregory David,4,0,30,26
1650627896909,MATH 10A,A02,083736,Patchell; Gregory David,27,0,30,3
1650627896909,MATH 10A,A03,083737,Patchell; Gregory David,24,0,30,6
1650627902950,MATH 10B,A01,083207,Staff,0,8,30,30
1650627902950,MATH 10B,A02,083208,Staff,0,8,30,30
1650627902950,MATH 10B,B01,083739,Staff,11,0,30,19
1650627902950,MATH 10B,B02,083740,Staff,28,0,30,2
1650627909012,MATH 18,A01,083743,Staff,0,0,30,30
1650627909012,MATH 18,A02,083744,Staff,23,0,30,7
1650627909012,MATH 18,A03,083745,Staff,21,0,30,9
1650627909012,MATH 18,A04,083746,Staff,26,0,30,4
1650627909012,MATH 18,B01,083748,Staff,0,15,30,30
1650627909012,MATH 18,B02,083749,Staff,0,11,30,30
1650627909012,MATH 18,B03,083750,Staff,0,12,30,30
1650627909012,MATH 18,B04,083751,Staff,0,12,30,30
1650627915058,MATH 20A,A01,083754,Staff,19,0,40,21
1650627921102,MATH 20B,A01,083756,Staff,0,12,30,30
1650627921102,MATH 20B,A02,083757,Staff,0,12,30,30
1650627927133,MATH 20C,A01,083760,Staff,0,15,30,30
1650627927133,MATH 20C,A02,083761,Staff,1,13,30,29
1650627927133,MATH 20C,B01,083762,Staff,11,0,30,19
1650627927133,MATH 20C,B02,083763,Staff,28,0,30,2
1650627933191,MATH 20D,A01,083765,Staff,1,1,30,29
1650627933191,MATH 20D,A02,083766,Staff,7,0,30,23
1650627933191,MATH 20D,A03,083767,Staff,24,0,30,6
1650627939245,MATH 20E,A01,083771,Staff,3,0,30,27
1650627939245,MATH 20E,A02,083772,Staff,17,0,30,13
1650627939245,MATH 20E,B01,083773,Staff,0,0,30,30
1650627939245,MATH 20E,B02,083774,Staff,9,0,30,21
1650627945294,MATH 103A,A01,083777,Staff,0,15,30,30
1650627945294,MATH 103A,A02,083778,Staff,0,15,30,30
1650627945294,MATH 103A,B01,083779,Staff,0,14,30,30
1650627945294,MATH 103A,B02,083780,Staff,0,14,30,30
1650627951346,MATH 105,A01,085443,Staff,0,22,30,30
1650627957376,MATH 109,A01,083213,Anzaldo; Leesa B,0,6,30,30
1650627957376,MATH 109,A02,083214,Anzaldo; Leesa B,0,7,30,30
1650627957376,MATH 109,B01,083215,Anzaldo; Leesa B,0,6,30,30
1650627957376,MATH 109,B02,083216,Anzaldo; Leesa B,0,6,30,30
1650627963421,MATH 142A,A01,083219,Chow; Bennett,0,16,30,30
1650627963421,MATH 142A,A02,083220,Chow; Bennett,0,15,30,30
1650627963421,MATH 142A,B01,083221,Chow; Bennett,0,14,30,30
1650627963421,MATH 142A,B02,083222,Chow; Bennett,0,13,30,30
1650627969471,MATH 193A,A01,083224,Staff,0,5,30,30
1650627969471,MATH 193A,A02,083225,Staff,0,6,30,30
1650627969471,MATH 193A,A03,083781,Staff,0,6,30,30
1650627969471,MATH 193A,A04,083782,Staff,0,7,30,30
1650627975517,MATH 197,001,091859,McAuley; Julian John,9998,0,9999,1
1650627981610,COGS 9,A01,083615,Staff,0,15,60,60
1650627987648,COGS 11,A01,083617,Boyle; Mary E. T.,18,0,40,22
1650627993699,COGS 13,A01,083071,Staff,0,38,40,40
1650627999728,COGS 14A,A01,092681,Staff,0,31,100,100
1650628005775,COGS 14B,A01,083073,Cheng; Tzu-Han,0,13,50,50
1650628011812,COGS 17,A01,092677,Staff,17,0,75,58
1650628017860,COGS 100,A01,083619,Staff,0,26,60,60
1650628023895,COGS 101A,A01,083621,Davis; Joshua Daniel,0,26,60,60
1650628029941,COGS 101B,A01,091572,Staff,0,4,60,60
1650628035995,COGS 101C,A01,083625,Delgado; Tania,15,0,30,15
1650628042037,COGS 107A,A01,083627,Boyle; Mary E. T.,1,15,60,59
1650628048091,COGS 118A,A01,083075,Staff,0,6,60,60
1650628054132,CSE 3,A50,083646,Miranda; Gregory Joseph,19,0,38,19
1650628054132,CSE 3,A51,083647,Miranda; Gregory Joseph,36,0,37,1
1650628060175,CSE 8A,A50,083650,Miranda; Gregory Joseph,0,30,40,40
1650628066218,CSE 11,A01,083080,Cao; Yingjun,0,95,40,40
1650628072269,CSE 12,A01,083652,Staff,0,19,100,100
1650628078316,CSE 15L,A01,083654,Staff,0,2,50,50
1650628078316,CSE 15L,A02,083655,Staff,0,1,50,50
1650628084342,CSE 20,A01,083657,Staff,51,0,80,29
1650628090389,CSE 30,A01,083084,Eldon; John,0,77,40,40
1650628096425,CSE 100,A01,083659,Cao; Yingjun,0,68,50,50
1650628102481,CSE 134B,A01,083661,Powell; Thomas Allan,0,35,65,65
1650628108513,CSE 140,A01,083663,Staff,0,8,75,75
1650628114646,CSE 140L,A01,083088,Eldon; John,0,16,75,75
1650628120697,CSE 175,A01,083665,Kumar; Rakesh,7,0,25,18
1650628126733,CSE 190,A00,092507,Dubnov; Shlomo,10,0,20,10
1650628132765,ECE 45,A01,083139,Staff,0,1,60,60
1650628138798,ECE 65,A50,083695,Staff,0,5,30,30
1650628144844,ECE 109,A01,091882,Touri; Behrouz,33,0,70,37
1650628150901,ECE 180,A00,083140,Abi Samra; Nicholas Camill,21,0,30,9
1650628150901,ECE 180,B00,083141,Abi Samra; Nicholas Camill,0,0,30,30
1650628156955,MATH 10A,A01,083735,Patchell; Gregory David,4,0,30,26
1650628156955,MATH 10A,A02,083736,Patchell; Gregory David,27,0,30,3
1650628156955,MATH 10A,A03,083737,Patchell; Gregory David,24,0,30,6
1650628163001,MATH 10B,A01,083207,Staff,0,8,30,30
1650628163001,MATH 10B,A02,083208,Staff,0,8,30,30
1650628163001,MATH 10B,B01,083739,Staff,11,0,30,19
1650628163001,MATH 10B,B02,083740,Staff,28,0,30,2
1650628169047,MATH 18,A01,083743,Staff,0,0,30,30
1650628169047,MATH 18,A02,083744,Staff,23,0,30,7
1650628169047,MATH 18,A03,083745,Staff,21,0,30,9
1650628169047,MATH 18,A04,083746,Staff,26,0,30,4
1650628169047,MATH 18,B01,083748,Staff,0,15,30,30
1650628169047,MATH 18,B02,083749,Staff,0,11,30,30
1650628169047,MATH 18,B03,083750,Staff,0,12,30,30
1650628169047,MATH 18,B04,083751,Staff,0,12,30,30
1650628175090,MATH 20A,A01,083754,Staff,19,0,40,21
1650628181134,MATH 20B,A01,083756,Staff,0,12,30,30
1650628181134,MATH 20B,A02,083757,Staff,0,12,30,30
1650628187169,MATH 20C,A01,083760,Staff,0,15,30,30
1650628187169,MATH 20C,A02,083761,Staff,1,13,30,29
1650628187169,MATH 20C,B01,083762,Staff,11,0,30,19
1650628187169,MATH 20C,B02,083763,Staff,28,0,30,2
1650628193217,MATH 20D,A01,083765,Staff,1,1,30,29
1650628193217,MATH 20D,A02,083766,Staff,7,0,30,23
1650628193217,MATH 20D,A03,083767,Staff,24,0,30,6
1650628199264,MATH 20E,A01,083771,Staff,3,0,30,27
1650628199264,MATH 20E,A02,083772,Staff,17,0,30,13
1650628199264,MATH 20E,B01,083773,Staff,0,0,30,30
1650628199264,MATH 20E,B02,083774,Staff,9,0,30,21
1650628205319,MATH 103A,A01,083777,Staff,0,15,30,30
1650628205319,MATH 103A,A02,083778,Staff,0,15,30,30
1650628205319,MATH 103A,B01,083779,Staff,0,14,30,30
1650628205319,MATH 103A,B02,083780,Staff,0,14,30,30
1650628211359,MATH 105,A01,085443,Staff,0,22,30,30
1650628217402,MATH 109,A01,083213,Anzaldo; Leesa B,0,6,30,30
1650628217402,MATH 109,A02,083214,Anzaldo; Leesa B,0,7,30,30
1650628217402,MATH 109,B01,083215,Anzaldo; Leesa B,0,6,30,30
1650628217402,MATH 109,B02,083216,Anzaldo; Leesa B,0,6,30,30
1650628223442,MATH 142A,A01,083219,Chow; Bennett,0,16,30,30
1650628223442,MATH 142A,A02,083220,Chow; Bennett,0,15,30,30
1650628223442,MATH 142A,B01,083221,Chow; Bennett,0,14,30,30
1650628223442,MATH 142A,B02,083222,Chow; Bennett,0,13,30,30
1650628229504,MATH 193A,A01,083224,Staff,0,5,30,30
1650628229504,MATH 193A,A02,083225,Staff,0,6,30,30
1650628229504,MATH 193A,A03,083781,Staff,0,6,30,30
1650628229504,MATH 193A,A04,083782,Staff,0,7,30,30
1650628235561,MATH 197,001,091859,McAuley; Julian John,9998,0,9999,1
1650628241704,COGS 9,A01,083615,Staff,0,15,60,60
1650628247760,COGS 11,A01,083617,Boyle; Mary E. T.,18,0,40,22
1650628253808,COGS 13,A01,083071,Staff,0,38,40,40
1650628259842,COGS 14A,A01,092681,Staff,0,31,100,100
1650628265884,COGS 14B,A01,083073,Cheng; Tzu-Han,0,13,50,50
1650628271923,COGS 17,A01,092677,Staff,17,0,75,58
1650628277972,COGS 100,A01,083619,Staff,0,26,60,60
1650628284016,COGS 101A,A01,083621,Davis; Joshua Daniel,0,26,60,60
1650628290082,COGS 101B,A01,091572,Staff,0,4,60,60
1650628296129,COGS 101C,A01,083625,Delgado; Tania,15,0,30,15
1650628302177,COGS 107A,A01,083627,Boyle; Mary E. T.,1,15,60,59
1650628308206,COGS 118A,A01,083075,Staff,0,6,60,60
1650628314244,CSE 3,A50,083646,Miranda; Gregory Joseph,19,0,38,19
1650628314244,CSE 3,A51,083647,Miranda; Gregory Joseph,36,0,37,1
1650628320290,CSE 8A,A50,083650,Miranda; Gregory Joseph,0,30,40,40
1650628326326,CSE 11,A01,083080,Cao; Yingjun,0,95,40,40
1650628332362,CSE 12,A01,083652,Staff,0,19,100,100
1650628338412,CSE 15L,A01,083654,Staff,0,2,50,50
1650628338412,CSE 15L,A02,083655,Staff,0,1,50,50
1650628344459,CSE 20,A01,083657,Staff,51,0,80,29
1650628350498,CSE 30,A01,083084,Eldon; John,0,77,40,40
1650628356563,CSE 100,A01,083659,Cao; Yingjun,0,68,50,50
1650628362591,CSE 134B,A01,083661,Powell; Thomas Allan,0,35,65,65
1650628368649,CSE 140,A01,083663,Staff,0,8,75,75
1650628374681,CSE 140L,A01,083088,Eldon; John,0,16,75,75
1650628380727,CSE 175,A01,083665,Kumar; Rakesh,7,0,25,18
1650628386766,CSE 190,A00,092507,Dubnov; Shlomo,10,0,20,10
1650628392813,ECE 45,A01,083139,Staff,0,1,60,60
1650628398865,ECE 65,A50,083695,Staff,0,5,30,30
1650628404898,ECE 109,A01,091882,Touri; Behrouz,33,0,70,37
1650628410951,ECE 180,A00,083140,Abi Samra; Nicholas Camill,21,0,30,9
1650628410951,ECE 180,B00,083141,Abi Samra; Nicholas Camill,0,0,30,30
1650628416990,MATH 10A,A01,083735,Patchell; Gregory David,4,0,30,26
1650628416990,MATH 10A,A02,083736,Patchell; Gregory David,27,0,30,3
1650628416990,MATH 10A,A03,083737,Patchell; Gregory David,24,0,30,6
1650628423040,MATH 10B,A01,083207,Staff,0,8,30,30
1650628423040,MATH 10B,A02,083208,Staff,0,8,30,30
1650628423040,MATH 10B,B01,083739,Staff,11,0,30,19
1650628423040,MATH 10B,B02,083740,Staff,28,0,30,2
1650628429079,MATH 18,A01,083743,Staff,0,0,30,30
1650628429079,MATH 18,A02,083744,Staff,23,0,30,7
1650628429079,MATH 18,A03,083745,Staff,21,0,30,9
1650628429079,MATH 18,A04,083746,Staff,26,0,30,4
1650628429079,MATH 18,B01,083748,Staff,0,15,30,30
1650628429079,MATH 18,B02,083749,Staff,0,11,30,30
1650628429079,MATH 18,B03,083750,Staff,0,12,30,30
1650628429079,MATH 18,B04,083751,Staff,0,12,30,30
1650628435121,MATH 20A,A01,083754,Staff,19,0,40,21
1650628441165,MATH 20B,A01,083756,Staff,0,12,30,30
1650628441165,MATH 20B,A02,083757,Staff,0,12,30,30
1650628447213,MATH 20C,A01,083760,Staff,0,15,30,30
1650628447213,MATH 20C,A02,083761,Staff,1,13,30,29
1650628447213,MATH 20C,B01,083762,Staff,11,0,30,19
1650628447213,MATH 20C,B02,083763,Staff,28,0,30,2
1650628453265,MATH 20D,A01,083765,Staff,1,1,30,29
1650628453265,MATH 20D,A02,083766,Staff,7,0,30,23
1650628453265,MATH 20D,A03,083767,Staff,24,0,30,6
1650628459318,MATH 20E,A01,083771,Staff,3,0,30,27
1650628459318,MATH 20E,A02,083772,Staff,17,0,30,13
1650628459318,MATH 20E,B01,083773,Staff,0,0,30,30
1650628459318,MATH 20E,B02,083774,Staff,9,0,30,21
1650628465365,MATH 103A,A01,083777,Staff,0,15,30,30
1650628465365,MATH 103A,A02,083778,Staff,0,15,30,30
1650628465365,MATH 103A,B01,083779,Staff,0,14,30,30
1650628465365,MATH 103A,B02,083780,Staff,0,14,30,30
1650628471405,MATH 105,A01,085443,Staff,0,22,30,30
1650628477450,MATH 109,A01,083213,Anzaldo; Leesa B,0,6,30,30
1650628477450,MATH 109,A02,083214,Anzaldo; Leesa B,0,7,30,30
1650628477450,MATH 109,B01,083215,Anzaldo; Leesa B,0,6,30,30
1650628477450,MATH 109,B02,083216,Anzaldo; Leesa B,0,6,30,30
1650628483478,MATH 142A,A01,083219,Chow; Bennett,0,16,30,30
1650628483478,MATH 142A,A02,083220,Chow; Bennett,0,15,30,30
1650628483478,MATH 142A,B01,083221,Chow; Bennett,0,14,30,30
1650628483478,MATH 142A,B02,083222,Chow; Bennett,0,13,30,30
1650628489503,MATH 193A,A01,083224,Staff,0,5,30,30
1650628489503,MATH 193A,A02,083225,Staff,0,6,30,30
1650628489503,MATH 193A,A03,083781,Staff,0,6,30,30
1650628489503,MATH 193A,A04,083782,Staff,0,7,30,30
1650628495551,MATH 197,001,091859,McAuley; Julian John,9998,0,9999,1
1650628501661,COGS 9,A01,083615,Staff,0,15,60,60
1650628507704,COGS 11,A01,083617,Boyle; Mary E. T.,18,0,40,22
1650628513759,COGS 13,A01,083071,Staff,0,38,40,40
1650628519796,COGS 14A,A01,092681,Staff,0,31,100,100
1650628525837,COGS 14B,A01,083073,Cheng; Tzu-Han,0,13,50,50
1650628531876,COGS 17,A01,092677,Staff,17,0,75,58
1650628537917,COGS 100,A01,083619,Staff,0,26,60,60
1650628543979,COGS 101A,A01,083621,Davis; Joshua Daniel,0,26,60,60
1650628550041,COGS 101B,A01,091572,Staff,0,4,60,60
1650628556078,COGS 101C,A01,083625,Delgado; Tania,15,0,30,15
1650628562143,COGS 107A,A01,083627,Boyle; Mary E. T.,1,15,60,59
1650628568193,COGS 118A,A01,083075,Staff,0,6,60,60
1650628574232,CSE 3,A50,083646,Miranda; Gregory Joseph,19,0,38,19
1650628574232,CSE 3,A51,083647,Miranda; Gregory Joseph,36,0,37,1
1650628580293,CSE 8A,A50,083650,Miranda; Gregory Joseph,0,30,40,40
1650628586349,CSE 11,A01,083080,Cao; Yingjun,0,95,40,40
1650628592392,CSE 12,A01,083652,Staff,0,19,100,100
1650628598418,CSE 15L,A01,083654,Staff,0,2,50,50
1650628598418,CSE 15L,A02,083655,Staff,0,1,50,50
1650628604456,CSE 20,A01,083657,Staff,51,0,80,29
1650628610491,CSE 30,A01,083084,Eldon; John,0,77,40,40
1650628616516,CSE 100,A01,083659,Cao; Yingjun,0,68,50,50
1650628622547,CSE 134B,A01,083661,Powell; Thomas Allan,0,35,65,65
1650628628606,CSE 140,A01,083663,Staff,0,8,75,75
1650628634649,CSE 140L,A01,083088,Eldon; John,0,16,75,75
1650628640691,CSE 175,A01,083665,Kumar; Rakesh,7,0,25,18
1650628646730,CSE 190,A00,092507,Dubnov; Shlomo,10,0,20,10
1650628652768,ECE 45,A01,083139,Staff,0,1,60,60
1650628658822,ECE 65,A50,083695,Staff,0,5,30,30
1650628664885,ECE 109,A01,091882,Touri; Behrouz,33,0,70,37
1650628670913,ECE 180,A00,083140,Abi Samra; Nicholas Camill,21,0,30,9
1650628670913,ECE 180,B00,083141,Abi Samra; Nicholas Camill,0,0,30,30
1650628676963,MATH 10A,A01,083735,Patchell; Gregory David,4,0,30,26
1650628676963,MATH 10A,A02,083736,Patchell; Gregory David,27,0,30,3
1650628676963,MATH 10A,A03,083737,Patchell; Gregory David,24,0,30,6
1650628683017,MATH 10B,A01,083207,Staff,0,8,30,30
1650628683017,MATH 10B,A02,083208,Staff,0,8,30,30
1650628683017,MATH 10B,B01,083739,Staff,11,0,30,19
1650628683017,MATH 10B,B02,083740,Staff,28,0,30,2
1650628689056,MATH 18,A01,083743,Staff,0,0,30,30
1650628689056,MATH 18,A02,083744,Staff,23,0,30,7
1650628689056,MATH 18,A03,083745,Staff,21,0,30,9
1650628689056,MATH 18,A04,083746,Staff,26,0,30,4
1650628689056,MATH 18,B01,083748,Staff,0,15,30,30
1650628689056,MATH 18,B02,083749,Staff,0,11,30,30
1650628689056,MATH 18,B03,083750,Staff,0,12,30,30
1650628689056,MATH 18,B04,083751,Staff,0,12,30,30
1650628695106,MATH 20A,A01,083754,Staff,19,0,40,21
1650628701146,MATH 20B,A01,083756,Staff,0,12,30,30
1650628701146,MATH 20B,A02,083757,Staff,0,12,30,30
1650628707175,MATH 20C,A01,083760,Staff,0,15,30,30
1650628707175,MATH 20C,A02,083761,Staff,1,13,30,29
1650628707175,MATH 20C,B01,083762,Staff,11,0,30,19
1650628707175,MATH 20C,B02,083763,Staff,28,0,30,2
1650628713354,MATH 20D,A01,083765,Staff,1,1,30,29
1650628713354,MATH 20D,A02,083766,Staff,7,0,30,23
1650628713354,MATH 20D,A03,083767,Staff,24,0,30,6
1650628719394,MATH 20E,A01,083771,Staff,3,0,30,27
1650628719394,MATH 20E,A02,083772,Staff,17,0,30,13
1650628719394,MATH 20E,B01,083773,Staff,0,0,30,30
1650628719394,MATH 20E,B02,083774,Staff,9,0,30,21
1650628725449,MATH 103A,A01,083777,Staff,0,15,30,30
1650628725449,MATH 103A,A02,083778,Staff,0,15,30,30
1650628725449,MATH 103A,B01,083779,Staff,0,14,30,30
1650628725449,MATH 103A,B02,083780,Staff,0,14,30,30
1650628731495,MATH 105,A01,085443,Staff,0,22,30,30
1650628737549,MATH 109,A01,083213,Anzaldo; Leesa B,0,6,30,30
1650628737549,MATH 109,A02,083214,Anzaldo; Leesa B,0,7,30,30
1650628737549,MATH 109,B01,083215,Anzaldo; Leesa B,0,6,30,30
1650628737549,MATH 109,B02,083216,Anzaldo; Leesa B,0,6,30,30
1650628743616,MATH 142A,A01,083219,Chow; Bennett,0,16,30,30
1650628743616,MATH 142A,A02,083220,Chow; Bennett,0,15,30,30
1650628743616,MATH 142A,B01,083221,Chow; Bennett,0,14,30,30
1650628743616,MATH 142A,B02,083222,Chow; Bennett,0,13,30,30
1650628749662,MATH 193A,A01,083224,Staff,0,5,30,30
1650628749662,MATH 193A,A02,083225,Staff,0,6,30,30
1650628749662,MATH 193A,A03,083781,Staff,0,6,30,30
1650628749662,MATH 193A,A04,083782,Staff,0,7,30,30
1650628755715,MATH 197,001,091859,McAuley; Julian John,9998,0,9999,1
1650628761805,COGS 9,A01,083615,Staff,0,15,60,60
1650628767846,COGS 11,A01,083617,Boyle; Mary E. T.,18,0,40,22
1650628773898,COGS 13,A01,083071,Staff,0,38,40,40
1650628779940,COGS 14A,A01,092681,Staff,0,31,100,100
1650628785992,COGS 14B,A01,083073,Cheng; Tzu-Han,0,13,50,50
1650628792051,COGS 17,A01,092677,Staff,17,0,75,58
1650628798092,COGS 100,A01,083619,Staff,0,26,60,60
1650628804140,COGS 101A,A01,083621,Davis; Joshua Daniel,0,26,60,60
1650628810171,COGS 101B,A01,091572,Staff,0,4,60,60
1650628816205,COGS 101C,A01,083625,Delgado; Tania,15,0,30,15
1650628822238,COGS 107A,A01,083627,Boyle; Mary E. T.,1,15,60,59
1650628828267,COGS 118A,A01,083075,Staff,0,6,60,60
1650628834306,CSE 3,A50,083646,Miranda; Gregory Joseph,19,0,38,19
1650628834306,CSE 3,A51,083647,Miranda; Gregory Joseph,36,0,37,1
1650628840347,CSE 8A,A50,083650,Miranda; Gregory Joseph,0,30,40,40
1650628846404,CSE 11,A01,083080,Cao; Yingjun,0,95,40,40
1650628852463,CSE 12,A01,083652,Staff,0,19,100,100
1650628858494,CSE 15L,A01,083654,Staff,0,2,50,50
1650628858494,CSE 15L,A02,083655,Staff,0,1,50,50
1650628864537,CSE 20,A01,083657,Staff,51,0,80,29
1650628870591,CSE 30,A01,083084,Eldon; John,0,77,40,40
1650628876628,CSE 100,A01,083659,Cao; Yingjun,0,68,50,50
1650628882661,CSE 134B,A01,083661,Powell; Thomas Allan,0,35,65,65
1650628888736,CSE 140,A01,083663,Staff,0,8,75,75
1650628894787,CSE 140L,A01,083088,Eldon; John,0,16,75,75
1650628900862,CSE 175,A01,083665,Kumar; Rakesh,7,0,25,18
1650628906905,CSE 190,A00,092507,Dubnov; Shlomo,10,0,20,10
1650628912957,ECE 45,A01,083139,Staff,0,1,60,60
1650628919014,ECE 65,A50,083695,Staff,0,5,30,30
1650628925065,ECE 109,A01,091882,Touri; Behrouz,33,0,70,37
1650628931109,ECE 180,A00,083140,Abi Samra; Nicholas Camill,21,0,30,9
1650628931109,ECE 180,B00,083141,Abi Samra; Nicholas Camill,0,0,30,30
1650628937165,MATH 10A,A01,083735,Patchell; Gregory David,4,0,30,26
1650628937165,MATH 10A,A02,083736,Patchell; Gregory David,27,0,30,3
1650628937165,MATH 10A,A03,083737,Patchell; Gregory David,24,0,30,6
1650628943202,MATH 10B,A01,083207,Staff,0,8,30,30
1650628943202,MATH 10B,A02,083208,Staff,0,8,30,30
1650628943202,MATH 10B,B01,083739,Staff,11,0,30,19
1650628943202,MATH 10B,B02,083740,Staff,28,0,30,2
1650628949261,MATH 18,A01,083743,Staff,0,0,30,30
1650628949261,MATH 18,A02,083744,Staff,23,0,30,7
1650628949261,MATH 18,A03,083745,Staff,21,0,30,9
1650628949261,MATH 18,A04,083746,Staff,26,0,30,4
1650628949261,MATH 18,B01,083748,Staff,0,15,30,30
1650628949261,MATH 18,B02,083749,Staff,0,11,30,30
1650628949261,MATH 18,B03,083750,Staff,0,12,30,30
1650628949261,MATH 18,B04,083751,Staff,0,12,30,30
1650628955321,MATH 20A,A01,083754,Staff,19,0,40,21
1650628961351,MATH 20B,A01,083756,Staff,0,12,30,30
1650628961351,MATH 20B,A02,083757,Staff,0,12,30,30
1650628967463,MATH 20C,A01,083760,Staff,0,15,30,30
1650628967463,MATH 20C,A02,083761,Staff,1,13,30,29
1650628967463,MATH 20C,B01,083762,Staff,11,0,30,19
1650628967463,MATH 20C,B02,083763,Staff,28,0,30,2
1650628973493,MATH 20D,A01,083765,Staff,1,1,30,29
1650628973493,MATH 20D,A02,083766,Staff,7,0,30,23
1650628973493,MATH 20D,A03,083767,Staff,24,0,30,6
1650628979541,MATH 20E,A01,083771,Staff,3,0,30,27
1650628979541,MATH 20E,A02,083772,Staff,17,0,30,13
1650628979541,MATH 20E,B01,083773,Staff,0,0,30,30
1650628979541,MATH 20E,B02,083774,Staff,9,0,30,21
1650628985588,MATH 103A,A01,083777,Staff,0,15,30,30
1650628985588,MATH 103A,A02,083778,Staff,0,15,30,30
1650628985588,MATH 103A,B01,083779,Staff,0,14,30,30
1650628985588,MATH 103A,B02,083780,Staff,0,14,30,30
1650628991631,MATH 105,A01,085443,Staff,0,22,30,30
1650628997680,MATH 109,A01,083213,Anzaldo; Leesa B,0,6,30,30
1650628997680,MATH 109,A02,083214,Anzaldo; Leesa B,0,7,30,30
1650628997680,MATH 109,B01,083215,Anzaldo; Leesa B,0,6,30,30
1650628997680,MATH 109,B02,083216,Anzaldo; Leesa B,0,6,30,30
1650629003737,MATH 142A,A01,083219,Chow; Bennett,0,16,30,30
1650629003737,MATH 142A,A02,083220,Chow; Bennett,0,15,30,30
1650629003737,MATH 142A,B01,083221,Chow; Bennett,0,14,30,30
1650629003737,MATH 142A,B02,083222,Chow; Bennett,0,13,30,30
1650629009793,MATH 193A,A01,083224,Staff,0,5,30,30
1650629009793,MATH 193A,A02,083225,Staff,0,6,30,30
1650629009793,MATH 193A,A03,083781,Staff,0,6,30,30
1650629009793,MATH 193A,A04,083782,Staff,0,7,30,30
1650629015848,MATH 197,001,091859,McAuley; Julian John,9998,0,9999,1
1650629021947,COGS 9,A01,083615,Staff,0,15,60,60
1650629027984,COGS 11,A01,083617,Boyle; Mary E. T.,18,0,40,22
1650629034037,COGS 13,A01,083071,Staff,0,38,40,40
1650629040067,COGS 14A,A01,092681,Staff,0,31,100,100
1650629046102,COGS 14B,A01,083073,Cheng; Tzu-Han,0,13,50,50
1650629052148,COGS 17,A01,092677,Staff,17,0,75,58
1650629058197,COGS 100,A01,083619,Staff,0,26,60,60
1650629064239,COGS 101A,A01,083621,Davis; Joshua Daniel,0,26,60,60
1650629070275,COGS 101B,A01,091572,Staff,0,4,60,60
1650629076317,COGS 101C,A01,083625,Delgado; Tania,15,0,30,15
1650629082363,COGS 107A,A01,083627,Boyle; Mary E. T.,1,15,60,59
1650629088409,COGS 118A,A01,083075,Staff,0,6,60,60
1650629094456,CSE 3,A50,083646,Miranda; Gregory Joseph,19,0,38,19
1650629094456,CSE 3,A51,083647,Miranda; Gregory Joseph,36,0,37,1
1650629100490,CSE 8A,A50,083650,Miranda; Gregory Joseph,0,30,40,40
1650629106535,CSE 11,A01,083080,Cao; Yingjun,0,95,40,40
1650629112586,CSE 12,A01,083652,Staff,0,19,100,100
1650629118632,CSE 15L,A01,083654,Staff,0,2,50,50
1650629118632,CSE 15L,A02,083655,Staff,0,1,50,50
1650629124685,CSE 20,A01,083657,Staff,51,0,80,29
1650629130736,CSE 30,A01,083084,Eldon; John,0,77,40,40
1650629136785,CSE 100,A01,083659,Cao; Yingjun,0,68,50,50
1650629142817,CSE 134B,A01,083661,Powell; Thomas Allan,0,35,65,65
1650629148876,CSE 140,A01,083663,Staff,0,8,75,75
1650629154920,CSE 140L,A01,083088,Eldon; John,0,16,75,75
1650629160972,CSE 175,A01,083665,Kumar; Rakesh,7,0,25,18
1650629167038,CSE 190,A00,092507,Dubnov; Shlomo,10,0,20,10
1650629173110,ECE 45,A01,083139,Staff,0,1,60,60
1650629179176,ECE 65,A50,083695,Staff,0,5,30,30
1650629185210,ECE 109,A01,091882,Touri; Behrouz,33,0,70,37
1650629191257,ECE 180,A00,083140,Abi Samra; Nicholas Camill,21,0,30,9
1650629191257,ECE 180,B00,083141,Abi Samra; Nicholas Camill,0,0,30,30
1650629197323,MATH 10A,A01,083735,Patchell; Gregory David,4,0,30,26
1650629197323,MATH 10A,A02,083736,Patchell; Gregory David,27,0,30,3
1650629197323,MATH 10A,A03,083737,Patchell; Gregory David,24,0,30,6
1650629203369,MATH 10B,A01,083207,Staff,0,8,30,30
1650629203369,MATH 10B,A02,083208,Staff,0,8,30,30
1650629203369,MATH 10B,B01,083739,Staff,11,0,30,19
1650629203369,MATH 10B,B02,083740,Staff,28,0,30,2
1650629209425,MATH 18,A01,083743,Staff,0,0,30,30
1650629209425,MATH 18,A02,083744,Staff,23,0,30,7
1650629209425,MATH 18,A03,083745,Staff,21,0,30,9
1650629209425,MATH 18,A04,083746,Staff,26,0,30,4
1650629209425,MATH 18,B01,083748,Staff,0,15,30,30
1650629209425,MATH 18,B02,083749,Staff,0,11,30,30
1650629209425,MATH 18,B03,083750,Staff,0,12,30,30
1650629209425,MATH 18,B04,083751,Staff,0,12,30,30
1650629215468,MATH 20A,A01,083754,Staff,19,0,40,21
1650629221520,MATH 20B,A01,083756,Staff,0,12,30,30
1650629221520,MATH 20B,A02,083757,Staff,0,12,30,30
1650629227577,MATH 20C,A01,083760,Staff,0,15,30,30
1650629227577,MATH 20C,A02,083761,Staff,1,13,30,29
1650629227577,MATH 20C,B01,083762,Staff,11,0,30,19
1650629227577,MATH 20C,B02,083763,Staff,28,0,30,2
1650629233625,MATH 20D,A01,083765,Staff,1,1,30,29
1650629233625,MATH 20D,A02,083766,Staff,7,0,30,23
1650629233625,MATH 20D,A03,083767,Staff,24,0,30,6
1650629239656,MATH 20E,A01,083771,Staff,3,0,30,27
1650629239656,MATH 20E,A02,083772,Staff,17,0,30,13
1650629239656,MATH 20E,B01,083773,Staff,0,0,30,30
1650629239656,MATH 20E,B02,083774,Staff,9,0,30,21
1650629245735,MATH 103A,A01,083777,Staff,0,15,30,30
1650629245735,MATH 103A,A02,083778,Staff,0,15,30,30
1650629245735,MATH 103A,B01,083779,Staff,0,14,30,30
1650629245735,MATH 103A,B02,083780,Staff,0,14,30,30
1650629251778,MATH 105,A01,085443,Staff,0,22,30,30
1650629257822,MATH 109,A01,083213,Anzaldo; Leesa B,0,6,30,30
1650629257822,MATH 109,A02,083214,Anzaldo; Leesa B,0,7,30,30
1650629257822,MATH 109,B01,083215,Anzaldo; Leesa B,0,6,30,30
1650629257822,MATH 109,B02,083216,Anzaldo; Leesa B,0,6,30,30
1650629263852,MATH 142A,A01,083219,Chow; Bennett,0,16,30,30
1650629263852,MATH 142A,A02,083220,Chow; Bennett,0,15,30,30
1650629263852,MATH 142A,B01,083221,Chow; Bennett,0,14,30,30
1650629263852,MATH 142A,B02,083222,Chow; Bennett,0,13,30,30
1650629269907,MATH 193A,A01,083224,Staff,0,5,30,30
1650629269907,MATH 193A,A02,083225,Staff,0,6,30,30
1650629269907,MATH 193A,A03,083781,Staff,0,6,30,30
1650629269907,MATH 193A,A04,083782,Staff,0,7,30,30
1650629275968,MATH 197,001,091859,McAuley; Julian John,9998,0,9999,1
1650629282089,COGS 9,A01,083615,Staff,0,15,60,60
1650629288134,COGS 11,A01,083617,Boyle; Mary E. T.,18,0,40,22
1650629294174,COGS 13,A01,083071,Staff,0,38,40,40
1650629300209,COGS 14A,A01,092681,Staff,0,31,100,100
1650629306396,COGS 14B,A01,083073,Cheng; Tzu-Han,0,13,50,50
1650629312455,COGS 17,A01,092677,Staff,17,0,75,58
1650629318495,COGS 100,A01,083619,Staff,0,26,60,60
1650629324562,COGS 101A,A01,083621,Davis; Joshua Daniel,0,26,60,60
1650629330602,COGS 101B,A01,091572,Staff,0,4,60,60
1650629336643,COGS 101C,A01,083625,Delgado; Tania,15,0,30,15
1650629342697,COGS 107A,A01,083627,Boyle; Mary E. T.,1,15,60,59
1650629348727,COGS 118A,A01,083075,Staff,0,6,60,60
1650629354772,CSE 3,A50,083646,Miranda; Gregory Joseph,19,0,38,19
1650629354772,CSE 3,A51,083647,Miranda; Gregory Joseph,36,0,37,1
1650629360810,CSE 8A,A50,083650,Miranda; Gregory Joseph,0,30,40,40
1650629366860,CSE 11,A01,083080,Cao; Yingjun,0,95,40,40
1650629372899,CSE 12,A01,083652,Staff,0,19,100,100
1650629378928,CSE 15L,A01,083654,Staff,0,2,50,50
1650629378928,CSE 15L,A02,083655,Staff,0,1,50,50
1650629384976,CSE 20,A01,083657,Staff,51,0,80,29
1650629391039,CSE 30,A01,083084,Eldon; John,0,77,40,40
1650629397087,CSE 100,A01,083659,Cao; Yingjun,0,68,50,50
1650629403143,CSE 134B,A01,083661,Powell; Thomas Allan,0,35,65,65
1650629409200,CSE 140,A01,083663,Staff,0,8,75,75
1650629415249,CSE 140L,A01,083088,Eldon; John,0,16,75,75
1650629421309,CSE 175,A01,083665,Kumar; Rakesh,7,0,25,18
1650629427361,CSE 190,A00,092507,Dubnov; Shlomo,10,0,20,10
1650629433387,ECE 45,A01,083139,Staff,0,1,60,60
1650629439417,ECE 65,A50,083695,Staff,0,5,30,30
1650629445467,ECE 109,A01,091882,Touri; Behrouz,33,0,70,37
1650629451527,ECE 180,A00,083140,Abi Samra; Nicholas Camill,21,0,30,9
1650629451527,ECE 180,B00,083141,Abi Samra; Nicholas Camill,0,0,30,30
1650629457567,MATH 10A,A01,083735,Patchell; Gregory David,4,0,30,26
1650629457567,MATH 10A,A02,083736,Patchell; Gregory David,27,0,30,3
1650629457567,MATH 10A,A03,083737,Patchell; Gregory David,24,0,30,6
1650629463604,MATH 10B,A01,083207,Staff,0,8,30,30
1650629463604,MATH 10B,A02,083208,Staff,0,8,30,30
1650629463604,MATH 10B,B01,083739,Staff,11,0,30,19
1650629463604,MATH 10B,B02,083740,Staff,28,0,30,2
1650629469660,MATH 18,A01,083743,Staff,0,0,30,30
1650629469660,MATH 18,A02,083744,Staff,23,0,30,7
1650629469660,MATH 18,A03,083745,Staff,21,0,30,9
1650629469660,MATH 18,A04,083746,Staff,26,0,30,4
1650629469660,MATH 18,B01,083748,Staff,0,15,30,30
1650629469660,MATH 18,B02,083749,Staff,0,11,30,30
1650629469660,MATH 18,B03,083750,Staff,0,12,30,30
1650629469660,MATH 18,B04,083751,Staff,0,12,30,30
1650629475704,MATH 20A,A01,083754,Staff,19,0,40,21
1650629481747,MATH 20B,A01,083756,Staff,0,12,30,30
1650629481747,MATH 20B,A02,083757,Staff,0,12,30,30
1650629487783,MATH 20C,A01,083760,Staff,0,15,30,30
1650629487783,MATH 20C,A02,083761,Staff,1,13,30,29
1650629487783,MATH 20C,B01,083762,Staff,11,0,30,19
1650629487783,MATH 20C,B02,083763,Staff,28,0,30,2
1650629493823,MATH 20D,A01,083765,Staff,1,1,30,29
1650629493823,MATH 20D,A02,083766,Staff,7,0,30,23
1650629493823,MATH 20D,A03,083767,Staff,24,0,30,6
1650629499871,MATH 20E,A01,083771,Staff,3,0,30,27
1650629499871,MATH 20E,A02,083772,Staff,17,0,30,13
1650629499871,MATH 20E,B01,083773,Staff,0,0,30,30
1650629499871,MATH 20E,B02,083774,Staff,9,0,30,21
1650629505926,MATH 103A,A01,083777,Staff,0,15,30,30
1650629505926,MATH 103A,A02,083778,Staff,0,15,30,30
1650629505926,MATH 103A,B01,083779,Staff,0,14,30,30
1650629505926,MATH 103A,B02,083780,Staff,0,14,30,30
1650629511981,MATH 105,A01,085443,Staff,0,22,30,30
1650629518018,MATH 109,A01,083213,Anzaldo; Leesa B,0,6,30,30
1650629518018,MATH 109,A02,083214,Anzaldo; Leesa B,0,7,30,30
1650629518018,MATH 109,B01,083215,Anzaldo; Leesa B,0,6,30,30
1650629518018,MATH 109,B02,083216,Anzaldo; Leesa B,0,6,30,30
1650629524072,MATH 142A,A01,083219,Chow; Bennett,0,16,30,30
1650629524072,MATH 142A,A02,083220,Chow; Bennett,0,15,30,30
1650629524072,MATH 142A,B01,083221,Chow; Bennett,0,14,30,30
1650629524072,MATH 142A,B02,083222,Chow; Bennett,0,13,30,30
1650629530129,MATH 193A,A01,083224,Staff,0,5,30,30
1650629530129,MATH 193A,A02,083225,Staff,0,6,30,30
1650629530129,MATH 193A,A03,083781,Staff,0,6,30,30
1650629530129,MATH 193A,A04,083782,Staff,0,7,30,30
1650629536174,MATH 197,001,091859,McAuley; Julian John,9998,0,9999,1
1650629542266,COGS 9,A01,083615,Staff,0,15,60,60
1650629548314,COGS 11,A01,083617,Boyle; Mary E. T.,18,0,40,22
1650629554376,COGS 13,A01,083071,Staff,0,38,40,40
1650629560442,COGS 14A,A01,092681,Staff,0,31,100,100
1650629566486,COGS 14B,A01,083073,Cheng; Tzu-Han,0,13,50,50
1650629572540,COGS 17,A01,092677,Staff,17,0,75,58
1650629578592,COGS 100,A01,083619,Staff,0,26,60,60
1650629584636,COGS 101A,A01,083621,Davis; Joshua Daniel,0,26,60,60
1650629590694,COGS 101B,A01,091572,Staff,0,4,60,60
1650629596733,COGS 101C,A01,083625,Delgado; Tania,15,0,30,15
1650629602793,COGS 107A,A01,083627,Boyle; Mary E. T.,1,15,60,59
1650629608842,COGS 118A,A01,083075,Staff,0,6,60,60
1650629614892,CSE 3,A50,083646,Miranda; Gregory Joseph,19,0,38,19
1650629614892,CSE 3,A51,083647,Miranda; Gregory Joseph,36,0,37,1
1650629620936,CSE 8A,A50,083650,Miranda; Gregory Joseph,0,30,40,40
1650629626980,CSE 11,A01,083080,Cao; Yingjun,0,95,40,40
1650629633029,CSE 12,A01,083652,Staff,0,19,100,100
1650629639072,CSE 15L,A01,083654,Staff,0,2,50,50
1650629639072,CSE 15L,A02,083655,Staff,0,1,50,50
1650629645122,CSE 20,A01,083657,Staff,51,0,80,29
1650629651155,CSE 30,A01,083084,Eldon; John,0,77,40,40
1650629657220,CSE 100,A01,083659,Cao; Yingjun,0,68,50,50
1650629663268,CSE 134B,A01,083661,Powell; Thomas Allan,0,35,65,65
1650629669314,CSE 140,A01,083663,Staff,0,8,75,75
1650629675372,CSE 140L,A01,083088,Eldon; John,0,16,75,75
1650629681413,CSE 175,A01,083665,Kumar; Rakesh,7,0,25,18
1650629687458,CSE 190,A00,092507,Dubnov; Shlomo,10,0,20,10
1650629693510,ECE 45,A01,083139,Staff,0,1,60,60
1650629699545,ECE 65,A50,083695,Staff,0,5,30,30
1650629705593,ECE 109,A01,091882,Touri; Behrouz,33,0,70,37
1650629711652,ECE 180,A00,083140,Abi Samra; Nicholas Camill,21,0,30,9
1650629711652,ECE 180,B00,083141,Abi Samra; Nicholas Camill,0,0,30,30
1650629717704,MATH 10A,A01,083735,Patchell; Gregory David,4,0,30,26
1650629717704,MATH 10A,A02,083736,Patchell; Gregory David,27,0,30,3
1650629717704,MATH 10A,A03,083737,Patchell; Gregory David,24,0,30,6
1650629723744,MATH 10B,A01,083207,Staff,0,8,30,30
1650629723744,MATH 10B,A02,083208,Staff,0,8,30,30
1650629723744,MATH 10B,B01,083739,Staff,11,0,30,19
1650629723744,MATH 10B,B02,083740,Staff,28,0,30,2
1650629729782,MATH 18,A01,083743,Staff,0,0,30,30
1650629729782,MATH 18,A02,083744,Staff,23,0,30,7
1650629729782,MATH 18,A03,083745,Staff,21,0,30,9
1650629729782,MATH 18,A04,083746,Staff,26,0,30,4
1650629729782,MATH 18,B01,083748,Staff,0,15,30,30
1650629729782,MATH 18,B02,083749,Staff,0,11,30,30
1650629729782,MATH 18,B03,083750,Staff,0,12,30,30
1650629729782,MATH 18,B04,083751,Staff,0,12,30,30
1650629735824,MATH 20A,A01,083754,Staff,19,0,40,21
1650629741854,MATH 20B,A01,083756,Staff,0,12,30,30
1650629741854,MATH 20B,A02,083757,Staff,0,12,30,30
1650629747902,MATH 20C,A01,083760,Staff,0,15,30,30
1650629747902,MATH 20C,A02,083761,Staff,1,13,30,29
1650629747902,MATH 20C,B01,083762,Staff,11,0,30,19
1650629747902,MATH 20C,B02,083763,Staff,28,0,30,2
1650629753956,MATH 20D,A01,083765,Staff,1,1,30,29
1650629753956,MATH 20D,A02,083766,Staff,7,0,30,23
1650629753956,MATH 20D,A03,083767,Staff,24,0,30,6
1650629759985,MATH 20E,A01,083771,Staff,3,0,30,27
1650629759985,MATH 20E,A02,083772,Staff,17,0,30,13
1650629759985,MATH 20E,B01,083773,Staff,0,0,30,30
1650629759985,MATH 20E,B02,083774,Staff,9,0,30,21
1650629766097,MATH 103A,A01,083777,Staff,0,15,30,30
1650629766097,MATH 103A,A02,083778,Staff,0,15,30,30
1650629766097,MATH 103A,B01,083779,Staff,0,14,30,30
1650629766097,MATH 103A,B02,083780,Staff,0,14,30,30
1650629772191,MATH 105,A01,085443,Staff,0,22,30,30
1650629778231,MATH 109,A01,083213,Anzaldo; Leesa B,0,6,30,30
1650629778231,MATH 109,A02,083214,Anzaldo; Leesa B,0,7,30,30
1650629778231,MATH 109,B01,083215,Anzaldo; Leesa B,0,6,30,30
1650629778231,MATH 109,B02,083216,Anzaldo; Leesa B,0,6,30,30
1650629784276,MATH 142A,A01,083219,Chow; Bennett,0,16,30,30
1650629784276,MATH 142A,A02,083220,Chow; Bennett,0,15,30,30
1650629784276,MATH 142A,B01,083221,Chow; Bennett,0,14,30,30
1650629784276,MATH 142A,B02,083222,Chow; Bennett,0,13,30,30
1650629790305,MATH 193A,A01,083224,Staff,0,5,30,30
1650629790305,MATH 193A,A02,083225,Staff,0,6,30,30
1650629790305,MATH 193A,A03,083781,Staff,0,6,30,30
1650629790305,MATH 193A,A04,083782,Staff,0,7,30,30
1650629796361,MATH 197,001,091859,McAuley; Julian John,9998,0,9999,1
1650629802449,COGS 9,A01,083615,Staff,0,15,60,60
1650629808487,COGS 11,A01,083617,Boyle; Mary E. T.,18,0,40,22
1650629814524,COGS 13,A01,083071,Staff,0,38,40,40
1650629820564,COGS 14A,A01,092681,Staff,0,31,100,100
1650629826610,COGS 14B,A01,083073,Cheng; Tzu-Han,0,13,50,50
1650629832672,COGS 17,A01,092677,Staff,17,0,75,58
1650629838707,COGS 100,A01,083619,Staff,0,26,60,60
1650629844744,COGS 101A,A01,083621,Davis; Joshua Daniel,0,26,60,60
1650629850771,COGS 101B,A01,091572,Staff,0,4,60,60
1650629856819,COGS 101C,A01,083625,Delgado; Tania,15,0,30,15
1650629862868,COGS 107A,A01,083627,Boyle; Mary E. T.,1,15,60,59
1650629868922,COGS 118A,A01,083075,Staff,0,6,60,60
1650629874978,CSE 3,A50,083646,Miranda; Gregory Joseph,19,0,38,19
1650629874978,CSE 3,A51,083647,Miranda; Gregory Joseph,36,0,37,1
1650629881010,CSE 8A,A50,083650,Miranda; Gregory Joseph,0,30,40,40
1650629887064,CSE 11,A01,083080,Cao; Yingjun,0,95,40,40
1650629893124,CSE 12,A01,083652,Staff,0,19,100,100
1650629899169,CSE 15L,A01,083654,Staff,0,2,50,50
1650629899169,CSE 15L,A02,083655,Staff,0,1,50,50
1650629905345,CSE 20,A01,083657,Staff,51,0,80,29
1650629911370,CSE 30,A01,083084,Eldon; John,0,77,40,40
1650629917420,CSE 100,A01,083659,Cao; Yingjun,0,68,50,50
1650629923519,CSE 134B,A01,083661,Powell; Thomas Allan,0,35,65,65
1650629929584,CSE 140,A01,083663,Staff,0,8,75,75
1650629935646,CSE 140L,A01,083088,Eldon; John,0,16,75,75
1650629941705,CSE 175,A01,083665,Kumar; Rakesh,7,0,25,18
1650629947730,CSE 190,A00,092507,Dubnov; Shlomo,10,0,20,10
1650629953782,ECE 45,A01,083139,Staff,0,1,60,60
1650629959832,ECE 65,A50,083695,Staff,0,5,30,30
1650629965885,ECE 109,A01,091882,Touri; Behrouz,33,0,70,37
1650629971923,ECE 180,A00,083140,Abi Samra; Nicholas Camill,21,0,30,9
1650629971923,ECE 180,B00,083141,Abi Samra; Nicholas Camill,0,0,30,30
1650629977961,MATH 10A,A01,083735,Patchell; Gregory David,4,0,30,26
1650629977961,MATH 10A,A02,083736,Patchell; Gregory David,27,0,30,3
1650629977961,MATH 10A,A03,083737,Patchell; Gregory David,24,0,30,6
1650629984028,MATH 10B,A01,083207,Staff,0,8,30,30
1650629984028,MATH 10B,A02,083208,Staff,0,8,30,30
1650629984028,MATH 10B,B01,083739,Staff,11,0,30,19
1650629984028,MATH 10B,B02,083740,Staff,28,0,30,2
1650629990086,MATH 18,A01,083743,Staff,0,0,30,30
1650629990086,MATH 18,A02,083744,Staff,23,0,30,7
1650629990086,MATH 18,A03,083745,Staff,21,0,30,9
1650629990086,MATH 18,A04,083746,Staff,26,0,30,4
1650629990086,MATH 18,B01,083748,Staff,0,15,30,30
1650629990086,MATH 18,B02,083749,Staff,0,11,30,30
1650629990086,MATH 18,B03,083750,Staff,0,12,30,30
1650629990086,MATH 18,B04,083751,Staff,0,12,30,30
1650629996129,MATH 20A,A01,083754,Staff,19,0,40,21
1650630002159,MATH 20B,A01,083756,Staff,0,12,30,30
1650630002159,MATH 20B,A02,083757,Staff,0,12,30,30
1650630008216,MATH 20C,A01,083760,Staff,0,15,30,30
1650630008216,MATH 20C,A02,083761,Staff,1,13,30,29
1650630008216,MATH 20C,B01,083762,Staff,11,0,30,19
1650630008216,MATH 20C,B02,083763,Staff,28,0,30,2
1650630014283,MATH 20D,A01,083765,Staff,1,1,30,29
1650630014283,MATH 20D,A02,083766,Staff,7,0,30,23
1650630014283,MATH 20D,A03,083767,Staff,24,0,30,6
1650630020324,MATH 20E,A01,083771,Staff,3,0,30,27
1650630020324,MATH 20E,A02,083772,Staff,17,0,30,13
1650630020324,MATH 20E,B01,083773,Staff,0,0,30,30
1650630020324,MATH 20E,B02,083774,Staff,9,0,30,21
1650630026390,MATH 103A,A01,083777,Staff,0,15,30,30
1650630026390,MATH 103A,A02,083778,Staff,0,15,30,30
1650630026390,MATH 103A,B01,083779,Staff,0,14,30,30
1650630026390,MATH 103A,B02,083780,Staff,0,14,30,30
1650630032438,MATH 105,A01,085443,Staff,0,22,30,30
1650630038491,MATH 109,A01,083213,Anzaldo; Leesa B,0,6,30,30
1650630038491,MATH 109,A02,083214,Anzaldo; Leesa B,0,7,30,30
1650630038491,MATH 109,B01,083215,Anzaldo; Leesa B,0,6,30,30
1650630038491,MATH 109,B02,083216,Anzaldo; Leesa B,0,6,30,30
1650630044536,MATH 142A,A01,083219,Chow; Bennett,0,16,30,30
1650630044536,MATH 142A,A02,083220,Chow; Bennett,0,15,30,30
1650630044536,MATH 142A,B01,083221,Chow; Bennett,0,14,30,30
1650630044536,MATH 142A,B02,083222,Chow; Bennett,0,13,30,30
1650630050609,MATH 193A,A01,083224,Staff,0,5,30,30
1650630050609,MATH 193A,A02,083225,Staff,0,6,30,30
1650630050609,MATH 193A,A03,083781,Staff,0,6,30,30
1650630050609,MATH 193A,A04,083782,Staff,0,7,30,30
1650630056677,MATH 197,001,091859,McAuley; Julian John,9998,0,9999,1
1650630062836,COGS 9,A01,083615,Staff,0,15,60,60
1650630068890,COGS 11,A01,083617,Boyle; Mary E. T.,18,0,40,22
1650630074948,COGS 13,A01,083071,Staff,0,38,40,40
1650630081004,COGS 14A,A01,092681,Staff,0,31,100,100
1650630087061,COGS 14B,A01,083073,Cheng; Tzu-Han,0,13,50,50
1650630093104,COGS 17,A01,092677,Staff,17,0,75,58
1650630099141,COGS 100,A01,083619,Staff,0,26,60,60
1650630105201,COGS 101A,A01,083621,Davis; Joshua Daniel,0,26,60,60
1650630111289,COGS 101B,A01,091572,Staff,0,4,60,60
1650630117390,COGS 101C,A01,083625,Delgado; Tania,15,0,30,15
1650630123458,COGS 107A,A01,083627,Boyle; Mary E. T.,1,15,60,59
1650630129487,COGS 118A,A01,083075,Staff,0,6,60,60
1650630135534,CSE 3,A50,083646,Miranda; Gregory Joseph,19,0,38,19
1650630135534,CSE 3,A51,083647,Miranda; Gregory Joseph,36,0,37,1
1650630141605,CSE 8A,A50,083650,Miranda; Gregory Joseph,0,30,40,40
1650630147654,CSE 11,A01,083080,Cao; Yingjun,0,95,40,40
1650630153714,CSE 12,A01,083652,Staff,0,19,100,100
1650630159760,CSE 15L,A01,083654,Staff,0,2,50,50
1650630159760,CSE 15L,A02,083655,Staff,0,1,50,50
1650630165824,CSE 20,A01,083657,Staff,51,0,80,29
1650630171872,CSE 30,A01,083084,Eldon; John,0,77,40,40
1650630177931,CSE 100,A01,083659,Cao; Yingjun,0,68,50,50
1650630183972,CSE 134B,A01,083661,Powell; Thomas Allan,0,35,65,65
1650630190020,CSE 140,A01,083663,Staff,0,8,75,75
1650630196080,CSE 140L,A01,083088,Eldon; John,0,16,75,75
1650630202118,CSE 175,A01,083665,Kumar; Rakesh,7,0,25,18
1650630208174,CSE 190,A00,092507,Dubnov; Shlomo,10,0,20,10
1650630214215,ECE 45,A01,083139,Staff,0,1,60,60
1650630220277,ECE 65,A50,083695,Staff,0,5,30,30
1650630226338,ECE 109,A01,091882,Touri; Behrouz,33,0,70,37
1650630232400,ECE 180,A00,083140,Abi Samra; Nicholas Camill,21,0,30,9
1650630232400,ECE 180,B00,083141,Abi Samra; Nicholas Camill,0,0,30,30
1650630238460,MATH 10A,A01,083735,Patchell; Gregory David,4,0,30,26
1650630238460,MATH 10A,A02,083736,Patchell; Gregory David,27,0,30,3
1650630238460,MATH 10A,A03,083737,Patchell; Gregory David,24,0,30,6
1650630244498,MATH 10B,A01,083207,Staff,0,8,30,30
1650630244498,MATH 10B,A02,083208,Staff,0,8,30,30
1650630244498,MATH 10B,B01,083739,Staff,11,0,30,19
1650630244498,MATH 10B,B02,083740,Staff,28,0,30,2
1650630250537,MATH 18,A01,083743,Staff,0,0,30,30
1650630250537,MATH 18,A02,083744,Staff,23,0,30,7
1650630250537,MATH 18,A03,083745,Staff,21,0,30,9
1650630250537,MATH 18,A04,083746,Staff,26,0,30,4
1650630250537,MATH 18,B01,083748,Staff,0,15,30,30
1650630250537,MATH 18,B02,083749,Staff,0,11,30,30
1650630250537,MATH 18,B03,083750,Staff,0,12,30,30
1650630250537,MATH 18,B04,083751,Staff,0,12,30,30
1650630256624,MATH 20A,A01,083754,Staff,19,0,40,21
1650630262679,MATH 20B,A01,083756,Staff,0,12,30,30
1650630262679,MATH 20B,A02,083757,Staff,0,12,30,30
1650630268735,MATH 20C,A01,083760,Staff,0,15,30,30
1650630268735,MATH 20C,A02,083761,Staff,1,13,30,29
1650630268735,MATH 20C,B01,083762,Staff,11,0,30,19
1650630268735,MATH 20C,B02,083763,Staff,28,0,30,2
1650630274798,MATH 20D,A01,083765,Staff,1,1,30,29
1650630274798,MATH 20D,A02,083766,Staff,7,0,30,23
1650630274798,MATH 20D,A03,083767,Staff,24,0,30,6
1650630280864,MATH 20E,A01,083771,Staff,3,0,30,27
1650630280864,MATH 20E,A02,083772,Staff,17,0,30,13
1650630280864,MATH 20E,B01,083773,Staff,0,0,30,30
1650630280864,MATH 20E,B02,083774,Staff,9,0,30,21
1650630286935,MATH 103A,A01,083777,Staff,0,15,30,30
1650630286935,MATH 103A,A02,083778,Staff,0,15,30,30
1650630286935,MATH 103A,B01,083779,Staff,0,14,30,30
1650630286935,MATH 103A,B02,083780,Staff,0,14,30,30
1650630292998,MATH 105,A01,085443,Staff,0,22,30,30
1650630299041,MATH 109,A01,083213,Anzaldo; Leesa B,0,6,30,30
1650630299041,MATH 109,A02,083214,Anzaldo; Leesa B,0,7,30,30
1650630299041,MATH 109,B01,083215,Anzaldo; Leesa B,0,6,30,30
1650630299041,MATH 109,B02,083216,Anzaldo; Leesa B,0,6,30,30
1650630305085,MATH 142A,A01,083219,Chow; Bennett,0,16,30,30
1650630305085,MATH 142A,A02,083220,Chow; Bennett,0,15,30,30
1650630305085,MATH 142A,B01,083221,Chow; Bennett,0,14,30,30
1650630305085,MATH 142A,B02,083222,Chow; Bennett,0,13,30,30
1650630311146,MATH 193A,A01,083224,Staff,0,5,30,30
1650630311146,MATH 193A,A02,083225,Staff,0,6,30,30
1650630311146,MATH 193A,A03,083781,Staff,0,6,30,30
1650630311146,MATH 193A,A04,083782,Staff,0,7,30,30
1650630317221,MATH 197,001,091859,McAuley; Julian John,9998,0,9999,1
1650630323359,COGS 9,A01,083615,Staff,0,15,60,60
1650630329414,COGS 11,A01,083617,Boyle; Mary E. T.,18,0,40,22
1650630335464,COGS 13,A01,083071,Staff,0,38,40,40
1650630341515,COGS 14A,A01,092681,Staff,0,31,100,100
1650630347570,COGS 14B,A01,083073,Cheng; Tzu-Han,0,13,50,50
1650630353623,COGS 17,A01,092677,Staff,17,0,75,58
1650630359672,COGS 100,A01,083619,Staff,0,26,60,60
1650630365722,COGS 101A,A01,083621,Davis; Joshua Daniel,0,26,60,60
1650630371784,COGS 101B,A01,091572,Staff,0,4,60,60
1650630377834,COGS 101C,A01,083625,Delgado; Tania,15,0,30,15
1650630383884,COGS 107A,A01,083627,Boyle; Mary E. T.,1,15,60,59
1650630389931,COGS 118A,A01,083075,Staff,0,6,60,60
1650630395985,CSE 3,A50,083646,Miranda; Gregory Joseph,19,0,38,19
1650630395985,CSE 3,A51,083647,Miranda; Gregory Joseph,36,0,37,1
1650630402074,CSE 8A,A50,083650,Miranda; Gregory Joseph,0,30,40,40
1650630408116,CSE 11,A01,083080,Cao; Yingjun,0,95,40,40
1650630414178,CSE 12,A01,083652,Staff,0,19,100,100
1650630420230,CSE 15L,A01,083654,Staff,0,2,50,50
1650630420230,CSE 15L,A02,083655,Staff,0,1,50,50
1650630426276,CSE 20,A01,083657,Staff,51,0,80,29
1650630432343,CSE 30,A01,083084,Eldon; John,0,77,40,40
1650630438407,CSE 100,A01,083659,Cao; Yingjun,0,68,50,50
1650630444451,CSE 134B,A01,083661,Powell; Thomas Allan,0,35,65,65
1650630450520,CSE 140,A01,083663,Staff,0,8,75,75
1650630456557,CSE 140L,A01,083088,Eldon; John,0,16,75,75
1650630462603,CSE 175,A01,083665,Kumar; Rakesh,7,0,25,18
1650630468656,CSE 190,A00,092507,Dubnov; Shlomo,10,0,20,10
1650630474704,ECE 45,A01,083139,Staff,0,1,60,60
1650630480747,ECE 65,A50,083695,Staff,0,5,30,30
1650630486803,ECE 109,A01,091882,Touri; Behrouz,33,0,70,37
1650630492854,ECE 180,A00,083140,Abi Samra; Nicholas Camill,21,0,30,9
1650630492854,ECE 180,B00,083141,Abi Samra; Nicholas Camill,0,0,30,30
1650630498883,MATH 10A,A01,083735,Patchell; Gregory David,4,0,30,26
1650630498883,MATH 10A,A02,083736,Patchell; Gregory David,27,0,30,3
1650630498883,MATH 10A,A03,083737,Patchell; Gregory David,24,0,30,6
1650630505070,MATH 10B,A01,083207,Staff,0,8,30,30
1650630505070,MATH 10B,A02,083208,Staff,0,8,30,30
1650630505070,MATH 10B,B01,083739,Staff,11,0,30,19
1650630505070,MATH 10B,B02,083740,Staff,28,0,30,2
1650630511137,MATH 18,A01,083743,Staff,0,0,30,30
1650630511137,MATH 18,A02,083744,Staff,23,0,30,7
1650630511137,MATH 18,A03,083745,Staff,21,0,30,9
1650630511137,MATH 18,A04,083746,Staff,26,0,30,4
1650630511137,MATH 18,B01,083748,Staff,0,15,30,30
1650630511137,MATH 18,B02,083749,Staff,0,11,30,30
1650630511137,MATH 18,B03,083750,Staff,0,12,30,30
1650630511137,MATH 18,B04,083751,Staff,0,12,30,30
1650630517186,MATH 20A,A01,083754,Staff,19,0,40,21
1650630523246,MATH 20B,A01,083756,Staff,0,12,30,30
1650630523246,MATH 20B,A02,083757,Staff,0,12,30,30
1650630529298,MATH 20C,A01,083760,Staff,0,15,30,30
1650630529298,MATH 20C,A02,083761,Staff,1,13,30,29
1650630529298,MATH 20C,B01,083762,Staff,11,0,30,19
1650630529298,MATH 20C,B02,083763,Staff,28,0,30,2
1650630535346,MATH 20D,A01,083765,Staff,1,1,30,29
1650630535346,MATH 20D,A02,083766,Staff,7,0,30,23
1650630535346,MATH 20D,A03,083767,Staff,24,0,30,6
1650630541383,MATH 20E,A01,083771,Staff,3,0,30,27
1650630541383,MATH 20E,A02,083772,Staff,17,0,30,13
1650630541383,MATH 20E,B01,083773,Staff,0,0,30,30
1650630541383,MATH 20E,B02,083774,Staff,9,0,30,21
1650630547452,MATH 103A,A01,083777,Staff,0,15,30,30
1650630547452,MATH 103A,A02,083778,Staff,0,15,30,30
1650630547452,MATH 103A,B01,083779,Staff,0,14,30,30
1650630547452,MATH 103A,B02,083780,Staff,0,14,30,30
1650630553493,MATH 105,A01,085443,Staff,0,22,30,30
1650630559525,MATH 109,A01,083213,Anzaldo; Leesa B,0,6,30,30
1650630559525,MATH 109,A02,083214,Anzaldo; Leesa B,0,7,30,30
1650630559525,MATH 109,B01,083215,Anzaldo; Leesa B,0,6,30,30
1650630559525,MATH 109,B02,083216,Anzaldo; Leesa B,0,6,30,30
1650630565558,MATH 142A,A01,083219,Chow; Bennett,0,16,30,30
1650630565558,MATH 142A,A02,083220,Chow; Bennett,0,15,30,30
1650630565558,MATH 142A,B01,083221,Chow; Bennett,0,14,30,30
1650630565558,MATH 142A,B02,083222,Chow; Bennett,0,13,30,30
1650630571618,MATH 193A,A01,083224,Staff,0,5,30,30
1650630571618,MATH 193A,A02,083225,Staff,0,6,30,30
1650630571618,MATH 193A,A03,083781,Staff,0,6,30,30
1650630571618,MATH 193A,A04,083782,Staff,0,7,30,30
1650630577662,MATH 197,001,091859,McAuley; Julian John,9998,0,9999,1
1650630583787,COGS 9,A01,083615,Staff,0,15,60,60
1650630589835,COGS 11,A01,083617,Boyle; Mary E. T.,18,0,40,22
1650630595908,COGS 13,A01,083071,Staff,0,38,40,40
1650630601954,COGS 14A,A01,092681,Staff,0,31,100,100
1650630608013,COGS 14B,A01,083073,Cheng; Tzu-Han,0,13,50,50
1650630614067,COGS 17,A01,092677,Staff,17,0,75,58
1650630620104,COGS 100,A01,083619,Staff,0,26,60,60
1650630626157,COGS 101A,A01,083621,Davis; Joshua Daniel,0,26,60,60
1650630632203,COGS 101B,A01,091572,Staff,0,4,60,60
1650630638253,COGS 101C,A01,083625,Delgado; Tania,15,0,30,15
1650630644308,COGS 107A,A01,083627,Boyle; Mary E. T.,1,15,60,59
1650630650332,COGS 118A,A01,083075,Staff,0,6,60,60
1650630656387,CSE 3,A50,083646,Miranda; Gregory Joseph,19,0,38,19
1650630656387,CSE 3,A51,083647,Miranda; Gregory Joseph,36,0,37,1
1650630662448,CSE 8A,A50,083650,Miranda; Gregory Joseph,0,30,40,40
1650630668506,CSE 11,A01,083080,Cao; Yingjun,0,95,40,40
1650630674565,CSE 12,A01,083652,Staff,0,19,100,100
1650630680600,CSE 15L,A01,083654,Staff,0,2,50,50
1650630680600,CSE 15L,A02,083655,Staff,0,1,50,50
1650630686650,CSE 20,A01,083657,Staff,51,0,80,29
1650630692702,CSE 30,A01,083084,Eldon; John,0,77,40,40
1650630698730,CSE 100,A01,083659,Cao; Yingjun,0,68,50,50
1650630704794,CSE 134B,A01,083661,Powell; Thomas Allan,0,35,65,65
1650630710839,CSE 140,A01,083663,Staff,0,8,75,75
1650630716867,CSE 140L,A01,083088,Eldon; John,0,16,75,75
1650630722914,CSE 175,A01,083665,Kumar; Rakesh,7,0,25,18
1650630728968,CSE 190,A00,092507,Dubnov; Shlomo,10,0,20,10
1650630735021,ECE 45,A01,083139,Staff,0,1,60,60
1650630741053,ECE 65,A50,083695,Staff,0,5,30,30
1650630747091,ECE 109,A01,091882,Touri; Behrouz,33,0,70,37
1650630753126,ECE 180,A00,083140,Abi Samra; Nicholas Camill,21,0,30,9
1650630753126,ECE 180,B00,083141,Abi Samra; Nicholas Camill,0,0,30,30
1650630759180,MATH 10A,A01,083735,Patchell; Gregory David,4,0,30,26
1650630759180,MATH 10A,A02,083736,Patchell; Gregory David,27,0,30,3
1650630759180,MATH 10A,A03,083737,Patchell; Gregory David,24,0,30,6
1650630765216,MATH 10B,A01,083207,Staff,0,8,30,30
1650630765216,MATH 10B,A02,083208,Staff,0,8,30,30
1650630765216,MATH 10B,B01,083739,Staff,11,0,30,19
1650630765216,MATH 10B,B02,083740,Staff,28,0,30,2
1650630771273,MATH 18,A01,083743,Staff,0,0,30,30
1650630771273,MATH 18,A02,083744,Staff,23,0,30,7
1650630771273,MATH 18,A03,083745,Staff,21,0,30,9
1650630771273,MATH 18,A04,083746,Staff,26,0,30,4
1650630771273,MATH 18,B01,083748,Staff,0,15,30,30
1650630771273,MATH 18,B02,083749,Staff,0,11,30,30
1650630771273,MATH 18,B03,083750,Staff,0,12,30,30
1650630771273,MATH 18,B04,083751,Staff,0,12,30,30
1650630777308,MATH 20A,A01,083754,Staff,19,0,40,21
1650630783347,MATH 20B,A01,083756,Staff,0,12,30,30
1650630783347,MATH 20B,A02,083757,Staff,0,12,30,30
1650630789379,MATH 20C,A01,083760,Staff,0,15,30,30
1650630789379,MATH 20C,A02,083761,Staff,1,13,30,29
1650630789379,MATH 20C,B01,083762,Staff,11,0,30,19
1650630789379,MATH 20C,B02,083763,Staff,28,0,30,2
1650630795427,MATH 20D,A01,083765,Staff,1,1,30,29
1650630795427,MATH 20D,A02,083766,Staff,7,0,30,23
1650630795427,MATH 20D,A03,083767,Staff,24,0,30,6
1650630801454,MATH 20E,A01,083771,Staff,3,0,30,27
1650630801454,MATH 20E,A02,083772,Staff,17,0,30,13
1650630801454,MATH 20E,B01,083773,Staff,0,0,30,30
1650630801454,MATH 20E,B02,083774,Staff,9,0,30,21
1650630807498,MATH 103A,A01,083777,Staff,0,15,30,30
1650630807498,MATH 103A,A02,083778,Staff,0,15,30,30
1650630807498,MATH 103A,B01,083779,Staff,0,14,30,30
1650630807498,MATH 103A,B02,083780,Staff,0,14,30,30
1650630813550,MATH 105,A01,085443,Staff,0,22,30,30
1650630819594,MATH 109,A01,083213,Anzaldo; Leesa B,0,6,30,30
1650630819594,MATH 109,A02,083214,Anzaldo; Leesa B,0,7,30,30
1650630819594,MATH 109,B01,083215,Anzaldo; Leesa B,0,6,30,30
1650630819594,MATH 109,B02,083216,Anzaldo; Leesa B,0,6,30,30
1650630825648,MATH 142A,A01,083219,Chow; Bennett,0,16,30,30
1650630825648,MATH 142A,A02,083220,Chow; Bennett,0,15,30,30
1650630825648,MATH 142A,B01,083221,Chow; Bennett,0,14,30,30
1650630825648,MATH 142A,B02,083222,Chow; Bennett,0,13,30,30
1650630831690,MATH 193A,A01,083224,Staff,0,5,30,30
1650630831690,MATH 193A,A02,083225,Staff,0,6,30,30
1650630831690,MATH 193A,A03,083781,Staff,0,6,30,30
1650630831690,MATH 193A,A04,083782,Staff,0,7,30,30
1650630837745,MATH 197,001,091859,McAuley; Julian John,9998,0,9999,1
1650630843884,COGS 9,A01,083615,Staff,0,15,60,60
1650630849939,COGS 11,A01,083617,Boyle; Mary E. T.,18,0,40,22
1650630855990,COGS 13,A01,083071,Staff,0,38,40,40
1650630862038,COGS 14A,A01,092681,Staff,0,31,100,100
1650630868091,COGS 14B,A01,083073,Cheng; Tzu-Han,0,13,50,50
1650630874118,COGS 17,A01,092677,Staff,17,0,75,58
1650630880158,COGS 100,A01,083619,Staff,0,26,60,60
1650630886198,COGS 101A,A01,083621,Davis; Joshua Daniel,0,26,60,60
1650630892263,COGS 101B,A01,091572,Staff,0,4,60,60
1650630898317,COGS 101C,A01,083625,Delgado; Tania,15,0,30,15
1650630904342,COGS 107A,A01,083627,Boyle; Mary E. T.,1,15,60,59
1650630910385,COGS 118A,A01,083075,Staff,0,6,60,60
1650630916446,CSE 3,A50,083646,Miranda; Gregory Joseph,19,0,38,19
1650630916446,CSE 3,A51,083647,Miranda; Gregory Joseph,36,0,37,1
1650630922499,CSE 8A,A50,083650,Miranda; Gregory Joseph,0,30,40,40
1650630928530,CSE 11,A01,083080,Cao; Yingjun,0,95,40,40
1650630934582,CSE 12,A01,083652,Staff,0,19,100,100
1650630940617,CSE 15L,A01,083654,Staff,0,2,50,50
1650630940617,CSE 15L,A02,083655,Staff,0,1,50,50
1650630946667,CSE 20,A01,083657,Staff,51,0,80,29
1650630952718,CSE 30,A01,083084,Eldon; John,0,77,40,40
1650630958779,CSE 100,A01,083659,Cao; Yingjun,0,68,50,50
1650630964812,CSE 134B,A01,083661,Powell; Thomas Allan,0,35,65,65
1650630970862,CSE 140,A01,083663,Staff,0,8,75,75
1650630976907,CSE 140L,A01,083088,Eldon; John,0,16,75,75
1650630982950,CSE 175,A01,083665,Kumar; Rakesh,7,0,25,18
1650630989012,CSE 190,A00,092507,Dubnov; Shlomo,10,0,20,10
1650630995076,ECE 45,A01,083139,Staff,0,1,60,60
1650631001139,ECE 65,A50,083695,Staff,0,5,30,30
1650631007193,ECE 109,A01,091882,Touri; Behrouz,33,0,70,37
1650631013222,ECE 180,A00,083140,Abi Samra; Nicholas Camill,21,0,30,9
1650631013222,ECE 180,B00,083141,Abi Samra; Nicholas Camill,0,0,30,30
1650631019268,MATH 10A,A01,083735,Patchell; Gregory David,4,0,30,26
1650631019268,MATH 10A,A02,083736,Patchell; Gregory David,27,0,30,3
1650631019268,MATH 10A,A03,083737,Patchell; Gregory David,24,0,30,6
1650631025323,MATH 10B,A01,083207,Staff,0,8,30,30
1650631025323,MATH 10B,A02,083208,Staff,0,8,30,30
1650631025323,MATH 10B,B01,083739,Staff,11,0,30,19
1650631025323,MATH 10B,B02,083740,Staff,28,0,30,2
1650631031375,MATH 18,A01,083743,Staff,0,0,30,30
1650631031375,MATH 18,A02,083744,Staff,23,0,30,7
1650631031375,MATH 18,A03,083745,Staff,21,0,30,9
1650631031375,MATH 18,A04,083746,Staff,26,0,30,4
1650631031375,MATH 18,B01,083748,Staff,0,15,30,30
1650631031375,MATH 18,B02,083749,Staff,0,11,30,30
1650631031375,MATH 18,B03,083750,Staff,0,12,30,30
1650631031375,MATH 18,B04,083751,Staff,0,12,30,30
1650631037415,MATH 20A,A01,083754,Staff,19,0,40,21
1650631043460,MATH 20B,A01,083756,Staff,0,12,30,30
1650631043460,MATH 20B,A02,083757,Staff,0,12,30,30
1650631049513,MATH 20C,A01,083760,Staff,0,15,30,30
1650631049513,MATH 20C,A02,083761,Staff,1,13,30,29
1650631049513,MATH 20C,B01,083762,Staff,11,0,30,19
1650631049513,MATH 20C,B02,083763,Staff,28,0,30,2
1650631055548,MATH 20D,A01,083765,Staff,1,1,30,29
1650631055548,MATH 20D,A02,083766,Staff,7,0,30,23
1650631055548,MATH 20D,A03,083767,Staff,24,0,30,6
1650631061588,MATH 20E,A01,083771,Staff,3,0,30,27
1650631061588,MATH 20E,A02,083772,Staff,17,0,30,13
1650631061588,MATH 20E,B01,083773,Staff,0,0,30,30
1650631061588,MATH 20E,B02,083774,Staff,9,0,30,21
1650631067643,MATH 103A,A01,083777,Staff,0,15,30,30
1650631067643,MATH 103A,A02,083778,Staff,0,15,30,30
1650631067643,MATH 103A,B01,083779,Staff,0,14,30,30
1650631067643,MATH 103A,B02,083780,Staff,0,14,30,30
1650631073679,MATH 105,A01,085443,Staff,0,22,30,30
1650631079711,MATH 109,A01,083213,Anzaldo; Leesa B,0,6,30,30
1650631079711,MATH 109,A02,083214,Anzaldo; Leesa B,0,7,30,30
1650631079711,MATH 109,B01,083215,Anzaldo; Leesa B,0,6,30,30
1650631079711,MATH 109,B02,083216,Anzaldo; Leesa B,0,6,30,30
1650631085776,MATH 142A,A01,083219,Chow; Bennett,0,16,30,30
1650631085776,MATH 142A,A02,083220,Chow; Bennett,0,15,30,30
1650631085776,MATH 142A,B01,083221,Chow; Bennett,0,14,30,30
1650631085776,MATH 142A,B02,083222,Chow; Bennett,0,13,30,30
1650631091826,MATH 193A,A01,083224,Staff,0,5,30,30
1650631091826,MATH 193A,A02,083225,Staff,0,6,30,30
1650631091826,MATH 193A,A03,083781,Staff,0,6,30,30
1650631091826,MATH 193A,A04,083782,Staff,0,7,30,30
1650631097863,MATH 197,001,091859,McAuley; Julian John,9998,0,9999,1
1650631104023,COGS 9,A01,083615,Staff,0,15,60,60
1650631110073,COGS 11,A01,083617,Boyle; Mary E. T.,18,0,40,22
1650631116105,COGS 13,A01,083071,Staff,0,38,40,40
1650631122140,COGS 14A,A01,092681,Staff,0,31,100,100
1650631128185,COGS 14B,A01,083073,Cheng; Tzu-Han,0,13,50,50
1650631134232,COGS 17,A01,092677,Staff,17,0,75,58
1650631140281,COGS 100,A01,083619,Staff,0,26,60,60
1650631146328,COGS 101A,A01,083621,Davis; Joshua Daniel,0,26,60,60
1650631152362,COGS 101B,A01,091572,Staff,0,4,60,60
1650631158399,COGS 101C,A01,083625,Delgado; Tania,15,0,30,15
1650631164458,COGS 107A,A01,083627,Boyle; Mary E. T.,1,15,60,59
1650631170509,COGS 118A,A01,083075,Staff,0,6,60,60
1650631176555,CSE 3,A50,083646,Miranda; Gregory Joseph,19,0,38,19
1650631176555,CSE 3,A51,083647,Miranda; Gregory Joseph,36,0,37,1
1650631182606,CSE 8A,A50,083650,Miranda; Gregory Joseph,0,30,40,40
1650631188657,CSE 11,A01,083080,Cao; Yingjun,0,95,40,40
1650631194710,CSE 12,A01,083652,Staff,0,19,100,100
1650631200751,CSE 15L,A01,083654,Staff,0,2,50,50
1650631200751,CSE 15L,A02,083655,Staff,0,1,50,50
1650631206786,CSE 20,A01,083657,Staff,51,0,80,29
1650631212820,CSE 30,A01,083084,Eldon; John,0,77,40,40
1650631218867,CSE 100,A01,083659,Cao; Yingjun,0,68,50,50
1650631224910,CSE 134B,A01,083661,Powell; Thomas Allan,0,35,65,65
1650631230941,CSE 140,A01,083663,Staff,0,8,75,75
1650631236987,CSE 140L,A01,083088,Eldon; John,0,16,75,75
1650631243043,CSE 175,A01,083665,Kumar; Rakesh,7,0,25,18
1650631249096,CSE 190,A00,092507,Dubnov; Shlomo,10,0,20,10
1650631255121,ECE 45,A01,083139,Staff,0,1,60,60
1650631261154,ECE 65,A50,083695,Staff,0,5,30,30
1650631267183,ECE 109,A01,091882,Touri; Behrouz,33,0,70,37
1650631273228,ECE 180,A00,083140,Abi Samra; Nicholas Camill,21,0,30,9
1650631273228,ECE 180,B00,083141,Abi Samra; Nicholas Camill,0,0,30,30
1650631279288,MATH 10A,A01,083735,Patchell; Gregory David,4,0,30,26
1650631279288,MATH 10A,A02,083736,Patchell; Gregory David,27,0,30,3
1650631279288,MATH 10A,A03,083737,Patchell; Gregory David,24,0,30,6
1650631285347,MATH 10B,A01,083207,Staff,0,8,30,30
1650631285347,MATH 10B,A02,083208,Staff,0,8,30,30
1650631285347,MATH 10B,B01,083739,Staff,11,0,30,19
1650631285347,MATH 10B,B02,083740,Staff,28,0,30,2
1650631291407,MATH 18,A01,083743,Staff,0,0,30,30
1650631291407,MATH 18,A02,083744,Staff,23,0,30,7
1650631291407,MATH 18,A03,083745,Staff,21,0,30,9
1650631291407,MATH 18,A04,083746,Staff,26,0,30,4
1650631291407,MATH 18,B01,083748,Staff,0,15,30,30
1650631291407,MATH 18,B02,083749,Staff,0,11,30,30
1650631291407,MATH 18,B03,083750,Staff,0,12,30,30
1650631291407,MATH 18,B04,083751,Staff,0,12,30,30
1650631297459,MATH 20A,A01,083754,Staff,19,0,40,21
1650631303506,MATH 20B,A01,083756,Staff,0,12,30,30
1650631303506,MATH 20B,A02,083757,Staff,0,12,30,30
1650631309560,MATH 20C,A01,083760,Staff,0,15,30,30
1650631309560,MATH 20C,A02,083761,Staff,1,13,30,29
1650631309560,MATH 20C,B01,083762,Staff,11,0,30,19
1650631309560,MATH 20C,B02,083763,Staff,28,0,30,2
1650631315620,MATH 20D,A01,083765,Staff,1,1,30,29
1650631315620,MATH 20D,A02,083766,Staff,7,0,30,23
1650631315620,MATH 20D,A03,083767,Staff,24,0,30,6
1650631321654,MATH 20E,A01,083771,Staff,3,0,30,27
1650631321654,MATH 20E,A02,083772,Staff,17,0,30,13
1650631321654,MATH 20E,B01,083773,Staff,0,0,30,30
1650631321654,MATH 20E,B02,083774,Staff,9,0,30,21
1650631327686,MATH 103A,A01,083777,Staff,0,15,30,30
1650631327686,MATH 103A,A02,083778,Staff,0,15,30,30
1650631327686,MATH 103A,B01,083779,Staff,0,14,30,30
1650631327686,MATH 103A,B02,083780,Staff,0,14,30,30
1650631333710,MATH 105,A01,085443,Staff,0,22,30,30
1650631339756,MATH 109,A01,083213,Anzaldo; Leesa B,0,6,30,30
1650631339756,MATH 109,A02,083214,Anzaldo; Leesa B,0,7,30,30
1650631339756,MATH 109,B01,083215,Anzaldo; Leesa B,0,6,30,30
1650631339756,MATH 109,B02,083216,Anzaldo; Leesa B,0,6,30,30
1650631345805,MATH 142A,A01,083219,Chow; Bennett,0,16,30,30
1650631345805,MATH 142A,A02,083220,Chow; Bennett,0,15,30,30
1650631345805,MATH 142A,B01,083221,Chow; Bennett,0,14,30,30
1650631345805,MATH 142A,B02,083222,Chow; Bennett,0,13,30,30
1650631351870,MATH 193A,A01,083224,Staff,0,5,30,30
1650631351870,MATH 193A,A02,083225,Staff,0,6,30,30
1650631351870,MATH 193A,A03,083781,Staff,0,6,30,30
1650631351870,MATH 193A,A04,083782,Staff,0,7,30,30
1650631357917,MATH 197,001,091859,McAuley; Julian John,9998,0,9999,1
1650631364024,COGS 9,A01,083615,Staff,0,15,60,60
1650631370075,COGS 11,A01,083617,Boyle; Mary E. T.,18,0,40,22
1650631376101,COGS 13,A01,083071,Staff,0,38,40,40
1650631382125,COGS 14A,A01,092681,Staff,0,31,100,100
1650631388172,COGS 14B,A01,083073,Cheng; Tzu-Han,0,13,50,50
1650631394214,COGS 17,A01,092677,Staff,17,0,75,58
1650631400267,COGS 100,A01,083619,Staff,0,26,60,60
1650631406307,COGS 101A,A01,083621,Davis; Joshua Daniel,0,26,60,60
1650631412352,COGS 101B,A01,091572,Staff,0,4,60,60
1650631418388,COGS 101C,A01,083625,Delgado; Tania,15,0,30,15
1650631424443,COGS 107A,A01,083627,Boyle; Mary E. T.,1,15,60,59
1650631430469,COGS 118A,A01,083075,Staff,0,6,60,60
1650631436516,CSE 3,A50,083646,Miranda; Gregory Joseph,19,0,38,19
1650631436516,CSE 3,A51,083647,Miranda; Gregory Joseph,36,0,37,1
1650631442560,CSE 8A,A50,083650,Miranda; Gregory Joseph,0,30,40,40
1650631448607,CSE 11,A01,083080,Cao; Yingjun,0,95,40,40
1650631454651,CSE 12,A01,083652,Staff,0,19,100,100
1650631460686,CSE 15L,A01,083654,Staff,0,2,50,50
1650631460686,CSE 15L,A02,083655,Staff,0,1,50,50
1650631466742,CSE 20,A01,083657,Staff,51,0,80,29
1650631472813,CSE 30,A01,083084,Eldon; John,0,77,40,40
1650631478860,CSE 100,A01,083659,Cao; Yingjun,0,68,50,50
1650631484911,CSE 134B,A01,083661,Powell; Thomas Allan,0,35,65,65
1650631490944,CSE 140,A01,083663,Staff,0,8,75,75
1650631496980,CSE 140L,A01,083088,Eldon; John,0,16,75,75
1650631503006,CSE 175,A01,083665,Kumar; Rakesh,7,0,25,18
1650631509036,CSE 190,A00,092507,Dubnov; Shlomo,10,0,20,10
1650631515079,ECE 45,A01,083139,Staff,0,1,60,60
1650631521114,ECE 65,A50,083695,Staff,0,5,30,30
1650631527169,ECE 109,A01,091882,Touri; Behrouz,33,0,70,37
1650631533195,ECE 180,A00,083140,Abi Samra; Nicholas Camill,21,0,30,9
1650631533195,ECE 180,B00,083141,Abi Samra; Nicholas Camill,0,0,30,30
1650631539232,MATH 10A,A01,083735,Patchell; Gregory David,4,0,30,26
1650631539232,MATH 10A,A02,083736,Patchell; Gregory David,27,0,30,3
1650631539232,MATH 10A,A03,083737,Patchell; Gregory David,24,0,30,6
1650631545279,MATH 10B,A01,083207,Staff,0,8,30,30
1650631545279,MATH 10B,A02,083208,Staff,0,8,30,30
1650631545279,MATH 10B,B01,083739,Staff,11,0,30,19
1650631545279,MATH 10B,B02,083740,Staff,28,0,30,2
1650631551333,MATH 18,A01,083743,Staff,0,0,30,30
1650631551333,MATH 18,A02,083744,Staff,23,0,30,7
1650631551333,MATH 18,A03,083745,Staff,21,0,30,9
1650631551333,MATH 18,A04,083746,Staff,26,0,30,4
1650631551333,MATH 18,B01,083748,Staff,0,15,30,30
1650631551333,MATH 18,B02,083749,Staff,0,11,30,30
1650631551333,MATH 18,B03,083750,Staff,0,12,30,30
1650631551333,MATH 18,B04,083751,Staff,0,12,30,30
1650631557365,MATH 20A,A01,083754,Staff,19,0,40,21
1650631563413,MATH 20B,A01,083756,Staff,0,12,30,30
1650631563413,MATH 20B,A02,083757,Staff,0,12,30,30
1650631569464,MATH 20C,A01,083760,Staff,0,15,30,30
1650631569464,MATH 20C,A02,083761,Staff,1,13,30,29
1650631569464,MATH 20C,B01,083762,Staff,11,0,30,19
1650631569464,MATH 20C,B02,083763,Staff,28,0,30,2
1650631575501,MATH 20D,A01,083765,Staff,1,1,30,29
1650631575501,MATH 20D,A02,083766,Staff,7,0,30,23
1650631575501,MATH 20D,A03,083767,Staff,24,0,30,6
1650631581559,MATH 20E,A01,083771,Staff,3,0,30,27
1650631581559,MATH 20E,A02,083772,Staff,17,0,30,13
1650631581559,MATH 20E,B01,083773,Staff,0,0,30,30
1650631581559,MATH 20E,B02,083774,Staff,9,0,30,21
1650631587610,MATH 103A,A01,083777,Staff,0,15,30,30
1650631587610,MATH 103A,A02,083778,Staff,0,15,30,30
1650631587610,MATH 103A,B01,083779,Staff,0,14,30,30
1650631587610,MATH 103A,B02,083780,Staff,0,14,30,30
1650631593644,MATH 105,A01,085443,Staff,0,22,30,30
1650631599682,MATH 109,A01,083213,Anzaldo; Leesa B,0,6,30,30
1650631599682,MATH 109,A02,083214,Anzaldo; Leesa B,0,7,30,30
1650631599682,MATH 109,B01,083215,Anzaldo; Leesa B,0,6,30,30
1650631599682,MATH 109,B02,083216,Anzaldo; Leesa B,0,6,30,30
1650631605726,MATH 142A,A01,083219,Chow; Bennett,0,16,30,30
1650631605726,MATH 142A,A02,083220,Chow; Bennett,0,15,30,30
1650631605726,MATH 142A,B01,083221,Chow; Bennett,0,14,30,30
1650631605726,MATH 142A,B02,083222,Chow; Bennett,0,13,30,30
1650631611772,MATH 193A,A01,083224,Staff,0,5,30,30
1650631611772,MATH 193A,A02,083225,Staff,0,6,30,30
1650631611772,MATH 193A,A03,083781,Staff,0,6,30,30
1650631611772,MATH 193A,A04,083782,Staff,0,7,30,30
1650631617814,MATH 197,001,091859,McAuley; Julian John,9998,0,9999,1
1650631623951,COGS 9,A01,083615,Staff,0,15,60,60
1650631629991,COGS 11,A01,083617,Boyle; Mary E. T.,18,0,40,22
1650631636048,COGS 13,A01,083071,Staff,0,38,40,40
1650631642074,COGS 14A,A01,092681,Staff,0,31,100,100
1650631648120,COGS 14B,A01,083073,Cheng; Tzu-Han,0,13,50,50
1650631654149,COGS 17,A01,092677,Staff,17,0,75,58
1650631660186,COGS 100,A01,083619,Staff,0,26,60,60
1650631666225,COGS 101A,A01,083621,Davis; Joshua Daniel,0,26,60,60
1650631672260,COGS 101B,A01,091572,Staff,0,4,60,60
1650631678310,COGS 101C,A01,083625,Delgado; Tania,15,0,30,15
1650631684346,COGS 107A,A01,083627,Boyle; Mary E. T.,1,15,60,59
1650631690389,COGS 118A,A01,083075,Staff,0,6,60,60
1650631696572,CSE 3,A50,083646,Miranda; Gregory Joseph,19,0,38,19
1650631696572,CSE 3,A51,083647,Miranda; Gregory Joseph,36,0,37,1
1650631702629,CSE 8A,A50,083650,Miranda; Gregory Joseph,0,30,40,40
1650631708674,CSE 11,A01,083080,Cao; Yingjun,0,95,40,40
1650631714726,CSE 12,A01,083652,Staff,0,19,100,100
1650631720761,CSE 15L,A01,083654,Staff,0,2,50,50
1650631720761,CSE 15L,A02,083655,Staff,0,1,50,50
1650631726798,CSE 20,A01,083657,Staff,51,0,80,29
1650631732849,CSE 30,A01,083084,Eldon; John,0,77,40,40
1650631738884,CSE 100,A01,083659,Cao; Yingjun,0,68,50,50
1650631744922,CSE 134B,A01,083661,Powell; Thomas Allan,0,35,65,65
1650631750952,CSE 140,A01,083663,Staff,0,8,75,75
1650631756992,CSE 140L,A01,083088,Eldon; John,0,16,75,75
1650631763049,CSE 175,A01,083665,Kumar; Rakesh,7,0,25,18
1650631769083,CSE 190,A00,092507,Dubnov; Shlomo,10,0,20,10
1650631775124,ECE 45,A01,083139,Staff,0,1,60,60
1650631781150,ECE 65,A50,083695,Staff,0,5,30,30
1650631787190,ECE 109,A01,091882,Touri; Behrouz,33,0,70,37
1650631793226,ECE 180,A00,083140,Abi Samra; Nicholas Camill,21,0,30,9
1650631793226,ECE 180,B00,083141,Abi Samra; Nicholas Camill,0,0,30,30
1650631799286,MATH 10A,A01,083735,Patchell; Gregory David,4,0,30,26
1650631799286,MATH 10A,A02,083736,Patchell; Gregory David,27,0,30,3
1650631799286,MATH 10A,A03,083737,Patchell; Gregory David,24,0,30,6
1650631805335,MATH 10B,A01,083207,Staff,0,8,30,30
1650631805335,MATH 10B,A02,083208,Staff,0,8,30,30
1650631805335,MATH 10B,B01,083739,Staff,11,0,30,19
1650631805335,MATH 10B,B02,083740,Staff,28,0,30,2
1650631811374,MATH 18,A01,083743,Staff,0,0,30,30
1650631811374,MATH 18,A02,083744,Staff,23,0,30,7
1650631811374,MATH 18,A03,083745,Staff,21,0,30,9
1650631811374,MATH 18,A04,083746,Staff,26,0,30,4
1650631811374,MATH 18,B01,083748,Staff,0,15,30,30
1650631811374,MATH 18,B02,083749,Staff,0,11,30,30
1650631811374,MATH 18,B03,083750,Staff,0,12,30,30
1650631811374,MATH 18,B04,083751,Staff,0,12,30,30
1650631817405,MATH 20A,A01,083754,Staff,19,0,40,21
1650631823442,MATH 20B,A01,083756,Staff,0,12,30,30
1650631823442,MATH 20B,A02,083757,Staff,0,12,30,30
1650631829476,MATH 20C,A01,083760,Staff,0,15,30,30
1650631829476,MATH 20C,A02,083761,Staff,1,13,30,29
1650631829476,MATH 20C,B01,083762,Staff,11,0,30,19
1650631829476,MATH 20C,B02,083763,Staff,28,0,30,2
1650631835519,MATH 20D,A01,083765,Staff,1,1,30,29
1650631835519,MATH 20D,A02,083766,Staff,7,0,30,23
1650631835519,MATH 20D,A03,083767,Staff,24,0,30,6
1650631841555,MATH 20E,A01,083771,Staff,3,0,30,27
1650631841555,MATH 20E,A02,083772,Staff,17,0,30,13
1650631841555,MATH 20E,B01,083773,Staff,0,0,30,30
1650631841555,MATH 20E,B02,083774,Staff,9,0,30,21
1650631847610,MATH 103A,A01,083777,Staff,0,15,30,30
1650631847610,MATH 103A,A02,083778,Staff,0,15,30,30
1650631847610,MATH 103A,B01,083779,Staff,0,14,30,30
1650631847610,MATH 103A,B02,083780,Staff,0,14,30,30
1650631853647,MATH 105,A01,085443,Staff,0,22,30,30
1650631859713,MATH 109,A01,083213,Anzaldo; Leesa B,0,6,30,30
1650631859713,MATH 109,A02,083214,Anzaldo; Leesa B,0,7,30,30
1650631859713,MATH 109,B01,083215,Anzaldo; Leesa B,0,6,30,30
1650631859713,MATH 109,B02,083216,Anzaldo; Leesa B,0,6,30,30
1650631865767,MATH 142A,A01,083219,Chow; Bennett,0,16,30,30
1650631865767,MATH 142A,A02,083220,Chow; Bennett,0,15,30,30
1650631865767,MATH 142A,B01,083221,Chow; Bennett,0,14,30,30
1650631865767,MATH 142A,B02,083222,Chow; Bennett,0,13,30,30
1650631871821,MATH 193A,A01,083224,Staff,0,5,30,30
1650631871821,MATH 193A,A02,083225,Staff,0,6,30,30
1650631871821,MATH 193A,A03,083781,Staff,0,6,30,30
1650631871821,MATH 193A,A04,083782,Staff,0,7,30,30
1650631877848,MATH 197,001,091859,McAuley; Julian John,9998,0,9999,1
1650631883954,COGS 9,A01,083615,Staff,0,15,60,60
1650631889994,COGS 11,A01,083617,Boyle; Mary E. T.,18,0,40,22
1650631896030,COGS 13,A01,083071,Staff,0,38,40,40
1650631902073,COGS 14A,A01,092681,Staff,0,31,100,100
1650631908107,COGS 14B,A01,083073,Cheng; Tzu-Han,0,13,50,50
1650631914158,COGS 17,A01,092677,Staff,17,0,75,58
1650631920191,COGS 100,A01,083619,Staff,0,26,60,60
1650631926228,COGS 101A,A01,083621,Davis; Joshua Daniel,0,26,60,60
1650631932275,COGS 101B,A01,091572,Staff,0,4,60,60
1650631938309,COGS 101C,A01,083625,Delgado; Tania,15,0,30,15
1650631944354,COGS 107A,A01,083627,Boyle; Mary E. T.,1,15,60,59
1650631950396,COGS 118A,A01,083075,Staff,0,6,60,60
1650631956443,CSE 3,A50,083646,Miranda; Gregory Joseph,19,0,38,19
1650631956443,CSE 3,A51,083647,Miranda; Gregory Joseph,36,0,37,1
1650631962490,CSE 8A,A50,083650,Miranda; Gregory Joseph,0,30,40,40
1650631968538,CSE 11,A01,083080,Cao; Yingjun,0,95,40,40
1650631974579,CSE 12,A01,083652,Staff,0,19,100,100
1650631980604,CSE 15L,A01,083654,Staff,0,2,50,50
1650631980604,CSE 15L,A02,083655,Staff,0,1,50,50
1650631986650,CSE 20,A01,083657,Staff,51,0,80,29
1650631992690,CSE 30,A01,083084,Eldon; John,0,77,40,40
1650631998742,CSE 100,A01,083659,Cao; Yingjun,0,68,50,50
1650632004777,CSE 134B,A01,083661,Powell; Thomas Allan,0,35,65,65
1650632010833,CSE 140,A01,083663,Staff,0,8,75,75
1650632016896,CSE 140L,A01,083088,Eldon; John,0,16,75,75
1650632022942,CSE 175,A01,083665,Kumar; Rakesh,7,0,25,18
1650632028994,CSE 190,A00,092507,Dubnov; Shlomo,10,0,20,10
1650632035028,ECE 45,A01,083139,Staff,0,1,60,60
1650632041073,ECE 65,A50,083695,Staff,0,5,30,30
1650632047103,ECE 109,A01,091882,Touri; Behrouz,33,0,70,37
1650632053129,ECE 180,A00,083140,Abi Samra; Nicholas Camill,21,0,30,9
1650632053129,ECE 180,B00,083141,Abi Samra; Nicholas Camill,0,0,30,30
1650632059205,MATH 10A,A01,083735,Patchell; Gregory David,4,0,30,26
1650632059205,MATH 10A,A02,083736,Patchell; Gregory David,27,0,30,3
1650632059205,MATH 10A,A03,083737,Patchell; Gregory David,24,0,30,6
1650632065251,MATH 10B,A01,083207,Staff,0,8,30,30
1650632065251,MATH 10B,A02,083208,Staff,0,8,30,30
1650632065251,MATH 10B,B01,083739,Staff,11,0,30,19
1650632065251,MATH 10B,B02,083740,Staff,28,0,30,2
1650632071305,MATH 18,A01,083743,Staff,0,0,30,30
1650632071305,MATH 18,A02,083744,Staff,23,0,30,7
1650632071305,MATH 18,A03,083745,Staff,21,0,30,9
1650632071305,MATH 18,A04,083746,Staff,26,0,30,4
1650632071305,MATH 18,B01,083748,Staff,0,15,30,30
1650632071305,MATH 18,B02,083749,Staff,0,11,30,30
1650632071305,MATH 18,B03,083750,Staff,0,12,30,30
1650632071305,MATH 18,B04,083751,Staff,0,12,30,30
1650632077364,MATH 20A,A01,083754,Staff,19,0,40,21
1650632083398,MATH 20B,A01,083756,Staff,0,12,30,30
1650632083398,MATH 20B,A02,083757,Staff,0,12,30,30
1650632089441,MATH 20C,A01,083760,Staff,0,15,30,30
1650632089441,MATH 20C,A02,083761,Staff,1,13,30,29
1650632089441,MATH 20C,B01,083762,Staff,11,0,30,19
1650632089441,MATH 20C,B02,083763,Staff,28,0,30,2
1650632095483,MATH 20D,A01,083765,Staff,1,1,30,29
1650632095483,MATH 20D,A02,083766,Staff,7,0,30,23
1650632095483,MATH 20D,A03,083767,Staff,24,0,30,6
1650632101538,MATH 20E,A01,083771,Staff,3,0,30,27
1650632101538,MATH 20E,A02,083772,Staff,17,0,30,13
1650632101538,MATH 20E,B01,083773,Staff,0,0,30,30
1650632101538,MATH 20E,B02,083774,Staff,9,0,30,21
1650632107574,MATH 103A,A01,083777,Staff,0,15,30,30
1650632107574,MATH 103A,A02,083778,Staff,0,15,30,30
1650632107574,MATH 103A,B01,083779,Staff,0,14,30,30
1650632107574,MATH 103A,B02,083780,Staff,0,14,30,30
1650632113632,MATH 105,A01,085443,Staff,0,22,30,30
1650632119671,MATH 109,A01,083213,Anzaldo; Leesa B,0,6,30,30
1650632119671,MATH 109,A02,083214,Anzaldo; Leesa B,0,7,30,30
1650632119671,MATH 109,B01,083215,Anzaldo; Leesa B,0,6,30,30
1650632119671,MATH 109,B02,083216,Anzaldo; Leesa B,0,6,30,30
1650632125715,MATH 142A,A01,083219,Chow; Bennett,0,16,30,30
1650632125715,MATH 142A,A02,083220,Chow; Bennett,0,15,30,30
1650632125715,MATH 142A,B01,083221,Chow; Bennett,0,14,30,30
1650632125715,MATH 142A,B02,083222,Chow; Bennett,0,13,30,30
1650632131758,MATH 193A,A01,083224,Staff,0,5,30,30
1650632131758,MATH 193A,A02,083225,Staff,0,6,30,30
1650632131758,MATH 193A,A03,083781,Staff,0,6,30,30
1650632131758,MATH 193A,A04,083782,Staff,0,7,30,30
1650632137813,MATH 197,001,091859,McAuley; Julian John,9998,0,9999,1
1650632143915,COGS 9,A01,083615,Staff,0,15,60,60
1650632149954,COGS 11,A01,083617,Boyle; Mary E. T.,18,0,40,22
1650632156012,COGS 13,A01,083071,Staff,0,38,40,40
1650632162053,COGS 14A,A01,092681,Staff,0,31,100,100
1650632168099,COGS 14B,A01,083073,Cheng; Tzu-Han,0,13,50,50
1650632174156,COGS 17,A01,092677,Staff,17,0,75,58
1650632180196,COGS 100,A01,083619,Staff,0,26,60,60
1650632186229,COGS 101A,A01,083621,Davis; Joshua Daniel,0,26,60,60
1650632192264,COGS 101B,A01,091572,Staff,0,4,60,60
1650632198318,COGS 101C,A01,083625,Delgado; Tania,15,0,30,15
1650632204343,COGS 107A,A01,083627,Boyle; Mary E. T.,1,15,60,59
1650632210372,COGS 118A,A01,083075,Staff,0,6,60,60
1650632216416,CSE 3,A50,083646,Miranda; Gregory Joseph,19,0,38,19
1650632216416,CSE 3,A51,083647,Miranda; Gregory Joseph,36,0,37,1
1650632222450,CSE 8A,A50,083650,Miranda; Gregory Joseph,0,30,40,40
1650632228493,CSE 11,A01,083080,Cao; Yingjun,0,95,40,40
1650632234539,CSE 12,A01,083652,Staff,0,19,100,100
1650632240590,CSE 15L,A01,083654,Staff,0,2,50,50
1650632240590,CSE 15L,A02,083655,Staff,0,1,50,50
1650632246636,CSE 20,A01,083657,Staff,51,0,80,29
1650632252698,CSE 30,A01,083084,Eldon; John,0,77,40,40
1650632258741,CSE 100,A01,083659,Cao; Yingjun,0,68,50,50
1650632264776,CSE 134B,A01,083661,Powell; Thomas Allan,0,35,65,65
1650632270828,CSE 140,A01,083663,Staff,0,8,75,75
1650632276877,CSE 140L,A01,083088,Eldon; John,0,16,75,75
1650632282928,CSE 175,A01,083665,Kumar; Rakesh,7,0,25,18
1650632288985,CSE 190,A00,092507,Dubnov; Shlomo,10,0,20,10
1650632295101,ECE 45,A01,083139,Staff,0,1,60,60
1650632301147,ECE 65,A50,083695,Staff,0,5,30,30
1650632307202,ECE 109,A01,091882,Touri; Behrouz,33,0,70,37
1650632313228,ECE 180,A00,083140,Abi Samra; Nicholas Camill,21,0,30,9
1650632313228,ECE 180,B00,083141,Abi Samra; Nicholas Camill,0,0,30,30
1650632319262,MATH 10A,A01,083735,Patchell; Gregory David,4,0,30,26
1650632319262,MATH 10A,A02,083736,Patchell; Gregory David,27,0,30,3
1650632319262,MATH 10A,A03,083737,Patchell; Gregory David,24,0,30,6
1650632325304,MATH 10B,A01,083207,Staff,0,8,30,30
1650632325304,MATH 10B,A02,083208,Staff,0,8,30,30
1650632325304,MATH 10B,B01,083739,Staff,11,0,30,19
1650632325304,MATH 10B,B02,083740,Staff,28,0,30,2
1650632331355,MATH 18,A01,083743,Staff,0,0,30,30
1650632331355,MATH 18,A02,083744,Staff,23,0,30,7
1650632331355,MATH 18,A03,083745,Staff,21,0,30,9
1650632331355,MATH 18,A04,083746,Staff,26,0,30,4
1650632331355,MATH 18,B01,083748,Staff,0,15,30,30
1650632331355,MATH 18,B02,083749,Staff,0,11,30,30
1650632331355,MATH 18,B03,083750,Staff,0,12,30,30
1650632331355,MATH 18,B04,083751,Staff,0,12,30,30
1650632337388,MATH 20A,A01,083754,Staff,19,0,40,21
1650632343431,MATH 20B,A01,083756,Staff,0,12,30,30
1650632343431,MATH 20B,A02,083757,Staff,0,12,30,30
1650632349464,MATH 20C,A01,083760,Staff,0,15,30,30
1650632349464,MATH 20C,A02,083761,Staff,1,13,30,29
1650632349464,MATH 20C,B01,083762,Staff,11,0,30,19
1650632349464,MATH 20C,B02,083763,Staff,28,0,30,2
1650632355492,MATH 20D,A01,083765,Staff,1,1,30,29
1650632355492,MATH 20D,A02,083766,Staff,7,0,30,23
1650632355492,MATH 20D,A03,083767,Staff,24,0,30,6
1650632361554,MATH 20E,A01,083771,Staff,3,0,30,27
1650632361554,MATH 20E,A02,083772,Staff,17,0,30,13
1650632361554,MATH 20E,B01,083773,Staff,0,0,30,30
1650632361554,MATH 20E,B02,083774,Staff,9,0,30,21
1650632367605,MATH 103A,A01,083777,Staff,0,15,30,30
1650632367605,MATH 103A,A02,083778,Staff,0,15,30,30
1650632367605,MATH 103A,B01,083779,Staff,0,14,30,30
1650632367605,MATH 103A,B02,083780,Staff,0,14,30,30
1650632373639,MATH 105,A01,085443,Staff,0,22,30,30
1650632379680,MATH 109,A01,083213,Anzaldo; Leesa B,0,6,30,30
1650632379680,MATH 109,A02,083214,Anzaldo; Leesa B,0,7,30,30
1650632379680,MATH 109,B01,083215,Anzaldo; Leesa B,0,6,30,30
1650632379680,MATH 109,B02,083216,Anzaldo; Leesa B,0,6,30,30
1650632385729,MATH 142A,A01,083219,Chow; Bennett,0,16,30,30
1650632385729,MATH 142A,A02,083220,Chow; Bennett,0,15,30,30
1650632385729,MATH 142A,B01,083221,Chow; Bennett,0,14,30,30
1650632385729,MATH 142A,B02,083222,Chow; Bennett,0,13,30,30
1650632391779,MATH 193A,A01,083224,Staff,0,5,30,30
1650632391779,MATH 193A,A02,083225,Staff,0,6,30,30
1650632391779,MATH 193A,A03,083781,Staff,0,6,30,30
1650632391779,MATH 193A,A04,083782,Staff,0,7,30,30
1650632397816,MATH 197,001,091859,McAuley; Julian John,9998,0,9999,1
1650632403918,COGS 9,A01,083615,Staff,0,15,60,60
1650632409976,COGS 11,A01,083617,Boyle; Mary E. T.,18,0,40,22
1650632416024,COGS 13,A01,083071,Staff,0,38,40,40
1650632422058,COGS 14A,A01,092681,Staff,0,31,100,100
1650632428100,COGS 14B,A01,083073,Cheng; Tzu-Han,0,13,50,50
1650632434144,COGS 17,A01,092677,Staff,17,0,75,58
1650632440196,COGS 100,A01,083619,Staff,0,26,60,60
1650632446244,COGS 101A,A01,083621,Davis; Joshua Daniel,0,26,60,60
1650632452277,COGS 101B,A01,091572,Staff,0,4,60,60
1650632458316,COGS 101C,A01,083625,Delgado; Tania,15,0,30,15
1650632464376,COGS 107A,A01,083627,Boyle; Mary E. T.,1,15,60,59
1650632470402,COGS 118A,A01,083075,Staff,0,6,60,60
1650632476451,CSE 3,A50,083646,Miranda; Gregory Joseph,19,0,38,19
1650632476451,CSE 3,A51,083647,Miranda; Gregory Joseph,36,0,37,1
1650632482512,CSE 8A,A50,083650,Miranda; Gregory Joseph,0,30,40,40
1650632488554,CSE 11,A01,083080,Cao; Yingjun,0,95,40,40
1650632494601,CSE 12,A01,083652,Staff,0,19,100,100
1650632500653,CSE 15L,A01,083654,Staff,0,2,50,50
1650632500653,CSE 15L,A02,083655,Staff,0,1,50,50
1650632506682,CSE 20,A01,083657,Staff,51,0,80,29
1650632512721,CSE 30,A01,083084,Eldon; John,0,77,40,40
1650632518773,CSE 100,A01,083659,Cao; Yingjun,0,68,50,50
1650632524811,CSE 134B,A01,083661,Powell; Thomas Allan,0,35,65,65
1650632530861,CSE 140,A01,083663,Staff,0,8,75,75
1650632536911,CSE 140L,A01,083088,Eldon; John,0,16,75,75
1650632542942,CSE 175,A01,083665,Kumar; Rakesh,7,0,25,18
1650632549000,CSE 190,A00,092507,Dubnov; Shlomo,10,0,20,10
1650632555042,ECE 45,A01,083139,Staff,0,1,60,60
1650632561080,ECE 65,A50,083695,Staff,0,5,30,30
1650632567128,ECE 109,A01,091882,Touri; Behrouz,33,0,70,37
1650632573176,ECE 180,A00,083140,Abi Samra; Nicholas Camill,21,0,30,9
1650632573176,ECE 180,B00,083141,Abi Samra; Nicholas Camill,0,0,30,30
1650632579227,MATH 10A,A01,083735,Patchell; Gregory David,4,0,30,26
1650632579227,MATH 10A,A02,083736,Patchell; Gregory David,27,0,30,3
1650632579227,MATH 10A,A03,083737,Patchell; Gregory David,24,0,30,6
1650632585254,MATH 10B,A01,083207,Staff,0,8,30,30
1650632585254,MATH 10B,A02,083208,Staff,0,8,30,30
1650632585254,MATH 10B,B01,083739,Staff,11,0,30,19
1650632585254,MATH 10B,B02,083740,Staff,28,0,30,2
1650632591295,MATH 18,A01,083743,Staff,0,0,30,30
1650632591295,MATH 18,A02,083744,Staff,23,0,30,7
1650632591295,MATH 18,A03,083745,Staff,21,0,30,9
1650632591295,MATH 18,A04,083746,Staff,26,0,30,4
1650632591295,MATH 18,B01,083748,Staff,0,15,30,30
1650632591295,MATH 18,B02,083749,Staff,0,11,30,30
1650632591295,MATH 18,B03,083750,Staff,0,12,30,30
1650632591295,MATH 18,B04,083751,Staff,0,12,30,30
1650632597338,MATH 20A,A01,083754,Staff,19,0,40,21
1650632603400,MATH 20B,A01,083756,Staff,0,12,30,30
1650632603400,MATH 20B,A02,083757,Staff,0,12,30,30
1650632609449,MATH 20C,A01,083760,Staff,0,15,30,30
1650632609449,MATH 20C,A02,083761,Staff,1,13,30,29
1650632609449,MATH 20C,B01,083762,Staff,11,0,30,19
1650632609449,MATH 20C,B02,083763,Staff,28,0,30,2
1650632615477,MATH 20D,A01,083765,Staff,1,1,30,29
1650632615477,MATH 20D,A02,083766,Staff,7,0,30,23
1650632615477,MATH 20D,A03,083767,Staff,24,0,30,6
1650632621505,MATH 20E,A01,083771,Staff,3,0,30,27
1650632621505,MATH 20E,A02,083772,Staff,17,0,30,13
1650632621505,MATH 20E,B01,083773,Staff,0,0,30,30
1650632621505,MATH 20E,B02,083774,Staff,9,0,30,21
1650632627563,MATH 103A,A01,083777,Staff,0,15,30,30
1650632627563,MATH 103A,A02,083778,Staff,0,15,30,30
1650632627563,MATH 103A,B01,083779,Staff,0,14,30,30
1650632627563,MATH 103A,B02,083780,Staff,0,14,30,30
1650632633589,MATH 105,A01,085443,Staff,0,22,30,30
1650632639650,MATH 109,A01,083213,Anzaldo; Leesa B,0,6,30,30
1650632639650,MATH 109,A02,083214,Anzaldo; Leesa B,0,7,30,30
1650632639650,MATH 109,B01,083215,Anzaldo; Leesa B,0,6,30,30
1650632639650,MATH 109,B02,083216,Anzaldo; Leesa B,0,6,30,30
1650632645676,MATH 142A,A01,083219,Chow; Bennett,0,16,30,30
1650632645676,MATH 142A,A02,083220,Chow; Bennett,0,15,30,30
1650632645676,MATH 142A,B01,083221,Chow; Bennett,0,14,30,30
1650632645676,MATH 142A,B02,083222,Chow; Bennett,0,13,30,30
1650632651708,MATH 193A,A01,083224,Staff,0,5,30,30
1650632651708,MATH 193A,A02,083225,Staff,0,6,30,30
1650632651708,MATH 193A,A03,083781,Staff,0,6,30,30
1650632651708,MATH 193A,A04,083782,Staff,0,7,30,30
1650632657734,MATH 197,001,091859,McAuley; Julian John,9998,0,9999,1
1650632663824,COGS 9,A01,083615,Staff,0,15,60,60
1650632669853,COGS 11,A01,083617,Boyle; Mary E. T.,18,0,40,22
1650632675886,COGS 13,A01,083071,Staff,0,38,40,40
1650632681942,COGS 14A,A01,092681,Staff,0,31,100,100
1650632687974,COGS 14B,A01,083073,Cheng; Tzu-Han,0,13,50,50
1650632694007,COGS 17,A01,092677,Staff,17,0,75,58
1650632700052,COGS 100,A01,083619,Staff,0,26,60,60
1650632706112,COGS 101A,A01,083621,Davis; Joshua Daniel,0,26,60,60
1650632712155,COGS 101B,A01,091572,Staff,0,4,60,60
1650632718192,COGS 101C,A01,083625,Delgado; Tania,15,0,30,15
1650632724226,COGS 107A,A01,083627,Boyle; Mary E. T.,1,15,60,59
1650632730273,COGS 118A,A01,083075,Staff,0,6,60,60
1650632736300,CSE 3,A50,083646,Miranda; Gregory Joseph,19,0,38,19
1650632736300,CSE 3,A51,083647,Miranda; Gregory Joseph,36,0,37,1
1650632742327,CSE 8A,A50,083650,Miranda; Gregory Joseph,0,30,40,40
1650632748355,CSE 11,A01,083080,Cao; Yingjun,0,95,40,40
1650632754390,CSE 12,A01,083652,Staff,0,19,100,100
1650632760421,CSE 15L,A01,083654,Staff,0,2,50,50
1650632760421,CSE 15L,A02,083655,Staff,0,1,50,50
1650632766464,CSE 20,A01,083657,Staff,51,0,80,29
1650632772489,CSE 30,A01,083084,Eldon; John,0,77,40,40
1650632778514,CSE 100,A01,083659,Cao; Yingjun,0,68,50,50
1650632784552,CSE 134B,A01,083661,Powell; Thomas Allan,0,35,65,65
1650632790604,CSE 140,A01,083663,Staff,0,8,75,75
1650632796634,CSE 140L,A01,083088,Eldon; John,0,16,75,75
1650632802679,CSE 175,A01,083665,Kumar; Rakesh,7,0,25,18
1650632808728,CSE 190,A00,092507,Dubnov; Shlomo,10,0,20,10
1650632814758,ECE 45,A01,083139,Staff,0,1,60,60
1650632820811,ECE 65,A50,083695,Staff,0,5,30,30
1650632826878,ECE 109,A01,091882,Touri; Behrouz,33,0,70,37
1650632832907,ECE 180,A00,083140,Abi Samra; Nicholas Camill,21,0,30,9
1650632832907,ECE 180,B00,083141,Abi Samra; Nicholas Camill,0,0,30,30
1650632838969,MATH 10A,A01,083735,Patchell; Gregory David,4,0,30,26
1650632838969,MATH 10A,A02,083736,Patchell; Gregory David,27,0,30,3
1650632838969,MATH 10A,A03,083737,Patchell; Gregory David,24,0,30,6
1650632844997,MATH 10B,A01,083207,Staff,0,8,30,30
1650632844997,MATH 10B,A02,083208,Staff,0,8,30,30
1650632844997,MATH 10B,B01,083739,Staff,11,0,30,19
1650632844997,MATH 10B,B02,083740,Staff,28,0,30,2
1650632851048,MATH 18,A01,083743,Staff,0,0,30,30
1650632851048,MATH 18,A02,083744,Staff,23,0,30,7
1650632851048,MATH 18,A03,083745,Staff,21,0,30,9
1650632851048,MATH 18,A04,083746,Staff,26,0,30,4
1650632851048,MATH 18,B01,083748,Staff,0,15,30,30
1650632851048,MATH 18,B02,083749,Staff,0,11,30,30
1650632851048,MATH 18,B03,083750,Staff,0,12,30,30
1650632851048,MATH 18,B04,083751,Staff,0,12,30,30
1650632857073,MATH 20A,A01,083754,Staff,19,0,40,21
1650632863140,MATH 20B,A01,083756,Staff,0,12,30,30
1650632863140,MATH 20B,A02,083757,Staff,0,12,30,30
1650632869176,MATH 20C,A01,083760,Staff,0,15,30,30
1650632869176,MATH 20C,A02,083761,Staff,1,13,30,29
1650632869176,MATH 20C,B01,083762,Staff,11,0,30,19
1650632869176,MATH 20C,B02,083763,Staff,28,0,30,2
1650632875217,MATH 20D,A01,083765,Staff,1,1,30,29
1650632875217,MATH 20D,A02,083766,Staff,7,0,30,23
1650632875217,MATH 20D,A03,083767,Staff,24,0,30,6
1650632881269,MATH 20E,A01,083771,Staff,3,0,30,27
1650632881269,MATH 20E,A02,083772,Staff,17,0,30,13
1650632881269,MATH 20E,B01,083773,Staff,0,0,30,30
1650632881269,MATH 20E,B02,083774,Staff,9,0,30,21
1650632887301,MATH 103A,A01,083777,Staff,0,15,30,30
1650632887301,MATH 103A,A02,083778,Staff,0,15,30,30
1650632887301,MATH 103A,B01,083779,Staff,0,14,30,30
1650632887301,MATH 103A,B02,083780,Staff,0,14,30,30
1650632893418,MATH 105,A01,085443,Staff,0,22,30,30
1650632899453,MATH 109,A01,083213,Anzaldo; Leesa B,0,6,30,30
1650632899453,MATH 109,A02,083214,Anzaldo; Leesa B,0,7,30,30
1650632899453,MATH 109,B01,083215,Anzaldo; Leesa B,0,6,30,30
1650632899453,MATH 109,B02,083216,Anzaldo; Leesa B,0,6,30,30
1650632905516,MATH 142A,A01,083219,Chow; Bennett,0,16,30,30
1650632905516,MATH 142A,A02,083220,Chow; Bennett,0,15,30,30
1650632905516,MATH 142A,B01,083221,Chow; Bennett,0,14,30,30
1650632905516,MATH 142A,B02,083222,Chow; Bennett,0,13,30,30
1650632911555,MATH 193A,A01,083224,Staff,0,5,30,30
1650632911555,MATH 193A,A02,083225,Staff,0,6,30,30
1650632911555,MATH 193A,A03,083781,Staff,0,6,30,30
1650632911555,MATH 193A,A04,083782,Staff,0,7,30,30
1650632917600,MATH 197,001,091859,McAuley; Julian John,9998,0,9999,1
1650632923706,COGS 9,A01,083615,Staff,0,15,60,60
1650632929746,COGS 11,A01,083617,Boyle; Mary E. T.,18,0,40,22
1650632935783,COGS 13,A01,083071,Staff,0,38,40,40
1650632941837,COGS 14A,A01,092681,Staff,0,31,100,100
1650632947869,COGS 14B,A01,083073,Cheng; Tzu-Han,0,13,50,50
1650632953900,COGS 17,A01,092677,Staff,17,0,75,58
1650632959959,COGS 100,A01,083619,Staff,0,26,60,60
1650632965986,COGS 101A,A01,083621,Davis; Joshua Daniel,0,26,60,60
1650632972019,COGS 101B,A01,091572,Staff,0,4,60,60
1650632978075,COGS 101C,A01,083625,Delgado; Tania,15,0,30,15
1650632984110,COGS 107A,A01,083627,Boyle; Mary E. T.,1,15,60,59
1650632990142,COGS 118A,A01,083075,Staff,0,6,60,60
1650632996182,CSE 3,A50,083646,Miranda; Gregory Joseph,19,0,38,19
1650632996182,CSE 3,A51,083647,Miranda; Gregory Joseph,36,0,37,1
1650633002235,CSE 8A,A50,083650,Miranda; Gregory Joseph,0,30,40,40
1650633008275,CSE 11,A01,083080,Cao; Yingjun,0,95,40,40
1650633014330,CSE 12,A01,083652,Staff,0,19,100,100
1650633020383,CSE 15L,A01,083654,Staff,0,2,50,50
1650633020383,CSE 15L,A02,083655,Staff,0,1,50,50
1650633026409,CSE 20,A01,083657,Staff,51,0,80,29
1650633032447,CSE 30,A01,083084,Eldon; John,0,77,40,40
1650633038472,CSE 100,A01,083659,Cao; Yingjun,0,68,50,50
1650633044517,CSE 134B,A01,083661,Powell; Thomas Allan,0,35,65,65
1650633050552,CSE 140,A01,083663,Staff,0,8,75,75
1650633056586,CSE 140L,A01,083088,Eldon; John,0,16,75,75
1650633062623,CSE 175,A01,083665,Kumar; Rakesh,7,0,25,18
1650633068647,CSE 190,A00,092507,Dubnov; Shlomo,10,0,20,10
1650633074673,ECE 45,A01,083139,Staff,0,1,60,60
1650633080717,ECE 65,A50,083695,Staff,0,5,30,30
1650633086755,ECE 109,A01,091882,Touri; Behrouz,33,0,70,37
1650633092779,ECE 180,A00,083140,Abi Samra; Nicholas Camill,21,0,30,9
1650633092779,ECE 180,B00,083141,Abi Samra; Nicholas Camill,0,0,30,30
1650633098839,MATH 10A,A01,083735,Patchell; Gregory David,4,0,30,26
1650633098839,MATH 10A,A02,083736,Patchell; Gregory David,27,0,30,3
1650633098839,MATH 10A,A03,083737,Patchell; Gregory David,24,0,30,6
1650633104865,MATH 10B,A01,083207,Staff,0,8,30,30
1650633104865,MATH 10B,A02,083208,Staff,0,8,30,30
1650633104865,MATH 10B,B01,083739,Staff,11,0,30,19
1650633104865,MATH 10B,B02,083740,Staff,28,0,30,2
1650633110892,MATH 18,A01,083743,Staff,0,0,30,30
1650633110892,MATH 18,A02,083744,Staff,23,0,30,7
1650633110892,MATH 18,A03,083745,Staff,21,0,30,9
1650633110892,MATH 18,A04,083746,Staff,26,0,30,4
1650633110892,MATH 18,B01,083748,Staff,0,15,30,30
1650633110892,MATH 18,B02,083749,Staff,0,11,30,30
1650633110892,MATH 18,B03,083750,Staff,0,12,30,30
1650633110892,MATH 18,B04,083751,Staff,0,12,30,30
1650633116917,MATH 20A,A01,083754,Staff,19,0,40,21
1650633122951,MATH 20B,A01,083756,Staff,0,12,30,30
1650633122951,MATH 20B,A02,083757,Staff,0,12,30,30
1650633128990,MATH 20C,A01,083760,Staff,0,15,30,30
1650633128990,MATH 20C,A02,083761,Staff,1,13,30,29
1650633128990,MATH 20C,B01,083762,Staff,11,0,30,19
1650633128990,MATH 20C,B02,083763,Staff,28,0,30,2
1650633135017,MATH 20D,A01,083765,Staff,1,1,30,29
1650633135017,MATH 20D,A02,083766,Staff,7,0,30,23
1650633135017,MATH 20D,A03,083767,Staff,24,0,30,6
1650633141045,MATH 20E,A01,083771,Staff,3,0,30,27
1650633141045,MATH 20E,A02,083772,Staff,17,0,30,13
1650633141045,MATH 20E,B01,083773,Staff,0,0,30,30
1650633141045,MATH 20E,B02,083774,Staff,9,0,30,21
1650633147094,MATH 103A,A01,083777,Staff,0,15,30,30
1650633147094,MATH 103A,A02,083778,Staff,0,15,30,30
1650633147094,MATH 103A,B01,083779,Staff,0,14,30,30
1650633147094,MATH 103A,B02,083780,Staff,0,14,30,30
1650633153120,MATH 105,A01,085443,Staff,0,22,30,30
1650633159147,MATH 109,A01,083213,Anzaldo; Leesa B,0,6,30,30
1650633159147,MATH 109,A02,083214,Anzaldo; Leesa B,0,7,30,30
1650633159147,MATH 109,B01,083215,Anzaldo; Leesa B,0,6,30,30
1650633159147,MATH 109,B02,083216,Anzaldo; Leesa B,0,6,30,30
1650633165177,MATH 142A,A01,083219,Chow; Bennett,0,16,30,30
1650633165177,MATH 142A,A02,083220,Chow; Bennett,0,15,30,30
1650633165177,MATH 142A,B01,083221,Chow; Bennett,0,14,30,30
1650633165177,MATH 142A,B02,083222,Chow; Bennett,0,13,30,30
1650633171215,MATH 193A,A01,083224,Staff,0,5,30,30
1650633171215,MATH 193A,A02,083225,Staff,0,6,30,30
1650633171215,MATH 193A,A03,083781,Staff,0,6,30,30
1650633171215,MATH 193A,A04,083782,Staff,0,7,30,30
1650633177248,MATH 197,001,091859,McAuley; Julian John,9998,0,9999,1
1650633183375,COGS 9,A01,083615,Staff,0,15,60,60
1650633189405,COGS 11,A01,083617,Boyle; Mary E. T.,18,0,40,22
1650633195446,COGS 13,A01,083071,Staff,0,38,40,40
1650633201488,COGS 14A,A01,092681,Staff,0,31,100,100
1650633207526,COGS 14B,A01,083073,Cheng; Tzu-Han,0,13,50,50
1650633213563,COGS 17,A01,092677,Staff,17,0,75,58
1650633219602,COGS 100,A01,083619,Staff,0,26,60,60
1650633225652,COGS 101A,A01,083621,Davis; Joshua Daniel,0,26,60,60
1650633231682,COGS 101B,A01,091572,Staff,0,4,60,60
1650633237735,COGS 101C,A01,083625,Delgado; Tania,15,0,30,15
1650633243794,COGS 107A,A01,083627,Boyle; Mary E. T.,1,15,60,59
1650633249820,COGS 118A,A01,083075,Staff,0,6,60,60
1650633255852,CSE 3,A50,083646,Miranda; Gregory Joseph,19,0,38,19
1650633255852,CSE 3,A51,083647,Miranda; Gregory Joseph,36,0,37,1
1650633261884,CSE 8A,A50,083650,Miranda; Gregory Joseph,0,30,40,40
1650633267925,CSE 11,A01,083080,Cao; Yingjun,0,95,40,40
1650633273978,CSE 12,A01,083652,Staff,0,19,100,100
1650633280014,CSE 15L,A01,083654,Staff,0,2,50,50
1650633280014,CSE 15L,A02,083655,Staff,0,1,50,50
1650633286041,CSE 20,A01,083657,Staff,51,0,80,29
1650633292067,CSE 30,A01,083084,Eldon; John,0,77,40,40
1650633298123,CSE 100,A01,083659,Cao; Yingjun,0,68,50,50
1650633304163,CSE 134B,A01,083661,Powell; Thomas Allan,0,35,65,65
1650633310195,CSE 140,A01,083663,Staff,0,8,75,75
1650633316229,CSE 140L,A01,083088,Eldon; John,0,16,75,75
1650633322263,CSE 175,A01,083665,Kumar; Rakesh,7,0,25,18
1650633328303,CSE 190,A00,092507,Dubnov; Shlomo,10,0,20,10
1650633334356,ECE 45,A01,083139,Staff,0,1,60,60
1650633340393,ECE 65,A50,083695,Staff,0,5,30,30
1650633346429,ECE 109,A01,091882,Touri; Behrouz,33,0,70,37
1650633352487,ECE 180,A00,083140,Abi Samra; Nicholas Camill,21,0,30,9
1650633352487,ECE 180,B00,083141,Abi Samra; Nicholas Camill,0,0,30,30
1650633358518,MATH 10A,A01,083735,Patchell; Gregory David,4,0,30,26
1650633358518,MATH 10A,A02,083736,Patchell; Gregory David,27,0,30,3
1650633358518,MATH 10A,A03,083737,Patchell; Gregory David,24,0,30,6
1650633364553,MATH 10B,A01,083207,Staff,0,8,30,30
1650633364553,MATH 10B,A02,083208,Staff,0,8,30,30
1650633364553,MATH 10B,B01,083739,Staff,11,0,30,19
1650633364553,MATH 10B,B02,083740,Staff,28,0,30,2
1650633370606,MATH 18,A01,083743,Staff,0,0,30,30
1650633370606,MATH 18,A02,083744,Staff,23,0,30,7
1650633370606,MATH 18,A03,083745,Staff,21,0,30,9
1650633370606,MATH 18,A04,083746,Staff,26,0,30,4
1650633370606,MATH 18,B01,083748,Staff,0,15,30,30
1650633370606,MATH 18,B02,083749,Staff,0,11,30,30
1650633370606,MATH 18,B03,083750,Staff,0,12,30,30
1650633370606,MATH 18,B04,083751,Staff,0,12,30,30
1650633376632,MATH 20A,A01,083754,Staff,19,0,40,21
1650633382678,MATH 20B,A01,083756,Staff,0,12,30,30
1650633382678,MATH 20B,A02,083757,Staff,0,12,30,30
1650633388710,MATH 20C,A01,083760,Staff,0,15,30,30
1650633388710,MATH 20C,A02,083761,Staff,1,13,30,29
1650633388710,MATH 20C,B01,083762,Staff,11,0,30,19
1650633388710,MATH 20C,B02,083763,Staff,28,0,30,2
1650633394738,MATH 20D,A01,083765,Staff,1,1,30,29
1650633394738,MATH 20D,A02,083766,Staff,7,0,30,23
1650633394738,MATH 20D,A03,083767,Staff,24,0,30,6
1650633400778,MATH 20E,A01,083771,Staff,3,0,30,27
1650633400778,MATH 20E,A02,083772,Staff,17,0,30,13
1650633400778,MATH 20E,B01,083773,Staff,0,0,30,30
1650633400778,MATH 20E,B02,083774,Staff,9,0,30,21
1650633406809,MATH 103A,A01,083777,Staff,0,15,30,30
1650633406809,MATH 103A,A02,083778,Staff,0,15,30,30
1650633406809,MATH 103A,B01,083779,Staff,0,14,30,30
1650633406809,MATH 103A,B02,083780,Staff,0,14,30,30
1650633412839,MATH 105,A01,085443,Staff,0,22,30,30
1650633418866,MATH 109,A01,083213,Anzaldo; Leesa B,0,6,30,30
1650633418866,MATH 109,A02,083214,Anzaldo; Leesa B,0,7,30,30
1650633418866,MATH 109,B01,083215,Anzaldo; Leesa B,0,6,30,30
1650633418866,MATH 109,B02,083216,Anzaldo; Leesa B,0,6,30,30
1650633424900,MATH 142A,A01,083219,Chow; Bennett,0,16,30,30
1650633424900,MATH 142A,A02,083220,Chow; Bennett,0,15,30,30
1650633424900,MATH 142A,B01,083221,Chow; Bennett,0,14,30,30
1650633424900,MATH 142A,B02,083222,Chow; Bennett,0,13,30,30
1650633430944,MATH 193A,A01,083224,Staff,0,5,30,30
1650633430944,MATH 193A,A02,083225,Staff,0,6,30,30
1650633430944,MATH 193A,A03,083781,Staff,0,6,30,30
1650633430944,MATH 193A,A04,083782,Staff,0,7,30,30
1650633436983,MATH 197,001,091859,McAuley; Julian John,9998,0,9999,1
1650633443061,COGS 9,A01,083615,Staff,0,15,60,60
1650633449094,COGS 11,A01,083617,Boyle; Mary E. T.,18,0,40,22
1650633455158,COGS 13,A01,083071,Staff,0,38,40,40
1650633461204,COGS 14A,A01,092681,Staff,0,31,100,100
1650633467250,COGS 14B,A01,083073,Cheng; Tzu-Han,0,13,50,50
1650633473296,COGS 17,A01,092677,Staff,17,0,75,58
1650633479330,COGS 100,A01,083619,Staff,0,26,60,60
1650633485447,COGS 101A,A01,083621,Davis; Joshua Daniel,0,26,60,60
1650633491488,COGS 101B,A01,091572,Staff,0,4,60,60
1650633497525,COGS 101C,A01,083625,Delgado; Tania,15,0,30,15
1650633503583,COGS 107A,A01,083627,Boyle; Mary E. T.,1,15,60,59
1650633509641,COGS 118A,A01,083075,Staff,0,6,60,60
1650633515667,CSE 3,A50,083646,Miranda; Gregory Joseph,19,0,38,19
1650633515667,CSE 3,A51,083647,Miranda; Gregory Joseph,36,0,37,1
1650633521713,CSE 8A,A50,083650,Miranda; Gregory Joseph,0,30,40,40
1650633527750,CSE 11,A01,083080,Cao; Yingjun,0,95,40,40
1650633533794,CSE 12,A01,083652,Staff,0,19,100,100
1650633539837,CSE 15L,A01,083654,Staff,0,2,50,50
1650633539837,CSE 15L,A02,083655,Staff,0,1,50,50
1650633545880,CSE 20,A01,083657,Staff,51,0,80,29
1650633551905,CSE 30,A01,083084,Eldon; John,0,77,40,40
1650633557933,CSE 100,A01,083659,Cao; Yingjun,0,68,50,50
1650633563986,CSE 134B,A01,083661,Powell; Thomas Allan,0,35,65,65
1650633570035,CSE 140,A01,083663,Staff,0,8,75,75
1650633576063,CSE 140L,A01,083088,Eldon; John,0,16,75,75
1650633582102,CSE 175,A01,083665,Kumar; Rakesh,7,0,25,18
1650633588139,CSE 190,A00,092507,Dubnov; Shlomo,10,0,20,10
1650633594188,ECE 45,A01,083139,Staff,0,1,60,60
1650633600219,ECE 65,A50,083695,Staff,0,5,30,30
1650633606260,ECE 109,A01,091882,Touri; Behrouz,33,0,70,37
1650633612286,ECE 180,A00,083140,Abi Samra; Nicholas Camill,21,0,30,9
1650633612286,ECE 180,B00,083141,Abi Samra; Nicholas Camill,0,0,30,30
1650633618335,MATH 10A,A01,083735,Patchell; Gregory David,4,0,30,26
1650633618335,MATH 10A,A02,083736,Patchell; Gregory David,27,0,30,3
1650633618335,MATH 10A,A03,083737,Patchell; Gregory David,24,0,30,6
1650633624366,MATH 10B,A01,083207,Staff,0,8,30,30
1650633624366,MATH 10B,A02,083208,Staff,0,8,30,30
1650633624366,MATH 10B,B01,083739,Staff,11,0,30,19
1650633624366,MATH 10B,B02,083740,Staff,28,0,30,2
1650633630399,MATH 18,A01,083743,Staff,0,0,30,30
1650633630399,MATH 18,A02,083744,Staff,23,0,30,7
1650633630399,MATH 18,A03,083745,Staff,21,0,30,9
1650633630399,MATH 18,A04,083746,Staff,26,0,30,4
1650633630399,MATH 18,B01,083748,Staff,0,15,30,30
1650633630399,MATH 18,B02,083749,Staff,0,11,30,30
1650633630399,MATH 18,B03,083750,Staff,0,12,30,30
1650633630399,MATH 18,B04,083751,Staff,0,12,30,30
1650633636453,MATH 20A,A01,083754,Staff,19,0,40,21
1650633642485,MATH 20B,A01,083756,Staff,0,12,30,30
1650633642485,MATH 20B,A02,083757,Staff,0,12,30,30
1650633648517,MATH 20C,A01,083760,Staff,0,15,30,30
1650633648517,MATH 20C,A02,083761,Staff,1,13,30,29
1650633648517,MATH 20C,B01,083762,Staff,11,0,30,19
1650633648517,MATH 20C,B02,083763,Staff,28,0,30,2
1650633654543,MATH 20D,A01,083765,Staff,1,1,30,29
1650633654543,MATH 20D,A02,083766,Staff,7,0,30,23
1650633654543,MATH 20D,A03,083767,Staff,24,0,30,6
1650633660573,MATH 20E,A01,083771,Staff,3,0,30,27
1650633660573,MATH 20E,A02,083772,Staff,17,0,30,13
1650633660573,MATH 20E,B01,083773,Staff,0,0,30,30
1650633660573,MATH 20E,B02,083774,Staff,9,0,30,21
1650633666607,MATH 103A,A01,083777,Staff,0,15,30,30
1650633666607,MATH 103A,A02,083778,Staff,0,15,30,30
1650633666607,MATH 103A,B01,083779,Staff,0,14,30,30
1650633666607,MATH 103A,B02,083780,Staff,0,14,30,30
1650633672639,MATH 105,A01,085443,Staff,0,22,30,30
1650633678672,MATH 109,A01,083213,Anzaldo; Leesa B,0,6,30,30
1650633678672,MATH 109,A02,083214,Anzaldo; Leesa B,0,7,30,30
1650633678672,MATH 109,B01,083215,Anzaldo; Leesa B,0,6,30,30
1650633678672,MATH 109,B02,083216,Anzaldo; Leesa B,0,6,30,30
1650633684730,MATH 142A,A01,083219,Chow; Bennett,0,16,30,30
1650633684730,MATH 142A,A02,083220,Chow; Bennett,0,15,30,30
1650633684730,MATH 142A,B01,083221,Chow; Bennett,0,14,30,30
1650633684730,MATH 142A,B02,083222,Chow; Bennett,0,13,30,30
1650633690766,MATH 193A,A01,083224,Staff,0,5,30,30
1650633690766,MATH 193A,A02,083225,Staff,0,6,30,30
1650633690766,MATH 193A,A03,083781,Staff,0,6,30,30
1650633690766,MATH 193A,A04,083782,Staff,0,7,30,30
1650633696801,MATH 197,001,091859,McAuley; Julian John,9998,0,9999,1
1650633702872,COGS 9,A01,083615,Staff,0,15,60,60
1650633708928,COGS 11,A01,083617,Boyle; Mary E. T.,18,0,40,22
1650633714959,COGS 13,A01,083071,Staff,0,38,40,40
1650633720991,COGS 14A,A01,092681,Staff,0,31,100,100
1650633727037,COGS 14B,A01,083073,Cheng; Tzu-Han,0,13,50,50
1650633733065,COGS 17,A01,092677,Staff,17,0,75,58
1650633739115,COGS 100,A01,083619,Staff,0,26,60,60
1650633745146,COGS 101A,A01,083621,Davis; Joshua Daniel,0,26,60,60
1650633751184,COGS 101B,A01,091572,Staff,0,4,60,60
1650633757216,COGS 101C,A01,083625,Delgado; Tania,15,0,30,15
1650633763241,COGS 107A,A01,083627,Boyle; Mary E. T.,1,15,60,59
1650633769284,COGS 118A,A01,083075,Staff,0,6,60,60
1650633775328,CSE 3,A50,083646,Miranda; Gregory Joseph,19,0,38,19
1650633775328,CSE 3,A51,083647,Miranda; Gregory Joseph,36,0,37,1
1650633781369,CSE 8A,A50,083650,Miranda; Gregory Joseph,0,30,40,40
1650633787398,CSE 11,A01,083080,Cao; Yingjun,0,95,40,40
1650633793445,CSE 12,A01,083652,Staff,0,19,100,100
1650633799471,CSE 15L,A01,083654,Staff,0,2,50,50
1650633799471,CSE 15L,A02,083655,Staff,0,1,50,50
1650633805512,CSE 20,A01,083657,Staff,51,0,80,29
1650633811548,CSE 30,A01,083084,Eldon; John,0,77,40,40
1650633817592,CSE 100,A01,083659,Cao; Yingjun,0,68,50,50
1650633823624,CSE 134B,A01,083661,Powell; Thomas Allan,0,35,65,65
1650633829654,CSE 140,A01,083663,Staff,0,8,75,75
1650633835679,CSE 140L,A01,083088,Eldon; John,0,16,75,75
1650633841725,CSE 175,A01,083665,Kumar; Rakesh,7,0,25,18
1650633847752,CSE 190,A00,092507,Dubnov; Shlomo,10,0,20,10
1650633853802,ECE 45,A01,083139,Staff,0,1,60,60
1650633859842,ECE 65,A50,083695,Staff,0,5,30,30
1650633865895,ECE 109,A01,091882,Touri; Behrouz,33,0,70,37
1650633871935,ECE 180,A00,083140,Abi Samra; Nicholas Camill,21,0,30,9
1650633871935,ECE 180,B00,083141,Abi Samra; Nicholas Camill,0,0,30,30
1650633877971,MATH 10A,A01,083735,Patchell; Gregory David,4,0,30,26
1650633877971,MATH 10A,A02,083736,Patchell; Gregory David,27,0,30,3
1650633877971,MATH 10A,A03,083737,Patchell; Gregory David,24,0,30,6
1650633884024,MATH 10B,A01,083207,Staff,0,8,30,30
1650633884024,MATH 10B,A02,083208,Staff,0,8,30,30
1650633884024,MATH 10B,B01,083739,Staff,11,0,30,19
1650633884024,MATH 10B,B02,083740,Staff,28,0,30,2
1650633890062,MATH 18,A01,083743,Staff,0,0,30,30
1650633890062,MATH 18,A02,083744,Staff,23,0,30,7
1650633890062,MATH 18,A03,083745,Staff,21,0,30,9
1650633890062,MATH 18,A04,083746,Staff,26,0,30,4
1650633890062,MATH 18,B01,083748,Staff,0,15,30,30
1650633890062,MATH 18,B02,083749,Staff,0,11,30,30
1650633890062,MATH 18,B03,083750,Staff,0,12,30,30
1650633890062,MATH 18,B04,083751,Staff,0,12,30,30
1650633896100,MATH 20A,A01,083754,Staff,19,0,40,21
1650633902125,MATH 20B,A01,083756,Staff,0,12,30,30
1650633902125,MATH 20B,A02,083757,Staff,0,12,30,30
1650633908162,MATH 20C,A01,083760,Staff,0,15,30,30
1650633908162,MATH 20C,A02,083761,Staff,1,13,30,29
1650633908162,MATH 20C,B01,083762,Staff,11,0,30,19
1650633908162,MATH 20C,B02,083763,Staff,28,0,30,2
1650633914221,MATH 20D,A01,083765,Staff,1,1,30,29
1650633914221,MATH 20D,A02,083766,Staff,7,0,30,23
1650633914221,MATH 20D,A03,083767,Staff,24,0,30,6
1650633920249,MATH 20E,A01,083771,Staff,3,0,30,27
1650633920249,MATH 20E,A02,083772,Staff,17,0,30,13
1650633920249,MATH 20E,B01,083773,Staff,0,0,30,30
1650633920249,MATH 20E,B02,083774,Staff,9,0,30,21
1650633926308,MATH 103A,A01,083777,Staff,0,15,30,30
1650633926308,MATH 103A,A02,083778,Staff,0,15,30,30
1650633926308,MATH 103A,B01,083779,Staff,0,14,30,30
1650633926308,MATH 103A,B02,083780,Staff,0,14,30,30
1650633932358,MATH 105,A01,085443,Staff,0,22,30,30
1650633938411,MATH 109,A01,083213,Anzaldo; Leesa B,0,6,30,30
1650633938411,MATH 109,A02,083214,Anzaldo; Leesa B,0,7,30,30
1650633938411,MATH 109,B01,083215,Anzaldo; Leesa B,0,6,30,30
1650633938411,MATH 109,B02,083216,Anzaldo; Leesa B,0,6,30,30
1650633944438,MATH 142A,A01,083219,Chow; Bennett,0,16,30,30
1650633944438,MATH 142A,A02,083220,Chow; Bennett,0,15,30,30
1650633944438,MATH 142A,B01,083221,Chow; Bennett,0,14,30,30
1650633944438,MATH 142A,B02,083222,Chow; Bennett,0,13,30,30
1650633950462,MATH 193A,A01,083224,Staff,0,5,30,30
1650633950462,MATH 193A,A02,083225,Staff,0,6,30,30
1650633950462,MATH 193A,A03,083781,Staff,0,6,30,30
1650633950462,MATH 193A,A04,083782,Staff,0,7,30,30
1650633956515,MATH 197,001,091859,McAuley; Julian John,9998,0,9999,1
1650633962618,COGS 9,A01,083615,Staff,0,15,60,60
1650633968654,COGS 11,A01,083617,Boyle; Mary E. T.,18,0,40,22
1650633974687,COGS 13,A01,083071,Staff,0,38,40,40
1650633980711,COGS 14A,A01,092681,Staff,0,31,100,100
1650633986743,COGS 14B,A01,083073,Cheng; Tzu-Han,0,13,50,50
1650633992797,COGS 17,A01,092677,Staff,17,0,75,58
1650633998821,COGS 100,A01,083619,Staff,0,26,60,60
1650634004850,COGS 101A,A01,083621,Davis; Joshua Daniel,0,26,60,60
1650634010898,COGS 101B,A01,091572,Staff,0,4,60,60
1650634016960,COGS 101C,A01,083625,Delgado; Tania,15,0,30,15
1650634022986,COGS 107A,A01,083627,Boyle; Mary E. T.,1,15,60,59
1650634029021,COGS 118A,A01,083075,Staff,0,6,60,60
1650634035051,CSE 3,A50,083646,Miranda; Gregory Joseph,19,0,38,19
1650634035051,CSE 3,A51,083647,Miranda; Gregory Joseph,36,0,37,1
1650634041090,CSE 8A,A50,083650,Miranda; Gregory Joseph,0,30,40,40
1650634047132,CSE 11,A01,083080,Cao; Yingjun,0,95,40,40
1650634053170,CSE 12,A01,083652,Staff,0,19,100,100
1650634059212,CSE 15L,A01,083654,Staff,0,2,50,50
1650634059212,CSE 15L,A02,083655,Staff,0,1,50,50
1650634065269,CSE 20,A01,083657,Staff,51,0,80,29
1650634071308,CSE 30,A01,083084,Eldon; John,0,77,40,40
1650634077336,CSE 100,A01,083659,Cao; Yingjun,0,68,50,50
1650634083471,CSE 134B,A01,083661,Powell; Thomas Allan,0,35,65,65
1650634089504,CSE 140,A01,083663,Staff,0,8,75,75
1650634095553,CSE 140L,A01,083088,Eldon; John,0,16,75,75
1650634101579,CSE 175,A01,083665,Kumar; Rakesh,7,0,25,18
1650634107619,CSE 190,A00,092507,Dubnov; Shlomo,10,0,20,10
1650634113642,ECE 45,A01,083139,Staff,0,1,60,60
1650634119685,ECE 65,A50,083695,Staff,0,5,30,30
1650634125713,ECE 109,A01,091882,Touri; Behrouz,33,0,70,37
1650634131748,ECE 180,A00,083140,Abi Samra; Nicholas Camill,21,0,30,9
1650634131748,ECE 180,B00,083141,Abi Samra; Nicholas Camill,0,0,30,30
1650634137775,MATH 10A,A01,083735,Patchell; Gregory David,4,0,30,26
1650634137775,MATH 10A,A02,083736,Patchell; Gregory David,27,0,30,3
1650634137775,MATH 10A,A03,083737,Patchell; Gregory David,24,0,30,6
1650634143800,MATH 10B,A01,083207,Staff,0,8,30,30
1650634143800,MATH 10B,A02,083208,Staff,0,8,30,30
1650634143800,MATH 10B,B01,083739,Staff,11,0,30,19
1650634143800,MATH 10B,B02,083740,Staff,28,0,30,2
1650634149835,MATH 18,A01,083743,Staff,0,0,30,30
1650634149835,MATH 18,A02,083744,Staff,23,0,30,7
1650634149835,MATH 18,A03,083745,Staff,21,0,30,9
1650634149835,MATH 18,A04,083746,Staff,26,0,30,4
1650634149835,MATH 18,B01,083748,Staff,0,15,30,30
1650634149835,MATH 18,B02,083749,Staff,0,11,30,30
1650634149835,MATH 18,B03,083750,Staff,0,12,30,30
1650634149835,MATH 18,B04,083751,Staff,0,12,30,30
1650634155858,MATH 20A,A01,083754,Staff,19,0,40,21
1650634161894,MATH 20B,A01,083756,Staff,0,12,30,30
1650634161894,MATH 20B,A02,083757,Staff,0,12,30,30
1650634167937,MATH 20C,A01,083760,Staff,0,15,30,30
1650634167937,MATH 20C,A02,083761,Staff,1,13,30,29
1650634167937,MATH 20C,B01,083762,Staff,11,0,30,19
1650634167937,MATH 20C,B02,083763,Staff,28,0,30,2
1650634173987,MATH 20D,A01,083765,Staff,1,1,30,29
1650634173987,MATH 20D,A02,083766,Staff,7,0,30,23
1650634173987,MATH 20D,A03,083767,Staff,24,0,30,6
1650634180032,MATH 20E,A01,083771,Staff,3,0,30,27
1650634180032,MATH 20E,A02,083772,Staff,17,0,30,13
1650634180032,MATH 20E,B01,083773,Staff,0,0,30,30
1650634180032,MATH 20E,B02,083774,Staff,9,0,30,21
1650634186058,MATH 103A,A01,083777,Staff,0,15,30,30
1650634186058,MATH 103A,A02,083778,Staff,0,15,30,30
1650634186058,MATH 103A,B01,083779,Staff,0,14,30,30
1650634186058,MATH 103A,B02,083780,Staff,0,14,30,30
1650634192082,MATH 105,A01,085443,Staff,0,22,30,30
1650634198131,MATH 109,A01,083213,Anzaldo; Leesa B,0,6,30,30
1650634198131,MATH 109,A02,083214,Anzaldo; Leesa B,0,7,30,30
1650634198131,MATH 109,B01,083215,Anzaldo; Leesa B,0,6,30,30
1650634198131,MATH 109,B02,083216,Anzaldo; Leesa B,0,6,30,30
1650634204177,MATH 142A,A01,083219,Chow; Bennett,0,16,30,30
1650634204177,MATH 142A,A02,083220,Chow; Bennett,0,15,30,30
1650634204177,MATH 142A,B01,083221,Chow; Bennett,0,14,30,30
1650634204177,MATH 142A,B02,083222,Chow; Bennett,0,13,30,30
1650634210227,MATH 193A,A01,083224,Staff,0,5,30,30
1650634210227,MATH 193A,A02,083225,Staff,0,6,30,30
1650634210227,MATH 193A,A03,083781,Staff,0,6,30,30
1650634210227,MATH 193A,A04,083782,Staff,0,7,30,30
1650634216262,MATH 197,001,091859,McAuley; Julian John,9998,0,9999,1
1650634222373,COGS 9,A01,083615,Staff,0,15,60,60
1650634228435,COGS 11,A01,083617,Boyle; Mary E. T.,18,0,40,22
1650634234471,COGS 13,A01,083071,Staff,0,38,40,40
1650634240497,COGS 14A,A01,092681,Staff,0,31,100,100
1650634246545,COGS 14B,A01,083073,Cheng; Tzu-Han,0,13,50,50
1650634252602,COGS 17,A01,092677,Staff,17,0,75,58
1650634258630,COGS 100,A01,083619,Staff,0,26,60,60
1650634264662,COGS 101A,A01,083621,Davis; Joshua Daniel,0,26,60,60
1650634270686,COGS 101B,A01,091572,Staff,0,4,60,60
1650634276730,COGS 101C,A01,083625,Delgado; Tania,15,0,30,15
1650634282755,COGS 107A,A01,083627,Boyle; Mary E. T.,1,15,60,59
1650634288785,COGS 118A,A01,083075,Staff,0,6,60,60
1650634294836,CSE 3,A50,083646,Miranda; Gregory Joseph,19,0,38,19
1650634294836,CSE 3,A51,083647,Miranda; Gregory Joseph,36,0,37,1
1650634300870,CSE 8A,A50,083650,Miranda; Gregory Joseph,0,30,40,40
1650634306914,CSE 11,A01,083080,Cao; Yingjun,0,95,40,40
1650634312939,CSE 12,A01,083652,Staff,0,19,100,100
1650634318964,CSE 15L,A01,083654,Staff,0,2,50,50
1650634318964,CSE 15L,A02,083655,Staff,0,1,50,50
1650634325001,CSE 20,A01,083657,Staff,51,0,80,29
1650634331048,CSE 30,A01,083084,Eldon; John,0,77,40,40
1650634337075,CSE 100,A01,083659,Cao; Yingjun,0,68,50,50
1650634343122,CSE 134B,A01,083661,Powell; Thomas Allan,0,35,65,65
1650634349149,CSE 140,A01,083663,Staff,0,8,75,75
1650634355198,CSE 140L,A01,083088,Eldon; John,0,16,75,75
1650634361231,CSE 175,A01,083665,Kumar; Rakesh,7,0,25,18
1650634367277,CSE 190,A00,092507,Dubnov; Shlomo,10,0,20,10
1650634373312,ECE 45,A01,083139,Staff,0,1,60,60
1650634379349,ECE 65,A50,083695,Staff,0,5,30,30
1650634385376,ECE 109,A01,091882,Touri; Behrouz,33,0,70,37
1650634391402,ECE 180,A00,083140,Abi Samra; Nicholas Camill,21,0,30,9
1650634391402,ECE 180,B00,083141,Abi Samra; Nicholas Camill,0,0,30,30
1650634397440,MATH 10A,A01,083735,Patchell; Gregory David,4,0,30,26
1650634397440,MATH 10A,A02,083736,Patchell; Gregory David,27,0,30,3
1650634397440,MATH 10A,A03,083737,Patchell; Gregory David,24,0,30,6
1650634403478,MATH 10B,A01,083207,Staff,0,8,30,30
1650634403478,MATH 10B,A02,083208,Staff,0,8,30,30
1650634403478,MATH 10B,B01,083739,Staff,11,0,30,19
1650634403478,MATH 10B,B02,083740,Staff,28,0,30,2
1650634409515,MATH 18,A01,083743,Staff,0,0,30,30
1650634409515,MATH 18,A02,083744,Staff,23,0,30,7
1650634409515,MATH 18,A03,083745,Staff,21,0,30,9
1650634409515,MATH 18,A04,083746,Staff,26,0,30,4
1650634409515,MATH 18,B01,083748,Staff,0,15,30,30
1650634409515,MATH 18,B02,083749,Staff,0,11,30,30
1650634409515,MATH 18,B03,083750,Staff,0,12,30,30
1650634409515,MATH 18,B04,083751,Staff,0,12,30,30
1650634415562,MATH 20A,A01,083754,Staff,19,0,40,21
1650634421589,MATH 20B,A01,083756,Staff,0,12,30,30
1650634421589,MATH 20B,A02,083757,Staff,0,12,30,30
1650634427615,MATH 20C,A01,083760,Staff,0,15,30,30
1650634427615,MATH 20C,A02,083761,Staff,1,13,30,29
1650634427615,MATH 20C,B01,083762,Staff,11,0,30,19
1650634427615,MATH 20C,B02,083763,Staff,28,0,30,2
1650634433641,MATH 20D,A01,083765,Staff,1,1,30,29
1650634433641,MATH 20D,A02,083766,Staff,7,0,30,23
1650634433641,MATH 20D,A03,083767,Staff,24,0,30,6
1650634439667,MATH 20E,A01,083771,Staff,3,0,30,27
1650634439667,MATH 20E,A02,083772,Staff,17,0,30,13
1650634439667,MATH 20E,B01,083773,Staff,0,0,30,30
1650634439667,MATH 20E,B02,083774,Staff,9,0,30,21
1650634445696,MATH 103A,A01,083777,Staff,0,15,30,30
1650634445696,MATH 103A,A02,083778,Staff,0,15,30,30
1650634445696,MATH 103A,B01,083779,Staff,0,14,30,30
1650634445696,MATH 103A,B02,083780,Staff,0,14,30,30
1650634451720,MATH 105,A01,085443,Staff,0,22,30,30
1650634457745,MATH 109,A01,083213,Anzaldo; Leesa B,0,6,30,30
1650634457745,MATH 109,A02,083214,Anzaldo; Leesa B,0,7,30,30
1650634457745,MATH 109,B01,083215,Anzaldo; Leesa B,0,6,30,30
1650634457745,MATH 109,B02,083216,Anzaldo; Leesa B,0,6,30,30
1650634463768,MATH 142A,A01,083219,Chow; Bennett,0,16,30,30
1650634463768,MATH 142A,A02,083220,Chow; Bennett,0,15,30,30
1650634463768,MATH 142A,B01,083221,Chow; Bennett,0,14,30,30
1650634463768,MATH 142A,B02,083222,Chow; Bennett,0,13,30,30
1650634469807,MATH 193A,A01,083224,Staff,0,5,30,30
1650634469807,MATH 193A,A02,083225,Staff,0,6,30,30
1650634469807,MATH 193A,A03,083781,Staff,0,6,30,30
1650634469807,MATH 193A,A04,083782,Staff,0,7,30,30
1650634475842,MATH 197,001,091859,McAuley; Julian John,9998,0,9999,1
1650634481945,COGS 9,A01,083615,Staff,0,15,60,60
1650634487970,COGS 11,A01,083617,Boyle; Mary E. T.,18,0,40,22
1650634494021,COGS 13,A01,083071,Staff,0,38,40,40
1650634500066,COGS 14A,A01,092681,Staff,0,31,100,100
1650634506093,COGS 14B,A01,083073,Cheng; Tzu-Han,0,13,50,50
1650634512154,COGS 17,A01,092677,Staff,17,0,75,58
1650634518178,COGS 100,A01,083619,Staff,0,26,60,60
1650634524229,COGS 101A,A01,083621,Davis; Joshua Daniel,0,26,60,60
1650634530266,COGS 101B,A01,091572,Staff,0,4,60,60
1650634536290,COGS 101C,A01,083625,Delgado; Tania,15,0,30,15
1650634542326,COGS 107A,A01,083627,Boyle; Mary E. T.,1,15,60,59
1650634548370,COGS 118A,A01,083075,Staff,0,6,60,60
1650634554407,CSE 3,A50,083646,Miranda; Gregory Joseph,19,0,38,19
1650634554407,CSE 3,A51,083647,Miranda; Gregory Joseph,36,0,37,1
1650634560436,CSE 8A,A50,083650,Miranda; Gregory Joseph,0,30,40,40
1650634566462,CSE 11,A01,083080,Cao; Yingjun,0,95,40,40
1650634572503,CSE 12,A01,083652,Staff,0,19,100,100
1650634578528,CSE 15L,A01,083654,Staff,0,2,50,50
1650634578528,CSE 15L,A02,083655,Staff,0,1,50,50
1650634584583,CSE 20,A01,083657,Staff,51,0,80,29
1650634590620,CSE 30,A01,083084,Eldon; John,0,77,40,40
1650634596649,CSE 100,A01,083659,Cao; Yingjun,0,68,50,50
1650634602684,CSE 134B,A01,083661,Powell; Thomas Allan,0,35,65,65
1650634608708,CSE 140,A01,083663,Staff,0,8,75,75
1650634614757,CSE 140L,A01,083088,Eldon; John,0,16,75,75
1650634620784,CSE 175,A01,083665,Kumar; Rakesh,7,0,25,18
1650634626828,CSE 190,A00,092507,Dubnov; Shlomo,10,0,20,10
1650634632855,ECE 45,A01,083139,Staff,0,1,60,60
1650634638896,ECE 65,A50,083695,Staff,0,5,30,30
1650634644920,ECE 109,A01,091882,Touri; Behrouz,33,0,70,37
1650634650956,ECE 180,A00,083140,Abi Samra; Nicholas Camill,21,0,30,9
1650634650956,ECE 180,B00,083141,Abi Samra; Nicholas Camill,0,0,30,30
1650634656991,MATH 10A,A01,083735,Patchell; Gregory David,4,0,30,26
1650634656991,MATH 10A,A02,083736,Patchell; Gregory David,27,0,30,3
1650634656991,MATH 10A,A03,083737,Patchell; Gregory David,24,0,30,6
1650634663016,MATH 10B,A01,083207,Staff,0,8,30,30
1650634663016,MATH 10B,A02,083208,Staff,0,8,30,30
1650634663016,MATH 10B,B01,083739,Staff,11,0,30,19
1650634663016,MATH 10B,B02,083740,Staff,28,0,30,2
1650634669068,MATH 18,A01,083743,Staff,0,0,30,30
1650634669068,MATH 18,A02,083744,Staff,23,0,30,7
1650634669068,MATH 18,A03,083745,Staff,21,0,30,9
1650634669068,MATH 18,A04,083746,Staff,26,0,30,4
1650634669068,MATH 18,B01,083748,Staff,0,15,30,30
1650634669068,MATH 18,B02,083749,Staff,0,11,30,30
1650634669068,MATH 18,B03,083750,Staff,0,12,30,30
1650634669068,MATH 18,B04,083751,Staff,0,12,30,30
1650634675121,MATH 20A,A01,083754,Staff,19,0,40,21
1650634681273,MATH 20B,A01,083756,Staff,0,12,30,30
1650634681273,MATH 20B,A02,083757,Staff,0,12,30,30
1650634687298,MATH 20C,A01,083760,Staff,0,15,30,30
1650634687298,MATH 20C,A02,083761,Staff,1,13,30,29
1650634687298,MATH 20C,B01,083762,Staff,11,0,30,19
1650634687298,MATH 20C,B02,083763,Staff,28,0,30,2
1650634693322,MATH 20D,A01,083765,Staff,1,1,30,29
1650634693322,MATH 20D,A02,083766,Staff,7,0,30,23
1650634693322,MATH 20D,A03,083767,Staff,24,0,30,6
1650634699356,MATH 20E,A01,083771,Staff,3,0,30,27
1650634699356,MATH 20E,A02,083772,Staff,17,0,30,13
1650634699356,MATH 20E,B01,083773,Staff,0,0,30,30
1650634699356,MATH 20E,B02,083774,Staff,9,0,30,21
1650634705391,MATH 103A,A01,083777,Staff,0,15,30,30
1650634705391,MATH 103A,A02,083778,Staff,0,15,30,30
1650634705391,MATH 103A,B01,083779,Staff,0,14,30,30
1650634705391,MATH 103A,B02,083780,Staff,0,14,30,30
1650634711419,MATH 105,A01,085443,Staff,0,22,30,30
1650634717459,MATH 109,A01,083213,Anzaldo; Leesa B,0,6,30,30
1650634717459,MATH 109,A02,083214,Anzaldo; Leesa B,0,7,30,30
1650634717459,MATH 109,B01,083215,Anzaldo; Leesa B,0,6,30,30
1650634717459,MATH 109,B02,083216,Anzaldo; Leesa B,0,6,30,30
1650634723484,MATH 142A,A01,083219,Chow; Bennett,0,16,30,30
1650634723484,MATH 142A,A02,083220,Chow; Bennett,0,15,30,30
1650634723484,MATH 142A,B01,083221,Chow; Bennett,0,14,30,30
1650634723484,MATH 142A,B02,083222,Chow; Bennett,0,13,30,30
1650634729510,MATH 193A,A01,083224,Staff,0,5,30,30
1650634729510,MATH 193A,A02,083225,Staff,0,6,30,30
1650634729510,MATH 193A,A03,083781,Staff,0,6,30,30
1650634729510,MATH 193A,A04,083782,Staff,0,7,30,30
1650634735559,MATH 197,001,091859,McAuley; Julian John,9998,0,9999,1
1650634741627,COGS 9,A01,083615,Staff,0,15,60,60
1650634747659,COGS 11,A01,083617,Boyle; Mary E. T.,18,0,40,22
1650634753692,COGS 13,A01,083071,Staff,0,38,40,40
1650634759730,COGS 14A,A01,092681,Staff,0,31,100,100
1650634765775,COGS 14B,A01,083073,Cheng; Tzu-Han,0,13,50,50
1650634771819,COGS 17,A01,092677,Staff,17,0,75,58
1650634777850,COGS 100,A01,083619,Staff,0,26,60,60
1650634783875,COGS 101A,A01,083621,Davis; Joshua Daniel,0,26,60,60
1650634789902,COGS 101B,A01,091572,Staff,0,4,60,60
1650634795927,COGS 101C,A01,083625,Delgado; Tania,15,0,30,15
1650634801953,COGS 107A,A01,083627,Boyle; Mary E. T.,1,15,60,59
1650634807991,COGS 118A,A01,083075,Staff,0,6,60,60
1650634814033,CSE 3,A50,083646,Miranda; Gregory Joseph,19,0,38,19
1650634814033,CSE 3,A51,083647,Miranda; Gregory Joseph,36,0,37,1
1650634820064,CSE 8A,A50,083650,Miranda; Gregory Joseph,0,30,40,40
1650634826089,CSE 11,A01,083080,Cao; Yingjun,0,95,40,40
1650634832112,CSE 12,A01,083652,Staff,0,19,100,100
1650634838154,CSE 15L,A01,083654,Staff,0,2,50,50
1650634838154,CSE 15L,A02,083655,Staff,0,1,50,50
1650634844182,CSE 20,A01,083657,Staff,51,0,80,29
1650634850211,CSE 30,A01,083084,Eldon; John,0,77,40,40
1650634856241,CSE 100,A01,083659,Cao; Yingjun,0,68,50,50
1650634862284,CSE 134B,A01,083661,Powell; Thomas Allan,0,35,65,65
1650634868309,CSE 140,A01,083663,Staff,0,8,75,75
1650634874337,CSE 140L,A01,083088,Eldon; John,0,16,75,75
1650634880369,CSE 175,A01,083665,Kumar; Rakesh,7,0,25,18
1650634886398,CSE 190,A00,092507,Dubnov; Shlomo,10,0,20,10
1650634892432,ECE 45,A01,083139,Staff,0,1,60,60
1650634898456,ECE 65,A50,083695,Staff,0,5,30,30
1650634904496,ECE 109,A01,091882,Touri; Behrouz,33,0,70,37
1650634910525,ECE 180,A00,083140,Abi Samra; Nicholas Camill,21,0,30,9
1650634910525,ECE 180,B00,083141,Abi Samra; Nicholas Camill,0,0,30,30
1650634916549,MATH 10A,A01,083735,Patchell; Gregory David,4,0,30,26
1650634916549,MATH 10A,A02,083736,Patchell; Gregory David,27,0,30,3
1650634916549,MATH 10A,A03,083737,Patchell; Gregory David,24,0,30,6
1650634922576,MATH 10B,A01,083207,Staff,0,8,30,30
1650634922576,MATH 10B,A02,083208,Staff,0,8,30,30
1650634922576,MATH 10B,B01,083739,Staff,11,0,30,19
1650634922576,MATH 10B,B02,083740,Staff,28,0,30,2
1650634928623,MATH 18,A01,083743,Staff,0,0,30,30
1650634928623,MATH 18,A02,083744,Staff,23,0,30,7
1650634928623,MATH 18,A03,083745,Staff,21,0,30,9
1650634928623,MATH 18,A04,083746,Staff,26,0,30,4
1650634928623,MATH 18,B01,083748,Staff,0,15,30,30
1650634928623,MATH 18,B02,083749,Staff,0,11,30,30
1650634928623,MATH 18,B03,083750,Staff,0,12,30,30
1650634928623,MATH 18,B04,083751,Staff,0,12,30,30
1650634934661,MATH 20A,A01,083754,Staff,19,0,40,21
1650634940686,MATH 20B,A01,083756,Staff,0,12,30,30
1650634940686,MATH 20B,A02,083757,Staff,0,12,30,30
1650634946714,MATH 20C,A01,083760,Staff,0,15,30,30
1650634946714,MATH 20C,A02,083761,Staff,1,13,30,29
1650634946714,MATH 20C,B01,083762,Staff,11,0,30,19
1650634946714,MATH 20C,B02,083763,Staff,28,0,30,2
1650634952739,MATH 20D,A01,083765,Staff,1,1,30,29
1650634952739,MATH 20D,A02,083766,Staff,7,0,30,23
1650634952739,MATH 20D,A03,083767,Staff,24,0,30,6
1650634958765,MATH 20E,A01,083771,Staff,3,0,30,27
1650634958765,MATH 20E,A02,083772,Staff,17,0,30,13
1650634958765,MATH 20E,B01,083773,Staff,0,0,30,30
1650634958765,MATH 20E,B02,083774,Staff,9,0,30,21
1650634964791,MATH 103A,A01,083777,Staff,0,15,30,30
1650634964791,MATH 103A,A02,083778,Staff,0,15,30,30
1650634964791,MATH 103A,B01,083779,Staff,0,14,30,30
1650634964791,MATH 103A,B02,083780,Staff,0,14,30,30
1650634970816,MATH 105,A01,085443,Staff,0,22,30,30
1650634976853,MATH 109,A01,083213,Anzaldo; Leesa B,0,6,30,30
1650634976853,MATH 109,A02,083214,Anzaldo; Leesa B,0,7,30,30
1650634976853,MATH 109,B01,083215,Anzaldo; Leesa B,0,6,30,30
1650634976853,MATH 109,B02,083216,Anzaldo; Leesa B,0,6,30,30
1650634982884,MATH 142A,A01,083219,Chow; Bennett,0,16,30,30
1650634982884,MATH 142A,A02,083220,Chow; Bennett,0,15,30,30
1650634982884,MATH 142A,B01,083221,Chow; Bennett,0,14,30,30
1650634982884,MATH 142A,B02,083222,Chow; Bennett,0,13,30,30
1650634988910,MATH 193A,A01,083224,Staff,0,5,30,30
1650634988910,MATH 193A,A02,083225,Staff,0,6,30,30
1650634988910,MATH 193A,A03,083781,Staff,0,6,30,30
1650634988910,MATH 193A,A04,083782,Staff,0,7,30,30
1650634994937,MATH 197,001,091859,McAuley; Julian John,9998,0,9999,1
1650635001026,COGS 9,A01,083615,Staff,0,15,60,60
1650635007050,COGS 11,A01,083617,Boyle; Mary E. T.,18,0,40,22
1650635013102,COGS 13,A01,083071,Staff,0,38,40,40
1650635019135,COGS 14A,A01,092681,Staff,0,31,100,100
1650635025159,COGS 14B,A01,083073,Cheng; Tzu-Han,0,13,50,50
1650635031187,COGS 17,A01,092677,Staff,17,0,75,58
1650635037212,COGS 100,A01,083619,Staff,0,26,60,60
1650635043241,COGS 101A,A01,083621,Davis; Joshua Daniel,0,26,60,60
1650635049269,COGS 101B,A01,091572,Staff,0,4,60,60
1650635055297,COGS 101C,A01,083625,Delgado; Tania,15,0,30,15
1650635061321,COGS 107A,A01,083627,Boyle; Mary E. T.,1,15,60,59
1650635067348,COGS 118A,A01,083075,Staff,0,6,60,60
1650635073373,CSE 3,A50,083646,Miranda; Gregory Joseph,19,0,38,19
1650635073373,CSE 3,A51,083647,Miranda; Gregory Joseph,36,0,37,1
1650635079412,CSE 8A,A50,083650,Miranda; Gregory Joseph,0,30,40,40
1650635085438,CSE 11,A01,083080,Cao; Yingjun,0,95,40,40
1650635091471,CSE 12,A01,083652,Staff,0,19,100,100
1650635097497,CSE 15L,A01,083654,Staff,0,2,50,50
1650635097497,CSE 15L,A02,083655,Staff,0,1,50,50
1650635103523,CSE 20,A01,083657,Staff,51,0,80,29
1650635109550,CSE 30,A01,083084,Eldon; John,0,77,40,40
1650635115574,CSE 100,A01,083659,Cao; Yingjun,0,68,50,50
1650635121602,CSE 134B,A01,083661,Powell; Thomas Allan,0,35,65,65
1650635127629,CSE 140,A01,083663,Staff,0,8,75,75
1650635133655,CSE 140L,A01,083088,Eldon; John,0,16,75,75
1650635139679,CSE 175,A01,083665,Kumar; Rakesh,7,0,25,18
1650635145705,CSE 190,A00,092507,Dubnov; Shlomo,10,0,20,10
1650635151746,ECE 45,A01,083139,Staff,0,1,60,60
1650635157770,ECE 65,A50,083695,Staff,0,5,30,30
1650635163817,ECE 109,A01,091882,Touri; Behrouz,33,0,70,37
1650635169844,ECE 180,A00,083140,Abi Samra; Nicholas Camill,21,0,30,9
1650635169844,ECE 180,B00,083141,Abi Samra; Nicholas Camill,0,0,30,30
1650635175893,MATH 10A,A01,083735,Patchell; Gregory David,4,0,30,26
1650635175893,MATH 10A,A02,083736,Patchell; Gregory David,27,0,30,3
1650635175893,MATH 10A,A03,083737,Patchell; Gregory David,24,0,30,6
1650635181917,MATH 10B,A01,083207,Staff,0,8,30,30
1650635181917,MATH 10B,A02,083208,Staff,0,8,30,30
1650635181917,MATH 10B,B01,083739,Staff,11,0,30,19
1650635181917,MATH 10B,B02,083740,Staff,28,0,30,2
1650635187964,MATH 18,A01,083743,Staff,0,0,30,30
1650635187964,MATH 18,A02,083744,Staff,23,0,30,7
1650635187964,MATH 18,A03,083745,Staff,21,0,30,9
1650635187964,MATH 18,A04,083746,Staff,26,0,30,4
1650635187964,MATH 18,B01,083748,Staff,0,15,30,30
1650635187964,MATH 18,B02,083749,Staff,0,11,30,30
1650635187964,MATH 18,B03,083750,Staff,0,12,30,30
1650635187964,MATH 18,B04,083751,Staff,0,12,30,30
1650635193990,MATH 20A,A01,083754,Staff,19,0,40,21
1650635200017,MATH 20B,A01,083756,Staff,0,12,30,30
1650635200017,MATH 20B,A02,083757,Staff,0,12,30,30
1650635206043,MATH 20C,A01,083760,Staff,0,15,30,30
1650635206043,MATH 20C,A02,083761,Staff,1,13,30,29
1650635206043,MATH 20C,B01,083762,Staff,11,0,30,19
1650635206043,MATH 20C,B02,083763,Staff,28,0,30,2
1650635212084,MATH 20D,A01,083765,Staff,1,1,30,29
1650635212084,MATH 20D,A02,083766,Staff,7,0,30,23
1650635212084,MATH 20D,A03,083767,Staff,24,0,30,6
1650635218111,MATH 20E,A01,083771,Staff,3,0,30,27
1650635218111,MATH 20E,A02,083772,Staff,17,0,30,13
1650635218111,MATH 20E,B01,083773,Staff,0,0,30,30
1650635218111,MATH 20E,B02,083774,Staff,9,0,30,21
1650635224136,MATH 103A,A01,083777,Staff,0,15,30,30
1650635224136,MATH 103A,A02,083778,Staff,0,15,30,30
1650635224136,MATH 103A,B01,083779,Staff,0,14,30,30
1650635224136,MATH 103A,B02,083780,Staff,0,14,30,30
1650635230164,MATH 105,A01,085443,Staff,0,22,30,30
1650635236205,MATH 109,A01,083213,Anzaldo; Leesa B,0,6,30,30
1650635236205,MATH 109,A02,083214,Anzaldo; Leesa B,0,7,30,30
1650635236205,MATH 109,B01,083215,Anzaldo; Leesa B,0,6,30,30
1650635236205,MATH 109,B02,083216,Anzaldo; Leesa B,0,6,30,30
1650635242235,MATH 142A,A01,083219,Chow; Bennett,0,16,30,30
1650635242235,MATH 142A,A02,083220,Chow; Bennett,0,15,30,30
1650635242235,MATH 142A,B01,083221,Chow; Bennett,0,14,30,30
1650635242235,MATH 142A,B02,083222,Chow; Bennett,0,13,30,30
1650635248262,MATH 193A,A01,083224,Staff,0,5,30,30
1650635248262,MATH 193A,A02,083225,Staff,0,6,30,30
1650635248262,MATH 193A,A03,083781,Staff,0,6,30,30
1650635248262,MATH 193A,A04,083782,Staff,0,7,30,30
1650635254299,MATH 197,001,091859,McAuley; Julian John,9998,0,9999,1
1650635260394,COGS 9,A01,083615,Staff,0,15,60,60
1650635266422,COGS 11,A01,083617,Boyle; Mary E. T.,18,0,40,22
1650635272537,COGS 13,A01,083071,Staff,0,38,40,40
1650635278564,COGS 14A,A01,092681,Staff,0,31,100,100
1650635284595,COGS 14B,A01,083073,Cheng; Tzu-Han,0,13,50,50
1650635290619,COGS 17,A01,092677,Staff,17,0,75,58
1650635296642,COGS 100,A01,083619,Staff,0,26,60,60
1650635302705,COGS 101A,A01,083621,Davis; Joshua Daniel,0,26,60,60
1650635308731,COGS 101B,A01,091572,Staff,0,4,60,60
1650635314762,COGS 101C,A01,083625,Delgado; Tania,15,0,30,15
1650635320787,COGS 107A,A01,083627,Boyle; Mary E. T.,1,15,60,59
1650635326822,COGS 118A,A01,083075,Staff,0,6,60,60
1650635332851,CSE 3,A50,083646,Miranda; Gregory Joseph,19,0,38,19
1650635332851,CSE 3,A51,083647,Miranda; Gregory Joseph,36,0,37,1
1650635338886,CSE 8A,A50,083650,Miranda; Gregory Joseph,0,30,40,40
1650635344917,CSE 11,A01,083080,Cao; Yingjun,0,95,40,40
1650635350960,CSE 12,A01,083652,Staff,0,19,100,100
1650635356985,CSE 15L,A01,083654,Staff,0,2,50,50
1650635356985,CSE 15L,A02,083655,Staff,0,1,50,50
1650635363011,CSE 20,A01,083657,Staff,51,0,80,29
1650635369053,CSE 30,A01,083084,Eldon; John,0,77,40,40
1650635375077,CSE 100,A01,083659,Cao; Yingjun,0,68,50,50
1650635381105,CSE 134B,A01,083661,Powell; Thomas Allan,0,35,65,65
1650635387128,CSE 140,A01,083663,Staff,0,8,75,75
1650635393155,CSE 140L,A01,083088,Eldon; John,0,16,75,75
1650635399179,CSE 175,A01,083665,Kumar; Rakesh,7,0,25,18
1650635405217,CSE 190,A00,092507,Dubnov; Shlomo,10,0,20,10
1650635411240,ECE 45,A01,083139,Staff,0,1,60,60
1650635417265,ECE 65,A50,083695,Staff,0,5,30,30
1650635423289,ECE 109,A01,091882,Touri; Behrouz,33,0,70,37
1650635429315,ECE 180,A00,083140,Abi Samra; Nicholas Camill,21,0,30,9
1650635429315,ECE 180,B00,083141,Abi Samra; Nicholas Camill,0,0,30,30
1650635435341,MATH 10A,A01,083735,Patchell; Gregory David,4,0,30,26
1650635435341,MATH 10A,A02,083736,Patchell; Gregory David,27,0,30,3
1650635435341,MATH 10A,A03,083737,Patchell; Gregory David,24,0,30,6
1650635441372,MATH 10B,A01,083207,Staff,0,8,30,30
1650635441372,MATH 10B,A02,083208,Staff,0,8,30,30
1650635441372,MATH 10B,B01,083739,Staff,11,0,30,19
1650635441372,MATH 10B,B02,083740,Staff,28,0,30,2
1650635447413,MATH 18,A01,083743,Staff,0,0,30,30
1650635447413,MATH 18,A02,083744,Staff,23,0,30,7
1650635447413,MATH 18,A03,083745,Staff,21,0,30,9
1650635447413,MATH 18,A04,083746,Staff,26,0,30,4
1650635447413,MATH 18,B01,083748,Staff,0,15,30,30
1650635447413,MATH 18,B02,083749,Staff,0,11,30,30
1650635447413,MATH 18,B03,083750,Staff,0,12,30,30
1650635447413,MATH 18,B04,083751,Staff,0,12,30,30
1650635453450,MATH 20A,A01,083754,Staff,19,0,40,21
1650635459478,MATH 20B,A01,083756,Staff,0,12,30,30
1650635459478,MATH 20B,A02,083757,Staff,0,12,30,30
1650635465503,MATH 20C,A01,083760,Staff,0,15,30,30
1650635465503,MATH 20C,A02,083761,Staff,1,13,30,29
1650635465503,MATH 20C,B01,083762,Staff,11,0,30,19
1650635465503,MATH 20C,B02,083763,Staff,28,0,30,2
1650635471535,MATH 20D,A01,083765,Staff,1,1,30,29
1650635471535,MATH 20D,A02,083766,Staff,7,0,30,23
1650635471535,MATH 20D,A03,083767,Staff,24,0,30,6
1650635477584,MATH 20E,A01,083771,Staff,3,0,30,27
1650635477584,MATH 20E,A02,083772,Staff,17,0,30,13
1650635477584,MATH 20E,B01,083773,Staff,0,0,30,30
1650635477584,MATH 20E,B02,083774,Staff,9,0,30,21
1650635483609,MATH 103A,A01,083777,Staff,0,15,30,30
1650635483609,MATH 103A,A02,083778,Staff,0,15,30,30
1650635483609,MATH 103A,B01,083779,Staff,0,14,30,30
1650635483609,MATH 103A,B02,083780,Staff,0,14,30,30
1650635489650,MATH 105,A01,085443,Staff,0,22,30,30
1650635495688,MATH 109,A01,083213,Anzaldo; Leesa B,0,6,30,30
1650635495688,MATH 109,A02,083214,Anzaldo; Leesa B,0,7,30,30
1650635495688,MATH 109,B01,083215,Anzaldo; Leesa B,0,6,30,30
1650635495688,MATH 109,B02,083216,Anzaldo; Leesa B,0,6,30,30
1650635501727,MATH 142A,A01,083219,Chow; Bennett,0,16,30,30
1650635501727,MATH 142A,A02,083220,Chow; Bennett,0,15,30,30
1650635501727,MATH 142A,B01,083221,Chow; Bennett,0,14,30,30
1650635501727,MATH 142A,B02,083222,Chow; Bennett,0,13,30,30
1650635507751,MATH 193A,A01,083224,Staff,0,5,30,30
1650635507751,MATH 193A,A02,083225,Staff,0,6,30,30
1650635507751,MATH 193A,A03,083781,Staff,0,6,30,30
1650635507751,MATH 193A,A04,083782,Staff,0,7,30,30
1650635513778,MATH 197,001,091859,McAuley; Julian John,9998,0,9999,1
1650635519835,COGS 9,A01,083615,Staff,0,15,60,60
1650635525868,COGS 11,A01,083617,Boyle; Mary E. T.,18,0,40,22
1650635531895,COGS 13,A01,083071,Staff,0,38,40,40
1650635537922,COGS 14A,A01,092681,Staff,0,31,100,100
1650635543948,COGS 14B,A01,083073,Cheng; Tzu-Han,0,13,50,50
1650635549974,COGS 17,A01,092677,Staff,17,0,75,58
1650635556007,COGS 100,A01,083619,Staff,0,26,60,60
1650635562031,COGS 101A,A01,083621,Davis; Joshua Daniel,0,26,60,60
1650635568077,COGS 101B,A01,091572,Staff,0,4,60,60
1650635574102,COGS 101C,A01,083625,Delgado; Tania,15,0,30,15
1650635580144,COGS 107A,A01,083627,Boyle; Mary E. T.,1,15,60,59
1650635586176,COGS 118A,A01,083075,Staff,0,6,60,60
1650635592201,CSE 3,A50,083646,Miranda; Gregory Joseph,19,0,38,19
1650635592201,CSE 3,A51,083647,Miranda; Gregory Joseph,36,0,37,1
1650635598232,CSE 8A,A50,083650,Miranda; Gregory Joseph,0,30,40,40
1650635604258,CSE 11,A01,083080,Cao; Yingjun,0,95,40,40
1650635610290,CSE 12,A01,083652,Staff,0,19,100,100
1650635616317,CSE 15L,A01,083654,Staff,0,2,50,50
1650635616317,CSE 15L,A02,083655,Staff,0,1,50,50
1650635622351,CSE 20,A01,083657,Staff,51,0,80,29
1650635628378,CSE 30,A01,083084,Eldon; John,0,77,40,40
1650635634407,CSE 100,A01,083659,Cao; Yingjun,0,68,50,50
1650635640435,CSE 134B,A01,083661,Powell; Thomas Allan,0,35,65,65
1650635646463,CSE 140,A01,083663,Staff,0,8,75,75
1650635652486,CSE 140L,A01,083088,Eldon; John,0,16,75,75
1650635658516,CSE 175,A01,083665,Kumar; Rakesh,7,0,25,18
1650635664543,CSE 190,A00,092507,Dubnov; Shlomo,10,0,20,10
1650635670571,ECE 45,A01,083139,Staff,0,1,60,60
1650635676594,ECE 65,A50,083695,Staff,0,5,30,30
1650635682616,ECE 109,A01,091882,Touri; Behrouz,33,0,70,37
1650635688664,ECE 180,A00,083140,Abi Samra; Nicholas Camill,21,0,30,9
1650635688664,ECE 180,B00,083141,Abi Samra; Nicholas Camill,0,0,30,30
1650635694687,MATH 10A,A01,083735,Patchell; Gregory David,4,0,30,26
1650635694687,MATH 10A,A02,083736,Patchell; Gregory David,27,0,30,3
1650635694687,MATH 10A,A03,083737,Patchell; Gregory David,24,0,30,6
1650635700713,MATH 10B,A01,083207,Staff,0,8,30,30
1650635700713,MATH 10B,A02,083208,Staff,0,8,30,30
1650635700713,MATH 10B,B01,083739,Staff,11,0,30,19
1650635700713,MATH 10B,B02,083740,Staff,28,0,30,2
1650635706762,MATH 18,A01,083743,Staff,0,0,30,30
1650635706762,MATH 18,A02,083744,Staff,23,0,30,7
1650635706762,MATH 18,A03,083745,Staff,21,0,30,9
1650635706762,MATH 18,A04,083746,Staff,26,0,30,4
1650635706762,MATH 18,B01,083748,Staff,0,15,30,30
1650635706762,MATH 18,B02,083749,Staff,0,11,30,30
1650635706762,MATH 18,B03,083750,Staff,0,12,30,30
1650635706762,MATH 18,B04,083751,Staff,0,12,30,30
1650635712788,MATH 20A,A01,083754,Staff,19,0,40,21
1650635718830,MATH 20B,A01,083756,Staff,0,12,30,30
1650635718830,MATH 20B,A02,083757,Staff,0,12,30,30
1650635724855,MATH 20C,A01,083760,Staff,0,15,30,30
1650635724855,MATH 20C,A02,083761,Staff,1,13,30,29
1650635724855,MATH 20C,B01,083762,Staff,11,0,30,19
1650635724855,MATH 20C,B02,083763,Staff,28,0,30,2
1650635730883,MATH 20D,A01,083765,Staff,1,1,30,29
1650635730883,MATH 20D,A02,083766,Staff,7,0,30,23
1650635730883,MATH 20D,A03,083767,Staff,24,0,30,6
1650635736908,MATH 20E,A01,083771,Staff,3,0,30,27
1650635736908,MATH 20E,A02,083772,Staff,17,0,30,13
1650635736908,MATH 20E,B01,083773,Staff,0,0,30,30
1650635736908,MATH 20E,B02,083774,Staff,9,0,30,21
1650635742938,MATH 103A,A01,083777,Staff,0,15,30,30
1650635742938,MATH 103A,A02,083778,Staff,0,15,30,30
1650635742938,MATH 103A,B01,083779,Staff,0,14,30,30
1650635742938,MATH 103A,B02,083780,Staff,0,14,30,30
1650635748978,MATH 105,A01,085443,Staff,0,22,30,30
1650635755003,MATH 109,A01,083213,Anzaldo; Leesa B,0,6,30,30
1650635755003,MATH 109,A02,083214,Anzaldo; Leesa B,0,7,30,30
1650635755003,MATH 109,B01,083215,Anzaldo; Leesa B,0,6,30,30
1650635755003,MATH 109,B02,083216,Anzaldo; Leesa B,0,6,30,30
1650635761047,MATH 142A,A01,083219,Chow; Bennett,0,16,30,30
1650635761047,MATH 142A,A02,083220,Chow; Bennett,0,15,30,30
1650635761047,MATH 142A,B01,083221,Chow; Bennett,0,14,30,30
1650635761047,MATH 142A,B02,083222,Chow; Bennett,0,13,30,30
1650635767073,MATH 193A,A01,083224,Staff,0,5,30,30
1650635767073,MATH 193A,A02,083225,Staff,0,6,30,30
1650635767073,MATH 193A,A03,083781,Staff,0,6,30,30
1650635767073,MATH 193A,A04,083782,Staff,0,7,30,30
1650635773106,MATH 197,001,091859,McAuley; Julian John,9998,0,9999,1
1650635779166,COGS 9,A01,083615,Staff,0,15,60,60
1650635785205,COGS 11,A01,083617,Boyle; Mary E. T.,18,0,40,22
1650635791230,COGS 13,A01,083071,Staff,0,38,40,40
1650635797255,COGS 14A,A01,092681,Staff,0,31,100,100
1650635803282,COGS 14B,A01,083073,Cheng; Tzu-Han,0,13,50,50
1650635809317,COGS 17,A01,092677,Staff,17,0,75,58
1650635815349,COGS 100,A01,083619,Staff,0,26,60,60
1650635821375,COGS 101A,A01,083621,Davis; Joshua Daniel,0,26,60,60
1650635827402,COGS 101B,A01,091572,Staff,0,4,60,60
1650635833431,COGS 101C,A01,083625,Delgado; Tania,15,0,30,15
1650635839482,COGS 107A,A01,083627,Boyle; Mary E. T.,1,15,60,59
1650635845512,COGS 118A,A01,083075,Staff,0,6,60,60
1650635851537,CSE 3,A50,083646,Miranda; Gregory Joseph,19,0,38,19
1650635851537,CSE 3,A51,083647,Miranda; Gregory Joseph,36,0,37,1
1650635857566,CSE 8A,A50,083650,Miranda; Gregory Joseph,0,30,40,40
1650635863592,CSE 11,A01,083080,Cao; Yingjun,0,95,40,40
1650635869700,CSE 12,A01,083652,Staff,0,19,100,100
1650635875727,CSE 15L,A01,083654,Staff,0,2,50,50
1650635875727,CSE 15L,A02,083655,Staff,0,1,50,50
1650635881773,CSE 20,A01,083657,Staff,51,0,80,29
1650635887798,CSE 30,A01,083084,Eldon; John,0,77,40,40
1650635893830,CSE 100,A01,083659,Cao; Yingjun,0,68,50,50
1650635899858,CSE 134B,A01,083661,Powell; Thomas Allan,0,35,65,65
1650635905883,CSE 140,A01,083663,Staff,0,8,75,75
1650635911908,CSE 140L,A01,083088,Eldon; John,0,16,75,75
1650635917940,CSE 175,A01,083665,Kumar; Rakesh,7,0,25,18
1650635923966,CSE 190,A00,092507,Dubnov; Shlomo,10,0,20,10
1650635929993,ECE 45,A01,083139,Staff,0,1,60,60
1650635936020,ECE 65,A50,083695,Staff,0,5,30,30
1650635942045,ECE 109,A01,091882,Touri; Behrouz,33,0,70,37
1650635948070,ECE 180,A00,083140,Abi Samra; Nicholas Camill,21,0,30,9
1650635948070,ECE 180,B00,083141,Abi Samra; Nicholas Camill,0,0,30,30
1650635954093,MATH 10A,A01,083735,Patchell; Gregory David,4,0,30,26
1650635954093,MATH 10A,A02,083736,Patchell; Gregory David,27,0,30,3
1650635954093,MATH 10A,A03,083737,Patchell; Gregory David,24,0,30,6
1650635960118,MATH 10B,A01,083207,Staff,0,8,30,30
1650635960118,MATH 10B,A02,083208,Staff,0,8,30,30
1650635960118,MATH 10B,B01,083739,Staff,11,0,30,19
1650635960118,MATH 10B,B02,083740,Staff,28,0,30,2
1650635966153,MATH 18,A01,083743,Staff,0,0,30,30
1650635966153,MATH 18,A02,083744,Staff,23,0,30,7
1650635966153,MATH 18,A03,083745,Staff,21,0,30,9
1650635966153,MATH 18,A04,083746,Staff,26,0,30,4
1650635966153,MATH 18,B01,083748,Staff,0,15,30,30
1650635966153,MATH 18,B02,083749,Staff,0,11,30,30
1650635966153,MATH 18,B03,083750,Staff,0,12,30,30
1650635966153,MATH 18,B04,083751,Staff,0,12,30,30
1650635972199,MATH 20A,A01,083754,Staff,19,0,40,21
1650635978224,MATH 20B,A01,083756,Staff,0,12,30,30
1650635978224,MATH 20B,A02,083757,Staff,0,12,30,30
1650635984251,MATH 20C,A01,083760,Staff,0,15,30,30
1650635984251,MATH 20C,A02,083761,Staff,1,13,30,29
1650635984251,MATH 20C,B01,083762,Staff,11,0,30,19
1650635984251,MATH 20C,B02,083763,Staff,28,0,30,2
1650635990304,MATH 20D,A01,083765,Staff,1,1,30,29
1650635990304,MATH 20D,A02,083766,Staff,7,0,30,23
1650635990304,MATH 20D,A03,083767,Staff,24,0,30,6
1650635996346,MATH 20E,A01,083771,Staff,3,0,30,27
1650635996346,MATH 20E,A02,083772,Staff,17,0,30,13
1650635996346,MATH 20E,B01,083773,Staff,0,0,30,30
1650635996346,MATH 20E,B02,083774,Staff,9,0,30,21
1650636002378,MATH 103A,A01,083777,Staff,0,15,30,30
1650636002378,MATH 103A,A02,083778,Staff,0,15,30,30
1650636002378,MATH 103A,B01,083779,Staff,0,14,30,30
1650636002378,MATH 103A,B02,083780,Staff,0,14,30,30
1650636008411,MATH 105,A01,085443,Staff,0,22,30,30
1650636014449,MATH 109,A01,083213,Anzaldo; Leesa B,0,6,30,30
1650636014449,MATH 109,A02,083214,Anzaldo; Leesa B,0,7,30,30
1650636014449,MATH 109,B01,083215,Anzaldo; Leesa B,0,6,30,30
1650636014449,MATH 109,B02,083216,Anzaldo; Leesa B,0,6,30,30
1650636020480,MATH 142A,A01,083219,Chow; Bennett,0,16,30,30
1650636020480,MATH 142A,A02,083220,Chow; Bennett,0,15,30,30
1650636020480,MATH 142A,B01,083221,Chow; Bennett,0,14,30,30
1650636020480,MATH 142A,B02,083222,Chow; Bennett,0,13,30,30
1650636026508,MATH 193A,A01,083224,Staff,0,5,30,30
1650636026508,MATH 193A,A02,083225,Staff,0,6,30,30
1650636026508,MATH 193A,A03,083781,Staff,0,6,30,30
1650636026508,MATH 193A,A04,083782,Staff,0,7,30,30
1650636032535,MATH 197,001,091859,McAuley; Julian John,9998,0,9999,1
1650636038593,COGS 9,A01,083615,Staff,0,15,60,60
1650636044618,COGS 11,A01,083617,Boyle; Mary E. T.,18,0,40,22
1650636050647,COGS 13,A01,083071,Staff,0,38,40,40
1650636056671,COGS 14A,A01,092681,Staff,0,31,100,100
1650636062696,COGS 14B,A01,083073,Cheng; Tzu-Han,0,13,50,50
1650636068721,COGS 17,A01,092677,Staff,17,0,75,58
1650636074770,COGS 100,A01,083619,Staff,0,26,60,60
1650636080795,COGS 101A,A01,083621,Davis; Joshua Daniel,0,26,60,60
1650636086823,COGS 101B,A01,091572,Staff,0,4,60,60
1650636092853,COGS 101C,A01,083625,Delgado; Tania,15,0,30,15
1650636098900,COGS 107A,A01,083627,Boyle; Mary E. T.,1,15,60,59
1650636104932,COGS 118A,A01,083075,Staff,0,6,60,60
1650636110962,CSE 3,A50,083646,Miranda; Gregory Joseph,19,0,38,19
1650636110962,CSE 3,A51,083647,Miranda; Gregory Joseph,36,0,37,1
1650636116993,CSE 8A,A50,083650,Miranda; Gregory Joseph,0,30,40,40
1650636123022,CSE 11,A01,083080,Cao; Yingjun,0,95,40,40
1650636129071,CSE 12,A01,083652,Staff,0,19,100,100
1650636135107,CSE 15L,A01,083654,Staff,0,2,50,50
1650636135107,CSE 15L,A02,083655,Staff,0,1,50,50
1650636141133,CSE 20,A01,083657,Staff,51,0,80,29
1650636147175,CSE 30,A01,083084,Eldon; John,0,77,40,40
1650636153220,CSE 100,A01,083659,Cao; Yingjun,0,68,50,50
1650636159249,CSE 134B,A01,083661,Powell; Thomas Allan,0,35,65,65
1650636165299,CSE 140,A01,083663,Staff,0,8,75,75
1650636171338,CSE 140L,A01,083088,Eldon; John,0,16,75,75
1650636177380,CSE 175,A01,083665,Kumar; Rakesh,7,0,25,18
1650636183406,CSE 190,A00,092507,Dubnov; Shlomo,10,0,20,10
1650636189432,ECE 45,A01,083139,Staff,0,1,60,60
1650636195456,ECE 65,A50,083695,Staff,0,5,30,30
1650636201491,ECE 109,A01,091882,Touri; Behrouz,33,0,70,37
1650636207515,ECE 180,A00,083140,Abi Samra; Nicholas Camill,21,0,30,9
1650636207515,ECE 180,B00,083141,Abi Samra; Nicholas Camill,0,0,30,30
1650636213553,MATH 10A,A01,083735,Patchell; Gregory David,4,0,30,26
1650636213553,MATH 10A,A02,083736,Patchell; Gregory David,27,0,30,3
1650636213553,MATH 10A,A03,083737,Patchell; Gregory David,24,0,30,6
1650636219577,MATH 10B,A01,083207,Staff,0,8,30,30
1650636219577,MATH 10B,A02,083208,Staff,0,8,30,30
1650636219577,MATH 10B,B01,083739,Staff,11,0,30,19
1650636219577,MATH 10B,B02,083740,Staff,28,0,30,2
1650636225613,MATH 18,A01,083743,Staff,0,0,30,30
1650636225613,MATH 18,A02,083744,Staff,23,0,30,7
1650636225613,MATH 18,A03,083745,Staff,21,0,30,9
1650636225613,MATH 18,A04,083746,Staff,26,0,30,4
1650636225613,MATH 18,B01,083748,Staff,0,15,30,30
1650636225613,MATH 18,B02,083749,Staff,0,11,30,30
1650636225613,MATH 18,B03,083750,Staff,0,12,30,30
1650636225613,MATH 18,B04,083751,Staff,0,12,30,30
1650636231640,MATH 20A,A01,083754,Staff,19,0,40,21
1650636237668,MATH 20B,A01,083756,Staff,0,12,30,30
1650636237668,MATH 20B,A02,083757,Staff,0,12,30,30
1650636243702,MATH 20C,A01,083760,Staff,0,15,30,30
1650636243702,MATH 20C,A02,083761,Staff,1,13,30,29
1650636243702,MATH 20C,B01,083762,Staff,11,0,30,19
1650636243702,MATH 20C,B02,083763,Staff,28,0,30,2
1650636249732,MATH 20D,A01,083765,Staff,1,1,30,29
1650636249732,MATH 20D,A02,083766,Staff,7,0,30,23
1650636249732,MATH 20D,A03,083767,Staff,24,0,30,6
1650636255766,MATH 20E,A01,083771,Staff,3,0,30,27
1650636255766,MATH 20E,A02,083772,Staff,17,0,30,13
1650636255766,MATH 20E,B01,083773,Staff,0,0,30,30
1650636255766,MATH 20E,B02,083774,Staff,9,0,30,21
1650636261808,MATH 103A,A01,083777,Staff,0,15,30,30
1650636261808,MATH 103A,A02,083778,Staff,0,15,30,30
1650636261808,MATH 103A,B01,083779,Staff,0,14,30,30
1650636261808,MATH 103A,B02,083780,Staff,0,14,30,30
1650636267837,MATH 105,A01,085443,Staff,0,22,30,30
1650636273871,MATH 109,A01,083213,Anzaldo; Leesa B,0,6,30,30
1650636273871,MATH 109,A02,083214,Anzaldo; Leesa B,0,7,30,30
1650636273871,MATH 109,B01,083215,Anzaldo; Leesa B,0,6,30,30
1650636273871,MATH 109,B02,083216,Anzaldo; Leesa B,0,6,30,30
1650636279900,MATH 142A,A01,083219,Chow; Bennett,0,16,30,30
1650636279900,MATH 142A,A02,083220,Chow; Bennett,0,15,30,30
1650636279900,MATH 142A,B01,083221,Chow; Bennett,0,14,30,30
1650636279900,MATH 142A,B02,083222,Chow; Bennett,0,13,30,30
1650636285940,MATH 193A,A01,083224,Staff,0,5,30,30
1650636285940,MATH 193A,A02,083225,Staff,0,6,30,30
1650636285940,MATH 193A,A03,083781,Staff,0,6,30,30
1650636285940,MATH 193A,A04,083782,Staff,0,7,30,30
1650636291965,MATH 197,001,091859,McAuley; Julian John,9998,0,9999,1
1650636298037,COGS 9,A01,083615,Staff,0,15,60,60
1650636304067,COGS 11,A01,083617,Boyle; Mary E. T.,18,0,40,22
1650636310104,COGS 13,A01,083071,Staff,0,38,40,40
1650636316132,COGS 14A,A01,092681,Staff,0,31,100,100
1650636322156,COGS 14B,A01,083073,Cheng; Tzu-Han,0,13,50,50
1650636328184,COGS 17,A01,092677,Staff,17,0,75,58
1650636334207,COGS 100,A01,083619,Staff,0,26,60,60
1650636340232,COGS 101A,A01,083621,Davis; Joshua Daniel,0,26,60,60
1650636346270,COGS 101B,A01,091572,Staff,0,4,60,60
1650636352298,COGS 101C,A01,083625,Delgado; Tania,15,0,30,15
1650636358327,COGS 107A,A01,083627,Boyle; Mary E. T.,1,15,60,59
1650636364352,COGS 118A,A01,083075,Staff,0,6,60,60
1650636370386,CSE 3,A50,083646,Miranda; Gregory Joseph,19,0,38,19
1650636370386,CSE 3,A51,083647,Miranda; Gregory Joseph,36,0,37,1
1650636376414,CSE 8A,A50,083650,Miranda; Gregory Joseph,0,30,40,40
1650636382459,CSE 11,A01,083080,Cao; Yingjun,0,95,40,40
1650636388483,CSE 12,A01,083652,Staff,0,19,100,100
1650636394507,CSE 15L,A01,083654,Staff,0,2,50,50
1650636394507,CSE 15L,A02,083655,Staff,0,1,50,50
1650636400541,CSE 20,A01,083657,Staff,51,0,80,29
1650636406582,CSE 30,A01,083084,Eldon; John,0,77,40,40
1650636412606,CSE 100,A01,083659,Cao; Yingjun,0,68,50,50
1650636418631,CSE 134B,A01,083661,Powell; Thomas Allan,0,35,65,65
1650636424659,CSE 140,A01,083663,Staff,0,8,75,75
1650636430684,CSE 140L,A01,083088,Eldon; John,0,16,75,75
1650636436712,CSE 175,A01,083665,Kumar; Rakesh,7,0,25,18
1650636442737,CSE 190,A00,092507,Dubnov; Shlomo,10,0,20,10
1650636448765,ECE 45,A01,083139,Staff,0,1,60,60
1650636454792,ECE 65,A50,083695,Staff,0,5,30,30
1650636460824,ECE 109,A01,091882,Touri; Behrouz,33,0,70,37
1650636466952,ECE 180,A00,083140,Abi Samra; Nicholas Camill,21,0,30,9
1650636466952,ECE 180,B00,083141,Abi Samra; Nicholas Camill,0,0,30,30
1650636472977,MATH 10A,A01,083735,Patchell; Gregory David,4,0,30,26
1650636472977,MATH 10A,A02,083736,Patchell; Gregory David,27,0,30,3
1650636472977,MATH 10A,A03,083737,Patchell; Gregory David,24,0,30,6
1650636479003,MATH 10B,A01,083207,Staff,0,8,30,30
1650636479003,MATH 10B,A02,083208,Staff,0,8,30,30
1650636479003,MATH 10B,B01,083739,Staff,11,0,30,19
1650636479003,MATH 10B,B02,083740,Staff,28,0,30,2
1650636485030,MATH 18,A01,083743,Staff,0,0,30,30
1650636485030,MATH 18,A02,083744,Staff,23,0,30,7
1650636485030,MATH 18,A03,083745,Staff,21,0,30,9
1650636485030,MATH 18,A04,083746,Staff,26,0,30,4
1650636485030,MATH 18,B01,083748,Staff,0,15,30,30
1650636485030,MATH 18,B02,083749,Staff,0,11,30,30
1650636485030,MATH 18,B03,083750,Staff,0,12,30,30
1650636485030,MATH 18,B04,083751,Staff,0,12,30,30
1650636491062,MATH 20A,A01,083754,Staff,19,0,40,21
1650636497092,MATH 20B,A01,083756,Staff,0,12,30,30
1650636497092,MATH 20B,A02,083757,Staff,0,12,30,30
1650636503121,MATH 20C,A01,083760,Staff,0,15,30,30
1650636503121,MATH 20C,A02,083761,Staff,1,13,30,29
1650636503121,MATH 20C,B01,083762,Staff,11,0,30,19
1650636503121,MATH 20C,B02,083763,Staff,28,0,30,2
1650636509157,MATH 20D,A01,083765,Staff,1,1,30,29
1650636509157,MATH 20D,A02,083766,Staff,7,0,30,23
1650636509157,MATH 20D,A03,083767,Staff,24,0,30,6
1650636515184,MATH 20E,A01,083771,Staff,3,0,30,27
1650636515184,MATH 20E,A02,083772,Staff,17,0,30,13
1650636515184,MATH 20E,B01,083773,Staff,0,0,30,30
1650636515184,MATH 20E,B02,083774,Staff,9,0,30,21
1650636521218,MATH 103A,A01,083777,Staff,0,15,30,30
1650636521218,MATH 103A,A02,083778,Staff,0,15,30,30
1650636521218,MATH 103A,B01,083779,Staff,0,14,30,30
1650636521218,MATH 103A,B02,083780,Staff,0,14,30,30
1650636527242,MATH 105,A01,085443,Staff,0,22,30,30
1650636533286,MATH 109,A01,083213,Anzaldo; Leesa B,0,6,30,30
1650636533286,MATH 109,A02,083214,Anzaldo; Leesa B,0,7,30,30
1650636533286,MATH 109,B01,083215,Anzaldo; Leesa B,0,6,30,30
1650636533286,MATH 109,B02,083216,Anzaldo; Leesa B,0,6,30,30
1650636539313,MATH 142A,A01,083219,Chow; Bennett,0,16,30,30
1650636539313,MATH 142A,A02,083220,Chow; Bennett,0,15,30,30
1650636539313,MATH 142A,B01,083221,Chow; Bennett,0,14,30,30
1650636539313,MATH 142A,B02,083222,Chow; Bennett,0,13,30,30
1650636545338,MATH 193A,A01,083224,Staff,0,5,30,30
1650636545338,MATH 193A,A02,083225,Staff,0,6,30,30
1650636545338,MATH 193A,A03,083781,Staff,0,6,30,30
1650636545338,MATH 193A,A04,083782,Staff,0,7,30,30
1650636551380,MATH 197,001,091859,McAuley; Julian John,9998,0,9999,1
1650636557431,COGS 9,A01,083615,Staff,0,15,60,60
1650636563456,COGS 11,A01,083617,Boyle; Mary E. T.,18,0,40,22
1650636569481,COGS 13,A01,083071,Staff,0,38,40,40
1650636575505,COGS 14A,A01,092681,Staff,0,31,100,100
1650636581529,COGS 14B,A01,083073,Cheng; Tzu-Han,0,13,50,50
1650636587555,COGS 17,A01,092677,Staff,17,0,75,58
1650636593581,COGS 100,A01,083619,Staff,0,26,60,60
1650636599605,COGS 101A,A01,083621,Davis; Joshua Daniel,0,26,60,60
1650636605633,COGS 101B,A01,091572,Staff,0,4,60,60
1650636611658,COGS 101C,A01,083625,Delgado; Tania,15,0,30,15
1650636617688,COGS 107A,A01,083627,Boyle; Mary E. T.,1,15,60,59
1650636623714,COGS 118A,A01,083075,Staff,0,6,60,60
1650636629738,CSE 3,A50,083646,Miranda; Gregory Joseph,19,0,38,19
1650636629738,CSE 3,A51,083647,Miranda; Gregory Joseph,36,0,37,1
1650636635761,CSE 8A,A50,083650,Miranda; Gregory Joseph,0,30,40,40
1650636641795,CSE 11,A01,083080,Cao; Yingjun,0,95,40,40
1650636647818,CSE 12,A01,083652,Staff,0,19,100,100
1650636653845,CSE 15L,A01,083654,Staff,0,2,50,50
1650636653845,CSE 15L,A02,083655,Staff,0,1,50,50
1650636659874,CSE 20,A01,083657,Staff,51,0,80,29
1650636665916,CSE 30,A01,083084,Eldon; John,0,77,40,40
1650636671943,CSE 100,A01,083659,Cao; Yingjun,0,68,50,50
1650636677968,CSE 134B,A01,083661,Powell; Thomas Allan,0,35,65,65
1650636683993,CSE 140,A01,083663,Staff,0,8,75,75
1650636690018,CSE 140L,A01,083088,Eldon; John,0,16,75,75
1650636696042,CSE 175,A01,083665,Kumar; Rakesh,7,0,25,18
1650636702069,CSE 190,A00,092507,Dubnov; Shlomo,10,0,20,10
1650636708093,ECE 45,A01,083139,Staff,0,1,60,60
1650636714117,ECE 65,A50,083695,Staff,0,5,30,30
1650636720143,ECE 109,A01,091882,Touri; Behrouz,33,0,70,37
1650636726166,ECE 180,A00,083140,Abi Samra; Nicholas Camill,21,0,30,9
1650636726166,ECE 180,B00,083141,Abi Samra; Nicholas Camill,0,0,30,30
1650636732197,MATH 10A,A01,083735,Patchell; Gregory David,4,0,30,26
1650636732197,MATH 10A,A02,083736,Patchell; Gregory David,27,0,30,3
1650636732197,MATH 10A,A03,083737,Patchell; Gregory David,24,0,30,6
1650636738222,MATH 10B,A01,083207,Staff,0,8,30,30
1650636738222,MATH 10B,A02,083208,Staff,0,8,30,30
1650636738222,MATH 10B,B01,083739,Staff,11,0,30,19
1650636738222,MATH 10B,B02,083740,Staff,28,0,30,2
1650636744249,MATH 18,A01,083743,Staff,0,0,30,30
1650636744249,MATH 18,A02,083744,Staff,23,0,30,7
1650636744249,MATH 18,A03,083745,Staff,21,0,30,9
1650636744249,MATH 18,A04,083746,Staff,26,0,30,4
1650636744249,MATH 18,B01,083748,Staff,0,15,30,30
1650636744249,MATH 18,B02,083749,Staff,0,11,30,30
1650636744249,MATH 18,B03,083750,Staff,0,12,30,30
1650636744249,MATH 18,B04,083751,Staff,0,12,30,30
1650636750274,MATH 20A,A01,083754,Staff,19,0,40,21
1650636756298,MATH 20B,A01,083756,Staff,0,12,30,30
1650636756298,MATH 20B,A02,083757,Staff,0,12,30,30
1650636762323,MATH 20C,A01,083760,Staff,0,15,30,30
1650636762323,MATH 20C,A02,083761,Staff,1,13,30,29
1650636762323,MATH 20C,B01,083762,Staff,11,0,30,19
1650636762323,MATH 20C,B02,083763,Staff,28,0,30,2
1650636768347,MATH 20D,A01,083765,Staff,1,1,30,29
1650636768347,MATH 20D,A02,083766,Staff,7,0,30,23
1650636768347,MATH 20D,A03,083767,Staff,24,0,30,6
1650636774376,MATH 20E,A01,083771,Staff,3,0,30,27
1650636774376,MATH 20E,A02,083772,Staff,17,0,30,13
1650636774376,MATH 20E,B01,083773,Staff,0,0,30,30
1650636774376,MATH 20E,B02,083774,Staff,9,0,30,21
1650636780413,MATH 103A,A01,083777,Staff,0,15,30,30
1650636780413,MATH 103A,A02,083778,Staff,0,15,30,30
1650636780413,MATH 103A,B01,083779,Staff,0,14,30,30
1650636780413,MATH 103A,B02,083780,Staff,0,14,30,30
1650636786439,MATH 105,A01,085443,Staff,0,22,30,30
1650636792468,MATH 109,A01,083213,Anzaldo; Leesa B,0,6,30,30
1650636792468,MATH 109,A02,083214,Anzaldo; Leesa B,0,7,30,30
1650636792468,MATH 109,B01,083215,Anzaldo; Leesa B,0,6,30,30
1650636792468,MATH 109,B02,083216,Anzaldo; Leesa B,0,6,30,30
1650636798492,MATH 142A,A01,083219,Chow; Bennett,0,16,30,30
1650636798492,MATH 142A,A02,083220,Chow; Bennett,0,15,30,30
1650636798492,MATH 142A,B01,083221,Chow; Bennett,0,14,30,30
1650636798492,MATH 142A,B02,083222,Chow; Bennett,0,13,30,30
1650636804517,MATH 193A,A01,083224,Staff,0,5,30,30
1650636804517,MATH 193A,A02,083225,Staff,0,6,30,30
1650636804517,MATH 193A,A03,083781,Staff,0,6,30,30
1650636804517,MATH 193A,A04,083782,Staff,0,7,30,30
1650636810543,MATH 197,001,091859,McAuley; Julian John,9998,0,9999,1
1650636816595,COGS 9,A01,083615,Staff,0,15,60,60
1650636822622,COGS 11,A01,083617,Boyle; Mary E. T.,18,0,40,22
1650636828646,COGS 13,A01,083071,Staff,0,38,40,40
1650636834670,COGS 14A,A01,092681,Staff,0,31,100,100
1650636840700,COGS 14B,A01,083073,Cheng; Tzu-Han,0,13,50,50
1650636846726,COGS 17,A01,092677,Staff,17,0,75,58
1650636852751,COGS 100,A01,083619,Staff,0,26,60,60
1650636858779,COGS 101A,A01,083621,Davis; Joshua Daniel,0,26,60,60
1650636864807,COGS 101B,A01,091572,Staff,0,4,60,60
1650636870830,COGS 101C,A01,083625,Delgado; Tania,15,0,30,15
1650636876853,COGS 107A,A01,083627,Boyle; Mary E. T.,1,15,60,59
1650636882878,COGS 118A,A01,083075,Staff,0,6,60,60
1650636888906,CSE 3,A50,083646,Miranda; Gregory Joseph,19,0,38,19
1650636888906,CSE 3,A51,083647,Miranda; Gregory Joseph,36,0,37,1
1650636894931,CSE 8A,A50,083650,Miranda; Gregory Joseph,0,30,40,40
1650636900958,CSE 11,A01,083080,Cao; Yingjun,0,95,40,40
1650636906989,CSE 12,A01,083652,Staff,0,19,100,100
1650636913020,CSE 15L,A01,083654,Staff,0,2,50,50
1650636913020,CSE 15L,A02,083655,Staff,0,1,50,50
1650636919054,CSE 20,A01,083657,Staff,51,0,80,29
1650636925080,CSE 30,A01,083084,Eldon; John,0,77,40,40
1650636931102,CSE 100,A01,083659,Cao; Yingjun,0,68,50,50
1650636937126,CSE 134B,A01,083661,Powell; Thomas Allan,0,35,65,65
1650636943148,CSE 140,A01,083663,Staff,0,8,75,75
1650636949173,CSE 140L,A01,083088,Eldon; John,0,16,75,75
1650636955198,CSE 175,A01,083665,Kumar; Rakesh,7,0,25,18
1650636961231,CSE 190,A00,092507,Dubnov; Shlomo,10,0,20,10
1650636967255,ECE 45,A01,083139,Staff,0,1,60,60
1650636973283,ECE 65,A50,083695,Staff,0,5,30,30
1650636979310,ECE 109,A01,091882,Touri; Behrouz,33,0,70,37
1650636985335,ECE 180,A00,083140,Abi Samra; Nicholas Camill,21,0,30,9
1650636985335,ECE 180,B00,083141,Abi Samra; Nicholas Camill,0,0,30,30
1650636991360,MATH 10A,A01,083735,Patchell; Gregory David,4,0,30,26
1650636991360,MATH 10A,A02,083736,Patchell; Gregory David,27,0,30,3
1650636991360,MATH 10A,A03,083737,Patchell; Gregory David,24,0,30,6
1650636997383,MATH 10B,A01,083207,Staff,0,8,30,30
1650636997383,MATH 10B,A02,083208,Staff,0,8,30,30
1650636997383,MATH 10B,B01,083739,Staff,11,0,30,19
1650636997383,MATH 10B,B02,083740,Staff,28,0,30,2
1650637003409,MATH 18,A01,083743,Staff,0,0,30,30
1650637003409,MATH 18,A02,083744,Staff,23,0,30,7
1650637003409,MATH 18,A03,083745,Staff,21,0,30,9
1650637003409,MATH 18,A04,083746,Staff,26,0,30,4
1650637003409,MATH 18,B01,083748,Staff,0,15,30,30
1650637003409,MATH 18,B02,083749,Staff,0,11,30,30
1650637003409,MATH 18,B03,083750,Staff,0,12,30,30
1650637003409,MATH 18,B04,083751,Staff,0,12,30,30
1650637009438,MATH 20A,A01,083754,Staff,19,0,40,21
1650637015467,MATH 20B,A01,083756,Staff,0,12,30,30
1650637015467,MATH 20B,A02,083757,Staff,0,12,30,30
1650637021496,MATH 20C,A01,083760,Staff,0,15,30,30
1650637021496,MATH 20C,A02,083761,Staff,1,13,30,29
1650637021496,MATH 20C,B01,083762,Staff,11,0,30,19
1650637021496,MATH 20C,B02,083763,Staff,28,0,30,2
1650637027531,MATH 20D,A01,083765,Staff,1,1,30,29
1650637027531,MATH 20D,A02,083766,Staff,7,0,30,23
1650637027531,MATH 20D,A03,083767,Staff,24,0,30,6
1650637033557,MATH 20E,A01,083771,Staff,3,0,30,27
1650637033557,MATH 20E,A02,083772,Staff,17,0,30,13
1650637033557,MATH 20E,B01,083773,Staff,0,0,30,30
1650637033557,MATH 20E,B02,083774,Staff,9,0,30,21
1650637039582,MATH 103A,A01,083777,Staff,0,15,30,30
1650637039582,MATH 103A,A02,083778,Staff,0,15,30,30
1650637039582,MATH 103A,B01,083779,Staff,0,14,30,30
1650637039582,MATH 103A,B02,083780,Staff,0,14,30,30
1650637045605,MATH 105,A01,085443,Staff,0,22,30,30
1650637051631,MATH 109,A01,083213,Anzaldo; Leesa B,0,6,30,30
1650637051631,MATH 109,A02,083214,Anzaldo; Leesa B,0,7,30,30
1650637051631,MATH 109,B01,083215,Anzaldo; Leesa B,0,6,30,30
1650637051631,MATH 109,B02,083216,Anzaldo; Leesa B,0,6,30,30
1650637057667,MATH 142A,A01,083219,Chow; Bennett,0,16,30,30
1650637057667,MATH 142A,A02,083220,Chow; Bennett,0,15,30,30
1650637057667,MATH 142A,B01,083221,Chow; Bennett,0,14,30,30
1650637057667,MATH 142A,B02,083222,Chow; Bennett,0,13,30,30
1650637063789,MATH 193A,A01,083224,Staff,0,5,30,30
1650637063789,MATH 193A,A02,083225,Staff,0,6,30,30
1650637063789,MATH 193A,A03,083781,Staff,0,6,30,30
1650637063789,MATH 193A,A04,083782,Staff,0,7,30,30
1650637069815,MATH 197,001,091859,McAuley; Julian John,9998,0,9999,1
1650637075875,COGS 9,A01,083615,Staff,0,15,60,60
1650637081900,COGS 11,A01,083617,Boyle; Mary E. T.,18,0,40,22
1650637087925,COGS 13,A01,083071,Staff,0,38,40,40
1650637093952,COGS 14A,A01,092681,Staff,0,31,100,100
1650637099977,COGS 14B,A01,083073,Cheng; Tzu-Han,0,13,50,50
1650637106002,COGS 17,A01,092677,Staff,17,0,75,58
1650637112027,COGS 100,A01,083619,Staff,0,26,60,60
1650637118051,COGS 101A,A01,083621,Davis; Joshua Daniel,0,26,60,60
1650637124078,COGS 101B,A01,091572,Staff,0,4,60,60
1650637130100,COGS 101C,A01,083625,Delgado; Tania,15,0,30,15
1650637136126,COGS 107A,A01,083627,Boyle; Mary E. T.,1,15,60,59
1650637142154,COGS 118A,A01,083075,Staff,0,6,60,60
1650637148179,CSE 3,A50,083646,Miranda; Gregory Joseph,19,0,38,19
1650637148179,CSE 3,A51,083647,Miranda; Gregory Joseph,36,0,37,1
1650637154207,CSE 8A,A50,083650,Miranda; Gregory Joseph,0,30,40,40
1650637160234,CSE 11,A01,083080,Cao; Yingjun,0,95,40,40
1650637166259,CSE 12,A01,083652,Staff,0,19,100,100
1650637172285,CSE 15L,A01,083654,Staff,0,2,50,50
1650637172285,CSE 15L,A02,083655,Staff,0,1,50,50
1650637178309,CSE 20,A01,083657,Staff,51,0,80,29
1650637184336,CSE 30,A01,083084,Eldon; John,0,77,40,40
1650637190360,CSE 100,A01,083659,Cao; Yingjun,0,68,50,50
1650637196384,CSE 134B,A01,083661,Powell; Thomas Allan,0,35,65,65
1650637202411,CSE 140,A01,083663,Staff,0,8,75,75
1650637208438,CSE 140L,A01,083088,Eldon; John,0,16,75,75
1650637214462,CSE 175,A01,083665,Kumar; Rakesh,7,0,25,18
1650637220491,CSE 190,A00,092507,Dubnov; Shlomo,10,0,20,10
1650637226519,ECE 45,A01,083139,Staff,0,1,60,60
1650637232543,ECE 65,A50,083695,Staff,0,5,30,30
1650637238568,ECE 109,A01,091882,Touri; Behrouz,33,0,70,37
1650637244593,ECE 180,A00,083140,Abi Samra; Nicholas Camill,21,0,30,9
1650637244593,ECE 180,B00,083141,Abi Samra; Nicholas Camill,0,0,30,30
1650637250622,MATH 10A,A01,083735,Patchell; Gregory David,4,0,30,26
1650637250622,MATH 10A,A02,083736,Patchell; Gregory David,27,0,30,3
1650637250622,MATH 10A,A03,083737,Patchell; Gregory David,24,0,30,6
1650637256647,MATH 10B,A01,083207,Staff,0,8,30,30
1650637256647,MATH 10B,A02,083208,Staff,0,8,30,30
1650637256647,MATH 10B,B01,083739,Staff,11,0,30,19
1650637256647,MATH 10B,B02,083740,Staff,28,0,30,2
1650637262674,MATH 18,A01,083743,Staff,0,0,30,30
1650637262674,MATH 18,A02,083744,Staff,23,0,30,7
1650637262674,MATH 18,A03,083745,Staff,21,0,30,9
1650637262674,MATH 18,A04,083746,Staff,26,0,30,4
1650637262674,MATH 18,B01,083748,Staff,0,15,30,30
1650637262674,MATH 18,B02,083749,Staff,0,11,30,30
1650637262674,MATH 18,B03,083750,Staff,0,12,30,30
1650637262674,MATH 18,B04,083751,Staff,0,12,30,30
1650637268698,MATH 20A,A01,083754,Staff,19,0,40,21
1650637274723,MATH 20B,A01,083756,Staff,0,12,30,30
1650637274723,MATH 20B,A02,083757,Staff,0,12,30,30
1650637280752,MATH 20C,A01,083760,Staff,0,15,30,30
1650637280752,MATH 20C,A02,083761,Staff,1,13,30,29
1650637280752,MATH 20C,B01,083762,Staff,11,0,30,19
1650637280752,MATH 20C,B02,083763,Staff,28,0,30,2
1650637286774,MATH 20D,A01,083765,Staff,1,1,30,29
1650637286774,MATH 20D,A02,083766,Staff,7,0,30,23
1650637286774,MATH 20D,A03,083767,Staff,24,0,30,6
1650637292803,MATH 20E,A01,083771,Staff,3,0,30,27
1650637292803,MATH 20E,A02,083772,Staff,17,0,30,13
1650637292803,MATH 20E,B01,083773,Staff,0,0,30,30
1650637292803,MATH 20E,B02,083774,Staff,9,0,30,21
1650637298827,MATH 103A,A01,083777,Staff,0,15,30,30
1650637298827,MATH 103A,A02,083778,Staff,0,15,30,30
1650637298827,MATH 103A,B01,083779,Staff,0,14,30,30
1650637298827,MATH 103A,B02,083780,Staff,0,14,30,30
1650637304851,MATH 105,A01,085443,Staff,0,22,30,30
1650637310880,MATH 109,A01,083213,Anzaldo; Leesa B,0,6,30,30
1650637310880,MATH 109,A02,083214,Anzaldo; Leesa B,0,7,30,30
1650637310880,MATH 109,B01,083215,Anzaldo; Leesa B,0,6,30,30
1650637310880,MATH 109,B02,083216,Anzaldo; Leesa B,0,6,30,30
1650637316905,MATH 142A,A01,083219,Chow; Bennett,0,16,30,30
1650637316905,MATH 142A,A02,083220,Chow; Bennett,0,15,30,30
1650637316905,MATH 142A,B01,083221,Chow; Bennett,0,14,30,30
1650637316905,MATH 142A,B02,083222,Chow; Bennett,0,13,30,30
1650637322929,MATH 193A,A01,083224,Staff,0,5,30,30
1650637322929,MATH 193A,A02,083225,Staff,0,6,30,30
1650637322929,MATH 193A,A03,083781,Staff,0,6,30,30
1650637322929,MATH 193A,A04,083782,Staff,0,7,30,30
1650637328956,MATH 197,001,091859,McAuley; Julian John,9998,0,9999,1
1650637335009,COGS 9,A01,083615,Staff,0,15,60,60
1650637341044,COGS 11,A01,083617,Boyle; Mary E. T.,18,0,40,22
1650637347069,COGS 13,A01,083071,Staff,0,38,40,40
1650637353094,COGS 14A,A01,092681,Staff,0,31,100,100
1650637359122,COGS 14B,A01,083073,Cheng; Tzu-Han,0,13,50,50
1650637365146,COGS 17,A01,092677,Staff,17,0,75,58
1650637371171,COGS 100,A01,083619,Staff,0,26,60,60
1650637377199,COGS 101A,A01,083621,Davis; Joshua Daniel,0,26,60,60
1650637383227,COGS 101B,A01,091572,Staff,0,4,60,60
1650637389255,COGS 101C,A01,083625,Delgado; Tania,15,0,30,15
1650637395280,COGS 107A,A01,083627,Boyle; Mary E. T.,1,15,60,59
1650637401307,COGS 118A,A01,083075,Staff,0,6,60,60
1650637407336,CSE 3,A50,083646,Miranda; Gregory Joseph,19,0,38,19
1650637407336,CSE 3,A51,083647,Miranda; Gregory Joseph,36,0,37,1
1650637413365,CSE 8A,A50,083650,Miranda; Gregory Joseph,0,30,40,40
1650637419397,CSE 11,A01,083080,Cao; Yingjun,0,95,40,40
1650637425424,CSE 12,A01,083652,Staff,0,19,100,100
1650637431449,CSE 15L,A01,083654,Staff,0,2,50,50
1650637431449,CSE 15L,A02,083655,Staff,0,1,50,50
1650637437473,CSE 20,A01,083657,Staff,51,0,80,29
1650637443497,CSE 30,A01,083084,Eldon; John,0,77,40,40
1650637449540,CSE 100,A01,083659,Cao; Yingjun,0,68,50,50
1650637455566,CSE 134B,A01,083661,Powell; Thomas Allan,0,35,65,65
1650637461593,CSE 140,A01,083663,Staff,0,8,75,75
1650637467620,CSE 140L,A01,083088,Eldon; John,0,16,75,75
1650637473645,CSE 175,A01,083665,Kumar; Rakesh,7,0,25,18
1650637479686,CSE 190,A00,092507,Dubnov; Shlomo,10,0,20,10
1650637485710,ECE 45,A01,083139,Staff,0,1,60,60
1650637491739,ECE 65,A50,083695,Staff,0,5,30,30
1650637497765,ECE 109,A01,091882,Touri; Behrouz,33,0,70,37
1650637503795,ECE 180,A00,083140,Abi Samra; Nicholas Camill,21,0,30,9
1650637503795,ECE 180,B00,083141,Abi Samra; Nicholas Camill,0,0,30,30
1650637509827,MATH 10A,A01,083735,Patchell; Gregory David,4,0,30,26
1650637509827,MATH 10A,A02,083736,Patchell; Gregory David,27,0,30,3
1650637509827,MATH 10A,A03,083737,Patchell; Gregory David,24,0,30,6
1650637515850,MATH 10B,A01,083207,Staff,0,8,30,30
1650637515850,MATH 10B,A02,083208,Staff,0,8,30,30
1650637515850,MATH 10B,B01,083739,Staff,11,0,30,19
1650637515850,MATH 10B,B02,083740,Staff,28,0,30,2
1650637521877,MATH 18,A01,083743,Staff,0,0,30,30
1650637521877,MATH 18,A02,083744,Staff,23,0,30,7
1650637521877,MATH 18,A03,083745,Staff,21,0,30,9
1650637521877,MATH 18,A04,083746,Staff,26,0,30,4
1650637521877,MATH 18,B01,083748,Staff,0,15,30,30
1650637521877,MATH 18,B02,083749,Staff,0,11,30,30
1650637521877,MATH 18,B03,083750,Staff,0,12,30,30
1650637521877,MATH 18,B04,083751,Staff,0,12,30,30
1650637527903,MATH 20A,A01,083754,Staff,19,0,40,21
1650637533926,MATH 20B,A01,083756,Staff,0,12,30,30
1650637533926,MATH 20B,A02,083757,Staff,0,12,30,30
1650637539949,MATH 20C,A01,083760,Staff,0,15,30,30
1650637539949,MATH 20C,A02,083761,Staff,1,13,30,29
1650637539949,MATH 20C,B01,083762,Staff,11,0,30,19
1650637539949,MATH 20C,B02,083763,Staff,28,0,30,2
1650637545977,MATH 20D,A01,083765,Staff,1,1,30,29
1650637545977,MATH 20D,A02,083766,Staff,7,0,30,23
1650637545977,MATH 20D,A03,083767,Staff,24,0,30,6
1650637552009,MATH 20E,A01,083771,Staff,3,0,30,27
1650637552009,MATH 20E,A02,083772,Staff,17,0,30,13
1650637552009,MATH 20E,B01,083773,Staff,0,0,30,30
1650637552009,MATH 20E,B02,083774,Staff,9,0,30,21
1650637558043,MATH 103A,A01,083777,Staff,0,15,30,30
1650637558043,MATH 103A,A02,083778,Staff,0,15,30,30
1650637558043,MATH 103A,B01,083779,Staff,0,14,30,30
1650637558043,MATH 103A,B02,083780,Staff,0,14,30,30
1650637564066,MATH 105,A01,085443,Staff,0,22,30,30
1650637570089,MATH 109,A01,083213,Anzaldo; Leesa B,0,6,30,30
1650637570089,MATH 109,A02,083214,Anzaldo; Leesa B,0,7,30,30
1650637570089,MATH 109,B01,083215,Anzaldo; Leesa B,0,6,30,30
1650637570089,MATH 109,B02,083216,Anzaldo; Leesa B,0,6,30,30
1650637576114,MATH 142A,A01,083219,Chow; Bennett,0,16,30,30
1650637576114,MATH 142A,A02,083220,Chow; Bennett,0,15,30,30
1650637576114,MATH 142A,B01,083221,Chow; Bennett,0,14,30,30
1650637576114,MATH 142A,B02,083222,Chow; Bennett,0,13,30,30
1650637582142,MATH 193A,A01,083224,Staff,0,5,30,30
1650637582142,MATH 193A,A02,083225,Staff,0,6,30,30
1650637582142,MATH 193A,A03,083781,Staff,0,6,30,30
1650637582142,MATH 193A,A04,083782,Staff,0,7,30,30
1650637588169,MATH 197,001,091859,McAuley; Julian John,9998,0,9999,1
1650637594229,COGS 9,A01,083615,Staff,0,15,60,60
1650637600253,COGS 11,A01,083617,Boyle; Mary E. T.,18,0,40,22
1650637606280,COGS 13,A01,083071,Staff,0,38,40,40
1650637612304,COGS 14A,A01,092681,Staff,0,31,100,100
1650637618332,COGS 14B,A01,083073,Cheng; Tzu-Han,0,13,50,50
1650637624372,COGS 17,A01,092677,Staff,17,0,75,58
1650637630395,COGS 100,A01,083619,Staff,0,26,60,60
1650637636420,COGS 101A,A01,083621,Davis; Joshua Daniel,0,26,60,60
1650637642446,COGS 101B,A01,091572,Staff,0,4,60,60
1650637648471,COGS 101C,A01,083625,Delgado; Tania,15,0,30,15
1650637654589,COGS 107A,A01,083627,Boyle; Mary E. T.,1,15,60,59
1650637660612,COGS 118A,A01,083075,Staff,0,6,60,60
1650637666640,CSE 3,A50,083646,Miranda; Gregory Joseph,19,0,38,19
1650637666640,CSE 3,A51,083647,Miranda; Gregory Joseph,36,0,37,1
1650637672665,CSE 8A,A50,083650,Miranda; Gregory Joseph,0,30,40,40
1650637678688,CSE 11,A01,083080,Cao; Yingjun,0,95,40,40
1650637684712,CSE 12,A01,083652,Staff,0,19,100,100
1650637690744,CSE 15L,A01,083654,Staff,0,2,50,50
1650637690744,CSE 15L,A02,083655,Staff,0,1,50,50
1650637696771,CSE 20,A01,083657,Staff,51,0,80,29
1650637702795,CSE 30,A01,083084,Eldon; John,0,77,40,40
1650637708823,CSE 100,A01,083659,Cao; Yingjun,0,68,50,50
1650637714848,CSE 134B,A01,083661,Powell; Thomas Allan,0,35,65,65
1650637720873,CSE 140,A01,083663,Staff,0,8,75,75
1650637726898,CSE 140L,A01,083088,Eldon; John,0,16,75,75
1650637732921,CSE 175,A01,083665,Kumar; Rakesh,7,0,25,18
1650637738946,CSE 190,A00,092507,Dubnov; Shlomo,10,0,20,10
1650637744970,ECE 45,A01,083139,Staff,0,1,60,60
1650637750998,ECE 65,A50,083695,Staff,0,5,30,30
1650637757032,ECE 109,A01,091882,Touri; Behrouz,33,0,70,37
1650637763062,ECE 180,A00,083140,Abi Samra; Nicholas Camill,21,0,30,9
1650637763062,ECE 180,B00,083141,Abi Samra; Nicholas Camill,0,0,30,30
1650637769087,MATH 10A,A01,083735,Patchell; Gregory David,4,0,30,26
1650637769087,MATH 10A,A02,083736,Patchell; Gregory David,27,0,30,3
1650637769087,MATH 10A,A03,083737,Patchell; Gregory David,24,0,30,6
1650637775112,MATH 10B,A01,083207,Staff,0,8,30,30
1650637775112,MATH 10B,A02,083208,Staff,0,8,30,30
1650637775112,MATH 10B,B01,083739,Staff,11,0,30,19
1650637775112,MATH 10B,B02,083740,Staff,28,0,30,2
1650637781142,MATH 18,A01,083743,Staff,0,0,30,30
1650637781142,MATH 18,A02,083744,Staff,23,0,30,7
1650637781142,MATH 18,A03,083745,Staff,21,0,30,9
1650637781142,MATH 18,A04,083746,Staff,26,0,30,4
1650637781142,MATH 18,B01,083748,Staff,0,15,30,30
1650637781142,MATH 18,B02,083749,Staff,0,11,30,30
1650637781142,MATH 18,B03,083750,Staff,0,12,30,30
1650637781142,MATH 18,B04,083751,Staff,0,12,30,30
1650637787167,MATH 20A,A01,083754,Staff,19,0,40,21
1650637793190,MATH 20B,A01,083756,Staff,0,12,30,30
1650637793190,MATH 20B,A02,083757,Staff,0,12,30,30
1650637799218,MATH 20C,A01,083760,Staff,0,15,30,30
1650637799218,MATH 20C,A02,083761,Staff,1,13,30,29
1650637799218,MATH 20C,B01,083762,Staff,11,0,30,19
1650637799218,MATH 20C,B02,083763,Staff,28,0,30,2
1650637805245,MATH 20D,A01,083765,Staff,1,1,30,29
1650637805245,MATH 20D,A02,083766,Staff,7,0,30,23
1650637805245,MATH 20D,A03,083767,Staff,24,0,30,6
1650637811268,MATH 20E,A01,083771,Staff,3,0,30,27
1650637811268,MATH 20E,A02,083772,Staff,17,0,30,13
1650637811268,MATH 20E,B01,083773,Staff,0,0,30,30
1650637811268,MATH 20E,B02,083774,Staff,9,0,30,21
1650637817296,MATH 103A,A01,083777,Staff,0,15,30,30
1650637817296,MATH 103A,A02,083778,Staff,0,15,30,30
1650637817296,MATH 103A,B01,083779,Staff,0,14,30,30
1650637817296,MATH 103A,B02,083780,Staff,0,14,30,30
1650637823323,MATH 105,A01,085443,Staff,0,22,30,30
1650637829357,MATH 109,A01,083213,Anzaldo; Leesa B,0,6,30,30
1650637829357,MATH 109,A02,083214,Anzaldo; Leesa B,0,7,30,30
1650637829357,MATH 109,B01,083215,Anzaldo; Leesa B,0,6,30,30
1650637829357,MATH 109,B02,083216,Anzaldo; Leesa B,0,6,30,30
1650637835516,MATH 142A,A01,083219,Chow; Bennett,0,16,30,30
1650637835516,MATH 142A,A02,083220,Chow; Bennett,0,15,30,30
1650637835516,MATH 142A,B01,083221,Chow; Bennett,0,14,30,30
1650637835516,MATH 142A,B02,083222,Chow; Bennett,0,13,30,30
1650637841538,MATH 193A,A01,083224,Staff,0,5,30,30
1650637841538,MATH 193A,A02,083225,Staff,0,6,30,30
1650637841538,MATH 193A,A03,083781,Staff,0,6,30,30
1650637841538,MATH 193A,A04,083782,Staff,0,7,30,30
1650637847561,MATH 197,001,091859,McAuley; Julian John,9998,0,9999,1
1650637853622,COGS 9,A01,083615,Staff,0,15,60,60
1650637859647,COGS 11,A01,083617,Boyle; Mary E. T.,18,0,40,22
1650637865675,COGS 13,A01,083071,Staff,0,38,40,40
1650637871717,COGS 14A,A01,092681,Staff,0,31,100,100
1650637877743,COGS 14B,A01,083073,Cheng; Tzu-Han,0,13,50,50
1650637883768,COGS 17,A01,092677,Staff,17,0,75,58
1650637889790,COGS 100,A01,083619,Staff,0,26,60,60
1650637895816,COGS 101A,A01,083621,Davis; Joshua Daniel,0,26,60,60
1650637901840,COGS 101B,A01,091572,Staff,0,4,60,60
1650637907868,COGS 101C,A01,083625,Delgado; Tania,15,0,30,15
1650637913896,COGS 107A,A01,083627,Boyle; Mary E. T.,1,15,60,59
1650637919920,COGS 118A,A01,083075,Staff,0,6,60,60
1650637925947,CSE 3,A50,083646,Miranda; Gregory Joseph,19,0,38,19
1650637925947,CSE 3,A51,083647,Miranda; Gregory Joseph,36,0,37,1
1650637931973,CSE 8A,A50,083650,Miranda; Gregory Joseph,0,30,40,40
1650637937997,CSE 11,A01,083080,Cao; Yingjun,0,95,40,40
1650637944022,CSE 12,A01,083652,Staff,0,19,100,100
1650637950049,CSE 15L,A01,083654,Staff,0,2,50,50
1650637950049,CSE 15L,A02,083655,Staff,0,1,50,50
1650637956078,CSE 20,A01,083657,Staff,51,0,80,29
1650637962106,CSE 30,A01,083084,Eldon; John,0,77,40,40
1650637968131,CSE 100,A01,083659,Cao; Yingjun,0,68,50,50
1650637974174,CSE 134B,A01,083661,Powell; Thomas Allan,0,35,65,65
1650637980199,CSE 140,A01,083663,Staff,0,8,75,75
1650637986230,CSE 140L,A01,083088,Eldon; John,0,16,75,75
1650637992256,CSE 175,A01,083665,Kumar; Rakesh,7,0,25,18
1650637998283,CSE 190,A00,092507,Dubnov; Shlomo,10,0,20,10
1650638004313,ECE 45,A01,083139,Staff,0,1,60,60
1650638010339,ECE 65,A50,083695,Staff,0,5,30,30
1650638016363,ECE 109,A01,091882,Touri; Behrouz,33,0,70,37
1650638022392,ECE 180,A00,083140,Abi Samra; Nicholas Camill,21,0,30,9
1650638022392,ECE 180,B00,083141,Abi Samra; Nicholas Camill,0,0,30,30
1650638028420,MATH 10A,A01,083735,Patchell; Gregory David,4,0,30,26
1650638028420,MATH 10A,A02,083736,Patchell; Gregory David,27,0,30,3
1650638028420,MATH 10A,A03,083737,Patchell; Gregory David,24,0,30,6
1650638034453,MATH 10B,A01,083207,Staff,0,8,30,30
1650638034453,MATH 10B,A02,083208,Staff,0,8,30,30
1650638034453,MATH 10B,B01,083739,Staff,11,0,30,19
1650638034453,MATH 10B,B02,083740,Staff,28,0,30,2
1650638040486,MATH 18,A01,083743,Staff,0,0,30,30
1650638040486,MATH 18,A02,083744,Staff,23,0,30,7
1650638040486,MATH 18,A03,083745,Staff,21,0,30,9
1650638040486,MATH 18,A04,083746,Staff,26,0,30,4
1650638040486,MATH 18,B01,083748,Staff,0,15,30,30
1650638040486,MATH 18,B02,083749,Staff,0,11,30,30
1650638040486,MATH 18,B03,083750,Staff,0,12,30,30
1650638040486,MATH 18,B04,083751,Staff,0,12,30,30
1650638046510,MATH 20A,A01,083754,Staff,19,0,40,21
1650638052538,MATH 20B,A01,083756,Staff,0,12,30,30
1650638052538,MATH 20B,A02,083757,Staff,0,12,30,30
1650638058564,MATH 20C,A01,083760,Staff,0,15,30,30
1650638058564,MATH 20C,A02,083761,Staff,1,13,30,29
1650638058564,MATH 20C,B01,083762,Staff,11,0,30,19
1650638058564,MATH 20C,B02,083763,Staff,28,0,30,2
1650638064589,MATH 20D,A01,083765,Staff,1,1,30,29
1650638064589,MATH 20D,A02,083766,Staff,7,0,30,23
1650638064589,MATH 20D,A03,083767,Staff,24,0,30,6
1650638070617,MATH 20E,A01,083771,Staff,3,0,30,27
1650638070617,MATH 20E,A02,083772,Staff,17,0,30,13
1650638070617,MATH 20E,B01,083773,Staff,0,0,30,30
1650638070617,MATH 20E,B02,083774,Staff,9,0,30,21
1650638076651,MATH 103A,A01,083777,Staff,0,15,30,30
1650638076651,MATH 103A,A02,083778,Staff,0,15,30,30
1650638076651,MATH 103A,B01,083779,Staff,0,14,30,30
1650638076651,MATH 103A,B02,083780,Staff,0,14,30,30
1650638082673,MATH 105,A01,085443,Staff,0,22,30,30
1650638088722,MATH 109,A01,083213,Anzaldo; Leesa B,0,6,30,30
1650638088722,MATH 109,A02,083214,Anzaldo; Leesa B,0,7,30,30
1650638088722,MATH 109,B01,083215,Anzaldo; Leesa B,0,6,30,30
1650638088722,MATH 109,B02,083216,Anzaldo; Leesa B,0,6,30,30
1650638094747,MATH 142A,A01,083219,Chow; Bennett,0,16,30,30
1650638094747,MATH 142A,A02,083220,Chow; Bennett,0,15,30,30
1650638094747,MATH 142A,B01,083221,Chow; Bennett,0,14,30,30
1650638094747,MATH 142A,B02,083222,Chow; Bennett,0,13,30,30
1650638100778,MATH 193A,A01,083224,Staff,0,5,30,30
1650638100778,MATH 193A,A02,083225,Staff,0,6,30,30
1650638100778,MATH 193A,A03,083781,Staff,0,6,30,30
1650638100778,MATH 193A,A04,083782,Staff,0,7,30,30
1650638106821,MATH 197,001,091859,McAuley; Julian John,9998,0,9999,1
1650638112877,COGS 9,A01,083615,Staff,0,15,60,60
1650638118901,COGS 11,A01,083617,Boyle; Mary E. T.,18,0,40,22
1650638124925,COGS 13,A01,083071,Staff,0,38,40,40
1650638130960,COGS 14A,A01,092681,Staff,0,31,100,100
1650638136986,COGS 14B,A01,083073,Cheng; Tzu-Han,0,13,50,50
1650638143018,COGS 17,A01,092677,Staff,17,0,75,58
1650638149039,COGS 100,A01,083619,Staff,0,26,60,60
1650638155074,COGS 101A,A01,083621,Davis; Joshua Daniel,0,26,60,60
1650638161099,COGS 101B,A01,091572,Staff,0,4,60,60
1650638167122,COGS 101C,A01,083625,Delgado; Tania,15,0,30,15
1650638173147,COGS 107A,A01,083627,Boyle; Mary E. T.,1,15,60,59
1650638179171,COGS 118A,A01,083075,Staff,0,6,60,60
1650638185200,CSE 3,A50,083646,Miranda; Gregory Joseph,19,0,38,19
1650638185200,CSE 3,A51,083647,Miranda; Gregory Joseph,36,0,37,1
1650638191229,CSE 8A,A50,083650,Miranda; Gregory Joseph,0,30,40,40
1650638197251,CSE 11,A01,083080,Cao; Yingjun,0,95,40,40
1650638203273,CSE 12,A01,083652,Staff,0,19,100,100
1650638209299,CSE 15L,A01,083654,Staff,0,2,50,50
1650638209299,CSE 15L,A02,083655,Staff,0,1,50,50
1650638215326,CSE 20,A01,083657,Staff,51,0,80,29
1650638221354,CSE 30,A01,083084,Eldon; John,0,77,40,40
1650638227378,CSE 100,A01,083659,Cao; Yingjun,0,68,50,50
1650638233405,CSE 134B,A01,083661,Powell; Thomas Allan,0,35,65,65
1650638239438,CSE 140,A01,083663,Staff,0,8,75,75
1650638245476,CSE 140L,A01,083088,Eldon; John,0,16,75,75
1650638251604,CSE 175,A01,083665,Kumar; Rakesh,7,0,25,18
1650638257628,CSE 190,A00,092507,Dubnov; Shlomo,10,0,20,10
1650638263663,ECE 45,A01,083139,Staff,0,1,60,60
1650638269686,ECE 65,A50,083695,Staff,0,5,30,30
1650638275711,ECE 109,A01,091882,Touri; Behrouz,33,0,70,37
1650638281739,ECE 180,A00,083140,Abi Samra; Nicholas Camill,21,0,30,9
1650638281739,ECE 180,B00,083141,Abi Samra; Nicholas Camill,0,0,30,30
1650638287776,MATH 10A,A01,083735,Patchell; Gregory David,4,0,30,26
1650638287776,MATH 10A,A02,083736,Patchell; Gregory David,27,0,30,3
1650638287776,MATH 10A,A03,083737,Patchell; Gregory David,24,0,30,6
1650638293802,MATH 10B,A01,083207,Staff,0,8,30,30
1650638293802,MATH 10B,A02,083208,Staff,0,8,30,30
1650638293802,MATH 10B,B01,083739,Staff,11,0,30,19
1650638293802,MATH 10B,B02,083740,Staff,28,0,30,2
1650638299837,MATH 18,A01,083743,Staff,0,0,30,30
1650638299837,MATH 18,A02,083744,Staff,23,0,30,7
1650638299837,MATH 18,A03,083745,Staff,21,0,30,9
1650638299837,MATH 18,A04,083746,Staff,26,0,30,4
1650638299837,MATH 18,B01,083748,Staff,0,15,30,30
1650638299837,MATH 18,B02,083749,Staff,0,11,30,30
1650638299837,MATH 18,B03,083750,Staff,0,12,30,30
1650638299837,MATH 18,B04,083751,Staff,0,12,30,30
1650638305865,MATH 20A,A01,083754,Staff,19,0,40,21
1650638311893,MATH 20B,A01,083756,Staff,0,12,30,30
1650638311893,MATH 20B,A02,083757,Staff,0,12,30,30
1650638317917,MATH 20C,A01,083760,Staff,0,15,30,30
1650638317917,MATH 20C,A02,083761,Staff,1,13,30,29
1650638317917,MATH 20C,B01,083762,Staff,11,0,30,19
1650638317917,MATH 20C,B02,083763,Staff,28,0,30,2
1650638323942,MATH 20D,A01,083765,Staff,1,1,30,29
1650638323942,MATH 20D,A02,083766,Staff,7,0,30,23
1650638323942,MATH 20D,A03,083767,Staff,24,0,30,6
1650638329970,MATH 20E,A01,083771,Staff,3,0,30,27
1650638329970,MATH 20E,A02,083772,Staff,17,0,30,13
1650638329970,MATH 20E,B01,083773,Staff,0,0,30,30
1650638329970,MATH 20E,B02,083774,Staff,9,0,30,21
1650638336000,MATH 103A,A01,083777,Staff,0,15,30,30
1650638336000,MATH 103A,A02,083778,Staff,0,15,30,30
1650638336000,MATH 103A,B01,083779,Staff,0,14,30,30
1650638336000,MATH 103A,B02,083780,Staff,0,14,30,30
1650638342027,MATH 105,A01,085443,Staff,0,22,30,30
1650638348056,MATH 109,A01,083213,Anzaldo; Leesa B,0,6,30,30
1650638348056,MATH 109,A02,083214,Anzaldo; Leesa B,0,7,30,30
1650638348056,MATH 109,B01,083215,Anzaldo; Leesa B,0,6,30,30
1650638348056,MATH 109,B02,083216,Anzaldo; Leesa B,0,6,30,30
1650638354085,MATH 142A,A01,083219,Chow; Bennett,0,16,30,30
1650638354085,MATH 142A,A02,083220,Chow; Bennett,0,15,30,30
1650638354085,MATH 142A,B01,083221,Chow; Bennett,0,14,30,30
1650638354085,MATH 142A,B02,083222,Chow; Bennett,0,13,30,30
1650638360114,MATH 193A,A01,083224,Staff,0,5,30,30
1650638360114,MATH 193A,A02,083225,Staff,0,6,30,30
1650638360114,MATH 193A,A03,083781,Staff,0,6,30,30
1650638360114,MATH 193A,A04,083782,Staff,0,7,30,30
1650638366146,MATH 197,001,091859,McAuley; Julian John,9998,0,9999,1
1650638372207,COGS 9,A01,083615,Staff,0,15,60,60
1650638378243,COGS 11,A01,083617,Boyle; Mary E. T.,18,0,40,22
1650638384272,COGS 13,A01,083071,Staff,0,38,40,40
1650638390297,COGS 14A,A01,092681,Staff,0,31,100,100
1650638396320,COGS 14B,A01,083073,Cheng; Tzu-Han,0,13,50,50
1650638402344,COGS 17,A01,092677,Staff,17,0,75,58
1650638408371,COGS 100,A01,083619,Staff,0,26,60,60
1650638414400,COGS 101A,A01,083621,Davis; Joshua Daniel,0,26,60,60
1650638420427,COGS 101B,A01,091572,Staff,0,4,60,60
1650638426464,COGS 101C,A01,083625,Delgado; Tania,15,0,30,15
1650638432488,COGS 107A,A01,083627,Boyle; Mary E. T.,1,15,60,59
1650638438512,COGS 118A,A01,083075,Staff,0,6,60,60
1650638444535,CSE 3,A50,083646,Miranda; Gregory Joseph,19,0,38,19
1650638444535,CSE 3,A51,083647,Miranda; Gregory Joseph,36,0,37,1
1650638450561,CSE 8A,A50,083650,Miranda; Gregory Joseph,0,30,40,40
1650638456586,CSE 11,A01,083080,Cao; Yingjun,0,95,40,40
1650638462619,CSE 12,A01,083652,Staff,0,19,100,100
1650638468649,CSE 15L,A01,083654,Staff,0,2,50,50
1650638468649,CSE 15L,A02,083655,Staff,0,1,50,50
1650638474673,CSE 20,A01,083657,Staff,51,0,80,29
1650638480697,CSE 30,A01,083084,Eldon; John,0,77,40,40
1650638486725,CSE 100,A01,083659,Cao; Yingjun,0,68,50,50
1650638492751,CSE 134B,A01,083661,Powell; Thomas Allan,0,35,65,65
1650638498777,CSE 140,A01,083663,Staff,0,8,75,75
1650638504801,CSE 140L,A01,083088,Eldon; John,0,16,75,75
1650638510825,CSE 175,A01,083665,Kumar; Rakesh,7,0,25,18
1650638516849,CSE 190,A00,092507,Dubnov; Shlomo,10,0,20,10
1650638522874,ECE 45,A01,083139,Staff,0,1,60,60
1650638528899,ECE 65,A50,083695,Staff,0,5,30,30
1650638534926,ECE 109,A01,091882,Touri; Behrouz,33,0,70,37
1650638540949,ECE 180,A00,083140,Abi Samra; Nicholas Camill,21,0,30,9
1650638540949,ECE 180,B00,083141,Abi Samra; Nicholas Camill,0,0,30,30
1650638546973,MATH 10A,A01,083735,Patchell; Gregory David,3,0,30,27
1650638546973,MATH 10A,A02,083736,Patchell; Gregory David,27,0,30,3
1650638546973,MATH 10A,A03,083737,Patchell; Gregory David,24,0,30,6
1650638553002,MATH 10B,A01,083207,Staff,0,8,30,30
1650638553002,MATH 10B,A02,083208,Staff,0,8,30,30
1650638553002,MATH 10B,B01,083739,Staff,11,0,30,19
1650638553002,MATH 10B,B02,083740,Staff,28,0,30,2
1650638559030,MATH 18,A01,083743,Staff,0,0,30,30
1650638559030,MATH 18,A02,083744,Staff,23,0,30,7
1650638559030,MATH 18,A03,083745,Staff,21,0,30,9
1650638559030,MATH 18,A04,083746,Staff,26,0,30,4
1650638559030,MATH 18,B01,083748,Staff,0,15,30,30
1650638559030,MATH 18,B02,083749,Staff,0,11,30,30
1650638559030,MATH 18,B03,083750,Staff,0,12,30,30
1650638559030,MATH 18,B04,083751,Staff,0,12,30,30
1650638565055,MATH 20A,A01,083754,Staff,19,0,40,21
1650638571083,MATH 20B,A01,083756,Staff,0,12,30,30
1650638571083,MATH 20B,A02,083757,Staff,0,12,30,30
1650638577109,MATH 20C,A01,083760,Staff,0,15,30,30
1650638577109,MATH 20C,A02,083761,Staff,1,13,30,29
1650638577109,MATH 20C,B01,083762,Staff,11,0,30,19
1650638577109,MATH 20C,B02,083763,Staff,28,0,30,2
1650638583134,MATH 20D,A01,083765,Staff,1,1,30,29
1650638583134,MATH 20D,A02,083766,Staff,7,0,30,23
1650638583134,MATH 20D,A03,083767,Staff,24,0,30,6
1650638589171,MATH 20E,A01,083771,Staff,3,0,30,27
1650638589171,MATH 20E,A02,083772,Staff,17,0,30,13
1650638589171,MATH 20E,B01,083773,Staff,0,0,30,30
1650638589171,MATH 20E,B02,083774,Staff,9,0,30,21
1650638595195,MATH 103A,A01,083777,Staff,0,15,30,30
1650638595195,MATH 103A,A02,083778,Staff,0,15,30,30
1650638595195,MATH 103A,B01,083779,Staff,0,14,30,30
1650638595195,MATH 103A,B02,083780,Staff,0,14,30,30
1650638601221,MATH 105,A01,085443,Staff,0,22,30,30
1650638607249,MATH 109,A01,083213,Anzaldo; Leesa B,0,6,30,30
1650638607249,MATH 109,A02,083214,Anzaldo; Leesa B,0,7,30,30
1650638607249,MATH 109,B01,083215,Anzaldo; Leesa B,0,6,30,30
1650638607249,MATH 109,B02,083216,Anzaldo; Leesa B,0,6,30,30
1650638613277,MATH 142A,A01,083219,Chow; Bennett,0,16,30,30
1650638613277,MATH 142A,A02,083220,Chow; Bennett,0,15,30,30
1650638613277,MATH 142A,B01,083221,Chow; Bennett,0,14,30,30
1650638613277,MATH 142A,B02,083222,Chow; Bennett,0,13,30,30
1650638619304,MATH 193A,A01,083224,Staff,0,5,30,30
1650638619304,MATH 193A,A02,083225,Staff,0,6,30,30
1650638619304,MATH 193A,A03,083781,Staff,0,6,30,30
1650638619304,MATH 193A,A04,083782,Staff,0,7,30,30
1650638625334,MATH 197,001,091859,McAuley; Julian John,9998,0,9999,1
1650638631397,COGS 9,A01,083615,Staff,0,15,60,60
1650638637432,COGS 11,A01,083617,Boyle; Mary E. T.,18,0,40,22
1650638643455,COGS 13,A01,083071,Staff,0,38,40,40
1650638649480,COGS 14A,A01,092681,Staff,0,31,100,100
1650638655508,COGS 14B,A01,083073,Cheng; Tzu-Han,0,13,50,50
1650638661547,COGS 17,A01,092677,Staff,17,0,75,58
1650638667570,COGS 100,A01,083619,Staff,0,26,60,60
1650638673593,COGS 101A,A01,083621,Davis; Joshua Daniel,0,26,60,60
1650638679617,COGS 101B,A01,091572,Staff,0,4,60,60
1650638685642,COGS 101C,A01,083625,Delgado; Tania,15,0,30,15
1650638691670,COGS 107A,A01,083627,Boyle; Mary E. T.,1,15,60,59
1650638697695,COGS 118A,A01,083075,Staff,0,6,60,60
1650638703728,CSE 3,A50,083646,Miranda; Gregory Joseph,19,0,38,19
1650638703728,CSE 3,A51,083647,Miranda; Gregory Joseph,36,0,37,1
1650638709752,CSE 8A,A50,083650,Miranda; Gregory Joseph,0,30,40,40
1650638715777,CSE 11,A01,083080,Cao; Yingjun,0,95,40,40
1650638721808,CSE 12,A01,083652,Staff,0,19,100,100
1650638727837,CSE 15L,A01,083654,Staff,0,2,50,50
1650638727837,CSE 15L,A02,083655,Staff,0,1,50,50
1650638733871,CSE 20,A01,083657,Staff,51,0,80,29
1650638739896,CSE 30,A01,083084,Eldon; John,0,77,40,40
1650638745923,CSE 100,A01,083659,Cao; Yingjun,0,68,50,50
1650638751947,CSE 134B,A01,083661,Powell; Thomas Allan,0,36,65,65
1650638757998,CSE 140,A01,083663,Staff,0,8,75,75
1650638764025,CSE 140L,A01,083088,Eldon; John,0,16,75,75
1650638770048,CSE 175,A01,083665,Kumar; Rakesh,7,0,25,18
1650638776072,CSE 190,A00,092507,Dubnov; Shlomo,10,0,20,10
1650638782101,ECE 45,A01,083139,Staff,0,1,60,60
1650638788125,ECE 65,A50,083695,Staff,0,5,30,30
1650638794155,ECE 109,A01,091882,Touri; Behrouz,33,0,70,37
1650638800179,ECE 180,A00,083140,Abi Samra; Nicholas Camill,21,0,30,9
1650638800179,ECE 180,B00,083141,Abi Samra; Nicholas Camill,0,0,30,30
1650638806204,MATH 10A,A01,083735,Patchell; Gregory David,3,0,30,27
1650638806204,MATH 10A,A02,083736,Patchell; Gregory David,27,0,30,3
1650638806204,MATH 10A,A03,083737,Patchell; Gregory David,24,0,30,6
1650638812231,MATH 10B,A01,083207,Staff,0,8,30,30
1650638812231,MATH 10B,A02,083208,Staff,0,8,30,30
1650638812231,MATH 10B,B01,083739,Staff,11,0,30,19
1650638812231,MATH 10B,B02,083740,Staff,28,0,30,2
1650638818257,MATH 18,A01,083743,Staff,0,0,30,30
1650638818257,MATH 18,A02,083744,Staff,23,0,30,7
1650638818257,MATH 18,A03,083745,Staff,21,0,30,9
1650638818257,MATH 18,A04,083746,Staff,26,0,30,4
1650638818257,MATH 18,B01,083748,Staff,0,15,30,30
1650638818257,MATH 18,B02,083749,Staff,0,11,30,30
1650638818257,MATH 18,B03,083750,Staff,0,12,30,30
1650638818257,MATH 18,B04,083751,Staff,0,12,30,30
1650638824282,MATH 20A,A01,083754,Staff,19,0,40,21
1650638830305,MATH 20B,A01,083756,Staff,0,12,30,30
1650638830305,MATH 20B,A02,083757,Staff,0,12,30,30
1650638836342,MATH 20C,A01,083760,Staff,0,15,30,30
1650638836342,MATH 20C,A02,083761,Staff,1,13,30,29
1650638836342,MATH 20C,B01,083762,Staff,11,0,30,19
1650638836342,MATH 20C,B02,083763,Staff,28,0,30,2
1650638842365,MATH 20D,A01,083765,Staff,1,1,30,29
1650638842365,MATH 20D,A02,083766,Staff,7,0,30,23
1650638842365,MATH 20D,A03,083767,Staff,24,0,30,6
1650638848479,MATH 20E,A01,083771,Staff,3,0,30,27
1650638848479,MATH 20E,A02,083772,Staff,17,0,30,13
1650638848479,MATH 20E,B01,083773,Staff,0,0,30,30
1650638848479,MATH 20E,B02,083774,Staff,9,0,30,21
1650638854505,MATH 103A,A01,083777,Staff,0,15,30,30
1650638854505,MATH 103A,A02,083778,Staff,0,15,30,30
1650638854505,MATH 103A,B01,083779,Staff,0,14,30,30
1650638854505,MATH 103A,B02,083780,Staff,0,14,30,30
1650638860540,MATH 105,A01,085443,Staff,0,22,30,30
1650638866565,MATH 109,A01,083213,Anzaldo; Leesa B,0,6,30,30
1650638866565,MATH 109,A02,083214,Anzaldo; Leesa B,0,7,30,30
1650638866565,MATH 109,B01,083215,Anzaldo; Leesa B,0,6,30,30
1650638866565,MATH 109,B02,083216,Anzaldo; Leesa B,0,6,30,30
1650638872594,MATH 142A,A01,083219,Chow; Bennett,0,16,30,30
1650638872594,MATH 142A,A02,083220,Chow; Bennett,0,15,30,30
1650638872594,MATH 142A,B01,083221,Chow; Bennett,0,14,30,30
1650638872594,MATH 142A,B02,083222,Chow; Bennett,0,13,30,30
1650638878621,MATH 193A,A01,083224,Staff,0,5,30,30
1650638878621,MATH 193A,A02,083225,Staff,0,6,30,30
1650638878621,MATH 193A,A03,083781,Staff,0,6,30,30
1650638878621,MATH 193A,A04,083782,Staff,0,7,30,30
1650638884647,MATH 197,001,091859,McAuley; Julian John,9998,0,9999,1
1650638890702,COGS 9,A01,083615,Staff,0,15,60,60
1650638896731,COGS 11,A01,083617,Boyle; Mary E. T.,18,0,40,22
1650638902763,COGS 13,A01,083071,Staff,0,38,40,40
1650638908790,COGS 14A,A01,092681,Staff,0,31,100,100
1650638914814,COGS 14B,A01,083073,Cheng; Tzu-Han,0,13,50,50
1650638920841,COGS 17,A01,092677,Staff,17,0,75,58
1650638926868,COGS 100,A01,083619,Staff,0,26,60,60
1650638932892,COGS 101A,A01,083621,Davis; Joshua Daniel,0,26,60,60
1650638938919,COGS 101B,A01,091572,Staff,0,4,60,60
1650638944952,COGS 101C,A01,083625,Delgado; Tania,15,0,30,15
1650638950998,COGS 107A,A01,083627,Boyle; Mary E. T.,1,15,60,59
1650638957032,COGS 118A,A01,083075,Staff,0,6,60,60
1650638963062,CSE 3,A50,083646,Miranda; Gregory Joseph,19,0,38,19
1650638963062,CSE 3,A51,083647,Miranda; Gregory Joseph,36,0,37,1
1650638969111,CSE 8A,A50,083650,Miranda; Gregory Joseph,0,30,40,40
1650638975139,CSE 11,A01,083080,Cao; Yingjun,0,95,40,40
1650638981166,CSE 12,A01,083652,Staff,0,19,100,100
1650638987197,CSE 15L,A01,083654,Staff,0,2,50,50
1650638987197,CSE 15L,A02,083655,Staff,0,1,50,50
1650638993220,CSE 20,A01,083657,Staff,51,0,80,29
1650638999246,CSE 30,A01,083084,Eldon; John,0,77,40,40
1650639005277,CSE 100,A01,083659,Cao; Yingjun,0,68,50,50
1650639011301,CSE 134B,A01,083661,Powell; Thomas Allan,0,36,65,65
1650639017326,CSE 140,A01,083663,Staff,0,8,75,75
1650639023351,CSE 140L,A01,083088,Eldon; John,0,16,75,75
1650639029375,CSE 175,A01,083665,Kumar; Rakesh,7,0,25,18
1650639035398,CSE 190,A00,092507,Dubnov; Shlomo,10,0,20,10
1650639041423,ECE 45,A01,083139,Staff,0,1,60,60
1650639047446,ECE 65,A50,083695,Staff,0,5,30,30
1650639053470,ECE 109,A01,091882,Touri; Behrouz,33,0,70,37
1650639059498,ECE 180,A00,083140,Abi Samra; Nicholas Camill,21,0,30,9
1650639059498,ECE 180,B00,083141,Abi Samra; Nicholas Camill,0,0,30,30
1650639065525,MATH 10A,A01,083735,Patchell; Gregory David,3,0,30,27
1650639065525,MATH 10A,A02,083736,Patchell; Gregory David,27,0,30,3
1650639065525,MATH 10A,A03,083737,Patchell; Gregory David,24,0,30,6
1650639071556,MATH 10B,A01,083207,Staff,0,8,30,30
1650639071556,MATH 10B,A02,083208,Staff,0,8,30,30
1650639071556,MATH 10B,B01,083739,Staff,11,0,30,19
1650639071556,MATH 10B,B02,083740,Staff,28,0,30,2
1650639077585,MATH 18,A01,083743,Staff,0,0,30,30
1650639077585,MATH 18,A02,083744,Staff,23,0,30,7
1650639077585,MATH 18,A03,083745,Staff,21,0,30,9
1650639077585,MATH 18,A04,083746,Staff,26,0,30,4
1650639077585,MATH 18,B01,083748,Staff,0,15,30,30
1650639077585,MATH 18,B02,083749,Staff,0,11,30,30
1650639077585,MATH 18,B03,083750,Staff,0,12,30,30
1650639077585,MATH 18,B04,083751,Staff,0,12,30,30
1650639083610,MATH 20A,A01,083754,Staff,19,0,40,21
1650639089633,MATH 20B,A01,083756,Staff,0,12,30,30
1650639089633,MATH 20B,A02,083757,Staff,0,12,30,30
1650639095664,MATH 20C,A01,083760,Staff,0,15,30,30
1650639095664,MATH 20C,A02,083761,Staff,1,13,30,29
1650639095664,MATH 20C,B01,083762,Staff,11,0,30,19
1650639095664,MATH 20C,B02,083763,Staff,28,0,30,2
1650639101691,MATH 20D,A01,083765,Staff,1,1,30,29
1650639101691,MATH 20D,A02,083766,Staff,7,0,30,23
1650639101691,MATH 20D,A03,083767,Staff,24,0,30,6
1650639107715,MATH 20E,A01,083771,Staff,3,0,30,27
1650639107715,MATH 20E,A02,083772,Staff,17,0,30,13
1650639107715,MATH 20E,B01,083773,Staff,0,0,30,30
1650639107715,MATH 20E,B02,083774,Staff,9,0,30,21
1650639113744,MATH 103A,A01,083777,Staff,0,15,30,30
1650639113744,MATH 103A,A02,083778,Staff,0,15,30,30
1650639113744,MATH 103A,B01,083779,Staff,0,14,30,30
1650639113744,MATH 103A,B02,083780,Staff,0,14,30,30
1650639119768,MATH 105,A01,085443,Staff,0,22,30,30
1650639125792,MATH 109,A01,083213,Anzaldo; Leesa B,0,6,30,30
1650639125792,MATH 109,A02,083214,Anzaldo; Leesa B,0,7,30,30
1650639125792,MATH 109,B01,083215,Anzaldo; Leesa B,0,6,30,30
1650639125792,MATH 109,B02,083216,Anzaldo; Leesa B,0,6,30,30
1650639131821,MATH 142A,A01,083219,Chow; Bennett,0,16,30,30
1650639131821,MATH 142A,A02,083220,Chow; Bennett,0,15,30,30
1650639131821,MATH 142A,B01,083221,Chow; Bennett,0,14,30,30
1650639131821,MATH 142A,B02,083222,Chow; Bennett,0,13,30,30
1650639137847,MATH 193A,A01,083224,Staff,0,5,30,30
1650639137847,MATH 193A,A02,083225,Staff,0,6,30,30
1650639137847,MATH 193A,A03,083781,Staff,0,6,30,30
1650639137847,MATH 193A,A04,083782,Staff,0,7,30,30
1650639143878,MATH 197,001,091859,McAuley; Julian John,9998,0,9999,1
1650639149932,COGS 9,A01,083615,Staff,0,15,60,60
1650639155956,COGS 11,A01,083617,Boyle; Mary E. T.,18,0,40,22
1650639161980,COGS 13,A01,083071,Staff,0,38,40,40
1650639168009,COGS 14A,A01,092681,Staff,0,31,100,100
1650639174037,COGS 14B,A01,083073,Cheng; Tzu-Han,0,13,50,50
1650639180063,COGS 17,A01,092677,Staff,17,0,75,58
1650639186088,COGS 100,A01,083619,Staff,0,26,60,60
1650639192112,COGS 101A,A01,083621,Davis; Joshua Daniel,0,26,60,60
1650639198136,COGS 101B,A01,091572,Staff,0,4,60,60
1650639204162,COGS 101C,A01,083625,Delgado; Tania,15,0,30,15
1650639210193,COGS 107A,A01,083627,Boyle; Mary E. T.,1,15,60,59
1650639216220,COGS 118A,A01,083075,Staff,0,6,60,60
1650639222245,CSE 3,A50,083646,Miranda; Gregory Joseph,19,0,38,19
1650639222245,CSE 3,A51,083647,Miranda; Gregory Joseph,36,0,37,1
1650639228270,CSE 8A,A50,083650,Miranda; Gregory Joseph,0,30,40,40
1650639234294,CSE 11,A01,083080,Cao; Yingjun,0,95,40,40
1650639240334,CSE 12,A01,083652,Staff,0,19,100,100
1650639246358,CSE 15L,A01,083654,Staff,0,2,50,50
1650639246358,CSE 15L,A02,083655,Staff,0,1,50,50
1650639252383,CSE 20,A01,083657,Staff,51,0,80,29
1650639258407,CSE 30,A01,083084,Eldon; John,0,77,40,40
1650639264435,CSE 100,A01,083659,Cao; Yingjun,0,68,50,50
1650639270458,CSE 134B,A01,083661,Powell; Thomas Allan,0,36,65,65
1650639276482,CSE 140,A01,083663,Staff,0,8,75,75
1650639282506,CSE 140L,A01,083088,Eldon; John,0,16,75,75
1650639288539,CSE 175,A01,083665,Kumar; Rakesh,7,0,25,18
1650639294575,CSE 190,A00,092507,Dubnov; Shlomo,10,0,20,10
1650639300608,ECE 45,A01,083139,Staff,0,1,60,60
1650639306635,ECE 65,A50,083695,Staff,0,5,30,30
1650639312656,ECE 109,A01,091882,Touri; Behrouz,33,0,70,37
1650639318683,ECE 180,A00,083140,Abi Samra; Nicholas Camill,21,0,30,9
1650639318683,ECE 180,B00,083141,Abi Samra; Nicholas Camill,0,0,30,30
1650639324715,MATH 10A,A01,083735,Patchell; Gregory David,3,0,30,27
1650639324715,MATH 10A,A02,083736,Patchell; Gregory David,27,0,30,3
1650639324715,MATH 10A,A03,083737,Patchell; Gregory David,24,0,30,6
1650639330749,MATH 10B,A01,083207,Staff,0,8,30,30
1650639330749,MATH 10B,A02,083208,Staff,0,8,30,30
1650639330749,MATH 10B,B01,083739,Staff,11,0,30,19
1650639330749,MATH 10B,B02,083740,Staff,28,0,30,2
1650639336779,MATH 18,A01,083743,Staff,0,0,30,30
1650639336779,MATH 18,A02,083744,Staff,23,0,30,7
1650639336779,MATH 18,A03,083745,Staff,21,0,30,9
1650639336779,MATH 18,A04,083746,Staff,26,0,30,4
1650639336779,MATH 18,B01,083748,Staff,0,15,30,30
1650639336779,MATH 18,B02,083749,Staff,0,11,30,30
1650639336779,MATH 18,B03,083750,Staff,0,12,30,30
1650639336779,MATH 18,B04,083751,Staff,0,12,30,30
1650639342802,MATH 20A,A01,083754,Staff,19,0,40,21
1650639348830,MATH 20B,A01,083756,Staff,0,12,30,30
1650639348830,MATH 20B,A02,083757,Staff,0,12,30,30
1650639354856,MATH 20C,A01,083760,Staff,0,15,30,30
1650639354856,MATH 20C,A02,083761,Staff,1,13,30,29
1650639354856,MATH 20C,B01,083762,Staff,11,0,30,19
1650639354856,MATH 20C,B02,083763,Staff,28,0,30,2
1650639360881,MATH 20D,A01,083765,Staff,1,1,30,29
1650639360881,MATH 20D,A02,083766,Staff,7,0,30,23
1650639360881,MATH 20D,A03,083767,Staff,24,0,30,6
1650639366905,MATH 20E,A01,083771,Staff,3,0,30,27
1650639366905,MATH 20E,A02,083772,Staff,17,0,30,13
1650639366905,MATH 20E,B01,083773,Staff,0,0,30,30
1650639366905,MATH 20E,B02,083774,Staff,9,0,30,21
1650639372929,MATH 103A,A01,083777,Staff,0,15,30,30
1650639372929,MATH 103A,A02,083778,Staff,0,15,30,30
1650639372929,MATH 103A,B01,083779,Staff,0,14,30,30
1650639372929,MATH 103A,B02,083780,Staff,0,14,30,30
1650639378953,MATH 105,A01,085443,Staff,0,22,30,30
1650639384981,MATH 109,A01,083213,Anzaldo; Leesa B,0,6,30,30
1650639384981,MATH 109,A02,083214,Anzaldo; Leesa B,0,7,30,30
1650639384981,MATH 109,B01,083215,Anzaldo; Leesa B,0,6,30,30
1650639384981,MATH 109,B02,083216,Anzaldo; Leesa B,0,6,30,30
1650639391009,MATH 142A,A01,083219,Chow; Bennett,0,16,30,30
1650639391009,MATH 142A,A02,083220,Chow; Bennett,0,15,30,30
1650639391009,MATH 142A,B01,083221,Chow; Bennett,0,14,30,30
1650639391009,MATH 142A,B02,083222,Chow; Bennett,0,13,30,30
1650639397035,MATH 193A,A01,083224,Staff,0,5,30,30
1650639397035,MATH 193A,A02,083225,Staff,0,6,30,30
1650639397035,MATH 193A,A03,083781,Staff,0,6,30,30
1650639397035,MATH 193A,A04,083782,Staff,0,7,30,30
1650639403060,MATH 197,001,091859,McAuley; Julian John,9998,0,9999,1
1650639409121,COGS 9,A01,083615,Staff,0,15,60,60
1650639415148,COGS 11,A01,083617,Boyle; Mary E. T.,18,0,40,22
1650639421172,COGS 13,A01,083071,Staff,0,38,40,40
1650639427199,COGS 14A,A01,092681,Staff,0,31,100,100
1650639433227,COGS 14B,A01,083073,Cheng; Tzu-Han,0,13,50,50
1650639439339,COGS 17,A01,092677,Staff,17,0,75,58
1650639445366,COGS 100,A01,083619,Staff,0,26,60,60
1650639451391,COGS 101A,A01,083621,Davis; Joshua Daniel,0,26,60,60
1650639457422,COGS 101B,A01,091572,Staff,0,4,60,60
1650639463445,COGS 101C,A01,083625,Delgado; Tania,15,0,30,15
1650639469473,COGS 107A,A01,083627,Boyle; Mary E. T.,1,15,60,59
1650639475505,COGS 118A,A01,083075,Staff,0,6,60,60
1650639481531,CSE 3,A50,083646,Miranda; Gregory Joseph,19,0,38,19
1650639481531,CSE 3,A51,083647,Miranda; Gregory Joseph,36,0,37,1
1650639487562,CSE 8A,A50,083650,Miranda; Gregory Joseph,0,30,40,40
1650639493590,CSE 11,A01,083080,Cao; Yingjun,0,95,40,40
1650639499614,CSE 12,A01,083652,Staff,0,19,100,100
1650639505646,CSE 15L,A01,083654,Staff,0,2,50,50
1650639505646,CSE 15L,A02,083655,Staff,0,1,50,50
1650639511669,CSE 20,A01,083657,Staff,51,0,80,29
1650639517694,CSE 30,A01,083084,Eldon; John,0,77,40,40
1650639523717,CSE 100,A01,083659,Cao; Yingjun,0,68,50,50
1650639529742,CSE 134B,A01,083661,Powell; Thomas Allan,0,36,65,65
1650639535766,CSE 140,A01,083663,Staff,0,8,75,75
1650639541793,CSE 140L,A01,083088,Eldon; John,0,16,75,75
1650639547817,CSE 175,A01,083665,Kumar; Rakesh,7,0,25,18
1650639553843,CSE 190,A00,092507,Dubnov; Shlomo,10,0,20,10
1650639559866,ECE 45,A01,083139,Staff,0,1,60,60
1650639565894,ECE 65,A50,083695,Staff,0,5,30,30
1650639571919,ECE 109,A01,091882,Touri; Behrouz,33,0,70,37
1650639577946,ECE 180,A00,083140,Abi Samra; Nicholas Camill,21,0,30,9
1650639577946,ECE 180,B00,083141,Abi Samra; Nicholas Camill,0,0,30,30
1650639583972,MATH 10A,A01,083735,Patchell; Gregory David,3,0,30,27
1650639583972,MATH 10A,A02,083736,Patchell; Gregory David,27,0,30,3
1650639583972,MATH 10A,A03,083737,Patchell; Gregory David,24,0,30,6
1650639590001,MATH 10B,A01,083207,Staff,0,8,30,30
1650639590001,MATH 10B,A02,083208,Staff,0,8,30,30
1650639590001,MATH 10B,B01,083739,Staff,11,0,30,19
1650639590001,MATH 10B,B02,083740,Staff,28,0,30,2
1650639596032,MATH 18,A01,083743,Staff,0,0,30,30
1650639596032,MATH 18,A02,083744,Staff,23,0,30,7
1650639596032,MATH 18,A03,083745,Staff,21,0,30,9
1650639596032,MATH 18,A04,083746,Staff,26,0,30,4
1650639596032,MATH 18,B01,083748,Staff,0,15,30,30
1650639596032,MATH 18,B02,083749,Staff,0,11,30,30
1650639596032,MATH 18,B03,083750,Staff,0,12,30,30
1650639596032,MATH 18,B04,083751,Staff,0,12,30,30
1650639602055,MATH 20A,A01,083754,Staff,19,0,40,21
1650639608083,MATH 20B,A01,083756,Staff,0,12,30,30
1650639608083,MATH 20B,A02,083757,Staff,0,12,30,30
1650639614107,MATH 20C,A01,083760,Staff,0,15,30,30
1650639614107,MATH 20C,A02,083761,Staff,1,13,30,29
1650639614107,MATH 20C,B01,083762,Staff,11,0,30,19
1650639614107,MATH 20C,B02,083763,Staff,28,0,30,2
1650639620130,MATH 20D,A01,083765,Staff,1,1,30,29
1650639620130,MATH 20D,A02,083766,Staff,7,0,30,23
1650639620130,MATH 20D,A03,083767,Staff,24,0,30,6
1650639626156,MATH 20E,A01,083771,Staff,3,0,30,27
1650639626156,MATH 20E,A02,083772,Staff,17,0,30,13
1650639626156,MATH 20E,B01,083773,Staff,0,0,30,30
1650639626156,MATH 20E,B02,083774,Staff,9,0,30,21
1650639632181,MATH 103A,A01,083777,Staff,0,15,30,30
1650639632181,MATH 103A,A02,083778,Staff,0,15,30,30
1650639632181,MATH 103A,B01,083779,Staff,0,14,30,30
1650639632181,MATH 103A,B02,083780,Staff,0,14,30,30
1650639638209,MATH 105,A01,085443,Staff,0,22,30,30
1650639644234,MATH 109,A01,083213,Anzaldo; Leesa B,0,6,30,30
1650639644234,MATH 109,A02,083214,Anzaldo; Leesa B,0,7,30,30
1650639644234,MATH 109,B01,083215,Anzaldo; Leesa B,0,6,30,30
1650639644234,MATH 109,B02,083216,Anzaldo; Leesa B,0,6,30,30
1650639650258,MATH 142A,A01,083219,Chow; Bennett,0,16,30,30
1650639650258,MATH 142A,A02,083220,Chow; Bennett,0,15,30,30
1650639650258,MATH 142A,B01,083221,Chow; Bennett,0,14,30,30
1650639650258,MATH 142A,B02,083222,Chow; Bennett,0,13,30,30
1650639656284,MATH 193A,A01,083224,Staff,0,5,30,30
1650639656284,MATH 193A,A02,083225,Staff,0,6,30,30
1650639656284,MATH 193A,A03,083781,Staff,0,6,30,30
1650639656284,MATH 193A,A04,083782,Staff,0,7,30,30
1650639662310,MATH 197,001,091859,McAuley; Julian John,9998,0,9999,1
1650639668363,COGS 9,A01,083615,Staff,0,15,60,60
1650639674390,COGS 11,A01,083617,Boyle; Mary E. T.,18,0,40,22
1650639680418,COGS 13,A01,083071,Staff,0,38,40,40
1650639686451,COGS 14A,A01,092681,Staff,0,31,100,100
1650639692474,COGS 14B,A01,083073,Cheng; Tzu-Han,0,13,50,50
1650639698507,COGS 17,A01,092677,Staff,17,0,75,58
1650639704542,COGS 100,A01,083619,Staff,0,26,60,60
1650639710569,COGS 101A,A01,083621,Davis; Joshua Daniel,0,26,60,60
1650639716593,COGS 101B,A01,091572,Staff,0,4,60,60
1650639722620,COGS 101C,A01,083625,Delgado; Tania,15,0,30,15
1650639728642,COGS 107A,A01,083627,Boyle; Mary E. T.,1,15,60,59
1650639734666,COGS 118A,A01,083075,Staff,0,6,60,60
1650639740701,CSE 3,A50,083646,Miranda; Gregory Joseph,19,0,38,19
1650639740701,CSE 3,A51,083647,Miranda; Gregory Joseph,36,0,37,1
1650639746728,CSE 8A,A50,083650,Miranda; Gregory Joseph,0,30,40,40
1650639752753,CSE 11,A01,083080,Cao; Yingjun,0,95,40,40
1650639758777,CSE 12,A01,083652,Staff,0,19,100,100
1650639764805,CSE 15L,A01,083654,Staff,0,2,50,50
1650639764805,CSE 15L,A02,083655,Staff,0,1,50,50
1650639770832,CSE 20,A01,083657,Staff,51,0,80,29
1650639776859,CSE 30,A01,083084,Eldon; John,0,77,40,40
1650639782884,CSE 100,A01,083659,Cao; Yingjun,0,68,50,50
1650639788907,CSE 134B,A01,083661,Powell; Thomas Allan,0,36,65,65
1650639794931,CSE 140,A01,083663,Staff,0,8,75,75
1650639800964,CSE 140L,A01,083088,Eldon; John,0,16,75,75
1650639806988,CSE 175,A01,083665,Kumar; Rakesh,7,0,25,18
1650639813012,CSE 190,A00,092507,Dubnov; Shlomo,10,0,20,10
1650639819036,ECE 45,A01,083139,Staff,0,1,60,60
1650639825067,ECE 65,A50,083695,Staff,0,5,30,30
1650639831092,ECE 109,A01,091882,Touri; Behrouz,33,0,70,37
1650639837117,ECE 180,A00,083140,Abi Samra; Nicholas Camill,21,0,30,9
1650639837117,ECE 180,B00,083141,Abi Samra; Nicholas Camill,0,0,30,30
1650639843143,MATH 10A,A01,083735,Patchell; Gregory David,3,0,30,27
1650639843143,MATH 10A,A02,083736,Patchell; Gregory David,27,0,30,3
1650639843143,MATH 10A,A03,083737,Patchell; Gregory David,24,0,30,6
1650639849175,MATH 10B,A01,083207,Staff,0,8,30,30
1650639849175,MATH 10B,A02,083208,Staff,0,8,30,30
1650639849175,MATH 10B,B01,083739,Staff,11,0,30,19
1650639849175,MATH 10B,B02,083740,Staff,28,0,30,2
1650639855206,MATH 18,A01,083743,Staff,0,0,30,30
1650639855206,MATH 18,A02,083744,Staff,23,0,30,7
1650639855206,MATH 18,A03,083745,Staff,21,0,30,9
1650639855206,MATH 18,A04,083746,Staff,26,0,30,4
1650639855206,MATH 18,B01,083748,Staff,0,15,30,30
1650639855206,MATH 18,B02,083749,Staff,0,11,30,30
1650639855206,MATH 18,B03,083750,Staff,0,12,30,30
1650639855206,MATH 18,B04,083751,Staff,0,12,30,30
1650639861232,MATH 20A,A01,083754,Staff,19,0,40,21
1650639867259,MATH 20B,A01,083756,Staff,0,12,30,30
1650639867259,MATH 20B,A02,083757,Staff,0,12,30,30
1650639873284,MATH 20C,A01,083760,Staff,0,15,30,30
1650639873284,MATH 20C,A02,083761,Staff,1,13,30,29
1650639873284,MATH 20C,B01,083762,Staff,11,0,30,19
1650639873284,MATH 20C,B02,083763,Staff,28,0,30,2
1650639879308,MATH 20D,A01,083765,Staff,1,1,30,29
1650639879308,MATH 20D,A02,083766,Staff,7,0,30,23
1650639879308,MATH 20D,A03,083767,Staff,24,0,30,6
1650639885336,MATH 20E,A01,083771,Staff,3,0,30,27
1650639885336,MATH 20E,A02,083772,Staff,17,0,30,13
1650639885336,MATH 20E,B01,083773,Staff,0,0,30,30
1650639885336,MATH 20E,B02,083774,Staff,9,0,30,21
1650639891359,MATH 103A,A01,083777,Staff,0,15,30,30
1650639891359,MATH 103A,A02,083778,Staff,0,15,30,30
1650639891359,MATH 103A,B01,083779,Staff,0,14,30,30
1650639891359,MATH 103A,B02,083780,Staff,0,14,30,30
1650639897383,MATH 105,A01,085443,Staff,0,22,30,30
1650639903408,MATH 109,A01,083213,Anzaldo; Leesa B,0,6,30,30
1650639903408,MATH 109,A02,083214,Anzaldo; Leesa B,0,7,30,30
1650639903408,MATH 109,B01,083215,Anzaldo; Leesa B,0,6,30,30
1650639903408,MATH 109,B02,083216,Anzaldo; Leesa B,0,6,30,30
1650639909441,MATH 142A,A01,083219,Chow; Bennett,0,16,30,30
1650639909441,MATH 142A,A02,083220,Chow; Bennett,0,15,30,30
1650639909441,MATH 142A,B01,083221,Chow; Bennett,0,14,30,30
1650639909441,MATH 142A,B02,083222,Chow; Bennett,0,13,30,30
1650639915463,MATH 193A,A01,083224,Staff,0,5,30,30
1650639915463,MATH 193A,A02,083225,Staff,0,6,30,30
1650639915463,MATH 193A,A03,083781,Staff,0,6,30,30
1650639915463,MATH 193A,A04,083782,Staff,0,7,30,30
1650639921488,MATH 197,001,091859,McAuley; Julian John,9998,0,9999,1
1650639927549,COGS 9,A01,083615,Staff,0,15,60,60
1650639933591,COGS 11,A01,083617,Boyle; Mary E. T.,18,0,40,22
1650639939626,COGS 13,A01,083071,Staff,0,38,40,40
1650639945654,COGS 14A,A01,092681,Staff,0,31,100,100
1650639951684,COGS 14B,A01,083073,Cheng; Tzu-Han,0,13,50,50
1650639957720,COGS 17,A01,092677,Staff,17,0,75,58
1650639963751,COGS 100,A01,083619,Staff,0,26,60,60
1650639969774,COGS 101A,A01,083621,Davis; Joshua Daniel,0,26,60,60
1650639975797,COGS 101B,A01,091572,Staff,0,4,60,60
1650639981820,COGS 101C,A01,083625,Delgado; Tania,15,0,30,15
1650639987845,COGS 107A,A01,083627,Boyle; Mary E. T.,1,15,60,59
1650639993882,COGS 118A,A01,083075,Staff,0,6,60,60
1650639999916,CSE 3,A50,083646,Miranda; Gregory Joseph,19,0,38,19
1650639999916,CSE 3,A51,083647,Miranda; Gregory Joseph,36,0,37,1
1650640005943,CSE 8A,A50,083650,Miranda; Gregory Joseph,0,30,40,40
1650640011973,CSE 11,A01,083080,Cao; Yingjun,0,95,40,40
1650640017996,CSE 12,A01,083652,Staff,0,19,100,100
1650640024023,CSE 15L,A01,083654,Staff,0,2,50,50
1650640024023,CSE 15L,A02,083655,Staff,0,1,50,50
1650640030069,CSE 20,A01,083657,Staff,51,0,80,29
1650640036190,CSE 30,A01,083084,Eldon; John,0,77,40,40
1650640042214,CSE 100,A01,083659,Cao; Yingjun,0,68,50,50
1650640048240,CSE 134B,A01,083661,Powell; Thomas Allan,0,36,65,65
1650640054266,CSE 140,A01,083663,Staff,0,8,75,75
1650640060302,CSE 140L,A01,083088,Eldon; John,0,16,75,75
1650640066339,CSE 175,A01,083665,Kumar; Rakesh,7,0,25,18
1650640072377,CSE 190,A00,092507,Dubnov; Shlomo,10,0,20,10
1650640078404,ECE 45,A01,083139,Staff,0,1,60,60
1650640084434,ECE 65,A50,083695,Staff,0,5,30,30
1650640090464,ECE 109,A01,091882,Touri; Behrouz,33,0,70,37
1650640096496,ECE 180,A00,083140,Abi Samra; Nicholas Camill,21,0,30,9
1650640096496,ECE 180,B00,083141,Abi Samra; Nicholas Camill,0,0,30,30
1650640102525,MATH 10A,A01,083735,Patchell; Gregory David,3,0,30,27
1650640102525,MATH 10A,A02,083736,Patchell; Gregory David,27,0,30,3
1650640102525,MATH 10A,A03,083737,Patchell; Gregory David,24,0,30,6
1650640108549,MATH 10B,A01,083207,Staff,0,8,30,30
1650640108549,MATH 10B,A02,083208,Staff,0,8,30,30
1650640108549,MATH 10B,B01,083739,Staff,11,0,30,19
1650640108549,MATH 10B,B02,083740,Staff,28,0,30,2
1650640114576,MATH 18,A01,083743,Staff,0,0,30,30
1650640114576,MATH 18,A02,083744,Staff,23,0,30,7
1650640114576,MATH 18,A03,083745,Staff,21,0,30,9
1650640114576,MATH 18,A04,083746,Staff,26,0,30,4
1650640114576,MATH 18,B01,083748,Staff,0,15,30,30
1650640114576,MATH 18,B02,083749,Staff,0,11,30,30
1650640114576,MATH 18,B03,083750,Staff,0,12,30,30
1650640114576,MATH 18,B04,083751,Staff,0,12,30,30
1650640120609,MATH 20A,A01,083754,Staff,19,0,40,21
1650640126633,MATH 20B,A01,083756,Staff,0,12,30,30
1650640126633,MATH 20B,A02,083757,Staff,0,12,30,30
1650640132658,MATH 20C,A01,083760,Staff,0,15,30,30
1650640132658,MATH 20C,A02,083761,Staff,1,13,30,29
1650640132658,MATH 20C,B01,083762,Staff,11,0,30,19
1650640132658,MATH 20C,B02,083763,Staff,28,0,30,2
1650640138693,MATH 20D,A01,083765,Staff,1,1,30,29
1650640138693,MATH 20D,A02,083766,Staff,7,0,30,23
1650640138693,MATH 20D,A03,083767,Staff,24,0,30,6
1650640144720,MATH 20E,A01,083771,Staff,3,0,30,27
1650640144720,MATH 20E,A02,083772,Staff,17,0,30,13
1650640144720,MATH 20E,B01,083773,Staff,0,0,30,30
1650640144720,MATH 20E,B02,083774,Staff,9,0,30,21
1650640150747,MATH 103A,A01,083777,Staff,0,15,30,30
1650640150747,MATH 103A,A02,083778,Staff,0,15,30,30
1650640150747,MATH 103A,B01,083779,Staff,0,14,30,30
1650640150747,MATH 103A,B02,083780,Staff,0,14,30,30
1650640156781,MATH 105,A01,085443,Staff,0,22,30,30
1650640162806,MATH 109,A01,083213,Anzaldo; Leesa B,0,6,30,30
1650640162806,MATH 109,A02,083214,Anzaldo; Leesa B,0,7,30,30
1650640162806,MATH 109,B01,083215,Anzaldo; Leesa B,0,6,30,30
1650640162806,MATH 109,B02,083216,Anzaldo; Leesa B,0,6,30,30
1650640168847,MATH 142A,A01,083219,Chow; Bennett,0,16,30,30
1650640168847,MATH 142A,A02,083220,Chow; Bennett,0,15,30,30
1650640168847,MATH 142A,B01,083221,Chow; Bennett,0,14,30,30
1650640168847,MATH 142A,B02,083222,Chow; Bennett,0,13,30,30
1650640174871,MATH 193A,A01,083224,Staff,0,5,30,30
1650640174871,MATH 193A,A02,083225,Staff,0,6,30,30
1650640174871,MATH 193A,A03,083781,Staff,0,6,30,30
1650640174871,MATH 193A,A04,083782,Staff,0,7,30,30
1650640180898,MATH 197,001,091859,McAuley; Julian John,9998,0,9999,1
1650640186949,COGS 9,A01,083615,Staff,0,15,60,60
1650640192972,COGS 11,A01,083617,Boyle; Mary E. T.,18,0,40,22
1650640198997,COGS 13,A01,083071,Staff,0,38,40,40
1650640205025,COGS 14A,A01,092681,Staff,0,31,100,100
1650640211050,COGS 14B,A01,083073,Cheng; Tzu-Han,0,13,50,50
1650640217080,COGS 17,A01,092677,Staff,17,0,75,58
1650640223103,COGS 100,A01,083619,Staff,0,26,60,60
1650640229127,COGS 101A,A01,083621,Davis; Joshua Daniel,0,26,60,60
1650640235154,COGS 101B,A01,091572,Staff,0,4,60,60
1650640241180,COGS 101C,A01,083625,Delgado; Tania,15,0,30,15
1650640247203,COGS 107A,A01,083627,Boyle; Mary E. T.,1,15,60,59
1650640253229,COGS 118A,A01,083075,Staff,0,6,60,60
1650640259253,CSE 3,A50,083646,Miranda; Gregory Joseph,19,0,38,19
1650640259253,CSE 3,A51,083647,Miranda; Gregory Joseph,36,0,37,1
1650640265284,CSE 8A,A50,083650,Miranda; Gregory Joseph,0,30,40,40
1650640271311,CSE 11,A01,083080,Cao; Yingjun,0,95,40,40
1650640277337,CSE 12,A01,083652,Staff,0,19,100,100
1650640283362,CSE 15L,A01,083654,Staff,0,2,50,50
1650640283362,CSE 15L,A02,083655,Staff,0,1,50,50
1650640289390,CSE 20,A01,083657,Staff,51,0,80,29
1650640295417,CSE 30,A01,083084,Eldon; John,0,77,40,40
1650640301446,CSE 100,A01,083659,Cao; Yingjun,0,68,50,50
1650640307474,CSE 134B,A01,083661,Powell; Thomas Allan,0,36,65,65
1650640313507,CSE 140,A01,083663,Staff,0,8,75,75
1650640319535,CSE 140L,A01,083088,Eldon; John,0,16,75,75
1650640325559,CSE 175,A01,083665,Kumar; Rakesh,7,0,25,18
1650640331583,CSE 190,A00,092507,Dubnov; Shlomo,10,0,20,10
1650640337606,ECE 45,A01,083139,Staff,0,1,60,60
1650640343632,ECE 65,A50,083695,Staff,0,5,30,30
1650640349656,ECE 109,A01,091882,Touri; Behrouz,33,0,70,37
1650640355680,ECE 180,A00,083140,Abi Samra; Nicholas Camill,21,0,30,9
1650640355680,ECE 180,B00,083141,Abi Samra; Nicholas Camill,0,0,30,30
1650640361717,MATH 10A,A01,083735,Patchell; Gregory David,3,0,30,27
1650640361717,MATH 10A,A02,083736,Patchell; Gregory David,27,0,30,3
1650640361717,MATH 10A,A03,083737,Patchell; Gregory David,24,0,30,6
1650640367744,MATH 10B,A01,083207,Staff,0,8,30,30
1650640367744,MATH 10B,A02,083208,Staff,0,8,30,30
1650640367744,MATH 10B,B01,083739,Staff,11,0,30,19
1650640367744,MATH 10B,B02,083740,Staff,28,0,30,2
1650640373775,MATH 18,A01,083743,Staff,0,0,30,30
1650640373775,MATH 18,A02,083744,Staff,23,0,30,7
1650640373775,MATH 18,A03,083745,Staff,21,0,30,9
1650640373775,MATH 18,A04,083746,Staff,26,0,30,4
1650640373775,MATH 18,B01,083748,Staff,0,15,30,30
1650640373775,MATH 18,B02,083749,Staff,0,11,30,30
1650640373775,MATH 18,B03,083750,Staff,0,12,30,30
1650640373775,MATH 18,B04,083751,Staff,0,12,30,30
1650640379804,MATH 20A,A01,083754,Staff,19,0,40,21
1650640385837,MATH 20B,A01,083756,Staff,0,12,30,30
1650640385837,MATH 20B,A02,083757,Staff,0,12,30,30
1650640391863,MATH 20C,A01,083760,Staff,0,15,30,30
1650640391863,MATH 20C,A02,083761,Staff,1,13,30,29
1650640391863,MATH 20C,B01,083762,Staff,11,0,30,19
1650640391863,MATH 20C,B02,083763,Staff,28,0,30,2
1650640397889,MATH 20D,A01,083765,Staff,1,1,30,29
1650640397889,MATH 20D,A02,083766,Staff,7,0,30,23
1650640397889,MATH 20D,A03,083767,Staff,24,0,30,6
1650640403915,MATH 20E,A01,083771,Staff,3,0,30,27
1650640403915,MATH 20E,A02,083772,Staff,17,0,30,13
1650640403915,MATH 20E,B01,083773,Staff,0,0,30,30
1650640403915,MATH 20E,B02,083774,Staff,9,0,30,21
1650640409954,MATH 103A,A01,083777,Staff,0,15,30,30
1650640409954,MATH 103A,A02,083778,Staff,0,15,30,30
1650640409954,MATH 103A,B01,083779,Staff,0,14,30,30
1650640409954,MATH 103A,B02,083780,Staff,0,14,30,30
1650640415979,MATH 105,A01,085443,Staff,0,22,30,30
1650640422017,MATH 109,A01,083213,Anzaldo; Leesa B,0,6,30,30
1650640422017,MATH 109,A02,083214,Anzaldo; Leesa B,0,7,30,30
1650640422017,MATH 109,B01,083215,Anzaldo; Leesa B,0,6,30,30
1650640422017,MATH 109,B02,083216,Anzaldo; Leesa B,0,6,30,30
1650640428046,MATH 142A,A01,083219,Chow; Bennett,0,16,30,30
1650640428046,MATH 142A,A02,083220,Chow; Bennett,0,15,30,30
1650640428046,MATH 142A,B01,083221,Chow; Bennett,0,14,30,30
1650640428046,MATH 142A,B02,083222,Chow; Bennett,0,13,30,30
1650640434070,MATH 193A,A01,083224,Staff,0,5,30,30
1650640434070,MATH 193A,A02,083225,Staff,0,6,30,30
1650640434070,MATH 193A,A03,083781,Staff,0,6,30,30
1650640434070,MATH 193A,A04,083782,Staff,0,7,30,30
1650640440097,MATH 197,001,091859,McAuley; Julian John,9998,0,9999,1
1650640446149,COGS 9,A01,083615,Staff,0,15,60,60
1650640452181,COGS 11,A01,083617,Boyle; Mary E. T.,18,0,40,22
1650640458208,COGS 13,A01,083071,Staff,0,38,40,40
1650640464235,COGS 14A,A01,092681,Staff,0,31,100,100
1650640470268,COGS 14B,A01,083073,Cheng; Tzu-Han,0,13,50,50
1650640476293,COGS 17,A01,092677,Staff,17,0,75,58
1650640482316,COGS 100,A01,083619,Staff,0,26,60,60
1650640488343,COGS 101A,A01,083621,Davis; Joshua Daniel,0,26,60,60
1650640494365,COGS 101B,A01,091572,Staff,0,4,60,60
1650640500390,COGS 101C,A01,083625,Delgado; Tania,15,0,30,15
1650640506415,COGS 107A,A01,083627,Boyle; Mary E. T.,1,15,60,59
1650640512442,COGS 118A,A01,083075,Staff,0,6,60,60
1650640518465,CSE 3,A50,083646,Miranda; Gregory Joseph,19,0,38,19
1650640518465,CSE 3,A51,083647,Miranda; Gregory Joseph,36,0,37,1
1650640524489,CSE 8A,A50,083650,Miranda; Gregory Joseph,0,30,40,40
1650640530521,CSE 11,A01,083080,Cao; Yingjun,0,95,40,40
1650640536550,CSE 12,A01,083652,Staff,0,19,100,100
1650640542575,CSE 15L,A01,083654,Staff,0,2,50,50
1650640542575,CSE 15L,A02,083655,Staff,0,1,50,50
1650640548604,CSE 20,A01,083657,Staff,51,0,80,29
1650640554630,CSE 30,A01,083084,Eldon; John,0,77,40,40
1650640560652,CSE 100,A01,083659,Cao; Yingjun,0,68,50,50
1650640566685,CSE 134B,A01,083661,Powell; Thomas Allan,0,36,65,65
1650640572709,CSE 140,A01,083663,Staff,0,8,75,75
1650640578736,CSE 140L,A01,083088,Eldon; John,0,16,75,75
1650640584759,CSE 175,A01,083665,Kumar; Rakesh,7,0,25,18
1650640590782,CSE 190,A00,092507,Dubnov; Shlomo,10,0,20,10
1650640596807,ECE 45,A01,083139,Staff,0,1,60,60
1650640602840,ECE 65,A50,083695,Staff,0,5,30,30
1650640608872,ECE 109,A01,091882,Touri; Behrouz,33,0,70,37
1650640614903,ECE 180,A00,083140,Abi Samra; Nicholas Camill,21,0,30,9
1650640614903,ECE 180,B00,083141,Abi Samra; Nicholas Camill,0,0,30,30
1650640620927,MATH 10A,A01,083735,Patchell; Gregory David,3,0,30,27
1650640620927,MATH 10A,A02,083736,Patchell; Gregory David,27,0,30,3
1650640620927,MATH 10A,A03,083737,Patchell; Gregory David,24,0,30,6
1650640626955,MATH 10B,A01,083207,Staff,0,8,30,30
1650640626955,MATH 10B,A02,083208,Staff,0,8,30,30
1650640626955,MATH 10B,B01,083739,Staff,11,0,30,19
1650640626955,MATH 10B,B02,083740,Staff,28,0,30,2
1650640633074,MATH 18,A01,083743,Staff,0,0,30,30
1650640633074,MATH 18,A02,083744,Staff,23,0,30,7
1650640633074,MATH 18,A03,083745,Staff,21,0,30,9
1650640633074,MATH 18,A04,083746,Staff,26,0,30,4
1650640633074,MATH 18,B01,083748,Staff,0,15,30,30
1650640633074,MATH 18,B02,083749,Staff,0,11,30,30
1650640633074,MATH 18,B03,083750,Staff,0,12,30,30
1650640633074,MATH 18,B04,083751,Staff,0,12,30,30
1650640639101,MATH 20A,A01,083754,Staff,19,0,40,21
1650640645137,MATH 20B,A01,083756,Staff,0,12,30,30
1650640645137,MATH 20B,A02,083757,Staff,0,12,30,30
1650640651160,MATH 20C,A01,083760,Staff,0,15,30,30
1650640651160,MATH 20C,A02,083761,Staff,1,13,30,29
1650640651160,MATH 20C,B01,083762,Staff,11,0,30,19
1650640651160,MATH 20C,B02,083763,Staff,28,0,30,2
1650640657191,MATH 20D,A01,083765,Staff,1,1,30,29
1650640657191,MATH 20D,A02,083766,Staff,7,0,30,23
1650640657191,MATH 20D,A03,083767,Staff,24,0,30,6
1650640663218,MATH 20E,A01,083771,Staff,3,0,30,27
1650640663218,MATH 20E,A02,083772,Staff,17,0,30,13
1650640663218,MATH 20E,B01,083773,Staff,0,0,30,30
1650640663218,MATH 20E,B02,083774,Staff,9,0,30,21
1650640669244,MATH 103A,A01,083777,Staff,0,15,30,30
1650640669244,MATH 103A,A02,083778,Staff,0,15,30,30
1650640669244,MATH 103A,B01,083779,Staff,0,14,30,30
1650640669244,MATH 103A,B02,083780,Staff,0,14,30,30
1650640675274,MATH 105,A01,085443,Staff,0,22,30,30
1650640681298,MATH 109,A01,083213,Anzaldo; Leesa B,0,6,30,30
1650640681298,MATH 109,A02,083214,Anzaldo; Leesa B,0,7,30,30
1650640681298,MATH 109,B01,083215,Anzaldo; Leesa B,0,6,30,30
1650640681298,MATH 109,B02,083216,Anzaldo; Leesa B,0,6,30,30
1650640687326,MATH 142A,A01,083219,Chow; Bennett,0,16,30,30
1650640687326,MATH 142A,A02,083220,Chow; Bennett,0,15,30,30
1650640687326,MATH 142A,B01,083221,Chow; Bennett,0,14,30,30
1650640687326,MATH 142A,B02,083222,Chow; Bennett,0,13,30,30
1650640693355,MATH 193A,A01,083224,Staff,0,5,30,30
1650640693355,MATH 193A,A02,083225,Staff,0,6,30,30
1650640693355,MATH 193A,A03,083781,Staff,0,6,30,30
1650640693355,MATH 193A,A04,083782,Staff,0,7,30,30
1650640699385,MATH 197,001,091859,McAuley; Julian John,9998,0,9999,1
1650640705437,COGS 9,A01,083615,Staff,0,15,60,60
1650640711461,COGS 11,A01,083617,Boyle; Mary E. T.,18,0,40,22
1650640717485,COGS 13,A01,083071,Staff,0,38,40,40
1650640723517,COGS 14A,A01,092681,Staff,0,31,100,100
1650640729553,COGS 14B,A01,083073,Cheng; Tzu-Han,0,13,50,50
1650640735588,COGS 17,A01,092677,Staff,17,0,75,58
1650640741611,COGS 100,A01,083619,Staff,0,26,60,60
1650640747633,COGS 101A,A01,083621,Davis; Joshua Daniel,0,26,60,60
1650640753658,COGS 101B,A01,091572,Staff,0,4,60,60
1650640759685,COGS 101C,A01,083625,Delgado; Tania,15,0,30,15
1650640765712,COGS 107A,A01,083627,Boyle; Mary E. T.,1,15,60,59
1650640771738,COGS 118A,A01,083075,Staff,0,6,60,60
1650640777767,CSE 3,A50,083646,Miranda; Gregory Joseph,19,0,38,19
1650640777767,CSE 3,A51,083647,Miranda; Gregory Joseph,36,0,37,1
1650640783792,CSE 8A,A50,083650,Miranda; Gregory Joseph,0,30,40,40
1650640789821,CSE 11,A01,083080,Cao; Yingjun,0,95,40,40
1650640795844,CSE 12,A01,083652,Staff,0,19,100,100
1650640801869,CSE 15L,A01,083654,Staff,0,2,50,50
1650640801869,CSE 15L,A02,083655,Staff,0,1,50,50
1650640807896,CSE 20,A01,083657,Staff,51,0,80,29
1650640813925,CSE 30,A01,083084,Eldon; John,0,77,40,40
1650640819953,CSE 100,A01,083659,Cao; Yingjun,0,68,50,50
1650640825980,CSE 134B,A01,083661,Powell; Thomas Allan,0,36,65,65
1650640832008,CSE 140,A01,083663,Staff,0,8,75,75
1650640838033,CSE 140L,A01,083088,Eldon; John,0,16,75,75
1650640844061,CSE 175,A01,083665,Kumar; Rakesh,7,0,25,18
1650640850109,CSE 190,A00,092507,Dubnov; Shlomo,10,0,20,10
1650640856133,ECE 45,A01,083139,Staff,0,1,60,60
1650640862162,ECE 65,A50,083695,Staff,0,5,30,30
1650640868193,ECE 109,A01,091882,Touri; Behrouz,33,0,70,37
1650640874217,ECE 180,A00,083140,Abi Samra; Nicholas Camill,21,0,30,9
1650640874217,ECE 180,B00,083141,Abi Samra; Nicholas Camill,0,0,30,30
1650640880255,MATH 10A,A01,083735,Patchell; Gregory David,3,0,30,27
1650640880255,MATH 10A,A02,083736,Patchell; Gregory David,27,0,30,3
1650640880255,MATH 10A,A03,083737,Patchell; Gregory David,24,0,30,6
1650640886279,MATH 10B,A01,083207,Staff,0,8,30,30
1650640886279,MATH 10B,A02,083208,Staff,0,8,30,30
1650640886279,MATH 10B,B01,083739,Staff,11,0,30,19
1650640886279,MATH 10B,B02,083740,Staff,28,0,30,2
1650640892329,MATH 18,A01,083743,Staff,0,0,30,30
1650640892329,MATH 18,A02,083744,Staff,23,0,30,7
1650640892329,MATH 18,A03,083745,Staff,21,0,30,9
1650640892329,MATH 18,A04,083746,Staff,26,0,30,4
1650640892329,MATH 18,B01,083748,Staff,0,15,30,30
1650640892329,MATH 18,B02,083749,Staff,0,11,30,30
1650640892329,MATH 18,B03,083750,Staff,0,12,30,30
1650640892329,MATH 18,B04,083751,Staff,0,12,30,30
1650640898361,MATH 20A,A01,083754,Staff,19,0,40,21
1650640904387,MATH 20B,A01,083756,Staff,0,12,30,30
1650640904387,MATH 20B,A02,083757,Staff,0,12,30,30
1650640910414,MATH 20C,A01,083760,Staff,0,15,30,30
1650640910414,MATH 20C,A02,083761,Staff,1,13,30,29
1650640910414,MATH 20C,B01,083762,Staff,11,0,30,19
1650640910414,MATH 20C,B02,083763,Staff,28,0,30,2
1650640916442,MATH 20D,A01,083765,Staff,1,1,30,29
1650640916442,MATH 20D,A02,083766,Staff,7,0,30,23
1650640916442,MATH 20D,A03,083767,Staff,24,0,30,6
1650640922470,MATH 20E,A01,083771,Staff,3,0,30,27
1650640922470,MATH 20E,A02,083772,Staff,17,0,30,13
1650640922470,MATH 20E,B01,083773,Staff,0,0,30,30
1650640922470,MATH 20E,B02,083774,Staff,9,0,30,21
1650640928510,MATH 103A,A01,083777,Staff,0,15,30,30
1650640928510,MATH 103A,A02,083778,Staff,0,15,30,30
1650640928510,MATH 103A,B01,083779,Staff,0,14,30,30
1650640928510,MATH 103A,B02,083780,Staff,0,14,30,30
1650640934537,MATH 105,A01,085443,Staff,0,22,30,30
1650640940560,MATH 109,A01,083213,Anzaldo; Leesa B,0,6,30,30
1650640940560,MATH 109,A02,083214,Anzaldo; Leesa B,0,7,30,30
1650640940560,MATH 109,B01,083215,Anzaldo; Leesa B,0,6,30,30
1650640940560,MATH 109,B02,083216,Anzaldo; Leesa B,0,6,30,30
1650640946586,MATH 142A,A01,083219,Chow; Bennett,0,16,30,30
1650640946586,MATH 142A,A02,083220,Chow; Bennett,0,15,30,30
1650640946586,MATH 142A,B01,083221,Chow; Bennett,0,14,30,30
1650640946586,MATH 142A,B02,083222,Chow; Bennett,0,13,30,30
1650640952611,MATH 193A,A01,083224,Staff,0,5,30,30
1650640952611,MATH 193A,A02,083225,Staff,0,6,30,30
1650640952611,MATH 193A,A03,083781,Staff,0,6,30,30
1650640952611,MATH 193A,A04,083782,Staff,0,7,30,30
1650640958645,MATH 197,001,091859,McAuley; Julian John,9998,0,9999,1
1650640964718,COGS 9,A01,083615,Staff,1,15,60,59
1650640970755,COGS 11,A01,083617,Boyle; Mary E. T.,18,0,40,22
1650640976779,COGS 13,A01,083071,Staff,0,38,40,40
1650640982823,COGS 14A,A01,092681,Staff,0,31,100,100
1650640988847,COGS 14B,A01,083073,Cheng; Tzu-Han,0,13,50,50
1650640994884,COGS 17,A01,092677,Staff,17,0,75,58
1650641000909,COGS 100,A01,083619,Staff,0,26,60,60
1650641006944,COGS 101A,A01,083621,Davis; Joshua Daniel,0,26,60,60
1650641012970,COGS 101B,A01,091572,Staff,0,4,60,60
1650641018994,COGS 101C,A01,083625,Delgado; Tania,15,0,30,15
1650641025021,COGS 107A,A01,083627,Boyle; Mary E. T.,1,15,60,59
1650641031046,COGS 118A,A01,083075,Staff,0,6,60,60
1650641037072,CSE 3,A50,083646,Miranda; Gregory Joseph,19,0,38,19
1650641037072,CSE 3,A51,083647,Miranda; Gregory Joseph,36,0,37,1
1650641043108,CSE 8A,A50,083650,Miranda; Gregory Joseph,0,30,40,40
1650641049136,CSE 11,A01,083080,Cao; Yingjun,0,95,40,40
1650641055161,CSE 12,A01,083652,Staff,0,19,100,100
1650641061186,CSE 15L,A01,083654,Staff,0,2,50,50
1650641061186,CSE 15L,A02,083655,Staff,0,1,50,50
1650641067220,CSE 20,A01,083657,Staff,51,0,80,29
1650641073257,CSE 30,A01,083084,Eldon; John,0,77,40,40
1650641079281,CSE 100,A01,083659,Cao; Yingjun,0,68,50,50
1650641085305,CSE 134B,A01,083661,Powell; Thomas Allan,0,36,65,65
1650641091336,CSE 140,A01,083663,Staff,0,8,75,75
1650641097362,CSE 140L,A01,083088,Eldon; John,0,16,75,75
1650641103389,CSE 175,A01,083665,Kumar; Rakesh,7,0,25,18
1650641109423,CSE 190,A00,092507,Dubnov; Shlomo,10,0,20,10
1650641115446,ECE 45,A01,083139,Staff,0,1,60,60
1650641121474,ECE 65,A50,083695,Staff,0,5,30,30
1650641127507,ECE 109,A01,091882,Touri; Behrouz,33,0,70,37
1650641133535,ECE 180,A00,083140,Abi Samra; Nicholas Camill,21,0,30,9
1650641133535,ECE 180,B00,083141,Abi Samra; Nicholas Camill,0,0,30,30
1650641139563,MATH 10A,A01,083735,Patchell; Gregory David,3,0,30,27
1650641139563,MATH 10A,A02,083736,Patchell; Gregory David,27,0,30,3
1650641139563,MATH 10A,A03,083737,Patchell; Gregory David,24,0,30,6
1650641145591,MATH 10B,A01,083207,Staff,0,8,30,30
1650641145591,MATH 10B,A02,083208,Staff,0,8,30,30
1650641145591,MATH 10B,B01,083739,Staff,11,0,30,19
1650641145591,MATH 10B,B02,083740,Staff,28,0,30,2
1650641151626,MATH 18,A01,083743,Staff,0,0,30,30
1650641151626,MATH 18,A02,083744,Staff,23,0,30,7
1650641151626,MATH 18,A03,083745,Staff,21,0,30,9
1650641151626,MATH 18,A04,083746,Staff,26,0,30,4
1650641151626,MATH 18,B01,083748,Staff,0,15,30,30
1650641151626,MATH 18,B02,083749,Staff,0,11,30,30
1650641151626,MATH 18,B03,083750,Staff,0,12,30,30
1650641151626,MATH 18,B04,083751,Staff,0,12,30,30
1650641157658,MATH 20A,A01,083754,Staff,19,0,40,21
1650641163707,MATH 20B,A01,083756,Staff,0,12,30,30
1650641163707,MATH 20B,A02,083757,Staff,0,12,30,30
1650641169737,MATH 20C,A01,083760,Staff,0,15,30,30
1650641169737,MATH 20C,A02,083761,Staff,1,13,30,29
1650641169737,MATH 20C,B01,083762,Staff,11,0,30,19
1650641169737,MATH 20C,B02,083763,Staff,28,0,30,2
1650641175761,MATH 20D,A01,083765,Staff,1,1,30,29
1650641175761,MATH 20D,A02,083766,Staff,7,0,30,23
1650641175761,MATH 20D,A03,083767,Staff,24,0,30,6
1650641181786,MATH 20E,A01,083771,Staff,3,0,30,27
1650641181786,MATH 20E,A02,083772,Staff,17,0,30,13
1650641181786,MATH 20E,B01,083773,Staff,0,0,30,30
1650641181786,MATH 20E,B02,083774,Staff,9,0,30,21
1650641187817,MATH 103A,A01,083777,Staff,0,15,30,30
1650641187817,MATH 103A,A02,083778,Staff,0,15,30,30
1650641187817,MATH 103A,B01,083779,Staff,0,14,30,30
1650641187817,MATH 103A,B02,083780,Staff,0,14,30,30
1650641193841,MATH 105,A01,085443,Staff,0,22,30,30
1650641199875,MATH 109,A01,083213,Anzaldo; Leesa B,0,6,30,30
1650641199875,MATH 109,A02,083214,Anzaldo; Leesa B,0,7,30,30
1650641199875,MATH 109,B01,083215,Anzaldo; Leesa B,0,6,30,30
1650641199875,MATH 109,B02,083216,Anzaldo; Leesa B,0,6,30,30
1650641205905,MATH 142A,A01,083219,Chow; Bennett,0,16,30,30
1650641205905,MATH 142A,A02,083220,Chow; Bennett,0,15,30,30
1650641205905,MATH 142A,B01,083221,Chow; Bennett,0,14,30,30
1650641205905,MATH 142A,B02,083222,Chow; Bennett,0,13,30,30
1650641211933,MATH 193A,A01,083224,Staff,0,5,30,30
1650641211933,MATH 193A,A02,083225,Staff,0,6,30,30
1650641211933,MATH 193A,A03,083781,Staff,0,6,30,30
1650641211933,MATH 193A,A04,083782,Staff,0,7,30,30
1650641217969,MATH 197,001,091859,McAuley; Julian John,9998,0,9999,1
1650641224128,COGS 9,A01,083615,Staff,1,15,60,59
1650641230152,COGS 11,A01,083617,Boyle; Mary E. T.,18,0,40,22
1650641236185,COGS 13,A01,083071,Staff,0,38,40,40
1650641242208,COGS 14A,A01,092681,Staff,0,31,100,100
1650641248246,COGS 14B,A01,083073,Cheng; Tzu-Han,0,13,50,50
1650641254269,COGS 17,A01,092677,Staff,17,0,75,58
1650641260296,COGS 100,A01,083619,Staff,0,26,60,60
1650641266332,COGS 101A,A01,083621,Davis; Joshua Daniel,0,26,60,60
1650641272355,COGS 101B,A01,091572,Staff,0,4,60,60
1650641278379,COGS 101C,A01,083625,Delgado; Tania,15,0,30,15
1650641284406,COGS 107A,A01,083627,Boyle; Mary E. T.,1,15,60,59
1650641290446,COGS 118A,A01,083075,Staff,0,6,60,60
1650641296487,CSE 3,A50,083646,Miranda; Gregory Joseph,19,0,38,19
1650641296487,CSE 3,A51,083647,Miranda; Gregory Joseph,36,0,37,1
1650641302515,CSE 8A,A50,083650,Miranda; Gregory Joseph,0,30,40,40
1650641308542,CSE 11,A01,083080,Cao; Yingjun,0,95,40,40
1650641314567,CSE 12,A01,083652,Staff,0,19,100,100
1650641320592,CSE 15L,A01,083654,Staff,0,2,50,50
1650641320592,CSE 15L,A02,083655,Staff,0,1,50,50
1650641326615,CSE 20,A01,083657,Staff,51,0,80,29
1650641332641,CSE 30,A01,083084,Eldon; John,0,77,40,40
1650641338665,CSE 100,A01,083659,Cao; Yingjun,0,68,50,50
1650641344693,CSE 134B,A01,083661,Powell; Thomas Allan,0,36,65,65
1650641350718,CSE 140,A01,083663,Staff,0,8,75,75
1650641356745,CSE 140L,A01,083088,Eldon; John,0,16,75,75
1650641362767,CSE 175,A01,083665,Kumar; Rakesh,7,0,25,18
1650641368802,CSE 190,A00,092507,Dubnov; Shlomo,10,0,20,10
1650641374829,ECE 45,A01,083139,Staff,0,1,60,60
1650641380862,ECE 65,A50,083695,Staff,0,5,30,30
1650641386887,ECE 109,A01,091882,Touri; Behrouz,33,0,70,37
1650641392916,ECE 180,A00,083140,Abi Samra; Nicholas Camill,21,0,30,9
1650641392916,ECE 180,B00,083141,Abi Samra; Nicholas Camill,0,0,30,30
1650641398948,MATH 10A,A01,083735,Patchell; Gregory David,3,0,30,27
1650641398948,MATH 10A,A02,083736,Patchell; Gregory David,27,0,30,3
1650641398948,MATH 10A,A03,083737,Patchell; Gregory David,24,0,30,6
1650641404972,MATH 10B,A01,083207,Staff,0,8,30,30
1650641404972,MATH 10B,A02,083208,Staff,0,8,30,30
1650641404972,MATH 10B,B01,083739,Staff,11,0,30,19
1650641404972,MATH 10B,B02,083740,Staff,28,0,30,2
1650641411003,MATH 18,A01,083743,Staff,0,0,30,30
1650641411003,MATH 18,A02,083744,Staff,23,0,30,7
1650641411003,MATH 18,A03,083745,Staff,21,0,30,9
1650641411003,MATH 18,A04,083746,Staff,26,0,30,4
1650641411003,MATH 18,B01,083748,Staff,0,15,30,30
1650641411003,MATH 18,B02,083749,Staff,0,11,30,30
1650641411003,MATH 18,B03,083750,Staff,0,12,30,30
1650641411003,MATH 18,B04,083751,Staff,0,12,30,30
1650641417038,MATH 20A,A01,083754,Staff,19,0,40,21
1650641423066,MATH 20B,A01,083756,Staff,0,12,30,30
1650641423066,MATH 20B,A02,083757,Staff,0,12,30,30
1650641429098,MATH 20C,A01,083760,Staff,0,15,30,30
1650641429098,MATH 20C,A02,083761,Staff,1,13,30,29
1650641429098,MATH 20C,B01,083762,Staff,11,0,30,19
1650641429098,MATH 20C,B02,083763,Staff,28,0,30,2
1650641435137,MATH 20D,A01,083765,Staff,1,1,30,29
1650641435137,MATH 20D,A02,083766,Staff,7,0,30,23
1650641435137,MATH 20D,A03,083767,Staff,24,0,30,6
1650641441173,MATH 20E,A01,083771,Staff,3,0,30,27
1650641441173,MATH 20E,A02,083772,Staff,17,0,30,13
1650641441173,MATH 20E,B01,083773,Staff,0,0,30,30
1650641441173,MATH 20E,B02,083774,Staff,9,0,30,21
1650641447196,MATH 103A,A01,083777,Staff,0,15,30,30
1650641447196,MATH 103A,A02,083778,Staff,0,15,30,30
1650641447196,MATH 103A,B01,083779,Staff,0,14,30,30
1650641447196,MATH 103A,B02,083780,Staff,0,14,30,30
1650641453231,MATH 105,A01,085443,Staff,0,22,30,30
1650641459256,MATH 109,A01,083213,Anzaldo; Leesa B,0,6,30,30
1650641459256,MATH 109,A02,083214,Anzaldo; Leesa B,0,7,30,30
1650641459256,MATH 109,B01,083215,Anzaldo; Leesa B,0,6,30,30
1650641459256,MATH 109,B02,083216,Anzaldo; Leesa B,0,6,30,30
1650641465303,MATH 142A,A01,083219,Chow; Bennett,0,16,30,30
1650641465303,MATH 142A,A02,083220,Chow; Bennett,0,15,30,30
1650641465303,MATH 142A,B01,083221,Chow; Bennett,0,14,30,30
1650641465303,MATH 142A,B02,083222,Chow; Bennett,0,13,30,30
1650641471340,MATH 193A,A01,083224,Staff,0,5,30,30
1650641471340,MATH 193A,A02,083225,Staff,0,6,30,30
1650641471340,MATH 193A,A03,083781,Staff,0,6,30,30
1650641471340,MATH 193A,A04,083782,Staff,0,7,30,30
1650641477364,MATH 197,001,091859,McAuley; Julian John,9998,0,9999,1
1650641483416,COGS 9,A01,083615,Staff,1,15,60,59
1650641489440,COGS 11,A01,083617,Boyle; Mary E. T.,18,0,40,22
1650641495461,COGS 13,A01,083071,Staff,0,38,40,40
1650641501494,COGS 14A,A01,092681,Staff,0,31,100,100
1650641507518,COGS 14B,A01,083073,Cheng; Tzu-Han,0,13,50,50
1650641513547,COGS 17,A01,092677,Staff,17,0,75,58
1650641519573,COGS 100,A01,083619,Staff,0,26,60,60
1650641525597,COGS 101A,A01,083621,Davis; Joshua Daniel,0,26,60,60
1650641531619,COGS 101B,A01,091572,Staff,0,4,60,60
1650641537643,COGS 101C,A01,083625,Delgado; Tania,15,0,30,15
1650641543670,COGS 107A,A01,083627,Boyle; Mary E. T.,1,15,60,59
1650641549694,COGS 118A,A01,083075,Staff,0,6,60,60
1650641555724,CSE 3,A50,083646,Miranda; Gregory Joseph,19,0,38,19
1650641555724,CSE 3,A51,083647,Miranda; Gregory Joseph,36,0,37,1
1650641561751,CSE 8A,A50,083650,Miranda; Gregory Joseph,0,30,40,40
1650641567775,CSE 11,A01,083080,Cao; Yingjun,0,95,40,40
1650641573802,CSE 12,A01,083652,Staff,0,19,100,100
1650641579825,CSE 15L,A01,083654,Staff,0,2,50,50
1650641579825,CSE 15L,A02,083655,Staff,0,1,50,50
1650641585864,CSE 20,A01,083657,Staff,51,0,80,29
1650641591886,CSE 30,A01,083084,Eldon; John,0,77,40,40
1650641597911,CSE 100,A01,083659,Cao; Yingjun,0,68,50,50
1650641603938,CSE 134B,A01,083661,Powell; Thomas Allan,0,36,65,65
1650641609964,CSE 140,A01,083663,Staff,0,8,75,75
1650641615987,CSE 140L,A01,083088,Eldon; John,0,16,75,75
1650641622014,CSE 175,A01,083665,Kumar; Rakesh,7,0,25,18
1650641628039,CSE 190,A00,092507,Dubnov; Shlomo,10,0,20,10
1650641634085,ECE 45,A01,083139,Staff,0,1,60,60
1650641640124,ECE 65,A50,083695,Staff,0,5,30,30
1650641646148,ECE 109,A01,091882,Touri; Behrouz,33,0,70,37
1650641652175,ECE 180,A00,083140,Abi Samra; Nicholas Camill,21,0,30,9
1650641652175,ECE 180,B00,083141,Abi Samra; Nicholas Camill,0,0,30,30
1650641658205,MATH 10A,A01,083735,Patchell; Gregory David,3,0,30,27
1650641658205,MATH 10A,A02,083736,Patchell; Gregory David,27,0,30,3
1650641658205,MATH 10A,A03,083737,Patchell; Gregory David,24,0,30,6
1650641664230,MATH 10B,A01,083207,Staff,0,8,30,30
1650641664230,MATH 10B,A02,083208,Staff,0,8,30,30
1650641664230,MATH 10B,B01,083739,Staff,11,0,30,19
1650641664230,MATH 10B,B02,083740,Staff,28,0,30,2
1650641670265,MATH 18,A01,083743,Staff,0,0,30,30
1650641670265,MATH 18,A02,083744,Staff,23,0,30,7
1650641670265,MATH 18,A03,083745,Staff,21,0,30,9
1650641670265,MATH 18,A04,083746,Staff,26,0,30,4
1650641670265,MATH 18,B01,083748,Staff,0,15,30,30
1650641670265,MATH 18,B02,083749,Staff,0,11,30,30
1650641670265,MATH 18,B03,083750,Staff,0,12,30,30
1650641670265,MATH 18,B04,083751,Staff,0,12,30,30
1650641676317,MATH 20A,A01,083754,Staff,19,0,40,21
1650641682344,MATH 20B,A01,083756,Staff,0,12,30,30
1650641682344,MATH 20B,A02,083757,Staff,0,12,30,30
1650641688370,MATH 20C,A01,083760,Staff,0,15,30,30
1650641688370,MATH 20C,A02,083761,Staff,1,13,30,29
1650641688370,MATH 20C,B01,083762,Staff,11,0,30,19
1650641688370,MATH 20C,B02,083763,Staff,28,0,30,2
1650641694393,MATH 20D,A01,083765,Staff,1,1,30,29
1650641694393,MATH 20D,A02,083766,Staff,7,0,30,23
1650641694393,MATH 20D,A03,083767,Staff,24,0,30,6
1650641700429,MATH 20E,A01,083771,Staff,3,0,30,27
1650641700429,MATH 20E,A02,083772,Staff,17,0,30,13
1650641700429,MATH 20E,B01,083773,Staff,0,0,30,30
1650641700429,MATH 20E,B02,083774,Staff,9,0,30,21
1650641706454,MATH 103A,A01,083777,Staff,0,15,30,30
1650641706454,MATH 103A,A02,083778,Staff,0,15,30,30
1650641706454,MATH 103A,B01,083779,Staff,0,14,30,30
1650641706454,MATH 103A,B02,083780,Staff,0,14,30,30
1650641712480,MATH 105,A01,085443,Staff,0,22,30,30
1650641718509,MATH 109,A01,083213,Anzaldo; Leesa B,0,6,30,30
1650641718509,MATH 109,A02,083214,Anzaldo; Leesa B,0,7,30,30
1650641718509,MATH 109,B01,083215,Anzaldo; Leesa B,0,6,30,30
1650641718509,MATH 109,B02,083216,Anzaldo; Leesa B,0,6,30,30
1650641724538,MATH 142A,A01,083219,Chow; Bennett,0,16,30,30
1650641724538,MATH 142A,A02,083220,Chow; Bennett,0,15,30,30
1650641724538,MATH 142A,B01,083221,Chow; Bennett,0,14,30,30
1650641724538,MATH 142A,B02,083222,Chow; Bennett,0,13,30,30
1650641730579,MATH 193A,A01,083224,Staff,0,5,30,30
1650641730579,MATH 193A,A02,083225,Staff,0,6,30,30
1650641730579,MATH 193A,A03,083781,Staff,0,6,30,30
1650641730579,MATH 193A,A04,083782,Staff,0,7,30,30
1650641736602,MATH 197,001,091859,McAuley; Julian John,9998,0,9999,1
1650641742668,COGS 9,A01,083615,Staff,1,15,60,59
1650641748693,COGS 11,A01,083617,Boyle; Mary E. T.,18,0,40,22
1650641754723,COGS 13,A01,083071,Staff,0,38,40,40
1650641760746,COGS 14A,A01,092681,Staff,0,31,100,100
1650641766778,COGS 14B,A01,083073,Cheng; Tzu-Han,0,13,50,50
1650641772800,COGS 17,A01,092677,Staff,17,0,75,58
1650641778823,COGS 100,A01,083619,Staff,0,26,60,60
1650641784855,COGS 101A,A01,083621,Davis; Joshua Daniel,0,26,60,60
1650641790888,COGS 101B,A01,091572,Staff,0,4,60,60
1650641796912,COGS 101C,A01,083625,Delgado; Tania,15,0,30,15
1650641802936,COGS 107A,A01,083627,Boyle; Mary E. T.,1,15,60,59
1650641808960,COGS 118A,A01,083075,Staff,0,6,60,60
1650641814985,CSE 3,A50,083646,Miranda; Gregory Joseph,19,0,38,19
1650641814985,CSE 3,A51,083647,Miranda; Gregory Joseph,36,0,37,1
1650641821100,CSE 8A,A50,083650,Miranda; Gregory Joseph,0,30,40,40
1650641827125,CSE 11,A01,083080,Cao; Yingjun,0,95,40,40
1650641833153,CSE 12,A01,083652,Staff,0,19,100,100
1650641839176,CSE 15L,A01,083654,Staff,0,2,50,50
1650641839176,CSE 15L,A02,083655,Staff,0,1,50,50
1650641845202,CSE 20,A01,083657,Staff,51,0,80,29
1650641851231,CSE 30,A01,083084,Eldon; John,0,77,40,40
1650641857256,CSE 100,A01,083659,Cao; Yingjun,0,68,50,50
1650641863284,CSE 134B,A01,083661,Powell; Thomas Allan,0,36,65,65
1650641869318,CSE 140,A01,083663,Staff,0,8,75,75
1650641875345,CSE 140L,A01,083088,Eldon; John,0,16,75,75
1650641881378,CSE 175,A01,083665,Kumar; Rakesh,7,0,25,18
1650641887409,CSE 190,A00,092507,Dubnov; Shlomo,10,0,20,10
1650641893443,ECE 45,A01,083139,Staff,0,1,60,60
1650641899467,ECE 65,A50,083695,Staff,0,5,30,30
1650641905490,ECE 109,A01,091882,Touri; Behrouz,33,0,70,37
1650641911513,ECE 180,A00,083140,Abi Samra; Nicholas Camill,21,0,30,9
1650641911513,ECE 180,B00,083141,Abi Samra; Nicholas Camill,0,0,30,30
1650641917553,MATH 10A,A01,083735,Patchell; Gregory David,3,0,30,27
1650641917553,MATH 10A,A02,083736,Patchell; Gregory David,27,0,30,3
1650641917553,MATH 10A,A03,083737,Patchell; Gregory David,24,0,30,6
1650641923581,MATH 10B,A01,083207,Staff,0,8,30,30
1650641923581,MATH 10B,A02,083208,Staff,0,8,30,30
1650641923581,MATH 10B,B01,083739,Staff,11,0,30,19
1650641923581,MATH 10B,B02,083740,Staff,28,0,30,2
1650641929633,MATH 18,A01,083743,Staff,0,0,30,30
1650641929633,MATH 18,A02,083744,Staff,23,0,30,7
1650641929633,MATH 18,A03,083745,Staff,21,0,30,9
1650641929633,MATH 18,A04,083746,Staff,26,0,30,4
1650641929633,MATH 18,B01,083748,Staff,0,15,30,30
1650641929633,MATH 18,B02,083749,Staff,0,11,30,30
1650641929633,MATH 18,B03,083750,Staff,0,12,30,30
1650641929633,MATH 18,B04,083751,Staff,0,12,30,30
1650641935665,MATH 20A,A01,083754,Staff,19,0,40,21
1650641941689,MATH 20B,A01,083756,Staff,0,12,30,30
1650641941689,MATH 20B,A02,083757,Staff,0,12,30,30
1650641947717,MATH 20C,A01,083760,Staff,0,15,30,30
1650641947717,MATH 20C,A02,083761,Staff,1,13,30,29
1650641947717,MATH 20C,B01,083762,Staff,11,0,30,19
1650641947717,MATH 20C,B02,083763,Staff,28,0,30,2
1650641953741,MATH 20D,A01,083765,Staff,1,1,30,29
1650641953741,MATH 20D,A02,083766,Staff,7,0,30,23
1650641953741,MATH 20D,A03,083767,Staff,24,0,30,6
1650641959767,MATH 20E,A01,083771,Staff,3,0,30,27
1650641959767,MATH 20E,A02,083772,Staff,17,0,30,13
1650641959767,MATH 20E,B01,083773,Staff,0,0,30,30
1650641959767,MATH 20E,B02,083774,Staff,9,0,30,21
1650641965798,MATH 103A,A01,083777,Staff,0,15,30,30
1650641965798,MATH 103A,A02,083778,Staff,0,15,30,30
1650641965798,MATH 103A,B01,083779,Staff,0,14,30,30
1650641965798,MATH 103A,B02,083780,Staff,0,14,30,30
1650641971825,MATH 105,A01,085443,Staff,0,22,30,30
1650641977854,MATH 109,A01,083213,Anzaldo; Leesa B,0,6,30,30
1650641977854,MATH 109,A02,083214,Anzaldo; Leesa B,0,7,30,30
1650641977854,MATH 109,B01,083215,Anzaldo; Leesa B,0,6,30,30
1650641977854,MATH 109,B02,083216,Anzaldo; Leesa B,0,6,30,30
1650641983879,MATH 142A,A01,083219,Chow; Bennett,0,16,30,30
1650641983879,MATH 142A,A02,083220,Chow; Bennett,0,15,30,30
1650641983879,MATH 142A,B01,083221,Chow; Bennett,0,14,30,30
1650641983879,MATH 142A,B02,083222,Chow; Bennett,0,13,30,30
1650641989904,MATH 193A,A01,083224,Staff,0,5,30,30
1650641989904,MATH 193A,A02,083225,Staff,0,6,30,30
1650641989904,MATH 193A,A03,083781,Staff,0,6,30,30
1650641989904,MATH 193A,A04,083782,Staff,0,7,30,30
1650641995925,MATH 197,001,091859,McAuley; Julian John,9998,0,9999,1
1650642001989,COGS 9,A01,083615,Staff,1,15,60,59
1650642008013,COGS 11,A01,083617,Boyle; Mary E. T.,18,0,40,22
1650642014053,COGS 13,A01,083071,Staff,0,38,40,40
1650642020083,COGS 14A,A01,092681,Staff,0,31,100,100
1650642026112,COGS 14B,A01,083073,Cheng; Tzu-Han,0,13,50,50
1650642032136,COGS 17,A01,092677,Staff,17,0,75,58
1650642038159,COGS 100,A01,083619,Staff,0,26,60,60
1650642044182,COGS 101A,A01,083621,Davis; Joshua Daniel,0,26,60,60
1650642050206,COGS 101B,A01,091572,Staff,0,4,60,60
1650642056247,COGS 101C,A01,083625,Delgado; Tania,15,0,30,15
1650642062273,COGS 107A,A01,083627,Boyle; Mary E. T.,1,15,60,59
1650642068298,COGS 118A,A01,083075,Staff,0,6,60,60
1650642074325,CSE 3,A50,083646,Miranda; Gregory Joseph,19,0,38,19
1650642074325,CSE 3,A51,083647,Miranda; Gregory Joseph,36,0,37,1
1650642080353,CSE 8A,A50,083650,Miranda; Gregory Joseph,0,30,40,40
1650642086379,CSE 11,A01,083080,Cao; Yingjun,0,95,40,40
1650642092419,CSE 12,A01,083652,Staff,0,19,100,100
1650642098444,CSE 15L,A01,083654,Staff,0,2,50,50
1650642098444,CSE 15L,A02,083655,Staff,0,1,50,50
1650642104471,CSE 20,A01,083657,Staff,51,0,80,29
1650642110496,CSE 30,A01,083084,Eldon; John,0,77,40,40
1650642123361,CSE 100,A01,083659,Cao; Yingjun,0,68,50,50
1650642129384,CSE 134B,A01,083661,Powell; Thomas Allan,0,36,65,65
1650642135408,CSE 140,A01,083663,Staff,0,8,75,75
1650642141445,CSE 140L,A01,083088,Eldon; John,0,16,75,75
1650642147470,CSE 175,A01,083665,Kumar; Rakesh,7,0,25,18
1650642153493,CSE 190,A00,092507,Dubnov; Shlomo,10,0,20,10
1650642159516,ECE 45,A01,083139,Staff,0,1,60,60
1650642165552,ECE 65,A50,083695,Staff,0,5,30,30
1650642171573,ECE 109,A01,091882,Touri; Behrouz,33,0,70,37
1650642177596,ECE 180,A00,083140,Abi Samra; Nicholas Camill,21,0,30,9
1650642177596,ECE 180,B00,083141,Abi Samra; Nicholas Camill,0,0,30,30
1650642183625,MATH 10A,A01,083735,Patchell; Gregory David,3,0,30,27
1650642183625,MATH 10A,A02,083736,Patchell; Gregory David,27,0,30,3
1650642183625,MATH 10A,A03,083737,Patchell; Gregory David,24,0,30,6
1650642189648,MATH 10B,A01,083207,Staff,0,8,30,30
1650642189648,MATH 10B,A02,083208,Staff,0,8,30,30
1650642189648,MATH 10B,B01,083739,Staff,11,0,30,19
1650642189648,MATH 10B,B02,083740,Staff,28,0,30,2
1650642195674,MATH 18,A01,083743,Staff,0,0,30,30
1650642195674,MATH 18,A02,083744,Staff,23,0,30,7
1650642195674,MATH 18,A03,083745,Staff,21,0,30,9
1650642195674,MATH 18,A04,083746,Staff,26,0,30,4
1650642195674,MATH 18,B01,083748,Staff,0,15,30,30
1650642195674,MATH 18,B02,083749,Staff,0,11,30,30
1650642195674,MATH 18,B03,083750,Staff,0,12,30,30
1650642195674,MATH 18,B04,083751,Staff,0,12,30,30
1650642201698,MATH 20A,A01,083754,Staff,19,0,40,21
1650642207727,MATH 20B,A01,083756,Staff,0,12,30,30
1650642207727,MATH 20B,A02,083757,Staff,0,12,30,30
1650642213756,MATH 20C,A01,083760,Staff,0,15,30,30
1650642213756,MATH 20C,A02,083761,Staff,1,13,30,29
1650642213756,MATH 20C,B01,083762,Staff,11,0,30,19
1650642213756,MATH 20C,B02,083763,Staff,28,0,30,2
1650642219781,MATH 20D,A01,083765,Staff,1,1,30,29
1650642219781,MATH 20D,A02,083766,Staff,7,0,30,23
1650642219781,MATH 20D,A03,083767,Staff,24,0,30,6
1650642225811,MATH 20E,A01,083771,Staff,3,0,30,27
1650642225811,MATH 20E,A02,083772,Staff,17,0,30,13
1650642225811,MATH 20E,B01,083773,Staff,0,0,30,30
1650642225811,MATH 20E,B02,083774,Staff,9,0,30,21
1650642231846,MATH 103A,A01,083777,Staff,0,15,30,30
1650642231846,MATH 103A,A02,083778,Staff,0,15,30,30
1650642231846,MATH 103A,B01,083779,Staff,0,14,30,30
1650642231846,MATH 103A,B02,083780,Staff,0,14,30,30
1650642237885,MATH 105,A01,085443,Staff,0,22,30,30
1650642243909,MATH 109,A01,083213,Anzaldo; Leesa B,0,6,30,30
1650642243909,MATH 109,A02,083214,Anzaldo; Leesa B,0,7,30,30
1650642243909,MATH 109,B01,083215,Anzaldo; Leesa B,0,6,30,30
1650642243909,MATH 109,B02,083216,Anzaldo; Leesa B,0,6,30,30
1650642249938,MATH 142A,A01,083219,Chow; Bennett,0,16,30,30
1650642249938,MATH 142A,A02,083220,Chow; Bennett,0,15,30,30
1650642249938,MATH 142A,B01,083221,Chow; Bennett,0,14,30,30
1650642249938,MATH 142A,B02,083222,Chow; Bennett,0,13,30,30
1650642255967,MATH 193A,A01,083224,Staff,0,5,30,30
1650642255967,MATH 193A,A02,083225,Staff,0,6,30,30
1650642255967,MATH 193A,A03,083781,Staff,0,6,30,30
1650642255967,MATH 193A,A04,083782,Staff,0,7,30,30
1650642261990,MATH 197,001,091859,McAuley; Julian John,9998,0,9999,1
1650642268054,COGS 9,A01,083615,Staff,1,15,60,59
1650642274090,COGS 11,A01,083617,Boyle; Mary E. T.,18,0,40,22
1650642280129,COGS 13,A01,083071,Staff,0,38,40,40
1650642286164,COGS 14A,A01,092681,Staff,0,31,100,100
1650642292199,COGS 14B,A01,083073,Cheng; Tzu-Han,0,13,50,50
1650642298222,COGS 17,A01,092677,Staff,17,0,75,58
1650642304247,COGS 100,A01,083619,Staff,0,26,60,60
1650642310275,COGS 101A,A01,083621,Davis; Joshua Daniel,0,26,60,60
1650642316305,COGS 101B,A01,091572,Staff,0,4,60,60
1650642322331,COGS 101C,A01,083625,Delgado; Tania,15,0,30,15
1650642328369,COGS 107A,A01,083627,Boyle; Mary E. T.,1,15,60,59
1650642334395,COGS 118A,A01,083075,Staff,0,6,60,60
1650642340422,CSE 3,A50,083646,Miranda; Gregory Joseph,19,0,38,19
1650642340422,CSE 3,A51,083647,Miranda; Gregory Joseph,36,0,37,1
1650642346451,CSE 8A,A50,083650,Miranda; Gregory Joseph,0,30,40,40
1650642352487,CSE 11,A01,083080,Cao; Yingjun,0,95,40,40
1650642358515,CSE 12,A01,083652,Staff,0,19,100,100
1650642364538,CSE 15L,A01,083654,Staff,0,2,50,50
1650642364538,CSE 15L,A02,083655,Staff,0,1,50,50
1650642370568,CSE 20,A01,083657,Staff,51,0,80,29
1650642376591,CSE 30,A01,083084,Eldon; John,0,77,40,40
1650642382615,CSE 100,A01,083659,Cao; Yingjun,0,68,50,50
1650642388653,CSE 134B,A01,083661,Powell; Thomas Allan,0,36,65,65
1650642394675,CSE 140,A01,083663,Staff,0,8,75,75
1650642400701,CSE 140L,A01,083088,Eldon; John,0,16,75,75
1650642406736,CSE 175,A01,083665,Kumar; Rakesh,7,0,25,18
1650642412764,CSE 190,A00,092507,Dubnov; Shlomo,10,0,20,10
1650642418788,ECE 45,A01,083139,Staff,0,1,60,60
1650642424910,ECE 65,A50,083695,Staff,0,5,30,30
1650642430937,ECE 109,A01,091882,Touri; Behrouz,33,0,70,37
1650642436961,ECE 180,A00,083140,Abi Samra; Nicholas Camill,21,0,30,9
1650642436961,ECE 180,B00,083141,Abi Samra; Nicholas Camill,0,0,30,30
1650642442986,MATH 10A,A01,083735,Patchell; Gregory David,3,0,30,27
1650642442986,MATH 10A,A02,083736,Patchell; Gregory David,27,0,30,3
1650642442986,MATH 10A,A03,083737,Patchell; Gregory David,24,0,30,6
1650642449014,MATH 10B,A01,083207,Staff,0,8,30,30
1650642449014,MATH 10B,A02,083208,Staff,0,8,30,30
1650642449014,MATH 10B,B01,083739,Staff,11,0,30,19
1650642449014,MATH 10B,B02,083740,Staff,28,0,30,2
1650642455053,MATH 18,A01,083743,Staff,0,0,30,30
1650642455053,MATH 18,A02,083744,Staff,23,0,30,7
1650642455053,MATH 18,A03,083745,Staff,21,0,30,9
1650642455053,MATH 18,A04,083746,Staff,26,0,30,4
1650642455053,MATH 18,B01,083748,Staff,0,15,30,30
1650642455053,MATH 18,B02,083749,Staff,0,11,30,30
1650642455053,MATH 18,B03,083750,Staff,0,12,30,30
1650642455053,MATH 18,B04,083751,Staff,0,12,30,30
1650642461079,MATH 20A,A01,083754,Staff,19,0,40,21
1650642467105,MATH 20B,A01,083756,Staff,0,12,30,30
1650642467105,MATH 20B,A02,083757,Staff,0,12,30,30
1650642473130,MATH 20C,A01,083760,Staff,0,15,30,30
1650642473130,MATH 20C,A02,083761,Staff,1,13,30,29
1650642473130,MATH 20C,B01,083762,Staff,11,0,30,19
1650642473130,MATH 20C,B02,083763,Staff,28,0,30,2
1650642479153,MATH 20D,A01,083765,Staff,1,1,30,29
1650642479153,MATH 20D,A02,083766,Staff,7,0,30,23
1650642479153,MATH 20D,A03,083767,Staff,24,0,30,6
1650642485178,MATH 20E,A01,083771,Staff,3,0,30,27
1650642485178,MATH 20E,A02,083772,Staff,17,0,30,13
1650642485178,MATH 20E,B01,083773,Staff,0,0,30,30
1650642485178,MATH 20E,B02,083774,Staff,9,0,30,21
1650642491201,MATH 103A,A01,083777,Staff,0,15,30,30
1650642491201,MATH 103A,A02,083778,Staff,0,15,30,30
1650642491201,MATH 103A,B01,083779,Staff,0,14,30,30
1650642491201,MATH 103A,B02,083780,Staff,0,14,30,30
1650642497227,MATH 105,A01,085443,Staff,0,22,30,30
1650642503254,MATH 109,A01,083213,Anzaldo; Leesa B,0,6,30,30
1650642503254,MATH 109,A02,083214,Anzaldo; Leesa B,0,7,30,30
1650642503254,MATH 109,B01,083215,Anzaldo; Leesa B,0,6,30,30
1650642503254,MATH 109,B02,083216,Anzaldo; Leesa B,0,6,30,30
1650642509279,MATH 142A,A01,083219,Chow; Bennett,0,16,30,30
1650642509279,MATH 142A,A02,083220,Chow; Bennett,0,15,30,30
1650642509279,MATH 142A,B01,083221,Chow; Bennett,0,14,30,30
1650642509279,MATH 142A,B02,083222,Chow; Bennett,0,13,30,30
1650642515305,MATH 193A,A01,083224,Staff,0,5,30,30
1650642515305,MATH 193A,A02,083225,Staff,0,6,30,30
1650642515305,MATH 193A,A03,083781,Staff,0,6,30,30
1650642515305,MATH 193A,A04,083782,Staff,0,7,30,30
1650642521332,MATH 197,001,091859,McAuley; Julian John,9998,0,9999,1
1650642527396,COGS 9,A01,083615,Staff,1,15,60,59
1650642533426,COGS 11,A01,083617,Boyle; Mary E. T.,18,0,40,22
1650642539448,COGS 13,A01,083071,Staff,0,38,40,40
1650642545473,COGS 14A,A01,092681,Staff,0,31,100,100
1650642551497,COGS 14B,A01,083073,Cheng; Tzu-Han,0,13,50,50
1650642557531,COGS 17,A01,092677,Staff,17,0,75,58
1650642563560,COGS 100,A01,083619,Staff,0,26,60,60
1650642569585,COGS 101A,A01,083621,Davis; Joshua Daniel,0,26,60,60
1650642575615,COGS 101B,A01,091572,Staff,0,4,60,60
1650642581646,COGS 101C,A01,083625,Delgado; Tania,15,0,30,15
1650642587674,COGS 107A,A01,083627,Boyle; Mary E. T.,1,15,60,59
1650642593711,COGS 118A,A01,083075,Staff,0,6,60,60
1650642599735,CSE 3,A50,083646,Miranda; Gregory Joseph,19,0,38,19
1650642599735,CSE 3,A51,083647,Miranda; Gregory Joseph,36,0,37,1
1650642605763,CSE 8A,A50,083650,Miranda; Gregory Joseph,0,30,40,40
1650642611786,CSE 11,A01,083080,Cao; Yingjun,0,95,40,40
1650642617814,CSE 12,A01,083652,Staff,0,19,100,100
1650642623845,CSE 15L,A01,083654,Staff,0,2,50,50
1650642623845,CSE 15L,A02,083655,Staff,0,1,50,50
1650642629869,CSE 20,A01,083657,Staff,51,0,80,29
1650642635908,CSE 30,A01,083084,Eldon; John,0,77,40,40
1650642641934,CSE 100,A01,083659,Cao; Yingjun,0,68,50,50
1650642647971,CSE 134B,A01,083661,Powell; Thomas Allan,0,36,65,65
1650642653994,CSE 140,A01,083663,Staff,0,8,75,75
1650642660021,CSE 140L,A01,083088,Eldon; John,0,16,75,75
1650642666044,CSE 175,A01,083665,Kumar; Rakesh,7,0,25,18
1650642672068,CSE 190,A00,092507,Dubnov; Shlomo,10,0,20,10
1650642678092,ECE 45,A01,083139,Staff,0,1,60,60
1650642684119,ECE 65,A50,083695,Staff,0,5,30,30
1650642690158,ECE 109,A01,091882,Touri; Behrouz,33,0,70,37
1650642696181,ECE 180,A00,083140,Abi Samra; Nicholas Camill,21,0,30,9
1650642696181,ECE 180,B00,083141,Abi Samra; Nicholas Camill,0,0,30,30
1650642702205,MATH 10A,A01,083735,Patchell; Gregory David,3,0,30,27
1650642702205,MATH 10A,A02,083736,Patchell; Gregory David,27,0,30,3
1650642702205,MATH 10A,A03,083737,Patchell; Gregory David,24,0,30,6
1650642708232,MATH 10B,A01,083207,Staff,0,8,30,30
1650642708232,MATH 10B,A02,083208,Staff,0,8,30,30
1650642708232,MATH 10B,B01,083739,Staff,11,0,30,19
1650642708232,MATH 10B,B02,083740,Staff,28,0,30,2
1650642714255,MATH 18,A01,083743,Staff,0,0,30,30
1650642714255,MATH 18,A02,083744,Staff,23,0,30,7
1650642714255,MATH 18,A03,083745,Staff,21,0,30,9
1650642714255,MATH 18,A04,083746,Staff,26,0,30,4
1650642714255,MATH 18,B01,083748,Staff,0,15,30,30
1650642714255,MATH 18,B02,083749,Staff,0,11,30,30
1650642714255,MATH 18,B03,083750,Staff,0,12,30,30
1650642714255,MATH 18,B04,083751,Staff,0,12,30,30
1650642720288,MATH 20A,A01,083754,Staff,19,0,40,21
1650642726317,MATH 20B,A01,083756,Staff,0,12,30,30
1650642726317,MATH 20B,A02,083757,Staff,0,12,30,30
1650642732369,MATH 20C,A01,083760,Staff,0,15,30,30
1650642732369,MATH 20C,A02,083761,Staff,1,13,30,29
1650642732369,MATH 20C,B01,083762,Staff,11,0,30,19
1650642732369,MATH 20C,B02,083763,Staff,28,0,30,2
1650642738394,MATH 20D,A01,083765,Staff,1,1,30,29
1650642738394,MATH 20D,A02,083766,Staff,7,0,30,23
1650642738394,MATH 20D,A03,083767,Staff,24,0,30,6
1650642744421,MATH 20E,A01,083771,Staff,3,0,30,27
1650642744421,MATH 20E,A02,083772,Staff,17,0,30,13
1650642744421,MATH 20E,B01,083773,Staff,0,0,30,30
1650642744421,MATH 20E,B02,083774,Staff,9,0,30,21
1650642750445,MATH 103A,A01,083777,Staff,0,15,30,30
1650642750445,MATH 103A,A02,083778,Staff,0,15,30,30
1650642750445,MATH 103A,B01,083779,Staff,0,14,30,30
1650642750445,MATH 103A,B02,083780,Staff,0,14,30,30
1650642756469,MATH 105,A01,085443,Staff,0,22,30,30
1650642762497,MATH 109,A01,083213,Anzaldo; Leesa B,0,6,30,30
1650642762497,MATH 109,A02,083214,Anzaldo; Leesa B,0,7,30,30
1650642762497,MATH 109,B01,083215,Anzaldo; Leesa B,0,6,30,30
1650642762497,MATH 109,B02,083216,Anzaldo; Leesa B,0,6,30,30
1650642768520,MATH 142A,A01,083219,Chow; Bennett,0,16,30,30
1650642768520,MATH 142A,A02,083220,Chow; Bennett,0,15,30,30
1650642768520,MATH 142A,B01,083221,Chow; Bennett,0,14,30,30
1650642768520,MATH 142A,B02,083222,Chow; Bennett,0,13,30,30
1650642774544,MATH 193A,A01,083224,Staff,0,5,30,30
1650642774544,MATH 193A,A02,083225,Staff,0,6,30,30
1650642774544,MATH 193A,A03,083781,Staff,0,6,30,30
1650642774544,MATH 193A,A04,083782,Staff,0,7,30,30
1650642780573,MATH 197,001,091859,McAuley; Julian John,9998,0,9999,1
1650642786629,COGS 9,A01,083615,Staff,1,15,60,59
1650642792651,COGS 11,A01,083617,Boyle; Mary E. T.,18,0,40,22
1650642798683,COGS 13,A01,083071,Staff,0,38,40,40
1650642804707,COGS 14A,A01,092681,Staff,0,31,100,100
1650642810730,COGS 14B,A01,083073,Cheng; Tzu-Han,0,13,50,50
1650642816754,COGS 17,A01,092677,Staff,17,0,75,58
1650642822781,COGS 100,A01,083619,Staff,0,26,60,60
1650642828810,COGS 101A,A01,083621,Davis; Joshua Daniel,0,26,60,60
1650642834833,COGS 101B,A01,091572,Staff,0,4,60,60
1650642840866,COGS 101C,A01,083625,Delgado; Tania,15,0,30,15
1650642846897,COGS 107A,A01,083627,Boyle; Mary E. T.,1,15,60,59
1650642852942,COGS 118A,A01,083075,Staff,0,6,60,60
1650642858970,CSE 3,A50,083646,Miranda; Gregory Joseph,19,0,38,19
1650642858970,CSE 3,A51,083647,Miranda; Gregory Joseph,36,0,37,1
1650642864994,CSE 8A,A50,083650,Miranda; Gregory Joseph,0,30,40,40
1650642871016,CSE 11,A01,083080,Cao; Yingjun,0,95,40,40
1650642877039,CSE 12,A01,083652,Staff,0,19,100,100
1650642883066,CSE 15L,A01,083654,Staff,0,2,50,50
1650642883066,CSE 15L,A02,083655,Staff,0,1,50,50
1650642889093,CSE 20,A01,083657,Staff,51,0,80,29
1650642895126,CSE 30,A01,083084,Eldon; John,0,77,40,40
1650642901148,CSE 100,A01,083659,Cao; Yingjun,0,69,50,50
1650642907170,CSE 134B,A01,083661,Powell; Thomas Allan,0,36,65,65
1650642913196,CSE 140,A01,083663,Staff,0,8,75,75
1650642919225,CSE 140L,A01,083088,Eldon; John,0,16,75,75
1650642925257,CSE 175,A01,083665,Kumar; Rakesh,7,0,25,18
1650642931290,CSE 190,A00,092507,Dubnov; Shlomo,10,0,20,10
1650642937318,ECE 45,A01,083139,Staff,0,1,60,60
1650642943349,ECE 65,A50,083695,Staff,0,5,30,30
1650642949384,ECE 109,A01,091882,Touri; Behrouz,33,0,70,37
1650642955409,ECE 180,A00,083140,Abi Samra; Nicholas Camill,21,0,30,9
1650642955409,ECE 180,B00,083141,Abi Samra; Nicholas Camill,0,0,30,30
1650642961440,MATH 10A,A01,083735,Patchell; Gregory David,3,0,30,27
1650642961440,MATH 10A,A02,083736,Patchell; Gregory David,27,0,30,3
1650642961440,MATH 10A,A03,083737,Patchell; Gregory David,24,0,30,6
1650642967468,MATH 10B,A01,083207,Staff,0,8,30,30
1650642967468,MATH 10B,A02,083208,Staff,0,8,30,30
1650642967468,MATH 10B,B01,083739,Staff,11,0,30,19
1650642967468,MATH 10B,B02,083740,Staff,28,0,30,2
1650642973493,MATH 18,A01,083743,Staff,0,0,30,30
1650642973493,MATH 18,A02,083744,Staff,23,0,30,7
1650642973493,MATH 18,A03,083745,Staff,21,0,30,9
1650642973493,MATH 18,A04,083746,Staff,26,0,30,4
1650642973493,MATH 18,B01,083748,Staff,0,15,30,30
1650642973493,MATH 18,B02,083749,Staff,0,11,30,30
1650642973493,MATH 18,B03,083750,Staff,0,12,30,30
1650642973493,MATH 18,B04,083751,Staff,0,12,30,30
1650642979516,MATH 20A,A01,083754,Staff,19,0,40,21
1650642985559,MATH 20B,A01,083756,Staff,0,12,30,30
1650642985559,MATH 20B,A02,083757,Staff,0,12,30,30
1650642991583,MATH 20C,A01,083760,Staff,0,15,30,30
1650642991583,MATH 20C,A02,083761,Staff,1,13,30,29
1650642991583,MATH 20C,B01,083762,Staff,11,0,30,19
1650642991583,MATH 20C,B02,083763,Staff,28,0,30,2
1650642997608,MATH 20D,A01,083765,Staff,1,1,30,29
1650642997608,MATH 20D,A02,083766,Staff,7,0,30,23
1650642997608,MATH 20D,A03,083767,Staff,24,0,30,6
1650643003631,MATH 20E,A01,083771,Staff,3,0,30,27
1650643003631,MATH 20E,A02,083772,Staff,17,0,30,13
1650643003631,MATH 20E,B01,083773,Staff,0,0,30,30
1650643003631,MATH 20E,B02,083774,Staff,9,0,30,21
1650643009661,MATH 103A,A01,083777,Staff,0,15,30,30
1650643009661,MATH 103A,A02,083778,Staff,0,15,30,30
1650643009661,MATH 103A,B01,083779,Staff,0,14,30,30
1650643009661,MATH 103A,B02,083780,Staff,0,14,30,30
1650643015685,MATH 105,A01,085443,Staff,0,22,30,30
1650643021799,MATH 109,A01,083213,Anzaldo; Leesa B,0,6,30,30
1650643021799,MATH 109,A02,083214,Anzaldo; Leesa B,0,7,30,30
1650643021799,MATH 109,B01,083215,Anzaldo; Leesa B,0,6,30,30
1650643021799,MATH 109,B02,083216,Anzaldo; Leesa B,0,6,30,30
1650643027827,MATH 142A,A01,083219,Chow; Bennett,0,16,30,30
1650643027827,MATH 142A,A02,083220,Chow; Bennett,0,15,30,30
1650643027827,MATH 142A,B01,083221,Chow; Bennett,0,14,30,30
1650643027827,MATH 142A,B02,083222,Chow; Bennett,0,13,30,30
1650643033850,MATH 193A,A01,083224,Staff,0,5,30,30
1650643033850,MATH 193A,A02,083225,Staff,0,6,30,30
1650643033850,MATH 193A,A03,083781,Staff,0,6,30,30
1650643033850,MATH 193A,A04,083782,Staff,0,7,30,30
1650643039882,MATH 197,001,091859,McAuley; Julian John,9998,0,9999,1
1650643045939,COGS 9,A01,083615,Staff,1,15,60,59
1650643051962,COGS 11,A01,083617,Boyle; Mary E. T.,18,0,40,22
1650643057988,COGS 13,A01,083071,Staff,0,38,40,40
1650643064022,COGS 14A,A01,092681,Staff,0,31,100,100
1650643070045,COGS 14B,A01,083073,Cheng; Tzu-Han,0,13,50,50
1650643076073,COGS 17,A01,092677,Staff,17,0,75,58
1650643082109,COGS 100,A01,083619,Staff,0,27,60,60
1650643088136,COGS 101A,A01,083621,Davis; Joshua Daniel,0,26,60,60
1650643094160,COGS 101B,A01,091572,Staff,0,4,60,60
1650643100197,COGS 101C,A01,083625,Delgado; Tania,15,0,30,15
1650643106232,COGS 107A,A01,083627,Boyle; Mary E. T.,1,15,60,59
1650643112268,COGS 118A,A01,083075,Staff,0,6,60,60
1650643118295,CSE 3,A50,083646,Miranda; Gregory Joseph,19,0,38,19
1650643118295,CSE 3,A51,083647,Miranda; Gregory Joseph,36,0,37,1
1650643124335,CSE 8A,A50,083650,Miranda; Gregory Joseph,0,30,40,40
1650643130362,CSE 11,A01,083080,Cao; Yingjun,0,95,40,40
1650643136390,CSE 12,A01,083652,Staff,0,19,100,100
1650643142430,CSE 15L,A01,083654,Staff,0,2,50,50
1650643142430,CSE 15L,A02,083655,Staff,0,1,50,50
1650643148461,CSE 20,A01,083657,Staff,51,0,80,29
1650643154493,CSE 30,A01,083084,Eldon; John,0,77,40,40
1650643160528,CSE 100,A01,083659,Cao; Yingjun,0,69,50,50
1650643166555,CSE 134B,A01,083661,Powell; Thomas Allan,0,36,65,65
1650643172581,CSE 140,A01,083663,Staff,0,8,75,75
1650643178610,CSE 140L,A01,083088,Eldon; John,0,16,75,75
1650643184637,CSE 175,A01,083665,Kumar; Rakesh,7,0,25,18
1650643190660,CSE 190,A00,092507,Dubnov; Shlomo,10,0,20,10
1650643196683,ECE 45,A01,083139,Staff,0,1,60,60
1650643202707,ECE 65,A50,083695,Staff,0,5,30,30
1650643208731,ECE 109,A01,091882,Touri; Behrouz,33,0,70,37
1650643214764,ECE 180,A00,083140,Abi Samra; Nicholas Camill,21,0,30,9
1650643214764,ECE 180,B00,083141,Abi Samra; Nicholas Camill,0,0,30,30
1650643220793,MATH 10A,A01,083735,Patchell; Gregory David,3,0,30,27
1650643220793,MATH 10A,A02,083736,Patchell; Gregory David,27,0,30,3
1650643220793,MATH 10A,A03,083737,Patchell; Gregory David,24,0,30,6
1650643226817,MATH 10B,A01,083207,Staff,0,8,30,30
1650643226817,MATH 10B,A02,083208,Staff,0,8,30,30
1650643226817,MATH 10B,B01,083739,Staff,11,0,30,19
1650643226817,MATH 10B,B02,083740,Staff,28,0,30,2
1650643232854,MATH 18,A01,083743,Staff,0,0,30,30
1650643232854,MATH 18,A02,083744,Staff,23,0,30,7
1650643232854,MATH 18,A03,083745,Staff,21,0,30,9
1650643232854,MATH 18,A04,083746,Staff,26,0,30,4
1650643232854,MATH 18,B01,083748,Staff,0,15,30,30
1650643232854,MATH 18,B02,083749,Staff,0,11,30,30
1650643232854,MATH 18,B03,083750,Staff,0,12,30,30
1650643232854,MATH 18,B04,083751,Staff,0,12,30,30
1650643238878,MATH 20A,A01,083754,Staff,19,0,40,21
1650643244901,MATH 20B,A01,083756,Staff,0,12,30,30
1650643244901,MATH 20B,A02,083757,Staff,0,12,30,30
1650643250928,MATH 20C,A01,083760,Staff,0,15,30,30
1650643250928,MATH 20C,A02,083761,Staff,1,13,30,29
1650643250928,MATH 20C,B01,083762,Staff,11,0,30,19
1650643250928,MATH 20C,B02,083763,Staff,28,0,30,2
1650643256952,MATH 20D,A01,083765,Staff,1,1,30,29
1650643256952,MATH 20D,A02,083766,Staff,7,0,30,23
1650643256952,MATH 20D,A03,083767,Staff,24,0,30,6
1650643262976,MATH 20E,A01,083771,Staff,3,0,30,27
1650643262976,MATH 20E,A02,083772,Staff,17,0,30,13
1650643262976,MATH 20E,B01,083773,Staff,0,0,30,30
1650643262976,MATH 20E,B02,083774,Staff,9,0,30,21
1650643269004,MATH 103A,A01,083777,Staff,0,15,30,30
1650643269004,MATH 103A,A02,083778,Staff,0,15,30,30
1650643269004,MATH 103A,B01,083779,Staff,0,14,30,30
1650643269004,MATH 103A,B02,083780,Staff,0,14,30,30
1650643275035,MATH 105,A01,085443,Staff,0,22,30,30
1650643281059,MATH 109,A01,083213,Anzaldo; Leesa B,0,6,30,30
1650643281059,MATH 109,A02,083214,Anzaldo; Leesa B,0,7,30,30
1650643281059,MATH 109,B01,083215,Anzaldo; Leesa B,0,6,30,30
1650643281059,MATH 109,B02,083216,Anzaldo; Leesa B,0,6,30,30
1650643287084,MATH 142A,A01,083219,Chow; Bennett,0,16,30,30
1650643287084,MATH 142A,A02,083220,Chow; Bennett,0,15,30,30
1650643287084,MATH 142A,B01,083221,Chow; Bennett,0,14,30,30
1650643287084,MATH 142A,B02,083222,Chow; Bennett,0,13,30,30
1650643293111,MATH 193A,A01,083224,Staff,0,5,30,30
1650643293111,MATH 193A,A02,083225,Staff,0,6,30,30
1650643293111,MATH 193A,A03,083781,Staff,0,6,30,30
1650643293111,MATH 193A,A04,083782,Staff,0,7,30,30
1650643299143,MATH 197,001,091859,McAuley; Julian John,9998,0,9999,1
1650643305213,COGS 9,A01,083615,Staff,1,15,60,59
1650643311240,COGS 11,A01,083617,Boyle; Mary E. T.,18,0,40,22
1650643317266,COGS 13,A01,083071,Staff,0,38,40,40
1650643323291,COGS 14A,A01,092681,Staff,0,31,100,100
1650643329316,COGS 14B,A01,083073,Cheng; Tzu-Han,0,13,50,50
1650643335344,COGS 17,A01,092677,Staff,17,0,75,58
1650643341368,COGS 100,A01,083619,Staff,0,27,60,60
1650643347414,COGS 101A,A01,083621,Davis; Joshua Daniel,0,26,60,60
1650643353441,COGS 101B,A01,091572,Staff,0,4,60,60
1650643359475,COGS 101C,A01,083625,Delgado; Tania,15,0,30,15
1650643365499,COGS 107A,A01,083627,Boyle; Mary E. T.,1,15,60,59
1650643371529,COGS 118A,A01,083075,Staff,0,6,60,60
1650643377553,CSE 3,A50,083646,Miranda; Gregory Joseph,19,0,38,19
1650643377553,CSE 3,A51,083647,Miranda; Gregory Joseph,36,0,37,1
1650643383587,CSE 8A,A50,083650,Miranda; Gregory Joseph,0,30,40,40
1650643389616,CSE 11,A01,083080,Cao; Yingjun,0,95,40,40
1650643395640,CSE 12,A01,083652,Staff,0,19,100,100
1650643401667,CSE 15L,A01,083654,Staff,0,2,50,50
1650643401667,CSE 15L,A02,083655,Staff,0,1,50,50
1650643407706,CSE 20,A01,083657,Staff,51,0,80,29
1650643413736,CSE 30,A01,083084,Eldon; John,0,77,40,40
1650643419773,CSE 100,A01,083659,Cao; Yingjun,0,69,50,50
1650643425806,CSE 134B,A01,083661,Powell; Thomas Allan,0,36,65,65
1650643431828,CSE 140,A01,083663,Staff,0,8,75,75
1650643437851,CSE 140L,A01,083088,Eldon; John,0,16,75,75
1650643443881,CSE 175,A01,083665,Kumar; Rakesh,7,0,25,18
1650643449922,CSE 190,A00,092507,Dubnov; Shlomo,10,0,20,10
1650643455946,ECE 45,A01,083139,Staff,0,1,60,60
1650643461971,ECE 65,A50,083695,Staff,0,5,30,30
1650643467999,ECE 109,A01,091882,Touri; Behrouz,33,0,70,37
1650643474026,ECE 180,A00,083140,Abi Samra; Nicholas Camill,21,0,30,9
1650643474026,ECE 180,B00,083141,Abi Samra; Nicholas Camill,0,0,30,30
1650643480051,MATH 10A,A01,083735,Patchell; Gregory David,3,0,30,27
1650643480051,MATH 10A,A02,083736,Patchell; Gregory David,27,0,30,3
1650643480051,MATH 10A,A03,083737,Patchell; Gregory David,24,0,30,6
1650643486080,MATH 10B,A01,083207,Staff,0,8,30,30
1650643486080,MATH 10B,A02,083208,Staff,0,8,30,30
1650643486080,MATH 10B,B01,083739,Staff,11,0,30,19
1650643486080,MATH 10B,B02,083740,Staff,28,0,30,2
1650643492107,MATH 18,A01,083743,Staff,0,0,30,30
1650643492107,MATH 18,A02,083744,Staff,23,0,30,7
1650643492107,MATH 18,A03,083745,Staff,21,0,30,9
1650643492107,MATH 18,A04,083746,Staff,26,0,30,4
1650643492107,MATH 18,B01,083748,Staff,0,15,30,30
1650643492107,MATH 18,B02,083749,Staff,0,11,30,30
1650643492107,MATH 18,B03,083750,Staff,0,12,30,30
1650643492107,MATH 18,B04,083751,Staff,0,12,30,30
1650643498135,MATH 20A,A01,083754,Staff,19,0,40,21
1650643504159,MATH 20B,A01,083756,Staff,0,12,30,30
1650643504159,MATH 20B,A02,083757,Staff,0,12,30,30
1650643510189,MATH 20C,A01,083760,Staff,0,15,30,30
1650643510189,MATH 20C,A02,083761,Staff,1,13,30,29
1650643510189,MATH 20C,B01,083762,Staff,11,0,30,19
1650643510189,MATH 20C,B02,083763,Staff,28,0,30,2
1650643516218,MATH 20D,A01,083765,Staff,1,1,30,29
1650643516218,MATH 20D,A02,083766,Staff,7,0,30,23
1650643516218,MATH 20D,A03,083767,Staff,24,0,30,6
1650643522247,MATH 20E,A01,083771,Staff,3,0,30,27
1650643522247,MATH 20E,A02,083772,Staff,17,0,30,13
1650643522247,MATH 20E,B01,083773,Staff,0,0,30,30
1650643522247,MATH 20E,B02,083774,Staff,9,0,30,21
1650643528275,MATH 103A,A01,083777,Staff,0,15,30,30
1650643528275,MATH 103A,A02,083778,Staff,0,15,30,30
1650643528275,MATH 103A,B01,083779,Staff,0,14,30,30
1650643528275,MATH 103A,B02,083780,Staff,0,14,30,30
1650643534307,MATH 105,A01,085443,Staff,0,22,30,30
1650643540333,MATH 109,A01,083213,Anzaldo; Leesa B,0,6,30,30
1650643540333,MATH 109,A02,083214,Anzaldo; Leesa B,0,7,30,30
1650643540333,MATH 109,B01,083215,Anzaldo; Leesa B,0,6,30,30
1650643540333,MATH 109,B02,083216,Anzaldo; Leesa B,0,6,30,30
1650643546362,MATH 142A,A01,083219,Chow; Bennett,0,16,30,30
1650643546362,MATH 142A,A02,083220,Chow; Bennett,0,15,30,30
1650643546362,MATH 142A,B01,083221,Chow; Bennett,0,14,30,30
1650643546362,MATH 142A,B02,083222,Chow; Bennett,0,13,30,30
1650643552396,MATH 193A,A01,083224,Staff,0,5,30,30
1650643552396,MATH 193A,A02,083225,Staff,0,6,30,30
1650643552396,MATH 193A,A03,083781,Staff,0,6,30,30
1650643552396,MATH 193A,A04,083782,Staff,0,7,30,30
1650643558420,MATH 197,001,091859,McAuley; Julian John,9998,0,9999,1
1650643564474,COGS 9,A01,083615,Staff,1,15,60,59
1650643570501,COGS 11,A01,083617,Boyle; Mary E. T.,18,0,40,22
1650643576532,COGS 13,A01,083071,Staff,0,38,40,40
1650643582569,COGS 14A,A01,092681,Staff,0,31,100,100
1650643588600,COGS 14B,A01,083073,Cheng; Tzu-Han,0,13,50,50
1650643594626,COGS 17,A01,092677,Staff,17,0,75,58
1650643600654,COGS 100,A01,083619,Staff,0,27,60,60
1650643606684,COGS 101A,A01,083621,Davis; Joshua Daniel,0,26,60,60
1650643612795,COGS 101B,A01,091572,Staff,0,4,60,60
1650643618820,COGS 101C,A01,083625,Delgado; Tania,15,0,30,15
1650643624844,COGS 107A,A01,083627,Boyle; Mary E. T.,1,15,60,59
1650643630867,COGS 118A,A01,083075,Staff,0,6,60,60
1650643636894,CSE 3,A50,083646,Miranda; Gregory Joseph,19,0,38,19
1650643636894,CSE 3,A51,083647,Miranda; Gregory Joseph,36,0,37,1
1650643642923,CSE 8A,A50,083650,Miranda; Gregory Joseph,0,30,40,40
1650643648947,CSE 11,A01,083080,Cao; Yingjun,0,95,40,40
1650643654976,CSE 12,A01,083652,Staff,0,19,100,100
1650643661001,CSE 15L,A01,083654,Staff,0,2,50,50
1650643661001,CSE 15L,A02,083655,Staff,0,1,50,50
1650643667026,CSE 20,A01,083657,Staff,51,0,80,29
1650643673050,CSE 30,A01,083084,Eldon; John,0,77,40,40
1650643679072,CSE 100,A01,083659,Cao; Yingjun,0,69,50,50
1650643685104,CSE 134B,A01,083661,Powell; Thomas Allan,0,36,65,65
1650643691128,CSE 140,A01,083663,Staff,0,8,75,75
1650643697150,CSE 140L,A01,083088,Eldon; John,0,16,75,75
1650643703177,CSE 175,A01,083665,Kumar; Rakesh,7,0,25,18
1650643709206,CSE 190,A00,092507,Dubnov; Shlomo,10,0,20,10
1650643715232,ECE 45,A01,083139,Staff,0,1,60,60
1650643721263,ECE 65,A50,083695,Staff,0,5,30,30
1650643727289,ECE 109,A01,091882,Touri; Behrouz,33,0,70,37
1650643733313,ECE 180,A00,083140,Abi Samra; Nicholas Camill,21,0,30,9
1650643733313,ECE 180,B00,083141,Abi Samra; Nicholas Camill,0,0,30,30
1650643739337,MATH 10A,A01,083735,Patchell; Gregory David,3,0,30,27
1650643739337,MATH 10A,A02,083736,Patchell; Gregory David,27,0,30,3
1650643739337,MATH 10A,A03,083737,Patchell; Gregory David,24,0,30,6
1650643745371,MATH 10B,A01,083207,Staff,0,8,30,30
1650643745371,MATH 10B,A02,083208,Staff,0,8,30,30
1650643745371,MATH 10B,B01,083739,Staff,11,0,30,19
1650643745371,MATH 10B,B02,083740,Staff,28,0,30,2
1650643751398,MATH 18,A01,083743,Staff,0,0,30,30
1650643751398,MATH 18,A02,083744,Staff,23,0,30,7
1650643751398,MATH 18,A03,083745,Staff,21,0,30,9
1650643751398,MATH 18,A04,083746,Staff,26,0,30,4
1650643751398,MATH 18,B01,083748,Staff,0,15,30,30
1650643751398,MATH 18,B02,083749,Staff,0,11,30,30
1650643751398,MATH 18,B03,083750,Staff,0,12,30,30
1650643751398,MATH 18,B04,083751,Staff,0,12,30,30
1650643757427,MATH 20A,A01,083754,Staff,19,0,40,21
1650643763469,MATH 20B,A01,083756,Staff,0,12,30,30
1650643763469,MATH 20B,A02,083757,Staff,0,12,30,30
1650643769493,MATH 20C,A01,083760,Staff,0,15,30,30
1650643769493,MATH 20C,A02,083761,Staff,1,13,30,29
1650643769493,MATH 20C,B01,083762,Staff,11,0,30,19
1650643769493,MATH 20C,B02,083763,Staff,28,0,30,2
1650643775523,MATH 20D,A01,083765,Staff,1,1,30,29
1650643775523,MATH 20D,A02,083766,Staff,7,0,30,23
1650643775523,MATH 20D,A03,083767,Staff,24,0,30,6
1650643781547,MATH 20E,A01,083771,Staff,3,0,30,27
1650643781547,MATH 20E,A02,083772,Staff,17,0,30,13
1650643781547,MATH 20E,B01,083773,Staff,0,0,30,30
1650643781547,MATH 20E,B02,083774,Staff,9,0,30,21
1650643787572,MATH 103A,A01,083777,Staff,0,15,30,30
1650643787572,MATH 103A,A02,083778,Staff,0,15,30,30
1650643787572,MATH 103A,B01,083779,Staff,0,14,30,30
1650643787572,MATH 103A,B02,083780,Staff,0,14,30,30
1650643793595,MATH 105,A01,085443,Staff,0,22,30,30
1650643799627,MATH 109,A01,083213,Anzaldo; Leesa B,0,6,30,30
1650643799627,MATH 109,A02,083214,Anzaldo; Leesa B,0,7,30,30
1650643799627,MATH 109,B01,083215,Anzaldo; Leesa B,0,6,30,30
1650643799627,MATH 109,B02,083216,Anzaldo; Leesa B,0,6,30,30
1650643805653,MATH 142A,A01,083219,Chow; Bennett,0,16,30,30
1650643805653,MATH 142A,A02,083220,Chow; Bennett,0,15,30,30
1650643805653,MATH 142A,B01,083221,Chow; Bennett,0,14,30,30
1650643805653,MATH 142A,B02,083222,Chow; Bennett,0,13,30,30
1650643811694,MATH 193A,A01,083224,Staff,0,5,30,30
1650643811694,MATH 193A,A02,083225,Staff,0,6,30,30
1650643811694,MATH 193A,A03,083781,Staff,0,6,30,30
1650643811694,MATH 193A,A04,083782,Staff,0,7,30,30
1650643817719,MATH 197,001,091859,McAuley; Julian John,9998,0,9999,1
1650643823780,COGS 9,A01,083615,Staff,1,15,60,59
1650643829804,COGS 11,A01,083617,Boyle; Mary E. T.,18,0,40,22
1650643835827,COGS 13,A01,083071,Staff,0,38,40,40
1650643841850,COGS 14A,A01,092681,Staff,0,31,100,100
1650643847883,COGS 14B,A01,083073,Cheng; Tzu-Han,0,13,50,50
1650643853907,COGS 17,A01,092677,Staff,17,0,75,58
1650643859931,COGS 100,A01,083619,Staff,0,27,60,60
1650643865957,COGS 101A,A01,083621,Davis; Joshua Daniel,0,26,60,60
1650643871981,COGS 101B,A01,091572,Staff,0,4,60,60
1650643878005,COGS 101C,A01,083625,Delgado; Tania,15,0,30,15
1650643884033,COGS 107A,A01,083627,Boyle; Mary E. T.,1,15,60,59
1650643890057,COGS 118A,A01,083075,Staff,0,6,60,60
1650643896085,CSE 3,A50,083646,Miranda; Gregory Joseph,19,0,38,19
1650643896085,CSE 3,A51,083647,Miranda; Gregory Joseph,36,0,37,1
1650643902114,CSE 8A,A50,083650,Miranda; Gregory Joseph,0,30,40,40
1650643908140,CSE 11,A01,083080,Cao; Yingjun,0,95,40,40
1650643914173,CSE 12,A01,083652,Staff,0,19,100,100
1650643920205,CSE 15L,A01,083654,Staff,0,2,50,50
1650643920205,CSE 15L,A02,083655,Staff,0,1,50,50
1650643926234,CSE 20,A01,083657,Staff,51,0,80,29
1650643932261,CSE 30,A01,083084,Eldon; John,0,77,40,40
1650643938285,CSE 100,A01,083659,Cao; Yingjun,0,69,50,50
1650643944311,CSE 134B,A01,083661,Powell; Thomas Allan,0,36,65,65
1650643950336,CSE 140,A01,083663,Staff,0,8,75,75
1650643956360,CSE 140L,A01,083088,Eldon; John,0,16,75,75
1650643962385,CSE 175,A01,083665,Kumar; Rakesh,7,0,25,18
1650643968409,CSE 190,A00,092507,Dubnov; Shlomo,10,0,20,10
1650643974435,ECE 45,A01,083139,Staff,0,1,60,60
1650643980467,ECE 65,A50,083695,Staff,0,5,30,30
1650643986494,ECE 109,A01,091882,Touri; Behrouz,33,0,70,37
1650643992530,ECE 180,A00,083140,Abi Samra; Nicholas Camill,21,0,30,9
1650643992530,ECE 180,B00,083141,Abi Samra; Nicholas Camill,0,0,30,30
1650643998557,MATH 10A,A01,083735,Patchell; Gregory David,3,0,30,27
1650643998557,MATH 10A,A02,083736,Patchell; Gregory David,27,0,30,3
1650643998557,MATH 10A,A03,083737,Patchell; Gregory David,24,0,30,6
1650644004585,MATH 10B,A01,083207,Staff,0,8,30,30
1650644004585,MATH 10B,A02,083208,Staff,0,8,30,30
1650644004585,MATH 10B,B01,083739,Staff,11,0,30,19
1650644004585,MATH 10B,B02,083740,Staff,28,0,30,2
1650644010608,MATH 18,A01,083743,Staff,0,0,30,30
1650644010608,MATH 18,A02,083744,Staff,23,0,30,7
1650644010608,MATH 18,A03,083745,Staff,21,0,30,9
1650644010608,MATH 18,A04,083746,Staff,26,0,30,4
1650644010608,MATH 18,B01,083748,Staff,0,15,30,30
1650644010608,MATH 18,B02,083749,Staff,0,11,30,30
1650644010608,MATH 18,B03,083750,Staff,0,12,30,30
1650644010608,MATH 18,B04,083751,Staff,0,12,30,30
1650644016637,MATH 20A,A01,083754,Staff,19,0,40,21
1650644022660,MATH 20B,A01,083756,Staff,0,12,30,30
1650644022660,MATH 20B,A02,083757,Staff,0,12,30,30
1650644028689,MATH 20C,A01,083760,Staff,0,15,30,30
1650644028689,MATH 20C,A02,083761,Staff,1,13,30,29
1650644028689,MATH 20C,B01,083762,Staff,11,0,30,19
1650644028689,MATH 20C,B02,083763,Staff,28,0,30,2
1650644034714,MATH 20D,A01,083765,Staff,1,1,30,29
1650644034714,MATH 20D,A02,083766,Staff,7,0,30,23
1650644034714,MATH 20D,A03,083767,Staff,24,0,30,6
1650644040750,MATH 20E,A01,083771,Staff,3,0,30,27
1650644040750,MATH 20E,A02,083772,Staff,17,0,30,13
1650644040750,MATH 20E,B01,083773,Staff,0,0,30,30
1650644040750,MATH 20E,B02,083774,Staff,9,0,30,21
1650644046789,MATH 103A,A01,083777,Staff,0,15,30,30
1650644046789,MATH 103A,A02,083778,Staff,0,15,30,30
1650644046789,MATH 103A,B01,083779,Staff,0,14,30,30
1650644046789,MATH 103A,B02,083780,Staff,0,14,30,30
1650644052812,MATH 105,A01,085443,Staff,0,22,30,30
1650644058848,MATH 109,A01,083213,Anzaldo; Leesa B,0,7,30,30
1650644058848,MATH 109,A02,083214,Anzaldo; Leesa B,0,7,30,30
1650644058848,MATH 109,B01,083215,Anzaldo; Leesa B,0,6,30,30
1650644058848,MATH 109,B02,083216,Anzaldo; Leesa B,0,6,30,30
1650644064876,MATH 142A,A01,083219,Chow; Bennett,0,16,30,30
1650644064876,MATH 142A,A02,083220,Chow; Bennett,0,15,30,30
1650644064876,MATH 142A,B01,083221,Chow; Bennett,0,14,30,30
1650644064876,MATH 142A,B02,083222,Chow; Bennett,0,13,30,30
1650644070904,MATH 193A,A01,083224,Staff,0,5,30,30
1650644070904,MATH 193A,A02,083225,Staff,0,6,30,30
1650644070904,MATH 193A,A03,083781,Staff,0,6,30,30
1650644070904,MATH 193A,A04,083782,Staff,0,7,30,30
1650644076929,MATH 197,001,091859,McAuley; Julian John,9998,0,9999,1
1650644082978,COGS 9,A01,083615,Staff,1,15,60,59
1650644089001,COGS 11,A01,083617,Boyle; Mary E. T.,18,0,40,22
1650644095024,COGS 13,A01,083071,Staff,0,38,40,40
1650644101050,COGS 14A,A01,092681,Staff,0,31,100,100
1650644107077,COGS 14B,A01,083073,Cheng; Tzu-Han,0,13,50,50
1650644113106,COGS 17,A01,092677,Staff,17,0,75,58
1650644119129,COGS 100,A01,083619,Staff,0,27,60,60
1650644125152,COGS 101A,A01,083621,Davis; Joshua Daniel,0,26,60,60
1650644131173,COGS 101B,A01,091572,Staff,0,4,60,60
1650644137197,COGS 101C,A01,083625,Delgado; Tania,15,0,30,15
1650644143221,COGS 107A,A01,083627,Boyle; Mary E. T.,1,15,60,59
1650644149244,COGS 118A,A01,083075,Staff,0,6,60,60
1650644155272,CSE 3,A50,083646,Miranda; Gregory Joseph,19,0,38,19
1650644155272,CSE 3,A51,083647,Miranda; Gregory Joseph,36,0,37,1
1650644161297,CSE 8A,A50,083650,Miranda; Gregory Joseph,0,30,40,40
1650644167328,CSE 11,A01,083080,Cao; Yingjun,0,95,40,40
1650644173358,CSE 12,A01,083652,Staff,0,19,100,100
1650644179381,CSE 15L,A01,083654,Staff,0,2,50,50
1650644179381,CSE 15L,A02,083655,Staff,0,1,50,50
1650644185412,CSE 20,A01,083657,Staff,51,0,80,29
1650644191438,CSE 30,A01,083084,Eldon; John,0,77,40,40
1650644197465,CSE 100,A01,083659,Cao; Yingjun,0,69,50,50
1650644203489,CSE 134B,A01,083661,Powell; Thomas Allan,0,36,65,65
1650644209623,CSE 140,A01,083663,Staff,0,8,75,75
1650644215647,CSE 140L,A01,083088,Eldon; John,0,16,75,75
1650644221673,CSE 175,A01,083665,Kumar; Rakesh,7,0,25,18
1650644227696,CSE 190,A00,092507,Dubnov; Shlomo,10,0,20,10
1650644233728,ECE 45,A01,083139,Staff,0,1,60,60
1650644239757,ECE 65,A50,083695,Staff,0,5,30,30
1650644245786,ECE 109,A01,091882,Touri; Behrouz,33,0,70,37
1650644251813,ECE 180,A00,083140,Abi Samra; Nicholas Camill,21,0,30,9
1650644251813,ECE 180,B00,083141,Abi Samra; Nicholas Camill,0,0,30,30
1650644257842,MATH 10A,A01,083735,Patchell; Gregory David,3,0,30,27
1650644257842,MATH 10A,A02,083736,Patchell; Gregory David,27,0,30,3
1650644257842,MATH 10A,A03,083737,Patchell; Gregory David,24,0,30,6
1650644263870,MATH 10B,A01,083207,Staff,0,8,30,30
1650644263870,MATH 10B,A02,083208,Staff,0,8,30,30
1650644263870,MATH 10B,B01,083739,Staff,11,0,30,19
1650644263870,MATH 10B,B02,083740,Staff,28,0,30,2
1650644269899,MATH 18,A01,083743,Staff,0,0,30,30
1650644269899,MATH 18,A02,083744,Staff,23,0,30,7
1650644269899,MATH 18,A03,083745,Staff,21,0,30,9
1650644269899,MATH 18,A04,083746,Staff,26,0,30,4
1650644269899,MATH 18,B01,083748,Staff,0,15,30,30
1650644269899,MATH 18,B02,083749,Staff,0,11,30,30
1650644269899,MATH 18,B03,083750,Staff,0,12,30,30
1650644269899,MATH 18,B04,083751,Staff,0,12,30,30
1650644275933,MATH 20A,A01,083754,Staff,19,0,40,21
1650644281955,MATH 20B,A01,083756,Staff,0,12,30,30
1650644281955,MATH 20B,A02,083757,Staff,0,12,30,30
1650644287983,MATH 20C,A01,083760,Staff,0,15,30,30
1650644287983,MATH 20C,A02,083761,Staff,1,13,30,29
1650644287983,MATH 20C,B01,083762,Staff,11,0,30,19
1650644287983,MATH 20C,B02,083763,Staff,28,0,30,2
1650644294010,MATH 20D,A01,083765,Staff,1,1,30,29
1650644294010,MATH 20D,A02,083766,Staff,7,0,30,23
1650644294010,MATH 20D,A03,083767,Staff,24,0,30,6
1650644300040,MATH 20E,A01,083771,Staff,3,0,30,27
1650644300040,MATH 20E,A02,083772,Staff,17,0,30,13
1650644300040,MATH 20E,B01,083773,Staff,0,0,30,30
1650644300040,MATH 20E,B02,083774,Staff,9,0,30,21
1650644306087,MATH 103A,A01,083777,Staff,0,15,30,30
1650644306087,MATH 103A,A02,083778,Staff,0,15,30,30
1650644306087,MATH 103A,B01,083779,Staff,0,14,30,30
1650644306087,MATH 103A,B02,083780,Staff,0,14,30,30
1650644312109,MATH 105,A01,085443,Staff,0,22,30,30
1650644318135,MATH 109,A01,083213,Anzaldo; Leesa B,0,7,30,30
1650644318135,MATH 109,A02,083214,Anzaldo; Leesa B,0,7,30,30
1650644318135,MATH 109,B01,083215,Anzaldo; Leesa B,0,6,30,30
1650644318135,MATH 109,B02,083216,Anzaldo; Leesa B,0,6,30,30
1650644324172,MATH 142A,A01,083219,Chow; Bennett,0,16,30,30
1650644324172,MATH 142A,A02,083220,Chow; Bennett,0,15,30,30
1650644324172,MATH 142A,B01,083221,Chow; Bennett,0,14,30,30
1650644324172,MATH 142A,B02,083222,Chow; Bennett,0,13,30,30
1650644330196,MATH 193A,A01,083224,Staff,0,5,30,30
1650644330196,MATH 193A,A02,083225,Staff,0,6,30,30
1650644330196,MATH 193A,A03,083781,Staff,0,6,30,30
1650644330196,MATH 193A,A04,083782,Staff,0,7,30,30
1650644336222,MATH 197,001,091859,McAuley; Julian John,9998,0,9999,1
1650644342275,COGS 9,A01,083615,Staff,1,15,60,59
1650644348306,COGS 11,A01,083617,Boyle; Mary E. T.,18,0,40,22
1650644354329,COGS 13,A01,083071,Staff,0,38,40,40
1650644360362,COGS 14A,A01,092681,Staff,0,31,100,100
1650644366385,COGS 14B,A01,083073,Cheng; Tzu-Han,0,13,50,50
1650644372409,COGS 17,A01,092677,Staff,17,0,75,58
1650644378439,COGS 100,A01,083619,Staff,0,27,60,60
1650644384462,COGS 101A,A01,083621,Davis; Joshua Daniel,0,26,60,60
1650644390487,COGS 101B,A01,091572,Staff,0,4,60,60
1650644396517,COGS 101C,A01,083625,Delgado; Tania,15,0,30,15
1650644402545,COGS 107A,A01,083627,Boyle; Mary E. T.,1,15,60,59
1650644408573,COGS 118A,A01,083075,Staff,0,6,60,60
1650644414598,CSE 3,A50,083646,Miranda; Gregory Joseph,19,0,38,19
1650644414598,CSE 3,A51,083647,Miranda; Gregory Joseph,36,0,37,1
1650644420628,CSE 8A,A50,083650,Miranda; Gregory Joseph,0,30,40,40
1650644426655,CSE 11,A01,083080,Cao; Yingjun,0,95,40,40
1650644432680,CSE 12,A01,083652,Staff,0,19,100,100
1650644438704,CSE 15L,A01,083654,Staff,0,2,50,50
1650644438704,CSE 15L,A02,083655,Staff,0,1,50,50
1650644444731,CSE 20,A01,083657,Staff,51,0,80,29
1650644450756,CSE 30,A01,083084,Eldon; John,0,77,40,40
1650644456777,CSE 100,A01,083659,Cao; Yingjun,0,69,50,50
1650644462801,CSE 134B,A01,083661,Powell; Thomas Allan,0,36,65,65
1650644468828,CSE 140,A01,083663,Staff,0,8,75,75
1650644474855,CSE 140L,A01,083088,Eldon; John,0,16,75,75
1650644480886,CSE 175,A01,083665,Kumar; Rakesh,7,0,25,18
1650644486912,CSE 190,A00,092507,Dubnov; Shlomo,10,0,20,10
1650644492936,ECE 45,A01,083139,Staff,0,1,60,60
1650644498969,ECE 65,A50,083695,Staff,0,5,30,30
1650644504993,ECE 109,A01,091882,Touri; Behrouz,33,0,70,37
1650644511024,ECE 180,A00,083140,Abi Samra; Nicholas Camill,21,0,30,9
1650644511024,ECE 180,B00,083141,Abi Samra; Nicholas Camill,0,0,30,30
1650644517049,MATH 10A,A01,083735,Patchell; Gregory David,3,0,30,27
1650644517049,MATH 10A,A02,083736,Patchell; Gregory David,27,0,30,3
1650644517049,MATH 10A,A03,083737,Patchell; Gregory David,24,0,30,6
1650644523082,MATH 10B,A01,083207,Staff,0,8,30,30
1650644523082,MATH 10B,A02,083208,Staff,0,8,30,30
1650644523082,MATH 10B,B01,083739,Staff,11,0,30,19
1650644523082,MATH 10B,B02,083740,Staff,28,0,30,2
1650644529113,MATH 18,A01,083743,Staff,0,0,30,30
1650644529113,MATH 18,A02,083744,Staff,23,0,30,7
1650644529113,MATH 18,A03,083745,Staff,21,0,30,9
1650644529113,MATH 18,A04,083746,Staff,26,0,30,4
1650644529113,MATH 18,B01,083748,Staff,0,15,30,30
1650644529113,MATH 18,B02,083749,Staff,0,11,30,30
1650644529113,MATH 18,B03,083750,Staff,0,12,30,30
1650644529113,MATH 18,B04,083751,Staff,0,12,30,30
1650644535139,MATH 20A,A01,083754,Staff,19,0,40,21
1650644541163,MATH 20B,A01,083756,Staff,0,12,30,30
1650644541163,MATH 20B,A02,083757,Staff,0,12,30,30
1650644547195,MATH 20C,A01,083760,Staff,0,15,30,30
1650644547195,MATH 20C,A02,083761,Staff,1,13,30,29
1650644547195,MATH 20C,B01,083762,Staff,11,0,30,19
1650644547195,MATH 20C,B02,083763,Staff,28,0,30,2
1650644553223,MATH 20D,A01,083765,Staff,1,1,30,29
1650644553223,MATH 20D,A02,083766,Staff,7,0,30,23
1650644553223,MATH 20D,A03,083767,Staff,24,0,30,6
1650644559263,MATH 20E,A01,083771,Staff,3,0,30,27
1650644559263,MATH 20E,A02,083772,Staff,17,0,30,13
1650644559263,MATH 20E,B01,083773,Staff,0,0,30,30
1650644559263,MATH 20E,B02,083774,Staff,9,0,30,21
1650644565297,MATH 103A,A01,083777,Staff,0,15,30,30
1650644565297,MATH 103A,A02,083778,Staff,0,15,30,30
1650644565297,MATH 103A,B01,083779,Staff,0,14,30,30
1650644565297,MATH 103A,B02,083780,Staff,0,14,30,30
1650644571323,MATH 105,A01,085443,Staff,0,22,30,30
1650644577346,MATH 109,A01,083213,Anzaldo; Leesa B,0,7,30,30
1650644577346,MATH 109,A02,083214,Anzaldo; Leesa B,0,7,30,30
1650644577346,MATH 109,B01,083215,Anzaldo; Leesa B,0,6,30,30
1650644577346,MATH 109,B02,083216,Anzaldo; Leesa B,0,6,30,30
1650644583372,MATH 142A,A01,083219,Chow; Bennett,0,16,30,30
1650644583372,MATH 142A,A02,083220,Chow; Bennett,0,15,30,30
1650644583372,MATH 142A,B01,083221,Chow; Bennett,0,14,30,30
1650644583372,MATH 142A,B02,083222,Chow; Bennett,0,13,30,30
1650644589400,MATH 193A,A01,083224,Staff,0,5,30,30
1650644589400,MATH 193A,A02,083225,Staff,0,6,30,30
1650644589400,MATH 193A,A03,083781,Staff,0,6,30,30
1650644589400,MATH 193A,A04,083782,Staff,0,7,30,30
1650644595430,MATH 197,001,091859,McAuley; Julian John,9998,0,9999,1
1650644601492,COGS 9,A01,083615,Staff,1,15,60,59
1650644607515,COGS 11,A01,083617,Boyle; Mary E. T.,18,0,40,22
1650644613542,COGS 13,A01,083071,Staff,0,38,40,40
1650644619569,COGS 14A,A01,092681,Staff,0,31,100,100
1650644625599,COGS 14B,A01,083073,Cheng; Tzu-Han,0,13,50,50
1650644631621,COGS 17,A01,092677,Staff,17,0,75,58
1650644637668,COGS 100,A01,083619,Staff,0,27,60,60
1650644643691,COGS 101A,A01,083621,Davis; Joshua Daniel,0,26,60,60
1650644649714,COGS 101B,A01,091572,Staff,0,4,60,60
1650644655738,COGS 101C,A01,083625,Delgado; Tania,15,0,30,15
1650644661761,COGS 107A,A01,083627,Boyle; Mary E. T.,1,15,60,59
1650644667785,COGS 118A,A01,083075,Staff,0,6,60,60
1650644673811,CSE 3,A50,083646,Miranda; Gregory Joseph,19,0,38,19
1650644673811,CSE 3,A51,083647,Miranda; Gregory Joseph,36,0,37,1
1650644679835,CSE 8A,A50,083650,Miranda; Gregory Joseph,0,30,40,40
1650644685865,CSE 11,A01,083080,Cao; Yingjun,0,95,40,40
1650644691891,CSE 12,A01,083652,Staff,0,19,100,100
1650644697915,CSE 15L,A01,083654,Staff,0,2,50,50
1650644697915,CSE 15L,A02,083655,Staff,0,1,50,50
1650644703942,CSE 20,A01,083657,Staff,51,0,80,29
1650644709979,CSE 30,A01,083084,Eldon; John,0,77,40,40
1650644716003,CSE 100,A01,083659,Cao; Yingjun,0,69,50,50
1650644722026,CSE 134B,A01,083661,Powell; Thomas Allan,0,36,65,65
1650644728049,CSE 140,A01,083663,Staff,0,8,75,75
1650644734071,CSE 140L,A01,083088,Eldon; John,0,16,75,75
1650644740097,CSE 175,A01,083665,Kumar; Rakesh,7,0,25,18
1650644746120,CSE 190,A00,092507,Dubnov; Shlomo,10,0,20,10
1650644752146,ECE 45,A01,083139,Staff,0,1,60,60
1650644758171,ECE 65,A50,083695,Staff,0,5,30,30
1650644764195,ECE 109,A01,091882,Touri; Behrouz,33,0,70,37
1650644770229,ECE 180,A00,083140,Abi Samra; Nicholas Camill,21,0,30,9
1650644770229,ECE 180,B00,083141,Abi Samra; Nicholas Camill,0,0,30,30
1650644776258,MATH 10A,A01,083735,Patchell; Gregory David,3,0,30,27
1650644776258,MATH 10A,A02,083736,Patchell; Gregory David,27,0,30,3
1650644776258,MATH 10A,A03,083737,Patchell; Gregory David,24,0,30,6
1650644782292,MATH 10B,A01,083207,Staff,0,8,30,30
1650644782292,MATH 10B,A02,083208,Staff,0,8,30,30
1650644782292,MATH 10B,B01,083739,Staff,11,0,30,19
1650644782292,MATH 10B,B02,083740,Staff,28,0,30,2
1650644788319,MATH 18,A01,083743,Staff,0,0,30,30
1650644788319,MATH 18,A02,083744,Staff,23,0,30,7
1650644788319,MATH 18,A03,083745,Staff,21,0,30,9
1650644788319,MATH 18,A04,083746,Staff,26,0,30,4
1650644788319,MATH 18,B01,083748,Staff,0,15,30,30
1650644788319,MATH 18,B02,083749,Staff,0,11,30,30
1650644788319,MATH 18,B03,083750,Staff,0,12,30,30
1650644788319,MATH 18,B04,083751,Staff,0,12,30,30
1650644794342,MATH 20A,A01,083754,Staff,19,0,40,21
1650644800368,MATH 20B,A01,083756,Staff,0,12,30,30
1650644800368,MATH 20B,A02,083757,Staff,0,12,30,30
1650644806483,MATH 20C,A01,083760,Staff,0,15,30,30
1650644806483,MATH 20C,A02,083761,Staff,1,13,30,29
1650644806483,MATH 20C,B01,083762,Staff,11,0,30,19
1650644806483,MATH 20C,B02,083763,Staff,28,0,30,2
1650644812509,MATH 20D,A01,083765,Staff,1,1,30,29
1650644812509,MATH 20D,A02,083766,Staff,7,0,30,23
1650644812509,MATH 20D,A03,083767,Staff,24,0,30,6
1650644818538,MATH 20E,A01,083771,Staff,3,0,30,27
1650644818538,MATH 20E,A02,083772,Staff,17,0,30,13
1650644818538,MATH 20E,B01,083773,Staff,0,0,30,30
1650644818538,MATH 20E,B02,083774,Staff,9,0,30,21
1650644824565,MATH 103A,A01,083777,Staff,0,15,30,30
1650644824565,MATH 103A,A02,083778,Staff,0,15,30,30
1650644824565,MATH 103A,B01,083779,Staff,0,14,30,30
1650644824565,MATH 103A,B02,083780,Staff,0,14,30,30
1650644830590,MATH 105,A01,085443,Staff,0,22,30,30
1650644836615,MATH 109,A01,083213,Anzaldo; Leesa B,0,7,30,30
1650644836615,MATH 109,A02,083214,Anzaldo; Leesa B,0,7,30,30
1650644836615,MATH 109,B01,083215,Anzaldo; Leesa B,0,6,30,30
1650644836615,MATH 109,B02,083216,Anzaldo; Leesa B,0,6,30,30
1650644842638,MATH 142A,A01,083219,Chow; Bennett,0,16,30,30
1650644842638,MATH 142A,A02,083220,Chow; Bennett,0,15,30,30
1650644842638,MATH 142A,B01,083221,Chow; Bennett,0,14,30,30
1650644842638,MATH 142A,B02,083222,Chow; Bennett,0,13,30,30
1650644848675,MATH 193A,A01,083224,Staff,0,5,30,30
1650644848675,MATH 193A,A02,083225,Staff,0,6,30,30
1650644848675,MATH 193A,A03,083781,Staff,0,6,30,30
1650644848675,MATH 193A,A04,083782,Staff,0,7,30,30
1650644854699,MATH 197,001,091859,McAuley; Julian John,9998,0,9999,1
1650644860754,COGS 9,A01,083615,Staff,1,15,60,59
1650644866782,COGS 11,A01,083617,Boyle; Mary E. T.,18,0,40,22
1650644872818,COGS 13,A01,083071,Staff,0,38,40,40
1650644878842,COGS 14A,A01,092681,Staff,0,31,100,100
1650644884869,COGS 14B,A01,083073,Cheng; Tzu-Han,0,13,50,50
1650644890893,COGS 17,A01,092677,Staff,17,0,75,58
1650644896917,COGS 100,A01,083619,Staff,0,27,60,60
1650644902940,COGS 101A,A01,083621,Davis; Joshua Daniel,0,26,60,60
1650644908964,COGS 101B,A01,091572,Staff,0,4,60,60
1650644914989,COGS 101C,A01,083625,Delgado; Tania,15,0,30,15
1650644921013,COGS 107A,A01,083627,Boyle; Mary E. T.,1,15,60,59
1650644927055,COGS 118A,A01,083075,Staff,0,6,60,60
1650644933083,CSE 3,A50,083646,Miranda; Gregory Joseph,19,0,38,19
1650644933083,CSE 3,A51,083647,Miranda; Gregory Joseph,36,0,37,1
1650644939106,CSE 8A,A50,083650,Miranda; Gregory Joseph,0,30,40,40
1650644945130,CSE 11,A01,083080,Cao; Yingjun,0,95,40,40
1650644951154,CSE 12,A01,083652,Staff,0,19,100,100
1650644957178,CSE 15L,A01,083654,Staff,0,2,50,50
1650644957178,CSE 15L,A02,083655,Staff,0,1,50,50
1650644963202,CSE 20,A01,083657,Staff,51,0,80,29
1650644969227,CSE 30,A01,083084,Eldon; John,0,77,40,40
1650644975252,CSE 100,A01,083659,Cao; Yingjun,0,69,50,50
1650644981282,CSE 134B,A01,083661,Powell; Thomas Allan,0,36,65,65
1650644987316,CSE 140,A01,083663,Staff,0,8,75,75
1650644993367,CSE 140L,A01,083088,Eldon; John,0,16,75,75
1650644999390,CSE 175,A01,083665,Kumar; Rakesh,7,0,25,18
1650645005415,CSE 190,A00,092507,Dubnov; Shlomo,10,0,20,10
1650645011446,ECE 45,A01,083139,Staff,0,1,60,60
1650645017471,ECE 65,A50,083695,Staff,0,5,30,30
1650645023494,ECE 109,A01,091882,Touri; Behrouz,33,0,70,37
1650645029520,ECE 180,A00,083140,Abi Samra; Nicholas Camill,21,0,30,9
1650645029520,ECE 180,B00,083141,Abi Samra; Nicholas Camill,0,0,30,30
1650645035547,MATH 10A,A01,083735,Patchell; Gregory David,3,0,30,27
1650645035547,MATH 10A,A02,083736,Patchell; Gregory David,27,0,30,3
1650645035547,MATH 10A,A03,083737,Patchell; Gregory David,24,0,30,6
1650645041571,MATH 10B,A01,083207,Staff,0,8,30,30
1650645041571,MATH 10B,A02,083208,Staff,0,8,30,30
1650645041571,MATH 10B,B01,083739,Staff,11,0,30,19
1650645041571,MATH 10B,B02,083740,Staff,28,0,30,2
1650645047617,MATH 18,A01,083743,Staff,0,0,30,30
1650645047617,MATH 18,A02,083744,Staff,23,0,30,7
1650645047617,MATH 18,A03,083745,Staff,21,0,30,9
1650645047617,MATH 18,A04,083746,Staff,26,0,30,4
1650645047617,MATH 18,B01,083748,Staff,0,15,30,30
1650645047617,MATH 18,B02,083749,Staff,0,11,30,30
1650645047617,MATH 18,B03,083750,Staff,0,12,30,30
1650645047617,MATH 18,B04,083751,Staff,0,12,30,30
1650645053640,MATH 20A,A01,083754,Staff,19,0,40,21
1650645059671,MATH 20B,A01,083756,Staff,0,12,30,30
1650645059671,MATH 20B,A02,083757,Staff,0,12,30,30
1650645065694,MATH 20C,A01,083760,Staff,0,15,30,30
1650645065694,MATH 20C,A02,083761,Staff,1,13,30,29
1650645065694,MATH 20C,B01,083762,Staff,11,0,30,19
1650645065694,MATH 20C,B02,083763,Staff,28,0,30,2
1650645071722,MATH 20D,A01,083765,Staff,1,1,30,29
1650645071722,MATH 20D,A02,083766,Staff,7,0,30,23
1650645071722,MATH 20D,A03,083767,Staff,24,0,30,6
1650645077745,MATH 20E,A01,083771,Staff,3,0,30,27
1650645077745,MATH 20E,A02,083772,Staff,17,0,30,13
1650645077745,MATH 20E,B01,083773,Staff,0,0,30,30
1650645077745,MATH 20E,B02,083774,Staff,9,0,30,21
1650645083772,MATH 103A,A01,083777,Staff,0,15,30,30
1650645083772,MATH 103A,A02,083778,Staff,0,15,30,30
1650645083772,MATH 103A,B01,083779,Staff,0,14,30,30
1650645083772,MATH 103A,B02,083780,Staff,0,14,30,30
1650645089799,MATH 105,A01,085443,Staff,0,22,30,30
1650645095829,MATH 109,A01,083213,Anzaldo; Leesa B,0,7,30,30
1650645095829,MATH 109,A02,083214,Anzaldo; Leesa B,0,7,30,30
1650645095829,MATH 109,B01,083215,Anzaldo; Leesa B,0,6,30,30
1650645095829,MATH 109,B02,083216,Anzaldo; Leesa B,0,6,30,30
1650645101854,MATH 142A,A01,083219,Chow; Bennett,0,16,30,30
1650645101854,MATH 142A,A02,083220,Chow; Bennett,0,15,30,30
1650645101854,MATH 142A,B01,083221,Chow; Bennett,0,14,30,30
1650645101854,MATH 142A,B02,083222,Chow; Bennett,0,13,30,30
1650645107881,MATH 193A,A01,083224,Staff,0,5,30,30
1650645107881,MATH 193A,A02,083225,Staff,0,6,30,30
1650645107881,MATH 193A,A03,083781,Staff,0,6,30,30
1650645107881,MATH 193A,A04,083782,Staff,0,7,30,30
1650645113905,MATH 197,001,091859,McAuley; Julian John,9998,0,9999,1
1650645119955,COGS 9,A01,083615,Staff,1,15,60,59
1650645125987,COGS 11,A01,083617,Boyle; Mary E. T.,18,0,40,22
1650645132015,COGS 13,A01,083071,Staff,0,38,40,40
1650645138038,COGS 14A,A01,092681,Staff,0,31,100,100
1650645144063,COGS 14B,A01,083073,Cheng; Tzu-Han,0,13,50,50
1650645150086,COGS 17,A01,092677,Staff,17,0,75,58
1650645156114,COGS 100,A01,083619,Staff,0,27,60,60
1650645162141,COGS 101A,A01,083621,Davis; Joshua Daniel,0,26,60,60
1650645168165,COGS 101B,A01,091572,Staff,0,4,60,60
1650645174191,COGS 101C,A01,083625,Delgado; Tania,15,0,30,15
1650645180214,COGS 107A,A01,083627,Boyle; Mary E. T.,1,15,60,59
1650645186245,COGS 118A,A01,083075,Staff,0,6,60,60
1650645192267,CSE 3,A50,083646,Miranda; Gregory Joseph,19,0,38,19
1650645192267,CSE 3,A51,083647,Miranda; Gregory Joseph,36,0,37,1
1650645198290,CSE 8A,A50,083650,Miranda; Gregory Joseph,0,30,40,40
1650645204312,CSE 11,A01,083080,Cao; Yingjun,0,95,40,40
1650645210347,CSE 12,A01,083652,Staff,0,19,100,100
1650645216379,CSE 15L,A01,083654,Staff,0,2,50,50
1650645216379,CSE 15L,A02,083655,Staff,0,1,50,50
1650645222403,CSE 20,A01,083657,Staff,51,0,80,29
1650645228427,CSE 30,A01,083084,Eldon; John,0,77,40,40
1650645234451,CSE 100,A01,083659,Cao; Yingjun,0,69,50,50
1650645240474,CSE 134B,A01,083661,Powell; Thomas Allan,0,36,65,65
1650645246499,CSE 140,A01,083663,Staff,0,8,75,75
1650645252527,CSE 140L,A01,083088,Eldon; John,0,16,75,75
1650645258552,CSE 175,A01,083665,Kumar; Rakesh,7,0,25,18
1650645264577,CSE 190,A00,092507,Dubnov; Shlomo,10,0,20,10
1650645270600,ECE 45,A01,083139,Staff,0,1,60,60
1650645276623,ECE 65,A50,083695,Staff,0,5,30,30
1650645282653,ECE 109,A01,091882,Touri; Behrouz,33,0,70,37
1650645288679,ECE 180,A00,083140,Abi Samra; Nicholas Camill,21,0,30,9
1650645288679,ECE 180,B00,083141,Abi Samra; Nicholas Camill,0,0,30,30
1650645294702,MATH 10A,A01,083735,Patchell; Gregory David,3,0,30,27
1650645294702,MATH 10A,A02,083736,Patchell; Gregory David,27,0,30,3
1650645294702,MATH 10A,A03,083737,Patchell; Gregory David,24,0,30,6
1650645300729,MATH 10B,A01,083207,Staff,0,8,30,30
1650645300729,MATH 10B,A02,083208,Staff,0,8,30,30
1650645300729,MATH 10B,B01,083739,Staff,11,0,30,19
1650645300729,MATH 10B,B02,083740,Staff,28,0,30,2
1650645306754,MATH 18,A01,083743,Staff,0,0,30,30
1650645306754,MATH 18,A02,083744,Staff,23,0,30,7
1650645306754,MATH 18,A03,083745,Staff,21,0,30,9
1650645306754,MATH 18,A04,083746,Staff,26,0,30,4
1650645306754,MATH 18,B01,083748,Staff,0,15,30,30
1650645306754,MATH 18,B02,083749,Staff,0,11,30,30
1650645306754,MATH 18,B03,083750,Staff,0,12,30,30
1650645306754,MATH 18,B04,083751,Staff,0,12,30,30
1650645312779,MATH 20A,A01,083754,Staff,19,0,40,21
1650645318803,MATH 20B,A01,083756,Staff,0,12,30,30
1650645318803,MATH 20B,A02,083757,Staff,0,12,30,30
1650645324836,MATH 20C,A01,083760,Staff,0,15,30,30
1650645324836,MATH 20C,A02,083761,Staff,1,13,30,29
1650645324836,MATH 20C,B01,083762,Staff,11,0,30,19
1650645324836,MATH 20C,B02,083763,Staff,28,0,30,2
1650645330871,MATH 20D,A01,083765,Staff,1,1,30,29
1650645330871,MATH 20D,A02,083766,Staff,7,0,30,23
1650645330871,MATH 20D,A03,083767,Staff,24,0,30,6
1650645336893,MATH 20E,A01,083771,Staff,3,0,30,27
1650645336893,MATH 20E,A02,083772,Staff,17,0,30,13
1650645336893,MATH 20E,B01,083773,Staff,0,0,30,30
1650645336893,MATH 20E,B02,083774,Staff,9,0,30,21
1650645342915,MATH 103A,A01,083777,Staff,0,15,30,30
1650645342915,MATH 103A,A02,083778,Staff,0,15,30,30
1650645342915,MATH 103A,B01,083779,Staff,0,14,30,30
1650645342915,MATH 103A,B02,083780,Staff,0,14,30,30
1650645348941,MATH 105,A01,085443,Staff,0,22,30,30
1650645354985,MATH 109,A01,083213,Anzaldo; Leesa B,0,7,30,30
1650645354985,MATH 109,A02,083214,Anzaldo; Leesa B,0,7,30,30
1650645354985,MATH 109,B01,083215,Anzaldo; Leesa B,0,6,30,30
1650645354985,MATH 109,B02,083216,Anzaldo; Leesa B,0,6,30,30
1650645361015,MATH 142A,A01,083219,Chow; Bennett,0,16,30,30
1650645361015,MATH 142A,A02,083220,Chow; Bennett,0,15,30,30
1650645361015,MATH 142A,B01,083221,Chow; Bennett,0,14,30,30
1650645361015,MATH 142A,B02,083222,Chow; Bennett,0,13,30,30
1650645367040,MATH 193A,A01,083224,Staff,0,5,30,30
1650645367040,MATH 193A,A02,083225,Staff,0,6,30,30
1650645367040,MATH 193A,A03,083781,Staff,0,6,30,30
1650645367040,MATH 193A,A04,083782,Staff,0,7,30,30
1650645373065,MATH 197,001,091859,McAuley; Julian John,9998,0,9999,1
1650645379125,COGS 9,A01,083615,Staff,1,15,60,59
1650645385146,COGS 11,A01,083617,Boyle; Mary E. T.,18,0,40,22
1650645391177,COGS 13,A01,083071,Staff,0,38,40,40
1650645397293,COGS 14A,A01,092681,Staff,0,31,100,100
1650645403318,COGS 14B,A01,083073,Cheng; Tzu-Han,0,13,50,50
1650645409350,COGS 17,A01,092677,Staff,17,0,75,58
1650645415387,COGS 100,A01,083619,Staff,0,27,60,60
1650645421430,COGS 101A,A01,083621,Davis; Joshua Daniel,0,26,60,60
1650645427454,COGS 101B,A01,091572,Staff,0,4,60,60
1650645433477,COGS 101C,A01,083625,Delgado; Tania,15,0,30,15
1650645439500,COGS 107A,A01,083627,Boyle; Mary E. T.,1,15,60,59
1650645445527,COGS 118A,A01,083075,Staff,0,6,60,60
1650645451553,CSE 3,A50,083646,Miranda; Gregory Joseph,19,0,38,19
1650645451553,CSE 3,A51,083647,Miranda; Gregory Joseph,36,0,37,1
1650645457578,CSE 8A,A50,083650,Miranda; Gregory Joseph,0,30,40,40
1650645463606,CSE 11,A01,083080,Cao; Yingjun,0,95,40,40
1650645469633,CSE 12,A01,083652,Staff,0,19,100,100
1650645475660,CSE 15L,A01,083654,Staff,0,2,50,50
1650645475660,CSE 15L,A02,083655,Staff,0,1,50,50
1650645481687,CSE 20,A01,083657,Staff,51,0,80,29
1650645487710,CSE 30,A01,083084,Eldon; John,0,77,40,40
1650645493739,CSE 100,A01,083659,Cao; Yingjun,0,69,50,50
1650645499765,CSE 134B,A01,083661,Powell; Thomas Allan,0,36,65,65
1650645505789,CSE 140,A01,083663,Staff,0,8,75,75
1650645511813,CSE 140L,A01,083088,Eldon; John,0,16,75,75
1650645517839,CSE 175,A01,083665,Kumar; Rakesh,7,0,25,18
1650645523865,CSE 190,A00,092507,Dubnov; Shlomo,10,0,20,10
1650645529889,ECE 45,A01,083139,Staff,0,1,60,60
1650645535913,ECE 65,A50,083695,Staff,0,5,30,30
1650645541939,ECE 109,A01,091882,Touri; Behrouz,33,0,70,37
1650645547963,ECE 180,A00,083140,Abi Samra; Nicholas Camill,21,0,30,9
1650645547963,ECE 180,B00,083141,Abi Samra; Nicholas Camill,0,0,30,30
1650645553991,MATH 10A,A01,083735,Patchell; Gregory David,3,0,30,27
1650645553991,MATH 10A,A02,083736,Patchell; Gregory David,27,0,30,3
1650645553991,MATH 10A,A03,083737,Patchell; Gregory David,24,0,30,6
1650645560016,MATH 10B,A01,083207,Staff,0,8,30,30
1650645560016,MATH 10B,A02,083208,Staff,0,8,30,30
1650645560016,MATH 10B,B01,083739,Staff,11,0,30,19
1650645560016,MATH 10B,B02,083740,Staff,28,0,30,2
1650645566046,MATH 18,A01,083743,Staff,0,0,30,30
1650645566046,MATH 18,A02,083744,Staff,23,0,30,7
1650645566046,MATH 18,A03,083745,Staff,21,0,30,9
1650645566046,MATH 18,A04,083746,Staff,26,0,30,4
1650645566046,MATH 18,B01,083748,Staff,0,15,30,30
1650645566046,MATH 18,B02,083749,Staff,0,11,30,30
1650645566046,MATH 18,B03,083750,Staff,0,12,30,30
1650645566046,MATH 18,B04,083751,Staff,0,12,30,30
1650645572074,MATH 20A,A01,083754,Staff,19,0,40,21
1650645578108,MATH 20B,A01,083756,Staff,0,12,30,30
1650645578108,MATH 20B,A02,083757,Staff,0,12,30,30
1650645584142,MATH 20C,A01,083760,Staff,0,15,30,30
1650645584142,MATH 20C,A02,083761,Staff,1,13,30,29
1650645584142,MATH 20C,B01,083762,Staff,11,0,30,19
1650645584142,MATH 20C,B02,083763,Staff,28,0,30,2
1650645590172,MATH 20D,A01,083765,Staff,1,1,30,29
1650645590172,MATH 20D,A02,083766,Staff,7,0,30,23
1650645590172,MATH 20D,A03,083767,Staff,24,0,30,6
1650645596204,MATH 20E,A01,083771,Staff,3,0,30,27
1650645596204,MATH 20E,A02,083772,Staff,17,0,30,13
1650645596204,MATH 20E,B01,083773,Staff,0,0,30,30
1650645596204,MATH 20E,B02,083774,Staff,9,0,30,21
1650645602236,MATH 103A,A01,083777,Staff,0,15,30,30
1650645602236,MATH 103A,A02,083778,Staff,0,15,30,30
1650645602236,MATH 103A,B01,083779,Staff,0,14,30,30
1650645602236,MATH 103A,B02,083780,Staff,0,14,30,30
1650645608275,MATH 105,A01,085443,Staff,0,22,30,30
1650645614304,MATH 109,A01,083213,Anzaldo; Leesa B,0,7,30,30
1650645614304,MATH 109,A02,083214,Anzaldo; Leesa B,0,7,30,30
1650645614304,MATH 109,B01,083215,Anzaldo; Leesa B,0,6,30,30
1650645614304,MATH 109,B02,083216,Anzaldo; Leesa B,0,6,30,30
1650645620329,MATH 142A,A01,083219,Chow; Bennett,0,16,30,30
1650645620329,MATH 142A,A02,083220,Chow; Bennett,0,15,30,30
1650645620329,MATH 142A,B01,083221,Chow; Bennett,0,14,30,30
1650645620329,MATH 142A,B02,083222,Chow; Bennett,0,13,30,30
1650645626353,MATH 193A,A01,083224,Staff,0,5,30,30
1650645626353,MATH 193A,A02,083225,Staff,0,6,30,30
1650645626353,MATH 193A,A03,083781,Staff,0,6,30,30
1650645626353,MATH 193A,A04,083782,Staff,0,7,30,30
1650645632376,MATH 197,001,091859,McAuley; Julian John,9998,0,9999,1
1650645638441,COGS 9,A01,083615,Staff,1,15,60,59
1650645644465,COGS 11,A01,083617,Boyle; Mary E. T.,18,0,40,22
1650645650505,COGS 13,A01,083071,Staff,0,38,40,40
1650645656531,COGS 14A,A01,092681,Staff,0,31,100,100
1650645662557,COGS 14B,A01,083073,Cheng; Tzu-Han,0,13,50,50
1650645668584,COGS 17,A01,092677,Staff,17,0,75,58
1650645674623,COGS 100,A01,083619,Staff,0,27,60,60
1650645680645,COGS 101A,A01,083621,Davis; Joshua Daniel,0,26,60,60
1650645686672,COGS 101B,A01,091572,Staff,0,4,60,60
1650645692697,COGS 101C,A01,083625,Delgado; Tania,15,0,30,15
1650645698725,COGS 107A,A01,083627,Boyle; Mary E. T.,1,15,60,59
1650645704764,COGS 118A,A01,083075,Staff,0,6,60,60
1650645710787,CSE 3,A50,083646,Miranda; Gregory Joseph,19,0,38,19
1650645710787,CSE 3,A51,083647,Miranda; Gregory Joseph,36,0,37,1
1650645716816,CSE 8A,A50,083650,Miranda; Gregory Joseph,0,30,40,40
1650645722848,CSE 11,A01,083080,Cao; Yingjun,0,95,40,40
1650645728873,CSE 12,A01,083652,Staff,0,19,100,100
1650645734898,CSE 15L,A01,083654,Staff,0,2,50,50
1650645734898,CSE 15L,A02,083655,Staff,0,1,50,50
1650645740926,CSE 20,A01,083657,Staff,51,0,80,29
1650645746970,CSE 30,A01,083084,Eldon; John,0,77,40,40
1650645752997,CSE 100,A01,083659,Cao; Yingjun,0,69,50,50
1650645759019,CSE 134B,A01,083661,Powell; Thomas Allan,0,36,65,65
1650645765047,CSE 140,A01,083663,Staff,0,8,75,75
1650645771090,CSE 140L,A01,083088,Eldon; John,0,16,75,75
1650645777114,CSE 175,A01,083665,Kumar; Rakesh,7,0,25,18
1650645783135,CSE 190,A00,092507,Dubnov; Shlomo,10,0,20,10
1650645789167,ECE 45,A01,083139,Staff,0,1,60,60
1650645795209,ECE 65,A50,083695,Staff,0,5,30,30
1650645801240,ECE 109,A01,091882,Touri; Behrouz,33,0,70,37
1650645807268,ECE 180,A00,083140,Abi Samra; Nicholas Camill,21,0,30,9
1650645807268,ECE 180,B00,083141,Abi Samra; Nicholas Camill,0,0,30,30
1650645813292,MATH 10A,A01,083735,Patchell; Gregory David,3,0,30,27
1650645813292,MATH 10A,A02,083736,Patchell; Gregory David,27,0,30,3
1650645813292,MATH 10A,A03,083737,Patchell; Gregory David,24,0,30,6
1650645819321,MATH 10B,A01,083207,Staff,0,8,30,30
1650645819321,MATH 10B,A02,083208,Staff,0,8,30,30
1650645819321,MATH 10B,B01,083739,Staff,11,0,30,19
1650645819321,MATH 10B,B02,083740,Staff,28,0,30,2
1650645825345,MATH 18,A01,083743,Staff,0,0,30,30
1650645825345,MATH 18,A02,083744,Staff,23,0,30,7
1650645825345,MATH 18,A03,083745,Staff,21,0,30,9
1650645825345,MATH 18,A04,083746,Staff,26,0,30,4
1650645825345,MATH 18,B01,083748,Staff,0,15,30,30
1650645825345,MATH 18,B02,083749,Staff,0,11,30,30
1650645825345,MATH 18,B03,083750,Staff,0,12,30,30
1650645825345,MATH 18,B04,083751,Staff,0,12,30,30
1650645831373,MATH 20A,A01,083754,Staff,19,0,40,21
1650645837399,MATH 20B,A01,083756,Staff,0,12,30,30
1650645837399,MATH 20B,A02,083757,Staff,0,12,30,30
1650645843430,MATH 20C,A01,083760,Staff,0,15,30,30
1650645843430,MATH 20C,A02,083761,Staff,1,13,30,29
1650645843430,MATH 20C,B01,083762,Staff,11,0,30,19
1650645843430,MATH 20C,B02,083763,Staff,28,0,30,2
1650645849456,MATH 20D,A01,083765,Staff,1,1,30,29
1650645849456,MATH 20D,A02,083766,Staff,7,0,30,23
1650645849456,MATH 20D,A03,083767,Staff,24,0,30,6
1650645855490,MATH 20E,A01,083771,Staff,3,0,30,27
1650645855490,MATH 20E,A02,083772,Staff,17,0,30,13
1650645855490,MATH 20E,B01,083773,Staff,0,0,30,30
1650645855490,MATH 20E,B02,083774,Staff,9,0,30,21
1650645861512,MATH 103A,A01,083777,Staff,0,15,30,30
1650645861512,MATH 103A,A02,083778,Staff,0,15,30,30
1650645861512,MATH 103A,B01,083779,Staff,0,14,30,30
1650645861512,MATH 103A,B02,083780,Staff,0,14,30,30
1650645867537,MATH 105,A01,085443,Staff,0,22,30,30
1650645873565,MATH 109,A01,083213,Anzaldo; Leesa B,0,7,30,30
1650645873565,MATH 109,A02,083214,Anzaldo; Leesa B,0,7,30,30
1650645873565,MATH 109,B01,083215,Anzaldo; Leesa B,0,6,30,30
1650645873565,MATH 109,B02,083216,Anzaldo; Leesa B,0,6,30,30
1650645879598,MATH 142A,A01,083219,Chow; Bennett,0,16,30,30
1650645879598,MATH 142A,A02,083220,Chow; Bennett,0,15,30,30
1650645879598,MATH 142A,B01,083221,Chow; Bennett,0,14,30,30
1650645879598,MATH 142A,B02,083222,Chow; Bennett,0,13,30,30
1650645885638,MATH 193A,A01,083224,Staff,0,5,30,30
1650645885638,MATH 193A,A02,083225,Staff,0,6,30,30
1650645885638,MATH 193A,A03,083781,Staff,0,6,30,30
1650645885638,MATH 193A,A04,083782,Staff,0,7,30,30
1650645891665,MATH 197,001,091859,McAuley; Julian John,9998,0,9999,1
1650645897725,COGS 9,A01,083615,Staff,1,15,60,59
1650645903765,COGS 11,A01,083617,Boyle; Mary E. T.,18,0,40,22
1650645909794,COGS 13,A01,083071,Staff,0,38,40,40
1650645915817,COGS 14A,A01,092681,Staff,0,31,100,100
1650645921848,COGS 14B,A01,083073,Cheng; Tzu-Han,0,13,50,50
1650645927879,COGS 17,A01,092677,Staff,17,0,75,58
1650645933913,COGS 100,A01,083619,Staff,0,27,60,60
1650645939937,COGS 101A,A01,083621,Davis; Joshua Daniel,0,26,60,60
1650645945963,COGS 101B,A01,091572,Staff,0,4,60,60
1650645951989,COGS 101C,A01,083625,Delgado; Tania,15,0,30,15
1650645958022,COGS 107A,A01,083627,Boyle; Mary E. T.,1,15,60,59
1650645964052,COGS 118A,A01,083075,Staff,0,6,60,60
1650645970086,CSE 3,A50,083646,Miranda; Gregory Joseph,19,0,38,19
1650645970086,CSE 3,A51,083647,Miranda; Gregory Joseph,36,0,37,1
1650645976117,CSE 8A,A50,083650,Miranda; Gregory Joseph,0,30,40,40
1650645982144,CSE 11,A01,083080,Cao; Yingjun,0,95,40,40
1650645988170,CSE 12,A01,083652,Staff,0,19,100,100
1650645994286,CSE 15L,A01,083654,Staff,0,2,50,50
1650645994286,CSE 15L,A02,083655,Staff,0,1,50,50
1650646000311,CSE 20,A01,083657,Staff,51,0,80,29
1650646006334,CSE 30,A01,083084,Eldon; John,0,77,40,40
1650646012362,CSE 100,A01,083659,Cao; Yingjun,0,69,50,50
1650646018384,CSE 134B,A01,083661,Powell; Thomas Allan,0,36,65,65
1650646024408,CSE 140,A01,083663,Staff,0,8,75,75
1650646030447,CSE 140L,A01,083088,Eldon; John,0,16,75,75
1650646036472,CSE 175,A01,083665,Kumar; Rakesh,7,0,25,18
1650646042495,CSE 190,A00,092507,Dubnov; Shlomo,10,0,20,10
1650646048519,ECE 45,A01,083139,Staff,0,1,60,60
1650646054541,ECE 65,A50,083695,Staff,0,5,30,30
1650646060573,ECE 109,A01,091882,Touri; Behrouz,33,0,70,37
1650646066603,ECE 180,A00,083140,Abi Samra; Nicholas Camill,21,0,30,9
1650646066603,ECE 180,B00,083141,Abi Samra; Nicholas Camill,0,0,30,30
1650646072631,MATH 10A,A01,083735,Patchell; Gregory David,3,0,30,27
1650646072631,MATH 10A,A02,083736,Patchell; Gregory David,27,0,30,3
1650646072631,MATH 10A,A03,083737,Patchell; Gregory David,24,0,30,6
1650646078662,MATH 10B,A01,083207,Staff,0,8,30,30
1650646078662,MATH 10B,A02,083208,Staff,0,8,30,30
1650646078662,MATH 10B,B01,083739,Staff,11,0,30,19
1650646078662,MATH 10B,B02,083740,Staff,28,0,30,2
1650646084691,MATH 18,A01,083743,Staff,0,0,30,30
1650646084691,MATH 18,A02,083744,Staff,23,0,30,7
1650646084691,MATH 18,A03,083745,Staff,21,0,30,9
1650646084691,MATH 18,A04,083746,Staff,26,0,30,4
1650646084691,MATH 18,B01,083748,Staff,0,15,30,30
1650646084691,MATH 18,B02,083749,Staff,0,11,30,30
1650646084691,MATH 18,B03,083750,Staff,0,12,30,30
1650646084691,MATH 18,B04,083751,Staff,0,12,30,30
1650646090716,MATH 20A,A01,083754,Staff,19,0,40,21
1650646096744,MATH 20B,A01,083756,Staff,0,12,30,30
1650646096744,MATH 20B,A02,083757,Staff,0,12,30,30
1650646102771,MATH 20C,A01,083760,Staff,0,15,30,30
1650646102771,MATH 20C,A02,083761,Staff,1,13,30,29
1650646102771,MATH 20C,B01,083762,Staff,11,0,30,19
1650646102771,MATH 20C,B02,083763,Staff,28,0,30,2
1650646108794,MATH 20D,A01,083765,Staff,1,1,30,29
1650646108794,MATH 20D,A02,083766,Staff,7,0,30,23
1650646108794,MATH 20D,A03,083767,Staff,24,0,30,6
1650646114818,MATH 20E,A01,083771,Staff,3,0,30,27
1650646114818,MATH 20E,A02,083772,Staff,17,0,30,13
1650646114818,MATH 20E,B01,083773,Staff,0,0,30,30
1650646114818,MATH 20E,B02,083774,Staff,9,0,30,21
1650646120853,MATH 103A,A01,083777,Staff,0,15,30,30
1650646120853,MATH 103A,A02,083778,Staff,0,15,30,30
1650646120853,MATH 103A,B01,083779,Staff,0,14,30,30
1650646120853,MATH 103A,B02,083780,Staff,0,14,30,30
1650646126879,MATH 105,A01,085443,Staff,0,22,30,30
1650646132906,MATH 109,A01,083213,Anzaldo; Leesa B,0,7,30,30
1650646132906,MATH 109,A02,083214,Anzaldo; Leesa B,0,7,30,30
1650646132906,MATH 109,B01,083215,Anzaldo; Leesa B,0,6,30,30
1650646132906,MATH 109,B02,083216,Anzaldo; Leesa B,0,6,30,30
1650646138930,MATH 142A,A01,083219,Chow; Bennett,0,16,30,30
1650646138930,MATH 142A,A02,083220,Chow; Bennett,0,15,30,30
1650646138930,MATH 142A,B01,083221,Chow; Bennett,0,14,30,30
1650646138930,MATH 142A,B02,083222,Chow; Bennett,0,13,30,30
1650646144960,MATH 193A,A01,083224,Staff,0,5,30,30
1650646144960,MATH 193A,A02,083225,Staff,0,6,30,30
1650646144960,MATH 193A,A03,083781,Staff,0,6,30,30
1650646144960,MATH 193A,A04,083782,Staff,0,7,30,30
1650646150988,MATH 197,001,091859,McAuley; Julian John,9998,0,9999,1
1650646157058,COGS 9,A01,083615,Staff,1,15,60,59
1650646163085,COGS 11,A01,083617,Boyle; Mary E. T.,18,0,40,22
1650646169111,COGS 13,A01,083071,Staff,0,38,40,40
1650646175147,COGS 14A,A01,092681,Staff,0,31,100,100
1650646181180,COGS 14B,A01,083073,Cheng; Tzu-Han,0,13,50,50
1650646187203,COGS 17,A01,092677,Staff,17,0,75,58
1650646193236,COGS 100,A01,083619,Staff,0,27,60,60
1650646199260,COGS 101A,A01,083621,Davis; Joshua Daniel,0,26,60,60
1650646205287,COGS 101B,A01,091572,Staff,0,4,60,60
1650646211326,COGS 101C,A01,083625,Delgado; Tania,15,0,30,15
1650646217354,COGS 107A,A01,083627,Boyle; Mary E. T.,1,15,60,59
1650646223382,COGS 118A,A01,083075,Staff,0,6,60,60
1650646229411,CSE 3,A50,083646,Miranda; Gregory Joseph,19,0,38,19
1650646229411,CSE 3,A51,083647,Miranda; Gregory Joseph,36,0,37,1
1650646235435,CSE 8A,A50,083650,Miranda; Gregory Joseph,0,30,40,40
1650646241459,CSE 11,A01,083080,Cao; Yingjun,0,95,40,40
1650646247491,CSE 12,A01,083652,Staff,0,19,100,100
1650646253517,CSE 15L,A01,083654,Staff,0,2,50,50
1650646253517,CSE 15L,A02,083655,Staff,0,1,50,50
1650646259540,CSE 20,A01,083657,Staff,51,0,80,29
1650646265565,CSE 30,A01,083084,Eldon; John,0,77,40,40
1650646271586,CSE 100,A01,083659,Cao; Yingjun,0,69,50,50
1650646277610,CSE 134B,A01,083661,Powell; Thomas Allan,0,36,65,65
1650646283635,CSE 140,A01,083663,Staff,0,8,75,75
1650646289661,CSE 140L,A01,083088,Eldon; John,0,16,75,75
1650646295695,CSE 175,A01,083665,Kumar; Rakesh,7,0,25,18
1650646301728,CSE 190,A00,092507,Dubnov; Shlomo,10,0,20,10
1650646307754,ECE 45,A01,083139,Staff,0,1,60,60
1650646313778,ECE 65,A50,083695,Staff,0,5,30,30
1650646319803,ECE 109,A01,091882,Touri; Behrouz,33,0,70,37
1650646325826,ECE 180,A00,083140,Abi Samra; Nicholas Camill,21,0,30,9
1650646325826,ECE 180,B00,083141,Abi Samra; Nicholas Camill,0,0,30,30
1650646331851,MATH 10A,A01,083735,Patchell; Gregory David,3,0,30,27
1650646331851,MATH 10A,A02,083736,Patchell; Gregory David,27,0,30,3
1650646331851,MATH 10A,A03,083737,Patchell; Gregory David,24,0,30,6
1650646337878,MATH 10B,A01,083207,Staff,0,8,30,30
1650646337878,MATH 10B,A02,083208,Staff,0,8,30,30
1650646337878,MATH 10B,B01,083739,Staff,11,0,30,19
1650646337878,MATH 10B,B02,083740,Staff,28,0,30,2
1650646343906,MATH 18,A01,083743,Staff,0,0,30,30
1650646343906,MATH 18,A02,083744,Staff,23,0,30,7
1650646343906,MATH 18,A03,083745,Staff,21,0,30,9
1650646343906,MATH 18,A04,083746,Staff,26,0,30,4
1650646343906,MATH 18,B01,083748,Staff,0,15,30,30
1650646343906,MATH 18,B02,083749,Staff,0,11,30,30
1650646343906,MATH 18,B03,083750,Staff,0,12,30,30
1650646343906,MATH 18,B04,083751,Staff,0,12,30,30
1650646349932,MATH 20A,A01,083754,Staff,19,0,40,21
1650646355957,MATH 20B,A01,083756,Staff,0,12,30,30
1650646355957,MATH 20B,A02,083757,Staff,0,12,30,30
1650646361981,MATH 20C,A01,083760,Staff,0,15,30,30
1650646361981,MATH 20C,A02,083761,Staff,1,13,30,29
1650646361981,MATH 20C,B01,083762,Staff,11,0,30,19
1650646361981,MATH 20C,B02,083763,Staff,28,0,30,2
1650646368006,MATH 20D,A01,083765,Staff,1,1,30,29
1650646368006,MATH 20D,A02,083766,Staff,7,0,30,23
1650646368006,MATH 20D,A03,083767,Staff,24,0,30,6
1650646374031,MATH 20E,A01,083771,Staff,3,0,30,27
1650646374031,MATH 20E,A02,083772,Staff,17,0,30,13
1650646374031,MATH 20E,B01,083773,Staff,0,0,30,30
1650646374031,MATH 20E,B02,083774,Staff,9,0,30,21
1650646380059,MATH 103A,A01,083777,Staff,0,15,30,30
1650646380059,MATH 103A,A02,083778,Staff,0,15,30,30
1650646380059,MATH 103A,B01,083779,Staff,0,14,30,30
1650646380059,MATH 103A,B02,083780,Staff,0,14,30,30
1650646386091,MATH 105,A01,085443,Staff,0,22,30,30
1650646392116,MATH 109,A01,083213,Anzaldo; Leesa B,0,7,30,30
1650646392116,MATH 109,A02,083214,Anzaldo; Leesa B,0,7,30,30
1650646392116,MATH 109,B01,083215,Anzaldo; Leesa B,0,6,30,30
1650646392116,MATH 109,B02,083216,Anzaldo; Leesa B,0,6,30,30
1650646398149,MATH 142A,A01,083219,Chow; Bennett,0,16,30,30
1650646398149,MATH 142A,A02,083220,Chow; Bennett,0,15,30,30
1650646398149,MATH 142A,B01,083221,Chow; Bennett,0,14,30,30
1650646398149,MATH 142A,B02,083222,Chow; Bennett,0,13,30,30
1650646404175,MATH 193A,A01,083224,Staff,0,5,30,30
1650646404175,MATH 193A,A02,083225,Staff,0,6,30,30
1650646404175,MATH 193A,A03,083781,Staff,0,6,30,30
1650646404175,MATH 193A,A04,083782,Staff,0,7,30,30
1650646410214,MATH 197,001,091859,McAuley; Julian John,9998,0,9999,1
1650646416269,COGS 9,A01,083615,Staff,1,15,60,59
1650646422310,COGS 11,A01,083617,Boyle; Mary E. T.,18,0,40,22
1650646428334,COGS 13,A01,083071,Staff,0,38,40,40
1650646434361,COGS 14A,A01,092681,Staff,0,31,100,100
1650646440384,COGS 14B,A01,083073,Cheng; Tzu-Han,0,13,50,50
1650646446410,COGS 17,A01,092677,Staff,17,0,75,58
1650646452438,COGS 100,A01,083619,Staff,0,27,60,60
1650646458461,COGS 101A,A01,083621,Davis; Joshua Daniel,0,26,60,60
1650646464488,COGS 101B,A01,091572,Staff,0,4,60,60
1650646470513,COGS 101C,A01,083625,Delgado; Tania,15,0,30,15
1650646476539,COGS 107A,A01,083627,Boyle; Mary E. T.,1,15,60,59
1650646482563,COGS 118A,A01,083075,Staff,0,6,60,60
1650646488601,CSE 3,A50,083646,Miranda; Gregory Joseph,19,0,38,19
1650646488601,CSE 3,A51,083647,Miranda; Gregory Joseph,36,0,37,1
1650646494630,CSE 8A,A50,083650,Miranda; Gregory Joseph,0,30,40,40
1650646500654,CSE 11,A01,083080,Cao; Yingjun,0,95,40,40
1650646506679,CSE 12,A01,083652,Staff,0,19,100,100
1650646512716,CSE 15L,A01,083654,Staff,0,2,50,50
1650646512716,CSE 15L,A02,083655,Staff,0,1,50,50
1650646518745,CSE 20,A01,083657,Staff,51,0,80,29
1650646524768,CSE 30,A01,083084,Eldon; John,0,77,40,40
1650646530791,CSE 100,A01,083659,Cao; Yingjun,0,69,50,50
1650646536816,CSE 134B,A01,083661,Powell; Thomas Allan,0,36,65,65
1650646542851,CSE 140,A01,083663,Staff,0,8,75,75
1650646548874,CSE 140L,A01,083088,Eldon; John,0,16,75,75
1650646554902,CSE 175,A01,083665,Kumar; Rakesh,7,0,25,18
1650646560929,CSE 190,A00,092507,Dubnov; Shlomo,10,0,20,10
1650646566956,ECE 45,A01,083139,Staff,0,1,60,60
1650646572983,ECE 65,A50,083695,Staff,0,5,30,30
1650646579007,ECE 109,A01,091882,Touri; Behrouz,33,0,70,37
1650646585033,ECE 180,A00,083140,Abi Samra; Nicholas Camill,21,0,30,9
1650646585033,ECE 180,B00,083141,Abi Samra; Nicholas Camill,0,0,30,30
1650646591137,MATH 10A,A01,083735,Patchell; Gregory David,3,0,30,27
1650646591137,MATH 10A,A02,083736,Patchell; Gregory David,27,0,30,3
1650646591137,MATH 10A,A03,083737,Patchell; Gregory David,24,0,30,6
1650646597165,MATH 10B,A01,083207,Staff,0,8,30,30
1650646597165,MATH 10B,A02,083208,Staff,0,8,30,30
1650646597165,MATH 10B,B01,083739,Staff,11,0,30,19
1650646597165,MATH 10B,B02,083740,Staff,28,0,30,2
1650646603189,MATH 18,A01,083743,Staff,0,0,30,30
1650646603189,MATH 18,A02,083744,Staff,23,0,30,7
1650646603189,MATH 18,A03,083745,Staff,21,0,30,9
1650646603189,MATH 18,A04,083746,Staff,26,0,30,4
1650646603189,MATH 18,B01,083748,Staff,0,15,30,30
1650646603189,MATH 18,B02,083749,Staff,0,11,30,30
1650646603189,MATH 18,B03,083750,Staff,0,12,30,30
1650646603189,MATH 18,B04,083751,Staff,0,12,30,30
1650646609213,MATH 20A,A01,083754,Staff,19,0,40,21
1650646615237,MATH 20B,A01,083756,Staff,0,12,30,30
1650646615237,MATH 20B,A02,083757,Staff,0,12,30,30
1650646621260,MATH 20C,A01,083760,Staff,0,15,30,30
1650646621260,MATH 20C,A02,083761,Staff,1,13,30,29
1650646621260,MATH 20C,B01,083762,Staff,11,0,30,19
1650646621260,MATH 20C,B02,083763,Staff,28,0,30,2
1650646627283,MATH 20D,A01,083765,Staff,1,1,30,29
1650646627283,MATH 20D,A02,083766,Staff,7,0,30,23
1650646627283,MATH 20D,A03,083767,Staff,24,0,30,6
1650646633307,MATH 20E,A01,083771,Staff,3,0,30,27
1650646633307,MATH 20E,A02,083772,Staff,17,0,30,13
1650646633307,MATH 20E,B01,083773,Staff,0,0,30,30
1650646633307,MATH 20E,B02,083774,Staff,9,0,30,21
1650646639338,MATH 103A,A01,083777,Staff,0,15,30,30
1650646639338,MATH 103A,A02,083778,Staff,0,15,30,30
1650646639338,MATH 103A,B01,083779,Staff,0,14,30,30
1650646639338,MATH 103A,B02,083780,Staff,0,14,30,30
1650646645362,MATH 105,A01,085443,Staff,0,22,30,30
1650646651386,MATH 109,A01,083213,Anzaldo; Leesa B,0,7,30,30
1650646651386,MATH 109,A02,083214,Anzaldo; Leesa B,0,7,30,30
1650646651386,MATH 109,B01,083215,Anzaldo; Leesa B,0,6,30,30
1650646651386,MATH 109,B02,083216,Anzaldo; Leesa B,0,6,30,30
1650646657412,MATH 142A,A01,083219,Chow; Bennett,0,16,30,30
1650646657412,MATH 142A,A02,083220,Chow; Bennett,0,15,30,30
1650646657412,MATH 142A,B01,083221,Chow; Bennett,0,14,30,30
1650646657412,MATH 142A,B02,083222,Chow; Bennett,0,13,30,30
1650646663436,MATH 193A,A01,083224,Staff,0,5,30,30
1650646663436,MATH 193A,A02,083225,Staff,0,6,30,30
1650646663436,MATH 193A,A03,083781,Staff,0,6,30,30
1650646663436,MATH 193A,A04,083782,Staff,0,7,30,30
1650646669463,MATH 197,001,091859,McAuley; Julian John,9998,0,9999,1
1650646675523,COGS 9,A01,083615,Staff,1,15,60,59
1650646681555,COGS 11,A01,083617,Boyle; Mary E. T.,18,0,40,22
1650646687580,COGS 13,A01,083071,Staff,0,38,40,40
1650646693608,COGS 14A,A01,092681,Staff,0,31,100,100
1650646699637,COGS 14B,A01,083073,Cheng; Tzu-Han,0,13,50,50
1650646705661,COGS 17,A01,092677,Staff,17,0,75,58
1650646711691,COGS 100,A01,083619,Staff,0,27,60,60
1650646717724,COGS 101A,A01,083621,Davis; Joshua Daniel,0,26,60,60
1650646723747,COGS 101B,A01,091572,Staff,0,4,60,60
1650646729781,COGS 101C,A01,083625,Delgado; Tania,15,0,30,15
1650646735812,COGS 107A,A01,083627,Boyle; Mary E. T.,1,15,60,59
1650646741838,COGS 118A,A01,083075,Staff,0,6,60,60
1650646747869,CSE 3,A50,083646,Miranda; Gregory Joseph,19,0,38,19
1650646747869,CSE 3,A51,083647,Miranda; Gregory Joseph,36,0,37,1
1650646753899,CSE 8A,A50,083650,Miranda; Gregory Joseph,0,30,40,40
1650646759922,CSE 11,A01,083080,Cao; Yingjun,0,95,40,40
1650646765949,CSE 12,A01,083652,Staff,0,19,100,100
1650646771971,CSE 15L,A01,083654,Staff,0,2,50,50
1650646771971,CSE 15L,A02,083655,Staff,0,1,50,50
1650646778002,CSE 20,A01,083657,Staff,51,0,80,29
1650646784025,CSE 30,A01,083084,Eldon; John,0,77,40,40
1650646790048,CSE 100,A01,083659,Cao; Yingjun,0,69,50,50
1650646796073,CSE 134B,A01,083661,Powell; Thomas Allan,0,36,65,65
1650646802096,CSE 140,A01,083663,Staff,0,8,75,75
1650646808119,CSE 140L,A01,083088,Eldon; John,0,16,75,75
1650646814144,CSE 175,A01,083665,Kumar; Rakesh,7,0,25,18
1650646820169,CSE 190,A00,092507,Dubnov; Shlomo,10,0,20,10
1650646826203,ECE 45,A01,083139,Staff,0,1,60,60
1650646832225,ECE 65,A50,083695,Staff,0,5,30,30
1650646838252,ECE 109,A01,091882,Touri; Behrouz,33,0,70,37
1650646844289,ECE 180,A00,083140,Abi Samra; Nicholas Camill,21,0,30,9
1650646844289,ECE 180,B00,083141,Abi Samra; Nicholas Camill,0,0,30,30
1650646850324,MATH 10A,A01,083735,Patchell; Gregory David,3,0,30,27
1650646850324,MATH 10A,A02,083736,Patchell; Gregory David,27,0,30,3
1650646850324,MATH 10A,A03,083737,Patchell; Gregory David,24,0,30,6
1650646856348,MATH 10B,A01,083207,Staff,0,8,30,30
1650646856348,MATH 10B,A02,083208,Staff,0,8,30,30
1650646856348,MATH 10B,B01,083739,Staff,11,0,30,19
1650646856348,MATH 10B,B02,083740,Staff,28,0,30,2
1650646862388,MATH 18,A01,083743,Staff,0,0,30,30
1650646862388,MATH 18,A02,083744,Staff,23,0,30,7
1650646862388,MATH 18,A03,083745,Staff,21,0,30,9
1650646862388,MATH 18,A04,083746,Staff,26,0,30,4
1650646862388,MATH 18,B01,083748,Staff,0,15,30,30
1650646862388,MATH 18,B02,083749,Staff,0,11,30,30
1650646862388,MATH 18,B03,083750,Staff,0,12,30,30
1650646862388,MATH 18,B04,083751,Staff,0,12,30,30
1650646868414,MATH 20A,A01,083754,Staff,19,0,40,21
1650646874447,MATH 20B,A01,083756,Staff,0,12,30,30
1650646874447,MATH 20B,A02,083757,Staff,0,12,30,30
1650646880485,MATH 20C,A01,083760,Staff,0,15,30,30
1650646880485,MATH 20C,A02,083761,Staff,1,13,30,29
1650646880485,MATH 20C,B01,083762,Staff,11,0,30,19
1650646880485,MATH 20C,B02,083763,Staff,28,0,30,2
1650646886515,MATH 20D,A01,083765,Staff,1,1,30,29
1650646886515,MATH 20D,A02,083766,Staff,7,0,30,23
1650646886515,MATH 20D,A03,083767,Staff,24,0,30,6
1650646892544,MATH 20E,A01,083771,Staff,3,0,30,27
1650646892544,MATH 20E,A02,083772,Staff,17,0,30,13
1650646892544,MATH 20E,B01,083773,Staff,0,0,30,30
1650646892544,MATH 20E,B02,083774,Staff,9,0,30,21
1650646898569,MATH 103A,A01,083777,Staff,0,15,30,30
1650646898569,MATH 103A,A02,083778,Staff,0,15,30,30
1650646898569,MATH 103A,B01,083779,Staff,0,14,30,30
1650646898569,MATH 103A,B02,083780,Staff,0,14,30,30
1650646904599,MATH 105,A01,085443,Staff,0,22,30,30
1650646910627,MATH 109,A01,083213,Anzaldo; Leesa B,0,7,30,30
1650646910627,MATH 109,A02,083214,Anzaldo; Leesa B,0,7,30,30
1650646910627,MATH 109,B01,083215,Anzaldo; Leesa B,0,6,30,30
1650646910627,MATH 109,B02,083216,Anzaldo; Leesa B,0,6,30,30
1650646916651,MATH 142A,A01,083219,Chow; Bennett,0,16,30,30
1650646916651,MATH 142A,A02,083220,Chow; Bennett,0,15,30,30
1650646916651,MATH 142A,B01,083221,Chow; Bennett,0,14,30,30
1650646916651,MATH 142A,B02,083222,Chow; Bennett,0,13,30,30
1650646922689,MATH 193A,A01,083224,Staff,0,5,30,30
1650646922689,MATH 193A,A02,083225,Staff,0,6,30,30
1650646922689,MATH 193A,A03,083781,Staff,0,6,30,30
1650646922689,MATH 193A,A04,083782,Staff,0,7,30,30
1650646928721,MATH 197,001,091859,McAuley; Julian John,9998,0,9999,1
1650646934784,COGS 9,A01,083615,Staff,1,15,60,59
1650646940814,COGS 11,A01,083617,Boyle; Mary E. T.,18,0,40,22
1650646946845,COGS 13,A01,083071,Staff,0,38,40,40
1650646952867,COGS 14A,A01,092681,Staff,0,31,100,100
1650646958891,COGS 14B,A01,083073,Cheng; Tzu-Han,0,13,50,50
1650646964913,COGS 17,A01,092677,Staff,17,0,75,58
1650646970935,COGS 100,A01,083619,Staff,0,27,60,60
1650646976962,COGS 101A,A01,083621,Davis; Joshua Daniel,0,26,60,60
1650646982992,COGS 101B,A01,091572,Staff,0,4,60,60
1650646989016,COGS 101C,A01,083625,Delgado; Tania,15,0,30,15
1650646995042,COGS 107A,A01,083627,Boyle; Mary E. T.,1,15,60,59
1650647001065,COGS 118A,A01,083075,Staff,0,6,60,60
1650647007093,CSE 3,A50,083646,Miranda; Gregory Joseph,19,0,38,19
1650647007093,CSE 3,A51,083647,Miranda; Gregory Joseph,36,0,37,1
1650647013130,CSE 8A,A50,083650,Miranda; Gregory Joseph,0,30,40,40
1650647019156,CSE 11,A01,083080,Cao; Yingjun,0,95,40,40
1650647025202,CSE 12,A01,083652,Staff,0,19,100,100
1650647031226,CSE 15L,A01,083654,Staff,0,2,50,50
1650647031226,CSE 15L,A02,083655,Staff,0,1,50,50
1650647037253,CSE 20,A01,083657,Staff,51,0,80,29
1650647043284,CSE 30,A01,083084,Eldon; John,0,77,40,40
1650647049310,CSE 100,A01,083659,Cao; Yingjun,0,69,50,50
1650647055337,CSE 134B,A01,083661,Powell; Thomas Allan,0,36,65,65
1650647061363,CSE 140,A01,083663,Staff,0,8,75,75
1650647067390,CSE 140L,A01,083088,Eldon; John,0,16,75,75
1650647073423,CSE 175,A01,083665,Kumar; Rakesh,7,0,25,18
1650647079455,CSE 190,A00,092507,Dubnov; Shlomo,10,0,20,10
1650647085479,ECE 45,A01,083139,Staff,0,1,60,60
1650647091501,ECE 65,A50,083695,Staff,0,5,30,30
1650647097548,ECE 109,A01,091882,Touri; Behrouz,33,0,70,37
1650647103582,ECE 180,A00,083140,Abi Samra; Nicholas Camill,21,0,30,9
1650647103582,ECE 180,B00,083141,Abi Samra; Nicholas Camill,0,0,30,30
1650647109614,MATH 10A,A01,083735,Patchell; Gregory David,3,0,30,27
1650647109614,MATH 10A,A02,083736,Patchell; Gregory David,27,0,30,3
1650647109614,MATH 10A,A03,083737,Patchell; Gregory David,24,0,30,6
1650647115637,MATH 10B,A01,083207,Staff,0,8,30,30
1650647115637,MATH 10B,A02,083208,Staff,0,8,30,30
1650647115637,MATH 10B,B01,083739,Staff,11,0,30,19
1650647115637,MATH 10B,B02,083740,Staff,28,0,30,2
1650647121672,MATH 18,A01,083743,Staff,0,0,30,30
1650647121672,MATH 18,A02,083744,Staff,23,0,30,7
1650647121672,MATH 18,A03,083745,Staff,21,0,30,9
1650647121672,MATH 18,A04,083746,Staff,26,0,30,4
1650647121672,MATH 18,B01,083748,Staff,0,15,30,30
1650647121672,MATH 18,B02,083749,Staff,0,11,30,30
1650647121672,MATH 18,B03,083750,Staff,0,12,30,30
1650647121672,MATH 18,B04,083751,Staff,0,12,30,30
1650647127701,MATH 20A,A01,083754,Staff,19,0,40,21
1650647133738,MATH 20B,A01,083756,Staff,0,12,30,30
1650647133738,MATH 20B,A02,083757,Staff,0,12,30,30
1650647139762,MATH 20C,A01,083760,Staff,0,15,30,30
1650647139762,MATH 20C,A02,083761,Staff,1,13,30,29
1650647139762,MATH 20C,B01,083762,Staff,11,0,30,19
1650647139762,MATH 20C,B02,083763,Staff,28,0,30,2
1650647145791,MATH 20D,A01,083765,Staff,1,1,30,29
1650647145791,MATH 20D,A02,083766,Staff,6,0,30,24
1650647145791,MATH 20D,A03,083767,Staff,24,0,30,6
1650647151816,MATH 20E,A01,083771,Staff,3,0,30,27
1650647151816,MATH 20E,A02,083772,Staff,17,0,30,13
1650647151816,MATH 20E,B01,083773,Staff,0,0,30,30
1650647151816,MATH 20E,B02,083774,Staff,9,0,30,21
1650647157844,MATH 103A,A01,083777,Staff,0,15,30,30
1650647157844,MATH 103A,A02,083778,Staff,0,15,30,30
1650647157844,MATH 103A,B01,083779,Staff,0,14,30,30
1650647157844,MATH 103A,B02,083780,Staff,0,14,30,30
1650647163869,MATH 105,A01,085443,Staff,0,22,30,30
1650647169907,MATH 109,A01,083213,Anzaldo; Leesa B,0,7,30,30
1650647169907,MATH 109,A02,083214,Anzaldo; Leesa B,0,7,30,30
1650647169907,MATH 109,B01,083215,Anzaldo; Leesa B,0,6,30,30
1650647169907,MATH 109,B02,083216,Anzaldo; Leesa B,0,6,30,30
1650647175932,MATH 142A,A01,083219,Chow; Bennett,0,16,30,30
1650647175932,MATH 142A,A02,083220,Chow; Bennett,0,15,30,30
1650647175932,MATH 142A,B01,083221,Chow; Bennett,0,14,30,30
1650647175932,MATH 142A,B02,083222,Chow; Bennett,0,13,30,30
1650647181959,MATH 193A,A01,083224,Staff,0,5,30,30
1650647181959,MATH 193A,A02,083225,Staff,0,6,30,30
1650647181959,MATH 193A,A03,083781,Staff,0,6,30,30
1650647181959,MATH 193A,A04,083782,Staff,0,7,30,30
1650647188084,MATH 197,001,091859,McAuley; Julian John,9998,0,9999,1
1650647194143,COGS 9,A01,083615,Staff,1,15,60,59
1650647200166,COGS 11,A01,083617,Boyle; Mary E. T.,18,0,40,22
1650647206190,COGS 13,A01,083071,Staff,0,38,40,40
1650647212225,COGS 14A,A01,092681,Staff,0,31,100,100
1650647218253,COGS 14B,A01,083073,Cheng; Tzu-Han,0,13,50,50
1650647224291,COGS 17,A01,092677,Staff,17,0,75,58
1650647230318,COGS 100,A01,083619,Staff,0,27,60,60
1650647236359,COGS 101A,A01,083621,Davis; Joshua Daniel,0,26,60,60
1650647242386,COGS 101B,A01,091572,Staff,0,4,60,60
1650647248418,COGS 101C,A01,083625,Delgado; Tania,15,0,30,15
1650647254454,COGS 107A,A01,083627,Boyle; Mary E. T.,1,15,60,59
1650647260479,COGS 118A,A01,083075,Staff,0,6,60,60
1650647266510,CSE 3,A50,083646,Miranda; Gregory Joseph,19,0,38,19
1650647266510,CSE 3,A51,083647,Miranda; Gregory Joseph,36,0,37,1
1650647272537,CSE 8A,A50,083650,Miranda; Gregory Joseph,0,30,40,40
1650647278562,CSE 11,A01,083080,Cao; Yingjun,0,95,40,40
1650647284590,CSE 12,A01,083652,Staff,0,19,100,100
1650647290619,CSE 15L,A01,083654,Staff,0,2,50,50
1650647290619,CSE 15L,A02,083655,Staff,0,1,50,50
1650647296648,CSE 20,A01,083657,Staff,51,0,80,29
1650647302680,CSE 30,A01,083084,Eldon; John,0,77,40,40
1650647308704,CSE 100,A01,083659,Cao; Yingjun,0,69,50,50
1650647314728,CSE 134B,A01,083661,Powell; Thomas Allan,0,36,65,65
1650647320758,CSE 140,A01,083663,Staff,0,8,75,75
1650647326782,CSE 140L,A01,083088,Eldon; John,0,16,75,75
1650647332807,CSE 175,A01,083665,Kumar; Rakesh,7,0,25,18
1650647338832,CSE 190,A00,092507,Dubnov; Shlomo,10,0,20,10
1650647344859,ECE 45,A01,083139,Staff,0,1,60,60
1650647350882,ECE 65,A50,083695,Staff,0,5,30,30
1650647356908,ECE 109,A01,091882,Touri; Behrouz,33,0,70,37
1650647362933,ECE 180,A00,083140,Abi Samra; Nicholas Camill,21,0,30,9
1650647362933,ECE 180,B00,083141,Abi Samra; Nicholas Camill,0,0,30,30
1650647368961,MATH 10A,A01,083735,Patchell; Gregory David,3,0,30,27
1650647368961,MATH 10A,A02,083736,Patchell; Gregory David,27,0,30,3
1650647368961,MATH 10A,A03,083737,Patchell; Gregory David,24,0,30,6
1650647374992,MATH 10B,A01,083207,Staff,0,8,30,30
1650647374992,MATH 10B,A02,083208,Staff,0,8,30,30
1650647374992,MATH 10B,B01,083739,Staff,11,0,30,19
1650647374992,MATH 10B,B02,083740,Staff,28,0,30,2
1650647381031,MATH 18,A01,083743,Staff,0,0,30,30
1650647381031,MATH 18,A02,083744,Staff,23,0,30,7
1650647381031,MATH 18,A03,083745,Staff,21,0,30,9
1650647381031,MATH 18,A04,083746,Staff,26,0,30,4
1650647381031,MATH 18,B01,083748,Staff,0,15,30,30
1650647381031,MATH 18,B02,083749,Staff,0,11,30,30
1650647381031,MATH 18,B03,083750,Staff,0,12,30,30
1650647381031,MATH 18,B04,083751,Staff,0,12,30,30
1650647387059,MATH 20A,A01,083754,Staff,19,0,40,21
1650647393103,MATH 20B,A01,083756,Staff,0,12,30,30
1650647393103,MATH 20B,A02,083757,Staff,0,12,30,30
1650647399132,MATH 20C,A01,083760,Staff,0,15,30,30
1650647399132,MATH 20C,A02,083761,Staff,1,13,30,29
1650647399132,MATH 20C,B01,083762,Staff,11,0,30,19
1650647399132,MATH 20C,B02,083763,Staff,28,0,30,2
1650647405155,MATH 20D,A01,083765,Staff,1,1,30,29
1650647405155,MATH 20D,A02,083766,Staff,6,0,30,24
1650647405155,MATH 20D,A03,083767,Staff,24,0,30,6
1650647411183,MATH 20E,A01,083771,Staff,3,0,30,27
1650647411183,MATH 20E,A02,083772,Staff,16,0,30,14
1650647411183,MATH 20E,B01,083773,Staff,0,0,30,30
1650647411183,MATH 20E,B02,083774,Staff,9,0,30,21
1650647417209,MATH 103A,A01,083777,Staff,0,15,30,30
1650647417209,MATH 103A,A02,083778,Staff,0,15,30,30
1650647417209,MATH 103A,B01,083779,Staff,0,14,30,30
1650647417209,MATH 103A,B02,083780,Staff,0,14,30,30
1650647423239,MATH 105,A01,085443,Staff,0,22,30,30
1650647429266,MATH 109,A01,083213,Anzaldo; Leesa B,0,7,30,30
1650647429266,MATH 109,A02,083214,Anzaldo; Leesa B,0,7,30,30
1650647429266,MATH 109,B01,083215,Anzaldo; Leesa B,0,6,30,30
1650647429266,MATH 109,B02,083216,Anzaldo; Leesa B,0,6,30,30
1650647435296,MATH 142A,A01,083219,Chow; Bennett,0,16,30,30
1650647435296,MATH 142A,A02,083220,Chow; Bennett,0,15,30,30
1650647435296,MATH 142A,B01,083221,Chow; Bennett,0,14,30,30
1650647435296,MATH 142A,B02,083222,Chow; Bennett,0,13,30,30
1650647441319,MATH 193A,A01,083224,Staff,0,5,30,30
1650647441319,MATH 193A,A02,083225,Staff,0,6,30,30
1650647441319,MATH 193A,A03,083781,Staff,0,6,30,30
1650647441319,MATH 193A,A04,083782,Staff,0,7,30,30
1650647447348,MATH 197,001,091859,McAuley; Julian John,9998,0,9999,1
1650647453414,COGS 9,A01,083615,Staff,1,15,60,59
1650647459438,COGS 11,A01,083617,Boyle; Mary E. T.,18,0,40,22
1650647465461,COGS 13,A01,083071,Staff,0,38,40,40
1650647471486,COGS 14A,A01,092681,Staff,0,31,100,100
1650647477508,COGS 14B,A01,083073,Cheng; Tzu-Han,0,13,50,50
1650647483532,COGS 17,A01,092677,Staff,17,0,75,58
1650647489556,COGS 100,A01,083619,Staff,0,27,60,60
1650647495580,COGS 101A,A01,083621,Davis; Joshua Daniel,0,26,60,60
1650647501606,COGS 101B,A01,091572,Staff,0,4,60,60
1650647507630,COGS 101C,A01,083625,Delgado; Tania,15,0,30,15
1650647513654,COGS 107A,A01,083627,Boyle; Mary E. T.,1,15,60,59
1650647519678,COGS 118A,A01,083075,Staff,0,6,60,60
1650647525711,CSE 3,A50,083646,Miranda; Gregory Joseph,19,0,38,19
1650647525711,CSE 3,A51,083647,Miranda; Gregory Joseph,36,0,37,1
1650647531739,CSE 8A,A50,083650,Miranda; Gregory Joseph,0,30,40,40
1650647537766,CSE 11,A01,083080,Cao; Yingjun,0,95,40,40
1650647543789,CSE 12,A01,083652,Staff,0,19,100,100
1650647549814,CSE 15L,A01,083654,Staff,0,2,50,50
1650647549814,CSE 15L,A02,083655,Staff,0,1,50,50
1650647555840,CSE 20,A01,083657,Staff,51,0,80,29
1650647561879,CSE 30,A01,083084,Eldon; John,0,77,40,40
1650647567905,CSE 100,A01,083659,Cao; Yingjun,0,69,50,50
1650647573932,CSE 134B,A01,083661,Powell; Thomas Allan,0,37,65,65
1650647579960,CSE 140,A01,083663,Staff,0,8,75,75
1650647585987,CSE 140L,A01,083088,Eldon; John,0,16,75,75
1650647592011,CSE 175,A01,083665,Kumar; Rakesh,7,0,25,18
1650647598036,CSE 190,A00,092507,Dubnov; Shlomo,10,0,20,10
1650647604060,ECE 45,A01,083139,Staff,0,1,60,60
1650647610087,ECE 65,A50,083695,Staff,0,5,30,30
1650647616110,ECE 109,A01,091882,Touri; Behrouz,33,0,70,37
1650647622136,ECE 180,A00,083140,Abi Samra; Nicholas Camill,21,0,30,9
1650647622136,ECE 180,B00,083141,Abi Samra; Nicholas Camill,0,0,30,30
1650647628170,MATH 10A,A01,083735,Patchell; Gregory David,3,0,30,27
1650647628170,MATH 10A,A02,083736,Patchell; Gregory David,27,0,30,3
1650647628170,MATH 10A,A03,083737,Patchell; Gregory David,24,0,30,6
1650647634194,MATH 10B,A01,083207,Staff,0,8,30,30
1650647634194,MATH 10B,A02,083208,Staff,0,8,30,30
1650647634194,MATH 10B,B01,083739,Staff,11,0,30,19
1650647634194,MATH 10B,B02,083740,Staff,28,0,30,2
1650647640221,MATH 18,A01,083743,Staff,0,0,30,30
1650647640221,MATH 18,A02,083744,Staff,23,0,30,7
1650647640221,MATH 18,A03,083745,Staff,21,0,30,9
1650647640221,MATH 18,A04,083746,Staff,26,0,30,4
1650647640221,MATH 18,B01,083748,Staff,0,15,30,30
1650647640221,MATH 18,B02,083749,Staff,0,11,30,30
1650647640221,MATH 18,B03,083750,Staff,0,12,30,30
1650647640221,MATH 18,B04,083751,Staff,0,12,30,30
1650647646248,MATH 20A,A01,083754,Staff,19,0,40,21
1650647652272,MATH 20B,A01,083756,Staff,0,12,30,30
1650647652272,MATH 20B,A02,083757,Staff,0,12,30,30
1650647658296,MATH 20C,A01,083760,Staff,0,15,30,30
1650647658296,MATH 20C,A02,083761,Staff,1,13,30,29
1650647658296,MATH 20C,B01,083762,Staff,11,0,30,19
1650647658296,MATH 20C,B02,083763,Staff,28,0,30,2
1650647664331,MATH 20D,A01,083765,Staff,1,1,30,29
1650647664331,MATH 20D,A02,083766,Staff,6,0,30,24
1650647664331,MATH 20D,A03,083767,Staff,24,0,30,6
1650647670367,MATH 20E,A01,083771,Staff,3,0,30,27
1650647670367,MATH 20E,A02,083772,Staff,16,0,30,14
1650647670367,MATH 20E,B01,083773,Staff,0,0,30,30
1650647670367,MATH 20E,B02,083774,Staff,9,0,30,21
1650647676392,MATH 103A,A01,083777,Staff,0,15,30,30
1650647676392,MATH 103A,A02,083778,Staff,0,15,30,30
1650647676392,MATH 103A,B01,083779,Staff,0,14,30,30
1650647676392,MATH 103A,B02,083780,Staff,0,14,30,30
1650647682413,MATH 105,A01,085443,Staff,0,22,30,30
1650647688444,MATH 109,A01,083213,Anzaldo; Leesa B,0,7,30,30
1650647688444,MATH 109,A02,083214,Anzaldo; Leesa B,0,7,30,30
1650647688444,MATH 109,B01,083215,Anzaldo; Leesa B,0,6,30,30
1650647688444,MATH 109,B02,083216,Anzaldo; Leesa B,0,6,30,30
1650647694486,MATH 142A,A01,083219,Chow; Bennett,0,16,30,30
1650647694486,MATH 142A,A02,083220,Chow; Bennett,0,15,30,30
1650647694486,MATH 142A,B01,083221,Chow; Bennett,0,14,30,30
1650647694486,MATH 142A,B02,083222,Chow; Bennett,0,13,30,30
1650647700514,MATH 193A,A01,083224,Staff,0,5,30,30
1650647700514,MATH 193A,A02,083225,Staff,0,6,30,30
1650647700514,MATH 193A,A03,083781,Staff,0,6,30,30
1650647700514,MATH 193A,A04,083782,Staff,0,7,30,30
1650647706538,MATH 197,001,091859,McAuley; Julian John,9998,0,9999,1
1650647712601,COGS 9,A01,083615,Staff,1,15,60,59
1650647718627,COGS 11,A01,083617,Boyle; Mary E. T.,18,0,40,22
1650647724661,COGS 13,A01,083071,Staff,0,38,40,40
1650647730698,COGS 14A,A01,092681,Staff,0,31,100,100
1650647736771,COGS 14B,A01,083073,Cheng; Tzu-Han,0,13,50,50
1650647742797,COGS 17,A01,092677,Staff,17,0,75,58
1650647748828,COGS 100,A01,083619,Staff,0,27,60,60
1650647754855,COGS 101A,A01,083621,Davis; Joshua Daniel,0,26,60,60
1650647760884,COGS 101B,A01,091572,Staff,0,4,60,60
1650647766909,COGS 101C,A01,083625,Delgado; Tania,15,0,30,15
1650647772938,COGS 107A,A01,083627,Boyle; Mary E. T.,1,15,60,59
1650647779055,COGS 118A,A01,083075,Staff,0,6,60,60
1650647785080,CSE 3,A50,083646,Miranda; Gregory Joseph,19,0,38,19
1650647785080,CSE 3,A51,083647,Miranda; Gregory Joseph,36,0,37,1
1650647791109,CSE 8A,A50,083650,Miranda; Gregory Joseph,0,30,40,40
1650647797147,CSE 11,A01,083080,Cao; Yingjun,0,95,40,40
1650647803173,CSE 12,A01,083652,Staff,0,19,100,100
1650647809207,CSE 15L,A01,083654,Staff,0,2,50,50
1650647809207,CSE 15L,A02,083655,Staff,0,1,50,50
1650647815232,CSE 20,A01,083657,Staff,51,0,80,29
1650647821269,CSE 30,A01,083084,Eldon; John,0,77,40,40
1650647827311,CSE 100,A01,083659,Cao; Yingjun,0,69,50,50
1650647833337,CSE 134B,A01,083661,Powell; Thomas Allan,0,37,65,65
1650647839368,CSE 140,A01,083663,Staff,0,8,75,75
1650647845394,CSE 140L,A01,083088,Eldon; John,0,16,75,75
1650647851425,CSE 175,A01,083665,Kumar; Rakesh,7,0,25,18
1650647857450,CSE 190,A00,092507,Dubnov; Shlomo,10,0,20,10
1650647863481,ECE 45,A01,083139,Staff,0,1,60,60
1650647869510,ECE 65,A50,083695,Staff,0,5,30,30
1650647875538,ECE 109,A01,091882,Touri; Behrouz,33,0,70,37
1650647881569,ECE 180,A00,083140,Abi Samra; Nicholas Camill,21,0,30,9
1650647881569,ECE 180,B00,083141,Abi Samra; Nicholas Camill,0,0,30,30
1650647887619,MATH 10A,A01,083735,Patchell; Gregory David,3,0,30,27
1650647887619,MATH 10A,A02,083736,Patchell; Gregory David,27,0,30,3
1650647887619,MATH 10A,A03,083737,Patchell; Gregory David,24,0,30,6
1650647893644,MATH 10B,A01,083207,Staff,0,8,30,30
1650647893644,MATH 10B,A02,083208,Staff,0,8,30,30
1650647893644,MATH 10B,B01,083739,Staff,11,0,30,19
1650647893644,MATH 10B,B02,083740,Staff,28,0,30,2
1650647899678,MATH 18,A01,083743,Staff,0,0,30,30
1650647899678,MATH 18,A02,083744,Staff,23,0,30,7
1650647899678,MATH 18,A03,083745,Staff,21,0,30,9
1650647899678,MATH 18,A04,083746,Staff,26,0,30,4
1650647899678,MATH 18,B01,083748,Staff,0,15,30,30
1650647899678,MATH 18,B02,083749,Staff,0,11,30,30
1650647899678,MATH 18,B03,083750,Staff,0,12,30,30
1650647899678,MATH 18,B04,083751,Staff,0,12,30,30
1650647905702,MATH 20A,A01,083754,Staff,19,0,40,21
1650647911736,MATH 20B,A01,083756,Staff,0,12,30,30
1650647911736,MATH 20B,A02,083757,Staff,0,12,30,30
1650647917761,MATH 20C,A01,083760,Staff,0,15,30,30
1650647917761,MATH 20C,A02,083761,Staff,1,13,30,29
1650647917761,MATH 20C,B01,083762,Staff,11,0,30,19
1650647917761,MATH 20C,B02,083763,Staff,28,0,30,2
1650647923787,MATH 20D,A01,083765,Staff,1,1,30,29
1650647923787,MATH 20D,A02,083766,Staff,6,0,30,24
1650647923787,MATH 20D,A03,083767,Staff,24,0,30,6
1650647929813,MATH 20E,A01,083771,Staff,3,0,30,27
1650647929813,MATH 20E,A02,083772,Staff,16,0,30,14
1650647929813,MATH 20E,B01,083773,Staff,0,0,30,30
1650647929813,MATH 20E,B02,083774,Staff,9,0,30,21
1650647935836,MATH 103A,A01,083777,Staff,0,15,30,30
1650647935836,MATH 103A,A02,083778,Staff,0,15,30,30
1650647935836,MATH 103A,B01,083779,Staff,0,14,30,30
1650647935836,MATH 103A,B02,083780,Staff,0,14,30,30
1650647941864,MATH 105,A01,085443,Staff,0,22,30,30
1650647947888,MATH 109,A01,083213,Anzaldo; Leesa B,0,7,30,30
1650647947888,MATH 109,A02,083214,Anzaldo; Leesa B,0,7,30,30
1650647947888,MATH 109,B01,083215,Anzaldo; Leesa B,0,6,30,30
1650647947888,MATH 109,B02,083216,Anzaldo; Leesa B,0,6,30,30
1650647953913,MATH 142A,A01,083219,Chow; Bennett,0,16,30,30
1650647953913,MATH 142A,A02,083220,Chow; Bennett,0,15,30,30
1650647953913,MATH 142A,B01,083221,Chow; Bennett,0,14,30,30
1650647953913,MATH 142A,B02,083222,Chow; Bennett,0,13,30,30
1650647959938,MATH 193A,A01,083224,Staff,0,5,30,30
1650647959938,MATH 193A,A02,083225,Staff,0,6,30,30
1650647959938,MATH 193A,A03,083781,Staff,0,6,30,30
1650647959938,MATH 193A,A04,083782,Staff,0,7,30,30
1650647965967,MATH 197,001,091859,McAuley; Julian John,9998,0,9999,1
1650647972027,COGS 9,A01,083615,Staff,1,15,60,59
1650647978051,COGS 11,A01,083617,Boyle; Mary E. T.,18,0,40,22
1650647984075,COGS 13,A01,083071,Staff,0,38,40,40
1650647990099,COGS 14A,A01,092681,Staff,0,31,100,100
1650647996132,COGS 14B,A01,083073,Cheng; Tzu-Han,0,13,50,50
1650648002161,COGS 17,A01,092677,Staff,17,0,75,58
1650648008187,COGS 100,A01,083619,Staff,0,27,60,60
1650648014221,COGS 101A,A01,083621,Davis; Joshua Daniel,0,26,60,60
1650648020253,COGS 101B,A01,091572,Staff,0,4,60,60
1650648026283,COGS 101C,A01,083625,Delgado; Tania,15,0,30,15
1650648032304,COGS 107A,A01,083627,Boyle; Mary E. T.,1,15,60,59
1650648038328,COGS 118A,A01,083075,Staff,0,6,60,60
1650648044363,CSE 3,A50,083646,Miranda; Gregory Joseph,19,0,38,19
1650648044363,CSE 3,A51,083647,Miranda; Gregory Joseph,36,0,37,1
1650648050392,CSE 8A,A50,083650,Miranda; Gregory Joseph,0,30,40,40
1650648056418,CSE 11,A01,083080,Cao; Yingjun,0,95,40,40
1650648062442,CSE 12,A01,083652,Staff,0,19,100,100
1650648068472,CSE 15L,A01,083654,Staff,0,2,50,50
1650648068472,CSE 15L,A02,083655,Staff,0,1,50,50
1650648074499,CSE 20,A01,083657,Staff,51,0,80,29
1650648080522,CSE 30,A01,083084,Eldon; John,0,77,40,40
1650648086549,CSE 100,A01,083659,Cao; Yingjun,0,69,50,50
1650648092576,CSE 134B,A01,083661,Powell; Thomas Allan,0,37,65,65
1650648098601,CSE 140,A01,083663,Staff,0,8,75,75
1650648104640,CSE 140L,A01,083088,Eldon; John,0,16,75,75
1650648110684,CSE 175,A01,083665,Kumar; Rakesh,7,0,25,18
1650648116718,CSE 190,A00,092507,Dubnov; Shlomo,10,0,20,10
1650648122743,ECE 45,A01,083139,Staff,0,1,60,60
1650648128783,ECE 65,A50,083695,Staff,0,5,30,30
1650648134814,ECE 109,A01,091882,Touri; Behrouz,33,0,70,37
1650648140838,ECE 180,A00,083140,Abi Samra; Nicholas Camill,21,0,30,9
1650648140838,ECE 180,B00,083141,Abi Samra; Nicholas Camill,0,0,30,30
1650648146869,MATH 10A,A01,083735,Patchell; Gregory David,3,0,30,27
1650648146869,MATH 10A,A02,083736,Patchell; Gregory David,27,0,30,3
1650648146869,MATH 10A,A03,083737,Patchell; Gregory David,24,0,30,6
1650648152894,MATH 10B,A01,083207,Staff,0,8,30,30
1650648152894,MATH 10B,A02,083208,Staff,0,8,30,30
1650648152894,MATH 10B,B01,083739,Staff,11,0,30,19
1650648152894,MATH 10B,B02,083740,Staff,28,0,30,2
1650648158925,MATH 18,A01,083743,Staff,0,0,30,30
1650648158925,MATH 18,A02,083744,Staff,23,0,30,7
1650648158925,MATH 18,A03,083745,Staff,21,0,30,9
1650648158925,MATH 18,A04,083746,Staff,26,0,30,4
1650648158925,MATH 18,B01,083748,Staff,0,15,30,30
1650648158925,MATH 18,B02,083749,Staff,0,11,30,30
1650648158925,MATH 18,B03,083750,Staff,0,12,30,30
1650648158925,MATH 18,B04,083751,Staff,0,12,30,30
1650648164951,MATH 20A,A01,083754,Staff,19,0,40,21
1650648170983,MATH 20B,A01,083756,Staff,0,12,30,30
1650648170983,MATH 20B,A02,083757,Staff,0,12,30,30
1650648177010,MATH 20C,A01,083760,Staff,0,15,30,30
1650648177010,MATH 20C,A02,083761,Staff,1,13,30,29
1650648177010,MATH 20C,B01,083762,Staff,11,0,30,19
1650648177010,MATH 20C,B02,083763,Staff,28,0,30,2
1650648183034,MATH 20D,A01,083765,Staff,1,1,30,29
1650648183034,MATH 20D,A02,083766,Staff,6,0,30,24
1650648183034,MATH 20D,A03,083767,Staff,24,0,30,6
1650648189057,MATH 20E,A01,083771,Staff,3,0,30,27
1650648189057,MATH 20E,A02,083772,Staff,16,0,30,14
1650648189057,MATH 20E,B01,083773,Staff,0,0,30,30
1650648189057,MATH 20E,B02,083774,Staff,9,0,30,21
1650648195086,MATH 103A,A01,083777,Staff,0,15,30,30
1650648195086,MATH 103A,A02,083778,Staff,0,15,30,30
1650648195086,MATH 103A,B01,083779,Staff,0,14,30,30
1650648195086,MATH 103A,B02,083780,Staff,0,14,30,30
1650648201111,MATH 105,A01,085443,Staff,0,22,30,30
1650648207135,MATH 109,A01,083213,Anzaldo; Leesa B,0,7,30,30
1650648207135,MATH 109,A02,083214,Anzaldo; Leesa B,0,7,30,30
1650648207135,MATH 109,B01,083215,Anzaldo; Leesa B,0,6,30,30
1650648207135,MATH 109,B02,083216,Anzaldo; Leesa B,0,6,30,30
1650648213158,MATH 142A,A01,083219,Chow; Bennett,0,16,30,30
1650648213158,MATH 142A,A02,083220,Chow; Bennett,0,15,30,30
1650648213158,MATH 142A,B01,083221,Chow; Bennett,0,14,30,30
1650648213158,MATH 142A,B02,083222,Chow; Bennett,0,13,30,30
1650648219183,MATH 193A,A01,083224,Staff,0,5,30,30
1650648219183,MATH 193A,A02,083225,Staff,0,6,30,30
1650648219183,MATH 193A,A03,083781,Staff,0,6,30,30
1650648219183,MATH 193A,A04,083782,Staff,0,7,30,30
1650648225207,MATH 197,001,091859,McAuley; Julian John,9998,0,9999,1
1650648231267,COGS 9,A01,083615,Staff,1,15,60,59
1650648237290,COGS 11,A01,083617,Boyle; Mary E. T.,18,0,40,22
1650648243322,COGS 13,A01,083071,Staff,0,38,40,40
1650648249348,COGS 14A,A01,092681,Staff,0,31,100,100
1650648255384,COGS 14B,A01,083073,Cheng; Tzu-Han,0,13,50,50
1650648261408,COGS 17,A01,092677,Staff,17,0,75,58
1650648267441,COGS 100,A01,083619,Staff,0,27,60,60
1650648273464,COGS 101A,A01,083621,Davis; Joshua Daniel,0,26,60,60
1650648279499,COGS 101B,A01,091572,Staff,0,4,60,60
1650648285532,COGS 101C,A01,083625,Delgado; Tania,15,0,30,15
1650648291574,COGS 107A,A01,083627,Boyle; Mary E. T.,1,15,60,59
1650648297599,COGS 118A,A01,083075,Staff,0,6,60,60
1650648303623,CSE 3,A50,083646,Miranda; Gregory Joseph,19,0,38,19
1650648303623,CSE 3,A51,083647,Miranda; Gregory Joseph,36,0,37,1
1650648309650,CSE 8A,A50,083650,Miranda; Gregory Joseph,0,30,40,40
1650648315678,CSE 11,A01,083080,Cao; Yingjun,0,95,40,40
1650648321704,CSE 12,A01,083652,Staff,0,19,100,100
1650648327729,CSE 15L,A01,083654,Staff,0,2,50,50
1650648327729,CSE 15L,A02,083655,Staff,0,1,50,50
1650648333765,CSE 20,A01,083657,Staff,51,0,80,29
1650648339787,CSE 30,A01,083084,Eldon; John,0,77,40,40
1650648345822,CSE 100,A01,083659,Cao; Yingjun,0,69,50,50
1650648351850,CSE 134B,A01,083661,Powell; Thomas Allan,0,37,65,65
1650648357877,CSE 140,A01,083663,Staff,0,8,75,75
1650648363907,CSE 140L,A01,083088,Eldon; John,0,16,75,75
1650648369941,CSE 175,A01,083665,Kumar; Rakesh,7,0,25,18
1650648376055,CSE 190,A00,092507,Dubnov; Shlomo,10,0,20,10
1650648382088,ECE 45,A01,083139,Staff,0,1,60,60
1650648388118,ECE 65,A50,083695,Staff,0,5,30,30
1650648394141,ECE 109,A01,091882,Touri; Behrouz,33,0,70,37
1650648400164,ECE 180,A00,083140,Abi Samra; Nicholas Camill,21,0,30,9
1650648400164,ECE 180,B00,083141,Abi Samra; Nicholas Camill,0,0,30,30
1650648406190,MATH 10A,A01,083735,Patchell; Gregory David,3,0,30,27
1650648406190,MATH 10A,A02,083736,Patchell; Gregory David,27,0,30,3
1650648406190,MATH 10A,A03,083737,Patchell; Gregory David,24,0,30,6
1650648412215,MATH 10B,A01,083207,Staff,0,8,30,30
1650648412215,MATH 10B,A02,083208,Staff,0,8,30,30
1650648412215,MATH 10B,B01,083739,Staff,11,0,30,19
1650648412215,MATH 10B,B02,083740,Staff,28,0,30,2
1650648418244,MATH 18,A01,083743,Staff,0,0,30,30
1650648418244,MATH 18,A02,083744,Staff,23,0,30,7
1650648418244,MATH 18,A03,083745,Staff,21,0,30,9
1650648418244,MATH 18,A04,083746,Staff,26,0,30,4
1650648418244,MATH 18,B01,083748,Staff,0,15,30,30
1650648418244,MATH 18,B02,083749,Staff,0,11,30,30
1650648418244,MATH 18,B03,083750,Staff,0,12,30,30
1650648418244,MATH 18,B04,083751,Staff,0,12,30,30
1650648424267,MATH 20A,A01,083754,Staff,19,0,40,21
1650648430305,MATH 20B,A01,083756,Staff,0,12,30,30
1650648430305,MATH 20B,A02,083757,Staff,0,12,30,30
1650648436329,MATH 20C,A01,083760,Staff,0,15,30,30
1650648436329,MATH 20C,A02,083761,Staff,1,13,30,29
1650648436329,MATH 20C,B01,083762,Staff,11,0,30,19
1650648436329,MATH 20C,B02,083763,Staff,28,0,30,2
1650648442352,MATH 20D,A01,083765,Staff,1,1,30,29
1650648442352,MATH 20D,A02,083766,Staff,6,0,30,24
1650648442352,MATH 20D,A03,083767,Staff,24,0,30,6
1650648448386,MATH 20E,A01,083771,Staff,3,0,30,27
1650648448386,MATH 20E,A02,083772,Staff,16,0,30,14
1650648448386,MATH 20E,B01,083773,Staff,0,0,30,30
1650648448386,MATH 20E,B02,083774,Staff,9,0,30,21
1650648454416,MATH 103A,A01,083777,Staff,0,15,30,30
1650648454416,MATH 103A,A02,083778,Staff,0,15,30,30
1650648454416,MATH 103A,B01,083779,Staff,0,14,30,30
1650648454416,MATH 103A,B02,083780,Staff,0,14,30,30
1650648460442,MATH 105,A01,085443,Staff,0,22,30,30
1650648466469,MATH 109,A01,083213,Anzaldo; Leesa B,0,7,30,30
1650648466469,MATH 109,A02,083214,Anzaldo; Leesa B,0,7,30,30
1650648466469,MATH 109,B01,083215,Anzaldo; Leesa B,0,6,30,30
1650648466469,MATH 109,B02,083216,Anzaldo; Leesa B,0,6,30,30
1650648472502,MATH 142A,A01,083219,Chow; Bennett,0,16,30,30
1650648472502,MATH 142A,A02,083220,Chow; Bennett,0,15,30,30
1650648472502,MATH 142A,B01,083221,Chow; Bennett,0,14,30,30
1650648472502,MATH 142A,B02,083222,Chow; Bennett,0,13,30,30
1650648478541,MATH 193A,A01,083224,Staff,0,5,30,30
1650648478541,MATH 193A,A02,083225,Staff,0,6,30,30
1650648478541,MATH 193A,A03,083781,Staff,0,6,30,30
1650648478541,MATH 193A,A04,083782,Staff,0,7,30,30
1650648484582,MATH 197,001,091859,McAuley; Julian John,9998,0,9999,1
1650648490635,COGS 9,A01,083615,Staff,1,15,60,59
1650648496674,COGS 11,A01,083617,Boyle; Mary E. T.,18,0,40,22
1650648502702,COGS 13,A01,083071,Staff,0,38,40,40
1650648508726,COGS 14A,A01,092681,Staff,0,31,100,100
1650648514753,COGS 14B,A01,083073,Cheng; Tzu-Han,0,13,50,50
1650648520790,COGS 17,A01,092677,Staff,17,0,75,58
1650648526815,COGS 100,A01,083619,Staff,0,27,60,60
1650648532843,COGS 101A,A01,083621,Davis; Joshua Daniel,0,26,60,60
1650648538872,COGS 101B,A01,091572,Staff,0,4,60,60
1650648544912,COGS 101C,A01,083625,Delgado; Tania,15,0,30,15
1650648550944,COGS 107A,A01,083627,Boyle; Mary E. T.,1,15,60,59
1650648556994,COGS 118A,A01,083075,Staff,0,6,60,60
1650648563091,CSE 3,A50,083646,Miranda; Gregory Joseph,19,0,38,19
1650648563091,CSE 3,A51,083647,Miranda; Gregory Joseph,36,0,37,1
1650648569217,CSE 8A,A50,083650,Miranda; Gregory Joseph,0,30,40,40
1650648575291,CSE 11,A01,083080,Cao; Yingjun,0,95,40,40
1650648581320,CSE 12,A01,083652,Staff,0,19,100,100
1650648587348,CSE 15L,A01,083654,Staff,0,2,50,50
1650648587348,CSE 15L,A02,083655,Staff,0,1,50,50
1650648593377,CSE 20,A01,083657,Staff,51,0,80,29
1650648599403,CSE 30,A01,083084,Eldon; John,0,77,40,40
1650648605428,CSE 100,A01,083659,Cao; Yingjun,0,69,50,50
1650648611451,CSE 134B,A01,083661,Powell; Thomas Allan,0,37,65,65
1650648617483,CSE 140,A01,083663,Staff,0,8,75,75
1650648623507,CSE 140L,A01,083088,Eldon; John,0,16,75,75
1650648629548,CSE 175,A01,083665,Kumar; Rakesh,7,0,25,18
1650648635572,CSE 190,A00,092507,Dubnov; Shlomo,10,0,20,10
1650648641606,ECE 45,A01,083139,Staff,0,1,60,60
1650648647629,ECE 65,A50,083695,Staff,0,5,30,30
1650648653652,ECE 109,A01,091882,Touri; Behrouz,33,0,70,37
1650648659681,ECE 180,A00,083140,Abi Samra; Nicholas Camill,21,0,30,9
1650648659681,ECE 180,B00,083141,Abi Samra; Nicholas Camill,0,0,30,30
1650648665705,MATH 10A,A01,083735,Patchell; Gregory David,3,0,30,27
1650648665705,MATH 10A,A02,083736,Patchell; Gregory David,27,0,30,3
1650648665705,MATH 10A,A03,083737,Patchell; Gregory David,24,0,30,6
1650648671727,MATH 10B,A01,083207,Staff,0,8,30,30
1650648671727,MATH 10B,A02,083208,Staff,0,8,30,30
1650648671727,MATH 10B,B01,083739,Staff,11,0,30,19
1650648671727,MATH 10B,B02,083740,Staff,28,0,30,2
1650648677763,MATH 18,A01,083743,Staff,0,0,30,30
1650648677763,MATH 18,A02,083744,Staff,23,0,30,7
1650648677763,MATH 18,A03,083745,Staff,21,0,30,9
1650648677763,MATH 18,A04,083746,Staff,26,0,30,4
1650648677763,MATH 18,B01,083748,Staff,0,15,30,30
1650648677763,MATH 18,B02,083749,Staff,0,11,30,30
1650648677763,MATH 18,B03,083750,Staff,0,12,30,30
1650648677763,MATH 18,B04,083751,Staff,0,12,30,30
1650648683786,MATH 20A,A01,083754,Staff,19,0,40,21
1650648689816,MATH 20B,A01,083756,Staff,0,12,30,30
1650648689816,MATH 20B,A02,083757,Staff,0,12,30,30
1650648695842,MATH 20C,A01,083760,Staff,0,15,30,30
1650648695842,MATH 20C,A02,083761,Staff,1,13,30,29
1650648695842,MATH 20C,B01,083762,Staff,11,0,30,19
1650648695842,MATH 20C,B02,083763,Staff,28,0,30,2
1650648701869,MATH 20D,A01,083765,Staff,1,1,30,29
1650648701869,MATH 20D,A02,083766,Staff,6,0,30,24
1650648701869,MATH 20D,A03,083767,Staff,24,0,30,6
1650648707896,MATH 20E,A01,083771,Staff,3,0,30,27
1650648707896,MATH 20E,A02,083772,Staff,16,0,30,14
1650648707896,MATH 20E,B01,083773,Staff,0,0,30,30
1650648707896,MATH 20E,B02,083774,Staff,9,0,30,21
1650648713930,MATH 103A,A01,083777,Staff,0,15,30,30
1650648713930,MATH 103A,A02,083778,Staff,0,15,30,30
1650648713930,MATH 103A,B01,083779,Staff,0,14,30,30
1650648713930,MATH 103A,B02,083780,Staff,0,14,30,30
1650648719952,MATH 105,A01,085443,Staff,0,22,30,30
1650648725983,MATH 109,A01,083213,Anzaldo; Leesa B,0,7,30,30
1650648725983,MATH 109,A02,083214,Anzaldo; Leesa B,0,7,30,30
1650648725983,MATH 109,B01,083215,Anzaldo; Leesa B,0,6,30,30
1650648725983,MATH 109,B02,083216,Anzaldo; Leesa B,0,6,30,30
1650648732011,MATH 142A,A01,083219,Chow; Bennett,0,16,30,30
1650648732011,MATH 142A,A02,083220,Chow; Bennett,0,15,30,30
1650648732011,MATH 142A,B01,083221,Chow; Bennett,0,14,30,30
1650648732011,MATH 142A,B02,083222,Chow; Bennett,0,13,30,30
1650648738051,MATH 193A,A01,083224,Staff,0,5,30,30
1650648738051,MATH 193A,A02,083225,Staff,0,6,30,30
1650648738051,MATH 193A,A03,083781,Staff,0,6,30,30
1650648738051,MATH 193A,A04,083782,Staff,0,7,30,30
1650648744074,MATH 197,001,091859,McAuley; Julian John,9998,0,9999,1
1650648750125,COGS 9,A01,083615,Staff,1,15,60,59
1650648756163,COGS 11,A01,083617,Boyle; Mary E. T.,18,0,40,22
1650648762190,COGS 13,A01,083071,Staff,0,38,40,40
1650648768231,COGS 14A,A01,092681,Staff,0,31,100,100
1650648774256,COGS 14B,A01,083073,Cheng; Tzu-Han,0,13,50,50
1650648780290,COGS 17,A01,092677,Staff,17,0,75,58
1650648786314,COGS 100,A01,083619,Staff,0,27,60,60
1650648792338,COGS 101A,A01,083621,Davis; Joshua Daniel,0,26,60,60
1650648798360,COGS 101B,A01,091572,Staff,0,4,60,60
1650648804387,COGS 101C,A01,083625,Delgado; Tania,15,0,30,15
1650648810410,COGS 107A,A01,083627,Boyle; Mary E. T.,1,15,60,59
1650648816451,COGS 118A,A01,083075,Staff,0,6,60,60
1650648822482,CSE 3,A50,083646,Miranda; Gregory Joseph,19,0,38,19
1650648822482,CSE 3,A51,083647,Miranda; Gregory Joseph,36,0,37,1
1650648828506,CSE 8A,A50,083650,Miranda; Gregory Joseph,0,30,40,40
1650648834530,CSE 11,A01,083080,Cao; Yingjun,0,95,40,40
1650648840557,CSE 12,A01,083652,Staff,0,19,100,100
1650648846580,CSE 15L,A01,083654,Staff,0,2,50,50
1650648846580,CSE 15L,A02,083655,Staff,0,1,50,50
1650648852606,CSE 20,A01,083657,Staff,51,0,80,29
1650648858632,CSE 30,A01,083084,Eldon; John,0,77,40,40
1650648864660,CSE 100,A01,083659,Cao; Yingjun,0,69,50,50
1650648870683,CSE 134B,A01,083661,Powell; Thomas Allan,0,37,65,65
1650648876706,CSE 140,A01,083663,Staff,0,8,75,75
1650648882729,CSE 140L,A01,083088,Eldon; John,0,16,75,75
1650648888755,CSE 175,A01,083665,Kumar; Rakesh,7,0,25,18
1650648894779,CSE 190,A00,092507,Dubnov; Shlomo,10,0,20,10
1650648900803,ECE 45,A01,083139,Staff,0,1,60,60
1650648906837,ECE 65,A50,083695,Staff,0,5,30,30
1650648912867,ECE 109,A01,091882,Touri; Behrouz,33,0,70,37
1650648918899,ECE 180,A00,083140,Abi Samra; Nicholas Camill,21,0,30,9
1650648918899,ECE 180,B00,083141,Abi Samra; Nicholas Camill,0,0,30,30
1650648924924,MATH 10A,A01,083735,Patchell; Gregory David,3,0,30,27
1650648924924,MATH 10A,A02,083736,Patchell; Gregory David,27,0,30,3
1650648924924,MATH 10A,A03,083737,Patchell; Gregory David,24,0,30,6
1650648930954,MATH 10B,A01,083207,Staff,0,8,30,30
1650648930954,MATH 10B,A02,083208,Staff,0,8,30,30
1650648930954,MATH 10B,B01,083739,Staff,11,0,30,19
1650648930954,MATH 10B,B02,083740,Staff,28,0,30,2
1650648936987,MATH 18,A01,083743,Staff,0,0,30,30
1650648936987,MATH 18,A02,083744,Staff,23,0,30,7
1650648936987,MATH 18,A03,083745,Staff,21,0,30,9
1650648936987,MATH 18,A04,083746,Staff,26,0,30,4
1650648936987,MATH 18,B01,083748,Staff,0,15,30,30
1650648936987,MATH 18,B02,083749,Staff,0,11,30,30
1650648936987,MATH 18,B03,083750,Staff,0,12,30,30
1650648936987,MATH 18,B04,083751,Staff,0,12,30,30
1650648943013,MATH 20A,A01,083754,Staff,19,0,40,21
1650648949037,MATH 20B,A01,083756,Staff,0,12,30,30
1650648949037,MATH 20B,A02,083757,Staff,0,12,30,30
1650648955065,MATH 20C,A01,083760,Staff,0,15,30,30
1650648955065,MATH 20C,A02,083761,Staff,1,13,30,29
1650648955065,MATH 20C,B01,083762,Staff,11,0,30,19
1650648955065,MATH 20C,B02,083763,Staff,28,0,30,2
1650648961095,MATH 20D,A01,083765,Staff,1,1,30,29
1650648961095,MATH 20D,A02,083766,Staff,6,0,30,24
1650648961095,MATH 20D,A03,083767,Staff,24,0,30,6
1650648967127,MATH 20E,A01,083771,Staff,3,0,30,27
1650648967127,MATH 20E,A02,083772,Staff,16,0,30,14
1650648967127,MATH 20E,B01,083773,Staff,0,0,30,30
1650648967127,MATH 20E,B02,083774,Staff,9,0,30,21
1650648973248,MATH 103A,A01,083777,Staff,0,15,30,30
1650648973248,MATH 103A,A02,083778,Staff,0,15,30,30
1650648973248,MATH 103A,B01,083779,Staff,0,14,30,30
1650648973248,MATH 103A,B02,083780,Staff,0,14,30,30
1650648979272,MATH 105,A01,085443,Staff,0,22,30,30
1650648985296,MATH 109,A01,083213,Anzaldo; Leesa B,0,7,30,30
1650648985296,MATH 109,A02,083214,Anzaldo; Leesa B,0,7,30,30
1650648985296,MATH 109,B01,083215,Anzaldo; Leesa B,0,6,30,30
1650648985296,MATH 109,B02,083216,Anzaldo; Leesa B,0,6,30,30
1650648991325,MATH 142A,A01,083219,Chow; Bennett,0,16,30,30
1650648991325,MATH 142A,A02,083220,Chow; Bennett,0,15,30,30
1650648991325,MATH 142A,B01,083221,Chow; Bennett,0,14,30,30
1650648991325,MATH 142A,B02,083222,Chow; Bennett,0,13,30,30
1650648997348,MATH 193A,A01,083224,Staff,0,5,30,30
1650648997348,MATH 193A,A02,083225,Staff,0,6,30,30
1650648997348,MATH 193A,A03,083781,Staff,0,6,30,30
1650648997348,MATH 193A,A04,083782,Staff,0,7,30,30
1650649003373,MATH 197,001,091859,McAuley; Julian John,9998,0,9999,1
1650649009442,COGS 9,A01,083615,Staff,1,15,60,59
1650649015468,COGS 11,A01,083617,Boyle; Mary E. T.,18,0,40,22
1650649021494,COGS 13,A01,083071,Staff,0,38,40,40
1650649027518,COGS 14A,A01,092681,Staff,0,31,100,100
1650649033546,COGS 14B,A01,083073,Cheng; Tzu-Han,0,13,50,50
1650649039569,COGS 17,A01,092677,Staff,17,0,75,58
1650649045599,COGS 100,A01,083619,Staff,0,27,60,60
1650649051626,COGS 101A,A01,083621,Davis; Joshua Daniel,0,26,60,60
1650649057653,COGS 101B,A01,091572,Staff,0,4,60,60
1650649063684,COGS 101C,A01,083625,Delgado; Tania,15,0,30,15
1650649069715,COGS 107A,A01,083627,Boyle; Mary E. T.,1,15,60,59
1650649075739,COGS 118A,A01,083075,Staff,0,6,60,60
1650649081768,CSE 3,A50,083646,Miranda; Gregory Joseph,19,0,38,19
1650649081768,CSE 3,A51,083647,Miranda; Gregory Joseph,36,0,37,1
1650649087792,CSE 8A,A50,083650,Miranda; Gregory Joseph,0,30,40,40
1650649093816,CSE 11,A01,083080,Cao; Yingjun,0,95,40,40
1650649099840,CSE 12,A01,083652,Staff,0,19,100,100
1650649105862,CSE 15L,A01,083654,Staff,0,2,50,50
1650649105862,CSE 15L,A02,083655,Staff,0,1,50,50
1650649111887,CSE 20,A01,083657,Staff,51,0,80,29
1650649117914,CSE 30,A01,083084,Eldon; John,0,77,40,40
1650649123946,CSE 100,A01,083659,Cao; Yingjun,0,69,50,50
1650649129977,CSE 134B,A01,083661,Powell; Thomas Allan,0,37,65,65
1650649136004,CSE 140,A01,083663,Staff,0,8,75,75
1650649142038,CSE 140L,A01,083088,Eldon; John,0,16,75,75
1650649148062,CSE 175,A01,083665,Kumar; Rakesh,7,0,25,18
1650649154090,CSE 190,A00,092507,Dubnov; Shlomo,10,0,20,10
1650649160116,ECE 45,A01,083139,Staff,0,1,60,60
1650649166152,ECE 65,A50,083695,Staff,0,5,30,30
1650649172182,ECE 109,A01,091882,Touri; Behrouz,33,0,70,37
1650649178207,ECE 180,A00,083140,Abi Samra; Nicholas Camill,21,0,30,9
1650649178207,ECE 180,B00,083141,Abi Samra; Nicholas Camill,0,0,30,30
1650649184231,MATH 10A,A01,083735,Patchell; Gregory David,3,0,30,27
1650649184231,MATH 10A,A02,083736,Patchell; Gregory David,27,0,30,3
1650649184231,MATH 10A,A03,083737,Patchell; Gregory David,24,0,30,6
1650649190257,MATH 10B,A01,083207,Staff,0,8,30,30
1650649190257,MATH 10B,A02,083208,Staff,0,8,30,30
1650649190257,MATH 10B,B01,083739,Staff,11,0,30,19
1650649190257,MATH 10B,B02,083740,Staff,28,0,30,2
1650649196284,MATH 18,A01,083743,Staff,0,0,30,30
1650649196284,MATH 18,A02,083744,Staff,23,0,30,7
1650649196284,MATH 18,A03,083745,Staff,21,0,30,9
1650649196284,MATH 18,A04,083746,Staff,26,0,30,4
1650649196284,MATH 18,B01,083748,Staff,0,15,30,30
1650649196284,MATH 18,B02,083749,Staff,0,11,30,30
1650649196284,MATH 18,B03,083750,Staff,0,12,30,30
1650649196284,MATH 18,B04,083751,Staff,0,12,30,30
1650649202310,MATH 20A,A01,083754,Staff,19,0,40,21
1650649208349,MATH 20B,A01,083756,Staff,0,12,30,30
1650649208349,MATH 20B,A02,083757,Staff,0,12,30,30
1650649214379,MATH 20C,A01,083760,Staff,0,15,30,30
1650649214379,MATH 20C,A02,083761,Staff,1,13,30,29
1650649214379,MATH 20C,B01,083762,Staff,11,0,30,19
1650649214379,MATH 20C,B02,083763,Staff,28,0,30,2
1650649220413,MATH 20D,A01,083765,Staff,1,1,30,29
1650649220413,MATH 20D,A02,083766,Staff,6,0,30,24
1650649220413,MATH 20D,A03,083767,Staff,24,0,30,6
1650649226439,MATH 20E,A01,083771,Staff,3,0,30,27
1650649226439,MATH 20E,A02,083772,Staff,16,0,30,14
1650649226439,MATH 20E,B01,083773,Staff,0,0,30,30
1650649226439,MATH 20E,B02,083774,Staff,9,0,30,21
1650649232464,MATH 103A,A01,083777,Staff,0,15,30,30
1650649232464,MATH 103A,A02,083778,Staff,0,15,30,30
1650649232464,MATH 103A,B01,083779,Staff,0,14,30,30
1650649232464,MATH 103A,B02,083780,Staff,0,14,30,30
1650649238491,MATH 105,A01,085443,Staff,0,22,30,30
1650649244520,MATH 109,A01,083213,Anzaldo; Leesa B,0,7,30,30
1650649244520,MATH 109,A02,083214,Anzaldo; Leesa B,0,7,30,30
1650649244520,MATH 109,B01,083215,Anzaldo; Leesa B,0,6,30,30
1650649244520,MATH 109,B02,083216,Anzaldo; Leesa B,0,6,30,30
1650649250548,MATH 142A,A01,083219,Chow; Bennett,0,16,30,30
1650649250548,MATH 142A,A02,083220,Chow; Bennett,0,15,30,30
1650649250548,MATH 142A,B01,083221,Chow; Bennett,0,14,30,30
1650649250548,MATH 142A,B02,083222,Chow; Bennett,0,13,30,30
1650649256574,MATH 193A,A01,083224,Staff,0,5,30,30
1650649256574,MATH 193A,A02,083225,Staff,0,6,30,30
1650649256574,MATH 193A,A03,083781,Staff,0,6,30,30
1650649256574,MATH 193A,A04,083782,Staff,0,7,30,30
1650649262598,MATH 197,001,091859,McAuley; Julian John,9998,0,9999,1
1650649268660,COGS 9,A01,083615,Staff,1,15,60,59
1650649274687,COGS 11,A01,083617,Boyle; Mary E. T.,18,0,40,22
1650649280712,COGS 13,A01,083071,Staff,0,39,40,40
1650649286736,COGS 14A,A01,092681,Staff,0,32,100,100
1650649292759,COGS 14B,A01,083073,Cheng; Tzu-Han,0,13,50,50
1650649298783,COGS 17,A01,092677,Staff,17,0,75,58
1650649304810,COGS 100,A01,083619,Staff,0,27,60,60
1650649310837,COGS 101A,A01,083621,Davis; Joshua Daniel,0,26,60,60
1650649316865,COGS 101B,A01,091572,Staff,0,4,60,60
1650649322892,COGS 101C,A01,083625,Delgado; Tania,15,0,30,15
1650649328931,COGS 107A,A01,083627,Boyle; Mary E. T.,1,16,60,59
1650649334955,COGS 118A,A01,083075,Staff,0,6,60,60
1650649340978,CSE 3,A50,083646,Miranda; Gregory Joseph,19,0,38,19
1650649340978,CSE 3,A51,083647,Miranda; Gregory Joseph,36,0,37,1
1650649347005,CSE 8A,A50,083650,Miranda; Gregory Joseph,0,30,40,40
1650649353030,CSE 11,A01,083080,Cao; Yingjun,0,95,40,40
1650649359056,CSE 12,A01,083652,Staff,0,19,100,100
1650649365080,CSE 15L,A01,083654,Staff,0,2,50,50
1650649365080,CSE 15L,A02,083655,Staff,0,1,50,50
1650649371105,CSE 20,A01,083657,Staff,51,0,80,29
1650649377127,CSE 30,A01,083084,Eldon; John,0,77,40,40
1650649383151,CSE 100,A01,083659,Cao; Yingjun,0,69,50,50
1650649389181,CSE 134B,A01,083661,Powell; Thomas Allan,0,37,65,65
1650649395204,CSE 140,A01,083663,Staff,0,8,75,75
1650649401232,CSE 140L,A01,083088,Eldon; John,0,16,75,75
1650649407260,CSE 175,A01,083665,Kumar; Rakesh,7,0,25,18
1650649413287,CSE 190,A00,092507,Dubnov; Shlomo,10,0,20,10
1650649419314,ECE 45,A01,083139,Staff,0,1,60,60
1650649425337,ECE 65,A50,083695,Staff,0,5,30,30
1650649431375,ECE 109,A01,091882,Touri; Behrouz,33,0,70,37
1650649437398,ECE 180,A00,083140,Abi Samra; Nicholas Camill,21,0,30,9
1650649437398,ECE 180,B00,083141,Abi Samra; Nicholas Camill,0,0,30,30
1650649443443,MATH 10A,A01,083735,Patchell; Gregory David,3,0,30,27
1650649443443,MATH 10A,A02,083736,Patchell; Gregory David,27,0,30,3
1650649443443,MATH 10A,A03,083737,Patchell; Gregory David,24,0,30,6
1650649449464,MATH 10B,A01,083207,Staff,0,8,30,30
1650649449464,MATH 10B,A02,083208,Staff,0,8,30,30
1650649449464,MATH 10B,B01,083739,Staff,11,0,30,19
1650649449464,MATH 10B,B02,083740,Staff,28,0,30,2
1650649455489,MATH 18,A01,083743,Staff,0,0,30,30
1650649455489,MATH 18,A02,083744,Staff,23,0,30,7
1650649455489,MATH 18,A03,083745,Staff,21,0,30,9
1650649455489,MATH 18,A04,083746,Staff,26,0,30,4
1650649455489,MATH 18,B01,083748,Staff,0,15,30,30
1650649455489,MATH 18,B02,083749,Staff,0,11,30,30
1650649455489,MATH 18,B03,083750,Staff,0,12,30,30
1650649455489,MATH 18,B04,083751,Staff,0,12,30,30
1650649461513,MATH 20A,A01,083754,Staff,19,0,40,21
1650649467535,MATH 20B,A01,083756,Staff,0,12,30,30
1650649467535,MATH 20B,A02,083757,Staff,0,12,30,30
1650649473563,MATH 20C,A01,083760,Staff,0,15,30,30
1650649473563,MATH 20C,A02,083761,Staff,1,13,30,29
1650649473563,MATH 20C,B01,083762,Staff,11,0,30,19
1650649473563,MATH 20C,B02,083763,Staff,28,0,30,2
1650649479591,MATH 20D,A01,083765,Staff,1,1,30,29
1650649479591,MATH 20D,A02,083766,Staff,6,0,30,24
1650649479591,MATH 20D,A03,083767,Staff,24,0,30,6
1650649485626,MATH 20E,A01,083771,Staff,3,0,30,27
1650649485626,MATH 20E,A02,083772,Staff,16,0,30,14
1650649485626,MATH 20E,B01,083773,Staff,0,0,30,30
1650649485626,MATH 20E,B02,083774,Staff,9,0,30,21
1650649491655,MATH 103A,A01,083777,Staff,0,15,30,30
1650649491655,MATH 103A,A02,083778,Staff,0,15,30,30
1650649491655,MATH 103A,B01,083779,Staff,0,14,30,30
1650649491655,MATH 103A,B02,083780,Staff,0,14,30,30
1650649497678,MATH 105,A01,085443,Staff,0,22,30,30
1650649503714,MATH 109,A01,083213,Anzaldo; Leesa B,0,7,30,30
1650649503714,MATH 109,A02,083214,Anzaldo; Leesa B,0,7,30,30
1650649503714,MATH 109,B01,083215,Anzaldo; Leesa B,0,6,30,30
1650649503714,MATH 109,B02,083216,Anzaldo; Leesa B,0,6,30,30
1650649509738,MATH 142A,A01,083219,Chow; Bennett,0,16,30,30
1650649509738,MATH 142A,A02,083220,Chow; Bennett,0,15,30,30
1650649509738,MATH 142A,B01,083221,Chow; Bennett,0,14,30,30
1650649509738,MATH 142A,B02,083222,Chow; Bennett,0,13,30,30
1650649515764,MATH 193A,A01,083224,Staff,0,5,30,30
1650649515764,MATH 193A,A02,083225,Staff,0,6,30,30
1650649515764,MATH 193A,A03,083781,Staff,0,6,30,30
1650649515764,MATH 193A,A04,083782,Staff,0,7,30,30
1650649521794,MATH 197,001,091859,McAuley; Julian John,9998,0,9999,1
1650649527845,COGS 9,A01,083615,Staff,1,15,60,59
1650649533870,COGS 11,A01,083617,Boyle; Mary E. T.,18,0,40,22
1650649539894,COGS 13,A01,083071,Staff,0,38,40,40
1650649545918,COGS 14A,A01,092681,Staff,0,31,100,100
1650649551956,COGS 14B,A01,083073,Cheng; Tzu-Han,0,13,50,50
1650649557980,COGS 17,A01,092677,Staff,17,0,75,58
1650649564096,COGS 100,A01,083619,Staff,0,28,60,60
1650649570135,COGS 101A,A01,083621,Davis; Joshua Daniel,0,27,60,60
1650649576162,COGS 101B,A01,091572,Staff,0,4,60,60
1650649582202,COGS 101C,A01,083625,Delgado; Tania,15,0,30,15
1650649588227,COGS 107A,A01,083627,Boyle; Mary E. T.,1,16,60,59
1650649594253,COGS 118A,A01,083075,Staff,0,6,60,60
1650649600284,CSE 3,A50,083646,Miranda; Gregory Joseph,19,0,38,19
1650649600284,CSE 3,A51,083647,Miranda; Gregory Joseph,36,0,37,1
1650649606311,CSE 8A,A50,083650,Miranda; Gregory Joseph,0,30,40,40
1650649612342,CSE 11,A01,083080,Cao; Yingjun,0,95,40,40
1650649618366,CSE 12,A01,083652,Staff,0,19,100,100
1650649624390,CSE 15L,A01,083654,Staff,0,2,50,50
1650649624390,CSE 15L,A02,083655,Staff,0,1,50,50
1650649630413,CSE 20,A01,083657,Staff,51,0,80,29
1650649636448,CSE 30,A01,083084,Eldon; John,0,77,40,40
1650649642478,CSE 100,A01,083659,Cao; Yingjun,0,69,50,50
1650649648517,CSE 134B,A01,083661,Powell; Thomas Allan,0,37,65,65
1650649654542,CSE 140,A01,083663,Staff,0,8,75,75
1650649660570,CSE 140L,A01,083088,Eldon; John,0,16,75,75
1650649666602,CSE 175,A01,083665,Kumar; Rakesh,7,0,25,18
1650649672629,CSE 190,A00,092507,Dubnov; Shlomo,10,0,20,10
1650649678655,ECE 45,A01,083139,Staff,0,1,60,60
1650649684682,ECE 65,A50,083695,Staff,0,5,30,30
1650649690708,ECE 109,A01,091882,Touri; Behrouz,33,0,70,37
1650649696743,ECE 180,A00,083140,Abi Samra; Nicholas Camill,21,0,30,9
1650649696743,ECE 180,B00,083141,Abi Samra; Nicholas Camill,0,0,30,30
1650649702785,MATH 10A,A01,083735,Patchell; Gregory David,3,0,30,27
1650649702785,MATH 10A,A02,083736,Patchell; Gregory David,27,0,30,3
1650649702785,MATH 10A,A03,083737,Patchell; Gregory David,24,0,30,6
1650649708809,MATH 10B,A01,083207,Staff,0,8,30,30
1650649708809,MATH 10B,A02,083208,Staff,0,8,30,30
1650649708809,MATH 10B,B01,083739,Staff,11,0,30,19
1650649708809,MATH 10B,B02,083740,Staff,28,0,30,2
1650649714841,MATH 18,A01,083743,Staff,0,0,30,30
1650649714841,MATH 18,A02,083744,Staff,23,0,30,7
1650649714841,MATH 18,A03,083745,Staff,21,0,30,9
1650649714841,MATH 18,A04,083746,Staff,26,0,30,4
1650649714841,MATH 18,B01,083748,Staff,0,15,30,30
1650649714841,MATH 18,B02,083749,Staff,0,11,30,30
1650649714841,MATH 18,B03,083750,Staff,0,12,30,30
1650649714841,MATH 18,B04,083751,Staff,0,12,30,30
1650649720884,MATH 20A,A01,083754,Staff,19,0,40,21
1650649726921,MATH 20B,A01,083756,Staff,0,12,30,30
1650649726921,MATH 20B,A02,083757,Staff,0,12,30,30
1650649732946,MATH 20C,A01,083760,Staff,0,15,30,30
1650649732946,MATH 20C,A02,083761,Staff,1,13,30,29
1650649732946,MATH 20C,B01,083762,Staff,11,0,30,19
1650649732946,MATH 20C,B02,083763,Staff,28,0,30,2
1650649738974,MATH 20D,A01,083765,Staff,1,1,30,29
1650649738974,MATH 20D,A02,083766,Staff,6,0,30,24
1650649738974,MATH 20D,A03,083767,Staff,24,0,30,6
1650649745002,MATH 20E,A01,083771,Staff,3,0,30,27
1650649745002,MATH 20E,A02,083772,Staff,16,0,30,14
1650649745002,MATH 20E,B01,083773,Staff,0,0,30,30
1650649745002,MATH 20E,B02,083774,Staff,9,0,30,21
1650649751029,MATH 103A,A01,083777,Staff,0,15,30,30
1650649751029,MATH 103A,A02,083778,Staff,0,15,30,30
1650649751029,MATH 103A,B01,083779,Staff,0,14,30,30
1650649751029,MATH 103A,B02,083780,Staff,0,14,30,30
1650649757067,MATH 105,A01,085443,Staff,0,22,30,30
1650649763095,MATH 109,A01,083213,Anzaldo; Leesa B,0,7,30,30
1650649763095,MATH 109,A02,083214,Anzaldo; Leesa B,0,7,30,30
1650649763095,MATH 109,B01,083215,Anzaldo; Leesa B,0,6,30,30
1650649763095,MATH 109,B02,083216,Anzaldo; Leesa B,0,6,30,30
1650649769120,MATH 142A,A01,083219,Chow; Bennett,0,16,30,30
1650649769120,MATH 142A,A02,083220,Chow; Bennett,0,15,30,30
1650649769120,MATH 142A,B01,083221,Chow; Bennett,0,14,30,30
1650649769120,MATH 142A,B02,083222,Chow; Bennett,0,13,30,30
1650649775145,MATH 193A,A01,083224,Staff,0,5,30,30
1650649775145,MATH 193A,A02,083225,Staff,0,6,30,30
1650649775145,MATH 193A,A03,083781,Staff,0,6,30,30
1650649775145,MATH 193A,A04,083782,Staff,0,7,30,30
1650649781177,MATH 197,001,091859,McAuley; Julian John,9998,0,9999,1
1650649787236,COGS 9,A01,083615,Staff,1,15,60,59
1650649793261,COGS 11,A01,083617,Boyle; Mary E. T.,18,0,40,22
1650649799295,COGS 13,A01,083071,Staff,0,38,40,40
1650649805323,COGS 14A,A01,092681,Staff,0,31,100,100
1650649811347,COGS 14B,A01,083073,Cheng; Tzu-Han,0,13,50,50
1650649817380,COGS 17,A01,092677,Staff,17,0,75,58
1650649823413,COGS 100,A01,083619,Staff,0,28,60,60
1650649829437,COGS 101A,A01,083621,Davis; Joshua Daniel,0,27,60,60
1650649835483,COGS 101B,A01,091572,Staff,0,4,60,60
1650649841507,COGS 101C,A01,083625,Delgado; Tania,15,0,30,15
1650649847536,COGS 107A,A01,083627,Boyle; Mary E. T.,1,16,60,59
1650649853574,COGS 118A,A01,083075,Staff,0,6,60,60
1650649859602,CSE 3,A50,083646,Miranda; Gregory Joseph,19,0,38,19
1650649859602,CSE 3,A51,083647,Miranda; Gregory Joseph,36,0,37,1
1650649865626,CSE 8A,A50,083650,Miranda; Gregory Joseph,0,30,40,40
1650649871648,CSE 11,A01,083080,Cao; Yingjun,0,95,40,40
1650649877672,CSE 12,A01,083652,Staff,0,19,100,100
1650649883698,CSE 15L,A01,083654,Staff,0,2,50,50
1650649883698,CSE 15L,A02,083655,Staff,0,1,50,50
1650649889721,CSE 20,A01,083657,Staff,51,0,80,29
1650649895743,CSE 30,A01,083084,Eldon; John,0,77,40,40
1650649901768,CSE 100,A01,083659,Cao; Yingjun,0,69,50,50
1650649907796,CSE 134B,A01,083661,Powell; Thomas Allan,0,37,65,65
1650649913826,CSE 140,A01,083663,Staff,0,8,75,75
1650649919853,CSE 140L,A01,083088,Eldon; John,0,16,75,75
1650649925891,CSE 175,A01,083665,Kumar; Rakesh,7,0,25,18
1650649931917,CSE 190,A00,092507,Dubnov; Shlomo,10,0,20,10
1650649937942,ECE 45,A01,083139,Staff,0,1,60,60
1650649943966,ECE 65,A50,083695,Staff,0,5,30,30
1650649949991,ECE 109,A01,091882,Touri; Behrouz,33,0,70,37
1650649956018,ECE 180,A00,083140,Abi Samra; Nicholas Camill,21,0,30,9
1650649956018,ECE 180,B00,083141,Abi Samra; Nicholas Camill,0,0,30,30
1650649962051,MATH 10A,A01,083735,Patchell; Gregory David,3,0,30,27
1650649962051,MATH 10A,A02,083736,Patchell; Gregory David,27,0,30,3
1650649962051,MATH 10A,A03,083737,Patchell; Gregory David,24,0,30,6
1650649968080,MATH 10B,A01,083207,Staff,0,8,30,30
1650649968080,MATH 10B,A02,083208,Staff,0,8,30,30
1650649968080,MATH 10B,B01,083739,Staff,11,0,30,19
1650649968080,MATH 10B,B02,083740,Staff,28,0,30,2
1650649974115,MATH 18,A01,083743,Staff,0,0,30,30
1650649974115,MATH 18,A02,083744,Staff,23,0,30,7
1650649974115,MATH 18,A03,083745,Staff,21,0,30,9
1650649974115,MATH 18,A04,083746,Staff,26,0,30,4
1650649974115,MATH 18,B01,083748,Staff,0,15,30,30
1650649974115,MATH 18,B02,083749,Staff,0,11,30,30
1650649974115,MATH 18,B03,083750,Staff,0,12,30,30
1650649974115,MATH 18,B04,083751,Staff,0,12,30,30
1650649980148,MATH 20A,A01,083754,Staff,19,0,40,21
1650649986171,MATH 20B,A01,083756,Staff,0,12,30,30
1650649986171,MATH 20B,A02,083757,Staff,0,12,30,30
1650649992194,MATH 20C,A01,083760,Staff,0,15,30,30
1650649992194,MATH 20C,A02,083761,Staff,1,13,30,29
1650649992194,MATH 20C,B01,083762,Staff,11,0,30,19
1650649992194,MATH 20C,B02,083763,Staff,28,0,30,2
1650649998223,MATH 20D,A01,083765,Staff,1,1,30,29
1650649998223,MATH 20D,A02,083766,Staff,6,0,30,24
1650649998223,MATH 20D,A03,083767,Staff,24,0,30,6
1650650004245,MATH 20E,A01,083771,Staff,3,0,30,27
1650650004245,MATH 20E,A02,083772,Staff,16,0,30,14
1650650004245,MATH 20E,B01,083773,Staff,0,0,30,30
1650650004245,MATH 20E,B02,083774,Staff,9,0,30,21
1650650010278,MATH 103A,A01,083777,Staff,0,15,30,30
1650650010278,MATH 103A,A02,083778,Staff,0,15,30,30
1650650010278,MATH 103A,B01,083779,Staff,0,14,30,30
1650650010278,MATH 103A,B02,083780,Staff,0,14,30,30
1650650016302,MATH 105,A01,085443,Staff,0,22,30,30
1650650022329,MATH 109,A01,083213,Anzaldo; Leesa B,0,7,30,30
1650650022329,MATH 109,A02,083214,Anzaldo; Leesa B,0,7,30,30
1650650022329,MATH 109,B01,083215,Anzaldo; Leesa B,0,6,30,30
1650650022329,MATH 109,B02,083216,Anzaldo; Leesa B,0,6,30,30
1650650028354,MATH 142A,A01,083219,Chow; Bennett,0,16,30,30
1650650028354,MATH 142A,A02,083220,Chow; Bennett,0,15,30,30
1650650028354,MATH 142A,B01,083221,Chow; Bennett,0,14,30,30
1650650028354,MATH 142A,B02,083222,Chow; Bennett,0,13,30,30
1650650034385,MATH 193A,A01,083224,Staff,0,5,30,30
1650650034385,MATH 193A,A02,083225,Staff,0,6,30,30
1650650034385,MATH 193A,A03,083781,Staff,0,6,30,30
1650650034385,MATH 193A,A04,083782,Staff,0,7,30,30
1650650040409,MATH 197,001,091859,McAuley; Julian John,9998,0,9999,1
1650650046485,COGS 9,A01,083615,Staff,1,15,60,59
1650650052512,COGS 11,A01,083617,Boyle; Mary E. T.,18,0,40,22
1650650058535,COGS 13,A01,083071,Staff,0,38,40,40
1650650064559,COGS 14A,A01,092681,Staff,0,31,100,100
1650650070582,COGS 14B,A01,083073,Cheng; Tzu-Han,0,13,50,50
1650650076606,COGS 17,A01,092677,Staff,17,0,75,58
1650650082631,COGS 100,A01,083619,Staff,0,28,60,60
1650650088665,COGS 101A,A01,083621,Davis; Joshua Daniel,0,27,60,60
1650650094689,COGS 101B,A01,091572,Staff,0,4,60,60
1650650100721,COGS 101C,A01,083625,Delgado; Tania,15,0,30,15
1650650106744,COGS 107A,A01,083627,Boyle; Mary E. T.,1,16,60,59
1650650112772,COGS 118A,A01,083075,Staff,0,6,60,60
1650650118803,CSE 3,A50,083646,Miranda; Gregory Joseph,19,0,38,19
1650650118803,CSE 3,A51,083647,Miranda; Gregory Joseph,36,0,37,1
1650650124834,CSE 8A,A50,083650,Miranda; Gregory Joseph,0,30,40,40
1650650130860,CSE 11,A01,083080,Cao; Yingjun,0,95,40,40
1650650136885,CSE 12,A01,083652,Staff,0,19,100,100
1650650142913,CSE 15L,A01,083654,Staff,0,2,50,50
1650650142913,CSE 15L,A02,083655,Staff,0,1,50,50
1650650148939,CSE 20,A01,083657,Staff,51,0,80,29
1650650154965,CSE 30,A01,083084,Eldon; John,0,77,40,40
1650650161083,CSE 100,A01,083659,Cao; Yingjun,0,69,50,50
1650650167107,CSE 134B,A01,083661,Powell; Thomas Allan,0,37,65,65
1650650173134,CSE 140,A01,083663,Staff,0,8,75,75
1650650179175,CSE 140L,A01,083088,Eldon; John,0,16,75,75
1650650185214,CSE 175,A01,083665,Kumar; Rakesh,7,0,25,18
1650650191240,CSE 190,A00,092507,Dubnov; Shlomo,10,0,20,10
1650650197273,ECE 45,A01,083139,Staff,0,1,60,60
1650650203300,ECE 65,A50,083695,Staff,0,5,30,30
1650650209323,ECE 109,A01,091882,Touri; Behrouz,33,0,70,37
1650650215346,ECE 180,A00,083140,Abi Samra; Nicholas Camill,21,0,30,9
1650650215346,ECE 180,B00,083141,Abi Samra; Nicholas Camill,0,0,30,30
1650650221374,MATH 10A,A01,083735,Patchell; Gregory David,3,0,30,27
1650650221374,MATH 10A,A02,083736,Patchell; Gregory David,27,0,30,3
1650650221374,MATH 10A,A03,083737,Patchell; Gregory David,24,0,30,6
1650650227400,MATH 10B,A01,083207,Staff,0,8,30,30
1650650227400,MATH 10B,A02,083208,Staff,0,8,30,30
1650650227400,MATH 10B,B01,083739,Staff,11,0,30,19
1650650227400,MATH 10B,B02,083740,Staff,28,0,30,2
1650650233430,MATH 18,A01,083743,Staff,0,0,30,30
1650650233430,MATH 18,A02,083744,Staff,23,0,30,7
1650650233430,MATH 18,A03,083745,Staff,21,0,30,9
1650650233430,MATH 18,A04,083746,Staff,26,0,30,4
1650650233430,MATH 18,B01,083748,Staff,0,15,30,30
1650650233430,MATH 18,B02,083749,Staff,0,11,30,30
1650650233430,MATH 18,B03,083750,Staff,0,12,30,30
1650650233430,MATH 18,B04,083751,Staff,0,12,30,30
1650650239455,MATH 20A,A01,083754,Staff,19,0,40,21
1650650245481,MATH 20B,A01,083756,Staff,0,12,30,30
1650650245481,MATH 20B,A02,083757,Staff,0,12,30,30
1650650251509,MATH 20C,A01,083760,Staff,0,15,30,30
1650650251509,MATH 20C,A02,083761,Staff,1,13,30,29
1650650251509,MATH 20C,B01,083762,Staff,11,0,30,19
1650650251509,MATH 20C,B02,083763,Staff,28,0,30,2
1650650257538,MATH 20D,A01,083765,Staff,1,1,30,29
1650650257538,MATH 20D,A02,083766,Staff,6,0,30,24
1650650257538,MATH 20D,A03,083767,Staff,24,0,30,6
1650650263570,MATH 20E,A01,083771,Staff,3,0,30,27
1650650263570,MATH 20E,A02,083772,Staff,16,0,30,14
1650650263570,MATH 20E,B01,083773,Staff,0,0,30,30
1650650263570,MATH 20E,B02,083774,Staff,9,0,30,21
1650650269601,MATH 103A,A01,083777,Staff,0,15,30,30
1650650269601,MATH 103A,A02,083778,Staff,0,15,30,30
1650650269601,MATH 103A,B01,083779,Staff,0,14,30,30
1650650269601,MATH 103A,B02,083780,Staff,0,14,30,30
1650650275628,MATH 105,A01,085443,Staff,0,22,30,30
1650650281656,MATH 109,A01,083213,Anzaldo; Leesa B,0,7,30,30
1650650281656,MATH 109,A02,083214,Anzaldo; Leesa B,0,7,30,30
1650650281656,MATH 109,B01,083215,Anzaldo; Leesa B,0,6,30,30
1650650281656,MATH 109,B02,083216,Anzaldo; Leesa B,0,6,30,30
1650650287693,MATH 142A,A01,083219,Chow; Bennett,0,16,30,30
1650650287693,MATH 142A,A02,083220,Chow; Bennett,0,15,30,30
1650650287693,MATH 142A,B01,083221,Chow; Bennett,0,14,30,30
1650650287693,MATH 142A,B02,083222,Chow; Bennett,0,13,30,30
1650650293715,MATH 193A,A01,083224,Staff,0,5,30,30
1650650293715,MATH 193A,A02,083225,Staff,0,6,30,30
1650650293715,MATH 193A,A03,083781,Staff,0,6,30,30
1650650293715,MATH 193A,A04,083782,Staff,0,7,30,30
1650650299741,MATH 197,001,091859,McAuley; Julian John,9998,0,9999,1
1650650305807,COGS 9,A01,083615,Staff,1,15,60,59
1650650311831,COGS 11,A01,083617,Boyle; Mary E. T.,18,0,40,22
1650650317855,COGS 13,A01,083071,Staff,0,39,40,40
1650650323878,COGS 14A,A01,092681,Staff,0,31,100,100
1650650329906,COGS 14B,A01,083073,Cheng; Tzu-Han,0,13,50,50
1650650335935,COGS 17,A01,092677,Staff,17,0,75,58
1650650341963,COGS 100,A01,083619,Staff,0,28,60,60
1650650347991,COGS 101A,A01,083621,Davis; Joshua Daniel,0,27,60,60
1650650354014,COGS 101B,A01,091572,Staff,0,4,60,60
1650650360042,COGS 101C,A01,083625,Delgado; Tania,15,0,30,15
1650650366069,COGS 107A,A01,083627,Boyle; Mary E. T.,1,16,60,59
1650650372092,COGS 118A,A01,083075,Staff,0,7,60,60
1650650378116,CSE 3,A50,083646,Miranda; Gregory Joseph,19,0,38,19
1650650378116,CSE 3,A51,083647,Miranda; Gregory Joseph,36,0,37,1
1650650384142,CSE 8A,A50,083650,Miranda; Gregory Joseph,0,30,40,40
1650650390165,CSE 11,A01,083080,Cao; Yingjun,0,95,40,40
1650650396198,CSE 12,A01,083652,Staff,0,19,100,100
1650650402237,CSE 15L,A01,083654,Staff,0,2,50,50
1650650402237,CSE 15L,A02,083655,Staff,0,1,50,50
1650650408260,CSE 20,A01,083657,Staff,51,0,80,29
1650650414289,CSE 30,A01,083084,Eldon; John,0,77,40,40
1650650420315,CSE 100,A01,083659,Cao; Yingjun,0,69,50,50
1650650426339,CSE 134B,A01,083661,Powell; Thomas Allan,0,37,65,65
1650650432374,CSE 140,A01,083663,Staff,0,8,75,75
1650650438401,CSE 140L,A01,083088,Eldon; John,0,16,75,75
1650650444425,CSE 175,A01,083665,Kumar; Rakesh,7,0,25,18
1650650450452,CSE 190,A00,092507,Dubnov; Shlomo,10,0,20,10
1650650456476,ECE 45,A01,083139,Staff,0,1,60,60
1650650462512,ECE 65,A50,083695,Staff,0,5,30,30
1650650468540,ECE 109,A01,091882,Touri; Behrouz,33,0,70,37
1650650474569,ECE 180,A00,083140,Abi Samra; Nicholas Camill,21,0,30,9
1650650474569,ECE 180,B00,083141,Abi Samra; Nicholas Camill,0,0,30,30
1650650480593,MATH 10A,A01,083735,Patchell; Gregory David,3,0,30,27
1650650480593,MATH 10A,A02,083736,Patchell; Gregory David,27,0,30,3
1650650480593,MATH 10A,A03,083737,Patchell; Gregory David,24,0,30,6
1650650486619,MATH 10B,A01,083207,Staff,0,8,30,30
1650650486619,MATH 10B,A02,083208,Staff,0,8,30,30
1650650486619,MATH 10B,B01,083739,Staff,11,0,30,19
1650650486619,MATH 10B,B02,083740,Staff,28,0,30,2
1650650492644,MATH 18,A01,083743,Staff,0,0,30,30
1650650492644,MATH 18,A02,083744,Staff,23,0,30,7
1650650492644,MATH 18,A03,083745,Staff,21,0,30,9
1650650492644,MATH 18,A04,083746,Staff,26,0,30,4
1650650492644,MATH 18,B01,083748,Staff,0,15,30,30
1650650492644,MATH 18,B02,083749,Staff,0,11,30,30
1650650492644,MATH 18,B03,083750,Staff,0,12,30,30
1650650492644,MATH 18,B04,083751,Staff,0,12,30,30
1650650498668,MATH 20A,A01,083754,Staff,19,0,40,21
1650650504693,MATH 20B,A01,083756,Staff,0,12,30,30
1650650504693,MATH 20B,A02,083757,Staff,0,12,30,30
1650650510720,MATH 20C,A01,083760,Staff,0,15,30,30
1650650510720,MATH 20C,A02,083761,Staff,1,13,30,29
1650650510720,MATH 20C,B01,083762,Staff,11,0,30,19
1650650510720,MATH 20C,B02,083763,Staff,28,0,30,2
1650650516747,MATH 20D,A01,083765,Staff,1,1,30,29
1650650516747,MATH 20D,A02,083766,Staff,6,0,30,24
1650650516747,MATH 20D,A03,083767,Staff,24,0,30,6
1650650522772,MATH 20E,A01,083771,Staff,3,0,30,27
1650650522772,MATH 20E,A02,083772,Staff,16,0,30,14
1650650522772,MATH 20E,B01,083773,Staff,0,0,30,30
1650650522772,MATH 20E,B02,083774,Staff,9,0,30,21
1650650528801,MATH 103A,A01,083777,Staff,0,15,30,30
1650650528801,MATH 103A,A02,083778,Staff,0,15,30,30
1650650528801,MATH 103A,B01,083779,Staff,0,14,30,30
1650650528801,MATH 103A,B02,083780,Staff,0,14,30,30
1650650534828,MATH 105,A01,085443,Staff,0,22,30,30
1650650540854,MATH 109,A01,083213,Anzaldo; Leesa B,0,7,30,30
1650650540854,MATH 109,A02,083214,Anzaldo; Leesa B,0,7,30,30
1650650540854,MATH 109,B01,083215,Anzaldo; Leesa B,0,6,30,30
1650650540854,MATH 109,B02,083216,Anzaldo; Leesa B,0,6,30,30
1650650546883,MATH 142A,A01,083219,Chow; Bennett,0,16,30,30
1650650546883,MATH 142A,A02,083220,Chow; Bennett,0,15,30,30
1650650546883,MATH 142A,B01,083221,Chow; Bennett,0,14,30,30
1650650546883,MATH 142A,B02,083222,Chow; Bennett,0,13,30,30
1650650552927,MATH 193A,A01,083224,Staff,0,5,30,30
1650650552927,MATH 193A,A02,083225,Staff,0,6,30,30
1650650552927,MATH 193A,A03,083781,Staff,0,6,30,30
1650650552927,MATH 193A,A04,083782,Staff,0,7,30,30
1650650558950,MATH 197,001,091859,McAuley; Julian John,9998,0,9999,1
1650650565014,COGS 9,A01,083615,Staff,1,15,60,59
1650650571039,COGS 11,A01,083617,Boyle; Mary E. T.,18,0,40,22
1650650577064,COGS 13,A01,083071,Staff,0,39,40,40
1650650583088,COGS 14A,A01,092681,Staff,0,32,100,100
1650650589112,COGS 14B,A01,083073,Cheng; Tzu-Han,0,13,50,50
1650650595140,COGS 17,A01,092677,Staff,17,0,75,58
1650650601166,COGS 100,A01,083619,Staff,0,28,60,60
1650650607190,COGS 101A,A01,083621,Davis; Joshua Daniel,0,27,60,60
1650650613220,COGS 101B,A01,091572,Staff,0,4,60,60
1650650619243,COGS 101C,A01,083625,Delgado; Tania,15,0,30,15
1650650625266,COGS 107A,A01,083627,Boyle; Mary E. T.,1,16,60,59
1650650631290,COGS 118A,A01,083075,Staff,0,7,60,60
1650650637320,CSE 3,A50,083646,Miranda; Gregory Joseph,19,0,38,19
1650650637320,CSE 3,A51,083647,Miranda; Gregory Joseph,36,0,37,1
1650650643343,CSE 8A,A50,083650,Miranda; Gregory Joseph,0,30,40,40
1650650649369,CSE 11,A01,083080,Cao; Yingjun,0,95,40,40
1650650655393,CSE 12,A01,083652,Staff,0,19,100,100
1650650661417,CSE 15L,A01,083654,Staff,0,2,50,50
1650650661417,CSE 15L,A02,083655,Staff,0,1,50,50
1650650667443,CSE 20,A01,083657,Staff,51,0,80,29
1650650673468,CSE 30,A01,083084,Eldon; John,0,77,40,40
1650650679494,CSE 100,A01,083659,Cao; Yingjun,0,69,50,50
1650650685520,CSE 134B,A01,083661,Powell; Thomas Allan,0,37,65,65
1650650691546,CSE 140,A01,083663,Staff,0,8,75,75
1650650697581,CSE 140L,A01,083088,Eldon; John,0,16,75,75
1650650703608,CSE 175,A01,083665,Kumar; Rakesh,7,0,25,18
1650650709634,CSE 190,A00,092507,Dubnov; Shlomo,10,0,20,10
1650650715659,ECE 45,A01,083139,Staff,0,1,60,60
1650650721688,ECE 65,A50,083695,Staff,0,5,30,30
1650650727721,ECE 109,A01,091882,Touri; Behrouz,33,0,70,37
1650650733748,ECE 180,A00,083140,Abi Samra; Nicholas Camill,21,0,30,9
1650650733748,ECE 180,B00,083141,Abi Samra; Nicholas Camill,0,0,30,30
1650650739781,MATH 10A,A01,083735,Patchell; Gregory David,3,0,30,27
1650650739781,MATH 10A,A02,083736,Patchell; Gregory David,27,0,30,3
1650650739781,MATH 10A,A03,083737,Patchell; Gregory David,24,0,30,6
1650650745808,MATH 10B,A01,083207,Staff,0,8,30,30
1650650745808,MATH 10B,A02,083208,Staff,0,8,30,30
1650650745808,MATH 10B,B01,083739,Staff,11,0,30,19
1650650745808,MATH 10B,B02,083740,Staff,28,0,30,2
1650650751832,MATH 18,A01,083743,Staff,0,0,30,30
1650650751832,MATH 18,A02,083744,Staff,23,0,30,7
1650650751832,MATH 18,A03,083745,Staff,21,0,30,9
1650650751832,MATH 18,A04,083746,Staff,26,0,30,4
1650650751832,MATH 18,B01,083748,Staff,0,15,30,30
1650650751832,MATH 18,B02,083749,Staff,0,11,30,30
1650650751832,MATH 18,B03,083750,Staff,0,12,30,30
1650650751832,MATH 18,B04,083751,Staff,0,12,30,30
1650650757964,MATH 20A,A01,083754,Staff,19,0,40,21
1650650764002,MATH 20B,A01,083756,Staff,0,12,30,30
1650650764002,MATH 20B,A02,083757,Staff,0,12,30,30
1650650779872,MATH 20C,A01,083760,Staff,0,15,30,30
1650650779872,MATH 20C,A02,083761,Staff,1,13,30,29
1650650779872,MATH 20C,B01,083762,Staff,11,0,30,19
1650650779872,MATH 20C,B02,083763,Staff,28,0,30,2
1650650785902,MATH 20D,A01,083765,Staff,1,1,30,29
1650650785902,MATH 20D,A02,083766,Staff,6,0,30,24
1650650785902,MATH 20D,A03,083767,Staff,24,0,30,6
1650650791930,MATH 20E,A01,083771,Staff,3,0,30,27
1650650791930,MATH 20E,A02,083772,Staff,16,0,30,14
1650650791930,MATH 20E,B01,083773,Staff,0,0,30,30
1650650791930,MATH 20E,B02,083774,Staff,9,0,30,21
1650650797969,MATH 103A,A01,083777,Staff,0,15,30,30
1650650797969,MATH 103A,A02,083778,Staff,0,15,30,30
1650650797969,MATH 103A,B01,083779,Staff,0,14,30,30
1650650797969,MATH 103A,B02,083780,Staff,0,14,30,30
1650650803994,MATH 105,A01,085443,Staff,0,22,30,30
1650650810017,MATH 109,A01,083213,Anzaldo; Leesa B,0,7,30,30
1650650810017,MATH 109,A02,083214,Anzaldo; Leesa B,0,7,30,30
1650650810017,MATH 109,B01,083215,Anzaldo; Leesa B,0,6,30,30
1650650810017,MATH 109,B02,083216,Anzaldo; Leesa B,0,6,30,30
1650650816041,MATH 142A,A01,083219,Chow; Bennett,0,16,30,30
1650650816041,MATH 142A,A02,083220,Chow; Bennett,0,15,30,30
1650650816041,MATH 142A,B01,083221,Chow; Bennett,0,14,30,30
1650650816041,MATH 142A,B02,083222,Chow; Bennett,0,13,30,30
1650650822071,MATH 193A,A01,083224,Staff,0,5,30,30
1650650822071,MATH 193A,A02,083225,Staff,0,6,30,30
1650650822071,MATH 193A,A03,083781,Staff,0,6,30,30
1650650822071,MATH 193A,A04,083782,Staff,0,7,30,30
1650650828107,MATH 197,001,091859,McAuley; Julian John,9998,0,9999,1
1650650834165,COGS 9,A01,083615,Staff,1,15,60,59
1650650840193,COGS 11,A01,083617,Boyle; Mary E. T.,18,0,40,22
1650650846216,COGS 13,A01,083071,Staff,0,39,40,40
1650650852242,COGS 14A,A01,092681,Staff,0,32,100,100
1650650858265,COGS 14B,A01,083073,Cheng; Tzu-Han,0,13,50,50
1650650864291,COGS 17,A01,092677,Staff,17,0,75,58
1650650870317,COGS 100,A01,083619,Staff,0,28,60,60
1650650876353,COGS 101A,A01,083621,Davis; Joshua Daniel,0,27,60,60
1650650882419,COGS 101B,A01,091572,Staff,0,4,60,60
1650650888449,COGS 101C,A01,083625,Delgado; Tania,15,0,30,15
1650650894477,COGS 107A,A01,083627,Boyle; Mary E. T.,1,16,60,59
1650650900502,COGS 118A,A01,083075,Staff,0,7,60,60
1650650906526,CSE 3,A50,083646,Miranda; Gregory Joseph,19,0,38,19
1650650906526,CSE 3,A51,083647,Miranda; Gregory Joseph,36,0,37,1
1650650912561,CSE 8A,A50,083650,Miranda; Gregory Joseph,0,30,40,40
1650650918584,CSE 11,A01,083080,Cao; Yingjun,0,95,40,40
1650650924606,CSE 12,A01,083652,Staff,0,19,100,100
1650650930643,CSE 15L,A01,083654,Staff,0,2,50,50
1650650930643,CSE 15L,A02,083655,Staff,0,1,50,50
1650650936667,CSE 20,A01,083657,Staff,51,0,80,29
1650650942693,CSE 30,A01,083084,Eldon; John,0,77,40,40
1650650948721,CSE 100,A01,083659,Cao; Yingjun,0,69,50,50
1650650954746,CSE 134B,A01,083661,Powell; Thomas Allan,0,37,65,65
1650650960769,CSE 140,A01,083663,Staff,0,8,75,75
1650650966793,CSE 140L,A01,083088,Eldon; John,0,16,75,75
1650650972821,CSE 175,A01,083665,Kumar; Rakesh,7,0,25,18
1650650978848,CSE 190,A00,092507,Dubnov; Shlomo,10,0,20,10
1650650984875,ECE 45,A01,083139,Staff,0,1,60,60
1650650990901,ECE 65,A50,083695,Staff,0,5,30,30
1650650996927,ECE 109,A01,091882,Touri; Behrouz,33,0,70,37
1650651002955,ECE 180,A00,083140,Abi Samra; Nicholas Camill,21,0,30,9
1650651002955,ECE 180,B00,083141,Abi Samra; Nicholas Camill,0,0,30,30
1650651008979,MATH 10A,A01,083735,Patchell; Gregory David,3,0,30,27
1650651008979,MATH 10A,A02,083736,Patchell; Gregory David,27,0,30,3
1650651008979,MATH 10A,A03,083737,Patchell; Gregory David,24,0,30,6
1650651015006,MATH 10B,A01,083207,Staff,0,8,30,30
1650651015006,MATH 10B,A02,083208,Staff,0,8,30,30
1650651015006,MATH 10B,B01,083739,Staff,11,0,30,19
1650651015006,MATH 10B,B02,083740,Staff,28,0,30,2
1650651021036,MATH 18,A01,083743,Staff,0,0,30,30
1650651021036,MATH 18,A02,083744,Staff,23,0,30,7
1650651021036,MATH 18,A03,083745,Staff,21,0,30,9
1650651021036,MATH 18,A04,083746,Staff,26,0,30,4
1650651021036,MATH 18,B01,083748,Staff,0,15,30,30
1650651021036,MATH 18,B02,083749,Staff,0,11,30,30
1650651021036,MATH 18,B03,083750,Staff,0,12,30,30
1650651021036,MATH 18,B04,083751,Staff,0,12,30,30
1650651027060,MATH 20A,A01,083754,Staff,19,0,40,21
1650651033084,MATH 20B,A01,083756,Staff,0,12,30,30
1650651033084,MATH 20B,A02,083757,Staff,0,12,30,30
1650651039110,MATH 20C,A01,083760,Staff,0,16,30,30
1650651039110,MATH 20C,A02,083761,Staff,1,13,30,29
1650651039110,MATH 20C,B01,083762,Staff,11,0,30,19
1650651039110,MATH 20C,B02,083763,Staff,28,0,30,2
1650651045133,MATH 20D,A01,083765,Staff,1,1,30,29
1650651045133,MATH 20D,A02,083766,Staff,6,0,30,24
1650651045133,MATH 20D,A03,083767,Staff,24,0,30,6
1650651051158,MATH 20E,A01,083771,Staff,3,0,30,27
1650651051158,MATH 20E,A02,083772,Staff,16,0,30,14
1650651051158,MATH 20E,B01,083773,Staff,0,0,30,30
1650651051158,MATH 20E,B02,083774,Staff,9,0,30,21
1650651057188,MATH 103A,A01,083777,Staff,0,15,30,30
1650651057188,MATH 103A,A02,083778,Staff,0,15,30,30
1650651057188,MATH 103A,B01,083779,Staff,0,14,30,30
1650651057188,MATH 103A,B02,083780,Staff,0,14,30,30
1650651063210,MATH 105,A01,085443,Staff,0,22,30,30
1650651069234,MATH 109,A01,083213,Anzaldo; Leesa B,0,7,30,30
1650651069234,MATH 109,A02,083214,Anzaldo; Leesa B,0,7,30,30
1650651069234,MATH 109,B01,083215,Anzaldo; Leesa B,0,6,30,30
1650651069234,MATH 109,B02,083216,Anzaldo; Leesa B,0,6,30,30
1650651075261,MATH 142A,A01,083219,Chow; Bennett,0,16,30,30
1650651075261,MATH 142A,A02,083220,Chow; Bennett,0,15,30,30
1650651075261,MATH 142A,B01,083221,Chow; Bennett,0,14,30,30
1650651075261,MATH 142A,B02,083222,Chow; Bennett,0,13,30,30
1650651081284,MATH 193A,A01,083224,Staff,0,5,30,30
1650651081284,MATH 193A,A02,083225,Staff,0,6,30,30
1650651081284,MATH 193A,A03,083781,Staff,0,6,30,30
1650651081284,MATH 193A,A04,083782,Staff,0,7,30,30
1650651087316,MATH 197,001,091859,McAuley; Julian John,9998,0,9999,1
1650651093368,COGS 9,A01,083615,Staff,1,15,60,59
1650651099395,COGS 11,A01,083617,Boyle; Mary E. T.,18,0,40,22
1650651105423,COGS 13,A01,083071,Staff,0,39,40,40
1650651111447,COGS 14A,A01,092681,Staff,0,32,100,100
1650651117470,COGS 14B,A01,083073,Cheng; Tzu-Han,0,13,50,50
1650651123499,COGS 17,A01,092677,Staff,17,0,75,58
1650651129527,COGS 100,A01,083619,Staff,0,28,60,60
1650651135555,COGS 101A,A01,083621,Davis; Joshua Daniel,0,27,60,60
1650651141586,COGS 101B,A01,091572,Staff,0,4,60,60
1650651147612,COGS 101C,A01,083625,Delgado; Tania,15,0,30,15
1650651153636,COGS 107A,A01,083627,Boyle; Mary E. T.,1,16,60,59
1650651159660,COGS 118A,A01,083075,Staff,0,7,60,60
1650651165688,CSE 3,A50,083646,Miranda; Gregory Joseph,19,0,38,19
1650651165688,CSE 3,A51,083647,Miranda; Gregory Joseph,36,0,37,1
1650651171718,CSE 8A,A50,083650,Miranda; Gregory Joseph,0,30,40,40
1650651177742,CSE 11,A01,083080,Cao; Yingjun,0,95,40,40
1650651183765,CSE 12,A01,083652,Staff,0,19,100,100
1650651189792,CSE 15L,A01,083654,Staff,0,2,50,50
1650651189792,CSE 15L,A02,083655,Staff,0,1,50,50
1650651195815,CSE 20,A01,083657,Staff,51,0,80,29
1650651201841,CSE 30,A01,083084,Eldon; John,0,77,40,40
1650651207870,CSE 100,A01,083659,Cao; Yingjun,0,69,50,50
1650651213904,CSE 134B,A01,083661,Powell; Thomas Allan,0,37,65,65
1650651219938,CSE 140,A01,083663,Staff,0,8,75,75
1650651225961,CSE 140L,A01,083088,Eldon; John,0,16,75,75
1650651231987,CSE 175,A01,083665,Kumar; Rakesh,7,0,25,18
1650651238009,CSE 190,A00,092507,Dubnov; Shlomo,10,0,20,10
1650651244045,ECE 45,A01,083139,Staff,0,1,60,60
1650651250069,ECE 65,A50,083695,Staff,0,5,30,30
1650651256113,ECE 109,A01,091882,Touri; Behrouz,33,0,70,37
1650651262141,ECE 180,A00,083140,Abi Samra; Nicholas Camill,21,0,30,9
1650651262141,ECE 180,B00,083141,Abi Samra; Nicholas Camill,0,0,30,30
1650651268165,MATH 10A,A01,083735,Patchell; Gregory David,3,0,30,27
1650651268165,MATH 10A,A02,083736,Patchell; Gregory David,27,0,30,3
1650651268165,MATH 10A,A03,083737,Patchell; Gregory David,24,0,30,6
1650651274199,MATH 10B,A01,083207,Staff,0,8,30,30
1650651274199,MATH 10B,A02,083208,Staff,0,8,30,30
1650651274199,MATH 10B,B01,083739,Staff,11,0,30,19
1650651274199,MATH 10B,B02,083740,Staff,28,0,30,2
1650651280226,MATH 18,A01,083743,Staff,0,0,30,30
1650651280226,MATH 18,A02,083744,Staff,23,0,30,7
1650651280226,MATH 18,A03,083745,Staff,21,0,30,9
1650651280226,MATH 18,A04,083746,Staff,26,0,30,4
1650651280226,MATH 18,B01,083748,Staff,0,15,30,30
1650651280226,MATH 18,B02,083749,Staff,0,11,30,30
1650651280226,MATH 18,B03,083750,Staff,0,12,30,30
1650651280226,MATH 18,B04,083751,Staff,0,12,30,30
1650651286257,MATH 20A,A01,083754,Staff,19,0,40,21
1650651292288,MATH 20B,A01,083756,Staff,0,12,30,30
1650651292288,MATH 20B,A02,083757,Staff,0,12,30,30
1650651298320,MATH 20C,A01,083760,Staff,0,16,30,30
1650651298320,MATH 20C,A02,083761,Staff,1,13,30,29
1650651298320,MATH 20C,B01,083762,Staff,11,0,30,19
1650651298320,MATH 20C,B02,083763,Staff,28,0,30,2
1650651304344,MATH 20D,A01,083765,Staff,1,1,30,29
1650651304344,MATH 20D,A02,083766,Staff,6,0,30,24
1650651304344,MATH 20D,A03,083767,Staff,24,0,30,6
1650651310367,MATH 20E,A01,083771,Staff,3,0,30,27
1650651310367,MATH 20E,A02,083772,Staff,16,0,30,14
1650651310367,MATH 20E,B01,083773,Staff,0,0,30,30
1650651310367,MATH 20E,B02,083774,Staff,9,0,30,21
1650651316403,MATH 103A,A01,083777,Staff,0,15,30,30
1650651316403,MATH 103A,A02,083778,Staff,0,15,30,30
1650651316403,MATH 103A,B01,083779,Staff,0,14,30,30
1650651316403,MATH 103A,B02,083780,Staff,0,14,30,30
1650651322440,MATH 105,A01,085443,Staff,0,22,30,30
1650651328469,MATH 109,A01,083213,Anzaldo; Leesa B,0,7,30,30
1650651328469,MATH 109,A02,083214,Anzaldo; Leesa B,0,7,30,30
1650651328469,MATH 109,B01,083215,Anzaldo; Leesa B,0,6,30,30
1650651328469,MATH 109,B02,083216,Anzaldo; Leesa B,0,6,30,30
1650651334498,MATH 142A,A01,083219,Chow; Bennett,0,16,30,30
1650651334498,MATH 142A,A02,083220,Chow; Bennett,0,15,30,30
1650651334498,MATH 142A,B01,083221,Chow; Bennett,0,14,30,30
1650651334498,MATH 142A,B02,083222,Chow; Bennett,0,13,30,30
1650651340526,MATH 193A,A01,083224,Staff,0,5,30,30
1650651340526,MATH 193A,A02,083225,Staff,0,6,30,30
1650651340526,MATH 193A,A03,083781,Staff,0,6,30,30
1650651340526,MATH 193A,A04,083782,Staff,0,7,30,30
1650651346565,MATH 197,001,091859,McAuley; Julian John,9998,0,9999,1
1650651352631,COGS 9,A01,083615,Staff,1,15,60,59
1650651358767,COGS 11,A01,083617,Boyle; Mary E. T.,18,0,40,22
1650651364790,COGS 13,A01,083071,Staff,0,39,40,40
1650651370822,COGS 14A,A01,092681,Staff,0,32,100,100
1650651376846,COGS 14B,A01,083073,Cheng; Tzu-Han,0,13,50,50
1650651382871,COGS 17,A01,092677,Staff,17,0,75,58
1650651388895,COGS 100,A01,083619,Staff,0,28,60,60
1650651394920,COGS 101A,A01,083621,Davis; Joshua Daniel,0,27,60,60
1650651400943,COGS 101B,A01,091572,Staff,0,4,60,60
1650651406974,COGS 101C,A01,083625,Delgado; Tania,15,0,30,15
1650651413003,COGS 107A,A01,083627,Boyle; Mary E. T.,1,16,60,59
1650651419030,COGS 118A,A01,083075,Staff,0,7,60,60
1650651425056,CSE 3,A50,083646,Miranda; Gregory Joseph,19,0,38,19
1650651425056,CSE 3,A51,083647,Miranda; Gregory Joseph,36,0,37,1
1650651431083,CSE 8A,A50,083650,Miranda; Gregory Joseph,0,30,40,40
1650651437106,CSE 11,A01,083080,Cao; Yingjun,0,95,40,40
1650651443131,CSE 12,A01,083652,Staff,0,19,100,100
1650651449158,CSE 15L,A01,083654,Staff,0,2,50,50
1650651449158,CSE 15L,A02,083655,Staff,0,1,50,50
1650651455182,CSE 20,A01,083657,Staff,51,0,80,29
1650651461206,CSE 30,A01,083084,Eldon; John,0,77,40,40
1650651467230,CSE 100,A01,083659,Cao; Yingjun,0,69,50,50
1650651473259,CSE 134B,A01,083661,Powell; Thomas Allan,0,37,65,65
1650651479290,CSE 140,A01,083663,Staff,0,8,75,75
1650651485327,CSE 140L,A01,083088,Eldon; John,0,16,75,75
1650651491366,CSE 175,A01,083665,Kumar; Rakesh,7,0,25,18
1650651497389,CSE 190,A00,092507,Dubnov; Shlomo,10,0,20,10
1650651503431,ECE 45,A01,083139,Staff,0,1,60,60
1650651509454,ECE 65,A50,083695,Staff,0,5,30,30
1650651515478,ECE 109,A01,091882,Touri; Behrouz,33,0,70,37
1650651521511,ECE 180,A00,083140,Abi Samra; Nicholas Camill,21,0,30,9
1650651521511,ECE 180,B00,083141,Abi Samra; Nicholas Camill,0,0,30,30
1650651527535,MATH 10A,A01,083735,Patchell; Gregory David,3,0,30,27
1650651527535,MATH 10A,A02,083736,Patchell; Gregory David,27,0,30,3
1650651527535,MATH 10A,A03,083737,Patchell; Gregory David,24,0,30,6
1650651533577,MATH 10B,A01,083207,Staff,0,8,30,30
1650651533577,MATH 10B,A02,083208,Staff,0,8,30,30
1650651533577,MATH 10B,B01,083739,Staff,11,0,30,19
1650651533577,MATH 10B,B02,083740,Staff,28,0,30,2
1650651539612,MATH 18,A01,083743,Staff,0,0,30,30
1650651539612,MATH 18,A02,083744,Staff,23,0,30,7
1650651539612,MATH 18,A03,083745,Staff,21,0,30,9
1650651539612,MATH 18,A04,083746,Staff,26,0,30,4
1650651539612,MATH 18,B01,083748,Staff,0,15,30,30
1650651539612,MATH 18,B02,083749,Staff,0,11,30,30
1650651539612,MATH 18,B03,083750,Staff,0,12,30,30
1650651539612,MATH 18,B04,083751,Staff,0,12,30,30
1650651545636,MATH 20A,A01,083754,Staff,19,0,40,21
1650651551659,MATH 20B,A01,083756,Staff,0,12,30,30
1650651551659,MATH 20B,A02,083757,Staff,0,12,30,30
1650651557691,MATH 20C,A01,083760,Staff,0,16,30,30
1650651557691,MATH 20C,A02,083761,Staff,1,13,30,29
1650651557691,MATH 20C,B01,083762,Staff,11,0,30,19
1650651557691,MATH 20C,B02,083763,Staff,28,0,30,2
1650651563716,MATH 20D,A01,083765,Staff,1,1,30,29
1650651563716,MATH 20D,A02,083766,Staff,6,0,30,24
1650651563716,MATH 20D,A03,083767,Staff,24,0,30,6
1650651569742,MATH 20E,A01,083771,Staff,3,0,30,27
1650651569742,MATH 20E,A02,083772,Staff,16,0,30,14
1650651569742,MATH 20E,B01,083773,Staff,0,0,30,30
1650651569742,MATH 20E,B02,083774,Staff,9,0,30,21
1650651575769,MATH 103A,A01,083777,Staff,0,15,30,30
1650651575769,MATH 103A,A02,083778,Staff,0,15,30,30
1650651575769,MATH 103A,B01,083779,Staff,0,14,30,30
1650651575769,MATH 103A,B02,083780,Staff,0,14,30,30
1650651581791,MATH 105,A01,085443,Staff,0,22,30,30
1650651587826,MATH 109,A01,083213,Anzaldo; Leesa B,0,7,30,30
1650651587826,MATH 109,A02,083214,Anzaldo; Leesa B,0,7,30,30
1650651587826,MATH 109,B01,083215,Anzaldo; Leesa B,0,6,30,30
1650651587826,MATH 109,B02,083216,Anzaldo; Leesa B,0,6,30,30
1650651593851,MATH 142A,A01,083219,Chow; Bennett,0,16,30,30
1650651593851,MATH 142A,A02,083220,Chow; Bennett,0,15,30,30
1650651593851,MATH 142A,B01,083221,Chow; Bennett,0,14,30,30
1650651593851,MATH 142A,B02,083222,Chow; Bennett,0,13,30,30
1650651599876,MATH 193A,A01,083224,Staff,0,5,30,30
1650651599876,MATH 193A,A02,083225,Staff,0,6,30,30
1650651599876,MATH 193A,A03,083781,Staff,0,6,30,30
1650651599876,MATH 193A,A04,083782,Staff,0,7,30,30
1650651605902,MATH 197,001,091859,McAuley; Julian John,9998,0,9999,1
1650651611954,COGS 9,A01,083615,Staff,1,16,60,59
1650651617978,COGS 11,A01,083617,Boyle; Mary E. T.,18,0,40,22
1650651624005,COGS 13,A01,083071,Staff,0,39,40,40
1650651630032,COGS 14A,A01,092681,Staff,0,32,100,100
1650651636056,COGS 14B,A01,083073,Cheng; Tzu-Han,0,13,50,50
1650651642079,COGS 17,A01,092677,Staff,17,0,75,58
1650651648104,COGS 100,A01,083619,Staff,0,28,60,60
1650651654131,COGS 101A,A01,083621,Davis; Joshua Daniel,0,27,60,60
1650651660154,COGS 101B,A01,091572,Staff,0,4,60,60
1650651666181,COGS 101C,A01,083625,Delgado; Tania,15,0,30,15
1650651672209,COGS 107A,A01,083627,Boyle; Mary E. T.,1,17,60,59
1650651678237,COGS 118A,A01,083075,Staff,0,7,60,60
1650651684259,CSE 3,A50,083646,Miranda; Gregory Joseph,19,0,38,19
1650651684259,CSE 3,A51,083647,Miranda; Gregory Joseph,36,0,37,1
1650651690288,CSE 8A,A50,083650,Miranda; Gregory Joseph,0,30,40,40
1650651696396,CSE 11,A01,083080,Cao; Yingjun,0,95,40,40
1650651702421,CSE 12,A01,083652,Staff,0,19,100,100
1650651708444,CSE 15L,A01,083654,Staff,0,2,50,50
1650651708444,CSE 15L,A02,083655,Staff,0,1,50,50
1650651714473,CSE 20,A01,083657,Staff,51,0,80,29
1650651720509,CSE 30,A01,083084,Eldon; John,0,77,40,40
1650651726536,CSE 100,A01,083659,Cao; Yingjun,0,69,50,50
1650651732564,CSE 134B,A01,083661,Powell; Thomas Allan,0,37,65,65
1650651738585,CSE 140,A01,083663,Staff,0,8,75,75
1650651744614,CSE 140L,A01,083088,Eldon; John,0,16,75,75
1650651750636,CSE 175,A01,083665,Kumar; Rakesh,7,0,25,18
1650651756661,CSE 190,A00,092507,Dubnov; Shlomo,10,0,20,10
1650651762683,ECE 45,A01,083139,Staff,0,1,60,60
1650651768707,ECE 65,A50,083695,Staff,0,5,30,30
1650651774732,ECE 109,A01,091882,Touri; Behrouz,33,0,70,37
1650651780768,ECE 180,A00,083140,Abi Samra; Nicholas Camill,21,0,30,9
1650651780768,ECE 180,B00,083141,Abi Samra; Nicholas Camill,0,0,30,30
1650651786791,MATH 10A,A01,083735,Patchell; Gregory David,3,0,30,27
1650651786791,MATH 10A,A02,083736,Patchell; Gregory David,27,0,30,3
1650651786791,MATH 10A,A03,083737,Patchell; Gregory David,24,0,30,6
1650651792815,MATH 10B,A01,083207,Staff,0,8,30,30
1650651792815,MATH 10B,A02,083208,Staff,0,8,30,30
1650651792815,MATH 10B,B01,083739,Staff,11,0,30,19
1650651792815,MATH 10B,B02,083740,Staff,28,0,30,2
1650651798844,MATH 18,A01,083743,Staff,0,0,30,30
1650651798844,MATH 18,A02,083744,Staff,23,0,30,7
1650651798844,MATH 18,A03,083745,Staff,21,0,30,9
1650651798844,MATH 18,A04,083746,Staff,26,0,30,4
1650651798844,MATH 18,B01,083748,Staff,0,15,30,30
1650651798844,MATH 18,B02,083749,Staff,0,11,30,30
1650651798844,MATH 18,B03,083750,Staff,0,12,30,30
1650651798844,MATH 18,B04,083751,Staff,0,12,30,30
1650651804869,MATH 20A,A01,083754,Staff,19,0,40,21
1650651810895,MATH 20B,A01,083756,Staff,0,12,30,30
1650651810895,MATH 20B,A02,083757,Staff,0,12,30,30
1650651816924,MATH 20C,A01,083760,Staff,0,16,30,30
1650651816924,MATH 20C,A02,083761,Staff,1,13,30,29
1650651816924,MATH 20C,B01,083762,Staff,11,0,30,19
1650651816924,MATH 20C,B02,083763,Staff,28,0,30,2
1650651822955,MATH 20D,A01,083765,Staff,1,1,30,29
1650651822955,MATH 20D,A02,083766,Staff,6,0,30,24
1650651822955,MATH 20D,A03,083767,Staff,24,0,30,6
1650651828993,MATH 20E,A01,083771,Staff,3,0,30,27
1650651828993,MATH 20E,A02,083772,Staff,16,0,30,14
1650651828993,MATH 20E,B01,083773,Staff,0,0,30,30
1650651828993,MATH 20E,B02,083774,Staff,9,0,30,21
1650651835017,MATH 103A,A01,083777,Staff,0,15,30,30
1650651835017,MATH 103A,A02,083778,Staff,0,15,30,30
1650651835017,MATH 103A,B01,083779,Staff,0,14,30,30
1650651835017,MATH 103A,B02,083780,Staff,0,14,30,30
1650651841051,MATH 105,A01,085443,Staff,0,22,30,30
1650651847075,MATH 109,A01,083213,Anzaldo; Leesa B,0,7,30,30
1650651847075,MATH 109,A02,083214,Anzaldo; Leesa B,0,7,30,30
1650651847075,MATH 109,B01,083215,Anzaldo; Leesa B,0,6,30,30
1650651847075,MATH 109,B02,083216,Anzaldo; Leesa B,0,6,30,30
1650651853100,MATH 142A,A01,083219,Chow; Bennett,0,16,30,30
1650651853100,MATH 142A,A02,083220,Chow; Bennett,0,15,30,30
1650651853100,MATH 142A,B01,083221,Chow; Bennett,0,14,30,30
1650651853100,MATH 142A,B02,083222,Chow; Bennett,0,13,30,30
1650651859125,MATH 193A,A01,083224,Staff,0,5,30,30
1650651859125,MATH 193A,A02,083225,Staff,0,6,30,30
1650651859125,MATH 193A,A03,083781,Staff,0,6,30,30
1650651859125,MATH 193A,A04,083782,Staff,0,7,30,30
1650651865153,MATH 197,001,091859,McAuley; Julian John,9998,0,9999,1
1650651871207,COGS 9,A01,083615,Staff,1,16,60,59
1650651877231,COGS 11,A01,083617,Boyle; Mary E. T.,18,0,40,22
1650651883256,COGS 13,A01,083071,Staff,0,39,40,40
1650651889282,COGS 14A,A01,092681,Staff,0,32,100,100
1650651895305,COGS 14B,A01,083073,Cheng; Tzu-Han,0,13,50,50
1650651901349,COGS 17,A01,092677,Staff,17,0,75,58
1650651907373,COGS 100,A01,083619,Staff,0,28,60,60
1650651913398,COGS 101A,A01,083621,Davis; Joshua Daniel,0,27,60,60
1650651919425,COGS 101B,A01,091572,Staff,0,4,60,60
1650651925448,COGS 101C,A01,083625,Delgado; Tania,15,0,30,15
1650651931475,COGS 107A,A01,083627,Boyle; Mary E. T.,1,17,60,59
1650651937500,COGS 118A,A01,083075,Staff,0,7,60,60
1650651943524,CSE 3,A50,083646,Miranda; Gregory Joseph,19,0,38,19
1650651943524,CSE 3,A51,083647,Miranda; Gregory Joseph,36,0,37,1
1650651949549,CSE 8A,A50,083650,Miranda; Gregory Joseph,0,30,40,40
1650651955665,CSE 11,A01,083080,Cao; Yingjun,0,95,40,40
1650651961692,CSE 12,A01,083652,Staff,0,19,100,100
1650651967725,CSE 15L,A01,083654,Staff,0,2,50,50
1650651967725,CSE 15L,A02,083655,Staff,0,1,50,50
1650651973751,CSE 20,A01,083657,Staff,51,0,80,29
1650651979787,CSE 30,A01,083084,Eldon; John,0,77,40,40
1650651985808,CSE 100,A01,083659,Cao; Yingjun,0,69,50,50
1650651991844,CSE 134B,A01,083661,Powell; Thomas Allan,0,37,65,65
1650651997872,CSE 140,A01,083663,Staff,0,8,75,75
1650652003898,CSE 140L,A01,083088,Eldon; John,0,16,75,75
1650652009922,CSE 175,A01,083665,Kumar; Rakesh,7,0,25,18
1650652015946,CSE 190,A00,092507,Dubnov; Shlomo,10,0,20,10
1650652021973,ECE 45,A01,083139,Staff,0,1,60,60
1650652027999,ECE 65,A50,083695,Staff,0,5,30,30
1650652034025,ECE 109,A01,091882,Touri; Behrouz,33,0,70,37
1650652040049,ECE 180,A00,083140,Abi Samra; Nicholas Camill,21,0,30,9
1650652040049,ECE 180,B00,083141,Abi Samra; Nicholas Camill,0,0,30,30
1650652046072,MATH 10A,A01,083735,Patchell; Gregory David,3,0,30,27
1650652046072,MATH 10A,A02,083736,Patchell; Gregory David,27,0,30,3
1650652046072,MATH 10A,A03,083737,Patchell; Gregory David,24,0,30,6
1650652052095,MATH 10B,A01,083207,Staff,0,8,30,30
1650652052095,MATH 10B,A02,083208,Staff,0,8,30,30
1650652052095,MATH 10B,B01,083739,Staff,11,0,30,19
1650652052095,MATH 10B,B02,083740,Staff,28,0,30,2
1650652058123,MATH 18,A01,083743,Staff,0,0,30,30
1650652058123,MATH 18,A02,083744,Staff,23,0,30,7
1650652058123,MATH 18,A03,083745,Staff,21,0,30,9
1650652058123,MATH 18,A04,083746,Staff,26,0,30,4
1650652058123,MATH 18,B01,083748,Staff,0,15,30,30
1650652058123,MATH 18,B02,083749,Staff,0,11,30,30
1650652058123,MATH 18,B03,083750,Staff,0,12,30,30
1650652058123,MATH 18,B04,083751,Staff,0,12,30,30
1650652064146,MATH 20A,A01,083754,Staff,19,0,40,21
1650652070170,MATH 20B,A01,083756,Staff,0,11,30,30
1650652070170,MATH 20B,A02,083757,Staff,0,12,30,30
1650652076194,MATH 20C,A01,083760,Staff,0,16,30,30
1650652076194,MATH 20C,A02,083761,Staff,1,13,30,29
1650652076194,MATH 20C,B01,083762,Staff,11,0,30,19
1650652076194,MATH 20C,B02,083763,Staff,28,0,30,2
1650652082222,MATH 20D,A01,083765,Staff,1,1,30,29
1650652082222,MATH 20D,A02,083766,Staff,6,0,30,24
1650652082222,MATH 20D,A03,083767,Staff,24,0,30,6
1650652088248,MATH 20E,A01,083771,Staff,3,0,30,27
1650652088248,MATH 20E,A02,083772,Staff,16,0,30,14
1650652088248,MATH 20E,B01,083773,Staff,0,0,30,30
1650652088248,MATH 20E,B02,083774,Staff,9,0,30,21
1650652094275,MATH 103A,A01,083777,Staff,0,15,30,30
1650652094275,MATH 103A,A02,083778,Staff,0,15,30,30
1650652094275,MATH 103A,B01,083779,Staff,0,14,30,30
1650652094275,MATH 103A,B02,083780,Staff,0,14,30,30
1650652100302,MATH 105,A01,085443,Staff,0,22,30,30
1650652106325,MATH 109,A01,083213,Anzaldo; Leesa B,0,7,30,30
1650652106325,MATH 109,A02,083214,Anzaldo; Leesa B,0,7,30,30
1650652106325,MATH 109,B01,083215,Anzaldo; Leesa B,0,6,30,30
1650652106325,MATH 109,B02,083216,Anzaldo; Leesa B,0,6,30,30
1650652112349,MATH 142A,A01,083219,Chow; Bennett,0,16,30,30
1650652112349,MATH 142A,A02,083220,Chow; Bennett,0,15,30,30
1650652112349,MATH 142A,B01,083221,Chow; Bennett,0,14,30,30
1650652112349,MATH 142A,B02,083222,Chow; Bennett,0,13,30,30
1650652118395,MATH 193A,A01,083224,Staff,0,5,30,30
1650652118395,MATH 193A,A02,083225,Staff,0,6,30,30
1650652118395,MATH 193A,A03,083781,Staff,0,6,30,30
1650652118395,MATH 193A,A04,083782,Staff,0,7,30,30
1650652124425,MATH 197,001,091859,McAuley; Julian John,9998,0,9999,1
1650652130477,COGS 9,A01,083615,Staff,1,16,60,59
1650652136504,COGS 11,A01,083617,Boyle; Mary E. T.,18,0,40,22
1650652142531,COGS 13,A01,083071,Staff,0,39,40,40
1650652148561,COGS 14A,A01,092681,Staff,0,32,100,100
1650652154593,COGS 14B,A01,083073,Cheng; Tzu-Han,0,13,50,50
1650652160617,COGS 17,A01,092677,Staff,17,0,75,58
1650652166655,COGS 100,A01,083619,Staff,0,28,60,60
1650652172681,COGS 101A,A01,083621,Davis; Joshua Daniel,0,27,60,60
1650652178706,COGS 101B,A01,091572,Staff,0,4,60,60
1650652184736,COGS 101C,A01,083625,Delgado; Tania,15,0,30,15
1650652190767,COGS 107A,A01,083627,Boyle; Mary E. T.,1,17,60,59
1650652196793,COGS 118A,A01,083075,Staff,0,7,60,60
1650652202817,CSE 3,A50,083646,Miranda; Gregory Joseph,19,0,38,19
1650652202817,CSE 3,A51,083647,Miranda; Gregory Joseph,36,0,37,1
1650652208844,CSE 8A,A50,083650,Miranda; Gregory Joseph,0,30,40,40
1650652214871,CSE 11,A01,083080,Cao; Yingjun,0,95,40,40
1650652220895,CSE 12,A01,083652,Staff,0,19,100,100
1650652226929,CSE 15L,A01,083654,Staff,0,2,50,50
1650652226929,CSE 15L,A02,083655,Staff,0,1,50,50
1650652232951,CSE 20,A01,083657,Staff,51,0,80,29
1650652238984,CSE 30,A01,083084,Eldon; John,0,77,40,40
1650652245011,CSE 100,A01,083659,Cao; Yingjun,0,69,50,50
1650652251034,CSE 134B,A01,083661,Powell; Thomas Allan,0,37,65,65
1650652257064,CSE 140,A01,083663,Staff,0,8,75,75
1650652263102,CSE 140L,A01,083088,Eldon; John,0,16,75,75
1650652269126,CSE 175,A01,083665,Kumar; Rakesh,7,0,25,18
1650652275161,CSE 190,A00,092507,Dubnov; Shlomo,10,0,20,10
1650652281187,ECE 45,A01,083139,Staff,0,1,60,60
1650652287219,ECE 65,A50,083695,Staff,0,5,30,30
1650652293245,ECE 109,A01,091882,Touri; Behrouz,33,0,70,37
1650652299274,ECE 180,A00,083140,Abi Samra; Nicholas Camill,21,0,30,9
1650652299274,ECE 180,B00,083141,Abi Samra; Nicholas Camill,0,0,30,30
1650652305304,MATH 10A,A01,083735,Patchell; Gregory David,3,0,30,27
1650652305304,MATH 10A,A02,083736,Patchell; Gregory David,27,0,30,3
1650652305304,MATH 10A,A03,083737,Patchell; Gregory David,24,0,30,6
1650652311331,MATH 10B,A01,083207,Staff,0,8,30,30
1650652311331,MATH 10B,A02,083208,Staff,0,8,30,30
1650652311331,MATH 10B,B01,083739,Staff,11,0,30,19
1650652311331,MATH 10B,B02,083740,Staff,28,0,30,2
1650652317360,MATH 18,A01,083743,Staff,0,0,30,30
1650652317360,MATH 18,A02,083744,Staff,23,0,30,7
1650652317360,MATH 18,A03,083745,Staff,21,0,30,9
1650652317360,MATH 18,A04,083746,Staff,26,0,30,4
1650652317360,MATH 18,B01,083748,Staff,0,15,30,30
1650652317360,MATH 18,B02,083749,Staff,0,11,30,30
1650652317360,MATH 18,B03,083750,Staff,0,12,30,30
1650652317360,MATH 18,B04,083751,Staff,0,12,30,30
1650652323384,MATH 20A,A01,083754,Staff,19,0,40,21
1650652329411,MATH 20B,A01,083756,Staff,0,11,30,30
1650652329411,MATH 20B,A02,083757,Staff,0,12,30,30
1650652335433,MATH 20C,A01,083760,Staff,0,16,30,30
1650652335433,MATH 20C,A02,083761,Staff,1,13,30,29
1650652335433,MATH 20C,B01,083762,Staff,11,0,30,19
1650652335433,MATH 20C,B02,083763,Staff,28,0,30,2
1650652341464,MATH 20D,A01,083765,Staff,1,1,30,29
1650652341464,MATH 20D,A02,083766,Staff,6,0,30,24
1650652341464,MATH 20D,A03,083767,Staff,24,0,30,6
1650652347491,MATH 20E,A01,083771,Staff,3,0,30,27
1650652347491,MATH 20E,A02,083772,Staff,16,0,30,14
1650652347491,MATH 20E,B01,083773,Staff,0,0,30,30
1650652347491,MATH 20E,B02,083774,Staff,9,0,30,21
1650652353527,MATH 103A,A01,083777,Staff,0,15,30,30
1650652353527,MATH 103A,A02,083778,Staff,0,15,30,30
1650652353527,MATH 103A,B01,083779,Staff,0,14,30,30
1650652353527,MATH 103A,B02,083780,Staff,0,14,30,30
1650652359550,MATH 105,A01,085443,Staff,0,22,30,30
1650652365579,MATH 109,A01,083213,Anzaldo; Leesa B,0,7,30,30
1650652365579,MATH 109,A02,083214,Anzaldo; Leesa B,0,7,30,30
1650652365579,MATH 109,B01,083215,Anzaldo; Leesa B,0,6,30,30
1650652365579,MATH 109,B02,083216,Anzaldo; Leesa B,0,6,30,30
1650652371603,MATH 142A,A01,083219,Chow; Bennett,0,16,30,30
1650652371603,MATH 142A,A02,083220,Chow; Bennett,0,15,30,30
1650652371603,MATH 142A,B01,083221,Chow; Bennett,0,14,30,30
1650652371603,MATH 142A,B02,083222,Chow; Bennett,0,13,30,30
1650652377632,MATH 193A,A01,083224,Staff,0,5,30,30
1650652377632,MATH 193A,A02,083225,Staff,0,6,30,30
1650652377632,MATH 193A,A03,083781,Staff,0,6,30,30
1650652377632,MATH 193A,A04,083782,Staff,0,7,30,30
1650652383664,MATH 197,001,091859,McAuley; Julian John,9998,0,9999,1
1650652389722,COGS 9,A01,083615,Staff,1,16,60,59
1650652395751,COGS 11,A01,083617,Boyle; Mary E. T.,18,0,40,22
1650652401774,COGS 13,A01,083071,Staff,0,39,40,40
1650652407797,COGS 14A,A01,092681,Staff,0,32,100,100
1650652413825,COGS 14B,A01,083073,Cheng; Tzu-Han,0,13,50,50
1650652419850,COGS 17,A01,092677,Staff,17,0,75,58
1650652425874,COGS 100,A01,083619,Staff,0,28,60,60
1650652431903,COGS 101A,A01,083621,Davis; Joshua Daniel,0,27,60,60
1650652437928,COGS 101B,A01,091572,Staff,0,4,60,60
1650652443958,COGS 101C,A01,083625,Delgado; Tania,15,0,30,15
1650652449984,COGS 107A,A01,083627,Boyle; Mary E. T.,1,17,60,59
1650652456011,COGS 118A,A01,083075,Staff,0,7,60,60
1650652462054,CSE 3,A50,083646,Miranda; Gregory Joseph,19,0,38,19
1650652462054,CSE 3,A51,083647,Miranda; Gregory Joseph,36,0,37,1
1650652468083,CSE 8A,A50,083650,Miranda; Gregory Joseph,0,30,40,40
1650652474118,CSE 11,A01,083080,Cao; Yingjun,0,95,40,40
1650652480146,CSE 12,A01,083652,Staff,0,19,100,100
1650652486174,CSE 15L,A01,083654,Staff,0,2,50,50
1650652486174,CSE 15L,A02,083655,Staff,0,1,50,50
1650652492213,CSE 20,A01,083657,Staff,51,0,80,29
1650652498245,CSE 30,A01,083084,Eldon; John,0,77,40,40
1650652504279,CSE 100,A01,083659,Cao; Yingjun,0,69,50,50
1650652510303,CSE 134B,A01,083661,Powell; Thomas Allan,0,37,65,65
1650652516334,CSE 140,A01,083663,Staff,0,8,75,75
1650652522374,CSE 140L,A01,083088,Eldon; John,0,16,75,75
1650652528398,CSE 175,A01,083665,Kumar; Rakesh,7,0,25,18
1650652534432,CSE 190,A00,092507,Dubnov; Shlomo,10,0,20,10
1650652540455,ECE 45,A01,083139,Staff,0,1,60,60
1650652546488,ECE 65,A50,083695,Staff,0,5,30,30
1650652552612,ECE 109,A01,091882,Touri; Behrouz,33,0,70,37
1650652558636,ECE 180,A00,083140,Abi Samra; Nicholas Camill,21,0,30,9
1650652558636,ECE 180,B00,083141,Abi Samra; Nicholas Camill,0,0,30,30
1650652564661,MATH 10A,A01,083735,Patchell; Gregory David,3,0,30,27
1650652564661,MATH 10A,A02,083736,Patchell; Gregory David,27,0,30,3
1650652564661,MATH 10A,A03,083737,Patchell; Gregory David,24,0,30,6
1650652570692,MATH 10B,A01,083207,Staff,0,8,30,30
1650652570692,MATH 10B,A02,083208,Staff,0,8,30,30
1650652570692,MATH 10B,B01,083739,Staff,11,0,30,19
1650652570692,MATH 10B,B02,083740,Staff,28,0,30,2
1650652576716,MATH 18,A01,083743,Staff,0,0,30,30
1650652576716,MATH 18,A02,083744,Staff,23,0,30,7
1650652576716,MATH 18,A03,083745,Staff,21,0,30,9
1650652576716,MATH 18,A04,083746,Staff,26,0,30,4
1650652576716,MATH 18,B01,083748,Staff,0,15,30,30
1650652576716,MATH 18,B02,083749,Staff,0,11,30,30
1650652576716,MATH 18,B03,083750,Staff,0,12,30,30
1650652576716,MATH 18,B04,083751,Staff,0,12,30,30
1650652582743,MATH 20A,A01,083754,Staff,19,0,40,21
1650652588771,MATH 20B,A01,083756,Staff,0,11,30,30
1650652588771,MATH 20B,A02,083757,Staff,0,12,30,30
1650652594794,MATH 20C,A01,083760,Staff,0,16,30,30
1650652594794,MATH 20C,A02,083761,Staff,1,13,30,29
1650652594794,MATH 20C,B01,083762,Staff,11,0,30,19
1650652594794,MATH 20C,B02,083763,Staff,28,0,30,2
1650652600820,MATH 20D,A01,083765,Staff,1,1,30,29
1650652600820,MATH 20D,A02,083766,Staff,6,0,30,24
1650652600820,MATH 20D,A03,083767,Staff,24,0,30,6
1650652606852,MATH 20E,A01,083771,Staff,3,0,30,27
1650652606852,MATH 20E,A02,083772,Staff,16,0,30,14
1650652606852,MATH 20E,B01,083773,Staff,0,0,30,30
1650652606852,MATH 20E,B02,083774,Staff,9,0,30,21
1650652612876,MATH 103A,A01,083777,Staff,0,15,30,30
1650652612876,MATH 103A,A02,083778,Staff,0,15,30,30
1650652612876,MATH 103A,B01,083779,Staff,0,14,30,30
1650652612876,MATH 103A,B02,083780,Staff,0,14,30,30
1650652618898,MATH 105,A01,085443,Staff,0,22,30,30
1650652624924,MATH 109,A01,083213,Anzaldo; Leesa B,0,7,30,30
1650652624924,MATH 109,A02,083214,Anzaldo; Leesa B,0,7,30,30
1650652624924,MATH 109,B01,083215,Anzaldo; Leesa B,0,6,30,30
1650652624924,MATH 109,B02,083216,Anzaldo; Leesa B,0,6,30,30
1650652630951,MATH 142A,A01,083219,Chow; Bennett,0,16,30,30
1650652630951,MATH 142A,A02,083220,Chow; Bennett,0,15,30,30
1650652630951,MATH 142A,B01,083221,Chow; Bennett,0,14,30,30
1650652630951,MATH 142A,B02,083222,Chow; Bennett,0,13,30,30
1650652637032,MATH 193A,A01,083224,Staff,0,5,30,30
1650652637032,MATH 193A,A02,083225,Staff,0,6,30,30
1650652637032,MATH 193A,A03,083781,Staff,0,6,30,30
1650652637032,MATH 193A,A04,083782,Staff,0,7,30,30
1650652643055,MATH 197,001,091859,McAuley; Julian John,9998,0,9999,1
1650652649106,COGS 9,A01,083615,Staff,1,16,60,59
1650652655132,COGS 11,A01,083617,Boyle; Mary E. T.,18,0,40,22
1650652661166,COGS 13,A01,083071,Staff,0,39,40,40
1650652667198,COGS 14A,A01,092681,Staff,0,32,100,100
1650652673227,COGS 14B,A01,083073,Cheng; Tzu-Han,0,13,50,50
1650652679254,COGS 17,A01,092677,Staff,17,0,75,58
1650652685280,COGS 100,A01,083619,Staff,0,28,60,60
1650652691309,COGS 101A,A01,083621,Davis; Joshua Daniel,0,27,60,60
1650652697333,COGS 101B,A01,091572,Staff,0,4,60,60
1650652703355,COGS 101C,A01,083625,Delgado; Tania,15,0,30,15
1650652709383,COGS 107A,A01,083627,Boyle; Mary E. T.,1,17,60,59
1650652715414,COGS 118A,A01,083075,Staff,0,7,60,60
1650652721440,CSE 3,A50,083646,Miranda; Gregory Joseph,19,0,38,19
1650652721440,CSE 3,A51,083647,Miranda; Gregory Joseph,36,0,37,1
1650652727463,CSE 8A,A50,083650,Miranda; Gregory Joseph,0,30,40,40
1650652733487,CSE 11,A01,083080,Cao; Yingjun,0,95,40,40
1650652739534,CSE 12,A01,083652,Staff,0,19,100,100
1650652745558,CSE 15L,A01,083654,Staff,0,2,50,50
1650652745558,CSE 15L,A02,083655,Staff,0,1,50,50
1650652751582,CSE 20,A01,083657,Staff,51,0,80,29
1650652757608,CSE 30,A01,083084,Eldon; John,0,77,40,40
1650652763632,CSE 100,A01,083659,Cao; Yingjun,0,69,50,50
1650652769681,CSE 134B,A01,083661,Powell; Thomas Allan,0,37,65,65
1650652775718,CSE 140,A01,083663,Staff,0,8,75,75
1650652781742,CSE 140L,A01,083088,Eldon; John,0,16,75,75
1650652787768,CSE 175,A01,083665,Kumar; Rakesh,7,0,25,18
1650652793804,CSE 190,A00,092507,Dubnov; Shlomo,10,0,20,10
1650652799841,ECE 45,A01,083139,Staff,0,1,60,60
1650652805871,ECE 65,A50,083695,Staff,0,5,30,30
1650652811894,ECE 109,A01,091882,Touri; Behrouz,33,0,70,37
1650652817922,ECE 180,A00,083140,Abi Samra; Nicholas Camill,21,0,30,9
1650652817922,ECE 180,B00,083141,Abi Samra; Nicholas Camill,0,0,30,30
1650652823945,MATH 10A,A01,083735,Patchell; Gregory David,3,0,30,27
1650652823945,MATH 10A,A02,083736,Patchell; Gregory David,27,0,30,3
1650652823945,MATH 10A,A03,083737,Patchell; Gregory David,24,0,30,6
1650652829971,MATH 10B,A01,083207,Staff,0,8,30,30
1650652829971,MATH 10B,A02,083208,Staff,0,8,30,30
1650652829971,MATH 10B,B01,083739,Staff,11,0,30,19
1650652829971,MATH 10B,B02,083740,Staff,28,0,30,2
1650652835995,MATH 18,A01,083743,Staff,0,0,30,30
1650652835995,MATH 18,A02,083744,Staff,23,0,30,7
1650652835995,MATH 18,A03,083745,Staff,21,0,30,9
1650652835995,MATH 18,A04,083746,Staff,26,0,30,4
1650652835995,MATH 18,B01,083748,Staff,0,15,30,30
1650652835995,MATH 18,B02,083749,Staff,0,11,30,30
1650652835995,MATH 18,B03,083750,Staff,0,12,30,30
1650652835995,MATH 18,B04,083751,Staff,0,12,30,30
1650652842030,MATH 20A,A01,083754,Staff,19,0,40,21
1650652848056,MATH 20B,A01,083756,Staff,0,11,30,30
1650652848056,MATH 20B,A02,083757,Staff,0,12,30,30
1650652854084,MATH 20C,A01,083760,Staff,0,16,30,30
1650652854084,MATH 20C,A02,083761,Staff,1,13,30,29
1650652854084,MATH 20C,B01,083762,Staff,11,0,30,19
1650652854084,MATH 20C,B02,083763,Staff,28,0,30,2
1650652860111,MATH 20D,A01,083765,Staff,1,1,30,29
1650652860111,MATH 20D,A02,083766,Staff,6,0,30,24
1650652860111,MATH 20D,A03,083767,Staff,24,0,30,6
1650652866139,MATH 20E,A01,083771,Staff,3,0,30,27
1650652866139,MATH 20E,A02,083772,Staff,16,0,30,14
1650652866139,MATH 20E,B01,083773,Staff,0,0,30,30
1650652866139,MATH 20E,B02,083774,Staff,9,0,30,21
1650652872170,MATH 103A,A01,083777,Staff,0,15,30,30
1650652872170,MATH 103A,A02,083778,Staff,0,15,30,30
1650652872170,MATH 103A,B01,083779,Staff,0,14,30,30
1650652872170,MATH 103A,B02,083780,Staff,0,14,30,30
1650652878197,MATH 105,A01,085443,Staff,0,22,30,30
1650652884224,MATH 109,A01,083213,Anzaldo; Leesa B,0,7,30,30
1650652884224,MATH 109,A02,083214,Anzaldo; Leesa B,0,7,30,30
1650652884224,MATH 109,B01,083215,Anzaldo; Leesa B,0,6,30,30
1650652884224,MATH 109,B02,083216,Anzaldo; Leesa B,0,6,30,30
1650652890252,MATH 142A,A01,083219,Chow; Bennett,0,16,30,30
1650652890252,MATH 142A,A02,083220,Chow; Bennett,0,15,30,30
1650652890252,MATH 142A,B01,083221,Chow; Bennett,0,14,30,30
1650652890252,MATH 142A,B02,083222,Chow; Bennett,0,13,30,30
1650652896283,MATH 193A,A01,083224,Staff,0,5,30,30
1650652896283,MATH 193A,A02,083225,Staff,0,6,30,30
1650652896283,MATH 193A,A03,083781,Staff,0,6,30,30
1650652896283,MATH 193A,A04,083782,Staff,0,7,30,30
1650652902314,MATH 197,001,091859,McAuley; Julian John,9998,0,9999,1
1650652908378,COGS 9,A01,083615,Staff,1,16,60,59
1650652914401,COGS 11,A01,083617,Boyle; Mary E. T.,18,0,40,22
1650652920434,COGS 13,A01,083071,Staff,0,39,40,40
1650652926466,COGS 14A,A01,092681,Staff,0,32,100,100
1650652932497,COGS 14B,A01,083073,Cheng; Tzu-Han,0,13,50,50
1650652938532,COGS 17,A01,092677,Staff,17,0,75,58
1650652944560,COGS 100,A01,083619,Staff,0,28,60,60
1650652950594,COGS 101A,A01,083621,Davis; Joshua Daniel,0,27,60,60
1650652956617,COGS 101B,A01,091572,Staff,0,4,60,60
1650652962664,COGS 101C,A01,083625,Delgado; Tania,15,0,30,15
1650652968709,COGS 107A,A01,083627,Boyle; Mary E. T.,1,17,60,59
1650652974742,COGS 118A,A01,083075,Staff,0,7,60,60
1650652980769,CSE 3,A50,083646,Miranda; Gregory Joseph,19,0,38,19
1650652980769,CSE 3,A51,083647,Miranda; Gregory Joseph,36,0,37,1
1650652986802,CSE 8A,A50,083650,Miranda; Gregory Joseph,0,30,40,40
1650652992832,CSE 11,A01,083080,Cao; Yingjun,0,95,40,40
1650652998857,CSE 12,A01,083652,Staff,0,19,100,100
1650653004886,CSE 15L,A01,083654,Staff,0,2,50,50
1650653004886,CSE 15L,A02,083655,Staff,0,1,50,50
1650653010910,CSE 20,A01,083657,Staff,51,0,80,29
1650653016946,CSE 30,A01,083084,Eldon; John,0,77,40,40
1650653022979,CSE 100,A01,083659,Cao; Yingjun,0,69,50,50
1650653029007,CSE 134B,A01,083661,Powell; Thomas Allan,0,37,65,65
1650653035033,CSE 140,A01,083663,Staff,0,8,75,75
1650653041059,CSE 140L,A01,083088,Eldon; John,0,16,75,75
1650653047117,CSE 175,A01,083665,Kumar; Rakesh,7,0,25,18
1650653053143,CSE 190,A00,092507,Dubnov; Shlomo,10,0,20,10
1650653059172,ECE 45,A01,083139,Staff,0,1,60,60
1650653065209,ECE 65,A50,083695,Staff,0,5,30,30
1650653071236,ECE 109,A01,091882,Touri; Behrouz,33,0,70,37
1650653077261,ECE 180,A00,083140,Abi Samra; Nicholas Camill,21,0,30,9
1650653077261,ECE 180,B00,083141,Abi Samra; Nicholas Camill,0,0,30,30
1650653083291,MATH 10A,A01,083735,Patchell; Gregory David,3,0,30,27
1650653083291,MATH 10A,A02,083736,Patchell; Gregory David,27,0,30,3
1650653083291,MATH 10A,A03,083737,Patchell; Gregory David,24,0,30,6
1650653089316,MATH 10B,A01,083207,Staff,0,8,30,30
1650653089316,MATH 10B,A02,083208,Staff,0,8,30,30
1650653089316,MATH 10B,B01,083739,Staff,11,0,30,19
1650653089316,MATH 10B,B02,083740,Staff,28,0,30,2
1650653095340,MATH 18,A01,083743,Staff,0,0,30,30
1650653095340,MATH 18,A02,083744,Staff,23,0,30,7
1650653095340,MATH 18,A03,083745,Staff,21,0,30,9
1650653095340,MATH 18,A04,083746,Staff,26,0,30,4
1650653095340,MATH 18,B01,083748,Staff,0,15,30,30
1650653095340,MATH 18,B02,083749,Staff,0,11,30,30
1650653095340,MATH 18,B03,083750,Staff,0,12,30,30
1650653095340,MATH 18,B04,083751,Staff,0,12,30,30
1650653101377,MATH 20A,A01,083754,Staff,19,0,40,21
1650653107402,MATH 20B,A01,083756,Staff,0,11,30,30
1650653107402,MATH 20B,A02,083757,Staff,0,12,30,30
1650653113426,MATH 20C,A01,083760,Staff,0,16,30,30
1650653113426,MATH 20C,A02,083761,Staff,1,14,30,29
1650653113426,MATH 20C,B01,083762,Staff,11,0,30,19
1650653113426,MATH 20C,B02,083763,Staff,28,0,30,2
1650653119454,MATH 20D,A01,083765,Staff,1,1,30,29
1650653119454,MATH 20D,A02,083766,Staff,6,0,30,24
1650653119454,MATH 20D,A03,083767,Staff,24,0,30,6
1650653125483,MATH 20E,A01,083771,Staff,3,0,30,27
1650653125483,MATH 20E,A02,083772,Staff,16,0,30,14
1650653125483,MATH 20E,B01,083773,Staff,0,0,30,30
1650653125483,MATH 20E,B02,083774,Staff,9,0,30,21
1650653131509,MATH 103A,A01,083777,Staff,0,15,30,30
1650653131509,MATH 103A,A02,083778,Staff,0,15,30,30
1650653131509,MATH 103A,B01,083779,Staff,0,14,30,30
1650653131509,MATH 103A,B02,083780,Staff,0,14,30,30
1650653137533,MATH 105,A01,085443,Staff,0,22,30,30
1650653143573,MATH 109,A01,083213,Anzaldo; Leesa B,0,7,30,30
1650653143573,MATH 109,A02,083214,Anzaldo; Leesa B,0,7,30,30
1650653143573,MATH 109,B01,083215,Anzaldo; Leesa B,0,6,30,30
1650653143573,MATH 109,B02,083216,Anzaldo; Leesa B,0,6,30,30
1650653149668,MATH 142A,A01,083219,Chow; Bennett,0,16,30,30
1650653149668,MATH 142A,A02,083220,Chow; Bennett,0,15,30,30
1650653149668,MATH 142A,B01,083221,Chow; Bennett,0,14,30,30
1650653149668,MATH 142A,B02,083222,Chow; Bennett,0,13,30,30
1650653155695,MATH 193A,A01,083224,Staff,0,5,30,30
1650653155695,MATH 193A,A02,083225,Staff,0,6,30,30
1650653155695,MATH 193A,A03,083781,Staff,0,6,30,30
1650653155695,MATH 193A,A04,083782,Staff,0,7,30,30
1650653161724,MATH 197,001,091859,McAuley; Julian John,9998,0,9999,1
1650653167795,COGS 9,A01,083615,Staff,1,16,60,59
1650653173823,COGS 11,A01,083617,Boyle; Mary E. T.,18,0,40,22
1650653179849,COGS 13,A01,083071,Staff,0,39,40,40
1650653185882,COGS 14A,A01,092681,Staff,0,32,100,100
1650653191906,COGS 14B,A01,083073,Cheng; Tzu-Han,0,13,50,50
1650653197941,COGS 17,A01,092677,Staff,17,0,75,58
1650653203962,COGS 100,A01,083619,Staff,0,28,60,60
1650653209986,COGS 101A,A01,083621,Davis; Joshua Daniel,0,27,60,60
1650653216015,COGS 101B,A01,091572,Staff,0,4,60,60
1650653222043,COGS 101C,A01,083625,Delgado; Tania,15,0,30,15
1650653228070,COGS 107A,A01,083627,Boyle; Mary E. T.,1,17,60,59
1650653234100,COGS 118A,A01,083075,Staff,0,7,60,60
1650653240129,CSE 3,A50,083646,Miranda; Gregory Joseph,19,0,38,19
1650653240129,CSE 3,A51,083647,Miranda; Gregory Joseph,36,0,37,1
1650653246156,CSE 8A,A50,083650,Miranda; Gregory Joseph,0,30,40,40
1650653252181,CSE 11,A01,083080,Cao; Yingjun,0,95,40,40
1650653258206,CSE 12,A01,083652,Staff,0,19,100,100
1650653264233,CSE 15L,A01,083654,Staff,0,2,50,50
1650653264233,CSE 15L,A02,083655,Staff,0,1,50,50
1650653270256,CSE 20,A01,083657,Staff,51,0,80,29
1650653276284,CSE 30,A01,083084,Eldon; John,0,77,40,40
1650653282324,CSE 100,A01,083659,Cao; Yingjun,0,69,50,50
1650653288350,CSE 134B,A01,083661,Powell; Thomas Allan,0,37,65,65
1650653294378,CSE 140,A01,083663,Staff,0,8,75,75
1650653300403,CSE 140L,A01,083088,Eldon; John,0,16,75,75
1650653306427,CSE 175,A01,083665,Kumar; Rakesh,7,0,25,18
1650653312454,CSE 190,A00,092507,Dubnov; Shlomo,10,0,20,10
1650653318493,ECE 45,A01,083139,Staff,0,1,60,60
1650653324524,ECE 65,A50,083695,Staff,0,5,30,30
1650653330546,ECE 109,A01,091882,Touri; Behrouz,33,0,70,37
1650653336571,ECE 180,A00,083140,Abi Samra; Nicholas Camill,21,0,30,9
1650653336571,ECE 180,B00,083141,Abi Samra; Nicholas Camill,0,0,30,30
1650653342599,MATH 10A,A01,083735,Patchell; Gregory David,3,0,30,27
1650653342599,MATH 10A,A02,083736,Patchell; Gregory David,27,0,30,3
1650653342599,MATH 10A,A03,083737,Patchell; Gregory David,24,0,30,6
1650653348624,MATH 10B,A01,083207,Staff,0,8,30,30
1650653348624,MATH 10B,A02,083208,Staff,0,8,30,30
1650653348624,MATH 10B,B01,083739,Staff,11,0,30,19
1650653348624,MATH 10B,B02,083740,Staff,28,0,30,2
1650653354664,MATH 18,A01,083743,Staff,0,0,30,30
1650653354664,MATH 18,A02,083744,Staff,23,0,30,7
1650653354664,MATH 18,A03,083745,Staff,21,0,30,9
1650653354664,MATH 18,A04,083746,Staff,26,0,30,4
1650653354664,MATH 18,B01,083748,Staff,0,15,30,30
1650653354664,MATH 18,B02,083749,Staff,0,11,30,30
1650653354664,MATH 18,B03,083750,Staff,0,12,30,30
1650653354664,MATH 18,B04,083751,Staff,0,12,30,30
1650653360694,MATH 20A,A01,083754,Staff,19,0,40,21
1650653366717,MATH 20B,A01,083756,Staff,0,11,30,30
1650653366717,MATH 20B,A02,083757,Staff,0,12,30,30
1650653372740,MATH 20C,A01,083760,Staff,0,16,30,30
1650653372740,MATH 20C,A02,083761,Staff,1,14,30,29
1650653372740,MATH 20C,B01,083762,Staff,11,0,30,19
1650653372740,MATH 20C,B02,083763,Staff,28,0,30,2
1650653378768,MATH 20D,A01,083765,Staff,1,1,30,29
1650653378768,MATH 20D,A02,083766,Staff,6,0,30,24
1650653378768,MATH 20D,A03,083767,Staff,24,0,30,6
1650653384792,MATH 20E,A01,083771,Staff,3,0,30,27
1650653384792,MATH 20E,A02,083772,Staff,16,0,30,14
1650653384792,MATH 20E,B01,083773,Staff,0,0,30,30
1650653384792,MATH 20E,B02,083774,Staff,9,0,30,21
1650653390815,MATH 103A,A01,083777,Staff,0,15,30,30
1650653390815,MATH 103A,A02,083778,Staff,0,15,30,30
1650653390815,MATH 103A,B01,083779,Staff,0,14,30,30
1650653390815,MATH 103A,B02,083780,Staff,0,14,30,30
1650653396842,MATH 105,A01,085443,Staff,0,22,30,30
1650653402872,MATH 109,A01,083213,Anzaldo; Leesa B,0,7,30,30
1650653402872,MATH 109,A02,083214,Anzaldo; Leesa B,0,7,30,30
1650653402872,MATH 109,B01,083215,Anzaldo; Leesa B,0,6,30,30
1650653402872,MATH 109,B02,083216,Anzaldo; Leesa B,0,6,30,30
1650653408896,MATH 142A,A01,083219,Chow; Bennett,0,16,30,30
1650653408896,MATH 142A,A02,083220,Chow; Bennett,0,15,30,30
1650653408896,MATH 142A,B01,083221,Chow; Bennett,0,14,30,30
1650653408896,MATH 142A,B02,083222,Chow; Bennett,0,13,30,30
1650653414919,MATH 193A,A01,083224,Staff,0,5,30,30
1650653414919,MATH 193A,A02,083225,Staff,0,6,30,30
1650653414919,MATH 193A,A03,083781,Staff,0,6,30,30
1650653414919,MATH 193A,A04,083782,Staff,0,7,30,30
1650653420943,MATH 197,001,091859,McAuley; Julian John,9998,0,9999,1
1650653427012,COGS 9,A01,083615,Staff,1,16,60,59
1650653433039,COGS 11,A01,083617,Boyle; Mary E. T.,18,0,40,22
1650653439061,COGS 13,A01,083071,Staff,0,39,40,40
1650653445084,COGS 14A,A01,092681,Staff,0,32,100,100
1650653451109,COGS 14B,A01,083073,Cheng; Tzu-Han,0,14,50,50
1650653457133,COGS 17,A01,092677,Staff,17,0,75,58
1650653463165,COGS 100,A01,083619,Staff,0,28,60,60
1650653469216,COGS 101A,A01,083621,Davis; Joshua Daniel,0,27,60,60
1650653475246,COGS 101B,A01,091572,Staff,0,4,60,60
1650653481269,COGS 101C,A01,083625,Delgado; Tania,15,0,30,15
1650653487297,COGS 107A,A01,083627,Boyle; Mary E. T.,1,17,60,59
1650653493321,COGS 118A,A01,083075,Staff,0,7,60,60
1650653499345,CSE 3,A50,083646,Miranda; Gregory Joseph,19,0,38,19
1650653499345,CSE 3,A51,083647,Miranda; Gregory Joseph,36,0,37,1
1650653505370,CSE 8A,A50,083650,Miranda; Gregory Joseph,0,30,40,40
1650653511395,CSE 11,A01,083080,Cao; Yingjun,0,95,40,40
1650653517430,CSE 12,A01,083652,Staff,0,19,100,100
1650653523458,CSE 15L,A01,083654,Staff,0,2,50,50
1650653523458,CSE 15L,A02,083655,Staff,0,1,50,50
1650653529488,CSE 20,A01,083657,Staff,51,0,80,29
1650653535511,CSE 30,A01,083084,Eldon; John,0,77,40,40
1650653541533,CSE 100,A01,083659,Cao; Yingjun,0,69,50,50
1650653547555,CSE 134B,A01,083661,Powell; Thomas Allan,0,37,65,65
1650653553589,CSE 140,A01,083663,Staff,0,8,75,75
1650653559614,CSE 140L,A01,083088,Eldon; John,0,16,75,75
1650653565646,CSE 175,A01,083665,Kumar; Rakesh,7,0,25,18
1650653571676,CSE 190,A00,092507,Dubnov; Shlomo,10,0,20,10
1650653577700,ECE 45,A01,083139,Staff,0,1,60,60
1650653583725,ECE 65,A50,083695,Staff,0,5,30,30
1650653589752,ECE 109,A01,091882,Touri; Behrouz,33,0,70,37
1650653595777,ECE 180,A00,083140,Abi Samra; Nicholas Camill,21,0,30,9
1650653595777,ECE 180,B00,083141,Abi Samra; Nicholas Camill,0,0,30,30
1650653601803,MATH 10A,A01,083735,Patchell; Gregory David,3,0,30,27
1650653601803,MATH 10A,A02,083736,Patchell; Gregory David,27,0,30,3
1650653601803,MATH 10A,A03,083737,Patchell; Gregory David,24,0,30,6
1650653607834,MATH 10B,A01,083207,Staff,0,8,30,30
1650653607834,MATH 10B,A02,083208,Staff,0,8,30,30
1650653607834,MATH 10B,B01,083739,Staff,11,0,30,19
1650653607834,MATH 10B,B02,083740,Staff,28,0,30,2
1650653613881,MATH 18,A01,083743,Staff,0,0,30,30
1650653613881,MATH 18,A02,083744,Staff,23,0,30,7
1650653613881,MATH 18,A03,083745,Staff,21,0,30,9
1650653613881,MATH 18,A04,083746,Staff,26,0,30,4
1650653613881,MATH 18,B01,083748,Staff,0,15,30,30
1650653613881,MATH 18,B02,083749,Staff,0,11,30,30
1650653613881,MATH 18,B03,083750,Staff,0,12,30,30
1650653613881,MATH 18,B04,083751,Staff,0,12,30,30
1650653619906,MATH 20A,A01,083754,Staff,19,0,40,21
1650653625930,MATH 20B,A01,083756,Staff,0,11,30,30
1650653625930,MATH 20B,A02,083757,Staff,0,12,30,30
1650653631955,MATH 20C,A01,083760,Staff,0,16,30,30
1650653631955,MATH 20C,A02,083761,Staff,1,14,30,29
1650653631955,MATH 20C,B01,083762,Staff,11,0,30,19
1650653631955,MATH 20C,B02,083763,Staff,28,0,30,2
1650653637982,MATH 20D,A01,083765,Staff,1,1,30,29
1650653637982,MATH 20D,A02,083766,Staff,6,0,30,24
1650653637982,MATH 20D,A03,083767,Staff,24,0,30,6
1650653644012,MATH 20E,A01,083771,Staff,3,0,30,27
1650653644012,MATH 20E,A02,083772,Staff,16,0,30,14
1650653644012,MATH 20E,B01,083773,Staff,0,0,30,30
1650653644012,MATH 20E,B02,083774,Staff,9,0,30,21
1650653650045,MATH 103A,A01,083777,Staff,0,15,30,30
1650653650045,MATH 103A,A02,083778,Staff,0,15,30,30
1650653650045,MATH 103A,B01,083779,Staff,0,14,30,30
1650653650045,MATH 103A,B02,083780,Staff,0,14,30,30
1650653656072,MATH 105,A01,085443,Staff,0,22,30,30
1650653662097,MATH 109,A01,083213,Anzaldo; Leesa B,0,7,30,30
1650653662097,MATH 109,A02,083214,Anzaldo; Leesa B,0,7,30,30
1650653662097,MATH 109,B01,083215,Anzaldo; Leesa B,0,6,30,30
1650653662097,MATH 109,B02,083216,Anzaldo; Leesa B,0,6,30,30
1650653668122,MATH 142A,A01,083219,Chow; Bennett,0,16,30,30
1650653668122,MATH 142A,A02,083220,Chow; Bennett,0,15,30,30
1650653668122,MATH 142A,B01,083221,Chow; Bennett,0,14,30,30
1650653668122,MATH 142A,B02,083222,Chow; Bennett,0,13,30,30
1650653674146,MATH 193A,A01,083224,Staff,0,5,30,30
1650653674146,MATH 193A,A02,083225,Staff,0,6,30,30
1650653674146,MATH 193A,A03,083781,Staff,0,6,30,30
1650653674146,MATH 193A,A04,083782,Staff,0,7,30,30
1650653680170,MATH 197,001,091859,McAuley; Julian John,9998,0,9999,1
1650653686235,COGS 9,A01,083615,Staff,1,16,60,59
1650653692259,COGS 11,A01,083617,Boyle; Mary E. T.,18,0,40,22
1650653698291,COGS 13,A01,083071,Staff,0,39,40,40
1650653704315,COGS 14A,A01,092681,Staff,0,32,100,100
1650653710338,COGS 14B,A01,083073,Cheng; Tzu-Han,0,14,50,50
1650653716363,COGS 17,A01,092677,Staff,17,0,75,58
1650653722386,COGS 100,A01,083619,Staff,0,28,60,60
1650653728422,COGS 101A,A01,083621,Davis; Joshua Daniel,0,27,60,60
1650653734447,COGS 101B,A01,091572,Staff,0,4,60,60
1650653740561,COGS 101C,A01,083625,Delgado; Tania,15,0,30,15
1650653746589,COGS 107A,A01,083627,Boyle; Mary E. T.,1,17,60,59
1650653752612,COGS 118A,A01,083075,Staff,0,7,60,60
1650653758640,CSE 3,A50,083646,Miranda; Gregory Joseph,19,0,38,19
1650653758640,CSE 3,A51,083647,Miranda; Gregory Joseph,36,0,37,1
1650653764668,CSE 8A,A50,083650,Miranda; Gregory Joseph,0,30,40,40
1650653770691,CSE 11,A01,083080,Cao; Yingjun,0,95,40,40
1650653776714,CSE 12,A01,083652,Staff,0,19,100,100
1650653782747,CSE 15L,A01,083654,Staff,0,2,50,50
1650653782747,CSE 15L,A02,083655,Staff,0,1,50,50
1650653788772,CSE 20,A01,083657,Staff,51,0,80,29
1650653794795,CSE 30,A01,083084,Eldon; John,0,77,40,40
1650653800820,CSE 100,A01,083659,Cao; Yingjun,0,69,50,50
1650653806846,CSE 134B,A01,083661,Powell; Thomas Allan,0,37,65,65
1650653812897,CSE 140,A01,083663,Staff,0,8,75,75
1650653818921,CSE 140L,A01,083088,Eldon; John,0,16,75,75
1650653824947,CSE 175,A01,083665,Kumar; Rakesh,7,0,25,18
1650653830971,CSE 190,A00,092507,Dubnov; Shlomo,10,0,20,10
1650653837004,ECE 45,A01,083139,Staff,0,1,60,60
1650653843030,ECE 65,A50,083695,Staff,0,5,30,30
1650653849062,ECE 109,A01,091882,Touri; Behrouz,33,0,70,37
1650653855090,ECE 180,A00,083140,Abi Samra; Nicholas Camill,21,0,30,9
1650653855090,ECE 180,B00,083141,Abi Samra; Nicholas Camill,0,0,30,30
1650653861119,MATH 10A,A01,083735,Patchell; Gregory David,3,0,30,27
1650653861119,MATH 10A,A02,083736,Patchell; Gregory David,27,0,30,3
1650653861119,MATH 10A,A03,083737,Patchell; Gregory David,24,0,30,6
1650653867142,MATH 10B,A01,083207,Staff,0,8,30,30
1650653867142,MATH 10B,A02,083208,Staff,0,8,30,30
1650653867142,MATH 10B,B01,083739,Staff,11,0,30,19
1650653867142,MATH 10B,B02,083740,Staff,28,0,30,2
1650653873169,MATH 18,A01,083743,Staff,0,0,30,30
1650653873169,MATH 18,A02,083744,Staff,23,0,30,7
1650653873169,MATH 18,A03,083745,Staff,21,0,30,9
1650653873169,MATH 18,A04,083746,Staff,26,0,30,4
1650653873169,MATH 18,B01,083748,Staff,0,15,30,30
1650653873169,MATH 18,B02,083749,Staff,0,11,30,30
1650653873169,MATH 18,B03,083750,Staff,0,12,30,30
1650653873169,MATH 18,B04,083751,Staff,0,12,30,30
1650653879194,MATH 20A,A01,083754,Staff,19,0,40,21
1650653885216,MATH 20B,A01,083756,Staff,0,11,30,30
1650653885216,MATH 20B,A02,083757,Staff,0,12,30,30
1650653891240,MATH 20C,A01,083760,Staff,0,16,30,30
1650653891240,MATH 20C,A02,083761,Staff,1,14,30,29
1650653891240,MATH 20C,B01,083762,Staff,11,0,30,19
1650653891240,MATH 20C,B02,083763,Staff,28,0,30,2
1650653897264,MATH 20D,A01,083765,Staff,1,1,30,29
1650653897264,MATH 20D,A02,083766,Staff,6,0,30,24
1650653897264,MATH 20D,A03,083767,Staff,24,0,30,6
1650653903287,MATH 20E,A01,083771,Staff,3,0,30,27
1650653903287,MATH 20E,A02,083772,Staff,16,0,30,14
1650653903287,MATH 20E,B01,083773,Staff,0,0,30,30
1650653903287,MATH 20E,B02,083774,Staff,9,0,30,21
1650653909311,MATH 103A,A01,083777,Staff,0,15,30,30
1650653909311,MATH 103A,A02,083778,Staff,0,15,30,30
1650653909311,MATH 103A,B01,083779,Staff,0,14,30,30
1650653909311,MATH 103A,B02,083780,Staff,0,14,30,30
1650653915342,MATH 105,A01,085443,Staff,0,22,30,30
1650653921369,MATH 109,A01,083213,Anzaldo; Leesa B,0,7,30,30
1650653921369,MATH 109,A02,083214,Anzaldo; Leesa B,0,7,30,30
1650653921369,MATH 109,B01,083215,Anzaldo; Leesa B,0,6,30,30
1650653921369,MATH 109,B02,083216,Anzaldo; Leesa B,0,6,30,30
1650653927397,MATH 142A,A01,083219,Chow; Bennett,0,16,30,30
1650653927397,MATH 142A,A02,083220,Chow; Bennett,0,15,30,30
1650653927397,MATH 142A,B01,083221,Chow; Bennett,0,14,30,30
1650653927397,MATH 142A,B02,083222,Chow; Bennett,0,13,30,30
1650653933424,MATH 193A,A01,083224,Staff,0,5,30,30
1650653933424,MATH 193A,A02,083225,Staff,0,6,30,30
1650653933424,MATH 193A,A03,083781,Staff,0,6,30,30
1650653933424,MATH 193A,A04,083782,Staff,0,7,30,30
1650653939452,MATH 197,001,091859,McAuley; Julian John,9998,0,9999,1
1650653945512,COGS 9,A01,083615,Staff,1,16,60,59
1650653951541,COGS 11,A01,083617,Boyle; Mary E. T.,18,0,40,22
1650653957570,COGS 13,A01,083071,Staff,0,39,40,40
1650653963594,COGS 14A,A01,092681,Staff,0,32,100,100
1650653969618,COGS 14B,A01,083073,Cheng; Tzu-Han,0,14,50,50
1650653975643,COGS 17,A01,092677,Staff,17,0,75,58
1650653981670,COGS 100,A01,083619,Staff,0,28,60,60
1650653987692,COGS 101A,A01,083621,Davis; Joshua Daniel,0,27,60,60
1650653993727,COGS 101B,A01,091572,Staff,0,4,60,60
1650653999755,COGS 101C,A01,083625,Delgado; Tania,15,0,30,15
1650654005776,COGS 107A,A01,083627,Boyle; Mary E. T.,1,17,60,59
1650654011810,COGS 118A,A01,083075,Staff,0,7,60,60
1650654017834,CSE 3,A50,083646,Miranda; Gregory Joseph,19,0,38,19
1650654017834,CSE 3,A51,083647,Miranda; Gregory Joseph,36,0,37,1
1650654023859,CSE 8A,A50,083650,Miranda; Gregory Joseph,0,30,40,40
1650654029882,CSE 11,A01,083080,Cao; Yingjun,0,95,40,40
1650654035905,CSE 12,A01,083652,Staff,0,19,100,100
1650654041928,CSE 15L,A01,083654,Staff,0,2,50,50
1650654041928,CSE 15L,A02,083655,Staff,0,1,50,50
1650654047965,CSE 20,A01,083657,Staff,51,0,80,29
1650654053992,CSE 30,A01,083084,Eldon; John,0,77,40,40
1650654060020,CSE 100,A01,083659,Cao; Yingjun,0,69,50,50
1650654066045,CSE 134B,A01,083661,Powell; Thomas Allan,0,37,65,65
1650654072069,CSE 140,A01,083663,Staff,0,8,75,75
1650654078105,CSE 140L,A01,083088,Eldon; John,0,16,75,75
1650654084136,CSE 175,A01,083665,Kumar; Rakesh,7,0,25,18
1650654090169,CSE 190,A00,092507,Dubnov; Shlomo,10,0,20,10
1650654096196,ECE 45,A01,083139,Staff,0,1,60,60
1650654102219,ECE 65,A50,083695,Staff,0,5,30,30
1650654108257,ECE 109,A01,091882,Touri; Behrouz,33,0,70,37
1650654114281,ECE 180,A00,083140,Abi Samra; Nicholas Camill,21,0,30,9
1650654114281,ECE 180,B00,083141,Abi Samra; Nicholas Camill,0,0,30,30
1650654120306,MATH 10A,A01,083735,Patchell; Gregory David,3,0,30,27
1650654120306,MATH 10A,A02,083736,Patchell; Gregory David,27,0,30,3
1650654120306,MATH 10A,A03,083737,Patchell; Gregory David,24,0,30,6
1650654126330,MATH 10B,A01,083207,Staff,0,8,30,30
1650654126330,MATH 10B,A02,083208,Staff,0,8,30,30
1650654126330,MATH 10B,B01,083739,Staff,11,0,30,19
1650654126330,MATH 10B,B02,083740,Staff,28,0,30,2
1650654132370,MATH 18,A01,083743,Staff,0,0,30,30
1650654132370,MATH 18,A02,083744,Staff,23,0,30,7
1650654132370,MATH 18,A03,083745,Staff,21,0,30,9
1650654132370,MATH 18,A04,083746,Staff,26,0,30,4
1650654132370,MATH 18,B01,083748,Staff,0,15,30,30
1650654132370,MATH 18,B02,083749,Staff,0,11,30,30
1650654132370,MATH 18,B03,083750,Staff,0,12,30,30
1650654132370,MATH 18,B04,083751,Staff,0,12,30,30
1650654138399,MATH 20A,A01,083754,Staff,19,0,40,21
1650654144427,MATH 20B,A01,083756,Staff,0,11,30,30
1650654144427,MATH 20B,A02,083757,Staff,0,12,30,30
1650654150450,MATH 20C,A01,083760,Staff,0,16,30,30
1650654150450,MATH 20C,A02,083761,Staff,1,14,30,29
1650654150450,MATH 20C,B01,083762,Staff,11,0,30,19
1650654150450,MATH 20C,B02,083763,Staff,28,0,30,2
1650654156475,MATH 20D,A01,083765,Staff,1,1,30,29
1650654156475,MATH 20D,A02,083766,Staff,6,0,30,24
1650654156475,MATH 20D,A03,083767,Staff,24,0,30,6
1650654162498,MATH 20E,A01,083771,Staff,3,0,30,27
1650654162498,MATH 20E,A02,083772,Staff,16,0,30,14
1650654162498,MATH 20E,B01,083773,Staff,0,0,30,30
1650654162498,MATH 20E,B02,083774,Staff,9,0,30,21
1650654168528,MATH 103A,A01,083777,Staff,0,15,30,30
1650654168528,MATH 103A,A02,083778,Staff,0,15,30,30
1650654168528,MATH 103A,B01,083779,Staff,0,14,30,30
1650654168528,MATH 103A,B02,083780,Staff,0,14,30,30
1650654174580,MATH 105,A01,085443,Staff,0,22,30,30
1650654180604,MATH 109,A01,083213,Anzaldo; Leesa B,0,7,30,30
1650654180604,MATH 109,A02,083214,Anzaldo; Leesa B,0,7,30,30
1650654180604,MATH 109,B01,083215,Anzaldo; Leesa B,0,6,30,30
1650654180604,MATH 109,B02,083216,Anzaldo; Leesa B,0,6,30,30
1650654186639,MATH 142A,A01,083219,Chow; Bennett,0,16,30,30
1650654186639,MATH 142A,A02,083220,Chow; Bennett,0,15,30,30
1650654186639,MATH 142A,B01,083221,Chow; Bennett,0,14,30,30
1650654186639,MATH 142A,B02,083222,Chow; Bennett,0,13,30,30
1650654192685,MATH 193A,A01,083224,Staff,0,5,30,30
1650654192685,MATH 193A,A02,083225,Staff,0,6,30,30
1650654192685,MATH 193A,A03,083781,Staff,0,6,30,30
1650654192685,MATH 193A,A04,083782,Staff,0,7,30,30
1650654198710,MATH 197,001,091859,McAuley; Julian John,9998,0,9999,1
1650654204777,COGS 9,A01,083615,Staff,1,16,60,59
1650654210801,COGS 11,A01,083617,Boyle; Mary E. T.,18,0,40,22
1650654216825,COGS 13,A01,083071,Staff,0,39,40,40
1650654222856,COGS 14A,A01,092681,Staff,0,32,100,100
1650654228885,COGS 14B,A01,083073,Cheng; Tzu-Han,0,14,50,50
1650654234909,COGS 17,A01,092677,Staff,17,0,75,58
1650654240935,COGS 100,A01,083619,Staff,0,28,60,60
1650654246964,COGS 101A,A01,083621,Davis; Joshua Daniel,0,27,60,60
1650654252993,COGS 101B,A01,091572,Staff,0,4,60,60
1650654259021,COGS 101C,A01,083625,Delgado; Tania,15,0,30,15
1650654265043,COGS 107A,A01,083627,Boyle; Mary E. T.,1,17,60,59
1650654271066,COGS 118A,A01,083075,Staff,0,7,60,60
1650654277112,CSE 3,A50,083646,Miranda; Gregory Joseph,19,0,38,19
1650654277112,CSE 3,A51,083647,Miranda; Gregory Joseph,36,0,37,1
1650654283144,CSE 8A,A50,083650,Miranda; Gregory Joseph,0,30,40,40
1650654289179,CSE 11,A01,083080,Cao; Yingjun,0,95,40,40
1650654295215,CSE 12,A01,083652,Staff,0,19,100,100
1650654301242,CSE 15L,A01,083654,Staff,0,2,50,50
1650654301242,CSE 15L,A02,083655,Staff,0,1,50,50
1650654307266,CSE 20,A01,083657,Staff,51,0,80,29
1650654313298,CSE 30,A01,083084,Eldon; John,0,77,40,40
1650654319329,CSE 100,A01,083659,Cao; Yingjun,0,69,50,50
1650654325353,CSE 134B,A01,083661,Powell; Thomas Allan,0,37,65,65
1650654331376,CSE 140,A01,083663,Staff,0,8,75,75
1650654337493,CSE 140L,A01,083088,Eldon; John,0,16,75,75
1650654343525,CSE 175,A01,083665,Kumar; Rakesh,7,0,25,18
1650654349552,CSE 190,A00,092507,Dubnov; Shlomo,10,0,20,10
1650654355583,ECE 45,A01,083139,Staff,0,1,60,60
1650654361611,ECE 65,A50,083695,Staff,0,5,30,30
1650654367635,ECE 109,A01,091882,Touri; Behrouz,33,0,70,37
1650654373671,ECE 180,A00,083140,Abi Samra; Nicholas Camill,21,0,30,9
1650654373671,ECE 180,B00,083141,Abi Samra; Nicholas Camill,0,0,30,30
1650654379717,MATH 10A,A01,083735,Patchell; Gregory David,3,0,30,27
1650654379717,MATH 10A,A02,083736,Patchell; Gregory David,27,0,30,3
1650654379717,MATH 10A,A03,083737,Patchell; Gregory David,24,0,30,6
1650654385744,MATH 10B,A01,083207,Staff,0,8,30,30
1650654385744,MATH 10B,A02,083208,Staff,0,8,30,30
1650654385744,MATH 10B,B01,083739,Staff,11,0,30,19
1650654385744,MATH 10B,B02,083740,Staff,28,0,30,2
1650654391778,MATH 18,A01,083743,Staff,0,0,30,30
1650654391778,MATH 18,A02,083744,Staff,23,0,30,7
1650654391778,MATH 18,A03,083745,Staff,21,0,30,9
1650654391778,MATH 18,A04,083746,Staff,26,0,30,4
1650654391778,MATH 18,B01,083748,Staff,0,15,30,30
1650654391778,MATH 18,B02,083749,Staff,0,11,30,30
1650654391778,MATH 18,B03,083750,Staff,0,12,30,30
1650654391778,MATH 18,B04,083751,Staff,0,12,30,30
1650654397809,MATH 20A,A01,083754,Staff,19,0,40,21
1650654403834,MATH 20B,A01,083756,Staff,0,11,30,30
1650654403834,MATH 20B,A02,083757,Staff,0,12,30,30
1650654409855,MATH 20C,A01,083760,Staff,0,16,30,30
1650654409855,MATH 20C,A02,083761,Staff,1,14,30,29
1650654409855,MATH 20C,B01,083762,Staff,11,0,30,19
1650654409855,MATH 20C,B02,083763,Staff,28,0,30,2
1650654415890,MATH 20D,A01,083765,Staff,1,1,30,29
1650654415890,MATH 20D,A02,083766,Staff,6,0,30,24
1650654415890,MATH 20D,A03,083767,Staff,24,0,30,6
1650654421919,MATH 20E,A01,083771,Staff,3,0,30,27
1650654421919,MATH 20E,A02,083772,Staff,16,0,30,14
1650654421919,MATH 20E,B01,083773,Staff,0,0,30,30
1650654421919,MATH 20E,B02,083774,Staff,9,0,30,21
1650654427947,MATH 103A,A01,083777,Staff,0,15,30,30
1650654427947,MATH 103A,A02,083778,Staff,0,15,30,30
1650654427947,MATH 103A,B01,083779,Staff,0,14,30,30
1650654427947,MATH 103A,B02,083780,Staff,0,14,30,30
1650654433969,MATH 105,A01,085443,Staff,0,22,30,30
1650654440000,MATH 109,A01,083213,Anzaldo; Leesa B,0,7,30,30
1650654440000,MATH 109,A02,083214,Anzaldo; Leesa B,0,7,30,30
1650654440000,MATH 109,B01,083215,Anzaldo; Leesa B,0,6,30,30
1650654440000,MATH 109,B02,083216,Anzaldo; Leesa B,0,6,30,30
1650654446036,MATH 142A,A01,083219,Chow; Bennett,0,16,30,30
1650654446036,MATH 142A,A02,083220,Chow; Bennett,0,15,30,30
1650654446036,MATH 142A,B01,083221,Chow; Bennett,0,14,30,30
1650654446036,MATH 142A,B02,083222,Chow; Bennett,0,13,30,30
1650654452062,MATH 193A,A01,083224,Staff,0,5,30,30
1650654452062,MATH 193A,A02,083225,Staff,0,6,30,30
1650654452062,MATH 193A,A03,083781,Staff,0,6,30,30
1650654452062,MATH 193A,A04,083782,Staff,0,7,30,30
1650654458087,MATH 197,001,091859,McAuley; Julian John,9998,0,9999,1
1650654464161,COGS 9,A01,083615,Staff,1,16,60,59
1650654470189,COGS 11,A01,083617,Boyle; Mary E. T.,18,0,40,22
1650654476212,COGS 13,A01,083071,Staff,0,39,40,40
1650654482234,COGS 14A,A01,092681,Staff,0,32,100,100
1650654488257,COGS 14B,A01,083073,Cheng; Tzu-Han,0,14,50,50
1650654494286,COGS 17,A01,092677,Staff,17,0,75,58
1650654500317,COGS 100,A01,083619,Staff,0,28,60,60
1650654506353,COGS 101A,A01,083621,Davis; Joshua Daniel,0,27,60,60
1650654512383,COGS 101B,A01,091572,Staff,0,4,60,60
1650654518411,COGS 101C,A01,083625,Delgado; Tania,15,0,30,15
1650654524434,COGS 107A,A01,083627,Boyle; Mary E. T.,1,17,60,59
1650654530461,COGS 118A,A01,083075,Staff,0,7,60,60
1650654536485,CSE 3,A50,083646,Miranda; Gregory Joseph,19,0,38,19
1650654536485,CSE 3,A51,083647,Miranda; Gregory Joseph,36,0,37,1
1650654542512,CSE 8A,A50,083650,Miranda; Gregory Joseph,0,30,40,40
1650654548536,CSE 11,A01,083080,Cao; Yingjun,0,95,40,40
1650654554560,CSE 12,A01,083652,Staff,0,19,100,100
1650654560593,CSE 15L,A01,083654,Staff,0,2,50,50
1650654560593,CSE 15L,A02,083655,Staff,0,1,50,50
1650654566617,CSE 20,A01,083657,Staff,51,0,80,29
1650654572651,CSE 30,A01,083084,Eldon; John,0,77,40,40
1650654578678,CSE 100,A01,083659,Cao; Yingjun,0,69,50,50
1650654584708,CSE 134B,A01,083661,Powell; Thomas Allan,0,37,65,65
1650654590732,CSE 140,A01,083663,Staff,0,8,75,75
1650654596762,CSE 140L,A01,083088,Eldon; John,0,16,75,75
1650654602791,CSE 175,A01,083665,Kumar; Rakesh,7,0,25,18
1650654608815,CSE 190,A00,092507,Dubnov; Shlomo,10,0,20,10
1650654614857,ECE 45,A01,083139,Staff,0,1,60,60
1650654620879,ECE 65,A50,083695,Staff,0,5,30,30
1650654626907,ECE 109,A01,091882,Touri; Behrouz,33,0,70,37
1650654632936,ECE 180,A00,083140,Abi Samra; Nicholas Camill,21,0,30,9
1650654632936,ECE 180,B00,083141,Abi Samra; Nicholas Camill,0,0,30,30
1650654638963,MATH 10A,A01,083735,Patchell; Gregory David,3,0,30,27
1650654638963,MATH 10A,A02,083736,Patchell; Gregory David,27,0,30,3
1650654638963,MATH 10A,A03,083737,Patchell; Gregory David,24,0,30,6
1650654644989,MATH 10B,A01,083207,Staff,0,8,30,30
1650654644989,MATH 10B,A02,083208,Staff,0,8,30,30
1650654644989,MATH 10B,B01,083739,Staff,11,0,30,19
1650654644989,MATH 10B,B02,083740,Staff,28,0,30,2
1650654651017,MATH 18,A01,083743,Staff,0,0,30,30
1650654651017,MATH 18,A02,083744,Staff,23,0,30,7
1650654651017,MATH 18,A03,083745,Staff,21,0,30,9
1650654651017,MATH 18,A04,083746,Staff,26,0,30,4
1650654651017,MATH 18,B01,083748,Staff,0,15,30,30
1650654651017,MATH 18,B02,083749,Staff,0,11,30,30
1650654651017,MATH 18,B03,083750,Staff,0,12,30,30
1650654651017,MATH 18,B04,083751,Staff,0,12,30,30
1650654657050,MATH 20A,A01,083754,Staff,19,0,40,21
1650654663072,MATH 20B,A01,083756,Staff,0,11,30,30
1650654663072,MATH 20B,A02,083757,Staff,0,12,30,30
1650654669099,MATH 20C,A01,083760,Staff,0,16,30,30
1650654669099,MATH 20C,A02,083761,Staff,1,14,30,29
1650654669099,MATH 20C,B01,083762,Staff,11,0,30,19
1650654669099,MATH 20C,B02,083763,Staff,28,0,30,2
1650654675121,MATH 20D,A01,083765,Staff,1,1,30,29
1650654675121,MATH 20D,A02,083766,Staff,6,0,30,24
1650654675121,MATH 20D,A03,083767,Staff,24,0,30,6
1650654681146,MATH 20E,A01,083771,Staff,3,0,30,27
1650654681146,MATH 20E,A02,083772,Staff,16,0,30,14
1650654681146,MATH 20E,B01,083773,Staff,0,0,30,30
1650654681146,MATH 20E,B02,083774,Staff,9,0,30,21
1650654687174,MATH 103A,A01,083777,Staff,0,15,30,30
1650654687174,MATH 103A,A02,083778,Staff,0,15,30,30
1650654687174,MATH 103A,B01,083779,Staff,0,14,30,30
1650654687174,MATH 103A,B02,083780,Staff,0,14,30,30
1650654693216,MATH 105,A01,085443,Staff,0,22,30,30
1650654699238,MATH 109,A01,083213,Anzaldo; Leesa B,0,7,30,30
1650654699238,MATH 109,A02,083214,Anzaldo; Leesa B,0,7,30,30
1650654699238,MATH 109,B01,083215,Anzaldo; Leesa B,0,6,30,30
1650654699238,MATH 109,B02,083216,Anzaldo; Leesa B,0,6,30,30
1650654705265,MATH 142A,A01,083219,Chow; Bennett,0,16,30,30
1650654705265,MATH 142A,A02,083220,Chow; Bennett,0,15,30,30
1650654705265,MATH 142A,B01,083221,Chow; Bennett,0,14,30,30
1650654705265,MATH 142A,B02,083222,Chow; Bennett,0,13,30,30
1650654711295,MATH 193A,A01,083224,Staff,0,5,30,30
1650654711295,MATH 193A,A02,083225,Staff,0,6,30,30
1650654711295,MATH 193A,A03,083781,Staff,0,6,30,30
1650654711295,MATH 193A,A04,083782,Staff,0,7,30,30
1650654717318,MATH 197,001,091859,McAuley; Julian John,9998,0,9999,1
1650654723375,COGS 9,A01,083615,Staff,1,16,60,59
1650654729400,COGS 11,A01,083617,Boyle; Mary E. T.,18,0,40,22
1650654735422,COGS 13,A01,083071,Staff,0,39,40,40
1650654741446,COGS 14A,A01,092681,Staff,0,32,100,100
1650654747470,COGS 14B,A01,083073,Cheng; Tzu-Han,0,14,50,50
1650654753494,COGS 17,A01,092677,Staff,17,0,75,58
1650654759517,COGS 100,A01,083619,Staff,0,28,60,60
1650654765545,COGS 101A,A01,083621,Davis; Joshua Daniel,0,27,60,60
1650654771569,COGS 101B,A01,091572,Staff,0,4,60,60
1650654777600,COGS 101C,A01,083625,Delgado; Tania,15,0,30,15
1650654783622,COGS 107A,A01,083627,Boyle; Mary E. T.,1,17,60,59
1650654789647,COGS 118A,A01,083075,Staff,0,7,60,60
1650654795672,CSE 3,A50,083646,Miranda; Gregory Joseph,19,0,38,19
1650654795672,CSE 3,A51,083647,Miranda; Gregory Joseph,36,0,37,1
1650654801696,CSE 8A,A50,083650,Miranda; Gregory Joseph,0,30,40,40
1650654807729,CSE 11,A01,083080,Cao; Yingjun,0,95,40,40
1650654813753,CSE 12,A01,083652,Staff,0,19,100,100
1650654819779,CSE 15L,A01,083654,Staff,0,2,50,50
1650654819779,CSE 15L,A02,083655,Staff,0,1,50,50
1650654825800,CSE 20,A01,083657,Staff,51,0,80,29
1650654831822,CSE 30,A01,083084,Eldon; John,0,77,40,40
1650654837846,CSE 100,A01,083659,Cao; Yingjun,0,69,50,50
1650654843873,CSE 134B,A01,083661,Powell; Thomas Allan,0,37,65,65
1650654849898,CSE 140,A01,083663,Staff,0,8,75,75
1650654855926,CSE 140L,A01,083088,Eldon; John,0,16,75,75
1650654861952,CSE 175,A01,083665,Kumar; Rakesh,7,0,25,18
1650654867978,CSE 190,A00,092507,Dubnov; Shlomo,10,0,20,10
1650654874009,ECE 45,A01,083139,Staff,0,1,60,60
1650654880035,ECE 65,A50,083695,Staff,0,5,30,30
1650654886061,ECE 109,A01,091882,Touri; Behrouz,33,0,70,37
1650654892092,ECE 180,A00,083140,Abi Samra; Nicholas Camill,21,0,30,9
1650654892092,ECE 180,B00,083141,Abi Samra; Nicholas Camill,0,0,30,30
1650654898120,MATH 10A,A01,083735,Patchell; Gregory David,3,0,30,27
1650654898120,MATH 10A,A02,083736,Patchell; Gregory David,27,0,30,3
1650654898120,MATH 10A,A03,083737,Patchell; Gregory David,24,0,30,6
1650654904142,MATH 10B,A01,083207,Staff,0,8,30,30
1650654904142,MATH 10B,A02,083208,Staff,0,8,30,30
1650654904142,MATH 10B,B01,083739,Staff,11,0,30,19
1650654904142,MATH 10B,B02,083740,Staff,28,0,30,2
1650654910170,MATH 18,A01,083743,Staff,0,0,30,30
1650654910170,MATH 18,A02,083744,Staff,23,0,30,7
1650654910170,MATH 18,A03,083745,Staff,21,0,30,9
1650654910170,MATH 18,A04,083746,Staff,26,0,30,4
1650654910170,MATH 18,B01,083748,Staff,0,15,30,30
1650654910170,MATH 18,B02,083749,Staff,0,11,30,30
1650654910170,MATH 18,B03,083750,Staff,0,12,30,30
1650654910170,MATH 18,B04,083751,Staff,0,12,30,30
1650654916194,MATH 20A,A01,083754,Staff,19,0,40,21
1650654922226,MATH 20B,A01,083756,Staff,0,11,30,30
1650654922226,MATH 20B,A02,083757,Staff,0,12,30,30
1650654928255,MATH 20C,A01,083760,Staff,0,16,30,30
1650654928255,MATH 20C,A02,083761,Staff,1,14,30,29
1650654928255,MATH 20C,B01,083762,Staff,11,0,30,19
1650654928255,MATH 20C,B02,083763,Staff,28,0,30,2
1650654934378,MATH 20D,A01,083765,Staff,1,1,30,29
1650654934378,MATH 20D,A02,083766,Staff,6,0,30,24
1650654934378,MATH 20D,A03,083767,Staff,24,0,30,6
1650654940407,MATH 20E,A01,083771,Staff,3,0,30,27
1650654940407,MATH 20E,A02,083772,Staff,16,0,30,14
1650654940407,MATH 20E,B01,083773,Staff,0,0,30,30
1650654940407,MATH 20E,B02,083774,Staff,9,0,30,21
1650654946435,MATH 103A,A01,083777,Staff,0,15,30,30
1650654946435,MATH 103A,A02,083778,Staff,0,15,30,30
1650654946435,MATH 103A,B01,083779,Staff,0,14,30,30
1650654946435,MATH 103A,B02,083780,Staff,0,14,30,30
1650654952464,MATH 105,A01,085443,Staff,0,22,30,30
1650654958496,MATH 109,A01,083213,Anzaldo; Leesa B,0,7,30,30
1650654958496,MATH 109,A02,083214,Anzaldo; Leesa B,0,7,30,30
1650654958496,MATH 109,B01,083215,Anzaldo; Leesa B,0,6,30,30
1650654958496,MATH 109,B02,083216,Anzaldo; Leesa B,0,6,30,30
1650654964527,MATH 142A,A01,083219,Chow; Bennett,0,16,30,30
1650654964527,MATH 142A,A02,083220,Chow; Bennett,0,15,30,30
1650654964527,MATH 142A,B01,083221,Chow; Bennett,0,14,30,30
1650654964527,MATH 142A,B02,083222,Chow; Bennett,0,13,30,30
1650654970551,MATH 193A,A01,083224,Staff,0,5,30,30
1650654970551,MATH 193A,A02,083225,Staff,0,6,30,30
1650654970551,MATH 193A,A03,083781,Staff,0,6,30,30
1650654970551,MATH 193A,A04,083782,Staff,0,7,30,30
1650654976579,MATH 197,001,091859,McAuley; Julian John,9998,0,9999,1
1650654982646,COGS 9,A01,083615,Staff,1,16,60,59
1650654988673,COGS 11,A01,083617,Boyle; Mary E. T.,18,0,40,22
1650654994698,COGS 13,A01,083071,Staff,0,39,40,40
1650655000720,COGS 14A,A01,092681,Staff,0,32,100,100
1650655006745,COGS 14B,A01,083073,Cheng; Tzu-Han,0,14,50,50
1650655012772,COGS 17,A01,092677,Staff,17,0,75,58
1650655018796,COGS 100,A01,083619,Staff,0,28,60,60
1650655024819,COGS 101A,A01,083621,Davis; Joshua Daniel,0,27,60,60
1650655030842,COGS 101B,A01,091572,Staff,0,4,60,60
1650655036866,COGS 101C,A01,083625,Delgado; Tania,15,0,30,15
1650655042889,COGS 107A,A01,083627,Boyle; Mary E. T.,1,17,60,59
1650655048925,COGS 118A,A01,083075,Staff,0,7,60,60
1650655054953,CSE 3,A50,083646,Miranda; Gregory Joseph,19,0,38,19
1650655054953,CSE 3,A51,083647,Miranda; Gregory Joseph,36,0,37,1
1650655060982,CSE 8A,A50,083650,Miranda; Gregory Joseph,0,30,40,40
1650655067008,CSE 11,A01,083080,Cao; Yingjun,0,95,40,40
1650655073032,CSE 12,A01,083652,Staff,0,19,100,100
1650655079059,CSE 15L,A01,083654,Staff,0,2,50,50
1650655079059,CSE 15L,A02,083655,Staff,0,1,50,50
1650655085086,CSE 20,A01,083657,Staff,51,0,80,29
1650655091118,CSE 30,A01,083084,Eldon; John,0,77,40,40
1650655097145,CSE 100,A01,083659,Cao; Yingjun,0,69,50,50
1650655103168,CSE 134B,A01,083661,Powell; Thomas Allan,0,37,65,65
1650655109191,CSE 140,A01,083663,Staff,0,8,75,75
1650655115214,CSE 140L,A01,083088,Eldon; John,0,16,75,75
1650655121238,CSE 175,A01,083665,Kumar; Rakesh,7,0,25,18
1650655127268,CSE 190,A00,092507,Dubnov; Shlomo,10,0,20,10
1650655133291,ECE 45,A01,083139,Staff,0,1,60,60
1650655139321,ECE 65,A50,083695,Staff,0,5,30,30
1650655145353,ECE 109,A01,091882,Touri; Behrouz,33,0,70,37
1650655151386,ECE 180,A00,083140,Abi Samra; Nicholas Camill,21,0,30,9
1650655151386,ECE 180,B00,083141,Abi Samra; Nicholas Camill,0,0,30,30
1650655157410,MATH 10A,A01,083735,Patchell; Gregory David,3,0,30,27
1650655157410,MATH 10A,A02,083736,Patchell; Gregory David,27,0,30,3
1650655157410,MATH 10A,A03,083737,Patchell; Gregory David,24,0,30,6
1650655163436,MATH 10B,A01,083207,Staff,0,8,30,30
1650655163436,MATH 10B,A02,083208,Staff,0,8,30,30
1650655163436,MATH 10B,B01,083739,Staff,11,0,30,19
1650655163436,MATH 10B,B02,083740,Staff,28,0,30,2
1650655169525,MATH 18,A01,083743,Staff,0,0,30,30
1650655169525,MATH 18,A02,083744,Staff,23,0,30,7
1650655169525,MATH 18,A03,083745,Staff,21,0,30,9
1650655169525,MATH 18,A04,083746,Staff,26,0,30,4
1650655169525,MATH 18,B01,083748,Staff,0,15,30,30
1650655169525,MATH 18,B02,083749,Staff,0,11,30,30
1650655169525,MATH 18,B03,083750,Staff,0,12,30,30
1650655169525,MATH 18,B04,083751,Staff,0,12,30,30
1650655175552,MATH 20A,A01,083754,Staff,19,0,40,21
1650655181579,MATH 20B,A01,083756,Staff,0,11,30,30
1650655181579,MATH 20B,A02,083757,Staff,0,12,30,30
1650655187604,MATH 20C,A01,083760,Staff,0,16,30,30
1650655187604,MATH 20C,A02,083761,Staff,1,14,30,29
1650655187604,MATH 20C,B01,083762,Staff,11,0,30,19
1650655187604,MATH 20C,B02,083763,Staff,28,0,30,2
1650655193631,MATH 20D,A01,083765,Staff,1,1,30,29
1650655193631,MATH 20D,A02,083766,Staff,6,0,30,24
1650655193631,MATH 20D,A03,083767,Staff,24,0,30,6
1650655199660,MATH 20E,A01,083771,Staff,3,0,30,27
1650655199660,MATH 20E,A02,083772,Staff,16,0,30,14
1650655199660,MATH 20E,B01,083773,Staff,0,0,30,30
1650655199660,MATH 20E,B02,083774,Staff,9,0,30,21
1650655205686,MATH 103A,A01,083777,Staff,0,15,30,30
1650655205686,MATH 103A,A02,083778,Staff,0,15,30,30
1650655205686,MATH 103A,B01,083779,Staff,0,14,30,30
1650655205686,MATH 103A,B02,083780,Staff,0,14,30,30
1650655211716,MATH 105,A01,085443,Staff,0,22,30,30
1650655217756,MATH 109,A01,083213,Anzaldo; Leesa B,0,7,30,30
1650655217756,MATH 109,A02,083214,Anzaldo; Leesa B,0,7,30,30
1650655217756,MATH 109,B01,083215,Anzaldo; Leesa B,0,6,30,30
1650655217756,MATH 109,B02,083216,Anzaldo; Leesa B,0,6,30,30
1650655223783,MATH 142A,A01,083219,Chow; Bennett,0,16,30,30
1650655223783,MATH 142A,A02,083220,Chow; Bennett,0,15,30,30
1650655223783,MATH 142A,B01,083221,Chow; Bennett,0,14,30,30
1650655223783,MATH 142A,B02,083222,Chow; Bennett,0,13,30,30
1650655229809,MATH 193A,A01,083224,Staff,0,5,30,30
1650655229809,MATH 193A,A02,083225,Staff,0,6,30,30
1650655229809,MATH 193A,A03,083781,Staff,0,6,30,30
1650655229809,MATH 193A,A04,083782,Staff,0,7,30,30
1650655235833,MATH 197,001,091859,McAuley; Julian John,9998,0,9999,1
1650655241888,COGS 9,A01,083615,Staff,1,16,60,59
1650655247913,COGS 11,A01,083617,Boyle; Mary E. T.,18,0,40,22
1650655253936,COGS 13,A01,083071,Staff,0,39,40,40
1650655259966,COGS 14A,A01,092681,Staff,0,32,100,100
1650655265994,COGS 14B,A01,083073,Cheng; Tzu-Han,0,14,50,50
1650655272018,COGS 17,A01,092677,Staff,17,0,75,58
1650655278040,COGS 100,A01,083619,Staff,0,28,60,60
1650655284068,COGS 101A,A01,083621,Davis; Joshua Daniel,0,27,60,60
1650655290097,COGS 101B,A01,091572,Staff,0,4,60,60
1650655296123,COGS 101C,A01,083625,Delgado; Tania,15,0,30,15
1650655302150,COGS 107A,A01,083627,Boyle; Mary E. T.,1,17,60,59
1650655308175,COGS 118A,A01,083075,Staff,0,7,60,60
1650655314205,CSE 3,A50,083646,Miranda; Gregory Joseph,19,0,38,19
1650655314205,CSE 3,A51,083647,Miranda; Gregory Joseph,36,0,37,1
1650655320241,CSE 8A,A50,083650,Miranda; Gregory Joseph,0,30,40,40
1650655326269,CSE 11,A01,083080,Cao; Yingjun,0,95,40,40
1650655332294,CSE 12,A01,083652,Staff,0,19,100,100
1650655338320,CSE 15L,A01,083654,Staff,0,2,50,50
1650655338320,CSE 15L,A02,083655,Staff,0,1,50,50
1650655344348,CSE 20,A01,083657,Staff,51,0,80,29
1650655350373,CSE 30,A01,083084,Eldon; John,0,77,40,40
1650655356396,CSE 100,A01,083659,Cao; Yingjun,0,69,50,50
1650655362424,CSE 134B,A01,083661,Powell; Thomas Allan,0,37,65,65
1650655368449,CSE 140,A01,083663,Staff,0,8,75,75
1650655374472,CSE 140L,A01,083088,Eldon; John,0,16,75,75
1650655380497,CSE 175,A01,083665,Kumar; Rakesh,7,0,25,18
1650655386520,CSE 190,A00,092507,Dubnov; Shlomo,10,0,20,10
1650655392547,ECE 45,A01,083139,Staff,0,1,60,60
1650655398585,ECE 65,A50,083695,Staff,0,5,30,30
1650655404611,ECE 109,A01,091882,Touri; Behrouz,33,0,70,37
1650655410634,ECE 180,A00,083140,Abi Samra; Nicholas Camill,21,0,30,9
1650655410634,ECE 180,B00,083141,Abi Samra; Nicholas Camill,0,0,30,30
1650655416661,MATH 10A,A01,083735,Patchell; Gregory David,3,0,30,27
1650655416661,MATH 10A,A02,083736,Patchell; Gregory David,27,0,30,3
1650655416661,MATH 10A,A03,083737,Patchell; Gregory David,24,0,30,6
1650655422708,MATH 10B,A01,083207,Staff,0,8,30,30
1650655422708,MATH 10B,A02,083208,Staff,0,8,30,30
1650655422708,MATH 10B,B01,083739,Staff,11,0,30,19
1650655422708,MATH 10B,B02,083740,Staff,28,0,30,2
1650655428740,MATH 18,A01,083743,Staff,0,0,30,30
1650655428740,MATH 18,A02,083744,Staff,23,0,30,7
1650655428740,MATH 18,A03,083745,Staff,21,0,30,9
1650655428740,MATH 18,A04,083746,Staff,26,0,30,4
1650655428740,MATH 18,B01,083748,Staff,0,15,30,30
1650655428740,MATH 18,B02,083749,Staff,0,11,30,30
1650655428740,MATH 18,B03,083750,Staff,0,12,30,30
1650655428740,MATH 18,B04,083751,Staff,0,12,30,30
1650655434776,MATH 20A,A01,083754,Staff,19,0,40,21
1650655440809,MATH 20B,A01,083756,Staff,0,11,30,30
1650655440809,MATH 20B,A02,083757,Staff,0,12,30,30
1650655446837,MATH 20C,A01,083760,Staff,0,16,30,30
1650655446837,MATH 20C,A02,083761,Staff,1,14,30,29
1650655446837,MATH 20C,B01,083762,Staff,11,0,30,19
1650655446837,MATH 20C,B02,083763,Staff,28,0,30,2
1650655452864,MATH 20D,A01,083765,Staff,1,1,30,29
1650655452864,MATH 20D,A02,083766,Staff,6,0,30,24
1650655452864,MATH 20D,A03,083767,Staff,24,0,30,6
1650655458903,MATH 20E,A01,083771,Staff,3,0,30,27
1650655458903,MATH 20E,A02,083772,Staff,16,0,30,14
1650655458903,MATH 20E,B01,083773,Staff,0,0,30,30
1650655458903,MATH 20E,B02,083774,Staff,9,0,30,21
1650655464943,MATH 103A,A01,083777,Staff,0,15,30,30
1650655464943,MATH 103A,A02,083778,Staff,0,15,30,30
1650655464943,MATH 103A,B01,083779,Staff,0,14,30,30
1650655464943,MATH 103A,B02,083780,Staff,0,14,30,30
1650655470971,MATH 105,A01,085443,Staff,0,22,30,30
1650655476996,MATH 109,A01,083213,Anzaldo; Leesa B,0,7,30,30
1650655476996,MATH 109,A02,083214,Anzaldo; Leesa B,0,7,30,30
1650655476996,MATH 109,B01,083215,Anzaldo; Leesa B,0,6,30,30
1650655476996,MATH 109,B02,083216,Anzaldo; Leesa B,0,6,30,30
1650655483025,MATH 142A,A01,083219,Chow; Bennett,0,16,30,30
1650655483025,MATH 142A,A02,083220,Chow; Bennett,0,15,30,30
1650655483025,MATH 142A,B01,083221,Chow; Bennett,0,14,30,30
1650655483025,MATH 142A,B02,083222,Chow; Bennett,0,13,30,30
1650655489060,MATH 193A,A01,083224,Staff,0,5,30,30
1650655489060,MATH 193A,A02,083225,Staff,0,6,30,30
1650655489060,MATH 193A,A03,083781,Staff,0,6,30,30
1650655489060,MATH 193A,A04,083782,Staff,0,7,30,30
1650655495083,MATH 197,001,091859,McAuley; Julian John,9998,0,9999,1
1650655501150,COGS 9,A01,083615,Staff,1,16,60,59
1650655507176,COGS 11,A01,083617,Boyle; Mary E. T.,18,0,40,22
1650655513204,COGS 13,A01,083071,Staff,0,39,40,40
1650655519232,COGS 14A,A01,092681,Staff,0,32,100,100
1650655525356,COGS 14B,A01,083073,Cheng; Tzu-Han,0,14,50,50
1650655531382,COGS 17,A01,092677,Staff,17,0,75,58
1650655537407,COGS 100,A01,083619,Staff,0,28,60,60
1650655543433,COGS 101A,A01,083621,Davis; Joshua Daniel,0,27,60,60
1650655549457,COGS 101B,A01,091572,Staff,0,4,60,60
1650655555486,COGS 101C,A01,083625,Delgado; Tania,15,0,30,15
1650655561513,COGS 107A,A01,083627,Boyle; Mary E. T.,1,17,60,59
1650655567539,COGS 118A,A01,083075,Staff,0,7,60,60
1650655573568,CSE 3,A50,083646,Miranda; Gregory Joseph,19,0,38,19
1650655573568,CSE 3,A51,083647,Miranda; Gregory Joseph,36,0,37,1
1650655579594,CSE 8A,A50,083650,Miranda; Gregory Joseph,0,30,40,40
1650655585617,CSE 11,A01,083080,Cao; Yingjun,0,95,40,40
1650655591644,CSE 12,A01,083652,Staff,0,19,100,100
1650655597670,CSE 15L,A01,083654,Staff,0,2,50,50
1650655597670,CSE 15L,A02,083655,Staff,0,1,50,50
1650655603695,CSE 20,A01,083657,Staff,51,0,80,29
1650655609720,CSE 30,A01,083084,Eldon; John,0,77,40,40
1650655615747,CSE 100,A01,083659,Cao; Yingjun,0,69,50,50
1650655621773,CSE 134B,A01,083661,Powell; Thomas Allan,0,37,65,65
1650655627804,CSE 140,A01,083663,Staff,0,8,75,75
1650655633829,CSE 140L,A01,083088,Eldon; John,0,16,75,75
1650655639854,CSE 175,A01,083665,Kumar; Rakesh,7,0,25,18
1650655645879,CSE 190,A00,092507,Dubnov; Shlomo,10,0,20,10
1650655651984,ECE 45,A01,083139,Staff,0,1,60,60
1650655658014,ECE 65,A50,083695,Staff,0,5,30,30
1650655664042,ECE 109,A01,091882,Touri; Behrouz,33,0,70,37
1650655670066,ECE 180,A00,083140,Abi Samra; Nicholas Camill,21,0,30,9
1650655670066,ECE 180,B00,083141,Abi Samra; Nicholas Camill,0,0,30,30
1650655676091,MATH 10A,A01,083735,Patchell; Gregory David,3,0,30,27
1650655676091,MATH 10A,A02,083736,Patchell; Gregory David,27,0,30,3
1650655676091,MATH 10A,A03,083737,Patchell; Gregory David,24,0,30,6
1650655682116,MATH 10B,A01,083207,Staff,0,8,30,30
1650655682116,MATH 10B,A02,083208,Staff,0,8,30,30
1650655682116,MATH 10B,B01,083739,Staff,11,0,30,19
1650655682116,MATH 10B,B02,083740,Staff,28,0,30,2
1650655688139,MATH 18,A01,083743,Staff,0,0,30,30
1650655688139,MATH 18,A02,083744,Staff,23,0,30,7
1650655688139,MATH 18,A03,083745,Staff,21,0,30,9
1650655688139,MATH 18,A04,083746,Staff,26,0,30,4
1650655688139,MATH 18,B01,083748,Staff,0,15,30,30
1650655688139,MATH 18,B02,083749,Staff,0,11,30,30
1650655688139,MATH 18,B03,083750,Staff,0,12,30,30
1650655688139,MATH 18,B04,083751,Staff,0,12,30,30
1650655694167,MATH 20A,A01,083754,Staff,19,0,40,21
1650655700192,MATH 20B,A01,083756,Staff,0,11,30,30
1650655700192,MATH 20B,A02,083757,Staff,0,12,30,30
1650655713086,MATH 20C,A01,083760,Staff,0,16,30,30
1650655713086,MATH 20C,A02,083761,Staff,1,14,30,29
1650655713086,MATH 20C,B01,083762,Staff,11,0,30,19
1650655713086,MATH 20C,B02,083763,Staff,28,0,30,2
1650655719113,MATH 20D,A01,083765,Staff,1,1,30,29
1650655719113,MATH 20D,A02,083766,Staff,6,0,30,24
1650655719113,MATH 20D,A03,083767,Staff,24,0,30,6
1650655725137,MATH 20E,A01,083771,Staff,3,0,30,27
1650655725137,MATH 20E,A02,083772,Staff,16,0,30,14
1650655725137,MATH 20E,B01,083773,Staff,0,0,30,30
1650655725137,MATH 20E,B02,083774,Staff,9,0,30,21
1650655731163,MATH 103A,A01,083777,Staff,0,15,30,30
1650655731163,MATH 103A,A02,083778,Staff,0,15,30,30
1650655731163,MATH 103A,B01,083779,Staff,0,14,30,30
1650655731163,MATH 103A,B02,083780,Staff,0,14,30,30
1650655737186,MATH 105,A01,085443,Staff,0,22,30,30
1650655743215,MATH 109,A01,083213,Anzaldo; Leesa B,0,7,30,30
1650655743215,MATH 109,A02,083214,Anzaldo; Leesa B,0,7,30,30
1650655743215,MATH 109,B01,083215,Anzaldo; Leesa B,0,6,30,30
1650655743215,MATH 109,B02,083216,Anzaldo; Leesa B,0,6,30,30
1650655749238,MATH 142A,A01,083219,Chow; Bennett,0,16,30,30
1650655749238,MATH 142A,A02,083220,Chow; Bennett,0,15,30,30
1650655749238,MATH 142A,B01,083221,Chow; Bennett,0,14,30,30
1650655749238,MATH 142A,B02,083222,Chow; Bennett,0,13,30,30
1650655755265,MATH 193A,A01,083224,Staff,0,5,30,30
1650655755265,MATH 193A,A02,083225,Staff,0,6,30,30
1650655755265,MATH 193A,A03,083781,Staff,0,6,30,30
1650655755265,MATH 193A,A04,083782,Staff,0,7,30,30
1650655761289,MATH 197,001,091859,McAuley; Julian John,9998,0,9999,1
1650655767348,COGS 9,A01,083615,Staff,1,16,60,59
1650655773371,COGS 11,A01,083617,Boyle; Mary E. T.,18,0,40,22
1650655779398,COGS 13,A01,083071,Staff,0,39,40,40
1650655785427,COGS 14A,A01,092681,Staff,0,32,100,100
1650655791453,COGS 14B,A01,083073,Cheng; Tzu-Han,0,14,50,50
1650655797477,COGS 17,A01,092677,Staff,17,0,75,58
1650655803503,COGS 100,A01,083619,Staff,0,28,60,60
1650655809527,COGS 101A,A01,083621,Davis; Joshua Daniel,0,27,60,60
1650655815553,COGS 101B,A01,091572,Staff,0,4,60,60
1650655821577,COGS 101C,A01,083625,Delgado; Tania,15,0,30,15
1650655827602,COGS 107A,A01,083627,Boyle; Mary E. T.,1,17,60,59
1650655833625,COGS 118A,A01,083075,Staff,0,7,60,60
1650655839662,CSE 3,A50,083646,Miranda; Gregory Joseph,19,0,38,19
1650655839662,CSE 3,A51,083647,Miranda; Gregory Joseph,36,0,37,1
1650655845685,CSE 8A,A50,083650,Miranda; Gregory Joseph,0,30,40,40
1650655851709,CSE 11,A01,083080,Cao; Yingjun,0,95,40,40
1650655857740,CSE 12,A01,083652,Staff,0,19,100,100
1650655863768,CSE 15L,A01,083654,Staff,0,2,50,50
1650655863768,CSE 15L,A02,083655,Staff,0,1,50,50
1650655869800,CSE 20,A01,083657,Staff,51,0,80,29
1650655875824,CSE 30,A01,083084,Eldon; John,0,77,40,40
1650655881852,CSE 100,A01,083659,Cao; Yingjun,0,69,50,50
1650655887880,CSE 134B,A01,083661,Powell; Thomas Allan,0,37,65,65
1650655893904,CSE 140,A01,083663,Staff,0,8,75,75
1650655899930,CSE 140L,A01,083088,Eldon; John,0,16,75,75
1650655905957,CSE 175,A01,083665,Kumar; Rakesh,7,0,25,18
1650655911983,CSE 190,A00,092507,Dubnov; Shlomo,10,0,20,10
1650655918011,ECE 45,A01,083139,Staff,0,1,60,60
1650655924039,ECE 65,A50,083695,Staff,0,5,30,30
1650655930068,ECE 109,A01,091882,Touri; Behrouz,33,0,70,37
1650655936094,ECE 180,A00,083140,Abi Samra; Nicholas Camill,21,0,30,9
1650655936094,ECE 180,B00,083141,Abi Samra; Nicholas Camill,0,0,30,30
1650655942129,MATH 10A,A01,083735,Patchell; Gregory David,3,0,30,27
1650655942129,MATH 10A,A02,083736,Patchell; Gregory David,27,0,30,3
1650655942129,MATH 10A,A03,083737,Patchell; Gregory David,24,0,30,6
1650655948155,MATH 10B,A01,083207,Staff,0,8,30,30
1650655948155,MATH 10B,A02,083208,Staff,0,8,30,30
1650655948155,MATH 10B,B01,083739,Staff,11,0,30,19
1650655948155,MATH 10B,B02,083740,Staff,28,0,30,2
1650655954193,MATH 18,A01,083743,Staff,0,0,30,30
1650655954193,MATH 18,A02,083744,Staff,23,0,30,7
1650655954193,MATH 18,A03,083745,Staff,21,0,30,9
1650655954193,MATH 18,A04,083746,Staff,26,0,30,4
1650655954193,MATH 18,B01,083748,Staff,0,15,30,30
1650655954193,MATH 18,B02,083749,Staff,0,11,30,30
1650655954193,MATH 18,B03,083750,Staff,0,12,30,30
1650655954193,MATH 18,B04,083751,Staff,0,12,30,30
1650655960223,MATH 20A,A01,083754,Staff,19,0,40,21
1650655966249,MATH 20B,A01,083756,Staff,0,11,30,30
1650655966249,MATH 20B,A02,083757,Staff,0,12,30,30
1650655972279,MATH 20C,A01,083760,Staff,0,16,30,30
1650655972279,MATH 20C,A02,083761,Staff,1,14,30,29
1650655972279,MATH 20C,B01,083762,Staff,11,0,30,19
1650655972279,MATH 20C,B02,083763,Staff,28,0,30,2
1650655978303,MATH 20D,A01,083765,Staff,1,1,30,29
1650655978303,MATH 20D,A02,083766,Staff,6,0,30,24
1650655978303,MATH 20D,A03,083767,Staff,24,0,30,6
1650655984327,MATH 20E,A01,083771,Staff,3,0,30,27
1650655984327,MATH 20E,A02,083772,Staff,16,0,30,14
1650655984327,MATH 20E,B01,083773,Staff,0,0,30,30
1650655984327,MATH 20E,B02,083774,Staff,9,0,30,21
1650655990370,MATH 103A,A01,083777,Staff,0,15,30,30
1650655990370,MATH 103A,A02,083778,Staff,0,15,30,30
1650655990370,MATH 103A,B01,083779,Staff,0,14,30,30
1650655990370,MATH 103A,B02,083780,Staff,0,14,30,30
1650655996398,MATH 105,A01,085443,Staff,0,22,30,30
1650656002425,MATH 109,A01,083213,Anzaldo; Leesa B,0,7,30,30
1650656002425,MATH 109,A02,083214,Anzaldo; Leesa B,0,7,30,30
1650656002425,MATH 109,B01,083215,Anzaldo; Leesa B,0,6,30,30
1650656002425,MATH 109,B02,083216,Anzaldo; Leesa B,0,6,30,30
1650656008458,MATH 142A,A01,083219,Chow; Bennett,0,16,30,30
1650656008458,MATH 142A,A02,083220,Chow; Bennett,0,15,30,30
1650656008458,MATH 142A,B01,083221,Chow; Bennett,0,14,30,30
1650656008458,MATH 142A,B02,083222,Chow; Bennett,0,13,30,30
1650656014483,MATH 193A,A01,083224,Staff,0,5,30,30
1650656014483,MATH 193A,A02,083225,Staff,0,6,30,30
1650656014483,MATH 193A,A03,083781,Staff,0,6,30,30
1650656014483,MATH 193A,A04,083782,Staff,0,7,30,30
1650656020509,MATH 197,001,091859,McAuley; Julian John,9998,0,9999,1
1650656026562,COGS 9,A01,083615,Staff,1,16,60,59
1650656032589,COGS 11,A01,083617,Boyle; Mary E. T.,18,0,40,22
1650656038614,COGS 13,A01,083071,Staff,0,39,40,40
1650656044638,COGS 14A,A01,092681,Staff,0,32,100,100
1650656050669,COGS 14B,A01,083073,Cheng; Tzu-Han,0,14,50,50
1650656056693,COGS 17,A01,092677,Staff,17,0,75,58
1650656062718,COGS 100,A01,083619,Staff,0,28,60,60
1650656068757,COGS 101A,A01,083621,Davis; Joshua Daniel,0,27,60,60
1650656074782,COGS 101B,A01,091572,Staff,0,4,60,60
1650656080812,COGS 101C,A01,083625,Delgado; Tania,15,0,30,15
1650656086838,COGS 107A,A01,083627,Boyle; Mary E. T.,1,17,60,59
1650656092862,COGS 118A,A01,083075,Staff,0,7,60,60
1650656098884,CSE 3,A50,083646,Miranda; Gregory Joseph,19,0,38,19
1650656098884,CSE 3,A51,083647,Miranda; Gregory Joseph,36,0,37,1
1650656104908,CSE 8A,A50,083650,Miranda; Gregory Joseph,0,30,40,40
1650656110939,CSE 11,A01,083080,Cao; Yingjun,0,95,40,40
1650656116966,CSE 12,A01,083652,Staff,0,19,100,100
1650656122993,CSE 15L,A01,083654,Staff,0,2,50,50
1650656122993,CSE 15L,A02,083655,Staff,0,1,50,50
1650656129111,CSE 20,A01,083657,Staff,51,0,80,29
1650656135135,CSE 30,A01,083084,Eldon; John,0,77,40,40
1650656141159,CSE 100,A01,083659,Cao; Yingjun,0,69,50,50
1650656147184,CSE 134B,A01,083661,Powell; Thomas Allan,0,37,65,65
1650656153209,CSE 140,A01,083663,Staff,0,8,75,75
1650656159235,CSE 140L,A01,083088,Eldon; John,0,16,75,75
1650656165260,CSE 175,A01,083665,Kumar; Rakesh,7,0,25,18
1650656171285,CSE 190,A00,092507,Dubnov; Shlomo,10,0,20,10
1650656177309,ECE 45,A01,083139,Staff,0,1,60,60
1650656183343,ECE 65,A50,083695,Staff,0,5,30,30
1650656189383,ECE 109,A01,091882,Touri; Behrouz,33,0,70,37
1650656195419,ECE 180,A00,083140,Abi Samra; Nicholas Camill,21,0,30,9
1650656195419,ECE 180,B00,083141,Abi Samra; Nicholas Camill,0,0,30,30
1650656201447,MATH 10A,A01,083735,Patchell; Gregory David,3,0,30,27
1650656201447,MATH 10A,A02,083736,Patchell; Gregory David,27,0,30,3
1650656201447,MATH 10A,A03,083737,Patchell; Gregory David,24,0,30,6
1650656207472,MATH 10B,A01,083207,Staff,0,8,30,30
1650656207472,MATH 10B,A02,083208,Staff,0,8,30,30
1650656207472,MATH 10B,B01,083739,Staff,11,0,30,19
1650656207472,MATH 10B,B02,083740,Staff,28,0,30,2
1650656213502,MATH 18,A01,083743,Staff,0,0,30,30
1650656213502,MATH 18,A02,083744,Staff,23,0,30,7
1650656213502,MATH 18,A03,083745,Staff,21,0,30,9
1650656213502,MATH 18,A04,083746,Staff,26,0,30,4
1650656213502,MATH 18,B01,083748,Staff,0,15,30,30
1650656213502,MATH 18,B02,083749,Staff,0,11,30,30
1650656213502,MATH 18,B03,083750,Staff,0,12,30,30
1650656213502,MATH 18,B04,083751,Staff,0,12,30,30
1650656219528,MATH 20A,A01,083754,Staff,19,0,40,21
1650656225553,MATH 20B,A01,083756,Staff,0,11,30,30
1650656225553,MATH 20B,A02,083757,Staff,0,12,30,30
1650656231578,MATH 20C,A01,083760,Staff,0,16,30,30
1650656231578,MATH 20C,A02,083761,Staff,1,14,30,29
1650656231578,MATH 20C,B01,083762,Staff,11,0,30,19
1650656231578,MATH 20C,B02,083763,Staff,28,0,30,2
1650656237601,MATH 20D,A01,083765,Staff,1,1,30,29
1650656237601,MATH 20D,A02,083766,Staff,6,0,30,24
1650656237601,MATH 20D,A03,083767,Staff,24,0,30,6
1650656243626,MATH 20E,A01,083771,Staff,3,0,30,27
1650656243626,MATH 20E,A02,083772,Staff,16,0,30,14
1650656243626,MATH 20E,B01,083773,Staff,0,0,30,30
1650656243626,MATH 20E,B02,083774,Staff,9,0,30,21
1650656249656,MATH 103A,A01,083777,Staff,0,15,30,30
1650656249656,MATH 103A,A02,083778,Staff,0,15,30,30
1650656249656,MATH 103A,B01,083779,Staff,0,14,30,30
1650656249656,MATH 103A,B02,083780,Staff,0,14,30,30
1650656255688,MATH 105,A01,085443,Staff,0,22,30,30
1650656261724,MATH 109,A01,083213,Anzaldo; Leesa B,0,7,30,30
1650656261724,MATH 109,A02,083214,Anzaldo; Leesa B,0,7,30,30
1650656261724,MATH 109,B01,083215,Anzaldo; Leesa B,0,6,30,30
1650656261724,MATH 109,B02,083216,Anzaldo; Leesa B,0,6,30,30
1650656267748,MATH 142A,A01,083219,Chow; Bennett,0,16,30,30
1650656267748,MATH 142A,A02,083220,Chow; Bennett,0,15,30,30
1650656267748,MATH 142A,B01,083221,Chow; Bennett,0,14,30,30
1650656267748,MATH 142A,B02,083222,Chow; Bennett,0,13,30,30
1650656273775,MATH 193A,A01,083224,Staff,0,5,30,30
1650656273775,MATH 193A,A02,083225,Staff,0,6,30,30
1650656273775,MATH 193A,A03,083781,Staff,0,6,30,30
1650656273775,MATH 193A,A04,083782,Staff,0,7,30,30
1650656279802,MATH 197,001,091859,McAuley; Julian John,9998,0,9999,1
1650656285864,COGS 9,A01,083615,Staff,1,16,60,59
1650656291893,COGS 11,A01,083617,Boyle; Mary E. T.,18,0,40,22
1650656297929,COGS 13,A01,083071,Staff,0,39,40,40
1650656303952,COGS 14A,A01,092681,Staff,0,32,100,100
1650656309982,COGS 14B,A01,083073,Cheng; Tzu-Han,0,14,50,50
1650656316006,COGS 17,A01,092677,Staff,17,0,75,58
1650656322031,COGS 100,A01,083619,Staff,0,28,60,60
1650656328059,COGS 101A,A01,083621,Davis; Joshua Daniel,0,27,60,60
1650656334084,COGS 101B,A01,091572,Staff,0,4,60,60
1650656340117,COGS 101C,A01,083625,Delgado; Tania,15,0,30,15
1650656346141,COGS 107A,A01,083627,Boyle; Mary E. T.,1,17,60,59
1650656352166,COGS 118A,A01,083075,Staff,0,7,60,60
1650656358191,CSE 3,A50,083646,Miranda; Gregory Joseph,19,0,38,19
1650656358191,CSE 3,A51,083647,Miranda; Gregory Joseph,36,0,37,1
1650656364218,CSE 8A,A50,083650,Miranda; Gregory Joseph,0,30,40,40
1650656370245,CSE 11,A01,083080,Cao; Yingjun,0,95,40,40
1650656376276,CSE 12,A01,083652,Staff,0,19,100,100
1650656382303,CSE 15L,A01,083654,Staff,0,2,50,50
1650656382303,CSE 15L,A02,083655,Staff,0,1,50,50
1650656388338,CSE 20,A01,083657,Staff,51,0,80,29
1650656394363,CSE 30,A01,083084,Eldon; John,0,77,40,40
1650656400402,CSE 100,A01,083659,Cao; Yingjun,0,69,50,50
1650656406425,CSE 134B,A01,083661,Powell; Thomas Allan,0,37,65,65
1650656412462,CSE 140,A01,083663,Staff,0,8,75,75
1650656418489,CSE 140L,A01,083088,Eldon; John,0,16,75,75
1650656424514,CSE 175,A01,083665,Kumar; Rakesh,7,0,25,18
1650656430537,CSE 190,A00,092507,Dubnov; Shlomo,10,0,20,10
1650656436569,ECE 45,A01,083139,Staff,0,1,60,60
1650656442603,ECE 65,A50,083695,Staff,0,5,30,30
1650656448628,ECE 109,A01,091882,Touri; Behrouz,33,0,70,37
1650656454651,ECE 180,A00,083140,Abi Samra; Nicholas Camill,21,0,30,9
1650656454651,ECE 180,B00,083141,Abi Samra; Nicholas Camill,0,0,30,30
1650656460675,MATH 10A,A01,083735,Patchell; Gregory David,3,0,30,27
1650656460675,MATH 10A,A02,083736,Patchell; Gregory David,27,0,30,3
1650656460675,MATH 10A,A03,083737,Patchell; Gregory David,24,0,30,6
1650656466699,MATH 10B,A01,083207,Staff,0,8,30,30
1650656466699,MATH 10B,A02,083208,Staff,0,8,30,30
1650656466699,MATH 10B,B01,083739,Staff,11,0,30,19
1650656466699,MATH 10B,B02,083740,Staff,28,0,30,2
1650656472724,MATH 18,A01,083743,Staff,0,0,30,30
1650656472724,MATH 18,A02,083744,Staff,23,0,30,7
1650656472724,MATH 18,A03,083745,Staff,21,0,30,9
1650656472724,MATH 18,A04,083746,Staff,26,0,30,4
1650656472724,MATH 18,B01,083748,Staff,0,15,30,30
1650656472724,MATH 18,B02,083749,Staff,0,11,30,30
1650656472724,MATH 18,B03,083750,Staff,0,12,30,30
1650656472724,MATH 18,B04,083751,Staff,0,12,30,30
1650656478750,MATH 20A,A01,083754,Staff,19,0,40,21
1650656484776,MATH 20B,A01,083756,Staff,0,11,30,30
1650656484776,MATH 20B,A02,083757,Staff,0,12,30,30
1650656490847,MATH 20C,A01,083760,Staff,0,16,30,30
1650656490847,MATH 20C,A02,083761,Staff,1,14,30,29
1650656490847,MATH 20C,B01,083762,Staff,11,0,30,19
1650656490847,MATH 20C,B02,083763,Staff,28,0,30,2
1650656496876,MATH 20D,A01,083765,Staff,1,1,30,29
1650656496876,MATH 20D,A02,083766,Staff,6,0,30,24
1650656496876,MATH 20D,A03,083767,Staff,24,0,30,6
1650656502906,MATH 20E,A01,083771,Staff,3,0,30,27
1650656502906,MATH 20E,A02,083772,Staff,16,0,30,14
1650656502906,MATH 20E,B01,083773,Staff,0,0,30,30
1650656502906,MATH 20E,B02,083774,Staff,9,0,30,21
1650656508943,MATH 103A,A01,083777,Staff,0,15,30,30
1650656508943,MATH 103A,A02,083778,Staff,0,15,30,30
1650656508943,MATH 103A,B01,083779,Staff,0,14,30,30
1650656508943,MATH 103A,B02,083780,Staff,0,14,30,30
1650656514966,MATH 105,A01,085443,Staff,0,22,30,30
1650656520991,MATH 109,A01,083213,Anzaldo; Leesa B,0,7,30,30
1650656520991,MATH 109,A02,083214,Anzaldo; Leesa B,0,7,30,30
1650656520991,MATH 109,B01,083215,Anzaldo; Leesa B,0,6,30,30
1650656520991,MATH 109,B02,083216,Anzaldo; Leesa B,0,6,30,30
1650656527016,MATH 142A,A01,083219,Chow; Bennett,0,16,30,30
1650656527016,MATH 142A,A02,083220,Chow; Bennett,0,15,30,30
1650656527016,MATH 142A,B01,083221,Chow; Bennett,0,14,30,30
1650656527016,MATH 142A,B02,083222,Chow; Bennett,0,13,30,30
1650656533039,MATH 193A,A01,083224,Staff,0,5,30,30
1650656533039,MATH 193A,A02,083225,Staff,0,6,30,30
1650656533039,MATH 193A,A03,083781,Staff,0,6,30,30
1650656533039,MATH 193A,A04,083782,Staff,0,7,30,30
1650656539071,MATH 197,001,091859,McAuley; Julian John,9998,0,9999,1
1650656545123,COGS 9,A01,083615,Staff,1,16,60,59
1650656551145,COGS 11,A01,083617,Boyle; Mary E. T.,18,0,40,22
1650656557169,COGS 13,A01,083071,Staff,0,39,40,40
1650656563202,COGS 14A,A01,092681,Staff,0,32,100,100
1650656569225,COGS 14B,A01,083073,Cheng; Tzu-Han,0,14,50,50
1650656575254,COGS 17,A01,092677,Staff,17,0,75,58
1650656581294,COGS 100,A01,083619,Staff,0,28,60,60
1650656587319,COGS 101A,A01,083621,Davis; Joshua Daniel,0,27,60,60
1650656593348,COGS 101B,A01,091572,Staff,0,4,60,60
1650656599380,COGS 101C,A01,083625,Delgado; Tania,15,0,30,15
1650656605429,COGS 107A,A01,083627,Boyle; Mary E. T.,1,17,60,59
1650656611454,COGS 118A,A01,083075,Staff,0,7,60,60
1650656617486,CSE 3,A50,083646,Miranda; Gregory Joseph,19,0,38,19
1650656617486,CSE 3,A51,083647,Miranda; Gregory Joseph,36,0,37,1
1650656623514,CSE 8A,A50,083650,Miranda; Gregory Joseph,0,30,40,40
1650656629541,CSE 11,A01,083080,Cao; Yingjun,0,95,40,40
1650656635567,CSE 12,A01,083652,Staff,0,19,100,100
1650656641596,CSE 15L,A01,083654,Staff,0,2,50,50
1650656641596,CSE 15L,A02,083655,Staff,0,1,50,50
1650656647620,CSE 20,A01,083657,Staff,51,0,80,29
1650656653648,CSE 30,A01,083084,Eldon; John,0,77,40,40
1650656659675,CSE 100,A01,083659,Cao; Yingjun,0,69,50,50
1650656665717,CSE 134B,A01,083661,Powell; Thomas Allan,0,37,65,65
1650656671749,CSE 140,A01,083663,Staff,0,8,75,75
1650656677773,CSE 140L,A01,083088,Eldon; John,0,16,75,75
1650656683797,CSE 175,A01,083665,Kumar; Rakesh,7,0,25,18
1650656689820,CSE 190,A00,092507,Dubnov; Shlomo,10,0,20,10
1650656695844,ECE 45,A01,083139,Staff,0,2,60,60
1650656701867,ECE 65,A50,083695,Staff,0,5,30,30
1650656707893,ECE 109,A01,091882,Touri; Behrouz,33,0,70,37
1650656713922,ECE 180,A00,083140,Abi Samra; Nicholas Camill,21,0,30,9
1650656713922,ECE 180,B00,083141,Abi Samra; Nicholas Camill,0,0,30,30
1650656719953,MATH 10A,A01,083735,Patchell; Gregory David,3,0,30,27
1650656719953,MATH 10A,A02,083736,Patchell; Gregory David,27,0,30,3
1650656719953,MATH 10A,A03,083737,Patchell; Gregory David,24,0,30,6
1650656726051,MATH 10B,A01,083207,Staff,0,8,30,30
1650656726051,MATH 10B,A02,083208,Staff,0,8,30,30
1650656726051,MATH 10B,B01,083739,Staff,11,0,30,19
1650656726051,MATH 10B,B02,083740,Staff,28,0,30,2
1650656732086,MATH 18,A01,083743,Staff,0,0,30,30
1650656732086,MATH 18,A02,083744,Staff,23,0,30,7
1650656732086,MATH 18,A03,083745,Staff,21,0,30,9
1650656732086,MATH 18,A04,083746,Staff,26,0,30,4
1650656732086,MATH 18,B01,083748,Staff,0,15,30,30
1650656732086,MATH 18,B02,083749,Staff,0,12,30,30
1650656732086,MATH 18,B03,083750,Staff,0,12,30,30
1650656732086,MATH 18,B04,083751,Staff,0,12,30,30
1650656738111,MATH 20A,A01,083754,Staff,19,0,40,21
1650656744142,MATH 20B,A01,083756,Staff,0,11,30,30
1650656744142,MATH 20B,A02,083757,Staff,0,12,30,30
1650656750166,MATH 20C,A01,083760,Staff,0,16,30,30
1650656750166,MATH 20C,A02,083761,Staff,1,14,30,29
1650656750166,MATH 20C,B01,083762,Staff,11,0,30,19
1650656750166,MATH 20C,B02,083763,Staff,28,0,30,2
1650656756191,MATH 20D,A01,083765,Staff,1,1,30,29
1650656756191,MATH 20D,A02,083766,Staff,6,0,30,24
1650656756191,MATH 20D,A03,083767,Staff,24,0,30,6
1650656762215,MATH 20E,A01,083771,Staff,3,0,30,27
1650656762215,MATH 20E,A02,083772,Staff,16,0,30,14
1650656762215,MATH 20E,B01,083773,Staff,0,0,30,30
1650656762215,MATH 20E,B02,083774,Staff,9,0,30,21
1650656768238,MATH 103A,A01,083777,Staff,0,15,30,30
1650656768238,MATH 103A,A02,083778,Staff,0,15,30,30
1650656768238,MATH 103A,B01,083779,Staff,0,14,30,30
1650656768238,MATH 103A,B02,083780,Staff,0,14,30,30
1650656774264,MATH 105,A01,085443,Staff,0,22,30,30
1650656780294,MATH 109,A01,083213,Anzaldo; Leesa B,0,7,30,30
1650656780294,MATH 109,A02,083214,Anzaldo; Leesa B,0,7,30,30
1650656780294,MATH 109,B01,083215,Anzaldo; Leesa B,0,6,30,30
1650656780294,MATH 109,B02,083216,Anzaldo; Leesa B,0,6,30,30
1650656786327,MATH 142A,A01,083219,Chow; Bennett,0,16,30,30
1650656786327,MATH 142A,A02,083220,Chow; Bennett,0,15,30,30
1650656786327,MATH 142A,B01,083221,Chow; Bennett,0,14,30,30
1650656786327,MATH 142A,B02,083222,Chow; Bennett,0,13,30,30
1650656792348,MATH 193A,A01,083224,Staff,0,5,30,30
1650656792348,MATH 193A,A02,083225,Staff,0,6,30,30
1650656792348,MATH 193A,A03,083781,Staff,0,6,30,30
1650656792348,MATH 193A,A04,083782,Staff,0,7,30,30
1650656798378,MATH 197,001,091859,McAuley; Julian John,9998,0,9999,1
1650656804435,COGS 9,A01,083615,Staff,1,16,60,59
1650656810459,COGS 11,A01,083617,Boyle; Mary E. T.,18,0,40,22
1650656816502,COGS 13,A01,083071,Staff,0,39,40,40
1650656822534,COGS 14A,A01,092681,Staff,0,32,100,100
1650656828557,COGS 14B,A01,083073,Cheng; Tzu-Han,0,14,50,50
1650656834583,COGS 17,A01,092677,Staff,17,0,75,58
1650656840611,COGS 100,A01,083619,Staff,0,28,60,60
1650656846635,COGS 101A,A01,083621,Davis; Joshua Daniel,0,27,60,60
1650656852660,COGS 101B,A01,091572,Staff,0,4,60,60
1650656858687,COGS 101C,A01,083625,Delgado; Tania,15,0,30,15
1650656864712,COGS 107A,A01,083627,Boyle; Mary E. T.,1,17,60,59
1650656870735,COGS 118A,A01,083075,Staff,0,7,60,60
1650656876766,CSE 3,A50,083646,Miranda; Gregory Joseph,19,0,38,19
1650656876766,CSE 3,A51,083647,Miranda; Gregory Joseph,36,0,37,1
1650656882796,CSE 8A,A50,083650,Miranda; Gregory Joseph,0,30,40,40
1650656888825,CSE 11,A01,083080,Cao; Yingjun,0,95,40,40
1650656894850,CSE 12,A01,083652,Staff,0,19,100,100
1650656900876,CSE 15L,A01,083654,Staff,0,2,50,50
1650656900876,CSE 15L,A02,083655,Staff,0,1,50,50
1650656906914,CSE 20,A01,083657,Staff,51,0,80,29
1650656912941,CSE 30,A01,083084,Eldon; John,0,77,40,40
1650656918965,CSE 100,A01,083659,Cao; Yingjun,0,69,50,50
1650656924995,CSE 134B,A01,083661,Powell; Thomas Allan,0,37,65,65
1650656931029,CSE 140,A01,083663,Staff,0,8,75,75
1650656937053,CSE 140L,A01,083088,Eldon; John,0,16,75,75
1650656943077,CSE 175,A01,083665,Kumar; Rakesh,7,0,25,18
1650656949110,CSE 190,A00,092507,Dubnov; Shlomo,10,0,20,10
1650656955135,ECE 45,A01,083139,Staff,0,2,60,60
1650656961171,ECE 65,A50,083695,Staff,0,5,30,30
1650656967201,ECE 109,A01,091882,Touri; Behrouz,33,0,70,37
1650656973231,ECE 180,A00,083140,Abi Samra; Nicholas Camill,21,0,30,9
1650656973231,ECE 180,B00,083141,Abi Samra; Nicholas Camill,0,0,30,30
1650656979255,MATH 10A,A01,083735,Patchell; Gregory David,3,0,30,27
1650656979255,MATH 10A,A02,083736,Patchell; Gregory David,27,0,30,3
1650656979255,MATH 10A,A03,083737,Patchell; Gregory David,24,0,30,6
1650656985278,MATH 10B,A01,083207,Staff,0,8,30,30
1650656985278,MATH 10B,A02,083208,Staff,0,8,30,30
1650656985278,MATH 10B,B01,083739,Staff,11,0,30,19
1650656985278,MATH 10B,B02,083740,Staff,28,0,30,2
1650656991308,MATH 18,A01,083743,Staff,0,0,30,30
1650656991308,MATH 18,A02,083744,Staff,23,0,30,7
1650656991308,MATH 18,A03,083745,Staff,21,0,30,9
1650656991308,MATH 18,A04,083746,Staff,26,0,30,4
1650656991308,MATH 18,B01,083748,Staff,0,15,30,30
1650656991308,MATH 18,B02,083749,Staff,0,12,30,30
1650656991308,MATH 18,B03,083750,Staff,0,12,30,30
1650656991308,MATH 18,B04,083751,Staff,0,12,30,30
1650656997331,MATH 20A,A01,083754,Staff,19,0,40,21
1650657003360,MATH 20B,A01,083756,Staff,0,11,30,30
1650657003360,MATH 20B,A02,083757,Staff,0,12,30,30
1650657009392,MATH 20C,A01,083760,Staff,0,16,30,30
1650657009392,MATH 20C,A02,083761,Staff,1,14,30,29
1650657009392,MATH 20C,B01,083762,Staff,11,0,30,19
1650657009392,MATH 20C,B02,083763,Staff,28,0,30,2
1650657015423,MATH 20D,A01,083765,Staff,1,1,30,29
1650657015423,MATH 20D,A02,083766,Staff,6,0,30,24
1650657015423,MATH 20D,A03,083767,Staff,24,0,30,6
1650657021447,MATH 20E,A01,083771,Staff,3,0,30,27
1650657021447,MATH 20E,A02,083772,Staff,16,0,30,14
1650657021447,MATH 20E,B01,083773,Staff,0,0,30,30
1650657021447,MATH 20E,B02,083774,Staff,9,0,30,21
1650657027470,MATH 103A,A01,083777,Staff,0,15,30,30
1650657027470,MATH 103A,A02,083778,Staff,0,15,30,30
1650657027470,MATH 103A,B01,083779,Staff,0,14,30,30
1650657027470,MATH 103A,B02,083780,Staff,0,14,30,30
1650657033494,MATH 105,A01,085443,Staff,0,22,30,30
1650657039520,MATH 109,A01,083213,Anzaldo; Leesa B,0,7,30,30
1650657039520,MATH 109,A02,083214,Anzaldo; Leesa B,0,7,30,30
1650657039520,MATH 109,B01,083215,Anzaldo; Leesa B,0,6,30,30
1650657039520,MATH 109,B02,083216,Anzaldo; Leesa B,0,6,30,30
1650657045544,MATH 142A,A01,083219,Chow; Bennett,0,16,30,30
1650657045544,MATH 142A,A02,083220,Chow; Bennett,0,15,30,30
1650657045544,MATH 142A,B01,083221,Chow; Bennett,0,14,30,30
1650657045544,MATH 142A,B02,083222,Chow; Bennett,0,13,30,30
1650657051566,MATH 193A,A01,083224,Staff,0,5,30,30
1650657051566,MATH 193A,A02,083225,Staff,0,6,30,30
1650657051566,MATH 193A,A03,083781,Staff,0,6,30,30
1650657051566,MATH 193A,A04,083782,Staff,0,7,30,30
1650657057590,MATH 197,001,091859,McAuley; Julian John,9998,0,9999,1
1650657063648,COGS 9,A01,083615,Staff,1,16,60,59
1650657069680,COGS 11,A01,083617,Boyle; Mary E. T.,18,0,40,22
1650657075706,COGS 13,A01,083071,Staff,0,39,40,40
1650657081730,COGS 14A,A01,092681,Staff,0,32,100,100
1650657087766,COGS 14B,A01,083073,Cheng; Tzu-Han,0,14,50,50
1650657093796,COGS 17,A01,092677,Staff,17,0,75,58
1650657099826,COGS 100,A01,083619,Staff,0,28,60,60
1650657105853,COGS 101A,A01,083621,Davis; Joshua Daniel,0,27,60,60
1650657111882,COGS 101B,A01,091572,Staff,0,4,60,60
1650657117908,COGS 101C,A01,083625,Delgado; Tania,15,0,30,15
1650657123939,COGS 107A,A01,083627,Boyle; Mary E. T.,1,17,60,59
1650657129966,COGS 118A,A01,083075,Staff,0,7,60,60
1650657135992,CSE 3,A50,083646,Miranda; Gregory Joseph,19,0,38,19
1650657135992,CSE 3,A51,083647,Miranda; Gregory Joseph,36,0,37,1
1650657142016,CSE 8A,A50,083650,Miranda; Gregory Joseph,0,30,40,40
1650657148054,CSE 11,A01,083080,Cao; Yingjun,0,95,40,40
1650657154079,CSE 12,A01,083652,Staff,0,19,100,100
1650657160103,CSE 15L,A01,083654,Staff,0,2,50,50
1650657160103,CSE 15L,A02,083655,Staff,0,1,50,50
1650657166126,CSE 20,A01,083657,Staff,51,0,80,29
1650657172149,CSE 30,A01,083084,Eldon; John,0,77,40,40
1650657178173,CSE 100,A01,083659,Cao; Yingjun,0,69,50,50
1650657184198,CSE 134B,A01,083661,Powell; Thomas Allan,0,37,65,65
1650657190221,CSE 140,A01,083663,Staff,0,8,75,75
1650657196248,CSE 140L,A01,083088,Eldon; John,0,16,75,75
1650657202274,CSE 175,A01,083665,Kumar; Rakesh,7,0,25,18
1650657208297,CSE 190,A00,092507,Dubnov; Shlomo,10,0,20,10
1650657214320,ECE 45,A01,083139,Staff,0,2,60,60
1650657220345,ECE 65,A50,083695,Staff,0,5,30,30
1650657226368,ECE 109,A01,091882,Touri; Behrouz,33,0,70,37
1650657232404,ECE 180,A00,083140,Abi Samra; Nicholas Camill,21,0,30,9
1650657232404,ECE 180,B00,083141,Abi Samra; Nicholas Camill,0,0,30,30
1650657238442,MATH 10A,A01,083735,Patchell; Gregory David,3,0,30,27
1650657238442,MATH 10A,A02,083736,Patchell; Gregory David,27,0,30,3
1650657238442,MATH 10A,A03,083737,Patchell; Gregory David,24,0,30,6
1650657244479,MATH 10B,A01,083207,Staff,0,8,30,30
1650657244479,MATH 10B,A02,083208,Staff,0,8,30,30
1650657244479,MATH 10B,B01,083739,Staff,11,0,30,19
1650657244479,MATH 10B,B02,083740,Staff,28,0,30,2
1650657250511,MATH 18,A01,083743,Staff,0,0,30,30
1650657250511,MATH 18,A02,083744,Staff,23,0,30,7
1650657250511,MATH 18,A03,083745,Staff,21,0,30,9
1650657250511,MATH 18,A04,083746,Staff,26,0,30,4
1650657250511,MATH 18,B01,083748,Staff,0,15,30,30
1650657250511,MATH 18,B02,083749,Staff,0,12,30,30
1650657250511,MATH 18,B03,083750,Staff,0,12,30,30
1650657250511,MATH 18,B04,083751,Staff,0,12,30,30
1650657256545,MATH 20A,A01,083754,Staff,19,0,40,21
1650657262571,MATH 20B,A01,083756,Staff,0,11,30,30
1650657262571,MATH 20B,A02,083757,Staff,0,12,30,30
1650657268594,MATH 20C,A01,083760,Staff,0,16,30,30
1650657268594,MATH 20C,A02,083761,Staff,1,14,30,29
1650657268594,MATH 20C,B01,083762,Staff,11,0,30,19
1650657268594,MATH 20C,B02,083763,Staff,28,0,30,2
1650657274621,MATH 20D,A01,083765,Staff,1,1,30,29
1650657274621,MATH 20D,A02,083766,Staff,6,0,30,24
1650657274621,MATH 20D,A03,083767,Staff,24,0,30,6
1650657280650,MATH 20E,A01,083771,Staff,3,0,30,27
1650657280650,MATH 20E,A02,083772,Staff,16,0,30,14
1650657280650,MATH 20E,B01,083773,Staff,0,0,30,30
1650657280650,MATH 20E,B02,083774,Staff,9,0,30,21
1650657286681,MATH 103A,A01,083777,Staff,0,15,30,30
1650657286681,MATH 103A,A02,083778,Staff,0,15,30,30
1650657286681,MATH 103A,B01,083779,Staff,0,14,30,30
1650657286681,MATH 103A,B02,083780,Staff,0,14,30,30
1650657292713,MATH 105,A01,085443,Staff,0,22,30,30
1650657298742,MATH 109,A01,083213,Anzaldo; Leesa B,0,7,30,30
1650657298742,MATH 109,A02,083214,Anzaldo; Leesa B,0,7,30,30
1650657298742,MATH 109,B01,083215,Anzaldo; Leesa B,0,6,30,30
1650657298742,MATH 109,B02,083216,Anzaldo; Leesa B,0,6,30,30
1650657304782,MATH 142A,A01,083219,Chow; Bennett,0,16,30,30
1650657304782,MATH 142A,A02,083220,Chow; Bennett,0,15,30,30
1650657304782,MATH 142A,B01,083221,Chow; Bennett,0,14,30,30
1650657304782,MATH 142A,B02,083222,Chow; Bennett,0,13,30,30
1650657310818,MATH 193A,A01,083224,Staff,0,5,30,30
1650657310818,MATH 193A,A02,083225,Staff,0,6,30,30
1650657310818,MATH 193A,A03,083781,Staff,0,6,30,30
1650657310818,MATH 193A,A04,083782,Staff,0,7,30,30
1650657316842,MATH 197,001,091859,McAuley; Julian John,9998,0,9999,1
1650657323003,COGS 9,A01,083615,Staff,1,16,60,59
1650657329026,COGS 11,A01,083617,Boyle; Mary E. T.,18,0,40,22
1650657335049,COGS 13,A01,083071,Staff,0,39,40,40
1650657341072,COGS 14A,A01,092681,Staff,0,32,100,100
1650657347099,COGS 14B,A01,083073,Cheng; Tzu-Han,0,14,50,50
1650657353122,COGS 17,A01,092677,Staff,17,0,75,58
1650657359149,COGS 100,A01,083619,Staff,0,28,60,60
1650657365173,COGS 101A,A01,083621,Davis; Joshua Daniel,0,27,60,60
1650657371210,COGS 101B,A01,091572,Staff,0,4,60,60
1650657377233,COGS 101C,A01,083625,Delgado; Tania,15,0,30,15
1650657383256,COGS 107A,A01,083627,Boyle; Mary E. T.,1,17,60,59
1650657389280,COGS 118A,A01,083075,Staff,0,7,60,60
1650657395304,CSE 3,A50,083646,Miranda; Gregory Joseph,19,0,38,19
1650657395304,CSE 3,A51,083647,Miranda; Gregory Joseph,36,0,37,1
1650657401330,CSE 8A,A50,083650,Miranda; Gregory Joseph,0,30,40,40
1650657407357,CSE 11,A01,083080,Cao; Yingjun,0,95,40,40
1650657413396,CSE 12,A01,083652,Staff,0,19,100,100
1650657419429,CSE 15L,A01,083654,Staff,0,2,50,50
1650657419429,CSE 15L,A02,083655,Staff,0,1,50,50
1650657425456,CSE 20,A01,083657,Staff,51,0,80,29
1650657431483,CSE 30,A01,083084,Eldon; John,0,78,40,40
1650657437510,CSE 100,A01,083659,Cao; Yingjun,0,68,50,50
1650657443536,CSE 134B,A01,083661,Powell; Thomas Allan,0,37,65,65
1650657449562,CSE 140,A01,083663,Staff,0,8,75,75
1650657455590,CSE 140L,A01,083088,Eldon; John,0,16,75,75
1650657461617,CSE 175,A01,083665,Kumar; Rakesh,7,0,25,18
1650657467642,CSE 190,A00,092507,Dubnov; Shlomo,10,0,20,10
1650657473669,ECE 45,A01,083139,Staff,0,2,60,60
1650657479702,ECE 65,A50,083695,Staff,0,5,30,30
1650657485729,ECE 109,A01,091882,Touri; Behrouz,33,0,70,37
1650657491752,ECE 180,A00,083140,Abi Samra; Nicholas Camill,21,0,30,9
1650657491752,ECE 180,B00,083141,Abi Samra; Nicholas Camill,0,0,30,30
1650657497780,MATH 10A,A01,083735,Patchell; Gregory David,3,0,30,27
1650657497780,MATH 10A,A02,083736,Patchell; Gregory David,27,0,30,3
1650657497780,MATH 10A,A03,083737,Patchell; Gregory David,24,0,30,6
1650657503814,MATH 10B,A01,083207,Staff,0,8,30,30
1650657503814,MATH 10B,A02,083208,Staff,0,8,30,30
1650657503814,MATH 10B,B01,083739,Staff,11,0,30,19
1650657503814,MATH 10B,B02,083740,Staff,28,0,30,2
1650657509842,MATH 18,A01,083743,Staff,0,0,30,30
1650657509842,MATH 18,A02,083744,Staff,23,0,30,7
1650657509842,MATH 18,A03,083745,Staff,21,0,30,9
1650657509842,MATH 18,A04,083746,Staff,26,0,30,4
1650657509842,MATH 18,B01,083748,Staff,0,15,30,30
1650657509842,MATH 18,B02,083749,Staff,0,12,30,30
1650657509842,MATH 18,B03,083750,Staff,0,12,30,30
1650657509842,MATH 18,B04,083751,Staff,0,12,30,30
1650657515865,MATH 20A,A01,083754,Staff,19,0,40,21
1650657521889,MATH 20B,A01,083756,Staff,0,11,30,30
1650657521889,MATH 20B,A02,083757,Staff,0,12,30,30
1650657527915,MATH 20C,A01,083760,Staff,0,16,30,30
1650657527915,MATH 20C,A02,083761,Staff,1,14,30,29
1650657527915,MATH 20C,B01,083762,Staff,11,0,30,19
1650657527915,MATH 20C,B02,083763,Staff,28,0,30,2
1650657533939,MATH 20D,A01,083765,Staff,1,1,30,29
1650657533939,MATH 20D,A02,083766,Staff,6,0,30,24
1650657533939,MATH 20D,A03,083767,Staff,24,0,30,6
1650657539974,MATH 20E,A01,083771,Staff,3,0,30,27
1650657539974,MATH 20E,A02,083772,Staff,16,0,30,14
1650657539974,MATH 20E,B01,083773,Staff,0,0,30,30
1650657539974,MATH 20E,B02,083774,Staff,9,0,30,21
1650657546017,MATH 103A,A01,083777,Staff,0,15,30,30
1650657546017,MATH 103A,A02,083778,Staff,0,15,30,30
1650657546017,MATH 103A,B01,083779,Staff,0,14,30,30
1650657546017,MATH 103A,B02,083780,Staff,0,14,30,30
1650657552046,MATH 105,A01,085443,Staff,0,22,30,30
1650657558071,MATH 109,A01,083213,Anzaldo; Leesa B,0,7,30,30
1650657558071,MATH 109,A02,083214,Anzaldo; Leesa B,0,7,30,30
1650657558071,MATH 109,B01,083215,Anzaldo; Leesa B,0,6,30,30
1650657558071,MATH 109,B02,083216,Anzaldo; Leesa B,0,6,30,30
1650657564094,MATH 142A,A01,083219,Chow; Bennett,0,16,30,30
1650657564094,MATH 142A,A02,083220,Chow; Bennett,0,15,30,30
1650657564094,MATH 142A,B01,083221,Chow; Bennett,0,14,30,30
1650657564094,MATH 142A,B02,083222,Chow; Bennett,0,13,30,30
1650657570117,MATH 193A,A01,083224,Staff,0,5,30,30
1650657570117,MATH 193A,A02,083225,Staff,0,6,30,30
1650657570117,MATH 193A,A03,083781,Staff,0,6,30,30
1650657570117,MATH 193A,A04,083782,Staff,0,7,30,30
1650657576142,MATH 197,001,091859,McAuley; Julian John,9998,0,9999,1
1650657582202,COGS 9,A01,083615,Staff,1,16,60,59
1650657588230,COGS 11,A01,083617,Boyle; Mary E. T.,18,0,40,22
1650657594256,COGS 13,A01,083071,Staff,0,39,40,40
1650657600283,COGS 14A,A01,092681,Staff,0,32,100,100
1650657606308,COGS 14B,A01,083073,Cheng; Tzu-Han,0,14,50,50
1650657612332,COGS 17,A01,092677,Staff,17,0,75,58
1650657618358,COGS 100,A01,083619,Staff,0,28,60,60
1650657624384,COGS 101A,A01,083621,Davis; Joshua Daniel,0,27,60,60
1650657630410,COGS 101B,A01,091572,Staff,0,4,60,60
1650657636444,COGS 101C,A01,083625,Delgado; Tania,15,0,30,15
1650657642471,COGS 107A,A01,083627,Boyle; Mary E. T.,1,17,60,59
1650657648495,COGS 118A,A01,083075,Staff,0,7,60,60
1650657654519,CSE 3,A50,083646,Miranda; Gregory Joseph,19,0,38,19
1650657654519,CSE 3,A51,083647,Miranda; Gregory Joseph,36,0,37,1
1650657660543,CSE 8A,A50,083650,Miranda; Gregory Joseph,0,30,40,40
1650657666566,CSE 11,A01,083080,Cao; Yingjun,0,95,40,40
1650657672590,CSE 12,A01,083652,Staff,0,19,100,100
1650657678613,CSE 15L,A01,083654,Staff,0,2,50,50
1650657678613,CSE 15L,A02,083655,Staff,0,1,50,50
1650657684642,CSE 20,A01,083657,Staff,51,0,80,29
1650657690668,CSE 30,A01,083084,Eldon; John,0,78,40,40
1650657696696,CSE 100,A01,083659,Cao; Yingjun,0,68,50,50
1650657702725,CSE 134B,A01,083661,Powell; Thomas Allan,0,37,65,65
1650657708755,CSE 140,A01,083663,Staff,0,8,75,75
1650657714780,CSE 140L,A01,083088,Eldon; John,0,16,75,75
1650657720809,CSE 175,A01,083665,Kumar; Rakesh,7,0,25,18
1650657726833,CSE 190,A00,092507,Dubnov; Shlomo,10,0,20,10
1650657732856,ECE 45,A01,083139,Staff,0,2,60,60
1650657738884,ECE 65,A50,083695,Staff,0,5,30,30
1650657744914,ECE 109,A01,091882,Touri; Behrouz,33,0,70,37
1650657750937,ECE 180,A00,083140,Abi Samra; Nicholas Camill,21,0,30,9
1650657750937,ECE 180,B00,083141,Abi Samra; Nicholas Camill,0,0,30,30
1650657756965,MATH 10A,A01,083735,Patchell; Gregory David,3,0,30,27
1650657756965,MATH 10A,A02,083736,Patchell; Gregory David,27,0,30,3
1650657756965,MATH 10A,A03,083737,Patchell; Gregory David,24,0,30,6
1650657762988,MATH 10B,A01,083207,Staff,0,8,30,30
1650657762988,MATH 10B,A02,083208,Staff,0,8,30,30
1650657762988,MATH 10B,B01,083739,Staff,11,0,30,19
1650657762988,MATH 10B,B02,083740,Staff,28,0,30,2
1650657769024,MATH 18,A01,083743,Staff,0,0,30,30
1650657769024,MATH 18,A02,083744,Staff,23,0,30,7
1650657769024,MATH 18,A03,083745,Staff,21,0,30,9
1650657769024,MATH 18,A04,083746,Staff,26,0,30,4
1650657769024,MATH 18,B01,083748,Staff,0,15,30,30
1650657769024,MATH 18,B02,083749,Staff,0,12,30,30
1650657769024,MATH 18,B03,083750,Staff,0,12,30,30
1650657769024,MATH 18,B04,083751,Staff,0,12,30,30
1650657775051,MATH 20A,A01,083754,Staff,19,0,40,21
1650657781080,MATH 20B,A01,083756,Staff,0,11,30,30
1650657781080,MATH 20B,A02,083757,Staff,0,12,30,30
1650657787110,MATH 20C,A01,083760,Staff,0,16,30,30
1650657787110,MATH 20C,A02,083761,Staff,1,14,30,29
1650657787110,MATH 20C,B01,083762,Staff,11,0,30,19
1650657787110,MATH 20C,B02,083763,Staff,28,0,30,2
1650657793133,MATH 20D,A01,083765,Staff,1,1,30,29
1650657793133,MATH 20D,A02,083766,Staff,6,0,30,24
1650657793133,MATH 20D,A03,083767,Staff,24,0,30,6
1650657799167,MATH 20E,A01,083771,Staff,3,0,30,27
1650657799167,MATH 20E,A02,083772,Staff,16,0,30,14
1650657799167,MATH 20E,B01,083773,Staff,0,0,30,30
1650657799167,MATH 20E,B02,083774,Staff,9,0,30,21
1650657805193,MATH 103A,A01,083777,Staff,0,15,30,30
1650657805193,MATH 103A,A02,083778,Staff,0,15,30,30
1650657805193,MATH 103A,B01,083779,Staff,0,14,30,30
1650657805193,MATH 103A,B02,083780,Staff,0,14,30,30
1650657811223,MATH 105,A01,085443,Staff,0,22,30,30
1650657817246,MATH 109,A01,083213,Anzaldo; Leesa B,0,7,30,30
1650657817246,MATH 109,A02,083214,Anzaldo; Leesa B,0,7,30,30
1650657817246,MATH 109,B01,083215,Anzaldo; Leesa B,0,6,30,30
1650657817246,MATH 109,B02,083216,Anzaldo; Leesa B,0,6,30,30
1650657823271,MATH 142A,A01,083219,Chow; Bennett,0,16,30,30
1650657823271,MATH 142A,A02,083220,Chow; Bennett,0,15,30,30
1650657823271,MATH 142A,B01,083221,Chow; Bennett,0,14,30,30
1650657823271,MATH 142A,B02,083222,Chow; Bennett,0,13,30,30
1650657829300,MATH 193A,A01,083224,Staff,0,5,30,30
1650657829300,MATH 193A,A02,083225,Staff,0,6,30,30
1650657829300,MATH 193A,A03,083781,Staff,0,6,30,30
1650657829300,MATH 193A,A04,083782,Staff,0,7,30,30
1650657835325,MATH 197,001,091859,McAuley; Julian John,9998,0,9999,1
1650657841390,COGS 9,A01,083615,Staff,1,16,60,59
1650657847428,COGS 11,A01,083617,Boyle; Mary E. T.,18,0,40,22
1650657853452,COGS 13,A01,083071,Staff,0,39,40,40
1650657859479,COGS 14A,A01,092681,Staff,0,32,100,100
1650657865502,COGS 14B,A01,083073,Cheng; Tzu-Han,0,14,50,50
1650657871525,COGS 17,A01,092677,Staff,17,0,75,58
1650657877556,COGS 100,A01,083619,Staff,0,28,60,60
1650657883579,COGS 101A,A01,083621,Davis; Joshua Daniel,0,27,60,60
1650657889611,COGS 101B,A01,091572,Staff,0,4,60,60
1650657895635,COGS 101C,A01,083625,Delgado; Tania,15,0,30,15
1650657901659,COGS 107A,A01,083627,Boyle; Mary E. T.,1,17,60,59
1650657907691,COGS 118A,A01,083075,Staff,0,7,60,60
1650657913804,CSE 3,A50,083646,Miranda; Gregory Joseph,19,0,38,19
1650657913804,CSE 3,A51,083647,Miranda; Gregory Joseph,36,0,37,1
1650657919832,CSE 8A,A50,083650,Miranda; Gregory Joseph,0,30,40,40
1650657925855,CSE 11,A01,083080,Cao; Yingjun,0,95,40,40
1650657931880,CSE 12,A01,083652,Staff,0,19,100,100
1650657937908,CSE 15L,A01,083654,Staff,0,2,50,50
1650657937908,CSE 15L,A02,083655,Staff,0,1,50,50
1650657943941,CSE 20,A01,083657,Staff,51,0,80,29
1650657949982,CSE 30,A01,083084,Eldon; John,0,78,40,40
1650657956024,CSE 100,A01,083659,Cao; Yingjun,0,68,50,50
1650657962047,CSE 134B,A01,083661,Powell; Thomas Allan,0,37,65,65
1650657968070,CSE 140,A01,083663,Staff,0,8,75,75
1650657974099,CSE 140L,A01,083088,Eldon; John,0,16,75,75
1650657980126,CSE 175,A01,083665,Kumar; Rakesh,7,0,25,18
1650657986155,CSE 190,A00,092507,Dubnov; Shlomo,10,0,20,10
1650657992194,ECE 45,A01,083139,Staff,0,2,60,60
1650657998223,ECE 65,A50,083695,Staff,0,5,30,30
1650658004250,ECE 109,A01,091882,Touri; Behrouz,33,0,70,37
1650658010271,ECE 180,A00,083140,Abi Samra; Nicholas Camill,21,0,30,9
1650658010271,ECE 180,B00,083141,Abi Samra; Nicholas Camill,0,0,30,30
1650658016308,MATH 10A,A01,083735,Patchell; Gregory David,3,0,30,27
1650658016308,MATH 10A,A02,083736,Patchell; Gregory David,27,0,30,3
1650658016308,MATH 10A,A03,083737,Patchell; Gregory David,24,0,30,6
1650658022332,MATH 10B,A01,083207,Staff,0,8,30,30
1650658022332,MATH 10B,A02,083208,Staff,0,8,30,30
1650658022332,MATH 10B,B01,083739,Staff,11,0,30,19
1650658022332,MATH 10B,B02,083740,Staff,28,0,30,2
1650658028356,MATH 18,A01,083743,Staff,0,0,30,30
1650658028356,MATH 18,A02,083744,Staff,23,0,30,7
1650658028356,MATH 18,A03,083745,Staff,21,0,30,9
1650658028356,MATH 18,A04,083746,Staff,26,0,30,4
1650658028356,MATH 18,B01,083748,Staff,0,15,30,30
1650658028356,MATH 18,B02,083749,Staff,0,12,30,30
1650658028356,MATH 18,B03,083750,Staff,0,12,30,30
1650658028356,MATH 18,B04,083751,Staff,0,12,30,30
1650658034389,MATH 20A,A01,083754,Staff,19,0,40,21
1650658040428,MATH 20B,A01,083756,Staff,0,11,30,30
1650658040428,MATH 20B,A02,083757,Staff,0,12,30,30
1650658046454,MATH 20C,A01,083760,Staff,0,16,30,30
1650658046454,MATH 20C,A02,083761,Staff,1,14,30,29
1650658046454,MATH 20C,B01,083762,Staff,11,0,30,19
1650658046454,MATH 20C,B02,083763,Staff,28,0,30,2
1650658052482,MATH 20D,A01,083765,Staff,1,1,30,29
1650658052482,MATH 20D,A02,083766,Staff,6,0,30,24
1650658052482,MATH 20D,A03,083767,Staff,24,0,30,6
1650658058506,MATH 20E,A01,083771,Staff,3,0,30,27
1650658058506,MATH 20E,A02,083772,Staff,16,0,30,14
1650658058506,MATH 20E,B01,083773,Staff,0,0,30,30
1650658058506,MATH 20E,B02,083774,Staff,9,0,30,21
1650658064535,MATH 103A,A01,083777,Staff,0,15,30,30
1650658064535,MATH 103A,A02,083778,Staff,0,15,30,30
1650658064535,MATH 103A,B01,083779,Staff,0,14,30,30
1650658064535,MATH 103A,B02,083780,Staff,0,14,30,30
1650658070570,MATH 105,A01,085443,Staff,0,22,30,30
1650658076599,MATH 109,A01,083213,Anzaldo; Leesa B,0,7,30,30
1650658076599,MATH 109,A02,083214,Anzaldo; Leesa B,0,7,30,30
1650658076599,MATH 109,B01,083215,Anzaldo; Leesa B,0,6,30,30
1650658076599,MATH 109,B02,083216,Anzaldo; Leesa B,0,6,30,30
1650658082627,MATH 142A,A01,083219,Chow; Bennett,0,16,30,30
1650658082627,MATH 142A,A02,083220,Chow; Bennett,0,15,30,30
1650658082627,MATH 142A,B01,083221,Chow; Bennett,0,14,30,30
1650658082627,MATH 142A,B02,083222,Chow; Bennett,0,13,30,30
1650658088650,MATH 193A,A01,083224,Staff,0,5,30,30
1650658088650,MATH 193A,A02,083225,Staff,0,6,30,30
1650658088650,MATH 193A,A03,083781,Staff,0,6,30,30
1650658088650,MATH 193A,A04,083782,Staff,0,7,30,30
1650658094676,MATH 197,001,091859,McAuley; Julian John,9998,0,9999,1
1650658100736,COGS 9,A01,083615,Staff,1,16,60,59
1650658106773,COGS 11,A01,083617,Boyle; Mary E. T.,18,0,40,22
1650658112808,COGS 13,A01,083071,Staff,0,39,40,40
1650658118833,COGS 14A,A01,092681,Staff,0,32,100,100
1650658124861,COGS 14B,A01,083073,Cheng; Tzu-Han,1,14,50,49
1650658130884,COGS 17,A01,092677,Staff,17,0,75,58
1650658136908,COGS 100,A01,083619,Staff,0,28,60,60
1650658142936,COGS 101A,A01,083621,Davis; Joshua Daniel,0,27,60,60
1650658148960,COGS 101B,A01,091572,Staff,0,4,60,60
1650658154983,COGS 101C,A01,083625,Delgado; Tania,15,0,30,15
1650658161023,COGS 107A,A01,083627,Boyle; Mary E. T.,1,17,60,59
1650658167050,COGS 118A,A01,083075,Staff,0,7,60,60
1650658173079,CSE 3,A50,083646,Miranda; Gregory Joseph,19,0,38,19
1650658173079,CSE 3,A51,083647,Miranda; Gregory Joseph,36,0,37,1
1650658179101,CSE 8A,A50,083650,Miranda; Gregory Joseph,0,30,40,40
1650658185134,CSE 11,A01,083080,Cao; Yingjun,0,95,40,40
1650658191157,CSE 12,A01,083652,Staff,0,19,100,100
1650658197181,CSE 15L,A01,083654,Staff,0,2,50,50
1650658197181,CSE 15L,A02,083655,Staff,0,1,50,50
1650658203206,CSE 20,A01,083657,Staff,51,0,80,29
1650658209231,CSE 30,A01,083084,Eldon; John,0,78,40,40
1650658215257,CSE 100,A01,083659,Cao; Yingjun,0,68,50,50
1650658221295,CSE 134B,A01,083661,Powell; Thomas Allan,0,37,65,65
1650658227317,CSE 140,A01,083663,Staff,0,8,75,75
1650658233342,CSE 140L,A01,083088,Eldon; John,0,16,75,75
1650658239367,CSE 175,A01,083665,Kumar; Rakesh,7,0,25,18
1650658245391,CSE 190,A00,092507,Dubnov; Shlomo,10,0,20,10
1650658251427,ECE 45,A01,083139,Staff,0,2,60,60
1650658257462,ECE 65,A50,083695,Staff,0,5,30,30
1650658263489,ECE 109,A01,091882,Touri; Behrouz,33,0,70,37
1650658269515,ECE 180,A00,083140,Abi Samra; Nicholas Camill,21,0,30,9
1650658269515,ECE 180,B00,083141,Abi Samra; Nicholas Camill,0,0,30,30
1650658275541,MATH 10A,A01,083735,Patchell; Gregory David,3,0,30,27
1650658275541,MATH 10A,A02,083736,Patchell; Gregory David,27,0,30,3
1650658275541,MATH 10A,A03,083737,Patchell; Gregory David,24,0,30,6
1650658281565,MATH 10B,A01,083207,Staff,0,9,30,30
1650658281565,MATH 10B,A02,083208,Staff,0,8,30,30
1650658281565,MATH 10B,B01,083739,Staff,11,0,30,19
1650658281565,MATH 10B,B02,083740,Staff,28,0,30,2
1650658287603,MATH 18,A01,083743,Staff,0,0,30,30
1650658287603,MATH 18,A02,083744,Staff,23,0,30,7
1650658287603,MATH 18,A03,083745,Staff,21,0,30,9
1650658287603,MATH 18,A04,083746,Staff,26,0,30,4
1650658287603,MATH 18,B01,083748,Staff,0,15,30,30
1650658287603,MATH 18,B02,083749,Staff,0,12,30,30
1650658287603,MATH 18,B03,083750,Staff,0,12,30,30
1650658287603,MATH 18,B04,083751,Staff,0,12,30,30
1650658293633,MATH 20A,A01,083754,Staff,19,0,40,21
1650658299661,MATH 20B,A01,083756,Staff,0,11,30,30
1650658299661,MATH 20B,A02,083757,Staff,0,12,30,30
1650658305684,MATH 20C,A01,083760,Staff,0,16,30,30
1650658305684,MATH 20C,A02,083761,Staff,1,14,30,29
1650658305684,MATH 20C,B01,083762,Staff,11,0,30,19
1650658305684,MATH 20C,B02,083763,Staff,28,0,30,2
1650658311711,MATH 20D,A01,083765,Staff,1,1,30,29
1650658311711,MATH 20D,A02,083766,Staff,6,0,30,24
1650658311711,MATH 20D,A03,083767,Staff,24,0,30,6
1650658317739,MATH 20E,A01,083771,Staff,3,0,30,27
1650658317739,MATH 20E,A02,083772,Staff,16,0,30,14
1650658317739,MATH 20E,B01,083773,Staff,0,0,30,30
1650658317739,MATH 20E,B02,083774,Staff,9,0,30,21
1650658323783,MATH 103A,A01,083777,Staff,0,15,30,30
1650658323783,MATH 103A,A02,083778,Staff,0,15,30,30
1650658323783,MATH 103A,B01,083779,Staff,0,14,30,30
1650658323783,MATH 103A,B02,083780,Staff,0,14,30,30
1650658329808,MATH 105,A01,085443,Staff,0,22,30,30
1650658335831,MATH 109,A01,083213,Anzaldo; Leesa B,0,7,30,30
1650658335831,MATH 109,A02,083214,Anzaldo; Leesa B,0,7,30,30
1650658335831,MATH 109,B01,083215,Anzaldo; Leesa B,0,7,30,30
1650658335831,MATH 109,B02,083216,Anzaldo; Leesa B,0,6,30,30
1650658341858,MATH 142A,A01,083219,Chow; Bennett,0,16,30,30
1650658341858,MATH 142A,A02,083220,Chow; Bennett,0,15,30,30
1650658341858,MATH 142A,B01,083221,Chow; Bennett,0,14,30,30
1650658341858,MATH 142A,B02,083222,Chow; Bennett,0,13,30,30
1650658347882,MATH 193A,A01,083224,Staff,0,5,30,30
1650658347882,MATH 193A,A02,083225,Staff,0,6,30,30
1650658347882,MATH 193A,A03,083781,Staff,0,6,30,30
1650658347882,MATH 193A,A04,083782,Staff,0,7,30,30
1650658353917,MATH 197,001,091859,McAuley; Julian John,9998,0,9999,1
1650658360013,COGS 9,A01,083615,Staff,1,16,60,59
1650658366041,COGS 11,A01,083617,Boyle; Mary E. T.,18,0,40,22
1650658372063,COGS 13,A01,083071,Staff,0,39,40,40
1650658378093,COGS 14A,A01,092681,Staff,0,32,100,100
1650658384126,COGS 14B,A01,083073,Cheng; Tzu-Han,1,14,50,49
1650658390149,COGS 17,A01,092677,Staff,17,0,75,58
1650658396197,COGS 100,A01,083619,Staff,0,28,60,60
1650658402220,COGS 101A,A01,083621,Davis; Joshua Daniel,0,27,60,60
1650658408247,COGS 101B,A01,091572,Staff,0,4,60,60
1650658414281,COGS 101C,A01,083625,Delgado; Tania,15,0,30,15
1650658420303,COGS 107A,A01,083627,Boyle; Mary E. T.,1,17,60,59
1650658426338,COGS 118A,A01,083075,Staff,0,7,60,60
1650658432362,CSE 3,A50,083646,Miranda; Gregory Joseph,19,0,38,19
1650658432362,CSE 3,A51,083647,Miranda; Gregory Joseph,36,0,37,1
1650658438391,CSE 8A,A50,083650,Miranda; Gregory Joseph,0,30,40,40
1650658444416,CSE 11,A01,083080,Cao; Yingjun,0,95,40,40
1650658450444,CSE 12,A01,083652,Staff,0,19,100,100
1650658456469,CSE 15L,A01,083654,Staff,0,2,50,50
1650658456469,CSE 15L,A02,083655,Staff,0,1,50,50
1650658462495,CSE 20,A01,083657,Staff,51,0,80,29
1650658468543,CSE 30,A01,083084,Eldon; John,0,78,40,40
1650658474575,CSE 100,A01,083659,Cao; Yingjun,0,68,50,50
1650658480604,CSE 134B,A01,083661,Powell; Thomas Allan,0,37,65,65
1650658486633,CSE 140,A01,083663,Staff,0,8,75,75
1650658492661,CSE 140L,A01,083088,Eldon; John,0,16,75,75
1650658498696,CSE 175,A01,083665,Kumar; Rakesh,7,0,25,18
1650658504720,CSE 190,A00,092507,Dubnov; Shlomo,10,0,20,10
1650658510851,ECE 45,A01,083139,Staff,0,2,60,60
1650658516881,ECE 65,A50,083695,Staff,0,5,30,30
1650658522905,ECE 109,A01,091882,Touri; Behrouz,33,0,70,37
1650658528927,ECE 180,A00,083140,Abi Samra; Nicholas Camill,21,0,30,9
1650658528927,ECE 180,B00,083141,Abi Samra; Nicholas Camill,0,0,30,30
1650658534956,MATH 10A,A01,083735,Patchell; Gregory David,3,0,30,27
1650658534956,MATH 10A,A02,083736,Patchell; Gregory David,27,0,30,3
1650658534956,MATH 10A,A03,083737,Patchell; Gregory David,24,0,30,6
1650658540984,MATH 10B,A01,083207,Staff,0,9,30,30
1650658540984,MATH 10B,A02,083208,Staff,0,8,30,30
1650658540984,MATH 10B,B01,083739,Staff,11,0,30,19
1650658540984,MATH 10B,B02,083740,Staff,28,0,30,2
1650658547014,MATH 18,A01,083743,Staff,0,0,30,30
1650658547014,MATH 18,A02,083744,Staff,23,0,30,7
1650658547014,MATH 18,A03,083745,Staff,21,0,30,9
1650658547014,MATH 18,A04,083746,Staff,26,0,30,4
1650658547014,MATH 18,B01,083748,Staff,0,15,30,30
1650658547014,MATH 18,B02,083749,Staff,0,12,30,30
1650658547014,MATH 18,B03,083750,Staff,0,12,30,30
1650658547014,MATH 18,B04,083751,Staff,0,12,30,30
1650658553037,MATH 20A,A01,083754,Staff,19,0,40,21
1650658559063,MATH 20B,A01,083756,Staff,0,11,30,30
1650658559063,MATH 20B,A02,083757,Staff,0,12,30,30
1650658565085,MATH 20C,A01,083760,Staff,0,16,30,30
1650658565085,MATH 20C,A02,083761,Staff,1,14,30,29
1650658565085,MATH 20C,B01,083762,Staff,11,0,30,19
1650658565085,MATH 20C,B02,083763,Staff,28,0,30,2
1650658571120,MATH 20D,A01,083765,Staff,1,1,30,29
1650658571120,MATH 20D,A02,083766,Staff,6,0,30,24
1650658571120,MATH 20D,A03,083767,Staff,24,0,30,6
1650658577143,MATH 20E,A01,083771,Staff,3,0,30,27
1650658577143,MATH 20E,A02,083772,Staff,16,0,30,14
1650658577143,MATH 20E,B01,083773,Staff,0,0,30,30
1650658577143,MATH 20E,B02,083774,Staff,9,0,30,21
1650658583167,MATH 103A,A01,083777,Staff,0,15,30,30
1650658583167,MATH 103A,A02,083778,Staff,0,15,30,30
1650658583167,MATH 103A,B01,083779,Staff,0,14,30,30
1650658583167,MATH 103A,B02,083780,Staff,0,14,30,30
1650658589189,MATH 105,A01,085443,Staff,0,22,30,30
1650658595210,MATH 109,A01,083213,Anzaldo; Leesa B,0,7,30,30
1650658595210,MATH 109,A02,083214,Anzaldo; Leesa B,0,7,30,30
1650658595210,MATH 109,B01,083215,Anzaldo; Leesa B,0,7,30,30
1650658595210,MATH 109,B02,083216,Anzaldo; Leesa B,0,6,30,30
1650658601238,MATH 142A,A01,083219,Chow; Bennett,0,16,30,30
1650658601238,MATH 142A,A02,083220,Chow; Bennett,0,15,30,30
1650658601238,MATH 142A,B01,083221,Chow; Bennett,0,14,30,30
1650658601238,MATH 142A,B02,083222,Chow; Bennett,0,13,30,30
1650658607263,MATH 193A,A01,083224,Staff,0,5,30,30
1650658607263,MATH 193A,A02,083225,Staff,0,6,30,30
1650658607263,MATH 193A,A03,083781,Staff,0,6,30,30
1650658607263,MATH 193A,A04,083782,Staff,0,7,30,30
1650658613294,MATH 197,001,091859,McAuley; Julian John,9998,0,9999,1
1650658619352,COGS 9,A01,083615,Staff,1,16,60,59
1650658625382,COGS 11,A01,083617,Boyle; Mary E. T.,18,0,40,22
1650658631408,COGS 13,A01,083071,Staff,0,39,40,40
1650658637442,COGS 14A,A01,092681,Staff,0,32,100,100
1650658643475,COGS 14B,A01,083073,Cheng; Tzu-Han,1,14,50,49
1650658649510,COGS 17,A01,092677,Staff,17,0,75,58
1650658655558,COGS 100,A01,083619,Staff,0,28,60,60
1650658661584,COGS 101A,A01,083621,Davis; Joshua Daniel,0,27,60,60
1650658667620,COGS 101B,A01,091572,Staff,0,4,60,60
1650658673645,COGS 101C,A01,083625,Delgado; Tania,15,0,30,15
1650658679669,COGS 107A,A01,083627,Boyle; Mary E. T.,1,17,60,59
1650658685700,COGS 118A,A01,083075,Staff,0,7,60,60
1650658691724,CSE 3,A50,083646,Miranda; Gregory Joseph,19,0,38,19
1650658691724,CSE 3,A51,083647,Miranda; Gregory Joseph,36,0,37,1
1650658697751,CSE 8A,A50,083650,Miranda; Gregory Joseph,0,30,40,40
1650658703779,CSE 11,A01,083080,Cao; Yingjun,0,95,40,40
1650658709803,CSE 12,A01,083652,Staff,0,19,100,100
1650658715828,CSE 15L,A01,083654,Staff,0,2,50,50
1650658715828,CSE 15L,A02,083655,Staff,0,1,50,50
1650658721868,CSE 20,A01,083657,Staff,51,0,80,29
1650658727892,CSE 30,A01,083084,Eldon; John,0,78,40,40
1650658733918,CSE 100,A01,083659,Cao; Yingjun,0,68,50,50
1650658739943,CSE 134B,A01,083661,Powell; Thomas Allan,0,37,65,65
1650658745970,CSE 140,A01,083663,Staff,0,8,75,75
1650658752002,CSE 140L,A01,083088,Eldon; John,0,16,75,75
1650658758027,CSE 175,A01,083665,Kumar; Rakesh,7,0,25,18
1650658764059,CSE 190,A00,092507,Dubnov; Shlomo,10,0,20,10
1650658770101,ECE 45,A01,083139,Staff,0,2,60,60
1650658776131,ECE 65,A50,083695,Staff,0,5,30,30
1650658782158,ECE 109,A01,091882,Touri; Behrouz,33,0,70,37
1650658788180,ECE 180,A00,083140,Abi Samra; Nicholas Camill,21,0,30,9
1650658788180,ECE 180,B00,083141,Abi Samra; Nicholas Camill,0,0,30,30
1650658794206,MATH 10A,A01,083735,Patchell; Gregory David,3,0,30,27
1650658794206,MATH 10A,A02,083736,Patchell; Gregory David,27,0,30,3
1650658794206,MATH 10A,A03,083737,Patchell; Gregory David,24,0,30,6
1650658800239,MATH 10B,A01,083207,Staff,0,9,30,30
1650658800239,MATH 10B,A02,083208,Staff,0,8,30,30
1650658800239,MATH 10B,B01,083739,Staff,11,0,30,19
1650658800239,MATH 10B,B02,083740,Staff,28,0,30,2
1650658806269,MATH 18,A01,083743,Staff,0,0,30,30
1650658806269,MATH 18,A02,083744,Staff,23,0,30,7
1650658806269,MATH 18,A03,083745,Staff,21,0,30,9
1650658806269,MATH 18,A04,083746,Staff,26,0,30,4
1650658806269,MATH 18,B01,083748,Staff,0,15,30,30
1650658806269,MATH 18,B02,083749,Staff,0,12,30,30
1650658806269,MATH 18,B03,083750,Staff,0,12,30,30
1650658806269,MATH 18,B04,083751,Staff,0,12,30,30
1650658812292,MATH 20A,A01,083754,Staff,19,0,40,21
1650658818324,MATH 20B,A01,083756,Staff,0,11,30,30
1650658818324,MATH 20B,A02,083757,Staff,0,12,30,30
1650658824348,MATH 20C,A01,083760,Staff,0,16,30,30
1650658824348,MATH 20C,A02,083761,Staff,1,14,30,29
1650658824348,MATH 20C,B01,083762,Staff,11,0,30,19
1650658824348,MATH 20C,B02,083763,Staff,28,0,30,2
1650658830375,MATH 20D,A01,083765,Staff,1,1,30,29
1650658830375,MATH 20D,A02,083766,Staff,6,0,30,24
1650658830375,MATH 20D,A03,083767,Staff,24,0,30,6
1650658836400,MATH 20E,A01,083771,Staff,3,0,30,27
1650658836400,MATH 20E,A02,083772,Staff,16,0,30,14
1650658836400,MATH 20E,B01,083773,Staff,0,0,30,30
1650658836400,MATH 20E,B02,083774,Staff,9,0,30,21
1650658842425,MATH 103A,A01,083777,Staff,0,15,30,30
1650658842425,MATH 103A,A02,083778,Staff,0,15,30,30
1650658842425,MATH 103A,B01,083779,Staff,0,14,30,30
1650658842425,MATH 103A,B02,083780,Staff,0,14,30,30
1650658848455,MATH 105,A01,085443,Staff,0,22,30,30
1650658854485,MATH 109,A01,083213,Anzaldo; Leesa B,0,7,30,30
1650658854485,MATH 109,A02,083214,Anzaldo; Leesa B,0,7,30,30
1650658854485,MATH 109,B01,083215,Anzaldo; Leesa B,0,7,30,30
1650658854485,MATH 109,B02,083216,Anzaldo; Leesa B,0,6,30,30
1650658860512,MATH 142A,A01,083219,Chow; Bennett,0,16,30,30
1650658860512,MATH 142A,A02,083220,Chow; Bennett,0,15,30,30
1650658860512,MATH 142A,B01,083221,Chow; Bennett,0,14,30,30
1650658860512,MATH 142A,B02,083222,Chow; Bennett,0,13,30,30
1650658866537,MATH 193A,A01,083224,Staff,0,5,30,30
1650658866537,MATH 193A,A02,083225,Staff,0,6,30,30
1650658866537,MATH 193A,A03,083781,Staff,0,6,30,30
1650658866537,MATH 193A,A04,083782,Staff,0,7,30,30
1650658872565,MATH 197,001,091859,McAuley; Julian John,9998,0,9999,1
1650658878636,COGS 9,A01,083615,Staff,1,16,60,59
1650658884663,COGS 11,A01,083617,Boyle; Mary E. T.,18,0,40,22
1650658890693,COGS 13,A01,083071,Staff,0,39,40,40
1650658896719,COGS 14A,A01,092681,Staff,0,32,100,100
1650658902748,COGS 14B,A01,083073,Cheng; Tzu-Han,1,14,50,49
1650658908780,COGS 17,A01,092677,Staff,17,0,75,58
1650658914803,COGS 100,A01,083619,Staff,0,28,60,60
1650658920848,COGS 101A,A01,083621,Davis; Joshua Daniel,0,27,60,60
1650658926876,COGS 101B,A01,091572,Staff,0,4,60,60
1650658932901,COGS 101C,A01,083625,Delgado; Tania,15,0,30,15
1650658938926,COGS 107A,A01,083627,Boyle; Mary E. T.,1,17,60,59
1650658944949,COGS 118A,A01,083075,Staff,0,7,60,60
1650658950973,CSE 3,A50,083646,Miranda; Gregory Joseph,19,0,38,19
1650658950973,CSE 3,A51,083647,Miranda; Gregory Joseph,36,0,37,1
1650658957000,CSE 8A,A50,083650,Miranda; Gregory Joseph,0,30,40,40
1650658963028,CSE 11,A01,083080,Cao; Yingjun,0,95,40,40
1650658969057,CSE 12,A01,083652,Staff,0,19,100,100
1650658975080,CSE 15L,A01,083654,Staff,0,2,50,50
1650658975080,CSE 15L,A02,083655,Staff,0,1,50,50
1650658981105,CSE 20,A01,083657,Staff,51,0,80,29
1650658987142,CSE 30,A01,083084,Eldon; John,0,78,40,40
1650658993169,CSE 100,A01,083659,Cao; Yingjun,0,68,50,50
1650658999201,CSE 134B,A01,083661,Powell; Thomas Allan,0,37,65,65
1650659005232,CSE 140,A01,083663,Staff,0,8,75,75
1650659011259,CSE 140L,A01,083088,Eldon; John,0,16,75,75
1650659017286,CSE 175,A01,083665,Kumar; Rakesh,7,0,25,18
1650659023330,CSE 190,A00,092507,Dubnov; Shlomo,10,0,20,10
1650659029355,ECE 45,A01,083139,Staff,0,2,60,60
1650659035384,ECE 65,A50,083695,Staff,0,5,30,30
1650659041412,ECE 109,A01,091882,Touri; Behrouz,33,0,70,37
1650659047450,ECE 180,A00,083140,Abi Samra; Nicholas Camill,21,0,30,9
1650659047450,ECE 180,B00,083141,Abi Samra; Nicholas Camill,0,0,30,30
1650659053476,MATH 10A,A01,083735,Patchell; Gregory David,3,0,30,27
1650659053476,MATH 10A,A02,083736,Patchell; Gregory David,27,0,30,3
1650659053476,MATH 10A,A03,083737,Patchell; Gregory David,24,0,30,6
1650659059500,MATH 10B,A01,083207,Staff,0,9,30,30
1650659059500,MATH 10B,A02,083208,Staff,0,8,30,30
1650659059500,MATH 10B,B01,083739,Staff,11,0,30,19
1650659059500,MATH 10B,B02,083740,Staff,28,0,30,2
1650659065524,MATH 18,A01,083743,Staff,0,0,30,30
1650659065524,MATH 18,A02,083744,Staff,23,0,30,7
1650659065524,MATH 18,A03,083745,Staff,21,0,30,9
1650659065524,MATH 18,A04,083746,Staff,26,0,30,4
1650659065524,MATH 18,B01,083748,Staff,0,15,30,30
1650659065524,MATH 18,B02,083749,Staff,0,12,30,30
1650659065524,MATH 18,B03,083750,Staff,0,12,30,30
1650659065524,MATH 18,B04,083751,Staff,0,12,30,30
1650659071549,MATH 20A,A01,083754,Staff,19,0,40,21
1650659077573,MATH 20B,A01,083756,Staff,0,11,30,30
1650659077573,MATH 20B,A02,083757,Staff,0,12,30,30
1650659083601,MATH 20C,A01,083760,Staff,0,16,30,30
1650659083601,MATH 20C,A02,083761,Staff,1,14,30,29
1650659083601,MATH 20C,B01,083762,Staff,11,0,30,19
1650659083601,MATH 20C,B02,083763,Staff,28,0,30,2
1650659089627,MATH 20D,A01,083765,Staff,1,1,30,29
1650659089627,MATH 20D,A02,083766,Staff,6,0,30,24
1650659089627,MATH 20D,A03,083767,Staff,24,0,30,6
1650659095662,MATH 20E,A01,083771,Staff,3,0,30,27
1650659095662,MATH 20E,A02,083772,Staff,16,0,30,14
1650659095662,MATH 20E,B01,083773,Staff,0,0,30,30
1650659095662,MATH 20E,B02,083774,Staff,9,0,30,21
1650659101694,MATH 103A,A01,083777,Staff,0,15,30,30
1650659101694,MATH 103A,A02,083778,Staff,0,15,30,30
1650659101694,MATH 103A,B01,083779,Staff,0,14,30,30
1650659101694,MATH 103A,B02,083780,Staff,0,14,30,30
1650659107834,MATH 105,A01,085443,Staff,0,22,30,30
1650659113858,MATH 109,A01,083213,Anzaldo; Leesa B,0,7,30,30
1650659113858,MATH 109,A02,083214,Anzaldo; Leesa B,0,7,30,30
1650659113858,MATH 109,B01,083215,Anzaldo; Leesa B,0,7,30,30
1650659113858,MATH 109,B02,083216,Anzaldo; Leesa B,0,6,30,30
1650659119892,MATH 142A,A01,083219,Chow; Bennett,0,16,30,30
1650659119892,MATH 142A,A02,083220,Chow; Bennett,0,15,30,30
1650659119892,MATH 142A,B01,083221,Chow; Bennett,0,14,30,30
1650659119892,MATH 142A,B02,083222,Chow; Bennett,0,13,30,30
1650659125922,MATH 193A,A01,083224,Staff,0,5,30,30
1650659125922,MATH 193A,A02,083225,Staff,0,6,30,30
1650659125922,MATH 193A,A03,083781,Staff,0,6,30,30
1650659125922,MATH 193A,A04,083782,Staff,0,7,30,30
1650659131946,MATH 197,001,091859,McAuley; Julian John,9998,0,9999,1
1650659138029,COGS 9,A01,083615,Staff,1,16,60,59
1650659144054,COGS 11,A01,083617,Boyle; Mary E. T.,18,0,40,22
1650659150090,COGS 13,A01,083071,Staff,0,39,40,40
1650659156116,COGS 14A,A01,092681,Staff,0,32,100,100
1650659162150,COGS 14B,A01,083073,Cheng; Tzu-Han,1,14,50,49
1650659168178,COGS 17,A01,092677,Staff,17,0,75,58
1650659174226,COGS 100,A01,083619,Staff,0,28,60,60
1650659180262,COGS 101A,A01,083621,Davis; Joshua Daniel,0,27,60,60
1650659186286,COGS 101B,A01,091572,Staff,0,4,60,60
1650659192318,COGS 101C,A01,083625,Delgado; Tania,15,0,30,15
1650659198352,COGS 107A,A01,083627,Boyle; Mary E. T.,1,17,60,59
1650659204385,COGS 118A,A01,083075,Staff,0,7,60,60
1650659210417,CSE 3,A50,083646,Miranda; Gregory Joseph,19,0,38,19
1650659210417,CSE 3,A51,083647,Miranda; Gregory Joseph,36,0,37,1
1650659216442,CSE 8A,A50,083650,Miranda; Gregory Joseph,0,30,40,40
1650659222466,CSE 11,A01,083080,Cao; Yingjun,0,95,40,40
1650659228501,CSE 12,A01,083652,Staff,0,19,100,100
1650659234525,CSE 15L,A01,083654,Staff,0,2,50,50
1650659234525,CSE 15L,A02,083655,Staff,0,1,50,50
1650659240549,CSE 20,A01,083657,Staff,51,0,80,29
1650659246573,CSE 30,A01,083084,Eldon; John,0,78,40,40
1650659252606,CSE 100,A01,083659,Cao; Yingjun,0,68,50,50
1650659258644,CSE 134B,A01,083661,Powell; Thomas Allan,0,37,65,65
1650659264672,CSE 140,A01,083663,Staff,0,8,75,75
1650659270700,CSE 140L,A01,083088,Eldon; John,0,16,75,75
1650659276727,CSE 175,A01,083665,Kumar; Rakesh,7,0,25,18
1650659282761,CSE 190,A00,092507,Dubnov; Shlomo,10,0,20,10
1650659288786,ECE 45,A01,083139,Staff,0,2,60,60
1650659294814,ECE 65,A50,083695,Staff,0,5,30,30
1650659300837,ECE 109,A01,091882,Touri; Behrouz,33,0,70,37
1650659306872,ECE 180,A00,083140,Abi Samra; Nicholas Camill,21,0,30,9
1650659306872,ECE 180,B00,083141,Abi Samra; Nicholas Camill,0,0,30,30
1650659312897,MATH 10A,A01,083735,Patchell; Gregory David,3,0,30,27
1650659312897,MATH 10A,A02,083736,Patchell; Gregory David,27,0,30,3
1650659312897,MATH 10A,A03,083737,Patchell; Gregory David,24,0,30,6
1650659318923,MATH 10B,A01,083207,Staff,0,9,30,30
1650659318923,MATH 10B,A02,083208,Staff,0,8,30,30
1650659318923,MATH 10B,B01,083739,Staff,11,0,30,19
1650659318923,MATH 10B,B02,083740,Staff,28,0,30,2
1650659324950,MATH 18,A01,083743,Staff,0,0,30,30
1650659324950,MATH 18,A02,083744,Staff,23,0,30,7
1650659324950,MATH 18,A03,083745,Staff,21,0,30,9
1650659324950,MATH 18,A04,083746,Staff,26,0,30,4
1650659324950,MATH 18,B01,083748,Staff,0,15,30,30
1650659324950,MATH 18,B02,083749,Staff,0,12,30,30
1650659324950,MATH 18,B03,083750,Staff,0,12,30,30
1650659324950,MATH 18,B04,083751,Staff,0,12,30,30
1650659330973,MATH 20A,A01,083754,Staff,19,0,40,21
1650659336996,MATH 20B,A01,083756,Staff,0,11,30,30
1650659336996,MATH 20B,A02,083757,Staff,0,12,30,30
1650659343024,MATH 20C,A01,083760,Staff,0,16,30,30
1650659343024,MATH 20C,A02,083761,Staff,1,14,30,29
1650659343024,MATH 20C,B01,083762,Staff,11,0,30,19
1650659343024,MATH 20C,B02,083763,Staff,28,0,30,2
1650659349048,MATH 20D,A01,083765,Staff,1,1,30,29
1650659349048,MATH 20D,A02,083766,Staff,6,0,30,24
1650659349048,MATH 20D,A03,083767,Staff,24,0,30,6
1650659355072,MATH 20E,A01,083771,Staff,3,0,30,27
1650659355072,MATH 20E,A02,083772,Staff,16,0,30,14
1650659355072,MATH 20E,B01,083773,Staff,0,0,30,30
1650659355072,MATH 20E,B02,083774,Staff,9,0,30,21
1650659361097,MATH 103A,A01,083777,Staff,0,15,30,30
1650659361097,MATH 103A,A02,083778,Staff,0,15,30,30
1650659361097,MATH 103A,B01,083779,Staff,0,14,30,30
1650659361097,MATH 103A,B02,083780,Staff,0,14,30,30
1650659367133,MATH 105,A01,085443,Staff,0,22,30,30
1650659373156,MATH 109,A01,083213,Anzaldo; Leesa B,0,7,30,30
1650659373156,MATH 109,A02,083214,Anzaldo; Leesa B,0,7,30,30
1650659373156,MATH 109,B01,083215,Anzaldo; Leesa B,0,7,30,30
1650659373156,MATH 109,B02,083216,Anzaldo; Leesa B,0,6,30,30
1650659379180,MATH 142A,A01,083219,Chow; Bennett,0,16,30,30
1650659379180,MATH 142A,A02,083220,Chow; Bennett,0,15,30,30
1650659379180,MATH 142A,B01,083221,Chow; Bennett,0,13,30,30
1650659379180,MATH 142A,B02,083222,Chow; Bennett,0,14,30,30
1650659385207,MATH 193A,A01,083224,Staff,0,5,30,30
1650659385207,MATH 193A,A02,083225,Staff,0,6,30,30
1650659385207,MATH 193A,A03,083781,Staff,0,6,30,30
1650659385207,MATH 193A,A04,083782,Staff,0,7,30,30
1650659391230,MATH 197,001,091859,McAuley; Julian John,9998,0,9999,1
1650659397285,COGS 9,A01,083615,Staff,1,16,60,59
1650659403332,COGS 11,A01,083617,Boyle; Mary E. T.,18,0,40,22
1650659409357,COGS 13,A01,083071,Staff,0,39,40,40
1650659415387,COGS 14A,A01,092681,Staff,0,32,100,100
1650659421424,COGS 14B,A01,083073,Cheng; Tzu-Han,1,14,50,49
1650659427456,COGS 17,A01,092677,Staff,17,0,75,58
1650659433479,COGS 100,A01,083619,Staff,0,28,60,60
1650659439505,COGS 101A,A01,083621,Davis; Joshua Daniel,0,27,60,60
1650659445531,COGS 101B,A01,091572,Staff,0,4,60,60
1650659451554,COGS 101C,A01,083625,Delgado; Tania,15,0,30,15
1650659457582,COGS 107A,A01,083627,Boyle; Mary E. T.,1,17,60,59
1650659463606,COGS 118A,A01,083075,Staff,0,7,60,60
1650659469643,CSE 3,A50,083646,Miranda; Gregory Joseph,19,0,38,19
1650659469643,CSE 3,A51,083647,Miranda; Gregory Joseph,36,0,37,1
1650659475689,CSE 8A,A50,083650,Miranda; Gregory Joseph,0,30,40,40
1650659481718,CSE 11,A01,083080,Cao; Yingjun,0,95,40,40
1650659487740,CSE 12,A01,083652,Staff,0,19,100,100
1650659493768,CSE 15L,A01,083654,Staff,0,2,50,50
1650659493768,CSE 15L,A02,083655,Staff,0,1,50,50
1650659499802,CSE 20,A01,083657,Staff,51,0,80,29
1650659505840,CSE 30,A01,083084,Eldon; John,0,78,40,40
1650659511868,CSE 100,A01,083659,Cao; Yingjun,0,68,50,50
1650659517896,CSE 134B,A01,083661,Powell; Thomas Allan,0,37,65,65
1650659523919,CSE 140,A01,083663,Staff,0,8,75,75
1650659529954,CSE 140L,A01,083088,Eldon; John,0,16,75,75
1650659535978,CSE 175,A01,083665,Kumar; Rakesh,7,0,25,18
1650659542004,CSE 190,A00,092507,Dubnov; Shlomo,10,0,20,10
1650659548035,ECE 45,A01,083139,Staff,0,2,60,60
1650659554059,ECE 65,A50,083695,Staff,0,5,30,30
1650659560083,ECE 109,A01,091882,Touri; Behrouz,33,0,70,37
1650659566109,ECE 180,A00,083140,Abi Samra; Nicholas Camill,20,0,30,10
1650659566109,ECE 180,B00,083141,Abi Samra; Nicholas Camill,0,0,30,30
1650659572137,MATH 10A,A01,083735,Patchell; Gregory David,3,0,30,27
1650659572137,MATH 10A,A02,083736,Patchell; Gregory David,27,0,30,3
1650659572137,MATH 10A,A03,083737,Patchell; Gregory David,24,0,30,6
1650659578163,MATH 10B,A01,083207,Staff,0,9,30,30
1650659578163,MATH 10B,A02,083208,Staff,0,8,30,30
1650659578163,MATH 10B,B01,083739,Staff,11,0,30,19
1650659578163,MATH 10B,B02,083740,Staff,28,0,30,2
1650659584191,MATH 18,A01,083743,Staff,0,0,30,30
1650659584191,MATH 18,A02,083744,Staff,23,0,30,7
1650659584191,MATH 18,A03,083745,Staff,21,0,30,9
1650659584191,MATH 18,A04,083746,Staff,26,0,30,4
1650659584191,MATH 18,B01,083748,Staff,0,15,30,30
1650659584191,MATH 18,B02,083749,Staff,0,12,30,30
1650659584191,MATH 18,B03,083750,Staff,0,12,30,30
1650659584191,MATH 18,B04,083751,Staff,0,12,30,30
1650659590215,MATH 20A,A01,083754,Staff,19,0,40,21
1650659596263,MATH 20B,A01,083756,Staff,0,11,30,30
1650659596263,MATH 20B,A02,083757,Staff,0,12,30,30
1650659602287,MATH 20C,A01,083760,Staff,0,16,30,30
1650659602287,MATH 20C,A02,083761,Staff,1,14,30,29
1650659602287,MATH 20C,B01,083762,Staff,11,0,30,19
1650659602287,MATH 20C,B02,083763,Staff,28,0,30,2
1650659608311,MATH 20D,A01,083765,Staff,1,1,30,29
1650659608311,MATH 20D,A02,083766,Staff,6,0,30,24
1650659608311,MATH 20D,A03,083767,Staff,24,0,30,6
1650659614340,MATH 20E,A01,083771,Staff,3,0,30,27
1650659614340,MATH 20E,A02,083772,Staff,16,0,30,14
1650659614340,MATH 20E,B01,083773,Staff,0,0,30,30
1650659614340,MATH 20E,B02,083774,Staff,9,0,30,21
1650659620366,MATH 103A,A01,083777,Staff,0,15,30,30
1650659620366,MATH 103A,A02,083778,Staff,0,15,30,30
1650659620366,MATH 103A,B01,083779,Staff,0,14,30,30
1650659620366,MATH 103A,B02,083780,Staff,0,14,30,30
1650659626391,MATH 105,A01,085443,Staff,0,22,30,30
1650659632417,MATH 109,A01,083213,Anzaldo; Leesa B,0,7,30,30
1650659632417,MATH 109,A02,083214,Anzaldo; Leesa B,0,7,30,30
1650659632417,MATH 109,B01,083215,Anzaldo; Leesa B,0,8,30,30
1650659632417,MATH 109,B02,083216,Anzaldo; Leesa B,0,6,30,30
1650659638441,MATH 142A,A01,083219,Chow; Bennett,0,16,30,30
1650659638441,MATH 142A,A02,083220,Chow; Bennett,0,15,30,30
1650659638441,MATH 142A,B01,083221,Chow; Bennett,0,13,30,30
1650659638441,MATH 142A,B02,083222,Chow; Bennett,0,14,30,30
1650659644465,MATH 193A,A01,083224,Staff,0,5,30,30
1650659644465,MATH 193A,A02,083225,Staff,0,6,30,30
1650659644465,MATH 193A,A03,083781,Staff,0,6,30,30
1650659644465,MATH 193A,A04,083782,Staff,0,7,30,30
1650659650490,MATH 197,001,091859,McAuley; Julian John,9998,0,9999,1
1650659656559,COGS 9,A01,083615,Staff,1,16,60,59
1650659662590,COGS 11,A01,083617,Boyle; Mary E. T.,18,0,40,22
1650659668613,COGS 13,A01,083071,Staff,0,39,40,40
1650659674636,COGS 14A,A01,092681,Staff,0,32,100,100
1650659680667,COGS 14B,A01,083073,Cheng; Tzu-Han,1,14,50,49
1650659686698,COGS 17,A01,092677,Staff,17,0,75,58
1650659692724,COGS 100,A01,083619,Staff,0,28,60,60
1650659698841,COGS 101A,A01,083621,Davis; Joshua Daniel,0,27,60,60
1650659704872,COGS 101B,A01,091572,Staff,0,4,60,60
1650659710909,COGS 101C,A01,083625,Delgado; Tania,15,0,30,15
1650659716933,COGS 107A,A01,083627,Boyle; Mary E. T.,1,17,60,59
1650659722956,COGS 118A,A01,083075,Staff,0,7,60,60
1650659728979,CSE 3,A50,083646,Miranda; Gregory Joseph,19,0,38,19
1650659728979,CSE 3,A51,083647,Miranda; Gregory Joseph,36,0,37,1
1650659735007,CSE 8A,A50,083650,Miranda; Gregory Joseph,0,30,40,40
1650659741033,CSE 11,A01,083080,Cao; Yingjun,0,95,40,40
1650659747059,CSE 12,A01,083652,Staff,0,19,100,100
1650659753087,CSE 15L,A01,083654,Staff,0,2,50,50
1650659753087,CSE 15L,A02,083655,Staff,0,1,50,50
1650659759120,CSE 20,A01,083657,Staff,51,0,80,29
1650659765144,CSE 30,A01,083084,Eldon; John,0,78,40,40
1650659771177,CSE 100,A01,083659,Cao; Yingjun,0,68,50,50
1650659777201,CSE 134B,A01,083661,Powell; Thomas Allan,0,37,65,65
1650659783224,CSE 140,A01,083663,Staff,0,8,75,75
1650659789250,CSE 140L,A01,083088,Eldon; John,0,17,75,75
1650659795277,CSE 175,A01,083665,Kumar; Rakesh,7,0,25,18
1650659801304,CSE 190,A00,092507,Dubnov; Shlomo,10,0,20,10
1650659807331,ECE 45,A01,083139,Staff,0,2,60,60
1650659813355,ECE 65,A50,083695,Staff,0,5,30,30
1650659819377,ECE 109,A01,091882,Touri; Behrouz,33,0,70,37
1650659825404,ECE 180,A00,083140,Abi Samra; Nicholas Camill,20,0,30,10
1650659825404,ECE 180,B00,083141,Abi Samra; Nicholas Camill,0,0,30,30
1650659831430,MATH 10A,A01,083735,Patchell; Gregory David,3,0,30,27
1650659831430,MATH 10A,A02,083736,Patchell; Gregory David,27,0,30,3
1650659831430,MATH 10A,A03,083737,Patchell; Gregory David,24,0,30,6
1650659837466,MATH 10B,A01,083207,Staff,0,9,30,30
1650659837466,MATH 10B,A02,083208,Staff,0,8,30,30
1650659837466,MATH 10B,B01,083739,Staff,11,0,30,19
1650659837466,MATH 10B,B02,083740,Staff,28,0,30,2
1650659843496,MATH 18,A01,083743,Staff,0,0,30,30
1650659843496,MATH 18,A02,083744,Staff,23,0,30,7
1650659843496,MATH 18,A03,083745,Staff,21,0,30,9
1650659843496,MATH 18,A04,083746,Staff,26,0,30,4
1650659843496,MATH 18,B01,083748,Staff,0,15,30,30
1650659843496,MATH 18,B02,083749,Staff,0,12,30,30
1650659843496,MATH 18,B03,083750,Staff,0,12,30,30
1650659843496,MATH 18,B04,083751,Staff,0,12,30,30
1650659849523,MATH 20A,A01,083754,Staff,19,0,40,21
1650659855548,MATH 20B,A01,083756,Staff,0,11,30,30
1650659855548,MATH 20B,A02,083757,Staff,0,12,30,30
1650659861572,MATH 20C,A01,083760,Staff,0,16,30,30
1650659861572,MATH 20C,A02,083761,Staff,1,14,30,29
1650659861572,MATH 20C,B01,083762,Staff,11,0,30,19
1650659861572,MATH 20C,B02,083763,Staff,28,0,30,2
1650659867597,MATH 20D,A01,083765,Staff,1,1,30,29
1650659867597,MATH 20D,A02,083766,Staff,6,0,30,24
1650659867597,MATH 20D,A03,083767,Staff,24,0,30,6
1650659873621,MATH 20E,A01,083771,Staff,3,0,30,27
1650659873621,MATH 20E,A02,083772,Staff,16,0,30,14
1650659873621,MATH 20E,B01,083773,Staff,0,0,30,30
1650659873621,MATH 20E,B02,083774,Staff,9,0,30,21
1650659879654,MATH 103A,A01,083777,Staff,0,15,30,30
1650659879654,MATH 103A,A02,083778,Staff,0,15,30,30
1650659879654,MATH 103A,B01,083779,Staff,0,14,30,30
1650659879654,MATH 103A,B02,083780,Staff,0,14,30,30
1650659885679,MATH 105,A01,085443,Staff,0,22,30,30
1650659891714,MATH 109,A01,083213,Anzaldo; Leesa B,0,7,30,30
1650659891714,MATH 109,A02,083214,Anzaldo; Leesa B,0,7,30,30
1650659891714,MATH 109,B01,083215,Anzaldo; Leesa B,0,8,30,30
1650659891714,MATH 109,B02,083216,Anzaldo; Leesa B,0,6,30,30
1650659897741,MATH 142A,A01,083219,Chow; Bennett,0,16,30,30
1650659897741,MATH 142A,A02,083220,Chow; Bennett,0,15,30,30
1650659897741,MATH 142A,B01,083221,Chow; Bennett,0,13,30,30
1650659897741,MATH 142A,B02,083222,Chow; Bennett,0,14,30,30
1650659903769,MATH 193A,A01,083224,Staff,0,5,30,30
1650659903769,MATH 193A,A02,083225,Staff,0,6,30,30
1650659903769,MATH 193A,A03,083781,Staff,0,6,30,30
1650659903769,MATH 193A,A04,083782,Staff,0,7,30,30
1650659909793,MATH 197,001,091859,McAuley; Julian John,9998,0,9999,1
1650659915855,COGS 9,A01,083615,Staff,1,16,60,59
1650659921883,COGS 11,A01,083617,Boyle; Mary E. T.,18,0,40,22
1650659927907,COGS 13,A01,083071,Staff,0,39,40,40
1650659933933,COGS 14A,A01,092681,Staff,0,32,100,100
1650659939967,COGS 14B,A01,083073,Cheng; Tzu-Han,1,14,50,49
1650659945994,COGS 17,A01,092677,Staff,17,0,75,58
1650659952022,COGS 100,A01,083619,Staff,0,28,60,60
1650659958051,COGS 101A,A01,083621,Davis; Joshua Daniel,0,27,60,60
1650659964079,COGS 101B,A01,091572,Staff,0,4,60,60
1650659970106,COGS 101C,A01,083625,Delgado; Tania,14,0,30,16
1650659976131,COGS 107A,A01,083627,Boyle; Mary E. T.,1,17,60,59
1650659982156,COGS 118A,A01,083075,Staff,0,7,60,60
1650659988181,CSE 3,A50,083646,Miranda; Gregory Joseph,19,0,38,19
1650659988181,CSE 3,A51,083647,Miranda; Gregory Joseph,36,0,37,1
1650659994211,CSE 8A,A50,083650,Miranda; Gregory Joseph,0,30,40,40
1650660000245,CSE 11,A01,083080,Cao; Yingjun,0,95,40,40
1650660006280,CSE 12,A01,083652,Staff,0,19,100,100
1650660012306,CSE 15L,A01,083654,Staff,0,2,50,50
1650660012306,CSE 15L,A02,083655,Staff,0,1,50,50
1650660018336,CSE 20,A01,083657,Staff,51,0,80,29
1650660024372,CSE 30,A01,083084,Eldon; John,0,78,40,40
1650660030396,CSE 100,A01,083659,Cao; Yingjun,0,68,50,50
1650660036423,CSE 134B,A01,083661,Powell; Thomas Allan,0,37,65,65
1650660042458,CSE 140,A01,083663,Staff,0,8,75,75
1650660048481,CSE 140L,A01,083088,Eldon; John,0,17,75,75
1650660054510,CSE 175,A01,083665,Kumar; Rakesh,7,0,25,18
1650660060540,CSE 190,A00,092507,Dubnov; Shlomo,10,0,20,10
1650660066563,ECE 45,A01,083139,Staff,0,2,60,60
1650660072621,ECE 65,A50,083695,Staff,0,5,30,30
1650660078644,ECE 109,A01,091882,Touri; Behrouz,33,0,70,37
1650660084668,ECE 180,A00,083140,Abi Samra; Nicholas Camill,20,0,30,10
1650660084668,ECE 180,B00,083141,Abi Samra; Nicholas Camill,0,0,30,30
1650660090700,MATH 10A,A01,083735,Patchell; Gregory David,3,0,30,27
1650660090700,MATH 10A,A02,083736,Patchell; Gregory David,27,0,30,3
1650660090700,MATH 10A,A03,083737,Patchell; Gregory David,24,0,30,6
1650660096732,MATH 10B,A01,083207,Staff,0,9,30,30
1650660096732,MATH 10B,A02,083208,Staff,0,8,30,30
1650660096732,MATH 10B,B01,083739,Staff,11,0,30,19
1650660096732,MATH 10B,B02,083740,Staff,28,0,30,2
1650660102764,MATH 18,A01,083743,Staff,0,0,30,30
1650660102764,MATH 18,A02,083744,Staff,23,0,30,7
1650660102764,MATH 18,A03,083745,Staff,21,0,30,9
1650660102764,MATH 18,A04,083746,Staff,26,0,30,4
1650660102764,MATH 18,B01,083748,Staff,0,15,30,30
1650660102764,MATH 18,B02,083749,Staff,0,12,30,30
1650660102764,MATH 18,B03,083750,Staff,0,12,30,30
1650660102764,MATH 18,B04,083751,Staff,0,12,30,30
1650660108787,MATH 20A,A01,083754,Staff,19,0,40,21
1650660114810,MATH 20B,A01,083756,Staff,0,11,30,30
1650660114810,MATH 20B,A02,083757,Staff,0,12,30,30
1650660120840,MATH 20C,A01,083760,Staff,0,16,30,30
1650660120840,MATH 20C,A02,083761,Staff,1,14,30,29
1650660120840,MATH 20C,B01,083762,Staff,11,0,30,19
1650660120840,MATH 20C,B02,083763,Staff,28,0,30,2
1650660126868,MATH 20D,A01,083765,Staff,1,1,30,29
1650660126868,MATH 20D,A02,083766,Staff,6,0,30,24
1650660126868,MATH 20D,A03,083767,Staff,24,0,30,6
1650660132892,MATH 20E,A01,083771,Staff,3,0,30,27
1650660132892,MATH 20E,A02,083772,Staff,16,0,30,14
1650660132892,MATH 20E,B01,083773,Staff,0,0,30,30
1650660132892,MATH 20E,B02,083774,Staff,9,0,30,21
1650660138924,MATH 103A,A01,083777,Staff,0,15,30,30
1650660138924,MATH 103A,A02,083778,Staff,0,15,30,30
1650660138924,MATH 103A,B01,083779,Staff,0,14,30,30
1650660138924,MATH 103A,B02,083780,Staff,0,14,30,30
1650660144948,MATH 105,A01,085443,Staff,0,22,30,30
1650660150983,MATH 109,A01,083213,Anzaldo; Leesa B,0,7,30,30
1650660150983,MATH 109,A02,083214,Anzaldo; Leesa B,0,7,30,30
1650660150983,MATH 109,B01,083215,Anzaldo; Leesa B,0,8,30,30
1650660150983,MATH 109,B02,083216,Anzaldo; Leesa B,0,6,30,30
1650660157006,MATH 142A,A01,083219,Chow; Bennett,0,16,30,30
1650660157006,MATH 142A,A02,083220,Chow; Bennett,0,15,30,30
1650660157006,MATH 142A,B01,083221,Chow; Bennett,0,13,30,30
1650660157006,MATH 142A,B02,083222,Chow; Bennett,0,14,30,30
1650660163043,MATH 193A,A01,083224,Staff,0,5,30,30
1650660163043,MATH 193A,A02,083225,Staff,0,6,30,30
1650660163043,MATH 193A,A03,083781,Staff,0,6,30,30
1650660163043,MATH 193A,A04,083782,Staff,0,7,30,30
1650660169075,MATH 197,001,091859,McAuley; Julian John,9998,0,9999,1
1650660175134,COGS 9,A01,083615,Staff,1,16,60,59
1650660181161,COGS 11,A01,083617,Boyle; Mary E. T.,18,0,40,22
1650660187186,COGS 13,A01,083071,Staff,0,39,40,40
1650660193213,COGS 14A,A01,092681,Staff,0,32,100,100
1650660199237,COGS 14B,A01,083073,Cheng; Tzu-Han,1,14,50,49
1650660205259,COGS 17,A01,092677,Staff,17,0,75,58
1650660211295,COGS 100,A01,083619,Staff,0,28,60,60
1650660217319,COGS 101A,A01,083621,Davis; Joshua Daniel,0,27,60,60
1650660223351,COGS 101B,A01,091572,Staff,0,4,60,60
1650660229379,COGS 101C,A01,083625,Delgado; Tania,14,0,30,16
1650660235403,COGS 107A,A01,083627,Boyle; Mary E. T.,1,17,60,59
1650660241432,COGS 118A,A01,083075,Staff,0,7,60,60
1650660247459,CSE 3,A50,083646,Miranda; Gregory Joseph,19,0,38,19
1650660247459,CSE 3,A51,083647,Miranda; Gregory Joseph,36,0,37,1
1650660253486,CSE 8A,A50,083650,Miranda; Gregory Joseph,0,30,40,40
1650660259512,CSE 11,A01,083080,Cao; Yingjun,0,95,40,40
1650660265540,CSE 12,A01,083652,Staff,0,19,100,100
1650660271567,CSE 15L,A01,083654,Staff,0,2,50,50
1650660271567,CSE 15L,A02,083655,Staff,0,1,50,50
1650660277593,CSE 20,A01,083657,Staff,51,0,80,29
1650660283620,CSE 30,A01,083084,Eldon; John,0,78,40,40
1650660289646,CSE 100,A01,083659,Cao; Yingjun,0,68,50,50
1650660295747,CSE 134B,A01,083661,Powell; Thomas Allan,0,37,65,65
1650660301770,CSE 140,A01,083663,Staff,0,8,75,75
1650660307801,CSE 140L,A01,083088,Eldon; John,0,17,75,75
1650660313827,CSE 175,A01,083665,Kumar; Rakesh,7,0,25,18
1650660319859,CSE 190,A00,092507,Dubnov; Shlomo,10,0,20,10
1650660325886,ECE 45,A01,083139,Staff,0,2,60,60
1650660331918,ECE 65,A50,083695,Staff,0,5,30,30
1650660337941,ECE 109,A01,091882,Touri; Behrouz,33,0,70,37
1650660343967,ECE 180,A00,083140,Abi Samra; Nicholas Camill,20,0,30,10
1650660343967,ECE 180,B00,083141,Abi Samra; Nicholas Camill,0,0,30,30
1650660350004,MATH 10A,A01,083735,Patchell; Gregory David,3,0,30,27
1650660350004,MATH 10A,A02,083736,Patchell; Gregory David,27,0,30,3
1650660350004,MATH 10A,A03,083737,Patchell; Gregory David,24,0,30,6
1650660356034,MATH 10B,A01,083207,Staff,0,9,30,30
1650660356034,MATH 10B,A02,083208,Staff,0,8,30,30
1650660356034,MATH 10B,B01,083739,Staff,11,0,30,19
1650660356034,MATH 10B,B02,083740,Staff,28,0,30,2
1650660362072,MATH 18,A01,083743,Staff,0,0,30,30
1650660362072,MATH 18,A02,083744,Staff,23,0,30,7
1650660362072,MATH 18,A03,083745,Staff,21,0,30,9
1650660362072,MATH 18,A04,083746,Staff,26,0,30,4
1650660362072,MATH 18,B01,083748,Staff,0,15,30,30
1650660362072,MATH 18,B02,083749,Staff,0,12,30,30
1650660362072,MATH 18,B03,083750,Staff,0,12,30,30
1650660362072,MATH 18,B04,083751,Staff,0,12,30,30
1650660368116,MATH 20A,A01,083754,Staff,19,0,40,21
1650660374145,MATH 20B,A01,083756,Staff,0,11,30,30
1650660374145,MATH 20B,A02,083757,Staff,0,12,30,30
1650660380181,MATH 20C,A01,083760,Staff,0,16,30,30
1650660380181,MATH 20C,A02,083761,Staff,1,14,30,29
1650660380181,MATH 20C,B01,083762,Staff,11,0,30,19
1650660380181,MATH 20C,B02,083763,Staff,28,0,30,2
1650660386213,MATH 20D,A01,083765,Staff,1,1,30,29
1650660386213,MATH 20D,A02,083766,Staff,6,0,30,24
1650660386213,MATH 20D,A03,083767,Staff,24,0,30,6
1650660392241,MATH 20E,A01,083771,Staff,3,0,30,27
1650660392241,MATH 20E,A02,083772,Staff,16,0,30,14
1650660392241,MATH 20E,B01,083773,Staff,0,0,30,30
1650660392241,MATH 20E,B02,083774,Staff,9,0,30,21
1650660398270,MATH 103A,A01,083777,Staff,0,15,30,30
1650660398270,MATH 103A,A02,083778,Staff,0,15,30,30
1650660398270,MATH 103A,B01,083779,Staff,0,14,30,30
1650660398270,MATH 103A,B02,083780,Staff,0,14,30,30
1650660404304,MATH 105,A01,085443,Staff,0,22,30,30
1650660410333,MATH 109,A01,083213,Anzaldo; Leesa B,0,7,30,30
1650660410333,MATH 109,A02,083214,Anzaldo; Leesa B,0,7,30,30
1650660410333,MATH 109,B01,083215,Anzaldo; Leesa B,0,8,30,30
1650660410333,MATH 109,B02,083216,Anzaldo; Leesa B,0,6,30,30
1650660416357,MATH 142A,A01,083219,Chow; Bennett,0,16,30,30
1650660416357,MATH 142A,A02,083220,Chow; Bennett,0,15,30,30
1650660416357,MATH 142A,B01,083221,Chow; Bennett,0,13,30,30
1650660416357,MATH 142A,B02,083222,Chow; Bennett,0,14,30,30
1650660422381,MATH 193A,A01,083224,Staff,0,5,30,30
1650660422381,MATH 193A,A02,083225,Staff,0,6,30,30
1650660422381,MATH 193A,A03,083781,Staff,0,6,30,30
1650660422381,MATH 193A,A04,083782,Staff,0,7,30,30
1650660428412,MATH 197,001,091859,McAuley; Julian John,9998,0,9999,1
1650660434476,COGS 9,A01,083615,Staff,1,16,60,59
1650660440502,COGS 11,A01,083617,Boyle; Mary E. T.,18,0,40,22
1650660446527,COGS 13,A01,083071,Staff,0,39,40,40
1650660452556,COGS 14A,A01,092681,Staff,0,32,100,100
1650660458584,COGS 14B,A01,083073,Cheng; Tzu-Han,1,14,50,49
1650660464607,COGS 17,A01,092677,Staff,17,0,75,58
1650660470639,COGS 100,A01,083619,Staff,0,28,60,60
1650660476663,COGS 101A,A01,083621,Davis; Joshua Daniel,0,27,60,60
1650660482687,COGS 101B,A01,091572,Staff,0,4,60,60
1650660488719,COGS 101C,A01,083625,Delgado; Tania,14,0,30,16
1650660494747,COGS 107A,A01,083627,Boyle; Mary E. T.,1,17,60,59
1650660500771,COGS 118A,A01,083075,Staff,0,7,60,60
1650660506801,CSE 3,A50,083646,Miranda; Gregory Joseph,19,0,38,19
1650660506801,CSE 3,A51,083647,Miranda; Gregory Joseph,36,0,37,1
1650660512831,CSE 8A,A50,083650,Miranda; Gregory Joseph,0,30,40,40
1650660518854,CSE 11,A01,083080,Cao; Yingjun,0,95,40,40
1650660524887,CSE 12,A01,083652,Staff,0,19,100,100
1650660530915,CSE 15L,A01,083654,Staff,0,2,50,50
1650660530915,CSE 15L,A02,083655,Staff,0,1,50,50
1650660536949,CSE 20,A01,083657,Staff,51,0,80,29
1650660542973,CSE 30,A01,083084,Eldon; John,0,78,40,40
1650660548998,CSE 100,A01,083659,Cao; Yingjun,0,68,50,50
1650660555026,CSE 134B,A01,083661,Powell; Thomas Allan,0,37,65,65
1650660561055,CSE 140,A01,083663,Staff,0,8,75,75
1650660567090,CSE 140L,A01,083088,Eldon; John,0,17,75,75
1650660573124,CSE 175,A01,083665,Kumar; Rakesh,7,0,25,18
1650660579160,CSE 190,A00,092507,Dubnov; Shlomo,10,0,20,10
1650660585182,ECE 45,A01,083139,Staff,0,2,60,60
1650660591209,ECE 65,A50,083695,Staff,0,5,30,30
1650660597234,ECE 109,A01,091882,Touri; Behrouz,33,0,70,37
1650660603263,ECE 180,A00,083140,Abi Samra; Nicholas Camill,20,0,30,10
1650660603263,ECE 180,B00,083141,Abi Samra; Nicholas Camill,0,0,30,30
1650660609289,MATH 10A,A01,083735,Patchell; Gregory David,3,0,30,27
1650660609289,MATH 10A,A02,083736,Patchell; Gregory David,27,0,30,3
1650660609289,MATH 10A,A03,083737,Patchell; Gregory David,24,0,30,6
1650660615315,MATH 10B,A01,083207,Staff,0,9,30,30
1650660615315,MATH 10B,A02,083208,Staff,1,8,30,29
1650660615315,MATH 10B,B01,083739,Staff,11,0,30,19
1650660615315,MATH 10B,B02,083740,Staff,28,0,30,2
1650660621346,MATH 18,A01,083743,Staff,0,0,30,30
1650660621346,MATH 18,A02,083744,Staff,23,0,30,7
1650660621346,MATH 18,A03,083745,Staff,21,0,30,9
1650660621346,MATH 18,A04,083746,Staff,26,0,30,4
1650660621346,MATH 18,B01,083748,Staff,0,15,30,30
1650660621346,MATH 18,B02,083749,Staff,0,12,30,30
1650660621346,MATH 18,B03,083750,Staff,0,12,30,30
1650660621346,MATH 18,B04,083751,Staff,0,12,30,30
1650660627373,MATH 20A,A01,083754,Staff,19,0,40,21
1650660633404,MATH 20B,A01,083756,Staff,0,11,30,30
1650660633404,MATH 20B,A02,083757,Staff,0,12,30,30
1650660639431,MATH 20C,A01,083760,Staff,0,16,30,30
1650660639431,MATH 20C,A02,083761,Staff,1,14,30,29
1650660639431,MATH 20C,B01,083762,Staff,11,0,30,19
1650660639431,MATH 20C,B02,083763,Staff,28,0,30,2
1650660645456,MATH 20D,A01,083765,Staff,1,1,30,29
1650660645456,MATH 20D,A02,083766,Staff,6,0,30,24
1650660645456,MATH 20D,A03,083767,Staff,24,0,30,6
1650660651481,MATH 20E,A01,083771,Staff,3,0,30,27
1650660651481,MATH 20E,A02,083772,Staff,16,0,30,14
1650660651481,MATH 20E,B01,083773,Staff,0,0,30,30
1650660651481,MATH 20E,B02,083774,Staff,9,0,30,21
1650660657505,MATH 103A,A01,083777,Staff,0,15,30,30
1650660657505,MATH 103A,A02,083778,Staff,0,15,30,30
1650660657505,MATH 103A,B01,083779,Staff,0,14,30,30
1650660657505,MATH 103A,B02,083780,Staff,0,14,30,30
1650660663531,MATH 105,A01,085443,Staff,0,22,30,30
1650660669558,MATH 109,A01,083213,Anzaldo; Leesa B,0,7,30,30
1650660669558,MATH 109,A02,083214,Anzaldo; Leesa B,0,7,30,30
1650660669558,MATH 109,B01,083215,Anzaldo; Leesa B,0,8,30,30
1650660669558,MATH 109,B02,083216,Anzaldo; Leesa B,0,6,30,30
1650660675583,MATH 142A,A01,083219,Chow; Bennett,0,16,30,30
1650660675583,MATH 142A,A02,083220,Chow; Bennett,0,15,30,30
1650660675583,MATH 142A,B01,083221,Chow; Bennett,0,13,30,30
1650660675583,MATH 142A,B02,083222,Chow; Bennett,0,14,30,30
1650660681613,MATH 193A,A01,083224,Staff,0,5,30,30
1650660681613,MATH 193A,A02,083225,Staff,0,6,30,30
1650660681613,MATH 193A,A03,083781,Staff,0,6,30,30
1650660681613,MATH 193A,A04,083782,Staff,0,7,30,30
1650660687637,MATH 197,001,091859,McAuley; Julian John,9998,0,9999,1
1650660693703,COGS 9,A01,083615,Staff,1,16,60,59
1650660699729,COGS 11,A01,083617,Boyle; Mary E. T.,18,0,40,22
1650660705753,COGS 13,A01,083071,Staff,0,39,40,40
1650660711787,COGS 14A,A01,092681,Staff,0,32,100,100
1650660717813,COGS 14B,A01,083073,Cheng; Tzu-Han,1,14,50,49
1650660723838,COGS 17,A01,092677,Staff,17,0,75,58
1650660729868,COGS 100,A01,083619,Staff,0,28,60,60
1650660735892,COGS 101A,A01,083621,Davis; Joshua Daniel,0,27,60,60
1650660741918,COGS 101B,A01,091572,Staff,0,4,60,60
1650660747951,COGS 101C,A01,083625,Delgado; Tania,14,0,30,16
1650660753978,COGS 107A,A01,083627,Boyle; Mary E. T.,1,17,60,59
1650660760005,COGS 118A,A01,083075,Staff,0,7,60,60
1650660766035,CSE 3,A50,083646,Miranda; Gregory Joseph,19,0,38,19
1650660766035,CSE 3,A51,083647,Miranda; Gregory Joseph,36,0,37,1
1650660772060,CSE 8A,A50,083650,Miranda; Gregory Joseph,0,30,40,40
1650660778087,CSE 11,A01,083080,Cao; Yingjun,0,95,40,40
1650660784114,CSE 12,A01,083652,Staff,0,19,100,100
1650660790138,CSE 15L,A01,083654,Staff,0,2,50,50
1650660790138,CSE 15L,A02,083655,Staff,0,1,50,50
1650660796162,CSE 20,A01,083657,Staff,51,0,80,29
1650660802189,CSE 30,A01,083084,Eldon; John,0,78,40,40
1650660808216,CSE 100,A01,083659,Cao; Yingjun,0,68,50,50
1650660814240,CSE 134B,A01,083661,Powell; Thomas Allan,0,38,65,65
1650660820268,CSE 140,A01,083663,Staff,0,8,75,75
1650660826291,CSE 140L,A01,083088,Eldon; John,0,17,75,75
1650660832320,CSE 175,A01,083665,Kumar; Rakesh,7,0,25,18
1650660838344,CSE 190,A00,092507,Dubnov; Shlomo,10,0,20,10
1650660844373,ECE 45,A01,083139,Staff,0,2,60,60
1650660850399,ECE 65,A50,083695,Staff,0,5,30,30
1650660856430,ECE 109,A01,091882,Touri; Behrouz,33,0,70,37
1650660862463,ECE 180,A00,083140,Abi Samra; Nicholas Camill,20,0,30,10
1650660862463,ECE 180,B00,083141,Abi Samra; Nicholas Camill,0,0,30,30
1650660868487,MATH 10A,A01,083735,Patchell; Gregory David,3,0,30,27
1650660868487,MATH 10A,A02,083736,Patchell; Gregory David,27,0,30,3
1650660868487,MATH 10A,A03,083737,Patchell; Gregory David,24,0,30,6
1650660874511,MATH 10B,A01,083207,Staff,0,9,30,30
1650660874511,MATH 10B,A02,083208,Staff,1,8,30,29
1650660874511,MATH 10B,B01,083739,Staff,11,0,30,19
1650660874511,MATH 10B,B02,083740,Staff,28,0,30,2
1650660880535,MATH 18,A01,083743,Staff,0,0,30,30
1650660880535,MATH 18,A02,083744,Staff,23,0,30,7
1650660880535,MATH 18,A03,083745,Staff,21,0,30,9
1650660880535,MATH 18,A04,083746,Staff,26,0,30,4
1650660880535,MATH 18,B01,083748,Staff,0,15,30,30
1650660880535,MATH 18,B02,083749,Staff,0,12,30,30
1650660880535,MATH 18,B03,083750,Staff,0,12,30,30
1650660880535,MATH 18,B04,083751,Staff,0,12,30,30
1650660886562,MATH 20A,A01,083754,Staff,19,0,40,21
1650660892684,MATH 20B,A01,083756,Staff,0,11,30,30
1650660892684,MATH 20B,A02,083757,Staff,0,12,30,30
1650660898708,MATH 20C,A01,083760,Staff,0,16,30,30
1650660898708,MATH 20C,A02,083761,Staff,1,14,30,29
1650660898708,MATH 20C,B01,083762,Staff,11,0,30,19
1650660898708,MATH 20C,B02,083763,Staff,28,0,30,2
1650660904736,MATH 20D,A01,083765,Staff,1,1,30,29
1650660904736,MATH 20D,A02,083766,Staff,6,0,30,24
1650660904736,MATH 20D,A03,083767,Staff,24,0,30,6
1650660910763,MATH 20E,A01,083771,Staff,3,0,30,27
1650660910763,MATH 20E,A02,083772,Staff,16,0,30,14
1650660910763,MATH 20E,B01,083773,Staff,0,0,30,30
1650660910763,MATH 20E,B02,083774,Staff,9,0,30,21
1650660916794,MATH 103A,A01,083777,Staff,0,15,30,30
1650660916794,MATH 103A,A02,083778,Staff,0,15,30,30
1650660916794,MATH 103A,B01,083779,Staff,0,14,30,30
1650660916794,MATH 103A,B02,083780,Staff,0,14,30,30
1650660922820,MATH 105,A01,085443,Staff,0,22,30,30
1650660928848,MATH 109,A01,083213,Anzaldo; Leesa B,0,7,30,30
1650660928848,MATH 109,A02,083214,Anzaldo; Leesa B,0,7,30,30
1650660928848,MATH 109,B01,083215,Anzaldo; Leesa B,0,8,30,30
1650660928848,MATH 109,B02,083216,Anzaldo; Leesa B,0,6,30,30
1650660934875,MATH 142A,A01,083219,Chow; Bennett,0,16,30,30
1650660934875,MATH 142A,A02,083220,Chow; Bennett,0,15,30,30
1650660934875,MATH 142A,B01,083221,Chow; Bennett,0,13,30,30
1650660934875,MATH 142A,B02,083222,Chow; Bennett,0,14,30,30
1650660940909,MATH 193A,A01,083224,Staff,0,5,30,30
1650660940909,MATH 193A,A02,083225,Staff,0,6,30,30
1650660940909,MATH 193A,A03,083781,Staff,0,6,30,30
1650660940909,MATH 193A,A04,083782,Staff,0,7,30,30
1650660946932,MATH 197,001,091859,McAuley; Julian John,9998,0,9999,1
1650660952993,COGS 9,A01,083615,Staff,1,16,60,59
1650660959017,COGS 11,A01,083617,Boyle; Mary E. T.,18,0,40,22
1650660965043,COGS 13,A01,083071,Staff,0,39,40,40
1650660971066,COGS 14A,A01,092681,Staff,0,32,100,100
1650660977090,COGS 14B,A01,083073,Cheng; Tzu-Han,1,14,50,49
1650660983116,COGS 17,A01,092677,Staff,17,0,75,58
1650660989142,COGS 100,A01,083619,Staff,0,28,60,60
1650660995171,COGS 101A,A01,083621,Davis; Joshua Daniel,0,27,60,60
1650661001198,COGS 101B,A01,091572,Staff,0,4,60,60
1650661007229,COGS 101C,A01,083625,Delgado; Tania,14,0,30,16
1650661013253,COGS 107A,A01,083627,Boyle; Mary E. T.,1,17,60,59
1650661019284,COGS 118A,A01,083075,Staff,0,7,60,60
1650661025308,CSE 3,A50,083646,Miranda; Gregory Joseph,19,0,38,19
1650661025308,CSE 3,A51,083647,Miranda; Gregory Joseph,36,0,37,1
1650661031337,CSE 8A,A50,083650,Miranda; Gregory Joseph,0,30,40,40
1650661037363,CSE 11,A01,083080,Cao; Yingjun,0,95,40,40
1650661043387,CSE 12,A01,083652,Staff,0,19,100,100
1650661049416,CSE 15L,A01,083654,Staff,0,2,50,50
1650661049416,CSE 15L,A02,083655,Staff,0,1,50,50
1650661055451,CSE 20,A01,083657,Staff,51,0,80,29
1650661061477,CSE 30,A01,083084,Eldon; John,0,78,40,40
1650661067502,CSE 100,A01,083659,Cao; Yingjun,0,68,50,50
1650661073531,CSE 134B,A01,083661,Powell; Thomas Allan,0,38,65,65
1650661079569,CSE 140,A01,083663,Staff,0,8,75,75
1650661085599,CSE 140L,A01,083088,Eldon; John,0,17,75,75
1650661091627,CSE 175,A01,083665,Kumar; Rakesh,7,0,25,18
1650661097653,CSE 190,A00,092507,Dubnov; Shlomo,10,0,20,10
1650661103694,ECE 45,A01,083139,Staff,0,2,60,60
1650661109731,ECE 65,A50,083695,Staff,0,5,30,30
1650661115769,ECE 109,A01,091882,Touri; Behrouz,33,0,70,37
1650661121794,ECE 180,A00,083140,Abi Samra; Nicholas Camill,20,0,30,10
1650661121794,ECE 180,B00,083141,Abi Samra; Nicholas Camill,0,0,30,30
1650661127822,MATH 10A,A01,083735,Patchell; Gregory David,3,0,30,27
1650661127822,MATH 10A,A02,083736,Patchell; Gregory David,27,0,30,3
1650661127822,MATH 10A,A03,083737,Patchell; Gregory David,24,0,30,6
1650661133847,MATH 10B,A01,083207,Staff,0,9,30,30
1650661133847,MATH 10B,A02,083208,Staff,1,8,30,29
1650661133847,MATH 10B,B01,083739,Staff,11,0,30,19
1650661133847,MATH 10B,B02,083740,Staff,28,0,30,2
1650661139880,MATH 18,A01,083743,Staff,0,0,30,30
1650661139880,MATH 18,A02,083744,Staff,23,0,30,7
1650661139880,MATH 18,A03,083745,Staff,21,0,30,9
1650661139880,MATH 18,A04,083746,Staff,26,0,30,4
1650661139880,MATH 18,B01,083748,Staff,0,15,30,30
1650661139880,MATH 18,B02,083749,Staff,0,12,30,30
1650661139880,MATH 18,B03,083750,Staff,0,12,30,30
1650661139880,MATH 18,B04,083751,Staff,0,12,30,30
1650661145904,MATH 20A,A01,083754,Staff,19,0,40,21
1650661151931,MATH 20B,A01,083756,Staff,0,11,30,30
1650661151931,MATH 20B,A02,083757,Staff,0,12,30,30
1650661157955,MATH 20C,A01,083760,Staff,0,16,30,30
1650661157955,MATH 20C,A02,083761,Staff,1,14,30,29
1650661157955,MATH 20C,B01,083762,Staff,11,0,30,19
1650661157955,MATH 20C,B02,083763,Staff,28,0,30,2
1650661163983,MATH 20D,A01,083765,Staff,1,1,30,29
1650661163983,MATH 20D,A02,083766,Staff,6,0,30,24
1650661163983,MATH 20D,A03,083767,Staff,24,0,30,6
1650661170010,MATH 20E,A01,083771,Staff,3,0,30,27
1650661170010,MATH 20E,A02,083772,Staff,16,0,30,14
1650661170010,MATH 20E,B01,083773,Staff,0,0,30,30
1650661170010,MATH 20E,B02,083774,Staff,9,0,30,21
1650661185899,MATH 103A,A01,083777,Staff,0,15,30,30
1650661185899,MATH 103A,A02,083778,Staff,0,15,30,30
1650661185899,MATH 103A,B01,083779,Staff,0,14,30,30
1650661185899,MATH 103A,B02,083780,Staff,0,14,30,30
1650661191922,MATH 105,A01,085443,Staff,0,22,30,30
1650661197948,MATH 109,A01,083213,Anzaldo; Leesa B,0,7,30,30
1650661197948,MATH 109,A02,083214,Anzaldo; Leesa B,0,7,30,30
1650661197948,MATH 109,B01,083215,Anzaldo; Leesa B,0,8,30,30
1650661197948,MATH 109,B02,083216,Anzaldo; Leesa B,0,6,30,30
1650661203982,MATH 142A,A01,083219,Chow; Bennett,0,16,30,30
1650661203982,MATH 142A,A02,083220,Chow; Bennett,0,15,30,30
1650661203982,MATH 142A,B01,083221,Chow; Bennett,0,13,30,30
1650661203982,MATH 142A,B02,083222,Chow; Bennett,0,14,30,30
1650661210014,MATH 193A,A01,083224,Staff,0,5,30,30
1650661210014,MATH 193A,A02,083225,Staff,0,6,30,30
1650661210014,MATH 193A,A03,083781,Staff,0,6,30,30
1650661210014,MATH 193A,A04,083782,Staff,0,7,30,30
1650661216038,MATH 197,001,091859,McAuley; Julian John,9998,0,9999,1
1650661222122,COGS 9,A01,083615,Staff,1,16,60,59
1650661228146,COGS 11,A01,083617,Boyle; Mary E. T.,18,0,40,22
1650661234176,COGS 13,A01,083071,Staff,0,39,40,40
1650661240210,COGS 14A,A01,092681,Staff,0,32,100,100
1650661246234,COGS 14B,A01,083073,Cheng; Tzu-Han,1,14,50,49
1650661252259,COGS 17,A01,092677,Staff,17,0,75,58
1650661258292,COGS 100,A01,083619,Staff,0,28,60,60
1650661264322,COGS 101A,A01,083621,Davis; Joshua Daniel,0,27,60,60
1650661270353,COGS 101B,A01,091572,Staff,0,4,60,60
1650661276389,COGS 101C,A01,083625,Delgado; Tania,14,0,30,16
1650661282412,COGS 107A,A01,083627,Boyle; Mary E. T.,1,17,60,59
1650661288439,COGS 118A,A01,083075,Staff,0,7,60,60
1650661294462,CSE 3,A50,083646,Miranda; Gregory Joseph,19,0,38,19
1650661294462,CSE 3,A51,083647,Miranda; Gregory Joseph,36,0,37,1
1650661300498,CSE 8A,A50,083650,Miranda; Gregory Joseph,0,30,40,40
1650661306524,CSE 11,A01,083080,Cao; Yingjun,0,95,40,40
1650661312548,CSE 12,A01,083652,Staff,0,19,100,100
1650661318581,CSE 15L,A01,083654,Staff,0,2,50,50
1650661318581,CSE 15L,A02,083655,Staff,0,1,50,50
1650661324631,CSE 20,A01,083657,Staff,51,0,80,29
1650661330659,CSE 30,A01,083084,Eldon; John,0,78,40,40
1650661336682,CSE 100,A01,083659,Cao; Yingjun,0,68,50,50
1650661342706,CSE 134B,A01,083661,Powell; Thomas Allan,0,38,65,65
1650661348736,CSE 140,A01,083663,Staff,0,8,75,75
1650661354772,CSE 140L,A01,083088,Eldon; John,0,17,75,75
1650661360796,CSE 175,A01,083665,Kumar; Rakesh,7,0,25,18
1650661366822,CSE 190,A00,092507,Dubnov; Shlomo,10,0,20,10
1650661372846,ECE 45,A01,083139,Staff,0,2,60,60
1650661378879,ECE 65,A50,083695,Staff,0,5,30,30
1650661384905,ECE 109,A01,091882,Touri; Behrouz,33,0,70,37
1650661390926,ECE 180,A00,083140,Abi Samra; Nicholas Camill,20,0,30,10
1650661390926,ECE 180,B00,083141,Abi Samra; Nicholas Camill,0,0,30,30
1650661396955,MATH 10A,A01,083735,Patchell; Gregory David,3,0,30,27
1650661396955,MATH 10A,A02,083736,Patchell; Gregory David,27,0,30,3
1650661396955,MATH 10A,A03,083737,Patchell; Gregory David,24,0,30,6
1650661402980,MATH 10B,A01,083207,Staff,0,9,30,30
1650661402980,MATH 10B,A02,083208,Staff,1,8,30,29
1650661402980,MATH 10B,B01,083739,Staff,11,0,30,19
1650661402980,MATH 10B,B02,083740,Staff,28,0,30,2
1650661409014,MATH 18,A01,083743,Staff,0,0,30,30
1650661409014,MATH 18,A02,083744,Staff,23,0,30,7
1650661409014,MATH 18,A03,083745,Staff,21,0,30,9
1650661409014,MATH 18,A04,083746,Staff,26,0,30,4
1650661409014,MATH 18,B01,083748,Staff,0,15,30,30
1650661409014,MATH 18,B02,083749,Staff,0,12,30,30
1650661409014,MATH 18,B03,083750,Staff,0,12,30,30
1650661409014,MATH 18,B04,083751,Staff,0,12,30,30
1650661415037,MATH 20A,A01,083754,Staff,19,0,40,21
1650661421064,MATH 20B,A01,083756,Staff,0,11,30,30
1650661421064,MATH 20B,A02,083757,Staff,0,12,30,30
1650661427090,MATH 20C,A01,083760,Staff,0,16,30,30
1650661427090,MATH 20C,A02,083761,Staff,1,14,30,29
1650661427090,MATH 20C,B01,083762,Staff,11,0,30,19
1650661427090,MATH 20C,B02,083763,Staff,28,0,30,2
1650661433122,MATH 20D,A01,083765,Staff,1,1,30,29
1650661433122,MATH 20D,A02,083766,Staff,6,0,30,24
1650661433122,MATH 20D,A03,083767,Staff,24,0,30,6
1650661439152,MATH 20E,A01,083771,Staff,3,0,30,27
1650661439152,MATH 20E,A02,083772,Staff,16,0,30,14
1650661439152,MATH 20E,B01,083773,Staff,0,0,30,30
1650661439152,MATH 20E,B02,083774,Staff,9,0,30,21
1650661445177,MATH 103A,A01,083777,Staff,0,15,30,30
1650661445177,MATH 103A,A02,083778,Staff,0,15,30,30
1650661445177,MATH 103A,B01,083779,Staff,0,14,30,30
1650661445177,MATH 103A,B02,083780,Staff,0,14,30,30
1650661451203,MATH 105,A01,085443,Staff,0,22,30,30
1650661457231,MATH 109,A01,083213,Anzaldo; Leesa B,0,7,30,30
1650661457231,MATH 109,A02,083214,Anzaldo; Leesa B,0,7,30,30
1650661457231,MATH 109,B01,083215,Anzaldo; Leesa B,0,8,30,30
1650661457231,MATH 109,B02,083216,Anzaldo; Leesa B,0,6,30,30
1650661463270,MATH 142A,A01,083219,Chow; Bennett,0,16,30,30
1650661463270,MATH 142A,A02,083220,Chow; Bennett,0,15,30,30
1650661463270,MATH 142A,B01,083221,Chow; Bennett,0,13,30,30
1650661463270,MATH 142A,B02,083222,Chow; Bennett,0,14,30,30
1650661469308,MATH 193A,A01,083224,Staff,0,5,30,30
1650661469308,MATH 193A,A02,083225,Staff,0,6,30,30
1650661469308,MATH 193A,A03,083781,Staff,0,6,30,30
1650661469308,MATH 193A,A04,083782,Staff,0,7,30,30
1650661475330,MATH 197,001,091859,McAuley; Julian John,9998,0,9999,1
1650661481383,COGS 9,A01,083615,Staff,1,16,60,59
1650661487408,COGS 11,A01,083617,Boyle; Mary E. T.,18,0,40,22
1650661493519,COGS 13,A01,083071,Staff,0,39,40,40
1650661499546,COGS 14A,A01,092681,Staff,0,32,100,100
1650661505569,COGS 14B,A01,083073,Cheng; Tzu-Han,1,14,50,49
1650661511607,COGS 17,A01,092677,Staff,17,0,75,58
1650661517634,COGS 100,A01,083619,Staff,0,28,60,60
1650661523659,COGS 101A,A01,083621,Davis; Joshua Daniel,0,27,60,60
1650661529683,COGS 101B,A01,091572,Staff,0,4,60,60
1650661535713,COGS 101C,A01,083625,Delgado; Tania,14,0,30,16
1650661541740,COGS 107A,A01,083627,Boyle; Mary E. T.,1,17,60,59
1650661547764,COGS 118A,A01,083075,Staff,0,7,60,60
1650661553797,CSE 3,A50,083646,Miranda; Gregory Joseph,19,0,38,19
1650661553797,CSE 3,A51,083647,Miranda; Gregory Joseph,36,0,37,1
1650661559821,CSE 8A,A50,083650,Miranda; Gregory Joseph,0,30,40,40
1650661565845,CSE 11,A01,083080,Cao; Yingjun,0,95,40,40
1650661571877,CSE 12,A01,083652,Staff,0,19,100,100
1650661577904,CSE 15L,A01,083654,Staff,0,2,50,50
1650661577904,CSE 15L,A02,083655,Staff,0,1,50,50
1650661583929,CSE 20,A01,083657,Staff,51,0,80,29
1650661589954,CSE 30,A01,083084,Eldon; John,0,78,40,40
1650661595981,CSE 100,A01,083659,Cao; Yingjun,0,68,50,50
1650661602005,CSE 134B,A01,083661,Powell; Thomas Allan,0,38,65,65
1650661608028,CSE 140,A01,083663,Staff,0,9,75,75
1650661614054,CSE 140L,A01,083088,Eldon; John,0,17,75,75
1650661620088,CSE 175,A01,083665,Kumar; Rakesh,7,0,25,18
1650661626115,CSE 190,A00,092507,Dubnov; Shlomo,10,0,20,10
1650661632138,ECE 45,A01,083139,Staff,0,2,60,60
1650661638166,ECE 65,A50,083695,Staff,0,5,30,30
1650661644195,ECE 109,A01,091882,Touri; Behrouz,33,0,70,37
1650661650217,ECE 180,A00,083140,Abi Samra; Nicholas Camill,20,0,30,10
1650661650217,ECE 180,B00,083141,Abi Samra; Nicholas Camill,0,0,30,30
1650661656281,MATH 10A,A01,083735,Patchell; Gregory David,3,0,30,27
1650661656281,MATH 10A,A02,083736,Patchell; Gregory David,27,0,30,3
1650661656281,MATH 10A,A03,083737,Patchell; Gregory David,24,0,30,6
1650661662309,MATH 10B,A01,083207,Staff,0,9,30,30
1650661662309,MATH 10B,A02,083208,Staff,1,8,30,29
1650661662309,MATH 10B,B01,083739,Staff,11,0,30,19
1650661662309,MATH 10B,B02,083740,Staff,28,0,30,2
1650661668338,MATH 18,A01,083743,Staff,0,0,30,30
1650661668338,MATH 18,A02,083744,Staff,23,0,30,7
1650661668338,MATH 18,A03,083745,Staff,21,0,30,9
1650661668338,MATH 18,A04,083746,Staff,26,0,30,4
1650661668338,MATH 18,B01,083748,Staff,0,15,30,30
1650661668338,MATH 18,B02,083749,Staff,0,12,30,30
1650661668338,MATH 18,B03,083750,Staff,0,12,30,30
1650661668338,MATH 18,B04,083751,Staff,0,12,30,30
1650661674366,MATH 20A,A01,083754,Staff,19,0,40,21
1650661680392,MATH 20B,A01,083756,Staff,0,11,30,30
1650661680392,MATH 20B,A02,083757,Staff,0,12,30,30
1650661686413,MATH 20C,A01,083760,Staff,0,16,30,30
1650661686413,MATH 20C,A02,083761,Staff,1,14,30,29
1650661686413,MATH 20C,B01,083762,Staff,11,0,30,19
1650661686413,MATH 20C,B02,083763,Staff,28,0,30,2
1650661692436,MATH 20D,A01,083765,Staff,1,1,30,29
1650661692436,MATH 20D,A02,083766,Staff,6,0,30,24
1650661692436,MATH 20D,A03,083767,Staff,24,0,30,6
1650661698463,MATH 20E,A01,083771,Staff,3,0,30,27
1650661698463,MATH 20E,A02,083772,Staff,16,0,30,14
1650661698463,MATH 20E,B01,083773,Staff,0,0,30,30
1650661698463,MATH 20E,B02,083774,Staff,9,0,30,21
1650661704492,MATH 103A,A01,083777,Staff,0,15,30,30
1650661704492,MATH 103A,A02,083778,Staff,0,15,30,30
1650661704492,MATH 103A,B01,083779,Staff,0,14,30,30
1650661704492,MATH 103A,B02,083780,Staff,0,14,30,30
1650661710526,MATH 105,A01,085443,Staff,0,22,30,30
1650661716553,MATH 109,A01,083213,Anzaldo; Leesa B,0,7,30,30
1650661716553,MATH 109,A02,083214,Anzaldo; Leesa B,0,7,30,30
1650661716553,MATH 109,B01,083215,Anzaldo; Leesa B,0,8,30,30
1650661716553,MATH 109,B02,083216,Anzaldo; Leesa B,0,6,30,30
1650661722577,MATH 142A,A01,083219,Chow; Bennett,0,16,30,30
1650661722577,MATH 142A,A02,083220,Chow; Bennett,0,15,30,30
1650661722577,MATH 142A,B01,083221,Chow; Bennett,0,13,30,30
1650661722577,MATH 142A,B02,083222,Chow; Bennett,0,14,30,30
1650661728603,MATH 193A,A01,083224,Staff,0,5,30,30
1650661728603,MATH 193A,A02,083225,Staff,0,6,30,30
1650661728603,MATH 193A,A03,083781,Staff,0,6,30,30
1650661728603,MATH 193A,A04,083782,Staff,0,7,30,30
1650661734627,MATH 197,001,091859,McAuley; Julian John,9998,0,9999,1
1650661740682,COGS 9,A01,083615,Staff,1,16,60,59
1650661746710,COGS 11,A01,083617,Boyle; Mary E. T.,18,0,40,22
1650661752735,COGS 13,A01,083071,Staff,0,39,40,40
1650661758768,COGS 14A,A01,092681,Staff,0,32,100,100
1650661764790,COGS 14B,A01,083073,Cheng; Tzu-Han,1,14,50,49
1650661770814,COGS 17,A01,092677,Staff,17,0,75,58
1650661776840,COGS 100,A01,083619,Staff,0,28,60,60
1650661782867,COGS 101A,A01,083621,Davis; Joshua Daniel,0,27,60,60
1650661788894,COGS 101B,A01,091572,Staff,0,4,60,60
1650661794935,COGS 101C,A01,083625,Delgado; Tania,14,0,30,16
1650661801036,COGS 107A,A01,083627,Boyle; Mary E. T.,1,17,60,59
1650661807063,COGS 118A,A01,083075,Staff,0,7,60,60
1650661813090,CSE 3,A50,083646,Miranda; Gregory Joseph,19,0,38,19
1650661813090,CSE 3,A51,083647,Miranda; Gregory Joseph,36,0,37,1
1650661819114,CSE 8A,A50,083650,Miranda; Gregory Joseph,0,30,40,40
1650661825138,CSE 11,A01,083080,Cao; Yingjun,0,95,40,40
1650661831160,CSE 12,A01,083652,Staff,0,19,100,100
1650661837184,CSE 15L,A01,083654,Staff,0,2,50,50
1650661837184,CSE 15L,A02,083655,Staff,0,1,50,50
1650661843210,CSE 20,A01,083657,Staff,51,0,80,29
1650661849234,CSE 30,A01,083084,Eldon; John,0,78,40,40
1650661855257,CSE 100,A01,083659,Cao; Yingjun,0,68,50,50
1650661861284,CSE 134B,A01,083661,Powell; Thomas Allan,0,38,65,65
1650661867305,CSE 140,A01,083663,Staff,0,9,75,75
1650661873342,CSE 140L,A01,083088,Eldon; John,0,17,75,75
1650661879364,CSE 175,A01,083665,Kumar; Rakesh,7,0,25,18
1650661885388,CSE 190,A00,092507,Dubnov; Shlomo,10,0,20,10
1650661891415,ECE 45,A01,083139,Staff,0,2,60,60
1650661897443,ECE 65,A50,083695,Staff,0,5,30,30
1650661903469,ECE 109,A01,091882,Touri; Behrouz,33,0,70,37
1650661909494,ECE 180,A00,083140,Abi Samra; Nicholas Camill,20,0,30,10
1650661909494,ECE 180,B00,083141,Abi Samra; Nicholas Camill,0,0,30,30
1650661915530,MATH 10A,A01,083735,Patchell; Gregory David,3,0,30,27
1650661915530,MATH 10A,A02,083736,Patchell; Gregory David,27,0,30,3
1650661915530,MATH 10A,A03,083737,Patchell; Gregory David,24,0,30,6
1650661921555,MATH 10B,A01,083207,Staff,0,9,30,30
1650661921555,MATH 10B,A02,083208,Staff,1,8,30,29
1650661921555,MATH 10B,B01,083739,Staff,11,0,30,19
1650661921555,MATH 10B,B02,083740,Staff,28,0,30,2
1650661927586,MATH 18,A01,083743,Staff,0,0,30,30
1650661927586,MATH 18,A02,083744,Staff,23,0,30,7
1650661927586,MATH 18,A03,083745,Staff,21,0,30,9
1650661927586,MATH 18,A04,083746,Staff,26,0,30,4
1650661927586,MATH 18,B01,083748,Staff,0,15,30,30
1650661927586,MATH 18,B02,083749,Staff,0,12,30,30
1650661927586,MATH 18,B03,083750,Staff,0,12,30,30
1650661927586,MATH 18,B04,083751,Staff,0,12,30,30
1650661933613,MATH 20A,A01,083754,Staff,19,0,40,21
1650661939640,MATH 20B,A01,083756,Staff,0,11,30,30
1650661939640,MATH 20B,A02,083757,Staff,0,12,30,30
1650661945668,MATH 20C,A01,083760,Staff,0,16,30,30
1650661945668,MATH 20C,A02,083761,Staff,1,14,30,29
1650661945668,MATH 20C,B01,083762,Staff,11,0,30,19
1650661945668,MATH 20C,B02,083763,Staff,28,0,30,2
1650661951696,MATH 20D,A01,083765,Staff,1,1,30,29
1650661951696,MATH 20D,A02,083766,Staff,6,0,30,24
1650661951696,MATH 20D,A03,083767,Staff,24,0,30,6
1650661957739,MATH 20E,A01,083771,Staff,3,0,30,27
1650661957739,MATH 20E,A02,083772,Staff,16,0,30,14
1650661957739,MATH 20E,B01,083773,Staff,0,0,30,30
1650661957739,MATH 20E,B02,083774,Staff,9,0,30,21
1650661963764,MATH 103A,A01,083777,Staff,0,15,30,30
1650661963764,MATH 103A,A02,083778,Staff,0,15,30,30
1650661963764,MATH 103A,B01,083779,Staff,0,14,30,30
1650661963764,MATH 103A,B02,083780,Staff,0,14,30,30
1650661969800,MATH 105,A01,085443,Staff,0,22,30,30
1650661975832,MATH 109,A01,083213,Anzaldo; Leesa B,0,7,30,30
1650661975832,MATH 109,A02,083214,Anzaldo; Leesa B,0,7,30,30
1650661975832,MATH 109,B01,083215,Anzaldo; Leesa B,0,8,30,30
1650661975832,MATH 109,B02,083216,Anzaldo; Leesa B,0,6,30,30
1650661981862,MATH 142A,A01,083219,Chow; Bennett,0,16,30,30
1650661981862,MATH 142A,A02,083220,Chow; Bennett,0,15,30,30
1650661981862,MATH 142A,B01,083221,Chow; Bennett,0,13,30,30
1650661981862,MATH 142A,B02,083222,Chow; Bennett,0,14,30,30
1650661987886,MATH 193A,A01,083224,Staff,0,5,30,30
1650661987886,MATH 193A,A02,083225,Staff,0,6,30,30
1650661987886,MATH 193A,A03,083781,Staff,0,6,30,30
1650661987886,MATH 193A,A04,083782,Staff,0,7,30,30
1650661993910,MATH 197,001,091859,McAuley; Julian John,9998,0,9999,1
1650661999977,COGS 9,A01,083615,Staff,1,16,60,59
1650662006014,COGS 11,A01,083617,Boyle; Mary E. T.,18,0,40,22
1650662012037,COGS 13,A01,083071,Staff,0,39,40,40
1650662018070,COGS 14A,A01,092681,Staff,0,32,100,100
1650662024102,COGS 14B,A01,083073,Cheng; Tzu-Han,1,14,50,49
1650662030133,COGS 17,A01,092677,Staff,17,0,75,58
1650662036157,COGS 100,A01,083619,Staff,0,28,60,60
1650662042185,COGS 101A,A01,083621,Davis; Joshua Daniel,0,27,60,60
1650662048211,COGS 101B,A01,091572,Staff,0,4,60,60
1650662054238,COGS 101C,A01,083625,Delgado; Tania,14,0,30,16
1650662060265,COGS 107A,A01,083627,Boyle; Mary E. T.,1,17,60,59
1650662066298,COGS 118A,A01,083075,Staff,0,7,60,60
1650662072322,CSE 3,A50,083646,Miranda; Gregory Joseph,19,0,38,19
1650662072322,CSE 3,A51,083647,Miranda; Gregory Joseph,36,0,37,1
1650662078357,CSE 8A,A50,083650,Miranda; Gregory Joseph,0,30,40,40
1650662084381,CSE 11,A01,083080,Cao; Yingjun,0,95,40,40
1650662090495,CSE 12,A01,083652,Staff,0,19,100,100
1650662096521,CSE 15L,A01,083654,Staff,0,2,50,50
1650662096521,CSE 15L,A02,083655,Staff,0,1,50,50
1650662102554,CSE 20,A01,083657,Staff,51,0,80,29
1650662108577,CSE 30,A01,083084,Eldon; John,0,78,40,40
1650662114601,CSE 100,A01,083659,Cao; Yingjun,0,68,50,50
1650662120628,CSE 134B,A01,083661,Powell; Thomas Allan,0,38,65,65
1650662126651,CSE 140,A01,083663,Staff,0,9,75,75
1650662132681,CSE 140L,A01,083088,Eldon; John,0,17,75,75
1650662138715,CSE 175,A01,083665,Kumar; Rakesh,7,0,25,18
1650662144743,CSE 190,A00,092507,Dubnov; Shlomo,10,0,20,10
1650662150768,ECE 45,A01,083139,Staff,0,2,60,60
1650662156791,ECE 65,A50,083695,Staff,0,5,30,30
1650662162825,ECE 109,A01,091882,Touri; Behrouz,33,0,70,37
1650662168868,ECE 180,A00,083140,Abi Samra; Nicholas Camill,20,0,30,10
1650662168868,ECE 180,B00,083141,Abi Samra; Nicholas Camill,0,0,30,30
1650662174893,MATH 10A,A01,083735,Patchell; Gregory David,3,0,30,27
1650662174893,MATH 10A,A02,083736,Patchell; Gregory David,27,0,30,3
1650662174893,MATH 10A,A03,083737,Patchell; Gregory David,24,0,30,6
1650662180919,MATH 10B,A01,083207,Staff,0,9,30,30
1650662180919,MATH 10B,A02,083208,Staff,1,8,30,29
1650662180919,MATH 10B,B01,083739,Staff,11,0,30,19
1650662180919,MATH 10B,B02,083740,Staff,28,0,30,2
1650662186945,MATH 18,A01,083743,Staff,0,0,30,30
1650662186945,MATH 18,A02,083744,Staff,23,0,30,7
1650662186945,MATH 18,A03,083745,Staff,21,0,30,9
1650662186945,MATH 18,A04,083746,Staff,26,0,30,4
1650662186945,MATH 18,B01,083748,Staff,0,15,30,30
1650662186945,MATH 18,B02,083749,Staff,0,12,30,30
1650662186945,MATH 18,B03,083750,Staff,0,12,30,30
1650662186945,MATH 18,B04,083751,Staff,0,12,30,30
1650662192966,MATH 20A,A01,083754,Staff,19,0,40,21
1650662198989,MATH 20B,A01,083756,Staff,0,11,30,30
1650662198989,MATH 20B,A02,083757,Staff,0,12,30,30
1650662205013,MATH 20C,A01,083760,Staff,0,16,30,30
1650662205013,MATH 20C,A02,083761,Staff,1,14,30,29
1650662205013,MATH 20C,B01,083762,Staff,11,0,30,19
1650662205013,MATH 20C,B02,083763,Staff,28,0,30,2
1650662211037,MATH 20D,A01,083765,Staff,1,1,30,29
1650662211037,MATH 20D,A02,083766,Staff,6,0,30,24
1650662211037,MATH 20D,A03,083767,Staff,24,0,30,6
1650662217060,MATH 20E,A01,083771,Staff,3,0,30,27
1650662217060,MATH 20E,A02,083772,Staff,16,0,30,14
1650662217060,MATH 20E,B01,083773,Staff,0,0,30,30
1650662217060,MATH 20E,B02,083774,Staff,9,0,30,21
1650662223098,MATH 103A,A01,083777,Staff,0,15,30,30
1650662223098,MATH 103A,A02,083778,Staff,0,15,30,30
1650662223098,MATH 103A,B01,083779,Staff,0,14,30,30
1650662223098,MATH 103A,B02,083780,Staff,0,14,30,30
1650662229125,MATH 105,A01,085443,Staff,0,22,30,30
1650662235154,MATH 109,A01,083213,Anzaldo; Leesa B,0,7,30,30
1650662235154,MATH 109,A02,083214,Anzaldo; Leesa B,0,7,30,30
1650662235154,MATH 109,B01,083215,Anzaldo; Leesa B,0,8,30,30
1650662235154,MATH 109,B02,083216,Anzaldo; Leesa B,0,6,30,30
1650662241180,MATH 142A,A01,083219,Chow; Bennett,0,16,30,30
1650662241180,MATH 142A,A02,083220,Chow; Bennett,0,15,30,30
1650662241180,MATH 142A,B01,083221,Chow; Bennett,0,13,30,30
1650662241180,MATH 142A,B02,083222,Chow; Bennett,0,14,30,30
1650662247205,MATH 193A,A01,083224,Staff,0,5,30,30
1650662247205,MATH 193A,A02,083225,Staff,0,6,30,30
1650662247205,MATH 193A,A03,083781,Staff,0,6,30,30
1650662247205,MATH 193A,A04,083782,Staff,0,7,30,30
1650662253241,MATH 197,001,091859,McAuley; Julian John,9998,0,9999,1
1650662259310,COGS 9,A01,083615,Staff,1,16,60,59
1650662265345,COGS 11,A01,083617,Boyle; Mary E. T.,18,0,40,22
1650662271368,COGS 13,A01,083071,Staff,0,39,40,40
1650662277400,COGS 14A,A01,092681,Staff,0,32,100,100
1650662283432,COGS 14B,A01,083073,Cheng; Tzu-Han,1,14,50,49
1650662289454,COGS 17,A01,092677,Staff,17,0,75,58
1650662295480,COGS 100,A01,083619,Staff,0,28,60,60
1650662301504,COGS 101A,A01,083621,Davis; Joshua Daniel,0,27,60,60
1650662307534,COGS 101B,A01,091572,Staff,0,4,60,60
1650662313558,COGS 101C,A01,083625,Delgado; Tania,14,0,30,16
1650662319583,COGS 107A,A01,083627,Boyle; Mary E. T.,1,17,60,59
1650662325606,COGS 118A,A01,083075,Staff,0,7,60,60
1650662331629,CSE 3,A50,083646,Miranda; Gregory Joseph,19,0,38,19
1650662331629,CSE 3,A51,083647,Miranda; Gregory Joseph,36,0,37,1
1650662337656,CSE 8A,A50,083650,Miranda; Gregory Joseph,0,30,40,40
1650662343679,CSE 11,A01,083080,Cao; Yingjun,0,95,40,40
1650662349716,CSE 12,A01,083652,Staff,0,19,100,100
1650662355739,CSE 15L,A01,083654,Staff,0,2,50,50
1650662355739,CSE 15L,A02,083655,Staff,0,1,50,50
1650662361765,CSE 20,A01,083657,Staff,51,0,80,29
1650662367788,CSE 30,A01,083084,Eldon; John,0,78,40,40
1650662373811,CSE 100,A01,083659,Cao; Yingjun,0,68,50,50
1650662379836,CSE 134B,A01,083661,Powell; Thomas Allan,0,38,65,65
1650662385865,CSE 140,A01,083663,Staff,0,9,75,75
1650662391889,CSE 140L,A01,083088,Eldon; John,0,17,75,75
1650662397916,CSE 175,A01,083665,Kumar; Rakesh,7,0,25,18
1650662403943,CSE 190,A00,092507,Dubnov; Shlomo,10,0,20,10
1650662409972,ECE 45,A01,083139,Staff,0,2,60,60
1650662415995,ECE 65,A50,083695,Staff,0,5,30,30
1650662422018,ECE 109,A01,091882,Touri; Behrouz,33,0,70,37
1650662428045,ECE 180,A00,083140,Abi Samra; Nicholas Camill,20,0,30,10
1650662428045,ECE 180,B00,083141,Abi Samra; Nicholas Camill,0,0,30,30
1650662434076,MATH 10A,A01,083735,Patchell; Gregory David,3,0,30,27
1650662434076,MATH 10A,A02,083736,Patchell; Gregory David,27,0,30,3
1650662434076,MATH 10A,A03,083737,Patchell; Gregory David,24,0,30,6
1650662440099,MATH 10B,A01,083207,Staff,0,9,30,30
1650662440099,MATH 10B,A02,083208,Staff,1,8,30,29
1650662440099,MATH 10B,B01,083739,Staff,11,0,30,19
1650662440099,MATH 10B,B02,083740,Staff,28,0,30,2
1650662446129,MATH 18,A01,083743,Staff,0,0,30,30
1650662446129,MATH 18,A02,083744,Staff,23,0,30,7
1650662446129,MATH 18,A03,083745,Staff,21,0,30,9
1650662446129,MATH 18,A04,083746,Staff,26,0,30,4
1650662446129,MATH 18,B01,083748,Staff,0,15,30,30
1650662446129,MATH 18,B02,083749,Staff,0,12,30,30
1650662446129,MATH 18,B03,083750,Staff,0,12,30,30
1650662446129,MATH 18,B04,083751,Staff,0,12,30,30
1650662452155,MATH 20A,A01,083754,Staff,19,0,40,21
1650662458182,MATH 20B,A01,083756,Staff,0,11,30,30
1650662458182,MATH 20B,A02,083757,Staff,0,12,30,30
1650662464216,MATH 20C,A01,083760,Staff,0,16,30,30
1650662464216,MATH 20C,A02,083761,Staff,1,14,30,29
1650662464216,MATH 20C,B01,083762,Staff,11,0,30,19
1650662464216,MATH 20C,B02,083763,Staff,28,0,30,2
1650662470256,MATH 20D,A01,083765,Staff,1,1,30,29
1650662470256,MATH 20D,A02,083766,Staff,6,0,30,24
1650662470256,MATH 20D,A03,083767,Staff,24,0,30,6
1650662476280,MATH 20E,A01,083771,Staff,3,0,30,27
1650662476280,MATH 20E,A02,083772,Staff,16,0,30,14
1650662476280,MATH 20E,B01,083773,Staff,0,0,30,30
1650662476280,MATH 20E,B02,083774,Staff,9,0,30,21
1650662482303,MATH 103A,A01,083777,Staff,0,15,30,30
1650662482303,MATH 103A,A02,083778,Staff,0,15,30,30
1650662482303,MATH 103A,B01,083779,Staff,0,14,30,30
1650662482303,MATH 103A,B02,083780,Staff,0,14,30,30
1650662488392,MATH 105,A01,085443,Staff,0,22,30,30
1650662494415,MATH 109,A01,083213,Anzaldo; Leesa B,0,7,30,30
1650662494415,MATH 109,A02,083214,Anzaldo; Leesa B,0,7,30,30
1650662494415,MATH 109,B01,083215,Anzaldo; Leesa B,0,8,30,30
1650662494415,MATH 109,B02,083216,Anzaldo; Leesa B,0,6,30,30
1650662500444,MATH 142A,A01,083219,Chow; Bennett,0,16,30,30
1650662500444,MATH 142A,A02,083220,Chow; Bennett,0,15,30,30
1650662500444,MATH 142A,B01,083221,Chow; Bennett,0,13,30,30
1650662500444,MATH 142A,B02,083222,Chow; Bennett,0,14,30,30
1650662506468,MATH 193A,A01,083224,Staff,0,5,30,30
1650662506468,MATH 193A,A02,083225,Staff,0,6,30,30
1650662506468,MATH 193A,A03,083781,Staff,0,6,30,30
1650662506468,MATH 193A,A04,083782,Staff,0,7,30,30
1650662512492,MATH 197,001,091859,McAuley; Julian John,9998,0,9999,1
1650662518567,COGS 9,A01,083615,Staff,1,16,60,59
1650662524591,COGS 11,A01,083617,Boyle; Mary E. T.,18,0,40,22
1650662530621,COGS 13,A01,083071,Staff,0,39,40,40
1650662536644,COGS 14A,A01,092681,Staff,0,32,100,100
1650662542672,COGS 14B,A01,083073,Cheng; Tzu-Han,1,14,50,49
1650662548698,COGS 17,A01,092677,Staff,17,0,75,58
1650662554722,COGS 100,A01,083619,Staff,0,28,60,60
1650662560748,COGS 101A,A01,083621,Davis; Joshua Daniel,0,27,60,60
1650662566776,COGS 101B,A01,091572,Staff,0,4,60,60
1650662572804,COGS 101C,A01,083625,Delgado; Tania,14,0,30,16
1650662578830,COGS 107A,A01,083627,Boyle; Mary E. T.,1,17,60,59
1650662584852,COGS 118A,A01,083075,Staff,0,7,60,60
1650662590876,CSE 3,A50,083646,Miranda; Gregory Joseph,19,0,38,19
1650662590876,CSE 3,A51,083647,Miranda; Gregory Joseph,36,0,37,1
1650662596904,CSE 8A,A50,083650,Miranda; Gregory Joseph,0,30,40,40
1650662602940,CSE 11,A01,083080,Cao; Yingjun,0,95,40,40
1650662608979,CSE 12,A01,083652,Staff,0,19,100,100
1650662615003,CSE 15L,A01,083654,Staff,0,2,50,50
1650662615003,CSE 15L,A02,083655,Staff,0,1,50,50
1650662621027,CSE 20,A01,083657,Staff,51,0,80,29
1650662627054,CSE 30,A01,083084,Eldon; John,0,78,40,40
1650662633079,CSE 100,A01,083659,Cao; Yingjun,0,68,50,50
1650662639108,CSE 134B,A01,083661,Powell; Thomas Allan,0,37,65,65
1650662645140,CSE 140,A01,083663,Staff,0,9,75,75
1650662651164,CSE 140L,A01,083088,Eldon; John,0,17,75,75
1650662657190,CSE 175,A01,083665,Kumar; Rakesh,7,0,25,18
1650662663219,CSE 190,A00,092507,Dubnov; Shlomo,10,0,20,10
1650662669242,ECE 45,A01,083139,Staff,0,2,60,60
1650662675280,ECE 65,A50,083695,Staff,0,5,30,30
1650662681309,ECE 109,A01,091882,Touri; Behrouz,33,0,70,37
1650662687437,ECE 180,A00,083140,Abi Samra; Nicholas Camill,20,0,30,10
1650662687437,ECE 180,B00,083141,Abi Samra; Nicholas Camill,0,0,30,30
1650662693485,MATH 10A,A01,083735,Patchell; Gregory David,3,0,30,27
1650662693485,MATH 10A,A02,083736,Patchell; Gregory David,27,0,30,3
1650662693485,MATH 10A,A03,083737,Patchell; Gregory David,24,0,30,6
1650662699509,MATH 10B,A01,083207,Staff,0,9,30,30
1650662699509,MATH 10B,A02,083208,Staff,1,8,30,29
1650662699509,MATH 10B,B01,083739,Staff,11,0,30,19
1650662699509,MATH 10B,B02,083740,Staff,28,0,30,2
1650662705553,MATH 18,A01,083743,Staff,0,0,30,30
1650662705553,MATH 18,A02,083744,Staff,23,0,30,7
1650662705553,MATH 18,A03,083745,Staff,21,0,30,9
1650662705553,MATH 18,A04,083746,Staff,26,0,30,4
1650662705553,MATH 18,B01,083748,Staff,0,15,30,30
1650662705553,MATH 18,B02,083749,Staff,0,12,30,30
1650662705553,MATH 18,B03,083750,Staff,0,12,30,30
1650662705553,MATH 18,B04,083751,Staff,0,12,30,30
1650662711591,MATH 20A,A01,083754,Staff,19,0,40,21
1650662717620,MATH 20B,A01,083756,Staff,0,11,30,30
1650662717620,MATH 20B,A02,083757,Staff,0,12,30,30
1650662723659,MATH 20C,A01,083760,Staff,0,16,30,30
1650662723659,MATH 20C,A02,083761,Staff,1,14,30,29
1650662723659,MATH 20C,B01,083762,Staff,11,0,30,19
1650662723659,MATH 20C,B02,083763,Staff,28,0,30,2
1650662729694,MATH 20D,A01,083765,Staff,1,1,30,29
1650662729694,MATH 20D,A02,083766,Staff,6,0,30,24
1650662729694,MATH 20D,A03,083767,Staff,24,0,30,6
1650662735722,MATH 20E,A01,083771,Staff,3,0,30,27
1650662735722,MATH 20E,A02,083772,Staff,16,0,30,14
1650662735722,MATH 20E,B01,083773,Staff,0,0,30,30
1650662735722,MATH 20E,B02,083774,Staff,9,0,30,21
1650662741764,MATH 103A,A01,083777,Staff,0,15,30,30
1650662741764,MATH 103A,A02,083778,Staff,0,15,30,30
1650662741764,MATH 103A,B01,083779,Staff,0,14,30,30
1650662741764,MATH 103A,B02,083780,Staff,0,14,30,30
1650662747794,MATH 105,A01,085443,Staff,0,22,30,30
1650662753825,MATH 109,A01,083213,Anzaldo; Leesa B,0,7,30,30
1650662753825,MATH 109,A02,083214,Anzaldo; Leesa B,0,7,30,30
1650662753825,MATH 109,B01,083215,Anzaldo; Leesa B,0,8,30,30
1650662753825,MATH 109,B02,083216,Anzaldo; Leesa B,0,6,30,30
1650662759852,MATH 142A,A01,083219,Chow; Bennett,0,16,30,30
1650662759852,MATH 142A,A02,083220,Chow; Bennett,0,15,30,30
1650662759852,MATH 142A,B01,083221,Chow; Bennett,0,13,30,30
1650662759852,MATH 142A,B02,083222,Chow; Bennett,0,14,30,30
1650662765876,MATH 193A,A01,083224,Staff,0,5,30,30
1650662765876,MATH 193A,A02,083225,Staff,0,6,30,30
1650662765876,MATH 193A,A03,083781,Staff,0,6,30,30
1650662765876,MATH 193A,A04,083782,Staff,0,7,30,30
1650662771903,MATH 197,001,091859,McAuley; Julian John,9998,0,9999,1
1650662777959,COGS 9,A01,083615,Staff,1,16,60,59
1650662783986,COGS 11,A01,083617,Boyle; Mary E. T.,18,0,40,22
1650662790019,COGS 13,A01,083071,Staff,0,39,40,40
1650662796045,COGS 14A,A01,092681,Staff,0,33,100,100
1650662802069,COGS 14B,A01,083073,Cheng; Tzu-Han,1,14,50,49
1650662808102,COGS 17,A01,092677,Staff,17,0,75,58
1650662814127,COGS 100,A01,083619,Staff,0,28,60,60
1650662820157,COGS 101A,A01,083621,Davis; Joshua Daniel,0,27,60,60
1650662826179,COGS 101B,A01,091572,Staff,0,4,60,60
1650662832210,COGS 101C,A01,083625,Delgado; Tania,14,0,30,16
1650662838237,COGS 107A,A01,083627,Boyle; Mary E. T.,1,17,60,59
1650662844272,COGS 118A,A01,083075,Staff,0,7,60,60
1650662850297,CSE 3,A50,083646,Miranda; Gregory Joseph,19,0,38,19
1650662850297,CSE 3,A51,083647,Miranda; Gregory Joseph,36,0,37,1
1650662856322,CSE 8A,A50,083650,Miranda; Gregory Joseph,0,30,40,40
1650662862348,CSE 11,A01,083080,Cao; Yingjun,0,95,40,40
1650662868371,CSE 12,A01,083652,Staff,0,19,100,100
1650662874412,CSE 15L,A01,083654,Staff,0,2,50,50
1650662874412,CSE 15L,A02,083655,Staff,0,1,50,50
1650662880435,CSE 20,A01,083657,Staff,51,0,80,29
1650662886471,CSE 30,A01,083084,Eldon; John,0,78,40,40
1650662892493,CSE 100,A01,083659,Cao; Yingjun,0,68,50,50
1650662898524,CSE 134B,A01,083661,Powell; Thomas Allan,0,37,65,65
1650662904554,CSE 140,A01,083663,Staff,0,9,75,75
1650662910578,CSE 140L,A01,083088,Eldon; John,0,17,75,75
1650662916601,CSE 175,A01,083665,Kumar; Rakesh,7,0,25,18
1650662922625,CSE 190,A00,092507,Dubnov; Shlomo,10,0,20,10
1650662928655,ECE 45,A01,083139,Staff,0,2,60,60
1650662934683,ECE 65,A50,083695,Staff,0,5,30,30
1650662940709,ECE 109,A01,091882,Touri; Behrouz,33,0,70,37
1650662946744,ECE 180,A00,083140,Abi Samra; Nicholas Camill,20,0,30,10
1650662946744,ECE 180,B00,083141,Abi Samra; Nicholas Camill,0,0,30,30
1650662952776,MATH 10A,A01,083735,Patchell; Gregory David,3,0,30,27
1650662952776,MATH 10A,A02,083736,Patchell; Gregory David,27,0,30,3
1650662952776,MATH 10A,A03,083737,Patchell; Gregory David,24,0,30,6
1650662958801,MATH 10B,A01,083207,Staff,0,9,30,30
1650662958801,MATH 10B,A02,083208,Staff,1,8,30,29
1650662958801,MATH 10B,B01,083739,Staff,11,0,30,19
1650662958801,MATH 10B,B02,083740,Staff,28,0,30,2
1650662964830,MATH 18,A01,083743,Staff,0,0,30,30
1650662964830,MATH 18,A02,083744,Staff,23,0,30,7
1650662964830,MATH 18,A03,083745,Staff,21,0,30,9
1650662964830,MATH 18,A04,083746,Staff,26,0,30,4
1650662964830,MATH 18,B01,083748,Staff,0,15,30,30
1650662964830,MATH 18,B02,083749,Staff,0,12,30,30
1650662964830,MATH 18,B03,083750,Staff,0,12,30,30
1650662964830,MATH 18,B04,083751,Staff,0,12,30,30
1650662970854,MATH 20A,A01,083754,Staff,19,0,40,21
1650662976878,MATH 20B,A01,083756,Staff,0,11,30,30
1650662976878,MATH 20B,A02,083757,Staff,0,12,30,30
1650662982905,MATH 20C,A01,083760,Staff,0,16,30,30
1650662982905,MATH 20C,A02,083761,Staff,1,14,30,29
1650662982905,MATH 20C,B01,083762,Staff,11,0,30,19
1650662982905,MATH 20C,B02,083763,Staff,28,0,30,2
1650662988930,MATH 20D,A01,083765,Staff,1,1,30,29
1650662988930,MATH 20D,A02,083766,Staff,6,0,30,24
1650662988930,MATH 20D,A03,083767,Staff,24,0,30,6
1650662994966,MATH 20E,A01,083771,Staff,3,0,30,27
1650662994966,MATH 20E,A02,083772,Staff,16,0,30,14
1650662994966,MATH 20E,B01,083773,Staff,0,0,30,30
1650662994966,MATH 20E,B02,083774,Staff,9,0,30,21
1650663001004,MATH 103A,A01,083777,Staff,0,15,30,30
1650663001004,MATH 103A,A02,083778,Staff,0,15,30,30
1650663001004,MATH 103A,B01,083779,Staff,0,14,30,30
1650663001004,MATH 103A,B02,083780,Staff,0,14,30,30
1650663007028,MATH 105,A01,085443,Staff,0,22,30,30
1650663013051,MATH 109,A01,083213,Anzaldo; Leesa B,0,7,30,30
1650663013051,MATH 109,A02,083214,Anzaldo; Leesa B,0,7,30,30
1650663013051,MATH 109,B01,083215,Anzaldo; Leesa B,0,8,30,30
1650663013051,MATH 109,B02,083216,Anzaldo; Leesa B,0,6,30,30
1650663019079,MATH 142A,A01,083219,Chow; Bennett,0,16,30,30
1650663019079,MATH 142A,A02,083220,Chow; Bennett,0,15,30,30
1650663019079,MATH 142A,B01,083221,Chow; Bennett,0,13,30,30
1650663019079,MATH 142A,B02,083222,Chow; Bennett,0,14,30,30
1650663025104,MATH 193A,A01,083224,Staff,0,5,30,30
1650663025104,MATH 193A,A02,083225,Staff,0,6,30,30
1650663025104,MATH 193A,A03,083781,Staff,0,6,30,30
1650663025104,MATH 193A,A04,083782,Staff,0,7,30,30
1650663031233,MATH 197,001,091859,McAuley; Julian John,9998,0,9999,1
1650663037293,COGS 9,A01,083615,Staff,1,16,60,59
1650663043319,COGS 11,A01,083617,Boyle; Mary E. T.,18,0,40,22
1650663049341,COGS 13,A01,083071,Staff,0,39,40,40
1650663055365,COGS 14A,A01,092681,Staff,0,33,100,100
1650663061400,COGS 14B,A01,083073,Cheng; Tzu-Han,1,14,50,49
1650663067424,COGS 17,A01,092677,Staff,16,0,75,59
1650663073451,COGS 100,A01,083619,Staff,0,28,60,60
1650663079477,COGS 101A,A01,083621,Davis; Joshua Daniel,0,27,60,60
1650663085504,COGS 101B,A01,091572,Staff,0,4,60,60
1650663091544,COGS 101C,A01,083625,Delgado; Tania,14,0,30,16
1650663097578,COGS 107A,A01,083627,Boyle; Mary E. T.,1,17,60,59
1650663103602,COGS 118A,A01,083075,Staff,0,7,60,60
1650663109640,CSE 3,A50,083646,Miranda; Gregory Joseph,19,0,38,19
1650663109640,CSE 3,A51,083647,Miranda; Gregory Joseph,36,0,37,1
1650663115668,CSE 8A,A50,083650,Miranda; Gregory Joseph,0,30,40,40
1650663121697,CSE 11,A01,083080,Cao; Yingjun,0,95,40,40
1650663127723,CSE 12,A01,083652,Staff,0,19,100,100
1650663133751,CSE 15L,A01,083654,Staff,0,2,50,50
1650663133751,CSE 15L,A02,083655,Staff,0,1,50,50
1650663139775,CSE 20,A01,083657,Staff,51,0,80,29
1650663145802,CSE 30,A01,083084,Eldon; John,0,78,40,40
1650663151835,CSE 100,A01,083659,Cao; Yingjun,0,68,50,50
1650663157862,CSE 134B,A01,083661,Powell; Thomas Allan,0,37,65,65
1650663163902,CSE 140,A01,083663,Staff,0,9,75,75
1650663169936,CSE 140L,A01,083088,Eldon; John,0,17,75,75
1650663175959,CSE 175,A01,083665,Kumar; Rakesh,7,0,25,18
1650663181993,CSE 190,A00,092507,Dubnov; Shlomo,10,0,20,10
1650663188027,ECE 45,A01,083139,Staff,0,2,60,60
1650663194052,ECE 65,A50,083695,Staff,0,5,30,30
1650663200092,ECE 109,A01,091882,Touri; Behrouz,33,0,70,37
1650663206118,ECE 180,A00,083140,Abi Samra; Nicholas Camill,20,0,30,10
1650663206118,ECE 180,B00,083141,Abi Samra; Nicholas Camill,0,0,30,30
1650663212144,MATH 10A,A01,083735,Patchell; Gregory David,3,0,30,27
1650663212144,MATH 10A,A02,083736,Patchell; Gregory David,27,0,30,3
1650663212144,MATH 10A,A03,083737,Patchell; Gregory David,24,0,30,6
1650663218173,MATH 10B,A01,083207,Staff,0,9,30,30
1650663218173,MATH 10B,A02,083208,Staff,1,8,30,29
1650663218173,MATH 10B,B01,083739,Staff,11,0,30,19
1650663218173,MATH 10B,B02,083740,Staff,28,0,30,2
1650663224199,MATH 18,A01,083743,Staff,0,0,30,30
1650663224199,MATH 18,A02,083744,Staff,23,0,30,7
1650663224199,MATH 18,A03,083745,Staff,21,0,30,9
1650663224199,MATH 18,A04,083746,Staff,26,0,30,4
1650663224199,MATH 18,B01,083748,Staff,0,15,30,30
1650663224199,MATH 18,B02,083749,Staff,0,12,30,30
1650663224199,MATH 18,B03,083750,Staff,0,12,30,30
1650663224199,MATH 18,B04,083751,Staff,0,12,30,30
1650663230222,MATH 20A,A01,083754,Staff,19,0,40,21
1650663236245,MATH 20B,A01,083756,Staff,0,11,30,30
1650663236245,MATH 20B,A02,083757,Staff,0,12,30,30
1650663242271,MATH 20C,A01,083760,Staff,0,16,30,30
1650663242271,MATH 20C,A02,083761,Staff,1,14,30,29
1650663242271,MATH 20C,B01,083762,Staff,11,0,30,19
1650663242271,MATH 20C,B02,083763,Staff,28,0,30,2
1650663248296,MATH 20D,A01,083765,Staff,1,1,30,29
1650663248296,MATH 20D,A02,083766,Staff,6,0,30,24
1650663248296,MATH 20D,A03,083767,Staff,24,0,30,6
1650663254320,MATH 20E,A01,083771,Staff,3,0,30,27
1650663254320,MATH 20E,A02,083772,Staff,16,0,30,14
1650663254320,MATH 20E,B01,083773,Staff,0,0,30,30
1650663254320,MATH 20E,B02,083774,Staff,9,0,30,21
1650663260361,MATH 103A,A01,083777,Staff,0,15,30,30
1650663260361,MATH 103A,A02,083778,Staff,0,15,30,30
1650663260361,MATH 103A,B01,083779,Staff,0,14,30,30
1650663260361,MATH 103A,B02,083780,Staff,0,14,30,30
1650663266393,MATH 105,A01,085443,Staff,0,22,30,30
1650663272435,MATH 109,A01,083213,Anzaldo; Leesa B,0,7,30,30
1650663272435,MATH 109,A02,083214,Anzaldo; Leesa B,0,7,30,30
1650663272435,MATH 109,B01,083215,Anzaldo; Leesa B,0,8,30,30
1650663272435,MATH 109,B02,083216,Anzaldo; Leesa B,0,6,30,30
1650663278457,MATH 142A,A01,083219,Chow; Bennett,0,16,30,30
1650663278457,MATH 142A,A02,083220,Chow; Bennett,0,15,30,30
1650663278457,MATH 142A,B01,083221,Chow; Bennett,0,13,30,30
1650663278457,MATH 142A,B02,083222,Chow; Bennett,0,14,30,30
1650663284586,MATH 193A,A01,083224,Staff,0,5,30,30
1650663284586,MATH 193A,A02,083225,Staff,0,6,30,30
1650663284586,MATH 193A,A03,083781,Staff,0,6,30,30
1650663284586,MATH 193A,A04,083782,Staff,0,7,30,30
1650663290611,MATH 197,001,091859,McAuley; Julian John,9998,0,9999,1
1650663296667,COGS 9,A01,083615,Staff,1,16,60,59
1650663302703,COGS 11,A01,083617,Boyle; Mary E. T.,18,0,40,22
1650663308734,COGS 13,A01,083071,Staff,0,39,40,40
1650663314759,COGS 14A,A01,092681,Staff,0,33,100,100
1650663320782,COGS 14B,A01,083073,Cheng; Tzu-Han,1,14,50,49
1650663326805,COGS 17,A01,092677,Staff,16,0,75,59
1650663332828,COGS 100,A01,083619,Staff,0,28,60,60
1650663338850,COGS 101A,A01,083621,Davis; Joshua Daniel,0,27,60,60
1650663344889,COGS 101B,A01,091572,Staff,0,4,60,60
1650663350914,COGS 101C,A01,083625,Delgado; Tania,14,0,30,16
1650663356936,COGS 107A,A01,083627,Boyle; Mary E. T.,1,17,60,59
1650663362967,COGS 118A,A01,083075,Staff,0,7,60,60
1650663368991,CSE 3,A50,083646,Miranda; Gregory Joseph,19,0,38,19
1650663368991,CSE 3,A51,083647,Miranda; Gregory Joseph,36,0,37,1
1650663375028,CSE 8A,A50,083650,Miranda; Gregory Joseph,0,30,40,40
1650663381053,CSE 11,A01,083080,Cao; Yingjun,0,95,40,40
1650663387078,CSE 12,A01,083652,Staff,0,19,100,100
1650663393102,CSE 15L,A01,083654,Staff,0,2,50,50
1650663393102,CSE 15L,A02,083655,Staff,0,1,50,50
1650663399124,CSE 20,A01,083657,Staff,51,0,80,29
1650663405151,CSE 30,A01,083084,Eldon; John,0,78,40,40
1650663411176,CSE 100,A01,083659,Cao; Yingjun,0,68,50,50
1650663417199,CSE 134B,A01,083661,Powell; Thomas Allan,0,37,65,65
1650663423233,CSE 140,A01,083663,Staff,0,9,75,75
1650663429257,CSE 140L,A01,083088,Eldon; John,0,17,75,75
1650663435285,CSE 175,A01,083665,Kumar; Rakesh,7,0,25,18
1650663441319,CSE 190,A00,092507,Dubnov; Shlomo,10,0,20,10
1650663447342,ECE 45,A01,083139,Staff,0,2,60,60
1650663453364,ECE 65,A50,083695,Staff,0,5,30,30
1650663459391,ECE 109,A01,091882,Touri; Behrouz,33,0,70,37
1650663465414,ECE 180,A00,083140,Abi Samra; Nicholas Camill,20,0,30,10
1650663465414,ECE 180,B00,083141,Abi Samra; Nicholas Camill,0,0,30,30
1650663471438,MATH 10A,A01,083735,Patchell; Gregory David,3,0,30,27
1650663471438,MATH 10A,A02,083736,Patchell; Gregory David,27,0,30,3
1650663471438,MATH 10A,A03,083737,Patchell; Gregory David,24,0,30,6
1650663477463,MATH 10B,A01,083207,Staff,0,9,30,30
1650663477463,MATH 10B,A02,083208,Staff,1,8,30,29
1650663477463,MATH 10B,B01,083739,Staff,11,0,30,19
1650663477463,MATH 10B,B02,083740,Staff,28,0,30,2
1650663483488,MATH 18,A01,083743,Staff,0,0,30,30
1650663483488,MATH 18,A02,083744,Staff,23,0,30,7
1650663483488,MATH 18,A03,083745,Staff,21,0,30,9
1650663483488,MATH 18,A04,083746,Staff,26,0,30,4
1650663483488,MATH 18,B01,083748,Staff,0,15,30,30
1650663483488,MATH 18,B02,083749,Staff,0,12,30,30
1650663483488,MATH 18,B03,083750,Staff,0,12,30,30
1650663483488,MATH 18,B04,083751,Staff,0,12,30,30
1650663489513,MATH 20A,A01,083754,Staff,19,0,40,21
1650663495537,MATH 20B,A01,083756,Staff,0,11,30,30
1650663495537,MATH 20B,A02,083757,Staff,0,12,30,30
1650663501574,MATH 20C,A01,083760,Staff,0,16,30,30
1650663501574,MATH 20C,A02,083761,Staff,1,14,30,29
1650663501574,MATH 20C,B01,083762,Staff,11,0,30,19
1650663501574,MATH 20C,B02,083763,Staff,28,0,30,2
1650663507598,MATH 20D,A01,083765,Staff,1,1,30,29
1650663507598,MATH 20D,A02,083766,Staff,6,0,30,24
1650663507598,MATH 20D,A03,083767,Staff,24,0,30,6
1650663513627,MATH 20E,A01,083771,Staff,3,0,30,27
1650663513627,MATH 20E,A02,083772,Staff,16,0,30,14
1650663513627,MATH 20E,B01,083773,Staff,0,0,30,30
1650663513627,MATH 20E,B02,083774,Staff,9,0,30,21
1650663519648,MATH 103A,A01,083777,Staff,0,15,30,30
1650663519648,MATH 103A,A02,083778,Staff,0,15,30,30
1650663519648,MATH 103A,B01,083779,Staff,0,14,30,30
1650663519648,MATH 103A,B02,083780,Staff,0,14,30,30
1650663525672,MATH 105,A01,085443,Staff,0,22,30,30
1650663531710,MATH 109,A01,083213,Anzaldo; Leesa B,0,7,30,30
1650663531710,MATH 109,A02,083214,Anzaldo; Leesa B,0,7,30,30
1650663531710,MATH 109,B01,083215,Anzaldo; Leesa B,0,8,30,30
1650663531710,MATH 109,B02,083216,Anzaldo; Leesa B,0,6,30,30
1650663537733,MATH 142A,A01,083219,Chow; Bennett,0,16,30,30
1650663537733,MATH 142A,A02,083220,Chow; Bennett,0,15,30,30
1650663537733,MATH 142A,B01,083221,Chow; Bennett,0,13,30,30
1650663537733,MATH 142A,B02,083222,Chow; Bennett,0,14,30,30
1650663543757,MATH 193A,A01,083224,Staff,0,5,30,30
1650663543757,MATH 193A,A02,083225,Staff,0,6,30,30
1650663543757,MATH 193A,A03,083781,Staff,0,6,30,30
1650663543757,MATH 193A,A04,083782,Staff,0,7,30,30
1650663549781,MATH 197,001,091859,McAuley; Julian John,9998,0,9999,1
1650663555828,COGS 9,A01,083615,Staff,1,16,60,59
1650663561860,COGS 11,A01,083617,Boyle; Mary E. T.,18,0,40,22
1650663567885,COGS 13,A01,083071,Staff,0,39,40,40
1650663573916,COGS 14A,A01,092681,Staff,0,33,100,100
1650663579945,COGS 14B,A01,083073,Cheng; Tzu-Han,1,14,50,49
1650663585975,COGS 17,A01,092677,Staff,16,0,75,59
1650663592002,COGS 100,A01,083619,Staff,0,28,60,60
1650663598026,COGS 101A,A01,083621,Davis; Joshua Daniel,0,27,60,60
1650663604050,COGS 101B,A01,091572,Staff,0,4,60,60
1650663610096,COGS 101C,A01,083625,Delgado; Tania,14,0,30,16
1650663616119,COGS 107A,A01,083627,Boyle; Mary E. T.,1,17,60,59
1650663622149,COGS 118A,A01,083075,Staff,0,7,60,60
1650663628182,CSE 3,A50,083646,Miranda; Gregory Joseph,19,0,38,19
1650663628182,CSE 3,A51,083647,Miranda; Gregory Joseph,36,0,37,1
1650663634209,CSE 8A,A50,083650,Miranda; Gregory Joseph,0,30,40,40
1650663640239,CSE 11,A01,083080,Cao; Yingjun,0,95,40,40
1650663646262,CSE 12,A01,083652,Staff,0,19,100,100
1650663652289,CSE 15L,A01,083654,Staff,0,2,50,50
1650663652289,CSE 15L,A02,083655,Staff,0,1,50,50
1650663658313,CSE 20,A01,083657,Staff,51,0,80,29
1650663664341,CSE 30,A01,083084,Eldon; John,0,78,40,40
1650663670365,CSE 100,A01,083659,Cao; Yingjun,0,68,50,50
1650663676389,CSE 134B,A01,083661,Powell; Thomas Allan,0,37,65,65
1650663682413,CSE 140,A01,083663,Staff,0,9,75,75
1650663688444,CSE 140L,A01,083088,Eldon; John,0,17,75,75
1650663694482,CSE 175,A01,083665,Kumar; Rakesh,7,0,25,18
1650663700504,CSE 190,A00,092507,Dubnov; Shlomo,10,0,20,10
1650663706531,ECE 45,A01,083139,Staff,0,2,60,60
1650663712563,ECE 65,A50,083695,Staff,0,5,30,30
1650663718591,ECE 109,A01,091882,Touri; Behrouz,33,0,70,37
1650663724616,ECE 180,A00,083140,Abi Samra; Nicholas Camill,20,0,30,10
1650663724616,ECE 180,B00,083141,Abi Samra; Nicholas Camill,0,0,30,30
1650663730644,MATH 10A,A01,083735,Patchell; Gregory David,3,0,30,27
1650663730644,MATH 10A,A02,083736,Patchell; Gregory David,27,0,30,3
1650663730644,MATH 10A,A03,083737,Patchell; Gregory David,24,0,30,6
1650663736677,MATH 10B,A01,083207,Staff,0,9,30,30
1650663736677,MATH 10B,A02,083208,Staff,1,8,30,29
1650663736677,MATH 10B,B01,083739,Staff,11,0,30,19
1650663736677,MATH 10B,B02,083740,Staff,28,0,30,2
1650663742708,MATH 18,A01,083743,Staff,0,0,30,30
1650663742708,MATH 18,A02,083744,Staff,23,0,30,7
1650663742708,MATH 18,A03,083745,Staff,21,0,30,9
1650663742708,MATH 18,A04,083746,Staff,26,0,30,4
1650663742708,MATH 18,B01,083748,Staff,0,15,30,30
1650663742708,MATH 18,B02,083749,Staff,0,12,30,30
1650663742708,MATH 18,B03,083750,Staff,0,12,30,30
1650663742708,MATH 18,B04,083751,Staff,0,12,30,30
1650663748740,MATH 20A,A01,083754,Staff,19,0,40,21
1650663754765,MATH 20B,A01,083756,Staff,0,11,30,30
1650663754765,MATH 20B,A02,083757,Staff,0,12,30,30
1650663760794,MATH 20C,A01,083760,Staff,0,16,30,30
1650663760794,MATH 20C,A02,083761,Staff,1,14,30,29
1650663760794,MATH 20C,B01,083762,Staff,11,0,30,19
1650663760794,MATH 20C,B02,083763,Staff,28,0,30,2
1650663766826,MATH 20D,A01,083765,Staff,1,1,30,29
1650663766826,MATH 20D,A02,083766,Staff,6,0,30,24
1650663766826,MATH 20D,A03,083767,Staff,24,0,30,6
1650663772850,MATH 20E,A01,083771,Staff,3,0,30,27
1650663772850,MATH 20E,A02,083772,Staff,16,0,30,14
1650663772850,MATH 20E,B01,083773,Staff,0,0,30,30
1650663772850,MATH 20E,B02,083774,Staff,9,0,30,21
1650663778878,MATH 103A,A01,083777,Staff,0,15,30,30
1650663778878,MATH 103A,A02,083778,Staff,0,15,30,30
1650663778878,MATH 103A,B01,083779,Staff,0,14,30,30
1650663778878,MATH 103A,B02,083780,Staff,0,14,30,30
1650663784910,MATH 105,A01,085443,Staff,0,22,30,30
1650663790933,MATH 109,A01,083213,Anzaldo; Leesa B,0,7,30,30
1650663790933,MATH 109,A02,083214,Anzaldo; Leesa B,0,7,30,30
1650663790933,MATH 109,B01,083215,Anzaldo; Leesa B,0,8,30,30
1650663790933,MATH 109,B02,083216,Anzaldo; Leesa B,0,6,30,30
1650663796960,MATH 142A,A01,083219,Chow; Bennett,0,16,30,30
1650663796960,MATH 142A,A02,083220,Chow; Bennett,0,15,30,30
1650663796960,MATH 142A,B01,083221,Chow; Bennett,0,13,30,30
1650663796960,MATH 142A,B02,083222,Chow; Bennett,0,14,30,30
1650663802988,MATH 193A,A01,083224,Staff,0,5,30,30
1650663802988,MATH 193A,A02,083225,Staff,0,6,30,30
1650663802988,MATH 193A,A03,083781,Staff,0,6,30,30
1650663802988,MATH 193A,A04,083782,Staff,0,7,30,30
1650663809025,MATH 197,001,091859,McAuley; Julian John,9998,0,9999,1
1650663815093,COGS 9,A01,083615,Staff,1,16,60,59
1650663821120,COGS 11,A01,083617,Boyle; Mary E. T.,18,0,40,22
1650663827148,COGS 13,A01,083071,Staff,0,39,40,40
1650663833172,COGS 14A,A01,092681,Staff,0,33,100,100
1650663839196,COGS 14B,A01,083073,Cheng; Tzu-Han,1,14,50,49
1650663845226,COGS 17,A01,092677,Staff,16,0,75,59
1650663851251,COGS 100,A01,083619,Staff,0,28,60,60
1650663857275,COGS 101A,A01,083621,Davis; Joshua Daniel,0,27,60,60
1650663863300,COGS 101B,A01,091572,Staff,0,4,60,60
1650663869328,COGS 101C,A01,083625,Delgado; Tania,14,0,30,16
1650663875453,COGS 107A,A01,083627,Boyle; Mary E. T.,1,17,60,59
1650663881479,COGS 118A,A01,083075,Staff,0,7,60,60
1650663887510,CSE 3,A50,083646,Miranda; Gregory Joseph,19,0,38,19
1650663887510,CSE 3,A51,083647,Miranda; Gregory Joseph,36,0,37,1
1650663893536,CSE 8A,A50,083650,Miranda; Gregory Joseph,0,30,40,40
1650663899566,CSE 11,A01,083080,Cao; Yingjun,0,95,40,40
1650663905594,CSE 12,A01,083652,Staff,0,19,100,100
1650663911617,CSE 15L,A01,083654,Staff,0,2,50,50
1650663911617,CSE 15L,A02,083655,Staff,0,1,50,50
1650663917640,CSE 20,A01,083657,Staff,51,0,80,29
1650663923669,CSE 30,A01,083084,Eldon; John,0,78,40,40
1650663929692,CSE 100,A01,083659,Cao; Yingjun,0,68,50,50
1650663935720,CSE 134B,A01,083661,Powell; Thomas Allan,0,37,65,65
1650663941746,CSE 140,A01,083663,Staff,0,9,75,75
1650663947776,CSE 140L,A01,083088,Eldon; John,0,17,75,75
1650663953806,CSE 175,A01,083665,Kumar; Rakesh,7,0,25,18
1650663959831,CSE 190,A00,092507,Dubnov; Shlomo,10,0,20,10
1650663965857,ECE 45,A01,083139,Staff,0,2,60,60
1650663971880,ECE 65,A50,083695,Staff,0,5,30,30
1650663977906,ECE 109,A01,091882,Touri; Behrouz,33,0,70,37
1650663983929,ECE 180,A00,083140,Abi Samra; Nicholas Camill,20,0,30,10
1650663983929,ECE 180,B00,083141,Abi Samra; Nicholas Camill,0,0,30,30
1650663989953,MATH 10A,A01,083735,Patchell; Gregory David,3,0,30,27
1650663989953,MATH 10A,A02,083736,Patchell; Gregory David,27,0,30,3
1650663989953,MATH 10A,A03,083737,Patchell; Gregory David,24,0,30,6
1650663995987,MATH 10B,A01,083207,Staff,0,9,30,30
1650663995987,MATH 10B,A02,083208,Staff,1,8,30,29
1650663995987,MATH 10B,B01,083739,Staff,11,0,30,19
1650663995987,MATH 10B,B02,083740,Staff,28,0,30,2
1650664002010,MATH 18,A01,083743,Staff,0,0,30,30
1650664002010,MATH 18,A02,083744,Staff,23,0,30,7
1650664002010,MATH 18,A03,083745,Staff,21,0,30,9
1650664002010,MATH 18,A04,083746,Staff,26,0,30,4
1650664002010,MATH 18,B01,083748,Staff,0,15,30,30
1650664002010,MATH 18,B02,083749,Staff,0,12,30,30
1650664002010,MATH 18,B03,083750,Staff,0,12,30,30
1650664002010,MATH 18,B04,083751,Staff,0,12,30,30
1650664008034,MATH 20A,A01,083754,Staff,19,0,40,21
1650664014060,MATH 20B,A01,083756,Staff,0,11,30,30
1650664014060,MATH 20B,A02,083757,Staff,0,12,30,30
1650664020086,MATH 20C,A01,083760,Staff,0,16,30,30
1650664020086,MATH 20C,A02,083761,Staff,1,14,30,29
1650664020086,MATH 20C,B01,083762,Staff,11,0,30,19
1650664020086,MATH 20C,B02,083763,Staff,28,0,30,2
1650664026116,MATH 20D,A01,083765,Staff,1,1,30,29
1650664026116,MATH 20D,A02,083766,Staff,6,0,30,24
1650664026116,MATH 20D,A03,083767,Staff,24,0,30,6
1650664032139,MATH 20E,A01,083771,Staff,3,0,30,27
1650664032139,MATH 20E,A02,083772,Staff,16,0,30,14
1650664032139,MATH 20E,B01,083773,Staff,0,0,30,30
1650664032139,MATH 20E,B02,083774,Staff,9,0,30,21
1650664038167,MATH 103A,A01,083777,Staff,0,15,30,30
1650664038167,MATH 103A,A02,083778,Staff,0,15,30,30
1650664038167,MATH 103A,B01,083779,Staff,0,14,30,30
1650664038167,MATH 103A,B02,083780,Staff,0,14,30,30
1650664044190,MATH 105,A01,085443,Staff,0,22,30,30
1650664050220,MATH 109,A01,083213,Anzaldo; Leesa B,0,7,30,30
1650664050220,MATH 109,A02,083214,Anzaldo; Leesa B,0,7,30,30
1650664050220,MATH 109,B01,083215,Anzaldo; Leesa B,0,8,30,30
1650664050220,MATH 109,B02,083216,Anzaldo; Leesa B,0,6,30,30
1650664056244,MATH 142A,A01,083219,Chow; Bennett,0,16,30,30
1650664056244,MATH 142A,A02,083220,Chow; Bennett,0,15,30,30
1650664056244,MATH 142A,B01,083221,Chow; Bennett,0,13,30,30
1650664056244,MATH 142A,B02,083222,Chow; Bennett,0,14,30,30
1650664062267,MATH 193A,A01,083224,Staff,0,5,30,30
1650664062267,MATH 193A,A02,083225,Staff,0,6,30,30
1650664062267,MATH 193A,A03,083781,Staff,0,6,30,30
1650664062267,MATH 193A,A04,083782,Staff,0,7,30,30
1650664068290,MATH 197,001,091859,McAuley; Julian John,9998,0,9999,1
1650664074359,COGS 9,A01,083615,Staff,1,16,60,59
1650664080382,COGS 11,A01,083617,Boyle; Mary E. T.,18,0,40,22
1650664086406,COGS 13,A01,083071,Staff,0,39,40,40
1650664092441,COGS 14A,A01,092681,Staff,0,33,100,100
1650664098472,COGS 14B,A01,083073,Cheng; Tzu-Han,1,14,50,49
1650664104495,COGS 17,A01,092677,Staff,16,0,75,59
1650664110516,COGS 100,A01,083619,Staff,0,28,60,60
1650664116542,COGS 101A,A01,083621,Davis; Joshua Daniel,0,27,60,60
1650664122564,COGS 101B,A01,091572,Staff,0,4,60,60
1650664128611,COGS 101C,A01,083625,Delgado; Tania,14,0,30,16
1650664134642,COGS 107A,A01,083627,Boyle; Mary E. T.,1,17,60,59
1650664140665,COGS 118A,A01,083075,Staff,0,7,60,60
1650664146691,CSE 3,A50,083646,Miranda; Gregory Joseph,19,0,38,19
1650664146691,CSE 3,A51,083647,Miranda; Gregory Joseph,36,0,37,1
1650664152713,CSE 8A,A50,083650,Miranda; Gregory Joseph,0,30,40,40
1650664158737,CSE 11,A01,083080,Cao; Yingjun,0,95,40,40
1650664164759,CSE 12,A01,083652,Staff,0,19,100,100
1650664170783,CSE 15L,A01,083654,Staff,0,2,50,50
1650664170783,CSE 15L,A02,083655,Staff,0,1,50,50
1650664176808,CSE 20,A01,083657,Staff,50,0,80,30
1650664182841,CSE 30,A01,083084,Eldon; John,0,78,40,40
1650664188866,CSE 100,A01,083659,Cao; Yingjun,0,68,50,50
1650664194897,CSE 134B,A01,083661,Powell; Thomas Allan,0,37,65,65
1650664200919,CSE 140,A01,083663,Staff,0,9,75,75
1650664206943,CSE 140L,A01,083088,Eldon; John,0,17,75,75
1650664212972,CSE 175,A01,083665,Kumar; Rakesh,7,0,25,18
1650664218999,CSE 190,A00,092507,Dubnov; Shlomo,10,0,20,10
1650664225028,ECE 45,A01,083139,Staff,0,2,60,60
1650664231067,ECE 65,A50,083695,Staff,0,5,30,30
1650664237099,ECE 109,A01,091882,Touri; Behrouz,33,0,70,37
1650664243128,ECE 180,A00,083140,Abi Samra; Nicholas Camill,20,0,30,10
1650664243128,ECE 180,B00,083141,Abi Samra; Nicholas Camill,0,0,30,30
1650664249165,MATH 10A,A01,083735,Patchell; Gregory David,3,0,30,27
1650664249165,MATH 10A,A02,083736,Patchell; Gregory David,27,0,30,3
1650664249165,MATH 10A,A03,083737,Patchell; Gregory David,24,0,30,6
1650664255194,MATH 10B,A01,083207,Staff,0,9,30,30
1650664255194,MATH 10B,A02,083208,Staff,1,8,30,29
1650664255194,MATH 10B,B01,083739,Staff,11,0,30,19
1650664255194,MATH 10B,B02,083740,Staff,28,0,30,2
1650664261220,MATH 18,A01,083743,Staff,0,0,30,30
1650664261220,MATH 18,A02,083744,Staff,23,0,30,7
1650664261220,MATH 18,A03,083745,Staff,21,0,30,9
1650664261220,MATH 18,A04,083746,Staff,26,0,30,4
1650664261220,MATH 18,B01,083748,Staff,0,15,30,30
1650664261220,MATH 18,B02,083749,Staff,0,12,30,30
1650664261220,MATH 18,B03,083750,Staff,0,12,30,30
1650664261220,MATH 18,B04,083751,Staff,0,11,30,30
1650664267244,MATH 20A,A01,083754,Staff,19,0,40,21
1650664273268,MATH 20B,A01,083756,Staff,0,11,30,30
1650664273268,MATH 20B,A02,083757,Staff,0,12,30,30
1650664279295,MATH 20C,A01,083760,Staff,0,16,30,30
1650664279295,MATH 20C,A02,083761,Staff,1,14,30,29
1650664279295,MATH 20C,B01,083762,Staff,11,0,30,19
1650664279295,MATH 20C,B02,083763,Staff,28,0,30,2
1650664285317,MATH 20D,A01,083765,Staff,1,1,30,29
1650664285317,MATH 20D,A02,083766,Staff,6,0,30,24
1650664285317,MATH 20D,A03,083767,Staff,24,0,30,6
1650664291345,MATH 20E,A01,083771,Staff,3,0,30,27
1650664291345,MATH 20E,A02,083772,Staff,16,0,30,14
1650664291345,MATH 20E,B01,083773,Staff,0,0,30,30
1650664291345,MATH 20E,B02,083774,Staff,9,0,30,21
1650664297374,MATH 103A,A01,083777,Staff,0,15,30,30
1650664297374,MATH 103A,A02,083778,Staff,0,15,30,30
1650664297374,MATH 103A,B01,083779,Staff,0,14,30,30
1650664297374,MATH 103A,B02,083780,Staff,0,14,30,30
1650664303405,MATH 105,A01,085443,Staff,0,22,30,30
1650664309433,MATH 109,A01,083213,Anzaldo; Leesa B,0,7,30,30
1650664309433,MATH 109,A02,083214,Anzaldo; Leesa B,0,7,30,30
1650664309433,MATH 109,B01,083215,Anzaldo; Leesa B,0,8,30,30
1650664309433,MATH 109,B02,083216,Anzaldo; Leesa B,0,6,30,30
1650664315461,MATH 142A,A01,083219,Chow; Bennett,0,16,30,30
1650664315461,MATH 142A,A02,083220,Chow; Bennett,0,15,30,30
1650664315461,MATH 142A,B01,083221,Chow; Bennett,0,13,30,30
1650664315461,MATH 142A,B02,083222,Chow; Bennett,0,14,30,30
1650664321486,MATH 193A,A01,083224,Staff,0,5,30,30
1650664321486,MATH 193A,A02,083225,Staff,0,6,30,30
1650664321486,MATH 193A,A03,083781,Staff,0,6,30,30
1650664321486,MATH 193A,A04,083782,Staff,0,7,30,30
1650664327533,MATH 197,001,091859,McAuley; Julian John,9998,0,9999,1
1650664333591,COGS 9,A01,083615,Staff,1,16,60,59
1650664339614,COGS 11,A01,083617,Boyle; Mary E. T.,18,0,40,22
1650664345639,COGS 13,A01,083071,Staff,0,39,40,40
1650664351663,COGS 14A,A01,092681,Staff,0,33,100,100
1650664357693,COGS 14B,A01,083073,Cheng; Tzu-Han,1,14,50,49
1650664363720,COGS 17,A01,092677,Staff,16,0,75,59
1650664369746,COGS 100,A01,083619,Staff,0,28,60,60
1650664375772,COGS 101A,A01,083621,Davis; Joshua Daniel,0,27,60,60
1650664381797,COGS 101B,A01,091572,Staff,0,4,60,60
1650664387825,COGS 101C,A01,083625,Delgado; Tania,14,0,30,16
1650664393852,COGS 107A,A01,083627,Boyle; Mary E. T.,1,17,60,59
1650664399879,COGS 118A,A01,083075,Staff,0,7,60,60
1650664405906,CSE 3,A50,083646,Miranda; Gregory Joseph,19,0,38,19
1650664405906,CSE 3,A51,083647,Miranda; Gregory Joseph,36,0,37,1
1650664411929,CSE 8A,A50,083650,Miranda; Gregory Joseph,0,30,40,40
1650664417953,CSE 11,A01,083080,Cao; Yingjun,0,95,40,40
1650664423988,CSE 12,A01,083652,Staff,0,19,100,100
1650664430010,CSE 15L,A01,083654,Staff,0,2,50,50
1650664430010,CSE 15L,A02,083655,Staff,0,1,50,50
1650664436037,CSE 20,A01,083657,Staff,50,0,80,30
1650664442061,CSE 30,A01,083084,Eldon; John,0,78,40,40
1650664448087,CSE 100,A01,083659,Cao; Yingjun,0,68,50,50
1650664454115,CSE 134B,A01,083661,Powell; Thomas Allan,0,37,65,65
1650664460137,CSE 140,A01,083663,Staff,0,9,75,75
1650664466165,CSE 140L,A01,083088,Eldon; John,0,17,75,75
1650664472275,CSE 175,A01,083665,Kumar; Rakesh,7,0,25,18
1650664478301,CSE 190,A00,092507,Dubnov; Shlomo,10,0,20,10
1650664484325,ECE 45,A01,083139,Staff,0,2,60,60
1650664490351,ECE 65,A50,083695,Staff,0,5,30,30
1650664496387,ECE 109,A01,091882,Touri; Behrouz,33,0,70,37
1650664502412,ECE 180,A00,083140,Abi Samra; Nicholas Camill,20,0,30,10
1650664502412,ECE 180,B00,083141,Abi Samra; Nicholas Camill,0,0,30,30
1650664508439,MATH 10A,A01,083735,Patchell; Gregory David,3,0,30,27
1650664508439,MATH 10A,A02,083736,Patchell; Gregory David,27,0,30,3
1650664508439,MATH 10A,A03,083737,Patchell; Gregory David,24,0,30,6
1650664514463,MATH 10B,A01,083207,Staff,0,9,30,30
1650664514463,MATH 10B,A02,083208,Staff,1,8,30,29
1650664514463,MATH 10B,B01,083739,Staff,11,0,30,19
1650664514463,MATH 10B,B02,083740,Staff,28,0,30,2
1650664520486,MATH 18,A01,083743,Staff,0,0,30,30
1650664520486,MATH 18,A02,083744,Staff,23,0,30,7
1650664520486,MATH 18,A03,083745,Staff,21,0,30,9
1650664520486,MATH 18,A04,083746,Staff,26,0,30,4
1650664520486,MATH 18,B01,083748,Staff,0,15,30,30
1650664520486,MATH 18,B02,083749,Staff,0,12,30,30
1650664520486,MATH 18,B03,083750,Staff,0,12,30,30
1650664520486,MATH 18,B04,083751,Staff,0,11,30,30
1650664526510,MATH 20A,A01,083754,Staff,19,0,40,21
1650664532543,MATH 20B,A01,083756,Staff,0,11,30,30
1650664532543,MATH 20B,A02,083757,Staff,0,12,30,30
1650664538567,MATH 20C,A01,083760,Staff,0,16,30,30
1650664538567,MATH 20C,A02,083761,Staff,1,14,30,29
1650664538567,MATH 20C,B01,083762,Staff,11,0,30,19
1650664538567,MATH 20C,B02,083763,Staff,28,0,30,2
1650664544600,MATH 20D,A01,083765,Staff,1,1,30,29
1650664544600,MATH 20D,A02,083766,Staff,6,0,30,24
1650664544600,MATH 20D,A03,083767,Staff,24,0,30,6
1650664550628,MATH 20E,A01,083771,Staff,3,0,30,27
1650664550628,MATH 20E,A02,083772,Staff,16,0,30,14
1650664550628,MATH 20E,B01,083773,Staff,0,0,30,30
1650664550628,MATH 20E,B02,083774,Staff,9,0,30,21
1650664556662,MATH 103A,A01,083777,Staff,0,15,30,30
1650664556662,MATH 103A,A02,083778,Staff,0,15,30,30
1650664556662,MATH 103A,B01,083779,Staff,0,14,30,30
1650664556662,MATH 103A,B02,083780,Staff,0,14,30,30
1650664562697,MATH 105,A01,085443,Staff,0,22,30,30
1650664568722,MATH 109,A01,083213,Anzaldo; Leesa B,0,7,30,30
1650664568722,MATH 109,A02,083214,Anzaldo; Leesa B,0,7,30,30
1650664568722,MATH 109,B01,083215,Anzaldo; Leesa B,0,8,30,30
1650664568722,MATH 109,B02,083216,Anzaldo; Leesa B,0,6,30,30
1650664574750,MATH 142A,A01,083219,Chow; Bennett,0,16,30,30
1650664574750,MATH 142A,A02,083220,Chow; Bennett,0,15,30,30
1650664574750,MATH 142A,B01,083221,Chow; Bennett,0,13,30,30
1650664574750,MATH 142A,B02,083222,Chow; Bennett,0,14,30,30
1650664580788,MATH 193A,A01,083224,Staff,0,5,30,30
1650664580788,MATH 193A,A02,083225,Staff,0,6,30,30
1650664580788,MATH 193A,A03,083781,Staff,0,6,30,30
1650664580788,MATH 193A,A04,083782,Staff,0,7,30,30
1650664586813,MATH 197,001,091859,McAuley; Julian John,9998,0,9999,1
1650664592864,COGS 9,A01,083615,Staff,1,16,60,59
1650664598890,COGS 11,A01,083617,Boyle; Mary E. T.,18,0,40,22
1650664604917,COGS 13,A01,083071,Staff,0,39,40,40
1650664610945,COGS 14A,A01,092681,Staff,0,33,100,100
1650664616990,COGS 14B,A01,083073,Cheng; Tzu-Han,1,14,50,49
1650664623021,COGS 17,A01,092677,Staff,16,0,75,59
1650664629046,COGS 100,A01,083619,Staff,0,28,60,60
1650664635069,COGS 101A,A01,083621,Davis; Joshua Daniel,0,27,60,60
1650664641096,COGS 101B,A01,091572,Staff,0,4,60,60
1650664647122,COGS 101C,A01,083625,Delgado; Tania,14,0,30,16
1650664653146,COGS 107A,A01,083627,Boyle; Mary E. T.,1,17,60,59
1650664659173,COGS 118A,A01,083075,Staff,0,7,60,60
1650664665200,CSE 3,A50,083646,Miranda; Gregory Joseph,19,0,38,19
1650664665200,CSE 3,A51,083647,Miranda; Gregory Joseph,36,0,37,1
1650664671224,CSE 8A,A50,083650,Miranda; Gregory Joseph,0,30,40,40
1650664677247,CSE 11,A01,083080,Cao; Yingjun,0,95,40,40
1650664683272,CSE 12,A01,083652,Staff,0,19,100,100
1650664689294,CSE 15L,A01,083654,Staff,0,2,50,50
1650664689294,CSE 15L,A02,083655,Staff,0,1,50,50
1650664695319,CSE 20,A01,083657,Staff,50,0,80,30
1650664701341,CSE 30,A01,083084,Eldon; John,0,78,40,40
1650664707374,CSE 100,A01,083659,Cao; Yingjun,0,68,50,50
1650664713397,CSE 134B,A01,083661,Powell; Thomas Allan,0,37,65,65
1650664719425,CSE 140,A01,083663,Staff,0,9,75,75
1650664725451,CSE 140L,A01,083088,Eldon; John,0,17,75,75
1650664731479,CSE 175,A01,083665,Kumar; Rakesh,7,0,25,18
1650664737501,CSE 190,A00,092507,Dubnov; Shlomo,10,0,20,10
1650664743528,ECE 45,A01,083139,Staff,0,2,60,60
1650664749554,ECE 65,A50,083695,Staff,0,5,30,30
1650664755589,ECE 109,A01,091882,Touri; Behrouz,33,0,70,37
1650664761611,ECE 180,A00,083140,Abi Samra; Nicholas Camill,20,0,30,10
1650664761611,ECE 180,B00,083141,Abi Samra; Nicholas Camill,0,0,30,30
1650664767641,MATH 10A,A01,083735,Patchell; Gregory David,3,0,30,27
1650664767641,MATH 10A,A02,083736,Patchell; Gregory David,27,0,30,3
1650664767641,MATH 10A,A03,083737,Patchell; Gregory David,24,0,30,6
1650664773667,MATH 10B,A01,083207,Staff,0,9,30,30
1650664773667,MATH 10B,A02,083208,Staff,1,8,30,29
1650664773667,MATH 10B,B01,083739,Staff,11,0,30,19
1650664773667,MATH 10B,B02,083740,Staff,28,0,30,2
1650664779695,MATH 18,A01,083743,Staff,0,0,30,30
1650664779695,MATH 18,A02,083744,Staff,23,0,30,7
1650664779695,MATH 18,A03,083745,Staff,21,0,30,9
1650664779695,MATH 18,A04,083746,Staff,26,0,30,4
1650664779695,MATH 18,B01,083748,Staff,0,15,30,30
1650664779695,MATH 18,B02,083749,Staff,0,12,30,30
1650664779695,MATH 18,B03,083750,Staff,0,12,30,30
1650664779695,MATH 18,B04,083751,Staff,0,11,30,30
1650664785716,MATH 20A,A01,083754,Staff,19,0,40,21
1650664791742,MATH 20B,A01,083756,Staff,0,11,30,30
1650664791742,MATH 20B,A02,083757,Staff,0,12,30,30
1650664797768,MATH 20C,A01,083760,Staff,0,16,30,30
1650664797768,MATH 20C,A02,083761,Staff,1,14,30,29
1650664797768,MATH 20C,B01,083762,Staff,11,0,30,19
1650664797768,MATH 20C,B02,083763,Staff,28,0,30,2
1650664803795,MATH 20D,A01,083765,Staff,1,1,30,29
1650664803795,MATH 20D,A02,083766,Staff,6,0,30,24
1650664803795,MATH 20D,A03,083767,Staff,24,0,30,6
1650664809821,MATH 20E,A01,083771,Staff,3,0,30,27
1650664809821,MATH 20E,A02,083772,Staff,16,0,30,14
1650664809821,MATH 20E,B01,083773,Staff,0,0,30,30
1650664809821,MATH 20E,B02,083774,Staff,9,0,30,21
1650664815871,MATH 103A,A01,083777,Staff,0,15,30,30
1650664815871,MATH 103A,A02,083778,Staff,0,15,30,30
1650664815871,MATH 103A,B01,083779,Staff,0,14,30,30
1650664815871,MATH 103A,B02,083780,Staff,0,14,30,30
1650664821903,MATH 105,A01,085443,Staff,0,22,30,30
1650664827927,MATH 109,A01,083213,Anzaldo; Leesa B,0,7,30,30
1650664827927,MATH 109,A02,083214,Anzaldo; Leesa B,0,7,30,30
1650664827927,MATH 109,B01,083215,Anzaldo; Leesa B,0,8,30,30
1650664827927,MATH 109,B02,083216,Anzaldo; Leesa B,0,6,30,30
1650664833964,MATH 142A,A01,083219,Chow; Bennett,0,16,30,30
1650664833964,MATH 142A,A02,083220,Chow; Bennett,0,15,30,30
1650664833964,MATH 142A,B01,083221,Chow; Bennett,0,13,30,30
1650664833964,MATH 142A,B02,083222,Chow; Bennett,0,14,30,30
1650664839988,MATH 193A,A01,083224,Staff,0,5,30,30
1650664839988,MATH 193A,A02,083225,Staff,0,6,30,30
1650664839988,MATH 193A,A03,083781,Staff,0,6,30,30
1650664839988,MATH 193A,A04,083782,Staff,0,7,30,30
1650664846013,MATH 197,001,091859,McAuley; Julian John,9998,0,9999,1
1650664852072,COGS 9,A01,083615,Staff,1,16,60,59
1650664858095,COGS 11,A01,083617,Boyle; Mary E. T.,18,0,40,22
1650664864119,COGS 13,A01,083071,Staff,0,39,40,40
1650664870151,COGS 14A,A01,092681,Staff,0,33,100,100
1650664876173,COGS 14B,A01,083073,Cheng; Tzu-Han,1,14,50,49
1650664882196,COGS 17,A01,092677,Staff,16,0,75,59
1650664888224,COGS 100,A01,083619,Staff,0,28,60,60
1650664894262,COGS 101A,A01,083621,Davis; Joshua Daniel,0,27,60,60
1650664900293,COGS 101B,A01,091572,Staff,0,4,60,60
1650664906318,COGS 101C,A01,083625,Delgado; Tania,14,0,30,16
1650664912343,COGS 107A,A01,083627,Boyle; Mary E. T.,1,17,60,59
1650664918369,COGS 118A,A01,083075,Staff,0,7,60,60
1650664924395,CSE 3,A50,083646,Miranda; Gregory Joseph,19,0,38,19
1650664924395,CSE 3,A51,083647,Miranda; Gregory Joseph,36,0,37,1
1650664930419,CSE 8A,A50,083650,Miranda; Gregory Joseph,0,30,40,40
1650664936443,CSE 11,A01,083080,Cao; Yingjun,0,95,40,40
1650664942470,CSE 12,A01,083652,Staff,0,19,100,100
1650664948500,CSE 15L,A01,083654,Staff,0,2,50,50
1650664948500,CSE 15L,A02,083655,Staff,0,1,50,50
1650664954524,CSE 20,A01,083657,Staff,50,0,80,30
1650664960556,CSE 30,A01,083084,Eldon; John,0,78,40,40
1650664966580,CSE 100,A01,083659,Cao; Yingjun,0,68,50,50
1650664972606,CSE 134B,A01,083661,Powell; Thomas Allan,0,37,65,65
1650664978629,CSE 140,A01,083663,Staff,0,9,75,75
1650664984655,CSE 140L,A01,083088,Eldon; John,0,17,75,75
1650664990695,CSE 175,A01,083665,Kumar; Rakesh,7,0,25,18
1650664996721,CSE 190,A00,092507,Dubnov; Shlomo,10,0,20,10
1650665002745,ECE 45,A01,083139,Staff,0,2,60,60
1650665008771,ECE 65,A50,083695,Staff,0,5,30,30
1650665014801,ECE 109,A01,091882,Touri; Behrouz,33,0,70,37
1650665020824,ECE 180,A00,083140,Abi Samra; Nicholas Camill,20,0,30,10
1650665020824,ECE 180,B00,083141,Abi Samra; Nicholas Camill,0,0,30,30
1650665026851,MATH 10A,A01,083735,Patchell; Gregory David,3,0,30,27
1650665026851,MATH 10A,A02,083736,Patchell; Gregory David,27,0,30,3
1650665026851,MATH 10A,A03,083737,Patchell; Gregory David,24,0,30,6
1650665032875,MATH 10B,A01,083207,Staff,0,9,30,30
1650665032875,MATH 10B,A02,083208,Staff,1,8,30,29
1650665032875,MATH 10B,B01,083739,Staff,11,0,30,19
1650665032875,MATH 10B,B02,083740,Staff,28,0,30,2
1650665038905,MATH 18,A01,083743,Staff,0,0,30,30
1650665038905,MATH 18,A02,083744,Staff,23,0,30,7
1650665038905,MATH 18,A03,083745,Staff,21,0,30,9
1650665038905,MATH 18,A04,083746,Staff,26,0,30,4
1650665038905,MATH 18,B01,083748,Staff,0,15,30,30
1650665038905,MATH 18,B02,083749,Staff,0,12,30,30
1650665038905,MATH 18,B03,083750,Staff,0,12,30,30
1650665038905,MATH 18,B04,083751,Staff,0,11,30,30
1650665044928,MATH 20A,A01,083754,Staff,19,0,40,21
1650665050960,MATH 20B,A01,083756,Staff,0,11,30,30
1650665050960,MATH 20B,A02,083757,Staff,0,12,30,30
1650665056990,MATH 20C,A01,083760,Staff,0,16,30,30
1650665056990,MATH 20C,A02,083761,Staff,1,14,30,29
1650665056990,MATH 20C,B01,083762,Staff,11,0,30,19
1650665056990,MATH 20C,B02,083763,Staff,28,0,30,2
1650665063017,MATH 20D,A01,083765,Staff,1,1,30,29
1650665063017,MATH 20D,A02,083766,Staff,6,0,30,24
1650665063017,MATH 20D,A03,083767,Staff,24,0,30,6
1650665069136,MATH 20E,A01,083771,Staff,3,0,30,27
1650665069136,MATH 20E,A02,083772,Staff,16,0,30,14
1650665069136,MATH 20E,B01,083773,Staff,0,0,30,30
1650665069136,MATH 20E,B02,083774,Staff,9,0,30,21
1650665075171,MATH 103A,A01,083777,Staff,0,15,30,30
1650665075171,MATH 103A,A02,083778,Staff,0,15,30,30
1650665075171,MATH 103A,B01,083779,Staff,0,14,30,30
1650665075171,MATH 103A,B02,083780,Staff,0,14,30,30
1650665081196,MATH 105,A01,085443,Staff,0,22,30,30
1650665087223,MATH 109,A01,083213,Anzaldo; Leesa B,0,7,30,30
1650665087223,MATH 109,A02,083214,Anzaldo; Leesa B,0,7,30,30
1650665087223,MATH 109,B01,083215,Anzaldo; Leesa B,0,8,30,30
1650665087223,MATH 109,B02,083216,Anzaldo; Leesa B,0,6,30,30
1650665093252,MATH 142A,A01,083219,Chow; Bennett,0,16,30,30
1650665093252,MATH 142A,A02,083220,Chow; Bennett,0,15,30,30
1650665093252,MATH 142A,B01,083221,Chow; Bennett,0,13,30,30
1650665093252,MATH 142A,B02,083222,Chow; Bennett,0,14,30,30
1650665099278,MATH 193A,A01,083224,Staff,0,5,30,30
1650665099278,MATH 193A,A02,083225,Staff,0,6,30,30
1650665099278,MATH 193A,A03,083781,Staff,0,6,30,30
1650665099278,MATH 193A,A04,083782,Staff,0,7,30,30
1650665105307,MATH 197,001,091859,McAuley; Julian John,9998,0,9999,1
1650665111366,COGS 9,A01,083615,Staff,1,16,60,59
1650665117401,COGS 11,A01,083617,Boyle; Mary E. T.,18,0,40,22
1650665123424,COGS 13,A01,083071,Staff,0,39,40,40
1650665129450,COGS 14A,A01,092681,Staff,0,33,100,100
1650665135479,COGS 14B,A01,083073,Cheng; Tzu-Han,1,14,50,49
1650665141509,COGS 17,A01,092677,Staff,16,0,75,59
1650665147543,COGS 100,A01,083619,Staff,0,28,60,60
1650665153577,COGS 101A,A01,083621,Davis; Joshua Daniel,0,27,60,60
1650665159601,COGS 101B,A01,091572,Staff,0,4,60,60
1650665165625,COGS 101C,A01,083625,Delgado; Tania,14,0,30,16
1650665171653,COGS 107A,A01,083627,Boyle; Mary E. T.,1,17,60,59
1650665177680,COGS 118A,A01,083075,Staff,0,7,60,60
1650665183705,CSE 3,A50,083646,Miranda; Gregory Joseph,19,0,38,19
1650665183705,CSE 3,A51,083647,Miranda; Gregory Joseph,36,0,37,1
1650665189737,CSE 8A,A50,083650,Miranda; Gregory Joseph,0,30,40,40
1650665195778,CSE 11,A01,083080,Cao; Yingjun,0,95,40,40
1650665201804,CSE 12,A01,083652,Staff,0,19,100,100
1650665207830,CSE 15L,A01,083654,Staff,0,2,50,50
1650665207830,CSE 15L,A02,083655,Staff,0,1,50,50
1650665213854,CSE 20,A01,083657,Staff,50,0,80,30
1650665219876,CSE 30,A01,083084,Eldon; John,0,78,40,40
1650665225901,CSE 100,A01,083659,Cao; Yingjun,0,68,50,50
1650665231924,CSE 134B,A01,083661,Powell; Thomas Allan,0,37,65,65
1650665237948,CSE 140,A01,083663,Staff,0,9,75,75
1650665243975,CSE 140L,A01,083088,Eldon; John,0,17,75,75
1650665250009,CSE 175,A01,083665,Kumar; Rakesh,7,0,25,18
1650665256036,CSE 190,A00,092507,Dubnov; Shlomo,10,0,20,10
1650665262066,ECE 45,A01,083139,Staff,0,2,60,60
1650665268096,ECE 65,A50,083695,Staff,0,5,30,30
1650665274126,ECE 109,A01,091882,Touri; Behrouz,33,0,70,37
1650665280155,ECE 180,A00,083140,Abi Samra; Nicholas Camill,20,0,30,10
1650665280155,ECE 180,B00,083141,Abi Samra; Nicholas Camill,0,0,30,30
1650665286193,MATH 10A,A01,083735,Patchell; Gregory David,3,0,30,27
1650665286193,MATH 10A,A02,083736,Patchell; Gregory David,27,0,30,3
1650665286193,MATH 10A,A03,083737,Patchell; Gregory David,24,0,30,6
1650665292217,MATH 10B,A01,083207,Staff,0,9,30,30
1650665292217,MATH 10B,A02,083208,Staff,1,8,30,29
1650665292217,MATH 10B,B01,083739,Staff,11,0,30,19
1650665292217,MATH 10B,B02,083740,Staff,28,0,30,2
1650665298248,MATH 18,A01,083743,Staff,0,0,30,30
1650665298248,MATH 18,A02,083744,Staff,23,0,30,7
1650665298248,MATH 18,A03,083745,Staff,21,0,30,9
1650665298248,MATH 18,A04,083746,Staff,26,0,30,4
1650665298248,MATH 18,B01,083748,Staff,0,15,30,30
1650665298248,MATH 18,B02,083749,Staff,0,12,30,30
1650665298248,MATH 18,B03,083750,Staff,0,12,30,30
1650665298248,MATH 18,B04,083751,Staff,0,11,30,30
1650665304272,MATH 20A,A01,083754,Staff,19,0,40,21
1650665310308,MATH 20B,A01,083756,Staff,0,11,30,30
1650665310308,MATH 20B,A02,083757,Staff,0,12,30,30
1650665316336,MATH 20C,A01,083760,Staff,0,16,30,30
1650665316336,MATH 20C,A02,083761,Staff,1,14,30,29
1650665316336,MATH 20C,B01,083762,Staff,11,0,30,19
1650665316336,MATH 20C,B02,083763,Staff,28,0,30,2
1650665322364,MATH 20D,A01,083765,Staff,1,1,30,29
1650665322364,MATH 20D,A02,083766,Staff,6,0,30,24
1650665322364,MATH 20D,A03,083767,Staff,24,0,30,6
1650665328393,MATH 20E,A01,083771,Staff,3,0,30,27
1650665328393,MATH 20E,A02,083772,Staff,16,0,30,14
1650665328393,MATH 20E,B01,083773,Staff,0,0,30,30
1650665328393,MATH 20E,B02,083774,Staff,9,0,30,21
1650665334420,MATH 103A,A01,083777,Staff,0,15,30,30
1650665334420,MATH 103A,A02,083778,Staff,0,15,30,30
1650665334420,MATH 103A,B01,083779,Staff,0,14,30,30
1650665334420,MATH 103A,B02,083780,Staff,0,14,30,30
1650665340447,MATH 105,A01,085443,Staff,0,22,30,30
1650665346485,MATH 109,A01,083213,Anzaldo; Leesa B,0,7,30,30
1650665346485,MATH 109,A02,083214,Anzaldo; Leesa B,0,7,30,30
1650665346485,MATH 109,B01,083215,Anzaldo; Leesa B,0,8,30,30
1650665346485,MATH 109,B02,083216,Anzaldo; Leesa B,0,6,30,30
1650665352515,MATH 142A,A01,083219,Chow; Bennett,0,16,30,30
1650665352515,MATH 142A,A02,083220,Chow; Bennett,0,15,30,30
1650665352515,MATH 142A,B01,083221,Chow; Bennett,0,13,30,30
1650665352515,MATH 142A,B02,083222,Chow; Bennett,0,14,30,30
1650665358554,MATH 193A,A01,083224,Staff,0,5,30,30
1650665358554,MATH 193A,A02,083225,Staff,0,6,30,30
1650665358554,MATH 193A,A03,083781,Staff,0,6,30,30
1650665358554,MATH 193A,A04,083782,Staff,0,7,30,30
1650665364578,MATH 197,001,091859,McAuley; Julian John,9998,0,9999,1
1650665370646,COGS 9,A01,083615,Staff,1,16,60,59
1650665376680,COGS 11,A01,083617,Boyle; Mary E. T.,18,0,40,22
1650665382708,COGS 13,A01,083071,Staff,0,39,40,40
1650665388741,COGS 14A,A01,092681,Staff,0,33,100,100
1650665394766,COGS 14B,A01,083073,Cheng; Tzu-Han,1,14,50,49
1650665400789,COGS 17,A01,092677,Staff,16,0,75,59
1650665406828,COGS 100,A01,083619,Staff,0,28,60,60
1650665412851,COGS 101A,A01,083621,Davis; Joshua Daniel,0,27,60,60
1650665418882,COGS 101B,A01,091572,Staff,0,4,60,60
1650665424916,COGS 101C,A01,083625,Delgado; Tania,14,0,30,16
1650665430948,COGS 107A,A01,083627,Boyle; Mary E. T.,1,17,60,59
1650665436973,COGS 118A,A01,083075,Staff,0,7,60,60
1650665442997,CSE 3,A50,083646,Miranda; Gregory Joseph,19,0,38,19
1650665442997,CSE 3,A51,083647,Miranda; Gregory Joseph,36,0,37,1
1650665449021,CSE 8A,A50,083650,Miranda; Gregory Joseph,0,30,40,40
1650665455045,CSE 11,A01,083080,Cao; Yingjun,0,95,40,40
1650665461073,CSE 12,A01,083652,Staff,0,19,100,100
1650665467104,CSE 15L,A01,083654,Staff,0,2,50,50
1650665467104,CSE 15L,A02,083655,Staff,0,1,50,50
1650665473128,CSE 20,A01,083657,Staff,50,0,80,30
1650665479155,CSE 30,A01,083084,Eldon; John,0,78,40,40
1650665485180,CSE 100,A01,083659,Cao; Yingjun,0,68,50,50
1650665491204,CSE 134B,A01,083661,Powell; Thomas Allan,0,37,65,65
1650665497237,CSE 140,A01,083663,Staff,0,9,75,75
1650665503261,CSE 140L,A01,083088,Eldon; John,0,17,75,75
1650665509288,CSE 175,A01,083665,Kumar; Rakesh,7,0,25,18
1650665515311,CSE 190,A00,092507,Dubnov; Shlomo,10,0,20,10
1650665521335,ECE 45,A01,083139,Staff,0,2,60,60
1650665527364,ECE 65,A50,083695,Staff,0,5,30,30
1650665533388,ECE 109,A01,091882,Touri; Behrouz,33,0,70,37
1650665539421,ECE 180,A00,083140,Abi Samra; Nicholas Camill,20,0,30,10
1650665539421,ECE 180,B00,083141,Abi Samra; Nicholas Camill,0,0,30,30
1650665545449,MATH 10A,A01,083735,Patchell; Gregory David,3,0,30,27
1650665545449,MATH 10A,A02,083736,Patchell; Gregory David,27,0,30,3
1650665545449,MATH 10A,A03,083737,Patchell; Gregory David,24,0,30,6
1650665551482,MATH 10B,A01,083207,Staff,0,9,30,30
1650665551482,MATH 10B,A02,083208,Staff,1,8,30,29
1650665551482,MATH 10B,B01,083739,Staff,11,0,30,19
1650665551482,MATH 10B,B02,083740,Staff,28,0,30,2
1650665557517,MATH 18,A01,083743,Staff,0,0,30,30
1650665557517,MATH 18,A02,083744,Staff,23,0,30,7
1650665557517,MATH 18,A03,083745,Staff,21,0,30,9
1650665557517,MATH 18,A04,083746,Staff,26,0,30,4
1650665557517,MATH 18,B01,083748,Staff,0,15,30,30
1650665557517,MATH 18,B02,083749,Staff,0,12,30,30
1650665557517,MATH 18,B03,083750,Staff,0,12,30,30
1650665557517,MATH 18,B04,083751,Staff,0,11,30,30
1650665563541,MATH 20A,A01,083754,Staff,19,0,40,21
1650665569568,MATH 20B,A01,083756,Staff,0,11,30,30
1650665569568,MATH 20B,A02,083757,Staff,0,12,30,30
1650665575597,MATH 20C,A01,083760,Staff,0,16,30,30
1650665575597,MATH 20C,A02,083761,Staff,1,14,30,29
1650665575597,MATH 20C,B01,083762,Staff,11,0,30,19
1650665575597,MATH 20C,B02,083763,Staff,28,0,30,2
1650665581626,MATH 20D,A01,083765,Staff,1,1,30,29
1650665581626,MATH 20D,A02,083766,Staff,6,0,30,24
1650665581626,MATH 20D,A03,083767,Staff,24,0,30,6
1650665587654,MATH 20E,A01,083771,Staff,3,0,30,27
1650665587654,MATH 20E,A02,083772,Staff,16,0,30,14
1650665587654,MATH 20E,B01,083773,Staff,0,0,30,30
1650665587654,MATH 20E,B02,083774,Staff,9,0,30,21
1650665593681,MATH 103A,A01,083777,Staff,0,15,30,30
1650665593681,MATH 103A,A02,083778,Staff,0,15,30,30
1650665593681,MATH 103A,B01,083779,Staff,0,14,30,30
1650665593681,MATH 103A,B02,083780,Staff,0,14,30,30
1650665599705,MATH 105,A01,085443,Staff,0,22,30,30
1650665605730,MATH 109,A01,083213,Anzaldo; Leesa B,0,7,30,30
1650665605730,MATH 109,A02,083214,Anzaldo; Leesa B,0,7,30,30
1650665605730,MATH 109,B01,083215,Anzaldo; Leesa B,0,8,30,30
1650665605730,MATH 109,B02,083216,Anzaldo; Leesa B,0,6,30,30
1650665611761,MATH 142A,A01,083219,Chow; Bennett,0,16,30,30
1650665611761,MATH 142A,A02,083220,Chow; Bennett,0,15,30,30
1650665611761,MATH 142A,B01,083221,Chow; Bennett,0,13,30,30
1650665611761,MATH 142A,B02,083222,Chow; Bennett,0,14,30,30
1650665617789,MATH 193A,A01,083224,Staff,0,5,30,30
1650665617789,MATH 193A,A02,083225,Staff,0,6,30,30
1650665617789,MATH 193A,A03,083781,Staff,0,6,30,30
1650665617789,MATH 193A,A04,083782,Staff,0,7,30,30
1650665623813,MATH 197,001,091859,McAuley; Julian John,9998,0,9999,1
1650665629880,COGS 9,A01,083615,Staff,1,16,60,59
1650665635909,COGS 11,A01,083617,Boyle; Mary E. T.,18,0,40,22
1650665641933,COGS 13,A01,083071,Staff,0,39,40,40
1650665647968,COGS 14A,A01,092681,Staff,0,33,100,100
1650665653995,COGS 14B,A01,083073,Cheng; Tzu-Han,1,14,50,49
1650665660122,COGS 17,A01,092677,Staff,16,0,75,59
1650665666154,COGS 100,A01,083619,Staff,0,28,60,60
1650665672182,COGS 101A,A01,083621,Davis; Joshua Daniel,0,27,60,60
1650665678205,COGS 101B,A01,091572,Staff,0,4,60,60
1650665684229,COGS 101C,A01,083625,Delgado; Tania,14,0,30,16
1650665690253,COGS 107A,A01,083627,Boyle; Mary E. T.,1,17,60,59
1650665696276,COGS 118A,A01,083075,Staff,0,7,60,60
1650665702298,CSE 3,A50,083646,Miranda; Gregory Joseph,19,0,38,19
1650665702298,CSE 3,A51,083647,Miranda; Gregory Joseph,36,0,37,1
1650665708328,CSE 8A,A50,083650,Miranda; Gregory Joseph,0,30,40,40
1650665714351,CSE 11,A01,083080,Cao; Yingjun,0,95,40,40
1650665720382,CSE 12,A01,083652,Staff,0,19,100,100
1650665726408,CSE 15L,A01,083654,Staff,0,2,50,50
1650665726408,CSE 15L,A02,083655,Staff,0,1,50,50
1650665732435,CSE 20,A01,083657,Staff,50,0,80,30
1650665738462,CSE 30,A01,083084,Eldon; John,0,78,40,40
1650665744492,CSE 100,A01,083659,Cao; Yingjun,0,68,50,50
1650665750516,CSE 134B,A01,083661,Powell; Thomas Allan,0,37,65,65
1650665756560,CSE 140,A01,083663,Staff,0,9,75,75
1650665762589,CSE 140L,A01,083088,Eldon; John,0,17,75,75
1650665768612,CSE 175,A01,083665,Kumar; Rakesh,7,0,25,18
1650665774646,CSE 190,A00,092507,Dubnov; Shlomo,10,0,20,10
1650665780672,ECE 45,A01,083139,Staff,0,2,60,60
1650665786694,ECE 65,A50,083695,Staff,0,5,30,30
1650665792727,ECE 109,A01,091882,Touri; Behrouz,33,0,70,37
1650665798753,ECE 180,A00,083140,Abi Samra; Nicholas Camill,20,0,30,10
1650665798753,ECE 180,B00,083141,Abi Samra; Nicholas Camill,0,0,30,30
1650665804777,MATH 10A,A01,083735,Patchell; Gregory David,3,0,30,27
1650665804777,MATH 10A,A02,083736,Patchell; Gregory David,27,0,30,3
1650665804777,MATH 10A,A03,083737,Patchell; Gregory David,24,0,30,6
1650665810811,MATH 10B,A01,083207,Staff,0,9,30,30
1650665810811,MATH 10B,A02,083208,Staff,1,8,30,29
1650665810811,MATH 10B,B01,083739,Staff,11,0,30,19
1650665810811,MATH 10B,B02,083740,Staff,28,0,30,2
1650665816842,MATH 18,A01,083743,Staff,0,0,30,30
1650665816842,MATH 18,A02,083744,Staff,23,0,30,7
1650665816842,MATH 18,A03,083745,Staff,21,0,30,9
1650665816842,MATH 18,A04,083746,Staff,26,0,30,4
1650665816842,MATH 18,B01,083748,Staff,0,15,30,30
1650665816842,MATH 18,B02,083749,Staff,0,12,30,30
1650665816842,MATH 18,B03,083750,Staff,0,12,30,30
1650665816842,MATH 18,B04,083751,Staff,0,11,30,30
1650665822869,MATH 20A,A01,083754,Staff,19,0,40,21
1650665828901,MATH 20B,A01,083756,Staff,0,11,30,30
1650665828901,MATH 20B,A02,083757,Staff,0,12,30,30
1650665834931,MATH 20C,A01,083760,Staff,0,16,30,30
1650665834931,MATH 20C,A02,083761,Staff,1,14,30,29
1650665834931,MATH 20C,B01,083762,Staff,11,0,30,19
1650665834931,MATH 20C,B02,083763,Staff,28,0,30,2
1650665840957,MATH 20D,A01,083765,Staff,1,1,30,29
1650665840957,MATH 20D,A02,083766,Staff,6,0,30,24
1650665840957,MATH 20D,A03,083767,Staff,24,0,30,6
1650665846982,MATH 20E,A01,083771,Staff,3,0,30,27
1650665846982,MATH 20E,A02,083772,Staff,16,0,30,14
1650665846982,MATH 20E,B01,083773,Staff,0,0,30,30
1650665846982,MATH 20E,B02,083774,Staff,9,0,30,21
1650665853005,MATH 103A,A01,083777,Staff,0,15,30,30
1650665853005,MATH 103A,A02,083778,Staff,0,15,30,30
1650665853005,MATH 103A,B01,083779,Staff,0,14,30,30
1650665853005,MATH 103A,B02,083780,Staff,0,14,30,30
1650665859028,MATH 105,A01,085443,Staff,0,22,30,30
1650665865051,MATH 109,A01,083213,Anzaldo; Leesa B,0,7,30,30
1650665865051,MATH 109,A02,083214,Anzaldo; Leesa B,0,7,30,30
1650665865051,MATH 109,B01,083215,Anzaldo; Leesa B,0,8,30,30
1650665865051,MATH 109,B02,083216,Anzaldo; Leesa B,0,6,30,30
1650665871081,MATH 142A,A01,083219,Chow; Bennett,0,16,30,30
1650665871081,MATH 142A,A02,083220,Chow; Bennett,0,15,30,30
1650665871081,MATH 142A,B01,083221,Chow; Bennett,0,13,30,30
1650665871081,MATH 142A,B02,083222,Chow; Bennett,0,14,30,30
1650665877109,MATH 193A,A01,083224,Staff,0,5,30,30
1650665877109,MATH 193A,A02,083225,Staff,0,6,30,30
1650665877109,MATH 193A,A03,083781,Staff,0,6,30,30
1650665877109,MATH 193A,A04,083782,Staff,0,7,30,30
1650665883135,MATH 197,001,091859,McAuley; Julian John,9998,0,9999,1
1650665889186,COGS 9,A01,083615,Staff,1,16,60,59
1650665895214,COGS 11,A01,083617,Boyle; Mary E. T.,18,0,40,22
1650665901236,COGS 13,A01,083071,Staff,0,39,40,40
1650665907263,COGS 14A,A01,092681,Staff,0,33,100,100
1650665913289,COGS 14B,A01,083073,Cheng; Tzu-Han,1,14,50,49
1650665919318,COGS 17,A01,092677,Staff,16,0,75,59
1650665925342,COGS 100,A01,083619,Staff,0,28,60,60
1650665931368,COGS 101A,A01,083621,Davis; Joshua Daniel,0,27,60,60
1650665937392,COGS 101B,A01,091572,Staff,0,4,60,60
1650665943418,COGS 101C,A01,083625,Delgado; Tania,14,0,30,16
1650665949445,COGS 107A,A01,083627,Boyle; Mary E. T.,1,17,60,59
1650665955469,COGS 118A,A01,083075,Staff,0,7,60,60
1650665961497,CSE 3,A50,083646,Miranda; Gregory Joseph,19,0,38,19
1650665961497,CSE 3,A51,083647,Miranda; Gregory Joseph,36,0,37,1
1650665967536,CSE 8A,A50,083650,Miranda; Gregory Joseph,0,30,40,40
1650665973564,CSE 11,A01,083080,Cao; Yingjun,0,95,40,40
1650665979598,CSE 12,A01,083652,Staff,0,19,100,100
1650665985629,CSE 15L,A01,083654,Staff,0,2,50,50
1650665985629,CSE 15L,A02,083655,Staff,0,1,50,50
1650665991661,CSE 20,A01,083657,Staff,50,0,80,30
1650665997684,CSE 30,A01,083084,Eldon; John,0,78,40,40
1650666003712,CSE 100,A01,083659,Cao; Yingjun,0,69,50,50
1650666009743,CSE 134B,A01,083661,Powell; Thomas Allan,0,37,65,65
1650666015770,CSE 140,A01,083663,Staff,0,9,75,75
1650666021794,CSE 140L,A01,083088,Eldon; John,0,17,75,75
1650666027815,CSE 175,A01,083665,Kumar; Rakesh,7,0,25,18
1650666033839,CSE 190,A00,092507,Dubnov; Shlomo,10,0,20,10
1650666039862,ECE 45,A01,083139,Staff,0,2,60,60
1650666045886,ECE 65,A50,083695,Staff,0,5,30,30
1650666051912,ECE 109,A01,091882,Touri; Behrouz,33,0,70,37
1650666057938,ECE 180,A00,083140,Abi Samra; Nicholas Camill,20,0,30,10
1650666057938,ECE 180,B00,083141,Abi Samra; Nicholas Camill,0,0,30,30
1650666063971,MATH 10A,A01,083735,Patchell; Gregory David,3,0,30,27
1650666063971,MATH 10A,A02,083736,Patchell; Gregory David,27,0,30,3
1650666063971,MATH 10A,A03,083737,Patchell; Gregory David,24,0,30,6
1650666069996,MATH 10B,A01,083207,Staff,0,9,30,30
1650666069996,MATH 10B,A02,083208,Staff,1,8,30,29
1650666069996,MATH 10B,B01,083739,Staff,11,0,30,19
1650666069996,MATH 10B,B02,083740,Staff,28,0,30,2
1650666076026,MATH 18,A01,083743,Staff,0,0,30,30
1650666076026,MATH 18,A02,083744,Staff,23,0,30,7
1650666076026,MATH 18,A03,083745,Staff,21,0,30,9
1650666076026,MATH 18,A04,083746,Staff,26,0,30,4
1650666076026,MATH 18,B01,083748,Staff,0,15,30,30
1650666076026,MATH 18,B02,083749,Staff,0,12,30,30
1650666076026,MATH 18,B03,083750,Staff,0,12,30,30
1650666076026,MATH 18,B04,083751,Staff,0,11,30,30
1650666082054,MATH 20A,A01,083754,Staff,19,0,40,21
1650666088089,MATH 20B,A01,083756,Staff,0,11,30,30
1650666088089,MATH 20B,A02,083757,Staff,0,12,30,30
1650666094117,MATH 20C,A01,083760,Staff,0,16,30,30
1650666094117,MATH 20C,A02,083761,Staff,1,14,30,29
1650666094117,MATH 20C,B01,083762,Staff,11,0,30,19
1650666094117,MATH 20C,B02,083763,Staff,28,0,30,2
1650666100140,MATH 20D,A01,083765,Staff,1,1,30,29
1650666100140,MATH 20D,A02,083766,Staff,6,0,30,24
1650666100140,MATH 20D,A03,083767,Staff,24,0,30,6
1650666106167,MATH 20E,A01,083771,Staff,3,0,30,27
1650666106167,MATH 20E,A02,083772,Staff,16,0,30,14
1650666106167,MATH 20E,B01,083773,Staff,0,0,30,30
1650666106167,MATH 20E,B02,083774,Staff,9,0,30,21
1650666112193,MATH 103A,A01,083777,Staff,0,15,30,30
1650666112193,MATH 103A,A02,083778,Staff,0,15,30,30
1650666112193,MATH 103A,B01,083779,Staff,0,14,30,30
1650666112193,MATH 103A,B02,083780,Staff,0,14,30,30
1650666118216,MATH 105,A01,085443,Staff,0,22,30,30
1650666124241,MATH 109,A01,083213,Anzaldo; Leesa B,0,7,30,30
1650666124241,MATH 109,A02,083214,Anzaldo; Leesa B,0,7,30,30
1650666124241,MATH 109,B01,083215,Anzaldo; Leesa B,0,8,30,30
1650666124241,MATH 109,B02,083216,Anzaldo; Leesa B,0,6,30,30
1650666130265,MATH 142A,A01,083219,Chow; Bennett,0,16,30,30
1650666130265,MATH 142A,A02,083220,Chow; Bennett,0,15,30,30
1650666130265,MATH 142A,B01,083221,Chow; Bennett,0,13,30,30
1650666130265,MATH 142A,B02,083222,Chow; Bennett,0,14,30,30
1650666136293,MATH 193A,A01,083224,Staff,0,5,30,30
1650666136293,MATH 193A,A02,083225,Staff,0,6,30,30
1650666136293,MATH 193A,A03,083781,Staff,0,6,30,30
1650666136293,MATH 193A,A04,083782,Staff,0,7,30,30
1650666142329,MATH 197,001,091859,McAuley; Julian John,9998,0,9999,1
1650666148380,COGS 9,A01,083615,Staff,1,16,60,59
1650666154403,COGS 11,A01,083617,Boyle; Mary E. T.,18,0,40,22
1650666160435,COGS 13,A01,083071,Staff,0,39,40,40
1650666166461,COGS 14A,A01,092681,Staff,0,33,100,100
1650666172492,COGS 14B,A01,083073,Cheng; Tzu-Han,1,14,50,49
1650666178516,COGS 17,A01,092677,Staff,16,0,75,59
1650666184551,COGS 100,A01,083619,Staff,0,28,60,60
1650666190583,COGS 101A,A01,083621,Davis; Joshua Daniel,0,27,60,60
1650666196608,COGS 101B,A01,091572,Staff,0,4,60,60
1650666202631,COGS 101C,A01,083625,Delgado; Tania,14,0,30,16
1650666208653,COGS 107A,A01,083627,Boyle; Mary E. T.,1,17,60,59
1650666214677,COGS 118A,A01,083075,Staff,0,7,60,60
1650666220703,CSE 3,A50,083646,Miranda; Gregory Joseph,19,0,38,19
1650666220703,CSE 3,A51,083647,Miranda; Gregory Joseph,36,0,37,1
1650666226729,CSE 8A,A50,083650,Miranda; Gregory Joseph,0,30,40,40
1650666232764,CSE 11,A01,083080,Cao; Yingjun,0,95,40,40
1650666238789,CSE 12,A01,083652,Staff,0,19,100,100
1650666244813,CSE 15L,A01,083654,Staff,0,2,50,50
1650666244813,CSE 15L,A02,083655,Staff,0,1,50,50
1650666250848,CSE 20,A01,083657,Staff,50,0,80,30
1650666256960,CSE 30,A01,083084,Eldon; John,0,78,40,40
1650666262987,CSE 100,A01,083659,Cao; Yingjun,0,69,50,50
1650666269014,CSE 134B,A01,083661,Powell; Thomas Allan,0,37,65,65
1650666275041,CSE 140,A01,083663,Staff,0,9,75,75
1650666281076,CSE 140L,A01,083088,Eldon; John,0,17,75,75
1650666287107,CSE 175,A01,083665,Kumar; Rakesh,7,0,25,18
1650666293134,CSE 190,A00,092507,Dubnov; Shlomo,10,0,20,10
1650666299157,ECE 45,A01,083139,Staff,0,2,60,60
1650666305180,ECE 65,A50,083695,Staff,0,5,30,30
1650666311203,ECE 109,A01,091882,Touri; Behrouz,33,0,70,37
1650666317227,ECE 180,A00,083140,Abi Samra; Nicholas Camill,20,0,30,10
1650666317227,ECE 180,B00,083141,Abi Samra; Nicholas Camill,0,0,30,30
1650666323253,MATH 10A,A01,083735,Patchell; Gregory David,3,0,30,27
1650666323253,MATH 10A,A02,083736,Patchell; Gregory David,27,0,30,3
1650666323253,MATH 10A,A03,083737,Patchell; Gregory David,24,0,30,6
1650666329279,MATH 10B,A01,083207,Staff,0,9,30,30
1650666329279,MATH 10B,A02,083208,Staff,1,8,30,29
1650666329279,MATH 10B,B01,083739,Staff,11,0,30,19
1650666329279,MATH 10B,B02,083740,Staff,28,0,30,2
1650666335304,MATH 18,A01,083743,Staff,0,0,30,30
1650666335304,MATH 18,A02,083744,Staff,23,0,30,7
1650666335304,MATH 18,A03,083745,Staff,21,0,30,9
1650666335304,MATH 18,A04,083746,Staff,26,0,30,4
1650666335304,MATH 18,B01,083748,Staff,0,15,30,30
1650666335304,MATH 18,B02,083749,Staff,0,12,30,30
1650666335304,MATH 18,B03,083750,Staff,0,12,30,30
1650666335304,MATH 18,B04,083751,Staff,0,11,30,30
1650666341330,MATH 20A,A01,083754,Staff,19,0,40,21
1650666347358,MATH 20B,A01,083756,Staff,0,11,30,30
1650666347358,MATH 20B,A02,083757,Staff,0,12,30,30
1650666353393,MATH 20C,A01,083760,Staff,0,16,30,30
1650666353393,MATH 20C,A02,083761,Staff,1,14,30,29
1650666353393,MATH 20C,B01,083762,Staff,11,0,30,19
1650666353393,MATH 20C,B02,083763,Staff,28,0,30,2
1650666359420,MATH 20D,A01,083765,Staff,1,1,30,29
1650666359420,MATH 20D,A02,083766,Staff,6,0,30,24
1650666359420,MATH 20D,A03,083767,Staff,24,0,30,6
1650666365446,MATH 20E,A01,083771,Staff,3,0,30,27
1650666365446,MATH 20E,A02,083772,Staff,16,0,30,14
1650666365446,MATH 20E,B01,083773,Staff,0,0,30,30
1650666365446,MATH 20E,B02,083774,Staff,9,0,30,21
1650666371474,MATH 103A,A01,083777,Staff,0,15,30,30
1650666371474,MATH 103A,A02,083778,Staff,0,15,30,30
1650666371474,MATH 103A,B01,083779,Staff,0,14,30,30
1650666371474,MATH 103A,B02,083780,Staff,0,14,30,30
1650666377497,MATH 105,A01,085443,Staff,0,22,30,30
1650666383524,MATH 109,A01,083213,Anzaldo; Leesa B,0,7,30,30
1650666383524,MATH 109,A02,083214,Anzaldo; Leesa B,0,7,30,30
1650666383524,MATH 109,B01,083215,Anzaldo; Leesa B,0,8,30,30
1650666383524,MATH 109,B02,083216,Anzaldo; Leesa B,0,6,30,30
1650666389553,MATH 142A,A01,083219,Chow; Bennett,0,16,30,30
1650666389553,MATH 142A,A02,083220,Chow; Bennett,0,15,30,30
1650666389553,MATH 142A,B01,083221,Chow; Bennett,0,13,30,30
1650666389553,MATH 142A,B02,083222,Chow; Bennett,0,14,30,30
1650666395581,MATH 193A,A01,083224,Staff,0,5,30,30
1650666395581,MATH 193A,A02,083225,Staff,0,6,30,30
1650666395581,MATH 193A,A03,083781,Staff,0,6,30,30
1650666395581,MATH 193A,A04,083782,Staff,0,7,30,30
1650666401606,MATH 197,001,091859,McAuley; Julian John,9998,0,9999,1
1650666407668,COGS 9,A01,083615,Staff,1,16,60,59
1650666413691,COGS 11,A01,083617,Boyle; Mary E. T.,18,0,40,22
1650666419720,COGS 13,A01,083071,Staff,0,39,40,40
1650666425762,COGS 14A,A01,092681,Staff,0,33,100,100
1650666431793,COGS 14B,A01,083073,Cheng; Tzu-Han,1,14,50,49
1650666437825,COGS 17,A01,092677,Staff,16,0,75,59
1650666443851,COGS 100,A01,083619,Staff,0,28,60,60
1650666449882,COGS 101A,A01,083621,Davis; Joshua Daniel,0,27,60,60
1650666455908,COGS 101B,A01,091572,Staff,0,4,60,60
1650666461953,COGS 101C,A01,083625,Delgado; Tania,14,0,30,16
1650666467976,COGS 107A,A01,083627,Boyle; Mary E. T.,1,17,60,59
1650666474002,COGS 118A,A01,083075,Staff,0,7,60,60
1650666480030,CSE 3,A50,083646,Miranda; Gregory Joseph,19,0,38,19
1650666480030,CSE 3,A51,083647,Miranda; Gregory Joseph,36,0,37,1
1650666486059,CSE 8A,A50,083650,Miranda; Gregory Joseph,0,30,40,40
1650666492083,CSE 11,A01,083080,Cao; Yingjun,0,95,40,40
1650666498107,CSE 12,A01,083652,Staff,0,20,100,100
1650666504140,CSE 15L,A01,083654,Staff,0,2,50,50
1650666504140,CSE 15L,A02,083655,Staff,0,1,50,50
1650666510162,CSE 20,A01,083657,Staff,50,0,80,30
1650666516191,CSE 30,A01,083084,Eldon; John,0,78,40,40
1650666522215,CSE 100,A01,083659,Cao; Yingjun,0,69,50,50
1650666528239,CSE 134B,A01,083661,Powell; Thomas Allan,0,37,65,65
1650666534274,CSE 140,A01,083663,Staff,0,9,75,75
1650666540304,CSE 140L,A01,083088,Eldon; John,0,17,75,75
1650666546343,CSE 175,A01,083665,Kumar; Rakesh,7,0,25,18
1650666552369,CSE 190,A00,092507,Dubnov; Shlomo,10,0,20,10
1650666558391,ECE 45,A01,083139,Staff,0,2,60,60
1650666564415,ECE 65,A50,083695,Staff,0,5,30,30
1650666570442,ECE 109,A01,091882,Touri; Behrouz,33,0,70,37
1650666576468,ECE 180,A00,083140,Abi Samra; Nicholas Camill,20,0,30,10
1650666576468,ECE 180,B00,083141,Abi Samra; Nicholas Camill,0,0,30,30
1650666582490,MATH 10A,A01,083735,Patchell; Gregory David,3,0,30,27
1650666582490,MATH 10A,A02,083736,Patchell; Gregory David,27,0,30,3
1650666582490,MATH 10A,A03,083737,Patchell; Gregory David,24,0,30,6
1650666588514,MATH 10B,A01,083207,Staff,0,9,30,30
1650666588514,MATH 10B,A02,083208,Staff,1,8,30,29
1650666588514,MATH 10B,B01,083739,Staff,11,0,30,19
1650666588514,MATH 10B,B02,083740,Staff,28,0,30,2
1650666594538,MATH 18,A01,083743,Staff,0,0,30,30
1650666594538,MATH 18,A02,083744,Staff,23,0,30,7
1650666594538,MATH 18,A03,083745,Staff,21,0,30,9
1650666594538,MATH 18,A04,083746,Staff,26,0,30,4
1650666594538,MATH 18,B01,083748,Staff,0,15,30,30
1650666594538,MATH 18,B02,083749,Staff,0,12,30,30
1650666594538,MATH 18,B03,083750,Staff,0,12,30,30
1650666594538,MATH 18,B04,083751,Staff,0,11,30,30
1650666600560,MATH 20A,A01,083754,Staff,19,0,40,21
1650666606584,MATH 20B,A01,083756,Staff,0,11,30,30
1650666606584,MATH 20B,A02,083757,Staff,0,12,30,30
1650666612610,MATH 20C,A01,083760,Staff,0,16,30,30
1650666612610,MATH 20C,A02,083761,Staff,1,14,30,29
1650666612610,MATH 20C,B01,083762,Staff,10,0,30,20
1650666612610,MATH 20C,B02,083763,Staff,28,0,30,2
1650666618634,MATH 20D,A01,083765,Staff,1,1,30,29
1650666618634,MATH 20D,A02,083766,Staff,6,0,30,24
1650666618634,MATH 20D,A03,083767,Staff,24,0,30,6
1650666624655,MATH 20E,A01,083771,Staff,3,0,30,27
1650666624655,MATH 20E,A02,083772,Staff,16,0,30,14
1650666624655,MATH 20E,B01,083773,Staff,0,0,30,30
1650666624655,MATH 20E,B02,083774,Staff,9,0,30,21
1650666630689,MATH 103A,A01,083777,Staff,0,15,30,30
1650666630689,MATH 103A,A02,083778,Staff,0,15,30,30
1650666630689,MATH 103A,B01,083779,Staff,0,14,30,30
1650666630689,MATH 103A,B02,083780,Staff,0,14,30,30
1650666636713,MATH 105,A01,085443,Staff,0,22,30,30
1650666642740,MATH 109,A01,083213,Anzaldo; Leesa B,0,7,30,30
1650666642740,MATH 109,A02,083214,Anzaldo; Leesa B,0,7,30,30
1650666642740,MATH 109,B01,083215,Anzaldo; Leesa B,0,8,30,30
1650666642740,MATH 109,B02,083216,Anzaldo; Leesa B,0,6,30,30
1650666648769,MATH 142A,A01,083219,Chow; Bennett,0,16,30,30
1650666648769,MATH 142A,A02,083220,Chow; Bennett,0,15,30,30
1650666648769,MATH 142A,B01,083221,Chow; Bennett,0,13,30,30
1650666648769,MATH 142A,B02,083222,Chow; Bennett,0,14,30,30
1650666654792,MATH 193A,A01,083224,Staff,0,5,30,30
1650666654792,MATH 193A,A02,083225,Staff,0,6,30,30
1650666654792,MATH 193A,A03,083781,Staff,0,6,30,30
1650666654792,MATH 193A,A04,083782,Staff,0,7,30,30
1650666660815,MATH 197,001,091859,McAuley; Julian John,9998,0,9999,1
1650666666876,COGS 9,A01,083615,Staff,1,16,60,59
1650666672898,COGS 11,A01,083617,Boyle; Mary E. T.,18,0,40,22
1650666678924,COGS 13,A01,083071,Staff,0,39,40,40
1650666684953,COGS 14A,A01,092681,Staff,0,33,100,100
1650666690980,COGS 14B,A01,083073,Cheng; Tzu-Han,1,14,50,49
1650666697014,COGS 17,A01,092677,Staff,15,0,75,60
1650666703038,COGS 100,A01,083619,Staff,0,28,60,60
1650666719392,COGS 101A,A01,083621,Davis; Joshua Daniel,0,27,60,60
1650666725426,COGS 101B,A01,091572,Staff,0,4,60,60
1650666731452,COGS 101C,A01,083625,Delgado; Tania,14,0,30,16
1650666737475,COGS 107A,A01,083627,Boyle; Mary E. T.,1,17,60,59
1650666743498,COGS 118A,A01,083075,Staff,0,7,60,60
1650666749522,CSE 3,A50,083646,Miranda; Gregory Joseph,19,0,38,19
1650666749522,CSE 3,A51,083647,Miranda; Gregory Joseph,36,0,37,1
1650666755551,CSE 8A,A50,083650,Miranda; Gregory Joseph,0,30,40,40
1650666761579,CSE 11,A01,083080,Cao; Yingjun,0,95,40,40
1650666767607,CSE 12,A01,083652,Staff,0,20,100,100
1650666773630,CSE 15L,A01,083654,Staff,0,2,50,50
1650666773630,CSE 15L,A02,083655,Staff,0,2,50,50
1650666779662,CSE 20,A01,083657,Staff,50,0,80,30
1650666785686,CSE 30,A01,083084,Eldon; John,0,78,40,40
1650666791708,CSE 100,A01,083659,Cao; Yingjun,0,69,50,50
1650666797732,CSE 134B,A01,083661,Powell; Thomas Allan,0,37,65,65
1650666803756,CSE 140,A01,083663,Staff,0,9,75,75
1650666809782,CSE 140L,A01,083088,Eldon; John,0,17,75,75
1650666815815,CSE 175,A01,083665,Kumar; Rakesh,7,0,25,18
1650666821846,CSE 190,A00,092507,Dubnov; Shlomo,10,0,20,10
1650666827873,ECE 45,A01,083139,Staff,0,2,60,60
1650666833902,ECE 65,A50,083695,Staff,0,5,30,30
1650666839934,ECE 109,A01,091882,Touri; Behrouz,33,0,70,37
1650666845968,ECE 180,A00,083140,Abi Samra; Nicholas Camill,20,0,30,10
1650666845968,ECE 180,B00,083141,Abi Samra; Nicholas Camill,0,0,30,30
1650666851995,MATH 10A,A01,083735,Patchell; Gregory David,3,0,30,27
1650666851995,MATH 10A,A02,083736,Patchell; Gregory David,27,0,30,3
1650666851995,MATH 10A,A03,083737,Patchell; Gregory David,24,0,30,6
1650666858044,MATH 10B,A01,083207,Staff,0,9,30,30
1650666858044,MATH 10B,A02,083208,Staff,1,8,30,29
1650666858044,MATH 10B,B01,083739,Staff,11,0,30,19
1650666858044,MATH 10B,B02,083740,Staff,28,0,30,2
1650666864151,MATH 18,A01,083743,Staff,0,0,30,30
1650666864151,MATH 18,A02,083744,Staff,23,0,30,7
1650666864151,MATH 18,A03,083745,Staff,21,0,30,9
1650666864151,MATH 18,A04,083746,Staff,26,0,30,4
1650666864151,MATH 18,B01,083748,Staff,0,15,30,30
1650666864151,MATH 18,B02,083749,Staff,0,12,30,30
1650666864151,MATH 18,B03,083750,Staff,0,12,30,30
1650666864151,MATH 18,B04,083751,Staff,0,11,30,30
1650666870174,MATH 20A,A01,083754,Staff,19,0,40,21
1650666876203,MATH 20B,A01,083756,Staff,0,11,30,30
1650666876203,MATH 20B,A02,083757,Staff,0,12,30,30
1650666882236,MATH 20C,A01,083760,Staff,0,16,30,30
1650666882236,MATH 20C,A02,083761,Staff,1,14,30,29
1650666882236,MATH 20C,B01,083762,Staff,10,0,30,20
1650666882236,MATH 20C,B02,083763,Staff,28,0,30,2
1650666888264,MATH 20D,A01,083765,Staff,1,1,30,29
1650666888264,MATH 20D,A02,083766,Staff,6,0,30,24
1650666888264,MATH 20D,A03,083767,Staff,24,0,30,6
1650666894299,MATH 20E,A01,083771,Staff,3,0,30,27
1650666894299,MATH 20E,A02,083772,Staff,16,0,30,14
1650666894299,MATH 20E,B01,083773,Staff,0,0,30,30
1650666894299,MATH 20E,B02,083774,Staff,9,0,30,21
1650666900326,MATH 103A,A01,083777,Staff,0,15,30,30
1650666900326,MATH 103A,A02,083778,Staff,0,15,30,30
1650666900326,MATH 103A,B01,083779,Staff,0,14,30,30
1650666900326,MATH 103A,B02,083780,Staff,0,14,30,30
1650666906350,MATH 105,A01,085443,Staff,0,22,30,30
1650666912376,MATH 109,A01,083213,Anzaldo; Leesa B,0,7,30,30
1650666912376,MATH 109,A02,083214,Anzaldo; Leesa B,0,7,30,30
1650666912376,MATH 109,B01,083215,Anzaldo; Leesa B,0,8,30,30
1650666912376,MATH 109,B02,083216,Anzaldo; Leesa B,0,6,30,30
1650666918410,MATH 142A,A01,083219,Chow; Bennett,0,16,30,30
1650666918410,MATH 142A,A02,083220,Chow; Bennett,0,15,30,30
1650666918410,MATH 142A,B01,083221,Chow; Bennett,0,13,30,30
1650666918410,MATH 142A,B02,083222,Chow; Bennett,0,14,30,30
1650666924433,MATH 193A,A01,083224,Staff,0,5,30,30
1650666924433,MATH 193A,A02,083225,Staff,0,6,30,30
1650666924433,MATH 193A,A03,083781,Staff,0,6,30,30
1650666924433,MATH 193A,A04,083782,Staff,0,7,30,30
1650666930469,MATH 197,001,091859,McAuley; Julian John,9998,0,9999,1
1650666936526,COGS 9,A01,083615,Staff,1,16,60,59
1650666942548,COGS 11,A01,083617,Boyle; Mary E. T.,18,0,40,22
1650666948576,COGS 13,A01,083071,Staff,0,39,40,40
1650666954599,COGS 14A,A01,092681,Staff,0,33,100,100
1650666960632,COGS 14B,A01,083073,Cheng; Tzu-Han,1,14,50,49
1650666966655,COGS 17,A01,092677,Staff,15,0,75,60
1650666972687,COGS 100,A01,083619,Staff,0,28,60,60
1650666978722,COGS 101A,A01,083621,Davis; Joshua Daniel,0,27,60,60
1650666984749,COGS 101B,A01,091572,Staff,0,4,60,60
1650666990772,COGS 101C,A01,083625,Delgado; Tania,14,0,30,16
1650666996794,COGS 107A,A01,083627,Boyle; Mary E. T.,1,17,60,59
1650667002820,COGS 118A,A01,083075,Staff,0,7,60,60
1650667008856,CSE 3,A50,083646,Miranda; Gregory Joseph,19,0,38,19
1650667008856,CSE 3,A51,083647,Miranda; Gregory Joseph,36,0,37,1
1650667014884,CSE 8A,A50,083650,Miranda; Gregory Joseph,0,30,40,40
1650667020921,CSE 11,A01,083080,Cao; Yingjun,0,95,40,40
1650667026945,CSE 12,A01,083652,Staff,0,20,100,100
1650667032969,CSE 15L,A01,083654,Staff,0,2,50,50
1650667032969,CSE 15L,A02,083655,Staff,0,2,50,50
1650667038996,CSE 20,A01,083657,Staff,50,0,80,30
1650667045020,CSE 30,A01,083084,Eldon; John,0,78,40,40
1650667051054,CSE 100,A01,083659,Cao; Yingjun,0,69,50,50
1650667057083,CSE 134B,A01,083661,Powell; Thomas Allan,0,37,65,65
1650667063114,CSE 140,A01,083663,Staff,0,9,75,75
1650667069141,CSE 140L,A01,083088,Eldon; John,0,17,75,75
1650667075165,CSE 175,A01,083665,Kumar; Rakesh,7,0,25,18
1650667081194,CSE 190,A00,092507,Dubnov; Shlomo,10,0,20,10
1650667087220,ECE 45,A01,083139,Staff,0,2,60,60
1650667093252,ECE 65,A50,083695,Staff,0,5,30,30
1650667099280,ECE 109,A01,091882,Touri; Behrouz,33,0,70,37
1650667105308,ECE 180,A00,083140,Abi Samra; Nicholas Camill,20,0,30,10
1650667105308,ECE 180,B00,083141,Abi Samra; Nicholas Camill,0,0,30,30
1650667111335,MATH 10A,A01,083735,Patchell; Gregory David,3,0,30,27
1650667111335,MATH 10A,A02,083736,Patchell; Gregory David,27,0,30,3
1650667111335,MATH 10A,A03,083737,Patchell; Gregory David,24,0,30,6
1650667117360,MATH 10B,A01,083207,Staff,0,9,30,30
1650667117360,MATH 10B,A02,083208,Staff,1,8,30,29
1650667117360,MATH 10B,B01,083739,Staff,11,0,30,19
1650667117360,MATH 10B,B02,083740,Staff,28,0,30,2
1650667123391,MATH 18,A01,083743,Staff,0,0,30,30
1650667123391,MATH 18,A02,083744,Staff,23,0,30,7
1650667123391,MATH 18,A03,083745,Staff,21,0,30,9
1650667123391,MATH 18,A04,083746,Staff,26,0,30,4
1650667123391,MATH 18,B01,083748,Staff,0,15,30,30
1650667123391,MATH 18,B02,083749,Staff,0,12,30,30
1650667123391,MATH 18,B03,083750,Staff,0,12,30,30
1650667123391,MATH 18,B04,083751,Staff,0,11,30,30
1650667129414,MATH 20A,A01,083754,Staff,19,0,40,21
1650667135441,MATH 20B,A01,083756,Staff,0,11,30,30
1650667135441,MATH 20B,A02,083757,Staff,0,12,30,30
1650667141470,MATH 20C,A01,083760,Staff,0,16,30,30
1650667141470,MATH 20C,A02,083761,Staff,1,14,30,29
1650667141470,MATH 20C,B01,083762,Staff,10,0,30,20
1650667141470,MATH 20C,B02,083763,Staff,28,0,30,2
1650667147505,MATH 20D,A01,083765,Staff,1,1,30,29
1650667147505,MATH 20D,A02,083766,Staff,6,0,30,24
1650667147505,MATH 20D,A03,083767,Staff,24,0,30,6
1650667153536,MATH 20E,A01,083771,Staff,3,0,30,27
1650667153536,MATH 20E,A02,083772,Staff,16,0,30,14
1650667153536,MATH 20E,B01,083773,Staff,0,0,30,30
1650667153536,MATH 20E,B02,083774,Staff,9,0,30,21
1650667159575,MATH 103A,A01,083777,Staff,0,15,30,30
1650667159575,MATH 103A,A02,083778,Staff,0,15,30,30
1650667159575,MATH 103A,B01,083779,Staff,0,14,30,30
1650667159575,MATH 103A,B02,083780,Staff,0,14,30,30
1650667165603,MATH 105,A01,085443,Staff,0,22,30,30
1650667171626,MATH 109,A01,083213,Anzaldo; Leesa B,0,7,30,30
1650667171626,MATH 109,A02,083214,Anzaldo; Leesa B,0,7,30,30
1650667171626,MATH 109,B01,083215,Anzaldo; Leesa B,0,8,30,30
1650667171626,MATH 109,B02,083216,Anzaldo; Leesa B,0,6,30,30
1650667177668,MATH 142A,A01,083219,Chow; Bennett,0,16,30,30
1650667177668,MATH 142A,A02,083220,Chow; Bennett,0,15,30,30
1650667177668,MATH 142A,B01,083221,Chow; Bennett,0,13,30,30
1650667177668,MATH 142A,B02,083222,Chow; Bennett,0,14,30,30
1650667183690,MATH 193A,A01,083224,Staff,0,5,30,30
1650667183690,MATH 193A,A02,083225,Staff,0,6,30,30
1650667183690,MATH 193A,A03,083781,Staff,0,6,30,30
1650667183690,MATH 193A,A04,083782,Staff,0,7,30,30
1650667189715,MATH 197,001,091859,McAuley; Julian John,9998,0,9999,1
1650667195764,COGS 9,A01,083615,Staff,1,16,60,59
1650667201789,COGS 11,A01,083617,Boyle; Mary E. T.,18,0,40,22
1650667207814,COGS 13,A01,083071,Staff,0,39,40,40
1650667213840,COGS 14A,A01,092681,Staff,0,33,100,100
1650667219868,COGS 14B,A01,083073,Cheng; Tzu-Han,1,14,50,49
1650667225894,COGS 17,A01,092677,Staff,15,0,75,60
1650667231918,COGS 100,A01,083619,Staff,0,28,60,60
1650667237943,COGS 101A,A01,083621,Davis; Joshua Daniel,0,27,60,60
1650667243966,COGS 101B,A01,091572,Staff,0,4,60,60
1650667249990,COGS 101C,A01,083625,Delgado; Tania,14,0,30,16
1650667256023,COGS 107A,A01,083627,Boyle; Mary E. T.,1,17,60,59
1650667262046,COGS 118A,A01,083075,Staff,0,7,60,60
1650667268076,CSE 3,A50,083646,Miranda; Gregory Joseph,19,0,38,19
1650667268076,CSE 3,A51,083647,Miranda; Gregory Joseph,36,0,37,1
1650667274100,CSE 8A,A50,083650,Miranda; Gregory Joseph,0,30,40,40
1650667280124,CSE 11,A01,083080,Cao; Yingjun,0,95,40,40
1650667286156,CSE 12,A01,083652,Staff,0,20,100,100
1650667292191,CSE 15L,A01,083654,Staff,0,2,50,50
1650667292191,CSE 15L,A02,083655,Staff,0,2,50,50
1650667298217,CSE 20,A01,083657,Staff,50,0,80,30
1650667304256,CSE 30,A01,083084,Eldon; John,0,78,40,40
1650667310289,CSE 100,A01,083659,Cao; Yingjun,0,69,50,50
1650667316315,CSE 134B,A01,083661,Powell; Thomas Allan,0,37,65,65
1650667322347,CSE 140,A01,083663,Staff,0,9,75,75
1650667328374,CSE 140L,A01,083088,Eldon; John,0,17,75,75
1650667334412,CSE 175,A01,083665,Kumar; Rakesh,7,0,25,18
1650667340441,CSE 190,A00,092507,Dubnov; Shlomo,10,0,20,10
1650667346468,ECE 45,A01,083139,Staff,0,2,60,60
1650667352491,ECE 65,A50,083695,Staff,0,5,30,30
1650667358517,ECE 109,A01,091882,Touri; Behrouz,33,0,70,37
1650667364542,ECE 180,A00,083140,Abi Samra; Nicholas Camill,20,0,30,10
1650667364542,ECE 180,B00,083141,Abi Samra; Nicholas Camill,0,0,30,30
1650667370566,MATH 10A,A01,083735,Patchell; Gregory David,3,0,30,27
1650667370566,MATH 10A,A02,083736,Patchell; Gregory David,27,0,30,3
1650667370566,MATH 10A,A03,083737,Patchell; Gregory David,24,0,30,6
1650667376604,MATH 10B,A01,083207,Staff,0,9,30,30
1650667376604,MATH 10B,A02,083208,Staff,1,8,30,29
1650667376604,MATH 10B,B01,083739,Staff,11,0,30,19
1650667376604,MATH 10B,B02,083740,Staff,28,0,30,2
1650667382643,MATH 18,A01,083743,Staff,0,0,30,30
1650667382643,MATH 18,A02,083744,Staff,23,0,30,7
1650667382643,MATH 18,A03,083745,Staff,21,0,30,9
1650667382643,MATH 18,A04,083746,Staff,26,0,30,4
1650667382643,MATH 18,B01,083748,Staff,0,15,30,30
1650667382643,MATH 18,B02,083749,Staff,0,12,30,30
1650667382643,MATH 18,B03,083750,Staff,0,12,30,30
1650667382643,MATH 18,B04,083751,Staff,0,11,30,30
1650667388667,MATH 20A,A01,083754,Staff,19,0,40,21
1650667394692,MATH 20B,A01,083756,Staff,0,11,30,30
1650667394692,MATH 20B,A02,083757,Staff,0,12,30,30
1650667400719,MATH 20C,A01,083760,Staff,0,16,30,30
1650667400719,MATH 20C,A02,083761,Staff,1,14,30,29
1650667400719,MATH 20C,B01,083762,Staff,10,0,30,20
1650667400719,MATH 20C,B02,083763,Staff,28,0,30,2
1650667406743,MATH 20D,A01,083765,Staff,1,1,30,29
1650667406743,MATH 20D,A02,083766,Staff,6,0,30,24
1650667406743,MATH 20D,A03,083767,Staff,24,0,30,6
1650667412771,MATH 20E,A01,083771,Staff,3,0,30,27
1650667412771,MATH 20E,A02,083772,Staff,16,0,30,14
1650667412771,MATH 20E,B01,083773,Staff,0,0,30,30
1650667412771,MATH 20E,B02,083774,Staff,9,0,30,21
1650667418796,MATH 103A,A01,083777,Staff,0,15,30,30
1650667418796,MATH 103A,A02,083778,Staff,0,15,30,30
1650667418796,MATH 103A,B01,083779,Staff,0,14,30,30
1650667418796,MATH 103A,B02,083780,Staff,0,14,30,30
1650667424831,MATH 105,A01,085443,Staff,0,22,30,30
1650667430856,MATH 109,A01,083213,Anzaldo; Leesa B,0,7,30,30
1650667430856,MATH 109,A02,083214,Anzaldo; Leesa B,0,7,30,30
1650667430856,MATH 109,B01,083215,Anzaldo; Leesa B,0,8,30,30
1650667430856,MATH 109,B02,083216,Anzaldo; Leesa B,0,6,30,30
1650667436884,MATH 142A,A01,083219,Chow; Bennett,0,16,30,30
1650667436884,MATH 142A,A02,083220,Chow; Bennett,0,15,30,30
1650667436884,MATH 142A,B01,083221,Chow; Bennett,0,13,30,30
1650667436884,MATH 142A,B02,083222,Chow; Bennett,0,14,30,30
1650667442908,MATH 193A,A01,083224,Staff,0,5,30,30
1650667442908,MATH 193A,A02,083225,Staff,0,6,30,30
1650667442908,MATH 193A,A03,083781,Staff,0,6,30,30
1650667442908,MATH 193A,A04,083782,Staff,0,7,30,30
1650667448941,MATH 197,001,091859,McAuley; Julian John,9998,0,9999,1
1650667455083,COGS 9,A01,083615,Staff,1,16,60,59
1650667461115,COGS 11,A01,083617,Boyle; Mary E. T.,18,0,40,22
1650667467142,COGS 13,A01,083071,Staff,0,39,40,40
1650667473167,COGS 14A,A01,092681,Staff,0,33,100,100
1650667479196,COGS 14B,A01,083073,Cheng; Tzu-Han,1,14,50,49
1650667485221,COGS 17,A01,092677,Staff,15,0,75,60
1650667491246,COGS 100,A01,083619,Staff,0,28,60,60
1650667497277,COGS 101A,A01,083621,Davis; Joshua Daniel,0,27,60,60
1650667503304,COGS 101B,A01,091572,Staff,0,4,60,60
1650667509330,COGS 101C,A01,083625,Delgado; Tania,14,0,30,16
1650667515354,COGS 107A,A01,083627,Boyle; Mary E. T.,1,17,60,59
1650667521387,COGS 118A,A01,083075,Staff,0,7,60,60
1650667527410,CSE 3,A50,083646,Miranda; Gregory Joseph,19,0,38,19
1650667527410,CSE 3,A51,083647,Miranda; Gregory Joseph,36,0,37,1
1650667533434,CSE 8A,A50,083650,Miranda; Gregory Joseph,0,30,40,40
1650667539466,CSE 11,A01,083080,Cao; Yingjun,0,95,40,40
1650667545491,CSE 12,A01,083652,Staff,0,20,100,100
1650667551514,CSE 15L,A01,083654,Staff,0,2,50,50
1650667551514,CSE 15L,A02,083655,Staff,0,2,50,50
1650667557543,CSE 20,A01,083657,Staff,50,0,80,30
1650667563565,CSE 30,A01,083084,Eldon; John,0,78,40,40
1650667569591,CSE 100,A01,083659,Cao; Yingjun,0,69,50,50
1650667575615,CSE 134B,A01,083661,Powell; Thomas Allan,0,37,65,65
1650667581639,CSE 140,A01,083663,Staff,0,9,75,75
1650667587661,CSE 140L,A01,083088,Eldon; John,0,17,75,75
1650667593686,CSE 175,A01,083665,Kumar; Rakesh,7,0,25,18
1650667599710,CSE 190,A00,092507,Dubnov; Shlomo,10,0,20,10
1650667605735,ECE 45,A01,083139,Staff,0,2,60,60
1650667611764,ECE 65,A50,083695,Staff,0,5,30,30
1650667617800,ECE 109,A01,091882,Touri; Behrouz,33,0,70,37
1650667623827,ECE 180,A00,083140,Abi Samra; Nicholas Camill,20,0,30,10
1650667623827,ECE 180,B00,083141,Abi Samra; Nicholas Camill,0,0,30,30
1650667629864,MATH 10A,A01,083735,Patchell; Gregory David,3,0,30,27
1650667629864,MATH 10A,A02,083736,Patchell; Gregory David,27,0,30,3
1650667629864,MATH 10A,A03,083737,Patchell; Gregory David,24,0,30,6
1650667635901,MATH 10B,A01,083207,Staff,0,9,30,30
1650667635901,MATH 10B,A02,083208,Staff,1,8,30,29
1650667635901,MATH 10B,B01,083739,Staff,11,0,30,19
1650667635901,MATH 10B,B02,083740,Staff,28,0,30,2
1650667641925,MATH 18,A01,083743,Staff,0,0,30,30
1650667641925,MATH 18,A02,083744,Staff,23,0,30,7
1650667641925,MATH 18,A03,083745,Staff,21,0,30,9
1650667641925,MATH 18,A04,083746,Staff,26,0,30,4
1650667641925,MATH 18,B01,083748,Staff,0,15,30,30
1650667641925,MATH 18,B02,083749,Staff,0,12,30,30
1650667641925,MATH 18,B03,083750,Staff,0,12,30,30
1650667641925,MATH 18,B04,083751,Staff,0,11,30,30
1650667647953,MATH 20A,A01,083754,Staff,19,0,40,21
1650667653983,MATH 20B,A01,083756,Staff,0,11,30,30
1650667653983,MATH 20B,A02,083757,Staff,0,12,30,30
1650667660008,MATH 20C,A01,083760,Staff,0,16,30,30
1650667660008,MATH 20C,A02,083761,Staff,1,14,30,29
1650667660008,MATH 20C,B01,083762,Staff,10,0,30,20
1650667660008,MATH 20C,B02,083763,Staff,28,0,30,2
1650667666034,MATH 20D,A01,083765,Staff,1,1,30,29
1650667666034,MATH 20D,A02,083766,Staff,6,0,30,24
1650667666034,MATH 20D,A03,083767,Staff,24,0,30,6
1650667672065,MATH 20E,A01,083771,Staff,3,0,30,27
1650667672065,MATH 20E,A02,083772,Staff,16,0,30,14
1650667672065,MATH 20E,B01,083773,Staff,0,0,30,30
1650667672065,MATH 20E,B02,083774,Staff,9,0,30,21
1650667678093,MATH 103A,A01,083777,Staff,0,15,30,30
1650667678093,MATH 103A,A02,083778,Staff,0,15,30,30
1650667678093,MATH 103A,B01,083779,Staff,0,14,30,30
1650667678093,MATH 103A,B02,083780,Staff,0,14,30,30
1650667684121,MATH 105,A01,085443,Staff,0,22,30,30
1650667690149,MATH 109,A01,083213,Anzaldo; Leesa B,0,7,30,30
1650667690149,MATH 109,A02,083214,Anzaldo; Leesa B,0,7,30,30
1650667690149,MATH 109,B01,083215,Anzaldo; Leesa B,0,8,30,30
1650667690149,MATH 109,B02,083216,Anzaldo; Leesa B,0,6,30,30
1650667696176,MATH 142A,A01,083219,Chow; Bennett,0,16,30,30
1650667696176,MATH 142A,A02,083220,Chow; Bennett,0,15,30,30
1650667696176,MATH 142A,B01,083221,Chow; Bennett,0,13,30,30
1650667696176,MATH 142A,B02,083222,Chow; Bennett,0,14,30,30
1650667702201,MATH 193A,A01,083224,Staff,0,5,30,30
1650667702201,MATH 193A,A02,083225,Staff,0,6,30,30
1650667702201,MATH 193A,A03,083781,Staff,0,6,30,30
1650667702201,MATH 193A,A04,083782,Staff,0,7,30,30
1650667708227,MATH 197,001,091859,McAuley; Julian John,9998,0,9999,1
1650667714279,COGS 9,A01,083615,Staff,1,16,60,59
1650667720306,COGS 11,A01,083617,Boyle; Mary E. T.,18,0,40,22
1650667726331,COGS 13,A01,083071,Staff,0,39,40,40
1650667732358,COGS 14A,A01,092681,Staff,0,33,100,100
1650667738382,COGS 14B,A01,083073,Cheng; Tzu-Han,1,14,50,49
1650667744406,COGS 17,A01,092677,Staff,15,0,75,60
1650667750430,COGS 100,A01,083619,Staff,0,28,60,60
1650667756452,COGS 101A,A01,083621,Davis; Joshua Daniel,0,27,60,60
1650667762482,COGS 101B,A01,091572,Staff,0,4,60,60
1650667768508,COGS 101C,A01,083625,Delgado; Tania,14,0,30,16
1650667774536,COGS 107A,A01,083627,Boyle; Mary E. T.,1,17,60,59
1650667780570,COGS 118A,A01,083075,Staff,0,7,60,60
1650667786594,CSE 3,A50,083646,Miranda; Gregory Joseph,19,0,38,19
1650667786594,CSE 3,A51,083647,Miranda; Gregory Joseph,36,0,37,1
1650667792619,CSE 8A,A50,083650,Miranda; Gregory Joseph,0,30,40,40
1650667798642,CSE 11,A01,083080,Cao; Yingjun,0,95,40,40
1650667804666,CSE 12,A01,083652,Staff,0,21,100,100
1650667810706,CSE 15L,A01,083654,Staff,0,3,50,50
1650667810706,CSE 15L,A02,083655,Staff,0,2,50,50
1650667816744,CSE 20,A01,083657,Staff,50,0,80,30
1650667822766,CSE 30,A01,083084,Eldon; John,0,78,40,40
1650667828792,CSE 100,A01,083659,Cao; Yingjun,0,69,50,50
1650667834816,CSE 134B,A01,083661,Powell; Thomas Allan,0,37,65,65
1650667840843,CSE 140,A01,083663,Staff,0,9,75,75
1650667846873,CSE 140L,A01,083088,Eldon; John,0,17,75,75
1650667852897,CSE 175,A01,083665,Kumar; Rakesh,7,0,25,18
1650667858925,CSE 190,A00,092507,Dubnov; Shlomo,10,0,20,10
1650667864953,ECE 45,A01,083139,Staff,0,2,60,60
1650667870978,ECE 65,A50,083695,Staff,0,5,30,30
1650667877005,ECE 109,A01,091882,Touri; Behrouz,33,0,70,37
1650667883027,ECE 180,A00,083140,Abi Samra; Nicholas Camill,20,0,30,10
1650667883027,ECE 180,B00,083141,Abi Samra; Nicholas Camill,0,0,30,30
1650667889056,MATH 10A,A01,083735,Patchell; Gregory David,3,0,30,27
1650667889056,MATH 10A,A02,083736,Patchell; Gregory David,27,0,30,3
1650667889056,MATH 10A,A03,083737,Patchell; Gregory David,24,0,30,6
1650667895083,MATH 10B,A01,083207,Staff,0,9,30,30
1650667895083,MATH 10B,A02,083208,Staff,1,8,30,29
1650667895083,MATH 10B,B01,083739,Staff,11,0,30,19
1650667895083,MATH 10B,B02,083740,Staff,28,0,30,2
1650667901115,MATH 18,A01,083743,Staff,0,0,30,30
1650667901115,MATH 18,A02,083744,Staff,23,0,30,7
1650667901115,MATH 18,A03,083745,Staff,21,0,30,9
1650667901115,MATH 18,A04,083746,Staff,26,0,30,4
1650667901115,MATH 18,B01,083748,Staff,0,15,30,30
1650667901115,MATH 18,B02,083749,Staff,0,12,30,30
1650667901115,MATH 18,B03,083750,Staff,0,12,30,30
1650667901115,MATH 18,B04,083751,Staff,0,11,30,30
1650667907141,MATH 20A,A01,083754,Staff,19,0,40,21
1650667913164,MATH 20B,A01,083756,Staff,0,11,30,30
1650667913164,MATH 20B,A02,083757,Staff,0,12,30,30
1650667919187,MATH 20C,A01,083760,Staff,0,16,30,30
1650667919187,MATH 20C,A02,083761,Staff,1,14,30,29
1650667919187,MATH 20C,B01,083762,Staff,10,0,30,20
1650667919187,MATH 20C,B02,083763,Staff,28,0,30,2
1650667925218,MATH 20D,A01,083765,Staff,1,1,30,29
1650667925218,MATH 20D,A02,083766,Staff,6,0,30,24
1650667925218,MATH 20D,A03,083767,Staff,24,0,30,6
1650667931242,MATH 20E,A01,083771,Staff,3,0,30,27
1650667931242,MATH 20E,A02,083772,Staff,16,0,30,14
1650667931242,MATH 20E,B01,083773,Staff,0,0,30,30
1650667931242,MATH 20E,B02,083774,Staff,9,0,30,21
1650667937273,MATH 103A,A01,083777,Staff,0,15,30,30
1650667937273,MATH 103A,A02,083778,Staff,0,15,30,30
1650667937273,MATH 103A,B01,083779,Staff,0,14,30,30
1650667937273,MATH 103A,B02,083780,Staff,0,14,30,30
1650667943300,MATH 105,A01,085443,Staff,0,22,30,30
1650667949329,MATH 109,A01,083213,Anzaldo; Leesa B,0,7,30,30
1650667949329,MATH 109,A02,083214,Anzaldo; Leesa B,0,7,30,30
1650667949329,MATH 109,B01,083215,Anzaldo; Leesa B,0,8,30,30
1650667949329,MATH 109,B02,083216,Anzaldo; Leesa B,0,6,30,30
1650667955359,MATH 142A,A01,083219,Chow; Bennett,0,16,30,30
1650667955359,MATH 142A,A02,083220,Chow; Bennett,0,15,30,30
1650667955359,MATH 142A,B01,083221,Chow; Bennett,0,13,30,30
1650667955359,MATH 142A,B02,083222,Chow; Bennett,0,14,30,30
1650667961384,MATH 193A,A01,083224,Staff,0,5,30,30
1650667961384,MATH 193A,A02,083225,Staff,0,6,30,30
1650667961384,MATH 193A,A03,083781,Staff,0,6,30,30
1650667961384,MATH 193A,A04,083782,Staff,0,7,30,30
1650667967406,MATH 197,001,091859,McAuley; Julian John,9998,0,9999,1
1650667973464,COGS 9,A01,083615,Staff,1,16,60,59
1650667979496,COGS 11,A01,083617,Boyle; Mary E. T.,18,0,40,22
1650667985522,COGS 13,A01,083071,Staff,0,39,40,40
1650667991552,COGS 14A,A01,092681,Staff,0,33,100,100
1650667997582,COGS 14B,A01,083073,Cheng; Tzu-Han,1,14,50,49
1650668003613,COGS 17,A01,092677,Staff,15,0,75,60
1650668009640,COGS 100,A01,083619,Staff,0,28,60,60
1650668015673,COGS 101A,A01,083621,Davis; Joshua Daniel,0,27,60,60
1650668021707,COGS 101B,A01,091572,Staff,0,4,60,60
1650668027731,COGS 101C,A01,083625,Delgado; Tania,14,0,30,16
1650668033755,COGS 107A,A01,083627,Boyle; Mary E. T.,1,17,60,59
1650668039785,COGS 118A,A01,083075,Staff,0,7,60,60
1650668045816,CSE 3,A50,083646,Miranda; Gregory Joseph,19,0,38,19
1650668045816,CSE 3,A51,083647,Miranda; Gregory Joseph,36,0,37,1
1650668051919,CSE 8A,A50,083650,Miranda; Gregory Joseph,0,30,40,40
1650668057943,CSE 11,A01,083080,Cao; Yingjun,0,95,40,40
1650668063965,CSE 12,A01,083652,Staff,0,21,100,100
1650668069990,CSE 15L,A01,083654,Staff,0,3,50,50
1650668069990,CSE 15L,A02,083655,Staff,0,2,50,50
1650668076014,CSE 20,A01,083657,Staff,50,0,80,30
1650668082040,CSE 30,A01,083084,Eldon; John,0,78,40,40
1650668088073,CSE 100,A01,083659,Cao; Yingjun,0,69,50,50
1650668094100,CSE 134B,A01,083661,Powell; Thomas Allan,0,37,65,65
1650668100125,CSE 140,A01,083663,Staff,0,9,75,75
1650668106149,CSE 140L,A01,083088,Eldon; John,0,17,75,75
1650668112181,CSE 175,A01,083665,Kumar; Rakesh,7,0,25,18
1650668118217,CSE 190,A00,092507,Dubnov; Shlomo,10,0,20,10
1650668124244,ECE 45,A01,083139,Staff,0,2,60,60
1650668130267,ECE 65,A50,083695,Staff,0,5,30,30
1650668136291,ECE 109,A01,091882,Touri; Behrouz,33,0,70,37
1650668142321,ECE 180,A00,083140,Abi Samra; Nicholas Camill,20,0,30,10
1650668142321,ECE 180,B00,083141,Abi Samra; Nicholas Camill,0,0,30,30
1650668148344,MATH 10A,A01,083735,Patchell; Gregory David,3,0,30,27
1650668148344,MATH 10A,A02,083736,Patchell; Gregory David,27,0,30,3
1650668148344,MATH 10A,A03,083737,Patchell; Gregory David,24,0,30,6
1650668154372,MATH 10B,A01,083207,Staff,0,9,30,30
1650668154372,MATH 10B,A02,083208,Staff,1,8,30,29
1650668154372,MATH 10B,B01,083739,Staff,11,0,30,19
1650668154372,MATH 10B,B02,083740,Staff,28,0,30,2
1650668160425,MATH 18,A01,083743,Staff,0,0,30,30
1650668160425,MATH 18,A02,083744,Staff,23,0,30,7
1650668160425,MATH 18,A03,083745,Staff,21,0,30,9
1650668160425,MATH 18,A04,083746,Staff,26,0,30,4
1650668160425,MATH 18,B01,083748,Staff,0,15,30,30
1650668160425,MATH 18,B02,083749,Staff,0,12,30,30
1650668160425,MATH 18,B03,083750,Staff,0,12,30,30
1650668160425,MATH 18,B04,083751,Staff,0,11,30,30
1650668166447,MATH 20A,A01,083754,Staff,19,0,40,21
1650668172477,MATH 20B,A01,083756,Staff,0,11,30,30
1650668172477,MATH 20B,A02,083757,Staff,0,12,30,30
1650668178506,MATH 20C,A01,083760,Staff,0,16,30,30
1650668178506,MATH 20C,A02,083761,Staff,1,14,30,29
1650668178506,MATH 20C,B01,083762,Staff,10,0,30,20
1650668178506,MATH 20C,B02,083763,Staff,28,0,30,2
1650668184537,MATH 20D,A01,083765,Staff,1,1,30,29
1650668184537,MATH 20D,A02,083766,Staff,6,0,30,24
1650668184537,MATH 20D,A03,083767,Staff,24,0,30,6
1650668190565,MATH 20E,A01,083771,Staff,3,0,30,27
1650668190565,MATH 20E,A02,083772,Staff,16,0,30,14
1650668190565,MATH 20E,B01,083773,Staff,0,0,30,30
1650668190565,MATH 20E,B02,083774,Staff,9,0,30,21
1650668196592,MATH 103A,A01,083777,Staff,0,15,30,30
1650668196592,MATH 103A,A02,083778,Staff,0,15,30,30
1650668196592,MATH 103A,B01,083779,Staff,0,14,30,30
1650668196592,MATH 103A,B02,083780,Staff,0,14,30,30
1650668202617,MATH 105,A01,085443,Staff,0,22,30,30
1650668208646,MATH 109,A01,083213,Anzaldo; Leesa B,0,7,30,30
1650668208646,MATH 109,A02,083214,Anzaldo; Leesa B,0,7,30,30
1650668208646,MATH 109,B01,083215,Anzaldo; Leesa B,0,8,30,30
1650668208646,MATH 109,B02,083216,Anzaldo; Leesa B,0,6,30,30
1650668214670,MATH 142A,A01,083219,Chow; Bennett,0,16,30,30
1650668214670,MATH 142A,A02,083220,Chow; Bennett,0,15,30,30
1650668214670,MATH 142A,B01,083221,Chow; Bennett,0,13,30,30
1650668214670,MATH 142A,B02,083222,Chow; Bennett,0,14,30,30
1650668220695,MATH 193A,A01,083224,Staff,0,5,30,30
1650668220695,MATH 193A,A02,083225,Staff,0,6,30,30
1650668220695,MATH 193A,A03,083781,Staff,0,6,30,30
1650668220695,MATH 193A,A04,083782,Staff,0,7,30,30
1650668226722,MATH 197,001,091859,McAuley; Julian John,9998,0,9999,1
1650668232783,COGS 9,A01,083615,Staff,1,16,60,59
1650668238808,COGS 11,A01,083617,Boyle; Mary E. T.,18,0,40,22
1650668244833,COGS 13,A01,083071,Staff,0,39,40,40
1650668250864,COGS 14A,A01,092681,Staff,0,33,100,100
1650668256896,COGS 14B,A01,083073,Cheng; Tzu-Han,1,14,50,49
1650668262923,COGS 17,A01,092677,Staff,15,0,75,60
1650668268945,COGS 100,A01,083619,Staff,0,28,60,60
1650668274973,COGS 101A,A01,083621,Davis; Joshua Daniel,0,27,60,60
1650668280996,COGS 101B,A01,091572,Staff,0,4,60,60
1650668287020,COGS 101C,A01,083625,Delgado; Tania,14,0,30,16
1650668293055,COGS 107A,A01,083627,Boyle; Mary E. T.,1,17,60,59
1650668299077,COGS 118A,A01,083075,Staff,0,7,60,60
1650668305103,CSE 3,A50,083646,Miranda; Gregory Joseph,19,0,38,19
1650668305103,CSE 3,A51,083647,Miranda; Gregory Joseph,36,0,37,1
1650668311130,CSE 8A,A50,083650,Miranda; Gregory Joseph,0,30,40,40
1650668317157,CSE 11,A01,083080,Cao; Yingjun,0,95,40,40
1650668323182,CSE 12,A01,083652,Staff,0,21,100,100
1650668329208,CSE 15L,A01,083654,Staff,0,3,50,50
1650668329208,CSE 15L,A02,083655,Staff,0,2,50,50
1650668335232,CSE 20,A01,083657,Staff,50,0,80,30
1650668341276,CSE 30,A01,083084,Eldon; John,0,78,40,40
1650668347299,CSE 100,A01,083659,Cao; Yingjun,0,69,50,50
1650668353329,CSE 134B,A01,083661,Powell; Thomas Allan,0,37,65,65
1650668359355,CSE 140,A01,083663,Staff,0,9,75,75
1650668365381,CSE 140L,A01,083088,Eldon; John,0,17,75,75
1650668371407,CSE 175,A01,083665,Kumar; Rakesh,7,0,25,18
1650668377428,CSE 190,A00,092507,Dubnov; Shlomo,10,0,20,10
1650668383451,ECE 45,A01,083139,Staff,0,2,60,60
1650668389482,ECE 65,A50,083695,Staff,0,5,30,30
1650668395516,ECE 109,A01,091882,Touri; Behrouz,33,0,70,37
1650668401542,ECE 180,A00,083140,Abi Samra; Nicholas Camill,20,0,30,10
1650668401542,ECE 180,B00,083141,Abi Samra; Nicholas Camill,0,0,30,30
1650668407565,MATH 10A,A01,083735,Patchell; Gregory David,3,0,30,27
1650668407565,MATH 10A,A02,083736,Patchell; Gregory David,27,0,30,3
1650668407565,MATH 10A,A03,083737,Patchell; Gregory David,24,0,30,6
1650668413589,MATH 10B,A01,083207,Staff,0,9,30,30
1650668413589,MATH 10B,A02,083208,Staff,1,8,30,29
1650668413589,MATH 10B,B01,083739,Staff,11,0,30,19
1650668413589,MATH 10B,B02,083740,Staff,28,0,30,2
1650668419622,MATH 18,A01,083743,Staff,0,0,30,30
1650668419622,MATH 18,A02,083744,Staff,23,0,30,7
1650668419622,MATH 18,A03,083745,Staff,21,0,30,9
1650668419622,MATH 18,A04,083746,Staff,26,0,30,4
1650668419622,MATH 18,B01,083748,Staff,0,15,30,30
1650668419622,MATH 18,B02,083749,Staff,0,12,30,30
1650668419622,MATH 18,B03,083750,Staff,0,12,30,30
1650668419622,MATH 18,B04,083751,Staff,0,11,30,30
1650668425652,MATH 20A,A01,083754,Staff,19,0,40,21
1650668431691,MATH 20B,A01,083756,Staff,0,11,30,30
1650668431691,MATH 20B,A02,083757,Staff,0,12,30,30
1650668437718,MATH 20C,A01,083760,Staff,0,16,30,30
1650668437718,MATH 20C,A02,083761,Staff,1,14,30,29
1650668437718,MATH 20C,B01,083762,Staff,10,0,30,20
1650668437718,MATH 20C,B02,083763,Staff,28,0,30,2
1650668443755,MATH 20D,A01,083765,Staff,1,1,30,29
1650668443755,MATH 20D,A02,083766,Staff,6,0,30,24
1650668443755,MATH 20D,A03,083767,Staff,24,0,30,6
1650668449787,MATH 20E,A01,083771,Staff,3,0,30,27
1650668449787,MATH 20E,A02,083772,Staff,16,0,30,14
1650668449787,MATH 20E,B01,083773,Staff,0,0,30,30
1650668449787,MATH 20E,B02,083774,Staff,9,0,30,21
1650668455813,MATH 103A,A01,083777,Staff,0,15,30,30
1650668455813,MATH 103A,A02,083778,Staff,0,15,30,30
1650668455813,MATH 103A,B01,083779,Staff,0,14,30,30
1650668455813,MATH 103A,B02,083780,Staff,0,14,30,30
1650668461841,MATH 105,A01,085443,Staff,0,22,30,30
1650668467880,MATH 109,A01,083213,Anzaldo; Leesa B,0,7,30,30
1650668467880,MATH 109,A02,083214,Anzaldo; Leesa B,0,7,30,30
1650668467880,MATH 109,B01,083215,Anzaldo; Leesa B,0,8,30,30
1650668467880,MATH 109,B02,083216,Anzaldo; Leesa B,0,6,30,30
1650668473914,MATH 142A,A01,083219,Chow; Bennett,0,16,30,30
1650668473914,MATH 142A,A02,083220,Chow; Bennett,0,15,30,30
1650668473914,MATH 142A,B01,083221,Chow; Bennett,0,13,30,30
1650668473914,MATH 142A,B02,083222,Chow; Bennett,0,14,30,30
1650668479941,MATH 193A,A01,083224,Staff,0,5,30,30
1650668479941,MATH 193A,A02,083225,Staff,0,6,30,30
1650668479941,MATH 193A,A03,083781,Staff,0,6,30,30
1650668479941,MATH 193A,A04,083782,Staff,0,7,30,30
1650668485971,MATH 197,001,091859,McAuley; Julian John,9998,0,9999,1
1650668492036,COGS 9,A01,083615,Staff,1,16,60,59
1650668498063,COGS 11,A01,083617,Boyle; Mary E. T.,18,0,40,22
1650668504093,COGS 13,A01,083071,Staff,0,39,40,40
1650668510119,COGS 14A,A01,092681,Staff,0,33,100,100
1650668516141,COGS 14B,A01,083073,Cheng; Tzu-Han,1,14,50,49
1650668522166,COGS 17,A01,092677,Staff,15,0,75,60
1650668528193,COGS 100,A01,083619,Staff,0,28,60,60
1650668534216,COGS 101A,A01,083621,Davis; Joshua Daniel,0,27,60,60
1650668540256,COGS 101B,A01,091572,Staff,0,4,60,60
1650668546281,COGS 101C,A01,083625,Delgado; Tania,14,0,30,16
1650668552304,COGS 107A,A01,083627,Boyle; Mary E. T.,1,17,60,59
1650668558328,COGS 118A,A01,083075,Staff,0,7,60,60
1650668564355,CSE 3,A50,083646,Miranda; Gregory Joseph,19,0,38,19
1650668564355,CSE 3,A51,083647,Miranda; Gregory Joseph,36,0,37,1
1650668570380,CSE 8A,A50,083650,Miranda; Gregory Joseph,0,30,40,40
1650668576403,CSE 11,A01,083080,Cao; Yingjun,0,95,40,40
1650668582427,CSE 12,A01,083652,Staff,0,21,100,100
1650668588453,CSE 15L,A01,083654,Staff,0,3,50,50
1650668588453,CSE 15L,A02,083655,Staff,0,2,50,50
1650668594479,CSE 20,A01,083657,Staff,50,0,80,30
1650668600502,CSE 30,A01,083084,Eldon; John,0,78,40,40
1650668606524,CSE 100,A01,083659,Cao; Yingjun,0,69,50,50
1650668612547,CSE 134B,A01,083661,Powell; Thomas Allan,0,37,65,65
1650668618576,CSE 140,A01,083663,Staff,0,9,75,75
1650668624613,CSE 140L,A01,083088,Eldon; John,0,17,75,75
1650668630639,CSE 175,A01,083665,Kumar; Rakesh,7,0,25,18
1650668636669,CSE 190,A00,092507,Dubnov; Shlomo,10,0,20,10
1650668642717,ECE 45,A01,083139,Staff,0,2,60,60
1650668648822,ECE 65,A50,083695,Staff,0,5,30,30
1650668654855,ECE 109,A01,091882,Touri; Behrouz,33,0,70,37
1650668660879,ECE 180,A00,083140,Abi Samra; Nicholas Camill,20,0,30,10
1650668660879,ECE 180,B00,083141,Abi Samra; Nicholas Camill,0,0,30,30
1650668666907,MATH 10A,A01,083735,Patchell; Gregory David,3,0,30,27
1650668666907,MATH 10A,A02,083736,Patchell; Gregory David,27,0,30,3
1650668666907,MATH 10A,A03,083737,Patchell; Gregory David,24,0,30,6
1650668672937,MATH 10B,A01,083207,Staff,0,9,30,30
1650668672937,MATH 10B,A02,083208,Staff,1,8,30,29
1650668672937,MATH 10B,B01,083739,Staff,11,0,30,19
1650668672937,MATH 10B,B02,083740,Staff,28,0,30,2
1650668678963,MATH 18,A01,083743,Staff,0,0,30,30
1650668678963,MATH 18,A02,083744,Staff,23,0,30,7
1650668678963,MATH 18,A03,083745,Staff,21,0,30,9
1650668678963,MATH 18,A04,083746,Staff,26,0,30,4
1650668678963,MATH 18,B01,083748,Staff,0,15,30,30
1650668678963,MATH 18,B02,083749,Staff,0,12,30,30
1650668678963,MATH 18,B03,083750,Staff,0,12,30,30
1650668678963,MATH 18,B04,083751,Staff,0,11,30,30
1650668684988,MATH 20A,A01,083754,Staff,19,0,40,21
1650668691012,MATH 20B,A01,083756,Staff,0,11,30,30
1650668691012,MATH 20B,A02,083757,Staff,0,12,30,30
1650668697053,MATH 20C,A01,083760,Staff,0,16,30,30
1650668697053,MATH 20C,A02,083761,Staff,1,14,30,29
1650668697053,MATH 20C,B01,083762,Staff,10,0,30,20
1650668697053,MATH 20C,B02,083763,Staff,28,0,30,2
1650668703090,MATH 20D,A01,083765,Staff,1,1,30,29
1650668703090,MATH 20D,A02,083766,Staff,6,0,30,24
1650668703090,MATH 20D,A03,083767,Staff,24,0,30,6
1650668709117,MATH 20E,A01,083771,Staff,3,0,30,27
1650668709117,MATH 20E,A02,083772,Staff,16,0,30,14
1650668709117,MATH 20E,B01,083773,Staff,0,0,30,30
1650668709117,MATH 20E,B02,083774,Staff,9,0,30,21
1650668715145,MATH 103A,A01,083777,Staff,0,15,30,30
1650668715145,MATH 103A,A02,083778,Staff,0,15,30,30
1650668715145,MATH 103A,B01,083779,Staff,0,14,30,30
1650668715145,MATH 103A,B02,083780,Staff,0,14,30,30
1650668721169,MATH 105,A01,085443,Staff,0,22,30,30
1650668727194,MATH 109,A01,083213,Anzaldo; Leesa B,0,7,30,30
1650668727194,MATH 109,A02,083214,Anzaldo; Leesa B,0,7,30,30
1650668727194,MATH 109,B01,083215,Anzaldo; Leesa B,0,8,30,30
1650668727194,MATH 109,B02,083216,Anzaldo; Leesa B,0,6,30,30
1650668733221,MATH 142A,A01,083219,Chow; Bennett,0,16,30,30
1650668733221,MATH 142A,A02,083220,Chow; Bennett,0,15,30,30
1650668733221,MATH 142A,B01,083221,Chow; Bennett,0,13,30,30
1650668733221,MATH 142A,B02,083222,Chow; Bennett,0,14,30,30
1650668739256,MATH 193A,A01,083224,Staff,0,5,30,30
1650668739256,MATH 193A,A02,083225,Staff,0,6,30,30
1650668739256,MATH 193A,A03,083781,Staff,0,6,30,30
1650668739256,MATH 193A,A04,083782,Staff,0,7,30,30
1650668745279,MATH 197,001,091859,McAuley; Julian John,9998,0,9999,1
1650668751345,COGS 9,A01,083615,Staff,1,16,60,59
1650668757368,COGS 11,A01,083617,Boyle; Mary E. T.,18,0,40,22
1650668763406,COGS 13,A01,083071,Staff,0,39,40,40
1650668769429,COGS 14A,A01,092681,Staff,0,33,100,100
1650668775458,COGS 14B,A01,083073,Cheng; Tzu-Han,1,14,50,49
1650668781483,COGS 17,A01,092677,Staff,15,0,75,60
1650668787506,COGS 100,A01,083619,Staff,0,28,60,60
1650668793528,COGS 101A,A01,083621,Davis; Joshua Daniel,0,27,60,60
1650668799554,COGS 101B,A01,091572,Staff,0,4,60,60
1650668805609,COGS 101C,A01,083625,Delgado; Tania,14,0,30,16
1650668811631,COGS 107A,A01,083627,Boyle; Mary E. T.,1,17,60,59
1650668817654,COGS 118A,A01,083075,Staff,0,7,60,60
1650668823677,CSE 3,A50,083646,Miranda; Gregory Joseph,19,0,38,19
1650668823677,CSE 3,A51,083647,Miranda; Gregory Joseph,36,0,37,1
1650668829707,CSE 8A,A50,083650,Miranda; Gregory Joseph,0,30,40,40
1650668835734,CSE 11,A01,083080,Cao; Yingjun,0,95,40,40
1650668841759,CSE 12,A01,083652,Staff,0,21,100,100
1650668847788,CSE 15L,A01,083654,Staff,0,3,50,50
1650668847788,CSE 15L,A02,083655,Staff,0,2,50,50
1650668853812,CSE 20,A01,083657,Staff,50,0,80,30
1650668859835,CSE 30,A01,083084,Eldon; John,0,78,40,40
1650668865866,CSE 100,A01,083659,Cao; Yingjun,0,69,50,50
1650668871890,CSE 134B,A01,083661,Powell; Thomas Allan,0,37,65,65
1650668877913,CSE 140,A01,083663,Staff,0,9,75,75
1650668883937,CSE 140L,A01,083088,Eldon; John,0,17,75,75
1650668889962,CSE 175,A01,083665,Kumar; Rakesh,7,0,25,18
1650668895985,CSE 190,A00,092507,Dubnov; Shlomo,10,0,20,10
1650668902017,ECE 45,A01,083139,Staff,0,2,60,60
1650668908040,ECE 65,A50,083695,Staff,0,5,30,30
1650668914068,ECE 109,A01,091882,Touri; Behrouz,33,0,70,37
1650668920093,ECE 180,A00,083140,Abi Samra; Nicholas Camill,20,0,30,10
1650668920093,ECE 180,B00,083141,Abi Samra; Nicholas Camill,0,0,30,30
1650668926117,MATH 10A,A01,083735,Patchell; Gregory David,3,0,30,27
1650668926117,MATH 10A,A02,083736,Patchell; Gregory David,27,0,30,3
1650668926117,MATH 10A,A03,083737,Patchell; Gregory David,24,0,30,6
1650668932141,MATH 10B,A01,083207,Staff,0,9,30,30
1650668932141,MATH 10B,A02,083208,Staff,1,8,30,29
1650668932141,MATH 10B,B01,083739,Staff,11,0,30,19
1650668932141,MATH 10B,B02,083740,Staff,28,0,30,2
1650668938170,MATH 18,A01,083743,Staff,0,0,30,30
1650668938170,MATH 18,A02,083744,Staff,23,0,30,7
1650668938170,MATH 18,A03,083745,Staff,21,0,30,9
1650668938170,MATH 18,A04,083746,Staff,26,0,30,4
1650668938170,MATH 18,B01,083748,Staff,0,15,30,30
1650668938170,MATH 18,B02,083749,Staff,0,12,30,30
1650668938170,MATH 18,B03,083750,Staff,0,12,30,30
1650668938170,MATH 18,B04,083751,Staff,0,11,30,30
1650668944202,MATH 20A,A01,083754,Staff,19,0,40,21
1650668950226,MATH 20B,A01,083756,Staff,0,11,30,30
1650668950226,MATH 20B,A02,083757,Staff,0,12,30,30
1650668956250,MATH 20C,A01,083760,Staff,0,16,30,30
1650668956250,MATH 20C,A02,083761,Staff,1,14,30,29
1650668956250,MATH 20C,B01,083762,Staff,10,0,30,20
1650668956250,MATH 20C,B02,083763,Staff,28,0,30,2
1650668962280,MATH 20D,A01,083765,Staff,1,1,30,29
1650668962280,MATH 20D,A02,083766,Staff,6,0,30,24
1650668962280,MATH 20D,A03,083767,Staff,24,0,30,6
1650668968313,MATH 20E,A01,083771,Staff,3,0,30,27
1650668968313,MATH 20E,A02,083772,Staff,16,0,30,14
1650668968313,MATH 20E,B01,083773,Staff,0,0,30,30
1650668968313,MATH 20E,B02,083774,Staff,9,0,30,21
1650668974348,MATH 103A,A01,083777,Staff,0,15,30,30
1650668974348,MATH 103A,A02,083778,Staff,0,15,30,30
1650668974348,MATH 103A,B01,083779,Staff,0,14,30,30
1650668974348,MATH 103A,B02,083780,Staff,0,14,30,30
1650668980372,MATH 105,A01,085443,Staff,0,22,30,30
1650668986395,MATH 109,A01,083213,Anzaldo; Leesa B,0,7,30,30
1650668986395,MATH 109,A02,083214,Anzaldo; Leesa B,0,7,30,30
1650668986395,MATH 109,B01,083215,Anzaldo; Leesa B,0,8,30,30
1650668986395,MATH 109,B02,083216,Anzaldo; Leesa B,0,6,30,30
1650668992430,MATH 142A,A01,083219,Chow; Bennett,0,16,30,30
1650668992430,MATH 142A,A02,083220,Chow; Bennett,0,15,30,30
1650668992430,MATH 142A,B01,083221,Chow; Bennett,0,13,30,30
1650668992430,MATH 142A,B02,083222,Chow; Bennett,0,14,30,30
1650668998457,MATH 193A,A01,083224,Staff,0,5,30,30
1650668998457,MATH 193A,A02,083225,Staff,0,6,30,30
1650668998457,MATH 193A,A03,083781,Staff,0,6,30,30
1650668998457,MATH 193A,A04,083782,Staff,0,7,30,30
1650669004484,MATH 197,001,091859,McAuley; Julian John,9998,0,9999,1
1650669010544,COGS 9,A01,083615,Staff,1,16,60,59
1650669016568,COGS 11,A01,083617,Boyle; Mary E. T.,18,0,40,22
1650669022592,COGS 13,A01,083071,Staff,0,39,40,40
1650669028617,COGS 14A,A01,092681,Staff,0,33,100,100
1650669034643,COGS 14B,A01,083073,Cheng; Tzu-Han,1,14,50,49
1650669040668,COGS 17,A01,092677,Staff,15,0,75,60
1650669046701,COGS 100,A01,083619,Staff,0,28,60,60
1650669052726,COGS 101A,A01,083621,Davis; Joshua Daniel,0,27,60,60
1650669058750,COGS 101B,A01,091572,Staff,0,4,60,60
1650669064775,COGS 101C,A01,083625,Delgado; Tania,14,0,30,16
1650669070799,COGS 107A,A01,083627,Boyle; Mary E. T.,1,17,60,59
1650669076823,COGS 118A,A01,083075,Staff,0,7,60,60
1650669082847,CSE 3,A50,083646,Miranda; Gregory Joseph,19,0,38,19
1650669082847,CSE 3,A51,083647,Miranda; Gregory Joseph,36,0,37,1
1650669088878,CSE 8A,A50,083650,Miranda; Gregory Joseph,0,30,40,40
1650669094900,CSE 11,A01,083080,Cao; Yingjun,0,95,40,40
1650669100924,CSE 12,A01,083652,Staff,0,21,100,100
1650669106951,CSE 15L,A01,083654,Staff,0,3,50,50
1650669106951,CSE 15L,A02,083655,Staff,0,2,50,50
1650669112975,CSE 20,A01,083657,Staff,50,0,80,30
1650669119017,CSE 30,A01,083084,Eldon; John,0,78,40,40
1650669125059,CSE 100,A01,083659,Cao; Yingjun,0,69,50,50
1650669131091,CSE 134B,A01,083661,Powell; Thomas Allan,0,37,65,65
1650669137114,CSE 140,A01,083663,Staff,0,9,75,75
1650669143142,CSE 140L,A01,083088,Eldon; John,0,17,75,75
1650669149168,CSE 175,A01,083665,Kumar; Rakesh,7,0,25,18
1650669155192,CSE 190,A00,092507,Dubnov; Shlomo,10,0,20,10
1650669161219,ECE 45,A01,083139,Staff,0,2,60,60
1650669167249,ECE 65,A50,083695,Staff,0,5,30,30
1650669173276,ECE 109,A01,091882,Touri; Behrouz,33,0,70,37
1650669179300,ECE 180,A00,083140,Abi Samra; Nicholas Camill,20,0,30,10
1650669179300,ECE 180,B00,083141,Abi Samra; Nicholas Camill,0,0,30,30
1650669185326,MATH 10A,A01,083735,Patchell; Gregory David,3,0,30,27
1650669185326,MATH 10A,A02,083736,Patchell; Gregory David,27,0,30,3
1650669185326,MATH 10A,A03,083737,Patchell; Gregory David,24,0,30,6
1650669191349,MATH 10B,A01,083207,Staff,0,9,30,30
1650669191349,MATH 10B,A02,083208,Staff,1,8,30,29
1650669191349,MATH 10B,B01,083739,Staff,11,0,30,19
1650669191349,MATH 10B,B02,083740,Staff,28,0,30,2
1650669197377,MATH 18,A01,083743,Staff,0,0,30,30
1650669197377,MATH 18,A02,083744,Staff,23,0,30,7
1650669197377,MATH 18,A03,083745,Staff,21,0,30,9
1650669197377,MATH 18,A04,083746,Staff,26,0,30,4
1650669197377,MATH 18,B01,083748,Staff,0,15,30,30
1650669197377,MATH 18,B02,083749,Staff,0,12,30,30
1650669197377,MATH 18,B03,083750,Staff,0,12,30,30
1650669197377,MATH 18,B04,083751,Staff,0,11,30,30
1650669203403,MATH 20A,A01,083754,Staff,19,0,40,21
1650669209426,MATH 20B,A01,083756,Staff,0,11,30,30
1650669209426,MATH 20B,A02,083757,Staff,0,12,30,30
1650669215457,MATH 20C,A01,083760,Staff,0,16,30,30
1650669215457,MATH 20C,A02,083761,Staff,1,14,30,29
1650669215457,MATH 20C,B01,083762,Staff,10,0,30,20
1650669215457,MATH 20C,B02,083763,Staff,28,0,30,2
1650669221487,MATH 20D,A01,083765,Staff,1,1,30,29
1650669221487,MATH 20D,A02,083766,Staff,6,0,30,24
1650669221487,MATH 20D,A03,083767,Staff,24,0,30,6
1650669227510,MATH 20E,A01,083771,Staff,3,0,30,27
1650669227510,MATH 20E,A02,083772,Staff,16,0,30,14
1650669227510,MATH 20E,B01,083773,Staff,0,0,30,30
1650669227510,MATH 20E,B02,083774,Staff,9,0,30,21
1650669233537,MATH 103A,A01,083777,Staff,0,15,30,30
1650669233537,MATH 103A,A02,083778,Staff,0,15,30,30
1650669233537,MATH 103A,B01,083779,Staff,0,14,30,30
1650669233537,MATH 103A,B02,083780,Staff,0,14,30,30
1650669239561,MATH 105,A01,085443,Staff,0,22,30,30
1650669245657,MATH 109,A01,083213,Anzaldo; Leesa B,0,7,30,30
1650669245657,MATH 109,A02,083214,Anzaldo; Leesa B,0,7,30,30
1650669245657,MATH 109,B01,083215,Anzaldo; Leesa B,0,8,30,30
1650669245657,MATH 109,B02,083216,Anzaldo; Leesa B,0,6,30,30
1650669251695,MATH 142A,A01,083219,Chow; Bennett,0,16,30,30
1650669251695,MATH 142A,A02,083220,Chow; Bennett,0,15,30,30
1650669251695,MATH 142A,B01,083221,Chow; Bennett,0,13,30,30
1650669251695,MATH 142A,B02,083222,Chow; Bennett,0,14,30,30
1650669257727,MATH 193A,A01,083224,Staff,0,5,30,30
1650669257727,MATH 193A,A02,083225,Staff,0,6,30,30
1650669257727,MATH 193A,A03,083781,Staff,0,6,30,30
1650669257727,MATH 193A,A04,083782,Staff,0,7,30,30
1650669263753,MATH 197,001,091859,McAuley; Julian John,9998,0,9999,1
1650669269817,COGS 9,A01,083615,Staff,1,16,60,59
1650669275840,COGS 11,A01,083617,Boyle; Mary E. T.,18,0,40,22
1650669281865,COGS 13,A01,083071,Staff,0,39,40,40
1650669287890,COGS 14A,A01,092681,Staff,0,32,100,100
1650669293914,COGS 14B,A01,083073,Cheng; Tzu-Han,1,14,50,49
1650669299937,COGS 17,A01,092677,Staff,15,0,75,60
1650669305965,COGS 100,A01,083619,Staff,0,28,60,60
1650669311990,COGS 101A,A01,083621,Davis; Joshua Daniel,0,27,60,60
1650669318012,COGS 101B,A01,091572,Staff,0,4,60,60
1650669324042,COGS 101C,A01,083625,Delgado; Tania,14,0,30,16
1650669330066,COGS 107A,A01,083627,Boyle; Mary E. T.,1,17,60,59
1650669336092,COGS 118A,A01,083075,Staff,0,7,60,60
1650669342120,CSE 3,A50,083646,Miranda; Gregory Joseph,19,0,38,19
1650669342120,CSE 3,A51,083647,Miranda; Gregory Joseph,36,0,37,1
1650669348144,CSE 8A,A50,083650,Miranda; Gregory Joseph,0,30,40,40
1650669354171,CSE 11,A01,083080,Cao; Yingjun,0,95,40,40
1650669360198,CSE 12,A01,083652,Staff,0,21,100,100
1650669366219,CSE 15L,A01,083654,Staff,0,3,50,50
1650669366219,CSE 15L,A02,083655,Staff,0,2,50,50
1650669372245,CSE 20,A01,083657,Staff,50,0,80,30
1650669378273,CSE 30,A01,083084,Eldon; John,0,78,40,40
1650669384297,CSE 100,A01,083659,Cao; Yingjun,0,69,50,50
1650669390322,CSE 134B,A01,083661,Powell; Thomas Allan,0,37,65,65
1650669396346,CSE 140,A01,083663,Staff,0,9,75,75
1650669402386,CSE 140L,A01,083088,Eldon; John,0,17,75,75
1650669408410,CSE 175,A01,083665,Kumar; Rakesh,7,0,25,18
1650669414435,CSE 190,A00,092507,Dubnov; Shlomo,10,0,20,10
1650669420459,ECE 45,A01,083139,Staff,0,2,60,60
1650669426482,ECE 65,A50,083695,Staff,0,5,30,30
1650669432511,ECE 109,A01,091882,Touri; Behrouz,33,0,70,37
1650669438542,ECE 180,A00,083140,Abi Samra; Nicholas Camill,20,0,30,10
1650669438542,ECE 180,B00,083141,Abi Samra; Nicholas Camill,0,0,30,30
1650669444569,MATH 10A,A01,083735,Patchell; Gregory David,3,0,30,27
1650669444569,MATH 10A,A02,083736,Patchell; Gregory David,27,0,30,3
1650669444569,MATH 10A,A03,083737,Patchell; Gregory David,24,0,30,6
1650669450592,MATH 10B,A01,083207,Staff,0,9,30,30
1650669450592,MATH 10B,A02,083208,Staff,1,8,30,29
1650669450592,MATH 10B,B01,083739,Staff,11,0,30,19
1650669450592,MATH 10B,B02,083740,Staff,28,0,30,2
1650669456615,MATH 18,A01,083743,Staff,0,0,30,30
1650669456615,MATH 18,A02,083744,Staff,23,0,30,7
1650669456615,MATH 18,A03,083745,Staff,21,0,30,9
1650669456615,MATH 18,A04,083746,Staff,26,0,30,4
1650669456615,MATH 18,B01,083748,Staff,0,15,30,30
1650669456615,MATH 18,B02,083749,Staff,0,12,30,30
1650669456615,MATH 18,B03,083750,Staff,0,12,30,30
1650669456615,MATH 18,B04,083751,Staff,0,11,30,30
1650669462639,MATH 20A,A01,083754,Staff,19,0,40,21
1650669468668,MATH 20B,A01,083756,Staff,0,11,30,30
1650669468668,MATH 20B,A02,083757,Staff,0,12,30,30
1650669474694,MATH 20C,A01,083760,Staff,0,16,30,30
1650669474694,MATH 20C,A02,083761,Staff,1,14,30,29
1650669474694,MATH 20C,B01,083762,Staff,10,0,30,20
1650669474694,MATH 20C,B02,083763,Staff,28,0,30,2
1650669480726,MATH 20D,A01,083765,Staff,1,1,30,29
1650669480726,MATH 20D,A02,083766,Staff,6,0,30,24
1650669480726,MATH 20D,A03,083767,Staff,24,0,30,6
1650669486751,MATH 20E,A01,083771,Staff,3,0,30,27
1650669486751,MATH 20E,A02,083772,Staff,16,0,30,14
1650669486751,MATH 20E,B01,083773,Staff,0,0,30,30
1650669486751,MATH 20E,B02,083774,Staff,9,0,30,21
1650669492774,MATH 103A,A01,083777,Staff,0,15,30,30
1650669492774,MATH 103A,A02,083778,Staff,0,15,30,30
1650669492774,MATH 103A,B01,083779,Staff,0,14,30,30
1650669492774,MATH 103A,B02,083780,Staff,0,14,30,30
1650669498797,MATH 105,A01,085443,Staff,0,22,30,30
1650669504820,MATH 109,A01,083213,Anzaldo; Leesa B,0,7,30,30
1650669504820,MATH 109,A02,083214,Anzaldo; Leesa B,0,7,30,30
1650669504820,MATH 109,B01,083215,Anzaldo; Leesa B,0,8,30,30
1650669504820,MATH 109,B02,083216,Anzaldo; Leesa B,0,6,30,30
1650669510844,MATH 142A,A01,083219,Chow; Bennett,0,16,30,30
1650669510844,MATH 142A,A02,083220,Chow; Bennett,0,15,30,30
1650669510844,MATH 142A,B01,083221,Chow; Bennett,0,13,30,30
1650669510844,MATH 142A,B02,083222,Chow; Bennett,0,14,30,30
1650669516868,MATH 193A,A01,083224,Staff,0,5,30,30
1650669516868,MATH 193A,A02,083225,Staff,0,6,30,30
1650669516868,MATH 193A,A03,083781,Staff,0,6,30,30
1650669516868,MATH 193A,A04,083782,Staff,0,7,30,30
1650669522901,MATH 197,001,091859,McAuley; Julian John,9998,0,9999,1
1650669528954,COGS 9,A01,083615,Staff,1,16,60,59
1650669534978,COGS 11,A01,083617,Boyle; Mary E. T.,18,0,40,22
1650669541005,COGS 13,A01,083071,Staff,0,39,40,40
1650669547028,COGS 14A,A01,092681,Staff,0,32,100,100
1650669553052,COGS 14B,A01,083073,Cheng; Tzu-Han,1,14,50,49
1650669559078,COGS 17,A01,092677,Staff,15,0,75,60
1650669565104,COGS 100,A01,083619,Staff,0,28,60,60
1650669571129,COGS 101A,A01,083621,Davis; Joshua Daniel,0,27,60,60
1650669577152,COGS 101B,A01,091572,Staff,0,4,60,60
1650669583173,COGS 101C,A01,083625,Delgado; Tania,14,0,30,16
1650669589199,COGS 107A,A01,083627,Boyle; Mary E. T.,1,17,60,59
1650669595223,COGS 118A,A01,083075,Staff,0,7,60,60
1650669601251,CSE 3,A50,083646,Miranda; Gregory Joseph,19,0,38,19
1650669601251,CSE 3,A51,083647,Miranda; Gregory Joseph,36,0,37,1
1650669607278,CSE 8A,A50,083650,Miranda; Gregory Joseph,0,30,40,40
1650669613305,CSE 11,A01,083080,Cao; Yingjun,0,95,40,40
1650669619328,CSE 12,A01,083652,Staff,0,21,100,100
1650669625351,CSE 15L,A01,083654,Staff,0,3,50,50
1650669625351,CSE 15L,A02,083655,Staff,0,2,50,50
1650669631381,CSE 20,A01,083657,Staff,50,0,80,30
1650669637408,CSE 30,A01,083084,Eldon; John,0,78,40,40
1650669643432,CSE 100,A01,083659,Cao; Yingjun,0,69,50,50
1650669649454,CSE 134B,A01,083661,Powell; Thomas Allan,0,37,65,65
1650669655476,CSE 140,A01,083663,Staff,0,9,75,75
1650669661501,CSE 140L,A01,083088,Eldon; John,0,17,75,75
1650669667531,CSE 175,A01,083665,Kumar; Rakesh,7,0,25,18
1650669673558,CSE 190,A00,092507,Dubnov; Shlomo,10,0,20,10
1650669679595,ECE 45,A01,083139,Staff,0,2,60,60
1650669685617,ECE 65,A50,083695,Staff,0,5,30,30
1650669691644,ECE 109,A01,091882,Touri; Behrouz,33,0,70,37
1650669697674,ECE 180,A00,083140,Abi Samra; Nicholas Camill,20,0,30,10
1650669697674,ECE 180,B00,083141,Abi Samra; Nicholas Camill,0,0,30,30
1650669703704,MATH 10A,A01,083735,Patchell; Gregory David,3,0,30,27
1650669703704,MATH 10A,A02,083736,Patchell; Gregory David,27,0,30,3
1650669703704,MATH 10A,A03,083737,Patchell; Gregory David,24,0,30,6
1650669709728,MATH 10B,A01,083207,Staff,0,9,30,30
1650669709728,MATH 10B,A02,083208,Staff,1,8,30,29
1650669709728,MATH 10B,B01,083739,Staff,11,0,30,19
1650669709728,MATH 10B,B02,083740,Staff,28,0,30,2
1650669715752,MATH 18,A01,083743,Staff,0,0,30,30
1650669715752,MATH 18,A02,083744,Staff,23,0,30,7
1650669715752,MATH 18,A03,083745,Staff,21,0,30,9
1650669715752,MATH 18,A04,083746,Staff,26,0,30,4
1650669715752,MATH 18,B01,083748,Staff,0,15,30,30
1650669715752,MATH 18,B02,083749,Staff,0,12,30,30
1650669715752,MATH 18,B03,083750,Staff,0,12,30,30
1650669715752,MATH 18,B04,083751,Staff,0,12,30,30
1650669721776,MATH 20A,A01,083754,Staff,19,0,40,21
1650669727800,MATH 20B,A01,083756,Staff,0,11,30,30
1650669727800,MATH 20B,A02,083757,Staff,0,12,30,30
1650669733824,MATH 20C,A01,083760,Staff,0,16,30,30
1650669733824,MATH 20C,A02,083761,Staff,1,14,30,29
1650669733824,MATH 20C,B01,083762,Staff,10,0,30,20
1650669733824,MATH 20C,B02,083763,Staff,28,0,30,2
1650669739851,MATH 20D,A01,083765,Staff,1,1,30,29
1650669739851,MATH 20D,A02,083766,Staff,6,0,30,24
1650669739851,MATH 20D,A03,083767,Staff,24,0,30,6
1650669745889,MATH 20E,A01,083771,Staff,3,0,30,27
1650669745889,MATH 20E,A02,083772,Staff,16,0,30,14
1650669745889,MATH 20E,B01,083773,Staff,0,0,30,30
1650669745889,MATH 20E,B02,083774,Staff,9,0,30,21
1650669751912,MATH 103A,A01,083777,Staff,0,15,30,30
1650669751912,MATH 103A,A02,083778,Staff,0,15,30,30
1650669751912,MATH 103A,B01,083779,Staff,0,14,30,30
1650669751912,MATH 103A,B02,083780,Staff,0,14,30,30
1650669757934,MATH 105,A01,085443,Staff,0,22,30,30
1650669763967,MATH 109,A01,083213,Anzaldo; Leesa B,0,7,30,30
1650669763967,MATH 109,A02,083214,Anzaldo; Leesa B,0,7,30,30
1650669763967,MATH 109,B01,083215,Anzaldo; Leesa B,0,8,30,30
1650669763967,MATH 109,B02,083216,Anzaldo; Leesa B,0,6,30,30
1650669769995,MATH 142A,A01,083219,Chow; Bennett,0,16,30,30
1650669769995,MATH 142A,A02,083220,Chow; Bennett,0,15,30,30
1650669769995,MATH 142A,B01,083221,Chow; Bennett,0,13,30,30
1650669769995,MATH 142A,B02,083222,Chow; Bennett,0,14,30,30
1650669776031,MATH 193A,A01,083224,Staff,0,5,30,30
1650669776031,MATH 193A,A02,083225,Staff,0,6,30,30
1650669776031,MATH 193A,A03,083781,Staff,0,6,30,30
1650669776031,MATH 193A,A04,083782,Staff,0,7,30,30
1650669782068,MATH 197,001,091859,McAuley; Julian John,9998,0,9999,1
1650669788124,COGS 9,A01,083615,Staff,1,16,60,59
1650669794147,COGS 11,A01,083617,Boyle; Mary E. T.,18,0,40,22
1650669800174,COGS 13,A01,083071,Staff,0,39,40,40
1650669806199,COGS 14A,A01,092681,Staff,0,32,100,100
1650669812222,COGS 14B,A01,083073,Cheng; Tzu-Han,1,14,50,49
1650669818245,COGS 17,A01,092677,Staff,15,0,75,60
1650669824282,COGS 100,A01,083619,Staff,0,28,60,60
1650669830308,COGS 101A,A01,083621,Davis; Joshua Daniel,0,27,60,60
1650669836431,COGS 101B,A01,091572,Staff,0,4,60,60
1650669842462,COGS 101C,A01,083625,Delgado; Tania,14,0,30,16
1650669848504,COGS 107A,A01,083627,Boyle; Mary E. T.,1,17,60,59
1650669854527,COGS 118A,A01,083075,Staff,0,7,60,60
1650669860553,CSE 3,A50,083646,Miranda; Gregory Joseph,19,0,38,19
1650669860553,CSE 3,A51,083647,Miranda; Gregory Joseph,36,0,37,1
1650669866577,CSE 8A,A50,083650,Miranda; Gregory Joseph,0,30,40,40
1650669872609,CSE 11,A01,083080,Cao; Yingjun,0,95,40,40
1650669878632,CSE 12,A01,083652,Staff,0,21,100,100
1650669884655,CSE 15L,A01,083654,Staff,0,3,50,50
1650669884655,CSE 15L,A02,083655,Staff,0,2,50,50
1650669890678,CSE 20,A01,083657,Staff,50,0,80,30
1650669896706,CSE 30,A01,083084,Eldon; John,0,78,40,40
1650669902729,CSE 100,A01,083659,Cao; Yingjun,0,69,50,50
1650669908765,CSE 134B,A01,083661,Powell; Thomas Allan,0,37,65,65
1650669914789,CSE 140,A01,083663,Staff,0,9,75,75
1650669920817,CSE 140L,A01,083088,Eldon; John,0,17,75,75
1650669926845,CSE 175,A01,083665,Kumar; Rakesh,7,0,25,18
1650669932872,CSE 190,A00,092507,Dubnov; Shlomo,10,0,20,10
1650669938899,ECE 45,A01,083139,Staff,0,2,60,60
1650669944925,ECE 65,A50,083695,Staff,0,5,30,30
1650669950950,ECE 109,A01,091882,Touri; Behrouz,33,0,70,37
1650669956977,ECE 180,A00,083140,Abi Samra; Nicholas Camill,20,0,30,10
1650669956977,ECE 180,B00,083141,Abi Samra; Nicholas Camill,0,0,30,30
1650669963002,MATH 10A,A01,083735,Patchell; Gregory David,3,0,30,27
1650669963002,MATH 10A,A02,083736,Patchell; Gregory David,27,0,30,3
1650669963002,MATH 10A,A03,083737,Patchell; Gregory David,24,0,30,6
1650669969028,MATH 10B,A01,083207,Staff,0,9,30,30
1650669969028,MATH 10B,A02,083208,Staff,1,8,30,29
1650669969028,MATH 10B,B01,083739,Staff,11,0,30,19
1650669969028,MATH 10B,B02,083740,Staff,28,0,30,2
1650669975058,MATH 18,A01,083743,Staff,0,0,30,30
1650669975058,MATH 18,A02,083744,Staff,23,0,30,7
1650669975058,MATH 18,A03,083745,Staff,21,0,30,9
1650669975058,MATH 18,A04,083746,Staff,26,0,30,4
1650669975058,MATH 18,B01,083748,Staff,0,15,30,30
1650669975058,MATH 18,B02,083749,Staff,0,12,30,30
1650669975058,MATH 18,B03,083750,Staff,0,12,30,30
1650669975058,MATH 18,B04,083751,Staff,0,12,30,30
1650669981098,MATH 20A,A01,083754,Staff,19,0,40,21
1650669987127,MATH 20B,A01,083756,Staff,0,11,30,30
1650669987127,MATH 20B,A02,083757,Staff,0,12,30,30
1650669993151,MATH 20C,A01,083760,Staff,0,16,30,30
1650669993151,MATH 20C,A02,083761,Staff,1,14,30,29
1650669993151,MATH 20C,B01,083762,Staff,10,0,30,20
1650669993151,MATH 20C,B02,083763,Staff,28,0,30,2
1650669999175,MATH 20D,A01,083765,Staff,1,1,30,29
1650669999175,MATH 20D,A02,083766,Staff,6,0,30,24
1650669999175,MATH 20D,A03,083767,Staff,24,0,30,6
1650670005198,MATH 20E,A01,083771,Staff,3,0,30,27
1650670005198,MATH 20E,A02,083772,Staff,16,0,30,14
1650670005198,MATH 20E,B01,083773,Staff,0,0,30,30
1650670005198,MATH 20E,B02,083774,Staff,9,0,30,21
1650670011220,MATH 103A,A01,083777,Staff,0,15,30,30
1650670011220,MATH 103A,A02,083778,Staff,0,15,30,30
1650670011220,MATH 103A,B01,083779,Staff,0,14,30,30
1650670011220,MATH 103A,B02,083780,Staff,0,14,30,30
1650670017243,MATH 105,A01,085443,Staff,0,22,30,30
1650670023265,MATH 109,A01,083213,Anzaldo; Leesa B,0,7,30,30
1650670023265,MATH 109,A02,083214,Anzaldo; Leesa B,0,7,30,30
1650670023265,MATH 109,B01,083215,Anzaldo; Leesa B,0,8,30,30
1650670023265,MATH 109,B02,083216,Anzaldo; Leesa B,0,6,30,30
1650670029292,MATH 142A,A01,083219,Chow; Bennett,0,16,30,30
1650670029292,MATH 142A,A02,083220,Chow; Bennett,0,15,30,30
1650670029292,MATH 142A,B01,083221,Chow; Bennett,0,13,30,30
1650670029292,MATH 142A,B02,083222,Chow; Bennett,0,14,30,30
1650670035317,MATH 193A,A01,083224,Staff,0,5,30,30
1650670035317,MATH 193A,A02,083225,Staff,0,6,30,30
1650670035317,MATH 193A,A03,083781,Staff,0,6,30,30
1650670035317,MATH 193A,A04,083782,Staff,0,7,30,30
1650670041342,MATH 197,001,091859,McAuley; Julian John,9998,0,9999,1
1650670047405,COGS 9,A01,083615,Staff,1,16,60,59
1650670053431,COGS 11,A01,083617,Boyle; Mary E. T.,18,0,40,22
1650670059453,COGS 13,A01,083071,Staff,0,39,40,40
1650670065482,COGS 14A,A01,092681,Staff,0,32,100,100
1650670071507,COGS 14B,A01,083073,Cheng; Tzu-Han,1,14,50,49
1650670077531,COGS 17,A01,092677,Staff,15,0,75,60
1650670083560,COGS 100,A01,083619,Staff,0,28,60,60
1650670089585,COGS 101A,A01,083621,Davis; Joshua Daniel,0,27,60,60
1650670095617,COGS 101B,A01,091572,Staff,0,4,60,60
1650670101644,COGS 101C,A01,083625,Delgado; Tania,14,0,30,16
1650670107668,COGS 107A,A01,083627,Boyle; Mary E. T.,1,17,60,59
1650670113693,COGS 118A,A01,083075,Staff,0,7,60,60
1650670119715,CSE 3,A50,083646,Miranda; Gregory Joseph,19,0,38,19
1650670119715,CSE 3,A51,083647,Miranda; Gregory Joseph,36,0,37,1
1650670125738,CSE 8A,A50,083650,Miranda; Gregory Joseph,0,30,40,40
1650670131759,CSE 11,A01,083080,Cao; Yingjun,0,95,40,40
1650670137782,CSE 12,A01,083652,Staff,0,21,100,100
1650670143819,CSE 15L,A01,083654,Staff,0,3,50,50
1650670143819,CSE 15L,A02,083655,Staff,0,2,50,50
1650670149845,CSE 20,A01,083657,Staff,50,0,80,30
1650670155872,CSE 30,A01,083084,Eldon; John,0,78,40,40
1650670161933,CSE 100,A01,083659,Cao; Yingjun,0,70,50,50
1650670167960,CSE 134B,A01,083661,Powell; Thomas Allan,0,37,65,65
1650670173987,CSE 140,A01,083663,Staff,0,9,75,75
1650670180014,CSE 140L,A01,083088,Eldon; John,0,17,75,75
1650670186039,CSE 175,A01,083665,Kumar; Rakesh,7,0,25,18
1650670192068,CSE 190,A00,092507,Dubnov; Shlomo,10,0,20,10
1650670198094,ECE 45,A01,083139,Staff,0,2,60,60
1650670204117,ECE 65,A50,083695,Staff,0,5,30,30
1650670210141,ECE 109,A01,091882,Touri; Behrouz,33,0,70,37
1650670216165,ECE 180,A00,083140,Abi Samra; Nicholas Camill,20,0,30,10
1650670216165,ECE 180,B00,083141,Abi Samra; Nicholas Camill,0,0,30,30
1650670222191,MATH 10A,A01,083735,Patchell; Gregory David,3,0,30,27
1650670222191,MATH 10A,A02,083736,Patchell; Gregory David,27,0,30,3
1650670222191,MATH 10A,A03,083737,Patchell; Gregory David,24,0,30,6
1650670228214,MATH 10B,A01,083207,Staff,0,9,30,30
1650670228214,MATH 10B,A02,083208,Staff,1,8,30,29
1650670228214,MATH 10B,B01,083739,Staff,11,0,30,19
1650670228214,MATH 10B,B02,083740,Staff,28,0,30,2
1650670234243,MATH 18,A01,083743,Staff,0,0,30,30
1650670234243,MATH 18,A02,083744,Staff,23,0,30,7
1650670234243,MATH 18,A03,083745,Staff,21,0,30,9
1650670234243,MATH 18,A04,083746,Staff,26,0,30,4
1650670234243,MATH 18,B01,083748,Staff,0,15,30,30
1650670234243,MATH 18,B02,083749,Staff,0,12,30,30
1650670234243,MATH 18,B03,083750,Staff,0,12,30,30
1650670234243,MATH 18,B04,083751,Staff,0,12,30,30
1650670240276,MATH 20A,A01,083754,Staff,19,0,40,21
1650670246305,MATH 20B,A01,083756,Staff,0,11,30,30
1650670246305,MATH 20B,A02,083757,Staff,0,12,30,30
1650670252329,MATH 20C,A01,083760,Staff,0,16,30,30
1650670252329,MATH 20C,A02,083761,Staff,1,14,30,29
1650670252329,MATH 20C,B01,083762,Staff,10,0,30,20
1650670252329,MATH 20C,B02,083763,Staff,28,0,30,2
1650670258359,MATH 20D,A01,083765,Staff,1,1,30,29
1650670258359,MATH 20D,A02,083766,Staff,6,0,30,24
1650670258359,MATH 20D,A03,083767,Staff,24,0,30,6
1650670264384,MATH 20E,A01,083771,Staff,3,0,30,27
1650670264384,MATH 20E,A02,083772,Staff,16,0,30,14
1650670264384,MATH 20E,B01,083773,Staff,0,0,30,30
1650670264384,MATH 20E,B02,083774,Staff,9,0,30,21
1650670270410,MATH 103A,A01,083777,Staff,0,15,30,30
1650670270410,MATH 103A,A02,083778,Staff,0,15,30,30
1650670270410,MATH 103A,B01,083779,Staff,0,14,30,30
1650670270410,MATH 103A,B02,083780,Staff,0,14,30,30
1650670276433,MATH 105,A01,085443,Staff,0,22,30,30
1650670282456,MATH 109,A01,083213,Anzaldo; Leesa B,0,7,30,30
1650670282456,MATH 109,A02,083214,Anzaldo; Leesa B,0,7,30,30
1650670282456,MATH 109,B01,083215,Anzaldo; Leesa B,0,8,30,30
1650670282456,MATH 109,B02,083216,Anzaldo; Leesa B,0,6,30,30
1650670288479,MATH 142A,A01,083219,Chow; Bennett,0,16,30,30
1650670288479,MATH 142A,A02,083220,Chow; Bennett,0,15,30,30
1650670288479,MATH 142A,B01,083221,Chow; Bennett,0,13,30,30
1650670288479,MATH 142A,B02,083222,Chow; Bennett,0,14,30,30
1650670294507,MATH 193A,A01,083224,Staff,0,5,30,30
1650670294507,MATH 193A,A02,083225,Staff,0,6,30,30
1650670294507,MATH 193A,A03,083781,Staff,0,6,30,30
1650670294507,MATH 193A,A04,083782,Staff,0,7,30,30
1650670300530,MATH 197,001,091859,McAuley; Julian John,9998,0,9999,1
1650670306583,COGS 9,A01,083615,Staff,1,16,60,59
1650670312606,COGS 11,A01,083617,Boyle; Mary E. T.,18,0,40,22
1650670318633,COGS 13,A01,083071,Staff,0,39,40,40
1650670324668,COGS 14A,A01,092681,Staff,0,32,100,100
1650670330698,COGS 14B,A01,083073,Cheng; Tzu-Han,1,14,50,49
1650670336722,COGS 17,A01,092677,Staff,15,0,75,60
1650670342746,COGS 100,A01,083619,Staff,0,28,60,60
1650670348771,COGS 101A,A01,083621,Davis; Joshua Daniel,0,27,60,60
1650670354809,COGS 101B,A01,091572,Staff,0,4,60,60
1650670360843,COGS 101C,A01,083625,Delgado; Tania,14,0,30,16
1650670366866,COGS 107A,A01,083627,Boyle; Mary E. T.,1,17,60,59
1650670372907,COGS 118A,A01,083075,Staff,0,7,60,60
1650670378940,CSE 3,A50,083646,Miranda; Gregory Joseph,19,0,38,19
1650670378940,CSE 3,A51,083647,Miranda; Gregory Joseph,36,0,37,1
1650670384970,CSE 8A,A50,083650,Miranda; Gregory Joseph,0,30,40,40
1650670390998,CSE 11,A01,083080,Cao; Yingjun,0,95,40,40
1650670397024,CSE 12,A01,083652,Staff,0,21,100,100
1650670403049,CSE 15L,A01,083654,Staff,0,3,50,50
1650670403049,CSE 15L,A02,083655,Staff,0,2,50,50
1650670409071,CSE 20,A01,083657,Staff,50,0,80,30
1650670415094,CSE 30,A01,083084,Eldon; John,0,78,40,40
1650670421118,CSE 100,A01,083659,Cao; Yingjun,0,70,50,50
1650670427151,CSE 134B,A01,083661,Powell; Thomas Allan,0,37,65,65
1650670433249,CSE 140,A01,083663,Staff,0,9,75,75
1650670439273,CSE 140L,A01,083088,Eldon; John,0,17,75,75
1650670445296,CSE 175,A01,083665,Kumar; Rakesh,7,0,25,18
1650670451321,CSE 190,A00,092507,Dubnov; Shlomo,10,0,20,10
1650670457356,ECE 45,A01,083139,Staff,0,2,60,60
1650670463394,ECE 65,A50,083695,Staff,0,5,30,30
1650670469425,ECE 109,A01,091882,Touri; Behrouz,33,0,70,37
1650670475465,ECE 180,A00,083140,Abi Samra; Nicholas Camill,20,0,30,10
1650670475465,ECE 180,B00,083141,Abi Samra; Nicholas Camill,0,0,30,30
1650670481489,MATH 10A,A01,083735,Patchell; Gregory David,3,0,30,27
1650670481489,MATH 10A,A02,083736,Patchell; Gregory David,27,0,30,3
1650670481489,MATH 10A,A03,083737,Patchell; Gregory David,24,0,30,6
1650670487525,MATH 10B,A01,083207,Staff,0,9,30,30
1650670487525,MATH 10B,A02,083208,Staff,1,8,30,29
1650670487525,MATH 10B,B01,083739,Staff,11,0,30,19
1650670487525,MATH 10B,B02,083740,Staff,28,0,30,2
1650670493554,MATH 18,A01,083743,Staff,0,0,30,30
1650670493554,MATH 18,A02,083744,Staff,23,0,30,7
1650670493554,MATH 18,A03,083745,Staff,21,0,30,9
1650670493554,MATH 18,A04,083746,Staff,26,0,30,4
1650670493554,MATH 18,B01,083748,Staff,0,15,30,30
1650670493554,MATH 18,B02,083749,Staff,0,12,30,30
1650670493554,MATH 18,B03,083750,Staff,0,12,30,30
1650670493554,MATH 18,B04,083751,Staff,0,12,30,30
1650670499579,MATH 20A,A01,083754,Staff,19,0,40,21
1650670505602,MATH 20B,A01,083756,Staff,0,11,30,30
1650670505602,MATH 20B,A02,083757,Staff,0,12,30,30
1650670511627,MATH 20C,A01,083760,Staff,0,16,30,30
1650670511627,MATH 20C,A02,083761,Staff,1,14,30,29
1650670511627,MATH 20C,B01,083762,Staff,10,0,30,20
1650670511627,MATH 20C,B02,083763,Staff,28,0,30,2
1650670517659,MATH 20D,A01,083765,Staff,1,1,30,29
1650670517659,MATH 20D,A02,083766,Staff,6,0,30,24
1650670517659,MATH 20D,A03,083767,Staff,24,0,30,6
1650670523687,MATH 20E,A01,083771,Staff,3,0,30,27
1650670523687,MATH 20E,A02,083772,Staff,16,0,30,14
1650670523687,MATH 20E,B01,083773,Staff,0,0,30,30
1650670523687,MATH 20E,B02,083774,Staff,9,0,30,21
1650670529713,MATH 103A,A01,083777,Staff,0,15,30,30
1650670529713,MATH 103A,A02,083778,Staff,0,15,30,30
1650670529713,MATH 103A,B01,083779,Staff,0,14,30,30
1650670529713,MATH 103A,B02,083780,Staff,0,14,30,30
1650670535736,MATH 105,A01,085443,Staff,0,22,30,30
1650670541760,MATH 109,A01,083213,Anzaldo; Leesa B,0,7,30,30
1650670541760,MATH 109,A02,083214,Anzaldo; Leesa B,0,7,30,30
1650670541760,MATH 109,B01,083215,Anzaldo; Leesa B,0,8,30,30
1650670541760,MATH 109,B02,083216,Anzaldo; Leesa B,0,6,30,30
1650670547785,MATH 142A,A01,083219,Chow; Bennett,0,16,30,30
1650670547785,MATH 142A,A02,083220,Chow; Bennett,0,15,30,30
1650670547785,MATH 142A,B01,083221,Chow; Bennett,0,13,30,30
1650670547785,MATH 142A,B02,083222,Chow; Bennett,0,14,30,30
1650670553808,MATH 193A,A01,083224,Staff,0,5,30,30
1650670553808,MATH 193A,A02,083225,Staff,0,6,30,30
1650670553808,MATH 193A,A03,083781,Staff,0,6,30,30
1650670553808,MATH 193A,A04,083782,Staff,0,7,30,30
1650670559832,MATH 197,001,091859,McAuley; Julian John,9998,0,9999,1
1650670565886,COGS 9,A01,083615,Staff,1,16,60,59
1650670571908,COGS 11,A01,083617,Boyle; Mary E. T.,18,0,40,22
1650670577930,COGS 13,A01,083071,Staff,0,39,40,40
1650670583954,COGS 14A,A01,092681,Staff,0,32,100,100
1650670589976,COGS 14B,A01,083073,Cheng; Tzu-Han,1,14,50,49
1650670596009,COGS 17,A01,092677,Staff,15,0,75,60
1650670602038,COGS 100,A01,083619,Staff,0,28,60,60
1650670608062,COGS 101A,A01,083621,Davis; Joshua Daniel,0,27,60,60
1650670614088,COGS 101B,A01,091572,Staff,0,4,60,60
1650670620115,COGS 101C,A01,083625,Delgado; Tania,14,0,30,16
1650670626153,COGS 107A,A01,083627,Boyle; Mary E. T.,1,17,60,59
1650670632177,COGS 118A,A01,083075,Staff,0,7,60,60
1650670638210,CSE 3,A50,083646,Miranda; Gregory Joseph,19,0,38,19
1650670638210,CSE 3,A51,083647,Miranda; Gregory Joseph,36,0,37,1
1650670644238,CSE 8A,A50,083650,Miranda; Gregory Joseph,0,30,40,40
1650670650263,CSE 11,A01,083080,Cao; Yingjun,0,95,40,40
1650670656296,CSE 12,A01,083652,Staff,0,21,100,100
1650670662322,CSE 15L,A01,083654,Staff,0,3,50,50
1650670662322,CSE 15L,A02,083655,Staff,0,2,50,50
1650670668352,CSE 20,A01,083657,Staff,50,0,80,30
1650670674386,CSE 30,A01,083084,Eldon; John,0,78,40,40
1650670680412,CSE 100,A01,083659,Cao; Yingjun,0,70,50,50
1650670686436,CSE 134B,A01,083661,Powell; Thomas Allan,0,37,65,65
1650670692466,CSE 140,A01,083663,Staff,0,9,75,75
1650670698489,CSE 140L,A01,083088,Eldon; John,0,17,75,75
1650670704510,CSE 175,A01,083665,Kumar; Rakesh,7,0,25,18
1650670710534,CSE 190,A00,092507,Dubnov; Shlomo,10,0,20,10
1650670716558,ECE 45,A01,083139,Staff,0,2,60,60
1650670722580,ECE 65,A50,083695,Staff,0,5,30,30
1650670728603,ECE 109,A01,091882,Touri; Behrouz,33,0,70,37
1650670734626,ECE 180,A00,083140,Abi Samra; Nicholas Camill,20,0,30,10
1650670734626,ECE 180,B00,083141,Abi Samra; Nicholas Camill,0,0,30,30
1650670740649,MATH 10A,A01,083735,Patchell; Gregory David,3,0,30,27
1650670740649,MATH 10A,A02,083736,Patchell; Gregory David,27,0,30,3
1650670740649,MATH 10A,A03,083737,Patchell; Gregory David,24,0,30,6
1650670746673,MATH 10B,A01,083207,Staff,0,9,30,30
1650670746673,MATH 10B,A02,083208,Staff,1,8,30,29
1650670746673,MATH 10B,B01,083739,Staff,11,0,30,19
1650670746673,MATH 10B,B02,083740,Staff,28,0,30,2
1650670752697,MATH 18,A01,083743,Staff,0,0,30,30
1650670752697,MATH 18,A02,083744,Staff,23,0,30,7
1650670752697,MATH 18,A03,083745,Staff,21,0,30,9
1650670752697,MATH 18,A04,083746,Staff,26,0,30,4
1650670752697,MATH 18,B01,083748,Staff,0,15,30,30
1650670752697,MATH 18,B02,083749,Staff,0,12,30,30
1650670752697,MATH 18,B03,083750,Staff,0,12,30,30
1650670752697,MATH 18,B04,083751,Staff,0,12,30,30
1650670758721,MATH 20A,A01,083754,Staff,19,0,40,21
1650670764744,MATH 20B,A01,083756,Staff,0,11,30,30
1650670764744,MATH 20B,A02,083757,Staff,0,12,30,30
1650670770783,MATH 20C,A01,083760,Staff,0,16,30,30
1650670770783,MATH 20C,A02,083761,Staff,1,14,30,29
1650670770783,MATH 20C,B01,083762,Staff,10,0,30,20
1650670770783,MATH 20C,B02,083763,Staff,28,0,30,2
1650670776807,MATH 20D,A01,083765,Staff,1,1,30,29
1650670776807,MATH 20D,A02,083766,Staff,6,0,30,24
1650670776807,MATH 20D,A03,083767,Staff,24,0,30,6
1650670782830,MATH 20E,A01,083771,Staff,3,0,30,27
1650670782830,MATH 20E,A02,083772,Staff,16,0,30,14
1650670782830,MATH 20E,B01,083773,Staff,0,0,30,30
1650670782830,MATH 20E,B02,083774,Staff,9,0,30,21
1650670788862,MATH 103A,A01,083777,Staff,0,15,30,30
1650670788862,MATH 103A,A02,083778,Staff,0,15,30,30
1650670788862,MATH 103A,B01,083779,Staff,0,14,30,30
1650670788862,MATH 103A,B02,083780,Staff,0,14,30,30
1650670794890,MATH 105,A01,085443,Staff,0,22,30,30
1650670800915,MATH 109,A01,083213,Anzaldo; Leesa B,0,7,30,30
1650670800915,MATH 109,A02,083214,Anzaldo; Leesa B,0,7,30,30
1650670800915,MATH 109,B01,083215,Anzaldo; Leesa B,0,8,30,30
1650670800915,MATH 109,B02,083216,Anzaldo; Leesa B,0,6,30,30
1650670806940,MATH 142A,A01,083219,Chow; Bennett,0,16,30,30
1650670806940,MATH 142A,A02,083220,Chow; Bennett,0,15,30,30
1650670806940,MATH 142A,B01,083221,Chow; Bennett,0,13,30,30
1650670806940,MATH 142A,B02,083222,Chow; Bennett,0,14,30,30
1650670812965,MATH 193A,A01,083224,Staff,0,5,30,30
1650670812965,MATH 193A,A02,083225,Staff,0,6,30,30
1650670812965,MATH 193A,A03,083781,Staff,0,6,30,30
1650670812965,MATH 193A,A04,083782,Staff,0,7,30,30
1650670818991,MATH 197,001,091859,McAuley; Julian John,9998,0,9999,1
1650670825049,COGS 9,A01,083615,Staff,1,16,60,59
1650670831075,COGS 11,A01,083617,Boyle; Mary E. T.,18,0,40,22
1650670837102,COGS 13,A01,083071,Staff,0,39,40,40
1650670843128,COGS 14A,A01,092681,Staff,0,32,100,100
1650670849155,COGS 14B,A01,083073,Cheng; Tzu-Han,1,14,50,49
1650670855179,COGS 17,A01,092677,Staff,15,0,75,60
1650670861203,COGS 100,A01,083619,Staff,0,28,60,60
1650670867225,COGS 101A,A01,083621,Davis; Joshua Daniel,0,27,60,60
1650670873250,COGS 101B,A01,091572,Staff,0,4,60,60
1650670879273,COGS 101C,A01,083625,Delgado; Tania,14,0,30,16
1650670885295,COGS 107A,A01,083627,Boyle; Mary E. T.,1,17,60,59
1650670891323,COGS 118A,A01,083075,Staff,0,7,60,60
1650670897356,CSE 3,A50,083646,Miranda; Gregory Joseph,19,0,38,19
1650670897356,CSE 3,A51,083647,Miranda; Gregory Joseph,36,0,37,1
1650670903387,CSE 8A,A50,083650,Miranda; Gregory Joseph,0,30,40,40
1650670909410,CSE 11,A01,083080,Cao; Yingjun,0,95,40,40
1650670915434,CSE 12,A01,083652,Staff,0,21,100,100
1650670921460,CSE 15L,A01,083654,Staff,0,3,50,50
1650670921460,CSE 15L,A02,083655,Staff,0,2,50,50
1650670927483,CSE 20,A01,083657,Staff,50,0,80,30
1650670933527,CSE 30,A01,083084,Eldon; John,0,78,40,40
1650670939548,CSE 100,A01,083659,Cao; Yingjun,0,70,50,50
1650670945575,CSE 134B,A01,083661,Powell; Thomas Allan,0,37,65,65
1650670951602,CSE 140,A01,083663,Staff,0,9,75,75
1650670957625,CSE 140L,A01,083088,Eldon; John,0,17,75,75
1650670963652,CSE 175,A01,083665,Kumar; Rakesh,7,0,25,18
1650670969678,CSE 190,A00,092507,Dubnov; Shlomo,10,0,20,10
1650670975701,ECE 45,A01,083139,Staff,0,2,60,60
1650670981728,ECE 65,A50,083695,Staff,0,5,30,30
1650670987753,ECE 109,A01,091882,Touri; Behrouz,33,0,70,37
1650670993778,ECE 180,A00,083140,Abi Samra; Nicholas Camill,20,0,30,10
1650670993778,ECE 180,B00,083141,Abi Samra; Nicholas Camill,0,0,30,30
1650670999812,MATH 10A,A01,083735,Patchell; Gregory David,3,0,30,27
1650670999812,MATH 10A,A02,083736,Patchell; Gregory David,27,0,30,3
1650670999812,MATH 10A,A03,083737,Patchell; Gregory David,24,0,30,6
1650671005835,MATH 10B,A01,083207,Staff,0,9,30,30
1650671005835,MATH 10B,A02,083208,Staff,1,8,30,29
1650671005835,MATH 10B,B01,083739,Staff,11,0,30,19
1650671005835,MATH 10B,B02,083740,Staff,28,0,30,2
1650671011871,MATH 18,A01,083743,Staff,0,0,30,30
1650671011871,MATH 18,A02,083744,Staff,23,0,30,7
1650671011871,MATH 18,A03,083745,Staff,21,0,30,9
1650671011871,MATH 18,A04,083746,Staff,26,0,30,4
1650671011871,MATH 18,B01,083748,Staff,0,15,30,30
1650671011871,MATH 18,B02,083749,Staff,0,12,30,30
1650671011871,MATH 18,B03,083750,Staff,0,12,30,30
1650671011871,MATH 18,B04,083751,Staff,0,12,30,30
1650671017896,MATH 20A,A01,083754,Staff,19,0,40,21
1650671023921,MATH 20B,A01,083756,Staff,0,11,30,30
1650671023921,MATH 20B,A02,083757,Staff,0,12,30,30
1650671030073,MATH 20C,A01,083760,Staff,0,16,30,30
1650671030073,MATH 20C,A02,083761,Staff,1,14,30,29
1650671030073,MATH 20C,B01,083762,Staff,10,0,30,20
1650671030073,MATH 20C,B02,083763,Staff,28,0,30,2
1650671036097,MATH 20D,A01,083765,Staff,1,1,30,29
1650671036097,MATH 20D,A02,083766,Staff,6,0,30,24
1650671036097,MATH 20D,A03,083767,Staff,24,0,30,6
1650671042124,MATH 20E,A01,083771,Staff,3,0,30,27
1650671042124,MATH 20E,A02,083772,Staff,16,0,30,14
1650671042124,MATH 20E,B01,083773,Staff,0,0,30,30
1650671042124,MATH 20E,B02,083774,Staff,9,0,30,21
1650671048149,MATH 103A,A01,083777,Staff,0,15,30,30
1650671048149,MATH 103A,A02,083778,Staff,0,15,30,30
1650671048149,MATH 103A,B01,083779,Staff,0,14,30,30
1650671048149,MATH 103A,B02,083780,Staff,0,14,30,30
1650671054183,MATH 105,A01,085443,Staff,0,22,30,30
1650671060210,MATH 109,A01,083213,Anzaldo; Leesa B,0,7,30,30
1650671060210,MATH 109,A02,083214,Anzaldo; Leesa B,0,7,30,30
1650671060210,MATH 109,B01,083215,Anzaldo; Leesa B,0,8,30,30
1650671060210,MATH 109,B02,083216,Anzaldo; Leesa B,0,6,30,30
1650671066233,MATH 142A,A01,083219,Chow; Bennett,0,16,30,30
1650671066233,MATH 142A,A02,083220,Chow; Bennett,0,15,30,30
1650671066233,MATH 142A,B01,083221,Chow; Bennett,0,13,30,30
1650671066233,MATH 142A,B02,083222,Chow; Bennett,0,14,30,30
1650671072260,MATH 193A,A01,083224,Staff,0,5,30,30
1650671072260,MATH 193A,A02,083225,Staff,0,6,30,30
1650671072260,MATH 193A,A03,083781,Staff,0,6,30,30
1650671072260,MATH 193A,A04,083782,Staff,0,7,30,30
1650671078293,MATH 197,001,091859,McAuley; Julian John,9998,0,9999,1
1650671084355,COGS 9,A01,083615,Staff,1,16,60,59
1650671090378,COGS 11,A01,083617,Boyle; Mary E. T.,18,0,40,22
1650671096405,COGS 13,A01,083071,Staff,0,39,40,40
1650671102445,COGS 14A,A01,092681,Staff,0,32,100,100
1650671108467,COGS 14B,A01,083073,Cheng; Tzu-Han,1,14,50,49
1650671114495,COGS 17,A01,092677,Staff,15,0,75,60
1650671120524,COGS 100,A01,083619,Staff,0,28,60,60
1650671126550,COGS 101A,A01,083621,Davis; Joshua Daniel,0,27,60,60
1650671132573,COGS 101B,A01,091572,Staff,0,4,60,60
1650671138597,COGS 101C,A01,083625,Delgado; Tania,14,0,30,16
1650671144620,COGS 107A,A01,083627,Boyle; Mary E. T.,1,17,60,59
1650671150643,COGS 118A,A01,083075,Staff,0,7,60,60
1650671156667,CSE 3,A50,083646,Miranda; Gregory Joseph,19,0,38,19
1650671156667,CSE 3,A51,083647,Miranda; Gregory Joseph,36,0,37,1
1650671162690,CSE 8A,A50,083650,Miranda; Gregory Joseph,0,30,40,40
1650671168712,CSE 11,A01,083080,Cao; Yingjun,0,95,40,40
1650671174750,CSE 12,A01,083652,Staff,0,21,100,100
1650671180783,CSE 15L,A01,083654,Staff,0,3,50,50
1650671180783,CSE 15L,A02,083655,Staff,0,2,50,50
1650671186809,CSE 20,A01,083657,Staff,50,0,80,30
1650671192832,CSE 30,A01,083084,Eldon; John,0,78,40,40
1650671198861,CSE 100,A01,083659,Cao; Yingjun,0,70,50,50
1650671204884,CSE 134B,A01,083661,Powell; Thomas Allan,0,37,65,65
1650671210910,CSE 140,A01,083663,Staff,0,9,75,75
1650671216943,CSE 140L,A01,083088,Eldon; John,0,17,75,75
1650671222979,CSE 175,A01,083665,Kumar; Rakesh,7,0,25,18
1650671229004,CSE 190,A00,092507,Dubnov; Shlomo,10,0,20,10
1650671235031,ECE 45,A01,083139,Staff,0,2,60,60
1650671241060,ECE 65,A50,083695,Staff,0,5,30,30
1650671247091,ECE 109,A01,091882,Touri; Behrouz,33,0,70,37
1650671253121,ECE 180,A00,083140,Abi Samra; Nicholas Camill,20,0,30,10
1650671253121,ECE 180,B00,083141,Abi Samra; Nicholas Camill,0,0,30,30
1650671259152,MATH 10A,A01,083735,Patchell; Gregory David,3,0,30,27
1650671259152,MATH 10A,A02,083736,Patchell; Gregory David,27,0,30,3
1650671259152,MATH 10A,A03,083737,Patchell; Gregory David,24,0,30,6
1650671265179,MATH 10B,A01,083207,Staff,0,9,30,30
1650671265179,MATH 10B,A02,083208,Staff,1,8,30,29
1650671265179,MATH 10B,B01,083739,Staff,11,0,30,19
1650671265179,MATH 10B,B02,083740,Staff,28,0,30,2
1650671271205,MATH 18,A01,083743,Staff,0,0,30,30
1650671271205,MATH 18,A02,083744,Staff,23,0,30,7
1650671271205,MATH 18,A03,083745,Staff,21,0,30,9
1650671271205,MATH 18,A04,083746,Staff,26,0,30,4
1650671271205,MATH 18,B01,083748,Staff,0,15,30,30
1650671271205,MATH 18,B02,083749,Staff,0,12,30,30
1650671271205,MATH 18,B03,083750,Staff,0,12,30,30
1650671271205,MATH 18,B04,083751,Staff,0,12,30,30
1650671277231,MATH 20A,A01,083754,Staff,19,0,40,21
1650671283255,MATH 20B,A01,083756,Staff,0,11,30,30
1650671283255,MATH 20B,A02,083757,Staff,0,12,30,30
1650671289280,MATH 20C,A01,083760,Staff,0,16,30,30
1650671289280,MATH 20C,A02,083761,Staff,1,14,30,29
1650671289280,MATH 20C,B01,083762,Staff,10,0,30,20
1650671289280,MATH 20C,B02,083763,Staff,28,0,30,2
1650671295303,MATH 20D,A01,083765,Staff,1,1,30,29
1650671295303,MATH 20D,A02,083766,Staff,6,0,30,24
1650671295303,MATH 20D,A03,083767,Staff,24,0,30,6
1650671301329,MATH 20E,A01,083771,Staff,3,0,30,27
1650671301329,MATH 20E,A02,083772,Staff,16,0,30,14
1650671301329,MATH 20E,B01,083773,Staff,0,0,30,30
1650671301329,MATH 20E,B02,083774,Staff,9,0,30,21
1650671307358,MATH 103A,A01,083777,Staff,0,15,30,30
1650671307358,MATH 103A,A02,083778,Staff,0,15,30,30
1650671307358,MATH 103A,B01,083779,Staff,0,14,30,30
1650671307358,MATH 103A,B02,083780,Staff,0,14,30,30
1650671313384,MATH 105,A01,085443,Staff,0,22,30,30
1650671319409,MATH 109,A01,083213,Anzaldo; Leesa B,0,7,30,30
1650671319409,MATH 109,A02,083214,Anzaldo; Leesa B,0,7,30,30
1650671319409,MATH 109,B01,083215,Anzaldo; Leesa B,0,8,30,30
1650671319409,MATH 109,B02,083216,Anzaldo; Leesa B,0,6,30,30
1650671325460,MATH 142A,A01,083219,Chow; Bennett,0,16,30,30
1650671325460,MATH 142A,A02,083220,Chow; Bennett,0,15,30,30
1650671325460,MATH 142A,B01,083221,Chow; Bennett,0,13,30,30
1650671325460,MATH 142A,B02,083222,Chow; Bennett,0,14,30,30
1650671331486,MATH 193A,A01,083224,Staff,0,5,30,30
1650671331486,MATH 193A,A02,083225,Staff,0,6,30,30
1650671331486,MATH 193A,A03,083781,Staff,0,6,30,30
1650671331486,MATH 193A,A04,083782,Staff,0,7,30,30
1650671337512,MATH 197,001,091859,McAuley; Julian John,9998,0,9999,1
1650671343568,COGS 9,A01,083615,Staff,1,16,60,59
1650671349599,COGS 11,A01,083617,Boyle; Mary E. T.,18,0,40,22
1650671355625,COGS 13,A01,083071,Staff,0,39,40,40
1650671361648,COGS 14A,A01,092681,Staff,0,32,100,100
1650671367675,COGS 14B,A01,083073,Cheng; Tzu-Han,1,14,50,49
1650671373704,COGS 17,A01,092677,Staff,15,0,75,60
1650671379728,COGS 100,A01,083619,Staff,0,28,60,60
1650671385753,COGS 101A,A01,083621,Davis; Joshua Daniel,0,27,60,60
1650671391783,COGS 101B,A01,091572,Staff,0,4,60,60
1650671397804,COGS 101C,A01,083625,Delgado; Tania,14,0,30,16
1650671403832,COGS 107A,A01,083627,Boyle; Mary E. T.,1,17,60,59
1650671409859,COGS 118A,A01,083075,Staff,0,7,60,60
1650671415881,CSE 3,A50,083646,Miranda; Gregory Joseph,19,0,38,19
1650671415881,CSE 3,A51,083647,Miranda; Gregory Joseph,36,0,37,1
1650671421906,CSE 8A,A50,083650,Miranda; Gregory Joseph,0,30,40,40
1650671427930,CSE 11,A01,083080,Cao; Yingjun,0,95,40,40
1650671433954,CSE 12,A01,083652,Staff,0,21,100,100
1650671439976,CSE 15L,A01,083654,Staff,0,3,50,50
1650671439976,CSE 15L,A02,083655,Staff,0,2,50,50
1650671446000,CSE 20,A01,083657,Staff,50,0,80,30
1650671452023,CSE 30,A01,083084,Eldon; John,0,78,40,40
1650671458046,CSE 100,A01,083659,Cao; Yingjun,0,70,50,50
1650671464074,CSE 134B,A01,083661,Powell; Thomas Allan,0,37,65,65
1650671470097,CSE 140,A01,083663,Staff,0,9,75,75
1650671476123,CSE 140L,A01,083088,Eldon; John,0,17,75,75
1650671482157,CSE 175,A01,083665,Kumar; Rakesh,7,0,25,18
1650671488181,CSE 190,A00,092507,Dubnov; Shlomo,10,0,20,10
1650671494206,ECE 45,A01,083139,Staff,0,2,60,60
1650671500228,ECE 65,A50,083695,Staff,0,5,30,30
1650671506252,ECE 109,A01,091882,Touri; Behrouz,33,0,70,37
1650671512281,ECE 180,A00,083140,Abi Samra; Nicholas Camill,20,0,30,10
1650671512281,ECE 180,B00,083141,Abi Samra; Nicholas Camill,0,0,30,30
1650671518312,MATH 10A,A01,083735,Patchell; Gregory David,3,0,30,27
1650671518312,MATH 10A,A02,083736,Patchell; Gregory David,27,0,30,3
1650671518312,MATH 10A,A03,083737,Patchell; Gregory David,24,0,30,6
1650671524340,MATH 10B,A01,083207,Staff,0,9,30,30
1650671524340,MATH 10B,A02,083208,Staff,1,8,30,29
1650671524340,MATH 10B,B01,083739,Staff,11,0,30,19
1650671524340,MATH 10B,B02,083740,Staff,28,0,30,2
1650671530370,MATH 18,A01,083743,Staff,0,0,30,30
1650671530370,MATH 18,A02,083744,Staff,23,0,30,7
1650671530370,MATH 18,A03,083745,Staff,21,0,30,9
1650671530370,MATH 18,A04,083746,Staff,26,0,30,4
1650671530370,MATH 18,B01,083748,Staff,0,15,30,30
1650671530370,MATH 18,B02,083749,Staff,0,12,30,30
1650671530370,MATH 18,B03,083750,Staff,0,12,30,30
1650671530370,MATH 18,B04,083751,Staff,0,12,30,30
1650671536392,MATH 20A,A01,083754,Staff,19,0,40,21
1650671542415,MATH 20B,A01,083756,Staff,0,11,30,30
1650671542415,MATH 20B,A02,083757,Staff,0,12,30,30
1650671548439,MATH 20C,A01,083760,Staff,0,16,30,30
1650671548439,MATH 20C,A02,083761,Staff,1,14,30,29
1650671548439,MATH 20C,B01,083762,Staff,10,0,30,20
1650671548439,MATH 20C,B02,083763,Staff,28,0,30,2
1650671554466,MATH 20D,A01,083765,Staff,1,1,30,29
1650671554466,MATH 20D,A02,083766,Staff,6,0,30,24
1650671554466,MATH 20D,A03,083767,Staff,24,0,30,6
1650671560495,MATH 20E,A01,083771,Staff,3,0,30,27
1650671560495,MATH 20E,A02,083772,Staff,16,0,30,14
1650671560495,MATH 20E,B01,083773,Staff,0,0,30,30
1650671560495,MATH 20E,B02,083774,Staff,9,0,30,21
1650671566519,MATH 103A,A01,083777,Staff,0,15,30,30
1650671566519,MATH 103A,A02,083778,Staff,0,15,30,30
1650671566519,MATH 103A,B01,083779,Staff,0,14,30,30
1650671566519,MATH 103A,B02,083780,Staff,0,14,30,30
1650671572544,MATH 105,A01,085443,Staff,0,22,30,30
1650671578571,MATH 109,A01,083213,Anzaldo; Leesa B,0,7,30,30
1650671578571,MATH 109,A02,083214,Anzaldo; Leesa B,0,7,30,30
1650671578571,MATH 109,B01,083215,Anzaldo; Leesa B,0,8,30,30
1650671578571,MATH 109,B02,083216,Anzaldo; Leesa B,0,6,30,30
1650671584610,MATH 142A,A01,083219,Chow; Bennett,0,16,30,30
1650671584610,MATH 142A,A02,083220,Chow; Bennett,0,15,30,30
1650671584610,MATH 142A,B01,083221,Chow; Bennett,0,13,30,30
1650671584610,MATH 142A,B02,083222,Chow; Bennett,0,14,30,30
1650671590636,MATH 193A,A01,083224,Staff,0,5,30,30
1650671590636,MATH 193A,A02,083225,Staff,0,6,30,30
1650671590636,MATH 193A,A03,083781,Staff,0,6,30,30
1650671590636,MATH 193A,A04,083782,Staff,0,7,30,30
1650671596669,MATH 197,001,091859,McAuley; Julian John,9998,0,9999,1
1650671602727,COGS 9,A01,083615,Staff,1,16,60,59
1650671608752,COGS 11,A01,083617,Boyle; Mary E. T.,18,0,40,22
1650671614778,COGS 13,A01,083071,Staff,0,39,40,40
1650671620926,COGS 14A,A01,092681,Staff,0,32,100,100
1650671626950,COGS 14B,A01,083073,Cheng; Tzu-Han,1,14,50,49
1650671632981,COGS 17,A01,092677,Staff,15,0,75,60
1650671639009,COGS 100,A01,083619,Staff,0,28,60,60
1650671645035,COGS 101A,A01,083621,Davis; Joshua Daniel,0,27,60,60
1650671651057,COGS 101B,A01,091572,Staff,0,4,60,60
1650671657086,COGS 101C,A01,083625,Delgado; Tania,14,0,30,16
1650671663116,COGS 107A,A01,083627,Boyle; Mary E. T.,1,17,60,59
1650671669141,COGS 118A,A01,083075,Staff,0,7,60,60
1650671675165,CSE 3,A50,083646,Miranda; Gregory Joseph,19,0,38,19
1650671675165,CSE 3,A51,083647,Miranda; Gregory Joseph,36,0,37,1
1650671681192,CSE 8A,A50,083650,Miranda; Gregory Joseph,0,30,40,40
1650671687219,CSE 11,A01,083080,Cao; Yingjun,0,95,40,40
1650671693252,CSE 12,A01,083652,Staff,0,21,100,100
1650671699276,CSE 15L,A01,083654,Staff,0,3,50,50
1650671699276,CSE 15L,A02,083655,Staff,0,2,50,50
1650671705303,CSE 20,A01,083657,Staff,50,0,80,30
1650671711335,CSE 30,A01,083084,Eldon; John,0,78,40,40
1650671717360,CSE 100,A01,083659,Cao; Yingjun,0,70,50,50
1650671723386,CSE 134B,A01,083661,Powell; Thomas Allan,0,37,65,65
1650671729410,CSE 140,A01,083663,Staff,0,9,75,75
1650671735438,CSE 140L,A01,083088,Eldon; John,0,17,75,75
1650671741473,CSE 175,A01,083665,Kumar; Rakesh,7,0,25,18
1650671747495,CSE 190,A00,092507,Dubnov; Shlomo,10,0,20,10
1650671753533,ECE 45,A01,083139,Staff,0,2,60,60
1650671759556,ECE 65,A50,083695,Staff,0,5,30,30
1650671765583,ECE 109,A01,091882,Touri; Behrouz,33,0,70,37
1650671771609,ECE 180,A00,083140,Abi Samra; Nicholas Camill,20,0,30,10
1650671771609,ECE 180,B00,083141,Abi Samra; Nicholas Camill,0,0,30,30
1650671777634,MATH 10A,A01,083735,Patchell; Gregory David,3,0,30,27
1650671777634,MATH 10A,A02,083736,Patchell; Gregory David,27,0,30,3
1650671777634,MATH 10A,A03,083737,Patchell; Gregory David,24,0,30,6
1650671783661,MATH 10B,A01,083207,Staff,0,9,30,30
1650671783661,MATH 10B,A02,083208,Staff,1,8,30,29
1650671783661,MATH 10B,B01,083739,Staff,11,0,30,19
1650671783661,MATH 10B,B02,083740,Staff,28,0,30,2
1650671789693,MATH 18,A01,083743,Staff,0,0,30,30
1650671789693,MATH 18,A02,083744,Staff,23,0,30,7
1650671789693,MATH 18,A03,083745,Staff,21,0,30,9
1650671789693,MATH 18,A04,083746,Staff,26,0,30,4
1650671789693,MATH 18,B01,083748,Staff,0,15,30,30
1650671789693,MATH 18,B02,083749,Staff,0,12,30,30
1650671789693,MATH 18,B03,083750,Staff,0,12,30,30
1650671789693,MATH 18,B04,083751,Staff,0,12,30,30
1650671795717,MATH 20A,A01,083754,Staff,19,0,40,21
1650671801741,MATH 20B,A01,083756,Staff,0,11,30,30
1650671801741,MATH 20B,A02,083757,Staff,0,12,30,30
1650671807768,MATH 20C,A01,083760,Staff,0,16,30,30
1650671807768,MATH 20C,A02,083761,Staff,1,14,30,29
1650671807768,MATH 20C,B01,083762,Staff,10,0,30,20
1650671807768,MATH 20C,B02,083763,Staff,28,0,30,2
1650671813794,MATH 20D,A01,083765,Staff,1,1,30,29
1650671813794,MATH 20D,A02,083766,Staff,6,0,30,24
1650671813794,MATH 20D,A03,083767,Staff,24,0,30,6
1650671819834,MATH 20E,A01,083771,Staff,3,0,30,27
1650671819834,MATH 20E,A02,083772,Staff,16,0,30,14
1650671819834,MATH 20E,B01,083773,Staff,0,0,30,30
1650671819834,MATH 20E,B02,083774,Staff,9,0,30,21
1650671825858,MATH 103A,A01,083777,Staff,0,15,30,30
1650671825858,MATH 103A,A02,083778,Staff,0,15,30,30
1650671825858,MATH 103A,B01,083779,Staff,0,14,30,30
1650671825858,MATH 103A,B02,083780,Staff,0,14,30,30
1650671831892,MATH 105,A01,085443,Staff,0,22,30,30
1650671837926,MATH 109,A01,083213,Anzaldo; Leesa B,0,7,30,30
1650671837926,MATH 109,A02,083214,Anzaldo; Leesa B,0,7,30,30
1650671837926,MATH 109,B01,083215,Anzaldo; Leesa B,0,8,30,30
1650671837926,MATH 109,B02,083216,Anzaldo; Leesa B,0,6,30,30
1650671843948,MATH 142A,A01,083219,Chow; Bennett,0,16,30,30
1650671843948,MATH 142A,A02,083220,Chow; Bennett,0,15,30,30
1650671843948,MATH 142A,B01,083221,Chow; Bennett,0,13,30,30
1650671843948,MATH 142A,B02,083222,Chow; Bennett,0,14,30,30
1650671849976,MATH 193A,A01,083224,Staff,0,5,30,30
1650671849976,MATH 193A,A02,083225,Staff,0,6,30,30
1650671849976,MATH 193A,A03,083781,Staff,0,6,30,30
1650671849976,MATH 193A,A04,083782,Staff,0,7,30,30
1650671855998,MATH 197,001,091859,McAuley; Julian John,9998,0,9999,1
1650671862057,COGS 9,A01,083615,Staff,1,16,60,59
1650671868089,COGS 11,A01,083617,Boyle; Mary E. T.,18,0,40,22
1650671874115,COGS 13,A01,083071,Staff,0,39,40,40
1650671880150,COGS 14A,A01,092681,Staff,0,32,100,100
1650671886186,COGS 14B,A01,083073,Cheng; Tzu-Han,1,14,50,49
1650671892211,COGS 17,A01,092677,Staff,15,0,75,60
1650671898234,COGS 100,A01,083619,Staff,0,28,60,60
1650671904271,COGS 101A,A01,083621,Davis; Joshua Daniel,0,27,60,60
1650671910296,COGS 101B,A01,091572,Staff,0,4,60,60
1650671916319,COGS 101C,A01,083625,Delgado; Tania,14,0,30,16
1650671922354,COGS 107A,A01,083627,Boyle; Mary E. T.,1,17,60,59
1650671928380,COGS 118A,A01,083075,Staff,0,7,60,60
1650671934430,CSE 3,A50,083646,Miranda; Gregory Joseph,19,0,38,19
1650671934430,CSE 3,A51,083647,Miranda; Gregory Joseph,36,0,37,1
1650671940476,CSE 8A,A50,083650,Miranda; Gregory Joseph,0,30,40,40
1650671946500,CSE 11,A01,083080,Cao; Yingjun,0,95,40,40
1650671952523,CSE 12,A01,083652,Staff,0,21,100,100
1650671958547,CSE 15L,A01,083654,Staff,0,3,50,50
1650671958547,CSE 15L,A02,083655,Staff,0,2,50,50
1650671964572,CSE 20,A01,083657,Staff,50,0,80,30
1650671970602,CSE 30,A01,083084,Eldon; John,0,78,40,40
1650671976625,CSE 100,A01,083659,Cao; Yingjun,0,70,50,50
1650671982677,CSE 134B,A01,083661,Powell; Thomas Allan,0,38,65,65
1650671988718,CSE 140,A01,083663,Staff,0,10,75,75
1650671994744,CSE 140L,A01,083088,Eldon; John,0,18,75,75
1650672000767,CSE 175,A01,083665,Kumar; Rakesh,7,0,25,18
1650672006791,CSE 190,A00,092507,Dubnov; Shlomo,10,0,20,10
1650672012814,ECE 45,A01,083139,Staff,0,2,60,60
1650672018857,ECE 65,A50,083695,Staff,0,5,30,30
1650672024881,ECE 109,A01,091882,Touri; Behrouz,33,0,70,37
1650672030910,ECE 180,A00,083140,Abi Samra; Nicholas Camill,20,0,30,10
1650672030910,ECE 180,B00,083141,Abi Samra; Nicholas Camill,0,0,30,30
1650672036934,MATH 10A,A01,083735,Patchell; Gregory David,3,0,30,27
1650672036934,MATH 10A,A02,083736,Patchell; Gregory David,27,0,30,3
1650672036934,MATH 10A,A03,083737,Patchell; Gregory David,24,0,30,6
1650672042963,MATH 10B,A01,083207,Staff,0,9,30,30
1650672042963,MATH 10B,A02,083208,Staff,1,8,30,29
1650672042963,MATH 10B,B01,083739,Staff,11,0,30,19
1650672042963,MATH 10B,B02,083740,Staff,28,0,30,2
1650672048992,MATH 18,A01,083743,Staff,0,0,30,30
1650672048992,MATH 18,A02,083744,Staff,23,0,30,7
1650672048992,MATH 18,A03,083745,Staff,21,0,30,9
1650672048992,MATH 18,A04,083746,Staff,26,0,30,4
1650672048992,MATH 18,B01,083748,Staff,0,15,30,30
1650672048992,MATH 18,B02,083749,Staff,0,12,30,30
1650672048992,MATH 18,B03,083750,Staff,0,12,30,30
1650672048992,MATH 18,B04,083751,Staff,0,12,30,30
1650672055023,MATH 20A,A01,083754,Staff,19,0,40,21
1650672061047,MATH 20B,A01,083756,Staff,0,11,30,30
1650672061047,MATH 20B,A02,083757,Staff,0,12,30,30
1650672067084,MATH 20C,A01,083760,Staff,0,16,30,30
1650672067084,MATH 20C,A02,083761,Staff,1,14,30,29
1650672067084,MATH 20C,B01,083762,Staff,10,0,30,20
1650672067084,MATH 20C,B02,083763,Staff,28,0,30,2
1650672073116,MATH 20D,A01,083765,Staff,1,1,30,29
1650672073116,MATH 20D,A02,083766,Staff,6,0,30,24
1650672073116,MATH 20D,A03,083767,Staff,24,0,30,6
1650672079141,MATH 20E,A01,083771,Staff,3,0,30,27
1650672079141,MATH 20E,A02,083772,Staff,16,0,30,14
1650672079141,MATH 20E,B01,083773,Staff,0,0,30,30
1650672079141,MATH 20E,B02,083774,Staff,9,0,30,21
1650672085195,MATH 103A,A01,083777,Staff,0,15,30,30
1650672085195,MATH 103A,A02,083778,Staff,0,15,30,30
1650672085195,MATH 103A,B01,083779,Staff,0,14,30,30
1650672085195,MATH 103A,B02,083780,Staff,0,14,30,30
1650672091221,MATH 105,A01,085443,Staff,0,22,30,30
1650672097260,MATH 109,A01,083213,Anzaldo; Leesa B,0,7,30,30
1650672097260,MATH 109,A02,083214,Anzaldo; Leesa B,0,7,30,30
1650672097260,MATH 109,B01,083215,Anzaldo; Leesa B,0,8,30,30
1650672097260,MATH 109,B02,083216,Anzaldo; Leesa B,0,6,30,30
1650672103299,MATH 142A,A01,083219,Chow; Bennett,0,16,30,30
1650672103299,MATH 142A,A02,083220,Chow; Bennett,0,15,30,30
1650672103299,MATH 142A,B01,083221,Chow; Bennett,0,13,30,30
1650672103299,MATH 142A,B02,083222,Chow; Bennett,0,14,30,30
1650672109324,MATH 193A,A01,083224,Staff,0,5,30,30
1650672109324,MATH 193A,A02,083225,Staff,0,6,30,30
1650672109324,MATH 193A,A03,083781,Staff,0,6,30,30
1650672109324,MATH 193A,A04,083782,Staff,0,7,30,30
1650672115351,MATH 197,001,091859,McAuley; Julian John,9998,0,9999,1
1650672121413,COGS 9,A01,083615,Staff,1,16,60,59
1650672127443,COGS 11,A01,083617,Boyle; Mary E. T.,18,0,40,22
1650672133465,COGS 13,A01,083071,Staff,0,39,40,40
1650672139491,COGS 14A,A01,092681,Staff,0,32,100,100
1650672145514,COGS 14B,A01,083073,Cheng; Tzu-Han,1,14,50,49
1650672151546,COGS 17,A01,092677,Staff,15,0,75,60
1650672157568,COGS 100,A01,083619,Staff,0,28,60,60
1650672163592,COGS 101A,A01,083621,Davis; Joshua Daniel,0,27,60,60
1650672169620,COGS 101B,A01,091572,Staff,0,4,60,60
1650672175643,COGS 101C,A01,083625,Delgado; Tania,14,0,30,16
1650672181667,COGS 107A,A01,083627,Boyle; Mary E. T.,1,17,60,59
1650672187691,COGS 118A,A01,083075,Staff,0,7,60,60
1650672193715,CSE 3,A50,083646,Miranda; Gregory Joseph,19,0,38,19
1650672193715,CSE 3,A51,083647,Miranda; Gregory Joseph,36,0,37,1
1650672199743,CSE 8A,A50,083650,Miranda; Gregory Joseph,0,30,40,40
1650672205766,CSE 11,A01,083080,Cao; Yingjun,0,95,40,40
1650672211804,CSE 12,A01,083652,Staff,0,21,100,100
1650672217920,CSE 15L,A01,083654,Staff,0,3,50,50
1650672217920,CSE 15L,A02,083655,Staff,0,2,50,50
1650672223946,CSE 20,A01,083657,Staff,50,0,80,30
1650672229973,CSE 30,A01,083084,Eldon; John,0,78,40,40
1650672236000,CSE 100,A01,083659,Cao; Yingjun,0,70,50,50
1650672242043,CSE 134B,A01,083661,Powell; Thomas Allan,0,38,65,65
1650672248071,CSE 140,A01,083663,Staff,0,10,75,75
1650672254107,CSE 140L,A01,083088,Eldon; John,0,18,75,75
1650672260140,CSE 175,A01,083665,Kumar; Rakesh,7,0,25,18
1650672266169,CSE 190,A00,092507,Dubnov; Shlomo,10,0,20,10
1650672272192,ECE 45,A01,083139,Staff,0,2,60,60
1650672278216,ECE 65,A50,083695,Staff,0,5,30,30
1650672284241,ECE 109,A01,091882,Touri; Behrouz,33,0,70,37
1650672290265,ECE 180,A00,083140,Abi Samra; Nicholas Camill,20,0,30,10
1650672290265,ECE 180,B00,083141,Abi Samra; Nicholas Camill,0,0,30,30
1650672296293,MATH 10A,A01,083735,Patchell; Gregory David,3,0,30,27
1650672296293,MATH 10A,A02,083736,Patchell; Gregory David,27,0,30,3
1650672296293,MATH 10A,A03,083737,Patchell; Gregory David,24,0,30,6
1650672302321,MATH 10B,A01,083207,Staff,0,9,30,30
1650672302321,MATH 10B,A02,083208,Staff,1,8,30,29
1650672302321,MATH 10B,B01,083739,Staff,11,0,30,19
1650672302321,MATH 10B,B02,083740,Staff,28,0,30,2
1650672308352,MATH 18,A01,083743,Staff,0,0,30,30
1650672308352,MATH 18,A02,083744,Staff,23,0,30,7
1650672308352,MATH 18,A03,083745,Staff,21,0,30,9
1650672308352,MATH 18,A04,083746,Staff,26,0,30,4
1650672308352,MATH 18,B01,083748,Staff,0,15,30,30
1650672308352,MATH 18,B02,083749,Staff,0,12,30,30
1650672308352,MATH 18,B03,083750,Staff,0,12,30,30
1650672308352,MATH 18,B04,083751,Staff,0,12,30,30
1650672314379,MATH 20A,A01,083754,Staff,19,0,40,21
1650672320412,MATH 20B,A01,083756,Staff,0,11,30,30
1650672320412,MATH 20B,A02,083757,Staff,0,12,30,30
1650672326441,MATH 20C,A01,083760,Staff,0,16,30,30
1650672326441,MATH 20C,A02,083761,Staff,1,15,30,29
1650672326441,MATH 20C,B01,083762,Staff,10,0,30,20
1650672326441,MATH 20C,B02,083763,Staff,28,0,30,2
1650672332469,MATH 20D,A01,083765,Staff,1,1,30,29
1650672332469,MATH 20D,A02,083766,Staff,6,0,30,24
1650672332469,MATH 20D,A03,083767,Staff,24,0,30,6
1650672338556,MATH 20E,A01,083771,Staff,3,0,30,27
1650672338556,MATH 20E,A02,083772,Staff,16,0,30,14
1650672338556,MATH 20E,B01,083773,Staff,0,0,30,30
1650672338556,MATH 20E,B02,083774,Staff,9,0,30,21
1650672344583,MATH 103A,A01,083777,Staff,0,15,30,30
1650672344583,MATH 103A,A02,083778,Staff,0,15,30,30
1650672344583,MATH 103A,B01,083779,Staff,0,14,30,30
1650672344583,MATH 103A,B02,083780,Staff,0,14,30,30
1650672350609,MATH 105,A01,085443,Staff,0,22,30,30
1650672356638,MATH 109,A01,083213,Anzaldo; Leesa B,0,7,30,30
1650672356638,MATH 109,A02,083214,Anzaldo; Leesa B,0,7,30,30
1650672356638,MATH 109,B01,083215,Anzaldo; Leesa B,0,8,30,30
1650672356638,MATH 109,B02,083216,Anzaldo; Leesa B,0,6,30,30
1650672362669,MATH 142A,A01,083219,Chow; Bennett,0,16,30,30
1650672362669,MATH 142A,A02,083220,Chow; Bennett,0,15,30,30
1650672362669,MATH 142A,B01,083221,Chow; Bennett,0,13,30,30
1650672362669,MATH 142A,B02,083222,Chow; Bennett,0,14,30,30
1650672368697,MATH 193A,A01,083224,Staff,0,5,30,30
1650672368697,MATH 193A,A02,083225,Staff,0,6,30,30
1650672368697,MATH 193A,A03,083781,Staff,0,6,30,30
1650672368697,MATH 193A,A04,083782,Staff,0,7,30,30
1650672374720,MATH 197,001,091859,McAuley; Julian John,9998,0,9999,1
1650672380786,COGS 9,A01,083615,Staff,1,16,60,59
1650672386824,COGS 11,A01,083617,Boyle; Mary E. T.,18,0,40,22
1650672392853,COGS 13,A01,083071,Staff,0,39,40,40
1650672398876,COGS 14A,A01,092681,Staff,0,32,100,100
1650672404900,COGS 14B,A01,083073,Cheng; Tzu-Han,1,14,50,49
1650672410930,COGS 17,A01,092677,Staff,15,0,75,60
1650672416953,COGS 100,A01,083619,Staff,0,28,60,60
1650672422980,COGS 101A,A01,083621,Davis; Joshua Daniel,0,27,60,60
1650672429010,COGS 101B,A01,091572,Staff,0,4,60,60
1650672435037,COGS 101C,A01,083625,Delgado; Tania,14,0,30,16
1650672441065,COGS 107A,A01,083627,Boyle; Mary E. T.,1,17,60,59
1650672447091,COGS 118A,A01,083075,Staff,0,7,60,60
1650672453124,CSE 3,A50,083646,Miranda; Gregory Joseph,19,0,38,19
1650672453124,CSE 3,A51,083647,Miranda; Gregory Joseph,36,0,37,1
1650672459147,CSE 8A,A50,083650,Miranda; Gregory Joseph,0,30,40,40
1650672465171,CSE 11,A01,083080,Cao; Yingjun,0,95,40,40
1650672471206,CSE 12,A01,083652,Staff,0,21,100,100
1650672477233,CSE 15L,A01,083654,Staff,0,3,50,50
1650672477233,CSE 15L,A02,083655,Staff,0,2,50,50
1650672483268,CSE 20,A01,083657,Staff,50,0,80,30
1650672489302,CSE 30,A01,083084,Eldon; John,0,78,40,40
1650672495325,CSE 100,A01,083659,Cao; Yingjun,0,70,50,50
1650672501349,CSE 134B,A01,083661,Powell; Thomas Allan,0,38,65,65
1650672507376,CSE 140,A01,083663,Staff,0,10,75,75
1650672513404,CSE 140L,A01,083088,Eldon; John,0,18,75,75
1650672519434,CSE 175,A01,083665,Kumar; Rakesh,7,0,25,18
1650672525457,CSE 190,A00,092507,Dubnov; Shlomo,10,0,20,10
1650672531496,ECE 45,A01,083139,Staff,0,2,60,60
1650672537521,ECE 65,A50,083695,Staff,0,5,30,30
1650672543545,ECE 109,A01,091882,Touri; Behrouz,33,0,70,37
1650672549576,ECE 180,A00,083140,Abi Samra; Nicholas Camill,20,0,30,10
1650672549576,ECE 180,B00,083141,Abi Samra; Nicholas Camill,0,0,30,30
1650672555600,MATH 10A,A01,083735,Patchell; Gregory David,3,0,30,27
1650672555600,MATH 10A,A02,083736,Patchell; Gregory David,27,0,30,3
1650672555600,MATH 10A,A03,083737,Patchell; Gregory David,24,0,30,6
1650672561636,MATH 10B,A01,083207,Staff,0,9,30,30
1650672561636,MATH 10B,A02,083208,Staff,1,8,30,29
1650672561636,MATH 10B,B01,083739,Staff,11,0,30,19
1650672561636,MATH 10B,B02,083740,Staff,28,0,30,2
1650672567667,MATH 18,A01,083743,Staff,0,0,30,30
1650672567667,MATH 18,A02,083744,Staff,23,0,30,7
1650672567667,MATH 18,A03,083745,Staff,21,0,30,9
1650672567667,MATH 18,A04,083746,Staff,26,0,30,4
1650672567667,MATH 18,B01,083748,Staff,0,15,30,30
1650672567667,MATH 18,B02,083749,Staff,0,12,30,30
1650672567667,MATH 18,B03,083750,Staff,0,12,30,30
1650672567667,MATH 18,B04,083751,Staff,0,12,30,30
1650672573693,MATH 20A,A01,083754,Staff,19,0,40,21
1650672579725,MATH 20B,A01,083756,Staff,0,11,30,30
1650672579725,MATH 20B,A02,083757,Staff,0,12,30,30
1650672585753,MATH 20C,A01,083760,Staff,0,16,30,30
1650672585753,MATH 20C,A02,083761,Staff,1,15,30,29
1650672585753,MATH 20C,B01,083762,Staff,10,0,30,20
1650672585753,MATH 20C,B02,083763,Staff,28,0,30,2
1650672591782,MATH 20D,A01,083765,Staff,1,1,30,29
1650672591782,MATH 20D,A02,083766,Staff,6,0,30,24
1650672591782,MATH 20D,A03,083767,Staff,24,0,30,6
1650672597807,MATH 20E,A01,083771,Staff,3,0,30,27
1650672597807,MATH 20E,A02,083772,Staff,16,0,30,14
1650672597807,MATH 20E,B01,083773,Staff,0,0,30,30
1650672597807,MATH 20E,B02,083774,Staff,9,0,30,21
1650672603832,MATH 103A,A01,083777,Staff,0,15,30,30
1650672603832,MATH 103A,A02,083778,Staff,0,15,30,30
1650672603832,MATH 103A,B01,083779,Staff,0,14,30,30
1650672603832,MATH 103A,B02,083780,Staff,0,14,30,30
1650672609854,MATH 105,A01,085443,Staff,0,22,30,30
1650672615884,MATH 109,A01,083213,Anzaldo; Leesa B,0,7,30,30
1650672615884,MATH 109,A02,083214,Anzaldo; Leesa B,0,7,30,30
1650672615884,MATH 109,B01,083215,Anzaldo; Leesa B,0,8,30,30
1650672615884,MATH 109,B02,083216,Anzaldo; Leesa B,0,6,30,30
1650672621908,MATH 142A,A01,083219,Chow; Bennett,0,16,30,30
1650672621908,MATH 142A,A02,083220,Chow; Bennett,0,15,30,30
1650672621908,MATH 142A,B01,083221,Chow; Bennett,0,13,30,30
1650672621908,MATH 142A,B02,083222,Chow; Bennett,0,14,30,30
1650672627935,MATH 193A,A01,083224,Staff,0,5,30,30
1650672627935,MATH 193A,A02,083225,Staff,0,6,30,30
1650672627935,MATH 193A,A03,083781,Staff,0,6,30,30
1650672627935,MATH 193A,A04,083782,Staff,0,7,30,30
1650672633959,MATH 197,001,091859,McAuley; Julian John,9998,0,9999,1
1650672640021,COGS 9,A01,083615,Staff,1,16,60,59
1650672646046,COGS 11,A01,083617,Boyle; Mary E. T.,18,0,40,22
1650672652069,COGS 13,A01,083071,Staff,0,39,40,40
1650672658097,COGS 14A,A01,092681,Staff,0,32,100,100
1650672664121,COGS 14B,A01,083073,Cheng; Tzu-Han,1,14,50,49
1650672670148,COGS 17,A01,092677,Staff,15,0,75,60
1650672676171,COGS 100,A01,083619,Staff,0,28,60,60
1650672682196,COGS 101A,A01,083621,Davis; Joshua Daniel,0,27,60,60
1650672688220,COGS 101B,A01,091572,Staff,0,4,60,60
1650672694252,COGS 101C,A01,083625,Delgado; Tania,14,0,30,16
1650672700275,COGS 107A,A01,083627,Boyle; Mary E. T.,1,17,60,59
1650672706304,COGS 118A,A01,083075,Staff,0,7,60,60
1650672712331,CSE 3,A50,083646,Miranda; Gregory Joseph,19,0,38,19
1650672712331,CSE 3,A51,083647,Miranda; Gregory Joseph,36,0,37,1
1650672718356,CSE 8A,A50,083650,Miranda; Gregory Joseph,0,30,40,40
1650672724383,CSE 11,A01,083080,Cao; Yingjun,0,95,40,40
1650672730411,CSE 12,A01,083652,Staff,0,21,100,100
1650672736439,CSE 15L,A01,083654,Staff,0,3,50,50
1650672736439,CSE 15L,A02,083655,Staff,0,2,50,50
1650672742468,CSE 20,A01,083657,Staff,50,0,80,30
1650672748495,CSE 30,A01,083084,Eldon; John,0,78,40,40
1650672754529,CSE 100,A01,083659,Cao; Yingjun,0,70,50,50
1650672760553,CSE 134B,A01,083661,Powell; Thomas Allan,0,38,65,65
1650672766579,CSE 140,A01,083663,Staff,0,10,75,75
1650672772609,CSE 140L,A01,083088,Eldon; John,0,18,75,75
1650672778644,CSE 175,A01,083665,Kumar; Rakesh,7,0,25,18
1650672784668,CSE 190,A00,092507,Dubnov; Shlomo,10,0,20,10
1650672790697,ECE 45,A01,083139,Staff,0,2,60,60
1650672796720,ECE 65,A50,083695,Staff,0,5,30,30
1650672802741,ECE 109,A01,091882,Touri; Behrouz,33,0,70,37
1650672808772,ECE 180,A00,083140,Abi Samra; Nicholas Camill,20,0,30,10
1650672808772,ECE 180,B00,083141,Abi Samra; Nicholas Camill,0,0,30,30
1650672814886,MATH 10A,A01,083735,Patchell; Gregory David,3,0,30,27
1650672814886,MATH 10A,A02,083736,Patchell; Gregory David,27,0,30,3
1650672814886,MATH 10A,A03,083737,Patchell; Gregory David,24,0,30,6
1650672820909,MATH 10B,A01,083207,Staff,0,9,30,30
1650672820909,MATH 10B,A02,083208,Staff,1,8,30,29
1650672820909,MATH 10B,B01,083739,Staff,11,0,30,19
1650672820909,MATH 10B,B02,083740,Staff,28,0,30,2
1650672826935,MATH 18,A01,083743,Staff,0,0,30,30
1650672826935,MATH 18,A02,083744,Staff,23,0,30,7
1650672826935,MATH 18,A03,083745,Staff,21,0,30,9
1650672826935,MATH 18,A04,083746,Staff,26,0,30,4
1650672826935,MATH 18,B01,083748,Staff,0,15,30,30
1650672826935,MATH 18,B02,083749,Staff,0,12,30,30
1650672826935,MATH 18,B03,083750,Staff,0,12,30,30
1650672826935,MATH 18,B04,083751,Staff,0,12,30,30
1650672832957,MATH 20A,A01,083754,Staff,19,0,40,21
1650672838981,MATH 20B,A01,083756,Staff,0,11,30,30
1650672838981,MATH 20B,A02,083757,Staff,0,12,30,30
1650672845006,MATH 20C,A01,083760,Staff,0,16,30,30
1650672845006,MATH 20C,A02,083761,Staff,1,15,30,29
1650672845006,MATH 20C,B01,083762,Staff,10,0,30,20
1650672845006,MATH 20C,B02,083763,Staff,28,0,30,2
1650672851030,MATH 20D,A01,083765,Staff,1,1,30,29
1650672851030,MATH 20D,A02,083766,Staff,6,0,30,24
1650672851030,MATH 20D,A03,083767,Staff,24,0,30,6
1650672857058,MATH 20E,A01,083771,Staff,3,0,30,27
1650672857058,MATH 20E,A02,083772,Staff,16,0,30,14
1650672857058,MATH 20E,B01,083773,Staff,0,0,30,30
1650672857058,MATH 20E,B02,083774,Staff,9,0,30,21
1650672863087,MATH 103A,A01,083777,Staff,0,15,30,30
1650672863087,MATH 103A,A02,083778,Staff,0,15,30,30
1650672863087,MATH 103A,B01,083779,Staff,0,14,30,30
1650672863087,MATH 103A,B02,083780,Staff,0,14,30,30
1650672869116,MATH 105,A01,085443,Staff,0,22,30,30
1650672875145,MATH 109,A01,083213,Anzaldo; Leesa B,0,7,30,30
1650672875145,MATH 109,A02,083214,Anzaldo; Leesa B,0,7,30,30
1650672875145,MATH 109,B01,083215,Anzaldo; Leesa B,0,8,30,30
1650672875145,MATH 109,B02,083216,Anzaldo; Leesa B,0,6,30,30
1650672881173,MATH 142A,A01,083219,Chow; Bennett,0,16,30,30
1650672881173,MATH 142A,A02,083220,Chow; Bennett,0,15,30,30
1650672881173,MATH 142A,B01,083221,Chow; Bennett,0,13,30,30
1650672881173,MATH 142A,B02,083222,Chow; Bennett,0,14,30,30
1650672887198,MATH 193A,A01,083224,Staff,0,5,30,30
1650672887198,MATH 193A,A02,083225,Staff,0,6,30,30
1650672887198,MATH 193A,A03,083781,Staff,0,6,30,30
1650672887198,MATH 193A,A04,083782,Staff,0,7,30,30
1650672893223,MATH 197,001,091859,McAuley; Julian John,9998,0,9999,1
1650672899290,COGS 9,A01,083615,Staff,1,16,60,59
1650672905316,COGS 11,A01,083617,Boyle; Mary E. T.,18,0,40,22
1650672911342,COGS 13,A01,083071,Staff,0,39,40,40
1650672917370,COGS 14A,A01,092681,Staff,0,32,100,100
1650672923401,COGS 14B,A01,083073,Cheng; Tzu-Han,1,14,50,49
1650672929428,COGS 17,A01,092677,Staff,15,0,75,60
1650672935461,COGS 100,A01,083619,Staff,0,28,60,60
1650672941486,COGS 101A,A01,083621,Davis; Joshua Daniel,0,27,60,60
1650672947511,COGS 101B,A01,091572,Staff,0,4,60,60
1650672953539,COGS 101C,A01,083625,Delgado; Tania,14,0,30,16
1650672959566,COGS 107A,A01,083627,Boyle; Mary E. T.,1,17,60,59
1650672965607,COGS 118A,A01,083075,Staff,0,7,60,60
1650672971636,CSE 3,A50,083646,Miranda; Gregory Joseph,19,0,38,19
1650672971636,CSE 3,A51,083647,Miranda; Gregory Joseph,36,0,37,1
1650672977663,CSE 8A,A50,083650,Miranda; Gregory Joseph,0,30,40,40
1650672983686,CSE 11,A01,083080,Cao; Yingjun,0,95,40,40
1650672989711,CSE 12,A01,083652,Staff,0,22,100,100
1650672995734,CSE 15L,A01,083654,Staff,0,3,50,50
1650672995734,CSE 15L,A02,083655,Staff,0,3,50,50
1650673001764,CSE 20,A01,083657,Staff,51,0,80,29
1650673007792,CSE 30,A01,083084,Eldon; John,0,78,40,40
1650673013816,CSE 100,A01,083659,Cao; Yingjun,0,70,50,50
1650673019843,CSE 134B,A01,083661,Powell; Thomas Allan,0,38,65,65
1650673025867,CSE 140,A01,083663,Staff,0,10,75,75
1650673031899,CSE 140L,A01,083088,Eldon; John,0,18,75,75
1650673037925,CSE 175,A01,083665,Kumar; Rakesh,7,0,25,18
1650673043949,CSE 190,A00,092507,Dubnov; Shlomo,10,0,20,10
1650673049972,ECE 45,A01,083139,Staff,0,2,60,60
1650673055999,ECE 65,A50,083695,Staff,0,5,30,30
1650673062023,ECE 109,A01,091882,Touri; Behrouz,33,0,70,37
1650673068047,ECE 180,A00,083140,Abi Samra; Nicholas Camill,20,0,30,10
1650673068047,ECE 180,B00,083141,Abi Samra; Nicholas Camill,0,0,30,30
1650673074071,MATH 10A,A01,083735,Patchell; Gregory David,3,0,30,27
1650673074071,MATH 10A,A02,083736,Patchell; Gregory David,27,0,30,3
1650673074071,MATH 10A,A03,083737,Patchell; Gregory David,24,0,30,6
1650673080096,MATH 10B,A01,083207,Staff,0,9,30,30
1650673080096,MATH 10B,A02,083208,Staff,1,8,30,29
1650673080096,MATH 10B,B01,083739,Staff,11,0,30,19
1650673080096,MATH 10B,B02,083740,Staff,28,0,30,2
1650673086122,MATH 18,A01,083743,Staff,0,0,30,30
1650673086122,MATH 18,A02,083744,Staff,23,0,30,7
1650673086122,MATH 18,A03,083745,Staff,21,0,30,9
1650673086122,MATH 18,A04,083746,Staff,26,0,30,4
1650673086122,MATH 18,B01,083748,Staff,0,15,30,30
1650673086122,MATH 18,B02,083749,Staff,0,12,30,30
1650673086122,MATH 18,B03,083750,Staff,0,12,30,30
1650673086122,MATH 18,B04,083751,Staff,0,12,30,30
1650673092147,MATH 20A,A01,083754,Staff,19,0,40,21
1650673098173,MATH 20B,A01,083756,Staff,0,11,30,30
1650673098173,MATH 20B,A02,083757,Staff,0,12,30,30
1650673104195,MATH 20C,A01,083760,Staff,0,16,30,30
1650673104195,MATH 20C,A02,083761,Staff,1,15,30,29
1650673104195,MATH 20C,B01,083762,Staff,10,0,30,20
1650673104195,MATH 20C,B02,083763,Staff,28,0,30,2
1650673110223,MATH 20D,A01,083765,Staff,1,1,30,29
1650673110223,MATH 20D,A02,083766,Staff,6,0,30,24
1650673110223,MATH 20D,A03,083767,Staff,24,0,30,6
1650673116259,MATH 20E,A01,083771,Staff,3,0,30,27
1650673116259,MATH 20E,A02,083772,Staff,16,0,30,14
1650673116259,MATH 20E,B01,083773,Staff,0,0,30,30
1650673116259,MATH 20E,B02,083774,Staff,9,0,30,21
1650673122283,MATH 103A,A01,083777,Staff,0,15,30,30
1650673122283,MATH 103A,A02,083778,Staff,0,15,30,30
1650673122283,MATH 103A,B01,083779,Staff,0,14,30,30
1650673122283,MATH 103A,B02,083780,Staff,0,14,30,30
1650673128307,MATH 105,A01,085443,Staff,0,22,30,30
1650673134331,MATH 109,A01,083213,Anzaldo; Leesa B,0,7,30,30
1650673134331,MATH 109,A02,083214,Anzaldo; Leesa B,0,7,30,30
1650673134331,MATH 109,B01,083215,Anzaldo; Leesa B,0,8,30,30
1650673134331,MATH 109,B02,083216,Anzaldo; Leesa B,0,6,30,30
1650673140360,MATH 142A,A01,083219,Chow; Bennett,0,16,30,30
1650673140360,MATH 142A,A02,083220,Chow; Bennett,0,15,30,30
1650673140360,MATH 142A,B01,083221,Chow; Bennett,0,13,30,30
1650673140360,MATH 142A,B02,083222,Chow; Bennett,0,14,30,30
1650673146384,MATH 193A,A01,083224,Staff,0,5,30,30
1650673146384,MATH 193A,A02,083225,Staff,0,6,30,30
1650673146384,MATH 193A,A03,083781,Staff,0,6,30,30
1650673146384,MATH 193A,A04,083782,Staff,0,7,30,30
1650673152417,MATH 197,001,091859,McAuley; Julian John,9998,0,9999,1
1650673158466,COGS 9,A01,083615,Staff,1,16,60,59
1650673164491,COGS 11,A01,083617,Boyle; Mary E. T.,18,0,40,22
1650673170524,COGS 13,A01,083071,Staff,0,39,40,40
1650673176546,COGS 14A,A01,092681,Staff,0,32,100,100
1650673182575,COGS 14B,A01,083073,Cheng; Tzu-Han,1,14,50,49
1650673188605,COGS 17,A01,092677,Staff,15,0,75,60
1650673194627,COGS 100,A01,083619,Staff,0,28,60,60
1650673200652,COGS 101A,A01,083621,Davis; Joshua Daniel,0,27,60,60
1650673212353,COGS 101B,A01,091572,Staff,0,4,60,60
1650673218378,COGS 101C,A01,083625,Delgado; Tania,14,0,30,16
1650673224411,COGS 107A,A01,083627,Boyle; Mary E. T.,1,17,60,59
1650673230433,COGS 118A,A01,083075,Staff,0,7,60,60
1650673236457,CSE 3,A50,083646,Miranda; Gregory Joseph,19,0,38,19
1650673236457,CSE 3,A51,083647,Miranda; Gregory Joseph,36,0,37,1
1650673242485,CSE 8A,A50,083650,Miranda; Gregory Joseph,0,30,40,40
1650673248511,CSE 11,A01,083080,Cao; Yingjun,0,95,40,40
1650673254538,CSE 12,A01,083652,Staff,0,22,100,100
1650673260560,CSE 15L,A01,083654,Staff,0,3,50,50
1650673260560,CSE 15L,A02,083655,Staff,0,3,50,50
1650673266588,CSE 20,A01,083657,Staff,51,0,80,29
1650673272615,CSE 30,A01,083084,Eldon; John,0,78,40,40
1650673278640,CSE 100,A01,083659,Cao; Yingjun,0,70,50,50
1650673284674,CSE 134B,A01,083661,Powell; Thomas Allan,0,38,65,65
1650673290698,CSE 140,A01,083663,Staff,0,10,75,75
1650673296725,CSE 140L,A01,083088,Eldon; John,0,18,75,75
1650673302750,CSE 175,A01,083665,Kumar; Rakesh,7,0,25,18
1650673308779,CSE 190,A00,092507,Dubnov; Shlomo,10,0,20,10
1650673314801,ECE 45,A01,083139,Staff,0,2,60,60
1650673320825,ECE 65,A50,083695,Staff,0,5,30,30
1650673326848,ECE 109,A01,091882,Touri; Behrouz,33,0,70,37
1650673332877,ECE 180,A00,083140,Abi Samra; Nicholas Camill,20,0,30,10
1650673332877,ECE 180,B00,083141,Abi Samra; Nicholas Camill,0,0,30,30
1650673338907,MATH 10A,A01,083735,Patchell; Gregory David,3,0,30,27
1650673338907,MATH 10A,A02,083736,Patchell; Gregory David,27,0,30,3
1650673338907,MATH 10A,A03,083737,Patchell; Gregory David,24,0,30,6
1650673344931,MATH 10B,A01,083207,Staff,0,9,30,30
1650673344931,MATH 10B,A02,083208,Staff,1,8,30,29
1650673344931,MATH 10B,B01,083739,Staff,11,0,30,19
1650673344931,MATH 10B,B02,083740,Staff,28,0,30,2
1650673350960,MATH 18,A01,083743,Staff,0,0,30,30
1650673350960,MATH 18,A02,083744,Staff,23,0,30,7
1650673350960,MATH 18,A03,083745,Staff,21,0,30,9
1650673350960,MATH 18,A04,083746,Staff,26,0,30,4
1650673350960,MATH 18,B01,083748,Staff,0,15,30,30
1650673350960,MATH 18,B02,083749,Staff,0,12,30,30
1650673350960,MATH 18,B03,083750,Staff,0,12,30,30
1650673350960,MATH 18,B04,083751,Staff,0,12,30,30
1650673356985,MATH 20A,A01,083754,Staff,19,0,40,21
1650673363011,MATH 20B,A01,083756,Staff,0,11,30,30
1650673363011,MATH 20B,A02,083757,Staff,0,12,30,30
1650673369041,MATH 20C,A01,083760,Staff,0,16,30,30
1650673369041,MATH 20C,A02,083761,Staff,1,15,30,29
1650673369041,MATH 20C,B01,083762,Staff,10,0,30,20
1650673369041,MATH 20C,B02,083763,Staff,28,0,30,2
1650673375066,MATH 20D,A01,083765,Staff,1,1,30,29
1650673375066,MATH 20D,A02,083766,Staff,6,0,30,24
1650673375066,MATH 20D,A03,083767,Staff,24,0,30,6
1650673381100,MATH 20E,A01,083771,Staff,3,0,30,27
1650673381100,MATH 20E,A02,083772,Staff,16,0,30,14
1650673381100,MATH 20E,B01,083773,Staff,0,0,30,30
1650673381100,MATH 20E,B02,083774,Staff,9,0,30,21
1650673387125,MATH 103A,A01,083777,Staff,0,15,30,30
1650673387125,MATH 103A,A02,083778,Staff,0,15,30,30
1650673387125,MATH 103A,B01,083779,Staff,0,14,30,30
1650673387125,MATH 103A,B02,083780,Staff,0,14,30,30
1650673393147,MATH 105,A01,085443,Staff,0,22,30,30
1650673399171,MATH 109,A01,083213,Anzaldo; Leesa B,0,7,30,30
1650673399171,MATH 109,A02,083214,Anzaldo; Leesa B,0,7,30,30
1650673399171,MATH 109,B01,083215,Anzaldo; Leesa B,0,8,30,30
1650673399171,MATH 109,B02,083216,Anzaldo; Leesa B,0,6,30,30
1650673405206,MATH 142A,A01,083219,Chow; Bennett,0,16,30,30
1650673405206,MATH 142A,A02,083220,Chow; Bennett,0,15,30,30
1650673405206,MATH 142A,B01,083221,Chow; Bennett,0,13,30,30
1650673405206,MATH 142A,B02,083222,Chow; Bennett,0,14,30,30
1650673411232,MATH 193A,A01,083224,Staff,0,5,30,30
1650673411232,MATH 193A,A02,083225,Staff,0,6,30,30
1650673411232,MATH 193A,A03,083781,Staff,0,6,30,30
1650673411232,MATH 193A,A04,083782,Staff,0,7,30,30
1650673417347,MATH 197,001,091859,McAuley; Julian John,9998,0,9999,1
1650673423407,COGS 9,A01,083615,Staff,1,16,60,59
1650673429430,COGS 11,A01,083617,Boyle; Mary E. T.,18,0,40,22
1650673435459,COGS 13,A01,083071,Staff,0,39,40,40
1650673441485,COGS 14A,A01,092681,Staff,0,32,100,100
1650673447511,COGS 14B,A01,083073,Cheng; Tzu-Han,1,14,50,49
1650673453534,COGS 17,A01,092677,Staff,15,0,75,60
1650673459557,COGS 100,A01,083619,Staff,0,28,60,60
1650673465584,COGS 101A,A01,083621,Davis; Joshua Daniel,0,27,60,60
1650673471615,COGS 101B,A01,091572,Staff,0,4,60,60
1650673477647,COGS 101C,A01,083625,Delgado; Tania,14,0,30,16
1650673483670,COGS 107A,A01,083627,Boyle; Mary E. T.,1,17,60,59
1650673489694,COGS 118A,A01,083075,Staff,0,7,60,60
1650673495725,CSE 3,A50,083646,Miranda; Gregory Joseph,19,0,38,19
1650673495725,CSE 3,A51,083647,Miranda; Gregory Joseph,36,0,37,1
1650673501750,CSE 8A,A50,083650,Miranda; Gregory Joseph,0,30,40,40
1650673507774,CSE 11,A01,083080,Cao; Yingjun,0,95,40,40
1650673513801,CSE 12,A01,083652,Staff,0,22,100,100
1650673519825,CSE 15L,A01,083654,Staff,0,3,50,50
1650673519825,CSE 15L,A02,083655,Staff,0,3,50,50
1650673525847,CSE 20,A01,083657,Staff,51,0,80,29
1650673531876,CSE 30,A01,083084,Eldon; John,0,78,40,40
1650673537906,CSE 100,A01,083659,Cao; Yingjun,0,70,50,50
1650673543938,CSE 134B,A01,083661,Powell; Thomas Allan,0,38,65,65
1650673549962,CSE 140,A01,083663,Staff,0,10,75,75
1650673555988,CSE 140L,A01,083088,Eldon; John,0,18,75,75
1650673562017,CSE 175,A01,083665,Kumar; Rakesh,7,0,25,18
1650673568040,CSE 190,A00,092507,Dubnov; Shlomo,10,0,20,10
1650673574066,ECE 45,A01,083139,Staff,0,2,60,60
1650673580093,ECE 65,A50,083695,Staff,0,5,30,30
1650673586124,ECE 109,A01,091882,Touri; Behrouz,33,0,70,37
1650673592151,ECE 180,A00,083140,Abi Samra; Nicholas Camill,20,0,30,10
1650673592151,ECE 180,B00,083141,Abi Samra; Nicholas Camill,0,0,30,30
1650673598178,MATH 10A,A01,083735,Patchell; Gregory David,3,0,30,27
1650673598178,MATH 10A,A02,083736,Patchell; Gregory David,27,0,30,3
1650673598178,MATH 10A,A03,083737,Patchell; Gregory David,24,0,30,6
1650673604202,MATH 10B,A01,083207,Staff,0,9,30,30
1650673604202,MATH 10B,A02,083208,Staff,1,8,30,29
1650673604202,MATH 10B,B01,083739,Staff,11,0,30,19
1650673604202,MATH 10B,B02,083740,Staff,28,0,30,2
1650673610232,MATH 18,A01,083743,Staff,0,0,30,30
1650673610232,MATH 18,A02,083744,Staff,23,0,30,7
1650673610232,MATH 18,A03,083745,Staff,21,0,30,9
1650673610232,MATH 18,A04,083746,Staff,26,0,30,4
1650673610232,MATH 18,B01,083748,Staff,0,15,30,30
1650673610232,MATH 18,B02,083749,Staff,0,12,30,30
1650673610232,MATH 18,B03,083750,Staff,0,12,30,30
1650673610232,MATH 18,B04,083751,Staff,0,12,30,30
1650673616256,MATH 20A,A01,083754,Staff,19,0,40,21
1650673622280,MATH 20B,A01,083756,Staff,0,11,30,30
1650673622280,MATH 20B,A02,083757,Staff,0,12,30,30
1650673628314,MATH 20C,A01,083760,Staff,0,16,30,30
1650673628314,MATH 20C,A02,083761,Staff,1,15,30,29
1650673628314,MATH 20C,B01,083762,Staff,10,0,30,20
1650673628314,MATH 20C,B02,083763,Staff,28,0,30,2
1650673634337,MATH 20D,A01,083765,Staff,1,1,30,29
1650673634337,MATH 20D,A02,083766,Staff,6,0,30,24
1650673634337,MATH 20D,A03,083767,Staff,24,0,30,6
1650673640365,MATH 20E,A01,083771,Staff,3,0,30,27
1650673640365,MATH 20E,A02,083772,Staff,16,0,30,14
1650673640365,MATH 20E,B01,083773,Staff,0,0,30,30
1650673640365,MATH 20E,B02,083774,Staff,9,0,30,21
1650673646392,MATH 103A,A01,083777,Staff,0,15,30,30
1650673646392,MATH 103A,A02,083778,Staff,0,15,30,30
1650673646392,MATH 103A,B01,083779,Staff,0,14,30,30
1650673646392,MATH 103A,B02,083780,Staff,0,14,30,30
1650673652416,MATH 105,A01,085443,Staff,0,22,30,30
1650673658441,MATH 109,A01,083213,Anzaldo; Leesa B,0,7,30,30
1650673658441,MATH 109,A02,083214,Anzaldo; Leesa B,0,7,30,30
1650673658441,MATH 109,B01,083215,Anzaldo; Leesa B,0,8,30,30
1650673658441,MATH 109,B02,083216,Anzaldo; Leesa B,0,6,30,30
1650673664475,MATH 142A,A01,083219,Chow; Bennett,0,16,30,30
1650673664475,MATH 142A,A02,083220,Chow; Bennett,0,15,30,30
1650673664475,MATH 142A,B01,083221,Chow; Bennett,0,13,30,30
1650673664475,MATH 142A,B02,083222,Chow; Bennett,0,14,30,30
1650673670501,MATH 193A,A01,083224,Staff,0,5,30,30
1650673670501,MATH 193A,A02,083225,Staff,0,6,30,30
1650673670501,MATH 193A,A03,083781,Staff,0,6,30,30
1650673670501,MATH 193A,A04,083782,Staff,0,7,30,30
1650673676525,MATH 197,001,091859,McAuley; Julian John,9998,0,9999,1
1650673682588,COGS 9,A01,083615,Staff,1,16,60,59
1650673688614,COGS 11,A01,083617,Boyle; Mary E. T.,18,0,40,22
1650673694653,COGS 13,A01,083071,Staff,0,39,40,40
1650673700683,COGS 14A,A01,092681,Staff,0,32,100,100
1650673706708,COGS 14B,A01,083073,Cheng; Tzu-Han,1,14,50,49
1650673712732,COGS 17,A01,092677,Staff,15,0,75,60
1650673718758,COGS 100,A01,083619,Staff,0,28,60,60
1650673724782,COGS 101A,A01,083621,Davis; Joshua Daniel,0,27,60,60
1650673730809,COGS 101B,A01,091572,Staff,0,4,60,60
1650673736837,COGS 101C,A01,083625,Delgado; Tania,14,0,30,16
1650673742864,COGS 107A,A01,083627,Boyle; Mary E. T.,1,17,60,59
1650673748891,COGS 118A,A01,083075,Staff,0,7,60,60
1650673754920,CSE 3,A50,083646,Miranda; Gregory Joseph,19,0,38,19
1650673754920,CSE 3,A51,083647,Miranda; Gregory Joseph,36,0,37,1
1650673760944,CSE 8A,A50,083650,Miranda; Gregory Joseph,0,30,40,40
1650673766966,CSE 11,A01,083080,Cao; Yingjun,0,95,40,40
1650673772997,CSE 12,A01,083652,Staff,0,21,100,100
1650673779020,CSE 15L,A01,083654,Staff,0,3,50,50
1650673779020,CSE 15L,A02,083655,Staff,0,2,50,50
1650673785054,CSE 20,A01,083657,Staff,50,0,80,30
1650673791080,CSE 30,A01,083084,Eldon; John,0,78,40,40
1650673797106,CSE 100,A01,083659,Cao; Yingjun,0,70,50,50
1650673803141,CSE 134B,A01,083661,Powell; Thomas Allan,0,38,65,65
1650673809167,CSE 140,A01,083663,Staff,0,10,75,75
1650673815199,CSE 140L,A01,083088,Eldon; John,0,18,75,75
1650673821223,CSE 175,A01,083665,Kumar; Rakesh,7,0,25,18
1650673827254,CSE 190,A00,092507,Dubnov; Shlomo,10,0,20,10
1650673833276,ECE 45,A01,083139,Staff,0,2,60,60
1650673839301,ECE 65,A50,083695,Staff,0,5,30,30
1650673845326,ECE 109,A01,091882,Touri; Behrouz,33,0,70,37
1650673851349,ECE 180,A00,083140,Abi Samra; Nicholas Camill,20,0,30,10
1650673851349,ECE 180,B00,083141,Abi Samra; Nicholas Camill,0,0,30,30
1650673857375,MATH 10A,A01,083735,Patchell; Gregory David,3,0,30,27
1650673857375,MATH 10A,A02,083736,Patchell; Gregory David,27,0,30,3
1650673857375,MATH 10A,A03,083737,Patchell; Gregory David,24,0,30,6
1650673863413,MATH 10B,A01,083207,Staff,0,9,30,30
1650673863413,MATH 10B,A02,083208,Staff,1,8,30,29
1650673863413,MATH 10B,B01,083739,Staff,11,0,30,19
1650673863413,MATH 10B,B02,083740,Staff,28,0,30,2
1650673869448,MATH 18,A01,083743,Staff,0,0,30,30
1650673869448,MATH 18,A02,083744,Staff,23,0,30,7
1650673869448,MATH 18,A03,083745,Staff,21,0,30,9
1650673869448,MATH 18,A04,083746,Staff,26,0,30,4
1650673869448,MATH 18,B01,083748,Staff,0,15,30,30
1650673869448,MATH 18,B02,083749,Staff,0,12,30,30
1650673869448,MATH 18,B03,083750,Staff,0,12,30,30
1650673869448,MATH 18,B04,083751,Staff,0,12,30,30
1650673875471,MATH 20A,A01,083754,Staff,19,0,40,21
1650673881496,MATH 20B,A01,083756,Staff,0,11,30,30
1650673881496,MATH 20B,A02,083757,Staff,0,12,30,30
1650673887520,MATH 20C,A01,083760,Staff,0,16,30,30
1650673887520,MATH 20C,A02,083761,Staff,1,15,30,29
1650673887520,MATH 20C,B01,083762,Staff,10,0,30,20
1650673887520,MATH 20C,B02,083763,Staff,28,0,30,2
1650673893545,MATH 20D,A01,083765,Staff,1,1,30,29
1650673893545,MATH 20D,A02,083766,Staff,6,0,30,24
1650673893545,MATH 20D,A03,083767,Staff,24,0,30,6
1650673899568,MATH 20E,A01,083771,Staff,3,0,30,27
1650673899568,MATH 20E,A02,083772,Staff,16,0,30,14
1650673899568,MATH 20E,B01,083773,Staff,0,0,30,30
1650673899568,MATH 20E,B02,083774,Staff,9,0,30,21
1650673905601,MATH 103A,A01,083777,Staff,0,15,30,30
1650673905601,MATH 103A,A02,083778,Staff,0,15,30,30
1650673905601,MATH 103A,B01,083779,Staff,0,14,30,30
1650673905601,MATH 103A,B02,083780,Staff,0,14,30,30
1650673911627,MATH 105,A01,085443,Staff,0,22,30,30
1650673917652,MATH 109,A01,083213,Anzaldo; Leesa B,0,7,30,30
1650673917652,MATH 109,A02,083214,Anzaldo; Leesa B,0,7,30,30
1650673917652,MATH 109,B01,083215,Anzaldo; Leesa B,0,8,30,30
1650673917652,MATH 109,B02,083216,Anzaldo; Leesa B,0,6,30,30
1650673923676,MATH 142A,A01,083219,Chow; Bennett,0,16,30,30
1650673923676,MATH 142A,A02,083220,Chow; Bennett,0,15,30,30
1650673923676,MATH 142A,B01,083221,Chow; Bennett,0,13,30,30
1650673923676,MATH 142A,B02,083222,Chow; Bennett,0,14,30,30
1650673929697,MATH 193A,A01,083224,Staff,0,5,30,30
1650673929697,MATH 193A,A02,083225,Staff,0,6,30,30
1650673929697,MATH 193A,A03,083781,Staff,0,6,30,30
1650673929697,MATH 193A,A04,083782,Staff,0,7,30,30
1650673935722,MATH 197,001,091859,McAuley; Julian John,9998,0,9999,1
1650673941776,COGS 9,A01,083615,Staff,1,16,60,59
1650673947834,COGS 11,A01,083617,Boyle; Mary E. T.,18,0,40,22
1650673953864,COGS 13,A01,083071,Staff,0,39,40,40
1650673959887,COGS 14A,A01,092681,Staff,0,32,100,100
1650673965913,COGS 14B,A01,083073,Cheng; Tzu-Han,1,14,50,49
1650673971938,COGS 17,A01,092677,Staff,15,0,75,60
1650673977965,COGS 100,A01,083619,Staff,0,28,60,60
1650673983990,COGS 101A,A01,083621,Davis; Joshua Daniel,0,27,60,60
1650673990057,COGS 101B,A01,091572,Staff,0,4,60,60
1650673996080,COGS 101C,A01,083625,Delgado; Tania,14,0,30,16
1650674002103,COGS 107A,A01,083627,Boyle; Mary E. T.,1,17,60,59
1650674008202,COGS 118A,A01,083075,Staff,0,7,60,60
1650674014230,CSE 3,A50,083646,Miranda; Gregory Joseph,19,0,38,19
1650674014230,CSE 3,A51,083647,Miranda; Gregory Joseph,36,0,37,1
1650674020255,CSE 8A,A50,083650,Miranda; Gregory Joseph,0,30,40,40
1650674026280,CSE 11,A01,083080,Cao; Yingjun,0,95,40,40
1650674032305,CSE 12,A01,083652,Staff,0,21,100,100
1650674038337,CSE 15L,A01,083654,Staff,0,3,50,50
1650674038337,CSE 15L,A02,083655,Staff,0,2,50,50
1650674044361,CSE 20,A01,083657,Staff,50,0,80,30
1650674050395,CSE 30,A01,083084,Eldon; John,0,78,40,40
1650674056418,CSE 100,A01,083659,Cao; Yingjun,0,70,50,50
1650674062445,CSE 134B,A01,083661,Powell; Thomas Allan,0,38,65,65
1650674068469,CSE 140,A01,083663,Staff,0,10,75,75
1650674074491,CSE 140L,A01,083088,Eldon; John,0,18,75,75
1650674080514,CSE 175,A01,083665,Kumar; Rakesh,7,0,25,18
1650674086540,CSE 190,A00,092507,Dubnov; Shlomo,10,0,20,10
1650674092566,ECE 45,A01,083139,Staff,0,2,60,60
1650674098592,ECE 65,A50,083695,Staff,0,5,30,30
1650674104616,ECE 109,A01,091882,Touri; Behrouz,33,0,70,37
1650674110645,ECE 180,A00,083140,Abi Samra; Nicholas Camill,20,0,30,10
1650674110645,ECE 180,B00,083141,Abi Samra; Nicholas Camill,0,0,30,30
1650674116674,MATH 10A,A01,083735,Patchell; Gregory David,3,0,30,27
1650674116674,MATH 10A,A02,083736,Patchell; Gregory David,27,0,30,3
1650674116674,MATH 10A,A03,083737,Patchell; Gregory David,24,0,30,6
1650674122697,MATH 10B,A01,083207,Staff,0,9,30,30
1650674122697,MATH 10B,A02,083208,Staff,1,8,30,29
1650674122697,MATH 10B,B01,083739,Staff,11,0,30,19
1650674122697,MATH 10B,B02,083740,Staff,28,0,30,2
1650674128721,MATH 18,A01,083743,Staff,0,0,30,30
1650674128721,MATH 18,A02,083744,Staff,23,0,30,7
1650674128721,MATH 18,A03,083745,Staff,21,0,30,9
1650674128721,MATH 18,A04,083746,Staff,26,0,30,4
1650674128721,MATH 18,B01,083748,Staff,0,15,30,30
1650674128721,MATH 18,B02,083749,Staff,0,12,30,30
1650674128721,MATH 18,B03,083750,Staff,0,12,30,30
1650674128721,MATH 18,B04,083751,Staff,0,12,30,30
1650674134747,MATH 20A,A01,083754,Staff,19,0,40,21
1650674140772,MATH 20B,A01,083756,Staff,0,11,30,30
1650674140772,MATH 20B,A02,083757,Staff,0,12,30,30
1650674146800,MATH 20C,A01,083760,Staff,0,16,30,30
1650674146800,MATH 20C,A02,083761,Staff,1,15,30,29
1650674146800,MATH 20C,B01,083762,Staff,10,0,30,20
1650674146800,MATH 20C,B02,083763,Staff,28,0,30,2
1650674152827,MATH 20D,A01,083765,Staff,1,1,30,29
1650674152827,MATH 20D,A02,083766,Staff,6,0,30,24
1650674152827,MATH 20D,A03,083767,Staff,24,0,30,6
1650674158866,MATH 20E,A01,083771,Staff,3,0,30,27
1650674158866,MATH 20E,A02,083772,Staff,16,0,30,14
1650674158866,MATH 20E,B01,083773,Staff,0,0,30,30
1650674158866,MATH 20E,B02,083774,Staff,9,0,30,21
1650674164895,MATH 103A,A01,083777,Staff,0,15,30,30
1650674164895,MATH 103A,A02,083778,Staff,0,15,30,30
1650674164895,MATH 103A,B01,083779,Staff,0,14,30,30
1650674164895,MATH 103A,B02,083780,Staff,0,14,30,30
1650674170926,MATH 105,A01,085443,Staff,0,22,30,30
1650674176956,MATH 109,A01,083213,Anzaldo; Leesa B,0,7,30,30
1650674176956,MATH 109,A02,083214,Anzaldo; Leesa B,0,7,30,30
1650674176956,MATH 109,B01,083215,Anzaldo; Leesa B,0,8,30,30
1650674176956,MATH 109,B02,083216,Anzaldo; Leesa B,0,6,30,30
1650674182979,MATH 142A,A01,083219,Chow; Bennett,0,16,30,30
1650674182979,MATH 142A,A02,083220,Chow; Bennett,0,15,30,30
1650674182979,MATH 142A,B01,083221,Chow; Bennett,0,13,30,30
1650674182979,MATH 142A,B02,083222,Chow; Bennett,0,14,30,30
1650674189006,MATH 193A,A01,083224,Staff,0,5,30,30
1650674189006,MATH 193A,A02,083225,Staff,0,6,30,30
1650674189006,MATH 193A,A03,083781,Staff,0,6,30,30
1650674189006,MATH 193A,A04,083782,Staff,0,7,30,30
1650674195038,MATH 197,001,091859,McAuley; Julian John,9998,0,9999,1
1650674201091,COGS 9,A01,083615,Staff,1,16,60,59
1650674207114,COGS 11,A01,083617,Boyle; Mary E. T.,18,0,40,22
1650674213142,COGS 13,A01,083071,Staff,0,39,40,40
1650674219170,COGS 14A,A01,092681,Staff,0,32,100,100
1650674225202,COGS 14B,A01,083073,Cheng; Tzu-Han,1,14,50,49
1650674231227,COGS 17,A01,092677,Staff,15,0,75,60
1650674237252,COGS 100,A01,083619,Staff,0,28,60,60
1650674243279,COGS 101A,A01,083621,Davis; Joshua Daniel,0,27,60,60
1650674249307,COGS 101B,A01,091572,Staff,0,4,60,60
1650674255331,COGS 101C,A01,083625,Delgado; Tania,14,0,30,16
1650674261353,COGS 107A,A01,083627,Boyle; Mary E. T.,1,17,60,59
1650674267377,COGS 118A,A01,083075,Staff,0,7,60,60
1650674273406,CSE 3,A50,083646,Miranda; Gregory Joseph,19,0,38,19
1650674273406,CSE 3,A51,083647,Miranda; Gregory Joseph,36,0,37,1
1650674279433,CSE 8A,A50,083650,Miranda; Gregory Joseph,0,30,40,40
1650674285459,CSE 11,A01,083080,Cao; Yingjun,0,95,40,40
1650674291486,CSE 12,A01,083652,Staff,0,21,100,100
1650674297512,CSE 15L,A01,083654,Staff,0,3,50,50
1650674297512,CSE 15L,A02,083655,Staff,0,2,50,50
1650674303537,CSE 20,A01,083657,Staff,50,0,80,30
1650674309565,CSE 30,A01,083084,Eldon; John,0,78,40,40
1650674315592,CSE 100,A01,083659,Cao; Yingjun,0,70,50,50
1650674321615,CSE 134B,A01,083661,Powell; Thomas Allan,0,38,65,65
1650674327642,CSE 140,A01,083663,Staff,0,10,75,75
1650674333664,CSE 140L,A01,083088,Eldon; John,0,18,75,75
1650674339690,CSE 175,A01,083665,Kumar; Rakesh,7,0,25,18
1650674345714,CSE 190,A00,092507,Dubnov; Shlomo,10,0,20,10
1650674351741,ECE 45,A01,083139,Staff,0,2,60,60
1650674357766,ECE 65,A50,083695,Staff,0,5,30,30
1650674363789,ECE 109,A01,091882,Touri; Behrouz,33,0,70,37
1650674369813,ECE 180,A00,083140,Abi Samra; Nicholas Camill,20,0,30,10
1650674369813,ECE 180,B00,083141,Abi Samra; Nicholas Camill,0,0,30,30
1650674375837,MATH 10A,A01,083735,Patchell; Gregory David,3,0,30,27
1650674375837,MATH 10A,A02,083736,Patchell; Gregory David,27,0,30,3
1650674375837,MATH 10A,A03,083737,Patchell; Gregory David,24,0,30,6
1650674381865,MATH 10B,A01,083207,Staff,0,9,30,30
1650674381865,MATH 10B,A02,083208,Staff,1,8,30,29
1650674381865,MATH 10B,B01,083739,Staff,11,0,30,19
1650674381865,MATH 10B,B02,083740,Staff,28,0,30,2
1650674387892,MATH 18,A01,083743,Staff,0,0,30,30
1650674387892,MATH 18,A02,083744,Staff,23,0,30,7
1650674387892,MATH 18,A03,083745,Staff,21,0,30,9
1650674387892,MATH 18,A04,083746,Staff,26,0,30,4
1650674387892,MATH 18,B01,083748,Staff,0,15,30,30
1650674387892,MATH 18,B02,083749,Staff,0,12,30,30
1650674387892,MATH 18,B03,083750,Staff,0,12,30,30
1650674387892,MATH 18,B04,083751,Staff,0,12,30,30
1650674393919,MATH 20A,A01,083754,Staff,19,0,40,21
1650674399943,MATH 20B,A01,083756,Staff,0,11,30,30
1650674399943,MATH 20B,A02,083757,Staff,0,12,30,30
1650674405973,MATH 20C,A01,083760,Staff,0,16,30,30
1650674405973,MATH 20C,A02,083761,Staff,1,15,30,29
1650674405973,MATH 20C,B01,083762,Staff,10,0,30,20
1650674405973,MATH 20C,B02,083763,Staff,28,0,30,2
1650674411999,MATH 20D,A01,083765,Staff,1,1,30,29
1650674411999,MATH 20D,A02,083766,Staff,6,0,30,24
1650674411999,MATH 20D,A03,083767,Staff,24,0,30,6
1650674418025,MATH 20E,A01,083771,Staff,3,0,30,27
1650674418025,MATH 20E,A02,083772,Staff,16,0,30,14
1650674418025,MATH 20E,B01,083773,Staff,0,0,30,30
1650674418025,MATH 20E,B02,083774,Staff,9,0,30,21
1650674424058,MATH 103A,A01,083777,Staff,0,15,30,30
1650674424058,MATH 103A,A02,083778,Staff,0,15,30,30
1650674424058,MATH 103A,B01,083779,Staff,0,14,30,30
1650674424058,MATH 103A,B02,083780,Staff,0,14,30,30
1650674430082,MATH 105,A01,085443,Staff,0,22,30,30
1650674436106,MATH 109,A01,083213,Anzaldo; Leesa B,0,7,30,30
1650674436106,MATH 109,A02,083214,Anzaldo; Leesa B,0,7,30,30
1650674436106,MATH 109,B01,083215,Anzaldo; Leesa B,0,8,30,30
1650674436106,MATH 109,B02,083216,Anzaldo; Leesa B,0,6,30,30
1650674442141,MATH 142A,A01,083219,Chow; Bennett,0,16,30,30
1650674442141,MATH 142A,A02,083220,Chow; Bennett,0,15,30,30
1650674442141,MATH 142A,B01,083221,Chow; Bennett,0,13,30,30
1650674442141,MATH 142A,B02,083222,Chow; Bennett,0,14,30,30
1650674448165,MATH 193A,A01,083224,Staff,0,5,30,30
1650674448165,MATH 193A,A02,083225,Staff,0,6,30,30
1650674448165,MATH 193A,A03,083781,Staff,0,6,30,30
1650674448165,MATH 193A,A04,083782,Staff,0,7,30,30
1650674454188,MATH 197,001,091859,McAuley; Julian John,9998,0,9999,1
1650674460242,COGS 9,A01,083615,Staff,1,16,60,59
1650674466265,COGS 11,A01,083617,Boyle; Mary E. T.,18,0,40,22
1650674472291,COGS 13,A01,083071,Staff,0,39,40,40
1650674478315,COGS 14A,A01,092681,Staff,0,32,100,100
1650674484343,COGS 14B,A01,083073,Cheng; Tzu-Han,1,14,50,49
1650674490367,COGS 17,A01,092677,Staff,15,0,75,60
1650674496391,COGS 100,A01,083619,Staff,0,28,60,60
1650674502422,COGS 101A,A01,083621,Davis; Joshua Daniel,0,27,60,60
1650674508446,COGS 101B,A01,091572,Staff,0,4,60,60
1650674514474,COGS 101C,A01,083625,Delgado; Tania,14,0,30,16
1650674520506,COGS 107A,A01,083627,Boyle; Mary E. T.,1,17,60,59
1650674526531,COGS 118A,A01,083075,Staff,0,7,60,60
1650674532554,CSE 3,A50,083646,Miranda; Gregory Joseph,19,0,38,19
1650674532554,CSE 3,A51,083647,Miranda; Gregory Joseph,36,0,37,1
1650674538581,CSE 8A,A50,083650,Miranda; Gregory Joseph,0,30,40,40
1650674544603,CSE 11,A01,083080,Cao; Yingjun,0,95,40,40
1650674550627,CSE 12,A01,083652,Staff,0,21,100,100
1650674556658,CSE 15L,A01,083654,Staff,0,3,50,50
1650674556658,CSE 15L,A02,083655,Staff,0,2,50,50
1650674562683,CSE 20,A01,083657,Staff,50,0,80,30
1650674568710,CSE 30,A01,083084,Eldon; John,0,78,40,40
1650674574734,CSE 100,A01,083659,Cao; Yingjun,0,70,50,50
1650674580757,CSE 134B,A01,083661,Powell; Thomas Allan,0,38,65,65
1650674586779,CSE 140,A01,083663,Staff,0,10,75,75
1650674592802,CSE 140L,A01,083088,Eldon; John,0,18,75,75
1650674598831,CSE 175,A01,083665,Kumar; Rakesh,7,0,25,18
1650674604944,CSE 190,A00,092507,Dubnov; Shlomo,10,0,20,10
1650674610970,ECE 45,A01,083139,Staff,0,2,60,60
1650674617004,ECE 65,A50,083695,Staff,0,5,30,30
1650674623029,ECE 109,A01,091882,Touri; Behrouz,33,0,70,37
1650674629055,ECE 180,A00,083140,Abi Samra; Nicholas Camill,20,0,30,10
1650674629055,ECE 180,B00,083141,Abi Samra; Nicholas Camill,0,0,30,30
1650674635079,MATH 10A,A01,083735,Patchell; Gregory David,3,0,30,27
1650674635079,MATH 10A,A02,083736,Patchell; Gregory David,27,0,30,3
1650674635079,MATH 10A,A03,083737,Patchell; Gregory David,24,0,30,6
1650674641107,MATH 10B,A01,083207,Staff,0,9,30,30
1650674641107,MATH 10B,A02,083208,Staff,1,8,30,29
1650674641107,MATH 10B,B01,083739,Staff,11,0,30,19
1650674641107,MATH 10B,B02,083740,Staff,28,0,30,2
1650674647134,MATH 18,A01,083743,Staff,0,0,30,30
1650674647134,MATH 18,A02,083744,Staff,23,0,30,7
1650674647134,MATH 18,A03,083745,Staff,21,0,30,9
1650674647134,MATH 18,A04,083746,Staff,26,0,30,4
1650674647134,MATH 18,B01,083748,Staff,0,15,30,30
1650674647134,MATH 18,B02,083749,Staff,0,12,30,30
1650674647134,MATH 18,B03,083750,Staff,0,12,30,30
1650674647134,MATH 18,B04,083751,Staff,0,12,30,30
1650674653159,MATH 20A,A01,083754,Staff,19,0,40,21
1650674659189,MATH 20B,A01,083756,Staff,0,11,30,30
1650674659189,MATH 20B,A02,083757,Staff,0,12,30,30
1650674665215,MATH 20C,A01,083760,Staff,0,16,30,30
1650674665215,MATH 20C,A02,083761,Staff,1,15,30,29
1650674665215,MATH 20C,B01,083762,Staff,10,0,30,20
1650674665215,MATH 20C,B02,083763,Staff,28,0,30,2
1650674671238,MATH 20D,A01,083765,Staff,1,1,30,29
1650674671238,MATH 20D,A02,083766,Staff,6,0,30,24
1650674671238,MATH 20D,A03,083767,Staff,24,0,30,6
1650674677265,MATH 20E,A01,083771,Staff,3,0,30,27
1650674677265,MATH 20E,A02,083772,Staff,16,0,30,14
1650674677265,MATH 20E,B01,083773,Staff,0,0,30,30
1650674677265,MATH 20E,B02,083774,Staff,9,0,30,21
1650674683290,MATH 103A,A01,083777,Staff,0,15,30,30
1650674683290,MATH 103A,A02,083778,Staff,0,15,30,30
1650674683290,MATH 103A,B01,083779,Staff,0,14,30,30
1650674683290,MATH 103A,B02,083780,Staff,0,14,30,30
1650674689314,MATH 105,A01,085443,Staff,0,22,30,30
1650674695343,MATH 109,A01,083213,Anzaldo; Leesa B,0,7,30,30
1650674695343,MATH 109,A02,083214,Anzaldo; Leesa B,0,7,30,30
1650674695343,MATH 109,B01,083215,Anzaldo; Leesa B,0,8,30,30
1650674695343,MATH 109,B02,083216,Anzaldo; Leesa B,0,6,30,30
1650674701367,MATH 142A,A01,083219,Chow; Bennett,0,16,30,30
1650674701367,MATH 142A,A02,083220,Chow; Bennett,0,15,30,30
1650674701367,MATH 142A,B01,083221,Chow; Bennett,0,13,30,30
1650674701367,MATH 142A,B02,083222,Chow; Bennett,0,14,30,30
1650674707390,MATH 193A,A01,083224,Staff,0,5,30,30
1650674707390,MATH 193A,A02,083225,Staff,0,6,30,30
1650674707390,MATH 193A,A03,083781,Staff,0,6,30,30
1650674707390,MATH 193A,A04,083782,Staff,0,7,30,30
1650674713414,MATH 197,001,091859,McAuley; Julian John,9998,0,9999,1
1650674719471,COGS 9,A01,083615,Staff,1,16,60,59
1650674725495,COGS 11,A01,083617,Boyle; Mary E. T.,18,0,40,22
1650674731519,COGS 13,A01,083071,Staff,0,39,40,40
1650674737553,COGS 14A,A01,092681,Staff,0,32,100,100
1650674743579,COGS 14B,A01,083073,Cheng; Tzu-Han,1,14,50,49
1650674749604,COGS 17,A01,092677,Staff,15,0,75,60
1650674755627,COGS 100,A01,083619,Staff,0,28,60,60
1650674761654,COGS 101A,A01,083621,Davis; Joshua Daniel,0,27,60,60
1650674767680,COGS 101B,A01,091572,Staff,0,4,60,60
1650674773707,COGS 101C,A01,083625,Delgado; Tania,14,0,30,16
1650674779732,COGS 107A,A01,083627,Boyle; Mary E. T.,1,17,60,59
1650674785755,COGS 118A,A01,083075,Staff,0,7,60,60
1650674791781,CSE 3,A50,083646,Miranda; Gregory Joseph,19,0,38,19
1650674791781,CSE 3,A51,083647,Miranda; Gregory Joseph,36,0,37,1
1650674797815,CSE 8A,A50,083650,Miranda; Gregory Joseph,0,30,40,40
1650674803842,CSE 11,A01,083080,Cao; Yingjun,0,95,40,40
1650674809869,CSE 12,A01,083652,Staff,0,21,100,100
1650674815895,CSE 15L,A01,083654,Staff,0,3,50,50
1650674815895,CSE 15L,A02,083655,Staff,0,2,50,50
1650674821923,CSE 20,A01,083657,Staff,50,0,80,30
1650674827946,CSE 30,A01,083084,Eldon; John,0,78,40,40
1650674833974,CSE 100,A01,083659,Cao; Yingjun,0,70,50,50
1650674840005,CSE 134B,A01,083661,Powell; Thomas Allan,0,38,65,65
1650674846029,CSE 140,A01,083663,Staff,0,10,75,75
1650674852056,CSE 140L,A01,083088,Eldon; John,0,18,75,75
1650674858079,CSE 175,A01,083665,Kumar; Rakesh,7,0,25,18
1650674864108,CSE 190,A00,092507,Dubnov; Shlomo,10,0,20,10
1650674870134,ECE 45,A01,083139,Staff,0,2,60,60
1650674876162,ECE 65,A50,083695,Staff,0,5,30,30
1650674882186,ECE 109,A01,091882,Touri; Behrouz,33,0,70,37
1650674888212,ECE 180,A00,083140,Abi Samra; Nicholas Camill,20,0,30,10
1650674888212,ECE 180,B00,083141,Abi Samra; Nicholas Camill,0,0,30,30
1650674894237,MATH 10A,A01,083735,Patchell; Gregory David,3,0,30,27
1650674894237,MATH 10A,A02,083736,Patchell; Gregory David,27,0,30,3
1650674894237,MATH 10A,A03,083737,Patchell; Gregory David,24,0,30,6
1650674900261,MATH 10B,A01,083207,Staff,0,9,30,30
1650674900261,MATH 10B,A02,083208,Staff,1,8,30,29
1650674900261,MATH 10B,B01,083739,Staff,11,0,30,19
1650674900261,MATH 10B,B02,083740,Staff,28,0,30,2
1650674906287,MATH 18,A01,083743,Staff,0,0,30,30
1650674906287,MATH 18,A02,083744,Staff,23,0,30,7
1650674906287,MATH 18,A03,083745,Staff,21,0,30,9
1650674906287,MATH 18,A04,083746,Staff,26,0,30,4
1650674906287,MATH 18,B01,083748,Staff,0,15,30,30
1650674906287,MATH 18,B02,083749,Staff,0,12,30,30
1650674906287,MATH 18,B03,083750,Staff,0,12,30,30
1650674906287,MATH 18,B04,083751,Staff,0,12,30,30
1650674912316,MATH 20A,A01,083754,Staff,19,0,40,21
1650674918340,MATH 20B,A01,083756,Staff,0,11,30,30
1650674918340,MATH 20B,A02,083757,Staff,0,12,30,30
1650674924365,MATH 20C,A01,083760,Staff,0,16,30,30
1650674924365,MATH 20C,A02,083761,Staff,1,15,30,29
1650674924365,MATH 20C,B01,083762,Staff,10,0,30,20
1650674924365,MATH 20C,B02,083763,Staff,28,0,30,2
1650674930396,MATH 20D,A01,083765,Staff,1,1,30,29
1650674930396,MATH 20D,A02,083766,Staff,6,0,30,24
1650674930396,MATH 20D,A03,083767,Staff,24,0,30,6
1650674936422,MATH 20E,A01,083771,Staff,3,0,30,27
1650674936422,MATH 20E,A02,083772,Staff,16,0,30,14
1650674936422,MATH 20E,B01,083773,Staff,0,0,30,30
1650674936422,MATH 20E,B02,083774,Staff,9,0,30,21
1650674942454,MATH 103A,A01,083777,Staff,0,15,30,30
1650674942454,MATH 103A,A02,083778,Staff,0,15,30,30
1650674942454,MATH 103A,B01,083779,Staff,0,14,30,30
1650674942454,MATH 103A,B02,083780,Staff,0,14,30,30
1650674948481,MATH 105,A01,085443,Staff,0,22,30,30
1650674954521,MATH 109,A01,083213,Anzaldo; Leesa B,0,7,30,30
1650674954521,MATH 109,A02,083214,Anzaldo; Leesa B,0,7,30,30
1650674954521,MATH 109,B01,083215,Anzaldo; Leesa B,0,8,30,30
1650674954521,MATH 109,B02,083216,Anzaldo; Leesa B,0,6,30,30
1650674960545,MATH 142A,A01,083219,Chow; Bennett,0,16,30,30
1650674960545,MATH 142A,A02,083220,Chow; Bennett,0,15,30,30
1650674960545,MATH 142A,B01,083221,Chow; Bennett,0,13,30,30
1650674960545,MATH 142A,B02,083222,Chow; Bennett,0,14,30,30
1650674966579,MATH 193A,A01,083224,Staff,0,5,30,30
1650674966579,MATH 193A,A02,083225,Staff,0,6,30,30
1650674966579,MATH 193A,A03,083781,Staff,0,6,30,30
1650674966579,MATH 193A,A04,083782,Staff,0,7,30,30
1650674972603,MATH 197,001,091859,McAuley; Julian John,9998,0,9999,1
1650674978669,COGS 9,A01,083615,Staff,1,16,60,59
1650674984693,COGS 11,A01,083617,Boyle; Mary E. T.,18,0,40,22
1650674990721,COGS 13,A01,083071,Staff,0,39,40,40
1650674996745,COGS 14A,A01,092681,Staff,0,32,100,100
1650675002773,COGS 14B,A01,083073,Cheng; Tzu-Han,1,14,50,49
1650675008796,COGS 17,A01,092677,Staff,15,0,75,60
1650675014826,COGS 100,A01,083619,Staff,0,28,60,60
1650675020850,COGS 101A,A01,083621,Davis; Joshua Daniel,0,27,60,60
1650675026884,COGS 101B,A01,091572,Staff,0,4,60,60
1650675032906,COGS 101C,A01,083625,Delgado; Tania,14,0,30,16
1650675038935,COGS 107A,A01,083627,Boyle; Mary E. T.,1,17,60,59
1650675044960,COGS 118A,A01,083075,Staff,0,7,60,60
1650675050986,CSE 3,A50,083646,Miranda; Gregory Joseph,19,0,38,19
1650675050986,CSE 3,A51,083647,Miranda; Gregory Joseph,36,0,37,1
1650675057010,CSE 8A,A50,083650,Miranda; Gregory Joseph,0,30,40,40
1650675063037,CSE 11,A01,083080,Cao; Yingjun,0,95,40,40
1650675069060,CSE 12,A01,083652,Staff,0,21,100,100
1650675075086,CSE 15L,A01,083654,Staff,0,3,50,50
1650675075086,CSE 15L,A02,083655,Staff,0,2,50,50
1650675081113,CSE 20,A01,083657,Staff,50,0,80,30
1650675087136,CSE 30,A01,083084,Eldon; John,0,78,40,40
1650675093159,CSE 100,A01,083659,Cao; Yingjun,0,70,50,50
1650675099194,CSE 134B,A01,083661,Powell; Thomas Allan,0,38,65,65
1650675105220,CSE 140,A01,083663,Staff,0,10,75,75
1650675111247,CSE 140L,A01,083088,Eldon; John,0,18,75,75
1650675117282,CSE 175,A01,083665,Kumar; Rakesh,7,0,25,18
1650675123309,CSE 190,A00,092507,Dubnov; Shlomo,10,0,20,10
1650675129336,ECE 45,A01,083139,Staff,0,2,60,60
1650675135362,ECE 65,A50,083695,Staff,0,5,30,30
1650675141385,ECE 109,A01,091882,Touri; Behrouz,33,0,70,37
1650675147417,ECE 180,A00,083140,Abi Samra; Nicholas Camill,20,0,30,10
1650675147417,ECE 180,B00,083141,Abi Samra; Nicholas Camill,0,0,30,30
1650675153442,MATH 10A,A01,083735,Patchell; Gregory David,3,0,30,27
1650675153442,MATH 10A,A02,083736,Patchell; Gregory David,27,0,30,3
1650675153442,MATH 10A,A03,083737,Patchell; Gregory David,24,0,30,6
1650675159468,MATH 10B,A01,083207,Staff,0,9,30,30
1650675159468,MATH 10B,A02,083208,Staff,1,8,30,29
1650675159468,MATH 10B,B01,083739,Staff,11,0,30,19
1650675159468,MATH 10B,B02,083740,Staff,28,0,30,2
1650675165493,MATH 18,A01,083743,Staff,0,0,30,30
1650675165493,MATH 18,A02,083744,Staff,23,0,30,7
1650675165493,MATH 18,A03,083745,Staff,21,0,30,9
1650675165493,MATH 18,A04,083746,Staff,26,0,30,4
1650675165493,MATH 18,B01,083748,Staff,0,15,30,30
1650675165493,MATH 18,B02,083749,Staff,0,12,30,30
1650675165493,MATH 18,B03,083750,Staff,0,12,30,30
1650675165493,MATH 18,B04,083751,Staff,0,12,30,30
1650675171515,MATH 20A,A01,083754,Staff,19,0,40,21
1650675177547,MATH 20B,A01,083756,Staff,0,11,30,30
1650675177547,MATH 20B,A02,083757,Staff,0,12,30,30
1650675183586,MATH 20C,A01,083760,Staff,0,16,30,30
1650675183586,MATH 20C,A02,083761,Staff,1,15,30,29
1650675183586,MATH 20C,B01,083762,Staff,10,0,30,20
1650675183586,MATH 20C,B02,083763,Staff,28,0,30,2
1650675189611,MATH 20D,A01,083765,Staff,1,1,30,29
1650675189611,MATH 20D,A02,083766,Staff,6,0,30,24
1650675189611,MATH 20D,A03,083767,Staff,24,0,30,6
1650675195641,MATH 20E,A01,083771,Staff,3,0,30,27
1650675195641,MATH 20E,A02,083772,Staff,16,0,30,14
1650675195641,MATH 20E,B01,083773,Staff,0,0,30,30
1650675195641,MATH 20E,B02,083774,Staff,9,0,30,21
1650675201757,MATH 103A,A01,083777,Staff,0,15,30,30
1650675201757,MATH 103A,A02,083778,Staff,0,15,30,30
1650675201757,MATH 103A,B01,083779,Staff,0,14,30,30
1650675201757,MATH 103A,B02,083780,Staff,0,14,30,30
1650675207782,MATH 105,A01,085443,Staff,0,22,30,30
1650675213805,MATH 109,A01,083213,Anzaldo; Leesa B,0,7,30,30
1650675213805,MATH 109,A02,083214,Anzaldo; Leesa B,0,7,30,30
1650675213805,MATH 109,B01,083215,Anzaldo; Leesa B,0,8,30,30
1650675213805,MATH 109,B02,083216,Anzaldo; Leesa B,0,6,30,30
1650675219828,MATH 142A,A01,083219,Chow; Bennett,0,16,30,30
1650675219828,MATH 142A,A02,083220,Chow; Bennett,0,15,30,30
1650675219828,MATH 142A,B01,083221,Chow; Bennett,0,13,30,30
1650675219828,MATH 142A,B02,083222,Chow; Bennett,0,14,30,30
1650675225869,MATH 193A,A01,083224,Staff,0,5,30,30
1650675225869,MATH 193A,A02,083225,Staff,0,6,30,30
1650675225869,MATH 193A,A03,083781,Staff,0,6,30,30
1650675225869,MATH 193A,A04,083782,Staff,0,7,30,30
1650675231892,MATH 197,001,091859,McAuley; Julian John,9998,0,9999,1
1650675237961,COGS 9,A01,083615,Staff,1,16,60,59
1650675243989,COGS 11,A01,083617,Boyle; Mary E. T.,18,0,40,22
1650675250016,COGS 13,A01,083071,Staff,0,39,40,40
1650675256042,COGS 14A,A01,092681,Staff,0,32,100,100
1650675262065,COGS 14B,A01,083073,Cheng; Tzu-Han,1,14,50,49
1650675268089,COGS 17,A01,092677,Staff,15,0,75,60
1650675274116,COGS 100,A01,083619,Staff,0,29,60,60
1650675280140,COGS 101A,A01,083621,Davis; Joshua Daniel,0,27,60,60
1650675286164,COGS 101B,A01,091572,Staff,0,4,60,60
1650675292190,COGS 101C,A01,083625,Delgado; Tania,14,0,30,16
1650675298215,COGS 107A,A01,083627,Boyle; Mary E. T.,1,17,60,59
1650675304242,COGS 118A,A01,083075,Staff,0,7,60,60
1650675310271,CSE 3,A50,083646,Miranda; Gregory Joseph,19,0,38,19
1650675310271,CSE 3,A51,083647,Miranda; Gregory Joseph,36,0,37,1
1650675316297,CSE 8A,A50,083650,Miranda; Gregory Joseph,0,30,40,40
1650675322324,CSE 11,A01,083080,Cao; Yingjun,0,95,40,40
1650675328351,CSE 12,A01,083652,Staff,0,21,100,100
1650675334375,CSE 15L,A01,083654,Staff,0,3,50,50
1650675334375,CSE 15L,A02,083655,Staff,0,2,50,50
1650675340397,CSE 20,A01,083657,Staff,50,0,80,30
1650675346422,CSE 30,A01,083084,Eldon; John,0,78,40,40
1650675352449,CSE 100,A01,083659,Cao; Yingjun,0,70,50,50
1650675358473,CSE 134B,A01,083661,Powell; Thomas Allan,0,38,65,65
1650675364498,CSE 140,A01,083663,Staff,0,10,75,75
1650675370521,CSE 140L,A01,083088,Eldon; John,0,18,75,75
1650675376544,CSE 175,A01,083665,Kumar; Rakesh,7,0,25,18
1650675382571,CSE 190,A00,092507,Dubnov; Shlomo,10,0,20,10
1650675388594,ECE 45,A01,083139,Staff,0,2,60,60
1650675394620,ECE 65,A50,083695,Staff,0,5,30,30
1650675400643,ECE 109,A01,091882,Touri; Behrouz,33,0,70,37
1650675406666,ECE 180,A00,083140,Abi Samra; Nicholas Camill,20,0,30,10
1650675406666,ECE 180,B00,083141,Abi Samra; Nicholas Camill,0,0,30,30
1650675412694,MATH 10A,A01,083735,Patchell; Gregory David,3,0,30,27
1650675412694,MATH 10A,A02,083736,Patchell; Gregory David,27,0,30,3
1650675412694,MATH 10A,A03,083737,Patchell; Gregory David,24,0,30,6
1650675418736,MATH 10B,A01,083207,Staff,0,9,30,30
1650675418736,MATH 10B,A02,083208,Staff,1,8,30,29
1650675418736,MATH 10B,B01,083739,Staff,11,0,30,19
1650675418736,MATH 10B,B02,083740,Staff,28,0,30,2
1650675424760,MATH 18,A01,083743,Staff,0,0,30,30
1650675424760,MATH 18,A02,083744,Staff,23,0,30,7
1650675424760,MATH 18,A03,083745,Staff,21,0,30,9
1650675424760,MATH 18,A04,083746,Staff,26,0,30,4
1650675424760,MATH 18,B01,083748,Staff,0,15,30,30
1650675424760,MATH 18,B02,083749,Staff,0,12,30,30
1650675424760,MATH 18,B03,083750,Staff,0,12,30,30
1650675424760,MATH 18,B04,083751,Staff,0,12,30,30
1650675430785,MATH 20A,A01,083754,Staff,19,0,40,21
1650675436808,MATH 20B,A01,083756,Staff,0,11,30,30
1650675436808,MATH 20B,A02,083757,Staff,0,12,30,30
1650675442835,MATH 20C,A01,083760,Staff,0,16,30,30
1650675442835,MATH 20C,A02,083761,Staff,1,15,30,29
1650675442835,MATH 20C,B01,083762,Staff,10,0,30,20
1650675442835,MATH 20C,B02,083763,Staff,28,0,30,2
1650675448859,MATH 20D,A01,083765,Staff,1,1,30,29
1650675448859,MATH 20D,A02,083766,Staff,6,0,30,24
1650675448859,MATH 20D,A03,083767,Staff,24,0,30,6
1650675454882,MATH 20E,A01,083771,Staff,3,0,30,27
1650675454882,MATH 20E,A02,083772,Staff,16,0,30,14
1650675454882,MATH 20E,B01,083773,Staff,0,0,30,30
1650675454882,MATH 20E,B02,083774,Staff,9,0,30,21
1650675460906,MATH 103A,A01,083777,Staff,0,15,30,30
1650675460906,MATH 103A,A02,083778,Staff,0,15,30,30
1650675460906,MATH 103A,B01,083779,Staff,0,14,30,30
1650675460906,MATH 103A,B02,083780,Staff,0,14,30,30
1650675466932,MATH 105,A01,085443,Staff,0,22,30,30
1650675472960,MATH 109,A01,083213,Anzaldo; Leesa B,0,7,30,30
1650675472960,MATH 109,A02,083214,Anzaldo; Leesa B,0,7,30,30
1650675472960,MATH 109,B01,083215,Anzaldo; Leesa B,0,8,30,30
1650675472960,MATH 109,B02,083216,Anzaldo; Leesa B,0,6,30,30
1650675478983,MATH 142A,A01,083219,Chow; Bennett,0,16,30,30
1650675478983,MATH 142A,A02,083220,Chow; Bennett,0,15,30,30
1650675478983,MATH 142A,B01,083221,Chow; Bennett,0,13,30,30
1650675478983,MATH 142A,B02,083222,Chow; Bennett,0,14,30,30
1650675485007,MATH 193A,A01,083224,Staff,0,5,30,30
1650675485007,MATH 193A,A02,083225,Staff,0,6,30,30
1650675485007,MATH 193A,A03,083781,Staff,0,6,30,30
1650675485007,MATH 193A,A04,083782,Staff,0,7,30,30
1650675491031,MATH 197,001,091859,McAuley; Julian John,9998,0,9999,1
1650675497087,COGS 9,A01,083615,Staff,1,16,60,59
1650675503113,COGS 11,A01,083617,Boyle; Mary E. T.,18,0,40,22
1650675509135,COGS 13,A01,083071,Staff,0,39,40,40
1650675515159,COGS 14A,A01,092681,Staff,0,32,100,100
1650675521184,COGS 14B,A01,083073,Cheng; Tzu-Han,1,14,50,49
1650675527211,COGS 17,A01,092677,Staff,15,0,75,60
1650675533238,COGS 100,A01,083619,Staff,0,29,60,60
1650675539261,COGS 101A,A01,083621,Davis; Joshua Daniel,0,27,60,60
1650675545284,COGS 101B,A01,091572,Staff,0,4,60,60
1650675551313,COGS 101C,A01,083625,Delgado; Tania,14,0,30,16
1650675557336,COGS 107A,A01,083627,Boyle; Mary E. T.,1,17,60,59
1650675563367,COGS 118A,A01,083075,Staff,0,7,60,60
1650675569392,CSE 3,A50,083646,Miranda; Gregory Joseph,18,0,38,20
1650675569392,CSE 3,A51,083647,Miranda; Gregory Joseph,36,0,37,1
1650675575420,CSE 8A,A50,083650,Miranda; Gregory Joseph,0,30,40,40
1650675581445,CSE 11,A01,083080,Cao; Yingjun,0,95,40,40
1650675587468,CSE 12,A01,083652,Staff,0,21,100,100
1650675593494,CSE 15L,A01,083654,Staff,0,3,50,50
1650675593494,CSE 15L,A02,083655,Staff,0,2,50,50
1650675599526,CSE 20,A01,083657,Staff,50,0,80,30
1650675605560,CSE 30,A01,083084,Eldon; John,0,78,40,40
1650675611588,CSE 100,A01,083659,Cao; Yingjun,0,70,50,50
1650675617613,CSE 134B,A01,083661,Powell; Thomas Allan,0,38,65,65
1650675623643,CSE 140,A01,083663,Staff,0,10,75,75
1650675629666,CSE 140L,A01,083088,Eldon; John,0,18,75,75
1650675635698,CSE 175,A01,083665,Kumar; Rakesh,7,0,25,18
1650675641724,CSE 190,A00,092507,Dubnov; Shlomo,10,0,20,10
1650675647747,ECE 45,A01,083139,Staff,0,2,60,60
1650675653777,ECE 65,A50,083695,Staff,0,5,30,30
1650675659803,ECE 109,A01,091882,Touri; Behrouz,33,0,70,37
1650675665832,ECE 180,A00,083140,Abi Samra; Nicholas Camill,20,0,30,10
1650675665832,ECE 180,B00,083141,Abi Samra; Nicholas Camill,0,0,30,30
1650675671855,MATH 10A,A01,083735,Patchell; Gregory David,3,0,30,27
1650675671855,MATH 10A,A02,083736,Patchell; Gregory David,27,0,30,3
1650675671855,MATH 10A,A03,083737,Patchell; Gregory David,24,0,30,6
1650675677889,MATH 10B,A01,083207,Staff,0,9,30,30
1650675677889,MATH 10B,A02,083208,Staff,1,8,30,29
1650675677889,MATH 10B,B01,083739,Staff,11,0,30,19
1650675677889,MATH 10B,B02,083740,Staff,28,0,30,2
1650675683920,MATH 18,A01,083743,Staff,0,0,30,30
1650675683920,MATH 18,A02,083744,Staff,23,0,30,7
1650675683920,MATH 18,A03,083745,Staff,21,0,30,9
1650675683920,MATH 18,A04,083746,Staff,26,0,30,4
1650675683920,MATH 18,B01,083748,Staff,0,15,30,30
1650675683920,MATH 18,B02,083749,Staff,0,12,30,30
1650675683920,MATH 18,B03,083750,Staff,0,12,30,30
1650675683920,MATH 18,B04,083751,Staff,0,12,30,30
1650675689944,MATH 20A,A01,083754,Staff,19,0,40,21
1650675695970,MATH 20B,A01,083756,Staff,0,11,30,30
1650675695970,MATH 20B,A02,083757,Staff,0,12,30,30
1650675701998,MATH 20C,A01,083760,Staff,0,16,30,30
1650675701998,MATH 20C,A02,083761,Staff,1,15,30,29
1650675701998,MATH 20C,B01,083762,Staff,10,0,30,20
1650675701998,MATH 20C,B02,083763,Staff,28,0,30,2
1650675708022,MATH 20D,A01,083765,Staff,1,1,30,29
1650675708022,MATH 20D,A02,083766,Staff,6,0,30,24
1650675708022,MATH 20D,A03,083767,Staff,24,0,30,6
1650675714047,MATH 20E,A01,083771,Staff,3,0,30,27
1650675714047,MATH 20E,A02,083772,Staff,16,0,30,14
1650675714047,MATH 20E,B01,083773,Staff,0,0,30,30
1650675714047,MATH 20E,B02,083774,Staff,9,0,30,21
1650675720072,MATH 103A,A01,083777,Staff,0,15,30,30
1650675720072,MATH 103A,A02,083778,Staff,0,15,30,30
1650675720072,MATH 103A,B01,083779,Staff,0,14,30,30
1650675720072,MATH 103A,B02,083780,Staff,0,14,30,30
1650675726110,MATH 105,A01,085443,Staff,0,22,30,30
1650675732138,MATH 109,A01,083213,Anzaldo; Leesa B,0,7,30,30
1650675732138,MATH 109,A02,083214,Anzaldo; Leesa B,0,7,30,30
1650675732138,MATH 109,B01,083215,Anzaldo; Leesa B,0,8,30,30
1650675732138,MATH 109,B02,083216,Anzaldo; Leesa B,0,6,30,30
1650675738172,MATH 142A,A01,083219,Chow; Bennett,0,16,30,30
1650675738172,MATH 142A,A02,083220,Chow; Bennett,0,15,30,30
1650675738172,MATH 142A,B01,083221,Chow; Bennett,0,13,30,30
1650675738172,MATH 142A,B02,083222,Chow; Bennett,0,14,30,30
1650675744195,MATH 193A,A01,083224,Staff,0,5,30,30
1650675744195,MATH 193A,A02,083225,Staff,0,6,30,30
1650675744195,MATH 193A,A03,083781,Staff,0,6,30,30
1650675744195,MATH 193A,A04,083782,Staff,0,7,30,30
1650675750219,MATH 197,001,091859,McAuley; Julian John,9998,0,9999,1
1650675756281,COGS 9,A01,083615,Staff,1,16,60,59
1650675762324,COGS 11,A01,083617,Boyle; Mary E. T.,18,0,40,22
1650675768350,COGS 13,A01,083071,Staff,0,39,40,40
1650675774375,COGS 14A,A01,092681,Staff,0,32,100,100
1650675780407,COGS 14B,A01,083073,Cheng; Tzu-Han,1,14,50,49
1650675786434,COGS 17,A01,092677,Staff,15,0,75,60
1650675792548,COGS 100,A01,083619,Staff,0,29,60,60
1650675798578,COGS 101A,A01,083621,Davis; Joshua Daniel,0,27,60,60
1650675804606,COGS 101B,A01,091572,Staff,0,4,60,60
1650675810630,COGS 101C,A01,083625,Delgado; Tania,14,0,30,16
1650675816653,COGS 107A,A01,083627,Boyle; Mary E. T.,1,17,60,59
1650675822675,COGS 118A,A01,083075,Staff,0,7,60,60
1650675828703,CSE 3,A50,083646,Miranda; Gregory Joseph,18,0,38,20
1650675828703,CSE 3,A51,083647,Miranda; Gregory Joseph,36,0,37,1
1650675834738,CSE 8A,A50,083650,Miranda; Gregory Joseph,0,30,40,40
1650675840762,CSE 11,A01,083080,Cao; Yingjun,0,95,40,40
1650675846807,CSE 12,A01,083652,Staff,0,21,100,100
1650675852836,CSE 15L,A01,083654,Staff,0,3,50,50
1650675852836,CSE 15L,A02,083655,Staff,0,2,50,50
1650675858863,CSE 20,A01,083657,Staff,50,0,80,30
1650675864890,CSE 30,A01,083084,Eldon; John,0,78,40,40
1650675870919,CSE 100,A01,083659,Cao; Yingjun,0,70,50,50
1650675876942,CSE 134B,A01,083661,Powell; Thomas Allan,0,38,65,65
1650675882968,CSE 140,A01,083663,Staff,0,10,75,75
1650675888996,CSE 140L,A01,083088,Eldon; John,0,18,75,75
1650675895022,CSE 175,A01,083665,Kumar; Rakesh,7,0,25,18
1650675901051,CSE 190,A00,092507,Dubnov; Shlomo,10,0,20,10
1650675907089,ECE 45,A01,083139,Staff,0,2,60,60
1650675913126,ECE 65,A50,083695,Staff,0,5,30,30
1650675919163,ECE 109,A01,091882,Touri; Behrouz,33,0,70,37
1650675925195,ECE 180,A00,083140,Abi Samra; Nicholas Camill,20,0,30,10
1650675925195,ECE 180,B00,083141,Abi Samra; Nicholas Camill,0,0,30,30
1650675931225,MATH 10A,A01,083735,Patchell; Gregory David,3,0,30,27
1650675931225,MATH 10A,A02,083736,Patchell; Gregory David,27,0,30,3
1650675931225,MATH 10A,A03,083737,Patchell; Gregory David,24,0,30,6
1650675937249,MATH 10B,A01,083207,Staff,0,9,30,30
1650675937249,MATH 10B,A02,083208,Staff,1,8,30,29
1650675937249,MATH 10B,B01,083739,Staff,11,0,30,19
1650675937249,MATH 10B,B02,083740,Staff,28,0,30,2
1650675943291,MATH 18,A01,083743,Staff,0,0,30,30
1650675943291,MATH 18,A02,083744,Staff,23,0,30,7
1650675943291,MATH 18,A03,083745,Staff,21,0,30,9
1650675943291,MATH 18,A04,083746,Staff,26,0,30,4
1650675943291,MATH 18,B01,083748,Staff,0,15,30,30
1650675943291,MATH 18,B02,083749,Staff,0,12,30,30
1650675943291,MATH 18,B03,083750,Staff,0,12,30,30
1650675943291,MATH 18,B04,083751,Staff,0,12,30,30
1650675949313,MATH 20A,A01,083754,Staff,19,0,40,21
1650675955340,MATH 20B,A01,083756,Staff,0,11,30,30
1650675955340,MATH 20B,A02,083757,Staff,0,12,30,30
1650675961382,MATH 20C,A01,083760,Staff,0,16,30,30
1650675961382,MATH 20C,A02,083761,Staff,1,15,30,29
1650675961382,MATH 20C,B01,083762,Staff,10,0,30,20
1650675961382,MATH 20C,B02,083763,Staff,28,0,30,2
1650675967406,MATH 20D,A01,083765,Staff,1,1,30,29
1650675967406,MATH 20D,A02,083766,Staff,6,0,30,24
1650675967406,MATH 20D,A03,083767,Staff,24,0,30,6
1650675973431,MATH 20E,A01,083771,Staff,3,0,30,27
1650675973431,MATH 20E,A02,083772,Staff,16,0,30,14
1650675973431,MATH 20E,B01,083773,Staff,0,0,30,30
1650675973431,MATH 20E,B02,083774,Staff,9,0,30,21
1650675979466,MATH 103A,A01,083777,Staff,0,15,30,30
1650675979466,MATH 103A,A02,083778,Staff,0,15,30,30
1650675979466,MATH 103A,B01,083779,Staff,0,14,30,30
1650675979466,MATH 103A,B02,083780,Staff,0,14,30,30
1650675985495,MATH 105,A01,085443,Staff,0,22,30,30
1650675991531,MATH 109,A01,083213,Anzaldo; Leesa B,0,7,30,30
1650675991531,MATH 109,A02,083214,Anzaldo; Leesa B,0,7,30,30
1650675991531,MATH 109,B01,083215,Anzaldo; Leesa B,0,8,30,30
1650675991531,MATH 109,B02,083216,Anzaldo; Leesa B,0,6,30,30
1650675997555,MATH 142A,A01,083219,Chow; Bennett,0,16,30,30
1650675997555,MATH 142A,A02,083220,Chow; Bennett,0,15,30,30
1650675997555,MATH 142A,B01,083221,Chow; Bennett,0,13,30,30
1650675997555,MATH 142A,B02,083222,Chow; Bennett,0,14,30,30
1650676003579,MATH 193A,A01,083224,Staff,0,5,30,30
1650676003579,MATH 193A,A02,083225,Staff,0,6,30,30
1650676003579,MATH 193A,A03,083781,Staff,0,6,30,30
1650676003579,MATH 193A,A04,083782,Staff,0,7,30,30
1650676009607,MATH 197,001,091859,McAuley; Julian John,9998,0,9999,1
1650676015671,COGS 9,A01,083615,Staff,1,16,60,59
1650676021702,COGS 11,A01,083617,Boyle; Mary E. T.,18,0,40,22
1650676027732,COGS 13,A01,083071,Staff,0,39,40,40
1650676033759,COGS 14A,A01,092681,Staff,0,32,100,100
1650676039786,COGS 14B,A01,083073,Cheng; Tzu-Han,1,14,50,49
1650676045813,COGS 17,A01,092677,Staff,15,0,75,60
1650676051847,COGS 100,A01,083619,Staff,0,29,60,60
1650676057874,COGS 101A,A01,083621,Davis; Joshua Daniel,0,27,60,60
1650676063900,COGS 101B,A01,091572,Staff,0,4,60,60
1650676069924,COGS 101C,A01,083625,Delgado; Tania,14,0,30,16
1650676075951,COGS 107A,A01,083627,Boyle; Mary E. T.,1,17,60,59
1650676081975,COGS 118A,A01,083075,Staff,0,7,60,60
1650676088014,CSE 3,A50,083646,Miranda; Gregory Joseph,18,0,38,20
1650676088014,CSE 3,A51,083647,Miranda; Gregory Joseph,36,0,37,1
1650676094037,CSE 8A,A50,083650,Miranda; Gregory Joseph,0,30,40,40
1650676100061,CSE 11,A01,083080,Cao; Yingjun,0,95,40,40
1650676106097,CSE 12,A01,083652,Staff,0,21,100,100
1650676112125,CSE 15L,A01,083654,Staff,0,3,50,50
1650676112125,CSE 15L,A02,083655,Staff,0,2,50,50
1650676118149,CSE 20,A01,083657,Staff,50,0,80,30
1650676124176,CSE 30,A01,083084,Eldon; John,0,78,40,40
1650676130226,CSE 100,A01,083659,Cao; Yingjun,0,70,50,50
1650676136249,CSE 134B,A01,083661,Powell; Thomas Allan,0,38,65,65
1650676142277,CSE 140,A01,083663,Staff,0,10,75,75
1650676148300,CSE 140L,A01,083088,Eldon; John,0,18,75,75
1650676154326,CSE 175,A01,083665,Kumar; Rakesh,7,0,25,18
1650676160368,CSE 190,A00,092507,Dubnov; Shlomo,10,0,20,10
1650676166406,ECE 45,A01,083139,Staff,0,2,60,60
1650676172434,ECE 65,A50,083695,Staff,0,5,30,30
1650676178459,ECE 109,A01,091882,Touri; Behrouz,33,0,70,37
1650676184486,ECE 180,A00,083140,Abi Samra; Nicholas Camill,20,0,30,10
1650676184486,ECE 180,B00,083141,Abi Samra; Nicholas Camill,0,0,30,30
1650676190511,MATH 10A,A01,083735,Patchell; Gregory David,3,0,30,27
1650676190511,MATH 10A,A02,083736,Patchell; Gregory David,27,0,30,3
1650676190511,MATH 10A,A03,083737,Patchell; Gregory David,24,0,30,6
1650676196534,MATH 10B,A01,083207,Staff,0,9,30,30
1650676196534,MATH 10B,A02,083208,Staff,1,8,30,29
1650676196534,MATH 10B,B01,083739,Staff,11,0,30,19
1650676196534,MATH 10B,B02,083740,Staff,28,0,30,2
1650676202560,MATH 18,A01,083743,Staff,0,0,30,30
1650676202560,MATH 18,A02,083744,Staff,23,0,30,7
1650676202560,MATH 18,A03,083745,Staff,21,0,30,9
1650676202560,MATH 18,A04,083746,Staff,26,0,30,4
1650676202560,MATH 18,B01,083748,Staff,0,15,30,30
1650676202560,MATH 18,B02,083749,Staff,0,12,30,30
1650676202560,MATH 18,B03,083750,Staff,0,12,30,30
1650676202560,MATH 18,B04,083751,Staff,0,12,30,30
1650676208582,MATH 20A,A01,083754,Staff,19,0,40,21
1650676214606,MATH 20B,A01,083756,Staff,0,11,30,30
1650676214606,MATH 20B,A02,083757,Staff,0,12,30,30
1650676220631,MATH 20C,A01,083760,Staff,0,16,30,30
1650676220631,MATH 20C,A02,083761,Staff,1,15,30,29
1650676220631,MATH 20C,B01,083762,Staff,10,0,30,20
1650676220631,MATH 20C,B02,083763,Staff,28,0,30,2
1650676226656,MATH 20D,A01,083765,Staff,1,1,30,29
1650676226656,MATH 20D,A02,083766,Staff,6,0,30,24
1650676226656,MATH 20D,A03,083767,Staff,24,0,30,6
1650676232685,MATH 20E,A01,083771,Staff,3,0,30,27
1650676232685,MATH 20E,A02,083772,Staff,16,0,30,14
1650676232685,MATH 20E,B01,083773,Staff,0,0,30,30
1650676232685,MATH 20E,B02,083774,Staff,9,0,30,21
1650676238715,MATH 103A,A01,083777,Staff,0,15,30,30
1650676238715,MATH 103A,A02,083778,Staff,0,15,30,30
1650676238715,MATH 103A,B01,083779,Staff,0,14,30,30
1650676238715,MATH 103A,B02,083780,Staff,0,14,30,30
1650676244744,MATH 105,A01,085443,Staff,0,22,30,30
1650676250769,MATH 109,A01,083213,Anzaldo; Leesa B,0,7,30,30
1650676250769,MATH 109,A02,083214,Anzaldo; Leesa B,0,7,30,30
1650676250769,MATH 109,B01,083215,Anzaldo; Leesa B,0,8,30,30
1650676250769,MATH 109,B02,083216,Anzaldo; Leesa B,0,6,30,30
1650676256796,MATH 142A,A01,083219,Chow; Bennett,0,16,30,30
1650676256796,MATH 142A,A02,083220,Chow; Bennett,0,15,30,30
1650676256796,MATH 142A,B01,083221,Chow; Bennett,0,13,30,30
1650676256796,MATH 142A,B02,083222,Chow; Bennett,0,14,30,30
1650676262833,MATH 193A,A01,083224,Staff,0,5,30,30
1650676262833,MATH 193A,A02,083225,Staff,0,6,30,30
1650676262833,MATH 193A,A03,083781,Staff,0,6,30,30
1650676262833,MATH 193A,A04,083782,Staff,0,7,30,30
1650676268858,MATH 197,001,091859,McAuley; Julian John,9998,0,9999,1
1650676274921,COGS 9,A01,083615,Staff,1,16,60,59
1650676280945,COGS 11,A01,083617,Boyle; Mary E. T.,18,0,40,22
1650676286973,COGS 13,A01,083071,Staff,0,39,40,40
1650676292997,COGS 14A,A01,092681,Staff,0,32,100,100
1650676299021,COGS 14B,A01,083073,Cheng; Tzu-Han,1,14,50,49
1650676305044,COGS 17,A01,092677,Staff,15,0,75,60
1650676311075,COGS 100,A01,083619,Staff,0,29,60,60
1650676317104,COGS 101A,A01,083621,Davis; Joshua Daniel,0,27,60,60
1650676323129,COGS 101B,A01,091572,Staff,0,4,60,60
1650676329161,COGS 101C,A01,083625,Delgado; Tania,14,0,30,16
1650676335188,COGS 107A,A01,083627,Boyle; Mary E. T.,1,17,60,59
1650676341220,COGS 118A,A01,083075,Staff,0,7,60,60
1650676347245,CSE 3,A50,083646,Miranda; Gregory Joseph,18,0,38,20
1650676347245,CSE 3,A51,083647,Miranda; Gregory Joseph,36,0,37,1
1650676353271,CSE 8A,A50,083650,Miranda; Gregory Joseph,0,30,40,40
1650676359299,CSE 11,A01,083080,Cao; Yingjun,0,95,40,40
1650676365325,CSE 12,A01,083652,Staff,0,21,100,100
1650676371347,CSE 15L,A01,083654,Staff,0,3,50,50
1650676371347,CSE 15L,A02,083655,Staff,0,2,50,50
1650676377373,CSE 20,A01,083657,Staff,50,0,80,30
1650676383402,CSE 30,A01,083084,Eldon; John,0,78,40,40
1650676389512,CSE 100,A01,083659,Cao; Yingjun,0,70,50,50
1650676395537,CSE 134B,A01,083661,Powell; Thomas Allan,0,38,65,65
1650676401560,CSE 140,A01,083663,Staff,0,10,75,75
1650676407585,CSE 140L,A01,083088,Eldon; John,0,18,75,75
1650676413612,CSE 175,A01,083665,Kumar; Rakesh,7,0,25,18
1650676419635,CSE 190,A00,092507,Dubnov; Shlomo,10,0,20,10
1650676425661,ECE 45,A01,083139,Staff,0,2,60,60
1650676431688,ECE 65,A50,083695,Staff,0,5,30,30
1650676437715,ECE 109,A01,091882,Touri; Behrouz,33,0,70,37
1650676443738,ECE 180,A00,083140,Abi Samra; Nicholas Camill,20,0,30,10
1650676443738,ECE 180,B00,083141,Abi Samra; Nicholas Camill,0,0,30,30
1650676449761,MATH 10A,A01,083735,Patchell; Gregory David,3,0,30,27
1650676449761,MATH 10A,A02,083736,Patchell; Gregory David,27,0,30,3
1650676449761,MATH 10A,A03,083737,Patchell; Gregory David,24,0,30,6
1650676455788,MATH 10B,A01,083207,Staff,0,9,30,30
1650676455788,MATH 10B,A02,083208,Staff,1,8,30,29
1650676455788,MATH 10B,B01,083739,Staff,11,0,30,19
1650676455788,MATH 10B,B02,083740,Staff,28,0,30,2
1650676461813,MATH 18,A01,083743,Staff,0,0,30,30
1650676461813,MATH 18,A02,083744,Staff,23,0,30,7
1650676461813,MATH 18,A03,083745,Staff,21,0,30,9
1650676461813,MATH 18,A04,083746,Staff,26,0,30,4
1650676461813,MATH 18,B01,083748,Staff,0,15,30,30
1650676461813,MATH 18,B02,083749,Staff,0,12,30,30
1650676461813,MATH 18,B03,083750,Staff,0,12,30,30
1650676461813,MATH 18,B04,083751,Staff,0,12,30,30
1650676467836,MATH 20A,A01,083754,Staff,19,0,40,21
1650676473858,MATH 20B,A01,083756,Staff,0,11,30,30
1650676473858,MATH 20B,A02,083757,Staff,0,12,30,30
1650676479881,MATH 20C,A01,083760,Staff,0,16,30,30
1650676479881,MATH 20C,A02,083761,Staff,1,16,30,29
1650676479881,MATH 20C,B01,083762,Staff,10,0,30,20
1650676479881,MATH 20C,B02,083763,Staff,28,0,30,2
1650676485908,MATH 20D,A01,083765,Staff,1,1,30,29
1650676485908,MATH 20D,A02,083766,Staff,6,0,30,24
1650676485908,MATH 20D,A03,083767,Staff,24,0,30,6
1650676491940,MATH 20E,A01,083771,Staff,3,0,30,27
1650676491940,MATH 20E,A02,083772,Staff,16,0,30,14
1650676491940,MATH 20E,B01,083773,Staff,0,0,30,30
1650676491940,MATH 20E,B02,083774,Staff,9,0,30,21
1650676497964,MATH 103A,A01,083777,Staff,0,15,30,30
1650676497964,MATH 103A,A02,083778,Staff,0,15,30,30
1650676497964,MATH 103A,B01,083779,Staff,0,14,30,30
1650676497964,MATH 103A,B02,083780,Staff,0,14,30,30
1650676503990,MATH 105,A01,085443,Staff,0,22,30,30
1650676510013,MATH 109,A01,083213,Anzaldo; Leesa B,0,7,30,30
1650676510013,MATH 109,A02,083214,Anzaldo; Leesa B,0,7,30,30
1650676510013,MATH 109,B01,083215,Anzaldo; Leesa B,0,8,30,30
1650676510013,MATH 109,B02,083216,Anzaldo; Leesa B,0,6,30,30
1650676516042,MATH 142A,A01,083219,Chow; Bennett,0,16,30,30
1650676516042,MATH 142A,A02,083220,Chow; Bennett,0,15,30,30
1650676516042,MATH 142A,B01,083221,Chow; Bennett,0,13,30,30
1650676516042,MATH 142A,B02,083222,Chow; Bennett,0,14,30,30
1650676522070,MATH 193A,A01,083224,Staff,0,5,30,30
1650676522070,MATH 193A,A02,083225,Staff,0,6,30,30
1650676522070,MATH 193A,A03,083781,Staff,0,6,30,30
1650676522070,MATH 193A,A04,083782,Staff,0,7,30,30
1650676528107,MATH 197,001,091859,McAuley; Julian John,9998,0,9999,1
1650676534167,COGS 9,A01,083615,Staff,1,16,60,59
1650676540190,COGS 11,A01,083617,Boyle; Mary E. T.,18,0,40,22
1650676546214,COGS 13,A01,083071,Staff,0,39,40,40
1650676552244,COGS 14A,A01,092681,Staff,0,32,100,100
1650676558268,COGS 14B,A01,083073,Cheng; Tzu-Han,1,14,50,49
1650676564304,COGS 17,A01,092677,Staff,15,0,75,60
1650676570330,COGS 100,A01,083619,Staff,0,29,60,60
1650676576357,COGS 101A,A01,083621,Davis; Joshua Daniel,0,27,60,60
1650676582383,COGS 101B,A01,091572,Staff,0,4,60,60
1650676588410,COGS 101C,A01,083625,Delgado; Tania,14,0,30,16
1650676594436,COGS 107A,A01,083627,Boyle; Mary E. T.,1,17,60,59
1650676600465,COGS 118A,A01,083075,Staff,0,7,60,60
1650676606491,CSE 3,A50,083646,Miranda; Gregory Joseph,18,0,38,20
1650676606491,CSE 3,A51,083647,Miranda; Gregory Joseph,36,0,37,1
1650676612516,CSE 8A,A50,083650,Miranda; Gregory Joseph,0,30,40,40
1650676618540,CSE 11,A01,083080,Cao; Yingjun,0,95,40,40
1650676624562,CSE 12,A01,083652,Staff,0,21,100,100
1650676630587,CSE 15L,A01,083654,Staff,0,3,50,50
1650676630587,CSE 15L,A02,083655,Staff,0,2,50,50
1650676636613,CSE 20,A01,083657,Staff,50,0,80,30
1650676642637,CSE 30,A01,083084,Eldon; John,0,78,40,40
1650676648660,CSE 100,A01,083659,Cao; Yingjun,0,70,50,50
1650676654684,CSE 134B,A01,083661,Powell; Thomas Allan,0,38,65,65
1650676660711,CSE 140,A01,083663,Staff,0,10,75,75
1650676666737,CSE 140L,A01,083088,Eldon; John,0,18,75,75
1650676672771,CSE 175,A01,083665,Kumar; Rakesh,7,0,25,18
1650676678796,CSE 190,A00,092507,Dubnov; Shlomo,10,0,20,10
1650676684823,ECE 45,A01,083139,Staff,0,2,60,60
1650676690847,ECE 65,A50,083695,Staff,0,5,30,30
1650676696872,ECE 109,A01,091882,Touri; Behrouz,33,0,70,37
1650676702900,ECE 180,A00,083140,Abi Samra; Nicholas Camill,20,0,30,10
1650676702900,ECE 180,B00,083141,Abi Samra; Nicholas Camill,0,0,30,30
1650676708924,MATH 10A,A01,083735,Patchell; Gregory David,3,0,30,27
1650676708924,MATH 10A,A02,083736,Patchell; Gregory David,27,0,30,3
1650676708924,MATH 10A,A03,083737,Patchell; Gregory David,24,0,30,6
1650676714947,MATH 10B,A01,083207,Staff,0,9,30,30
1650676714947,MATH 10B,A02,083208,Staff,1,8,30,29
1650676714947,MATH 10B,B01,083739,Staff,11,0,30,19
1650676714947,MATH 10B,B02,083740,Staff,28,0,30,2
1650676720978,MATH 18,A01,083743,Staff,0,0,30,30
1650676720978,MATH 18,A02,083744,Staff,23,0,30,7
1650676720978,MATH 18,A03,083745,Staff,21,0,30,9
1650676720978,MATH 18,A04,083746,Staff,26,0,30,4
1650676720978,MATH 18,B01,083748,Staff,0,15,30,30
1650676720978,MATH 18,B02,083749,Staff,0,12,30,30
1650676720978,MATH 18,B03,083750,Staff,0,12,30,30
1650676720978,MATH 18,B04,083751,Staff,0,12,30,30
1650676727001,MATH 20A,A01,083754,Staff,19,0,40,21
1650676733027,MATH 20B,A01,083756,Staff,0,11,30,30
1650676733027,MATH 20B,A02,083757,Staff,0,12,30,30
1650676739051,MATH 20C,A01,083760,Staff,0,16,30,30
1650676739051,MATH 20C,A02,083761,Staff,1,16,30,29
1650676739051,MATH 20C,B01,083762,Staff,10,0,30,20
1650676739051,MATH 20C,B02,083763,Staff,28,0,30,2
1650676745075,MATH 20D,A01,083765,Staff,1,1,30,29
1650676745075,MATH 20D,A02,083766,Staff,6,0,30,24
1650676745075,MATH 20D,A03,083767,Staff,24,0,30,6
1650676751102,MATH 20E,A01,083771,Staff,3,0,30,27
1650676751102,MATH 20E,A02,083772,Staff,16,0,30,14
1650676751102,MATH 20E,B01,083773,Staff,0,0,30,30
1650676751102,MATH 20E,B02,083774,Staff,9,0,30,21
1650676757128,MATH 103A,A01,083777,Staff,0,15,30,30
1650676757128,MATH 103A,A02,083778,Staff,0,15,30,30
1650676757128,MATH 103A,B01,083779,Staff,0,14,30,30
1650676757128,MATH 103A,B02,083780,Staff,0,14,30,30
1650676763151,MATH 105,A01,085443,Staff,0,22,30,30
1650676769175,MATH 109,A01,083213,Anzaldo; Leesa B,0,7,30,30
1650676769175,MATH 109,A02,083214,Anzaldo; Leesa B,0,7,30,30
1650676769175,MATH 109,B01,083215,Anzaldo; Leesa B,0,8,30,30
1650676769175,MATH 109,B02,083216,Anzaldo; Leesa B,0,6,30,30
1650676775203,MATH 142A,A01,083219,Chow; Bennett,0,16,30,30
1650676775203,MATH 142A,A02,083220,Chow; Bennett,0,15,30,30
1650676775203,MATH 142A,B01,083221,Chow; Bennett,0,13,30,30
1650676775203,MATH 142A,B02,083222,Chow; Bennett,0,14,30,30
1650676781230,MATH 193A,A01,083224,Staff,0,5,30,30
1650676781230,MATH 193A,A02,083225,Staff,0,6,30,30
1650676781230,MATH 193A,A03,083781,Staff,0,6,30,30
1650676781230,MATH 193A,A04,083782,Staff,0,7,30,30
1650676787252,MATH 197,001,091859,McAuley; Julian John,9998,0,9999,1
1650676793312,COGS 9,A01,083615,Staff,1,16,60,59
1650676799335,COGS 11,A01,083617,Boyle; Mary E. T.,18,0,40,22
1650676805362,COGS 13,A01,083071,Staff,0,39,40,40
1650676811389,COGS 14A,A01,092681,Staff,0,32,100,100
1650676817412,COGS 14B,A01,083073,Cheng; Tzu-Han,1,14,50,49
1650676823447,COGS 17,A01,092677,Staff,15,0,75,60
1650676829474,COGS 100,A01,083619,Staff,0,29,60,60
1650676835498,COGS 101A,A01,083621,Davis; Joshua Daniel,0,27,60,60
1650676841531,COGS 101B,A01,091572,Staff,0,4,60,60
1650676847558,COGS 101C,A01,083625,Delgado; Tania,14,0,30,16
1650676853585,COGS 107A,A01,083627,Boyle; Mary E. T.,1,17,60,59
1650676859612,COGS 118A,A01,083075,Staff,0,7,60,60
1650676865640,CSE 3,A50,083646,Miranda; Gregory Joseph,18,0,38,20
1650676865640,CSE 3,A51,083647,Miranda; Gregory Joseph,36,0,37,1
1650676871671,CSE 8A,A50,083650,Miranda; Gregory Joseph,0,30,40,40
1650676877695,CSE 11,A01,083080,Cao; Yingjun,0,95,40,40
1650676883719,CSE 12,A01,083652,Staff,0,21,100,100
1650676889743,CSE 15L,A01,083654,Staff,0,3,50,50
1650676889743,CSE 15L,A02,083655,Staff,0,2,50,50
1650676895767,CSE 20,A01,083657,Staff,50,0,80,30
1650676901799,CSE 30,A01,083084,Eldon; John,0,78,40,40
1650676907823,CSE 100,A01,083659,Cao; Yingjun,0,70,50,50
1650676913850,CSE 134B,A01,083661,Powell; Thomas Allan,0,38,65,65
1650676919885,CSE 140,A01,083663,Staff,0,10,75,75
1650676925908,CSE 140L,A01,083088,Eldon; John,0,18,75,75
1650676931935,CSE 175,A01,083665,Kumar; Rakesh,7,0,25,18
1650676937961,CSE 190,A00,092507,Dubnov; Shlomo,10,0,20,10
1650676943987,ECE 45,A01,083139,Staff,0,2,60,60
1650676950027,ECE 65,A50,083695,Staff,0,5,30,30
1650676956055,ECE 109,A01,091882,Touri; Behrouz,33,0,70,37
1650676962080,ECE 180,A00,083140,Abi Samra; Nicholas Camill,20,0,30,10
1650676962080,ECE 180,B00,083141,Abi Samra; Nicholas Camill,0,0,30,30
1650676968106,MATH 10A,A01,083735,Patchell; Gregory David,3,0,30,27
1650676968106,MATH 10A,A02,083736,Patchell; Gregory David,27,0,30,3
1650676968106,MATH 10A,A03,083737,Patchell; Gregory David,24,0,30,6
1650676974131,MATH 10B,A01,083207,Staff,0,9,30,30
1650676974131,MATH 10B,A02,083208,Staff,1,8,30,29
1650676974131,MATH 10B,B01,083739,Staff,11,0,30,19
1650676974131,MATH 10B,B02,083740,Staff,28,0,30,2
1650676980158,MATH 18,A01,083743,Staff,0,0,30,30
1650676980158,MATH 18,A02,083744,Staff,23,0,30,7
1650676980158,MATH 18,A03,083745,Staff,21,0,30,9
1650676980158,MATH 18,A04,083746,Staff,26,0,30,4
1650676980158,MATH 18,B01,083748,Staff,0,15,30,30
1650676980158,MATH 18,B02,083749,Staff,0,12,30,30
1650676980158,MATH 18,B03,083750,Staff,0,12,30,30
1650676980158,MATH 18,B04,083751,Staff,0,12,30,30
1650676986276,MATH 20A,A01,083754,Staff,19,0,40,21
1650676992300,MATH 20B,A01,083756,Staff,0,11,30,30
1650676992300,MATH 20B,A02,083757,Staff,0,12,30,30
1650676998328,MATH 20C,A01,083760,Staff,0,16,30,30
1650676998328,MATH 20C,A02,083761,Staff,1,16,30,29
1650676998328,MATH 20C,B01,083762,Staff,10,0,30,20
1650676998328,MATH 20C,B02,083763,Staff,28,0,30,2
1650677004353,MATH 20D,A01,083765,Staff,1,1,30,29
1650677004353,MATH 20D,A02,083766,Staff,6,0,30,24
1650677004353,MATH 20D,A03,083767,Staff,24,0,30,6
1650677010380,MATH 20E,A01,083771,Staff,3,0,30,27
1650677010380,MATH 20E,A02,083772,Staff,16,0,30,14
1650677010380,MATH 20E,B01,083773,Staff,0,0,30,30
1650677010380,MATH 20E,B02,083774,Staff,9,0,30,21
1650677016406,MATH 103A,A01,083777,Staff,0,15,30,30
1650677016406,MATH 103A,A02,083778,Staff,0,15,30,30
1650677016406,MATH 103A,B01,083779,Staff,0,14,30,30
1650677016406,MATH 103A,B02,083780,Staff,0,14,30,30
1650677022431,MATH 105,A01,085443,Staff,0,22,30,30
1650677028453,MATH 109,A01,083213,Anzaldo; Leesa B,0,7,30,30
1650677028453,MATH 109,A02,083214,Anzaldo; Leesa B,0,7,30,30
1650677028453,MATH 109,B01,083215,Anzaldo; Leesa B,0,8,30,30
1650677028453,MATH 109,B02,083216,Anzaldo; Leesa B,0,6,30,30
1650677034480,MATH 142A,A01,083219,Chow; Bennett,0,16,30,30
1650677034480,MATH 142A,A02,083220,Chow; Bennett,0,15,30,30
1650677034480,MATH 142A,B01,083221,Chow; Bennett,0,13,30,30
1650677034480,MATH 142A,B02,083222,Chow; Bennett,0,14,30,30
1650677040502,MATH 193A,A01,083224,Staff,0,5,30,30
1650677040502,MATH 193A,A02,083225,Staff,0,6,30,30
1650677040502,MATH 193A,A03,083781,Staff,0,6,30,30
1650677040502,MATH 193A,A04,083782,Staff,0,7,30,30
1650677046535,MATH 197,001,091859,McAuley; Julian John,9998,0,9999,1
1650677052585,COGS 9,A01,083615,Staff,1,16,60,59
1650677058608,COGS 11,A01,083617,Boyle; Mary E. T.,18,0,40,22
1650677064633,COGS 13,A01,083071,Staff,0,39,40,40
1650677070655,COGS 14A,A01,092681,Staff,0,32,100,100
1650677076681,COGS 14B,A01,083073,Cheng; Tzu-Han,1,14,50,49
1650677082703,COGS 17,A01,092677,Staff,15,0,75,60
1650677088734,COGS 100,A01,083619,Staff,0,29,60,60
1650677094761,COGS 101A,A01,083621,Davis; Joshua Daniel,0,27,60,60
1650677100798,COGS 101B,A01,091572,Staff,0,4,60,60
1650677106837,COGS 101C,A01,083625,Delgado; Tania,14,0,30,16
1650677112860,COGS 107A,A01,083627,Boyle; Mary E. T.,1,17,60,59
1650677118883,COGS 118A,A01,083075,Staff,0,7,60,60
1650677124914,CSE 3,A50,083646,Miranda; Gregory Joseph,18,0,38,20
1650677124914,CSE 3,A51,083647,Miranda; Gregory Joseph,36,0,37,1
1650677130939,CSE 8A,A50,083650,Miranda; Gregory Joseph,0,30,40,40
1650677136963,CSE 11,A01,083080,Cao; Yingjun,0,95,40,40
1650677142990,CSE 12,A01,083652,Staff,0,21,100,100
1650677149013,CSE 15L,A01,083654,Staff,0,3,50,50
1650677149013,CSE 15L,A02,083655,Staff,0,2,50,50
1650677155037,CSE 20,A01,083657,Staff,50,0,80,30
1650677161064,CSE 30,A01,083084,Eldon; John,0,78,40,40
1650677167088,CSE 100,A01,083659,Cao; Yingjun,0,70,50,50
1650677173111,CSE 134B,A01,083661,Powell; Thomas Allan,0,38,65,65
1650677179134,CSE 140,A01,083663,Staff,0,10,75,75
1650677185160,CSE 140L,A01,083088,Eldon; John,0,18,75,75
1650677191187,CSE 175,A01,083665,Kumar; Rakesh,7,0,25,18
1650677197216,CSE 190,A00,092507,Dubnov; Shlomo,10,0,20,10
1650677203240,ECE 45,A01,083139,Staff,0,2,60,60
1650677209263,ECE 65,A50,083695,Staff,0,5,30,30
1650677215290,ECE 109,A01,091882,Touri; Behrouz,33,0,70,37
1650677221324,ECE 180,A00,083140,Abi Samra; Nicholas Camill,20,0,30,10
1650677221324,ECE 180,B00,083141,Abi Samra; Nicholas Camill,0,0,30,30
1650677227348,MATH 10A,A01,083735,Patchell; Gregory David,3,0,30,27
1650677227348,MATH 10A,A02,083736,Patchell; Gregory David,27,0,30,3
1650677227348,MATH 10A,A03,083737,Patchell; Gregory David,24,0,30,6
1650677233374,MATH 10B,A01,083207,Staff,0,9,30,30
1650677233374,MATH 10B,A02,083208,Staff,1,8,30,29
1650677233374,MATH 10B,B01,083739,Staff,11,0,30,19
1650677233374,MATH 10B,B02,083740,Staff,28,0,30,2
1650677239399,MATH 18,A01,083743,Staff,0,0,30,30
1650677239399,MATH 18,A02,083744,Staff,23,0,30,7
1650677239399,MATH 18,A03,083745,Staff,21,0,30,9
1650677239399,MATH 18,A04,083746,Staff,26,0,30,4
1650677239399,MATH 18,B01,083748,Staff,0,15,30,30
1650677239399,MATH 18,B02,083749,Staff,0,12,30,30
1650677239399,MATH 18,B03,083750,Staff,0,12,30,30
1650677239399,MATH 18,B04,083751,Staff,0,12,30,30
1650677245422,MATH 20A,A01,083754,Staff,19,0,40,21
1650677251450,MATH 20B,A01,083756,Staff,0,11,30,30
1650677251450,MATH 20B,A02,083757,Staff,0,12,30,30
1650677257473,MATH 20C,A01,083760,Staff,0,16,30,30
1650677257473,MATH 20C,A02,083761,Staff,1,16,30,29
1650677257473,MATH 20C,B01,083762,Staff,10,0,30,20
1650677257473,MATH 20C,B02,083763,Staff,28,0,30,2
1650677263500,MATH 20D,A01,083765,Staff,1,1,30,29
1650677263500,MATH 20D,A02,083766,Staff,6,0,30,24
1650677263500,MATH 20D,A03,083767,Staff,24,0,30,6
1650677269525,MATH 20E,A01,083771,Staff,3,0,30,27
1650677269525,MATH 20E,A02,083772,Staff,16,0,30,14
1650677269525,MATH 20E,B01,083773,Staff,0,0,30,30
1650677269525,MATH 20E,B02,083774,Staff,9,0,30,21
1650677275550,MATH 103A,A01,083777,Staff,0,15,30,30
1650677275550,MATH 103A,A02,083778,Staff,0,15,30,30
1650677275550,MATH 103A,B01,083779,Staff,0,14,30,30
1650677275550,MATH 103A,B02,083780,Staff,0,14,30,30
1650677281574,MATH 105,A01,085443,Staff,0,22,30,30
1650677287598,MATH 109,A01,083213,Anzaldo; Leesa B,0,7,30,30
1650677287598,MATH 109,A02,083214,Anzaldo; Leesa B,0,7,30,30
1650677287598,MATH 109,B01,083215,Anzaldo; Leesa B,0,8,30,30
1650677287598,MATH 109,B02,083216,Anzaldo; Leesa B,0,6,30,30
1650677293626,MATH 142A,A01,083219,Chow; Bennett,0,16,30,30
1650677293626,MATH 142A,A02,083220,Chow; Bennett,0,15,30,30
1650677293626,MATH 142A,B01,083221,Chow; Bennett,0,13,30,30
1650677293626,MATH 142A,B02,083222,Chow; Bennett,0,14,30,30
1650677299656,MATH 193A,A01,083224,Staff,0,5,30,30
1650677299656,MATH 193A,A02,083225,Staff,0,6,30,30
1650677299656,MATH 193A,A03,083781,Staff,0,6,30,30
1650677299656,MATH 193A,A04,083782,Staff,0,7,30,30
1650677305682,MATH 197,001,091859,McAuley; Julian John,9998,0,9999,1
1650677311739,COGS 9,A01,083615,Staff,1,16,60,59
1650677317763,COGS 11,A01,083617,Boyle; Mary E. T.,18,0,40,22
1650677323787,COGS 13,A01,083071,Staff,0,39,40,40
1650677329814,COGS 14A,A01,092681,Staff,0,32,100,100
1650677335838,COGS 14B,A01,083073,Cheng; Tzu-Han,1,14,50,49
1650677341864,COGS 17,A01,092677,Staff,15,0,75,60
1650677347891,COGS 100,A01,083619,Staff,0,29,60,60
1650677353918,COGS 101A,A01,083621,Davis; Joshua Daniel,0,27,60,60
1650677359943,COGS 101B,A01,091572,Staff,0,4,60,60
1650677365970,COGS 101C,A01,083625,Delgado; Tania,14,0,30,16
1650677371994,COGS 107A,A01,083627,Boyle; Mary E. T.,1,17,60,59
1650677378018,COGS 118A,A01,083075,Staff,0,7,60,60
1650677384041,CSE 3,A50,083646,Miranda; Gregory Joseph,18,0,38,20
1650677384041,CSE 3,A51,083647,Miranda; Gregory Joseph,36,0,37,1
1650677390065,CSE 8A,A50,083650,Miranda; Gregory Joseph,0,30,40,40
1650677396092,CSE 11,A01,083080,Cao; Yingjun,0,95,40,40
1650677402114,CSE 12,A01,083652,Staff,0,21,100,100
1650677408137,CSE 15L,A01,083654,Staff,0,3,50,50
1650677408137,CSE 15L,A02,083655,Staff,0,2,50,50
1650677414164,CSE 20,A01,083657,Staff,50,0,80,30
1650677420186,CSE 30,A01,083084,Eldon; John,0,78,40,40
1650677426213,CSE 100,A01,083659,Cao; Yingjun,0,70,50,50
1650677432237,CSE 134B,A01,083661,Powell; Thomas Allan,0,38,65,65
1650677438259,CSE 140,A01,083663,Staff,0,10,75,75
1650677444283,CSE 140L,A01,083088,Eldon; John,0,18,75,75
1650677450309,CSE 175,A01,083665,Kumar; Rakesh,7,0,25,18
1650677456332,CSE 190,A00,092507,Dubnov; Shlomo,10,0,20,10
1650677462359,ECE 45,A01,083139,Staff,0,2,60,60
1650677468383,ECE 65,A50,083695,Staff,0,5,30,30
1650677474413,ECE 109,A01,091882,Touri; Behrouz,33,0,70,37
1650677480442,ECE 180,A00,083140,Abi Samra; Nicholas Camill,20,0,30,10
1650677480442,ECE 180,B00,083141,Abi Samra; Nicholas Camill,0,0,30,30
1650677486469,MATH 10A,A01,083735,Patchell; Gregory David,3,0,30,27
1650677486469,MATH 10A,A02,083736,Patchell; Gregory David,27,0,30,3
1650677486469,MATH 10A,A03,083737,Patchell; Gregory David,24,0,30,6
1650677492497,MATH 10B,A01,083207,Staff,0,9,30,30
1650677492497,MATH 10B,A02,083208,Staff,1,8,30,29
1650677492497,MATH 10B,B01,083739,Staff,11,0,30,19
1650677492497,MATH 10B,B02,083740,Staff,28,0,30,2
1650677498528,MATH 18,A01,083743,Staff,0,0,30,30
1650677498528,MATH 18,A02,083744,Staff,23,0,30,7
1650677498528,MATH 18,A03,083745,Staff,21,0,30,9
1650677498528,MATH 18,A04,083746,Staff,26,0,30,4
1650677498528,MATH 18,B01,083748,Staff,0,15,30,30
1650677498528,MATH 18,B02,083749,Staff,0,12,30,30
1650677498528,MATH 18,B03,083750,Staff,0,12,30,30
1650677498528,MATH 18,B04,083751,Staff,0,12,30,30
1650677504553,MATH 20A,A01,083754,Staff,19,0,40,21
1650677510592,MATH 20B,A01,083756,Staff,0,11,30,30
1650677510592,MATH 20B,A02,083757,Staff,0,12,30,30
1650677516615,MATH 20C,A01,083760,Staff,0,16,30,30
1650677516615,MATH 20C,A02,083761,Staff,1,16,30,29
1650677516615,MATH 20C,B01,083762,Staff,10,0,30,20
1650677516615,MATH 20C,B02,083763,Staff,28,0,30,2
1650677522650,MATH 20D,A01,083765,Staff,1,1,30,29
1650677522650,MATH 20D,A02,083766,Staff,6,0,30,24
1650677522650,MATH 20D,A03,083767,Staff,24,0,30,6
1650677528678,MATH 20E,A01,083771,Staff,3,0,30,27
1650677528678,MATH 20E,A02,083772,Staff,16,0,30,14
1650677528678,MATH 20E,B01,083773,Staff,0,0,30,30
1650677528678,MATH 20E,B02,083774,Staff,9,0,30,21
1650677534706,MATH 103A,A01,083777,Staff,0,15,30,30
1650677534706,MATH 103A,A02,083778,Staff,0,15,30,30
1650677534706,MATH 103A,B01,083779,Staff,0,14,30,30
1650677534706,MATH 103A,B02,083780,Staff,0,14,30,30
1650677540736,MATH 105,A01,085443,Staff,0,22,30,30
1650677546758,MATH 109,A01,083213,Anzaldo; Leesa B,0,7,30,30
1650677546758,MATH 109,A02,083214,Anzaldo; Leesa B,0,7,30,30
1650677546758,MATH 109,B01,083215,Anzaldo; Leesa B,0,8,30,30
1650677546758,MATH 109,B02,083216,Anzaldo; Leesa B,0,6,30,30
1650677552788,MATH 142A,A01,083219,Chow; Bennett,0,16,30,30
1650677552788,MATH 142A,A02,083220,Chow; Bennett,0,15,30,30
1650677552788,MATH 142A,B01,083221,Chow; Bennett,0,13,30,30
1650677552788,MATH 142A,B02,083222,Chow; Bennett,0,14,30,30
1650677558811,MATH 193A,A01,083224,Staff,0,5,30,30
1650677558811,MATH 193A,A02,083225,Staff,0,6,30,30
1650677558811,MATH 193A,A03,083781,Staff,0,6,30,30
1650677558811,MATH 193A,A04,083782,Staff,0,7,30,30
1650677564853,MATH 197,001,091859,McAuley; Julian John,9998,0,9999,1
1650677570911,COGS 9,A01,083615,Staff,1,16,60,59
1650677577008,COGS 11,A01,083617,Boyle; Mary E. T.,18,0,40,22
1650677583032,COGS 13,A01,083071,Staff,0,39,40,40
1650677589054,COGS 14A,A01,092681,Staff,0,32,100,100
1650677595083,COGS 14B,A01,083073,Cheng; Tzu-Han,1,14,50,49
1650677601110,COGS 17,A01,092677,Staff,15,0,75,60
1650677607137,COGS 100,A01,083619,Staff,0,29,60,60
1650677613169,COGS 101A,A01,083621,Davis; Joshua Daniel,0,27,60,60
1650677619205,COGS 101B,A01,091572,Staff,0,4,60,60
1650677625232,COGS 101C,A01,083625,Delgado; Tania,14,0,30,16
1650677631256,COGS 107A,A01,083627,Boyle; Mary E. T.,1,17,60,59
1650677637280,COGS 118A,A01,083075,Staff,0,7,60,60
1650677643305,CSE 3,A50,083646,Miranda; Gregory Joseph,18,0,38,20
1650677643305,CSE 3,A51,083647,Miranda; Gregory Joseph,36,0,37,1
1650677649329,CSE 8A,A50,083650,Miranda; Gregory Joseph,0,30,40,40
1650677655355,CSE 11,A01,083080,Cao; Yingjun,0,95,40,40
1650677661382,CSE 12,A01,083652,Staff,0,21,100,100
1650677667405,CSE 15L,A01,083654,Staff,0,3,50,50
1650677667405,CSE 15L,A02,083655,Staff,0,2,50,50
1650677673435,CSE 20,A01,083657,Staff,50,0,80,30
1650677679456,CSE 30,A01,083084,Eldon; John,0,78,40,40
1650677685482,CSE 100,A01,083659,Cao; Yingjun,0,70,50,50
1650677691508,CSE 134B,A01,083661,Powell; Thomas Allan,0,38,65,65
1650677697533,CSE 140,A01,083663,Staff,0,10,75,75
1650677703561,CSE 140L,A01,083088,Eldon; John,0,18,75,75
1650677709590,CSE 175,A01,083665,Kumar; Rakesh,7,0,25,18
1650677715621,CSE 190,A00,092507,Dubnov; Shlomo,10,0,20,10
1650677721652,ECE 45,A01,083139,Staff,0,2,60,60
1650677727683,ECE 65,A50,083695,Staff,0,5,30,30
1650677733708,ECE 109,A01,091882,Touri; Behrouz,33,0,70,37
1650677739731,ECE 180,A00,083140,Abi Samra; Nicholas Camill,20,0,30,10
1650677739731,ECE 180,B00,083141,Abi Samra; Nicholas Camill,0,0,30,30
1650677745752,MATH 10A,A01,083735,Patchell; Gregory David,3,0,30,27
1650677745752,MATH 10A,A02,083736,Patchell; Gregory David,27,0,30,3
1650677745752,MATH 10A,A03,083737,Patchell; Gregory David,24,0,30,6
1650677751775,MATH 10B,A01,083207,Staff,0,9,30,30
1650677751775,MATH 10B,A02,083208,Staff,1,8,30,29
1650677751775,MATH 10B,B01,083739,Staff,11,0,30,19
1650677751775,MATH 10B,B02,083740,Staff,28,0,30,2
1650677757799,MATH 18,A01,083743,Staff,0,0,30,30
1650677757799,MATH 18,A02,083744,Staff,23,0,30,7
1650677757799,MATH 18,A03,083745,Staff,21,0,30,9
1650677757799,MATH 18,A04,083746,Staff,26,0,30,4
1650677757799,MATH 18,B01,083748,Staff,0,15,30,30
1650677757799,MATH 18,B02,083749,Staff,0,12,30,30
1650677757799,MATH 18,B03,083750,Staff,0,12,30,30
1650677757799,MATH 18,B04,083751,Staff,0,12,30,30
1650677763824,MATH 20A,A01,083754,Staff,19,0,40,21
1650677769853,MATH 20B,A01,083756,Staff,0,11,30,30
1650677769853,MATH 20B,A02,083757,Staff,0,12,30,30
1650677775877,MATH 20C,A01,083760,Staff,0,16,30,30
1650677775877,MATH 20C,A02,083761,Staff,1,16,30,29
1650677775877,MATH 20C,B01,083762,Staff,10,0,30,20
1650677775877,MATH 20C,B02,083763,Staff,28,0,30,2
1650677781900,MATH 20D,A01,083765,Staff,1,1,30,29
1650677781900,MATH 20D,A02,083766,Staff,6,0,30,24
1650677781900,MATH 20D,A03,083767,Staff,24,0,30,6
1650677787928,MATH 20E,A01,083771,Staff,3,0,30,27
1650677787928,MATH 20E,A02,083772,Staff,16,0,30,14
1650677787928,MATH 20E,B01,083773,Staff,0,0,30,30
1650677787928,MATH 20E,B02,083774,Staff,9,0,30,21
1650677793953,MATH 103A,A01,083777,Staff,0,15,30,30
1650677793953,MATH 103A,A02,083778,Staff,0,15,30,30
1650677793953,MATH 103A,B01,083779,Staff,0,14,30,30
1650677793953,MATH 103A,B02,083780,Staff,0,14,30,30
1650677799979,MATH 105,A01,085443,Staff,0,22,30,30
1650677806009,MATH 109,A01,083213,Anzaldo; Leesa B,0,7,30,30
1650677806009,MATH 109,A02,083214,Anzaldo; Leesa B,0,7,30,30
1650677806009,MATH 109,B01,083215,Anzaldo; Leesa B,0,8,30,30
1650677806009,MATH 109,B02,083216,Anzaldo; Leesa B,0,6,30,30
1650677812034,MATH 142A,A01,083219,Chow; Bennett,0,16,30,30
1650677812034,MATH 142A,A02,083220,Chow; Bennett,0,15,30,30
1650677812034,MATH 142A,B01,083221,Chow; Bennett,0,13,30,30
1650677812034,MATH 142A,B02,083222,Chow; Bennett,0,14,30,30
1650677818061,MATH 193A,A01,083224,Staff,0,5,30,30
1650677818061,MATH 193A,A02,083225,Staff,0,6,30,30
1650677818061,MATH 193A,A03,083781,Staff,0,6,30,30
1650677818061,MATH 193A,A04,083782,Staff,0,7,30,30
1650677824083,MATH 197,001,091859,McAuley; Julian John,9998,0,9999,1
1650677830143,COGS 9,A01,083615,Staff,1,16,60,59
1650677836167,COGS 11,A01,083617,Boyle; Mary E. T.,18,0,40,22
1650677842193,COGS 13,A01,083071,Staff,0,39,40,40
1650677848216,COGS 14A,A01,092681,Staff,0,32,100,100
1650677854239,COGS 14B,A01,083073,Cheng; Tzu-Han,1,14,50,49
1650677860263,COGS 17,A01,092677,Staff,15,0,75,60
1650677866287,COGS 100,A01,083619,Staff,0,29,60,60
1650677872322,COGS 101A,A01,083621,Davis; Joshua Daniel,0,27,60,60
1650677878346,COGS 101B,A01,091572,Staff,0,4,60,60
1650677884369,COGS 101C,A01,083625,Delgado; Tania,14,0,30,16
1650677890395,COGS 107A,A01,083627,Boyle; Mary E. T.,1,17,60,59
1650677896418,COGS 118A,A01,083075,Staff,0,7,60,60
1650677902443,CSE 3,A50,083646,Miranda; Gregory Joseph,18,0,38,20
1650677902443,CSE 3,A51,083647,Miranda; Gregory Joseph,36,0,37,1
1650677908466,CSE 8A,A50,083650,Miranda; Gregory Joseph,0,30,40,40
1650677914490,CSE 11,A01,083080,Cao; Yingjun,0,95,40,40
1650677920514,CSE 12,A01,083652,Staff,0,21,100,100
1650677926538,CSE 15L,A01,083654,Staff,0,3,50,50
1650677926538,CSE 15L,A02,083655,Staff,0,2,50,50
1650677932562,CSE 20,A01,083657,Staff,50,0,80,30
1650677938589,CSE 30,A01,083084,Eldon; John,0,78,40,40
1650677944624,CSE 100,A01,083659,Cao; Yingjun,0,70,50,50
1650677950648,CSE 134B,A01,083661,Powell; Thomas Allan,0,38,65,65
1650677956674,CSE 140,A01,083663,Staff,0,10,75,75
1650677962703,CSE 140L,A01,083088,Eldon; John,0,18,75,75
1650677968735,CSE 175,A01,083665,Kumar; Rakesh,7,0,25,18
1650677974759,CSE 190,A00,092507,Dubnov; Shlomo,10,0,20,10
1650677980784,ECE 45,A01,083139,Staff,0,2,60,60
1650677986807,ECE 65,A50,083695,Staff,0,5,30,30
1650677992831,ECE 109,A01,091882,Touri; Behrouz,33,0,70,37
1650677998854,ECE 180,A00,083140,Abi Samra; Nicholas Camill,20,0,30,10
1650677998854,ECE 180,B00,083141,Abi Samra; Nicholas Camill,0,0,30,30
1650678004878,MATH 10A,A01,083735,Patchell; Gregory David,3,0,30,27
1650678004878,MATH 10A,A02,083736,Patchell; Gregory David,27,0,30,3
1650678004878,MATH 10A,A03,083737,Patchell; Gregory David,24,0,30,6
1650678010904,MATH 10B,A01,083207,Staff,0,9,30,30
1650678010904,MATH 10B,A02,083208,Staff,1,8,30,29
1650678010904,MATH 10B,B01,083739,Staff,11,0,30,19
1650678010904,MATH 10B,B02,083740,Staff,28,0,30,2
1650678016934,MATH 18,A01,083743,Staff,0,0,30,30
1650678016934,MATH 18,A02,083744,Staff,23,0,30,7
1650678016934,MATH 18,A03,083745,Staff,21,0,30,9
1650678016934,MATH 18,A04,083746,Staff,26,0,30,4
1650678016934,MATH 18,B01,083748,Staff,0,15,30,30
1650678016934,MATH 18,B02,083749,Staff,0,12,30,30
1650678016934,MATH 18,B03,083750,Staff,0,12,30,30
1650678016934,MATH 18,B04,083751,Staff,0,12,30,30
1650678022960,MATH 20A,A01,083754,Staff,19,0,40,21
1650678028988,MATH 20B,A01,083756,Staff,0,11,30,30
1650678028988,MATH 20B,A02,083757,Staff,0,12,30,30
1650678035018,MATH 20C,A01,083760,Staff,0,16,30,30
1650678035018,MATH 20C,A02,083761,Staff,1,16,30,29
1650678035018,MATH 20C,B01,083762,Staff,10,0,30,20
1650678035018,MATH 20C,B02,083763,Staff,28,0,30,2
1650678041045,MATH 20D,A01,083765,Staff,1,1,30,29
1650678041045,MATH 20D,A02,083766,Staff,6,0,30,24
1650678041045,MATH 20D,A03,083767,Staff,24,0,30,6
1650678047075,MATH 20E,A01,083771,Staff,3,0,30,27
1650678047075,MATH 20E,A02,083772,Staff,16,0,30,14
1650678047075,MATH 20E,B01,083773,Staff,0,0,30,30
1650678047075,MATH 20E,B02,083774,Staff,9,0,30,21
1650678053101,MATH 103A,A01,083777,Staff,0,15,30,30
1650678053101,MATH 103A,A02,083778,Staff,0,15,30,30
1650678053101,MATH 103A,B01,083779,Staff,0,14,30,30
1650678053101,MATH 103A,B02,083780,Staff,0,14,30,30
1650678059125,MATH 105,A01,085443,Staff,0,22,30,30
1650678065150,MATH 109,A01,083213,Anzaldo; Leesa B,0,7,30,30
1650678065150,MATH 109,A02,083214,Anzaldo; Leesa B,0,7,30,30
1650678065150,MATH 109,B01,083215,Anzaldo; Leesa B,0,8,30,30
1650678065150,MATH 109,B02,083216,Anzaldo; Leesa B,0,6,30,30
1650678071181,MATH 142A,A01,083219,Chow; Bennett,0,16,30,30
1650678071181,MATH 142A,A02,083220,Chow; Bennett,0,15,30,30
1650678071181,MATH 142A,B01,083221,Chow; Bennett,0,13,30,30
1650678071181,MATH 142A,B02,083222,Chow; Bennett,0,14,30,30
1650678077205,MATH 193A,A01,083224,Staff,0,5,30,30
1650678077205,MATH 193A,A02,083225,Staff,0,6,30,30
1650678077205,MATH 193A,A03,083781,Staff,0,6,30,30
1650678077205,MATH 193A,A04,083782,Staff,0,7,30,30
1650678083231,MATH 197,001,091859,McAuley; Julian John,9998,0,9999,1
1650678089291,COGS 9,A01,083615,Staff,1,16,60,59
1650678095315,COGS 11,A01,083617,Boyle; Mary E. T.,18,0,40,22
1650678101343,COGS 13,A01,083071,Staff,0,39,40,40
1650678107368,COGS 14A,A01,092681,Staff,0,32,100,100
1650678113395,COGS 14B,A01,083073,Cheng; Tzu-Han,1,14,50,49
1650678119418,COGS 17,A01,092677,Staff,15,0,75,60
1650678125445,COGS 100,A01,083619,Staff,0,29,60,60
1650678131472,COGS 101A,A01,083621,Davis; Joshua Daniel,0,27,60,60
1650678137499,COGS 101B,A01,091572,Staff,0,4,60,60
1650678143533,COGS 101C,A01,083625,Delgado; Tania,14,0,30,16
1650678149557,COGS 107A,A01,083627,Boyle; Mary E. T.,1,17,60,59
1650678155581,COGS 118A,A01,083075,Staff,0,7,60,60
1650678161643,CSE 3,A50,083646,Miranda; Gregory Joseph,18,0,38,20
1650678161643,CSE 3,A51,083647,Miranda; Gregory Joseph,36,0,37,1
1650678167673,CSE 8A,A50,083650,Miranda; Gregory Joseph,0,30,40,40
1650678173791,CSE 11,A01,083080,Cao; Yingjun,0,95,40,40
1650678179815,CSE 12,A01,083652,Staff,0,21,100,100
1650678185840,CSE 15L,A01,083654,Staff,0,3,50,50
1650678185840,CSE 15L,A02,083655,Staff,0,2,50,50
1650678191874,CSE 20,A01,083657,Staff,50,0,80,30
1650678197902,CSE 30,A01,083084,Eldon; John,0,78,40,40
1650678203925,CSE 100,A01,083659,Cao; Yingjun,0,70,50,50
1650678209948,CSE 134B,A01,083661,Powell; Thomas Allan,0,38,65,65
1650678215970,CSE 140,A01,083663,Staff,0,10,75,75
1650678222003,CSE 140L,A01,083088,Eldon; John,0,18,75,75
1650678228029,CSE 175,A01,083665,Kumar; Rakesh,7,0,25,18
1650678234058,CSE 190,A00,092507,Dubnov; Shlomo,10,0,20,10
1650678240085,ECE 45,A01,083139,Staff,0,2,60,60
1650678246111,ECE 65,A50,083695,Staff,0,5,30,30
1650678252136,ECE 109,A01,091882,Touri; Behrouz,33,0,70,37
1650678258160,ECE 180,A00,083140,Abi Samra; Nicholas Camill,20,0,30,10
1650678258160,ECE 180,B00,083141,Abi Samra; Nicholas Camill,0,0,30,30
1650678264184,MATH 10A,A01,083735,Patchell; Gregory David,3,0,30,27
1650678264184,MATH 10A,A02,083736,Patchell; Gregory David,27,0,30,3
1650678264184,MATH 10A,A03,083737,Patchell; Gregory David,24,0,30,6
1650678270209,MATH 10B,A01,083207,Staff,0,9,30,30
1650678270209,MATH 10B,A02,083208,Staff,1,8,30,29
1650678270209,MATH 10B,B01,083739,Staff,11,0,30,19
1650678270209,MATH 10B,B02,083740,Staff,28,0,30,2
1650678276238,MATH 18,A01,083743,Staff,0,0,30,30
1650678276238,MATH 18,A02,083744,Staff,23,0,30,7
1650678276238,MATH 18,A03,083745,Staff,21,0,30,9
1650678276238,MATH 18,A04,083746,Staff,26,0,30,4
1650678276238,MATH 18,B01,083748,Staff,0,15,30,30
1650678276238,MATH 18,B02,083749,Staff,0,12,30,30
1650678276238,MATH 18,B03,083750,Staff,0,12,30,30
1650678276238,MATH 18,B04,083751,Staff,0,12,30,30
1650678282264,MATH 20A,A01,083754,Staff,19,0,40,21
1650678288290,MATH 20B,A01,083756,Staff,0,11,30,30
1650678288290,MATH 20B,A02,083757,Staff,0,12,30,30
1650678294339,MATH 20C,A01,083760,Staff,0,16,30,30
1650678294339,MATH 20C,A02,083761,Staff,1,16,30,29
1650678294339,MATH 20C,B01,083762,Staff,10,0,30,20
1650678294339,MATH 20C,B02,083763,Staff,28,0,30,2
1650678300361,MATH 20D,A01,083765,Staff,1,1,30,29
1650678300361,MATH 20D,A02,083766,Staff,6,0,30,24
1650678300361,MATH 20D,A03,083767,Staff,24,0,30,6
1650678306415,MATH 20E,A01,083771,Staff,3,0,30,27
1650678306415,MATH 20E,A02,083772,Staff,16,0,30,14
1650678306415,MATH 20E,B01,083773,Staff,0,0,30,30
1650678306415,MATH 20E,B02,083774,Staff,9,0,30,21
1650678312439,MATH 103A,A01,083777,Staff,0,15,30,30
1650678312439,MATH 103A,A02,083778,Staff,0,15,30,30
1650678312439,MATH 103A,B01,083779,Staff,0,14,30,30
1650678312439,MATH 103A,B02,083780,Staff,0,14,30,30
1650678318464,MATH 105,A01,085443,Staff,0,22,30,30
1650678324492,MATH 109,A01,083213,Anzaldo; Leesa B,0,7,30,30
1650678324492,MATH 109,A02,083214,Anzaldo; Leesa B,0,7,30,30
1650678324492,MATH 109,B01,083215,Anzaldo; Leesa B,0,8,30,30
1650678324492,MATH 109,B02,083216,Anzaldo; Leesa B,0,6,30,30
1650678330519,MATH 142A,A01,083219,Chow; Bennett,0,16,30,30
1650678330519,MATH 142A,A02,083220,Chow; Bennett,0,15,30,30
1650678330519,MATH 142A,B01,083221,Chow; Bennett,0,13,30,30
1650678330519,MATH 142A,B02,083222,Chow; Bennett,0,14,30,30
1650678336541,MATH 193A,A01,083224,Staff,0,5,30,30
1650678336541,MATH 193A,A02,083225,Staff,0,6,30,30
1650678336541,MATH 193A,A03,083781,Staff,0,6,30,30
1650678336541,MATH 193A,A04,083782,Staff,0,7,30,30
1650678342565,MATH 197,001,091859,McAuley; Julian John,9998,0,9999,1
1650678348616,COGS 9,A01,083615,Staff,1,16,60,59
1650678354639,COGS 11,A01,083617,Boyle; Mary E. T.,18,0,40,22
1650678360662,COGS 13,A01,083071,Staff,0,39,40,40
1650678366700,COGS 14A,A01,092681,Staff,0,32,100,100
1650678372725,COGS 14B,A01,083073,Cheng; Tzu-Han,1,14,50,49
1650678378748,COGS 17,A01,092677,Staff,15,0,75,60
1650678384777,COGS 100,A01,083619,Staff,0,29,60,60
1650678390800,COGS 101A,A01,083621,Davis; Joshua Daniel,0,27,60,60
1650678396829,COGS 101B,A01,091572,Staff,0,4,60,60
1650678402856,COGS 101C,A01,083625,Delgado; Tania,14,0,30,16
1650678408879,COGS 107A,A01,083627,Boyle; Mary E. T.,1,17,60,59
1650678414903,COGS 118A,A01,083075,Staff,0,7,60,60
1650678420930,CSE 3,A50,083646,Miranda; Gregory Joseph,18,0,38,20
1650678420930,CSE 3,A51,083647,Miranda; Gregory Joseph,36,0,37,1
1650678426954,CSE 8A,A50,083650,Miranda; Gregory Joseph,0,30,40,40
1650678432984,CSE 11,A01,083080,Cao; Yingjun,0,95,40,40
1650678439011,CSE 12,A01,083652,Staff,0,21,100,100
1650678445035,CSE 15L,A01,083654,Staff,0,3,50,50
1650678445035,CSE 15L,A02,083655,Staff,0,2,50,50
1650678451059,CSE 20,A01,083657,Staff,50,0,80,30
1650678457083,CSE 30,A01,083084,Eldon; John,0,78,40,40
1650678463108,CSE 100,A01,083659,Cao; Yingjun,0,70,50,50
1650678469130,CSE 134B,A01,083661,Powell; Thomas Allan,0,38,65,65
1650678475156,CSE 140,A01,083663,Staff,0,10,75,75
1650678481187,CSE 140L,A01,083088,Eldon; John,0,18,75,75
1650678487211,CSE 175,A01,083665,Kumar; Rakesh,7,0,25,18
1650678493237,CSE 190,A00,092507,Dubnov; Shlomo,10,0,20,10
1650678499260,ECE 45,A01,083139,Staff,0,2,60,60
1650678505290,ECE 65,A50,083695,Staff,0,5,30,30
1650678511322,ECE 109,A01,091882,Touri; Behrouz,33,0,70,37
1650678517349,ECE 180,A00,083140,Abi Samra; Nicholas Camill,20,0,30,10
1650678517349,ECE 180,B00,083141,Abi Samra; Nicholas Camill,0,0,30,30
1650678523375,MATH 10A,A01,083735,Patchell; Gregory David,3,0,30,27
1650678523375,MATH 10A,A02,083736,Patchell; Gregory David,27,0,30,3
1650678523375,MATH 10A,A03,083737,Patchell; Gregory David,24,0,30,6
1650678529399,MATH 10B,A01,083207,Staff,0,9,30,30
1650678529399,MATH 10B,A02,083208,Staff,1,8,30,29
1650678529399,MATH 10B,B01,083739,Staff,11,0,30,19
1650678529399,MATH 10B,B02,083740,Staff,28,0,30,2
1650678535424,MATH 18,A01,083743,Staff,0,0,30,30
1650678535424,MATH 18,A02,083744,Staff,23,0,30,7
1650678535424,MATH 18,A03,083745,Staff,21,0,30,9
1650678535424,MATH 18,A04,083746,Staff,26,0,30,4
1650678535424,MATH 18,B01,083748,Staff,0,15,30,30
1650678535424,MATH 18,B02,083749,Staff,0,12,30,30
1650678535424,MATH 18,B03,083750,Staff,0,12,30,30
1650678535424,MATH 18,B04,083751,Staff,0,12,30,30
1650678541447,MATH 20A,A01,083754,Staff,19,0,40,21
1650678547474,MATH 20B,A01,083756,Staff,0,11,30,30
1650678547474,MATH 20B,A02,083757,Staff,0,12,30,30
1650678553499,MATH 20C,A01,083760,Staff,0,16,30,30
1650678553499,MATH 20C,A02,083761,Staff,1,16,30,29
1650678553499,MATH 20C,B01,083762,Staff,10,0,30,20
1650678553499,MATH 20C,B02,083763,Staff,28,0,30,2
1650678559523,MATH 20D,A01,083765,Staff,1,1,30,29
1650678559523,MATH 20D,A02,083766,Staff,6,0,30,24
1650678559523,MATH 20D,A03,083767,Staff,24,0,30,6
1650678565548,MATH 20E,A01,083771,Staff,3,0,30,27
1650678565548,MATH 20E,A02,083772,Staff,16,0,30,14
1650678565548,MATH 20E,B01,083773,Staff,0,0,30,30
1650678565548,MATH 20E,B02,083774,Staff,9,0,30,21
1650678571575,MATH 103A,A01,083777,Staff,0,15,30,30
1650678571575,MATH 103A,A02,083778,Staff,0,15,30,30
1650678571575,MATH 103A,B01,083779,Staff,0,14,30,30
1650678571575,MATH 103A,B02,083780,Staff,0,14,30,30
1650678577603,MATH 105,A01,085443,Staff,0,22,30,30
1650678583637,MATH 109,A01,083213,Anzaldo; Leesa B,0,7,30,30
1650678583637,MATH 109,A02,083214,Anzaldo; Leesa B,0,7,30,30
1650678583637,MATH 109,B01,083215,Anzaldo; Leesa B,0,8,30,30
1650678583637,MATH 109,B02,083216,Anzaldo; Leesa B,0,6,30,30
1650678589666,MATH 142A,A01,083219,Chow; Bennett,0,16,30,30
1650678589666,MATH 142A,A02,083220,Chow; Bennett,0,15,30,30
1650678589666,MATH 142A,B01,083221,Chow; Bennett,0,13,30,30
1650678589666,MATH 142A,B02,083222,Chow; Bennett,0,14,30,30
1650678595690,MATH 193A,A01,083224,Staff,0,5,30,30
1650678595690,MATH 193A,A02,083225,Staff,0,6,30,30
1650678595690,MATH 193A,A03,083781,Staff,0,6,30,30
1650678595690,MATH 193A,A04,083782,Staff,0,7,30,30
1650678601718,MATH 197,001,091859,McAuley; Julian John,9998,0,9999,1
1650678607772,COGS 9,A01,083615,Staff,1,16,60,59
1650678613794,COGS 11,A01,083617,Boyle; Mary E. T.,18,0,40,22
1650678619823,COGS 13,A01,083071,Staff,0,39,40,40
1650678625848,COGS 14A,A01,092681,Staff,0,32,100,100
1650678631873,COGS 14B,A01,083073,Cheng; Tzu-Han,1,14,50,49
1650678637896,COGS 17,A01,092677,Staff,15,0,75,60
1650678643919,COGS 100,A01,083619,Staff,0,29,60,60
1650678649942,COGS 101A,A01,083621,Davis; Joshua Daniel,0,27,60,60
1650678655969,COGS 101B,A01,091572,Staff,0,4,60,60
1650678661998,COGS 101C,A01,083625,Delgado; Tania,14,0,30,16
1650678668026,COGS 107A,A01,083627,Boyle; Mary E. T.,1,17,60,59
1650678674050,COGS 118A,A01,083075,Staff,0,7,60,60
1650678680075,CSE 3,A50,083646,Miranda; Gregory Joseph,18,0,38,20
1650678680075,CSE 3,A51,083647,Miranda; Gregory Joseph,36,0,37,1
1650678686101,CSE 8A,A50,083650,Miranda; Gregory Joseph,0,30,40,40
1650678692124,CSE 11,A01,083080,Cao; Yingjun,0,95,40,40
1650678698148,CSE 12,A01,083652,Staff,0,21,100,100
1650678704173,CSE 15L,A01,083654,Staff,0,3,50,50
1650678704173,CSE 15L,A02,083655,Staff,0,2,50,50
1650678710197,CSE 20,A01,083657,Staff,50,0,80,30
1650678716219,CSE 30,A01,083084,Eldon; John,0,78,40,40
1650678722243,CSE 100,A01,083659,Cao; Yingjun,0,70,50,50
1650678728282,CSE 134B,A01,083661,Powell; Thomas Allan,0,38,65,65
1650678734313,CSE 140,A01,083663,Staff,0,10,75,75
1650678740337,CSE 140L,A01,083088,Eldon; John,0,18,75,75
1650678746360,CSE 175,A01,083665,Kumar; Rakesh,7,0,25,18
1650678752394,CSE 190,A00,092507,Dubnov; Shlomo,10,0,20,10
1650678758418,ECE 45,A01,083139,Staff,0,2,60,60
1650678764444,ECE 65,A50,083695,Staff,0,5,30,30
1650678770564,ECE 109,A01,091882,Touri; Behrouz,33,0,70,37
1650678776590,ECE 180,A00,083140,Abi Samra; Nicholas Camill,20,0,30,10
1650678776590,ECE 180,B00,083141,Abi Samra; Nicholas Camill,0,0,30,30
1650678782614,MATH 10A,A01,083735,Patchell; Gregory David,3,0,30,27
1650678782614,MATH 10A,A02,083736,Patchell; Gregory David,27,0,30,3
1650678782614,MATH 10A,A03,083737,Patchell; Gregory David,24,0,30,6
1650678788638,MATH 10B,A01,083207,Staff,0,9,30,30
1650678788638,MATH 10B,A02,083208,Staff,1,8,30,29
1650678788638,MATH 10B,B01,083739,Staff,11,0,30,19
1650678788638,MATH 10B,B02,083740,Staff,28,0,30,2
1650678794670,MATH 18,A01,083743,Staff,0,0,30,30
1650678794670,MATH 18,A02,083744,Staff,23,0,30,7
1650678794670,MATH 18,A03,083745,Staff,21,0,30,9
1650678794670,MATH 18,A04,083746,Staff,26,0,30,4
1650678794670,MATH 18,B01,083748,Staff,0,15,30,30
1650678794670,MATH 18,B02,083749,Staff,0,12,30,30
1650678794670,MATH 18,B03,083750,Staff,0,12,30,30
1650678794670,MATH 18,B04,083751,Staff,0,12,30,30
1650678800693,MATH 20A,A01,083754,Staff,19,0,40,21
1650678806716,MATH 20B,A01,083756,Staff,0,11,30,30
1650678806716,MATH 20B,A02,083757,Staff,0,12,30,30
1650678812744,MATH 20C,A01,083760,Staff,0,16,30,30
1650678812744,MATH 20C,A02,083761,Staff,1,16,30,29
1650678812744,MATH 20C,B01,083762,Staff,10,0,30,20
1650678812744,MATH 20C,B02,083763,Staff,28,0,30,2
1650678818778,MATH 20D,A01,083765,Staff,1,1,30,29
1650678818778,MATH 20D,A02,083766,Staff,6,0,30,24
1650678818778,MATH 20D,A03,083767,Staff,24,0,30,6
1650678824802,MATH 20E,A01,083771,Staff,3,0,30,27
1650678824802,MATH 20E,A02,083772,Staff,16,0,30,14
1650678824802,MATH 20E,B01,083773,Staff,0,0,30,30
1650678824802,MATH 20E,B02,083774,Staff,9,0,30,21
1650678830841,MATH 103A,A01,083777,Staff,0,15,30,30
1650678830841,MATH 103A,A02,083778,Staff,0,15,30,30
1650678830841,MATH 103A,B01,083779,Staff,0,15,30,30
1650678830841,MATH 103A,B02,083780,Staff,0,14,30,30
1650678836866,MATH 105,A01,085443,Staff,0,22,30,30
1650678842892,MATH 109,A01,083213,Anzaldo; Leesa B,0,7,30,30
1650678842892,MATH 109,A02,083214,Anzaldo; Leesa B,0,7,30,30
1650678842892,MATH 109,B01,083215,Anzaldo; Leesa B,0,8,30,30
1650678842892,MATH 109,B02,083216,Anzaldo; Leesa B,0,6,30,30
1650678848920,MATH 142A,A01,083219,Chow; Bennett,0,16,30,30
1650678848920,MATH 142A,A02,083220,Chow; Bennett,0,15,30,30
1650678848920,MATH 142A,B01,083221,Chow; Bennett,0,13,30,30
1650678848920,MATH 142A,B02,083222,Chow; Bennett,0,14,30,30
1650678854944,MATH 193A,A01,083224,Staff,0,5,30,30
1650678854944,MATH 193A,A02,083225,Staff,0,6,30,30
1650678854944,MATH 193A,A03,083781,Staff,0,6,30,30
1650678854944,MATH 193A,A04,083782,Staff,0,7,30,30
1650678860968,MATH 197,001,091859,McAuley; Julian John,9998,0,9999,1
1650678867029,COGS 9,A01,083615,Staff,1,16,60,59
1650678873065,COGS 11,A01,083617,Boyle; Mary E. T.,18,0,40,22
1650678879089,COGS 13,A01,083071,Staff,0,39,40,40
1650678885114,COGS 14A,A01,092681,Staff,0,32,100,100
1650678891146,COGS 14B,A01,083073,Cheng; Tzu-Han,1,14,50,49
1650678897173,COGS 17,A01,092677,Staff,15,0,75,60
1650678903200,COGS 100,A01,083619,Staff,0,29,60,60
1650678909228,COGS 101A,A01,083621,Davis; Joshua Daniel,0,27,60,60
1650678915254,COGS 101B,A01,091572,Staff,0,4,60,60
1650678921281,COGS 101C,A01,083625,Delgado; Tania,14,0,30,16
1650678927307,COGS 107A,A01,083627,Boyle; Mary E. T.,1,17,60,59
1650678933330,COGS 118A,A01,083075,Staff,0,7,60,60
1650678939361,CSE 3,A50,083646,Miranda; Gregory Joseph,18,0,38,20
1650678939361,CSE 3,A51,083647,Miranda; Gregory Joseph,36,0,37,1
1650678945385,CSE 8A,A50,083650,Miranda; Gregory Joseph,0,30,40,40
1650678951423,CSE 11,A01,083080,Cao; Yingjun,0,95,40,40
1650678957450,CSE 12,A01,083652,Staff,0,21,100,100
1650678963474,CSE 15L,A01,083654,Staff,0,3,50,50
1650678963474,CSE 15L,A02,083655,Staff,0,2,50,50
1650678969500,CSE 20,A01,083657,Staff,50,0,80,30
1650678975523,CSE 30,A01,083084,Eldon; John,0,78,40,40
1650678981549,CSE 100,A01,083659,Cao; Yingjun,0,70,50,50
1650678987573,CSE 134B,A01,083661,Powell; Thomas Allan,0,38,65,65
1650678993594,CSE 140,A01,083663,Staff,0,10,75,75
1650678999618,CSE 140L,A01,083088,Eldon; John,0,18,75,75
1650679005641,CSE 175,A01,083665,Kumar; Rakesh,7,0,25,18
1650679011666,CSE 190,A00,092507,Dubnov; Shlomo,10,0,20,10
1650679017689,ECE 45,A01,083139,Staff,0,2,60,60
1650679023716,ECE 65,A50,083695,Staff,0,5,30,30
1650679029744,ECE 109,A01,091882,Touri; Behrouz,33,0,70,37
1650679035766,ECE 180,A00,083140,Abi Samra; Nicholas Camill,20,0,30,10
1650679035766,ECE 180,B00,083141,Abi Samra; Nicholas Camill,0,0,30,30
1650679041788,MATH 10A,A01,083735,Patchell; Gregory David,3,0,30,27
1650679041788,MATH 10A,A02,083736,Patchell; Gregory David,27,0,30,3
1650679041788,MATH 10A,A03,083737,Patchell; Gregory David,24,0,30,6
1650679047811,MATH 10B,A01,083207,Staff,0,9,30,30
1650679047811,MATH 10B,A02,083208,Staff,1,8,30,29
1650679047811,MATH 10B,B01,083739,Staff,11,0,30,19
1650679047811,MATH 10B,B02,083740,Staff,28,0,30,2
1650679053837,MATH 18,A01,083743,Staff,0,0,30,30
1650679053837,MATH 18,A02,083744,Staff,23,0,30,7
1650679053837,MATH 18,A03,083745,Staff,21,0,30,9
1650679053837,MATH 18,A04,083746,Staff,26,0,30,4
1650679053837,MATH 18,B01,083748,Staff,0,15,30,30
1650679053837,MATH 18,B02,083749,Staff,0,12,30,30
1650679053837,MATH 18,B03,083750,Staff,0,12,30,30
1650679053837,MATH 18,B04,083751,Staff,0,12,30,30
1650679059880,MATH 20A,A01,083754,Staff,19,0,40,21
1650679065914,MATH 20B,A01,083756,Staff,0,11,30,30
1650679065914,MATH 20B,A02,083757,Staff,0,12,30,30
1650679071946,MATH 20C,A01,083760,Staff,0,16,30,30
1650679071946,MATH 20C,A02,083761,Staff,1,16,30,29
1650679071946,MATH 20C,B01,083762,Staff,10,0,30,20
1650679071946,MATH 20C,B02,083763,Staff,28,0,30,2
1650679077973,MATH 20D,A01,083765,Staff,2,1,30,28
1650679077973,MATH 20D,A02,083766,Staff,5,0,30,25
1650679077973,MATH 20D,A03,083767,Staff,24,0,30,6
1650679084007,MATH 20E,A01,083771,Staff,3,0,30,27
1650679084007,MATH 20E,A02,083772,Staff,16,0,30,14
1650679084007,MATH 20E,B01,083773,Staff,0,0,30,30
1650679084007,MATH 20E,B02,083774,Staff,9,0,30,21
1650679090031,MATH 103A,A01,083777,Staff,0,15,30,30
1650679090031,MATH 103A,A02,083778,Staff,0,15,30,30
1650679090031,MATH 103A,B01,083779,Staff,0,15,30,30
1650679090031,MATH 103A,B02,083780,Staff,0,14,30,30
1650679096055,MATH 105,A01,085443,Staff,0,22,30,30
1650679102079,MATH 109,A01,083213,Anzaldo; Leesa B,0,7,30,30
1650679102079,MATH 109,A02,083214,Anzaldo; Leesa B,0,7,30,30
1650679102079,MATH 109,B01,083215,Anzaldo; Leesa B,0,8,30,30
1650679102079,MATH 109,B02,083216,Anzaldo; Leesa B,0,6,30,30
1650679108108,MATH 142A,A01,083219,Chow; Bennett,0,16,30,30
1650679108108,MATH 142A,A02,083220,Chow; Bennett,0,15,30,30
1650679108108,MATH 142A,B01,083221,Chow; Bennett,0,13,30,30
1650679108108,MATH 142A,B02,083222,Chow; Bennett,0,14,30,30
1650679114137,MATH 193A,A01,083224,Staff,0,5,30,30
1650679114137,MATH 193A,A02,083225,Staff,0,6,30,30
1650679114137,MATH 193A,A03,083781,Staff,0,6,30,30
1650679114137,MATH 193A,A04,083782,Staff,0,7,30,30
1650679120160,MATH 197,001,091859,McAuley; Julian John,9998,0,9999,1
1650679126219,COGS 9,A01,083615,Staff,1,16,60,59
1650679132251,COGS 11,A01,083617,Boyle; Mary E. T.,18,0,40,22
1650679138278,COGS 13,A01,083071,Staff,0,38,40,40
1650679144304,COGS 14A,A01,092681,Staff,0,34,100,100
1650679150328,COGS 14B,A01,083073,Cheng; Tzu-Han,1,14,50,49
1650679156351,COGS 17,A01,092677,Staff,15,0,75,60
1650679162374,COGS 100,A01,083619,Staff,0,29,60,60
1650679168399,COGS 101A,A01,083621,Davis; Joshua Daniel,0,27,60,60
1650679174425,COGS 101B,A01,091572,Staff,0,4,60,60
1650679180448,COGS 101C,A01,083625,Delgado; Tania,14,0,30,16
1650679186477,COGS 107A,A01,083627,Boyle; Mary E. T.,1,17,60,59
1650679192501,COGS 118A,A01,083075,Staff,0,7,60,60
1650679198527,CSE 3,A50,083646,Miranda; Gregory Joseph,18,0,38,20
1650679198527,CSE 3,A51,083647,Miranda; Gregory Joseph,36,0,37,1
1650679204549,CSE 8A,A50,083650,Miranda; Gregory Joseph,0,30,40,40
1650679210578,CSE 11,A01,083080,Cao; Yingjun,0,95,40,40
1650679216603,CSE 12,A01,083652,Staff,0,21,100,100
1650679222625,CSE 15L,A01,083654,Staff,0,3,50,50
1650679222625,CSE 15L,A02,083655,Staff,0,2,50,50
1650679228652,CSE 20,A01,083657,Staff,50,0,80,30
1650679234676,CSE 30,A01,083084,Eldon; John,0,78,40,40
1650679240702,CSE 100,A01,083659,Cao; Yingjun,0,70,50,50
1650679246729,CSE 134B,A01,083661,Powell; Thomas Allan,0,38,65,65
1650679252762,CSE 140,A01,083663,Staff,0,10,75,75
1650679258786,CSE 140L,A01,083088,Eldon; John,0,18,75,75
1650679264816,CSE 175,A01,083665,Kumar; Rakesh,7,0,25,18
1650679270842,CSE 190,A00,092507,Dubnov; Shlomo,10,0,20,10
1650679276866,ECE 45,A01,083139,Staff,0,2,60,60
1650679282890,ECE 65,A50,083695,Staff,0,5,30,30
1650679288918,ECE 109,A01,091882,Touri; Behrouz,33,0,70,37
1650679294940,ECE 180,A00,083140,Abi Samra; Nicholas Camill,20,0,30,10
1650679294940,ECE 180,B00,083141,Abi Samra; Nicholas Camill,0,0,30,30
1650679300964,MATH 10A,A01,083735,Patchell; Gregory David,3,0,30,27
1650679300964,MATH 10A,A02,083736,Patchell; Gregory David,27,0,30,3
1650679300964,MATH 10A,A03,083737,Patchell; Gregory David,24,0,30,6
1650679306988,MATH 10B,A01,083207,Staff,0,9,30,30
1650679306988,MATH 10B,A02,083208,Staff,1,8,30,29
1650679306988,MATH 10B,B01,083739,Staff,11,0,30,19
1650679306988,MATH 10B,B02,083740,Staff,28,0,30,2
1650679313011,MATH 18,A01,083743,Staff,0,0,30,30
1650679313011,MATH 18,A02,083744,Staff,23,0,30,7
1650679313011,MATH 18,A03,083745,Staff,21,0,30,9
1650679313011,MATH 18,A04,083746,Staff,26,0,30,4
1650679313011,MATH 18,B01,083748,Staff,0,15,30,30
1650679313011,MATH 18,B02,083749,Staff,0,12,30,30
1650679313011,MATH 18,B03,083750,Staff,0,12,30,30
1650679313011,MATH 18,B04,083751,Staff,0,12,30,30
1650679319036,MATH 20A,A01,083754,Staff,19,0,40,21
1650679325058,MATH 20B,A01,083756,Staff,0,11,30,30
1650679325058,MATH 20B,A02,083757,Staff,0,12,30,30
1650679331086,MATH 20C,A01,083760,Staff,0,16,30,30
1650679331086,MATH 20C,A02,083761,Staff,1,16,30,29
1650679331086,MATH 20C,B01,083762,Staff,10,0,30,20
1650679331086,MATH 20C,B02,083763,Staff,28,0,30,2
1650679337110,MATH 20D,A01,083765,Staff,2,1,30,28
1650679337110,MATH 20D,A02,083766,Staff,5,0,30,25
1650679337110,MATH 20D,A03,083767,Staff,24,0,30,6
1650679343136,MATH 20E,A01,083771,Staff,3,0,30,27
1650679343136,MATH 20E,A02,083772,Staff,16,0,30,14
1650679343136,MATH 20E,B01,083773,Staff,0,0,30,30
1650679343136,MATH 20E,B02,083774,Staff,9,0,30,21
1650679349161,MATH 103A,A01,083777,Staff,0,15,30,30
1650679349161,MATH 103A,A02,083778,Staff,0,15,30,30
1650679349161,MATH 103A,B01,083779,Staff,0,15,30,30
1650679349161,MATH 103A,B02,083780,Staff,0,14,30,30
1650679355185,MATH 105,A01,085443,Staff,0,22,30,30
1650679361211,MATH 109,A01,083213,Anzaldo; Leesa B,0,7,30,30
1650679361211,MATH 109,A02,083214,Anzaldo; Leesa B,0,7,30,30
1650679361211,MATH 109,B01,083215,Anzaldo; Leesa B,0,8,30,30
1650679361211,MATH 109,B02,083216,Anzaldo; Leesa B,0,6,30,30
1650679367328,MATH 142A,A01,083219,Chow; Bennett,0,16,30,30
1650679367328,MATH 142A,A02,083220,Chow; Bennett,0,15,30,30
1650679367328,MATH 142A,B01,083221,Chow; Bennett,0,13,30,30
1650679367328,MATH 142A,B02,083222,Chow; Bennett,0,14,30,30
1650679373356,MATH 193A,A01,083224,Staff,0,5,30,30
1650679373356,MATH 193A,A02,083225,Staff,0,6,30,30
1650679373356,MATH 193A,A03,083781,Staff,0,6,30,30
1650679373356,MATH 193A,A04,083782,Staff,0,7,30,30
1650679379383,MATH 197,001,091859,McAuley; Julian John,9998,0,9999,1
1650679385434,COGS 9,A01,083615,Staff,1,16,60,59
1650679391460,COGS 11,A01,083617,Boyle; Mary E. T.,18,0,40,22
1650679397483,COGS 13,A01,083071,Staff,0,38,40,40
1650679403509,COGS 14A,A01,092681,Staff,0,34,100,100
1650679409532,COGS 14B,A01,083073,Cheng; Tzu-Han,1,14,50,49
1650679415554,COGS 17,A01,092677,Staff,15,0,75,60
1650679421580,COGS 100,A01,083619,Staff,0,29,60,60
1650679427602,COGS 101A,A01,083621,Davis; Joshua Daniel,0,27,60,60
1650679433636,COGS 101B,A01,091572,Staff,0,4,60,60
1650679439661,COGS 101C,A01,083625,Delgado; Tania,14,0,30,16
1650679445685,COGS 107A,A01,083627,Boyle; Mary E. T.,1,17,60,59
1650679451711,COGS 118A,A01,083075,Staff,0,7,60,60
1650679457741,CSE 3,A50,083646,Miranda; Gregory Joseph,18,0,38,20
1650679457741,CSE 3,A51,083647,Miranda; Gregory Joseph,36,0,37,1
1650679463765,CSE 8A,A50,083650,Miranda; Gregory Joseph,0,30,40,40
1650679469792,CSE 11,A01,083080,Cao; Yingjun,0,95,40,40
1650679475824,CSE 12,A01,083652,Staff,0,21,100,100
1650679481851,CSE 15L,A01,083654,Staff,0,3,50,50
1650679481851,CSE 15L,A02,083655,Staff,0,2,50,50
1650679487896,CSE 20,A01,083657,Staff,50,0,80,30
1650679493923,CSE 30,A01,083084,Eldon; John,0,78,40,40
1650679499946,CSE 100,A01,083659,Cao; Yingjun,0,70,50,50
1650679505970,CSE 134B,A01,083661,Powell; Thomas Allan,0,38,65,65
1650679511997,CSE 140,A01,083663,Staff,0,10,75,75
1650679518021,CSE 140L,A01,083088,Eldon; John,0,18,75,75
1650679524045,CSE 175,A01,083665,Kumar; Rakesh,7,0,25,18
1650679530071,CSE 190,A00,092507,Dubnov; Shlomo,10,0,20,10
1650679536095,ECE 45,A01,083139,Staff,0,2,60,60
1650679542120,ECE 65,A50,083695,Staff,0,5,30,30
1650679548144,ECE 109,A01,091882,Touri; Behrouz,33,0,70,37
1650679554178,ECE 180,A00,083140,Abi Samra; Nicholas Camill,20,0,30,10
1650679554178,ECE 180,B00,083141,Abi Samra; Nicholas Camill,0,0,30,30
1650679560210,MATH 10A,A01,083735,Patchell; Gregory David,3,0,30,27
1650679560210,MATH 10A,A02,083736,Patchell; Gregory David,27,0,30,3
1650679560210,MATH 10A,A03,083737,Patchell; Gregory David,24,0,30,6
1650679566235,MATH 10B,A01,083207,Staff,0,9,30,30
1650679566235,MATH 10B,A02,083208,Staff,1,8,30,29
1650679566235,MATH 10B,B01,083739,Staff,11,0,30,19
1650679566235,MATH 10B,B02,083740,Staff,28,0,30,2
1650679572261,MATH 18,A01,083743,Staff,0,0,30,30
1650679572261,MATH 18,A02,083744,Staff,23,0,30,7
1650679572261,MATH 18,A03,083745,Staff,21,0,30,9
1650679572261,MATH 18,A04,083746,Staff,26,0,30,4
1650679572261,MATH 18,B01,083748,Staff,0,15,30,30
1650679572261,MATH 18,B02,083749,Staff,0,12,30,30
1650679572261,MATH 18,B03,083750,Staff,0,12,30,30
1650679572261,MATH 18,B04,083751,Staff,0,12,30,30
1650679578285,MATH 20A,A01,083754,Staff,19,0,40,21
1650679584310,MATH 20B,A01,083756,Staff,0,11,30,30
1650679584310,MATH 20B,A02,083757,Staff,0,12,30,30
1650679590339,MATH 20C,A01,083760,Staff,0,16,30,30
1650679590339,MATH 20C,A02,083761,Staff,1,16,30,29
1650679590339,MATH 20C,B01,083762,Staff,10,0,30,20
1650679590339,MATH 20C,B02,083763,Staff,28,0,30,2
1650679596365,MATH 20D,A01,083765,Staff,2,1,30,28
1650679596365,MATH 20D,A02,083766,Staff,5,0,30,25
1650679596365,MATH 20D,A03,083767,Staff,24,0,30,6
1650679602389,MATH 20E,A01,083771,Staff,3,0,30,27
1650679602389,MATH 20E,A02,083772,Staff,16,0,30,14
1650679602389,MATH 20E,B01,083773,Staff,0,0,30,30
1650679602389,MATH 20E,B02,083774,Staff,9,0,30,21
1650679608413,MATH 103A,A01,083777,Staff,0,15,30,30
1650679608413,MATH 103A,A02,083778,Staff,0,15,30,30
1650679608413,MATH 103A,B01,083779,Staff,0,15,30,30
1650679608413,MATH 103A,B02,083780,Staff,0,14,30,30
1650679614438,MATH 105,A01,085443,Staff,0,22,30,30
1650679620461,MATH 109,A01,083213,Anzaldo; Leesa B,0,7,30,30
1650679620461,MATH 109,A02,083214,Anzaldo; Leesa B,0,7,30,30
1650679620461,MATH 109,B01,083215,Anzaldo; Leesa B,0,8,30,30
1650679620461,MATH 109,B02,083216,Anzaldo; Leesa B,0,6,30,30
1650679626489,MATH 142A,A01,083219,Chow; Bennett,0,16,30,30
1650679626489,MATH 142A,A02,083220,Chow; Bennett,0,15,30,30
1650679626489,MATH 142A,B01,083221,Chow; Bennett,0,13,30,30
1650679626489,MATH 142A,B02,083222,Chow; Bennett,0,14,30,30
1650679632544,MATH 193A,A01,083224,Staff,0,5,30,30
1650679632544,MATH 193A,A02,083225,Staff,0,6,30,30
1650679632544,MATH 193A,A03,083781,Staff,0,6,30,30
1650679632544,MATH 193A,A04,083782,Staff,0,7,30,30
1650679638569,MATH 197,001,091859,McAuley; Julian John,9998,0,9999,1
1650679644627,COGS 9,A01,083615,Staff,1,16,60,59
1650679650652,COGS 11,A01,083617,Boyle; Mary E. T.,17,0,40,23
1650679656679,COGS 13,A01,083071,Staff,0,38,40,40
1650679662701,COGS 14A,A01,092681,Staff,0,34,100,100
1650679668726,COGS 14B,A01,083073,Cheng; Tzu-Han,1,14,50,49
1650679674751,COGS 17,A01,092677,Staff,15,0,75,60
1650679680775,COGS 100,A01,083619,Staff,0,29,60,60
1650679686801,COGS 101A,A01,083621,Davis; Joshua Daniel,0,27,60,60
1650679692829,COGS 101B,A01,091572,Staff,0,4,60,60
1650679698857,COGS 101C,A01,083625,Delgado; Tania,14,0,30,16
1650679704881,COGS 107A,A01,083627,Boyle; Mary E. T.,1,17,60,59
1650679710906,COGS 118A,A01,083075,Staff,0,7,60,60
1650679716933,CSE 3,A50,083646,Miranda; Gregory Joseph,18,0,38,20
1650679716933,CSE 3,A51,083647,Miranda; Gregory Joseph,36,0,37,1
1650679722959,CSE 8A,A50,083650,Miranda; Gregory Joseph,0,30,40,40
1650679728983,CSE 11,A01,083080,Cao; Yingjun,0,95,40,40
1650679735006,CSE 12,A01,083652,Staff,0,21,100,100
1650679741030,CSE 15L,A01,083654,Staff,0,3,50,50
1650679741030,CSE 15L,A02,083655,Staff,0,2,50,50
1650679747053,CSE 20,A01,083657,Staff,50,0,80,30
1650679753078,CSE 30,A01,083084,Eldon; John,0,78,40,40
1650679759100,CSE 100,A01,083659,Cao; Yingjun,0,70,50,50
1650679765125,CSE 134B,A01,083661,Powell; Thomas Allan,0,38,65,65
1650679771152,CSE 140,A01,083663,Staff,0,10,75,75
1650679777186,CSE 140L,A01,083088,Eldon; John,0,18,75,75
1650679783213,CSE 175,A01,083665,Kumar; Rakesh,7,0,25,18
1650679789237,CSE 190,A00,092507,Dubnov; Shlomo,10,0,20,10
1650679795264,ECE 45,A01,083139,Staff,0,2,60,60
1650679801288,ECE 65,A50,083695,Staff,0,5,30,30
1650679807314,ECE 109,A01,091882,Touri; Behrouz,33,0,70,37
1650679813336,ECE 180,A00,083140,Abi Samra; Nicholas Camill,20,0,30,10
1650679813336,ECE 180,B00,083141,Abi Samra; Nicholas Camill,0,0,30,30
1650679819364,MATH 10A,A01,083735,Patchell; Gregory David,3,0,30,27
1650679819364,MATH 10A,A02,083736,Patchell; Gregory David,27,0,30,3
1650679819364,MATH 10A,A03,083737,Patchell; Gregory David,24,0,30,6
1650679825389,MATH 10B,A01,083207,Staff,0,9,30,30
1650679825389,MATH 10B,A02,083208,Staff,1,8,30,29
1650679825389,MATH 10B,B01,083739,Staff,11,0,30,19
1650679825389,MATH 10B,B02,083740,Staff,28,0,30,2
1650679831412,MATH 18,A01,083743,Staff,0,0,30,30
1650679831412,MATH 18,A02,083744,Staff,23,0,30,7
1650679831412,MATH 18,A03,083745,Staff,21,0,30,9
1650679831412,MATH 18,A04,083746,Staff,26,0,30,4
1650679831412,MATH 18,B01,083748,Staff,0,15,30,30
1650679831412,MATH 18,B02,083749,Staff,0,12,30,30
1650679831412,MATH 18,B03,083750,Staff,0,12,30,30
1650679831412,MATH 18,B04,083751,Staff,0,12,30,30
1650679837438,MATH 20A,A01,083754,Staff,19,0,40,21
1650679843463,MATH 20B,A01,083756,Staff,0,11,30,30
1650679843463,MATH 20B,A02,083757,Staff,0,12,30,30
1650679849493,MATH 20C,A01,083760,Staff,0,16,30,30
1650679849493,MATH 20C,A02,083761,Staff,1,16,30,29
1650679849493,MATH 20C,B01,083762,Staff,10,0,30,20
1650679849493,MATH 20C,B02,083763,Staff,28,0,30,2
1650679855516,MATH 20D,A01,083765,Staff,2,1,30,28
1650679855516,MATH 20D,A02,083766,Staff,5,0,30,25
1650679855516,MATH 20D,A03,083767,Staff,24,0,30,6
1650679861566,MATH 20E,A01,083771,Staff,3,0,30,27
1650679861566,MATH 20E,A02,083772,Staff,16,0,30,14
1650679861566,MATH 20E,B01,083773,Staff,0,0,30,30
1650679861566,MATH 20E,B02,083774,Staff,9,0,30,21
1650679867595,MATH 103A,A01,083777,Staff,0,15,30,30
1650679867595,MATH 103A,A02,083778,Staff,0,15,30,30
1650679867595,MATH 103A,B01,083779,Staff,0,15,30,30
1650679867595,MATH 103A,B02,083780,Staff,0,14,30,30
1650679873620,MATH 105,A01,085443,Staff,0,22,30,30
1650679886391,MATH 109,A01,083213,Anzaldo; Leesa B,0,7,30,30
1650679886391,MATH 109,A02,083214,Anzaldo; Leesa B,0,7,30,30
1650679886391,MATH 109,B01,083215,Anzaldo; Leesa B,0,8,30,30
1650679886391,MATH 109,B02,083216,Anzaldo; Leesa B,0,6,30,30
1650679892419,MATH 142A,A01,083219,Chow; Bennett,0,16,30,30
1650679892419,MATH 142A,A02,083220,Chow; Bennett,0,15,30,30
1650679892419,MATH 142A,B01,083221,Chow; Bennett,0,13,30,30
1650679892419,MATH 142A,B02,083222,Chow; Bennett,0,14,30,30
1650679898442,MATH 193A,A01,083224,Staff,0,5,30,30
1650679898442,MATH 193A,A02,083225,Staff,0,6,30,30
1650679898442,MATH 193A,A03,083781,Staff,0,6,30,30
1650679898442,MATH 193A,A04,083782,Staff,0,7,30,30
1650679904464,MATH 197,001,091859,McAuley; Julian John,9998,0,9999,1
1650679910521,COGS 9,A01,083615,Staff,1,16,60,59
1650679916574,COGS 11,A01,083617,Boyle; Mary E. T.,17,0,40,23
1650679922601,COGS 13,A01,083071,Staff,0,38,40,40
1650679928637,COGS 14A,A01,092681,Staff,0,34,100,100
1650679934661,COGS 14B,A01,083073,Cheng; Tzu-Han,1,14,50,49
1650679940685,COGS 17,A01,092677,Staff,15,0,75,60
1650679946711,COGS 100,A01,083619,Staff,0,29,60,60
1650679952743,COGS 101A,A01,083621,Davis; Joshua Daniel,0,27,60,60
1650679958766,COGS 101B,A01,091572,Staff,0,4,60,60
1650679964881,COGS 101C,A01,083625,Delgado; Tania,14,0,30,16
1650679970905,COGS 107A,A01,083627,Boyle; Mary E. T.,1,17,60,59
1650679976931,COGS 118A,A01,083075,Staff,0,7,60,60
1650679982958,CSE 3,A50,083646,Miranda; Gregory Joseph,18,0,38,20
1650679982958,CSE 3,A51,083647,Miranda; Gregory Joseph,36,0,37,1
1650679988986,CSE 8A,A50,083650,Miranda; Gregory Joseph,0,30,40,40
1650679995007,CSE 11,A01,083080,Cao; Yingjun,0,95,40,40
1650680001035,CSE 12,A01,083652,Staff,0,21,100,100
1650680007059,CSE 15L,A01,083654,Staff,0,3,50,50
1650680007059,CSE 15L,A02,083655,Staff,0,2,50,50
1650680013082,CSE 20,A01,083657,Staff,49,0,80,31
1650680019106,CSE 30,A01,083084,Eldon; John,0,78,40,40
1650680025131,CSE 100,A01,083659,Cao; Yingjun,0,70,50,50
1650680031159,CSE 134B,A01,083661,Powell; Thomas Allan,0,38,65,65
1650680037189,CSE 140,A01,083663,Staff,0,10,75,75
1650680043213,CSE 140L,A01,083088,Eldon; John,0,18,75,75
1650680049265,CSE 175,A01,083665,Kumar; Rakesh,7,0,25,18
1650680055290,CSE 190,A00,092507,Dubnov; Shlomo,10,0,20,10
1650680061318,ECE 45,A01,083139,Staff,0,2,60,60
1650680067349,ECE 65,A50,083695,Staff,0,5,30,30
1650680073371,ECE 109,A01,091882,Touri; Behrouz,33,0,70,37
1650680079393,ECE 180,A00,083140,Abi Samra; Nicholas Camill,20,0,30,10
1650680079393,ECE 180,B00,083141,Abi Samra; Nicholas Camill,0,0,30,30
1650680085427,MATH 10A,A01,083735,Patchell; Gregory David,3,0,30,27
1650680085427,MATH 10A,A02,083736,Patchell; Gregory David,27,0,30,3
1650680085427,MATH 10A,A03,083737,Patchell; Gregory David,24,0,30,6
1650680091455,MATH 10B,A01,083207,Staff,0,9,30,30
1650680091455,MATH 10B,A02,083208,Staff,1,8,30,29
1650680091455,MATH 10B,B01,083739,Staff,11,0,30,19
1650680091455,MATH 10B,B02,083740,Staff,28,0,30,2
1650680097483,MATH 18,A01,083743,Staff,0,0,30,30
1650680097483,MATH 18,A02,083744,Staff,23,0,30,7
1650680097483,MATH 18,A03,083745,Staff,21,0,30,9
1650680097483,MATH 18,A04,083746,Staff,26,0,30,4
1650680097483,MATH 18,B01,083748,Staff,0,15,30,30
1650680097483,MATH 18,B02,083749,Staff,0,12,30,30
1650680097483,MATH 18,B03,083750,Staff,0,12,30,30
1650680097483,MATH 18,B04,083751,Staff,0,12,30,30
1650680103505,MATH 20A,A01,083754,Staff,19,0,40,21
1650680109530,MATH 20B,A01,083756,Staff,0,11,30,30
1650680109530,MATH 20B,A02,083757,Staff,0,12,30,30
1650680115578,MATH 20C,A01,083760,Staff,0,16,30,30
1650680115578,MATH 20C,A02,083761,Staff,1,16,30,29
1650680115578,MATH 20C,B01,083762,Staff,10,0,30,20
1650680115578,MATH 20C,B02,083763,Staff,28,0,30,2
1650680121603,MATH 20D,A01,083765,Staff,2,1,30,28
1650680121603,MATH 20D,A02,083766,Staff,5,0,30,25
1650680121603,MATH 20D,A03,083767,Staff,24,0,30,6
1650680127626,MATH 20E,A01,083771,Staff,3,0,30,27
1650680127626,MATH 20E,A02,083772,Staff,16,0,30,14
1650680127626,MATH 20E,B01,083773,Staff,0,0,30,30
1650680127626,MATH 20E,B02,083774,Staff,9,0,30,21
1650680133656,MATH 103A,A01,083777,Staff,0,15,30,30
1650680133656,MATH 103A,A02,083778,Staff,0,15,30,30
1650680133656,MATH 103A,B01,083779,Staff,0,15,30,30
1650680133656,MATH 103A,B02,083780,Staff,0,14,30,30
1650680139679,MATH 105,A01,085443,Staff,0,22,30,30
1650680145712,MATH 109,A01,083213,Anzaldo; Leesa B,0,7,30,30
1650680145712,MATH 109,A02,083214,Anzaldo; Leesa B,0,7,30,30
1650680145712,MATH 109,B01,083215,Anzaldo; Leesa B,0,8,30,30
1650680145712,MATH 109,B02,083216,Anzaldo; Leesa B,0,6,30,30
1650680151737,MATH 142A,A01,083219,Chow; Bennett,0,16,30,30
1650680151737,MATH 142A,A02,083220,Chow; Bennett,0,15,30,30
1650680151737,MATH 142A,B01,083221,Chow; Bennett,0,13,30,30
1650680151737,MATH 142A,B02,083222,Chow; Bennett,0,14,30,30
1650680157760,MATH 193A,A01,083224,Staff,0,5,30,30
1650680157760,MATH 193A,A02,083225,Staff,0,6,30,30
1650680157760,MATH 193A,A03,083781,Staff,0,6,30,30
1650680157760,MATH 193A,A04,083782,Staff,0,7,30,30
1650680163798,MATH 197,001,091859,McAuley; Julian John,9998,0,9999,1
1650680169849,COGS 9,A01,083615,Staff,1,16,60,59
1650680175872,COGS 11,A01,083617,Boyle; Mary E. T.,17,0,40,23
1650680181900,COGS 13,A01,083071,Staff,0,38,40,40
1650680187923,COGS 14A,A01,092681,Staff,0,34,100,100
1650680193948,COGS 14B,A01,083073,Cheng; Tzu-Han,1,14,50,49
1650680199970,COGS 17,A01,092677,Staff,15,0,75,60
1650680205993,COGS 100,A01,083619,Staff,0,29,60,60
1650680212020,COGS 101A,A01,083621,Davis; Joshua Daniel,0,27,60,60
1650680218045,COGS 101B,A01,091572,Staff,0,4,60,60
1650680224068,COGS 101C,A01,083625,Delgado; Tania,14,0,30,16
1650680230092,COGS 107A,A01,083627,Boyle; Mary E. T.,1,17,60,59
1650680236118,COGS 118A,A01,083075,Staff,0,7,60,60
1650680242153,CSE 3,A50,083646,Miranda; Gregory Joseph,18,0,38,20
1650680242153,CSE 3,A51,083647,Miranda; Gregory Joseph,36,0,37,1
1650680248177,CSE 8A,A50,083650,Miranda; Gregory Joseph,0,30,40,40
1650680254203,CSE 11,A01,083080,Cao; Yingjun,0,95,40,40
1650680260233,CSE 12,A01,083652,Staff,0,21,100,100
1650680266256,CSE 15L,A01,083654,Staff,0,3,50,50
1650680266256,CSE 15L,A02,083655,Staff,0,2,50,50
1650680272278,CSE 20,A01,083657,Staff,49,0,80,31
1650680278302,CSE 30,A01,083084,Eldon; John,0,78,40,40
1650680284333,CSE 100,A01,083659,Cao; Yingjun,0,70,50,50
1650680290372,CSE 134B,A01,083661,Powell; Thomas Allan,0,38,65,65
1650680296397,CSE 140,A01,083663,Staff,0,10,75,75
1650680302420,CSE 140L,A01,083088,Eldon; John,0,18,75,75
1650680308444,CSE 175,A01,083665,Kumar; Rakesh,7,0,25,18
1650680314468,CSE 190,A00,092507,Dubnov; Shlomo,10,0,20,10
1650680320498,ECE 45,A01,083139,Staff,0,2,60,60
1650680326525,ECE 65,A50,083695,Staff,0,5,30,30
1650680332550,ECE 109,A01,091882,Touri; Behrouz,33,0,70,37
1650680338571,ECE 180,A00,083140,Abi Samra; Nicholas Camill,20,0,30,10
1650680338571,ECE 180,B00,083141,Abi Samra; Nicholas Camill,0,0,30,30
1650680344598,MATH 10A,A01,083735,Patchell; Gregory David,3,0,30,27
1650680344598,MATH 10A,A02,083736,Patchell; Gregory David,27,0,30,3
1650680344598,MATH 10A,A03,083737,Patchell; Gregory David,24,0,30,6
1650680350628,MATH 10B,A01,083207,Staff,0,9,30,30
1650680350628,MATH 10B,A02,083208,Staff,1,8,30,29
1650680350628,MATH 10B,B01,083739,Staff,11,0,30,19
1650680350628,MATH 10B,B02,083740,Staff,28,0,30,2
1650680356655,MATH 18,A01,083743,Staff,0,0,30,30
1650680356655,MATH 18,A02,083744,Staff,23,0,30,7
1650680356655,MATH 18,A03,083745,Staff,21,0,30,9
1650680356655,MATH 18,A04,083746,Staff,26,0,30,4
1650680356655,MATH 18,B01,083748,Staff,0,15,30,30
1650680356655,MATH 18,B02,083749,Staff,0,12,30,30
1650680356655,MATH 18,B03,083750,Staff,0,12,30,30
1650680356655,MATH 18,B04,083751,Staff,0,12,30,30
1650680362681,MATH 20A,A01,083754,Staff,19,0,40,21
1650680368708,MATH 20B,A01,083756,Staff,0,11,30,30
1650680368708,MATH 20B,A02,083757,Staff,0,12,30,30
1650680374732,MATH 20C,A01,083760,Staff,0,16,30,30
1650680374732,MATH 20C,A02,083761,Staff,1,16,30,29
1650680374732,MATH 20C,B01,083762,Staff,10,0,30,20
1650680374732,MATH 20C,B02,083763,Staff,28,0,30,2
1650680380757,MATH 20D,A01,083765,Staff,2,1,30,28
1650680380757,MATH 20D,A02,083766,Staff,6,0,30,24
1650680380757,MATH 20D,A03,083767,Staff,24,0,30,6
1650680386789,MATH 20E,A01,083771,Staff,3,0,30,27
1650680386789,MATH 20E,A02,083772,Staff,16,0,30,14
1650680386789,MATH 20E,B01,083773,Staff,0,0,30,30
1650680386789,MATH 20E,B02,083774,Staff,9,0,30,21
1650680392818,MATH 103A,A01,083777,Staff,0,15,30,30
1650680392818,MATH 103A,A02,083778,Staff,0,15,30,30
1650680392818,MATH 103A,B01,083779,Staff,0,15,30,30
1650680392818,MATH 103A,B02,083780,Staff,0,14,30,30
1650680398842,MATH 105,A01,085443,Staff,0,22,30,30
1650680404874,MATH 109,A01,083213,Anzaldo; Leesa B,0,7,30,30
1650680404874,MATH 109,A02,083214,Anzaldo; Leesa B,0,7,30,30
1650680404874,MATH 109,B01,083215,Anzaldo; Leesa B,0,8,30,30
1650680404874,MATH 109,B02,083216,Anzaldo; Leesa B,0,6,30,30
1650680410902,MATH 142A,A01,083219,Chow; Bennett,0,16,30,30
1650680410902,MATH 142A,A02,083220,Chow; Bennett,0,15,30,30
1650680410902,MATH 142A,B01,083221,Chow; Bennett,0,13,30,30
1650680410902,MATH 142A,B02,083222,Chow; Bennett,0,14,30,30
1650680416930,MATH 193A,A01,083224,Staff,0,5,30,30
1650680416930,MATH 193A,A02,083225,Staff,0,6,30,30
1650680416930,MATH 193A,A03,083781,Staff,0,6,30,30
1650680416930,MATH 193A,A04,083782,Staff,0,7,30,30
1650680422957,MATH 197,001,091859,McAuley; Julian John,9998,0,9999,1
1650680429024,COGS 9,A01,083615,Staff,1,16,60,59
1650680435049,COGS 11,A01,083617,Boyle; Mary E. T.,17,0,40,23
1650680441076,COGS 13,A01,083071,Staff,0,38,40,40
1650680447101,COGS 14A,A01,092681,Staff,0,34,100,100
1650680453125,COGS 14B,A01,083073,Cheng; Tzu-Han,1,14,50,49
1650680459149,COGS 17,A01,092677,Staff,15,0,75,60
1650680465176,COGS 100,A01,083619,Staff,0,29,60,60
1650680471205,COGS 101A,A01,083621,Davis; Joshua Daniel,0,27,60,60
1650680477231,COGS 101B,A01,091572,Staff,0,4,60,60
1650680483259,COGS 101C,A01,083625,Delgado; Tania,14,0,30,16
1650680489287,COGS 107A,A01,083627,Boyle; Mary E. T.,1,17,60,59
1650680495317,COGS 118A,A01,083075,Staff,0,7,60,60
1650680501346,CSE 3,A50,083646,Miranda; Gregory Joseph,18,0,38,20
1650680501346,CSE 3,A51,083647,Miranda; Gregory Joseph,36,0,37,1
1650680507369,CSE 8A,A50,083650,Miranda; Gregory Joseph,0,30,40,40
1650680513400,CSE 11,A01,083080,Cao; Yingjun,0,95,40,40
1650680519425,CSE 12,A01,083652,Staff,0,21,100,100
1650680525452,CSE 15L,A01,083654,Staff,0,3,50,50
1650680525452,CSE 15L,A02,083655,Staff,0,2,50,50
1650680531479,CSE 20,A01,083657,Staff,49,0,80,31
1650680537508,CSE 30,A01,083084,Eldon; John,0,78,40,40
1650680543533,CSE 100,A01,083659,Cao; Yingjun,0,70,50,50
1650680549561,CSE 134B,A01,083661,Powell; Thomas Allan,0,38,65,65
1650680555588,CSE 140,A01,083663,Staff,0,10,75,75
1650680561711,CSE 140L,A01,083088,Eldon; John,0,18,75,75
1650680567734,CSE 175,A01,083665,Kumar; Rakesh,7,0,25,18
1650680573758,CSE 190,A00,092507,Dubnov; Shlomo,10,0,20,10
1650680579787,ECE 45,A01,083139,Staff,0,2,60,60
1650680585810,ECE 65,A50,083695,Staff,0,5,30,30
1650680591834,ECE 109,A01,091882,Touri; Behrouz,33,0,70,37
1650680597860,ECE 180,A00,083140,Abi Samra; Nicholas Camill,20,0,30,10
1650680597860,ECE 180,B00,083141,Abi Samra; Nicholas Camill,0,0,30,30
1650680603884,MATH 10A,A01,083735,Patchell; Gregory David,3,0,30,27
1650680603884,MATH 10A,A02,083736,Patchell; Gregory David,27,0,30,3
1650680603884,MATH 10A,A03,083737,Patchell; Gregory David,24,0,30,6
1650680609911,MATH 10B,A01,083207,Staff,0,9,30,30
1650680609911,MATH 10B,A02,083208,Staff,1,8,30,29
1650680609911,MATH 10B,B01,083739,Staff,11,0,30,19
1650680609911,MATH 10B,B02,083740,Staff,28,0,30,2
1650680615944,MATH 18,A01,083743,Staff,0,0,30,30
1650680615944,MATH 18,A02,083744,Staff,23,0,30,7
1650680615944,MATH 18,A03,083745,Staff,21,0,30,9
1650680615944,MATH 18,A04,083746,Staff,26,0,30,4
1650680615944,MATH 18,B01,083748,Staff,0,15,30,30
1650680615944,MATH 18,B02,083749,Staff,0,12,30,30
1650680615944,MATH 18,B03,083750,Staff,0,12,30,30
1650680615944,MATH 18,B04,083751,Staff,0,12,30,30
1650680621968,MATH 20A,A01,083754,Staff,19,0,40,21
1650680627993,MATH 20B,A01,083756,Staff,0,11,30,30
1650680627993,MATH 20B,A02,083757,Staff,0,12,30,30
1650680634022,MATH 20C,A01,083760,Staff,0,16,30,30
1650680634022,MATH 20C,A02,083761,Staff,1,16,30,29
1650680634022,MATH 20C,B01,083762,Staff,10,0,30,20
1650680634022,MATH 20C,B02,083763,Staff,28,0,30,2
1650680640046,MATH 20D,A01,083765,Staff,2,1,30,28
1650680640046,MATH 20D,A02,083766,Staff,6,0,30,24
1650680640046,MATH 20D,A03,083767,Staff,24,0,30,6
1650680646076,MATH 20E,A01,083771,Staff,3,0,30,27
1650680646076,MATH 20E,A02,083772,Staff,16,0,30,14
1650680646076,MATH 20E,B01,083773,Staff,0,0,30,30
1650680646076,MATH 20E,B02,083774,Staff,9,0,30,21
1650680652099,MATH 103A,A01,083777,Staff,0,15,30,30
1650680652099,MATH 103A,A02,083778,Staff,0,15,30,30
1650680652099,MATH 103A,B01,083779,Staff,0,15,30,30
1650680652099,MATH 103A,B02,083780,Staff,0,14,30,30
1650680658127,MATH 105,A01,085443,Staff,0,22,30,30
1650680664155,MATH 109,A01,083213,Anzaldo; Leesa B,0,7,30,30
1650680664155,MATH 109,A02,083214,Anzaldo; Leesa B,0,7,30,30
1650680664155,MATH 109,B01,083215,Anzaldo; Leesa B,0,8,30,30
1650680664155,MATH 109,B02,083216,Anzaldo; Leesa B,0,6,30,30
1650680670179,MATH 142A,A01,083219,Chow; Bennett,0,16,30,30
1650680670179,MATH 142A,A02,083220,Chow; Bennett,0,15,30,30
1650680670179,MATH 142A,B01,083221,Chow; Bennett,0,13,30,30
1650680670179,MATH 142A,B02,083222,Chow; Bennett,0,14,30,30
1650680676202,MATH 193A,A01,083224,Staff,0,5,30,30
1650680676202,MATH 193A,A02,083225,Staff,0,6,30,30
1650680676202,MATH 193A,A03,083781,Staff,0,6,30,30
1650680676202,MATH 193A,A04,083782,Staff,0,7,30,30
1650680682226,MATH 197,001,091859,McAuley; Julian John,9998,0,9999,1
1650680688286,COGS 9,A01,083615,Staff,1,16,60,59
1650680694313,COGS 11,A01,083617,Boyle; Mary E. T.,16,0,40,24
1650680700340,COGS 13,A01,083071,Staff,0,38,40,40
1650680706372,COGS 14A,A01,092681,Staff,0,34,100,100
1650680712397,COGS 14B,A01,083073,Cheng; Tzu-Han,1,14,50,49
1650680718427,COGS 17,A01,092677,Staff,15,0,75,60
1650680724449,COGS 100,A01,083619,Staff,0,29,60,60
1650680730476,COGS 101A,A01,083621,Davis; Joshua Daniel,0,27,60,60
1650680736497,COGS 101B,A01,091572,Staff,0,4,60,60
1650680742520,COGS 101C,A01,083625,Delgado; Tania,14,0,30,16
1650680748544,COGS 107A,A01,083627,Boyle; Mary E. T.,1,17,60,59
1650680754570,COGS 118A,A01,083075,Staff,0,7,60,60
1650680760598,CSE 3,A50,083646,Miranda; Gregory Joseph,18,0,38,20
1650680760598,CSE 3,A51,083647,Miranda; Gregory Joseph,36,0,37,1
1650680766623,CSE 8A,A50,083650,Miranda; Gregory Joseph,0,30,40,40
1650680772646,CSE 11,A01,083080,Cao; Yingjun,0,95,40,40
1650680778674,CSE 12,A01,083652,Staff,0,21,100,100
1650680784697,CSE 15L,A01,083654,Staff,0,3,50,50
1650680784697,CSE 15L,A02,083655,Staff,0,2,50,50
1650680790721,CSE 20,A01,083657,Staff,49,0,80,31
1650680796743,CSE 30,A01,083084,Eldon; John,0,78,40,40
1650680802775,CSE 100,A01,083659,Cao; Yingjun,0,70,50,50
1650680808800,CSE 134B,A01,083661,Powell; Thomas Allan,0,38,65,65
1650680814826,CSE 140,A01,083663,Staff,0,10,75,75
1650680820853,CSE 140L,A01,083088,Eldon; John,0,18,75,75
1650680826879,CSE 175,A01,083665,Kumar; Rakesh,7,0,25,18
1650680832904,CSE 190,A00,092507,Dubnov; Shlomo,10,0,20,10
1650680838929,ECE 45,A01,083139,Staff,0,2,60,60
1650680844953,ECE 65,A50,083695,Staff,0,5,30,30
1650680850975,ECE 109,A01,091882,Touri; Behrouz,33,0,70,37
1650680857006,ECE 180,A00,083140,Abi Samra; Nicholas Camill,20,0,30,10
1650680857006,ECE 180,B00,083141,Abi Samra; Nicholas Camill,0,0,30,30
1650680863030,MATH 10A,A01,083735,Patchell; Gregory David,3,0,30,27
1650680863030,MATH 10A,A02,083736,Patchell; Gregory David,27,0,30,3
1650680863030,MATH 10A,A03,083737,Patchell; Gregory David,24,0,30,6
1650680869058,MATH 10B,A01,083207,Staff,0,9,30,30
1650680869058,MATH 10B,A02,083208,Staff,1,8,30,29
1650680869058,MATH 10B,B01,083739,Staff,11,0,30,19
1650680869058,MATH 10B,B02,083740,Staff,28,0,30,2
1650680875085,MATH 18,A01,083743,Staff,0,0,30,30
1650680875085,MATH 18,A02,083744,Staff,23,0,30,7
1650680875085,MATH 18,A03,083745,Staff,21,0,30,9
1650680875085,MATH 18,A04,083746,Staff,26,0,30,4
1650680875085,MATH 18,B01,083748,Staff,0,15,30,30
1650680875085,MATH 18,B02,083749,Staff,0,12,30,30
1650680875085,MATH 18,B03,083750,Staff,0,12,30,30
1650680875085,MATH 18,B04,083751,Staff,0,12,30,30
1650680881116,MATH 20A,A01,083754,Staff,19,0,40,21
1650680887140,MATH 20B,A01,083756,Staff,0,11,30,30
1650680887140,MATH 20B,A02,083757,Staff,0,12,30,30
1650680893171,MATH 20C,A01,083760,Staff,0,16,30,30
1650680893171,MATH 20C,A02,083761,Staff,1,16,30,29
1650680893171,MATH 20C,B01,083762,Staff,10,0,30,20
1650680893171,MATH 20C,B02,083763,Staff,28,0,30,2
1650680899196,MATH 20D,A01,083765,Staff,2,1,30,28
1650680899196,MATH 20D,A02,083766,Staff,6,0,30,24
1650680899196,MATH 20D,A03,083767,Staff,24,0,30,6
1650680905227,MATH 20E,A01,083771,Staff,3,0,30,27
1650680905227,MATH 20E,A02,083772,Staff,16,0,30,14
1650680905227,MATH 20E,B01,083773,Staff,0,0,30,30
1650680905227,MATH 20E,B02,083774,Staff,9,0,30,21
1650680911256,MATH 103A,A01,083777,Staff,0,15,30,30
1650680911256,MATH 103A,A02,083778,Staff,0,15,30,30
1650680911256,MATH 103A,B01,083779,Staff,0,15,30,30
1650680911256,MATH 103A,B02,083780,Staff,0,14,30,30
1650680917282,MATH 105,A01,085443,Staff,0,22,30,30
1650680923319,MATH 109,A01,083213,Anzaldo; Leesa B,0,7,30,30
1650680923319,MATH 109,A02,083214,Anzaldo; Leesa B,0,7,30,30
1650680923319,MATH 109,B01,083215,Anzaldo; Leesa B,0,8,30,30
1650680923319,MATH 109,B02,083216,Anzaldo; Leesa B,0,6,30,30
1650680929343,MATH 142A,A01,083219,Chow; Bennett,0,16,30,30
1650680929343,MATH 142A,A02,083220,Chow; Bennett,0,15,30,30
1650680929343,MATH 142A,B01,083221,Chow; Bennett,0,13,30,30
1650680929343,MATH 142A,B02,083222,Chow; Bennett,0,14,30,30
1650680935366,MATH 193A,A01,083224,Staff,0,5,30,30
1650680935366,MATH 193A,A02,083225,Staff,0,6,30,30
1650680935366,MATH 193A,A03,083781,Staff,0,6,30,30
1650680935366,MATH 193A,A04,083782,Staff,0,7,30,30
1650680941390,MATH 197,001,091859,McAuley; Julian John,9998,0,9999,1
1650680947448,COGS 9,A01,083615,Staff,1,16,60,59
1650680953475,COGS 11,A01,083617,Boyle; Mary E. T.,16,0,40,24
1650680959499,COGS 13,A01,083071,Staff,0,38,40,40
1650680965526,COGS 14A,A01,092681,Staff,0,34,100,100
1650680971556,COGS 14B,A01,083073,Cheng; Tzu-Han,1,14,50,49
1650680977579,COGS 17,A01,092677,Staff,15,0,75,60
1650680983629,COGS 100,A01,083619,Staff,0,29,60,60
1650680989654,COGS 101A,A01,083621,Davis; Joshua Daniel,0,27,60,60
1650680995684,COGS 101B,A01,091572,Staff,0,4,60,60
1650681001711,COGS 101C,A01,083625,Delgado; Tania,14,0,30,16
1650681007735,COGS 107A,A01,083627,Boyle; Mary E. T.,1,17,60,59
1650681013757,COGS 118A,A01,083075,Staff,0,7,60,60
1650681019783,CSE 3,A50,083646,Miranda; Gregory Joseph,18,0,38,20
1650681019783,CSE 3,A51,083647,Miranda; Gregory Joseph,36,0,37,1
1650681025810,CSE 8A,A50,083650,Miranda; Gregory Joseph,0,30,40,40
1650681031831,CSE 11,A01,083080,Cao; Yingjun,0,95,40,40
1650681037855,CSE 12,A01,083652,Staff,0,21,100,100
1650681043878,CSE 15L,A01,083654,Staff,0,3,50,50
1650681043878,CSE 15L,A02,083655,Staff,0,2,50,50
1650681049905,CSE 20,A01,083657,Staff,49,0,80,31
1650681055940,CSE 30,A01,083084,Eldon; John,0,78,40,40
1650681061967,CSE 100,A01,083659,Cao; Yingjun,0,70,50,50
1650681067998,CSE 134B,A01,083661,Powell; Thomas Allan,0,38,65,65
1650681074030,CSE 140,A01,083663,Staff,0,10,75,75
1650681080052,CSE 140L,A01,083088,Eldon; John,0,18,75,75
1650681086076,CSE 175,A01,083665,Kumar; Rakesh,7,0,25,18
1650681092100,CSE 190,A00,092507,Dubnov; Shlomo,10,0,20,10
1650681098125,ECE 45,A01,083139,Staff,0,2,60,60
1650681104152,ECE 65,A50,083695,Staff,0,5,30,30
1650681110175,ECE 109,A01,091882,Touri; Behrouz,33,0,70,37
1650681116204,ECE 180,A00,083140,Abi Samra; Nicholas Camill,20,0,30,10
1650681116204,ECE 180,B00,083141,Abi Samra; Nicholas Camill,0,0,30,30
1650681122232,MATH 10A,A01,083735,Patchell; Gregory David,3,0,30,27
1650681122232,MATH 10A,A02,083736,Patchell; Gregory David,27,0,30,3
1650681122232,MATH 10A,A03,083737,Patchell; Gregory David,24,0,30,6
1650681128256,MATH 10B,A01,083207,Staff,0,9,30,30
1650681128256,MATH 10B,A02,083208,Staff,1,8,30,29
1650681128256,MATH 10B,B01,083739,Staff,11,0,30,19
1650681128256,MATH 10B,B02,083740,Staff,28,0,30,2
1650681134281,MATH 18,A01,083743,Staff,0,0,30,30
1650681134281,MATH 18,A02,083744,Staff,23,0,30,7
1650681134281,MATH 18,A03,083745,Staff,21,0,30,9
1650681134281,MATH 18,A04,083746,Staff,26,0,30,4
1650681134281,MATH 18,B01,083748,Staff,0,15,30,30
1650681134281,MATH 18,B02,083749,Staff,0,12,30,30
1650681134281,MATH 18,B03,083750,Staff,0,12,30,30
1650681134281,MATH 18,B04,083751,Staff,0,12,30,30
1650681140314,MATH 20A,A01,083754,Staff,19,0,40,21
1650681146343,MATH 20B,A01,083756,Staff,0,11,30,30
1650681146343,MATH 20B,A02,083757,Staff,0,12,30,30
1650681152366,MATH 20C,A01,083760,Staff,0,16,30,30
1650681152366,MATH 20C,A02,083761,Staff,1,16,30,29
1650681152366,MATH 20C,B01,083762,Staff,10,0,30,20
1650681152366,MATH 20C,B02,083763,Staff,28,0,30,2
1650681158480,MATH 20D,A01,083765,Staff,2,1,30,28
1650681158480,MATH 20D,A02,083766,Staff,6,0,30,24
1650681158480,MATH 20D,A03,083767,Staff,24,0,30,6
1650681164504,MATH 20E,A01,083771,Staff,3,0,30,27
1650681164504,MATH 20E,A02,083772,Staff,16,0,30,14
1650681164504,MATH 20E,B01,083773,Staff,0,0,30,30
1650681164504,MATH 20E,B02,083774,Staff,9,0,30,21
1650681170529,MATH 103A,A01,083777,Staff,0,15,30,30
1650681170529,MATH 103A,A02,083778,Staff,0,15,30,30
1650681170529,MATH 103A,B01,083779,Staff,0,15,30,30
1650681170529,MATH 103A,B02,083780,Staff,0,14,30,30
1650681176553,MATH 105,A01,085443,Staff,0,22,30,30
1650681182578,MATH 109,A01,083213,Anzaldo; Leesa B,0,7,30,30
1650681182578,MATH 109,A02,083214,Anzaldo; Leesa B,0,7,30,30
1650681182578,MATH 109,B01,083215,Anzaldo; Leesa B,0,8,30,30
1650681182578,MATH 109,B02,083216,Anzaldo; Leesa B,0,6,30,30
1650681188607,MATH 142A,A01,083219,Chow; Bennett,0,16,30,30
1650681188607,MATH 142A,A02,083220,Chow; Bennett,0,15,30,30
1650681188607,MATH 142A,B01,083221,Chow; Bennett,0,13,30,30
1650681188607,MATH 142A,B02,083222,Chow; Bennett,0,14,30,30
1650681194635,MATH 193A,A01,083224,Staff,0,5,30,30
1650681194635,MATH 193A,A02,083225,Staff,0,6,30,30
1650681194635,MATH 193A,A03,083781,Staff,0,6,30,30
1650681194635,MATH 193A,A04,083782,Staff,0,7,30,30
1650681200659,MATH 197,001,091859,McAuley; Julian John,9998,0,9999,1
1650681206714,COGS 9,A01,083615,Staff,1,16,60,59
1650681212738,COGS 11,A01,083617,Boyle; Mary E. T.,16,0,40,24
1650681218761,COGS 13,A01,083071,Staff,0,38,40,40
1650681224795,COGS 14A,A01,092681,Staff,0,34,100,100
1650681230822,COGS 14B,A01,083073,Cheng; Tzu-Han,1,14,50,49
1650681236848,COGS 17,A01,092677,Staff,15,0,75,60
1650681242875,COGS 100,A01,083619,Staff,0,29,60,60
1650681248916,COGS 101A,A01,083621,Davis; Joshua Daniel,0,27,60,60
1650681254940,COGS 101B,A01,091572,Staff,0,4,60,60
1650681260964,COGS 101C,A01,083625,Delgado; Tania,14,0,30,16
1650681266987,COGS 107A,A01,083627,Boyle; Mary E. T.,1,17,60,59
1650681273013,COGS 118A,A01,083075,Staff,0,7,60,60
1650681279051,CSE 3,A50,083646,Miranda; Gregory Joseph,18,0,38,20
1650681279051,CSE 3,A51,083647,Miranda; Gregory Joseph,36,0,37,1
1650681285075,CSE 8A,A50,083650,Miranda; Gregory Joseph,0,30,40,40
1650681291101,CSE 11,A01,083080,Cao; Yingjun,0,95,40,40
1650681297128,CSE 12,A01,083652,Staff,0,21,100,100
1650681303154,CSE 15L,A01,083654,Staff,0,3,50,50
1650681303154,CSE 15L,A02,083655,Staff,0,2,50,50
1650681309181,CSE 20,A01,083657,Staff,49,0,80,31
1650681315204,CSE 30,A01,083084,Eldon; John,0,78,40,40
1650681321233,CSE 100,A01,083659,Cao; Yingjun,0,70,50,50
1650681327261,CSE 134B,A01,083661,Powell; Thomas Allan,0,38,65,65
1650681333288,CSE 140,A01,083663,Staff,0,10,75,75
1650681339314,CSE 140L,A01,083088,Eldon; John,0,18,75,75
1650681345338,CSE 175,A01,083665,Kumar; Rakesh,7,0,25,18
1650681351375,CSE 190,A00,092507,Dubnov; Shlomo,10,0,20,10
1650681357421,ECE 45,A01,083139,Staff,0,2,60,60
1650681363464,ECE 65,A50,083695,Staff,0,5,30,30
1650681369495,ECE 109,A01,091882,Touri; Behrouz,33,0,70,37
1650681375532,ECE 180,A00,083140,Abi Samra; Nicholas Camill,20,0,30,10
1650681375532,ECE 180,B00,083141,Abi Samra; Nicholas Camill,0,0,30,30
1650681381556,MATH 10A,A01,083735,Patchell; Gregory David,3,0,30,27
1650681381556,MATH 10A,A02,083736,Patchell; Gregory David,27,0,30,3
1650681381556,MATH 10A,A03,083737,Patchell; Gregory David,24,0,30,6
1650681387579,MATH 10B,A01,083207,Staff,0,9,30,30
1650681387579,MATH 10B,A02,083208,Staff,1,8,30,29
1650681387579,MATH 10B,B01,083739,Staff,11,0,30,19
1650681387579,MATH 10B,B02,083740,Staff,28,0,30,2
1650681393609,MATH 18,A01,083743,Staff,0,0,30,30
1650681393609,MATH 18,A02,083744,Staff,23,0,30,7
1650681393609,MATH 18,A03,083745,Staff,21,0,30,9
1650681393609,MATH 18,A04,083746,Staff,26,0,30,4
1650681393609,MATH 18,B01,083748,Staff,0,15,30,30
1650681393609,MATH 18,B02,083749,Staff,0,12,30,30
1650681393609,MATH 18,B03,083750,Staff,0,12,30,30
1650681393609,MATH 18,B04,083751,Staff,0,12,30,30
1650681399636,MATH 20A,A01,083754,Staff,19,0,40,21
1650681405659,MATH 20B,A01,083756,Staff,0,11,30,30
1650681405659,MATH 20B,A02,083757,Staff,0,12,30,30
1650681411686,MATH 20C,A01,083760,Staff,0,16,30,30
1650681411686,MATH 20C,A02,083761,Staff,1,16,30,29
1650681411686,MATH 20C,B01,083762,Staff,10,0,30,20
1650681411686,MATH 20C,B02,083763,Staff,28,0,30,2
1650681417713,MATH 20D,A01,083765,Staff,2,1,30,28
1650681417713,MATH 20D,A02,083766,Staff,6,0,30,24
1650681417713,MATH 20D,A03,083767,Staff,24,0,30,6
1650681423741,MATH 20E,A01,083771,Staff,3,0,30,27
1650681423741,MATH 20E,A02,083772,Staff,16,0,30,14
1650681423741,MATH 20E,B01,083773,Staff,0,0,30,30
1650681423741,MATH 20E,B02,083774,Staff,9,0,30,21
1650681429765,MATH 103A,A01,083777,Staff,0,15,30,30
1650681429765,MATH 103A,A02,083778,Staff,0,15,30,30
1650681429765,MATH 103A,B01,083779,Staff,0,15,30,30
1650681429765,MATH 103A,B02,083780,Staff,0,14,30,30
1650681435797,MATH 105,A01,085443,Staff,0,22,30,30
1650681441826,MATH 109,A01,083213,Anzaldo; Leesa B,0,7,30,30
1650681441826,MATH 109,A02,083214,Anzaldo; Leesa B,0,7,30,30
1650681441826,MATH 109,B01,083215,Anzaldo; Leesa B,0,8,30,30
1650681441826,MATH 109,B02,083216,Anzaldo; Leesa B,0,6,30,30
1650681447853,MATH 142A,A01,083219,Chow; Bennett,0,16,30,30
1650681447853,MATH 142A,A02,083220,Chow; Bennett,0,15,30,30
1650681447853,MATH 142A,B01,083221,Chow; Bennett,0,13,30,30
1650681447853,MATH 142A,B02,083222,Chow; Bennett,0,14,30,30
1650681453887,MATH 193A,A01,083224,Staff,0,5,30,30
1650681453887,MATH 193A,A02,083225,Staff,0,6,30,30
1650681453887,MATH 193A,A03,083781,Staff,0,6,30,30
1650681453887,MATH 193A,A04,083782,Staff,0,7,30,30
1650681459933,MATH 197,001,091859,McAuley; Julian John,9998,0,9999,1
1650681465997,COGS 9,A01,083615,Staff,1,16,60,59
1650681472019,COGS 11,A01,083617,Boyle; Mary E. T.,16,0,40,24
1650681478043,COGS 13,A01,083071,Staff,0,38,40,40
1650681484069,COGS 14A,A01,092681,Staff,0,34,100,100
1650681490097,COGS 14B,A01,083073,Cheng; Tzu-Han,1,14,50,49
1650681496129,COGS 17,A01,092677,Staff,15,0,75,60
1650681502165,COGS 100,A01,083619,Staff,0,29,60,60
1650681508198,COGS 101A,A01,083621,Davis; Joshua Daniel,0,27,60,60
1650681514240,COGS 101B,A01,091572,Staff,0,4,60,60
1650681520264,COGS 101C,A01,083625,Delgado; Tania,14,0,30,16
1650681526287,COGS 107A,A01,083627,Boyle; Mary E. T.,1,17,60,59
1650681532311,COGS 118A,A01,083075,Staff,0,7,60,60
1650681538334,CSE 3,A50,083646,Miranda; Gregory Joseph,18,0,38,20
1650681538334,CSE 3,A51,083647,Miranda; Gregory Joseph,36,0,37,1
1650681544364,CSE 8A,A50,083650,Miranda; Gregory Joseph,0,30,40,40
1650681550392,CSE 11,A01,083080,Cao; Yingjun,0,95,40,40
1650681556415,CSE 12,A01,083652,Staff,0,21,100,100
1650681562444,CSE 15L,A01,083654,Staff,0,3,50,50
1650681562444,CSE 15L,A02,083655,Staff,0,2,50,50
1650681568468,CSE 20,A01,083657,Staff,49,0,80,31
1650681574492,CSE 30,A01,083084,Eldon; John,0,78,40,40
1650681580515,CSE 100,A01,083659,Cao; Yingjun,0,70,50,50
1650681586546,CSE 134B,A01,083661,Powell; Thomas Allan,0,38,65,65
1650681592571,CSE 140,A01,083663,Staff,0,10,75,75
1650681598594,CSE 140L,A01,083088,Eldon; John,0,18,75,75
1650681604630,CSE 175,A01,083665,Kumar; Rakesh,7,0,25,18
1650681610652,CSE 190,A00,092507,Dubnov; Shlomo,10,0,20,10
1650681616676,ECE 45,A01,083139,Staff,0,2,60,60
1650681622704,ECE 65,A50,083695,Staff,0,5,30,30
1650681628735,ECE 109,A01,091882,Touri; Behrouz,33,0,70,37
1650681634758,ECE 180,A00,083140,Abi Samra; Nicholas Camill,20,0,30,10
1650681634758,ECE 180,B00,083141,Abi Samra; Nicholas Camill,0,0,30,30
1650681640783,MATH 10A,A01,083735,Patchell; Gregory David,3,0,30,27
1650681640783,MATH 10A,A02,083736,Patchell; Gregory David,27,0,30,3
1650681640783,MATH 10A,A03,083737,Patchell; Gregory David,24,0,30,6
1650681646822,MATH 10B,A01,083207,Staff,0,9,30,30
1650681646822,MATH 10B,A02,083208,Staff,1,8,30,29
1650681646822,MATH 10B,B01,083739,Staff,11,0,30,19
1650681646822,MATH 10B,B02,083740,Staff,28,0,30,2
1650681652866,MATH 18,A01,083743,Staff,0,0,30,30
1650681652866,MATH 18,A02,083744,Staff,23,0,30,7
1650681652866,MATH 18,A03,083745,Staff,21,0,30,9
1650681652866,MATH 18,A04,083746,Staff,26,0,30,4
1650681652866,MATH 18,B01,083748,Staff,0,15,30,30
1650681652866,MATH 18,B02,083749,Staff,0,12,30,30
1650681652866,MATH 18,B03,083750,Staff,0,12,30,30
1650681652866,MATH 18,B04,083751,Staff,0,12,30,30
1650681658892,MATH 20A,A01,083754,Staff,19,0,40,21
1650681664917,MATH 20B,A01,083756,Staff,0,11,30,30
1650681664917,MATH 20B,A02,083757,Staff,0,12,30,30
1650681670947,MATH 20C,A01,083760,Staff,0,16,30,30
1650681670947,MATH 20C,A02,083761,Staff,1,16,30,29
1650681670947,MATH 20C,B01,083762,Staff,10,0,30,20
1650681670947,MATH 20C,B02,083763,Staff,28,0,30,2
1650681676970,MATH 20D,A01,083765,Staff,2,1,30,28
1650681676970,MATH 20D,A02,083766,Staff,6,0,30,24
1650681676970,MATH 20D,A03,083767,Staff,24,0,30,6
1650681682997,MATH 20E,A01,083771,Staff,3,0,30,27
1650681682997,MATH 20E,A02,083772,Staff,16,0,30,14
1650681682997,MATH 20E,B01,083773,Staff,0,0,30,30
1650681682997,MATH 20E,B02,083774,Staff,9,0,30,21
1650681689022,MATH 103A,A01,083777,Staff,0,15,30,30
1650681689022,MATH 103A,A02,083778,Staff,0,15,30,30
1650681689022,MATH 103A,B01,083779,Staff,0,15,30,30
1650681689022,MATH 103A,B02,083780,Staff,0,14,30,30
1650681695059,MATH 105,A01,085443,Staff,0,22,30,30
1650681701088,MATH 109,A01,083213,Anzaldo; Leesa B,0,7,30,30
1650681701088,MATH 109,A02,083214,Anzaldo; Leesa B,0,7,30,30
1650681701088,MATH 109,B01,083215,Anzaldo; Leesa B,0,8,30,30
1650681701088,MATH 109,B02,083216,Anzaldo; Leesa B,0,6,30,30
1650681707116,MATH 142A,A01,083219,Chow; Bennett,0,16,30,30
1650681707116,MATH 142A,A02,083220,Chow; Bennett,0,15,30,30
1650681707116,MATH 142A,B01,083221,Chow; Bennett,0,13,30,30
1650681707116,MATH 142A,B02,083222,Chow; Bennett,0,14,30,30
1650681713140,MATH 193A,A01,083224,Staff,0,5,30,30
1650681713140,MATH 193A,A02,083225,Staff,0,6,30,30
1650681713140,MATH 193A,A03,083781,Staff,0,6,30,30
1650681713140,MATH 193A,A04,083782,Staff,0,7,30,30
1650681719175,MATH 197,001,091859,McAuley; Julian John,9998,0,9999,1
1650681725227,COGS 9,A01,083615,Staff,1,16,60,59
1650681731251,COGS 11,A01,083617,Boyle; Mary E. T.,16,0,40,24
1650681737278,COGS 13,A01,083071,Staff,0,38,40,40
1650681743302,COGS 14A,A01,092681,Staff,0,34,100,100
1650681749419,COGS 14B,A01,083073,Cheng; Tzu-Han,1,14,50,49
1650681755444,COGS 17,A01,092677,Staff,15,0,75,60
1650681761471,COGS 100,A01,083619,Staff,0,29,60,60
1650681767493,COGS 101A,A01,083621,Davis; Joshua Daniel,0,27,60,60
1650681773518,COGS 101B,A01,091572,Staff,0,4,60,60
1650681779545,COGS 101C,A01,083625,Delgado; Tania,14,0,30,16
1650681785568,COGS 107A,A01,083627,Boyle; Mary E. T.,1,17,60,59
1650681791601,COGS 118A,A01,083075,Staff,0,7,60,60
1650681797625,CSE 3,A50,083646,Miranda; Gregory Joseph,18,0,38,20
1650681797625,CSE 3,A51,083647,Miranda; Gregory Joseph,36,0,37,1
1650681803652,CSE 8A,A50,083650,Miranda; Gregory Joseph,0,30,40,40
1650681809680,CSE 11,A01,083080,Cao; Yingjun,0,95,40,40
1650681815705,CSE 12,A01,083652,Staff,0,21,100,100
1650681821731,CSE 15L,A01,083654,Staff,0,3,50,50
1650681821731,CSE 15L,A02,083655,Staff,0,2,50,50
1650681827757,CSE 20,A01,083657,Staff,49,0,80,31
1650681833780,CSE 30,A01,083084,Eldon; John,0,78,40,40
1650681839803,CSE 100,A01,083659,Cao; Yingjun,0,70,50,50
1650681845829,CSE 134B,A01,083661,Powell; Thomas Allan,0,38,65,65
1650681851852,CSE 140,A01,083663,Staff,0,10,75,75
1650681857878,CSE 140L,A01,083088,Eldon; John,0,18,75,75
1650681863911,CSE 175,A01,083665,Kumar; Rakesh,7,0,25,18
1650681869940,CSE 190,A00,092507,Dubnov; Shlomo,10,0,20,10
1650681875962,ECE 45,A01,083139,Staff,0,2,60,60
1650681881988,ECE 65,A50,083695,Staff,0,5,30,30
1650681888015,ECE 109,A01,091882,Touri; Behrouz,33,0,70,37
1650681894042,ECE 180,A00,083140,Abi Samra; Nicholas Camill,20,0,30,10
1650681894042,ECE 180,B00,083141,Abi Samra; Nicholas Camill,0,0,30,30
1650681900067,MATH 10A,A01,083735,Patchell; Gregory David,3,0,30,27
1650681900067,MATH 10A,A02,083736,Patchell; Gregory David,27,0,30,3
1650681900067,MATH 10A,A03,083737,Patchell; Gregory David,24,0,30,6
1650681906094,MATH 10B,A01,083207,Staff,0,9,30,30
1650681906094,MATH 10B,A02,083208,Staff,1,8,30,29
1650681906094,MATH 10B,B01,083739,Staff,11,0,30,19
1650681906094,MATH 10B,B02,083740,Staff,28,0,30,2
1650681912118,MATH 18,A01,083743,Staff,0,0,30,30
1650681912118,MATH 18,A02,083744,Staff,23,0,30,7
1650681912118,MATH 18,A03,083745,Staff,21,0,30,9
1650681912118,MATH 18,A04,083746,Staff,26,0,30,4
1650681912118,MATH 18,B01,083748,Staff,0,15,30,30
1650681912118,MATH 18,B02,083749,Staff,0,12,30,30
1650681912118,MATH 18,B03,083750,Staff,0,12,30,30
1650681912118,MATH 18,B04,083751,Staff,0,12,30,30
1650681918144,MATH 20A,A01,083754,Staff,19,0,40,21
1650681924176,MATH 20B,A01,083756,Staff,0,11,30,30
1650681924176,MATH 20B,A02,083757,Staff,0,12,30,30
1650681930208,MATH 20C,A01,083760,Staff,0,16,30,30
1650681930208,MATH 20C,A02,083761,Staff,1,16,30,29
1650681930208,MATH 20C,B01,083762,Staff,10,0,30,20
1650681930208,MATH 20C,B02,083763,Staff,28,0,30,2
1650681936233,MATH 20D,A01,083765,Staff,2,1,30,28
1650681936233,MATH 20D,A02,083766,Staff,6,0,30,24
1650681936233,MATH 20D,A03,083767,Staff,24,0,30,6
1650681942257,MATH 20E,A01,083771,Staff,3,0,30,27
1650681942257,MATH 20E,A02,083772,Staff,16,0,30,14
1650681942257,MATH 20E,B01,083773,Staff,0,0,30,30
1650681942257,MATH 20E,B02,083774,Staff,9,0,30,21
1650681948287,MATH 103A,A01,083777,Staff,0,15,30,30
1650681948287,MATH 103A,A02,083778,Staff,0,15,30,30
1650681948287,MATH 103A,B01,083779,Staff,0,15,30,30
1650681948287,MATH 103A,B02,083780,Staff,0,14,30,30
1650681954310,MATH 105,A01,085443,Staff,0,22,30,30
1650681960333,MATH 109,A01,083213,Anzaldo; Leesa B,0,7,30,30
1650681960333,MATH 109,A02,083214,Anzaldo; Leesa B,0,7,30,30
1650681960333,MATH 109,B01,083215,Anzaldo; Leesa B,0,8,30,30
1650681960333,MATH 109,B02,083216,Anzaldo; Leesa B,0,6,30,30
1650681966358,MATH 142A,A01,083219,Chow; Bennett,0,16,30,30
1650681966358,MATH 142A,A02,083220,Chow; Bennett,0,15,30,30
1650681966358,MATH 142A,B01,083221,Chow; Bennett,0,13,30,30
1650681966358,MATH 142A,B02,083222,Chow; Bennett,0,14,30,30
1650681972385,MATH 193A,A01,083224,Staff,0,5,30,30
1650681972385,MATH 193A,A02,083225,Staff,0,6,30,30
1650681972385,MATH 193A,A03,083781,Staff,0,6,30,30
1650681972385,MATH 193A,A04,083782,Staff,0,7,30,30
1650681978408,MATH 197,001,091859,McAuley; Julian John,9998,0,9999,1
1650681984467,COGS 9,A01,083615,Staff,1,16,60,59
1650681990503,COGS 11,A01,083617,Boyle; Mary E. T.,16,0,40,24
1650681996533,COGS 13,A01,083071,Staff,0,38,40,40
1650682002557,COGS 14A,A01,092681,Staff,0,34,100,100
1650682008590,COGS 14B,A01,083073,Cheng; Tzu-Han,1,14,50,49
1650682014614,COGS 17,A01,092677,Staff,15,0,75,60
1650682020641,COGS 100,A01,083619,Staff,0,29,60,60
1650682026684,COGS 101A,A01,083621,Davis; Joshua Daniel,0,27,60,60
1650682032709,COGS 101B,A01,091572,Staff,0,4,60,60
1650682038733,COGS 101C,A01,083625,Delgado; Tania,14,0,30,16
1650682044755,COGS 107A,A01,083627,Boyle; Mary E. T.,1,17,60,59
1650682050781,COGS 118A,A01,083075,Staff,0,7,60,60
1650682056806,CSE 3,A50,083646,Miranda; Gregory Joseph,18,0,38,20
1650682056806,CSE 3,A51,083647,Miranda; Gregory Joseph,36,0,37,1
1650682062830,CSE 8A,A50,083650,Miranda; Gregory Joseph,0,30,40,40
1650682068863,CSE 11,A01,083080,Cao; Yingjun,0,95,40,40
1650682074898,CSE 12,A01,083652,Staff,0,21,100,100
1650682080922,CSE 15L,A01,083654,Staff,0,3,50,50
1650682080922,CSE 15L,A02,083655,Staff,0,2,50,50
1650682086946,CSE 20,A01,083657,Staff,49,0,80,31
1650682092970,CSE 30,A01,083084,Eldon; John,0,78,40,40
1650682098994,CSE 100,A01,083659,Cao; Yingjun,0,70,50,50
1650682105022,CSE 134B,A01,083661,Powell; Thomas Allan,0,38,65,65
1650682111051,CSE 140,A01,083663,Staff,0,10,75,75
1650682117077,CSE 140L,A01,083088,Eldon; John,0,18,75,75
1650682123102,CSE 175,A01,083665,Kumar; Rakesh,7,0,25,18
1650682129128,CSE 190,A00,092507,Dubnov; Shlomo,10,0,20,10
1650682135155,ECE 45,A01,083139,Staff,0,2,60,60
1650682141178,ECE 65,A50,083695,Staff,0,5,30,30
1650682147202,ECE 109,A01,091882,Touri; Behrouz,33,0,70,37
1650682153231,ECE 180,A00,083140,Abi Samra; Nicholas Camill,20,0,30,10
1650682153231,ECE 180,B00,083141,Abi Samra; Nicholas Camill,0,0,30,30
1650682159255,MATH 10A,A01,083735,Patchell; Gregory David,2,0,30,28
1650682159255,MATH 10A,A02,083736,Patchell; Gregory David,27,0,30,3
1650682159255,MATH 10A,A03,083737,Patchell; Gregory David,24,0,30,6
1650682165289,MATH 10B,A01,083207,Staff,0,9,30,30
1650682165289,MATH 10B,A02,083208,Staff,1,8,30,29
1650682165289,MATH 10B,B01,083739,Staff,11,0,30,19
1650682165289,MATH 10B,B02,083740,Staff,28,0,30,2
1650682171313,MATH 18,A01,083743,Staff,0,0,30,30
1650682171313,MATH 18,A02,083744,Staff,23,0,30,7
1650682171313,MATH 18,A03,083745,Staff,21,0,30,9
1650682171313,MATH 18,A04,083746,Staff,26,0,30,4
1650682171313,MATH 18,B01,083748,Staff,0,15,30,30
1650682171313,MATH 18,B02,083749,Staff,0,12,30,30
1650682171313,MATH 18,B03,083750,Staff,0,12,30,30
1650682171313,MATH 18,B04,083751,Staff,0,12,30,30
1650682177338,MATH 20A,A01,083754,Staff,19,0,40,21
1650682183360,MATH 20B,A01,083756,Staff,0,11,30,30
1650682183360,MATH 20B,A02,083757,Staff,0,12,30,30
1650682189386,MATH 20C,A01,083760,Staff,0,16,30,30
1650682189386,MATH 20C,A02,083761,Staff,1,16,30,29
1650682189386,MATH 20C,B01,083762,Staff,10,0,30,20
1650682189386,MATH 20C,B02,083763,Staff,28,0,30,2
1650682195411,MATH 20D,A01,083765,Staff,2,1,30,28
1650682195411,MATH 20D,A02,083766,Staff,6,0,30,24
1650682195411,MATH 20D,A03,083767,Staff,24,0,30,6
1650682201435,MATH 20E,A01,083771,Staff,3,0,30,27
1650682201435,MATH 20E,A02,083772,Staff,16,0,30,14
1650682201435,MATH 20E,B01,083773,Staff,0,0,30,30
1650682201435,MATH 20E,B02,083774,Staff,9,0,30,21
1650682207463,MATH 103A,A01,083777,Staff,0,15,30,30
1650682207463,MATH 103A,A02,083778,Staff,0,15,30,30
1650682207463,MATH 103A,B01,083779,Staff,0,15,30,30
1650682207463,MATH 103A,B02,083780,Staff,0,14,30,30
1650682213496,MATH 105,A01,085443,Staff,0,22,30,30
1650682219532,MATH 109,A01,083213,Anzaldo; Leesa B,0,7,30,30
1650682219532,MATH 109,A02,083214,Anzaldo; Leesa B,0,7,30,30
1650682219532,MATH 109,B01,083215,Anzaldo; Leesa B,0,8,30,30
1650682219532,MATH 109,B02,083216,Anzaldo; Leesa B,0,6,30,30
1650682225556,MATH 142A,A01,083219,Chow; Bennett,0,16,30,30
1650682225556,MATH 142A,A02,083220,Chow; Bennett,0,15,30,30
1650682225556,MATH 142A,B01,083221,Chow; Bennett,0,13,30,30
1650682225556,MATH 142A,B02,083222,Chow; Bennett,0,14,30,30
1650682231579,MATH 193A,A01,083224,Staff,0,5,30,30
1650682231579,MATH 193A,A02,083225,Staff,0,6,30,30
1650682231579,MATH 193A,A03,083781,Staff,0,6,30,30
1650682231579,MATH 193A,A04,083782,Staff,0,7,30,30
1650682237602,MATH 197,001,091859,McAuley; Julian John,9998,0,9999,1
1650682243671,COGS 9,A01,083615,Staff,1,16,60,59
1650682249697,COGS 11,A01,083617,Boyle; Mary E. T.,16,0,40,24
1650682255730,COGS 13,A01,083071,Staff,0,38,40,40
1650682261753,COGS 14A,A01,092681,Staff,0,34,100,100
1650682267786,COGS 14B,A01,083073,Cheng; Tzu-Han,1,14,50,49
1650682273810,COGS 17,A01,092677,Staff,15,0,75,60
1650682279836,COGS 100,A01,083619,Staff,0,29,60,60
1650682285859,COGS 101A,A01,083621,Davis; Joshua Daniel,0,27,60,60
1650682291883,COGS 101B,A01,091572,Staff,0,4,60,60
1650682297910,COGS 101C,A01,083625,Delgado; Tania,14,0,30,16
1650682303932,COGS 107A,A01,083627,Boyle; Mary E. T.,1,17,60,59
1650682309956,COGS 118A,A01,083075,Staff,0,7,60,60
1650682315980,CSE 3,A50,083646,Miranda; Gregory Joseph,18,0,38,20
1650682315980,CSE 3,A51,083647,Miranda; Gregory Joseph,36,0,37,1
1650682322004,CSE 8A,A50,083650,Miranda; Gregory Joseph,0,30,40,40
1650682328030,CSE 11,A01,083080,Cao; Yingjun,0,95,40,40
1650682334057,CSE 12,A01,083652,Staff,0,21,100,100
1650682340080,CSE 15L,A01,083654,Staff,0,3,50,50
1650682340080,CSE 15L,A02,083655,Staff,0,2,50,50
1650682346198,CSE 20,A01,083657,Staff,49,0,80,31
1650682352239,CSE 30,A01,083084,Eldon; John,0,78,40,40
1650682358264,CSE 100,A01,083659,Cao; Yingjun,0,70,50,50
1650682364286,CSE 134B,A01,083661,Powell; Thomas Allan,0,38,65,65
1650682370310,CSE 140,A01,083663,Staff,0,10,75,75
1650682376337,CSE 140L,A01,083088,Eldon; John,0,18,75,75
1650682382364,CSE 175,A01,083665,Kumar; Rakesh,7,0,25,18
1650682388388,CSE 190,A00,092507,Dubnov; Shlomo,10,0,20,10
1650682394417,ECE 45,A01,083139,Staff,0,2,60,60
1650682400445,ECE 65,A50,083695,Staff,0,5,30,30
1650682406467,ECE 109,A01,091882,Touri; Behrouz,33,0,70,37
1650682412489,ECE 180,A00,083140,Abi Samra; Nicholas Camill,20,0,30,10
1650682412489,ECE 180,B00,083141,Abi Samra; Nicholas Camill,0,0,30,30
1650682418520,MATH 10A,A01,083735,Patchell; Gregory David,2,0,30,28
1650682418520,MATH 10A,A02,083736,Patchell; Gregory David,27,0,30,3
1650682418520,MATH 10A,A03,083737,Patchell; Gregory David,24,0,30,6
1650682424551,MATH 10B,A01,083207,Staff,0,9,30,30
1650682424551,MATH 10B,A02,083208,Staff,1,8,30,29
1650682424551,MATH 10B,B01,083739,Staff,11,0,30,19
1650682424551,MATH 10B,B02,083740,Staff,28,0,30,2
1650682430576,MATH 18,A01,083743,Staff,0,0,30,30
1650682430576,MATH 18,A02,083744,Staff,23,0,30,7
1650682430576,MATH 18,A03,083745,Staff,21,0,30,9
1650682430576,MATH 18,A04,083746,Staff,26,0,30,4
1650682430576,MATH 18,B01,083748,Staff,0,15,30,30
1650682430576,MATH 18,B02,083749,Staff,0,12,30,30
1650682430576,MATH 18,B03,083750,Staff,0,12,30,30
1650682430576,MATH 18,B04,083751,Staff,0,12,30,30
1650682436600,MATH 20A,A01,083754,Staff,19,0,40,21
1650682442623,MATH 20B,A01,083756,Staff,0,11,30,30
1650682442623,MATH 20B,A02,083757,Staff,0,12,30,30
1650682448651,MATH 20C,A01,083760,Staff,0,16,30,30
1650682448651,MATH 20C,A02,083761,Staff,1,16,30,29
1650682448651,MATH 20C,B01,083762,Staff,10,0,30,20
1650682448651,MATH 20C,B02,083763,Staff,28,0,30,2
1650682454675,MATH 20D,A01,083765,Staff,2,1,30,28
1650682454675,MATH 20D,A02,083766,Staff,6,0,30,24
1650682454675,MATH 20D,A03,083767,Staff,24,0,30,6
1650682460704,MATH 20E,A01,083771,Staff,3,0,30,27
1650682460704,MATH 20E,A02,083772,Staff,16,0,30,14
1650682460704,MATH 20E,B01,083773,Staff,0,0,30,30
1650682460704,MATH 20E,B02,083774,Staff,9,0,30,21
1650682466728,MATH 103A,A01,083777,Staff,0,15,30,30
1650682466728,MATH 103A,A02,083778,Staff,0,15,30,30
1650682466728,MATH 103A,B01,083779,Staff,0,15,30,30
1650682466728,MATH 103A,B02,083780,Staff,0,14,30,30
1650682472753,MATH 105,A01,085443,Staff,0,22,30,30
1650682478784,MATH 109,A01,083213,Anzaldo; Leesa B,0,7,30,30
1650682478784,MATH 109,A02,083214,Anzaldo; Leesa B,0,7,30,30
1650682478784,MATH 109,B01,083215,Anzaldo; Leesa B,0,8,30,30
1650682478784,MATH 109,B02,083216,Anzaldo; Leesa B,0,6,30,30
1650682484813,MATH 142A,A01,083219,Chow; Bennett,0,16,30,30
1650682484813,MATH 142A,A02,083220,Chow; Bennett,0,15,30,30
1650682484813,MATH 142A,B01,083221,Chow; Bennett,0,13,30,30
1650682484813,MATH 142A,B02,083222,Chow; Bennett,0,14,30,30
1650682490851,MATH 193A,A01,083224,Staff,0,5,30,30
1650682490851,MATH 193A,A02,083225,Staff,0,6,30,30
1650682490851,MATH 193A,A03,083781,Staff,0,6,30,30
1650682490851,MATH 193A,A04,083782,Staff,0,7,30,30
1650682496875,MATH 197,001,091859,McAuley; Julian John,9998,0,9999,1
1650682502927,COGS 9,A01,083615,Staff,1,16,60,59
1650682508950,COGS 11,A01,083617,Boyle; Mary E. T.,16,0,40,24
1650682514974,COGS 13,A01,083071,Staff,0,38,40,40
1650682520999,COGS 14A,A01,092681,Staff,0,34,100,100
1650682527025,COGS 14B,A01,083073,Cheng; Tzu-Han,1,14,50,49
1650682533050,COGS 17,A01,092677,Staff,15,0,75,60
1650682539073,COGS 100,A01,083619,Staff,0,29,60,60
1650682545098,COGS 101A,A01,083621,Davis; Joshua Daniel,0,27,60,60
1650682551126,COGS 101B,A01,091572,Staff,0,4,60,60
1650682557149,COGS 101C,A01,083625,Delgado; Tania,14,0,30,16
1650682563175,COGS 107A,A01,083627,Boyle; Mary E. T.,1,17,60,59
1650682569206,COGS 118A,A01,083075,Staff,0,7,60,60
1650682575238,CSE 3,A50,083646,Miranda; Gregory Joseph,18,0,38,20
1650682575238,CSE 3,A51,083647,Miranda; Gregory Joseph,36,0,37,1
1650682581262,CSE 8A,A50,083650,Miranda; Gregory Joseph,0,30,40,40
1650682587285,CSE 11,A01,083080,Cao; Yingjun,0,95,40,40
1650682593308,CSE 12,A01,083652,Staff,0,21,100,100
1650682599331,CSE 15L,A01,083654,Staff,0,3,50,50
1650682599331,CSE 15L,A02,083655,Staff,0,2,50,50
1650682605356,CSE 20,A01,083657,Staff,49,0,80,31
1650682611379,CSE 30,A01,083084,Eldon; John,0,78,40,40
1650682617403,CSE 100,A01,083659,Cao; Yingjun,0,70,50,50
1650682623429,CSE 134B,A01,083661,Powell; Thomas Allan,0,38,65,65
1650682629460,CSE 140,A01,083663,Staff,0,10,75,75
1650682635487,CSE 140L,A01,083088,Eldon; John,0,18,75,75
1650682641510,CSE 175,A01,083665,Kumar; Rakesh,7,0,25,18
1650682647535,CSE 190,A00,092507,Dubnov; Shlomo,10,0,20,10
1650682653561,ECE 45,A01,083139,Staff,0,2,60,60
1650682659586,ECE 65,A50,083695,Staff,0,5,30,30
1650682665612,ECE 109,A01,091882,Touri; Behrouz,33,0,70,37
1650682671636,ECE 180,A00,083140,Abi Samra; Nicholas Camill,20,0,30,10
1650682671636,ECE 180,B00,083141,Abi Samra; Nicholas Camill,0,0,30,30
1650682677671,MATH 10A,A01,083735,Patchell; Gregory David,2,0,30,28
1650682677671,MATH 10A,A02,083736,Patchell; Gregory David,27,0,30,3
1650682677671,MATH 10A,A03,083737,Patchell; Gregory David,24,0,30,6
1650682683697,MATH 10B,A01,083207,Staff,0,9,30,30
1650682683697,MATH 10B,A02,083208,Staff,1,8,30,29
1650682683697,MATH 10B,B01,083739,Staff,11,0,30,19
1650682683697,MATH 10B,B02,083740,Staff,28,0,30,2
1650682689727,MATH 18,A01,083743,Staff,0,0,30,30
1650682689727,MATH 18,A02,083744,Staff,23,0,30,7
1650682689727,MATH 18,A03,083745,Staff,21,0,30,9
1650682689727,MATH 18,A04,083746,Staff,26,0,30,4
1650682689727,MATH 18,B01,083748,Staff,0,15,30,30
1650682689727,MATH 18,B02,083749,Staff,0,12,30,30
1650682689727,MATH 18,B03,083750,Staff,0,12,30,30
1650682689727,MATH 18,B04,083751,Staff,0,12,30,30
1650682695753,MATH 20A,A01,083754,Staff,19,0,40,21
1650682701777,MATH 20B,A01,083756,Staff,0,11,30,30
1650682701777,MATH 20B,A02,083757,Staff,0,12,30,30
1650682707804,MATH 20C,A01,083760,Staff,0,16,30,30
1650682707804,MATH 20C,A02,083761,Staff,1,16,30,29
1650682707804,MATH 20C,B01,083762,Staff,10,0,30,20
1650682707804,MATH 20C,B02,083763,Staff,28,0,30,2
1650682713832,MATH 20D,A01,083765,Staff,2,1,30,28
1650682713832,MATH 20D,A02,083766,Staff,6,0,30,24
1650682713832,MATH 20D,A03,083767,Staff,24,0,30,6
1650682719858,MATH 20E,A01,083771,Staff,3,0,30,27
1650682719858,MATH 20E,A02,083772,Staff,16,0,30,14
1650682719858,MATH 20E,B01,083773,Staff,0,0,30,30
1650682719858,MATH 20E,B02,083774,Staff,9,0,30,21
1650682725888,MATH 103A,A01,083777,Staff,0,15,30,30
1650682725888,MATH 103A,A02,083778,Staff,0,15,30,30
1650682725888,MATH 103A,B01,083779,Staff,0,15,30,30
1650682725888,MATH 103A,B02,083780,Staff,0,14,30,30
1650682731915,MATH 105,A01,085443,Staff,0,22,30,30
1650682737942,MATH 109,A01,083213,Anzaldo; Leesa B,0,7,30,30
1650682737942,MATH 109,A02,083214,Anzaldo; Leesa B,0,7,30,30
1650682737942,MATH 109,B01,083215,Anzaldo; Leesa B,0,8,30,30
1650682737942,MATH 109,B02,083216,Anzaldo; Leesa B,0,6,30,30
1650682743971,MATH 142A,A01,083219,Chow; Bennett,0,16,30,30
1650682743971,MATH 142A,A02,083220,Chow; Bennett,0,15,30,30
1650682743971,MATH 142A,B01,083221,Chow; Bennett,0,13,30,30
1650682743971,MATH 142A,B02,083222,Chow; Bennett,0,14,30,30
1650682750003,MATH 193A,A01,083224,Staff,0,5,30,30
1650682750003,MATH 193A,A02,083225,Staff,0,6,30,30
1650682750003,MATH 193A,A03,083781,Staff,0,6,30,30
1650682750003,MATH 193A,A04,083782,Staff,0,7,30,30
1650682756026,MATH 197,001,091859,McAuley; Julian John,9998,0,9999,1
1650682762091,COGS 9,A01,083615,Staff,1,16,60,59
1650682768115,COGS 11,A01,083617,Boyle; Mary E. T.,16,0,40,24
1650682774139,COGS 13,A01,083071,Staff,0,38,40,40
1650682780165,COGS 14A,A01,092681,Staff,0,34,100,100
1650682786190,COGS 14B,A01,083073,Cheng; Tzu-Han,1,14,50,49
1650682792213,COGS 17,A01,092677,Staff,15,0,75,60
1650682798237,COGS 100,A01,083619,Staff,0,29,60,60
1650682804262,COGS 101A,A01,083621,Davis; Joshua Daniel,0,27,60,60
1650682810293,COGS 101B,A01,091572,Staff,0,4,60,60
1650682816325,COGS 101C,A01,083625,Delgado; Tania,14,0,30,16
1650682822348,COGS 107A,A01,083627,Boyle; Mary E. T.,1,17,60,59
1650682828374,COGS 118A,A01,083075,Staff,0,7,60,60
1650682834404,CSE 3,A50,083646,Miranda; Gregory Joseph,18,0,38,20
1650682834404,CSE 3,A51,083647,Miranda; Gregory Joseph,36,0,37,1
1650682840432,CSE 8A,A50,083650,Miranda; Gregory Joseph,0,30,40,40
1650682846458,CSE 11,A01,083080,Cao; Yingjun,0,95,40,40
1650682852482,CSE 12,A01,083652,Staff,0,21,100,100
1650682858506,CSE 15L,A01,083654,Staff,0,3,50,50
1650682858506,CSE 15L,A02,083655,Staff,0,2,50,50
1650682864530,CSE 20,A01,083657,Staff,49,0,80,31
1650682870558,CSE 30,A01,083084,Eldon; John,0,78,40,40
1650682876587,CSE 100,A01,083659,Cao; Yingjun,0,70,50,50
1650682882610,CSE 134B,A01,083661,Powell; Thomas Allan,0,38,65,65
1650682888633,CSE 140,A01,083663,Staff,0,10,75,75
1650682894657,CSE 140L,A01,083088,Eldon; John,0,18,75,75
1650682900682,CSE 175,A01,083665,Kumar; Rakesh,7,0,25,18
1650682906708,CSE 190,A00,092507,Dubnov; Shlomo,10,0,20,10
1650682912734,ECE 45,A01,083139,Staff,0,2,60,60
1650682918757,ECE 65,A50,083695,Staff,0,5,30,30
1650682924802,ECE 109,A01,091882,Touri; Behrouz,33,0,70,37
1650682930826,ECE 180,A00,083140,Abi Samra; Nicholas Camill,20,0,30,10
1650682930826,ECE 180,B00,083141,Abi Samra; Nicholas Camill,0,0,30,30
1650682936851,MATH 10A,A01,083735,Patchell; Gregory David,2,0,30,28
1650682936851,MATH 10A,A02,083736,Patchell; Gregory David,27,0,30,3
1650682936851,MATH 10A,A03,083737,Patchell; Gregory David,24,0,30,6
1650682942964,MATH 10B,A01,083207,Staff,0,9,30,30
1650682942964,MATH 10B,A02,083208,Staff,1,8,30,29
1650682942964,MATH 10B,B01,083739,Staff,11,0,30,19
1650682942964,MATH 10B,B02,083740,Staff,28,0,30,2
1650682948995,MATH 18,A01,083743,Staff,0,0,30,30
1650682948995,MATH 18,A02,083744,Staff,23,0,30,7
1650682948995,MATH 18,A03,083745,Staff,21,0,30,9
1650682948995,MATH 18,A04,083746,Staff,26,0,30,4
1650682948995,MATH 18,B01,083748,Staff,0,15,30,30
1650682948995,MATH 18,B02,083749,Staff,0,12,30,30
1650682948995,MATH 18,B03,083750,Staff,0,12,30,30
1650682948995,MATH 18,B04,083751,Staff,0,12,30,30
1650682955019,MATH 20A,A01,083754,Staff,19,0,40,21
1650682961046,MATH 20B,A01,083756,Staff,0,11,30,30
1650682961046,MATH 20B,A02,083757,Staff,0,12,30,30
1650682967080,MATH 20C,A01,083760,Staff,0,16,30,30
1650682967080,MATH 20C,A02,083761,Staff,1,16,30,29
1650682967080,MATH 20C,B01,083762,Staff,10,0,30,20
1650682967080,MATH 20C,B02,083763,Staff,28,0,30,2
1650682973108,MATH 20D,A01,083765,Staff,2,1,30,28
1650682973108,MATH 20D,A02,083766,Staff,6,0,30,24
1650682973108,MATH 20D,A03,083767,Staff,24,0,30,6
1650682979138,MATH 20E,A01,083771,Staff,3,0,30,27
1650682979138,MATH 20E,A02,083772,Staff,16,0,30,14
1650682979138,MATH 20E,B01,083773,Staff,0,0,30,30
1650682979138,MATH 20E,B02,083774,Staff,9,0,30,21
1650682985163,MATH 103A,A01,083777,Staff,0,15,30,30
1650682985163,MATH 103A,A02,083778,Staff,0,15,30,30
1650682985163,MATH 103A,B01,083779,Staff,0,15,30,30
1650682985163,MATH 103A,B02,083780,Staff,0,14,30,30
1650682991187,MATH 105,A01,085443,Staff,0,22,30,30
1650682997222,MATH 109,A01,083213,Anzaldo; Leesa B,0,7,30,30
1650682997222,MATH 109,A02,083214,Anzaldo; Leesa B,0,7,30,30
1650682997222,MATH 109,B01,083215,Anzaldo; Leesa B,0,8,30,30
1650682997222,MATH 109,B02,083216,Anzaldo; Leesa B,0,6,30,30
1650683003251,MATH 142A,A01,083219,Chow; Bennett,0,16,30,30
1650683003251,MATH 142A,A02,083220,Chow; Bennett,0,15,30,30
1650683003251,MATH 142A,B01,083221,Chow; Bennett,0,13,30,30
1650683003251,MATH 142A,B02,083222,Chow; Bennett,0,14,30,30
1650683009278,MATH 193A,A01,083224,Staff,0,5,30,30
1650683009278,MATH 193A,A02,083225,Staff,0,6,30,30
1650683009278,MATH 193A,A03,083781,Staff,0,6,30,30
1650683009278,MATH 193A,A04,083782,Staff,0,7,30,30
1650683015303,MATH 197,001,091859,McAuley; Julian John,9998,0,9999,1
1650683021356,COGS 9,A01,083615,Staff,1,16,60,59
1650683027379,COGS 11,A01,083617,Boyle; Mary E. T.,16,0,40,24
1650683033409,COGS 13,A01,083071,Staff,0,38,40,40
1650683039440,COGS 14A,A01,092681,Staff,0,34,100,100
1650683045469,COGS 14B,A01,083073,Cheng; Tzu-Han,1,14,50,49
1650683051510,COGS 17,A01,092677,Staff,15,0,75,60
1650683057534,COGS 100,A01,083619,Staff,0,29,60,60
1650683063561,COGS 101A,A01,083621,Davis; Joshua Daniel,0,27,60,60
1650683069584,COGS 101B,A01,091572,Staff,0,4,60,60
1650683075608,COGS 101C,A01,083625,Delgado; Tania,14,0,30,16
1650683081634,COGS 107A,A01,083627,Boyle; Mary E. T.,1,17,60,59
1650683087661,COGS 118A,A01,083075,Staff,0,7,60,60
1650683093686,CSE 3,A50,083646,Miranda; Gregory Joseph,18,0,38,20
1650683093686,CSE 3,A51,083647,Miranda; Gregory Joseph,36,0,37,1
1650683099711,CSE 8A,A50,083650,Miranda; Gregory Joseph,0,30,40,40
1650683105734,CSE 11,A01,083080,Cao; Yingjun,0,96,40,40
1650683111758,CSE 12,A01,083652,Staff,0,21,100,100
1650683117784,CSE 15L,A01,083654,Staff,0,3,50,50
1650683117784,CSE 15L,A02,083655,Staff,0,2,50,50
1650683123808,CSE 20,A01,083657,Staff,49,0,80,31
1650683129831,CSE 30,A01,083084,Eldon; John,0,78,40,40
1650683135858,CSE 100,A01,083659,Cao; Yingjun,0,70,50,50
1650683141885,CSE 134B,A01,083661,Powell; Thomas Allan,0,38,65,65
1650683147906,CSE 140,A01,083663,Staff,0,10,75,75
1650683153931,CSE 140L,A01,083088,Eldon; John,0,18,75,75
1650683159955,CSE 175,A01,083665,Kumar; Rakesh,7,0,25,18
1650683165980,CSE 190,A00,092507,Dubnov; Shlomo,10,0,20,10
1650683172008,ECE 45,A01,083139,Staff,0,2,60,60
1650683178034,ECE 65,A50,083695,Staff,0,5,30,30
1650683184061,ECE 109,A01,091882,Touri; Behrouz,33,0,70,37
1650683190088,ECE 180,A00,083140,Abi Samra; Nicholas Camill,20,0,30,10
1650683190088,ECE 180,B00,083141,Abi Samra; Nicholas Camill,0,0,30,30
1650683196113,MATH 10A,A01,083735,Patchell; Gregory David,2,0,30,28
1650683196113,MATH 10A,A02,083736,Patchell; Gregory David,27,0,30,3
1650683196113,MATH 10A,A03,083737,Patchell; Gregory David,24,0,30,6
1650683202140,MATH 10B,A01,083207,Staff,0,9,30,30
1650683202140,MATH 10B,A02,083208,Staff,1,8,30,29
1650683202140,MATH 10B,B01,083739,Staff,11,0,30,19
1650683202140,MATH 10B,B02,083740,Staff,28,0,30,2
1650683208167,MATH 18,A01,083743,Staff,0,0,30,30
1650683208167,MATH 18,A02,083744,Staff,23,0,30,7
1650683208167,MATH 18,A03,083745,Staff,21,0,30,9
1650683208167,MATH 18,A04,083746,Staff,26,0,30,4
1650683208167,MATH 18,B01,083748,Staff,0,15,30,30
1650683208167,MATH 18,B02,083749,Staff,0,12,30,30
1650683208167,MATH 18,B03,083750,Staff,0,12,30,30
1650683208167,MATH 18,B04,083751,Staff,0,12,30,30
1650683214193,MATH 20A,A01,083754,Staff,19,0,40,21
1650683220226,MATH 20B,A01,083756,Staff,0,11,30,30
1650683220226,MATH 20B,A02,083757,Staff,0,12,30,30
1650683226254,MATH 20C,A01,083760,Staff,0,16,30,30
1650683226254,MATH 20C,A02,083761,Staff,1,16,30,29
1650683226254,MATH 20C,B01,083762,Staff,10,0,30,20
1650683226254,MATH 20C,B02,083763,Staff,28,0,30,2
1650683232277,MATH 20D,A01,083765,Staff,2,1,30,28
1650683232277,MATH 20D,A02,083766,Staff,6,0,30,24
1650683232277,MATH 20D,A03,083767,Staff,24,0,30,6
1650683238305,MATH 20E,A01,083771,Staff,3,0,30,27
1650683238305,MATH 20E,A02,083772,Staff,16,0,30,14
1650683238305,MATH 20E,B01,083773,Staff,0,0,30,30
1650683238305,MATH 20E,B02,083774,Staff,9,0,30,21
1650683244335,MATH 103A,A01,083777,Staff,0,15,30,30
1650683244335,MATH 103A,A02,083778,Staff,0,15,30,30
1650683244335,MATH 103A,B01,083779,Staff,0,15,30,30
1650683244335,MATH 103A,B02,083780,Staff,0,14,30,30
1650683250359,MATH 105,A01,085443,Staff,0,22,30,30
1650683256388,MATH 109,A01,083213,Anzaldo; Leesa B,0,7,30,30
1650683256388,MATH 109,A02,083214,Anzaldo; Leesa B,0,7,30,30
1650683256388,MATH 109,B01,083215,Anzaldo; Leesa B,0,8,30,30
1650683256388,MATH 109,B02,083216,Anzaldo; Leesa B,0,6,30,30
1650683262411,MATH 142A,A01,083219,Chow; Bennett,0,16,30,30
1650683262411,MATH 142A,A02,083220,Chow; Bennett,0,15,30,30
1650683262411,MATH 142A,B01,083221,Chow; Bennett,0,13,30,30
1650683262411,MATH 142A,B02,083222,Chow; Bennett,0,14,30,30
1650683268434,MATH 193A,A01,083224,Staff,0,5,30,30
1650683268434,MATH 193A,A02,083225,Staff,0,6,30,30
1650683268434,MATH 193A,A03,083781,Staff,0,6,30,30
1650683268434,MATH 193A,A04,083782,Staff,0,7,30,30
1650683274456,MATH 197,001,091859,McAuley; Julian John,9998,0,9999,1
1650683280517,COGS 9,A01,083615,Staff,1,16,60,59
1650683286543,COGS 11,A01,083617,Boyle; Mary E. T.,16,0,40,24
1650683292566,COGS 13,A01,083071,Staff,0,38,40,40
1650683298589,COGS 14A,A01,092681,Staff,0,34,100,100
1650683304612,COGS 14B,A01,083073,Cheng; Tzu-Han,1,14,50,49
1650683310642,COGS 17,A01,092677,Staff,15,0,75,60
1650683316665,COGS 100,A01,083619,Staff,0,29,60,60
1650683322690,COGS 101A,A01,083621,Davis; Joshua Daniel,0,27,60,60
1650683328718,COGS 101B,A01,091572,Staff,0,4,60,60
1650683334753,COGS 101C,A01,083625,Delgado; Tania,14,0,30,16
1650683340784,COGS 107A,A01,083627,Boyle; Mary E. T.,1,17,60,59
1650683346813,COGS 118A,A01,083075,Staff,0,7,60,60
1650683352840,CSE 3,A50,083646,Miranda; Gregory Joseph,18,0,38,20
1650683352840,CSE 3,A51,083647,Miranda; Gregory Joseph,36,0,37,1
1650683358868,CSE 8A,A50,083650,Miranda; Gregory Joseph,0,30,40,40
1650683364909,CSE 11,A01,083080,Cao; Yingjun,0,96,40,40
1650683370935,CSE 12,A01,083652,Staff,0,21,100,100
1650683376961,CSE 15L,A01,083654,Staff,0,3,50,50
1650683376961,CSE 15L,A02,083655,Staff,0,2,50,50
1650683382987,CSE 20,A01,083657,Staff,49,0,80,31
1650683389011,CSE 30,A01,083084,Eldon; John,0,78,40,40
1650683395038,CSE 100,A01,083659,Cao; Yingjun,0,70,50,50
1650683401066,CSE 134B,A01,083661,Powell; Thomas Allan,0,38,65,65
1650683407097,CSE 140,A01,083663,Staff,0,10,75,75
1650683413124,CSE 140L,A01,083088,Eldon; John,0,18,75,75
1650683419147,CSE 175,A01,083665,Kumar; Rakesh,7,0,25,18
1650683425182,CSE 190,A00,092507,Dubnov; Shlomo,10,0,20,10
1650683431204,ECE 45,A01,083139,Staff,0,2,60,60
1650683437228,ECE 65,A50,083695,Staff,0,5,30,30
1650683443256,ECE 109,A01,091882,Touri; Behrouz,33,0,70,37
1650683449282,ECE 180,A00,083140,Abi Samra; Nicholas Camill,20,0,30,10
1650683449282,ECE 180,B00,083141,Abi Samra; Nicholas Camill,0,0,30,30
1650683455309,MATH 10A,A01,083735,Patchell; Gregory David,2,0,30,28
1650683455309,MATH 10A,A02,083736,Patchell; Gregory David,27,0,30,3
1650683455309,MATH 10A,A03,083737,Patchell; Gregory David,24,0,30,6
1650683461339,MATH 10B,A01,083207,Staff,0,9,30,30
1650683461339,MATH 10B,A02,083208,Staff,1,8,30,29
1650683461339,MATH 10B,B01,083739,Staff,11,0,30,19
1650683461339,MATH 10B,B02,083740,Staff,28,0,30,2
1650683467378,MATH 18,A01,083743,Staff,0,0,30,30
1650683467378,MATH 18,A02,083744,Staff,23,0,30,7
1650683467378,MATH 18,A03,083745,Staff,21,0,30,9
1650683467378,MATH 18,A04,083746,Staff,26,0,30,4
1650683467378,MATH 18,B01,083748,Staff,0,15,30,30
1650683467378,MATH 18,B02,083749,Staff,0,12,30,30
1650683467378,MATH 18,B03,083750,Staff,0,12,30,30
1650683467378,MATH 18,B04,083751,Staff,0,12,30,30
1650683473404,MATH 20A,A01,083754,Staff,19,0,40,21
1650683479428,MATH 20B,A01,083756,Staff,0,11,30,30
1650683479428,MATH 20B,A02,083757,Staff,0,12,30,30
1650683485458,MATH 20C,A01,083760,Staff,0,16,30,30
1650683485458,MATH 20C,A02,083761,Staff,1,16,30,29
1650683485458,MATH 20C,B01,083762,Staff,10,0,30,20
1650683485458,MATH 20C,B02,083763,Staff,28,0,30,2
1650683491482,MATH 20D,A01,083765,Staff,2,1,30,28
1650683491482,MATH 20D,A02,083766,Staff,6,0,30,24
1650683491482,MATH 20D,A03,083767,Staff,24,0,30,6
1650683497506,MATH 20E,A01,083771,Staff,3,0,30,27
1650683497506,MATH 20E,A02,083772,Staff,16,0,30,14
1650683497506,MATH 20E,B01,083773,Staff,0,0,30,30
1650683497506,MATH 20E,B02,083774,Staff,9,0,30,21
1650683503537,MATH 103A,A01,083777,Staff,0,15,30,30
1650683503537,MATH 103A,A02,083778,Staff,0,15,30,30
1650683503537,MATH 103A,B01,083779,Staff,0,15,30,30
1650683503537,MATH 103A,B02,083780,Staff,0,14,30,30
1650683509560,MATH 105,A01,085443,Staff,0,22,30,30
1650683515597,MATH 109,A01,083213,Anzaldo; Leesa B,0,7,30,30
1650683515597,MATH 109,A02,083214,Anzaldo; Leesa B,0,7,30,30
1650683515597,MATH 109,B01,083215,Anzaldo; Leesa B,0,8,30,30
1650683515597,MATH 109,B02,083216,Anzaldo; Leesa B,0,6,30,30
1650683521626,MATH 142A,A01,083219,Chow; Bennett,0,16,30,30
1650683521626,MATH 142A,A02,083220,Chow; Bennett,0,15,30,30
1650683521626,MATH 142A,B01,083221,Chow; Bennett,0,13,30,30
1650683521626,MATH 142A,B02,083222,Chow; Bennett,0,14,30,30
1650683527670,MATH 193A,A01,083224,Staff,0,5,30,30
1650683527670,MATH 193A,A02,083225,Staff,0,6,30,30
1650683527670,MATH 193A,A03,083781,Staff,0,6,30,30
1650683527670,MATH 193A,A04,083782,Staff,0,7,30,30
1650683533693,MATH 197,001,091859,McAuley; Julian John,9998,0,9999,1
1650683539838,COGS 9,A01,083615,Staff,1,16,60,59
1650683545865,COGS 11,A01,083617,Boyle; Mary E. T.,16,0,40,24
1650683551892,COGS 13,A01,083071,Staff,0,38,40,40
1650683557919,COGS 14A,A01,092681,Staff,0,34,100,100
1650683563950,COGS 14B,A01,083073,Cheng; Tzu-Han,1,14,50,49
1650683569982,COGS 17,A01,092677,Staff,15,0,75,60
1650683576009,COGS 100,A01,083619,Staff,0,29,60,60
1650683582033,COGS 101A,A01,083621,Davis; Joshua Daniel,0,27,60,60
1650683588055,COGS 101B,A01,091572,Staff,0,4,60,60
1650683594085,COGS 101C,A01,083625,Delgado; Tania,14,0,30,16
1650683600109,COGS 107A,A01,083627,Boyle; Mary E. T.,1,17,60,59
1650683606135,COGS 118A,A01,083075,Staff,0,7,60,60
1650683612160,CSE 3,A50,083646,Miranda; Gregory Joseph,18,0,38,20
1650683612160,CSE 3,A51,083647,Miranda; Gregory Joseph,36,0,37,1
1650683618185,CSE 8A,A50,083650,Miranda; Gregory Joseph,0,30,40,40
1650683624212,CSE 11,A01,083080,Cao; Yingjun,0,96,40,40
1650683630235,CSE 12,A01,083652,Staff,0,21,100,100
1650683636260,CSE 15L,A01,083654,Staff,0,3,50,50
1650683636260,CSE 15L,A02,083655,Staff,0,2,50,50
1650683642285,CSE 20,A01,083657,Staff,49,0,80,31
1650683648307,CSE 30,A01,083084,Eldon; John,0,78,40,40
1650683654331,CSE 100,A01,083659,Cao; Yingjun,0,70,50,50
1650683660357,CSE 134B,A01,083661,Powell; Thomas Allan,0,38,65,65
1650683666381,CSE 140,A01,083663,Staff,0,10,75,75
1650683672405,CSE 140L,A01,083088,Eldon; John,0,18,75,75
1650683678430,CSE 175,A01,083665,Kumar; Rakesh,7,0,25,18
1650683684453,CSE 190,A00,092507,Dubnov; Shlomo,10,0,20,10
1650683690480,ECE 45,A01,083139,Staff,0,2,60,60
1650683696505,ECE 65,A50,083695,Staff,0,5,30,30
1650683702530,ECE 109,A01,091882,Touri; Behrouz,33,0,70,37
1650683708561,ECE 180,A00,083140,Abi Samra; Nicholas Camill,20,0,30,10
1650683708561,ECE 180,B00,083141,Abi Samra; Nicholas Camill,0,0,30,30
1650683714592,MATH 10A,A01,083735,Patchell; Gregory David,2,0,30,28
1650683714592,MATH 10A,A02,083736,Patchell; Gregory David,27,0,30,3
1650683714592,MATH 10A,A03,083737,Patchell; Gregory David,24,0,30,6
1650683720616,MATH 10B,A01,083207,Staff,0,9,30,30
1650683720616,MATH 10B,A02,083208,Staff,1,8,30,29
1650683720616,MATH 10B,B01,083739,Staff,11,0,30,19
1650683720616,MATH 10B,B02,083740,Staff,28,0,30,2
1650683726646,MATH 18,A01,083743,Staff,0,0,30,30
1650683726646,MATH 18,A02,083744,Staff,23,0,30,7
1650683726646,MATH 18,A03,083745,Staff,21,0,30,9
1650683726646,MATH 18,A04,083746,Staff,26,0,30,4
1650683726646,MATH 18,B01,083748,Staff,0,15,30,30
1650683726646,MATH 18,B02,083749,Staff,0,12,30,30
1650683726646,MATH 18,B03,083750,Staff,0,12,30,30
1650683726646,MATH 18,B04,083751,Staff,0,12,30,30
1650683732706,MATH 20A,A01,083754,Staff,19,0,40,21
1650683738732,MATH 20B,A01,083756,Staff,0,11,30,30
1650683738732,MATH 20B,A02,083757,Staff,0,12,30,30
1650683744757,MATH 20C,A01,083760,Staff,0,16,30,30
1650683744757,MATH 20C,A02,083761,Staff,1,16,30,29
1650683744757,MATH 20C,B01,083762,Staff,10,0,30,20
1650683744757,MATH 20C,B02,083763,Staff,28,0,30,2
1650683750783,MATH 20D,A01,083765,Staff,2,1,30,28
1650683750783,MATH 20D,A02,083766,Staff,6,0,30,24
1650683750783,MATH 20D,A03,083767,Staff,24,0,30,6
1650683756807,MATH 20E,A01,083771,Staff,3,0,30,27
1650683756807,MATH 20E,A02,083772,Staff,16,0,30,14
1650683756807,MATH 20E,B01,083773,Staff,0,0,30,30
1650683756807,MATH 20E,B02,083774,Staff,9,0,30,21
1650683762835,MATH 103A,A01,083777,Staff,0,15,30,30
1650683762835,MATH 103A,A02,083778,Staff,0,15,30,30
1650683762835,MATH 103A,B01,083779,Staff,0,15,30,30
1650683762835,MATH 103A,B02,083780,Staff,0,15,30,30
1650683768857,MATH 105,A01,085443,Staff,0,22,30,30
1650683774892,MATH 109,A01,083213,Anzaldo; Leesa B,0,7,30,30
1650683774892,MATH 109,A02,083214,Anzaldo; Leesa B,0,7,30,30
1650683774892,MATH 109,B01,083215,Anzaldo; Leesa B,0,8,30,30
1650683774892,MATH 109,B02,083216,Anzaldo; Leesa B,0,6,30,30
1650683780917,MATH 142A,A01,083219,Chow; Bennett,0,16,30,30
1650683780917,MATH 142A,A02,083220,Chow; Bennett,0,15,30,30
1650683780917,MATH 142A,B01,083221,Chow; Bennett,0,13,30,30
1650683780917,MATH 142A,B02,083222,Chow; Bennett,0,14,30,30
1650683786940,MATH 193A,A01,083224,Staff,0,5,30,30
1650683786940,MATH 193A,A02,083225,Staff,0,6,30,30
1650683786940,MATH 193A,A03,083781,Staff,0,6,30,30
1650683786940,MATH 193A,A04,083782,Staff,0,7,30,30
1650683792962,MATH 197,001,091859,McAuley; Julian John,9998,0,9999,1
1650683799013,COGS 9,A01,083615,Staff,1,16,60,59
1650683805037,COGS 11,A01,083617,Boyle; Mary E. T.,16,0,40,24
1650683811061,COGS 13,A01,083071,Staff,0,38,40,40
1650683817086,COGS 14A,A01,092681,Staff,0,34,100,100
1650683823109,COGS 14B,A01,083073,Cheng; Tzu-Han,1,14,50,49
1650683829135,COGS 17,A01,092677,Staff,15,0,75,60
1650683835158,COGS 100,A01,083619,Staff,0,29,60,60
1650683841182,COGS 101A,A01,083621,Davis; Joshua Daniel,0,27,60,60
1650683847205,COGS 101B,A01,091572,Staff,0,4,60,60
1650683853231,COGS 101C,A01,083625,Delgado; Tania,14,0,30,16
1650683859258,COGS 107A,A01,083627,Boyle; Mary E. T.,1,17,60,59
1650683865281,COGS 118A,A01,083075,Staff,0,7,60,60
1650683871310,CSE 3,A50,083646,Miranda; Gregory Joseph,18,0,38,20
1650683871310,CSE 3,A51,083647,Miranda; Gregory Joseph,36,0,37,1
1650683877337,CSE 8A,A50,083650,Miranda; Gregory Joseph,0,31,40,40
1650683883361,CSE 11,A01,083080,Cao; Yingjun,0,96,40,40
1650683889384,CSE 12,A01,083652,Staff,0,21,100,100
1650683895408,CSE 15L,A01,083654,Staff,0,3,50,50
1650683895408,CSE 15L,A02,083655,Staff,0,2,50,50
1650683901432,CSE 20,A01,083657,Staff,49,0,80,31
1650683907467,CSE 30,A01,083084,Eldon; John,0,78,40,40
1650683913502,CSE 100,A01,083659,Cao; Yingjun,0,70,50,50
1650683919529,CSE 134B,A01,083661,Powell; Thomas Allan,0,38,65,65
1650683925553,CSE 140,A01,083663,Staff,0,10,75,75
1650683931576,CSE 140L,A01,083088,Eldon; John,0,18,75,75
1650683937603,CSE 175,A01,083665,Kumar; Rakesh,7,0,25,18
1650683943629,CSE 190,A00,092507,Dubnov; Shlomo,10,0,20,10
1650683949650,ECE 45,A01,083139,Staff,0,2,60,60
1650683955674,ECE 65,A50,083695,Staff,0,5,30,30
1650683961698,ECE 109,A01,091882,Touri; Behrouz,33,0,70,37
1650683967721,ECE 180,A00,083140,Abi Samra; Nicholas Camill,20,0,30,10
1650683967721,ECE 180,B00,083141,Abi Samra; Nicholas Camill,0,0,30,30
1650683973751,MATH 10A,A01,083735,Patchell; Gregory David,2,0,30,28
1650683973751,MATH 10A,A02,083736,Patchell; Gregory David,27,0,30,3
1650683973751,MATH 10A,A03,083737,Patchell; Gregory David,24,0,30,6
1650683979780,MATH 10B,A01,083207,Staff,0,9,30,30
1650683979780,MATH 10B,A02,083208,Staff,1,8,30,29
1650683979780,MATH 10B,B01,083739,Staff,11,0,30,19
1650683979780,MATH 10B,B02,083740,Staff,28,0,30,2
1650683985810,MATH 18,A01,083743,Staff,0,0,30,30
1650683985810,MATH 18,A02,083744,Staff,23,0,30,7
1650683985810,MATH 18,A03,083745,Staff,21,0,30,9
1650683985810,MATH 18,A04,083746,Staff,26,0,30,4
1650683985810,MATH 18,B01,083748,Staff,0,15,30,30
1650683985810,MATH 18,B02,083749,Staff,0,12,30,30
1650683985810,MATH 18,B03,083750,Staff,0,12,30,30
1650683985810,MATH 18,B04,083751,Staff,0,12,30,30
1650683991837,MATH 20A,A01,083754,Staff,19,0,40,21
1650683997864,MATH 20B,A01,083756,Staff,0,11,30,30
1650683997864,MATH 20B,A02,083757,Staff,0,12,30,30
1650684003892,MATH 20C,A01,083760,Staff,0,16,30,30
1650684003892,MATH 20C,A02,083761,Staff,1,16,30,29
1650684003892,MATH 20C,B01,083762,Staff,10,0,30,20
1650684003892,MATH 20C,B02,083763,Staff,28,0,30,2
1650684009915,MATH 20D,A01,083765,Staff,2,1,30,28
1650684009915,MATH 20D,A02,083766,Staff,6,0,30,24
1650684009915,MATH 20D,A03,083767,Staff,24,0,30,6
1650684015944,MATH 20E,A01,083771,Staff,3,0,30,27
1650684015944,MATH 20E,A02,083772,Staff,16,0,30,14
1650684015944,MATH 20E,B01,083773,Staff,0,0,30,30
1650684015944,MATH 20E,B02,083774,Staff,9,0,30,21
1650684021969,MATH 103A,A01,083777,Staff,0,15,30,30
1650684021969,MATH 103A,A02,083778,Staff,0,15,30,30
1650684021969,MATH 103A,B01,083779,Staff,0,15,30,30
1650684021969,MATH 103A,B02,083780,Staff,0,15,30,30
1650684027993,MATH 105,A01,085443,Staff,0,22,30,30
1650684034022,MATH 109,A01,083213,Anzaldo; Leesa B,0,7,30,30
1650684034022,MATH 109,A02,083214,Anzaldo; Leesa B,0,7,30,30
1650684034022,MATH 109,B01,083215,Anzaldo; Leesa B,0,8,30,30
1650684034022,MATH 109,B02,083216,Anzaldo; Leesa B,0,6,30,30
1650684040054,MATH 142A,A01,083219,Chow; Bennett,0,16,30,30
1650684040054,MATH 142A,A02,083220,Chow; Bennett,0,15,30,30
1650684040054,MATH 142A,B01,083221,Chow; Bennett,0,13,30,30
1650684040054,MATH 142A,B02,083222,Chow; Bennett,0,14,30,30
1650684046083,MATH 193A,A01,083224,Staff,0,5,30,30
1650684046083,MATH 193A,A02,083225,Staff,0,6,30,30
1650684046083,MATH 193A,A03,083781,Staff,0,6,30,30
1650684046083,MATH 193A,A04,083782,Staff,0,7,30,30
1650684052105,MATH 197,001,091859,McAuley; Julian John,9998,0,9999,1
1650684058175,COGS 9,A01,083615,Staff,1,16,60,59
1650684064201,COGS 11,A01,083617,Boyle; Mary E. T.,16,0,40,24
1650684070227,COGS 13,A01,083071,Staff,0,38,40,40
1650684076261,COGS 14A,A01,092681,Staff,0,34,100,100
1650684082287,COGS 14B,A01,083073,Cheng; Tzu-Han,1,14,50,49
1650684088312,COGS 17,A01,092677,Staff,15,0,75,60
1650684094335,COGS 100,A01,083619,Staff,0,29,60,60
1650684100359,COGS 101A,A01,083621,Davis; Joshua Daniel,0,27,60,60
1650684106384,COGS 101B,A01,091572,Staff,0,4,60,60
1650684112408,COGS 101C,A01,083625,Delgado; Tania,14,0,30,16
1650684118435,COGS 107A,A01,083627,Boyle; Mary E. T.,1,17,60,59
1650684124458,COGS 118A,A01,083075,Staff,0,7,60,60
1650684130584,CSE 3,A50,083646,Miranda; Gregory Joseph,18,0,38,20
1650684130584,CSE 3,A51,083647,Miranda; Gregory Joseph,36,0,37,1
1650684136612,CSE 8A,A50,083650,Miranda; Gregory Joseph,0,31,40,40
1650684142661,CSE 11,A01,083080,Cao; Yingjun,0,96,40,40
1650684148688,CSE 12,A01,083652,Staff,0,21,100,100
1650684154712,CSE 15L,A01,083654,Staff,0,3,50,50
1650684154712,CSE 15L,A02,083655,Staff,0,2,50,50
1650684160736,CSE 20,A01,083657,Staff,49,0,80,31
1650684166763,CSE 30,A01,083084,Eldon; John,0,78,40,40
1650684172791,CSE 100,A01,083659,Cao; Yingjun,0,70,50,50
1650684178814,CSE 134B,A01,083661,Powell; Thomas Allan,0,38,65,65
1650684184841,CSE 140,A01,083663,Staff,0,10,75,75
1650684190864,CSE 140L,A01,083088,Eldon; John,0,18,75,75
1650684196887,CSE 175,A01,083665,Kumar; Rakesh,7,0,25,18
1650684202912,CSE 190,A00,092507,Dubnov; Shlomo,10,0,20,10
1650684208945,ECE 45,A01,083139,Staff,0,2,60,60
1650684214971,ECE 65,A50,083695,Staff,0,5,30,30
1650684220995,ECE 109,A01,091882,Touri; Behrouz,33,0,70,37
1650684227019,ECE 180,A00,083140,Abi Samra; Nicholas Camill,20,0,30,10
1650684227019,ECE 180,B00,083141,Abi Samra; Nicholas Camill,0,0,30,30
1650684233044,MATH 10A,A01,083735,Patchell; Gregory David,2,0,30,28
1650684233044,MATH 10A,A02,083736,Patchell; Gregory David,27,0,30,3
1650684233044,MATH 10A,A03,083737,Patchell; Gregory David,24,0,30,6
1650684239075,MATH 10B,A01,083207,Staff,0,9,30,30
1650684239075,MATH 10B,A02,083208,Staff,1,8,30,29
1650684239075,MATH 10B,B01,083739,Staff,11,0,30,19
1650684239075,MATH 10B,B02,083740,Staff,28,0,30,2
1650684245111,MATH 18,A01,083743,Staff,0,0,30,30
1650684245111,MATH 18,A02,083744,Staff,23,0,30,7
1650684245111,MATH 18,A03,083745,Staff,21,0,30,9
1650684245111,MATH 18,A04,083746,Staff,26,0,30,4
1650684245111,MATH 18,B01,083748,Staff,0,15,30,30
1650684245111,MATH 18,B02,083749,Staff,0,12,30,30
1650684245111,MATH 18,B03,083750,Staff,0,12,30,30
1650684245111,MATH 18,B04,083751,Staff,0,12,30,30
1650684251136,MATH 20A,A01,083754,Staff,19,0,40,21
1650684257160,MATH 20B,A01,083756,Staff,0,11,30,30
1650684257160,MATH 20B,A02,083757,Staff,0,12,30,30
1650684263183,MATH 20C,A01,083760,Staff,0,16,30,30
1650684263183,MATH 20C,A02,083761,Staff,1,16,30,29
1650684263183,MATH 20C,B01,083762,Staff,10,0,30,20
1650684263183,MATH 20C,B02,083763,Staff,28,0,30,2
1650684269208,MATH 20D,A01,083765,Staff,2,1,30,28
1650684269208,MATH 20D,A02,083766,Staff,6,0,30,24
1650684269208,MATH 20D,A03,083767,Staff,24,0,30,6
1650684275253,MATH 20E,A01,083771,Staff,3,0,30,27
1650684275253,MATH 20E,A02,083772,Staff,16,0,30,14
1650684275253,MATH 20E,B01,083773,Staff,0,0,30,30
1650684275253,MATH 20E,B02,083774,Staff,9,0,30,21
1650684281280,MATH 103A,A01,083777,Staff,0,15,30,30
1650684281280,MATH 103A,A02,083778,Staff,0,15,30,30
1650684281280,MATH 103A,B01,083779,Staff,0,15,30,30
1650684281280,MATH 103A,B02,083780,Staff,0,15,30,30
1650684287308,MATH 105,A01,085443,Staff,0,22,30,30
1650684293336,MATH 109,A01,083213,Anzaldo; Leesa B,0,7,30,30
1650684293336,MATH 109,A02,083214,Anzaldo; Leesa B,0,7,30,30
1650684293336,MATH 109,B01,083215,Anzaldo; Leesa B,0,8,30,30
1650684293336,MATH 109,B02,083216,Anzaldo; Leesa B,0,6,30,30
1650684299359,MATH 142A,A01,083219,Chow; Bennett,0,16,30,30
1650684299359,MATH 142A,A02,083220,Chow; Bennett,0,15,30,30
1650684299359,MATH 142A,B01,083221,Chow; Bennett,0,13,30,30
1650684299359,MATH 142A,B02,083222,Chow; Bennett,0,14,30,30
1650684305386,MATH 193A,A01,083224,Staff,0,5,30,30
1650684305386,MATH 193A,A02,083225,Staff,0,6,30,30
1650684305386,MATH 193A,A03,083781,Staff,0,6,30,30
1650684305386,MATH 193A,A04,083782,Staff,0,7,30,30
1650684311411,MATH 197,001,091859,McAuley; Julian John,9998,0,9999,1
1650684317486,COGS 9,A01,083615,Staff,1,16,60,59
1650684323512,COGS 11,A01,083617,Boyle; Mary E. T.,16,0,40,24
1650684329548,COGS 13,A01,083071,Staff,0,38,40,40
1650684335580,COGS 14A,A01,092681,Staff,0,35,100,100
1650684341606,COGS 14B,A01,083073,Cheng; Tzu-Han,1,14,50,49
1650684347631,COGS 17,A01,092677,Staff,15,0,75,60
1650684353656,COGS 100,A01,083619,Staff,0,29,60,60
1650684359684,COGS 101A,A01,083621,Davis; Joshua Daniel,0,27,60,60
1650684365711,COGS 101B,A01,091572,Staff,0,4,60,60
1650684371735,COGS 101C,A01,083625,Delgado; Tania,14,0,30,16
1650684377763,COGS 107A,A01,083627,Boyle; Mary E. T.,1,17,60,59
1650684383786,COGS 118A,A01,083075,Staff,0,7,60,60
1650684389826,CSE 3,A50,083646,Miranda; Gregory Joseph,18,0,38,20
1650684389826,CSE 3,A51,083647,Miranda; Gregory Joseph,36,0,37,1
1650684395851,CSE 8A,A50,083650,Miranda; Gregory Joseph,0,31,40,40
1650684401879,CSE 11,A01,083080,Cao; Yingjun,0,96,40,40
1650684407905,CSE 12,A01,083652,Staff,0,21,100,100
1650684413928,CSE 15L,A01,083654,Staff,0,3,50,50
1650684413928,CSE 15L,A02,083655,Staff,0,2,50,50
1650684419951,CSE 20,A01,083657,Staff,49,0,80,31
1650684425975,CSE 30,A01,083084,Eldon; John,0,78,40,40
1650684432001,CSE 100,A01,083659,Cao; Yingjun,0,70,50,50
1650684438030,CSE 134B,A01,083661,Powell; Thomas Allan,0,38,65,65
1650684444053,CSE 140,A01,083663,Staff,0,10,75,75
1650684450076,CSE 140L,A01,083088,Eldon; John,0,18,75,75
1650684456105,CSE 175,A01,083665,Kumar; Rakesh,7,0,25,18
1650684462129,CSE 190,A00,092507,Dubnov; Shlomo,10,0,20,10
1650684468154,ECE 45,A01,083139,Staff,0,2,60,60
1650684474179,ECE 65,A50,083695,Staff,0,5,30,30
1650684480202,ECE 109,A01,091882,Touri; Behrouz,33,0,70,37
1650684486226,ECE 180,A00,083140,Abi Samra; Nicholas Camill,20,0,30,10
1650684486226,ECE 180,B00,083141,Abi Samra; Nicholas Camill,0,0,30,30
1650684492258,MATH 10A,A01,083735,Patchell; Gregory David,2,0,30,28
1650684492258,MATH 10A,A02,083736,Patchell; Gregory David,27,0,30,3
1650684492258,MATH 10A,A03,083737,Patchell; Gregory David,24,0,30,6
1650684498287,MATH 10B,A01,083207,Staff,0,9,30,30
1650684498287,MATH 10B,A02,083208,Staff,1,8,30,29
1650684498287,MATH 10B,B01,083739,Staff,11,0,30,19
1650684498287,MATH 10B,B02,083740,Staff,28,0,30,2
1650684504311,MATH 18,A01,083743,Staff,0,0,30,30
1650684504311,MATH 18,A02,083744,Staff,23,0,30,7
1650684504311,MATH 18,A03,083745,Staff,21,0,30,9
1650684504311,MATH 18,A04,083746,Staff,26,0,30,4
1650684504311,MATH 18,B01,083748,Staff,0,15,30,30
1650684504311,MATH 18,B02,083749,Staff,0,12,30,30
1650684504311,MATH 18,B03,083750,Staff,0,12,30,30
1650684504311,MATH 18,B04,083751,Staff,0,12,30,30
1650684510334,MATH 20A,A01,083754,Staff,19,0,40,21
1650684516365,MATH 20B,A01,083756,Staff,0,11,30,30
1650684516365,MATH 20B,A02,083757,Staff,0,12,30,30
1650684522393,MATH 20C,A01,083760,Staff,0,16,30,30
1650684522393,MATH 20C,A02,083761,Staff,1,16,30,29
1650684522393,MATH 20C,B01,083762,Staff,10,0,30,20
1650684522393,MATH 20C,B02,083763,Staff,28,0,30,2
1650684528417,MATH 20D,A01,083765,Staff,2,1,30,28
1650684528417,MATH 20D,A02,083766,Staff,6,0,30,24
1650684528417,MATH 20D,A03,083767,Staff,24,0,30,6
1650684534441,MATH 20E,A01,083771,Staff,3,0,30,27
1650684534441,MATH 20E,A02,083772,Staff,16,0,30,14
1650684534441,MATH 20E,B01,083773,Staff,0,0,30,30
1650684534441,MATH 20E,B02,083774,Staff,9,0,30,21
1650684540464,MATH 103A,A01,083777,Staff,0,15,30,30
1650684540464,MATH 103A,A02,083778,Staff,0,15,30,30
1650684540464,MATH 103A,B01,083779,Staff,0,15,30,30
1650684540464,MATH 103A,B02,083780,Staff,0,15,30,30
1650684546488,MATH 105,A01,085443,Staff,0,22,30,30
1650684552509,MATH 109,A01,083213,Anzaldo; Leesa B,0,7,30,30
1650684552509,MATH 109,A02,083214,Anzaldo; Leesa B,0,7,30,30
1650684552509,MATH 109,B01,083215,Anzaldo; Leesa B,0,8,30,30
1650684552509,MATH 109,B02,083216,Anzaldo; Leesa B,0,6,30,30
1650684558554,MATH 142A,A01,083219,Chow; Bennett,0,16,30,30
1650684558554,MATH 142A,A02,083220,Chow; Bennett,0,15,30,30
1650684558554,MATH 142A,B01,083221,Chow; Bennett,0,13,30,30
1650684558554,MATH 142A,B02,083222,Chow; Bennett,0,14,30,30
1650684564579,MATH 193A,A01,083224,Staff,0,5,30,30
1650684564579,MATH 193A,A02,083225,Staff,0,6,30,30
1650684564579,MATH 193A,A03,083781,Staff,0,6,30,30
1650684564579,MATH 193A,A04,083782,Staff,0,7,30,30
1650684570601,MATH 197,001,091859,McAuley; Julian John,9998,0,9999,1
1650684576649,COGS 9,A01,083615,Staff,1,16,60,59
1650684582677,COGS 11,A01,083617,Boyle; Mary E. T.,16,0,40,24
1650684588700,COGS 13,A01,083071,Staff,0,38,40,40
1650684594723,COGS 14A,A01,092681,Staff,0,35,100,100
1650684600746,COGS 14B,A01,083073,Cheng; Tzu-Han,1,14,50,49
1650684606775,COGS 17,A01,092677,Staff,14,0,75,61
1650684612799,COGS 100,A01,083619,Staff,0,29,60,60
1650684618823,COGS 101A,A01,083621,Davis; Joshua Daniel,0,27,60,60
1650684624847,COGS 101B,A01,091572,Staff,0,4,60,60
1650684630874,COGS 101C,A01,083625,Delgado; Tania,14,0,30,16
1650684636898,COGS 107A,A01,083627,Boyle; Mary E. T.,1,17,60,59
1650684642925,COGS 118A,A01,083075,Staff,0,7,60,60
1650684648953,CSE 3,A50,083646,Miranda; Gregory Joseph,18,0,38,20
1650684648953,CSE 3,A51,083647,Miranda; Gregory Joseph,36,0,37,1
1650684654977,CSE 8A,A50,083650,Miranda; Gregory Joseph,0,31,40,40
1650684661001,CSE 11,A01,083080,Cao; Yingjun,0,96,40,40
1650684667025,CSE 12,A01,083652,Staff,0,21,100,100
1650684673048,CSE 15L,A01,083654,Staff,0,3,50,50
1650684673048,CSE 15L,A02,083655,Staff,0,2,50,50
1650684679073,CSE 20,A01,083657,Staff,49,0,80,31
1650684685096,CSE 30,A01,083084,Eldon; John,0,78,40,40
1650684691119,CSE 100,A01,083659,Cao; Yingjun,0,70,50,50
1650684697146,CSE 134B,A01,083661,Powell; Thomas Allan,0,38,65,65
1650684703182,CSE 140,A01,083663,Staff,0,10,75,75
1650684709216,CSE 140L,A01,083088,Eldon; John,0,18,75,75
1650684715238,CSE 175,A01,083665,Kumar; Rakesh,7,0,25,18
1650684721263,CSE 190,A00,092507,Dubnov; Shlomo,10,0,20,10
1650684727377,ECE 45,A01,083139,Staff,0,2,60,60
1650684733408,ECE 65,A50,083695,Staff,0,5,30,30
1650684739435,ECE 109,A01,091882,Touri; Behrouz,33,0,70,37
1650684745458,ECE 180,A00,083140,Abi Samra; Nicholas Camill,20,0,30,10
1650684745458,ECE 180,B00,083141,Abi Samra; Nicholas Camill,0,0,30,30
1650684751482,MATH 10A,A01,083735,Patchell; Gregory David,2,0,30,28
1650684751482,MATH 10A,A02,083736,Patchell; Gregory David,27,0,30,3
1650684751482,MATH 10A,A03,083737,Patchell; Gregory David,24,0,30,6
1650684757506,MATH 10B,A01,083207,Staff,0,9,30,30
1650684757506,MATH 10B,A02,083208,Staff,1,8,30,29
1650684757506,MATH 10B,B01,083739,Staff,11,0,30,19
1650684757506,MATH 10B,B02,083740,Staff,28,0,30,2
1650684763547,MATH 18,A01,083743,Staff,0,0,30,30
1650684763547,MATH 18,A02,083744,Staff,23,0,30,7
1650684763547,MATH 18,A03,083745,Staff,21,0,30,9
1650684763547,MATH 18,A04,083746,Staff,26,0,30,4
1650684763547,MATH 18,B01,083748,Staff,0,15,30,30
1650684763547,MATH 18,B02,083749,Staff,0,12,30,30
1650684763547,MATH 18,B03,083750,Staff,0,12,30,30
1650684763547,MATH 18,B04,083751,Staff,0,12,30,30
1650684769568,MATH 20A,A01,083754,Staff,19,0,40,21
1650684775598,MATH 20B,A01,083756,Staff,0,11,30,30
1650684775598,MATH 20B,A02,083757,Staff,0,12,30,30
1650684781627,MATH 20C,A01,083760,Staff,0,16,30,30
1650684781627,MATH 20C,A02,083761,Staff,1,16,30,29
1650684781627,MATH 20C,B01,083762,Staff,10,0,30,20
1650684781627,MATH 20C,B02,083763,Staff,28,0,30,2
1650684787653,MATH 20D,A01,083765,Staff,2,1,30,28
1650684787653,MATH 20D,A02,083766,Staff,6,0,30,24
1650684787653,MATH 20D,A03,083767,Staff,24,0,30,6
1650684793677,MATH 20E,A01,083771,Staff,3,0,30,27
1650684793677,MATH 20E,A02,083772,Staff,16,0,30,14
1650684793677,MATH 20E,B01,083773,Staff,0,0,30,30
1650684793677,MATH 20E,B02,083774,Staff,9,0,30,21
1650684799699,MATH 103A,A01,083777,Staff,0,15,30,30
1650684799699,MATH 103A,A02,083778,Staff,0,15,30,30
1650684799699,MATH 103A,B01,083779,Staff,0,15,30,30
1650684799699,MATH 103A,B02,083780,Staff,0,15,30,30
1650684805725,MATH 105,A01,085443,Staff,0,22,30,30
1650684811753,MATH 109,A01,083213,Anzaldo; Leesa B,0,7,30,30
1650684811753,MATH 109,A02,083214,Anzaldo; Leesa B,0,7,30,30
1650684811753,MATH 109,B01,083215,Anzaldo; Leesa B,0,8,30,30
1650684811753,MATH 109,B02,083216,Anzaldo; Leesa B,0,6,30,30
1650684817783,MATH 142A,A01,083219,Chow; Bennett,0,16,30,30
1650684817783,MATH 142A,A02,083220,Chow; Bennett,0,15,30,30
1650684817783,MATH 142A,B01,083221,Chow; Bennett,0,13,30,30
1650684817783,MATH 142A,B02,083222,Chow; Bennett,0,14,30,30
1650684823807,MATH 193A,A01,083224,Staff,0,5,30,30
1650684823807,MATH 193A,A02,083225,Staff,0,6,30,30
1650684823807,MATH 193A,A03,083781,Staff,0,6,30,30
1650684823807,MATH 193A,A04,083782,Staff,0,7,30,30
1650684829832,MATH 197,001,091859,McAuley; Julian John,9998,0,9999,1
1650684835891,COGS 9,A01,083615,Staff,1,16,60,59
1650684841917,COGS 11,A01,083617,Boyle; Mary E. T.,16,0,40,24
1650684847941,COGS 13,A01,083071,Staff,0,38,40,40
1650684853965,COGS 14A,A01,092681,Staff,0,35,100,100
1650684859992,COGS 14B,A01,083073,Cheng; Tzu-Han,1,14,50,49
1650684866015,COGS 17,A01,092677,Staff,14,0,75,61
1650684872038,COGS 100,A01,083619,Staff,0,29,60,60
1650684878062,COGS 101A,A01,083621,Davis; Joshua Daniel,0,27,60,60
1650684884086,COGS 101B,A01,091572,Staff,0,4,60,60
1650684890111,COGS 101C,A01,083625,Delgado; Tania,14,0,30,16
1650684896138,COGS 107A,A01,083627,Boyle; Mary E. T.,1,17,60,59
1650684902161,COGS 118A,A01,083075,Staff,0,7,60,60
1650684908198,CSE 3,A50,083646,Miranda; Gregory Joseph,18,0,38,20
1650684908198,CSE 3,A51,083647,Miranda; Gregory Joseph,36,0,37,1
1650684914221,CSE 8A,A50,083650,Miranda; Gregory Joseph,0,31,40,40
1650684920257,CSE 11,A01,083080,Cao; Yingjun,0,96,40,40
1650684926287,CSE 12,A01,083652,Staff,0,21,100,100
1650684932318,CSE 15L,A01,083654,Staff,0,3,50,50
1650684932318,CSE 15L,A02,083655,Staff,0,2,50,50
1650684938358,CSE 20,A01,083657,Staff,49,0,80,31
1650684944381,CSE 30,A01,083084,Eldon; John,0,78,40,40
1650684950407,CSE 100,A01,083659,Cao; Yingjun,0,70,50,50
1650684956430,CSE 134B,A01,083661,Powell; Thomas Allan,0,38,65,65
1650684962460,CSE 140,A01,083663,Staff,0,10,75,75
1650684968491,CSE 140L,A01,083088,Eldon; John,0,18,75,75
1650684974517,CSE 175,A01,083665,Kumar; Rakesh,7,0,25,18
1650684980540,CSE 190,A00,092507,Dubnov; Shlomo,10,0,20,10
1650684986567,ECE 45,A01,083139,Staff,0,2,60,60
1650684992594,ECE 65,A50,083695,Staff,0,5,30,30
1650684998616,ECE 109,A01,091882,Touri; Behrouz,33,0,70,37
1650685004641,ECE 180,A00,083140,Abi Samra; Nicholas Camill,20,0,30,10
1650685004641,ECE 180,B00,083141,Abi Samra; Nicholas Camill,0,0,30,30
1650685010673,MATH 10A,A01,083735,Patchell; Gregory David,2,0,30,28
1650685010673,MATH 10A,A02,083736,Patchell; Gregory David,27,0,30,3
1650685010673,MATH 10A,A03,083737,Patchell; Gregory David,24,0,30,6
1650685016697,MATH 10B,A01,083207,Staff,0,9,30,30
1650685016697,MATH 10B,A02,083208,Staff,1,8,30,29
1650685016697,MATH 10B,B01,083739,Staff,11,0,30,19
1650685016697,MATH 10B,B02,083740,Staff,28,0,30,2
1650685022742,MATH 18,A01,083743,Staff,0,0,30,30
1650685022742,MATH 18,A02,083744,Staff,23,0,30,7
1650685022742,MATH 18,A03,083745,Staff,21,0,30,9
1650685022742,MATH 18,A04,083746,Staff,26,0,30,4
1650685022742,MATH 18,B01,083748,Staff,0,15,30,30
1650685022742,MATH 18,B02,083749,Staff,0,12,30,30
1650685022742,MATH 18,B03,083750,Staff,0,12,30,30
1650685022742,MATH 18,B04,083751,Staff,0,12,30,30
1650685028765,MATH 20A,A01,083754,Staff,19,0,40,21
1650685034788,MATH 20B,A01,083756,Staff,0,11,30,30
1650685034788,MATH 20B,A02,083757,Staff,0,12,30,30
1650685040815,MATH 20C,A01,083760,Staff,0,16,30,30
1650685040815,MATH 20C,A02,083761,Staff,1,16,30,29
1650685040815,MATH 20C,B01,083762,Staff,10,0,30,20
1650685040815,MATH 20C,B02,083763,Staff,28,0,30,2
1650685046839,MATH 20D,A01,083765,Staff,2,1,30,28
1650685046839,MATH 20D,A02,083766,Staff,6,0,30,24
1650685046839,MATH 20D,A03,083767,Staff,24,0,30,6
1650685052869,MATH 20E,A01,083771,Staff,3,0,30,27
1650685052869,MATH 20E,A02,083772,Staff,16,0,30,14
1650685052869,MATH 20E,B01,083773,Staff,0,0,30,30
1650685052869,MATH 20E,B02,083774,Staff,9,0,30,21
1650685058913,MATH 103A,A01,083777,Staff,0,15,30,30
1650685058913,MATH 103A,A02,083778,Staff,0,15,30,30
1650685058913,MATH 103A,B01,083779,Staff,0,15,30,30
1650685058913,MATH 103A,B02,083780,Staff,0,15,30,30
1650685064938,MATH 105,A01,085443,Staff,0,22,30,30
1650685070963,MATH 109,A01,083213,Anzaldo; Leesa B,0,7,30,30
1650685070963,MATH 109,A02,083214,Anzaldo; Leesa B,0,7,30,30
1650685070963,MATH 109,B01,083215,Anzaldo; Leesa B,0,8,30,30
1650685070963,MATH 109,B02,083216,Anzaldo; Leesa B,0,6,30,30
1650685076987,MATH 142A,A01,083219,Chow; Bennett,0,16,30,30
1650685076987,MATH 142A,A02,083220,Chow; Bennett,0,15,30,30
1650685076987,MATH 142A,B01,083221,Chow; Bennett,0,13,30,30
1650685076987,MATH 142A,B02,083222,Chow; Bennett,0,14,30,30
1650685083011,MATH 193A,A01,083224,Staff,0,5,30,30
1650685083011,MATH 193A,A02,083225,Staff,0,6,30,30
1650685083011,MATH 193A,A03,083781,Staff,0,6,30,30
1650685083011,MATH 193A,A04,083782,Staff,0,7,30,30
1650685089039,MATH 197,001,091859,McAuley; Julian John,9998,0,9999,1
1650685095090,COGS 9,A01,083615,Staff,1,16,60,59
1650685101117,COGS 11,A01,083617,Boyle; Mary E. T.,16,0,40,24
1650685107143,COGS 13,A01,083071,Staff,0,38,40,40
1650685113169,COGS 14A,A01,092681,Staff,0,35,100,100
1650685119193,COGS 14B,A01,083073,Cheng; Tzu-Han,1,14,50,49
1650685125219,COGS 17,A01,092677,Staff,14,0,75,61
1650685131242,COGS 100,A01,083619,Staff,0,29,60,60
1650685137276,COGS 101A,A01,083621,Davis; Joshua Daniel,0,27,60,60
1650685143300,COGS 101B,A01,091572,Staff,0,4,60,60
1650685149324,COGS 101C,A01,083625,Delgado; Tania,14,0,30,16
1650685155348,COGS 107A,A01,083627,Boyle; Mary E. T.,1,17,60,59
1650685161371,COGS 118A,A01,083075,Staff,0,7,60,60
1650685167398,CSE 3,A50,083646,Miranda; Gregory Joseph,18,0,38,20
1650685167398,CSE 3,A51,083647,Miranda; Gregory Joseph,36,0,37,1
1650685173436,CSE 8A,A50,083650,Miranda; Gregory Joseph,0,31,40,40
1650685179463,CSE 11,A01,083080,Cao; Yingjun,0,96,40,40
1650685185485,CSE 12,A01,083652,Staff,0,21,100,100
1650685191511,CSE 15L,A01,083654,Staff,0,3,50,50
1650685191511,CSE 15L,A02,083655,Staff,0,2,50,50
1650685197535,CSE 20,A01,083657,Staff,49,0,80,31
1650685203561,CSE 30,A01,083084,Eldon; John,0,78,40,40
1650685209584,CSE 100,A01,083659,Cao; Yingjun,0,70,50,50
1650685215606,CSE 134B,A01,083661,Powell; Thomas Allan,0,38,65,65
1650685221628,CSE 140,A01,083663,Staff,0,10,75,75
1650685227657,CSE 140L,A01,083088,Eldon; John,0,18,75,75
1650685233685,CSE 175,A01,083665,Kumar; Rakesh,7,0,25,18
1650685239709,CSE 190,A00,092507,Dubnov; Shlomo,10,0,20,10
1650685245732,ECE 45,A01,083139,Staff,0,2,60,60
1650685251754,ECE 65,A50,083695,Staff,0,5,30,30
1650685257778,ECE 109,A01,091882,Touri; Behrouz,33,0,70,37
1650685263803,ECE 180,A00,083140,Abi Samra; Nicholas Camill,20,0,30,10
1650685263803,ECE 180,B00,083141,Abi Samra; Nicholas Camill,0,0,30,30
1650685269830,MATH 10A,A01,083735,Patchell; Gregory David,2,0,30,28
1650685269830,MATH 10A,A02,083736,Patchell; Gregory David,27,0,30,3
1650685269830,MATH 10A,A03,083737,Patchell; Gregory David,24,0,30,6
1650685275862,MATH 10B,A01,083207,Staff,0,9,30,30
1650685275862,MATH 10B,A02,083208,Staff,1,8,30,29
1650685275862,MATH 10B,B01,083739,Staff,11,0,30,19
1650685275862,MATH 10B,B02,083740,Staff,28,0,30,2
1650685281887,MATH 18,A01,083743,Staff,0,0,30,30
1650685281887,MATH 18,A02,083744,Staff,23,0,30,7
1650685281887,MATH 18,A03,083745,Staff,21,0,30,9
1650685281887,MATH 18,A04,083746,Staff,26,0,30,4
1650685281887,MATH 18,B01,083748,Staff,0,15,30,30
1650685281887,MATH 18,B02,083749,Staff,0,12,30,30
1650685281887,MATH 18,B03,083750,Staff,0,12,30,30
1650685281887,MATH 18,B04,083751,Staff,0,12,30,30
1650685300207,MATH 20A,A01,083754,Staff,19,0,40,21
1650685306238,MATH 20B,A01,083756,Staff,0,11,30,30
1650685306238,MATH 20B,A02,083757,Staff,0,12,30,30
1650685312259,MATH 20C,A01,083760,Staff,0,16,30,30
1650685312259,MATH 20C,A02,083761,Staff,1,16,30,29
1650685312259,MATH 20C,B01,083762,Staff,10,0,30,20
1650685312259,MATH 20C,B02,083763,Staff,28,0,30,2
1650685318287,MATH 20D,A01,083765,Staff,2,1,30,28
1650685318287,MATH 20D,A02,083766,Staff,6,0,30,24
1650685318287,MATH 20D,A03,083767,Staff,24,0,30,6
1650685324312,MATH 20E,A01,083771,Staff,3,0,30,27
1650685324312,MATH 20E,A02,083772,Staff,16,0,30,14
1650685324312,MATH 20E,B01,083773,Staff,0,0,30,30
1650685324312,MATH 20E,B02,083774,Staff,9,0,30,21
1650685330339,MATH 103A,A01,083777,Staff,0,15,30,30
1650685330339,MATH 103A,A02,083778,Staff,0,15,30,30
1650685330339,MATH 103A,B01,083779,Staff,0,15,30,30
1650685330339,MATH 103A,B02,083780,Staff,0,15,30,30
1650685336464,MATH 105,A01,085443,Staff,0,22,30,30
1650685342499,MATH 109,A01,083213,Anzaldo; Leesa B,0,7,30,30
1650685342499,MATH 109,A02,083214,Anzaldo; Leesa B,0,7,30,30
1650685342499,MATH 109,B01,083215,Anzaldo; Leesa B,0,8,30,30
1650685342499,MATH 109,B02,083216,Anzaldo; Leesa B,0,6,30,30
1650685348522,MATH 142A,A01,083219,Chow; Bennett,0,16,30,30
1650685348522,MATH 142A,A02,083220,Chow; Bennett,0,15,30,30
1650685348522,MATH 142A,B01,083221,Chow; Bennett,0,13,30,30
1650685348522,MATH 142A,B02,083222,Chow; Bennett,0,14,30,30
1650685354552,MATH 193A,A01,083224,Staff,0,5,30,30
1650685354552,MATH 193A,A02,083225,Staff,0,6,30,30
1650685354552,MATH 193A,A03,083781,Staff,0,6,30,30
1650685354552,MATH 193A,A04,083782,Staff,0,7,30,30
1650685360591,MATH 197,001,091859,McAuley; Julian John,9998,0,9999,1
1650685366653,COGS 9,A01,083615,Staff,1,16,60,59
1650685372679,COGS 11,A01,083617,Boyle; Mary E. T.,16,0,40,24
1650685378703,COGS 13,A01,083071,Staff,0,38,40,40
1650685384728,COGS 14A,A01,092681,Staff,0,35,100,100
1650685390760,COGS 14B,A01,083073,Cheng; Tzu-Han,1,14,50,49
1650685396785,COGS 17,A01,092677,Staff,14,0,75,61
1650685402820,COGS 100,A01,083619,Staff,0,29,60,60
1650685408851,COGS 101A,A01,083621,Davis; Joshua Daniel,0,27,60,60
1650685414876,COGS 101B,A01,091572,Staff,0,4,60,60
1650685420900,COGS 101C,A01,083625,Delgado; Tania,14,0,30,16
1650685426923,COGS 107A,A01,083627,Boyle; Mary E. T.,1,17,60,59
1650685432948,COGS 118A,A01,083075,Staff,0,7,60,60
1650685438973,CSE 3,A50,083646,Miranda; Gregory Joseph,18,0,38,20
1650685438973,CSE 3,A51,083647,Miranda; Gregory Joseph,36,0,37,1
1650685444995,CSE 8A,A50,083650,Miranda; Gregory Joseph,0,31,40,40
1650685451022,CSE 11,A01,083080,Cao; Yingjun,0,96,40,40
1650685457081,CSE 12,A01,083652,Staff,0,21,100,100
1650685463105,CSE 15L,A01,083654,Staff,0,3,50,50
1650685463105,CSE 15L,A02,083655,Staff,0,2,50,50
1650685469128,CSE 20,A01,083657,Staff,49,0,80,31
1650685475151,CSE 30,A01,083084,Eldon; John,0,78,40,40
1650685481176,CSE 100,A01,083659,Cao; Yingjun,0,70,50,50
1650685487210,CSE 134B,A01,083661,Powell; Thomas Allan,0,38,65,65
1650685493235,CSE 140,A01,083663,Staff,0,10,75,75
1650685499272,CSE 140L,A01,083088,Eldon; John,0,18,75,75
1650685505297,CSE 175,A01,083665,Kumar; Rakesh,7,0,25,18
1650685511319,CSE 190,A00,092507,Dubnov; Shlomo,10,0,20,10
1650685517349,ECE 45,A01,083139,Staff,0,2,60,60
1650685523375,ECE 65,A50,083695,Staff,0,5,30,30
1650685529399,ECE 109,A01,091882,Touri; Behrouz,33,0,70,37
1650685535422,ECE 180,A00,083140,Abi Samra; Nicholas Camill,20,0,30,10
1650685535422,ECE 180,B00,083141,Abi Samra; Nicholas Camill,0,0,30,30
1650685541444,MATH 10A,A01,083735,Patchell; Gregory David,2,0,30,28
1650685541444,MATH 10A,A02,083736,Patchell; Gregory David,27,0,30,3
1650685541444,MATH 10A,A03,083737,Patchell; Gregory David,24,0,30,6
1650685547468,MATH 10B,A01,083207,Staff,0,9,30,30
1650685547468,MATH 10B,A02,083208,Staff,1,8,30,29
1650685547468,MATH 10B,B01,083739,Staff,11,0,30,19
1650685547468,MATH 10B,B02,083740,Staff,28,0,30,2
1650685553495,MATH 18,A01,083743,Staff,0,0,30,30
1650685553495,MATH 18,A02,083744,Staff,23,0,30,7
1650685553495,MATH 18,A03,083745,Staff,21,0,30,9
1650685553495,MATH 18,A04,083746,Staff,26,0,30,4
1650685553495,MATH 18,B01,083748,Staff,0,15,30,30
1650685553495,MATH 18,B02,083749,Staff,0,12,30,30
1650685553495,MATH 18,B03,083750,Staff,0,12,30,30
1650685553495,MATH 18,B04,083751,Staff,0,12,30,30
1650685559520,MATH 20A,A01,083754,Staff,19,0,40,21
1650685565548,MATH 20B,A01,083756,Staff,0,11,30,30
1650685565548,MATH 20B,A02,083757,Staff,0,12,30,30
1650685571581,MATH 20C,A01,083760,Staff,0,16,30,30
1650685571581,MATH 20C,A02,083761,Staff,1,16,30,29
1650685571581,MATH 20C,B01,083762,Staff,10,0,30,20
1650685571581,MATH 20C,B02,083763,Staff,28,0,30,2
1650685577605,MATH 20D,A01,083765,Staff,2,1,30,28
1650685577605,MATH 20D,A02,083766,Staff,6,0,30,24
1650685577605,MATH 20D,A03,083767,Staff,24,0,30,6
1650685583633,MATH 20E,A01,083771,Staff,3,0,30,27
1650685583633,MATH 20E,A02,083772,Staff,16,0,30,14
1650685583633,MATH 20E,B01,083773,Staff,0,0,30,30
1650685583633,MATH 20E,B02,083774,Staff,9,0,30,21
1650685589660,MATH 103A,A01,083777,Staff,0,15,30,30
1650685589660,MATH 103A,A02,083778,Staff,0,15,30,30
1650685589660,MATH 103A,B01,083779,Staff,0,15,30,30
1650685589660,MATH 103A,B02,083780,Staff,0,15,30,30
1650685595685,MATH 105,A01,085443,Staff,0,22,30,30
1650685601713,MATH 109,A01,083213,Anzaldo; Leesa B,0,7,30,30
1650685601713,MATH 109,A02,083214,Anzaldo; Leesa B,0,7,30,30
1650685601713,MATH 109,B01,083215,Anzaldo; Leesa B,0,8,30,30
1650685601713,MATH 109,B02,083216,Anzaldo; Leesa B,0,6,30,30
1650685607742,MATH 142A,A01,083219,Chow; Bennett,0,16,30,30
1650685607742,MATH 142A,A02,083220,Chow; Bennett,0,15,30,30
1650685607742,MATH 142A,B01,083221,Chow; Bennett,0,13,30,30
1650685607742,MATH 142A,B02,083222,Chow; Bennett,0,14,30,30
1650685613771,MATH 193A,A01,083224,Staff,0,5,30,30
1650685613771,MATH 193A,A02,083225,Staff,0,6,30,30
1650685613771,MATH 193A,A03,083781,Staff,0,6,30,30
1650685613771,MATH 193A,A04,083782,Staff,0,7,30,30
1650685619799,MATH 197,001,091859,McAuley; Julian John,9998,0,9999,1
1650685625862,COGS 9,A01,083615,Staff,1,16,60,59
1650685631899,COGS 11,A01,083617,Boyle; Mary E. T.,16,0,40,24
1650685637927,COGS 13,A01,083071,Staff,0,38,40,40
1650685643954,COGS 14A,A01,092681,Staff,0,35,100,100
1650685649977,COGS 14B,A01,083073,Cheng; Tzu-Han,1,14,50,49
1650685656003,COGS 17,A01,092677,Staff,14,0,75,61
1650685662032,COGS 100,A01,083619,Staff,0,29,60,60
1650685668054,COGS 101A,A01,083621,Davis; Joshua Daniel,0,27,60,60
1650685674092,COGS 101B,A01,091572,Staff,0,4,60,60
1650685680116,COGS 101C,A01,083625,Delgado; Tania,14,0,30,16
1650685686137,COGS 107A,A01,083627,Boyle; Mary E. T.,1,17,60,59
1650685692159,COGS 118A,A01,083075,Staff,0,7,60,60
1650685698181,CSE 3,A50,083646,Miranda; Gregory Joseph,18,0,38,20
1650685698181,CSE 3,A51,083647,Miranda; Gregory Joseph,36,0,37,1
1650685704215,CSE 8A,A50,083650,Miranda; Gregory Joseph,0,31,40,40
1650685710237,CSE 11,A01,083080,Cao; Yingjun,0,96,40,40
1650685716261,CSE 12,A01,083652,Staff,0,21,100,100
1650685722283,CSE 15L,A01,083654,Staff,0,3,50,50
1650685722283,CSE 15L,A02,083655,Staff,0,2,50,50
1650685728306,CSE 20,A01,083657,Staff,49,0,80,31
1650685734333,CSE 30,A01,083084,Eldon; John,0,78,40,40
1650685740361,CSE 100,A01,083659,Cao; Yingjun,0,70,50,50
1650685746383,CSE 134B,A01,083661,Powell; Thomas Allan,0,38,65,65
1650685752409,CSE 140,A01,083663,Staff,0,10,75,75
1650685758433,CSE 140L,A01,083088,Eldon; John,0,18,75,75
1650685764456,CSE 175,A01,083665,Kumar; Rakesh,7,0,25,18
1650685770482,CSE 190,A00,092507,Dubnov; Shlomo,10,0,20,10
1650685776506,ECE 45,A01,083139,Staff,0,2,60,60
1650685782530,ECE 65,A50,083695,Staff,0,5,30,30
1650685788560,ECE 109,A01,091882,Touri; Behrouz,33,0,70,37
1650685794584,ECE 180,A00,083140,Abi Samra; Nicholas Camill,20,0,30,10
1650685794584,ECE 180,B00,083141,Abi Samra; Nicholas Camill,0,0,30,30
1650685800616,MATH 10A,A01,083735,Patchell; Gregory David,2,0,30,28
1650685800616,MATH 10A,A02,083736,Patchell; Gregory David,27,0,30,3
1650685800616,MATH 10A,A03,083737,Patchell; Gregory David,24,0,30,6
1650685806650,MATH 10B,A01,083207,Staff,0,9,30,30
1650685806650,MATH 10B,A02,083208,Staff,1,8,30,29
1650685806650,MATH 10B,B01,083739,Staff,11,0,30,19
1650685806650,MATH 10B,B02,083740,Staff,28,0,30,2
1650685812677,MATH 18,A01,083743,Staff,0,0,30,30
1650685812677,MATH 18,A02,083744,Staff,23,0,30,7
1650685812677,MATH 18,A03,083745,Staff,21,0,30,9
1650685812677,MATH 18,A04,083746,Staff,26,0,30,4
1650685812677,MATH 18,B01,083748,Staff,0,15,30,30
1650685812677,MATH 18,B02,083749,Staff,0,12,30,30
1650685812677,MATH 18,B03,083750,Staff,0,12,30,30
1650685812677,MATH 18,B04,083751,Staff,0,12,30,30
1650685818709,MATH 20A,A01,083754,Staff,19,0,40,21
1650685824734,MATH 20B,A01,083756,Staff,0,11,30,30
1650685824734,MATH 20B,A02,083757,Staff,0,12,30,30
1650685830759,MATH 20C,A01,083760,Staff,0,16,30,30
1650685830759,MATH 20C,A02,083761,Staff,1,16,30,29
1650685830759,MATH 20C,B01,083762,Staff,10,0,30,20
1650685830759,MATH 20C,B02,083763,Staff,28,0,30,2
1650685836780,MATH 20D,A01,083765,Staff,2,1,30,28
1650685836780,MATH 20D,A02,083766,Staff,6,0,30,24
1650685836780,MATH 20D,A03,083767,Staff,24,0,30,6
1650685842804,MATH 20E,A01,083771,Staff,3,0,30,27
1650685842804,MATH 20E,A02,083772,Staff,16,0,30,14
1650685842804,MATH 20E,B01,083773,Staff,0,0,30,30
1650685842804,MATH 20E,B02,083774,Staff,9,0,30,21
1650685848834,MATH 103A,A01,083777,Staff,0,15,30,30
1650685848834,MATH 103A,A02,083778,Staff,0,15,30,30
1650685848834,MATH 103A,B01,083779,Staff,0,15,30,30
1650685848834,MATH 103A,B02,083780,Staff,0,15,30,30
1650685854862,MATH 105,A01,085443,Staff,0,22,30,30
1650685860888,MATH 109,A01,083213,Anzaldo; Leesa B,0,7,30,30
1650685860888,MATH 109,A02,083214,Anzaldo; Leesa B,0,7,30,30
1650685860888,MATH 109,B01,083215,Anzaldo; Leesa B,0,8,30,30
1650685860888,MATH 109,B02,083216,Anzaldo; Leesa B,0,6,30,30
1650685866925,MATH 142A,A01,083219,Chow; Bennett,0,16,30,30
1650685866925,MATH 142A,A02,083220,Chow; Bennett,0,15,30,30
1650685866925,MATH 142A,B01,083221,Chow; Bennett,0,13,30,30
1650685866925,MATH 142A,B02,083222,Chow; Bennett,0,14,30,30
1650685872951,MATH 193A,A01,083224,Staff,0,5,30,30
1650685872951,MATH 193A,A02,083225,Staff,0,6,30,30
1650685872951,MATH 193A,A03,083781,Staff,0,6,30,30
1650685872951,MATH 193A,A04,083782,Staff,0,7,30,30
1650685878975,MATH 197,001,091859,McAuley; Julian John,9998,0,9999,1
1650685885035,COGS 9,A01,083615,Staff,1,16,60,59
1650685891065,COGS 11,A01,083617,Boyle; Mary E. T.,16,0,40,24
1650685897095,COGS 13,A01,083071,Staff,0,38,40,40
1650685903125,COGS 14A,A01,092681,Staff,0,35,100,100
1650685909159,COGS 14B,A01,083073,Cheng; Tzu-Han,1,14,50,49
1650685915185,COGS 17,A01,092677,Staff,14,0,75,61
1650685921213,COGS 100,A01,083619,Staff,0,29,60,60
1650685927325,COGS 101A,A01,083621,Davis; Joshua Daniel,0,27,60,60
1650685933348,COGS 101B,A01,091572,Staff,0,4,60,60
1650685939375,COGS 101C,A01,083625,Delgado; Tania,14,0,30,16
1650685945402,COGS 107A,A01,083627,Boyle; Mary E. T.,1,17,60,59
1650685951435,COGS 118A,A01,083075,Staff,0,7,60,60
1650685957464,CSE 3,A50,083646,Miranda; Gregory Joseph,18,0,38,20
1650685957464,CSE 3,A51,083647,Miranda; Gregory Joseph,36,0,37,1
1650685963488,CSE 8A,A50,083650,Miranda; Gregory Joseph,0,31,40,40
1650685969514,CSE 11,A01,083080,Cao; Yingjun,0,96,40,40
1650685975547,CSE 12,A01,083652,Staff,0,21,100,100
1650685981574,CSE 15L,A01,083654,Staff,0,3,50,50
1650685981574,CSE 15L,A02,083655,Staff,0,2,50,50
1650685987612,CSE 20,A01,083657,Staff,49,0,80,31
1650685993635,CSE 30,A01,083084,Eldon; John,0,78,40,40
1650685999658,CSE 100,A01,083659,Cao; Yingjun,0,70,50,50
1650686005682,CSE 134B,A01,083661,Powell; Thomas Allan,0,38,65,65
1650686011710,CSE 140,A01,083663,Staff,0,10,75,75
1650686017734,CSE 140L,A01,083088,Eldon; John,0,18,75,75
1650686023757,CSE 175,A01,083665,Kumar; Rakesh,7,0,25,18
1650686029781,CSE 190,A00,092507,Dubnov; Shlomo,10,0,20,10
1650686035818,ECE 45,A01,083139,Staff,0,2,60,60
1650686041847,ECE 65,A50,083695,Staff,0,5,30,30
1650686047876,ECE 109,A01,091882,Touri; Behrouz,33,0,70,37
1650686053900,ECE 180,A00,083140,Abi Samra; Nicholas Camill,20,0,30,10
1650686053900,ECE 180,B00,083141,Abi Samra; Nicholas Camill,0,0,30,30
1650686059931,MATH 10A,A01,083735,Patchell; Gregory David,2,0,30,28
1650686059931,MATH 10A,A02,083736,Patchell; Gregory David,27,0,30,3
1650686059931,MATH 10A,A03,083737,Patchell; Gregory David,24,0,30,6
1650686065959,MATH 10B,A01,083207,Staff,0,9,30,30
1650686065959,MATH 10B,A02,083208,Staff,1,8,30,29
1650686065959,MATH 10B,B01,083739,Staff,11,0,30,19
1650686065959,MATH 10B,B02,083740,Staff,28,0,30,2
1650686071992,MATH 18,A01,083743,Staff,0,0,30,30
1650686071992,MATH 18,A02,083744,Staff,23,0,30,7
1650686071992,MATH 18,A03,083745,Staff,21,0,30,9
1650686071992,MATH 18,A04,083746,Staff,26,0,30,4
1650686071992,MATH 18,B01,083748,Staff,0,15,30,30
1650686071992,MATH 18,B02,083749,Staff,0,12,30,30
1650686071992,MATH 18,B03,083750,Staff,0,12,30,30
1650686071992,MATH 18,B04,083751,Staff,0,12,30,30
1650686078014,MATH 20A,A01,083754,Staff,19,0,40,21
1650686084038,MATH 20B,A01,083756,Staff,0,11,30,30
1650686084038,MATH 20B,A02,083757,Staff,0,12,30,30
1650686090062,MATH 20C,A01,083760,Staff,0,16,30,30
1650686090062,MATH 20C,A02,083761,Staff,1,16,30,29
1650686090062,MATH 20C,B01,083762,Staff,10,0,30,20
1650686090062,MATH 20C,B02,083763,Staff,28,0,30,2
1650686096087,MATH 20D,A01,083765,Staff,2,1,30,28
1650686096087,MATH 20D,A02,083766,Staff,6,0,30,24
1650686096087,MATH 20D,A03,083767,Staff,24,0,30,6
1650686102112,MATH 20E,A01,083771,Staff,3,0,30,27
1650686102112,MATH 20E,A02,083772,Staff,16,0,30,14
1650686102112,MATH 20E,B01,083773,Staff,0,0,30,30
1650686102112,MATH 20E,B02,083774,Staff,8,0,30,22
1650686108140,MATH 103A,A01,083777,Staff,0,15,30,30
1650686108140,MATH 103A,A02,083778,Staff,0,15,30,30
1650686108140,MATH 103A,B01,083779,Staff,0,15,30,30
1650686108140,MATH 103A,B02,083780,Staff,0,15,30,30
1650686114163,MATH 105,A01,085443,Staff,0,22,30,30
1650686120188,MATH 109,A01,083213,Anzaldo; Leesa B,0,7,30,30
1650686120188,MATH 109,A02,083214,Anzaldo; Leesa B,0,7,30,30
1650686120188,MATH 109,B01,083215,Anzaldo; Leesa B,0,8,30,30
1650686120188,MATH 109,B02,083216,Anzaldo; Leesa B,0,6,30,30
1650686126217,MATH 142A,A01,083219,Chow; Bennett,0,16,30,30
1650686126217,MATH 142A,A02,083220,Chow; Bennett,0,15,30,30
1650686126217,MATH 142A,B01,083221,Chow; Bennett,0,13,30,30
1650686126217,MATH 142A,B02,083222,Chow; Bennett,0,14,30,30
1650686132240,MATH 193A,A01,083224,Staff,0,5,30,30
1650686132240,MATH 193A,A02,083225,Staff,0,6,30,30
1650686132240,MATH 193A,A03,083781,Staff,0,6,30,30
1650686132240,MATH 193A,A04,083782,Staff,0,7,30,30
1650686138266,MATH 197,001,091859,McAuley; Julian John,9998,0,9999,1
1650686144320,COGS 9,A01,083615,Staff,1,16,60,59
1650686150344,COGS 11,A01,083617,Boyle; Mary E. T.,16,0,40,24
1650686156371,COGS 13,A01,083071,Staff,0,38,40,40
1650686162399,COGS 14A,A01,092681,Staff,0,35,100,100
1650686168423,COGS 14B,A01,083073,Cheng; Tzu-Han,1,14,50,49
1650686174448,COGS 17,A01,092677,Staff,14,0,75,61
1650686180470,COGS 100,A01,083619,Staff,0,29,60,60
1650686186498,COGS 101A,A01,083621,Davis; Joshua Daniel,0,27,60,60
1650686192525,COGS 101B,A01,091572,Staff,0,4,60,60
1650686198556,COGS 101C,A01,083625,Delgado; Tania,14,0,30,16
1650686204591,COGS 107A,A01,083627,Boyle; Mary E. T.,1,17,60,59
1650686210618,COGS 118A,A01,083075,Staff,0,7,60,60
1650686216649,CSE 3,A50,083646,Miranda; Gregory Joseph,18,0,38,20
1650686216649,CSE 3,A51,083647,Miranda; Gregory Joseph,36,0,37,1
1650686222687,CSE 8A,A50,083650,Miranda; Gregory Joseph,0,31,40,40
1650686228713,CSE 11,A01,083080,Cao; Yingjun,0,96,40,40
1650686234738,CSE 12,A01,083652,Staff,0,21,100,100
1650686240762,CSE 15L,A01,083654,Staff,0,3,50,50
1650686240762,CSE 15L,A02,083655,Staff,0,2,50,50
1650686246792,CSE 20,A01,083657,Staff,49,0,80,31
1650686252815,CSE 30,A01,083084,Eldon; John,0,78,40,40
1650686258840,CSE 100,A01,083659,Cao; Yingjun,0,70,50,50
1650686264864,CSE 134B,A01,083661,Powell; Thomas Allan,0,38,65,65
1650686270888,CSE 140,A01,083663,Staff,0,10,75,75
1650686276912,CSE 140L,A01,083088,Eldon; John,0,18,75,75
1650686282936,CSE 175,A01,083665,Kumar; Rakesh,7,0,25,18
1650686288963,CSE 190,A00,092507,Dubnov; Shlomo,10,0,20,10
1650686294989,ECE 45,A01,083139,Staff,0,2,60,60
1650686301015,ECE 65,A50,083695,Staff,0,5,30,30
1650686307043,ECE 109,A01,091882,Touri; Behrouz,33,0,70,37
1650686313067,ECE 180,A00,083140,Abi Samra; Nicholas Camill,20,0,30,10
1650686313067,ECE 180,B00,083141,Abi Samra; Nicholas Camill,0,0,30,30
1650686319091,MATH 10A,A01,083735,Patchell; Gregory David,2,0,30,28
1650686319091,MATH 10A,A02,083736,Patchell; Gregory David,27,0,30,3
1650686319091,MATH 10A,A03,083737,Patchell; Gregory David,24,0,30,6
1650686325119,MATH 10B,A01,083207,Staff,0,9,30,30
1650686325119,MATH 10B,A02,083208,Staff,1,8,30,29
1650686325119,MATH 10B,B01,083739,Staff,11,0,30,19
1650686325119,MATH 10B,B02,083740,Staff,28,0,30,2
1650686331148,MATH 18,A01,083743,Staff,0,0,30,30
1650686331148,MATH 18,A02,083744,Staff,23,0,30,7
1650686331148,MATH 18,A03,083745,Staff,21,0,30,9
1650686331148,MATH 18,A04,083746,Staff,26,0,30,4
1650686331148,MATH 18,B01,083748,Staff,0,15,30,30
1650686331148,MATH 18,B02,083749,Staff,0,12,30,30
1650686331148,MATH 18,B03,083750,Staff,0,12,30,30
1650686331148,MATH 18,B04,083751,Staff,0,12,30,30
1650686337175,MATH 20A,A01,083754,Staff,19,0,40,21
1650686343204,MATH 20B,A01,083756,Staff,0,11,30,30
1650686343204,MATH 20B,A02,083757,Staff,0,12,30,30
1650686349229,MATH 20C,A01,083760,Staff,0,16,30,30
1650686349229,MATH 20C,A02,083761,Staff,1,16,30,29
1650686349229,MATH 20C,B01,083762,Staff,10,0,30,20
1650686349229,MATH 20C,B02,083763,Staff,28,0,30,2
1650686355257,MATH 20D,A01,083765,Staff,2,1,30,28
1650686355257,MATH 20D,A02,083766,Staff,6,0,30,24
1650686355257,MATH 20D,A03,083767,Staff,24,0,30,6
1650686361287,MATH 20E,A01,083771,Staff,3,0,30,27
1650686361287,MATH 20E,A02,083772,Staff,16,0,30,14
1650686361287,MATH 20E,B01,083773,Staff,0,0,30,30
1650686361287,MATH 20E,B02,083774,Staff,8,0,30,22
1650686367315,MATH 103A,A01,083777,Staff,0,15,30,30
1650686367315,MATH 103A,A02,083778,Staff,0,15,30,30
1650686367315,MATH 103A,B01,083779,Staff,0,15,30,30
1650686367315,MATH 103A,B02,083780,Staff,0,15,30,30
1650686373340,MATH 105,A01,085443,Staff,0,22,30,30
1650686379375,MATH 109,A01,083213,Anzaldo; Leesa B,0,7,30,30
1650686379375,MATH 109,A02,083214,Anzaldo; Leesa B,0,7,30,30
1650686379375,MATH 109,B01,083215,Anzaldo; Leesa B,0,8,30,30
1650686379375,MATH 109,B02,083216,Anzaldo; Leesa B,0,6,30,30
1650686385398,MATH 142A,A01,083219,Chow; Bennett,0,16,30,30
1650686385398,MATH 142A,A02,083220,Chow; Bennett,0,15,30,30
1650686385398,MATH 142A,B01,083221,Chow; Bennett,0,13,30,30
1650686385398,MATH 142A,B02,083222,Chow; Bennett,0,14,30,30
1650686391436,MATH 193A,A01,083224,Staff,0,5,30,30
1650686391436,MATH 193A,A02,083225,Staff,0,6,30,30
1650686391436,MATH 193A,A03,083781,Staff,0,6,30,30
1650686391436,MATH 193A,A04,083782,Staff,0,7,30,30
1650686397459,MATH 197,001,091859,McAuley; Julian John,9998,0,9999,1
1650686403515,COGS 9,A01,083615,Staff,1,16,60,59
1650686409539,COGS 11,A01,083617,Boyle; Mary E. T.,16,0,40,24
1650686415561,COGS 13,A01,083071,Staff,0,38,40,40
1650686421587,COGS 14A,A01,092681,Staff,0,35,100,100
1650686427617,COGS 14B,A01,083073,Cheng; Tzu-Han,1,14,50,49
1650686433640,COGS 17,A01,092677,Staff,14,0,75,61
1650686439663,COGS 100,A01,083619,Staff,0,29,60,60
1650686445695,COGS 101A,A01,083621,Davis; Joshua Daniel,0,27,60,60
1650686451717,COGS 101B,A01,091572,Staff,0,4,60,60
1650686457744,COGS 101C,A01,083625,Delgado; Tania,14,0,30,16
1650686463770,COGS 107A,A01,083627,Boyle; Mary E. T.,1,17,60,59
1650686469793,COGS 118A,A01,083075,Staff,0,7,60,60
1650686475816,CSE 3,A50,083646,Miranda; Gregory Joseph,18,0,38,20
1650686475816,CSE 3,A51,083647,Miranda; Gregory Joseph,36,0,37,1
1650686481839,CSE 8A,A50,083650,Miranda; Gregory Joseph,0,31,40,40
1650686487863,CSE 11,A01,083080,Cao; Yingjun,0,96,40,40
1650686493888,CSE 12,A01,083652,Staff,0,21,100,100
1650686499912,CSE 15L,A01,083654,Staff,0,3,50,50
1650686499912,CSE 15L,A02,083655,Staff,0,2,50,50
1650686505942,CSE 20,A01,083657,Staff,49,0,80,31
1650686511966,CSE 30,A01,083084,Eldon; John,0,78,40,40
1650686517994,CSE 100,A01,083659,Cao; Yingjun,0,70,50,50
1650686524109,CSE 134B,A01,083661,Powell; Thomas Allan,0,38,65,65
1650686530132,CSE 140,A01,083663,Staff,0,10,75,75
1650686536158,CSE 140L,A01,083088,Eldon; John,0,18,75,75
1650686542183,CSE 175,A01,083665,Kumar; Rakesh,7,0,25,18
1650686548207,CSE 190,A00,092507,Dubnov; Shlomo,10,0,20,10
1650686554233,ECE 45,A01,083139,Staff,0,2,60,60
1650686560265,ECE 65,A50,083695,Staff,0,5,30,30
1650686566297,ECE 109,A01,091882,Touri; Behrouz,33,0,70,37
1650686572326,ECE 180,A00,083140,Abi Samra; Nicholas Camill,20,0,30,10
1650686572326,ECE 180,B00,083141,Abi Samra; Nicholas Camill,0,0,30,30
1650686578351,MATH 10A,A01,083735,Patchell; Gregory David,2,0,30,28
1650686578351,MATH 10A,A02,083736,Patchell; Gregory David,27,0,30,3
1650686578351,MATH 10A,A03,083737,Patchell; Gregory David,24,0,30,6
1650686584380,MATH 10B,A01,083207,Staff,0,9,30,30
1650686584380,MATH 10B,A02,083208,Staff,1,8,30,29
1650686584380,MATH 10B,B01,083739,Staff,11,0,30,19
1650686584380,MATH 10B,B02,083740,Staff,28,0,30,2
1650686590410,MATH 18,A01,083743,Staff,0,0,30,30
1650686590410,MATH 18,A02,083744,Staff,23,0,30,7
1650686590410,MATH 18,A03,083745,Staff,21,0,30,9
1650686590410,MATH 18,A04,083746,Staff,26,0,30,4
1650686590410,MATH 18,B01,083748,Staff,0,15,30,30
1650686590410,MATH 18,B02,083749,Staff,0,12,30,30
1650686590410,MATH 18,B03,083750,Staff,0,12,30,30
1650686590410,MATH 18,B04,083751,Staff,0,12,30,30
1650686596439,MATH 20A,A01,083754,Staff,19,0,40,21
1650686602465,MATH 20B,A01,083756,Staff,0,11,30,30
1650686602465,MATH 20B,A02,083757,Staff,0,12,30,30
1650686608490,MATH 20C,A01,083760,Staff,0,16,30,30
1650686608490,MATH 20C,A02,083761,Staff,1,16,30,29
1650686608490,MATH 20C,B01,083762,Staff,10,0,30,20
1650686608490,MATH 20C,B02,083763,Staff,28,0,30,2
1650686614516,MATH 20D,A01,083765,Staff,2,1,30,28
1650686614516,MATH 20D,A02,083766,Staff,6,0,30,24
1650686614516,MATH 20D,A03,083767,Staff,24,0,30,6
1650686620543,MATH 20E,A01,083771,Staff,3,0,30,27
1650686620543,MATH 20E,A02,083772,Staff,16,0,30,14
1650686620543,MATH 20E,B01,083773,Staff,0,0,30,30
1650686620543,MATH 20E,B02,083774,Staff,8,0,30,22
1650686626568,MATH 103A,A01,083777,Staff,0,15,30,30
1650686626568,MATH 103A,A02,083778,Staff,0,15,30,30
1650686626568,MATH 103A,B01,083779,Staff,0,15,30,30
1650686626568,MATH 103A,B02,083780,Staff,0,15,30,30
1650686632591,MATH 105,A01,085443,Staff,0,22,30,30
1650686638615,MATH 109,A01,083213,Anzaldo; Leesa B,0,7,30,30
1650686638615,MATH 109,A02,083214,Anzaldo; Leesa B,0,7,30,30
1650686638615,MATH 109,B01,083215,Anzaldo; Leesa B,0,8,30,30
1650686638615,MATH 109,B02,083216,Anzaldo; Leesa B,0,6,30,30
1650686644639,MATH 142A,A01,083219,Chow; Bennett,0,16,30,30
1650686644639,MATH 142A,A02,083220,Chow; Bennett,0,15,30,30
1650686644639,MATH 142A,B01,083221,Chow; Bennett,0,13,30,30
1650686644639,MATH 142A,B02,083222,Chow; Bennett,0,14,30,30
1650686650663,MATH 193A,A01,083224,Staff,0,5,30,30
1650686650663,MATH 193A,A02,083225,Staff,0,6,30,30
1650686650663,MATH 193A,A03,083781,Staff,0,6,30,30
1650686650663,MATH 193A,A04,083782,Staff,0,7,30,30
1650686656687,MATH 197,001,091859,McAuley; Julian John,9998,0,9999,1
1650686662741,COGS 9,A01,083615,Staff,1,16,60,59
1650686668765,COGS 11,A01,083617,Boyle; Mary E. T.,16,0,40,24
1650686674788,COGS 13,A01,083071,Staff,0,38,40,40
1650686680812,COGS 14A,A01,092681,Staff,0,35,100,100
1650686686840,COGS 14B,A01,083073,Cheng; Tzu-Han,1,14,50,49
1650686692870,COGS 17,A01,092677,Staff,14,0,75,61
1650686698899,COGS 100,A01,083619,Staff,0,29,60,60
1650686704924,COGS 101A,A01,083621,Davis; Joshua Daniel,0,27,60,60
1650686710948,COGS 101B,A01,091572,Staff,0,4,60,60
1650686716977,COGS 101C,A01,083625,Delgado; Tania,14,0,30,16
1650686723004,COGS 107A,A01,083627,Boyle; Mary E. T.,1,17,60,59
1650686729032,COGS 118A,A01,083075,Staff,0,7,60,60
1650686735055,CSE 3,A50,083646,Miranda; Gregory Joseph,18,0,38,20
1650686735055,CSE 3,A51,083647,Miranda; Gregory Joseph,36,0,37,1
1650686741080,CSE 8A,A50,083650,Miranda; Gregory Joseph,0,31,40,40
1650686747102,CSE 11,A01,083080,Cao; Yingjun,0,96,40,40
1650686753130,CSE 12,A01,083652,Staff,0,21,100,100
1650686759154,CSE 15L,A01,083654,Staff,0,3,50,50
1650686759154,CSE 15L,A02,083655,Staff,0,2,50,50
1650686765179,CSE 20,A01,083657,Staff,49,0,80,31
1650686771206,CSE 30,A01,083084,Eldon; John,0,78,40,40
1650686777233,CSE 100,A01,083659,Cao; Yingjun,0,70,50,50
1650686783259,CSE 134B,A01,083661,Powell; Thomas Allan,0,38,65,65
1650686789281,CSE 140,A01,083663,Staff,0,10,75,75
1650686795307,CSE 140L,A01,083088,Eldon; John,0,18,75,75
1650686801335,CSE 175,A01,083665,Kumar; Rakesh,7,0,25,18
1650686807367,CSE 190,A00,092507,Dubnov; Shlomo,10,0,20,10
1650686813392,ECE 45,A01,083139,Staff,0,2,60,60
1650686819416,ECE 65,A50,083695,Staff,0,5,30,30
1650686825442,ECE 109,A01,091882,Touri; Behrouz,33,0,70,37
1650686831477,ECE 180,A00,083140,Abi Samra; Nicholas Camill,20,0,30,10
1650686831477,ECE 180,B00,083141,Abi Samra; Nicholas Camill,0,0,30,30
1650686837502,MATH 10A,A01,083735,Patchell; Gregory David,2,0,30,28
1650686837502,MATH 10A,A02,083736,Patchell; Gregory David,27,0,30,3
1650686837502,MATH 10A,A03,083737,Patchell; Gregory David,24,0,30,6
1650686843525,MATH 10B,A01,083207,Staff,0,9,30,30
1650686843525,MATH 10B,A02,083208,Staff,1,8,30,29
1650686843525,MATH 10B,B01,083739,Staff,11,0,30,19
1650686843525,MATH 10B,B02,083740,Staff,28,0,30,2
1650686849554,MATH 18,A01,083743,Staff,0,0,30,30
1650686849554,MATH 18,A02,083744,Staff,23,0,30,7
1650686849554,MATH 18,A03,083745,Staff,21,0,30,9
1650686849554,MATH 18,A04,083746,Staff,26,0,30,4
1650686849554,MATH 18,B01,083748,Staff,0,15,30,30
1650686849554,MATH 18,B02,083749,Staff,0,12,30,30
1650686849554,MATH 18,B03,083750,Staff,0,12,30,30
1650686849554,MATH 18,B04,083751,Staff,0,12,30,30
1650686855575,MATH 20A,A01,083754,Staff,19,0,40,21
1650686861600,MATH 20B,A01,083756,Staff,0,11,30,30
1650686861600,MATH 20B,A02,083757,Staff,0,12,30,30
1650686867624,MATH 20C,A01,083760,Staff,0,16,30,30
1650686867624,MATH 20C,A02,083761,Staff,1,16,30,29
1650686867624,MATH 20C,B01,083762,Staff,10,0,30,20
1650686867624,MATH 20C,B02,083763,Staff,28,0,30,2
1650686873660,MATH 20D,A01,083765,Staff,2,1,30,28
1650686873660,MATH 20D,A02,083766,Staff,6,0,30,24
1650686873660,MATH 20D,A03,083767,Staff,24,0,30,6
1650686879682,MATH 20E,A01,083771,Staff,3,0,30,27
1650686879682,MATH 20E,A02,083772,Staff,16,0,30,14
1650686879682,MATH 20E,B01,083773,Staff,0,0,30,30
1650686879682,MATH 20E,B02,083774,Staff,8,0,30,22
1650686885709,MATH 103A,A01,083777,Staff,0,15,30,30
1650686885709,MATH 103A,A02,083778,Staff,0,15,30,30
1650686885709,MATH 103A,B01,083779,Staff,0,15,30,30
1650686885709,MATH 103A,B02,083780,Staff,0,15,30,30
1650686891733,MATH 105,A01,085443,Staff,0,22,30,30
1650686897757,MATH 109,A01,083213,Anzaldo; Leesa B,0,7,30,30
1650686897757,MATH 109,A02,083214,Anzaldo; Leesa B,0,7,30,30
1650686897757,MATH 109,B01,083215,Anzaldo; Leesa B,0,8,30,30
1650686897757,MATH 109,B02,083216,Anzaldo; Leesa B,0,6,30,30
1650686903782,MATH 142A,A01,083219,Chow; Bennett,0,16,30,30
1650686903782,MATH 142A,A02,083220,Chow; Bennett,0,15,30,30
1650686903782,MATH 142A,B01,083221,Chow; Bennett,0,13,30,30
1650686903782,MATH 142A,B02,083222,Chow; Bennett,0,14,30,30
1650686909816,MATH 193A,A01,083224,Staff,0,5,30,30
1650686909816,MATH 193A,A02,083225,Staff,0,6,30,30
1650686909816,MATH 193A,A03,083781,Staff,0,6,30,30
1650686909816,MATH 193A,A04,083782,Staff,0,7,30,30
1650686915842,MATH 197,001,091859,McAuley; Julian John,9998,0,9999,1
1650686921890,COGS 9,A01,083615,Staff,1,16,60,59
1650686927913,COGS 11,A01,083617,Boyle; Mary E. T.,16,0,40,24
1650686933938,COGS 13,A01,083071,Staff,0,38,40,40
1650686939964,COGS 14A,A01,092681,Staff,0,35,100,100
1650686946003,COGS 14B,A01,083073,Cheng; Tzu-Han,1,14,50,49
1650686952026,COGS 17,A01,092677,Staff,14,0,75,61
1650686958049,COGS 100,A01,083619,Staff,0,29,60,60
1650686964076,COGS 101A,A01,083621,Davis; Joshua Daniel,0,27,60,60
1650686970104,COGS 101B,A01,091572,Staff,0,4,60,60
1650686976127,COGS 101C,A01,083625,Delgado; Tania,14,0,30,16
1650686982149,COGS 107A,A01,083627,Boyle; Mary E. T.,1,17,60,59
1650686988173,COGS 118A,A01,083075,Staff,0,7,60,60
1650686994196,CSE 3,A50,083646,Miranda; Gregory Joseph,18,0,38,20
1650686994196,CSE 3,A51,083647,Miranda; Gregory Joseph,36,0,37,1
1650687000220,CSE 8A,A50,083650,Miranda; Gregory Joseph,0,31,40,40
1650687006246,CSE 11,A01,083080,Cao; Yingjun,0,96,40,40
1650687012283,CSE 12,A01,083652,Staff,0,21,100,100
1650687018333,CSE 15L,A01,083654,Staff,0,3,50,50
1650687018333,CSE 15L,A02,083655,Staff,0,2,50,50
1650687024358,CSE 20,A01,083657,Staff,49,0,80,31
1650687030385,CSE 30,A01,083084,Eldon; John,0,78,40,40
1650687036408,CSE 100,A01,083659,Cao; Yingjun,0,70,50,50
1650687042430,CSE 134B,A01,083661,Powell; Thomas Allan,0,38,65,65
1650687048456,CSE 140,A01,083663,Staff,0,10,75,75
1650687054482,CSE 140L,A01,083088,Eldon; John,0,18,75,75
1650687060506,CSE 175,A01,083665,Kumar; Rakesh,7,0,25,18
1650687066531,CSE 190,A00,092507,Dubnov; Shlomo,10,0,20,10
1650687072554,ECE 45,A01,083139,Staff,0,2,60,60
1650687078577,ECE 65,A50,083695,Staff,0,5,30,30
1650687084600,ECE 109,A01,091882,Touri; Behrouz,33,0,70,37
1650687090644,ECE 180,A00,083140,Abi Samra; Nicholas Camill,20,0,30,10
1650687090644,ECE 180,B00,083141,Abi Samra; Nicholas Camill,0,0,30,30
1650687096668,MATH 10A,A01,083735,Patchell; Gregory David,2,0,30,28
1650687096668,MATH 10A,A02,083736,Patchell; Gregory David,27,0,30,3
1650687096668,MATH 10A,A03,083737,Patchell; Gregory David,24,0,30,6
1650687102689,MATH 10B,A01,083207,Staff,0,9,30,30
1650687102689,MATH 10B,A02,083208,Staff,1,8,30,29
1650687102689,MATH 10B,B01,083739,Staff,11,0,30,19
1650687102689,MATH 10B,B02,083740,Staff,28,0,30,2
1650687108716,MATH 18,A01,083743,Staff,0,0,30,30
1650687108716,MATH 18,A02,083744,Staff,23,0,30,7
1650687108716,MATH 18,A03,083745,Staff,21,0,30,9
1650687108716,MATH 18,A04,083746,Staff,26,0,30,4
1650687108716,MATH 18,B01,083748,Staff,0,15,30,30
1650687108716,MATH 18,B02,083749,Staff,0,12,30,30
1650687108716,MATH 18,B03,083750,Staff,0,12,30,30
1650687108716,MATH 18,B04,083751,Staff,0,12,30,30
1650687114740,MATH 20A,A01,083754,Staff,19,0,40,21
1650687120857,MATH 20B,A01,083756,Staff,0,11,30,30
1650687120857,MATH 20B,A02,083757,Staff,0,12,30,30
1650687126884,MATH 20C,A01,083760,Staff,0,16,30,30
1650687126884,MATH 20C,A02,083761,Staff,1,16,30,29
1650687126884,MATH 20C,B01,083762,Staff,9,0,30,21
1650687126884,MATH 20C,B02,083763,Staff,28,0,30,2
1650687132906,MATH 20D,A01,083765,Staff,2,1,30,28
1650687132906,MATH 20D,A02,083766,Staff,6,0,30,24
1650687132906,MATH 20D,A03,083767,Staff,24,0,30,6
1650687138930,MATH 20E,A01,083771,Staff,3,0,30,27
1650687138930,MATH 20E,A02,083772,Staff,16,0,30,14
1650687138930,MATH 20E,B01,083773,Staff,0,0,30,30
1650687138930,MATH 20E,B02,083774,Staff,8,0,30,22
1650687144958,MATH 103A,A01,083777,Staff,0,15,30,30
1650687144958,MATH 103A,A02,083778,Staff,0,15,30,30
1650687144958,MATH 103A,B01,083779,Staff,0,15,30,30
1650687144958,MATH 103A,B02,083780,Staff,0,15,30,30
1650687150981,MATH 105,A01,085443,Staff,0,22,30,30
1650687157005,MATH 109,A01,083213,Anzaldo; Leesa B,0,7,30,30
1650687157005,MATH 109,A02,083214,Anzaldo; Leesa B,0,7,30,30
1650687157005,MATH 109,B01,083215,Anzaldo; Leesa B,0,8,30,30
1650687157005,MATH 109,B02,083216,Anzaldo; Leesa B,0,6,30,30
1650687163026,MATH 142A,A01,083219,Chow; Bennett,0,16,30,30
1650687163026,MATH 142A,A02,083220,Chow; Bennett,0,15,30,30
1650687163026,MATH 142A,B01,083221,Chow; Bennett,0,14,30,30
1650687163026,MATH 142A,B02,083222,Chow; Bennett,0,14,30,30
1650687169060,MATH 193A,A01,083224,Staff,0,5,30,30
1650687169060,MATH 193A,A02,083225,Staff,0,6,30,30
1650687169060,MATH 193A,A03,083781,Staff,0,6,30,30
1650687169060,MATH 193A,A04,083782,Staff,0,7,30,30
1650687175084,MATH 197,001,091859,McAuley; Julian John,9998,0,9999,1
1650687181143,COGS 9,A01,083615,Staff,1,16,60,59
1650687187166,COGS 11,A01,083617,Boyle; Mary E. T.,16,0,40,24
1650687193189,COGS 13,A01,083071,Staff,0,38,40,40
1650687199214,COGS 14A,A01,092681,Staff,0,35,100,100
1650687205238,COGS 14B,A01,083073,Cheng; Tzu-Han,1,14,50,49
1650687211263,COGS 17,A01,092677,Staff,14,0,75,61
1650687217289,COGS 100,A01,083619,Staff,0,29,60,60
1650687223321,COGS 101A,A01,083621,Davis; Joshua Daniel,0,27,60,60
1650687229352,COGS 101B,A01,091572,Staff,0,4,60,60
1650687235375,COGS 101C,A01,083625,Delgado; Tania,14,0,30,16
1650687241401,COGS 107A,A01,083627,Boyle; Mary E. T.,1,17,60,59
1650687247428,COGS 118A,A01,083075,Staff,0,7,60,60
1650687253454,CSE 3,A50,083646,Miranda; Gregory Joseph,18,0,38,20
1650687253454,CSE 3,A51,083647,Miranda; Gregory Joseph,36,0,37,1
1650687259480,CSE 8A,A50,083650,Miranda; Gregory Joseph,0,31,40,40
1650687265507,CSE 11,A01,083080,Cao; Yingjun,0,96,40,40
1650687271532,CSE 12,A01,083652,Staff,0,21,100,100
1650687277561,CSE 15L,A01,083654,Staff,0,3,50,50
1650687277561,CSE 15L,A02,083655,Staff,0,2,50,50
1650687283589,CSE 20,A01,083657,Staff,49,0,80,31
1650687289612,CSE 30,A01,083084,Eldon; John,0,78,40,40
1650687295639,CSE 100,A01,083659,Cao; Yingjun,0,70,50,50
1650687301667,CSE 134B,A01,083661,Powell; Thomas Allan,0,38,65,65
1650687307690,CSE 140,A01,083663,Staff,0,10,75,75
1650687313716,CSE 140L,A01,083088,Eldon; John,0,18,75,75
1650687319741,CSE 175,A01,083665,Kumar; Rakesh,7,0,25,18
1650687325765,CSE 190,A00,092507,Dubnov; Shlomo,10,0,20,10
1650687331796,ECE 45,A01,083139,Staff,0,2,60,60
1650687337820,ECE 65,A50,083695,Staff,0,5,30,30
1650687343843,ECE 109,A01,091882,Touri; Behrouz,33,0,70,37
1650687349866,ECE 180,A00,083140,Abi Samra; Nicholas Camill,20,0,30,10
1650687349866,ECE 180,B00,083141,Abi Samra; Nicholas Camill,0,0,30,30
1650687355900,MATH 10A,A01,083735,Patchell; Gregory David,2,0,30,28
1650687355900,MATH 10A,A02,083736,Patchell; Gregory David,27,0,30,3
1650687355900,MATH 10A,A03,083737,Patchell; Gregory David,24,0,30,6
1650687361932,MATH 10B,A01,083207,Staff,0,9,30,30
1650687361932,MATH 10B,A02,083208,Staff,1,8,30,29
1650687361932,MATH 10B,B01,083739,Staff,11,0,30,19
1650687361932,MATH 10B,B02,083740,Staff,28,0,30,2
1650687367964,MATH 18,A01,083743,Staff,0,0,30,30
1650687367964,MATH 18,A02,083744,Staff,23,0,30,7
1650687367964,MATH 18,A03,083745,Staff,21,0,30,9
1650687367964,MATH 18,A04,083746,Staff,26,0,30,4
1650687367964,MATH 18,B01,083748,Staff,0,15,30,30
1650687367964,MATH 18,B02,083749,Staff,0,12,30,30
1650687367964,MATH 18,B03,083750,Staff,0,12,30,30
1650687367964,MATH 18,B04,083751,Staff,0,12,30,30
1650687373987,MATH 20A,A01,083754,Staff,19,0,40,21
1650687380013,MATH 20B,A01,083756,Staff,0,11,30,30
1650687380013,MATH 20B,A02,083757,Staff,0,12,30,30
1650687386041,MATH 20C,A01,083760,Staff,0,16,30,30
1650687386041,MATH 20C,A02,083761,Staff,1,16,30,29
1650687386041,MATH 20C,B01,083762,Staff,9,0,30,21
1650687386041,MATH 20C,B02,083763,Staff,28,0,30,2
1650687392065,MATH 20D,A01,083765,Staff,2,1,30,28
1650687392065,MATH 20D,A02,083766,Staff,6,0,30,24
1650687392065,MATH 20D,A03,083767,Staff,24,0,30,6
1650687398088,MATH 20E,A01,083771,Staff,3,0,30,27
1650687398088,MATH 20E,A02,083772,Staff,16,0,30,14
1650687398088,MATH 20E,B01,083773,Staff,0,0,30,30
1650687398088,MATH 20E,B02,083774,Staff,8,0,30,22
1650687404112,MATH 103A,A01,083777,Staff,0,15,30,30
1650687404112,MATH 103A,A02,083778,Staff,0,15,30,30
1650687404112,MATH 103A,B01,083779,Staff,0,15,30,30
1650687404112,MATH 103A,B02,083780,Staff,0,15,30,30
1650687410139,MATH 105,A01,085443,Staff,0,22,30,30
1650687416164,MATH 109,A01,083213,Anzaldo; Leesa B,0,7,30,30
1650687416164,MATH 109,A02,083214,Anzaldo; Leesa B,0,7,30,30
1650687416164,MATH 109,B01,083215,Anzaldo; Leesa B,0,8,30,30
1650687416164,MATH 109,B02,083216,Anzaldo; Leesa B,0,6,30,30
1650687422195,MATH 142A,A01,083219,Chow; Bennett,0,16,30,30
1650687422195,MATH 142A,A02,083220,Chow; Bennett,0,15,30,30
1650687422195,MATH 142A,B01,083221,Chow; Bennett,0,14,30,30
1650687422195,MATH 142A,B02,083222,Chow; Bennett,0,14,30,30
1650687428220,MATH 193A,A01,083224,Staff,0,5,30,30
1650687428220,MATH 193A,A02,083225,Staff,0,6,30,30
1650687428220,MATH 193A,A03,083781,Staff,0,6,30,30
1650687428220,MATH 193A,A04,083782,Staff,0,7,30,30
1650687434244,MATH 197,001,091859,McAuley; Julian John,9998,0,9999,1
1650687440292,COGS 9,A01,083615,Staff,1,16,60,59
1650687446318,COGS 11,A01,083617,Boyle; Mary E. T.,16,0,40,24
1650687452343,COGS 13,A01,083071,Staff,0,38,40,40
1650687458367,COGS 14A,A01,092681,Staff,0,35,100,100
1650687464395,COGS 14B,A01,083073,Cheng; Tzu-Han,1,14,50,49
1650687470424,COGS 17,A01,092677,Staff,14,0,75,61
1650687476448,COGS 100,A01,083619,Staff,0,29,60,60
1650687482472,COGS 101A,A01,083621,Davis; Joshua Daniel,0,27,60,60
1650687488498,COGS 101B,A01,091572,Staff,0,4,60,60
1650687494520,COGS 101C,A01,083625,Delgado; Tania,14,0,30,16
1650687500544,COGS 107A,A01,083627,Boyle; Mary E. T.,1,17,60,59
1650687506568,COGS 118A,A01,083075,Staff,0,7,60,60
1650687512593,CSE 3,A50,083646,Miranda; Gregory Joseph,18,0,38,20
1650687512593,CSE 3,A51,083647,Miranda; Gregory Joseph,36,0,37,1
1650687518616,CSE 8A,A50,083650,Miranda; Gregory Joseph,0,31,40,40
1650687524640,CSE 11,A01,083080,Cao; Yingjun,0,96,40,40
1650687530672,CSE 12,A01,083652,Staff,0,21,100,100
1650687536696,CSE 15L,A01,083654,Staff,0,3,50,50
1650687536696,CSE 15L,A02,083655,Staff,0,2,50,50
1650687542723,CSE 20,A01,083657,Staff,49,0,80,31
1650687548759,CSE 30,A01,083084,Eldon; John,0,78,40,40
1650687554786,CSE 100,A01,083659,Cao; Yingjun,0,70,50,50
1650687560813,CSE 134B,A01,083661,Powell; Thomas Allan,0,38,65,65
1650687566837,CSE 140,A01,083663,Staff,0,10,75,75
1650687572862,CSE 140L,A01,083088,Eldon; John,0,18,75,75
1650687578886,CSE 175,A01,083665,Kumar; Rakesh,7,0,25,18
1650687584912,CSE 190,A00,092507,Dubnov; Shlomo,10,0,20,10
1650687590935,ECE 45,A01,083139,Staff,0,2,60,60
1650687596959,ECE 65,A50,083695,Staff,0,5,30,30
1650687602986,ECE 109,A01,091882,Touri; Behrouz,33,0,70,37
1650687609012,ECE 180,A00,083140,Abi Samra; Nicholas Camill,20,0,30,10
1650687609012,ECE 180,B00,083141,Abi Samra; Nicholas Camill,0,0,30,30
1650687615037,MATH 10A,A01,083735,Patchell; Gregory David,2,0,30,28
1650687615037,MATH 10A,A02,083736,Patchell; Gregory David,27,0,30,3
1650687615037,MATH 10A,A03,083737,Patchell; Gregory David,24,0,30,6
1650687621061,MATH 10B,A01,083207,Staff,0,9,30,30
1650687621061,MATH 10B,A02,083208,Staff,1,8,30,29
1650687621061,MATH 10B,B01,083739,Staff,11,0,30,19
1650687621061,MATH 10B,B02,083740,Staff,28,0,30,2
1650687627087,MATH 18,A01,083743,Staff,0,0,30,30
1650687627087,MATH 18,A02,083744,Staff,23,0,30,7
1650687627087,MATH 18,A03,083745,Staff,21,0,30,9
1650687627087,MATH 18,A04,083746,Staff,26,0,30,4
1650687627087,MATH 18,B01,083748,Staff,0,15,30,30
1650687627087,MATH 18,B02,083749,Staff,0,12,30,30
1650687627087,MATH 18,B03,083750,Staff,0,12,30,30
1650687627087,MATH 18,B04,083751,Staff,0,12,30,30
1650687633110,MATH 20A,A01,083754,Staff,19,0,40,21
1650687639146,MATH 20B,A01,083756,Staff,0,11,30,30
1650687639146,MATH 20B,A02,083757,Staff,0,12,30,30
1650687645170,MATH 20C,A01,083760,Staff,0,16,30,30
1650687645170,MATH 20C,A02,083761,Staff,1,16,30,29
1650687645170,MATH 20C,B01,083762,Staff,9,0,30,21
1650687645170,MATH 20C,B02,083763,Staff,28,0,30,2
1650687651206,MATH 20D,A01,083765,Staff,2,1,30,28
1650687651206,MATH 20D,A02,083766,Staff,6,0,30,24
1650687651206,MATH 20D,A03,083767,Staff,24,0,30,6
1650687657234,MATH 20E,A01,083771,Staff,3,0,30,27
1650687657234,MATH 20E,A02,083772,Staff,16,0,30,14
1650687657234,MATH 20E,B01,083773,Staff,0,0,30,30
1650687657234,MATH 20E,B02,083774,Staff,8,0,30,22
1650687663260,MATH 103A,A01,083777,Staff,0,15,30,30
1650687663260,MATH 103A,A02,083778,Staff,0,15,30,30
1650687663260,MATH 103A,B01,083779,Staff,0,15,30,30
1650687663260,MATH 103A,B02,083780,Staff,0,15,30,30
1650687669285,MATH 105,A01,085443,Staff,0,22,30,30
1650687675308,MATH 109,A01,083213,Anzaldo; Leesa B,0,7,30,30
1650687675308,MATH 109,A02,083214,Anzaldo; Leesa B,0,7,30,30
1650687675308,MATH 109,B01,083215,Anzaldo; Leesa B,0,8,30,30
1650687675308,MATH 109,B02,083216,Anzaldo; Leesa B,0,6,30,30
1650687681333,MATH 142A,A01,083219,Chow; Bennett,0,16,30,30
1650687681333,MATH 142A,A02,083220,Chow; Bennett,0,15,30,30
1650687681333,MATH 142A,B01,083221,Chow; Bennett,0,14,30,30
1650687681333,MATH 142A,B02,083222,Chow; Bennett,0,14,30,30
1650687687357,MATH 193A,A01,083224,Staff,0,5,30,30
1650687687357,MATH 193A,A02,083225,Staff,0,6,30,30
1650687687357,MATH 193A,A03,083781,Staff,0,6,30,30
1650687687357,MATH 193A,A04,083782,Staff,0,7,30,30
1650687693381,MATH 197,001,091859,McAuley; Julian John,9998,0,9999,1
1650687699446,COGS 9,A01,083615,Staff,1,16,60,59
1650687705470,COGS 11,A01,083617,Boyle; Mary E. T.,16,0,40,24
1650687711570,COGS 13,A01,083071,Staff,0,38,40,40
1650687717596,COGS 14A,A01,092681,Staff,0,35,100,100
1650687723618,COGS 14B,A01,083073,Cheng; Tzu-Han,1,14,50,49
1650687729644,COGS 17,A01,092677,Staff,14,0,75,61
1650687735668,COGS 100,A01,083619,Staff,0,29,60,60
1650687741694,COGS 101A,A01,083621,Davis; Joshua Daniel,0,27,60,60
1650687747721,COGS 101B,A01,091572,Staff,0,4,60,60
1650687753743,COGS 101C,A01,083625,Delgado; Tania,14,0,30,16
1650687759768,COGS 107A,A01,083627,Boyle; Mary E. T.,1,17,60,59
1650687765794,COGS 118A,A01,083075,Staff,0,7,60,60
1650687771820,CSE 3,A50,083646,Miranda; Gregory Joseph,18,0,38,20
1650687771820,CSE 3,A51,083647,Miranda; Gregory Joseph,36,0,37,1
1650687777847,CSE 8A,A50,083650,Miranda; Gregory Joseph,0,31,40,40
1650687783875,CSE 11,A01,083080,Cao; Yingjun,0,96,40,40
1650687789899,CSE 12,A01,083652,Staff,0,21,100,100
1650687795922,CSE 15L,A01,083654,Staff,0,3,50,50
1650687795922,CSE 15L,A02,083655,Staff,0,2,50,50
1650687801946,CSE 20,A01,083657,Staff,49,0,80,31
1650687807972,CSE 30,A01,083084,Eldon; John,0,78,40,40
1650687813995,CSE 100,A01,083659,Cao; Yingjun,0,70,50,50
1650687820022,CSE 134B,A01,083661,Powell; Thomas Allan,0,38,65,65
1650687826046,CSE 140,A01,083663,Staff,0,10,75,75
1650687832069,CSE 140L,A01,083088,Eldon; John,0,18,75,75
1650687838095,CSE 175,A01,083665,Kumar; Rakesh,7,0,25,18
1650687844121,CSE 190,A00,092507,Dubnov; Shlomo,10,0,20,10
1650687850144,ECE 45,A01,083139,Staff,0,2,60,60
1650687856166,ECE 65,A50,083695,Staff,0,5,30,30
1650687862190,ECE 109,A01,091882,Touri; Behrouz,33,0,70,37
1650687868217,ECE 180,A00,083140,Abi Samra; Nicholas Camill,20,0,30,10
1650687868217,ECE 180,B00,083141,Abi Samra; Nicholas Camill,0,0,30,30
1650687874246,MATH 10A,A01,083735,Patchell; Gregory David,2,0,30,28
1650687874246,MATH 10A,A02,083736,Patchell; Gregory David,27,0,30,3
1650687874246,MATH 10A,A03,083737,Patchell; Gregory David,24,0,30,6
1650687880268,MATH 10B,A01,083207,Staff,0,9,30,30
1650687880268,MATH 10B,A02,083208,Staff,1,8,30,29
1650687880268,MATH 10B,B01,083739,Staff,11,0,30,19
1650687880268,MATH 10B,B02,083740,Staff,28,0,30,2
1650687886299,MATH 18,A01,083743,Staff,0,0,30,30
1650687886299,MATH 18,A02,083744,Staff,23,0,30,7
1650687886299,MATH 18,A03,083745,Staff,21,0,30,9
1650687886299,MATH 18,A04,083746,Staff,26,0,30,4
1650687886299,MATH 18,B01,083748,Staff,0,15,30,30
1650687886299,MATH 18,B02,083749,Staff,0,12,30,30
1650687886299,MATH 18,B03,083750,Staff,0,12,30,30
1650687886299,MATH 18,B04,083751,Staff,0,12,30,30
1650687892322,MATH 20A,A01,083754,Staff,19,0,40,21
1650687898358,MATH 20B,A01,083756,Staff,0,11,30,30
1650687898358,MATH 20B,A02,083757,Staff,0,12,30,30
1650687904385,MATH 20C,A01,083760,Staff,0,16,30,30
1650687904385,MATH 20C,A02,083761,Staff,1,16,30,29
1650687904385,MATH 20C,B01,083762,Staff,9,0,30,21
1650687904385,MATH 20C,B02,083763,Staff,28,0,30,2
1650687910409,MATH 20D,A01,083765,Staff,2,1,30,28
1650687910409,MATH 20D,A02,083766,Staff,6,0,30,24
1650687910409,MATH 20D,A03,083767,Staff,24,0,30,6
1650687916436,MATH 20E,A01,083771,Staff,3,0,30,27
1650687916436,MATH 20E,A02,083772,Staff,16,0,30,14
1650687916436,MATH 20E,B01,083773,Staff,0,0,30,30
1650687916436,MATH 20E,B02,083774,Staff,8,0,30,22
1650687922463,MATH 103A,A01,083777,Staff,0,15,30,30
1650687922463,MATH 103A,A02,083778,Staff,0,15,30,30
1650687922463,MATH 103A,B01,083779,Staff,0,15,30,30
1650687922463,MATH 103A,B02,083780,Staff,0,15,30,30
1650687928490,MATH 105,A01,085443,Staff,0,22,30,30
1650687934515,MATH 109,A01,083213,Anzaldo; Leesa B,0,7,30,30
1650687934515,MATH 109,A02,083214,Anzaldo; Leesa B,0,7,30,30
1650687934515,MATH 109,B01,083215,Anzaldo; Leesa B,0,8,30,30
1650687934515,MATH 109,B02,083216,Anzaldo; Leesa B,0,6,30,30
1650687940551,MATH 142A,A01,083219,Chow; Bennett,0,16,30,30
1650687940551,MATH 142A,A02,083220,Chow; Bennett,0,15,30,30
1650687940551,MATH 142A,B01,083221,Chow; Bennett,0,14,30,30
1650687940551,MATH 142A,B02,083222,Chow; Bennett,0,14,30,30
1650687946579,MATH 193A,A01,083224,Staff,0,5,30,30
1650687946579,MATH 193A,A02,083225,Staff,0,6,30,30
1650687946579,MATH 193A,A03,083781,Staff,0,6,30,30
1650687946579,MATH 193A,A04,083782,Staff,0,7,30,30
1650687952609,MATH 197,001,091859,McAuley; Julian John,9998,0,9999,1
1650687958675,COGS 9,A01,083615,Staff,1,16,60,59
1650687964708,COGS 11,A01,083617,Boyle; Mary E. T.,16,0,40,24
1650687970734,COGS 13,A01,083071,Staff,0,38,40,40
1650687976763,COGS 14A,A01,092681,Staff,0,35,100,100
1650687982790,COGS 14B,A01,083073,Cheng; Tzu-Han,1,14,50,49
1650687988817,COGS 17,A01,092677,Staff,14,0,75,61
1650687994839,COGS 100,A01,083619,Staff,0,29,60,60
1650688000864,COGS 101A,A01,083621,Davis; Joshua Daniel,0,27,60,60
1650688006891,COGS 101B,A01,091572,Staff,0,4,60,60
1650688012916,COGS 101C,A01,083625,Delgado; Tania,14,0,30,16
1650688018942,COGS 107A,A01,083627,Boyle; Mary E. T.,1,17,60,59
1650688024986,COGS 118A,A01,083075,Staff,0,7,60,60
1650688031015,CSE 3,A50,083646,Miranda; Gregory Joseph,18,0,38,20
1650688031015,CSE 3,A51,083647,Miranda; Gregory Joseph,36,0,37,1
1650688037039,CSE 8A,A50,083650,Miranda; Gregory Joseph,0,31,40,40
1650688043078,CSE 11,A01,083080,Cao; Yingjun,0,96,40,40
1650688049100,CSE 12,A01,083652,Staff,0,21,100,100
1650688055123,CSE 15L,A01,083654,Staff,0,3,50,50
1650688055123,CSE 15L,A02,083655,Staff,0,2,50,50
1650688061150,CSE 20,A01,083657,Staff,49,0,80,31
1650688067176,CSE 30,A01,083084,Eldon; John,0,78,40,40
1650688073204,CSE 100,A01,083659,Cao; Yingjun,0,70,50,50
1650688079227,CSE 134B,A01,083661,Powell; Thomas Allan,0,38,65,65
1650688085252,CSE 140,A01,083663,Staff,0,10,75,75
1650688091275,CSE 140L,A01,083088,Eldon; John,0,18,75,75
1650688097307,CSE 175,A01,083665,Kumar; Rakesh,7,0,25,18
1650688103334,CSE 190,A00,092507,Dubnov; Shlomo,10,0,20,10
1650688109361,ECE 45,A01,083139,Staff,0,2,60,60
1650688115385,ECE 65,A50,083695,Staff,0,5,30,30
1650688121419,ECE 109,A01,091882,Touri; Behrouz,33,0,70,37
1650688127455,ECE 180,A00,083140,Abi Samra; Nicholas Camill,20,0,30,10
1650688127455,ECE 180,B00,083141,Abi Samra; Nicholas Camill,0,0,30,30
1650688133483,MATH 10A,A01,083735,Patchell; Gregory David,2,0,30,28
1650688133483,MATH 10A,A02,083736,Patchell; Gregory David,27,0,30,3
1650688133483,MATH 10A,A03,083737,Patchell; Gregory David,24,0,30,6
1650688139509,MATH 10B,A01,083207,Staff,0,9,30,30
1650688139509,MATH 10B,A02,083208,Staff,1,8,30,29
1650688139509,MATH 10B,B01,083739,Staff,11,0,30,19
1650688139509,MATH 10B,B02,083740,Staff,28,0,30,2
1650688145540,MATH 18,A01,083743,Staff,0,0,30,30
1650688145540,MATH 18,A02,083744,Staff,23,0,30,7
1650688145540,MATH 18,A03,083745,Staff,21,0,30,9
1650688145540,MATH 18,A04,083746,Staff,26,0,30,4
1650688145540,MATH 18,B01,083748,Staff,0,15,30,30
1650688145540,MATH 18,B02,083749,Staff,0,12,30,30
1650688145540,MATH 18,B03,083750,Staff,0,12,30,30
1650688145540,MATH 18,B04,083751,Staff,0,12,30,30
1650688151567,MATH 20A,A01,083754,Staff,19,0,40,21
1650688157591,MATH 20B,A01,083756,Staff,0,11,30,30
1650688157591,MATH 20B,A02,083757,Staff,0,12,30,30
1650688163615,MATH 20C,A01,083760,Staff,0,16,30,30
1650688163615,MATH 20C,A02,083761,Staff,1,16,30,29
1650688163615,MATH 20C,B01,083762,Staff,9,0,30,21
1650688163615,MATH 20C,B02,083763,Staff,28,0,30,2
1650688169642,MATH 20D,A01,083765,Staff,2,1,30,28
1650688169642,MATH 20D,A02,083766,Staff,6,0,30,24
1650688169642,MATH 20D,A03,083767,Staff,24,0,30,6
1650688175686,MATH 20E,A01,083771,Staff,3,0,30,27
1650688175686,MATH 20E,A02,083772,Staff,16,0,30,14
1650688175686,MATH 20E,B01,083773,Staff,0,0,30,30
1650688175686,MATH 20E,B02,083774,Staff,8,0,30,22
1650688181709,MATH 103A,A01,083777,Staff,0,15,30,30
1650688181709,MATH 103A,A02,083778,Staff,0,15,30,30
1650688181709,MATH 103A,B01,083779,Staff,0,15,30,30
1650688181709,MATH 103A,B02,083780,Staff,0,15,30,30
1650688187736,MATH 105,A01,085443,Staff,0,22,30,30
1650688193787,MATH 109,A01,083213,Anzaldo; Leesa B,0,7,30,30
1650688193787,MATH 109,A02,083214,Anzaldo; Leesa B,0,7,30,30
1650688193787,MATH 109,B01,083215,Anzaldo; Leesa B,0,8,30,30
1650688193787,MATH 109,B02,083216,Anzaldo; Leesa B,0,6,30,30
1650688199815,MATH 142A,A01,083219,Chow; Bennett,0,16,30,30
1650688199815,MATH 142A,A02,083220,Chow; Bennett,0,15,30,30
1650688199815,MATH 142A,B01,083221,Chow; Bennett,0,14,30,30
1650688199815,MATH 142A,B02,083222,Chow; Bennett,0,14,30,30
1650688205846,MATH 193A,A01,083224,Staff,0,5,30,30
1650688205846,MATH 193A,A02,083225,Staff,0,6,30,30
1650688205846,MATH 193A,A03,083781,Staff,0,6,30,30
1650688205846,MATH 193A,A04,083782,Staff,0,7,30,30
1650688211978,MATH 197,001,091859,McAuley; Julian John,9998,0,9999,1
1650688218040,COGS 9,A01,083615,Staff,1,16,60,59
1650688224063,COGS 11,A01,083617,Boyle; Mary E. T.,16,0,40,24
1650688230090,COGS 13,A01,083071,Staff,0,38,40,40
1650688236115,COGS 14A,A01,092681,Staff,0,35,100,100
1650688242140,COGS 14B,A01,083073,Cheng; Tzu-Han,1,14,50,49
1650688248164,COGS 17,A01,092677,Staff,14,0,75,61
1650688254205,COGS 100,A01,083619,Staff,0,29,60,60
1650688260241,COGS 101A,A01,083621,Davis; Joshua Daniel,0,27,60,60
1650688266276,COGS 101B,A01,091572,Staff,0,4,60,60
1650688272340,COGS 101C,A01,083625,Delgado; Tania,14,0,30,16
1650688278362,COGS 107A,A01,083627,Boyle; Mary E. T.,1,17,60,59
1650688284390,COGS 118A,A01,083075,Staff,0,7,60,60
1650688290413,CSE 3,A50,083646,Miranda; Gregory Joseph,18,0,38,20
1650688290413,CSE 3,A51,083647,Miranda; Gregory Joseph,36,0,37,1
1650688296437,CSE 8A,A50,083650,Miranda; Gregory Joseph,0,31,40,40
1650688302460,CSE 11,A01,083080,Cao; Yingjun,0,96,40,40
1650688308583,CSE 12,A01,083652,Staff,0,21,100,100
1650688314608,CSE 15L,A01,083654,Staff,0,3,50,50
1650688314608,CSE 15L,A02,083655,Staff,0,2,50,50
1650688320634,CSE 20,A01,083657,Staff,49,0,80,31
1650688326661,CSE 30,A01,083084,Eldon; John,0,78,40,40
1650688332683,CSE 100,A01,083659,Cao; Yingjun,0,70,50,50
1650688338709,CSE 134B,A01,083661,Powell; Thomas Allan,0,38,65,65
1650688344730,CSE 140,A01,083663,Staff,0,10,75,75
1650688350756,CSE 140L,A01,083088,Eldon; John,0,18,75,75
1650688356780,CSE 175,A01,083665,Kumar; Rakesh,7,0,25,18
1650688362801,CSE 190,A00,092507,Dubnov; Shlomo,10,0,20,10
1650688368824,ECE 45,A01,083139,Staff,0,2,60,60
1650688374851,ECE 65,A50,083695,Staff,0,5,30,30
1650688380880,ECE 109,A01,091882,Touri; Behrouz,33,0,70,37
1650688386907,ECE 180,A00,083140,Abi Samra; Nicholas Camill,20,0,30,10
1650688386907,ECE 180,B00,083141,Abi Samra; Nicholas Camill,0,0,30,30
1650688392939,MATH 10A,A01,083735,Patchell; Gregory David,2,0,30,28
1650688392939,MATH 10A,A02,083736,Patchell; Gregory David,27,0,30,3
1650688392939,MATH 10A,A03,083737,Patchell; Gregory David,24,0,30,6
1650688398962,MATH 10B,A01,083207,Staff,0,9,30,30
1650688398962,MATH 10B,A02,083208,Staff,1,8,30,29
1650688398962,MATH 10B,B01,083739,Staff,11,0,30,19
1650688398962,MATH 10B,B02,083740,Staff,28,0,30,2
1650688404990,MATH 18,A01,083743,Staff,0,0,30,30
1650688404990,MATH 18,A02,083744,Staff,23,0,30,7
1650688404990,MATH 18,A03,083745,Staff,21,0,30,9
1650688404990,MATH 18,A04,083746,Staff,26,0,30,4
1650688404990,MATH 18,B01,083748,Staff,0,15,30,30
1650688404990,MATH 18,B02,083749,Staff,0,12,30,30
1650688404990,MATH 18,B03,083750,Staff,0,12,30,30
1650688404990,MATH 18,B04,083751,Staff,0,12,30,30
1650688411014,MATH 20A,A01,083754,Staff,19,0,40,21
1650688417039,MATH 20B,A01,083756,Staff,0,11,30,30
1650688417039,MATH 20B,A02,083757,Staff,0,12,30,30
1650688423062,MATH 20C,A01,083760,Staff,0,16,30,30
1650688423062,MATH 20C,A02,083761,Staff,1,16,30,29
1650688423062,MATH 20C,B01,083762,Staff,9,0,30,21
1650688423062,MATH 20C,B02,083763,Staff,28,0,30,2
1650688429095,MATH 20D,A01,083765,Staff,2,1,30,28
1650688429095,MATH 20D,A02,083766,Staff,6,0,30,24
1650688429095,MATH 20D,A03,083767,Staff,24,0,30,6
1650688435118,MATH 20E,A01,083771,Staff,3,0,30,27
1650688435118,MATH 20E,A02,083772,Staff,16,0,30,14
1650688435118,MATH 20E,B01,083773,Staff,0,0,30,30
1650688435118,MATH 20E,B02,083774,Staff,7,0,30,23
1650688441144,MATH 103A,A01,083777,Staff,0,15,30,30
1650688441144,MATH 103A,A02,083778,Staff,0,15,30,30
1650688441144,MATH 103A,B01,083779,Staff,0,15,30,30
1650688441144,MATH 103A,B02,083780,Staff,0,15,30,30
1650688447185,MATH 105,A01,085443,Staff,0,22,30,30
1650688453214,MATH 109,A01,083213,Anzaldo; Leesa B,0,7,30,30
1650688453214,MATH 109,A02,083214,Anzaldo; Leesa B,0,7,30,30
1650688453214,MATH 109,B01,083215,Anzaldo; Leesa B,0,8,30,30
1650688453214,MATH 109,B02,083216,Anzaldo; Leesa B,0,6,30,30
1650688459235,MATH 142A,A01,083219,Chow; Bennett,0,16,30,30
1650688459235,MATH 142A,A02,083220,Chow; Bennett,0,15,30,30
1650688459235,MATH 142A,B01,083221,Chow; Bennett,0,14,30,30
1650688459235,MATH 142A,B02,083222,Chow; Bennett,0,14,30,30
1650688465266,MATH 193A,A01,083224,Staff,0,5,30,30
1650688465266,MATH 193A,A02,083225,Staff,0,6,30,30
1650688465266,MATH 193A,A03,083781,Staff,0,6,30,30
1650688465266,MATH 193A,A04,083782,Staff,0,7,30,30
1650688471289,MATH 197,001,091859,McAuley; Julian John,9998,0,9999,1
1650688477341,COGS 9,A01,083615,Staff,1,16,60,59
1650688483377,COGS 11,A01,083617,Boyle; Mary E. T.,16,0,40,24
1650688489399,COGS 13,A01,083071,Staff,0,38,40,40
1650688495421,COGS 14A,A01,092681,Staff,0,35,100,100
1650688501446,COGS 14B,A01,083073,Cheng; Tzu-Han,1,14,50,49
1650688507470,COGS 17,A01,092677,Staff,14,0,75,61
1650688513494,COGS 100,A01,083619,Staff,0,29,60,60
1650688519516,COGS 101A,A01,083621,Davis; Joshua Daniel,0,27,60,60
1650688525539,COGS 101B,A01,091572,Staff,0,4,60,60
1650688531573,COGS 101C,A01,083625,Delgado; Tania,14,0,30,16
1650688537604,COGS 107A,A01,083627,Boyle; Mary E. T.,1,17,60,59
1650688543627,COGS 118A,A01,083075,Staff,0,7,60,60
1650688549653,CSE 3,A50,083646,Miranda; Gregory Joseph,18,0,38,20
1650688549653,CSE 3,A51,083647,Miranda; Gregory Joseph,36,0,37,1
1650688555686,CSE 8A,A50,083650,Miranda; Gregory Joseph,0,31,40,40
1650688561708,CSE 11,A01,083080,Cao; Yingjun,0,96,40,40
1650688567732,CSE 12,A01,083652,Staff,0,21,100,100
1650688573756,CSE 15L,A01,083654,Staff,0,3,50,50
1650688573756,CSE 15L,A02,083655,Staff,0,2,50,50
1650688579790,CSE 20,A01,083657,Staff,49,0,80,31
1650688585813,CSE 30,A01,083084,Eldon; John,0,78,40,40
1650688591840,CSE 100,A01,083659,Cao; Yingjun,0,70,50,50
1650688597880,CSE 134B,A01,083661,Powell; Thomas Allan,0,38,65,65
1650688603904,CSE 140,A01,083663,Staff,0,10,75,75
1650688609930,CSE 140L,A01,083088,Eldon; John,0,18,75,75
1650688615954,CSE 175,A01,083665,Kumar; Rakesh,7,0,25,18
1650688621980,CSE 190,A00,092507,Dubnov; Shlomo,10,0,20,10
1650688628010,ECE 45,A01,083139,Staff,0,2,60,60
1650688634034,ECE 65,A50,083695,Staff,0,5,30,30
1650688640060,ECE 109,A01,091882,Touri; Behrouz,33,0,70,37
1650688646086,ECE 180,A00,083140,Abi Samra; Nicholas Camill,20,0,30,10
1650688646086,ECE 180,B00,083141,Abi Samra; Nicholas Camill,0,0,30,30
1650688652113,MATH 10A,A01,083735,Patchell; Gregory David,2,0,30,28
1650688652113,MATH 10A,A02,083736,Patchell; Gregory David,27,0,30,3
1650688652113,MATH 10A,A03,083737,Patchell; Gregory David,24,0,30,6
1650688658141,MATH 10B,A01,083207,Staff,0,9,30,30
1650688658141,MATH 10B,A02,083208,Staff,1,8,30,29
1650688658141,MATH 10B,B01,083739,Staff,11,0,30,19
1650688658141,MATH 10B,B02,083740,Staff,28,0,30,2
1650688664174,MATH 18,A01,083743,Staff,0,0,30,30
1650688664174,MATH 18,A02,083744,Staff,23,0,30,7
1650688664174,MATH 18,A03,083745,Staff,21,0,30,9
1650688664174,MATH 18,A04,083746,Staff,26,0,30,4
1650688664174,MATH 18,B01,083748,Staff,0,15,30,30
1650688664174,MATH 18,B02,083749,Staff,0,12,30,30
1650688664174,MATH 18,B03,083750,Staff,0,12,30,30
1650688664174,MATH 18,B04,083751,Staff,0,12,30,30
1650688670201,MATH 20A,A01,083754,Staff,19,0,40,21
1650688676236,MATH 20B,A01,083756,Staff,0,11,30,30
1650688676236,MATH 20B,A02,083757,Staff,0,12,30,30
1650688682262,MATH 20C,A01,083760,Staff,0,16,30,30
1650688682262,MATH 20C,A02,083761,Staff,1,16,30,29
1650688682262,MATH 20C,B01,083762,Staff,9,0,30,21
1650688682262,MATH 20C,B02,083763,Staff,28,0,30,2
1650688688288,MATH 20D,A01,083765,Staff,2,1,30,28
1650688688288,MATH 20D,A02,083766,Staff,6,0,30,24
1650688688288,MATH 20D,A03,083767,Staff,24,0,30,6
1650688694316,MATH 20E,A01,083771,Staff,3,0,30,27
1650688694316,MATH 20E,A02,083772,Staff,16,0,30,14
1650688694316,MATH 20E,B01,083773,Staff,0,0,30,30
1650688694316,MATH 20E,B02,083774,Staff,7,0,30,23
1650688700340,MATH 103A,A01,083777,Staff,0,15,30,30
1650688700340,MATH 103A,A02,083778,Staff,0,15,30,30
1650688700340,MATH 103A,B01,083779,Staff,0,15,30,30
1650688700340,MATH 103A,B02,083780,Staff,0,15,30,30
1650688706376,MATH 105,A01,085443,Staff,0,22,30,30
1650688712402,MATH 109,A01,083213,Anzaldo; Leesa B,0,7,30,30
1650688712402,MATH 109,A02,083214,Anzaldo; Leesa B,0,7,30,30
1650688712402,MATH 109,B01,083215,Anzaldo; Leesa B,0,8,30,30
1650688712402,MATH 109,B02,083216,Anzaldo; Leesa B,0,6,30,30
1650688718430,MATH 142A,A01,083219,Chow; Bennett,0,16,30,30
1650688718430,MATH 142A,A02,083220,Chow; Bennett,0,15,30,30
1650688718430,MATH 142A,B01,083221,Chow; Bennett,0,14,30,30
1650688718430,MATH 142A,B02,083222,Chow; Bennett,0,14,30,30
1650688724467,MATH 193A,A01,083224,Staff,0,5,30,30
1650688724467,MATH 193A,A02,083225,Staff,0,6,30,30
1650688724467,MATH 193A,A03,083781,Staff,0,6,30,30
1650688724467,MATH 193A,A04,083782,Staff,0,7,30,30
1650688730488,MATH 197,001,091859,McAuley; Julian John,9998,0,9999,1
1650688736538,COGS 9,A01,083615,Staff,1,16,60,59
1650688742565,COGS 11,A01,083617,Boyle; Mary E. T.,16,0,40,24
1650688748588,COGS 13,A01,083071,Staff,0,38,40,40
1650688754618,COGS 14A,A01,092681,Staff,0,35,100,100
1650688760642,COGS 14B,A01,083073,Cheng; Tzu-Han,1,14,50,49
1650688766669,COGS 17,A01,092677,Staff,14,0,75,61
1650688772701,COGS 100,A01,083619,Staff,0,29,60,60
1650688778725,COGS 101A,A01,083621,Davis; Joshua Daniel,0,27,60,60
1650688784749,COGS 101B,A01,091572,Staff,0,4,60,60
1650688790775,COGS 101C,A01,083625,Delgado; Tania,14,0,30,16
1650688796799,COGS 107A,A01,083627,Boyle; Mary E. T.,1,17,60,59
1650688802823,COGS 118A,A01,083075,Staff,0,7,60,60
1650688808852,CSE 3,A50,083646,Miranda; Gregory Joseph,18,0,38,20
1650688808852,CSE 3,A51,083647,Miranda; Gregory Joseph,36,0,37,1
1650688814879,CSE 8A,A50,083650,Miranda; Gregory Joseph,0,31,40,40
1650688820915,CSE 11,A01,083080,Cao; Yingjun,0,96,40,40
1650688826945,CSE 12,A01,083652,Staff,0,21,100,100
1650688832969,CSE 15L,A01,083654,Staff,0,3,50,50
1650688832969,CSE 15L,A02,083655,Staff,0,2,50,50
1650688838990,CSE 20,A01,083657,Staff,49,0,80,31
1650688845013,CSE 30,A01,083084,Eldon; John,0,78,40,40
1650688851036,CSE 100,A01,083659,Cao; Yingjun,0,70,50,50
1650688857062,CSE 134B,A01,083661,Powell; Thomas Allan,0,38,65,65
1650688863085,CSE 140,A01,083663,Staff,0,10,75,75
1650688869109,CSE 140L,A01,083088,Eldon; John,0,18,75,75
1650688875132,CSE 175,A01,083665,Kumar; Rakesh,7,0,25,18
1650688881157,CSE 190,A00,092507,Dubnov; Shlomo,10,0,20,10
1650688887180,ECE 45,A01,083139,Staff,0,2,60,60
1650688893203,ECE 65,A50,083695,Staff,0,5,30,30
1650688899227,ECE 109,A01,091882,Touri; Behrouz,33,0,70,37
1650688905342,ECE 180,A00,083140,Abi Samra; Nicholas Camill,20,0,30,10
1650688905342,ECE 180,B00,083141,Abi Samra; Nicholas Camill,0,0,30,30
1650688911379,MATH 10A,A01,083735,Patchell; Gregory David,2,0,30,28
1650688911379,MATH 10A,A02,083736,Patchell; Gregory David,27,0,30,3
1650688911379,MATH 10A,A03,083737,Patchell; Gregory David,24,0,30,6
1650688917411,MATH 10B,A01,083207,Staff,0,9,30,30
1650688917411,MATH 10B,A02,083208,Staff,1,8,30,29
1650688917411,MATH 10B,B01,083739,Staff,11,0,30,19
1650688917411,MATH 10B,B02,083740,Staff,28,0,30,2
1650688923439,MATH 18,A01,083743,Staff,0,0,30,30
1650688923439,MATH 18,A02,083744,Staff,23,0,30,7
1650688923439,MATH 18,A03,083745,Staff,21,0,30,9
1650688923439,MATH 18,A04,083746,Staff,26,0,30,4
1650688923439,MATH 18,B01,083748,Staff,0,15,30,30
1650688923439,MATH 18,B02,083749,Staff,0,12,30,30
1650688923439,MATH 18,B03,083750,Staff,0,12,30,30
1650688923439,MATH 18,B04,083751,Staff,0,12,30,30
1650688929465,MATH 20A,A01,083754,Staff,19,0,40,21
1650688935491,MATH 20B,A01,083756,Staff,0,11,30,30
1650688935491,MATH 20B,A02,083757,Staff,0,12,30,30
1650688941514,MATH 20C,A01,083760,Staff,0,16,30,30
1650688941514,MATH 20C,A02,083761,Staff,1,16,30,29
1650688941514,MATH 20C,B01,083762,Staff,9,0,30,21
1650688941514,MATH 20C,B02,083763,Staff,28,0,30,2
1650688947540,MATH 20D,A01,083765,Staff,2,1,30,28
1650688947540,MATH 20D,A02,083766,Staff,6,0,30,24
1650688947540,MATH 20D,A03,083767,Staff,24,0,30,6
1650688953568,MATH 20E,A01,083771,Staff,3,0,30,27
1650688953568,MATH 20E,A02,083772,Staff,16,0,30,14
1650688953568,MATH 20E,B01,083773,Staff,0,0,30,30
1650688953568,MATH 20E,B02,083774,Staff,7,0,30,23
1650688959590,MATH 103A,A01,083777,Staff,0,15,30,30
1650688959590,MATH 103A,A02,083778,Staff,0,15,30,30
1650688959590,MATH 103A,B01,083779,Staff,0,15,30,30
1650688959590,MATH 103A,B02,083780,Staff,0,15,30,30
1650688965625,MATH 105,A01,085443,Staff,0,22,30,30
1650688971649,MATH 109,A01,083213,Anzaldo; Leesa B,0,7,30,30
1650688971649,MATH 109,A02,083214,Anzaldo; Leesa B,0,7,30,30
1650688971649,MATH 109,B01,083215,Anzaldo; Leesa B,0,8,30,30
1650688971649,MATH 109,B02,083216,Anzaldo; Leesa B,0,6,30,30
1650688977672,MATH 142A,A01,083219,Chow; Bennett,0,16,30,30
1650688977672,MATH 142A,A02,083220,Chow; Bennett,0,15,30,30
1650688977672,MATH 142A,B01,083221,Chow; Bennett,0,15,30,30
1650688977672,MATH 142A,B02,083222,Chow; Bennett,0,14,30,30
1650688983693,MATH 193A,A01,083224,Staff,0,5,30,30
1650688983693,MATH 193A,A02,083225,Staff,0,6,30,30
1650688983693,MATH 193A,A03,083781,Staff,0,6,30,30
1650688983693,MATH 193A,A04,083782,Staff,0,7,30,30
1650688989721,MATH 197,001,091859,McAuley; Julian John,9998,0,9999,1
1650688995774,COGS 9,A01,083615,Staff,1,16,60,59
1650689001799,COGS 11,A01,083617,Boyle; Mary E. T.,16,0,40,24
1650689007821,COGS 13,A01,083071,Staff,0,38,40,40
1650689013844,COGS 14A,A01,092681,Staff,0,35,100,100
1650689019869,COGS 14B,A01,083073,Cheng; Tzu-Han,1,14,50,49
1650689025909,COGS 17,A01,092677,Staff,14,0,75,61
1650689031946,COGS 100,A01,083619,Staff,0,29,60,60
1650689037968,COGS 101A,A01,083621,Davis; Joshua Daniel,0,27,60,60
1650689043992,COGS 101B,A01,091572,Staff,0,4,60,60
1650689050019,COGS 101C,A01,083625,Delgado; Tania,14,0,30,16
1650689056055,COGS 107A,A01,083627,Boyle; Mary E. T.,1,17,60,59
1650689062081,COGS 118A,A01,083075,Staff,0,7,60,60
1650689068104,CSE 3,A50,083646,Miranda; Gregory Joseph,18,0,38,20
1650689068104,CSE 3,A51,083647,Miranda; Gregory Joseph,36,0,37,1
1650689074132,CSE 8A,A50,083650,Miranda; Gregory Joseph,0,31,40,40
1650689080158,CSE 11,A01,083080,Cao; Yingjun,0,96,40,40
1650689086182,CSE 12,A01,083652,Staff,0,21,100,100
1650689092210,CSE 15L,A01,083654,Staff,0,3,50,50
1650689092210,CSE 15L,A02,083655,Staff,0,2,50,50
1650689098233,CSE 20,A01,083657,Staff,49,0,80,31
1650689104262,CSE 30,A01,083084,Eldon; John,0,78,40,40
1650689110289,CSE 100,A01,083659,Cao; Yingjun,0,70,50,50
1650689116315,CSE 134B,A01,083661,Powell; Thomas Allan,0,38,65,65
1650689122339,CSE 140,A01,083663,Staff,0,10,75,75
1650689128466,CSE 140L,A01,083088,Eldon; John,0,18,75,75
1650689134498,CSE 175,A01,083665,Kumar; Rakesh,7,0,25,18
1650689140523,CSE 190,A00,092507,Dubnov; Shlomo,10,0,20,10
1650689146559,ECE 45,A01,083139,Staff,0,2,60,60
1650689152607,ECE 65,A50,083695,Staff,0,5,30,30
1650689158630,ECE 109,A01,091882,Touri; Behrouz,33,0,70,37
1650689164661,ECE 180,A00,083140,Abi Samra; Nicholas Camill,20,0,30,10
1650689164661,ECE 180,B00,083141,Abi Samra; Nicholas Camill,0,0,30,30
1650689170690,MATH 10A,A01,083735,Patchell; Gregory David,2,0,30,28
1650689170690,MATH 10A,A02,083736,Patchell; Gregory David,27,0,30,3
1650689170690,MATH 10A,A03,083737,Patchell; Gregory David,24,0,30,6
1650689176720,MATH 10B,A01,083207,Staff,0,9,30,30
1650689176720,MATH 10B,A02,083208,Staff,1,8,30,29
1650689176720,MATH 10B,B01,083739,Staff,11,0,30,19
1650689176720,MATH 10B,B02,083740,Staff,28,0,30,2
1650689182754,MATH 18,A01,083743,Staff,0,0,30,30
1650689182754,MATH 18,A02,083744,Staff,23,0,30,7
1650689182754,MATH 18,A03,083745,Staff,21,0,30,9
1650689182754,MATH 18,A04,083746,Staff,26,0,30,4
1650689182754,MATH 18,B01,083748,Staff,0,15,30,30
1650689182754,MATH 18,B02,083749,Staff,0,12,30,30
1650689182754,MATH 18,B03,083750,Staff,0,12,30,30
1650689182754,MATH 18,B04,083751,Staff,0,12,30,30
1650689188787,MATH 20A,A01,083754,Staff,19,0,40,21
1650689194818,MATH 20B,A01,083756,Staff,0,11,30,30
1650689194818,MATH 20B,A02,083757,Staff,0,12,30,30
1650689200848,MATH 20C,A01,083760,Staff,0,16,30,30
1650689200848,MATH 20C,A02,083761,Staff,1,16,30,29
1650689200848,MATH 20C,B01,083762,Staff,9,0,30,21
1650689200848,MATH 20C,B02,083763,Staff,28,0,30,2
1650689206877,MATH 20D,A01,083765,Staff,2,1,30,28
1650689206877,MATH 20D,A02,083766,Staff,6,0,30,24
1650689206877,MATH 20D,A03,083767,Staff,24,0,30,6
1650689212903,MATH 20E,A01,083771,Staff,3,0,30,27
1650689212903,MATH 20E,A02,083772,Staff,16,0,30,14
1650689212903,MATH 20E,B01,083773,Staff,0,0,30,30
1650689212903,MATH 20E,B02,083774,Staff,8,0,30,22
1650689218933,MATH 103A,A01,083777,Staff,0,15,30,30
1650689218933,MATH 103A,A02,083778,Staff,0,15,30,30
1650689218933,MATH 103A,B01,083779,Staff,0,15,30,30
1650689218933,MATH 103A,B02,083780,Staff,0,15,30,30
1650689224971,MATH 105,A01,085443,Staff,0,22,30,30
1650689230997,MATH 109,A01,083213,Anzaldo; Leesa B,0,7,30,30
1650689230997,MATH 109,A02,083214,Anzaldo; Leesa B,0,7,30,30
1650689230997,MATH 109,B01,083215,Anzaldo; Leesa B,0,8,30,30
1650689230997,MATH 109,B02,083216,Anzaldo; Leesa B,0,6,30,30
1650689237031,MATH 142A,A01,083219,Chow; Bennett,0,16,30,30
1650689237031,MATH 142A,A02,083220,Chow; Bennett,0,15,30,30
1650689237031,MATH 142A,B01,083221,Chow; Bennett,0,15,30,30
1650689237031,MATH 142A,B02,083222,Chow; Bennett,0,14,30,30
1650689243072,MATH 193A,A01,083224,Staff,0,5,30,30
1650689243072,MATH 193A,A02,083225,Staff,0,6,30,30
1650689243072,MATH 193A,A03,083781,Staff,0,6,30,30
1650689243072,MATH 193A,A04,083782,Staff,0,7,30,30
1650689249103,MATH 197,001,091859,McAuley; Julian John,9998,0,9999,1
1650689255196,COGS 9,A01,083615,Staff,1,16,60,59
1650689261235,COGS 11,A01,083617,Boyle; Mary E. T.,16,0,40,24
1650689267259,COGS 13,A01,083071,Staff,0,38,40,40
1650689273288,COGS 14A,A01,092681,Staff,0,35,100,100
1650689279312,COGS 14B,A01,083073,Cheng; Tzu-Han,1,14,50,49
1650689285336,COGS 17,A01,092677,Staff,14,0,75,61
1650689291361,COGS 100,A01,083619,Staff,0,29,60,60
1650689297386,COGS 101A,A01,083621,Davis; Joshua Daniel,0,27,60,60
1650689303419,COGS 101B,A01,091572,Staff,0,4,60,60
1650689309447,COGS 101C,A01,083625,Delgado; Tania,14,0,30,16
1650689315470,COGS 107A,A01,083627,Boyle; Mary E. T.,1,17,60,59
1650689321498,COGS 118A,A01,083075,Staff,0,7,60,60
1650689327522,CSE 3,A50,083646,Miranda; Gregory Joseph,18,0,38,20
1650689327522,CSE 3,A51,083647,Miranda; Gregory Joseph,36,0,37,1
1650689333554,CSE 8A,A50,083650,Miranda; Gregory Joseph,0,31,40,40
1650689339581,CSE 11,A01,083080,Cao; Yingjun,0,96,40,40
1650689345605,CSE 12,A01,083652,Staff,0,21,100,100
1650689351647,CSE 15L,A01,083654,Staff,0,3,50,50
1650689351647,CSE 15L,A02,083655,Staff,0,2,50,50
1650689357689,CSE 20,A01,083657,Staff,49,0,80,31
1650689363712,CSE 30,A01,083084,Eldon; John,0,78,40,40
1650689369740,CSE 100,A01,083659,Cao; Yingjun,0,70,50,50
1650689375779,CSE 134B,A01,083661,Powell; Thomas Allan,0,38,65,65
1650689381801,CSE 140,A01,083663,Staff,0,10,75,75
1650689387840,CSE 140L,A01,083088,Eldon; John,0,18,75,75
1650689393872,CSE 175,A01,083665,Kumar; Rakesh,7,0,25,18
1650689399907,CSE 190,A00,092507,Dubnov; Shlomo,10,0,20,10
1650689405944,ECE 45,A01,083139,Staff,0,2,60,60
1650689411978,ECE 65,A50,083695,Staff,0,5,30,30
1650689418000,ECE 109,A01,091882,Touri; Behrouz,33,0,70,37
1650689424040,ECE 180,A00,083140,Abi Samra; Nicholas Camill,20,0,30,10
1650689424040,ECE 180,B00,083141,Abi Samra; Nicholas Camill,0,0,30,30
1650689430077,MATH 10A,A01,083735,Patchell; Gregory David,2,0,30,28
1650689430077,MATH 10A,A02,083736,Patchell; Gregory David,27,0,30,3
1650689430077,MATH 10A,A03,083737,Patchell; Gregory David,24,0,30,6
1650689436116,MATH 10B,A01,083207,Staff,0,9,30,30
1650689436116,MATH 10B,A02,083208,Staff,1,8,30,29
1650689436116,MATH 10B,B01,083739,Staff,11,0,30,19
1650689436116,MATH 10B,B02,083740,Staff,28,0,30,2
1650689442146,MATH 18,A01,083743,Staff,0,0,30,30
1650689442146,MATH 18,A02,083744,Staff,23,0,30,7
1650689442146,MATH 18,A03,083745,Staff,21,0,30,9
1650689442146,MATH 18,A04,083746,Staff,26,0,30,4
1650689442146,MATH 18,B01,083748,Staff,0,15,30,30
1650689442146,MATH 18,B02,083749,Staff,0,12,30,30
1650689442146,MATH 18,B03,083750,Staff,0,12,30,30
1650689442146,MATH 18,B04,083751,Staff,0,12,30,30
1650689448174,MATH 20A,A01,083754,Staff,19,0,40,21
1650689454198,MATH 20B,A01,083756,Staff,0,11,30,30
1650689454198,MATH 20B,A02,083757,Staff,0,12,30,30
1650689460238,MATH 20C,A01,083760,Staff,0,16,30,30
1650689460238,MATH 20C,A02,083761,Staff,1,16,30,29
1650689460238,MATH 20C,B01,083762,Staff,9,0,30,21
1650689460238,MATH 20C,B02,083763,Staff,28,0,30,2
1650689466277,MATH 20D,A01,083765,Staff,2,1,30,28
1650689466277,MATH 20D,A02,083766,Staff,6,0,30,24
1650689466277,MATH 20D,A03,083767,Staff,24,0,30,6
1650689472302,MATH 20E,A01,083771,Staff,3,0,30,27
1650689472302,MATH 20E,A02,083772,Staff,16,0,30,14
1650689472302,MATH 20E,B01,083773,Staff,0,0,30,30
1650689472302,MATH 20E,B02,083774,Staff,8,0,30,22
1650689478352,MATH 103A,A01,083777,Staff,0,15,30,30
1650689478352,MATH 103A,A02,083778,Staff,0,15,30,30
1650689478352,MATH 103A,B01,083779,Staff,0,15,30,30
1650689478352,MATH 103A,B02,083780,Staff,0,15,30,30
1650689484387,MATH 105,A01,085443,Staff,0,22,30,30
1650689490412,MATH 109,A01,083213,Anzaldo; Leesa B,0,7,30,30
1650689490412,MATH 109,A02,083214,Anzaldo; Leesa B,0,7,30,30
1650689490412,MATH 109,B01,083215,Anzaldo; Leesa B,0,8,30,30
1650689490412,MATH 109,B02,083216,Anzaldo; Leesa B,0,6,30,30
1650689496446,MATH 142A,A01,083219,Chow; Bennett,0,16,30,30
1650689496446,MATH 142A,A02,083220,Chow; Bennett,0,15,30,30
1650689496446,MATH 142A,B01,083221,Chow; Bennett,0,15,30,30
1650689496446,MATH 142A,B02,083222,Chow; Bennett,0,14,30,30
1650689502571,MATH 193A,A01,083224,Staff,0,5,30,30
1650689502571,MATH 193A,A02,083225,Staff,0,6,30,30
1650689502571,MATH 193A,A03,083781,Staff,0,6,30,30
1650689502571,MATH 193A,A04,083782,Staff,0,7,30,30
1650689508598,MATH 197,001,091859,McAuley; Julian John,9998,0,9999,1
1650689514652,COGS 9,A01,083615,Staff,1,16,60,59
1650689520676,COGS 11,A01,083617,Boyle; Mary E. T.,16,0,40,24
1650689526701,COGS 13,A01,083071,Staff,0,38,40,40
1650689532723,COGS 14A,A01,092681,Staff,0,35,100,100
1650689538749,COGS 14B,A01,083073,Cheng; Tzu-Han,1,14,50,49
1650689544774,COGS 17,A01,092677,Staff,14,0,75,61
1650689550796,COGS 100,A01,083619,Staff,0,29,60,60
1650689556827,COGS 101A,A01,083621,Davis; Joshua Daniel,0,27,60,60
1650689562877,COGS 101B,A01,091572,Staff,0,4,60,60
1650689568904,COGS 101C,A01,083625,Delgado; Tania,14,0,30,16
1650689574930,COGS 107A,A01,083627,Boyle; Mary E. T.,1,17,60,59
1650689580953,COGS 118A,A01,083075,Staff,0,7,60,60
1650689586983,CSE 3,A50,083646,Miranda; Gregory Joseph,18,0,38,20
1650689586983,CSE 3,A51,083647,Miranda; Gregory Joseph,36,0,37,1
1650689593006,CSE 8A,A50,083650,Miranda; Gregory Joseph,0,31,40,40
1650689599041,CSE 11,A01,083080,Cao; Yingjun,0,96,40,40
1650689605082,CSE 12,A01,083652,Staff,0,21,100,100
1650689611108,CSE 15L,A01,083654,Staff,0,3,50,50
1650689611108,CSE 15L,A02,083655,Staff,0,2,50,50
1650689617139,CSE 20,A01,083657,Staff,49,0,80,31
1650689623169,CSE 30,A01,083084,Eldon; John,0,78,40,40
1650689629199,CSE 100,A01,083659,Cao; Yingjun,0,70,50,50
1650689635222,CSE 134B,A01,083661,Powell; Thomas Allan,0,38,65,65
1650689641246,CSE 140,A01,083663,Staff,0,10,75,75
1650689647275,CSE 140L,A01,083088,Eldon; John,0,18,75,75
1650689653298,CSE 175,A01,083665,Kumar; Rakesh,7,0,25,18
1650689659322,CSE 190,A00,092507,Dubnov; Shlomo,10,0,20,10
1650689665356,ECE 45,A01,083139,Staff,0,2,60,60
1650689671383,ECE 65,A50,083695,Staff,0,5,30,30
1650689677409,ECE 109,A01,091882,Touri; Behrouz,33,0,70,37
1650689683436,ECE 180,A00,083140,Abi Samra; Nicholas Camill,20,0,30,10
1650689683436,ECE 180,B00,083141,Abi Samra; Nicholas Camill,0,0,30,30
1650689689475,MATH 10A,A01,083735,Patchell; Gregory David,2,0,30,28
1650689689475,MATH 10A,A02,083736,Patchell; Gregory David,27,0,30,3
1650689689475,MATH 10A,A03,083737,Patchell; Gregory David,24,0,30,6
1650689695510,MATH 10B,A01,083207,Staff,0,9,30,30
1650689695510,MATH 10B,A02,083208,Staff,1,8,30,29
1650689695510,MATH 10B,B01,083739,Staff,11,0,30,19
1650689695510,MATH 10B,B02,083740,Staff,28,0,30,2
1650689701544,MATH 18,A01,083743,Staff,0,0,30,30
1650689701544,MATH 18,A02,083744,Staff,23,0,30,7
1650689701544,MATH 18,A03,083745,Staff,21,0,30,9
1650689701544,MATH 18,A04,083746,Staff,26,0,30,4
1650689701544,MATH 18,B01,083748,Staff,0,15,30,30
1650689701544,MATH 18,B02,083749,Staff,0,12,30,30
1650689701544,MATH 18,B03,083750,Staff,0,12,30,30
1650689701544,MATH 18,B04,083751,Staff,0,12,30,30
1650689707568,MATH 20A,A01,083754,Staff,19,0,40,21
1650689713590,MATH 20B,A01,083756,Staff,0,11,30,30
1650689713590,MATH 20B,A02,083757,Staff,0,12,30,30
1650689719618,MATH 20C,A01,083760,Staff,0,16,30,30
1650689719618,MATH 20C,A02,083761,Staff,1,16,30,29
1650689719618,MATH 20C,B01,083762,Staff,9,0,30,21
1650689719618,MATH 20C,B02,083763,Staff,28,0,30,2
1650689725648,MATH 20D,A01,083765,Staff,2,1,30,28
1650689725648,MATH 20D,A02,083766,Staff,6,0,30,24
1650689725648,MATH 20D,A03,083767,Staff,24,0,30,6
1650689731692,MATH 20E,A01,083771,Staff,3,0,30,27
1650689731692,MATH 20E,A02,083772,Staff,16,0,30,14
1650689731692,MATH 20E,B01,083773,Staff,0,0,30,30
1650689731692,MATH 20E,B02,083774,Staff,8,0,30,22
1650689737721,MATH 103A,A01,083777,Staff,0,15,30,30
1650689737721,MATH 103A,A02,083778,Staff,0,15,30,30
1650689737721,MATH 103A,B01,083779,Staff,0,15,30,30
1650689737721,MATH 103A,B02,083780,Staff,0,15,30,30
1650689743754,MATH 105,A01,085443,Staff,0,22,30,30
1650689749777,MATH 109,A01,083213,Anzaldo; Leesa B,0,7,30,30
1650689749777,MATH 109,A02,083214,Anzaldo; Leesa B,0,7,30,30
1650689749777,MATH 109,B01,083215,Anzaldo; Leesa B,0,8,30,30
1650689749777,MATH 109,B02,083216,Anzaldo; Leesa B,0,6,30,30
1650689755800,MATH 142A,A01,083219,Chow; Bennett,0,16,30,30
1650689755800,MATH 142A,A02,083220,Chow; Bennett,0,15,30,30
1650689755800,MATH 142A,B01,083221,Chow; Bennett,0,15,30,30
1650689755800,MATH 142A,B02,083222,Chow; Bennett,0,14,30,30
1650689761835,MATH 193A,A01,083224,Staff,0,5,30,30
1650689761835,MATH 193A,A02,083225,Staff,0,6,30,30
1650689761835,MATH 193A,A03,083781,Staff,0,6,30,30
1650689761835,MATH 193A,A04,083782,Staff,0,7,30,30
1650689767860,MATH 197,001,091859,McAuley; Julian John,9998,0,9999,1
1650689773949,COGS 9,A01,083615,Staff,1,16,60,59
1650689779973,COGS 11,A01,083617,Boyle; Mary E. T.,16,0,40,24
1650689785995,COGS 13,A01,083071,Staff,0,38,40,40
1650689792019,COGS 14A,A01,092681,Staff,0,35,100,100
1650689798042,COGS 14B,A01,083073,Cheng; Tzu-Han,1,14,50,49
1650689804090,COGS 17,A01,092677,Staff,14,0,75,61
1650689810121,COGS 100,A01,083619,Staff,0,29,60,60
1650689816153,COGS 101A,A01,083621,Davis; Joshua Daniel,0,27,60,60
1650689822186,COGS 101B,A01,091572,Staff,0,4,60,60
1650689828228,COGS 101C,A01,083625,Delgado; Tania,14,0,30,16
1650689834259,COGS 107A,A01,083627,Boyle; Mary E. T.,1,17,60,59
1650689840282,COGS 118A,A01,083075,Staff,0,7,60,60
1650689846307,CSE 3,A50,083646,Miranda; Gregory Joseph,18,0,38,20
1650689846307,CSE 3,A51,083647,Miranda; Gregory Joseph,36,0,37,1
1650689852335,CSE 8A,A50,083650,Miranda; Gregory Joseph,0,31,40,40
1650689858375,CSE 11,A01,083080,Cao; Yingjun,0,96,40,40
1650689864399,CSE 12,A01,083652,Staff,0,21,100,100
1650689870430,CSE 15L,A01,083654,Staff,0,3,50,50
1650689870430,CSE 15L,A02,083655,Staff,0,2,50,50
1650689876470,CSE 20,A01,083657,Staff,49,0,80,31
1650689882505,CSE 30,A01,083084,Eldon; John,0,78,40,40
1650689888533,CSE 100,A01,083659,Cao; Yingjun,0,70,50,50
1650689894558,CSE 134B,A01,083661,Powell; Thomas Allan,0,38,65,65
1650689900584,CSE 140,A01,083663,Staff,0,10,75,75
1650689906610,CSE 140L,A01,083088,Eldon; John,0,18,75,75
1650689912635,CSE 175,A01,083665,Kumar; Rakesh,7,0,25,18
1650689918658,CSE 190,A00,092507,Dubnov; Shlomo,10,0,20,10
1650689924686,ECE 45,A01,083139,Staff,0,2,60,60
1650689930710,ECE 65,A50,083695,Staff,0,5,30,30
1650689936734,ECE 109,A01,091882,Touri; Behrouz,33,0,70,37
1650689942762,ECE 180,A00,083140,Abi Samra; Nicholas Camill,20,0,30,10
1650689942762,ECE 180,B00,083141,Abi Samra; Nicholas Camill,0,0,30,30
1650689948788,MATH 10A,A01,083735,Patchell; Gregory David,2,0,30,28
1650689948788,MATH 10A,A02,083736,Patchell; Gregory David,27,0,30,3
1650689948788,MATH 10A,A03,083737,Patchell; Gregory David,24,0,30,6
1650689954815,MATH 10B,A01,083207,Staff,0,9,30,30
1650689954815,MATH 10B,A02,083208,Staff,1,8,30,29
1650689954815,MATH 10B,B01,083739,Staff,11,0,30,19
1650689954815,MATH 10B,B02,083740,Staff,28,0,30,2
1650689960841,MATH 18,A01,083743,Staff,0,0,30,30
1650689960841,MATH 18,A02,083744,Staff,23,0,30,7
1650689960841,MATH 18,A03,083745,Staff,21,0,30,9
1650689960841,MATH 18,A04,083746,Staff,26,0,30,4
1650689960841,MATH 18,B01,083748,Staff,0,15,30,30
1650689960841,MATH 18,B02,083749,Staff,0,12,30,30
1650689960841,MATH 18,B03,083750,Staff,0,12,30,30
1650689960841,MATH 18,B04,083751,Staff,0,12,30,30
1650689966867,MATH 20A,A01,083754,Staff,19,0,40,21
1650689972894,MATH 20B,A01,083756,Staff,0,11,30,30
1650689972894,MATH 20B,A02,083757,Staff,0,12,30,30
1650689978919,MATH 20C,A01,083760,Staff,0,16,30,30
1650689978919,MATH 20C,A02,083761,Staff,1,16,30,29
1650689978919,MATH 20C,B01,083762,Staff,9,0,30,21
1650689978919,MATH 20C,B02,083763,Staff,28,0,30,2
1650689984950,MATH 20D,A01,083765,Staff,2,1,30,28
1650689984950,MATH 20D,A02,083766,Staff,6,0,30,24
1650689984950,MATH 20D,A03,083767,Staff,24,0,30,6
1650689990980,MATH 20E,A01,083771,Staff,3,0,30,27
1650689990980,MATH 20E,A02,083772,Staff,16,0,30,14
1650689990980,MATH 20E,B01,083773,Staff,0,0,30,30
1650689990980,MATH 20E,B02,083774,Staff,8,0,30,22
1650689997007,MATH 103A,A01,083777,Staff,0,15,30,30
1650689997007,MATH 103A,A02,083778,Staff,0,15,30,30
1650689997007,MATH 103A,B01,083779,Staff,0,15,30,30
1650689997007,MATH 103A,B02,083780,Staff,0,15,30,30
1650690003030,MATH 105,A01,085443,Staff,0,22,30,30
1650690009053,MATH 109,A01,083213,Anzaldo; Leesa B,0,7,30,30
1650690009053,MATH 109,A02,083214,Anzaldo; Leesa B,0,7,30,30
1650690009053,MATH 109,B01,083215,Anzaldo; Leesa B,0,8,30,30
1650690009053,MATH 109,B02,083216,Anzaldo; Leesa B,0,6,30,30
1650690015081,MATH 142A,A01,083219,Chow; Bennett,0,16,30,30
1650690015081,MATH 142A,A02,083220,Chow; Bennett,0,15,30,30
1650690015081,MATH 142A,B01,083221,Chow; Bennett,0,15,30,30
1650690015081,MATH 142A,B02,083222,Chow; Bennett,0,14,30,30
1650690021106,MATH 193A,A01,083224,Staff,0,5,30,30
1650690021106,MATH 193A,A02,083225,Staff,0,6,30,30
1650690021106,MATH 193A,A03,083781,Staff,0,6,30,30
1650690021106,MATH 193A,A04,083782,Staff,0,7,30,30
1650690027132,MATH 197,001,091859,McAuley; Julian John,9998,0,9999,1
1650690033195,COGS 9,A01,083615,Staff,1,16,60,59
1650690039221,COGS 11,A01,083617,Boyle; Mary E. T.,16,0,40,24
1650690045248,COGS 13,A01,083071,Staff,0,38,40,40
1650690051269,COGS 14A,A01,092681,Staff,0,35,100,100
1650690057294,COGS 14B,A01,083073,Cheng; Tzu-Han,1,14,50,49
1650690063321,COGS 17,A01,092677,Staff,14,0,75,61
1650690069347,COGS 100,A01,083619,Staff,0,29,60,60
1650690075371,COGS 101A,A01,083621,Davis; Joshua Daniel,0,27,60,60
1650690081399,COGS 101B,A01,091572,Staff,0,4,60,60
1650690087422,COGS 101C,A01,083625,Delgado; Tania,14,0,30,16
1650690093537,COGS 107A,A01,083627,Boyle; Mary E. T.,1,17,60,59
1650690099560,COGS 118A,A01,083075,Staff,0,7,60,60
1650690105586,CSE 3,A50,083646,Miranda; Gregory Joseph,18,0,38,20
1650690105586,CSE 3,A51,083647,Miranda; Gregory Joseph,36,0,37,1
1650690111613,CSE 8A,A50,083650,Miranda; Gregory Joseph,0,31,40,40
1650690117638,CSE 11,A01,083080,Cao; Yingjun,0,96,40,40
1650690123668,CSE 12,A01,083652,Staff,0,21,100,100
1650690129699,CSE 15L,A01,083654,Staff,0,3,50,50
1650690129699,CSE 15L,A02,083655,Staff,0,2,50,50
1650690135726,CSE 20,A01,083657,Staff,49,0,80,31
1650690141751,CSE 30,A01,083084,Eldon; John,0,78,40,40
1650690147774,CSE 100,A01,083659,Cao; Yingjun,0,70,50,50
1650690153801,CSE 134B,A01,083661,Powell; Thomas Allan,0,38,65,65
1650690159823,CSE 140,A01,083663,Staff,0,10,75,75
1650690165846,CSE 140L,A01,083088,Eldon; John,0,18,75,75
1650690171871,CSE 175,A01,083665,Kumar; Rakesh,7,0,25,18
1650690177893,CSE 190,A00,092507,Dubnov; Shlomo,10,0,20,10
1650690183914,ECE 45,A01,083139,Staff,0,2,60,60
1650690189941,ECE 65,A50,083695,Staff,0,5,30,30
1650690195965,ECE 109,A01,091882,Touri; Behrouz,33,0,70,37
1650690201989,ECE 180,A00,083140,Abi Samra; Nicholas Camill,20,0,30,10
1650690201989,ECE 180,B00,083141,Abi Samra; Nicholas Camill,0,0,30,30
1650690208015,MATH 10A,A01,083735,Patchell; Gregory David,2,0,30,28
1650690208015,MATH 10A,A02,083736,Patchell; Gregory David,27,0,30,3
1650690208015,MATH 10A,A03,083737,Patchell; Gregory David,24,0,30,6
1650690214042,MATH 10B,A01,083207,Staff,0,9,30,30
1650690214042,MATH 10B,A02,083208,Staff,1,8,30,29
1650690214042,MATH 10B,B01,083739,Staff,11,0,30,19
1650690214042,MATH 10B,B02,083740,Staff,28,0,30,2
1650690220071,MATH 18,A01,083743,Staff,0,0,30,30
1650690220071,MATH 18,A02,083744,Staff,23,0,30,7
1650690220071,MATH 18,A03,083745,Staff,21,0,30,9
1650690220071,MATH 18,A04,083746,Staff,26,0,30,4
1650690220071,MATH 18,B01,083748,Staff,0,15,30,30
1650690220071,MATH 18,B02,083749,Staff,0,12,30,30
1650690220071,MATH 18,B03,083750,Staff,0,12,30,30
1650690220071,MATH 18,B04,083751,Staff,0,12,30,30
1650690226095,MATH 20A,A01,083754,Staff,19,0,40,21
1650690232123,MATH 20B,A01,083756,Staff,0,11,30,30
1650690232123,MATH 20B,A02,083757,Staff,0,12,30,30
1650690238151,MATH 20C,A01,083760,Staff,0,16,30,30
1650690238151,MATH 20C,A02,083761,Staff,1,16,30,29
1650690238151,MATH 20C,B01,083762,Staff,9,0,30,21
1650690238151,MATH 20C,B02,083763,Staff,28,0,30,2
1650690244179,MATH 20D,A01,083765,Staff,2,1,30,28
1650690244179,MATH 20D,A02,083766,Staff,6,0,30,24
1650690244179,MATH 20D,A03,083767,Staff,24,0,30,6
1650690250207,MATH 20E,A01,083771,Staff,3,0,30,27
1650690250207,MATH 20E,A02,083772,Staff,16,0,30,14
1650690250207,MATH 20E,B01,083773,Staff,0,0,30,30
1650690250207,MATH 20E,B02,083774,Staff,8,0,30,22
1650690256229,MATH 103A,A01,083777,Staff,0,15,30,30
1650690256229,MATH 103A,A02,083778,Staff,0,15,30,30
1650690256229,MATH 103A,B01,083779,Staff,0,15,30,30
1650690256229,MATH 103A,B02,083780,Staff,0,15,30,30
1650690262255,MATH 105,A01,085443,Staff,0,22,30,30
1650690268292,MATH 109,A01,083213,Anzaldo; Leesa B,0,7,30,30
1650690268292,MATH 109,A02,083214,Anzaldo; Leesa B,0,7,30,30
1650690268292,MATH 109,B01,083215,Anzaldo; Leesa B,0,8,30,30
1650690268292,MATH 109,B02,083216,Anzaldo; Leesa B,0,6,30,30
1650690274321,MATH 142A,A01,083219,Chow; Bennett,0,16,30,30
1650690274321,MATH 142A,A02,083220,Chow; Bennett,0,15,30,30
1650690274321,MATH 142A,B01,083221,Chow; Bennett,0,15,30,30
1650690274321,MATH 142A,B02,083222,Chow; Bennett,0,14,30,30
1650690280354,MATH 193A,A01,083224,Staff,0,5,30,30
1650690280354,MATH 193A,A02,083225,Staff,0,6,30,30
1650690280354,MATH 193A,A03,083781,Staff,0,6,30,30
1650690280354,MATH 193A,A04,083782,Staff,0,7,30,30
1650690286378,MATH 197,001,091859,McAuley; Julian John,9998,0,9999,1
1650690292450,COGS 9,A01,083615,Staff,1,16,60,59
1650690298475,COGS 11,A01,083617,Boyle; Mary E. T.,16,0,40,24
1650690304504,COGS 13,A01,083071,Staff,0,38,40,40
1650690310528,COGS 14A,A01,092681,Staff,0,35,100,100
1650690316556,COGS 14B,A01,083073,Cheng; Tzu-Han,1,14,50,49
1650690322580,COGS 17,A01,092677,Staff,14,0,75,61
1650690328608,COGS 100,A01,083619,Staff,0,29,60,60
1650690334633,COGS 101A,A01,083621,Davis; Joshua Daniel,0,27,60,60
1650690340656,COGS 101B,A01,091572,Staff,0,4,60,60
1650690346679,COGS 101C,A01,083625,Delgado; Tania,14,0,30,16
1650690352703,COGS 107A,A01,083627,Boyle; Mary E. T.,1,17,60,59
1650690358727,COGS 118A,A01,083075,Staff,0,7,60,60
1650690364754,CSE 3,A50,083646,Miranda; Gregory Joseph,18,0,38,20
1650690364754,CSE 3,A51,083647,Miranda; Gregory Joseph,36,0,37,1
1650690370783,CSE 8A,A50,083650,Miranda; Gregory Joseph,0,31,40,40
1650690376807,CSE 11,A01,083080,Cao; Yingjun,0,96,40,40
1650690382835,CSE 12,A01,083652,Staff,0,21,100,100
1650690388859,CSE 15L,A01,083654,Staff,0,3,50,50
1650690388859,CSE 15L,A02,083655,Staff,0,2,50,50
1650690394883,CSE 20,A01,083657,Staff,49,0,80,31
1650690400910,CSE 30,A01,083084,Eldon; John,0,78,40,40
1650690406934,CSE 100,A01,083659,Cao; Yingjun,0,70,50,50
1650690412961,CSE 134B,A01,083661,Powell; Thomas Allan,0,38,65,65
1650690418984,CSE 140,A01,083663,Staff,0,10,75,75
1650690425009,CSE 140L,A01,083088,Eldon; John,0,18,75,75
1650690431033,CSE 175,A01,083665,Kumar; Rakesh,7,0,25,18
1650690437057,CSE 190,A00,092507,Dubnov; Shlomo,10,0,20,10
1650690443084,ECE 45,A01,083139,Staff,0,2,60,60
1650690449115,ECE 65,A50,083695,Staff,0,5,30,30
1650690455142,ECE 109,A01,091882,Touri; Behrouz,33,0,70,37
1650690461176,ECE 180,A00,083140,Abi Samra; Nicholas Camill,20,0,30,10
1650690461176,ECE 180,B00,083141,Abi Samra; Nicholas Camill,0,0,30,30
1650690467199,MATH 10A,A01,083735,Patchell; Gregory David,2,0,30,28
1650690467199,MATH 10A,A02,083736,Patchell; Gregory David,27,0,30,3
1650690467199,MATH 10A,A03,083737,Patchell; Gregory David,24,0,30,6
1650690473241,MATH 10B,A01,083207,Staff,0,9,30,30
1650690473241,MATH 10B,A02,083208,Staff,1,8,30,29
1650690473241,MATH 10B,B01,083739,Staff,11,0,30,19
1650690473241,MATH 10B,B02,083740,Staff,28,0,30,2
1650690479275,MATH 18,A01,083743,Staff,0,0,30,30
1650690479275,MATH 18,A02,083744,Staff,23,0,30,7
1650690479275,MATH 18,A03,083745,Staff,21,0,30,9
1650690479275,MATH 18,A04,083746,Staff,26,0,30,4
1650690479275,MATH 18,B01,083748,Staff,0,15,30,30
1650690479275,MATH 18,B02,083749,Staff,0,12,30,30
1650690479275,MATH 18,B03,083750,Staff,0,12,30,30
1650690479275,MATH 18,B04,083751,Staff,0,12,30,30
1650690485299,MATH 20A,A01,083754,Staff,19,0,40,21
1650690491326,MATH 20B,A01,083756,Staff,0,11,30,30
1650690491326,MATH 20B,A02,083757,Staff,0,12,30,30
1650690497354,MATH 20C,A01,083760,Staff,0,16,30,30
1650690497354,MATH 20C,A02,083761,Staff,1,16,30,29
1650690497354,MATH 20C,B01,083762,Staff,9,0,30,21
1650690497354,MATH 20C,B02,083763,Staff,28,0,30,2
1650690503376,MATH 20D,A01,083765,Staff,2,1,30,28
1650690503376,MATH 20D,A02,083766,Staff,6,0,30,24
1650690503376,MATH 20D,A03,083767,Staff,24,0,30,6
1650690509404,MATH 20E,A01,083771,Staff,3,0,30,27
1650690509404,MATH 20E,A02,083772,Staff,16,0,30,14
1650690509404,MATH 20E,B01,083773,Staff,0,0,30,30
1650690509404,MATH 20E,B02,083774,Staff,8,0,30,22
1650690515431,MATH 103A,A01,083777,Staff,0,15,30,30
1650690515431,MATH 103A,A02,083778,Staff,0,15,30,30
1650690515431,MATH 103A,B01,083779,Staff,0,15,30,30
1650690515431,MATH 103A,B02,083780,Staff,0,15,30,30
1650690521454,MATH 105,A01,085443,Staff,0,22,30,30
1650690527490,MATH 109,A01,083213,Anzaldo; Leesa B,0,7,30,30
1650690527490,MATH 109,A02,083214,Anzaldo; Leesa B,0,7,30,30
1650690527490,MATH 109,B01,083215,Anzaldo; Leesa B,0,8,30,30
1650690527490,MATH 109,B02,083216,Anzaldo; Leesa B,0,6,30,30
1650690533516,MATH 142A,A01,083219,Chow; Bennett,0,16,30,30
1650690533516,MATH 142A,A02,083220,Chow; Bennett,0,15,30,30
1650690533516,MATH 142A,B01,083221,Chow; Bennett,0,15,30,30
1650690533516,MATH 142A,B02,083222,Chow; Bennett,0,14,30,30
1650690539540,MATH 193A,A01,083224,Staff,0,5,30,30
1650690539540,MATH 193A,A02,083225,Staff,0,6,30,30
1650690539540,MATH 193A,A03,083781,Staff,0,6,30,30
1650690539540,MATH 193A,A04,083782,Staff,0,7,30,30
1650690545564,MATH 197,001,091859,McAuley; Julian John,9998,0,9999,1
1650690551634,COGS 9,A01,083615,Staff,1,16,60,59
1650690557657,COGS 11,A01,083617,Boyle; Mary E. T.,16,0,40,24
1650690563687,COGS 13,A01,083071,Staff,0,38,40,40
1650690569710,COGS 14A,A01,092681,Staff,0,35,100,100
1650690575742,COGS 14B,A01,083073,Cheng; Tzu-Han,1,14,50,49
1650690581763,COGS 17,A01,092677,Staff,13,0,75,62
1650690587788,COGS 100,A01,083619,Staff,0,29,60,60
1650690593812,COGS 101A,A01,083621,Davis; Joshua Daniel,0,27,60,60
1650690599835,COGS 101B,A01,091572,Staff,0,4,60,60
1650690605865,COGS 101C,A01,083625,Delgado; Tania,14,0,30,16
1650690611889,COGS 107A,A01,083627,Boyle; Mary E. T.,1,17,60,59
1650690617916,COGS 118A,A01,083075,Staff,0,7,60,60
1650690623940,CSE 3,A50,083646,Miranda; Gregory Joseph,18,0,38,20
1650690623940,CSE 3,A51,083647,Miranda; Gregory Joseph,36,0,37,1
1650690629965,CSE 8A,A50,083650,Miranda; Gregory Joseph,0,31,40,40
1650690635989,CSE 11,A01,083080,Cao; Yingjun,0,96,40,40
1650690642016,CSE 12,A01,083652,Staff,0,21,100,100
1650690648041,CSE 15L,A01,083654,Staff,0,3,50,50
1650690648041,CSE 15L,A02,083655,Staff,0,2,50,50
1650690654070,CSE 20,A01,083657,Staff,49,0,80,31
1650690660093,CSE 30,A01,083084,Eldon; John,0,78,40,40
1650690666117,CSE 100,A01,083659,Cao; Yingjun,0,70,50,50
1650690672142,CSE 134B,A01,083661,Powell; Thomas Allan,0,38,65,65
1650690678175,CSE 140,A01,083663,Staff,0,10,75,75
1650690684203,CSE 140L,A01,083088,Eldon; John,0,18,75,75
1650690690326,CSE 175,A01,083665,Kumar; Rakesh,7,0,25,18
1650690696350,CSE 190,A00,092507,Dubnov; Shlomo,10,0,20,10
1650690702375,ECE 45,A01,083139,Staff,0,2,60,60
1650690708397,ECE 65,A50,083695,Staff,0,5,30,30
1650690714420,ECE 109,A01,091882,Touri; Behrouz,33,0,70,37
1650690720464,ECE 180,A00,083140,Abi Samra; Nicholas Camill,20,0,30,10
1650690720464,ECE 180,B00,083141,Abi Samra; Nicholas Camill,0,0,30,30
1650690726488,MATH 10A,A01,083735,Patchell; Gregory David,2,0,30,28
1650690726488,MATH 10A,A02,083736,Patchell; Gregory David,27,0,30,3
1650690726488,MATH 10A,A03,083737,Patchell; Gregory David,24,0,30,6
1650690732511,MATH 10B,A01,083207,Staff,0,9,30,30
1650690732511,MATH 10B,A02,083208,Staff,1,8,30,29
1650690732511,MATH 10B,B01,083739,Staff,11,0,30,19
1650690732511,MATH 10B,B02,083740,Staff,28,0,30,2
1650690738540,MATH 18,A01,083743,Staff,0,0,30,30
1650690738540,MATH 18,A02,083744,Staff,23,0,30,7
1650690738540,MATH 18,A03,083745,Staff,21,0,30,9
1650690738540,MATH 18,A04,083746,Staff,26,0,30,4
1650690738540,MATH 18,B01,083748,Staff,0,15,30,30
1650690738540,MATH 18,B02,083749,Staff,0,12,30,30
1650690738540,MATH 18,B03,083750,Staff,0,12,30,30
1650690738540,MATH 18,B04,083751,Staff,0,12,30,30
1650690744566,MATH 20A,A01,083754,Staff,19,0,40,21
1650690750589,MATH 20B,A01,083756,Staff,0,11,30,30
1650690750589,MATH 20B,A02,083757,Staff,0,12,30,30
1650690756614,MATH 20C,A01,083760,Staff,0,16,30,30
1650690756614,MATH 20C,A02,083761,Staff,1,16,30,29
1650690756614,MATH 20C,B01,083762,Staff,9,0,30,21
1650690756614,MATH 20C,B02,083763,Staff,28,0,30,2
1650690762636,MATH 20D,A01,083765,Staff,2,1,30,28
1650690762636,MATH 20D,A02,083766,Staff,6,0,30,24
1650690762636,MATH 20D,A03,083767,Staff,24,0,30,6
1650690768661,MATH 20E,A01,083771,Staff,3,0,30,27
1650690768661,MATH 20E,A02,083772,Staff,16,0,30,14
1650690768661,MATH 20E,B01,083773,Staff,0,0,30,30
1650690768661,MATH 20E,B02,083774,Staff,8,0,30,22
1650690774685,MATH 103A,A01,083777,Staff,0,15,30,30
1650690774685,MATH 103A,A02,083778,Staff,0,15,30,30
1650690774685,MATH 103A,B01,083779,Staff,0,15,30,30
1650690774685,MATH 103A,B02,083780,Staff,0,15,30,30
1650690780710,MATH 105,A01,085443,Staff,0,22,30,30
1650690786732,MATH 109,A01,083213,Anzaldo; Leesa B,0,7,30,30
1650690786732,MATH 109,A02,083214,Anzaldo; Leesa B,0,7,30,30
1650690786732,MATH 109,B01,083215,Anzaldo; Leesa B,0,8,30,30
1650690786732,MATH 109,B02,083216,Anzaldo; Leesa B,0,6,30,30
1650690792757,MATH 142A,A01,083219,Chow; Bennett,0,16,30,30
1650690792757,MATH 142A,A02,083220,Chow; Bennett,0,15,30,30
1650690792757,MATH 142A,B01,083221,Chow; Bennett,0,15,30,30
1650690792757,MATH 142A,B02,083222,Chow; Bennett,0,14,30,30
1650690798781,MATH 193A,A01,083224,Staff,0,5,30,30
1650690798781,MATH 193A,A02,083225,Staff,0,6,30,30
1650690798781,MATH 193A,A03,083781,Staff,0,6,30,30
1650690798781,MATH 193A,A04,083782,Staff,0,7,30,30
1650690804805,MATH 197,001,091859,McAuley; Julian John,9998,0,9999,1
1650690810866,COGS 9,A01,083615,Staff,1,16,60,59
1650690816889,COGS 11,A01,083617,Boyle; Mary E. T.,16,0,40,24
1650690822916,COGS 13,A01,083071,Staff,0,38,40,40
1650690828949,COGS 14A,A01,092681,Staff,0,35,100,100
1650690834974,COGS 14B,A01,083073,Cheng; Tzu-Han,1,14,50,49
1650690840998,COGS 17,A01,092677,Staff,13,0,75,62
1650690847024,COGS 100,A01,083619,Staff,0,29,60,60
1650690853058,COGS 101A,A01,083621,Davis; Joshua Daniel,0,27,60,60
1650690859082,COGS 101B,A01,091572,Staff,0,4,60,60
1650690865105,COGS 101C,A01,083625,Delgado; Tania,14,0,30,16
1650690871129,COGS 107A,A01,083627,Boyle; Mary E. T.,1,17,60,59
1650690877152,COGS 118A,A01,083075,Staff,0,7,60,60
1650690883177,CSE 3,A50,083646,Miranda; Gregory Joseph,18,0,38,20
1650690883177,CSE 3,A51,083647,Miranda; Gregory Joseph,36,0,37,1
1650690889202,CSE 8A,A50,083650,Miranda; Gregory Joseph,0,31,40,40
1650690895227,CSE 11,A01,083080,Cao; Yingjun,0,96,40,40
1650690901252,CSE 12,A01,083652,Staff,0,21,100,100
1650690907278,CSE 15L,A01,083654,Staff,0,3,50,50
1650690907278,CSE 15L,A02,083655,Staff,0,2,50,50
1650690913306,CSE 20,A01,083657,Staff,49,0,80,31
1650690919359,CSE 30,A01,083084,Eldon; John,0,78,40,40
1650690925387,CSE 100,A01,083659,Cao; Yingjun,0,70,50,50
1650690931413,CSE 134B,A01,083661,Powell; Thomas Allan,0,38,65,65
1650690937436,CSE 140,A01,083663,Staff,0,10,75,75
1650690943461,CSE 140L,A01,083088,Eldon; John,0,18,75,75
1650690949485,CSE 175,A01,083665,Kumar; Rakesh,7,0,25,18
1650690955512,CSE 190,A00,092507,Dubnov; Shlomo,10,0,20,10
1650690961542,ECE 45,A01,083139,Staff,0,2,60,60
1650690967575,ECE 65,A50,083695,Staff,0,5,30,30
1650690973602,ECE 109,A01,091882,Touri; Behrouz,33,0,70,37
1650690979635,ECE 180,A00,083140,Abi Samra; Nicholas Camill,20,0,30,10
1650690979635,ECE 180,B00,083141,Abi Samra; Nicholas Camill,0,0,30,30
1650690985660,MATH 10A,A01,083735,Patchell; Gregory David,2,0,30,28
1650690985660,MATH 10A,A02,083736,Patchell; Gregory David,27,0,30,3
1650690985660,MATH 10A,A03,083737,Patchell; Gregory David,24,0,30,6
1650690991687,MATH 10B,A01,083207,Staff,0,9,30,30
1650690991687,MATH 10B,A02,083208,Staff,1,8,30,29
1650690991687,MATH 10B,B01,083739,Staff,11,0,30,19
1650690991687,MATH 10B,B02,083740,Staff,28,0,30,2
1650690997730,MATH 18,A01,083743,Staff,0,0,30,30
1650690997730,MATH 18,A02,083744,Staff,23,0,30,7
1650690997730,MATH 18,A03,083745,Staff,21,0,30,9
1650690997730,MATH 18,A04,083746,Staff,26,0,30,4
1650690997730,MATH 18,B01,083748,Staff,0,15,30,30
1650690997730,MATH 18,B02,083749,Staff,0,12,30,30
1650690997730,MATH 18,B03,083750,Staff,0,12,30,30
1650690997730,MATH 18,B04,083751,Staff,0,12,30,30
1650691003764,MATH 20A,A01,083754,Staff,19,0,40,21
1650691009794,MATH 20B,A01,083756,Staff,0,11,30,30
1650691009794,MATH 20B,A02,083757,Staff,0,12,30,30
1650691015822,MATH 20C,A01,083760,Staff,0,16,30,30
1650691015822,MATH 20C,A02,083761,Staff,1,16,30,29
1650691015822,MATH 20C,B01,083762,Staff,9,0,30,21
1650691015822,MATH 20C,B02,083763,Staff,28,0,30,2
1650691021857,MATH 20D,A01,083765,Staff,2,1,30,28
1650691021857,MATH 20D,A02,083766,Staff,6,0,30,24
1650691021857,MATH 20D,A03,083767,Staff,24,0,30,6
1650691027883,MATH 20E,A01,083771,Staff,3,0,30,27
1650691027883,MATH 20E,A02,083772,Staff,16,0,30,14
1650691027883,MATH 20E,B01,083773,Staff,0,0,30,30
1650691027883,MATH 20E,B02,083774,Staff,8,0,30,22
1650691033913,MATH 103A,A01,083777,Staff,0,15,30,30
1650691033913,MATH 103A,A02,083778,Staff,0,15,30,30
1650691033913,MATH 103A,B01,083779,Staff,0,15,30,30
1650691033913,MATH 103A,B02,083780,Staff,0,15,30,30
1650691039936,MATH 105,A01,085443,Staff,0,22,30,30
1650691045969,MATH 109,A01,083213,Anzaldo; Leesa B,0,7,30,30
1650691045969,MATH 109,A02,083214,Anzaldo; Leesa B,0,7,30,30
1650691045969,MATH 109,B01,083215,Anzaldo; Leesa B,0,8,30,30
1650691045969,MATH 109,B02,083216,Anzaldo; Leesa B,0,6,30,30
1650691052002,MATH 142A,A01,083219,Chow; Bennett,0,16,30,30
1650691052002,MATH 142A,A02,083220,Chow; Bennett,0,15,30,30
1650691052002,MATH 142A,B01,083221,Chow; Bennett,0,15,30,30
1650691052002,MATH 142A,B02,083222,Chow; Bennett,0,14,30,30
1650691058030,MATH 193A,A01,083224,Staff,0,5,30,30
1650691058030,MATH 193A,A02,083225,Staff,0,6,30,30
1650691058030,MATH 193A,A03,083781,Staff,0,6,30,30
1650691058030,MATH 193A,A04,083782,Staff,0,7,30,30
1650691064055,MATH 197,001,091859,McAuley; Julian John,9998,0,9999,1
1650691070111,COGS 9,A01,083615,Staff,1,16,60,59
1650691076132,COGS 11,A01,083617,Boyle; Mary E. T.,16,0,40,24
1650691082167,COGS 13,A01,083071,Staff,0,38,40,40
1650691088205,COGS 14A,A01,092681,Staff,0,35,100,100
1650691094228,COGS 14B,A01,083073,Cheng; Tzu-Han,1,14,50,49
1650691100261,COGS 17,A01,092677,Staff,13,0,75,62
1650691106287,COGS 100,A01,083619,Staff,0,29,60,60
1650691112315,COGS 101A,A01,083621,Davis; Joshua Daniel,0,27,60,60
1650691118338,COGS 101B,A01,091572,Staff,0,4,60,60
1650691124362,COGS 101C,A01,083625,Delgado; Tania,14,0,30,16
1650691130388,COGS 107A,A01,083627,Boyle; Mary E. T.,1,17,60,59
1650691136426,COGS 118A,A01,083075,Staff,0,7,60,60
1650691142450,CSE 3,A50,083646,Miranda; Gregory Joseph,18,0,38,20
1650691142450,CSE 3,A51,083647,Miranda; Gregory Joseph,36,0,37,1
1650691148474,CSE 8A,A50,083650,Miranda; Gregory Joseph,0,31,40,40
1650691154498,CSE 11,A01,083080,Cao; Yingjun,0,96,40,40
1650691160537,CSE 12,A01,083652,Staff,0,21,100,100
1650691166560,CSE 15L,A01,083654,Staff,0,3,50,50
1650691166560,CSE 15L,A02,083655,Staff,0,2,50,50
1650691172584,CSE 20,A01,083657,Staff,49,0,80,31
1650691178634,CSE 30,A01,083084,Eldon; John,0,78,40,40
1650691184661,CSE 100,A01,083659,Cao; Yingjun,0,70,50,50
1650691190688,CSE 134B,A01,083661,Powell; Thomas Allan,0,38,65,65
1650691196711,CSE 140,A01,083663,Staff,0,10,75,75
1650691202735,CSE 140L,A01,083088,Eldon; John,0,18,75,75
1650691208762,CSE 175,A01,083665,Kumar; Rakesh,7,0,25,18
1650691214794,CSE 190,A00,092507,Dubnov; Shlomo,10,0,20,10
1650691220816,ECE 45,A01,083139,Staff,0,2,60,60
1650691226846,ECE 65,A50,083695,Staff,0,5,30,30
1650691232868,ECE 109,A01,091882,Touri; Behrouz,33,0,70,37
1650691238894,ECE 180,A00,083140,Abi Samra; Nicholas Camill,20,0,30,10
1650691238894,ECE 180,B00,083141,Abi Samra; Nicholas Camill,0,0,30,30
1650691244927,MATH 10A,A01,083735,Patchell; Gregory David,2,0,30,28
1650691244927,MATH 10A,A02,083736,Patchell; Gregory David,27,0,30,3
1650691244927,MATH 10A,A03,083737,Patchell; Gregory David,24,0,30,6
1650691250962,MATH 10B,A01,083207,Staff,0,9,30,30
1650691250962,MATH 10B,A02,083208,Staff,1,8,30,29
1650691250962,MATH 10B,B01,083739,Staff,11,0,30,19
1650691250962,MATH 10B,B02,083740,Staff,28,0,30,2
1650691256992,MATH 18,A01,083743,Staff,0,0,30,30
1650691256992,MATH 18,A02,083744,Staff,23,0,30,7
1650691256992,MATH 18,A03,083745,Staff,21,0,30,9
1650691256992,MATH 18,A04,083746,Staff,26,0,30,4
1650691256992,MATH 18,B01,083748,Staff,0,15,30,30
1650691256992,MATH 18,B02,083749,Staff,0,12,30,30
1650691256992,MATH 18,B03,083750,Staff,0,12,30,30
1650691256992,MATH 18,B04,083751,Staff,0,12,30,30
1650691263019,MATH 20A,A01,083754,Staff,19,0,40,21
1650691269045,MATH 20B,A01,083756,Staff,0,11,30,30
1650691269045,MATH 20B,A02,083757,Staff,0,12,30,30
1650691275079,MATH 20C,A01,083760,Staff,0,16,30,30
1650691275079,MATH 20C,A02,083761,Staff,1,16,30,29
1650691275079,MATH 20C,B01,083762,Staff,9,0,30,21
1650691275079,MATH 20C,B02,083763,Staff,28,0,30,2
1650691281105,MATH 20D,A01,083765,Staff,2,1,30,28
1650691281105,MATH 20D,A02,083766,Staff,6,0,30,24
1650691281105,MATH 20D,A03,083767,Staff,24,0,30,6
1650691287209,MATH 20E,A01,083771,Staff,3,0,30,27
1650691287209,MATH 20E,A02,083772,Staff,16,0,30,14
1650691287209,MATH 20E,B01,083773,Staff,0,0,30,30
1650691287209,MATH 20E,B02,083774,Staff,8,0,30,22
1650691293231,MATH 103A,A01,083777,Staff,0,15,30,30
1650691293231,MATH 103A,A02,083778,Staff,0,15,30,30
1650691293231,MATH 103A,B01,083779,Staff,0,15,30,30
1650691293231,MATH 103A,B02,083780,Staff,0,15,30,30
1650691299260,MATH 105,A01,085443,Staff,0,22,30,30
1650691305290,MATH 109,A01,083213,Anzaldo; Leesa B,0,7,30,30
1650691305290,MATH 109,A02,083214,Anzaldo; Leesa B,0,7,30,30
1650691305290,MATH 109,B01,083215,Anzaldo; Leesa B,0,8,30,30
1650691305290,MATH 109,B02,083216,Anzaldo; Leesa B,0,6,30,30
1650691311314,MATH 142A,A01,083219,Chow; Bennett,0,16,30,30
1650691311314,MATH 142A,A02,083220,Chow; Bennett,0,15,30,30
1650691311314,MATH 142A,B01,083221,Chow; Bennett,0,15,30,30
1650691311314,MATH 142A,B02,083222,Chow; Bennett,0,14,30,30
1650691317338,MATH 193A,A01,083224,Staff,0,5,30,30
1650691317338,MATH 193A,A02,083225,Staff,0,6,30,30
1650691317338,MATH 193A,A03,083781,Staff,0,6,30,30
1650691317338,MATH 193A,A04,083782,Staff,0,7,30,30
1650691323374,MATH 197,001,091859,McAuley; Julian John,9998,0,9999,1
1650691329430,COGS 9,A01,083615,Staff,1,16,60,59
1650691335455,COGS 11,A01,083617,Boyle; Mary E. T.,16,0,40,24
1650691341492,COGS 13,A01,083071,Staff,0,38,40,40
1650691347516,COGS 14A,A01,092681,Staff,0,35,100,100
1650691353543,COGS 14B,A01,083073,Cheng; Tzu-Han,1,14,50,49
1650691359579,COGS 17,A01,092677,Staff,13,0,75,62
1650691365605,COGS 100,A01,083619,Staff,0,29,60,60
1650691371644,COGS 101A,A01,083621,Davis; Joshua Daniel,0,27,60,60
1650691377666,COGS 101B,A01,091572,Staff,0,4,60,60
1650691383692,COGS 101C,A01,083625,Delgado; Tania,14,0,30,16
1650691389715,COGS 107A,A01,083627,Boyle; Mary E. T.,1,17,60,59
1650691395737,COGS 118A,A01,083075,Staff,0,7,60,60
1650691401764,CSE 3,A50,083646,Miranda; Gregory Joseph,18,0,38,20
1650691401764,CSE 3,A51,083647,Miranda; Gregory Joseph,36,0,37,1
1650691407787,CSE 8A,A50,083650,Miranda; Gregory Joseph,0,31,40,40
1650691413811,CSE 11,A01,083080,Cao; Yingjun,0,96,40,40
1650691419833,CSE 12,A01,083652,Staff,0,21,100,100
1650691425858,CSE 15L,A01,083654,Staff,0,3,50,50
1650691425858,CSE 15L,A02,083655,Staff,0,2,50,50
1650691431887,CSE 20,A01,083657,Staff,49,0,80,31
1650691437919,CSE 30,A01,083084,Eldon; John,0,78,40,40
1650691443946,CSE 100,A01,083659,Cao; Yingjun,0,70,50,50
1650691449970,CSE 134B,A01,083661,Powell; Thomas Allan,0,38,65,65
1650691455993,CSE 140,A01,083663,Staff,0,10,75,75
1650691462019,CSE 140L,A01,083088,Eldon; John,0,18,75,75
1650691468043,CSE 175,A01,083665,Kumar; Rakesh,7,0,25,18
1650691474079,CSE 190,A00,092507,Dubnov; Shlomo,10,0,20,10
1650691480112,ECE 45,A01,083139,Staff,0,2,60,60
1650691486156,ECE 65,A50,083695,Staff,0,5,30,30
1650691492183,ECE 109,A01,091882,Touri; Behrouz,33,0,70,37
1650691498220,ECE 180,A00,083140,Abi Samra; Nicholas Camill,20,0,30,10
1650691498220,ECE 180,B00,083141,Abi Samra; Nicholas Camill,0,0,30,30
1650691504247,MATH 10A,A01,083735,Patchell; Gregory David,2,0,30,28
1650691504247,MATH 10A,A02,083736,Patchell; Gregory David,27,0,30,3
1650691504247,MATH 10A,A03,083737,Patchell; Gregory David,24,0,30,6
1650691510277,MATH 10B,A01,083207,Staff,0,9,30,30
1650691510277,MATH 10B,A02,083208,Staff,1,8,30,29
1650691510277,MATH 10B,B01,083739,Staff,11,0,30,19
1650691510277,MATH 10B,B02,083740,Staff,28,0,30,2
1650691516302,MATH 18,A01,083743,Staff,0,0,30,30
1650691516302,MATH 18,A02,083744,Staff,23,0,30,7
1650691516302,MATH 18,A03,083745,Staff,21,0,30,9
1650691516302,MATH 18,A04,083746,Staff,26,0,30,4
1650691516302,MATH 18,B01,083748,Staff,0,15,30,30
1650691516302,MATH 18,B02,083749,Staff,0,12,30,30
1650691516302,MATH 18,B03,083750,Staff,0,12,30,30
1650691516302,MATH 18,B04,083751,Staff,0,12,30,30
1650691522330,MATH 20A,A01,083754,Staff,19,0,40,21
1650691528353,MATH 20B,A01,083756,Staff,0,11,30,30
1650691528353,MATH 20B,A02,083757,Staff,0,12,30,30
1650691534376,MATH 20C,A01,083760,Staff,0,16,30,30
1650691534376,MATH 20C,A02,083761,Staff,1,16,30,29
1650691534376,MATH 20C,B01,083762,Staff,9,0,30,21
1650691534376,MATH 20C,B02,083763,Staff,28,0,30,2
1650691540400,MATH 20D,A01,083765,Staff,2,1,30,28
1650691540400,MATH 20D,A02,083766,Staff,6,0,30,24
1650691540400,MATH 20D,A03,083767,Staff,24,0,30,6
1650691546423,MATH 20E,A01,083771,Staff,3,0,30,27
1650691546423,MATH 20E,A02,083772,Staff,16,0,30,14
1650691546423,MATH 20E,B01,083773,Staff,0,0,30,30
1650691546423,MATH 20E,B02,083774,Staff,8,0,30,22
1650691552446,MATH 103A,A01,083777,Staff,0,15,30,30
1650691552446,MATH 103A,A02,083778,Staff,0,15,30,30
1650691552446,MATH 103A,B01,083779,Staff,0,15,30,30
1650691552446,MATH 103A,B02,083780,Staff,0,15,30,30
1650691558480,MATH 105,A01,085443,Staff,0,22,30,30
1650691564508,MATH 109,A01,083213,Anzaldo; Leesa B,0,7,30,30
1650691564508,MATH 109,A02,083214,Anzaldo; Leesa B,0,7,30,30
1650691564508,MATH 109,B01,083215,Anzaldo; Leesa B,0,8,30,30
1650691564508,MATH 109,B02,083216,Anzaldo; Leesa B,0,6,30,30
1650691570532,MATH 142A,A01,083219,Chow; Bennett,0,16,30,30
1650691570532,MATH 142A,A02,083220,Chow; Bennett,0,15,30,30
1650691570532,MATH 142A,B01,083221,Chow; Bennett,0,15,30,30
1650691570532,MATH 142A,B02,083222,Chow; Bennett,0,14,30,30
1650691576560,MATH 193A,A01,083224,Staff,0,5,30,30
1650691576560,MATH 193A,A02,083225,Staff,0,6,30,30
1650691576560,MATH 193A,A03,083781,Staff,0,6,30,30
1650691576560,MATH 193A,A04,083782,Staff,0,7,30,30
1650691582585,MATH 197,001,091859,McAuley; Julian John,9998,0,9999,1
1650691588647,COGS 9,A01,083615,Staff,1,16,60,59
1650691594681,COGS 11,A01,083617,Boyle; Mary E. T.,16,0,40,24
1650691600711,COGS 13,A01,083071,Staff,0,38,40,40
1650691606735,COGS 14A,A01,092681,Staff,0,35,100,100
1650691612765,COGS 14B,A01,083073,Cheng; Tzu-Han,0,13,50,50
1650691618795,COGS 17,A01,092677,Staff,13,0,75,62
1650691624822,COGS 100,A01,083619,Staff,0,29,60,60
1650691630846,COGS 101A,A01,083621,Davis; Joshua Daniel,0,27,60,60
1650691636873,COGS 101B,A01,091572,Staff,0,4,60,60
1650691642899,COGS 101C,A01,083625,Delgado; Tania,14,0,30,16
1650691648922,COGS 107A,A01,083627,Boyle; Mary E. T.,0,16,60,60
1650691654945,COGS 118A,A01,083075,Staff,0,7,60,60
1650691660970,CSE 3,A50,083646,Miranda; Gregory Joseph,18,0,38,20
1650691660970,CSE 3,A51,083647,Miranda; Gregory Joseph,36,0,37,1
1650691667000,CSE 8A,A50,083650,Miranda; Gregory Joseph,0,31,40,40
1650691673031,CSE 11,A01,083080,Cao; Yingjun,0,96,40,40
1650691679058,CSE 12,A01,083652,Staff,0,21,100,100
1650691685084,CSE 15L,A01,083654,Staff,0,3,50,50
1650691685084,CSE 15L,A02,083655,Staff,0,2,50,50
1650691691111,CSE 20,A01,083657,Staff,49,0,80,31
1650691697138,CSE 30,A01,083084,Eldon; John,0,78,40,40
1650691703160,CSE 100,A01,083659,Cao; Yingjun,0,70,50,50
1650691709188,CSE 134B,A01,083661,Powell; Thomas Allan,0,38,65,65
1650691715214,CSE 140,A01,083663,Staff,0,10,75,75
1650691721238,CSE 140L,A01,083088,Eldon; John,0,18,75,75
1650691727262,CSE 175,A01,083665,Kumar; Rakesh,7,0,25,18
1650691733285,CSE 190,A00,092507,Dubnov; Shlomo,10,0,20,10
1650691739313,ECE 45,A01,083139,Staff,0,2,60,60
1650691745335,ECE 65,A50,083695,Staff,0,5,30,30
1650691751362,ECE 109,A01,091882,Touri; Behrouz,33,0,70,37
1650691757384,ECE 180,A00,083140,Abi Samra; Nicholas Camill,20,0,30,10
1650691757384,ECE 180,B00,083141,Abi Samra; Nicholas Camill,0,0,30,30
1650691763412,MATH 10A,A01,083735,Patchell; Gregory David,2,0,30,28
1650691763412,MATH 10A,A02,083736,Patchell; Gregory David,27,0,30,3
1650691763412,MATH 10A,A03,083737,Patchell; Gregory David,24,0,30,6
1650691769440,MATH 10B,A01,083207,Staff,0,9,30,30
1650691769440,MATH 10B,A02,083208,Staff,1,7,30,29
1650691769440,MATH 10B,B01,083739,Staff,11,0,30,19
1650691769440,MATH 10B,B02,083740,Staff,28,0,30,2
1650691775464,MATH 18,A01,083743,Staff,0,0,30,30
1650691775464,MATH 18,A02,083744,Staff,23,0,30,7
1650691775464,MATH 18,A03,083745,Staff,21,0,30,9
1650691775464,MATH 18,A04,083746,Staff,26,0,30,4
1650691775464,MATH 18,B01,083748,Staff,0,15,30,30
1650691775464,MATH 18,B02,083749,Staff,0,12,30,30
1650691775464,MATH 18,B03,083750,Staff,0,12,30,30
1650691775464,MATH 18,B04,083751,Staff,0,12,30,30
1650691781488,MATH 20A,A01,083754,Staff,19,0,40,21
1650691787512,MATH 20B,A01,083756,Staff,0,11,30,30
1650691787512,MATH 20B,A02,083757,Staff,0,12,30,30
1650691793538,MATH 20C,A01,083760,Staff,0,16,30,30
1650691793538,MATH 20C,A02,083761,Staff,0,15,30,30
1650691793538,MATH 20C,B01,083762,Staff,9,0,30,21
1650691793538,MATH 20C,B02,083763,Staff,28,0,30,2
1650691799564,MATH 20D,A01,083765,Staff,2,1,30,28
1650691799564,MATH 20D,A02,083766,Staff,6,0,30,24
1650691799564,MATH 20D,A03,083767,Staff,24,0,30,6
1650691805587,MATH 20E,A01,083771,Staff,3,0,30,27
1650691805587,MATH 20E,A02,083772,Staff,16,0,30,14
1650691805587,MATH 20E,B01,083773,Staff,0,0,30,30
1650691805587,MATH 20E,B02,083774,Staff,8,0,30,22
1650691811612,MATH 103A,A01,083777,Staff,0,15,30,30
1650691811612,MATH 103A,A02,083778,Staff,0,15,30,30
1650691811612,MATH 103A,B01,083779,Staff,0,15,30,30
1650691811612,MATH 103A,B02,083780,Staff,0,15,30,30
1650691817659,MATH 105,A01,085443,Staff,0,22,30,30
1650691823691,MATH 109,A01,083213,Anzaldo; Leesa B,0,7,30,30
1650691823691,MATH 109,A02,083214,Anzaldo; Leesa B,0,7,30,30
1650691823691,MATH 109,B01,083215,Anzaldo; Leesa B,0,8,30,30
1650691823691,MATH 109,B02,083216,Anzaldo; Leesa B,0,6,30,30
1650691829720,MATH 142A,A01,083219,Chow; Bennett,0,16,30,30
1650691829720,MATH 142A,A02,083220,Chow; Bennett,0,15,30,30
1650691829720,MATH 142A,B01,083221,Chow; Bennett,0,15,30,30
1650691829720,MATH 142A,B02,083222,Chow; Bennett,0,14,30,30
1650691835745,MATH 193A,A01,083224,Staff,0,5,30,30
1650691835745,MATH 193A,A02,083225,Staff,0,6,30,30
1650691835745,MATH 193A,A03,083781,Staff,0,6,30,30
1650691835745,MATH 193A,A04,083782,Staff,0,7,30,30
1650691841768,MATH 197,001,091859,McAuley; Julian John,9998,0,9999,1
1650691847821,COGS 9,A01,083615,Staff,1,15,60,59
1650691853847,COGS 11,A01,083617,Boyle; Mary E. T.,16,0,40,24
1650691859870,COGS 13,A01,083071,Staff,0,38,40,40
1650691865893,COGS 14A,A01,092681,Staff,0,35,100,100
1650691871923,COGS 14B,A01,083073,Cheng; Tzu-Han,1,13,50,49
1650691878037,COGS 17,A01,092677,Staff,13,0,75,62
1650691884064,COGS 100,A01,083619,Staff,0,29,60,60
1650691890087,COGS 101A,A01,083621,Davis; Joshua Daniel,0,27,60,60
1650691896113,COGS 101B,A01,091572,Staff,0,4,60,60
1650691902142,COGS 101C,A01,083625,Delgado; Tania,14,0,30,16
1650691908171,COGS 107A,A01,083627,Boyle; Mary E. T.,0,16,60,60
1650691914195,COGS 118A,A01,083075,Staff,0,7,60,60
1650691920228,CSE 3,A50,083646,Miranda; Gregory Joseph,18,0,38,20
1650691920228,CSE 3,A51,083647,Miranda; Gregory Joseph,36,0,37,1
1650691926252,CSE 8A,A50,083650,Miranda; Gregory Joseph,0,31,40,40
1650691932276,CSE 11,A01,083080,Cao; Yingjun,0,96,40,40
1650691938315,CSE 12,A01,083652,Staff,0,21,100,100
1650691944338,CSE 15L,A01,083654,Staff,0,3,50,50
1650691944338,CSE 15L,A02,083655,Staff,0,2,50,50
1650691950361,CSE 20,A01,083657,Staff,49,0,80,31
1650691956384,CSE 30,A01,083084,Eldon; John,0,78,40,40
1650691962407,CSE 100,A01,083659,Cao; Yingjun,0,70,50,50
1650691968436,CSE 134B,A01,083661,Powell; Thomas Allan,0,38,65,65
1650691974459,CSE 140,A01,083663,Staff,0,10,75,75
1650691980484,CSE 140L,A01,083088,Eldon; John,0,18,75,75
1650691986505,CSE 175,A01,083665,Kumar; Rakesh,7,0,25,18
1650691992530,CSE 190,A00,092507,Dubnov; Shlomo,10,0,20,10
1650691998553,ECE 45,A01,083139,Staff,0,2,60,60
1650692004575,ECE 65,A50,083695,Staff,0,5,30,30
1650692010597,ECE 109,A01,091882,Touri; Behrouz,33,0,70,37
1650692016626,ECE 180,A00,083140,Abi Samra; Nicholas Camill,20,0,30,10
1650692016626,ECE 180,B00,083141,Abi Samra; Nicholas Camill,0,0,30,30
1650692034358,MATH 10A,A01,083735,Patchell; Gregory David,2,0,30,28
1650692034358,MATH 10A,A02,083736,Patchell; Gregory David,27,0,30,3
1650692034358,MATH 10A,A03,083737,Patchell; Gregory David,24,0,30,6
1650692040381,MATH 10B,A01,083207,Staff,0,9,30,30
1650692040381,MATH 10B,A02,083208,Staff,1,7,30,29
1650692040381,MATH 10B,B01,083739,Staff,11,0,30,19
1650692040381,MATH 10B,B02,083740,Staff,28,0,30,2
1650692046406,MATH 18,A01,083743,Staff,0,0,30,30
1650692046406,MATH 18,A02,083744,Staff,23,0,30,7
1650692046406,MATH 18,A03,083745,Staff,21,0,30,9
1650692046406,MATH 18,A04,083746,Staff,26,0,30,4
1650692046406,MATH 18,B01,083748,Staff,0,15,30,30
1650692046406,MATH 18,B02,083749,Staff,0,12,30,30
1650692046406,MATH 18,B03,083750,Staff,0,12,30,30
1650692046406,MATH 18,B04,083751,Staff,0,12,30,30
1650692052428,MATH 20A,A01,083754,Staff,19,0,40,21
1650692058451,MATH 20B,A01,083756,Staff,0,11,30,30
1650692058451,MATH 20B,A02,083757,Staff,0,12,30,30
1650692064475,MATH 20C,A01,083760,Staff,0,16,30,30
1650692064475,MATH 20C,A02,083761,Staff,0,15,30,30
1650692064475,MATH 20C,B01,083762,Staff,9,0,30,21
1650692064475,MATH 20C,B02,083763,Staff,28,0,30,2
1650692070499,MATH 20D,A01,083765,Staff,2,1,30,28
1650692070499,MATH 20D,A02,083766,Staff,6,0,30,24
1650692070499,MATH 20D,A03,083767,Staff,24,0,30,6
1650692076527,MATH 20E,A01,083771,Staff,3,0,30,27
1650692076527,MATH 20E,A02,083772,Staff,16,0,30,14
1650692076527,MATH 20E,B01,083773,Staff,0,0,30,30
1650692076527,MATH 20E,B02,083774,Staff,8,0,30,22
1650692082550,MATH 103A,A01,083777,Staff,0,15,30,30
1650692082550,MATH 103A,A02,083778,Staff,0,15,30,30
1650692082550,MATH 103A,B01,083779,Staff,0,15,30,30
1650692082550,MATH 103A,B02,083780,Staff,0,15,30,30
1650692088577,MATH 105,A01,085443,Staff,0,22,30,30
1650692094600,MATH 109,A01,083213,Anzaldo; Leesa B,0,7,30,30
1650692094600,MATH 109,A02,083214,Anzaldo; Leesa B,0,7,30,30
1650692094600,MATH 109,B01,083215,Anzaldo; Leesa B,0,8,30,30
1650692094600,MATH 109,B02,083216,Anzaldo; Leesa B,0,6,30,30
1650692100624,MATH 142A,A01,083219,Chow; Bennett,0,16,30,30
1650692100624,MATH 142A,A02,083220,Chow; Bennett,0,15,30,30
1650692100624,MATH 142A,B01,083221,Chow; Bennett,0,15,30,30
1650692100624,MATH 142A,B02,083222,Chow; Bennett,0,14,30,30
1650692106655,MATH 193A,A01,083224,Staff,0,5,30,30
1650692106655,MATH 193A,A02,083225,Staff,0,6,30,30
1650692106655,MATH 193A,A03,083781,Staff,0,6,30,30
1650692106655,MATH 193A,A04,083782,Staff,0,7,30,30
1650692112679,MATH 197,001,091859,McAuley; Julian John,9998,0,9999,1
1650692118740,COGS 9,A01,083615,Staff,1,15,60,59
1650692124762,COGS 11,A01,083617,Boyle; Mary E. T.,16,0,40,24
1650692130785,COGS 13,A01,083071,Staff,0,38,40,40
1650692136811,COGS 14A,A01,092681,Staff,0,35,100,100
1650692142834,COGS 14B,A01,083073,Cheng; Tzu-Han,1,13,50,49
1650692148857,COGS 17,A01,092677,Staff,13,0,75,62
1650692154883,COGS 100,A01,083619,Staff,0,29,60,60
1650692160930,COGS 101A,A01,083621,Davis; Joshua Daniel,0,27,60,60
1650692166953,COGS 101B,A01,091572,Staff,0,4,60,60
1650692172976,COGS 101C,A01,083625,Delgado; Tania,14,0,30,16
1650692179002,COGS 107A,A01,083627,Boyle; Mary E. T.,0,16,60,60
1650692185028,COGS 118A,A01,083075,Staff,0,7,60,60
1650692191055,CSE 3,A50,083646,Miranda; Gregory Joseph,18,0,38,20
1650692191055,CSE 3,A51,083647,Miranda; Gregory Joseph,36,0,37,1
1650692197079,CSE 8A,A50,083650,Miranda; Gregory Joseph,0,31,40,40
1650692203105,CSE 11,A01,083080,Cao; Yingjun,0,96,40,40
1650692209131,CSE 12,A01,083652,Staff,0,21,100,100
1650692215155,CSE 15L,A01,083654,Staff,0,3,50,50
1650692215155,CSE 15L,A02,083655,Staff,0,2,50,50
1650692221180,CSE 20,A01,083657,Staff,49,0,80,31
1650692227206,CSE 30,A01,083084,Eldon; John,0,78,40,40
1650692233241,CSE 100,A01,083659,Cao; Yingjun,0,70,50,50
1650692239265,CSE 134B,A01,083661,Powell; Thomas Allan,0,38,65,65
1650692245290,CSE 140,A01,083663,Staff,0,10,75,75
1650692251315,CSE 140L,A01,083088,Eldon; John,0,18,75,75
1650692257338,CSE 175,A01,083665,Kumar; Rakesh,7,0,25,18
1650692263362,CSE 190,A00,092507,Dubnov; Shlomo,10,0,20,10
1650692269384,ECE 45,A01,083139,Staff,0,2,60,60
1650692275410,ECE 65,A50,083695,Staff,0,5,30,30
1650692281449,ECE 109,A01,091882,Touri; Behrouz,33,0,70,37
1650692287472,ECE 180,A00,083140,Abi Samra; Nicholas Camill,20,0,30,10
1650692287472,ECE 180,B00,083141,Abi Samra; Nicholas Camill,0,0,30,30
1650692293496,MATH 10A,A01,083735,Patchell; Gregory David,2,0,30,28
1650692293496,MATH 10A,A02,083736,Patchell; Gregory David,27,0,30,3
1650692293496,MATH 10A,A03,083737,Patchell; Gregory David,24,0,30,6
1650692299520,MATH 10B,A01,083207,Staff,0,9,30,30
1650692299520,MATH 10B,A02,083208,Staff,1,7,30,29
1650692299520,MATH 10B,B01,083739,Staff,11,0,30,19
1650692299520,MATH 10B,B02,083740,Staff,28,0,30,2
1650692305545,MATH 18,A01,083743,Staff,0,0,30,30
1650692305545,MATH 18,A02,083744,Staff,23,0,30,7
1650692305545,MATH 18,A03,083745,Staff,21,0,30,9
1650692305545,MATH 18,A04,083746,Staff,26,0,30,4
1650692305545,MATH 18,B01,083748,Staff,0,15,30,30
1650692305545,MATH 18,B02,083749,Staff,0,12,30,30
1650692305545,MATH 18,B03,083750,Staff,0,12,30,30
1650692305545,MATH 18,B04,083751,Staff,0,12,30,30
1650692311572,MATH 20A,A01,083754,Staff,19,0,40,21
1650692317600,MATH 20B,A01,083756,Staff,0,11,30,30
1650692317600,MATH 20B,A02,083757,Staff,0,12,30,30
1650692323623,MATH 20C,A01,083760,Staff,0,16,30,30
1650692323623,MATH 20C,A02,083761,Staff,0,15,30,30
1650692323623,MATH 20C,B01,083762,Staff,9,0,30,21
1650692323623,MATH 20C,B02,083763,Staff,28,0,30,2
1650692329655,MATH 20D,A01,083765,Staff,2,1,30,28
1650692329655,MATH 20D,A02,083766,Staff,6,0,30,24
1650692329655,MATH 20D,A03,083767,Staff,24,0,30,6
1650692335682,MATH 20E,A01,083771,Staff,3,0,30,27
1650692335682,MATH 20E,A02,083772,Staff,16,0,30,14
1650692335682,MATH 20E,B01,083773,Staff,0,0,30,30
1650692335682,MATH 20E,B02,083774,Staff,8,0,30,22
1650692341704,MATH 103A,A01,083777,Staff,0,15,30,30
1650692341704,MATH 103A,A02,083778,Staff,0,15,30,30
1650692341704,MATH 103A,B01,083779,Staff,0,15,30,30
1650692341704,MATH 103A,B02,083780,Staff,0,15,30,30
1650692347733,MATH 105,A01,085443,Staff,0,22,30,30
1650692353762,MATH 109,A01,083213,Anzaldo; Leesa B,0,7,30,30
1650692353762,MATH 109,A02,083214,Anzaldo; Leesa B,0,7,30,30
1650692353762,MATH 109,B01,083215,Anzaldo; Leesa B,0,8,30,30
1650692353762,MATH 109,B02,083216,Anzaldo; Leesa B,0,6,30,30
1650692359790,MATH 142A,A01,083219,Chow; Bennett,0,16,30,30
1650692359790,MATH 142A,A02,083220,Chow; Bennett,0,15,30,30
1650692359790,MATH 142A,B01,083221,Chow; Bennett,0,15,30,30
1650692359790,MATH 142A,B02,083222,Chow; Bennett,0,14,30,30
1650692365818,MATH 193A,A01,083224,Staff,0,5,30,30
1650692365818,MATH 193A,A02,083225,Staff,0,6,30,30
1650692365818,MATH 193A,A03,083781,Staff,0,6,30,30
1650692365818,MATH 193A,A04,083782,Staff,0,7,30,30
1650692371843,MATH 197,001,091859,McAuley; Julian John,9998,0,9999,1
1650692377904,COGS 9,A01,083615,Staff,1,15,60,59
1650692383943,COGS 11,A01,083617,Boyle; Mary E. T.,16,0,40,24
1650692389977,COGS 13,A01,083071,Staff,0,38,40,40
1650692396000,COGS 14A,A01,092681,Staff,0,35,100,100
1650692402030,COGS 14B,A01,083073,Cheng; Tzu-Han,1,13,50,49
1650692408055,COGS 17,A01,092677,Staff,13,0,75,62
1650692414078,COGS 100,A01,083619,Staff,0,29,60,60
1650692420105,COGS 101A,A01,083621,Davis; Joshua Daniel,0,27,60,60
1650692426130,COGS 101B,A01,091572,Staff,0,4,60,60
1650692432154,COGS 101C,A01,083625,Delgado; Tania,14,0,30,16
1650692438178,COGS 107A,A01,083627,Boyle; Mary E. T.,0,16,60,60
1650692444200,COGS 118A,A01,083075,Staff,0,7,60,60
1650692450224,CSE 3,A50,083646,Miranda; Gregory Joseph,18,0,38,20
1650692450224,CSE 3,A51,083647,Miranda; Gregory Joseph,36,0,37,1
1650692456248,CSE 8A,A50,083650,Miranda; Gregory Joseph,0,31,40,40
1650692462273,CSE 11,A01,083080,Cao; Yingjun,0,96,40,40
1650692468297,CSE 12,A01,083652,Staff,0,21,100,100
1650692474320,CSE 15L,A01,083654,Staff,0,3,50,50
1650692474320,CSE 15L,A02,083655,Staff,0,2,50,50
1650692480343,CSE 20,A01,083657,Staff,49,0,80,31
1650692486457,CSE 30,A01,083084,Eldon; John,0,78,40,40
1650692492480,CSE 100,A01,083659,Cao; Yingjun,0,70,50,50
1650692498501,CSE 134B,A01,083661,Powell; Thomas Allan,0,38,65,65
1650692504528,CSE 140,A01,083663,Staff,0,10,75,75
1650692510551,CSE 140L,A01,083088,Eldon; John,0,18,75,75
1650692516574,CSE 175,A01,083665,Kumar; Rakesh,7,0,25,18
1650692522597,CSE 190,A00,092507,Dubnov; Shlomo,10,0,20,10
1650692528624,ECE 45,A01,083139,Staff,0,2,60,60
1650692534654,ECE 65,A50,083695,Staff,0,5,30,30
1650692540682,ECE 109,A01,091882,Touri; Behrouz,33,0,70,37
1650692546705,ECE 180,A00,083140,Abi Samra; Nicholas Camill,20,0,30,10
1650692546705,ECE 180,B00,083141,Abi Samra; Nicholas Camill,0,0,30,30
1650692552729,MATH 10A,A01,083735,Patchell; Gregory David,2,0,30,28
1650692552729,MATH 10A,A02,083736,Patchell; Gregory David,27,0,30,3
1650692552729,MATH 10A,A03,083737,Patchell; Gregory David,24,0,30,6
1650692558753,MATH 10B,A01,083207,Staff,0,9,30,30
1650692558753,MATH 10B,A02,083208,Staff,1,7,30,29
1650692558753,MATH 10B,B01,083739,Staff,11,0,30,19
1650692558753,MATH 10B,B02,083740,Staff,28,0,30,2
1650692564777,MATH 18,A01,083743,Staff,0,0,30,30
1650692564777,MATH 18,A02,083744,Staff,23,0,30,7
1650692564777,MATH 18,A03,083745,Staff,21,0,30,9
1650692564777,MATH 18,A04,083746,Staff,26,0,30,4
1650692564777,MATH 18,B01,083748,Staff,0,15,30,30
1650692564777,MATH 18,B02,083749,Staff,0,12,30,30
1650692564777,MATH 18,B03,083750,Staff,0,12,30,30
1650692564777,MATH 18,B04,083751,Staff,0,12,30,30
1650692570801,MATH 20A,A01,083754,Staff,19,0,40,21
1650692576839,MATH 20B,A01,083756,Staff,0,11,30,30
1650692576839,MATH 20B,A02,083757,Staff,0,12,30,30
1650692582868,MATH 20C,A01,083760,Staff,0,16,30,30
1650692582868,MATH 20C,A02,083761,Staff,0,15,30,30
1650692582868,MATH 20C,B01,083762,Staff,9,0,30,21
1650692582868,MATH 20C,B02,083763,Staff,28,0,30,2
1650692588895,MATH 20D,A01,083765,Staff,2,1,30,28
1650692588895,MATH 20D,A02,083766,Staff,6,0,30,24
1650692588895,MATH 20D,A03,083767,Staff,24,0,30,6
1650692594924,MATH 20E,A01,083771,Staff,3,0,30,27
1650692594924,MATH 20E,A02,083772,Staff,16,0,30,14
1650692594924,MATH 20E,B01,083773,Staff,0,0,30,30
1650692594924,MATH 20E,B02,083774,Staff,8,0,30,22
1650692600951,MATH 103A,A01,083777,Staff,0,15,30,30
1650692600951,MATH 103A,A02,083778,Staff,0,15,30,30
1650692600951,MATH 103A,B01,083779,Staff,0,15,30,30
1650692600951,MATH 103A,B02,083780,Staff,0,15,30,30
1650692606977,MATH 105,A01,085443,Staff,0,22,30,30
1650692613005,MATH 109,A01,083213,Anzaldo; Leesa B,0,7,30,30
1650692613005,MATH 109,A02,083214,Anzaldo; Leesa B,0,7,30,30
1650692613005,MATH 109,B01,083215,Anzaldo; Leesa B,0,8,30,30
1650692613005,MATH 109,B02,083216,Anzaldo; Leesa B,0,6,30,30
1650692619033,MATH 142A,A01,083219,Chow; Bennett,0,16,30,30
1650692619033,MATH 142A,A02,083220,Chow; Bennett,0,15,30,30
1650692619033,MATH 142A,B01,083221,Chow; Bennett,0,15,30,30
1650692619033,MATH 142A,B02,083222,Chow; Bennett,0,14,30,30
1650692625061,MATH 193A,A01,083224,Staff,0,5,30,30
1650692625061,MATH 193A,A02,083225,Staff,0,6,30,30
1650692625061,MATH 193A,A03,083781,Staff,0,6,30,30
1650692625061,MATH 193A,A04,083782,Staff,0,7,30,30
1650692631085,MATH 197,001,091859,McAuley; Julian John,9998,0,9999,1
1650692637139,COGS 9,A01,083615,Staff,1,15,60,59
1650692643162,COGS 11,A01,083617,Boyle; Mary E. T.,16,0,40,24
1650692649186,COGS 13,A01,083071,Staff,0,38,40,40
1650692655210,COGS 14A,A01,092681,Staff,0,35,100,100
1650692661234,COGS 14B,A01,083073,Cheng; Tzu-Han,1,13,50,49
1650692667259,COGS 17,A01,092677,Staff,13,0,75,62
1650692673283,COGS 100,A01,083619,Staff,0,29,60,60
1650692679305,COGS 101A,A01,083621,Davis; Joshua Daniel,0,27,60,60
1650692685327,COGS 101B,A01,091572,Staff,0,4,60,60
1650692691355,COGS 101C,A01,083625,Delgado; Tania,14,0,30,16
1650692697377,COGS 107A,A01,083627,Boyle; Mary E. T.,0,16,60,60
1650692703404,COGS 118A,A01,083075,Staff,0,7,60,60
1650692709431,CSE 3,A50,083646,Miranda; Gregory Joseph,18,0,38,20
1650692709431,CSE 3,A51,083647,Miranda; Gregory Joseph,36,0,37,1
1650692715463,CSE 8A,A50,083650,Miranda; Gregory Joseph,0,31,40,40
1650692721489,CSE 11,A01,083080,Cao; Yingjun,0,96,40,40
1650692727512,CSE 12,A01,083652,Staff,0,21,100,100
1650692733546,CSE 15L,A01,083654,Staff,0,3,50,50
1650692733546,CSE 15L,A02,083655,Staff,0,2,50,50
1650692739572,CSE 20,A01,083657,Staff,49,0,80,31
1650692745594,CSE 30,A01,083084,Eldon; John,0,78,40,40
1650692751618,CSE 100,A01,083659,Cao; Yingjun,0,70,50,50
1650692757640,CSE 134B,A01,083661,Powell; Thomas Allan,0,38,65,65
1650692763662,CSE 140,A01,083663,Staff,0,10,75,75
1650692769685,CSE 140L,A01,083088,Eldon; John,0,18,75,75
1650692775711,CSE 175,A01,083665,Kumar; Rakesh,7,0,25,18
1650692781735,CSE 190,A00,092507,Dubnov; Shlomo,10,0,20,10
1650692787759,ECE 45,A01,083139,Staff,0,2,60,60
1650692793784,ECE 65,A50,083695,Staff,0,5,30,30
1650692799806,ECE 109,A01,091882,Touri; Behrouz,33,0,70,37
1650692805838,ECE 180,A00,083140,Abi Samra; Nicholas Camill,20,0,30,10
1650692805838,ECE 180,B00,083141,Abi Samra; Nicholas Camill,0,0,30,30
1650692811862,MATH 10A,A01,083735,Patchell; Gregory David,2,0,30,28
1650692811862,MATH 10A,A02,083736,Patchell; Gregory David,27,0,30,3
1650692811862,MATH 10A,A03,083737,Patchell; Gregory David,24,0,30,6
1650692817890,MATH 10B,A01,083207,Staff,0,9,30,30
1650692817890,MATH 10B,A02,083208,Staff,1,7,30,29
1650692817890,MATH 10B,B01,083739,Staff,11,0,30,19
1650692817890,MATH 10B,B02,083740,Staff,28,0,30,2
1650692823918,MATH 18,A01,083743,Staff,0,0,30,30
1650692823918,MATH 18,A02,083744,Staff,23,0,30,7
1650692823918,MATH 18,A03,083745,Staff,21,0,30,9
1650692823918,MATH 18,A04,083746,Staff,26,0,30,4
1650692823918,MATH 18,B01,083748,Staff,0,15,30,30
1650692823918,MATH 18,B02,083749,Staff,0,12,30,30
1650692823918,MATH 18,B03,083750,Staff,0,12,30,30
1650692823918,MATH 18,B04,083751,Staff,0,12,30,30
1650692829942,MATH 20A,A01,083754,Staff,19,0,40,21
1650692835964,MATH 20B,A01,083756,Staff,0,11,30,30
1650692835964,MATH 20B,A02,083757,Staff,0,12,30,30
1650692841988,MATH 20C,A01,083760,Staff,0,16,30,30
1650692841988,MATH 20C,A02,083761,Staff,0,15,30,30
1650692841988,MATH 20C,B01,083762,Staff,9,0,30,21
1650692841988,MATH 20C,B02,083763,Staff,28,0,30,2
1650692848012,MATH 20D,A01,083765,Staff,2,1,30,28
1650692848012,MATH 20D,A02,083766,Staff,6,0,30,24
1650692848012,MATH 20D,A03,083767,Staff,24,0,30,6
1650692854037,MATH 20E,A01,083771,Staff,3,0,30,27
1650692854037,MATH 20E,A02,083772,Staff,16,0,30,14
1650692854037,MATH 20E,B01,083773,Staff,0,0,30,30
1650692854037,MATH 20E,B02,083774,Staff,8,0,30,22
1650692860067,MATH 103A,A01,083777,Staff,0,15,30,30
1650692860067,MATH 103A,A02,083778,Staff,0,15,30,30
1650692860067,MATH 103A,B01,083779,Staff,0,15,30,30
1650692860067,MATH 103A,B02,083780,Staff,0,15,30,30
1650692866093,MATH 105,A01,085443,Staff,0,22,30,30
1650692872117,MATH 109,A01,083213,Anzaldo; Leesa B,0,7,30,30
1650692872117,MATH 109,A02,083214,Anzaldo; Leesa B,0,7,30,30
1650692872117,MATH 109,B01,083215,Anzaldo; Leesa B,0,8,30,30
1650692872117,MATH 109,B02,083216,Anzaldo; Leesa B,0,6,30,30
1650692878140,MATH 142A,A01,083219,Chow; Bennett,0,16,30,30
1650692878140,MATH 142A,A02,083220,Chow; Bennett,0,15,30,30
1650692878140,MATH 142A,B01,083221,Chow; Bennett,0,15,30,30
1650692878140,MATH 142A,B02,083222,Chow; Bennett,0,14,30,30
1650692884165,MATH 193A,A01,083224,Staff,0,5,30,30
1650692884165,MATH 193A,A02,083225,Staff,0,6,30,30
1650692884165,MATH 193A,A03,083781,Staff,0,6,30,30
1650692884165,MATH 193A,A04,083782,Staff,0,7,30,30
1650692890188,MATH 197,001,091859,McAuley; Julian John,9998,0,9999,1
1650692896243,COGS 9,A01,083615,Staff,1,15,60,59
1650692902268,COGS 11,A01,083617,Boyle; Mary E. T.,16,0,40,24
1650692908290,COGS 13,A01,083071,Staff,0,38,40,40
1650692914315,COGS 14A,A01,092681,Staff,0,35,100,100
1650692920340,COGS 14B,A01,083073,Cheng; Tzu-Han,1,13,50,49
1650692926363,COGS 17,A01,092677,Staff,13,0,75,62
1650692932404,COGS 100,A01,083619,Staff,0,29,60,60
1650692938430,COGS 101A,A01,083621,Davis; Joshua Daniel,0,27,60,60
1650692944454,COGS 101B,A01,091572,Staff,0,4,60,60
1650692950476,COGS 101C,A01,083625,Delgado; Tania,14,0,30,16
1650692956511,COGS 107A,A01,083627,Boyle; Mary E. T.,0,16,60,60
1650692962536,COGS 118A,A01,083075,Staff,0,7,60,60
1650692968565,CSE 3,A50,083646,Miranda; Gregory Joseph,18,0,38,20
1650692968565,CSE 3,A51,083647,Miranda; Gregory Joseph,36,0,37,1
1650692974594,CSE 8A,A50,083650,Miranda; Gregory Joseph,0,31,40,40
1650692980616,CSE 11,A01,083080,Cao; Yingjun,0,96,40,40
1650692986640,CSE 12,A01,083652,Staff,0,21,100,100
1650692992663,CSE 15L,A01,083654,Staff,0,3,50,50
1650692992663,CSE 15L,A02,083655,Staff,0,2,50,50
1650692998685,CSE 20,A01,083657,Staff,49,0,80,31
1650693004710,CSE 30,A01,083084,Eldon; John,0,78,40,40
1650693010734,CSE 100,A01,083659,Cao; Yingjun,0,70,50,50
1650693016760,CSE 134B,A01,083661,Powell; Thomas Allan,0,38,65,65
1650693022786,CSE 140,A01,083663,Staff,0,10,75,75
1650693028810,CSE 140L,A01,083088,Eldon; John,0,18,75,75
1650693034837,CSE 175,A01,083665,Kumar; Rakesh,7,0,25,18
1650693040865,CSE 190,A00,092507,Dubnov; Shlomo,10,0,20,10
1650693046888,ECE 45,A01,083139,Staff,0,2,60,60
1650693052924,ECE 65,A50,083695,Staff,0,5,30,30
1650693058948,ECE 109,A01,091882,Touri; Behrouz,33,0,70,37
1650693064972,ECE 180,A00,083140,Abi Samra; Nicholas Camill,20,0,30,10
1650693064972,ECE 180,B00,083141,Abi Samra; Nicholas Camill,0,0,30,30
1650693070996,MATH 10A,A01,083735,Patchell; Gregory David,2,0,30,28
1650693070996,MATH 10A,A02,083736,Patchell; Gregory David,27,0,30,3
1650693070996,MATH 10A,A03,083737,Patchell; Gregory David,24,0,30,6
1650693077021,MATH 10B,A01,083207,Staff,0,9,30,30
1650693077021,MATH 10B,A02,083208,Staff,1,7,30,29
1650693077021,MATH 10B,B01,083739,Staff,11,0,30,19
1650693077021,MATH 10B,B02,083740,Staff,28,0,30,2
1650693083145,MATH 18,A01,083743,Staff,0,0,30,30
1650693083145,MATH 18,A02,083744,Staff,23,0,30,7
1650693083145,MATH 18,A03,083745,Staff,21,0,30,9
1650693083145,MATH 18,A04,083746,Staff,26,0,30,4
1650693083145,MATH 18,B01,083748,Staff,0,15,30,30
1650693083145,MATH 18,B02,083749,Staff,0,12,30,30
1650693083145,MATH 18,B03,083750,Staff,0,12,30,30
1650693083145,MATH 18,B04,083751,Staff,0,12,30,30
1650693089168,MATH 20A,A01,083754,Staff,19,0,40,21
1650693095192,MATH 20B,A01,083756,Staff,0,11,30,30
1650693095192,MATH 20B,A02,083757,Staff,0,12,30,30
1650693101220,MATH 20C,A01,083760,Staff,0,16,30,30
1650693101220,MATH 20C,A02,083761,Staff,0,15,30,30
1650693101220,MATH 20C,B01,083762,Staff,9,0,30,21
1650693101220,MATH 20C,B02,083763,Staff,28,0,30,2
1650693107245,MATH 20D,A01,083765,Staff,2,1,30,28
1650693107245,MATH 20D,A02,083766,Staff,6,0,30,24
1650693107245,MATH 20D,A03,083767,Staff,24,0,30,6
1650693113268,MATH 20E,A01,083771,Staff,3,0,30,27
1650693113268,MATH 20E,A02,083772,Staff,16,0,30,14
1650693113268,MATH 20E,B01,083773,Staff,0,0,30,30
1650693113268,MATH 20E,B02,083774,Staff,8,0,30,22
1650693119292,MATH 103A,A01,083777,Staff,0,15,30,30
1650693119292,MATH 103A,A02,083778,Staff,0,15,30,30
1650693119292,MATH 103A,B01,083779,Staff,0,15,30,30
1650693119292,MATH 103A,B02,083780,Staff,0,15,30,30
1650693125326,MATH 105,A01,085443,Staff,0,22,30,30
1650693131349,MATH 109,A01,083213,Anzaldo; Leesa B,0,7,30,30
1650693131349,MATH 109,A02,083214,Anzaldo; Leesa B,0,7,30,30
1650693131349,MATH 109,B01,083215,Anzaldo; Leesa B,0,8,30,30
1650693131349,MATH 109,B02,083216,Anzaldo; Leesa B,0,6,30,30
1650693137373,MATH 142A,A01,083219,Chow; Bennett,0,16,30,30
1650693137373,MATH 142A,A02,083220,Chow; Bennett,0,15,30,30
1650693137373,MATH 142A,B01,083221,Chow; Bennett,0,15,30,30
1650693137373,MATH 142A,B02,083222,Chow; Bennett,0,14,30,30
1650693143398,MATH 193A,A01,083224,Staff,0,5,30,30
1650693143398,MATH 193A,A02,083225,Staff,0,6,30,30
1650693143398,MATH 193A,A03,083781,Staff,0,6,30,30
1650693143398,MATH 193A,A04,083782,Staff,0,7,30,30
1650693149424,MATH 197,001,091859,McAuley; Julian John,9998,0,9999,1
1650693155481,COGS 9,A01,083615,Staff,1,15,60,59
1650693161508,COGS 11,A01,083617,Boyle; Mary E. T.,16,0,40,24
1650693167531,COGS 13,A01,083071,Staff,0,38,40,40
1650693173555,COGS 14A,A01,092681,Staff,0,35,100,100
1650693179582,COGS 14B,A01,083073,Cheng; Tzu-Han,1,13,50,49
1650693185609,COGS 17,A01,092677,Staff,13,0,75,62
1650693191637,COGS 100,A01,083619,Staff,0,29,60,60
1650693197665,COGS 101A,A01,083621,Davis; Joshua Daniel,0,27,60,60
1650693203698,COGS 101B,A01,091572,Staff,0,4,60,60
1650693209721,COGS 101C,A01,083625,Delgado; Tania,14,0,30,16
1650693215745,COGS 107A,A01,083627,Boyle; Mary E. T.,0,16,60,60
1650693221776,COGS 118A,A01,083075,Staff,0,7,60,60
1650693227800,CSE 3,A50,083646,Miranda; Gregory Joseph,18,0,38,20
1650693227800,CSE 3,A51,083647,Miranda; Gregory Joseph,36,0,37,1
1650693233823,CSE 8A,A50,083650,Miranda; Gregory Joseph,0,31,40,40
1650693239849,CSE 11,A01,083080,Cao; Yingjun,0,96,40,40
1650693245877,CSE 12,A01,083652,Staff,0,21,100,100
1650693251904,CSE 15L,A01,083654,Staff,0,3,50,50
1650693251904,CSE 15L,A02,083655,Staff,0,2,50,50
1650693257926,CSE 20,A01,083657,Staff,49,0,80,31
1650693263959,CSE 30,A01,083084,Eldon; John,0,78,40,40
1650693269986,CSE 100,A01,083659,Cao; Yingjun,0,70,50,50
1650693276009,CSE 134B,A01,083661,Powell; Thomas Allan,0,38,65,65
1650693282032,CSE 140,A01,083663,Staff,0,10,75,75
1650693288056,CSE 140L,A01,083088,Eldon; John,0,18,75,75
1650693294079,CSE 175,A01,083665,Kumar; Rakesh,7,0,25,18
1650693300101,CSE 190,A00,092507,Dubnov; Shlomo,10,0,20,10
1650693306126,ECE 45,A01,083139,Staff,0,2,60,60
1650693312150,ECE 65,A50,083695,Staff,0,5,30,30
1650693318174,ECE 109,A01,091882,Touri; Behrouz,33,0,70,37
1650693324200,ECE 180,A00,083140,Abi Samra; Nicholas Camill,20,0,30,10
1650693324200,ECE 180,B00,083141,Abi Samra; Nicholas Camill,0,0,30,30
1650693330224,MATH 10A,A01,083735,Patchell; Gregory David,2,0,30,28
1650693330224,MATH 10A,A02,083736,Patchell; Gregory David,27,0,30,3
1650693330224,MATH 10A,A03,083737,Patchell; Gregory David,24,0,30,6
1650693336248,MATH 10B,A01,083207,Staff,0,9,30,30
1650693336248,MATH 10B,A02,083208,Staff,1,7,30,29
1650693336248,MATH 10B,B01,083739,Staff,11,0,30,19
1650693336248,MATH 10B,B02,083740,Staff,28,0,30,2
1650693342272,MATH 18,A01,083743,Staff,0,0,30,30
1650693342272,MATH 18,A02,083744,Staff,23,0,30,7
1650693342272,MATH 18,A03,083745,Staff,21,0,30,9
1650693342272,MATH 18,A04,083746,Staff,26,0,30,4
1650693342272,MATH 18,B01,083748,Staff,0,15,30,30
1650693342272,MATH 18,B02,083749,Staff,0,12,30,30
1650693342272,MATH 18,B03,083750,Staff,0,12,30,30
1650693342272,MATH 18,B04,083751,Staff,0,12,30,30
1650693348296,MATH 20A,A01,083754,Staff,19,0,40,21
1650693354334,MATH 20B,A01,083756,Staff,0,11,30,30
1650693354334,MATH 20B,A02,083757,Staff,0,12,30,30
1650693360359,MATH 20C,A01,083760,Staff,0,16,30,30
1650693360359,MATH 20C,A02,083761,Staff,0,15,30,30
1650693360359,MATH 20C,B01,083762,Staff,9,0,30,21
1650693360359,MATH 20C,B02,083763,Staff,28,0,30,2
1650693366383,MATH 20D,A01,083765,Staff,2,1,30,28
1650693366383,MATH 20D,A02,083766,Staff,6,0,30,24
1650693366383,MATH 20D,A03,083767,Staff,24,0,30,6
1650693372411,MATH 20E,A01,083771,Staff,3,0,30,27
1650693372411,MATH 20E,A02,083772,Staff,16,0,30,14
1650693372411,MATH 20E,B01,083773,Staff,0,0,30,30
1650693372411,MATH 20E,B02,083774,Staff,8,0,30,22
1650693378437,MATH 103A,A01,083777,Staff,0,15,30,30
1650693378437,MATH 103A,A02,083778,Staff,0,15,30,30
1650693378437,MATH 103A,B01,083779,Staff,0,15,30,30
1650693378437,MATH 103A,B02,083780,Staff,0,15,30,30
1650693384461,MATH 105,A01,085443,Staff,0,22,30,30
1650693390484,MATH 109,A01,083213,Anzaldo; Leesa B,0,7,30,30
1650693390484,MATH 109,A02,083214,Anzaldo; Leesa B,0,7,30,30
1650693390484,MATH 109,B01,083215,Anzaldo; Leesa B,0,8,30,30
1650693390484,MATH 109,B02,083216,Anzaldo; Leesa B,0,6,30,30
1650693396513,MATH 142A,A01,083219,Chow; Bennett,0,16,30,30
1650693396513,MATH 142A,A02,083220,Chow; Bennett,0,15,30,30
1650693396513,MATH 142A,B01,083221,Chow; Bennett,0,15,30,30
1650693396513,MATH 142A,B02,083222,Chow; Bennett,0,14,30,30
1650693402536,MATH 193A,A01,083224,Staff,0,5,30,30
1650693402536,MATH 193A,A02,083225,Staff,0,6,30,30
1650693402536,MATH 193A,A03,083781,Staff,0,6,30,30
1650693402536,MATH 193A,A04,083782,Staff,0,7,30,30
1650693408560,MATH 197,001,091859,McAuley; Julian John,9998,0,9999,1
1650693414617,COGS 9,A01,083615,Staff,1,15,60,59
1650693420641,COGS 11,A01,083617,Boyle; Mary E. T.,16,0,40,24
1650693426664,COGS 13,A01,083071,Staff,0,38,40,40
1650693432690,COGS 14A,A01,092681,Staff,0,35,100,100
1650693438722,COGS 14B,A01,083073,Cheng; Tzu-Han,1,13,50,49
1650693444746,COGS 17,A01,092677,Staff,13,0,75,62
1650693450769,COGS 100,A01,083619,Staff,0,28,60,60
1650693456792,COGS 101A,A01,083621,Davis; Joshua Daniel,0,27,60,60
1650693462817,COGS 101B,A01,091572,Staff,0,4,60,60
1650693468853,COGS 101C,A01,083625,Delgado; Tania,14,0,30,16
1650693474879,COGS 107A,A01,083627,Boyle; Mary E. T.,0,16,60,60
1650693480911,COGS 118A,A01,083075,Staff,0,7,60,60
1650693486935,CSE 3,A50,083646,Miranda; Gregory Joseph,18,0,38,20
1650693486935,CSE 3,A51,083647,Miranda; Gregory Joseph,36,0,37,1
1650693492959,CSE 8A,A50,083650,Miranda; Gregory Joseph,0,31,40,40
1650693498983,CSE 11,A01,083080,Cao; Yingjun,0,96,40,40
1650693505022,CSE 12,A01,083652,Staff,0,21,100,100
1650693511044,CSE 15L,A01,083654,Staff,0,3,50,50
1650693511044,CSE 15L,A02,083655,Staff,0,2,50,50
1650693517067,CSE 20,A01,083657,Staff,49,0,80,31
1650693523090,CSE 30,A01,083084,Eldon; John,0,78,40,40
1650693529114,CSE 100,A01,083659,Cao; Yingjun,0,70,50,50
1650693535138,CSE 134B,A01,083661,Powell; Thomas Allan,0,38,65,65
1650693541163,CSE 140,A01,083663,Staff,0,10,75,75
1650693547185,CSE 140L,A01,083088,Eldon; John,0,18,75,75
1650693553209,CSE 175,A01,083665,Kumar; Rakesh,7,0,25,18
1650693559232,CSE 190,A00,092507,Dubnov; Shlomo,10,0,20,10
1650693565259,ECE 45,A01,083139,Staff,0,2,60,60
1650693571283,ECE 65,A50,083695,Staff,0,5,30,30
1650693577308,ECE 109,A01,091882,Touri; Behrouz,33,0,70,37
1650693583331,ECE 180,A00,083140,Abi Samra; Nicholas Camill,20,0,30,10
1650693583331,ECE 180,B00,083141,Abi Samra; Nicholas Camill,0,0,30,30
1650693589355,MATH 10A,A01,083735,Patchell; Gregory David,2,0,30,28
1650693589355,MATH 10A,A02,083736,Patchell; Gregory David,27,0,30,3
1650693589355,MATH 10A,A03,083737,Patchell; Gregory David,24,0,30,6
1650693595382,MATH 10B,A01,083207,Staff,0,9,30,30
1650693595382,MATH 10B,A02,083208,Staff,1,7,30,29
1650693595382,MATH 10B,B01,083739,Staff,11,0,30,19
1650693595382,MATH 10B,B02,083740,Staff,28,0,30,2
1650693601408,MATH 18,A01,083743,Staff,0,0,30,30
1650693601408,MATH 18,A02,083744,Staff,23,0,30,7
1650693601408,MATH 18,A03,083745,Staff,21,0,30,9
1650693601408,MATH 18,A04,083746,Staff,26,0,30,4
1650693601408,MATH 18,B01,083748,Staff,0,15,30,30
1650693601408,MATH 18,B02,083749,Staff,0,12,30,30
1650693601408,MATH 18,B03,083750,Staff,0,12,30,30
1650693601408,MATH 18,B04,083751,Staff,0,12,30,30
1650693607431,MATH 20A,A01,083754,Staff,19,0,40,21
1650693613454,MATH 20B,A01,083756,Staff,0,11,30,30
1650693613454,MATH 20B,A02,083757,Staff,0,12,30,30
1650693619482,MATH 20C,A01,083760,Staff,0,16,30,30
1650693619482,MATH 20C,A02,083761,Staff,0,15,30,30
1650693619482,MATH 20C,B01,083762,Staff,9,0,30,21
1650693619482,MATH 20C,B02,083763,Staff,28,0,30,2
1650693625512,MATH 20D,A01,083765,Staff,2,1,30,28
1650693625512,MATH 20D,A02,083766,Staff,6,0,30,24
1650693625512,MATH 20D,A03,083767,Staff,24,0,30,6
1650693631555,MATH 20E,A01,083771,Staff,3,0,30,27
1650693631555,MATH 20E,A02,083772,Staff,16,0,30,14
1650693631555,MATH 20E,B01,083773,Staff,0,0,30,30
1650693631555,MATH 20E,B02,083774,Staff,8,0,30,22
1650693637587,MATH 103A,A01,083777,Staff,0,15,30,30
1650693637587,MATH 103A,A02,083778,Staff,0,15,30,30
1650693637587,MATH 103A,B01,083779,Staff,0,15,30,30
1650693637587,MATH 103A,B02,083780,Staff,0,15,30,30
1650693643611,MATH 105,A01,085443,Staff,0,22,30,30
1650693649640,MATH 109,A01,083213,Anzaldo; Leesa B,0,7,30,30
1650693649640,MATH 109,A02,083214,Anzaldo; Leesa B,0,7,30,30
1650693649640,MATH 109,B01,083215,Anzaldo; Leesa B,0,8,30,30
1650693649640,MATH 109,B02,083216,Anzaldo; Leesa B,0,6,30,30
1650693655665,MATH 142A,A01,083219,Chow; Bennett,0,16,30,30
1650693655665,MATH 142A,A02,083220,Chow; Bennett,0,15,30,30
1650693655665,MATH 142A,B01,083221,Chow; Bennett,0,15,30,30
1650693655665,MATH 142A,B02,083222,Chow; Bennett,0,14,30,30
1650693661692,MATH 193A,A01,083224,Staff,0,5,30,30
1650693661692,MATH 193A,A02,083225,Staff,0,6,30,30
1650693661692,MATH 193A,A03,083781,Staff,0,6,30,30
1650693661692,MATH 193A,A04,083782,Staff,0,7,30,30
1650693667717,MATH 197,001,091859,McAuley; Julian John,9998,0,9999,1
1650693673863,COGS 9,A01,083615,Staff,1,15,60,59
1650693679888,COGS 11,A01,083617,Boyle; Mary E. T.,16,0,40,24
1650693685912,COGS 13,A01,083071,Staff,0,38,40,40
1650693692073,COGS 14A,A01,092681,Staff,0,35,100,100
1650693698097,COGS 14B,A01,083073,Cheng; Tzu-Han,1,13,50,49
1650693704119,COGS 17,A01,092677,Staff,13,0,75,62
1650693710145,COGS 100,A01,083619,Staff,0,28,60,60
1650693716171,COGS 101A,A01,083621,Davis; Joshua Daniel,0,27,60,60
1650693722196,COGS 101B,A01,091572,Staff,0,4,60,60
1650693728219,COGS 101C,A01,083625,Delgado; Tania,14,0,30,16
1650693734243,COGS 107A,A01,083627,Boyle; Mary E. T.,0,16,60,60
1650693740265,COGS 118A,A01,083075,Staff,0,7,60,60
1650693746289,CSE 3,A50,083646,Miranda; Gregory Joseph,18,0,38,20
1650693746289,CSE 3,A51,083647,Miranda; Gregory Joseph,36,0,37,1
1650693752314,CSE 8A,A50,083650,Miranda; Gregory Joseph,0,31,40,40
1650693758337,CSE 11,A01,083080,Cao; Yingjun,0,96,40,40
1650693764367,CSE 12,A01,083652,Staff,0,21,100,100
1650693770395,CSE 15L,A01,083654,Staff,0,3,50,50
1650693770395,CSE 15L,A02,083655,Staff,0,2,50,50
1650693776420,CSE 20,A01,083657,Staff,49,0,80,31
1650693782447,CSE 30,A01,083084,Eldon; John,0,78,40,40
1650693788471,CSE 100,A01,083659,Cao; Yingjun,0,70,50,50
1650693794495,CSE 134B,A01,083661,Powell; Thomas Allan,0,38,65,65
1650693800518,CSE 140,A01,083663,Staff,0,10,75,75
1650693806541,CSE 140L,A01,083088,Eldon; John,0,18,75,75
1650693812565,CSE 175,A01,083665,Kumar; Rakesh,7,0,25,18
1650693818589,CSE 190,A00,092507,Dubnov; Shlomo,10,0,20,10
1650693824612,ECE 45,A01,083139,Staff,0,2,60,60
1650693830644,ECE 65,A50,083695,Staff,0,5,30,30
1650693836675,ECE 109,A01,091882,Touri; Behrouz,33,0,70,37
1650693842702,ECE 180,A00,083140,Abi Samra; Nicholas Camill,20,0,30,10
1650693842702,ECE 180,B00,083141,Abi Samra; Nicholas Camill,0,0,30,30
1650693848725,MATH 10A,A01,083735,Patchell; Gregory David,2,0,30,28
1650693848725,MATH 10A,A02,083736,Patchell; Gregory David,27,0,30,3
1650693848725,MATH 10A,A03,083737,Patchell; Gregory David,24,0,30,6
1650693854761,MATH 10B,A01,083207,Staff,0,9,30,30
1650693854761,MATH 10B,A02,083208,Staff,1,7,30,29
1650693854761,MATH 10B,B01,083739,Staff,11,0,30,19
1650693854761,MATH 10B,B02,083740,Staff,28,0,30,2
1650693860787,MATH 18,A01,083743,Staff,0,0,30,30
1650693860787,MATH 18,A02,083744,Staff,23,0,30,7
1650693860787,MATH 18,A03,083745,Staff,21,0,30,9
1650693860787,MATH 18,A04,083746,Staff,26,0,30,4
1650693860787,MATH 18,B01,083748,Staff,0,15,30,30
1650693860787,MATH 18,B02,083749,Staff,0,12,30,30
1650693860787,MATH 18,B03,083750,Staff,0,12,30,30
1650693860787,MATH 18,B04,083751,Staff,0,12,30,30
1650693866813,MATH 20A,A01,083754,Staff,19,0,40,21
1650693872847,MATH 20B,A01,083756,Staff,0,11,30,30
1650693872847,MATH 20B,A02,083757,Staff,0,12,30,30
1650693878871,MATH 20C,A01,083760,Staff,0,16,30,30
1650693878871,MATH 20C,A02,083761,Staff,0,15,30,30
1650693878871,MATH 20C,B01,083762,Staff,9,0,30,21
1650693878871,MATH 20C,B02,083763,Staff,28,0,30,2
1650693884893,MATH 20D,A01,083765,Staff,2,1,30,28
1650693884893,MATH 20D,A02,083766,Staff,6,0,30,24
1650693884893,MATH 20D,A03,083767,Staff,24,0,30,6
1650693890925,MATH 20E,A01,083771,Staff,3,0,30,27
1650693890925,MATH 20E,A02,083772,Staff,16,0,30,14
1650693890925,MATH 20E,B01,083773,Staff,0,0,30,30
1650693890925,MATH 20E,B02,083774,Staff,8,0,30,22
1650693896954,MATH 103A,A01,083777,Staff,0,15,30,30
1650693896954,MATH 103A,A02,083778,Staff,0,15,30,30
1650693896954,MATH 103A,B01,083779,Staff,0,15,30,30
1650693896954,MATH 103A,B02,083780,Staff,0,15,30,30
1650693902977,MATH 105,A01,085443,Staff,0,22,30,30
1650693909012,MATH 109,A01,083213,Anzaldo; Leesa B,0,7,30,30
1650693909012,MATH 109,A02,083214,Anzaldo; Leesa B,0,7,30,30
1650693909012,MATH 109,B01,083215,Anzaldo; Leesa B,0,8,30,30
1650693909012,MATH 109,B02,083216,Anzaldo; Leesa B,0,6,30,30
1650693915037,MATH 142A,A01,083219,Chow; Bennett,0,16,30,30
1650693915037,MATH 142A,A02,083220,Chow; Bennett,0,15,30,30
1650693915037,MATH 142A,B01,083221,Chow; Bennett,0,15,30,30
1650693915037,MATH 142A,B02,083222,Chow; Bennett,0,14,30,30
1650693921075,MATH 193A,A01,083224,Staff,0,5,30,30
1650693921075,MATH 193A,A02,083225,Staff,0,6,30,30
1650693921075,MATH 193A,A03,083781,Staff,0,6,30,30
1650693921075,MATH 193A,A04,083782,Staff,0,7,30,30
1650693927100,MATH 197,001,091859,McAuley; Julian John,9998,0,9999,1
1650693933152,COGS 9,A01,083615,Staff,1,15,60,59
1650693939176,COGS 11,A01,083617,Boyle; Mary E. T.,16,0,40,24
1650693945209,COGS 13,A01,083071,Staff,0,38,40,40
1650693951232,COGS 14A,A01,092681,Staff,0,35,100,100
1650693957259,COGS 14B,A01,083073,Cheng; Tzu-Han,1,13,50,49
1650693963283,COGS 17,A01,092677,Staff,13,0,75,62
1650693969309,COGS 100,A01,083619,Staff,0,28,60,60
1650693975336,COGS 101A,A01,083621,Davis; Joshua Daniel,0,27,60,60
1650693981358,COGS 101B,A01,091572,Staff,0,4,60,60
1650693987382,COGS 101C,A01,083625,Delgado; Tania,14,0,30,16
1650693993411,COGS 107A,A01,083627,Boyle; Mary E. T.,0,16,60,60
1650693999435,COGS 118A,A01,083075,Staff,0,7,60,60
1650694005459,CSE 3,A50,083646,Miranda; Gregory Joseph,18,0,38,20
1650694005459,CSE 3,A51,083647,Miranda; Gregory Joseph,36,0,37,1
1650694011484,CSE 8A,A50,083650,Miranda; Gregory Joseph,0,31,40,40
1650694017509,CSE 11,A01,083080,Cao; Yingjun,0,96,40,40
1650694023532,CSE 12,A01,083652,Staff,0,21,100,100
1650694029559,CSE 15L,A01,083654,Staff,0,3,50,50
1650694029559,CSE 15L,A02,083655,Staff,0,2,50,50
1650694035585,CSE 20,A01,083657,Staff,49,0,80,31
1650694041612,CSE 30,A01,083084,Eldon; John,0,78,40,40
1650694047638,CSE 100,A01,083659,Cao; Yingjun,0,70,50,50
1650694053663,CSE 134B,A01,083661,Powell; Thomas Allan,0,38,65,65
1650694059687,CSE 140,A01,083663,Staff,0,10,75,75
1650694065714,CSE 140L,A01,083088,Eldon; John,0,18,75,75
1650694071741,CSE 175,A01,083665,Kumar; Rakesh,7,0,25,18
1650694077766,CSE 190,A00,092507,Dubnov; Shlomo,10,0,20,10
1650694083794,ECE 45,A01,083139,Staff,0,2,60,60
1650694089818,ECE 65,A50,083695,Staff,0,5,30,30
1650694095842,ECE 109,A01,091882,Touri; Behrouz,33,0,70,37
1650694101866,ECE 180,A00,083140,Abi Samra; Nicholas Camill,20,0,30,10
1650694101866,ECE 180,B00,083141,Abi Samra; Nicholas Camill,0,0,30,30
1650694107894,MATH 10A,A01,083735,Patchell; Gregory David,2,0,30,28
1650694107894,MATH 10A,A02,083736,Patchell; Gregory David,27,0,30,3
1650694107894,MATH 10A,A03,083737,Patchell; Gregory David,24,0,30,6
1650694113917,MATH 10B,A01,083207,Staff,0,9,30,30
1650694113917,MATH 10B,A02,083208,Staff,1,7,30,29
1650694113917,MATH 10B,B01,083739,Staff,11,0,30,19
1650694113917,MATH 10B,B02,083740,Staff,28,0,30,2
1650694119948,MATH 18,A01,083743,Staff,0,0,30,30
1650694119948,MATH 18,A02,083744,Staff,23,0,30,7
1650694119948,MATH 18,A03,083745,Staff,21,0,30,9
1650694119948,MATH 18,A04,083746,Staff,26,0,30,4
1650694119948,MATH 18,B01,083748,Staff,0,15,30,30
1650694119948,MATH 18,B02,083749,Staff,0,12,30,30
1650694119948,MATH 18,B03,083750,Staff,0,12,30,30
1650694119948,MATH 18,B04,083751,Staff,0,12,30,30
1650694125975,MATH 20A,A01,083754,Staff,19,0,40,21
1650694132002,MATH 20B,A01,083756,Staff,0,11,30,30
1650694132002,MATH 20B,A02,083757,Staff,0,12,30,30
1650694138024,MATH 20C,A01,083760,Staff,0,16,30,30
1650694138024,MATH 20C,A02,083761,Staff,0,15,30,30
1650694138024,MATH 20C,B01,083762,Staff,9,0,30,21
1650694138024,MATH 20C,B02,083763,Staff,28,0,30,2
1650694144058,MATH 20D,A01,083765,Staff,2,1,30,28
1650694144058,MATH 20D,A02,083766,Staff,6,0,30,24
1650694144058,MATH 20D,A03,083767,Staff,24,0,30,6
1650694150106,MATH 20E,A01,083771,Staff,3,0,30,27
1650694150106,MATH 20E,A02,083772,Staff,16,0,30,14
1650694150106,MATH 20E,B01,083773,Staff,0,0,30,30
1650694150106,MATH 20E,B02,083774,Staff,8,0,30,22
1650694156137,MATH 103A,A01,083777,Staff,0,15,30,30
1650694156137,MATH 103A,A02,083778,Staff,0,15,30,30
1650694156137,MATH 103A,B01,083779,Staff,0,15,30,30
1650694156137,MATH 103A,B02,083780,Staff,0,15,30,30
1650694162161,MATH 105,A01,085443,Staff,0,22,30,30
1650694168188,MATH 109,A01,083213,Anzaldo; Leesa B,0,7,30,30
1650694168188,MATH 109,A02,083214,Anzaldo; Leesa B,0,7,30,30
1650694168188,MATH 109,B01,083215,Anzaldo; Leesa B,0,8,30,30
1650694168188,MATH 109,B02,083216,Anzaldo; Leesa B,0,6,30,30
1650694174213,MATH 142A,A01,083219,Chow; Bennett,0,16,30,30
1650694174213,MATH 142A,A02,083220,Chow; Bennett,0,15,30,30
1650694174213,MATH 142A,B01,083221,Chow; Bennett,0,15,30,30
1650694174213,MATH 142A,B02,083222,Chow; Bennett,0,14,30,30
1650694180244,MATH 193A,A01,083224,Staff,0,5,30,30
1650694180244,MATH 193A,A02,083225,Staff,0,6,30,30
1650694180244,MATH 193A,A03,083781,Staff,0,6,30,30
1650694180244,MATH 193A,A04,083782,Staff,0,7,30,30
1650694186271,MATH 197,001,091859,McAuley; Julian John,9998,0,9999,1
1650694192341,COGS 9,A01,083615,Staff,1,15,60,59
1650694198365,COGS 11,A01,083617,Boyle; Mary E. T.,16,0,40,24
1650694204393,COGS 13,A01,083071,Staff,0,38,40,40
1650694210417,COGS 14A,A01,092681,Staff,0,35,100,100
1650694216445,COGS 14B,A01,083073,Cheng; Tzu-Han,1,13,50,49
1650694222469,COGS 17,A01,092677,Staff,13,0,75,62
1650694228493,COGS 100,A01,083619,Staff,0,28,60,60
1650694234524,COGS 101A,A01,083621,Davis; Joshua Daniel,0,27,60,60
1650694240549,COGS 101B,A01,091572,Staff,0,4,60,60
1650694246576,COGS 101C,A01,083625,Delgado; Tania,14,0,30,16
1650694252608,COGS 107A,A01,083627,Boyle; Mary E. T.,0,16,60,60
1650694258635,COGS 118A,A01,083075,Staff,0,7,60,60
1650694264661,CSE 3,A50,083646,Miranda; Gregory Joseph,18,0,38,20
1650694264661,CSE 3,A51,083647,Miranda; Gregory Joseph,36,0,37,1
1650694270779,CSE 8A,A50,083650,Miranda; Gregory Joseph,0,31,40,40
1650694276807,CSE 11,A01,083080,Cao; Yingjun,0,96,40,40
1650694282831,CSE 12,A01,083652,Staff,0,21,100,100
1650694288853,CSE 15L,A01,083654,Staff,0,3,50,50
1650694288853,CSE 15L,A02,083655,Staff,0,2,50,50
1650694294892,CSE 20,A01,083657,Staff,49,0,80,31
1650694300917,CSE 30,A01,083084,Eldon; John,0,78,40,40
1650694306940,CSE 100,A01,083659,Cao; Yingjun,0,70,50,50
1650694312962,CSE 134B,A01,083661,Powell; Thomas Allan,0,38,65,65
1650694318985,CSE 140,A01,083663,Staff,0,10,75,75
1650694325013,CSE 140L,A01,083088,Eldon; John,0,18,75,75
1650694331037,CSE 175,A01,083665,Kumar; Rakesh,7,0,25,18
1650694337060,CSE 190,A00,092507,Dubnov; Shlomo,10,0,20,10
1650694343086,ECE 45,A01,083139,Staff,0,2,60,60
1650694349110,ECE 65,A50,083695,Staff,0,5,30,30
1650694355141,ECE 109,A01,091882,Touri; Behrouz,33,0,70,37
1650694361164,ECE 180,A00,083140,Abi Samra; Nicholas Camill,20,0,30,10
1650694361164,ECE 180,B00,083141,Abi Samra; Nicholas Camill,0,0,30,30
1650694367194,MATH 10A,A01,083735,Patchell; Gregory David,2,0,30,28
1650694367194,MATH 10A,A02,083736,Patchell; Gregory David,27,0,30,3
1650694367194,MATH 10A,A03,083737,Patchell; Gregory David,24,0,30,6
1650694373218,MATH 10B,A01,083207,Staff,0,9,30,30
1650694373218,MATH 10B,A02,083208,Staff,1,7,30,29
1650694373218,MATH 10B,B01,083739,Staff,11,0,30,19
1650694373218,MATH 10B,B02,083740,Staff,28,0,30,2
1650694379252,MATH 18,A01,083743,Staff,0,0,30,30
1650694379252,MATH 18,A02,083744,Staff,23,0,30,7
1650694379252,MATH 18,A03,083745,Staff,21,0,30,9
1650694379252,MATH 18,A04,083746,Staff,26,0,30,4
1650694379252,MATH 18,B01,083748,Staff,0,15,30,30
1650694379252,MATH 18,B02,083749,Staff,0,12,30,30
1650694379252,MATH 18,B03,083750,Staff,0,12,30,30
1650694379252,MATH 18,B04,083751,Staff,0,12,30,30
1650694385277,MATH 20A,A01,083754,Staff,19,0,40,21
1650694391301,MATH 20B,A01,083756,Staff,0,11,30,30
1650694391301,MATH 20B,A02,083757,Staff,0,12,30,30
1650694397326,MATH 20C,A01,083760,Staff,0,16,30,30
1650694397326,MATH 20C,A02,083761,Staff,0,15,30,30
1650694397326,MATH 20C,B01,083762,Staff,9,0,30,21
1650694397326,MATH 20C,B02,083763,Staff,28,0,30,2
1650694403348,MATH 20D,A01,083765,Staff,2,1,30,28
1650694403348,MATH 20D,A02,083766,Staff,6,0,30,24
1650694403348,MATH 20D,A03,083767,Staff,24,0,30,6
1650694409375,MATH 20E,A01,083771,Staff,3,0,30,27
1650694409375,MATH 20E,A02,083772,Staff,16,0,30,14
1650694409375,MATH 20E,B01,083773,Staff,0,0,30,30
1650694409375,MATH 20E,B02,083774,Staff,8,0,30,22
1650694415404,MATH 103A,A01,083777,Staff,0,15,30,30
1650694415404,MATH 103A,A02,083778,Staff,0,15,30,30
1650694415404,MATH 103A,B01,083779,Staff,0,15,30,30
1650694415404,MATH 103A,B02,083780,Staff,0,15,30,30
1650694421433,MATH 105,A01,085443,Staff,0,22,30,30
1650694427464,MATH 109,A01,083213,Anzaldo; Leesa B,0,7,30,30
1650694427464,MATH 109,A02,083214,Anzaldo; Leesa B,0,7,30,30
1650694427464,MATH 109,B01,083215,Anzaldo; Leesa B,0,8,30,30
1650694427464,MATH 109,B02,083216,Anzaldo; Leesa B,0,6,30,30
1650694433493,MATH 142A,A01,083219,Chow; Bennett,0,16,30,30
1650694433493,MATH 142A,A02,083220,Chow; Bennett,0,15,30,30
1650694433493,MATH 142A,B01,083221,Chow; Bennett,0,15,30,30
1650694433493,MATH 142A,B02,083222,Chow; Bennett,0,14,30,30
1650694439518,MATH 193A,A01,083224,Staff,0,5,30,30
1650694439518,MATH 193A,A02,083225,Staff,0,6,30,30
1650694439518,MATH 193A,A03,083781,Staff,0,6,30,30
1650694439518,MATH 193A,A04,083782,Staff,0,7,30,30
1650694445540,MATH 197,001,091859,McAuley; Julian John,9998,0,9999,1
1650694451596,COGS 9,A01,083615,Staff,1,15,60,59
1650694457623,COGS 11,A01,083617,Boyle; Mary E. T.,16,0,40,24
1650694463653,COGS 13,A01,083071,Staff,0,38,40,40
1650694469677,COGS 14A,A01,092681,Staff,0,35,100,100
1650694475700,COGS 14B,A01,083073,Cheng; Tzu-Han,1,13,50,49
1650694481727,COGS 17,A01,092677,Staff,13,0,75,62
1650694487750,COGS 100,A01,083619,Staff,0,28,60,60
1650694493775,COGS 101A,A01,083621,Davis; Joshua Daniel,0,27,60,60
1650694499800,COGS 101B,A01,091572,Staff,0,4,60,60
1650694505826,COGS 101C,A01,083625,Delgado; Tania,14,0,30,16
1650694511851,COGS 107A,A01,083627,Boyle; Mary E. T.,0,16,60,60
1650694517875,COGS 118A,A01,083075,Staff,0,7,60,60
1650694523898,CSE 3,A50,083646,Miranda; Gregory Joseph,18,0,38,20
1650694523898,CSE 3,A51,083647,Miranda; Gregory Joseph,36,0,37,1
1650694529926,CSE 8A,A50,083650,Miranda; Gregory Joseph,0,31,40,40
1650694535948,CSE 11,A01,083080,Cao; Yingjun,0,96,40,40
1650694541976,CSE 12,A01,083652,Staff,0,21,100,100
1650694548000,CSE 15L,A01,083654,Staff,0,3,50,50
1650694548000,CSE 15L,A02,083655,Staff,0,2,50,50
1650694554026,CSE 20,A01,083657,Staff,49,0,80,31
1650694560050,CSE 30,A01,083084,Eldon; John,0,78,40,40
1650694566074,CSE 100,A01,083659,Cao; Yingjun,0,70,50,50
1650694572096,CSE 134B,A01,083661,Powell; Thomas Allan,0,38,65,65
1650694578122,CSE 140,A01,083663,Staff,0,10,75,75
1650694584148,CSE 140L,A01,083088,Eldon; John,0,19,75,75
1650694590176,CSE 175,A01,083665,Kumar; Rakesh,7,0,25,18
1650694596203,CSE 190,A00,092507,Dubnov; Shlomo,10,0,20,10
1650694602228,ECE 45,A01,083139,Staff,0,2,60,60
1650694608251,ECE 65,A50,083695,Staff,0,5,30,30
1650694614281,ECE 109,A01,091882,Touri; Behrouz,33,0,70,37
1650694620310,ECE 180,A00,083140,Abi Samra; Nicholas Camill,20,0,30,10
1650694620310,ECE 180,B00,083141,Abi Samra; Nicholas Camill,0,0,30,30
1650694626331,MATH 10A,A01,083735,Patchell; Gregory David,2,0,30,28
1650694626331,MATH 10A,A02,083736,Patchell; Gregory David,27,0,30,3
1650694626331,MATH 10A,A03,083737,Patchell; Gregory David,24,0,30,6
1650694632356,MATH 10B,A01,083207,Staff,0,9,30,30
1650694632356,MATH 10B,A02,083208,Staff,1,7,30,29
1650694632356,MATH 10B,B01,083739,Staff,11,0,30,19
1650694632356,MATH 10B,B02,083740,Staff,28,0,30,2
1650694638383,MATH 18,A01,083743,Staff,0,0,30,30
1650694638383,MATH 18,A02,083744,Staff,23,0,30,7
1650694638383,MATH 18,A03,083745,Staff,21,0,30,9
1650694638383,MATH 18,A04,083746,Staff,26,0,30,4
1650694638383,MATH 18,B01,083748,Staff,0,15,30,30
1650694638383,MATH 18,B02,083749,Staff,0,12,30,30
1650694638383,MATH 18,B03,083750,Staff,0,12,30,30
1650694638383,MATH 18,B04,083751,Staff,0,12,30,30
1650694644408,MATH 20A,A01,083754,Staff,19,0,40,21
1650694650432,MATH 20B,A01,083756,Staff,0,11,30,30
1650694650432,MATH 20B,A02,083757,Staff,0,12,30,30
1650694656455,MATH 20C,A01,083760,Staff,0,16,30,30
1650694656455,MATH 20C,A02,083761,Staff,0,15,30,30
1650694656455,MATH 20C,B01,083762,Staff,9,0,30,21
1650694656455,MATH 20C,B02,083763,Staff,28,0,30,2
1650694662482,MATH 20D,A01,083765,Staff,2,1,30,28
1650694662482,MATH 20D,A02,083766,Staff,6,0,30,24
1650694662482,MATH 20D,A03,083767,Staff,24,0,30,6
1650694668506,MATH 20E,A01,083771,Staff,3,0,30,27
1650694668506,MATH 20E,A02,083772,Staff,16,0,30,14
1650694668506,MATH 20E,B01,083773,Staff,0,0,30,30
1650694668506,MATH 20E,B02,083774,Staff,8,0,30,22
1650694674530,MATH 103A,A01,083777,Staff,0,15,30,30
1650694674530,MATH 103A,A02,083778,Staff,0,15,30,30
1650694674530,MATH 103A,B01,083779,Staff,0,15,30,30
1650694674530,MATH 103A,B02,083780,Staff,0,15,30,30
1650694680552,MATH 105,A01,085443,Staff,0,22,30,30
1650694686594,MATH 109,A01,083213,Anzaldo; Leesa B,0,7,30,30
1650694686594,MATH 109,A02,083214,Anzaldo; Leesa B,0,7,30,30
1650694686594,MATH 109,B01,083215,Anzaldo; Leesa B,0,8,30,30
1650694686594,MATH 109,B02,083216,Anzaldo; Leesa B,0,6,30,30
1650694692619,MATH 142A,A01,083219,Chow; Bennett,0,16,30,30
1650694692619,MATH 142A,A02,083220,Chow; Bennett,0,15,30,30
1650694692619,MATH 142A,B01,083221,Chow; Bennett,0,15,30,30
1650694692619,MATH 142A,B02,083222,Chow; Bennett,0,14,30,30
1650694698643,MATH 193A,A01,083224,Staff,0,5,30,30
1650694698643,MATH 193A,A02,083225,Staff,0,6,30,30
1650694698643,MATH 193A,A03,083781,Staff,0,6,30,30
1650694698643,MATH 193A,A04,083782,Staff,0,7,30,30
1650694704665,MATH 197,001,091859,McAuley; Julian John,9998,0,9999,1
1650694710716,COGS 9,A01,083615,Staff,1,15,60,59
1650694716742,COGS 11,A01,083617,Boyle; Mary E. T.,16,0,40,24
1650694722766,COGS 13,A01,083071,Staff,0,38,40,40
1650694728797,COGS 14A,A01,092681,Staff,0,35,100,100
1650694734820,COGS 14B,A01,083073,Cheng; Tzu-Han,1,13,50,49
1650694740844,COGS 17,A01,092677,Staff,13,0,75,62
1650694746868,COGS 100,A01,083619,Staff,0,28,60,60
1650694752893,COGS 101A,A01,083621,Davis; Joshua Daniel,0,27,60,60
1650694758917,COGS 101B,A01,091572,Staff,0,4,60,60
1650694764944,COGS 101C,A01,083625,Delgado; Tania,14,0,30,16
1650694770969,COGS 107A,A01,083627,Boyle; Mary E. T.,0,16,60,60
1650694776993,COGS 118A,A01,083075,Staff,0,7,60,60
1650694783027,CSE 3,A50,083646,Miranda; Gregory Joseph,18,0,38,20
1650694783027,CSE 3,A51,083647,Miranda; Gregory Joseph,36,0,37,1
1650694789050,CSE 8A,A50,083650,Miranda; Gregory Joseph,0,31,40,40
1650694795075,CSE 11,A01,083080,Cao; Yingjun,0,96,40,40
1650694801101,CSE 12,A01,083652,Staff,0,20,100,100
1650694807124,CSE 15L,A01,083654,Staff,0,3,50,50
1650694807124,CSE 15L,A02,083655,Staff,0,2,50,50
1650694813148,CSE 20,A01,083657,Staff,49,0,80,31
1650694819173,CSE 30,A01,083084,Eldon; John,0,78,40,40
1650694825197,CSE 100,A01,083659,Cao; Yingjun,0,70,50,50
1650694831224,CSE 134B,A01,083661,Powell; Thomas Allan,0,38,65,65
1650694837248,CSE 140,A01,083663,Staff,0,10,75,75
1650694843279,CSE 140L,A01,083088,Eldon; John,0,19,75,75
1650694849308,CSE 175,A01,083665,Kumar; Rakesh,7,0,25,18
1650694855332,CSE 190,A00,092507,Dubnov; Shlomo,10,0,20,10
1650694861359,ECE 45,A01,083139,Staff,0,2,60,60
1650694867469,ECE 65,A50,083695,Staff,0,5,30,30
1650694873490,ECE 109,A01,091882,Touri; Behrouz,33,0,70,37
1650694879517,ECE 180,A00,083140,Abi Samra; Nicholas Camill,20,0,30,10
1650694879517,ECE 180,B00,083141,Abi Samra; Nicholas Camill,0,0,30,30
1650694885565,MATH 10A,A01,083735,Patchell; Gregory David,2,0,30,28
1650694885565,MATH 10A,A02,083736,Patchell; Gregory David,27,0,30,3
1650694885565,MATH 10A,A03,083737,Patchell; Gregory David,24,0,30,6
1650694891588,MATH 10B,A01,083207,Staff,0,9,30,30
1650694891588,MATH 10B,A02,083208,Staff,1,7,30,29
1650694891588,MATH 10B,B01,083739,Staff,11,0,30,19
1650694891588,MATH 10B,B02,083740,Staff,28,0,30,2
1650694897619,MATH 18,A01,083743,Staff,0,0,30,30
1650694897619,MATH 18,A02,083744,Staff,23,0,30,7
1650694897619,MATH 18,A03,083745,Staff,21,0,30,9
1650694897619,MATH 18,A04,083746,Staff,26,0,30,4
1650694897619,MATH 18,B01,083748,Staff,0,15,30,30
1650694897619,MATH 18,B02,083749,Staff,0,12,30,30
1650694897619,MATH 18,B03,083750,Staff,0,12,30,30
1650694897619,MATH 18,B04,083751,Staff,0,12,30,30
1650694903647,MATH 20A,A01,083754,Staff,19,0,40,21
1650694909673,MATH 20B,A01,083756,Staff,0,11,30,30
1650694909673,MATH 20B,A02,083757,Staff,0,12,30,30
1650694915696,MATH 20C,A01,083760,Staff,0,16,30,30
1650694915696,MATH 20C,A02,083761,Staff,0,15,30,30
1650694915696,MATH 20C,B01,083762,Staff,9,0,30,21
1650694915696,MATH 20C,B02,083763,Staff,28,0,30,2
1650694921720,MATH 20D,A01,083765,Staff,2,1,30,28
1650694921720,MATH 20D,A02,083766,Staff,6,0,30,24
1650694921720,MATH 20D,A03,083767,Staff,24,0,30,6
1650694927748,MATH 20E,A01,083771,Staff,3,0,30,27
1650694927748,MATH 20E,A02,083772,Staff,16,0,30,14
1650694927748,MATH 20E,B01,083773,Staff,0,0,30,30
1650694927748,MATH 20E,B02,083774,Staff,7,0,30,23
1650694933772,MATH 103A,A01,083777,Staff,0,15,30,30
1650694933772,MATH 103A,A02,083778,Staff,0,15,30,30
1650694933772,MATH 103A,B01,083779,Staff,0,15,30,30
1650694933772,MATH 103A,B02,083780,Staff,0,15,30,30
1650694939804,MATH 105,A01,085443,Staff,0,22,30,30
1650694945832,MATH 109,A01,083213,Anzaldo; Leesa B,0,7,30,30
1650694945832,MATH 109,A02,083214,Anzaldo; Leesa B,0,7,30,30
1650694945832,MATH 109,B01,083215,Anzaldo; Leesa B,0,8,30,30
1650694945832,MATH 109,B02,083216,Anzaldo; Leesa B,0,6,30,30
1650694951858,MATH 142A,A01,083219,Chow; Bennett,0,16,30,30
1650694951858,MATH 142A,A02,083220,Chow; Bennett,0,15,30,30
1650694951858,MATH 142A,B01,083221,Chow; Bennett,0,15,30,30
1650694951858,MATH 142A,B02,083222,Chow; Bennett,0,14,30,30
1650694957881,MATH 193A,A01,083224,Staff,0,5,30,30
1650694957881,MATH 193A,A02,083225,Staff,0,6,30,30
1650694957881,MATH 193A,A03,083781,Staff,0,6,30,30
1650694957881,MATH 193A,A04,083782,Staff,0,7,30,30
1650694963919,MATH 197,001,091859,McAuley; Julian John,9998,0,9999,1
1650694969975,COGS 9,A01,083615,Staff,1,15,60,59
1650694976003,COGS 11,A01,083617,Boyle; Mary E. T.,16,0,40,24
1650694982036,COGS 13,A01,083071,Staff,0,38,40,40
1650694988061,COGS 14A,A01,092681,Staff,0,35,100,100
1650694994085,COGS 14B,A01,083073,Cheng; Tzu-Han,1,13,50,49
1650695000112,COGS 17,A01,092677,Staff,13,0,75,62
1650695006136,COGS 100,A01,083619,Staff,0,28,60,60
1650695012172,COGS 101A,A01,083621,Davis; Joshua Daniel,0,27,60,60
1650695018198,COGS 101B,A01,091572,Staff,0,4,60,60
1650695024221,COGS 101C,A01,083625,Delgado; Tania,14,0,30,16
1650695030246,COGS 107A,A01,083627,Boyle; Mary E. T.,0,16,60,60
1650695036271,COGS 118A,A01,083075,Staff,0,7,60,60
1650695042300,CSE 3,A50,083646,Miranda; Gregory Joseph,18,0,38,20
1650695042300,CSE 3,A51,083647,Miranda; Gregory Joseph,36,0,37,1
1650695048336,CSE 8A,A50,083650,Miranda; Gregory Joseph,0,31,40,40
1650695054363,CSE 11,A01,083080,Cao; Yingjun,0,96,40,40
1650695060387,CSE 12,A01,083652,Staff,0,20,100,100
1650695066410,CSE 15L,A01,083654,Staff,0,3,50,50
1650695066410,CSE 15L,A02,083655,Staff,0,2,50,50
1650695072434,CSE 20,A01,083657,Staff,49,0,80,31
1650695078460,CSE 30,A01,083084,Eldon; John,0,77,40,40
1650695084488,CSE 100,A01,083659,Cao; Yingjun,0,70,50,50
1650695090511,CSE 134B,A01,083661,Powell; Thomas Allan,0,38,65,65
1650695096541,CSE 140,A01,083663,Staff,0,10,75,75
1650695102583,CSE 140L,A01,083088,Eldon; John,0,19,75,75
1650695108611,CSE 175,A01,083665,Kumar; Rakesh,7,0,25,18
1650695114634,CSE 190,A00,092507,Dubnov; Shlomo,10,0,20,10
1650695120660,ECE 45,A01,083139,Staff,0,2,60,60
1650695126694,ECE 65,A50,083695,Staff,0,5,30,30
1650695132726,ECE 109,A01,091882,Touri; Behrouz,33,0,70,37
1650695138749,ECE 180,A00,083140,Abi Samra; Nicholas Camill,20,0,30,10
1650695138749,ECE 180,B00,083141,Abi Samra; Nicholas Camill,0,0,30,30
1650695144779,MATH 10A,A01,083735,Patchell; Gregory David,2,0,30,28
1650695144779,MATH 10A,A02,083736,Patchell; Gregory David,27,0,30,3
1650695144779,MATH 10A,A03,083737,Patchell; Gregory David,24,0,30,6
1650695150807,MATH 10B,A01,083207,Staff,0,9,30,30
1650695150807,MATH 10B,A02,083208,Staff,1,7,30,29
1650695150807,MATH 10B,B01,083739,Staff,11,0,30,19
1650695150807,MATH 10B,B02,083740,Staff,28,0,30,2
1650695156833,MATH 18,A01,083743,Staff,0,0,30,30
1650695156833,MATH 18,A02,083744,Staff,23,0,30,7
1650695156833,MATH 18,A03,083745,Staff,21,0,30,9
1650695156833,MATH 18,A04,083746,Staff,26,0,30,4
1650695156833,MATH 18,B01,083748,Staff,0,15,30,30
1650695156833,MATH 18,B02,083749,Staff,0,12,30,30
1650695156833,MATH 18,B03,083750,Staff,0,12,30,30
1650695156833,MATH 18,B04,083751,Staff,0,12,30,30
1650695162868,MATH 20A,A01,083754,Staff,19,0,40,21
1650695168890,MATH 20B,A01,083756,Staff,0,11,30,30
1650695168890,MATH 20B,A02,083757,Staff,0,12,30,30
1650695174917,MATH 20C,A01,083760,Staff,0,16,30,30
1650695174917,MATH 20C,A02,083761,Staff,0,15,30,30
1650695174917,MATH 20C,B01,083762,Staff,9,0,30,21
1650695174917,MATH 20C,B02,083763,Staff,28,0,30,2
1650695180952,MATH 20D,A01,083765,Staff,2,1,30,28
1650695180952,MATH 20D,A02,083766,Staff,6,0,30,24
1650695180952,MATH 20D,A03,083767,Staff,24,0,30,6
1650695186979,MATH 20E,A01,083771,Staff,3,0,30,27
1650695186979,MATH 20E,A02,083772,Staff,16,0,30,14
1650695186979,MATH 20E,B01,083773,Staff,0,0,30,30
1650695186979,MATH 20E,B02,083774,Staff,7,0,30,23
1650695193007,MATH 103A,A01,083777,Staff,0,15,30,30
1650695193007,MATH 103A,A02,083778,Staff,0,15,30,30
1650695193007,MATH 103A,B01,083779,Staff,0,15,30,30
1650695193007,MATH 103A,B02,083780,Staff,0,15,30,30
1650695199034,MATH 105,A01,085443,Staff,0,22,30,30
1650695205067,MATH 109,A01,083213,Anzaldo; Leesa B,0,7,30,30
1650695205067,MATH 109,A02,083214,Anzaldo; Leesa B,0,7,30,30
1650695205067,MATH 109,B01,083215,Anzaldo; Leesa B,0,8,30,30
1650695205067,MATH 109,B02,083216,Anzaldo; Leesa B,0,6,30,30
1650695211092,MATH 142A,A01,083219,Chow; Bennett,0,16,30,30
1650695211092,MATH 142A,A02,083220,Chow; Bennett,0,15,30,30
1650695211092,MATH 142A,B01,083221,Chow; Bennett,0,15,30,30
1650695211092,MATH 142A,B02,083222,Chow; Bennett,0,14,30,30
1650695217116,MATH 193A,A01,083224,Staff,0,5,30,30
1650695217116,MATH 193A,A02,083225,Staff,0,6,30,30
1650695217116,MATH 193A,A03,083781,Staff,0,6,30,30
1650695217116,MATH 193A,A04,083782,Staff,0,7,30,30
1650695223140,MATH 197,001,091859,McAuley; Julian John,9998,0,9999,1
1650695229206,COGS 9,A01,083615,Staff,1,15,60,59
1650695235229,COGS 11,A01,083617,Boyle; Mary E. T.,16,0,40,24
1650695241254,COGS 13,A01,083071,Staff,0,38,40,40
1650695247324,COGS 14A,A01,092681,Staff,0,35,100,100
1650695253349,COGS 14B,A01,083073,Cheng; Tzu-Han,1,13,50,49
1650695259375,COGS 17,A01,092677,Staff,13,0,75,62
1650695265407,COGS 100,A01,083619,Staff,0,28,60,60
1650695271432,COGS 101A,A01,083621,Davis; Joshua Daniel,0,27,60,60
1650695277455,COGS 101B,A01,091572,Staff,0,4,60,60
1650695283475,COGS 101C,A01,083625,Delgado; Tania,14,0,30,16
1650695289500,COGS 107A,A01,083627,Boyle; Mary E. T.,0,16,60,60
1650695295521,COGS 118A,A01,083075,Staff,0,7,60,60
1650695301545,CSE 3,A50,083646,Miranda; Gregory Joseph,18,0,38,20
1650695301545,CSE 3,A51,083647,Miranda; Gregory Joseph,36,0,37,1
1650695307571,CSE 8A,A50,083650,Miranda; Gregory Joseph,0,31,40,40
1650695313597,CSE 11,A01,083080,Cao; Yingjun,0,96,40,40
1650695319619,CSE 12,A01,083652,Staff,0,20,100,100
1650695325643,CSE 15L,A01,083654,Staff,0,3,50,50
1650695325643,CSE 15L,A02,083655,Staff,0,2,50,50
1650695331682,CSE 20,A01,083657,Staff,49,0,80,31
1650695337708,CSE 30,A01,083084,Eldon; John,0,77,40,40
1650695343732,CSE 100,A01,083659,Cao; Yingjun,0,70,50,50
1650695349757,CSE 134B,A01,083661,Powell; Thomas Allan,0,38,65,65
1650695355781,CSE 140,A01,083663,Staff,0,10,75,75
1650695361804,CSE 140L,A01,083088,Eldon; John,0,19,75,75
1650695367830,CSE 175,A01,083665,Kumar; Rakesh,7,0,25,18
1650695373858,CSE 190,A00,092507,Dubnov; Shlomo,10,0,20,10
1650695379880,ECE 45,A01,083139,Staff,0,2,60,60
1650695385906,ECE 65,A50,083695,Staff,0,5,30,30
1650695391939,ECE 109,A01,091882,Touri; Behrouz,33,0,70,37
1650695397966,ECE 180,A00,083140,Abi Samra; Nicholas Camill,20,0,30,10
1650695397966,ECE 180,B00,083141,Abi Samra; Nicholas Camill,0,0,30,30
1650695403997,MATH 10A,A01,083735,Patchell; Gregory David,2,0,30,28
1650695403997,MATH 10A,A02,083736,Patchell; Gregory David,27,0,30,3
1650695403997,MATH 10A,A03,083737,Patchell; Gregory David,24,0,30,6
1650695410025,MATH 10B,A01,083207,Staff,0,9,30,30
1650695410025,MATH 10B,A02,083208,Staff,1,7,30,29
1650695410025,MATH 10B,B01,083739,Staff,11,0,30,19
1650695410025,MATH 10B,B02,083740,Staff,28,0,30,2
1650695416058,MATH 18,A01,083743,Staff,0,0,30,30
1650695416058,MATH 18,A02,083744,Staff,23,0,30,7
1650695416058,MATH 18,A03,083745,Staff,21,0,30,9
1650695416058,MATH 18,A04,083746,Staff,26,0,30,4
1650695416058,MATH 18,B01,083748,Staff,0,15,30,30
1650695416058,MATH 18,B02,083749,Staff,0,12,30,30
1650695416058,MATH 18,B03,083750,Staff,0,12,30,30
1650695416058,MATH 18,B04,083751,Staff,0,12,30,30
1650695422082,MATH 20A,A01,083754,Staff,19,0,40,21
1650695428110,MATH 20B,A01,083756,Staff,0,11,30,30
1650695428110,MATH 20B,A02,083757,Staff,0,12,30,30
1650695434137,MATH 20C,A01,083760,Staff,0,16,30,30
1650695434137,MATH 20C,A02,083761,Staff,0,15,30,30
1650695434137,MATH 20C,B01,083762,Staff,9,0,30,21
1650695434137,MATH 20C,B02,083763,Staff,28,0,30,2
1650695440160,MATH 20D,A01,083765,Staff,2,1,30,28
1650695440160,MATH 20D,A02,083766,Staff,6,0,30,24
1650695440160,MATH 20D,A03,083767,Staff,24,0,30,6
1650695446188,MATH 20E,A01,083771,Staff,3,0,30,27
1650695446188,MATH 20E,A02,083772,Staff,16,0,30,14
1650695446188,MATH 20E,B01,083773,Staff,0,0,30,30
1650695446188,MATH 20E,B02,083774,Staff,7,0,30,23
1650695452211,MATH 103A,A01,083777,Staff,0,15,30,30
1650695452211,MATH 103A,A02,083778,Staff,0,15,30,30
1650695452211,MATH 103A,B01,083779,Staff,0,15,30,30
1650695452211,MATH 103A,B02,083780,Staff,0,15,30,30
1650695458234,MATH 105,A01,085443,Staff,0,22,30,30
1650695464352,MATH 109,A01,083213,Anzaldo; Leesa B,0,7,30,30
1650695464352,MATH 109,A02,083214,Anzaldo; Leesa B,0,7,30,30
1650695464352,MATH 109,B01,083215,Anzaldo; Leesa B,0,8,30,30
1650695464352,MATH 109,B02,083216,Anzaldo; Leesa B,0,6,30,30
1650695470387,MATH 142A,A01,083219,Chow; Bennett,0,16,30,30
1650695470387,MATH 142A,A02,083220,Chow; Bennett,0,15,30,30
1650695470387,MATH 142A,B01,083221,Chow; Bennett,0,15,30,30
1650695470387,MATH 142A,B02,083222,Chow; Bennett,0,14,30,30
1650695476412,MATH 193A,A01,083224,Staff,0,5,30,30
1650695476412,MATH 193A,A02,083225,Staff,0,6,30,30
1650695476412,MATH 193A,A03,083781,Staff,0,6,30,30
1650695476412,MATH 193A,A04,083782,Staff,0,7,30,30
1650695482436,MATH 197,001,091859,McAuley; Julian John,9998,0,9999,1
1650695488488,COGS 9,A01,083615,Staff,1,15,60,59
1650695494511,COGS 11,A01,083617,Boyle; Mary E. T.,16,0,40,24
1650695500536,COGS 13,A01,083071,Staff,0,38,40,40
1650695506560,COGS 14A,A01,092681,Staff,0,35,100,100
1650695512595,COGS 14B,A01,083073,Cheng; Tzu-Han,1,13,50,49
1650695518619,COGS 17,A01,092677,Staff,13,0,75,62
1650695524648,COGS 100,A01,083619,Staff,0,28,60,60
1650695530676,COGS 101A,A01,083621,Davis; Joshua Daniel,0,27,60,60
1650695536700,COGS 101B,A01,091572,Staff,0,4,60,60
1650695542734,COGS 101C,A01,083625,Delgado; Tania,14,0,30,16
1650695548758,COGS 107A,A01,083627,Boyle; Mary E. T.,0,16,60,60
1650695554785,COGS 118A,A01,083075,Staff,0,7,60,60
1650695560808,CSE 3,A50,083646,Miranda; Gregory Joseph,18,0,38,20
1650695560808,CSE 3,A51,083647,Miranda; Gregory Joseph,36,0,37,1
1650695566836,CSE 8A,A50,083650,Miranda; Gregory Joseph,0,31,40,40
1650695572860,CSE 11,A01,083080,Cao; Yingjun,0,96,40,40
1650695578888,CSE 12,A01,083652,Staff,0,20,100,100
1650695584913,CSE 15L,A01,083654,Staff,0,3,50,50
1650695584913,CSE 15L,A02,083655,Staff,0,2,50,50
1650695590942,CSE 20,A01,083657,Staff,49,0,80,31
1650695596966,CSE 30,A01,083084,Eldon; John,0,77,40,40
1650695602991,CSE 100,A01,083659,Cao; Yingjun,0,70,50,50
1650695609015,CSE 134B,A01,083661,Powell; Thomas Allan,0,38,65,65
1650695615038,CSE 140,A01,083663,Staff,0,10,75,75
1650695621066,CSE 140L,A01,083088,Eldon; John,0,19,75,75
1650695627089,CSE 175,A01,083665,Kumar; Rakesh,7,0,25,18
1650695633117,CSE 190,A00,092507,Dubnov; Shlomo,10,0,20,10
1650695639161,ECE 45,A01,083139,Staff,0,2,60,60
1650695645183,ECE 65,A50,083695,Staff,0,5,30,30
1650695651207,ECE 109,A01,091882,Touri; Behrouz,33,0,70,37
1650695657235,ECE 180,A00,083140,Abi Samra; Nicholas Camill,20,0,30,10
1650695657235,ECE 180,B00,083141,Abi Samra; Nicholas Camill,0,0,30,30
1650695663261,MATH 10A,A01,083735,Patchell; Gregory David,2,0,30,28
1650695663261,MATH 10A,A02,083736,Patchell; Gregory David,27,0,30,3
1650695663261,MATH 10A,A03,083737,Patchell; Gregory David,24,0,30,6
1650695669289,MATH 10B,A01,083207,Staff,0,9,30,30
1650695669289,MATH 10B,A02,083208,Staff,1,7,30,29
1650695669289,MATH 10B,B01,083739,Staff,11,0,30,19
1650695669289,MATH 10B,B02,083740,Staff,28,0,30,2
1650695675313,MATH 18,A01,083743,Staff,0,0,30,30
1650695675313,MATH 18,A02,083744,Staff,23,0,30,7
1650695675313,MATH 18,A03,083745,Staff,21,0,30,9
1650695675313,MATH 18,A04,083746,Staff,26,0,30,4
1650695675313,MATH 18,B01,083748,Staff,0,15,30,30
1650695675313,MATH 18,B02,083749,Staff,0,12,30,30
1650695675313,MATH 18,B03,083750,Staff,0,12,30,30
1650695675313,MATH 18,B04,083751,Staff,0,12,30,30
1650695681342,MATH 20A,A01,083754,Staff,19,0,40,21
1650695687370,MATH 20B,A01,083756,Staff,0,11,30,30
1650695687370,MATH 20B,A02,083757,Staff,0,12,30,30
1650695693396,MATH 20C,A01,083760,Staff,0,16,30,30
1650695693396,MATH 20C,A02,083761,Staff,0,15,30,30
1650695693396,MATH 20C,B01,083762,Staff,9,0,30,21
1650695693396,MATH 20C,B02,083763,Staff,28,0,30,2
1650695699426,MATH 20D,A01,083765,Staff,2,1,30,28
1650695699426,MATH 20D,A02,083766,Staff,6,0,30,24
1650695699426,MATH 20D,A03,083767,Staff,24,0,30,6
1650695705454,MATH 20E,A01,083771,Staff,3,0,30,27
1650695705454,MATH 20E,A02,083772,Staff,16,0,30,14
1650695705454,MATH 20E,B01,083773,Staff,0,0,30,30
1650695705454,MATH 20E,B02,083774,Staff,7,0,30,23
1650695711479,MATH 103A,A01,083777,Staff,0,15,30,30
1650695711479,MATH 103A,A02,083778,Staff,0,15,30,30
1650695711479,MATH 103A,B01,083779,Staff,0,15,30,30
1650695711479,MATH 103A,B02,083780,Staff,0,15,30,30
1650695717503,MATH 105,A01,085443,Staff,0,22,30,30
1650695723530,MATH 109,A01,083213,Anzaldo; Leesa B,0,7,30,30
1650695723530,MATH 109,A02,083214,Anzaldo; Leesa B,0,7,30,30
1650695723530,MATH 109,B01,083215,Anzaldo; Leesa B,0,8,30,30
1650695723530,MATH 109,B02,083216,Anzaldo; Leesa B,0,6,30,30
1650695729552,MATH 142A,A01,083219,Chow; Bennett,0,16,30,30
1650695729552,MATH 142A,A02,083220,Chow; Bennett,0,15,30,30
1650695729552,MATH 142A,B01,083221,Chow; Bennett,0,15,30,30
1650695729552,MATH 142A,B02,083222,Chow; Bennett,0,14,30,30
1650695735577,MATH 193A,A01,083224,Staff,0,5,30,30
1650695735577,MATH 193A,A02,083225,Staff,0,6,30,30
1650695735577,MATH 193A,A03,083781,Staff,0,6,30,30
1650695735577,MATH 193A,A04,083782,Staff,0,7,30,30
1650695741603,MATH 197,001,091859,McAuley; Julian John,9998,0,9999,1
1650695747662,COGS 9,A01,083615,Staff,1,15,60,59
1650695753686,COGS 11,A01,083617,Boyle; Mary E. T.,16,0,40,24
1650695759710,COGS 13,A01,083071,Staff,0,38,40,40
1650695765733,COGS 14A,A01,092681,Staff,0,35,100,100
1650695771769,COGS 14B,A01,083073,Cheng; Tzu-Han,1,13,50,49
1650695777793,COGS 17,A01,092677,Staff,13,0,75,62
1650695783817,COGS 100,A01,083619,Staff,0,28,60,60
1650695789841,COGS 101A,A01,083621,Davis; Joshua Daniel,0,27,60,60
1650695795869,COGS 101B,A01,091572,Staff,0,4,60,60
1650695801897,COGS 101C,A01,083625,Delgado; Tania,14,0,30,16
1650695807922,COGS 107A,A01,083627,Boyle; Mary E. T.,0,16,60,60
1650695813945,COGS 118A,A01,083075,Staff,0,7,60,60
1650695819972,CSE 3,A50,083646,Miranda; Gregory Joseph,18,0,38,20
1650695819972,CSE 3,A51,083647,Miranda; Gregory Joseph,36,0,37,1
1650695825998,CSE 8A,A50,083650,Miranda; Gregory Joseph,0,31,40,40
1650695832023,CSE 11,A01,083080,Cao; Yingjun,0,96,40,40
1650695838061,CSE 12,A01,083652,Staff,0,21,100,100
1650695844092,CSE 15L,A01,083654,Staff,0,3,50,50
1650695844092,CSE 15L,A02,083655,Staff,0,2,50,50
1650695850130,CSE 20,A01,083657,Staff,49,0,80,31
1650695856171,CSE 30,A01,083084,Eldon; John,0,77,40,40
1650695862195,CSE 100,A01,083659,Cao; Yingjun,0,70,50,50
1650695868223,CSE 134B,A01,083661,Powell; Thomas Allan,0,38,65,65
1650695874246,CSE 140,A01,083663,Staff,0,10,75,75
1650695880277,CSE 140L,A01,083088,Eldon; John,0,19,75,75
1650695886312,CSE 175,A01,083665,Kumar; Rakesh,7,0,25,18
1650695892336,CSE 190,A00,092507,Dubnov; Shlomo,10,0,20,10
1650695898365,ECE 45,A01,083139,Staff,0,2,60,60
1650695904392,ECE 65,A50,083695,Staff,0,5,30,30
1650695910419,ECE 109,A01,091882,Touri; Behrouz,33,0,70,37
1650695916443,ECE 180,A00,083140,Abi Samra; Nicholas Camill,20,0,30,10
1650695916443,ECE 180,B00,083141,Abi Samra; Nicholas Camill,0,0,30,30
1650695922478,MATH 10A,A01,083735,Patchell; Gregory David,2,0,30,28
1650695922478,MATH 10A,A02,083736,Patchell; Gregory David,27,0,30,3
1650695922478,MATH 10A,A03,083737,Patchell; Gregory David,24,0,30,6
1650695928503,MATH 10B,A01,083207,Staff,0,9,30,30
1650695928503,MATH 10B,A02,083208,Staff,1,7,30,29
1650695928503,MATH 10B,B01,083739,Staff,11,0,30,19
1650695928503,MATH 10B,B02,083740,Staff,28,0,30,2
1650695934535,MATH 18,A01,083743,Staff,0,0,30,30
1650695934535,MATH 18,A02,083744,Staff,23,0,30,7
1650695934535,MATH 18,A03,083745,Staff,21,0,30,9
1650695934535,MATH 18,A04,083746,Staff,26,0,30,4
1650695934535,MATH 18,B01,083748,Staff,0,15,30,30
1650695934535,MATH 18,B02,083749,Staff,0,12,30,30
1650695934535,MATH 18,B03,083750,Staff,0,12,30,30
1650695934535,MATH 18,B04,083751,Staff,0,12,30,30
1650695940569,MATH 20A,A01,083754,Staff,19,0,40,21
1650695946595,MATH 20B,A01,083756,Staff,0,11,30,30
1650695946595,MATH 20B,A02,083757,Staff,0,12,30,30
1650695952621,MATH 20C,A01,083760,Staff,0,16,30,30
1650695952621,MATH 20C,A02,083761,Staff,0,15,30,30
1650695952621,MATH 20C,B01,083762,Staff,9,0,30,21
1650695952621,MATH 20C,B02,083763,Staff,28,0,30,2
1650695958657,MATH 20D,A01,083765,Staff,2,1,30,28
1650695958657,MATH 20D,A02,083766,Staff,6,0,30,24
1650695958657,MATH 20D,A03,083767,Staff,24,0,30,6
1650695964684,MATH 20E,A01,083771,Staff,3,0,30,27
1650695964684,MATH 20E,A02,083772,Staff,16,0,30,14
1650695964684,MATH 20E,B01,083773,Staff,0,0,30,30
1650695964684,MATH 20E,B02,083774,Staff,7,0,30,23
1650695970713,MATH 103A,A01,083777,Staff,0,15,30,30
1650695970713,MATH 103A,A02,083778,Staff,0,15,30,30
1650695970713,MATH 103A,B01,083779,Staff,0,15,30,30
1650695970713,MATH 103A,B02,083780,Staff,0,15,30,30
1650695976743,MATH 105,A01,085443,Staff,0,22,30,30
1650695982767,MATH 109,A01,083213,Anzaldo; Leesa B,0,7,30,30
1650695982767,MATH 109,A02,083214,Anzaldo; Leesa B,0,7,30,30
1650695982767,MATH 109,B01,083215,Anzaldo; Leesa B,0,8,30,30
1650695982767,MATH 109,B02,083216,Anzaldo; Leesa B,0,6,30,30
1650695988792,MATH 142A,A01,083219,Chow; Bennett,0,16,30,30
1650695988792,MATH 142A,A02,083220,Chow; Bennett,0,15,30,30
1650695988792,MATH 142A,B01,083221,Chow; Bennett,0,15,30,30
1650695988792,MATH 142A,B02,083222,Chow; Bennett,0,14,30,30
1650695994817,MATH 193A,A01,083224,Staff,0,5,30,30
1650695994817,MATH 193A,A02,083225,Staff,0,6,30,30
1650695994817,MATH 193A,A03,083781,Staff,0,6,30,30
1650695994817,MATH 193A,A04,083782,Staff,0,7,30,30
1650696000841,MATH 197,001,091859,McAuley; Julian John,9998,0,9999,1
1650696006891,COGS 9,A01,083615,Staff,1,15,60,59
1650696012915,COGS 11,A01,083617,Boyle; Mary E. T.,16,0,40,24
1650696018943,COGS 13,A01,083071,Staff,0,38,40,40
1650696024969,COGS 14A,A01,092681,Staff,0,35,100,100
1650696030994,COGS 14B,A01,083073,Cheng; Tzu-Han,1,13,50,49
1650696037019,COGS 17,A01,092677,Staff,13,0,75,62
1650696043058,COGS 100,A01,083619,Staff,0,28,60,60
1650696049097,COGS 101A,A01,083621,Davis; Joshua Daniel,0,27,60,60
1650696055213,COGS 101B,A01,091572,Staff,0,4,60,60
1650696061244,COGS 101C,A01,083625,Delgado; Tania,14,0,30,16
1650696067268,COGS 107A,A01,083627,Boyle; Mary E. T.,0,16,60,60
1650696073294,COGS 118A,A01,083075,Staff,0,7,60,60
1650696079323,CSE 3,A50,083646,Miranda; Gregory Joseph,18,0,38,20
1650696079323,CSE 3,A51,083647,Miranda; Gregory Joseph,36,0,37,1
1650696085347,CSE 8A,A50,083650,Miranda; Gregory Joseph,0,31,40,40
1650696091374,CSE 11,A01,083080,Cao; Yingjun,0,96,40,40
1650696097399,CSE 12,A01,083652,Staff,0,21,100,100
1650696103423,CSE 15L,A01,083654,Staff,0,3,50,50
1650696103423,CSE 15L,A02,083655,Staff,0,2,50,50
1650696109447,CSE 20,A01,083657,Staff,49,0,80,31
1650696115471,CSE 30,A01,083084,Eldon; John,0,77,40,40
1650696121499,CSE 100,A01,083659,Cao; Yingjun,0,70,50,50
1650696127522,CSE 134B,A01,083661,Powell; Thomas Allan,0,38,65,65
1650696133547,CSE 140,A01,083663,Staff,0,10,75,75
1650696139572,CSE 140L,A01,083088,Eldon; John,0,19,75,75
1650696145595,CSE 175,A01,083665,Kumar; Rakesh,7,0,25,18
1650696151620,CSE 190,A00,092507,Dubnov; Shlomo,10,0,20,10
1650696157647,ECE 45,A01,083139,Staff,0,2,60,60
1650696163671,ECE 65,A50,083695,Staff,0,5,30,30
1650696169695,ECE 109,A01,091882,Touri; Behrouz,33,0,70,37
1650696175721,ECE 180,A00,083140,Abi Samra; Nicholas Camill,20,0,30,10
1650696175721,ECE 180,B00,083141,Abi Samra; Nicholas Camill,0,0,30,30
1650696181747,MATH 10A,A01,083735,Patchell; Gregory David,2,0,30,28
1650696181747,MATH 10A,A02,083736,Patchell; Gregory David,27,0,30,3
1650696181747,MATH 10A,A03,083737,Patchell; Gregory David,24,0,30,6
1650696187773,MATH 10B,A01,083207,Staff,0,9,30,30
1650696187773,MATH 10B,A02,083208,Staff,1,7,30,29
1650696187773,MATH 10B,B01,083739,Staff,11,0,30,19
1650696187773,MATH 10B,B02,083740,Staff,28,0,30,2
1650696193802,MATH 18,A01,083743,Staff,0,0,30,30
1650696193802,MATH 18,A02,083744,Staff,23,0,30,7
1650696193802,MATH 18,A03,083745,Staff,21,0,30,9
1650696193802,MATH 18,A04,083746,Staff,26,0,30,4
1650696193802,MATH 18,B01,083748,Staff,0,15,30,30
1650696193802,MATH 18,B02,083749,Staff,0,12,30,30
1650696193802,MATH 18,B03,083750,Staff,0,12,30,30
1650696193802,MATH 18,B04,083751,Staff,0,12,30,30
1650696199826,MATH 20A,A01,083754,Staff,19,0,40,21
1650696205853,MATH 20B,A01,083756,Staff,0,11,30,30
1650696205853,MATH 20B,A02,083757,Staff,0,12,30,30
1650696211881,MATH 20C,A01,083760,Staff,0,16,30,30
1650696211881,MATH 20C,A02,083761,Staff,0,15,30,30
1650696211881,MATH 20C,B01,083762,Staff,9,0,30,21
1650696211881,MATH 20C,B02,083763,Staff,28,0,30,2
1650696217916,MATH 20D,A01,083765,Staff,2,1,30,28
1650696217916,MATH 20D,A02,083766,Staff,6,0,30,24
1650696217916,MATH 20D,A03,083767,Staff,24,0,30,6
1650696223939,MATH 20E,A01,083771,Staff,3,0,30,27
1650696223939,MATH 20E,A02,083772,Staff,16,0,30,14
1650696223939,MATH 20E,B01,083773,Staff,0,0,30,30
1650696223939,MATH 20E,B02,083774,Staff,7,0,30,23
1650696229964,MATH 103A,A01,083777,Staff,0,15,30,30
1650696229964,MATH 103A,A02,083778,Staff,0,15,30,30
1650696229964,MATH 103A,B01,083779,Staff,0,15,30,30
1650696229964,MATH 103A,B02,083780,Staff,0,15,30,30
1650696235987,MATH 105,A01,085443,Staff,0,22,30,30
1650696242016,MATH 109,A01,083213,Anzaldo; Leesa B,0,7,30,30
1650696242016,MATH 109,A02,083214,Anzaldo; Leesa B,0,7,30,30
1650696242016,MATH 109,B01,083215,Anzaldo; Leesa B,0,8,30,30
1650696242016,MATH 109,B02,083216,Anzaldo; Leesa B,0,6,30,30
1650696248041,MATH 142A,A01,083219,Chow; Bennett,0,16,30,30
1650696248041,MATH 142A,A02,083220,Chow; Bennett,0,15,30,30
1650696248041,MATH 142A,B01,083221,Chow; Bennett,0,15,30,30
1650696248041,MATH 142A,B02,083222,Chow; Bennett,0,14,30,30
1650696254065,MATH 193A,A01,083224,Staff,0,5,30,30
1650696254065,MATH 193A,A02,083225,Staff,0,6,30,30
1650696254065,MATH 193A,A03,083781,Staff,0,6,30,30
1650696254065,MATH 193A,A04,083782,Staff,0,7,30,30
1650696260092,MATH 197,001,091859,McAuley; Julian John,9998,0,9999,1
1650696266153,COGS 9,A01,083615,Staff,1,15,60,59
1650696272176,COGS 11,A01,083617,Boyle; Mary E. T.,16,0,40,24
1650696278204,COGS 13,A01,083071,Staff,0,38,40,40
1650696284227,COGS 14A,A01,092681,Staff,0,35,100,100
1650696290254,COGS 14B,A01,083073,Cheng; Tzu-Han,1,13,50,49
1650696296280,COGS 17,A01,092677,Staff,13,0,75,62
1650696302303,COGS 100,A01,083619,Staff,0,28,60,60
1650696308328,COGS 101A,A01,083621,Davis; Joshua Daniel,0,27,60,60
1650696314355,COGS 101B,A01,091572,Staff,0,4,60,60
1650696320378,COGS 101C,A01,083625,Delgado; Tania,14,0,30,16
1650696326402,COGS 107A,A01,083627,Boyle; Mary E. T.,0,16,60,60
1650696332434,COGS 118A,A01,083075,Staff,0,7,60,60
1650696338463,CSE 3,A50,083646,Miranda; Gregory Joseph,18,0,38,20
1650696338463,CSE 3,A51,083647,Miranda; Gregory Joseph,36,0,37,1
1650696344491,CSE 8A,A50,083650,Miranda; Gregory Joseph,0,31,40,40
1650696350519,CSE 11,A01,083080,Cao; Yingjun,0,96,40,40
1650696356542,CSE 12,A01,083652,Staff,0,21,100,100
1650696362572,CSE 15L,A01,083654,Staff,0,3,50,50
1650696362572,CSE 15L,A02,083655,Staff,0,2,50,50
1650696368600,CSE 20,A01,083657,Staff,49,0,80,31
1650696374628,CSE 30,A01,083084,Eldon; John,0,77,40,40
1650696380652,CSE 100,A01,083659,Cao; Yingjun,0,70,50,50
1650696386680,CSE 134B,A01,083661,Powell; Thomas Allan,0,38,65,65
1650696392707,CSE 140,A01,083663,Staff,0,10,75,75
1650696398730,CSE 140L,A01,083088,Eldon; John,0,19,75,75
1650696404762,CSE 175,A01,083665,Kumar; Rakesh,7,0,25,18
1650696410786,CSE 190,A00,092507,Dubnov; Shlomo,10,0,20,10
1650696416813,ECE 45,A01,083139,Staff,0,2,60,60
1650696422841,ECE 65,A50,083695,Staff,0,5,30,30
1650696428865,ECE 109,A01,091882,Touri; Behrouz,33,0,70,37
1650696434892,ECE 180,A00,083140,Abi Samra; Nicholas Camill,20,0,30,10
1650696434892,ECE 180,B00,083141,Abi Samra; Nicholas Camill,0,0,30,30
1650696440916,MATH 10A,A01,083735,Patchell; Gregory David,2,0,30,28
1650696440916,MATH 10A,A02,083736,Patchell; Gregory David,27,0,30,3
1650696440916,MATH 10A,A03,083737,Patchell; Gregory David,24,0,30,6
1650696446943,MATH 10B,A01,083207,Staff,0,9,30,30
1650696446943,MATH 10B,A02,083208,Staff,1,7,30,29
1650696446943,MATH 10B,B01,083739,Staff,11,0,30,19
1650696446943,MATH 10B,B02,083740,Staff,28,0,30,2
1650696452968,MATH 18,A01,083743,Staff,0,0,30,30
1650696452968,MATH 18,A02,083744,Staff,23,0,30,7
1650696452968,MATH 18,A03,083745,Staff,21,0,30,9
1650696452968,MATH 18,A04,083746,Staff,26,0,30,4
1650696452968,MATH 18,B01,083748,Staff,0,15,30,30
1650696452968,MATH 18,B02,083749,Staff,0,12,30,30
1650696452968,MATH 18,B03,083750,Staff,0,12,30,30
1650696452968,MATH 18,B04,083751,Staff,0,12,30,30
1650696458992,MATH 20A,A01,083754,Staff,19,0,40,21
1650696465017,MATH 20B,A01,083756,Staff,0,11,30,30
1650696465017,MATH 20B,A02,083757,Staff,0,12,30,30
1650696471042,MATH 20C,A01,083760,Staff,0,16,30,30
1650696471042,MATH 20C,A02,083761,Staff,0,15,30,30
1650696471042,MATH 20C,B01,083762,Staff,9,0,30,21
1650696471042,MATH 20C,B02,083763,Staff,28,0,30,2
1650696477077,MATH 20D,A01,083765,Staff,2,1,30,28
1650696477077,MATH 20D,A02,083766,Staff,6,0,30,24
1650696477077,MATH 20D,A03,083767,Staff,24,0,30,6
1650696483105,MATH 20E,A01,083771,Staff,3,0,30,27
1650696483105,MATH 20E,A02,083772,Staff,16,0,30,14
1650696483105,MATH 20E,B01,083773,Staff,0,0,30,30
1650696483105,MATH 20E,B02,083774,Staff,7,0,30,23
1650696489129,MATH 103A,A01,083777,Staff,0,15,30,30
1650696489129,MATH 103A,A02,083778,Staff,0,15,30,30
1650696489129,MATH 103A,B01,083779,Staff,0,15,30,30
1650696489129,MATH 103A,B02,083780,Staff,0,15,30,30
1650696495155,MATH 105,A01,085443,Staff,0,22,30,30
1650696501180,MATH 109,A01,083213,Anzaldo; Leesa B,0,7,30,30
1650696501180,MATH 109,A02,083214,Anzaldo; Leesa B,0,7,30,30
1650696501180,MATH 109,B01,083215,Anzaldo; Leesa B,0,8,30,30
1650696501180,MATH 109,B02,083216,Anzaldo; Leesa B,0,6,30,30
1650696507202,MATH 142A,A01,083219,Chow; Bennett,0,16,30,30
1650696507202,MATH 142A,A02,083220,Chow; Bennett,0,15,30,30
1650696507202,MATH 142A,B01,083221,Chow; Bennett,0,15,30,30
1650696507202,MATH 142A,B02,083222,Chow; Bennett,0,14,30,30
1650696513227,MATH 193A,A01,083224,Staff,0,5,30,30
1650696513227,MATH 193A,A02,083225,Staff,0,6,30,30
1650696513227,MATH 193A,A03,083781,Staff,0,6,30,30
1650696513227,MATH 193A,A04,083782,Staff,0,7,30,30
1650696519252,MATH 197,001,091859,McAuley; Julian John,9998,0,9999,1
1650696525305,COGS 9,A01,083615,Staff,1,15,60,59
1650696531329,COGS 11,A01,083617,Boyle; Mary E. T.,16,0,40,24
1650696537355,COGS 13,A01,083071,Staff,0,38,40,40
1650696543395,COGS 14A,A01,092681,Staff,0,35,100,100
1650696549422,COGS 14B,A01,083073,Cheng; Tzu-Han,1,13,50,49
1650696555448,COGS 17,A01,092677,Staff,13,0,75,62
1650696561474,COGS 100,A01,083619,Staff,0,28,60,60
1650696567499,COGS 101A,A01,083621,Davis; Joshua Daniel,0,27,60,60
1650696573525,COGS 101B,A01,091572,Staff,0,4,60,60
1650696579547,COGS 101C,A01,083625,Delgado; Tania,14,0,30,16
1650696585587,COGS 107A,A01,083627,Boyle; Mary E. T.,0,16,60,60
1650696591613,COGS 118A,A01,083075,Staff,0,7,60,60
1650696597634,CSE 3,A50,083646,Miranda; Gregory Joseph,18,0,38,20
1650696597634,CSE 3,A51,083647,Miranda; Gregory Joseph,36,0,37,1
1650696603658,CSE 8A,A50,083650,Miranda; Gregory Joseph,0,31,40,40
1650696609685,CSE 11,A01,083080,Cao; Yingjun,0,96,40,40
1650696615708,CSE 12,A01,083652,Staff,0,21,100,100
1650696621732,CSE 15L,A01,083654,Staff,0,3,50,50
1650696621732,CSE 15L,A02,083655,Staff,0,2,50,50
1650696627753,CSE 20,A01,083657,Staff,49,0,80,31
1650696633781,CSE 30,A01,083084,Eldon; John,0,77,40,40
1650696639811,CSE 100,A01,083659,Cao; Yingjun,0,70,50,50
1650696645835,CSE 134B,A01,083661,Powell; Thomas Allan,0,38,65,65
1650696651959,CSE 140,A01,083663,Staff,0,10,75,75
1650696657987,CSE 140L,A01,083088,Eldon; John,0,19,75,75
1650696664014,CSE 175,A01,083665,Kumar; Rakesh,7,0,25,18
1650696670040,CSE 190,A00,092507,Dubnov; Shlomo,10,0,20,10
1650696676076,ECE 45,A01,083139,Staff,0,2,60,60
1650696682100,ECE 65,A50,083695,Staff,0,5,30,30
1650696688131,ECE 109,A01,091882,Touri; Behrouz,33,0,70,37
1650696694155,ECE 180,A00,083140,Abi Samra; Nicholas Camill,20,0,30,10
1650696694155,ECE 180,B00,083141,Abi Samra; Nicholas Camill,0,0,30,30
1650696700179,MATH 10A,A01,083735,Patchell; Gregory David,2,0,30,28
1650696700179,MATH 10A,A02,083736,Patchell; Gregory David,27,0,30,3
1650696700179,MATH 10A,A03,083737,Patchell; Gregory David,24,0,30,6
1650696706206,MATH 10B,A01,083207,Staff,0,9,30,30
1650696706206,MATH 10B,A02,083208,Staff,1,7,30,29
1650696706206,MATH 10B,B01,083739,Staff,11,0,30,19
1650696706206,MATH 10B,B02,083740,Staff,28,0,30,2
1650696712233,MATH 18,A01,083743,Staff,0,0,30,30
1650696712233,MATH 18,A02,083744,Staff,23,0,30,7
1650696712233,MATH 18,A03,083745,Staff,21,0,30,9
1650696712233,MATH 18,A04,083746,Staff,26,0,30,4
1650696712233,MATH 18,B01,083748,Staff,0,15,30,30
1650696712233,MATH 18,B02,083749,Staff,0,12,30,30
1650696712233,MATH 18,B03,083750,Staff,0,12,30,30
1650696712233,MATH 18,B04,083751,Staff,0,12,30,30
1650696718260,MATH 20A,A01,083754,Staff,19,0,40,21
1650696724285,MATH 20B,A01,083756,Staff,0,11,30,30
1650696724285,MATH 20B,A02,083757,Staff,0,12,30,30
1650696730310,MATH 20C,A01,083760,Staff,0,16,30,30
1650696730310,MATH 20C,A02,083761,Staff,0,15,30,30
1650696730310,MATH 20C,B01,083762,Staff,9,0,30,21
1650696730310,MATH 20C,B02,083763,Staff,28,0,30,2
1650696736335,MATH 20D,A01,083765,Staff,2,1,30,28
1650696736335,MATH 20D,A02,083766,Staff,6,0,30,24
1650696736335,MATH 20D,A03,083767,Staff,24,0,30,6
1650696742358,MATH 20E,A01,083771,Staff,3,0,30,27
1650696742358,MATH 20E,A02,083772,Staff,16,0,30,14
1650696742358,MATH 20E,B01,083773,Staff,0,0,30,30
1650696742358,MATH 20E,B02,083774,Staff,7,0,30,23
1650696748387,MATH 103A,A01,083777,Staff,0,15,30,30
1650696748387,MATH 103A,A02,083778,Staff,0,15,30,30
1650696748387,MATH 103A,B01,083779,Staff,0,15,30,30
1650696748387,MATH 103A,B02,083780,Staff,0,15,30,30
1650696754415,MATH 105,A01,085443,Staff,0,22,30,30
1650696760441,MATH 109,A01,083213,Anzaldo; Leesa B,0,7,30,30
1650696760441,MATH 109,A02,083214,Anzaldo; Leesa B,0,7,30,30
1650696760441,MATH 109,B01,083215,Anzaldo; Leesa B,0,8,30,30
1650696760441,MATH 109,B02,083216,Anzaldo; Leesa B,0,6,30,30
1650696766467,MATH 142A,A01,083219,Chow; Bennett,0,16,30,30
1650696766467,MATH 142A,A02,083220,Chow; Bennett,0,15,30,30
1650696766467,MATH 142A,B01,083221,Chow; Bennett,0,15,30,30
1650696766467,MATH 142A,B02,083222,Chow; Bennett,0,14,30,30
1650696772500,MATH 193A,A01,083224,Staff,0,5,30,30
1650696772500,MATH 193A,A02,083225,Staff,0,6,30,30
1650696772500,MATH 193A,A03,083781,Staff,0,6,30,30
1650696772500,MATH 193A,A04,083782,Staff,0,7,30,30
1650696778527,MATH 197,001,091859,McAuley; Julian John,9998,0,9999,1
1650696784582,COGS 9,A01,083615,Staff,1,15,60,59
1650696790614,COGS 11,A01,083617,Boyle; Mary E. T.,16,0,40,24
1650696796644,COGS 13,A01,083071,Staff,0,38,40,40
1650696802667,COGS 14A,A01,092681,Staff,0,35,100,100
1650696808700,COGS 14B,A01,083073,Cheng; Tzu-Han,1,13,50,49
1650696814728,COGS 17,A01,092677,Staff,13,0,75,62
1650696820755,COGS 100,A01,083619,Staff,0,28,60,60
1650696826779,COGS 101A,A01,083621,Davis; Joshua Daniel,0,27,60,60
1650696832805,COGS 101B,A01,091572,Staff,0,4,60,60
1650696838829,COGS 101C,A01,083625,Delgado; Tania,14,0,30,16
1650696844852,COGS 107A,A01,083627,Boyle; Mary E. T.,0,16,60,60
1650696850879,COGS 118A,A01,083075,Staff,0,7,60,60
1650696856906,CSE 3,A50,083646,Miranda; Gregory Joseph,18,0,38,20
1650696856906,CSE 3,A51,083647,Miranda; Gregory Joseph,36,0,37,1
1650696862929,CSE 8A,A50,083650,Miranda; Gregory Joseph,0,31,40,40
1650696868956,CSE 11,A01,083080,Cao; Yingjun,0,96,40,40
1650696874980,CSE 12,A01,083652,Staff,0,21,100,100
1650696881002,CSE 15L,A01,083654,Staff,0,3,50,50
1650696881002,CSE 15L,A02,083655,Staff,0,2,50,50
1650696887024,CSE 20,A01,083657,Staff,49,0,80,31
1650696893051,CSE 30,A01,083084,Eldon; John,0,77,40,40
1650696899073,CSE 100,A01,083659,Cao; Yingjun,0,70,50,50
1650696905097,CSE 134B,A01,083661,Powell; Thomas Allan,0,38,65,65
1650696911121,CSE 140,A01,083663,Staff,0,10,75,75
1650696917144,CSE 140L,A01,083088,Eldon; John,0,19,75,75
1650696923172,CSE 175,A01,083665,Kumar; Rakesh,7,0,25,18
1650696929206,CSE 190,A00,092507,Dubnov; Shlomo,10,0,20,10
1650696935232,ECE 45,A01,083139,Staff,0,2,60,60
1650696941256,ECE 65,A50,083695,Staff,0,5,30,30
1650696947288,ECE 109,A01,091882,Touri; Behrouz,33,0,70,37
1650696953318,ECE 180,A00,083140,Abi Samra; Nicholas Camill,20,0,30,10
1650696953318,ECE 180,B00,083141,Abi Samra; Nicholas Camill,0,0,30,30
1650696959346,MATH 10A,A01,083735,Patchell; Gregory David,2,0,30,28
1650696959346,MATH 10A,A02,083736,Patchell; Gregory David,27,0,30,3
1650696959346,MATH 10A,A03,083737,Patchell; Gregory David,24,0,30,6
1650696965389,MATH 10B,A01,083207,Staff,0,9,30,30
1650696965389,MATH 10B,A02,083208,Staff,1,7,30,29
1650696965389,MATH 10B,B01,083739,Staff,11,0,30,19
1650696965389,MATH 10B,B02,083740,Staff,28,0,30,2
1650696971422,MATH 18,A01,083743,Staff,0,0,30,30
1650696971422,MATH 18,A02,083744,Staff,23,0,30,7
1650696971422,MATH 18,A03,083745,Staff,21,0,30,9
1650696971422,MATH 18,A04,083746,Staff,26,0,30,4
1650696971422,MATH 18,B01,083748,Staff,0,15,30,30
1650696971422,MATH 18,B02,083749,Staff,0,12,30,30
1650696971422,MATH 18,B03,083750,Staff,0,12,30,30
1650696971422,MATH 18,B04,083751,Staff,0,12,30,30
1650696977449,MATH 20A,A01,083754,Staff,19,0,40,21
1650696983477,MATH 20B,A01,083756,Staff,0,11,30,30
1650696983477,MATH 20B,A02,083757,Staff,0,12,30,30
1650696989504,MATH 20C,A01,083760,Staff,0,16,30,30
1650696989504,MATH 20C,A02,083761,Staff,0,15,30,30
1650696989504,MATH 20C,B01,083762,Staff,9,0,30,21
1650696989504,MATH 20C,B02,083763,Staff,28,0,30,2
1650696995538,MATH 20D,A01,083765,Staff,2,1,30,28
1650696995538,MATH 20D,A02,083766,Staff,6,0,30,24
1650696995538,MATH 20D,A03,083767,Staff,24,0,30,6
1650697001563,MATH 20E,A01,083771,Staff,3,0,30,27
1650697001563,MATH 20E,A02,083772,Staff,16,0,30,14
1650697001563,MATH 20E,B01,083773,Staff,0,0,30,30
1650697001563,MATH 20E,B02,083774,Staff,6,0,30,24
1650697007587,MATH 103A,A01,083777,Staff,0,15,30,30
1650697007587,MATH 103A,A02,083778,Staff,0,15,30,30
1650697007587,MATH 103A,B01,083779,Staff,0,15,30,30
1650697007587,MATH 103A,B02,083780,Staff,0,15,30,30
1650697013621,MATH 105,A01,085443,Staff,0,22,30,30
1650697019645,MATH 109,A01,083213,Anzaldo; Leesa B,0,7,30,30
1650697019645,MATH 109,A02,083214,Anzaldo; Leesa B,0,7,30,30
1650697019645,MATH 109,B01,083215,Anzaldo; Leesa B,0,8,30,30
1650697019645,MATH 109,B02,083216,Anzaldo; Leesa B,0,6,30,30
1650697025675,MATH 142A,A01,083219,Chow; Bennett,0,16,30,30
1650697025675,MATH 142A,A02,083220,Chow; Bennett,0,15,30,30
1650697025675,MATH 142A,B01,083221,Chow; Bennett,0,15,30,30
1650697025675,MATH 142A,B02,083222,Chow; Bennett,0,14,30,30
1650697031703,MATH 193A,A01,083224,Staff,0,5,30,30
1650697031703,MATH 193A,A02,083225,Staff,0,6,30,30
1650697031703,MATH 193A,A03,083781,Staff,0,6,30,30
1650697031703,MATH 193A,A04,083782,Staff,0,7,30,30
1650697037740,MATH 197,001,091859,McAuley; Julian John,9998,0,9999,1
1650697043811,COGS 9,A01,083615,Staff,1,15,60,59
1650697049836,COGS 11,A01,083617,Boyle; Mary E. T.,16,0,40,24
1650697055859,COGS 13,A01,083071,Staff,0,38,40,40
1650697061887,COGS 14A,A01,092681,Staff,0,35,100,100
1650697067910,COGS 14B,A01,083073,Cheng; Tzu-Han,1,13,50,49
1650697073943,COGS 17,A01,092677,Staff,13,0,75,62
1650697079970,COGS 100,A01,083619,Staff,0,28,60,60
1650697085997,COGS 101A,A01,083621,Davis; Joshua Daniel,0,27,60,60
1650697092028,COGS 101B,A01,091572,Staff,0,4,60,60
1650697098053,COGS 101C,A01,083625,Delgado; Tania,14,0,30,16
1650697104080,COGS 107A,A01,083627,Boyle; Mary E. T.,0,16,60,60
1650697110104,COGS 118A,A01,083075,Staff,0,7,60,60
1650697116129,CSE 3,A50,083646,Miranda; Gregory Joseph,18,0,38,20
1650697116129,CSE 3,A51,083647,Miranda; Gregory Joseph,36,0,37,1
1650697122171,CSE 8A,A50,083650,Miranda; Gregory Joseph,0,31,40,40
1650697128197,CSE 11,A01,083080,Cao; Yingjun,0,96,40,40
1650697134221,CSE 12,A01,083652,Staff,0,21,100,100
1650697140250,CSE 15L,A01,083654,Staff,0,3,50,50
1650697140250,CSE 15L,A02,083655,Staff,0,2,50,50
1650697146275,CSE 20,A01,083657,Staff,49,0,80,31
1650697152298,CSE 30,A01,083084,Eldon; John,0,77,40,40
1650697158322,CSE 100,A01,083659,Cao; Yingjun,0,70,50,50
1650697164350,CSE 134B,A01,083661,Powell; Thomas Allan,0,38,65,65
1650697170372,CSE 140,A01,083663,Staff,0,10,75,75
1650697176398,CSE 140L,A01,083088,Eldon; John,0,19,75,75
1650697182423,CSE 175,A01,083665,Kumar; Rakesh,7,0,25,18
1650697188447,CSE 190,A00,092507,Dubnov; Shlomo,10,0,20,10
1650697194470,ECE 45,A01,083139,Staff,0,2,60,60
1650697200494,ECE 65,A50,083695,Staff,0,5,30,30
1650697206517,ECE 109,A01,091882,Touri; Behrouz,33,0,70,37
1650697212540,ECE 180,A00,083140,Abi Samra; Nicholas Camill,20,0,30,10
1650697212540,ECE 180,B00,083141,Abi Samra; Nicholas Camill,0,0,30,30
1650697218569,MATH 10A,A01,083735,Patchell; Gregory David,2,0,30,28
1650697218569,MATH 10A,A02,083736,Patchell; Gregory David,27,0,30,3
1650697218569,MATH 10A,A03,083737,Patchell; Gregory David,24,0,30,6
1650697224605,MATH 10B,A01,083207,Staff,0,9,30,30
1650697224605,MATH 10B,A02,083208,Staff,1,7,30,29
1650697224605,MATH 10B,B01,083739,Staff,11,0,30,19
1650697224605,MATH 10B,B02,083740,Staff,28,0,30,2
1650697230636,MATH 18,A01,083743,Staff,0,0,30,30
1650697230636,MATH 18,A02,083744,Staff,23,0,30,7
1650697230636,MATH 18,A03,083745,Staff,21,0,30,9
1650697230636,MATH 18,A04,083746,Staff,26,0,30,4
1650697230636,MATH 18,B01,083748,Staff,0,15,30,30
1650697230636,MATH 18,B02,083749,Staff,0,12,30,30
1650697230636,MATH 18,B03,083750,Staff,0,12,30,30
1650697230636,MATH 18,B04,083751,Staff,0,12,30,30
1650697236662,MATH 20A,A01,083754,Staff,19,0,40,21
1650697242689,MATH 20B,A01,083756,Staff,0,11,30,30
1650697242689,MATH 20B,A02,083757,Staff,0,12,30,30
1650697248812,MATH 20C,A01,083760,Staff,0,16,30,30
1650697248812,MATH 20C,A02,083761,Staff,0,15,30,30
1650697248812,MATH 20C,B01,083762,Staff,9,0,30,21
1650697248812,MATH 20C,B02,083763,Staff,28,0,30,2
1650697254834,MATH 20D,A01,083765,Staff,2,1,30,28
1650697254834,MATH 20D,A02,083766,Staff,6,0,30,24
1650697254834,MATH 20D,A03,083767,Staff,24,0,30,6
1650697260887,MATH 20E,A01,083771,Staff,3,0,30,27
1650697260887,MATH 20E,A02,083772,Staff,16,0,30,14
1650697260887,MATH 20E,B01,083773,Staff,0,0,30,30
1650697260887,MATH 20E,B02,083774,Staff,6,0,30,24
1650697266917,MATH 103A,A01,083777,Staff,0,15,30,30
1650697266917,MATH 103A,A02,083778,Staff,0,15,30,30
1650697266917,MATH 103A,B01,083779,Staff,0,15,30,30
1650697266917,MATH 103A,B02,083780,Staff,0,15,30,30
1650697272943,MATH 105,A01,085443,Staff,0,22,30,30
1650697278968,MATH 109,A01,083213,Anzaldo; Leesa B,0,7,30,30
1650697278968,MATH 109,A02,083214,Anzaldo; Leesa B,0,7,30,30
1650697278968,MATH 109,B01,083215,Anzaldo; Leesa B,0,8,30,30
1650697278968,MATH 109,B02,083216,Anzaldo; Leesa B,0,6,30,30
1650697285005,MATH 142A,A01,083219,Chow; Bennett,0,16,30,30
1650697285005,MATH 142A,A02,083220,Chow; Bennett,0,15,30,30
1650697285005,MATH 142A,B01,083221,Chow; Bennett,0,15,30,30
1650697285005,MATH 142A,B02,083222,Chow; Bennett,0,14,30,30
1650697291035,MATH 193A,A01,083224,Staff,0,5,30,30
1650697291035,MATH 193A,A02,083225,Staff,0,6,30,30
1650697291035,MATH 193A,A03,083781,Staff,0,6,30,30
1650697291035,MATH 193A,A04,083782,Staff,0,7,30,30
1650697297064,MATH 197,001,091859,McAuley; Julian John,9998,0,9999,1
1650697303120,COGS 9,A01,083615,Staff,1,15,60,59
1650697309143,COGS 11,A01,083617,Boyle; Mary E. T.,16,0,40,24
1650697315167,COGS 13,A01,083071,Staff,0,38,40,40
1650697321191,COGS 14A,A01,092681,Staff,0,35,100,100
1650697327224,COGS 14B,A01,083073,Cheng; Tzu-Han,1,13,50,49
1650697333259,COGS 17,A01,092677,Staff,13,0,75,62
1650697339292,COGS 100,A01,083619,Staff,0,28,60,60
1650697345316,COGS 101A,A01,083621,Davis; Joshua Daniel,0,27,60,60
1650697351340,COGS 101B,A01,091572,Staff,0,4,60,60
1650697357364,COGS 101C,A01,083625,Delgado; Tania,14,0,30,16
1650697363386,COGS 107A,A01,083627,Boyle; Mary E. T.,0,16,60,60
1650697369410,COGS 118A,A01,083075,Staff,0,7,60,60
1650697375440,CSE 3,A50,083646,Miranda; Gregory Joseph,18,0,38,20
1650697375440,CSE 3,A51,083647,Miranda; Gregory Joseph,36,0,37,1
1650697381470,CSE 8A,A50,083650,Miranda; Gregory Joseph,0,31,40,40
1650697387492,CSE 11,A01,083080,Cao; Yingjun,0,96,40,40
1650697393523,CSE 12,A01,083652,Staff,0,21,100,100
1650697399548,CSE 15L,A01,083654,Staff,0,3,50,50
1650697399548,CSE 15L,A02,083655,Staff,0,2,50,50
1650697405580,CSE 20,A01,083657,Staff,49,0,80,31
1650697411605,CSE 30,A01,083084,Eldon; John,0,77,40,40
1650697417631,CSE 100,A01,083659,Cao; Yingjun,0,70,50,50
1650697423669,CSE 134B,A01,083661,Powell; Thomas Allan,0,38,65,65
1650697429694,CSE 140,A01,083663,Staff,0,10,75,75
1650697435718,CSE 140L,A01,083088,Eldon; John,0,19,75,75
1650697441746,CSE 175,A01,083665,Kumar; Rakesh,7,0,25,18
1650697447775,CSE 190,A00,092507,Dubnov; Shlomo,10,0,20,10
1650697453811,ECE 45,A01,083139,Staff,0,2,60,60
1650697459833,ECE 65,A50,083695,Staff,0,5,30,30
1650697465864,ECE 109,A01,091882,Touri; Behrouz,33,0,70,37
1650697471888,ECE 180,A00,083140,Abi Samra; Nicholas Camill,20,0,30,10
1650697471888,ECE 180,B00,083141,Abi Samra; Nicholas Camill,0,0,30,30
1650697477913,MATH 10A,A01,083735,Patchell; Gregory David,2,0,30,28
1650697477913,MATH 10A,A02,083736,Patchell; Gregory David,27,0,30,3
1650697477913,MATH 10A,A03,083737,Patchell; Gregory David,24,0,30,6
1650697483936,MATH 10B,A01,083207,Staff,0,9,30,30
1650697483936,MATH 10B,A02,083208,Staff,1,7,30,29
1650697483936,MATH 10B,B01,083739,Staff,11,0,30,19
1650697483936,MATH 10B,B02,083740,Staff,28,0,30,2
1650697489961,MATH 18,A01,083743,Staff,0,0,30,30
1650697489961,MATH 18,A02,083744,Staff,23,0,30,7
1650697489961,MATH 18,A03,083745,Staff,21,0,30,9
1650697489961,MATH 18,A04,083746,Staff,26,0,30,4
1650697489961,MATH 18,B01,083748,Staff,0,15,30,30
1650697489961,MATH 18,B02,083749,Staff,0,12,30,30
1650697489961,MATH 18,B03,083750,Staff,0,12,30,30
1650697489961,MATH 18,B04,083751,Staff,0,12,30,30
1650697495986,MATH 20A,A01,083754,Staff,19,0,40,21
1650697502015,MATH 20B,A01,083756,Staff,0,11,30,30
1650697502015,MATH 20B,A02,083757,Staff,0,12,30,30
1650697508040,MATH 20C,A01,083760,Staff,0,16,30,30
1650697508040,MATH 20C,A02,083761,Staff,0,15,30,30
1650697508040,MATH 20C,B01,083762,Staff,9,0,30,21
1650697508040,MATH 20C,B02,083763,Staff,28,0,30,2
1650697514064,MATH 20D,A01,083765,Staff,2,1,30,28
1650697514064,MATH 20D,A02,083766,Staff,6,0,30,24
1650697514064,MATH 20D,A03,083767,Staff,24,0,30,6
1650697520088,MATH 20E,A01,083771,Staff,3,0,30,27
1650697520088,MATH 20E,A02,083772,Staff,16,0,30,14
1650697520088,MATH 20E,B01,083773,Staff,0,0,30,30
1650697520088,MATH 20E,B02,083774,Staff,6,0,30,24
1650697526112,MATH 103A,A01,083777,Staff,0,15,30,30
1650697526112,MATH 103A,A02,083778,Staff,0,15,30,30
1650697526112,MATH 103A,B01,083779,Staff,0,15,30,30
1650697526112,MATH 103A,B02,083780,Staff,0,15,30,30
1650697532139,MATH 105,A01,085443,Staff,0,22,30,30
1650697538165,MATH 109,A01,083213,Anzaldo; Leesa B,0,7,30,30
1650697538165,MATH 109,A02,083214,Anzaldo; Leesa B,0,7,30,30
1650697538165,MATH 109,B01,083215,Anzaldo; Leesa B,0,8,30,30
1650697538165,MATH 109,B02,083216,Anzaldo; Leesa B,0,6,30,30
1650697544195,MATH 142A,A01,083219,Chow; Bennett,0,16,30,30
1650697544195,MATH 142A,A02,083220,Chow; Bennett,0,15,30,30
1650697544195,MATH 142A,B01,083221,Chow; Bennett,0,15,30,30
1650697544195,MATH 142A,B02,083222,Chow; Bennett,0,14,30,30
1650697550220,MATH 193A,A01,083224,Staff,0,5,30,30
1650697550220,MATH 193A,A02,083225,Staff,0,6,30,30
1650697550220,MATH 193A,A03,083781,Staff,0,6,30,30
1650697550220,MATH 193A,A04,083782,Staff,0,7,30,30
1650697556249,MATH 197,001,091859,McAuley; Julian John,9998,0,9999,1
1650697562305,COGS 9,A01,083615,Staff,1,15,60,59
1650697568329,COGS 11,A01,083617,Boyle; Mary E. T.,16,0,40,24
1650697574372,COGS 13,A01,083071,Staff,0,38,40,40
1650697580405,COGS 14A,A01,092681,Staff,0,35,100,100
1650697586431,COGS 14B,A01,083073,Cheng; Tzu-Han,1,13,50,49
1650697592457,COGS 17,A01,092677,Staff,13,0,75,62
1650697598481,COGS 100,A01,083619,Staff,0,28,60,60
1650697604508,COGS 101A,A01,083621,Davis; Joshua Daniel,0,27,60,60
1650697610534,COGS 101B,A01,091572,Staff,0,4,60,60
1650697616559,COGS 101C,A01,083625,Delgado; Tania,14,0,30,16
1650697622587,COGS 107A,A01,083627,Boyle; Mary E. T.,0,16,60,60
1650697628609,COGS 118A,A01,083075,Staff,0,7,60,60
1650697634632,CSE 3,A50,083646,Miranda; Gregory Joseph,18,0,38,20
1650697634632,CSE 3,A51,083647,Miranda; Gregory Joseph,36,0,37,1
1650697640657,CSE 8A,A50,083650,Miranda; Gregory Joseph,0,31,40,40
1650697646681,CSE 11,A01,083080,Cao; Yingjun,0,96,40,40
1650697652706,CSE 12,A01,083652,Staff,0,21,100,100
1650697658733,CSE 15L,A01,083654,Staff,0,3,50,50
1650697658733,CSE 15L,A02,083655,Staff,0,2,50,50
1650697664768,CSE 20,A01,083657,Staff,49,0,80,31
1650697670791,CSE 30,A01,083084,Eldon; John,0,77,40,40
1650697676816,CSE 100,A01,083659,Cao; Yingjun,0,70,50,50
1650697682840,CSE 134B,A01,083661,Powell; Thomas Allan,0,38,65,65
1650697688864,CSE 140,A01,083663,Staff,0,10,75,75
1650697694889,CSE 140L,A01,083088,Eldon; John,0,19,75,75
1650697700912,CSE 175,A01,083665,Kumar; Rakesh,7,0,25,18
1650697706940,CSE 190,A00,092507,Dubnov; Shlomo,10,0,20,10
1650697712963,ECE 45,A01,083139,Staff,0,2,60,60
1650697718988,ECE 65,A50,083695,Staff,0,5,30,30
1650697725013,ECE 109,A01,091882,Touri; Behrouz,33,0,70,37
1650697731037,ECE 180,A00,083140,Abi Samra; Nicholas Camill,20,0,30,10
1650697731037,ECE 180,B00,083141,Abi Samra; Nicholas Camill,0,0,30,30
1650697737070,MATH 10A,A01,083735,Patchell; Gregory David,2,0,30,28
1650697737070,MATH 10A,A02,083736,Patchell; Gregory David,27,0,30,3
1650697737070,MATH 10A,A03,083737,Patchell; Gregory David,24,0,30,6
1650697743099,MATH 10B,A01,083207,Staff,0,9,30,30
1650697743099,MATH 10B,A02,083208,Staff,1,7,30,29
1650697743099,MATH 10B,B01,083739,Staff,11,0,30,19
1650697743099,MATH 10B,B02,083740,Staff,28,0,30,2
1650697749127,MATH 18,A01,083743,Staff,0,0,30,30
1650697749127,MATH 18,A02,083744,Staff,23,0,30,7
1650697749127,MATH 18,A03,083745,Staff,21,0,30,9
1650697749127,MATH 18,A04,083746,Staff,26,0,30,4
1650697749127,MATH 18,B01,083748,Staff,0,15,30,30
1650697749127,MATH 18,B02,083749,Staff,0,12,30,30
1650697749127,MATH 18,B03,083750,Staff,0,12,30,30
1650697749127,MATH 18,B04,083751,Staff,0,12,30,30
1650697755163,MATH 20A,A01,083754,Staff,19,0,40,21
1650697761192,MATH 20B,A01,083756,Staff,0,11,30,30
1650697761192,MATH 20B,A02,083757,Staff,0,12,30,30
1650697767215,MATH 20C,A01,083760,Staff,0,16,30,30
1650697767215,MATH 20C,A02,083761,Staff,0,15,30,30
1650697767215,MATH 20C,B01,083762,Staff,9,0,30,21
1650697767215,MATH 20C,B02,083763,Staff,28,0,30,2
1650697773239,MATH 20D,A01,083765,Staff,2,1,30,28
1650697773239,MATH 20D,A02,083766,Staff,6,0,30,24
1650697773239,MATH 20D,A03,083767,Staff,24,0,30,6
1650697779265,MATH 20E,A01,083771,Staff,3,0,30,27
1650697779265,MATH 20E,A02,083772,Staff,16,0,30,14
1650697779265,MATH 20E,B01,083773,Staff,0,0,30,30
1650697779265,MATH 20E,B02,083774,Staff,6,0,30,24
1650697785296,MATH 103A,A01,083777,Staff,0,15,30,30
1650697785296,MATH 103A,A02,083778,Staff,0,15,30,30
1650697785296,MATH 103A,B01,083779,Staff,0,15,30,30
1650697785296,MATH 103A,B02,083780,Staff,0,15,30,30
1650697791325,MATH 105,A01,085443,Staff,0,22,30,30
1650697797348,MATH 109,A01,083213,Anzaldo; Leesa B,0,7,30,30
1650697797348,MATH 109,A02,083214,Anzaldo; Leesa B,0,7,30,30
1650697797348,MATH 109,B01,083215,Anzaldo; Leesa B,0,8,30,30
1650697797348,MATH 109,B02,083216,Anzaldo; Leesa B,0,6,30,30
1650697803372,MATH 142A,A01,083219,Chow; Bennett,0,16,30,30
1650697803372,MATH 142A,A02,083220,Chow; Bennett,0,15,30,30
1650697803372,MATH 142A,B01,083221,Chow; Bennett,0,15,30,30
1650697803372,MATH 142A,B02,083222,Chow; Bennett,0,14,30,30
1650697809408,MATH 193A,A01,083224,Staff,0,5,30,30
1650697809408,MATH 193A,A02,083225,Staff,0,6,30,30
1650697809408,MATH 193A,A03,083781,Staff,0,6,30,30
1650697809408,MATH 193A,A04,083782,Staff,0,7,30,30
1650697815434,MATH 197,001,091859,McAuley; Julian John,9998,0,9999,1
1650697821495,COGS 9,A01,083615,Staff,1,15,60,59
1650697827516,COGS 11,A01,083617,Boyle; Mary E. T.,16,0,40,24
1650697833540,COGS 13,A01,083071,Staff,0,38,40,40
1650697839657,COGS 14A,A01,092681,Staff,0,35,100,100
1650697845679,COGS 14B,A01,083073,Cheng; Tzu-Han,1,13,50,49
1650697851706,COGS 17,A01,092677,Staff,13,0,75,62
1650697857730,COGS 100,A01,083619,Staff,0,28,60,60
1650697863763,COGS 101A,A01,083621,Davis; Joshua Daniel,0,27,60,60
1650697869789,COGS 101B,A01,091572,Staff,0,4,60,60
1650697875815,COGS 101C,A01,083625,Delgado; Tania,14,0,30,16
1650697881840,COGS 107A,A01,083627,Boyle; Mary E. T.,0,16,60,60
1650697887865,COGS 118A,A01,083075,Staff,0,8,60,60
1650697893889,CSE 3,A50,083646,Miranda; Gregory Joseph,18,0,38,20
1650697893889,CSE 3,A51,083647,Miranda; Gregory Joseph,36,0,37,1
1650697899915,CSE 8A,A50,083650,Miranda; Gregory Joseph,0,31,40,40
1650697905940,CSE 11,A01,083080,Cao; Yingjun,0,96,40,40
1650697911970,CSE 12,A01,083652,Staff,0,21,100,100
1650697917995,CSE 15L,A01,083654,Staff,0,3,50,50
1650697917995,CSE 15L,A02,083655,Staff,0,2,50,50
1650697924021,CSE 20,A01,083657,Staff,49,0,80,31
1650697930070,CSE 30,A01,083084,Eldon; John,0,77,40,40
1650697936096,CSE 100,A01,083659,Cao; Yingjun,0,70,50,50
1650697942131,CSE 134B,A01,083661,Powell; Thomas Allan,0,38,65,65
1650697948230,CSE 140,A01,083663,Staff,0,10,75,75
1650697954259,CSE 140L,A01,083088,Eldon; John,0,19,75,75
1650697960283,CSE 175,A01,083665,Kumar; Rakesh,7,0,25,18
1650697966308,CSE 190,A00,092507,Dubnov; Shlomo,10,0,20,10
1650697972343,ECE 45,A01,083139,Staff,0,2,60,60
1650697978372,ECE 65,A50,083695,Staff,0,5,30,30
1650697984396,ECE 109,A01,091882,Touri; Behrouz,33,0,70,37
1650697990420,ECE 180,A00,083140,Abi Samra; Nicholas Camill,20,0,30,10
1650697990420,ECE 180,B00,083141,Abi Samra; Nicholas Camill,0,0,30,30
1650697996450,MATH 10A,A01,083735,Patchell; Gregory David,2,0,30,28
1650697996450,MATH 10A,A02,083736,Patchell; Gregory David,27,0,30,3
1650697996450,MATH 10A,A03,083737,Patchell; Gregory David,24,0,30,6
1650698002476,MATH 10B,A01,083207,Staff,0,9,30,30
1650698002476,MATH 10B,A02,083208,Staff,1,7,30,29
1650698002476,MATH 10B,B01,083739,Staff,11,0,30,19
1650698002476,MATH 10B,B02,083740,Staff,28,0,30,2
1650698008511,MATH 18,A01,083743,Staff,0,0,30,30
1650698008511,MATH 18,A02,083744,Staff,23,0,30,7
1650698008511,MATH 18,A03,083745,Staff,21,0,30,9
1650698008511,MATH 18,A04,083746,Staff,26,0,30,4
1650698008511,MATH 18,B01,083748,Staff,0,15,30,30
1650698008511,MATH 18,B02,083749,Staff,0,12,30,30
1650698008511,MATH 18,B03,083750,Staff,0,12,30,30
1650698008511,MATH 18,B04,083751,Staff,0,12,30,30
1650698014542,MATH 20A,A01,083754,Staff,19,0,40,21
1650698020567,MATH 20B,A01,083756,Staff,0,11,30,30
1650698020567,MATH 20B,A02,083757,Staff,0,12,30,30
1650698026600,MATH 20C,A01,083760,Staff,0,16,30,30
1650698026600,MATH 20C,A02,083761,Staff,0,15,30,30
1650698026600,MATH 20C,B01,083762,Staff,9,0,30,21
1650698026600,MATH 20C,B02,083763,Staff,28,0,30,2
1650698032634,MATH 20D,A01,083765,Staff,2,1,30,28
1650698032634,MATH 20D,A02,083766,Staff,6,0,30,24
1650698032634,MATH 20D,A03,083767,Staff,24,0,30,6
1650698038667,MATH 20E,A01,083771,Staff,3,0,30,27
1650698038667,MATH 20E,A02,083772,Staff,16,0,30,14
1650698038667,MATH 20E,B01,083773,Staff,0,0,30,30
1650698038667,MATH 20E,B02,083774,Staff,6,0,30,24
1650698044696,MATH 103A,A01,083777,Staff,0,15,30,30
1650698044696,MATH 103A,A02,083778,Staff,0,15,30,30
1650698044696,MATH 103A,B01,083779,Staff,0,15,30,30
1650698044696,MATH 103A,B02,083780,Staff,0,15,30,30
1650698050727,MATH 105,A01,085443,Staff,0,22,30,30
1650698056758,MATH 109,A01,083213,Anzaldo; Leesa B,0,7,30,30
1650698056758,MATH 109,A02,083214,Anzaldo; Leesa B,0,7,30,30
1650698056758,MATH 109,B01,083215,Anzaldo; Leesa B,0,8,30,30
1650698056758,MATH 109,B02,083216,Anzaldo; Leesa B,0,6,30,30
1650698062782,MATH 142A,A01,083219,Chow; Bennett,0,16,30,30
1650698062782,MATH 142A,A02,083220,Chow; Bennett,0,15,30,30
1650698062782,MATH 142A,B01,083221,Chow; Bennett,0,15,30,30
1650698062782,MATH 142A,B02,083222,Chow; Bennett,0,14,30,30
1650698068814,MATH 193A,A01,083224,Staff,0,5,30,30
1650698068814,MATH 193A,A02,083225,Staff,0,6,30,30
1650698068814,MATH 193A,A03,083781,Staff,0,6,30,30
1650698068814,MATH 193A,A04,083782,Staff,0,7,30,30
1650698074843,MATH 197,001,091859,McAuley; Julian John,9998,0,9999,1
1650698080911,COGS 9,A01,083615,Staff,1,15,60,59
1650698086935,COGS 11,A01,083617,Boyle; Mary E. T.,16,0,40,24
1650698092960,COGS 13,A01,083071,Staff,0,38,40,40
1650698098989,COGS 14A,A01,092681,Staff,0,35,100,100
1650698105012,COGS 14B,A01,083073,Cheng; Tzu-Han,1,13,50,49
1650698111040,COGS 17,A01,092677,Staff,13,0,75,62
1650698117074,COGS 100,A01,083619,Staff,0,28,60,60
1650698123101,COGS 101A,A01,083621,Davis; Joshua Daniel,0,27,60,60
1650698129127,COGS 101B,A01,091572,Staff,0,4,60,60
1650698135152,COGS 101C,A01,083625,Delgado; Tania,14,0,30,16
1650698141176,COGS 107A,A01,083627,Boyle; Mary E. T.,0,16,60,60
1650698147204,COGS 118A,A01,083075,Staff,0,8,60,60
1650698153243,CSE 3,A50,083646,Miranda; Gregory Joseph,18,0,38,20
1650698153243,CSE 3,A51,083647,Miranda; Gregory Joseph,36,0,37,1
1650698159267,CSE 8A,A50,083650,Miranda; Gregory Joseph,0,31,40,40
1650698165292,CSE 11,A01,083080,Cao; Yingjun,0,96,40,40
1650698171322,CSE 12,A01,083652,Staff,0,21,100,100
1650698177346,CSE 15L,A01,083654,Staff,0,3,50,50
1650698177346,CSE 15L,A02,083655,Staff,0,2,50,50
1650698183374,CSE 20,A01,083657,Staff,49,0,80,31
1650698189406,CSE 30,A01,083084,Eldon; John,0,77,40,40
1650698195436,CSE 100,A01,083659,Cao; Yingjun,0,70,50,50
1650698201460,CSE 134B,A01,083661,Powell; Thomas Allan,0,38,65,65
1650698207488,CSE 140,A01,083663,Staff,0,10,75,75
1650698213517,CSE 140L,A01,083088,Eldon; John,0,19,75,75
1650698219544,CSE 175,A01,083665,Kumar; Rakesh,7,0,25,18
1650698225568,CSE 190,A00,092507,Dubnov; Shlomo,10,0,20,10
1650698231591,ECE 45,A01,083139,Staff,0,2,60,60
1650698237616,ECE 65,A50,083695,Staff,0,5,30,30
1650698243645,ECE 109,A01,091882,Touri; Behrouz,33,0,70,37
1650698249669,ECE 180,A00,083140,Abi Samra; Nicholas Camill,20,0,30,10
1650698249669,ECE 180,B00,083141,Abi Samra; Nicholas Camill,0,0,30,30
1650698255693,MATH 10A,A01,083735,Patchell; Gregory David,2,0,30,28
1650698255693,MATH 10A,A02,083736,Patchell; Gregory David,27,0,30,3
1650698255693,MATH 10A,A03,083737,Patchell; Gregory David,24,0,30,6
1650698261722,MATH 10B,A01,083207,Staff,0,9,30,30
1650698261722,MATH 10B,A02,083208,Staff,1,7,30,29
1650698261722,MATH 10B,B01,083739,Staff,11,0,30,19
1650698261722,MATH 10B,B02,083740,Staff,28,0,30,2
1650698267756,MATH 18,A01,083743,Staff,0,0,30,30
1650698267756,MATH 18,A02,083744,Staff,23,0,30,7
1650698267756,MATH 18,A03,083745,Staff,21,0,30,9
1650698267756,MATH 18,A04,083746,Staff,26,0,30,4
1650698267756,MATH 18,B01,083748,Staff,0,15,30,30
1650698267756,MATH 18,B02,083749,Staff,0,12,30,30
1650698267756,MATH 18,B03,083750,Staff,0,12,30,30
1650698267756,MATH 18,B04,083751,Staff,0,12,30,30
1650698273783,MATH 20A,A01,083754,Staff,19,0,40,21
1650698279811,MATH 20B,A01,083756,Staff,0,11,30,30
1650698279811,MATH 20B,A02,083757,Staff,0,12,30,30
1650698285836,MATH 20C,A01,083760,Staff,0,16,30,30
1650698285836,MATH 20C,A02,083761,Staff,0,15,30,30
1650698285836,MATH 20C,B01,083762,Staff,9,0,30,21
1650698285836,MATH 20C,B02,083763,Staff,28,0,30,2
1650698291861,MATH 20D,A01,083765,Staff,2,1,30,28
1650698291861,MATH 20D,A02,083766,Staff,6,0,30,24
1650698291861,MATH 20D,A03,083767,Staff,24,0,30,6
1650698297891,MATH 20E,A01,083771,Staff,3,0,30,27
1650698297891,MATH 20E,A02,083772,Staff,16,0,30,14
1650698297891,MATH 20E,B01,083773,Staff,0,0,30,30
1650698297891,MATH 20E,B02,083774,Staff,6,0,30,24
1650698303920,MATH 103A,A01,083777,Staff,0,15,30,30
1650698303920,MATH 103A,A02,083778,Staff,0,15,30,30
1650698303920,MATH 103A,B01,083779,Staff,0,15,30,30
1650698303920,MATH 103A,B02,083780,Staff,0,15,30,30
1650698309945,MATH 105,A01,085443,Staff,0,22,30,30
1650698315970,MATH 109,A01,083213,Anzaldo; Leesa B,0,7,30,30
1650698315970,MATH 109,A02,083214,Anzaldo; Leesa B,0,7,30,30
1650698315970,MATH 109,B01,083215,Anzaldo; Leesa B,0,8,30,30
1650698315970,MATH 109,B02,083216,Anzaldo; Leesa B,0,6,30,30
1650698322007,MATH 142A,A01,083219,Chow; Bennett,0,16,30,30
1650698322007,MATH 142A,A02,083220,Chow; Bennett,0,15,30,30
1650698322007,MATH 142A,B01,083221,Chow; Bennett,0,15,30,30
1650698322007,MATH 142A,B02,083222,Chow; Bennett,0,14,30,30
1650698328034,MATH 193A,A01,083224,Staff,0,5,30,30
1650698328034,MATH 193A,A02,083225,Staff,0,6,30,30
1650698328034,MATH 193A,A03,083781,Staff,0,6,30,30
1650698328034,MATH 193A,A04,083782,Staff,0,7,30,30
1650698334058,MATH 197,001,091859,McAuley; Julian John,9998,0,9999,1
1650698340119,COGS 9,A01,083615,Staff,1,15,60,59
1650698346144,COGS 11,A01,083617,Boyle; Mary E. T.,16,0,40,24
1650698352168,COGS 13,A01,083071,Staff,0,38,40,40
1650698358196,COGS 14A,A01,092681,Staff,0,35,100,100
1650698364225,COGS 14B,A01,083073,Cheng; Tzu-Han,1,13,50,49
1650698370248,COGS 17,A01,092677,Staff,13,0,75,62
1650698376273,COGS 100,A01,083619,Staff,0,28,60,60
1650698382303,COGS 101A,A01,083621,Davis; Joshua Daniel,0,27,60,60
1650698388327,COGS 101B,A01,091572,Staff,0,4,60,60
1650698394350,COGS 101C,A01,083625,Delgado; Tania,14,0,30,16
1650698400373,COGS 107A,A01,083627,Boyle; Mary E. T.,0,16,60,60
1650698406405,COGS 118A,A01,083075,Staff,0,8,60,60
1650698412428,CSE 3,A50,083646,Miranda; Gregory Joseph,18,0,38,20
1650698412428,CSE 3,A51,083647,Miranda; Gregory Joseph,36,0,37,1
1650698418453,CSE 8A,A50,083650,Miranda; Gregory Joseph,0,31,40,40
1650698424477,CSE 11,A01,083080,Cao; Yingjun,0,96,40,40
1650698430503,CSE 12,A01,083652,Staff,0,21,100,100
1650698436621,CSE 15L,A01,083654,Staff,0,3,50,50
1650698436621,CSE 15L,A02,083655,Staff,0,2,50,50
1650698442643,CSE 20,A01,083657,Staff,49,0,80,31
1650698448672,CSE 30,A01,083084,Eldon; John,0,77,40,40
1650698454696,CSE 100,A01,083659,Cao; Yingjun,0,70,50,50
1650698460722,CSE 134B,A01,083661,Powell; Thomas Allan,0,38,65,65
1650698466748,CSE 140,A01,083663,Staff,0,10,75,75
1650698472778,CSE 140L,A01,083088,Eldon; John,0,19,75,75
1650698478808,CSE 175,A01,083665,Kumar; Rakesh,7,0,25,18
1650698484833,CSE 190,A00,092507,Dubnov; Shlomo,10,0,20,10
1650698490858,ECE 45,A01,083139,Staff,0,2,60,60
1650698496885,ECE 65,A50,083695,Staff,0,5,30,30
1650698502910,ECE 109,A01,091882,Touri; Behrouz,33,0,70,37
1650698508938,ECE 180,A00,083140,Abi Samra; Nicholas Camill,20,0,30,10
1650698508938,ECE 180,B00,083141,Abi Samra; Nicholas Camill,0,0,30,30
1650698514963,MATH 10A,A01,083735,Patchell; Gregory David,2,0,30,28
1650698514963,MATH 10A,A02,083736,Patchell; Gregory David,27,0,30,3
1650698514963,MATH 10A,A03,083737,Patchell; Gregory David,24,0,30,6
1650698520990,MATH 10B,A01,083207,Staff,0,9,30,30
1650698520990,MATH 10B,A02,083208,Staff,1,7,30,29
1650698520990,MATH 10B,B01,083739,Staff,11,0,30,19
1650698520990,MATH 10B,B02,083740,Staff,28,0,30,2
1650698527033,MATH 18,A01,083743,Staff,0,0,30,30
1650698527033,MATH 18,A02,083744,Staff,23,0,30,7
1650698527033,MATH 18,A03,083745,Staff,21,0,30,9
1650698527033,MATH 18,A04,083746,Staff,26,0,30,4
1650698527033,MATH 18,B01,083748,Staff,0,15,30,30
1650698527033,MATH 18,B02,083749,Staff,0,12,30,30
1650698527033,MATH 18,B03,083750,Staff,0,12,30,30
1650698527033,MATH 18,B04,083751,Staff,0,12,30,30
1650698533057,MATH 20A,A01,083754,Staff,19,0,40,21
1650698539083,MATH 20B,A01,083756,Staff,0,11,30,30
1650698539083,MATH 20B,A02,083757,Staff,0,12,30,30
1650698545108,MATH 20C,A01,083760,Staff,0,16,30,30
1650698545108,MATH 20C,A02,083761,Staff,0,15,30,30
1650698545108,MATH 20C,B01,083762,Staff,9,0,30,21
1650698545108,MATH 20C,B02,083763,Staff,28,0,30,2
1650698551135,MATH 20D,A01,083765,Staff,2,1,30,28
1650698551135,MATH 20D,A02,083766,Staff,6,0,30,24
1650698551135,MATH 20D,A03,083767,Staff,24,0,30,6
1650698557161,MATH 20E,A01,083771,Staff,3,0,30,27
1650698557161,MATH 20E,A02,083772,Staff,16,0,30,14
1650698557161,MATH 20E,B01,083773,Staff,0,0,30,30
1650698557161,MATH 20E,B02,083774,Staff,6,0,30,24
1650698563189,MATH 103A,A01,083777,Staff,0,15,30,30
1650698563189,MATH 103A,A02,083778,Staff,0,15,30,30
1650698563189,MATH 103A,B01,083779,Staff,0,15,30,30
1650698563189,MATH 103A,B02,083780,Staff,0,15,30,30
1650698569213,MATH 105,A01,085443,Staff,0,22,30,30
1650698575239,MATH 109,A01,083213,Anzaldo; Leesa B,0,7,30,30
1650698575239,MATH 109,A02,083214,Anzaldo; Leesa B,0,7,30,30
1650698575239,MATH 109,B01,083215,Anzaldo; Leesa B,0,8,30,30
1650698575239,MATH 109,B02,083216,Anzaldo; Leesa B,0,6,30,30
1650698581280,MATH 142A,A01,083219,Chow; Bennett,0,16,30,30
1650698581280,MATH 142A,A02,083220,Chow; Bennett,0,15,30,30
1650698581280,MATH 142A,B01,083221,Chow; Bennett,0,15,30,30
1650698581280,MATH 142A,B02,083222,Chow; Bennett,0,14,30,30
1650698587304,MATH 193A,A01,083224,Staff,0,5,30,30
1650698587304,MATH 193A,A02,083225,Staff,0,6,30,30
1650698587304,MATH 193A,A03,083781,Staff,0,6,30,30
1650698587304,MATH 193A,A04,083782,Staff,0,7,30,30
1650698593328,MATH 197,001,091859,McAuley; Julian John,9998,0,9999,1
1650698599408,COGS 9,A01,083615,Staff,1,15,60,59
1650698605434,COGS 11,A01,083617,Boyle; Mary E. T.,16,0,40,24
1650698611459,COGS 13,A01,083071,Staff,0,38,40,40
1650698617484,COGS 14A,A01,092681,Staff,0,35,100,100
1650698623508,COGS 14B,A01,083073,Cheng; Tzu-Han,1,13,50,49
1650698629531,COGS 17,A01,092677,Staff,13,0,75,62
1650698635559,COGS 100,A01,083619,Staff,0,28,60,60
1650698641586,COGS 101A,A01,083621,Davis; Joshua Daniel,0,27,60,60
1650698647611,COGS 101B,A01,091572,Staff,0,4,60,60
1650698653639,COGS 101C,A01,083625,Delgado; Tania,14,0,30,16
1650698659663,COGS 107A,A01,083627,Boyle; Mary E. T.,0,16,60,60
1650698665687,COGS 118A,A01,083075,Staff,0,8,60,60
1650698671718,CSE 3,A50,083646,Miranda; Gregory Joseph,18,0,38,20
1650698671718,CSE 3,A51,083647,Miranda; Gregory Joseph,36,0,37,1
1650698677747,CSE 8A,A50,083650,Miranda; Gregory Joseph,0,31,40,40
1650698683776,CSE 11,A01,083080,Cao; Yingjun,0,96,40,40
1650698689800,CSE 12,A01,083652,Staff,0,21,100,100
1650698695828,CSE 15L,A01,083654,Staff,0,3,50,50
1650698695828,CSE 15L,A02,083655,Staff,0,2,50,50
1650698701855,CSE 20,A01,083657,Staff,49,0,80,31
1650698707882,CSE 30,A01,083084,Eldon; John,0,77,40,40
1650698713906,CSE 100,A01,083659,Cao; Yingjun,0,70,50,50
1650698719934,CSE 134B,A01,083661,Powell; Thomas Allan,0,38,65,65
1650698725958,CSE 140,A01,083663,Staff,0,10,75,75
1650698731989,CSE 140L,A01,083088,Eldon; John,0,19,75,75
1650698738020,CSE 175,A01,083665,Kumar; Rakesh,7,0,25,18
1650698744044,CSE 190,A00,092507,Dubnov; Shlomo,10,0,20,10
1650698750070,ECE 45,A01,083139,Staff,0,2,60,60
1650698756096,ECE 65,A50,083695,Staff,0,5,30,30
1650698762134,ECE 109,A01,091882,Touri; Behrouz,33,0,70,37
1650698768166,ECE 180,A00,083140,Abi Samra; Nicholas Camill,20,0,30,10
1650698768166,ECE 180,B00,083141,Abi Samra; Nicholas Camill,0,0,30,30
1650698774191,MATH 10A,A01,083735,Patchell; Gregory David,2,0,30,28
1650698774191,MATH 10A,A02,083736,Patchell; Gregory David,27,0,30,3
1650698774191,MATH 10A,A03,083737,Patchell; Gregory David,24,0,30,6
1650698780236,MATH 10B,A01,083207,Staff,0,9,30,30
1650698780236,MATH 10B,A02,083208,Staff,1,7,30,29
1650698780236,MATH 10B,B01,083739,Staff,11,0,30,19
1650698780236,MATH 10B,B02,083740,Staff,28,0,30,2
1650698786267,MATH 18,A01,083743,Staff,0,0,30,30
1650698786267,MATH 18,A02,083744,Staff,23,0,30,7
1650698786267,MATH 18,A03,083745,Staff,21,0,30,9
1650698786267,MATH 18,A04,083746,Staff,26,0,30,4
1650698786267,MATH 18,B01,083748,Staff,0,15,30,30
1650698786267,MATH 18,B02,083749,Staff,0,12,30,30
1650698786267,MATH 18,B03,083750,Staff,0,12,30,30
1650698786267,MATH 18,B04,083751,Staff,0,12,30,30
1650698792302,MATH 20A,A01,083754,Staff,19,0,40,21
1650698798326,MATH 20B,A01,083756,Staff,0,11,30,30
1650698798326,MATH 20B,A02,083757,Staff,0,12,30,30
1650698804352,MATH 20C,A01,083760,Staff,0,16,30,30
1650698804352,MATH 20C,A02,083761,Staff,0,15,30,30
1650698804352,MATH 20C,B01,083762,Staff,9,0,30,21
1650698804352,MATH 20C,B02,083763,Staff,28,0,30,2
1650698810381,MATH 20D,A01,083765,Staff,2,1,30,28
1650698810381,MATH 20D,A02,083766,Staff,6,0,30,24
1650698810381,MATH 20D,A03,083767,Staff,24,0,30,6
1650698816406,MATH 20E,A01,083771,Staff,3,0,30,27
1650698816406,MATH 20E,A02,083772,Staff,16,0,30,14
1650698816406,MATH 20E,B01,083773,Staff,0,0,30,30
1650698816406,MATH 20E,B02,083774,Staff,6,0,30,24
1650698822432,MATH 103A,A01,083777,Staff,0,15,30,30
1650698822432,MATH 103A,A02,083778,Staff,0,15,30,30
1650698822432,MATH 103A,B01,083779,Staff,0,15,30,30
1650698822432,MATH 103A,B02,083780,Staff,0,15,30,30
1650698828467,MATH 105,A01,085443,Staff,0,22,30,30
1650698834492,MATH 109,A01,083213,Anzaldo; Leesa B,0,7,30,30
1650698834492,MATH 109,A02,083214,Anzaldo; Leesa B,0,7,30,30
1650698834492,MATH 109,B01,083215,Anzaldo; Leesa B,0,8,30,30
1650698834492,MATH 109,B02,083216,Anzaldo; Leesa B,0,6,30,30
1650698840516,MATH 142A,A01,083219,Chow; Bennett,0,16,30,30
1650698840516,MATH 142A,A02,083220,Chow; Bennett,0,15,30,30
1650698840516,MATH 142A,B01,083221,Chow; Bennett,0,15,30,30
1650698840516,MATH 142A,B02,083222,Chow; Bennett,0,14,30,30
1650698846544,MATH 193A,A01,083224,Staff,0,5,30,30
1650698846544,MATH 193A,A02,083225,Staff,0,6,30,30
1650698846544,MATH 193A,A03,083781,Staff,0,6,30,30
1650698846544,MATH 193A,A04,083782,Staff,0,7,30,30
1650698852569,MATH 197,001,091859,McAuley; Julian John,9998,0,9999,1
1650698858631,COGS 9,A01,083615,Staff,1,15,60,59
1650698864659,COGS 11,A01,083617,Boyle; Mary E. T.,16,0,40,24
1650698870689,COGS 13,A01,083071,Staff,0,38,40,40
1650698876714,COGS 14A,A01,092681,Staff,0,35,100,100
1650698882751,COGS 14B,A01,083073,Cheng; Tzu-Han,1,13,50,49
1650698888776,COGS 17,A01,092677,Staff,13,0,75,62
1650698894803,COGS 100,A01,083619,Staff,0,28,60,60
1650698900838,COGS 101A,A01,083621,Davis; Joshua Daniel,0,27,60,60
1650698906862,COGS 101B,A01,091572,Staff,0,4,60,60
1650698912886,COGS 101C,A01,083625,Delgado; Tania,14,0,30,16
1650698918913,COGS 107A,A01,083627,Boyle; Mary E. T.,0,16,60,60
1650698924951,COGS 118A,A01,083075,Staff,0,8,60,60
1650698930984,CSE 3,A50,083646,Miranda; Gregory Joseph,18,0,38,20
1650698930984,CSE 3,A51,083647,Miranda; Gregory Joseph,36,0,37,1
1650698937013,CSE 8A,A50,083650,Miranda; Gregory Joseph,0,31,40,40
1650698943039,CSE 11,A01,083080,Cao; Yingjun,0,96,40,40
1650698949065,CSE 12,A01,083652,Staff,0,21,100,100
1650698955089,CSE 15L,A01,083654,Staff,0,3,50,50
1650698955089,CSE 15L,A02,083655,Staff,0,2,50,50
1650698961114,CSE 20,A01,083657,Staff,49,0,80,31
1650698967141,CSE 30,A01,083084,Eldon; John,0,77,40,40
1650698973168,CSE 100,A01,083659,Cao; Yingjun,0,70,50,50
1650698979197,CSE 134B,A01,083661,Powell; Thomas Allan,0,38,65,65
1650698985227,CSE 140,A01,083663,Staff,0,10,75,75
1650698991255,CSE 140L,A01,083088,Eldon; John,0,19,75,75
1650698997279,CSE 175,A01,083665,Kumar; Rakesh,7,0,25,18
1650699003322,CSE 190,A00,092507,Dubnov; Shlomo,10,0,20,10
1650699009346,ECE 45,A01,083139,Staff,0,2,60,60
1650699015370,ECE 65,A50,083695,Staff,0,5,30,30
1650699021402,ECE 109,A01,091882,Touri; Behrouz,33,0,70,37
1650699027429,ECE 180,A00,083140,Abi Samra; Nicholas Camill,20,0,30,10
1650699027429,ECE 180,B00,083141,Abi Samra; Nicholas Camill,0,0,30,30
1650699033542,MATH 10A,A01,083735,Patchell; Gregory David,2,0,30,28
1650699033542,MATH 10A,A02,083736,Patchell; Gregory David,27,0,30,3
1650699033542,MATH 10A,A03,083737,Patchell; Gregory David,24,0,30,6
1650699039570,MATH 10B,A01,083207,Staff,0,9,30,30
1650699039570,MATH 10B,A02,083208,Staff,1,7,30,29
1650699039570,MATH 10B,B01,083739,Staff,11,0,30,19
1650699039570,MATH 10B,B02,083740,Staff,28,0,30,2
1650699045600,MATH 18,A01,083743,Staff,0,0,30,30
1650699045600,MATH 18,A02,083744,Staff,23,0,30,7
1650699045600,MATH 18,A03,083745,Staff,21,0,30,9
1650699045600,MATH 18,A04,083746,Staff,26,0,30,4
1650699045600,MATH 18,B01,083748,Staff,0,15,30,30
1650699045600,MATH 18,B02,083749,Staff,0,12,30,30
1650699045600,MATH 18,B03,083750,Staff,0,12,30,30
1650699045600,MATH 18,B04,083751,Staff,0,12,30,30
1650699051623,MATH 20A,A01,083754,Staff,19,0,40,21
1650699057646,MATH 20B,A01,083756,Staff,0,11,30,30
1650699057646,MATH 20B,A02,083757,Staff,0,12,30,30
1650699063671,MATH 20C,A01,083760,Staff,0,16,30,30
1650699063671,MATH 20C,A02,083761,Staff,0,15,30,30
1650699063671,MATH 20C,B01,083762,Staff,9,0,30,21
1650699063671,MATH 20C,B02,083763,Staff,28,0,30,2
1650699069703,MATH 20D,A01,083765,Staff,2,1,30,28
1650699069703,MATH 20D,A02,083766,Staff,6,0,30,24
1650699069703,MATH 20D,A03,083767,Staff,24,0,30,6
1650699075727,MATH 20E,A01,083771,Staff,3,0,30,27
1650699075727,MATH 20E,A02,083772,Staff,16,0,30,14
1650699075727,MATH 20E,B01,083773,Staff,0,0,30,30
1650699075727,MATH 20E,B02,083774,Staff,6,0,30,24
1650699081750,MATH 103A,A01,083777,Staff,0,15,30,30
1650699081750,MATH 103A,A02,083778,Staff,0,15,30,30
1650699081750,MATH 103A,B01,083779,Staff,0,15,30,30
1650699081750,MATH 103A,B02,083780,Staff,0,15,30,30
1650699087780,MATH 105,A01,085443,Staff,0,22,30,30
1650699093804,MATH 109,A01,083213,Anzaldo; Leesa B,0,7,30,30
1650699093804,MATH 109,A02,083214,Anzaldo; Leesa B,0,7,30,30
1650699093804,MATH 109,B01,083215,Anzaldo; Leesa B,0,8,30,30
1650699093804,MATH 109,B02,083216,Anzaldo; Leesa B,0,6,30,30
1650699099828,MATH 142A,A01,083219,Chow; Bennett,0,16,30,30
1650699099828,MATH 142A,A02,083220,Chow; Bennett,0,15,30,30
1650699099828,MATH 142A,B01,083221,Chow; Bennett,0,15,30,30
1650699099828,MATH 142A,B02,083222,Chow; Bennett,0,14,30,30
1650699105852,MATH 193A,A01,083224,Staff,0,5,30,30
1650699105852,MATH 193A,A02,083225,Staff,0,6,30,30
1650699105852,MATH 193A,A03,083781,Staff,0,6,30,30
1650699105852,MATH 193A,A04,083782,Staff,0,7,30,30
1650699111875,MATH 197,001,091859,McAuley; Julian John,9998,0,9999,1
1650699117984,COGS 9,A01,083615,Staff,1,15,60,59
1650699124017,COGS 11,A01,083617,Boyle; Mary E. T.,16,0,40,24
1650699130047,COGS 13,A01,083071,Staff,0,38,40,40
1650699136074,COGS 14A,A01,092681,Staff,0,35,100,100
1650699142097,COGS 14B,A01,083073,Cheng; Tzu-Han,1,13,50,49
1650699148126,COGS 17,A01,092677,Staff,13,0,75,62
1650699154151,COGS 100,A01,083619,Staff,0,28,60,60
1650699160189,COGS 101A,A01,083621,Davis; Joshua Daniel,0,27,60,60
1650699166216,COGS 101B,A01,091572,Staff,0,4,60,60
1650699172243,COGS 101C,A01,083625,Delgado; Tania,14,0,30,16
1650699178270,COGS 107A,A01,083627,Boyle; Mary E. T.,0,16,60,60
1650699184402,COGS 118A,A01,083075,Staff,0,8,60,60
1650699190434,CSE 3,A50,083646,Miranda; Gregory Joseph,18,0,38,20
1650699190434,CSE 3,A51,083647,Miranda; Gregory Joseph,36,0,37,1
1650699196465,CSE 8A,A50,083650,Miranda; Gregory Joseph,0,31,40,40
1650699202489,CSE 11,A01,083080,Cao; Yingjun,0,96,40,40
1650699208522,CSE 12,A01,083652,Staff,0,21,100,100
1650699214564,CSE 15L,A01,083654,Staff,0,3,50,50
1650699214564,CSE 15L,A02,083655,Staff,0,2,50,50
1650699220589,CSE 20,A01,083657,Staff,49,0,80,31
1650699226620,CSE 30,A01,083084,Eldon; John,0,77,40,40
1650699232650,CSE 100,A01,083659,Cao; Yingjun,0,70,50,50
1650699238678,CSE 134B,A01,083661,Powell; Thomas Allan,0,38,65,65
1650699244709,CSE 140,A01,083663,Staff,0,10,75,75
1650699250742,CSE 140L,A01,083088,Eldon; John,0,19,75,75
1650699256771,CSE 175,A01,083665,Kumar; Rakesh,7,0,25,18
1650699262810,CSE 190,A00,092507,Dubnov; Shlomo,10,0,20,10
1650699268833,ECE 45,A01,083139,Staff,0,2,60,60
1650699274861,ECE 65,A50,083695,Staff,0,5,30,30
1650699280890,ECE 109,A01,091882,Touri; Behrouz,33,0,70,37
1650699286920,ECE 180,A00,083140,Abi Samra; Nicholas Camill,20,0,30,10
1650699286920,ECE 180,B00,083141,Abi Samra; Nicholas Camill,0,0,30,30
1650699292951,MATH 10A,A01,083735,Patchell; Gregory David,2,0,30,28
1650699292951,MATH 10A,A02,083736,Patchell; Gregory David,27,0,30,3
1650699292951,MATH 10A,A03,083737,Patchell; Gregory David,24,0,30,6
1650699307848,MATH 10B,A01,083207,Staff,0,9,30,30
1650699307848,MATH 10B,A02,083208,Staff,1,7,30,29
1650699307848,MATH 10B,B01,083739,Staff,11,0,30,19
1650699307848,MATH 10B,B02,083740,Staff,28,0,30,2
1650699313875,MATH 18,A01,083743,Staff,0,0,30,30
1650699313875,MATH 18,A02,083744,Staff,23,0,30,7
1650699313875,MATH 18,A03,083745,Staff,21,0,30,9
1650699313875,MATH 18,A04,083746,Staff,26,0,30,4
1650699313875,MATH 18,B01,083748,Staff,0,15,30,30
1650699313875,MATH 18,B02,083749,Staff,0,12,30,30
1650699313875,MATH 18,B03,083750,Staff,0,12,30,30
1650699313875,MATH 18,B04,083751,Staff,0,12,30,30
1650699319899,MATH 20A,A01,083754,Staff,19,0,40,21
1650699325933,MATH 20B,A01,083756,Staff,0,11,30,30
1650699325933,MATH 20B,A02,083757,Staff,0,12,30,30
1650699331957,MATH 20C,A01,083760,Staff,0,16,30,30
1650699331957,MATH 20C,A02,083761,Staff,0,15,30,30
1650699331957,MATH 20C,B01,083762,Staff,9,0,30,21
1650699331957,MATH 20C,B02,083763,Staff,28,0,30,2
1650699337985,MATH 20D,A01,083765,Staff,2,1,30,28
1650699337985,MATH 20D,A02,083766,Staff,6,0,30,24
1650699337985,MATH 20D,A03,083767,Staff,24,0,30,6
1650699344018,MATH 20E,A01,083771,Staff,3,0,30,27
1650699344018,MATH 20E,A02,083772,Staff,16,0,30,14
1650699344018,MATH 20E,B01,083773,Staff,0,0,30,30
1650699344018,MATH 20E,B02,083774,Staff,6,0,30,24
1650699350043,MATH 103A,A01,083777,Staff,0,15,30,30
1650699350043,MATH 103A,A02,083778,Staff,0,15,30,30
1650699350043,MATH 103A,B01,083779,Staff,0,15,30,30
1650699350043,MATH 103A,B02,083780,Staff,0,15,30,30
1650699356070,MATH 105,A01,085443,Staff,0,22,30,30
1650699362105,MATH 109,A01,083213,Anzaldo; Leesa B,0,7,30,30
1650699362105,MATH 109,A02,083214,Anzaldo; Leesa B,0,7,30,30
1650699362105,MATH 109,B01,083215,Anzaldo; Leesa B,0,8,30,30
1650699362105,MATH 109,B02,083216,Anzaldo; Leesa B,0,6,30,30
1650699368131,MATH 142A,A01,083219,Chow; Bennett,0,16,30,30
1650699368131,MATH 142A,A02,083220,Chow; Bennett,0,15,30,30
1650699368131,MATH 142A,B01,083221,Chow; Bennett,0,15,30,30
1650699368131,MATH 142A,B02,083222,Chow; Bennett,0,14,30,30
1650699374161,MATH 193A,A01,083224,Staff,0,5,30,30
1650699374161,MATH 193A,A02,083225,Staff,0,6,30,30
1650699374161,MATH 193A,A03,083781,Staff,0,6,30,30
1650699374161,MATH 193A,A04,083782,Staff,0,7,30,30
1650699380195,MATH 197,001,091859,McAuley; Julian John,9998,0,9999,1
1650699386265,COGS 9,A01,083615,Staff,1,15,60,59
1650699392289,COGS 11,A01,083617,Boyle; Mary E. T.,16,0,40,24
1650699398314,COGS 13,A01,083071,Staff,0,38,40,40
1650699404347,COGS 14A,A01,092681,Staff,0,35,100,100
1650699410372,COGS 14B,A01,083073,Cheng; Tzu-Han,1,13,50,49
1650699416410,COGS 17,A01,092677,Staff,13,0,75,62
1650699422439,COGS 100,A01,083619,Staff,0,28,60,60
1650699428476,COGS 101A,A01,083621,Davis; Joshua Daniel,0,27,60,60
1650699434502,COGS 101B,A01,091572,Staff,0,4,60,60
1650699440526,COGS 101C,A01,083625,Delgado; Tania,14,0,30,16
1650699446553,COGS 107A,A01,083627,Boyle; Mary E. T.,0,16,60,60
1650699452593,COGS 118A,A01,083075,Staff,0,8,60,60
1650699458620,CSE 3,A50,083646,Miranda; Gregory Joseph,18,0,38,20
1650699458620,CSE 3,A51,083647,Miranda; Gregory Joseph,36,0,37,1
1650699464649,CSE 8A,A50,083650,Miranda; Gregory Joseph,0,31,40,40
1650699470679,CSE 11,A01,083080,Cao; Yingjun,0,96,40,40
1650699476706,CSE 12,A01,083652,Staff,0,21,100,100
1650699482733,CSE 15L,A01,083654,Staff,0,3,50,50
1650699482733,CSE 15L,A02,083655,Staff,0,2,50,50
1650699488760,CSE 20,A01,083657,Staff,49,0,80,31
1650699494784,CSE 30,A01,083084,Eldon; John,0,77,40,40
1650699500811,CSE 100,A01,083659,Cao; Yingjun,0,70,50,50
1650699506835,CSE 134B,A01,083661,Powell; Thomas Allan,0,38,65,65
1650699512863,CSE 140,A01,083663,Staff,0,10,75,75
1650699518886,CSE 140L,A01,083088,Eldon; John,0,19,75,75
1650699524913,CSE 175,A01,083665,Kumar; Rakesh,7,0,25,18
1650699530944,CSE 190,A00,092507,Dubnov; Shlomo,10,0,20,10
1650699536975,ECE 45,A01,083139,Staff,0,2,60,60
1650699543009,ECE 65,A50,083695,Staff,0,5,30,30
1650699549033,ECE 109,A01,091882,Touri; Behrouz,33,0,70,37
1650699555062,ECE 180,A00,083140,Abi Samra; Nicholas Camill,20,0,30,10
1650699555062,ECE 180,B00,083141,Abi Samra; Nicholas Camill,0,0,30,30
1650699561098,MATH 10A,A01,083735,Patchell; Gregory David,2,0,30,28
1650699561098,MATH 10A,A02,083736,Patchell; Gregory David,27,0,30,3
1650699561098,MATH 10A,A03,083737,Patchell; Gregory David,24,0,30,6
1650699567122,MATH 10B,A01,083207,Staff,0,9,30,30
1650699567122,MATH 10B,A02,083208,Staff,1,7,30,29
1650699567122,MATH 10B,B01,083739,Staff,11,0,30,19
1650699567122,MATH 10B,B02,083740,Staff,28,0,30,2
1650699573150,MATH 18,A01,083743,Staff,0,0,30,30
1650699573150,MATH 18,A02,083744,Staff,23,0,30,7
1650699573150,MATH 18,A03,083745,Staff,21,0,30,9
1650699573150,MATH 18,A04,083746,Staff,26,0,30,4
1650699573150,MATH 18,B01,083748,Staff,0,15,30,30
1650699573150,MATH 18,B02,083749,Staff,0,12,30,30
1650699573150,MATH 18,B03,083750,Staff,0,12,30,30
1650699573150,MATH 18,B04,083751,Staff,0,12,30,30
1650699579173,MATH 20A,A01,083754,Staff,19,0,40,21
1650699585198,MATH 20B,A01,083756,Staff,0,11,30,30
1650699585198,MATH 20B,A02,083757,Staff,0,12,30,30
1650699591238,MATH 20C,A01,083760,Staff,0,16,30,30
1650699591238,MATH 20C,A02,083761,Staff,0,15,30,30
1650699591238,MATH 20C,B01,083762,Staff,9,0,30,21
1650699591238,MATH 20C,B02,083763,Staff,28,0,30,2
1650699597268,MATH 20D,A01,083765,Staff,2,1,30,28
1650699597268,MATH 20D,A02,083766,Staff,6,0,30,24
1650699597268,MATH 20D,A03,083767,Staff,24,0,30,6
1650699603296,MATH 20E,A01,083771,Staff,3,0,30,27
1650699603296,MATH 20E,A02,083772,Staff,16,0,30,14
1650699603296,MATH 20E,B01,083773,Staff,0,0,30,30
1650699603296,MATH 20E,B02,083774,Staff,6,0,30,24
1650699609327,MATH 103A,A01,083777,Staff,0,15,30,30
1650699609327,MATH 103A,A02,083778,Staff,0,15,30,30
1650699609327,MATH 103A,B01,083779,Staff,0,15,30,30
1650699609327,MATH 103A,B02,083780,Staff,0,15,30,30
1650699615365,MATH 105,A01,085443,Staff,0,22,30,30
1650699621391,MATH 109,A01,083213,Anzaldo; Leesa B,0,7,30,30
1650699621391,MATH 109,A02,083214,Anzaldo; Leesa B,0,7,30,30
1650699621391,MATH 109,B01,083215,Anzaldo; Leesa B,0,8,30,30
1650699621391,MATH 109,B02,083216,Anzaldo; Leesa B,0,6,30,30
1650699627418,MATH 142A,A01,083219,Chow; Bennett,0,16,30,30
1650699627418,MATH 142A,A02,083220,Chow; Bennett,0,15,30,30
1650699627418,MATH 142A,B01,083221,Chow; Bennett,0,15,30,30
1650699627418,MATH 142A,B02,083222,Chow; Bennett,0,14,30,30
1650699633446,MATH 193A,A01,083224,Staff,0,5,30,30
1650699633446,MATH 193A,A02,083225,Staff,0,6,30,30
1650699633446,MATH 193A,A03,083781,Staff,0,6,30,30
1650699633446,MATH 193A,A04,083782,Staff,0,7,30,30
1650699639561,MATH 197,001,091859,McAuley; Julian John,9998,0,9999,1
1650699645625,COGS 9,A01,083615,Staff,1,15,60,59
1650699651651,COGS 11,A01,083617,Boyle; Mary E. T.,16,0,40,24
1650699657678,COGS 13,A01,083071,Staff,0,38,40,40
1650699663715,COGS 14A,A01,092681,Staff,0,35,100,100
1650699669747,COGS 14B,A01,083073,Cheng; Tzu-Han,1,13,50,49
1650699675774,COGS 17,A01,092677,Staff,13,0,75,62
1650699681798,COGS 100,A01,083619,Staff,0,28,60,60
1650699687827,COGS 101A,A01,083621,Davis; Joshua Daniel,0,27,60,60
1650699693859,COGS 101B,A01,091572,Staff,0,4,60,60
1650699699886,COGS 101C,A01,083625,Delgado; Tania,14,0,30,16
1650699705913,COGS 107A,A01,083627,Boyle; Mary E. T.,0,16,60,60
1650699711938,COGS 118A,A01,083075,Staff,0,8,60,60
1650699717966,CSE 3,A50,083646,Miranda; Gregory Joseph,18,0,38,20
1650699717966,CSE 3,A51,083647,Miranda; Gregory Joseph,36,0,37,1
1650699723993,CSE 8A,A50,083650,Miranda; Gregory Joseph,0,31,40,40
1650699730017,CSE 11,A01,083080,Cao; Yingjun,0,96,40,40
1650699736053,CSE 12,A01,083652,Staff,0,21,100,100
1650699742084,CSE 15L,A01,083654,Staff,0,3,50,50
1650699742084,CSE 15L,A02,083655,Staff,0,2,50,50
1650699748110,CSE 20,A01,083657,Staff,49,0,80,31
1650699754136,CSE 30,A01,083084,Eldon; John,0,77,40,40
1650699760166,CSE 100,A01,083659,Cao; Yingjun,0,70,50,50
1650699766199,CSE 134B,A01,083661,Powell; Thomas Allan,0,38,65,65
1650699772223,CSE 140,A01,083663,Staff,0,10,75,75
1650699778250,CSE 140L,A01,083088,Eldon; John,0,19,75,75
1650699784277,CSE 175,A01,083665,Kumar; Rakesh,7,0,25,18
1650699790307,CSE 190,A00,092507,Dubnov; Shlomo,10,0,20,10
1650699796330,ECE 45,A01,083139,Staff,0,2,60,60
1650699802360,ECE 65,A50,083695,Staff,0,5,30,30
1650699808391,ECE 109,A01,091882,Touri; Behrouz,33,0,70,37
1650699814419,ECE 180,A00,083140,Abi Samra; Nicholas Camill,20,0,30,10
1650699814419,ECE 180,B00,083141,Abi Samra; Nicholas Camill,0,0,30,30
1650699820458,MATH 10A,A01,083735,Patchell; Gregory David,2,0,30,28
1650699820458,MATH 10A,A02,083736,Patchell; Gregory David,27,0,30,3
1650699820458,MATH 10A,A03,083737,Patchell; Gregory David,24,0,30,6
1650699826485,MATH 10B,A01,083207,Staff,0,9,30,30
1650699826485,MATH 10B,A02,083208,Staff,1,7,30,29
1650699826485,MATH 10B,B01,083739,Staff,11,0,30,19
1650699826485,MATH 10B,B02,083740,Staff,28,0,30,2
1650699832512,MATH 18,A01,083743,Staff,0,0,30,30
1650699832512,MATH 18,A02,083744,Staff,23,0,30,7
1650699832512,MATH 18,A03,083745,Staff,21,0,30,9
1650699832512,MATH 18,A04,083746,Staff,26,0,30,4
1650699832512,MATH 18,B01,083748,Staff,0,15,30,30
1650699832512,MATH 18,B02,083749,Staff,0,12,30,30
1650699832512,MATH 18,B03,083750,Staff,0,12,30,30
1650699832512,MATH 18,B04,083751,Staff,0,12,30,30
1650699838539,MATH 20A,A01,083754,Staff,19,0,40,21
1650699844573,MATH 20B,A01,083756,Staff,0,11,30,30
1650699844573,MATH 20B,A02,083757,Staff,0,12,30,30
1650699850599,MATH 20C,A01,083760,Staff,0,16,30,30
1650699850599,MATH 20C,A02,083761,Staff,0,15,30,30
1650699850599,MATH 20C,B01,083762,Staff,9,0,30,21
1650699850599,MATH 20C,B02,083763,Staff,28,0,30,2
1650699856633,MATH 20D,A01,083765,Staff,2,1,30,28
1650699856633,MATH 20D,A02,083766,Staff,6,0,30,24
1650699856633,MATH 20D,A03,083767,Staff,24,0,30,6
1650699862661,MATH 20E,A01,083771,Staff,3,0,30,27
1650699862661,MATH 20E,A02,083772,Staff,16,0,30,14
1650699862661,MATH 20E,B01,083773,Staff,0,0,30,30
1650699862661,MATH 20E,B02,083774,Staff,6,0,30,24
1650699868686,MATH 103A,A01,083777,Staff,0,15,30,30
1650699868686,MATH 103A,A02,083778,Staff,0,15,30,30
1650699868686,MATH 103A,B01,083779,Staff,0,15,30,30
1650699868686,MATH 103A,B02,083780,Staff,0,15,30,30
1650699874715,MATH 105,A01,085443,Staff,0,22,30,30
1650699880741,MATH 109,A01,083213,Anzaldo; Leesa B,0,7,30,30
1650699880741,MATH 109,A02,083214,Anzaldo; Leesa B,0,7,30,30
1650699880741,MATH 109,B01,083215,Anzaldo; Leesa B,0,8,30,30
1650699880741,MATH 109,B02,083216,Anzaldo; Leesa B,0,6,30,30
1650699886768,MATH 142A,A01,083219,Chow; Bennett,0,16,30,30
1650699886768,MATH 142A,A02,083220,Chow; Bennett,0,15,30,30
1650699886768,MATH 142A,B01,083221,Chow; Bennett,0,15,30,30
1650699886768,MATH 142A,B02,083222,Chow; Bennett,0,14,30,30
1650699892793,MATH 193A,A01,083224,Staff,0,5,30,30
1650699892793,MATH 193A,A02,083225,Staff,0,6,30,30
1650699892793,MATH 193A,A03,083781,Staff,0,6,30,30
1650699892793,MATH 193A,A04,083782,Staff,0,7,30,30
1650699898830,MATH 197,001,091859,McAuley; Julian John,9998,0,9999,1
1650699904901,COGS 9,A01,083615,Staff,1,15,60,59
1650699910932,COGS 11,A01,083617,Boyle; Mary E. T.,16,0,40,24
1650699916955,COGS 13,A01,083071,Staff,0,38,40,40
1650699922981,COGS 14A,A01,092681,Staff,0,35,100,100
1650699929010,COGS 14B,A01,083073,Cheng; Tzu-Han,1,13,50,49
1650699935036,COGS 17,A01,092677,Staff,13,0,75,62
1650699941066,COGS 100,A01,083619,Staff,0,28,60,60
1650699947093,COGS 101A,A01,083621,Davis; Joshua Daniel,0,27,60,60
1650699953120,COGS 101B,A01,091572,Staff,0,4,60,60
1650699959146,COGS 101C,A01,083625,Delgado; Tania,14,0,30,16
1650699965171,COGS 107A,A01,083627,Boyle; Mary E. T.,0,16,60,60
1650699971199,COGS 118A,A01,083075,Staff,0,8,60,60
1650699977233,CSE 3,A50,083646,Miranda; Gregory Joseph,18,0,38,20
1650699977233,CSE 3,A51,083647,Miranda; Gregory Joseph,36,0,37,1
1650699983263,CSE 8A,A50,083650,Miranda; Gregory Joseph,0,30,40,40
1650699989290,CSE 11,A01,083080,Cao; Yingjun,0,96,40,40
1650699995319,CSE 12,A01,083652,Staff,0,21,100,100
1650700001346,CSE 15L,A01,083654,Staff,0,3,50,50
1650700001346,CSE 15L,A02,083655,Staff,0,2,50,50
1650700007375,CSE 20,A01,083657,Staff,49,0,80,31
1650700013400,CSE 30,A01,083084,Eldon; John,0,77,40,40
1650700019425,CSE 100,A01,083659,Cao; Yingjun,0,70,50,50
1650700025450,CSE 134B,A01,083661,Powell; Thomas Allan,0,38,65,65
1650700031475,CSE 140,A01,083663,Staff,0,10,75,75
1650700037500,CSE 140L,A01,083088,Eldon; John,0,19,75,75
1650700043527,CSE 175,A01,083665,Kumar; Rakesh,7,0,25,18
1650700049556,CSE 190,A00,092507,Dubnov; Shlomo,10,0,20,10
1650700055583,ECE 45,A01,083139,Staff,0,2,60,60
1650700061608,ECE 65,A50,083695,Staff,0,5,30,30
1650700067640,ECE 109,A01,091882,Touri; Behrouz,33,0,70,37
1650700073667,ECE 180,A00,083140,Abi Samra; Nicholas Camill,20,0,30,10
1650700073667,ECE 180,B00,083141,Abi Samra; Nicholas Camill,0,0,30,30
1650700079696,MATH 10A,A01,083735,Patchell; Gregory David,2,0,30,28
1650700079696,MATH 10A,A02,083736,Patchell; Gregory David,27,0,30,3
1650700079696,MATH 10A,A03,083737,Patchell; Gregory David,24,0,30,6
1650700085724,MATH 10B,A01,083207,Staff,0,9,30,30
1650700085724,MATH 10B,A02,083208,Staff,1,7,30,29
1650700085724,MATH 10B,B01,083739,Staff,11,0,30,19
1650700085724,MATH 10B,B02,083740,Staff,28,0,30,2
1650700091751,MATH 18,A01,083743,Staff,0,0,30,30
1650700091751,MATH 18,A02,083744,Staff,23,0,30,7
1650700091751,MATH 18,A03,083745,Staff,21,0,30,9
1650700091751,MATH 18,A04,083746,Staff,26,0,30,4
1650700091751,MATH 18,B01,083748,Staff,0,15,30,30
1650700091751,MATH 18,B02,083749,Staff,0,12,30,30
1650700091751,MATH 18,B03,083750,Staff,0,12,30,30
1650700091751,MATH 18,B04,083751,Staff,0,12,30,30
1650700097776,MATH 20A,A01,083754,Staff,19,0,40,21
1650700103811,MATH 20B,A01,083756,Staff,0,11,30,30
1650700103811,MATH 20B,A02,083757,Staff,0,12,30,30
1650700109843,MATH 20C,A01,083760,Staff,0,16,30,30
1650700109843,MATH 20C,A02,083761,Staff,0,15,30,30
1650700109843,MATH 20C,B01,083762,Staff,9,0,30,21
1650700109843,MATH 20C,B02,083763,Staff,28,0,30,2
1650700115868,MATH 20D,A01,083765,Staff,2,1,30,28
1650700115868,MATH 20D,A02,083766,Staff,6,0,30,24
1650700115868,MATH 20D,A03,083767,Staff,24,0,30,6
1650700121895,MATH 20E,A01,083771,Staff,3,0,30,27
1650700121895,MATH 20E,A02,083772,Staff,16,0,30,14
1650700121895,MATH 20E,B01,083773,Staff,0,0,30,30
1650700121895,MATH 20E,B02,083774,Staff,6,0,30,24
1650700127928,MATH 103A,A01,083777,Staff,0,15,30,30
1650700127928,MATH 103A,A02,083778,Staff,0,15,30,30
1650700127928,MATH 103A,B01,083779,Staff,0,15,30,30
1650700127928,MATH 103A,B02,083780,Staff,0,15,30,30
1650700133967,MATH 105,A01,085443,Staff,0,22,30,30
1650700139995,MATH 109,A01,083213,Anzaldo; Leesa B,0,7,30,30
1650700139995,MATH 109,A02,083214,Anzaldo; Leesa B,0,7,30,30
1650700139995,MATH 109,B01,083215,Anzaldo; Leesa B,0,8,30,30
1650700139995,MATH 109,B02,083216,Anzaldo; Leesa B,0,6,30,30
1650700146026,MATH 142A,A01,083219,Chow; Bennett,0,16,30,30
1650700146026,MATH 142A,A02,083220,Chow; Bennett,0,15,30,30
1650700146026,MATH 142A,B01,083221,Chow; Bennett,0,15,30,30
1650700146026,MATH 142A,B02,083222,Chow; Bennett,0,14,30,30
1650700152056,MATH 193A,A01,083224,Staff,0,5,30,30
1650700152056,MATH 193A,A02,083225,Staff,0,6,30,30
1650700152056,MATH 193A,A03,083781,Staff,0,6,30,30
1650700152056,MATH 193A,A04,083782,Staff,0,7,30,30
1650700158085,MATH 197,001,091859,McAuley; Julian John,9998,0,9999,1
1650700164162,COGS 9,A01,083615,Staff,1,15,60,59
1650700170189,COGS 11,A01,083617,Boyle; Mary E. T.,16,0,40,24
1650700176217,COGS 13,A01,083071,Staff,0,38,40,40
1650700182243,COGS 14A,A01,092681,Staff,0,35,100,100
1650700188268,COGS 14B,A01,083073,Cheng; Tzu-Han,1,13,50,49
1650700194295,COGS 17,A01,092677,Staff,13,0,75,62
1650700200322,COGS 100,A01,083619,Staff,0,28,60,60
1650700206352,COGS 101A,A01,083621,Davis; Joshua Daniel,0,27,60,60
1650700212382,COGS 101B,A01,091572,Staff,0,4,60,60
1650700218417,COGS 101C,A01,083625,Delgado; Tania,14,0,30,16
1650700224441,COGS 107A,A01,083627,Boyle; Mary E. T.,0,16,60,60
1650700230565,COGS 118A,A01,083075,Staff,0,8,60,60
1650700236595,CSE 3,A50,083646,Miranda; Gregory Joseph,18,0,38,20
1650700236595,CSE 3,A51,083647,Miranda; Gregory Joseph,36,0,37,1
1650700242623,CSE 8A,A50,083650,Miranda; Gregory Joseph,0,30,40,40
1650700248653,CSE 11,A01,083080,Cao; Yingjun,0,96,40,40
1650700254691,CSE 12,A01,083652,Staff,0,21,100,100
1650700260714,CSE 15L,A01,083654,Staff,0,3,50,50
1650700260714,CSE 15L,A02,083655,Staff,0,2,50,50
1650700266736,CSE 20,A01,083657,Staff,49,0,80,31
1650700272763,CSE 30,A01,083084,Eldon; John,0,77,40,40
1650700278796,CSE 100,A01,083659,Cao; Yingjun,0,70,50,50
1650700284820,CSE 134B,A01,083661,Powell; Thomas Allan,0,38,65,65
1650700290845,CSE 140,A01,083663,Staff,0,10,75,75
1650700296869,CSE 140L,A01,083088,Eldon; John,0,19,75,75
1650700302915,CSE 175,A01,083665,Kumar; Rakesh,7,0,25,18
1650700308943,CSE 190,A00,092507,Dubnov; Shlomo,10,0,20,10
1650700314969,ECE 45,A01,083139,Staff,0,2,60,60
1650700320999,ECE 65,A50,083695,Staff,0,5,30,30
1650700327025,ECE 109,A01,091882,Touri; Behrouz,33,0,70,37
1650700333051,ECE 180,A00,083140,Abi Samra; Nicholas Camill,20,0,30,10
1650700333051,ECE 180,B00,083141,Abi Samra; Nicholas Camill,0,0,30,30
1650700339083,MATH 10A,A01,083735,Patchell; Gregory David,2,0,30,28
1650700339083,MATH 10A,A02,083736,Patchell; Gregory David,27,0,30,3
1650700339083,MATH 10A,A03,083737,Patchell; Gregory David,24,0,30,6
1650700345108,MATH 10B,A01,083207,Staff,0,9,30,30
1650700345108,MATH 10B,A02,083208,Staff,1,7,30,29
1650700345108,MATH 10B,B01,083739,Staff,11,0,30,19
1650700345108,MATH 10B,B02,083740,Staff,28,0,30,2
1650700351137,MATH 18,A01,083743,Staff,0,0,30,30
1650700351137,MATH 18,A02,083744,Staff,23,0,30,7
1650700351137,MATH 18,A03,083745,Staff,21,0,30,9
1650700351137,MATH 18,A04,083746,Staff,26,0,30,4
1650700351137,MATH 18,B01,083748,Staff,0,15,30,30
1650700351137,MATH 18,B02,083749,Staff,0,12,30,30
1650700351137,MATH 18,B03,083750,Staff,0,12,30,30
1650700351137,MATH 18,B04,083751,Staff,0,12,30,30
1650700357162,MATH 20A,A01,083754,Staff,19,0,40,21
1650700363199,MATH 20B,A01,083756,Staff,0,11,30,30
1650700363199,MATH 20B,A02,083757,Staff,0,12,30,30
1650700369223,MATH 20C,A01,083760,Staff,0,16,30,30
1650700369223,MATH 20C,A02,083761,Staff,0,15,30,30
1650700369223,MATH 20C,B01,083762,Staff,9,0,30,21
1650700369223,MATH 20C,B02,083763,Staff,28,0,30,2
1650700375259,MATH 20D,A01,083765,Staff,2,1,30,28
1650700375259,MATH 20D,A02,083766,Staff,6,0,30,24
1650700375259,MATH 20D,A03,083767,Staff,24,0,30,6
1650700381296,MATH 20E,A01,083771,Staff,3,0,30,27
1650700381296,MATH 20E,A02,083772,Staff,16,0,30,14
1650700381296,MATH 20E,B01,083773,Staff,0,0,30,30
1650700381296,MATH 20E,B02,083774,Staff,6,0,30,24
1650700387325,MATH 103A,A01,083777,Staff,0,15,30,30
1650700387325,MATH 103A,A02,083778,Staff,0,15,30,30
1650700387325,MATH 103A,B01,083779,Staff,0,15,30,30
1650700387325,MATH 103A,B02,083780,Staff,0,15,30,30
1650700393354,MATH 105,A01,085443,Staff,0,22,30,30
1650700399380,MATH 109,A01,083213,Anzaldo; Leesa B,0,7,30,30
1650700399380,MATH 109,A02,083214,Anzaldo; Leesa B,0,7,30,30
1650700399380,MATH 109,B01,083215,Anzaldo; Leesa B,0,8,30,30
1650700399380,MATH 109,B02,083216,Anzaldo; Leesa B,0,6,30,30
1650700405409,MATH 142A,A01,083219,Chow; Bennett,0,16,30,30
1650700405409,MATH 142A,A02,083220,Chow; Bennett,0,15,30,30
1650700405409,MATH 142A,B01,083221,Chow; Bennett,0,15,30,30
1650700405409,MATH 142A,B02,083222,Chow; Bennett,0,14,30,30
1650700411436,MATH 193A,A01,083224,Staff,0,5,30,30
1650700411436,MATH 193A,A02,083225,Staff,0,6,30,30
1650700411436,MATH 193A,A03,083781,Staff,0,6,30,30
1650700411436,MATH 193A,A04,083782,Staff,0,7,30,30
1650700417461,MATH 197,001,091859,McAuley; Julian John,9998,0,9999,1
1650700423536,COGS 9,A01,083615,Staff,1,15,60,59
1650700429563,COGS 11,A01,083617,Boyle; Mary E. T.,16,0,40,24
1650700435595,COGS 13,A01,083071,Staff,0,38,40,40
1650700441621,COGS 14A,A01,092681,Staff,0,35,100,100
1650700447647,COGS 14B,A01,083073,Cheng; Tzu-Han,1,13,50,49
1650700453678,COGS 17,A01,092677,Staff,13,0,75,62
1650700459712,COGS 100,A01,083619,Staff,0,28,60,60
1650700465745,COGS 101A,A01,083621,Davis; Joshua Daniel,0,27,60,60
1650700471773,COGS 101B,A01,091572,Staff,0,4,60,60
1650700477813,COGS 101C,A01,083625,Delgado; Tania,14,0,30,16
1650700483837,COGS 107A,A01,083627,Boyle; Mary E. T.,0,16,60,60
1650700489862,COGS 118A,A01,083075,Staff,0,8,60,60
1650700495889,CSE 3,A50,083646,Miranda; Gregory Joseph,18,0,38,20
1650700495889,CSE 3,A51,083647,Miranda; Gregory Joseph,36,0,37,1
1650700501914,CSE 8A,A50,083650,Miranda; Gregory Joseph,0,30,40,40
1650700507944,CSE 11,A01,083080,Cao; Yingjun,0,96,40,40
1650700513968,CSE 12,A01,083652,Staff,0,21,100,100
1650700519993,CSE 15L,A01,083654,Staff,0,3,50,50
1650700519993,CSE 15L,A02,083655,Staff,0,2,50,50
1650700526019,CSE 20,A01,083657,Staff,49,0,80,31
1650700532047,CSE 30,A01,083084,Eldon; John,0,77,40,40
1650700538076,CSE 100,A01,083659,Cao; Yingjun,0,70,50,50
1650700544106,CSE 134B,A01,083661,Powell; Thomas Allan,0,38,65,65
1650700550132,CSE 140,A01,083663,Staff,0,10,75,75
1650700556161,CSE 140L,A01,083088,Eldon; John,0,19,75,75
1650700562186,CSE 175,A01,083665,Kumar; Rakesh,7,0,25,18
1650700568216,CSE 190,A00,092507,Dubnov; Shlomo,10,0,20,10
1650700574247,ECE 45,A01,083139,Staff,1,2,60,59
1650700580271,ECE 65,A50,083695,Staff,0,5,30,30
1650700586301,ECE 109,A01,091882,Touri; Behrouz,33,0,70,37
1650700592327,ECE 180,A00,083140,Abi Samra; Nicholas Camill,20,0,30,10
1650700592327,ECE 180,B00,083141,Abi Samra; Nicholas Camill,0,0,30,30
1650700598356,MATH 10A,A01,083735,Patchell; Gregory David,2,0,30,28
1650700598356,MATH 10A,A02,083736,Patchell; Gregory David,27,0,30,3
1650700598356,MATH 10A,A03,083737,Patchell; Gregory David,24,0,30,6
1650700604381,MATH 10B,A01,083207,Staff,0,9,30,30
1650700604381,MATH 10B,A02,083208,Staff,1,7,30,29
1650700604381,MATH 10B,B01,083739,Staff,11,0,30,19
1650700604381,MATH 10B,B02,083740,Staff,28,0,30,2
1650700610407,MATH 18,A01,083743,Staff,0,0,30,30
1650700610407,MATH 18,A02,083744,Staff,23,0,30,7
1650700610407,MATH 18,A03,083745,Staff,21,0,30,9
1650700610407,MATH 18,A04,083746,Staff,26,0,30,4
1650700610407,MATH 18,B01,083748,Staff,0,15,30,30
1650700610407,MATH 18,B02,083749,Staff,0,12,30,30
1650700610407,MATH 18,B03,083750,Staff,0,12,30,30
1650700610407,MATH 18,B04,083751,Staff,0,12,30,30
1650700616439,MATH 20A,A01,083754,Staff,19,0,40,21
1650700622468,MATH 20B,A01,083756,Staff,0,11,30,30
1650700622468,MATH 20B,A02,083757,Staff,0,12,30,30
1650700628494,MATH 20C,A01,083760,Staff,0,16,30,30
1650700628494,MATH 20C,A02,083761,Staff,0,15,30,30
1650700628494,MATH 20C,B01,083762,Staff,9,0,30,21
1650700628494,MATH 20C,B02,083763,Staff,28,0,30,2
1650700634518,MATH 20D,A01,083765,Staff,2,1,30,28
1650700634518,MATH 20D,A02,083766,Staff,6,0,30,24
1650700634518,MATH 20D,A03,083767,Staff,24,0,30,6
1650700640549,MATH 20E,A01,083771,Staff,3,0,30,27
1650700640549,MATH 20E,A02,083772,Staff,16,0,30,14
1650700640549,MATH 20E,B01,083773,Staff,0,0,30,30
1650700640549,MATH 20E,B02,083774,Staff,6,0,30,24
1650700646576,MATH 103A,A01,083777,Staff,0,15,30,30
1650700646576,MATH 103A,A02,083778,Staff,0,15,30,30
1650700646576,MATH 103A,B01,083779,Staff,0,15,30,30
1650700646576,MATH 103A,B02,083780,Staff,0,15,30,30
1650700652605,MATH 105,A01,085443,Staff,0,22,30,30
1650700658635,MATH 109,A01,083213,Anzaldo; Leesa B,0,7,30,30
1650700658635,MATH 109,A02,083214,Anzaldo; Leesa B,0,7,30,30
1650700658635,MATH 109,B01,083215,Anzaldo; Leesa B,0,8,30,30
1650700658635,MATH 109,B02,083216,Anzaldo; Leesa B,0,6,30,30
1650700664660,MATH 142A,A01,083219,Chow; Bennett,0,16,30,30
1650700664660,MATH 142A,A02,083220,Chow; Bennett,0,15,30,30
1650700664660,MATH 142A,B01,083221,Chow; Bennett,0,15,30,30
1650700664660,MATH 142A,B02,083222,Chow; Bennett,0,14,30,30
1650700670690,MATH 193A,A01,083224,Staff,0,5,30,30
1650700670690,MATH 193A,A02,083225,Staff,0,6,30,30
1650700670690,MATH 193A,A03,083781,Staff,0,6,30,30
1650700670690,MATH 193A,A04,083782,Staff,0,7,30,30
1650700676717,MATH 197,001,091859,McAuley; Julian John,9998,0,9999,1
1650700682794,COGS 9,A01,083615,Staff,1,15,60,59
1650700688824,COGS 11,A01,083617,Boyle; Mary E. T.,16,0,40,24
1650700694856,COGS 13,A01,083071,Staff,0,38,40,40
1650700700880,COGS 14A,A01,092681,Staff,0,35,100,100
1650700706904,COGS 14B,A01,083073,Cheng; Tzu-Han,1,13,50,49
1650700712929,COGS 17,A01,092677,Staff,13,0,75,62
1650700718957,COGS 100,A01,083619,Staff,0,28,60,60
1650700724987,COGS 101A,A01,083621,Davis; Joshua Daniel,0,27,60,60
1650700731011,COGS 101B,A01,091572,Staff,0,4,60,60
1650700737041,COGS 101C,A01,083625,Delgado; Tania,14,0,30,16
1650700743065,COGS 107A,A01,083627,Boyle; Mary E. T.,0,16,60,60
1650700749094,COGS 118A,A01,083075,Staff,0,8,60,60
1650700755125,CSE 3,A50,083646,Miranda; Gregory Joseph,18,0,38,20
1650700755125,CSE 3,A51,083647,Miranda; Gregory Joseph,36,0,37,1
1650700761154,CSE 8A,A50,083650,Miranda; Gregory Joseph,0,30,40,40
1650700767178,CSE 11,A01,083080,Cao; Yingjun,0,96,40,40
1650700773204,CSE 12,A01,083652,Staff,0,21,100,100
1650700779231,CSE 15L,A01,083654,Staff,0,3,50,50
1650700779231,CSE 15L,A02,083655,Staff,0,2,50,50
1650700785257,CSE 20,A01,083657,Staff,49,0,80,31
1650700791286,CSE 30,A01,083084,Eldon; John,0,77,40,40
1650700797318,CSE 100,A01,083659,Cao; Yingjun,0,70,50,50
1650700803342,CSE 134B,A01,083661,Powell; Thomas Allan,0,38,65,65
1650700809369,CSE 140,A01,083663,Staff,0,10,75,75
1650700815397,CSE 140L,A01,083088,Eldon; John,0,19,75,75
1650700821427,CSE 175,A01,083665,Kumar; Rakesh,7,0,25,18
1650700827542,CSE 190,A00,092507,Dubnov; Shlomo,10,0,20,10
1650700833571,ECE 45,A01,083139,Staff,1,2,60,59
1650700839603,ECE 65,A50,083695,Staff,0,5,30,30
1650700845630,ECE 109,A01,091882,Touri; Behrouz,33,0,70,37
1650700851655,ECE 180,A00,083140,Abi Samra; Nicholas Camill,20,0,30,10
1650700851655,ECE 180,B00,083141,Abi Samra; Nicholas Camill,0,0,30,30
1650700857688,MATH 10A,A01,083735,Patchell; Gregory David,2,0,30,28
1650700857688,MATH 10A,A02,083736,Patchell; Gregory David,27,0,30,3
1650700857688,MATH 10A,A03,083737,Patchell; Gregory David,24,0,30,6
1650700863722,MATH 10B,A01,083207,Staff,0,9,30,30
1650700863722,MATH 10B,A02,083208,Staff,1,7,30,29
1650700863722,MATH 10B,B01,083739,Staff,11,0,30,19
1650700863722,MATH 10B,B02,083740,Staff,28,0,30,2
1650700869750,MATH 18,A01,083743,Staff,0,0,30,30
1650700869750,MATH 18,A02,083744,Staff,23,0,30,7
1650700869750,MATH 18,A03,083745,Staff,21,0,30,9
1650700869750,MATH 18,A04,083746,Staff,26,0,30,4
1650700869750,MATH 18,B01,083748,Staff,0,15,30,30
1650700869750,MATH 18,B02,083749,Staff,0,12,30,30
1650700869750,MATH 18,B03,083750,Staff,0,12,30,30
1650700869750,MATH 18,B04,083751,Staff,0,12,30,30
1650700875774,MATH 20A,A01,083754,Staff,19,0,40,21
1650700881803,MATH 20B,A01,083756,Staff,0,11,30,30
1650700881803,MATH 20B,A02,083757,Staff,0,12,30,30
1650700887828,MATH 20C,A01,083760,Staff,0,16,30,30
1650700887828,MATH 20C,A02,083761,Staff,0,15,30,30
1650700887828,MATH 20C,B01,083762,Staff,9,0,30,21
1650700887828,MATH 20C,B02,083763,Staff,28,0,30,2
1650700893858,MATH 20D,A01,083765,Staff,2,1,30,28
1650700893858,MATH 20D,A02,083766,Staff,6,0,30,24
1650700893858,MATH 20D,A03,083767,Staff,24,0,30,6
1650700899888,MATH 20E,A01,083771,Staff,3,0,30,27
1650700899888,MATH 20E,A02,083772,Staff,16,0,30,14
1650700899888,MATH 20E,B01,083773,Staff,0,0,30,30
1650700899888,MATH 20E,B02,083774,Staff,6,0,30,24
1650700905918,MATH 103A,A01,083777,Staff,0,15,30,30
1650700905918,MATH 103A,A02,083778,Staff,0,15,30,30
1650700905918,MATH 103A,B01,083779,Staff,0,15,30,30
1650700905918,MATH 103A,B02,083780,Staff,0,15,30,30
1650700911946,MATH 105,A01,085443,Staff,0,22,30,30
1650700917975,MATH 109,A01,083213,Anzaldo; Leesa B,0,7,30,30
1650700917975,MATH 109,A02,083214,Anzaldo; Leesa B,0,7,30,30
1650700917975,MATH 109,B01,083215,Anzaldo; Leesa B,0,8,30,30
1650700917975,MATH 109,B02,083216,Anzaldo; Leesa B,0,6,30,30
1650700924001,MATH 142A,A01,083219,Chow; Bennett,0,16,30,30
1650700924001,MATH 142A,A02,083220,Chow; Bennett,0,15,30,30
1650700924001,MATH 142A,B01,083221,Chow; Bennett,0,15,30,30
1650700924001,MATH 142A,B02,083222,Chow; Bennett,0,14,30,30
1650700930035,MATH 193A,A01,083224,Staff,0,5,30,30
1650700930035,MATH 193A,A02,083225,Staff,0,6,30,30
1650700930035,MATH 193A,A03,083781,Staff,0,6,30,30
1650700930035,MATH 193A,A04,083782,Staff,0,7,30,30
1650700936060,MATH 197,001,091859,McAuley; Julian John,9998,0,9999,1
1650700942116,COGS 9,A01,083615,Staff,1,15,60,59
1650700948147,COGS 11,A01,083617,Boyle; Mary E. T.,16,0,40,24
1650700954172,COGS 13,A01,083071,Staff,0,38,40,40
1650700960199,COGS 14A,A01,092681,Staff,0,35,100,100
1650700966223,COGS 14B,A01,083073,Cheng; Tzu-Han,1,13,50,49
1650700972253,COGS 17,A01,092677,Staff,13,0,75,62
1650700978284,COGS 100,A01,083619,Staff,0,28,60,60
1650700984310,COGS 101A,A01,083621,Davis; Joshua Daniel,0,27,60,60
1650700990342,COGS 101B,A01,091572,Staff,0,4,60,60
1650700996367,COGS 101C,A01,083625,Delgado; Tania,14,0,30,16
1650701002409,COGS 107A,A01,083627,Boyle; Mary E. T.,0,16,60,60
1650701008436,COGS 118A,A01,083075,Staff,0,8,60,60
1650701014462,CSE 3,A50,083646,Miranda; Gregory Joseph,18,0,38,20
1650701014462,CSE 3,A51,083647,Miranda; Gregory Joseph,36,0,37,1
1650701020499,CSE 8A,A50,083650,Miranda; Gregory Joseph,0,30,40,40
1650701026524,CSE 11,A01,083080,Cao; Yingjun,0,96,40,40
1650701032552,CSE 12,A01,083652,Staff,0,21,100,100
1650701038578,CSE 15L,A01,083654,Staff,0,3,50,50
1650701038578,CSE 15L,A02,083655,Staff,0,2,50,50
1650701044602,CSE 20,A01,083657,Staff,49,0,80,31
1650701050627,CSE 30,A01,083084,Eldon; John,0,77,40,40
1650701056653,CSE 100,A01,083659,Cao; Yingjun,0,70,50,50
1650701062682,CSE 134B,A01,083661,Powell; Thomas Allan,0,38,65,65
1650701068708,CSE 140,A01,083663,Staff,0,10,75,75
1650701074733,CSE 140L,A01,083088,Eldon; John,0,19,75,75
1650701080757,CSE 175,A01,083665,Kumar; Rakesh,7,0,25,18
1650701086786,CSE 190,A00,092507,Dubnov; Shlomo,10,0,20,10
1650701092822,ECE 45,A01,083139,Staff,1,2,60,59
1650701098850,ECE 65,A50,083695,Staff,0,5,30,30
1650701104882,ECE 109,A01,091882,Touri; Behrouz,33,0,70,37
1650701110909,ECE 180,A00,083140,Abi Samra; Nicholas Camill,20,0,30,10
1650701110909,ECE 180,B00,083141,Abi Samra; Nicholas Camill,0,0,30,30
1650701116936,MATH 10A,A01,083735,Patchell; Gregory David,2,0,30,28
1650701116936,MATH 10A,A02,083736,Patchell; Gregory David,27,0,30,3
1650701116936,MATH 10A,A03,083737,Patchell; Gregory David,24,0,30,6
1650701122962,MATH 10B,A01,083207,Staff,0,9,30,30
1650701122962,MATH 10B,A02,083208,Staff,1,7,30,29
1650701122962,MATH 10B,B01,083739,Staff,11,0,30,19
1650701122962,MATH 10B,B02,083740,Staff,28,0,30,2
1650701129016,MATH 18,A01,083743,Staff,0,0,30,30
1650701129016,MATH 18,A02,083744,Staff,23,0,30,7
1650701129016,MATH 18,A03,083745,Staff,21,0,30,9
1650701129016,MATH 18,A04,083746,Staff,26,0,30,4
1650701129016,MATH 18,B01,083748,Staff,0,15,30,30
1650701129016,MATH 18,B02,083749,Staff,0,12,30,30
1650701129016,MATH 18,B03,083750,Staff,0,12,30,30
1650701129016,MATH 18,B04,083751,Staff,0,12,30,30
1650701135043,MATH 20A,A01,083754,Staff,19,0,40,21
1650701141070,MATH 20B,A01,083756,Staff,0,11,30,30
1650701141070,MATH 20B,A02,083757,Staff,0,12,30,30
1650701147099,MATH 20C,A01,083760,Staff,0,16,30,30
1650701147099,MATH 20C,A02,083761,Staff,0,15,30,30
1650701147099,MATH 20C,B01,083762,Staff,9,0,30,21
1650701147099,MATH 20C,B02,083763,Staff,28,0,30,2
1650701153132,MATH 20D,A01,083765,Staff,2,1,30,28
1650701153132,MATH 20D,A02,083766,Staff,6,0,30,24
1650701153132,MATH 20D,A03,083767,Staff,24,0,30,6
1650701159157,MATH 20E,A01,083771,Staff,3,0,30,27
1650701159157,MATH 20E,A02,083772,Staff,16,0,30,14
1650701159157,MATH 20E,B01,083773,Staff,0,0,30,30
1650701159157,MATH 20E,B02,083774,Staff,6,0,30,24
1650701165187,MATH 103A,A01,083777,Staff,0,15,30,30
1650701165187,MATH 103A,A02,083778,Staff,0,15,30,30
1650701165187,MATH 103A,B01,083779,Staff,0,15,30,30
1650701165187,MATH 103A,B02,083780,Staff,0,15,30,30
1650701171210,MATH 105,A01,085443,Staff,0,22,30,30
1650701177239,MATH 109,A01,083213,Anzaldo; Leesa B,0,7,30,30
1650701177239,MATH 109,A02,083214,Anzaldo; Leesa B,0,7,30,30
1650701177239,MATH 109,B01,083215,Anzaldo; Leesa B,0,8,30,30
1650701177239,MATH 109,B02,083216,Anzaldo; Leesa B,0,6,30,30
1650701183263,MATH 142A,A01,083219,Chow; Bennett,0,16,30,30
1650701183263,MATH 142A,A02,083220,Chow; Bennett,0,15,30,30
1650701183263,MATH 142A,B01,083221,Chow; Bennett,0,15,30,30
1650701183263,MATH 142A,B02,083222,Chow; Bennett,0,14,30,30
1650701189294,MATH 193A,A01,083224,Staff,0,5,30,30
1650701189294,MATH 193A,A02,083225,Staff,0,6,30,30
1650701189294,MATH 193A,A03,083781,Staff,0,6,30,30
1650701189294,MATH 193A,A04,083782,Staff,0,7,30,30
1650701195318,MATH 197,001,091859,McAuley; Julian John,9998,0,9999,1
1650701201384,COGS 9,A01,083615,Staff,1,15,60,59
1650701207406,COGS 11,A01,083617,Boyle; Mary E. T.,16,0,40,24
1650701213431,COGS 13,A01,083071,Staff,0,38,40,40
1650701219456,COGS 14A,A01,092681,Staff,0,35,100,100
1650701225481,COGS 14B,A01,083073,Cheng; Tzu-Han,1,13,50,49
1650701231504,COGS 17,A01,092677,Staff,13,0,75,62
1650701237531,COGS 100,A01,083619,Staff,0,28,60,60
1650701243555,COGS 101A,A01,083621,Davis; Joshua Daniel,0,27,60,60
1650701249579,COGS 101B,A01,091572,Staff,0,4,60,60
1650701255602,COGS 101C,A01,083625,Delgado; Tania,14,0,30,16
1650701261626,COGS 107A,A01,083627,Boyle; Mary E. T.,0,16,60,60
1650701267653,COGS 118A,A01,083075,Staff,0,8,60,60
1650701273681,CSE 3,A50,083646,Miranda; Gregory Joseph,18,0,38,20
1650701273681,CSE 3,A51,083647,Miranda; Gregory Joseph,36,0,37,1
1650701279704,CSE 8A,A50,083650,Miranda; Gregory Joseph,0,30,40,40
1650701285730,CSE 11,A01,083080,Cao; Yingjun,0,96,40,40
1650701291754,CSE 12,A01,083652,Staff,0,21,100,100
1650701297780,CSE 15L,A01,083654,Staff,0,3,50,50
1650701297780,CSE 15L,A02,083655,Staff,0,2,50,50
1650701303805,CSE 20,A01,083657,Staff,49,0,80,31
1650701309828,CSE 30,A01,083084,Eldon; John,0,77,40,40
1650701315856,CSE 100,A01,083659,Cao; Yingjun,0,70,50,50
1650701321882,CSE 134B,A01,083661,Powell; Thomas Allan,0,38,65,65
1650701327906,CSE 140,A01,083663,Staff,0,10,75,75
1650701333939,CSE 140L,A01,083088,Eldon; John,0,19,75,75
1650701339981,CSE 175,A01,083665,Kumar; Rakesh,7,0,25,18
1650701346005,CSE 190,A00,092507,Dubnov; Shlomo,10,0,20,10
1650701352030,ECE 45,A01,083139,Staff,1,2,60,59
1650701358054,ECE 65,A50,083695,Staff,0,5,30,30
1650701364079,ECE 109,A01,091882,Touri; Behrouz,33,0,70,37
1650701370105,ECE 180,A00,083140,Abi Samra; Nicholas Camill,20,0,30,10
1650701370105,ECE 180,B00,083141,Abi Samra; Nicholas Camill,0,0,30,30
1650701376134,MATH 10A,A01,083735,Patchell; Gregory David,2,0,30,28
1650701376134,MATH 10A,A02,083736,Patchell; Gregory David,27,0,30,3
1650701376134,MATH 10A,A03,083737,Patchell; Gregory David,24,0,30,6
1650701382160,MATH 10B,A01,083207,Staff,0,9,30,30
1650701382160,MATH 10B,A02,083208,Staff,1,7,30,29
1650701382160,MATH 10B,B01,083739,Staff,11,0,30,19
1650701382160,MATH 10B,B02,083740,Staff,28,0,30,2
1650701388185,MATH 18,A01,083743,Staff,0,0,30,30
1650701388185,MATH 18,A02,083744,Staff,23,0,30,7
1650701388185,MATH 18,A03,083745,Staff,21,0,30,9
1650701388185,MATH 18,A04,083746,Staff,26,0,30,4
1650701388185,MATH 18,B01,083748,Staff,0,15,30,30
1650701388185,MATH 18,B02,083749,Staff,0,12,30,30
1650701388185,MATH 18,B03,083750,Staff,0,12,30,30
1650701388185,MATH 18,B04,083751,Staff,0,12,30,30
1650701394211,MATH 20A,A01,083754,Staff,19,0,40,21
1650701400240,MATH 20B,A01,083756,Staff,0,11,30,30
1650701400240,MATH 20B,A02,083757,Staff,0,12,30,30
1650701406264,MATH 20C,A01,083760,Staff,0,16,30,30
1650701406264,MATH 20C,A02,083761,Staff,0,15,30,30
1650701406264,MATH 20C,B01,083762,Staff,9,0,30,21
1650701406264,MATH 20C,B02,083763,Staff,28,0,30,2
1650701412289,MATH 20D,A01,083765,Staff,2,1,30,28
1650701412289,MATH 20D,A02,083766,Staff,6,0,30,24
1650701412289,MATH 20D,A03,083767,Staff,24,0,30,6
1650701418320,MATH 20E,A01,083771,Staff,3,0,30,27
1650701418320,MATH 20E,A02,083772,Staff,16,0,30,14
1650701418320,MATH 20E,B01,083773,Staff,0,0,30,30
1650701418320,MATH 20E,B02,083774,Staff,6,0,30,24
1650701424418,MATH 103A,A01,083777,Staff,0,15,30,30
1650701424418,MATH 103A,A02,083778,Staff,0,15,30,30
1650701424418,MATH 103A,B01,083779,Staff,0,15,30,30
1650701424418,MATH 103A,B02,083780,Staff,0,15,30,30
1650701430446,MATH 105,A01,085443,Staff,0,22,30,30
1650701436474,MATH 109,A01,083213,Anzaldo; Leesa B,0,7,30,30
1650701436474,MATH 109,A02,083214,Anzaldo; Leesa B,0,7,30,30
1650701436474,MATH 109,B01,083215,Anzaldo; Leesa B,0,8,30,30
1650701436474,MATH 109,B02,083216,Anzaldo; Leesa B,0,6,30,30
1650701442503,MATH 142A,A01,083219,Chow; Bennett,0,16,30,30
1650701442503,MATH 142A,A02,083220,Chow; Bennett,0,15,30,30
1650701442503,MATH 142A,B01,083221,Chow; Bennett,0,15,30,30
1650701442503,MATH 142A,B02,083222,Chow; Bennett,0,14,30,30
1650701448531,MATH 193A,A01,083224,Staff,0,5,30,30
1650701448531,MATH 193A,A02,083225,Staff,0,6,30,30
1650701448531,MATH 193A,A03,083781,Staff,0,6,30,30
1650701448531,MATH 193A,A04,083782,Staff,0,7,30,30
1650701454556,MATH 197,001,091859,McAuley; Julian John,9998,0,9999,1
1650701460622,COGS 9,A01,083615,Staff,1,15,60,59
1650701466650,COGS 11,A01,083617,Boyle; Mary E. T.,16,0,40,24
1650701472675,COGS 13,A01,083071,Staff,0,38,40,40
1650701478698,COGS 14A,A01,092681,Staff,0,35,100,100
1650701484721,COGS 14B,A01,083073,Cheng; Tzu-Han,1,13,50,49
1650701490752,COGS 17,A01,092677,Staff,13,0,75,62
1650701496777,COGS 100,A01,083619,Staff,0,28,60,60
1650701502804,COGS 101A,A01,083621,Davis; Joshua Daniel,0,27,60,60
1650701508832,COGS 101B,A01,091572,Staff,0,4,60,60
1650701514858,COGS 101C,A01,083625,Delgado; Tania,14,0,30,16
1650701520883,COGS 107A,A01,083627,Boyle; Mary E. T.,0,16,60,60
1650701526908,COGS 118A,A01,083075,Staff,0,8,60,60
1650701532945,CSE 3,A50,083646,Miranda; Gregory Joseph,18,0,38,20
1650701532945,CSE 3,A51,083647,Miranda; Gregory Joseph,36,0,37,1
1650701538969,CSE 8A,A50,083650,Miranda; Gregory Joseph,0,30,40,40
1650701545000,CSE 11,A01,083080,Cao; Yingjun,0,96,40,40
1650701551035,CSE 12,A01,083652,Staff,0,21,100,100
1650701557066,CSE 15L,A01,083654,Staff,0,3,50,50
1650701557066,CSE 15L,A02,083655,Staff,0,2,50,50
1650701563095,CSE 20,A01,083657,Staff,49,0,80,31
1650701569119,CSE 30,A01,083084,Eldon; John,0,77,40,40
1650701575145,CSE 100,A01,083659,Cao; Yingjun,0,70,50,50
1650701581175,CSE 134B,A01,083661,Powell; Thomas Allan,0,38,65,65
1650701587200,CSE 140,A01,083663,Staff,0,10,75,75
1650701593228,CSE 140L,A01,083088,Eldon; John,0,19,75,75
1650701599258,CSE 175,A01,083665,Kumar; Rakesh,7,0,25,18
1650701605284,CSE 190,A00,092507,Dubnov; Shlomo,10,0,20,10
1650701611310,ECE 45,A01,083139,Staff,1,2,60,59
1650701617335,ECE 65,A50,083695,Staff,0,5,30,30
1650701623365,ECE 109,A01,091882,Touri; Behrouz,33,0,70,37
1650701629394,ECE 180,A00,083140,Abi Samra; Nicholas Camill,20,0,30,10
1650701629394,ECE 180,B00,083141,Abi Samra; Nicholas Camill,0,0,30,30
1650701635421,MATH 10A,A01,083735,Patchell; Gregory David,2,0,30,28
1650701635421,MATH 10A,A02,083736,Patchell; Gregory David,27,0,30,3
1650701635421,MATH 10A,A03,083737,Patchell; Gregory David,24,0,30,6
1650701641454,MATH 10B,A01,083207,Staff,0,9,30,30
1650701641454,MATH 10B,A02,083208,Staff,1,7,30,29
1650701641454,MATH 10B,B01,083739,Staff,11,0,30,19
1650701641454,MATH 10B,B02,083740,Staff,28,0,30,2
1650701647486,MATH 18,A01,083743,Staff,0,0,30,30
1650701647486,MATH 18,A02,083744,Staff,23,0,30,7
1650701647486,MATH 18,A03,083745,Staff,21,0,30,9
1650701647486,MATH 18,A04,083746,Staff,26,0,30,4
1650701647486,MATH 18,B01,083748,Staff,0,15,30,30
1650701647486,MATH 18,B02,083749,Staff,0,12,30,30
1650701647486,MATH 18,B03,083750,Staff,0,12,30,30
1650701647486,MATH 18,B04,083751,Staff,0,12,30,30
1650701653510,MATH 20A,A01,083754,Staff,19,0,40,21
1650701659534,MATH 20B,A01,083756,Staff,0,11,30,30
1650701659534,MATH 20B,A02,083757,Staff,0,12,30,30
1650701665559,MATH 20C,A01,083760,Staff,0,16,30,30
1650701665559,MATH 20C,A02,083761,Staff,0,15,30,30
1650701665559,MATH 20C,B01,083762,Staff,9,0,30,21
1650701665559,MATH 20C,B02,083763,Staff,28,0,30,2
1650701671588,MATH 20D,A01,083765,Staff,2,1,30,28
1650701671588,MATH 20D,A02,083766,Staff,6,0,30,24
1650701671588,MATH 20D,A03,083767,Staff,24,0,30,6
1650701677614,MATH 20E,A01,083771,Staff,3,0,30,27
1650701677614,MATH 20E,A02,083772,Staff,16,0,30,14
1650701677614,MATH 20E,B01,083773,Staff,0,0,30,30
1650701677614,MATH 20E,B02,083774,Staff,6,0,30,24
1650701683646,MATH 103A,A01,083777,Staff,0,15,30,30
1650701683646,MATH 103A,A02,083778,Staff,0,15,30,30
1650701683646,MATH 103A,B01,083779,Staff,0,15,30,30
1650701683646,MATH 103A,B02,083780,Staff,0,15,30,30
1650701689671,MATH 105,A01,085443,Staff,0,22,30,30
1650701695697,MATH 109,A01,083213,Anzaldo; Leesa B,0,7,30,30
1650701695697,MATH 109,A02,083214,Anzaldo; Leesa B,0,7,30,30
1650701695697,MATH 109,B01,083215,Anzaldo; Leesa B,0,8,30,30
1650701695697,MATH 109,B02,083216,Anzaldo; Leesa B,0,6,30,30
1650701701727,MATH 142A,A01,083219,Chow; Bennett,0,16,30,30
1650701701727,MATH 142A,A02,083220,Chow; Bennett,0,15,30,30
1650701701727,MATH 142A,B01,083221,Chow; Bennett,0,15,30,30
1650701701727,MATH 142A,B02,083222,Chow; Bennett,0,14,30,30
1650701707754,MATH 193A,A01,083224,Staff,0,5,30,30
1650701707754,MATH 193A,A02,083225,Staff,0,6,30,30
1650701707754,MATH 193A,A03,083781,Staff,0,6,30,30
1650701707754,MATH 193A,A04,083782,Staff,0,7,30,30
1650701713785,MATH 197,001,091859,McAuley; Julian John,9998,0,9999,1
1650701719847,COGS 9,A01,083615,Staff,1,15,60,59
1650701725871,COGS 11,A01,083617,Boyle; Mary E. T.,16,0,40,24
1650701731896,COGS 13,A01,083071,Staff,0,38,40,40
1650701737919,COGS 14A,A01,092681,Staff,0,35,100,100
1650701743947,COGS 14B,A01,083073,Cheng; Tzu-Han,1,13,50,49
1650701749974,COGS 17,A01,092677,Staff,13,0,75,62
1650701756001,COGS 100,A01,083619,Staff,0,28,60,60
1650701762034,COGS 101A,A01,083621,Davis; Joshua Daniel,0,27,60,60
1650701768060,COGS 101B,A01,091572,Staff,0,4,60,60
1650701774090,COGS 101C,A01,083625,Delgado; Tania,14,0,30,16
1650701780115,COGS 107A,A01,083627,Boyle; Mary E. T.,0,16,60,60
1650701786139,COGS 118A,A01,083075,Staff,0,8,60,60
1650701792168,CSE 3,A50,083646,Miranda; Gregory Joseph,18,0,38,20
1650701792168,CSE 3,A51,083647,Miranda; Gregory Joseph,36,0,37,1
1650701798194,CSE 8A,A50,083650,Miranda; Gregory Joseph,0,30,40,40
1650701804220,CSE 11,A01,083080,Cao; Yingjun,0,96,40,40
1650701810244,CSE 12,A01,083652,Staff,0,21,100,100
1650701816271,CSE 15L,A01,083654,Staff,0,3,50,50
1650701816271,CSE 15L,A02,083655,Staff,0,2,50,50
1650701822295,CSE 20,A01,083657,Staff,49,0,80,31
1650701828334,CSE 30,A01,083084,Eldon; John,0,77,40,40
1650701834360,CSE 100,A01,083659,Cao; Yingjun,0,70,50,50
1650701840386,CSE 134B,A01,083661,Powell; Thomas Allan,0,38,65,65
1650701846411,CSE 140,A01,083663,Staff,0,11,75,75
1650701852435,CSE 140L,A01,083088,Eldon; John,0,19,75,75
1650701858461,CSE 175,A01,083665,Kumar; Rakesh,7,0,25,18
1650701864485,CSE 190,A00,092507,Dubnov; Shlomo,10,0,20,10
1650701870513,ECE 45,A01,083139,Staff,1,2,60,59
1650701876540,ECE 65,A50,083695,Staff,0,5,30,30
1650701882570,ECE 109,A01,091882,Touri; Behrouz,33,0,70,37
1650701888593,ECE 180,A00,083140,Abi Samra; Nicholas Camill,20,0,30,10
1650701888593,ECE 180,B00,083141,Abi Samra; Nicholas Camill,0,0,30,30
1650701894626,MATH 10A,A01,083735,Patchell; Gregory David,2,0,30,28
1650701894626,MATH 10A,A02,083736,Patchell; Gregory David,27,0,30,3
1650701894626,MATH 10A,A03,083737,Patchell; Gregory David,24,0,30,6
1650701900654,MATH 10B,A01,083207,Staff,0,9,30,30
1650701900654,MATH 10B,A02,083208,Staff,1,7,30,29
1650701900654,MATH 10B,B01,083739,Staff,11,0,30,19
1650701900654,MATH 10B,B02,083740,Staff,28,0,30,2
1650701906679,MATH 18,A01,083743,Staff,0,0,30,30
1650701906679,MATH 18,A02,083744,Staff,23,0,30,7
1650701906679,MATH 18,A03,083745,Staff,21,0,30,9
1650701906679,MATH 18,A04,083746,Staff,26,0,30,4
1650701906679,MATH 18,B01,083748,Staff,0,15,30,30
1650701906679,MATH 18,B02,083749,Staff,0,12,30,30
1650701906679,MATH 18,B03,083750,Staff,0,12,30,30
1650701906679,MATH 18,B04,083751,Staff,0,12,30,30
1650701912706,MATH 20A,A01,083754,Staff,19,0,40,21
1650701918731,MATH 20B,A01,083756,Staff,0,11,30,30
1650701918731,MATH 20B,A02,083757,Staff,0,12,30,30
1650701924755,MATH 20C,A01,083760,Staff,0,16,30,30
1650701924755,MATH 20C,A02,083761,Staff,0,15,30,30
1650701924755,MATH 20C,B01,083762,Staff,9,0,30,21
1650701924755,MATH 20C,B02,083763,Staff,28,0,30,2
1650701930783,MATH 20D,A01,083765,Staff,2,1,30,28
1650701930783,MATH 20D,A02,083766,Staff,6,0,30,24
1650701930783,MATH 20D,A03,083767,Staff,24,0,30,6
1650701936814,MATH 20E,A01,083771,Staff,3,0,30,27
1650701936814,MATH 20E,A02,083772,Staff,16,0,30,14
1650701936814,MATH 20E,B01,083773,Staff,0,0,30,30
1650701936814,MATH 20E,B02,083774,Staff,6,0,30,24
1650701942866,MATH 103A,A01,083777,Staff,0,15,30,30
1650701942866,MATH 103A,A02,083778,Staff,0,15,30,30
1650701942866,MATH 103A,B01,083779,Staff,0,15,30,30
1650701942866,MATH 103A,B02,083780,Staff,0,15,30,30
1650701948901,MATH 105,A01,085443,Staff,0,22,30,30
1650701954929,MATH 109,A01,083213,Anzaldo; Leesa B,0,7,30,30
1650701954929,MATH 109,A02,083214,Anzaldo; Leesa B,0,7,30,30
1650701954929,MATH 109,B01,083215,Anzaldo; Leesa B,0,8,30,30
1650701954929,MATH 109,B02,083216,Anzaldo; Leesa B,0,6,30,30
1650701960958,MATH 142A,A01,083219,Chow; Bennett,0,16,30,30
1650701960958,MATH 142A,A02,083220,Chow; Bennett,0,15,30,30
1650701960958,MATH 142A,B01,083221,Chow; Bennett,0,15,30,30
1650701960958,MATH 142A,B02,083222,Chow; Bennett,0,14,30,30
1650701966981,MATH 193A,A01,083224,Staff,0,5,30,30
1650701966981,MATH 193A,A02,083225,Staff,0,6,30,30
1650701966981,MATH 193A,A03,083781,Staff,0,6,30,30
1650701966981,MATH 193A,A04,083782,Staff,0,7,30,30
1650701973008,MATH 197,001,091859,McAuley; Julian John,9998,0,9999,1
1650701979086,COGS 9,A01,083615,Staff,1,15,60,59
1650701985112,COGS 11,A01,083617,Boyle; Mary E. T.,16,0,40,24
1650701991137,COGS 13,A01,083071,Staff,0,38,40,40
1650701997165,COGS 14A,A01,092681,Staff,0,35,100,100
1650702003190,COGS 14B,A01,083073,Cheng; Tzu-Han,1,13,50,49
1650702009213,COGS 17,A01,092677,Staff,13,0,75,62
1650702015315,COGS 100,A01,083619,Staff,0,28,60,60
1650702021344,COGS 101A,A01,083621,Davis; Joshua Daniel,0,27,60,60
1650702027372,COGS 101B,A01,091572,Staff,0,4,60,60
1650702033399,COGS 101C,A01,083625,Delgado; Tania,14,0,30,16
1650702039423,COGS 107A,A01,083627,Boyle; Mary E. T.,0,16,60,60
1650702045450,COGS 118A,A01,083075,Staff,0,8,60,60
1650702051476,CSE 3,A50,083646,Miranda; Gregory Joseph,18,0,38,20
1650702051476,CSE 3,A51,083647,Miranda; Gregory Joseph,36,0,37,1
1650702057501,CSE 8A,A50,083650,Miranda; Gregory Joseph,0,30,40,40
1650702063540,CSE 11,A01,083080,Cao; Yingjun,0,96,40,40
1650702069563,CSE 12,A01,083652,Staff,0,21,100,100
1650702075585,CSE 15L,A01,083654,Staff,0,3,50,50
1650702075585,CSE 15L,A02,083655,Staff,0,2,50,50
1650702081617,CSE 20,A01,083657,Staff,49,0,80,31
1650702087642,CSE 30,A01,083084,Eldon; John,0,77,40,40
1650702093670,CSE 100,A01,083659,Cao; Yingjun,0,70,50,50
1650702099702,CSE 134B,A01,083661,Powell; Thomas Allan,0,38,65,65
1650702105728,CSE 140,A01,083663,Staff,0,11,75,75
1650702111752,CSE 140L,A01,083088,Eldon; John,0,19,75,75
1650702117794,CSE 175,A01,083665,Kumar; Rakesh,7,0,25,18
1650702123829,CSE 190,A00,092507,Dubnov; Shlomo,10,0,20,10
1650702129862,ECE 45,A01,083139,Staff,1,2,60,59
1650702135889,ECE 65,A50,083695,Staff,0,5,30,30
1650702141917,ECE 109,A01,091882,Touri; Behrouz,33,0,70,37
1650702147947,ECE 180,A00,083140,Abi Samra; Nicholas Camill,20,0,30,10
1650702147947,ECE 180,B00,083141,Abi Samra; Nicholas Camill,0,0,30,30
1650702153976,MATH 10A,A01,083735,Patchell; Gregory David,2,0,30,28
1650702153976,MATH 10A,A02,083736,Patchell; Gregory David,27,0,30,3
1650702153976,MATH 10A,A03,083737,Patchell; Gregory David,24,0,30,6
1650702160004,MATH 10B,A01,083207,Staff,0,9,30,30
1650702160004,MATH 10B,A02,083208,Staff,1,7,30,29
1650702160004,MATH 10B,B01,083739,Staff,11,0,30,19
1650702160004,MATH 10B,B02,083740,Staff,28,0,30,2
1650702166038,MATH 18,A01,083743,Staff,0,0,30,30
1650702166038,MATH 18,A02,083744,Staff,23,0,30,7
1650702166038,MATH 18,A03,083745,Staff,21,0,30,9
1650702166038,MATH 18,A04,083746,Staff,26,0,30,4
1650702166038,MATH 18,B01,083748,Staff,0,15,30,30
1650702166038,MATH 18,B02,083749,Staff,0,12,30,30
1650702166038,MATH 18,B03,083750,Staff,0,12,30,30
1650702166038,MATH 18,B04,083751,Staff,0,12,30,30
1650702172079,MATH 20A,A01,083754,Staff,19,0,40,21
1650702178109,MATH 20B,A01,083756,Staff,0,11,30,30
1650702178109,MATH 20B,A02,083757,Staff,0,12,30,30
1650702184133,MATH 20C,A01,083760,Staff,0,16,30,30
1650702184133,MATH 20C,A02,083761,Staff,0,15,30,30
1650702184133,MATH 20C,B01,083762,Staff,9,0,30,21
1650702184133,MATH 20C,B02,083763,Staff,28,0,30,2
1650702190159,MATH 20D,A01,083765,Staff,2,1,30,28
1650702190159,MATH 20D,A02,083766,Staff,6,0,30,24
1650702190159,MATH 20D,A03,083767,Staff,24,0,30,6
1650702196182,MATH 20E,A01,083771,Staff,3,0,30,27
1650702196182,MATH 20E,A02,083772,Staff,16,0,30,14
1650702196182,MATH 20E,B01,083773,Staff,0,0,30,30
1650702196182,MATH 20E,B02,083774,Staff,6,0,30,24
1650702202208,MATH 103A,A01,083777,Staff,0,15,30,30
1650702202208,MATH 103A,A02,083778,Staff,0,15,30,30
1650702202208,MATH 103A,B01,083779,Staff,0,15,30,30
1650702202208,MATH 103A,B02,083780,Staff,0,15,30,30
1650702208231,MATH 105,A01,085443,Staff,0,22,30,30
1650702214260,MATH 109,A01,083213,Anzaldo; Leesa B,0,7,30,30
1650702214260,MATH 109,A02,083214,Anzaldo; Leesa B,0,7,30,30
1650702214260,MATH 109,B01,083215,Anzaldo; Leesa B,0,8,30,30
1650702214260,MATH 109,B02,083216,Anzaldo; Leesa B,0,6,30,30
1650702220285,MATH 142A,A01,083219,Chow; Bennett,0,16,30,30
1650702220285,MATH 142A,A02,083220,Chow; Bennett,0,15,30,30
1650702220285,MATH 142A,B01,083221,Chow; Bennett,0,15,30,30
1650702220285,MATH 142A,B02,083222,Chow; Bennett,0,14,30,30
1650702226311,MATH 193A,A01,083224,Staff,0,5,30,30
1650702226311,MATH 193A,A02,083225,Staff,0,6,30,30
1650702226311,MATH 193A,A03,083781,Staff,0,6,30,30
1650702226311,MATH 193A,A04,083782,Staff,0,7,30,30
1650702232350,MATH 197,001,091859,McAuley; Julian John,9998,0,9999,1
1650702238404,COGS 9,A01,083615,Staff,1,15,60,59
1650702244431,COGS 11,A01,083617,Boyle; Mary E. T.,16,0,40,24
1650702250455,COGS 13,A01,083071,Staff,0,38,40,40
1650702256483,COGS 14A,A01,092681,Staff,0,35,100,100
1650702262508,COGS 14B,A01,083073,Cheng; Tzu-Han,1,13,50,49
1650702268535,COGS 17,A01,092677,Staff,13,0,75,62
1650702274573,COGS 100,A01,083619,Staff,0,28,60,60
1650702280602,COGS 101A,A01,083621,Davis; Joshua Daniel,0,27,60,60
1650702286627,COGS 101B,A01,091572,Staff,0,4,60,60
1650702292656,COGS 101C,A01,083625,Delgado; Tania,14,0,30,16
1650702298683,COGS 107A,A01,083627,Boyle; Mary E. T.,0,16,60,60
1650702304707,COGS 118A,A01,083075,Staff,0,8,60,60
1650702310736,CSE 3,A50,083646,Miranda; Gregory Joseph,18,0,38,20
1650702310736,CSE 3,A51,083647,Miranda; Gregory Joseph,36,0,37,1
1650702316765,CSE 8A,A50,083650,Miranda; Gregory Joseph,0,30,40,40
1650702322806,CSE 11,A01,083080,Cao; Yingjun,0,96,40,40
1650702328833,CSE 12,A01,083652,Staff,0,21,100,100
1650702334860,CSE 15L,A01,083654,Staff,0,3,50,50
1650702334860,CSE 15L,A02,083655,Staff,0,2,50,50
1650702340887,CSE 20,A01,083657,Staff,49,0,80,31
1650702346921,CSE 30,A01,083084,Eldon; John,0,77,40,40
1650702352947,CSE 100,A01,083659,Cao; Yingjun,0,70,50,50
1650702358986,CSE 134B,A01,083661,Powell; Thomas Allan,0,38,65,65
1650702365013,CSE 140,A01,083663,Staff,0,11,75,75
1650702371042,CSE 140L,A01,083088,Eldon; John,0,20,75,75
1650702377069,CSE 175,A01,083665,Kumar; Rakesh,7,0,25,18
1650702383104,CSE 190,A00,092507,Dubnov; Shlomo,10,0,20,10
1650702389135,ECE 45,A01,083139,Staff,1,2,60,59
1650702395162,ECE 65,A50,083695,Staff,0,5,30,30
1650702401194,ECE 109,A01,091882,Touri; Behrouz,33,0,70,37
1650702407229,ECE 180,A00,083140,Abi Samra; Nicholas Camill,20,0,30,10
1650702407229,ECE 180,B00,083141,Abi Samra; Nicholas Camill,0,0,30,30
1650702413261,MATH 10A,A01,083735,Patchell; Gregory David,2,0,30,28
1650702413261,MATH 10A,A02,083736,Patchell; Gregory David,27,0,30,3
1650702413261,MATH 10A,A03,083737,Patchell; Gregory David,24,0,30,6
1650702419296,MATH 10B,A01,083207,Staff,0,9,30,30
1650702419296,MATH 10B,A02,083208,Staff,1,7,30,29
1650702419296,MATH 10B,B01,083739,Staff,11,0,30,19
1650702419296,MATH 10B,B02,083740,Staff,28,0,30,2
1650702425325,MATH 18,A01,083743,Staff,0,0,30,30
1650702425325,MATH 18,A02,083744,Staff,23,0,30,7
1650702425325,MATH 18,A03,083745,Staff,21,0,30,9
1650702425325,MATH 18,A04,083746,Staff,26,0,30,4
1650702425325,MATH 18,B01,083748,Staff,0,15,30,30
1650702425325,MATH 18,B02,083749,Staff,0,12,30,30
1650702425325,MATH 18,B03,083750,Staff,0,12,30,30
1650702425325,MATH 18,B04,083751,Staff,0,12,30,30
1650702431349,MATH 20A,A01,083754,Staff,19,0,40,21
1650702437379,MATH 20B,A01,083756,Staff,0,11,30,30
1650702437379,MATH 20B,A02,083757,Staff,0,12,30,30
1650702443413,MATH 20C,A01,083760,Staff,0,16,30,30
1650702443413,MATH 20C,A02,083761,Staff,0,15,30,30
1650702443413,MATH 20C,B01,083762,Staff,9,0,30,21
1650702443413,MATH 20C,B02,083763,Staff,28,0,30,2
1650702449437,MATH 20D,A01,083765,Staff,2,1,30,28
1650702449437,MATH 20D,A02,083766,Staff,6,0,30,24
1650702449437,MATH 20D,A03,083767,Staff,24,0,30,6
1650702455468,MATH 20E,A01,083771,Staff,3,0,30,27
1650702455468,MATH 20E,A02,083772,Staff,16,0,30,14
1650702455468,MATH 20E,B01,083773,Staff,0,0,30,30
1650702455468,MATH 20E,B02,083774,Staff,6,0,30,24
1650702461501,MATH 103A,A01,083777,Staff,0,15,30,30
1650702461501,MATH 103A,A02,083778,Staff,0,15,30,30
1650702461501,MATH 103A,B01,083779,Staff,0,15,30,30
1650702461501,MATH 103A,B02,083780,Staff,0,15,30,30
1650702467532,MATH 105,A01,085443,Staff,0,22,30,30
1650702473566,MATH 109,A01,083213,Anzaldo; Leesa B,0,7,30,30
1650702473566,MATH 109,A02,083214,Anzaldo; Leesa B,0,7,30,30
1650702473566,MATH 109,B01,083215,Anzaldo; Leesa B,0,8,30,30
1650702473566,MATH 109,B02,083216,Anzaldo; Leesa B,0,6,30,30
1650702479601,MATH 142A,A01,083219,Chow; Bennett,0,16,30,30
1650702479601,MATH 142A,A02,083220,Chow; Bennett,0,15,30,30
1650702479601,MATH 142A,B01,083221,Chow; Bennett,0,15,30,30
1650702479601,MATH 142A,B02,083222,Chow; Bennett,0,14,30,30
1650702485645,MATH 193A,A01,083224,Staff,0,5,30,30
1650702485645,MATH 193A,A02,083225,Staff,0,6,30,30
1650702485645,MATH 193A,A03,083781,Staff,0,6,30,30
1650702485645,MATH 193A,A04,083782,Staff,0,7,30,30
1650702491670,MATH 197,001,091859,McAuley; Julian John,9998,0,9999,1
1650702497758,COGS 9,A01,083615,Staff,1,15,60,59
1650702503784,COGS 11,A01,083617,Boyle; Mary E. T.,16,0,40,24
1650702509815,COGS 13,A01,083071,Staff,0,38,40,40
1650702515842,COGS 14A,A01,092681,Staff,0,35,100,100
1650702521874,COGS 14B,A01,083073,Cheng; Tzu-Han,1,13,50,49
1650702527900,COGS 17,A01,092677,Staff,13,0,75,62
1650702533927,COGS 100,A01,083619,Staff,0,28,60,60
1650702539965,COGS 101A,A01,083621,Davis; Joshua Daniel,0,27,60,60
1650702545996,COGS 101B,A01,091572,Staff,0,4,60,60
1650702552027,COGS 101C,A01,083625,Delgado; Tania,14,0,30,16
1650702558055,COGS 107A,A01,083627,Boyle; Mary E. T.,0,16,60,60
1650702564081,COGS 118A,A01,083075,Staff,0,8,60,60
1650702570112,CSE 3,A50,083646,Miranda; Gregory Joseph,18,0,38,20
1650702570112,CSE 3,A51,083647,Miranda; Gregory Joseph,36,0,37,1
1650702576142,CSE 8A,A50,083650,Miranda; Gregory Joseph,0,30,40,40
1650702582170,CSE 11,A01,083080,Cao; Yingjun,0,96,40,40
1650702588201,CSE 12,A01,083652,Staff,0,21,100,100
1650702594245,CSE 15L,A01,083654,Staff,0,3,50,50
1650702594245,CSE 15L,A02,083655,Staff,0,2,50,50
1650702600269,CSE 20,A01,083657,Staff,49,0,80,31
1650702606296,CSE 30,A01,083084,Eldon; John,0,77,40,40
1650702612398,CSE 100,A01,083659,Cao; Yingjun,0,70,50,50
1650702618425,CSE 134B,A01,083661,Powell; Thomas Allan,0,38,65,65
1650702624449,CSE 140,A01,083663,Staff,0,11,75,75
1650702630472,CSE 140L,A01,083088,Eldon; John,0,20,75,75
1650702636503,CSE 175,A01,083665,Kumar; Rakesh,7,0,25,18
1650702642529,CSE 190,A00,092507,Dubnov; Shlomo,10,0,20,10
1650702648552,ECE 45,A01,083139,Staff,1,2,60,59
1650702654575,ECE 65,A50,083695,Staff,0,5,30,30
1650702660600,ECE 109,A01,091882,Touri; Behrouz,33,0,70,37
1650702666625,ECE 180,A00,083140,Abi Samra; Nicholas Camill,20,0,30,10
1650702666625,ECE 180,B00,083141,Abi Samra; Nicholas Camill,0,0,30,30
1650702672651,MATH 10A,A01,083735,Patchell; Gregory David,2,0,30,28
1650702672651,MATH 10A,A02,083736,Patchell; Gregory David,27,0,30,3
1650702672651,MATH 10A,A03,083737,Patchell; Gregory David,24,0,30,6
1650702678675,MATH 10B,A01,083207,Staff,0,9,30,30
1650702678675,MATH 10B,A02,083208,Staff,1,7,30,29
1650702678675,MATH 10B,B01,083739,Staff,11,0,30,19
1650702678675,MATH 10B,B02,083740,Staff,28,0,30,2
1650702684706,MATH 18,A01,083743,Staff,0,0,30,30
1650702684706,MATH 18,A02,083744,Staff,23,0,30,7
1650702684706,MATH 18,A03,083745,Staff,21,0,30,9
1650702684706,MATH 18,A04,083746,Staff,26,0,30,4
1650702684706,MATH 18,B01,083748,Staff,0,15,30,30
1650702684706,MATH 18,B02,083749,Staff,0,12,30,30
1650702684706,MATH 18,B03,083750,Staff,0,12,30,30
1650702684706,MATH 18,B04,083751,Staff,0,12,30,30
1650702690731,MATH 20A,A01,083754,Staff,19,0,40,21
1650702696761,MATH 20B,A01,083756,Staff,0,11,30,30
1650702696761,MATH 20B,A02,083757,Staff,0,12,30,30
1650702702790,MATH 20C,A01,083760,Staff,0,16,30,30
1650702702790,MATH 20C,A02,083761,Staff,0,15,30,30
1650702702790,MATH 20C,B01,083762,Staff,9,0,30,21
1650702702790,MATH 20C,B02,083763,Staff,28,0,30,2
1650702708815,MATH 20D,A01,083765,Staff,2,1,30,28
1650702708815,MATH 20D,A02,083766,Staff,6,0,30,24
1650702708815,MATH 20D,A03,083767,Staff,24,0,30,6
1650702714845,MATH 20E,A01,083771,Staff,3,0,30,27
1650702714845,MATH 20E,A02,083772,Staff,16,0,30,14
1650702714845,MATH 20E,B01,083773,Staff,0,0,30,30
1650702714845,MATH 20E,B02,083774,Staff,6,0,30,24
1650702720875,MATH 103A,A01,083777,Staff,0,15,30,30
1650702720875,MATH 103A,A02,083778,Staff,0,15,30,30
1650702720875,MATH 103A,B01,083779,Staff,0,15,30,30
1650702720875,MATH 103A,B02,083780,Staff,0,15,30,30
1650702726899,MATH 105,A01,085443,Staff,0,22,30,30
1650702732923,MATH 109,A01,083213,Anzaldo; Leesa B,0,7,30,30
1650702732923,MATH 109,A02,083214,Anzaldo; Leesa B,0,7,30,30
1650702732923,MATH 109,B01,083215,Anzaldo; Leesa B,0,8,30,30
1650702732923,MATH 109,B02,083216,Anzaldo; Leesa B,0,6,30,30
1650702738950,MATH 142A,A01,083219,Chow; Bennett,0,16,30,30
1650702738950,MATH 142A,A02,083220,Chow; Bennett,0,15,30,30
1650702738950,MATH 142A,B01,083221,Chow; Bennett,0,15,30,30
1650702738950,MATH 142A,B02,083222,Chow; Bennett,0,14,30,30
1650702744979,MATH 193A,A01,083224,Staff,0,5,30,30
1650702744979,MATH 193A,A02,083225,Staff,0,6,30,30
1650702744979,MATH 193A,A03,083781,Staff,0,6,30,30
1650702744979,MATH 193A,A04,083782,Staff,0,7,30,30
1650702751006,MATH 197,001,091859,McAuley; Julian John,9998,0,9999,1
1650702757072,COGS 9,A01,083615,Staff,1,15,60,59
1650702763104,COGS 11,A01,083617,Boyle; Mary E. T.,16,0,40,24
1650702769128,COGS 13,A01,083071,Staff,0,38,40,40
1650702775153,COGS 14A,A01,092681,Staff,0,35,100,100
1650702781178,COGS 14B,A01,083073,Cheng; Tzu-Han,1,13,50,49
1650702787202,COGS 17,A01,092677,Staff,13,0,75,62
1650702793228,COGS 100,A01,083619,Staff,0,28,60,60
1650702799256,COGS 101A,A01,083621,Davis; Joshua Daniel,0,27,60,60
1650702805281,COGS 101B,A01,091572,Staff,0,4,60,60
1650702811307,COGS 101C,A01,083625,Delgado; Tania,14,0,30,16
1650702817332,COGS 107A,A01,083627,Boyle; Mary E. T.,0,16,60,60
1650702823359,COGS 118A,A01,083075,Staff,0,8,60,60
1650702829393,CSE 3,A50,083646,Miranda; Gregory Joseph,18,0,38,20
1650702829393,CSE 3,A51,083647,Miranda; Gregory Joseph,36,0,37,1
1650702835419,CSE 8A,A50,083650,Miranda; Gregory Joseph,0,30,40,40
1650702841441,CSE 11,A01,083080,Cao; Yingjun,0,96,40,40
1650702847464,CSE 12,A01,083652,Staff,0,21,100,100
1650702853491,CSE 15L,A01,083654,Staff,0,3,50,50
1650702853491,CSE 15L,A02,083655,Staff,0,2,50,50
1650702859515,CSE 20,A01,083657,Staff,49,0,80,31
1650702865542,CSE 30,A01,083084,Eldon; John,0,77,40,40
1650702871571,CSE 100,A01,083659,Cao; Yingjun,0,70,50,50
1650702877595,CSE 134B,A01,083661,Powell; Thomas Allan,0,38,65,65
1650702883619,CSE 140,A01,083663,Staff,0,11,75,75
1650702889644,CSE 140L,A01,083088,Eldon; John,0,20,75,75
1650702895674,CSE 175,A01,083665,Kumar; Rakesh,7,0,25,18
1650702901698,CSE 190,A00,092507,Dubnov; Shlomo,10,0,20,10
1650702907722,ECE 45,A01,083139,Staff,1,2,60,59
1650702913748,ECE 65,A50,083695,Staff,0,5,30,30
1650702919772,ECE 109,A01,091882,Touri; Behrouz,33,0,70,37
1650702925798,ECE 180,A00,083140,Abi Samra; Nicholas Camill,20,0,30,10
1650702925798,ECE 180,B00,083141,Abi Samra; Nicholas Camill,0,0,30,30
1650702931830,MATH 10A,A01,083735,Patchell; Gregory David,2,0,30,28
1650702931830,MATH 10A,A02,083736,Patchell; Gregory David,27,0,30,3
1650702931830,MATH 10A,A03,083737,Patchell; Gregory David,24,0,30,6
1650702937862,MATH 10B,A01,083207,Staff,0,9,30,30
1650702937862,MATH 10B,A02,083208,Staff,1,7,30,29
1650702937862,MATH 10B,B01,083739,Staff,11,0,30,19
1650702937862,MATH 10B,B02,083740,Staff,28,0,30,2
1650702943891,MATH 18,A01,083743,Staff,0,0,30,30
1650702943891,MATH 18,A02,083744,Staff,23,0,30,7
1650702943891,MATH 18,A03,083745,Staff,21,0,30,9
1650702943891,MATH 18,A04,083746,Staff,26,0,30,4
1650702943891,MATH 18,B01,083748,Staff,0,15,30,30
1650702943891,MATH 18,B02,083749,Staff,0,12,30,30
1650702943891,MATH 18,B03,083750,Staff,0,12,30,30
1650702943891,MATH 18,B04,083751,Staff,0,12,30,30
1650702949921,MATH 20A,A01,083754,Staff,19,0,40,21
1650702955946,MATH 20B,A01,083756,Staff,0,11,30,30
1650702955946,MATH 20B,A02,083757,Staff,0,12,30,30
1650702961977,MATH 20C,A01,083760,Staff,0,16,30,30
1650702961977,MATH 20C,A02,083761,Staff,0,15,30,30
1650702961977,MATH 20C,B01,083762,Staff,9,0,30,21
1650702961977,MATH 20C,B02,083763,Staff,28,0,30,2
1650702968005,MATH 20D,A01,083765,Staff,2,1,30,28
1650702968005,MATH 20D,A02,083766,Staff,6,0,30,24
1650702968005,MATH 20D,A03,083767,Staff,24,0,30,6
1650702974031,MATH 20E,A01,083771,Staff,3,0,30,27
1650702974031,MATH 20E,A02,083772,Staff,16,0,30,14
1650702974031,MATH 20E,B01,083773,Staff,0,0,30,30
1650702974031,MATH 20E,B02,083774,Staff,6,0,30,24
1650702980064,MATH 103A,A01,083777,Staff,0,15,30,30
1650702980064,MATH 103A,A02,083778,Staff,0,15,30,30
1650702980064,MATH 103A,B01,083779,Staff,0,15,30,30
1650702980064,MATH 103A,B02,083780,Staff,0,15,30,30
1650702986093,MATH 105,A01,085443,Staff,0,22,30,30
1650702992125,MATH 109,A01,083213,Anzaldo; Leesa B,0,7,30,30
1650702992125,MATH 109,A02,083214,Anzaldo; Leesa B,0,7,30,30
1650702992125,MATH 109,B01,083215,Anzaldo; Leesa B,0,8,30,30
1650702992125,MATH 109,B02,083216,Anzaldo; Leesa B,0,6,30,30
1650702998155,MATH 142A,A01,083219,Chow; Bennett,0,16,30,30
1650702998155,MATH 142A,A02,083220,Chow; Bennett,0,15,30,30
1650702998155,MATH 142A,B01,083221,Chow; Bennett,0,15,30,30
1650702998155,MATH 142A,B02,083222,Chow; Bennett,0,14,30,30
1650703004190,MATH 193A,A01,083224,Staff,0,5,30,30
1650703004190,MATH 193A,A02,083225,Staff,0,6,30,30
1650703004190,MATH 193A,A03,083781,Staff,0,6,30,30
1650703004190,MATH 193A,A04,083782,Staff,0,7,30,30
1650703010220,MATH 197,001,091859,McAuley; Julian John,9998,0,9999,1
1650703016294,COGS 9,A01,083615,Staff,1,15,60,59
1650703022320,COGS 11,A01,083617,Boyle; Mary E. T.,16,0,40,24
1650703028344,COGS 13,A01,083071,Staff,0,38,40,40
1650703034372,COGS 14A,A01,092681,Staff,0,35,100,100
1650703040401,COGS 14B,A01,083073,Cheng; Tzu-Han,1,13,50,49
1650703046438,COGS 17,A01,092677,Staff,13,0,75,62
1650703052468,COGS 100,A01,083619,Staff,0,28,60,60
1650703058494,COGS 101A,A01,083621,Davis; Joshua Daniel,0,27,60,60
1650703064519,COGS 101B,A01,091572,Staff,0,4,60,60
1650703070551,COGS 101C,A01,083625,Delgado; Tania,14,0,30,16
1650703076578,COGS 107A,A01,083627,Boyle; Mary E. T.,0,16,60,60
1650703082605,COGS 118A,A01,083075,Staff,0,8,60,60
1650703088630,CSE 3,A50,083646,Miranda; Gregory Joseph,18,0,38,20
1650703088630,CSE 3,A51,083647,Miranda; Gregory Joseph,36,0,37,1
1650703094654,CSE 8A,A50,083650,Miranda; Gregory Joseph,0,30,40,40
1650703100683,CSE 11,A01,083080,Cao; Yingjun,0,96,40,40
1650703106708,CSE 12,A01,083652,Staff,0,21,100,100
1650703112737,CSE 15L,A01,083654,Staff,0,3,50,50
1650703112737,CSE 15L,A02,083655,Staff,0,2,50,50
1650703118769,CSE 20,A01,083657,Staff,49,0,80,31
1650703124800,CSE 30,A01,083084,Eldon; John,0,77,40,40
1650703130826,CSE 100,A01,083659,Cao; Yingjun,0,70,50,50
1650703136850,CSE 134B,A01,083661,Powell; Thomas Allan,0,38,65,65
1650703142876,CSE 140,A01,083663,Staff,0,11,75,75
1650703148901,CSE 140L,A01,083088,Eldon; John,0,20,75,75
1650703154925,CSE 175,A01,083665,Kumar; Rakesh,7,0,25,18
1650703160949,CSE 190,A00,092507,Dubnov; Shlomo,10,0,20,10
1650703166973,ECE 45,A01,083139,Staff,1,2,60,59
1650703173008,ECE 65,A50,083695,Staff,0,5,30,30
1650703179041,ECE 109,A01,091882,Touri; Behrouz,33,0,70,37
1650703185071,ECE 180,A00,083140,Abi Samra; Nicholas Camill,20,0,30,10
1650703185071,ECE 180,B00,083141,Abi Samra; Nicholas Camill,0,0,30,30
1650703191099,MATH 10A,A01,083735,Patchell; Gregory David,2,0,30,28
1650703191099,MATH 10A,A02,083736,Patchell; Gregory David,27,0,30,3
1650703191099,MATH 10A,A03,083737,Patchell; Gregory David,24,0,30,6
1650703197126,MATH 10B,A01,083207,Staff,0,9,30,30
1650703197126,MATH 10B,A02,083208,Staff,1,7,30,29
1650703197126,MATH 10B,B01,083739,Staff,11,0,30,19
1650703197126,MATH 10B,B02,083740,Staff,28,0,30,2
1650703203163,MATH 18,A01,083743,Staff,0,0,30,30
1650703203163,MATH 18,A02,083744,Staff,23,0,30,7
1650703203163,MATH 18,A03,083745,Staff,21,0,30,9
1650703203163,MATH 18,A04,083746,Staff,26,0,30,4
1650703203163,MATH 18,B01,083748,Staff,0,15,30,30
1650703203163,MATH 18,B02,083749,Staff,0,12,30,30
1650703203163,MATH 18,B03,083750,Staff,0,12,30,30
1650703203163,MATH 18,B04,083751,Staff,0,12,30,30
1650703209273,MATH 20A,A01,083754,Staff,19,0,40,21
1650703215302,MATH 20B,A01,083756,Staff,0,11,30,30
1650703215302,MATH 20B,A02,083757,Staff,0,12,30,30
1650703221329,MATH 20C,A01,083760,Staff,0,16,30,30
1650703221329,MATH 20C,A02,083761,Staff,0,15,30,30
1650703221329,MATH 20C,B01,083762,Staff,9,0,30,21
1650703221329,MATH 20C,B02,083763,Staff,28,0,30,2
1650703227358,MATH 20D,A01,083765,Staff,2,1,30,28
1650703227358,MATH 20D,A02,083766,Staff,6,0,30,24
1650703227358,MATH 20D,A03,083767,Staff,24,0,30,6
1650703233383,MATH 20E,A01,083771,Staff,3,0,30,27
1650703233383,MATH 20E,A02,083772,Staff,16,0,30,14
1650703233383,MATH 20E,B01,083773,Staff,0,0,30,30
1650703233383,MATH 20E,B02,083774,Staff,6,0,30,24
1650703239419,MATH 103A,A01,083777,Staff,0,15,30,30
1650703239419,MATH 103A,A02,083778,Staff,0,15,30,30
1650703239419,MATH 103A,B01,083779,Staff,0,15,30,30
1650703239419,MATH 103A,B02,083780,Staff,0,15,30,30
1650703245444,MATH 105,A01,085443,Staff,0,22,30,30
1650703251479,MATH 109,A01,083213,Anzaldo; Leesa B,0,7,30,30
1650703251479,MATH 109,A02,083214,Anzaldo; Leesa B,0,7,30,30
1650703251479,MATH 109,B01,083215,Anzaldo; Leesa B,0,8,30,30
1650703251479,MATH 109,B02,083216,Anzaldo; Leesa B,0,6,30,30
1650703257507,MATH 142A,A01,083219,Chow; Bennett,0,16,30,30
1650703257507,MATH 142A,A02,083220,Chow; Bennett,0,15,30,30
1650703257507,MATH 142A,B01,083221,Chow; Bennett,0,15,30,30
1650703257507,MATH 142A,B02,083222,Chow; Bennett,0,14,30,30
1650703263535,MATH 193A,A01,083224,Staff,0,5,30,30
1650703263535,MATH 193A,A02,083225,Staff,0,6,30,30
1650703263535,MATH 193A,A03,083781,Staff,0,6,30,30
1650703263535,MATH 193A,A04,083782,Staff,0,7,30,30
1650703269566,MATH 197,001,091859,McAuley; Julian John,9998,0,9999,1
1650703275632,COGS 9,A01,083615,Staff,1,15,60,59
1650703281657,COGS 11,A01,083617,Boyle; Mary E. T.,16,0,40,24
1650703287685,COGS 13,A01,083071,Staff,0,38,40,40
1650703293712,COGS 14A,A01,092681,Staff,0,35,100,100
1650703299735,COGS 14B,A01,083073,Cheng; Tzu-Han,1,13,50,49
1650703305761,COGS 17,A01,092677,Staff,13,0,75,62
1650703311785,COGS 100,A01,083619,Staff,0,28,60,60
1650703317810,COGS 101A,A01,083621,Davis; Joshua Daniel,0,27,60,60
1650703323840,COGS 101B,A01,091572,Staff,0,4,60,60
1650703329865,COGS 101C,A01,083625,Delgado; Tania,14,0,30,16
1650703335891,COGS 107A,A01,083627,Boyle; Mary E. T.,0,16,60,60
1650703341914,COGS 118A,A01,083075,Staff,0,8,60,60
1650703347944,CSE 3,A50,083646,Miranda; Gregory Joseph,18,0,38,20
1650703347944,CSE 3,A51,083647,Miranda; Gregory Joseph,36,0,37,1
1650703353971,CSE 8A,A50,083650,Miranda; Gregory Joseph,0,30,40,40
1650703359995,CSE 11,A01,083080,Cao; Yingjun,0,96,40,40
1650703366020,CSE 12,A01,083652,Staff,0,21,100,100
1650703372045,CSE 15L,A01,083654,Staff,0,3,50,50
1650703372045,CSE 15L,A02,083655,Staff,0,2,50,50
1650703378073,CSE 20,A01,083657,Staff,49,0,80,31
1650703384102,CSE 30,A01,083084,Eldon; John,0,77,40,40
1650703390127,CSE 100,A01,083659,Cao; Yingjun,0,70,50,50
1650703396159,CSE 134B,A01,083661,Powell; Thomas Allan,0,38,65,65
1650703402189,CSE 140,A01,083663,Staff,0,11,75,75
1650703408216,CSE 140L,A01,083088,Eldon; John,0,20,75,75
1650703414241,CSE 175,A01,083665,Kumar; Rakesh,7,0,25,18
1650703420268,CSE 190,A00,092507,Dubnov; Shlomo,10,0,20,10
1650703426291,ECE 45,A01,083139,Staff,1,2,60,59
1650703432316,ECE 65,A50,083695,Staff,0,5,30,30
1650703438345,ECE 109,A01,091882,Touri; Behrouz,33,0,70,37
1650703444370,ECE 180,A00,083140,Abi Samra; Nicholas Camill,20,0,30,10
1650703444370,ECE 180,B00,083141,Abi Samra; Nicholas Camill,0,0,30,30
1650703450396,MATH 10A,A01,083735,Patchell; Gregory David,2,0,30,28
1650703450396,MATH 10A,A02,083736,Patchell; Gregory David,27,0,30,3
1650703450396,MATH 10A,A03,083737,Patchell; Gregory David,24,0,30,6
1650703456431,MATH 10B,A01,083207,Staff,0,9,30,30
1650703456431,MATH 10B,A02,083208,Staff,1,7,30,29
1650703456431,MATH 10B,B01,083739,Staff,11,0,30,19
1650703456431,MATH 10B,B02,083740,Staff,28,0,30,2
1650703462464,MATH 18,A01,083743,Staff,0,0,30,30
1650703462464,MATH 18,A02,083744,Staff,23,0,30,7
1650703462464,MATH 18,A03,083745,Staff,21,0,30,9
1650703462464,MATH 18,A04,083746,Staff,26,0,30,4
1650703462464,MATH 18,B01,083748,Staff,0,15,30,30
1650703462464,MATH 18,B02,083749,Staff,0,12,30,30
1650703462464,MATH 18,B03,083750,Staff,0,12,30,30
1650703462464,MATH 18,B04,083751,Staff,0,12,30,30
1650703468490,MATH 20A,A01,083754,Staff,19,0,40,21
1650703474515,MATH 20B,A01,083756,Staff,0,11,30,30
1650703474515,MATH 20B,A02,083757,Staff,0,12,30,30
1650703480540,MATH 20C,A01,083760,Staff,0,16,30,30
1650703480540,MATH 20C,A02,083761,Staff,0,15,30,30
1650703480540,MATH 20C,B01,083762,Staff,9,0,30,21
1650703480540,MATH 20C,B02,083763,Staff,28,0,30,2
1650703486566,MATH 20D,A01,083765,Staff,2,1,30,28
1650703486566,MATH 20D,A02,083766,Staff,6,0,30,24
1650703486566,MATH 20D,A03,083767,Staff,24,0,30,6
1650703492595,MATH 20E,A01,083771,Staff,3,0,30,27
1650703492595,MATH 20E,A02,083772,Staff,16,0,30,14
1650703492595,MATH 20E,B01,083773,Staff,0,0,30,30
1650703492595,MATH 20E,B02,083774,Staff,6,0,30,24
1650703498625,MATH 103A,A01,083777,Staff,0,15,30,30
1650703498625,MATH 103A,A02,083778,Staff,0,15,30,30
1650703498625,MATH 103A,B01,083779,Staff,0,15,30,30
1650703498625,MATH 103A,B02,083780,Staff,0,15,30,30
1650703504649,MATH 105,A01,085443,Staff,0,22,30,30
1650703510673,MATH 109,A01,083213,Anzaldo; Leesa B,0,7,30,30
1650703510673,MATH 109,A02,083214,Anzaldo; Leesa B,0,7,30,30
1650703510673,MATH 109,B01,083215,Anzaldo; Leesa B,0,8,30,30
1650703510673,MATH 109,B02,083216,Anzaldo; Leesa B,0,6,30,30
1650703516700,MATH 142A,A01,083219,Chow; Bennett,0,16,30,30
1650703516700,MATH 142A,A02,083220,Chow; Bennett,0,15,30,30
1650703516700,MATH 142A,B01,083221,Chow; Bennett,0,15,30,30
1650703516700,MATH 142A,B02,083222,Chow; Bennett,0,14,30,30
1650703522727,MATH 193A,A01,083224,Staff,0,5,30,30
1650703522727,MATH 193A,A02,083225,Staff,0,6,30,30
1650703522727,MATH 193A,A03,083781,Staff,0,6,30,30
1650703522727,MATH 193A,A04,083782,Staff,0,7,30,30
1650703528753,MATH 197,001,091859,McAuley; Julian John,9998,0,9999,1
1650703534834,COGS 9,A01,083615,Staff,1,15,60,59
1650703540862,COGS 11,A01,083617,Boyle; Mary E. T.,16,0,40,24
1650703546886,COGS 13,A01,083071,Staff,0,38,40,40
1650703552913,COGS 14A,A01,092681,Staff,0,35,100,100
1650703558939,COGS 14B,A01,083073,Cheng; Tzu-Han,1,13,50,49
1650703564965,COGS 17,A01,092677,Staff,13,0,75,62
1650703570989,COGS 100,A01,083619,Staff,0,28,60,60
1650703577016,COGS 101A,A01,083621,Davis; Joshua Daniel,0,27,60,60
1650703583041,COGS 101B,A01,091572,Staff,0,4,60,60
1650703589068,COGS 101C,A01,083625,Delgado; Tania,14,0,30,16
1650703595098,COGS 107A,A01,083627,Boyle; Mary E. T.,0,16,60,60
1650703601125,COGS 118A,A01,083075,Staff,0,8,60,60
1650703607153,CSE 3,A50,083646,Miranda; Gregory Joseph,18,0,38,20
1650703607153,CSE 3,A51,083647,Miranda; Gregory Joseph,36,0,37,1
1650703613181,CSE 8A,A50,083650,Miranda; Gregory Joseph,0,30,40,40
1650703619210,CSE 11,A01,083080,Cao; Yingjun,0,96,40,40
1650703625239,CSE 12,A01,083652,Staff,0,21,100,100
1650703631266,CSE 15L,A01,083654,Staff,0,3,50,50
1650703631266,CSE 15L,A02,083655,Staff,0,2,50,50
1650703637294,CSE 20,A01,083657,Staff,49,0,80,31
1650703643321,CSE 30,A01,083084,Eldon; John,0,77,40,40
1650703649344,CSE 100,A01,083659,Cao; Yingjun,0,70,50,50
1650703655366,CSE 134B,A01,083661,Powell; Thomas Allan,0,38,65,65
1650703661392,CSE 140,A01,083663,Staff,0,11,75,75
1650703667416,CSE 140L,A01,083088,Eldon; John,0,20,75,75
1650703673442,CSE 175,A01,083665,Kumar; Rakesh,7,0,25,18
1650703679475,CSE 190,A00,092507,Dubnov; Shlomo,10,0,20,10
1650703685501,ECE 45,A01,083139,Staff,1,2,60,59
1650703691532,ECE 65,A50,083695,Staff,0,5,30,30
1650703697556,ECE 109,A01,091882,Touri; Behrouz,33,0,70,37
1650703703584,ECE 180,A00,083140,Abi Samra; Nicholas Camill,20,0,30,10
1650703703584,ECE 180,B00,083141,Abi Samra; Nicholas Camill,0,0,30,30
1650703709616,MATH 10A,A01,083735,Patchell; Gregory David,2,0,30,28
1650703709616,MATH 10A,A02,083736,Patchell; Gregory David,27,0,30,3
1650703709616,MATH 10A,A03,083737,Patchell; Gregory David,24,0,30,6
1650703715657,MATH 10B,A01,083207,Staff,0,9,30,30
1650703715657,MATH 10B,A02,083208,Staff,1,7,30,29
1650703715657,MATH 10B,B01,083739,Staff,11,0,30,19
1650703715657,MATH 10B,B02,083740,Staff,28,0,30,2
1650703721690,MATH 18,A01,083743,Staff,0,0,30,30
1650703721690,MATH 18,A02,083744,Staff,23,0,30,7
1650703721690,MATH 18,A03,083745,Staff,21,0,30,9
1650703721690,MATH 18,A04,083746,Staff,26,0,30,4
1650703721690,MATH 18,B01,083748,Staff,0,15,30,30
1650703721690,MATH 18,B02,083749,Staff,0,12,30,30
1650703721690,MATH 18,B03,083750,Staff,0,12,30,30
1650703721690,MATH 18,B04,083751,Staff,0,12,30,30
1650703727714,MATH 20A,A01,083754,Staff,19,0,40,21
1650703733738,MATH 20B,A01,083756,Staff,0,11,30,30
1650703733738,MATH 20B,A02,083757,Staff,0,12,30,30
1650703739761,MATH 20C,A01,083760,Staff,0,16,30,30
1650703739761,MATH 20C,A02,083761,Staff,0,15,30,30
1650703739761,MATH 20C,B01,083762,Staff,9,0,30,21
1650703739761,MATH 20C,B02,083763,Staff,28,0,30,2
1650703745783,MATH 20D,A01,083765,Staff,2,1,30,28
1650703745783,MATH 20D,A02,083766,Staff,6,0,30,24
1650703745783,MATH 20D,A03,083767,Staff,24,0,30,6
1650703751807,MATH 20E,A01,083771,Staff,3,0,30,27
1650703751807,MATH 20E,A02,083772,Staff,16,0,30,14
1650703751807,MATH 20E,B01,083773,Staff,0,0,30,30
1650703751807,MATH 20E,B02,083774,Staff,6,0,30,24
1650703757838,MATH 103A,A01,083777,Staff,0,15,30,30
1650703757838,MATH 103A,A02,083778,Staff,0,15,30,30
1650703757838,MATH 103A,B01,083779,Staff,0,15,30,30
1650703757838,MATH 103A,B02,083780,Staff,0,15,30,30
1650703763865,MATH 105,A01,085443,Staff,0,22,30,30
1650703769894,MATH 109,A01,083213,Anzaldo; Leesa B,0,7,30,30
1650703769894,MATH 109,A02,083214,Anzaldo; Leesa B,0,7,30,30
1650703769894,MATH 109,B01,083215,Anzaldo; Leesa B,0,8,30,30
1650703769894,MATH 109,B02,083216,Anzaldo; Leesa B,0,6,30,30
1650703775919,MATH 142A,A01,083219,Chow; Bennett,0,16,30,30
1650703775919,MATH 142A,A02,083220,Chow; Bennett,0,15,30,30
1650703775919,MATH 142A,B01,083221,Chow; Bennett,0,15,30,30
1650703775919,MATH 142A,B02,083222,Chow; Bennett,0,14,30,30
1650703781944,MATH 193A,A01,083224,Staff,0,5,30,30
1650703781944,MATH 193A,A02,083225,Staff,0,6,30,30
1650703781944,MATH 193A,A03,083781,Staff,0,6,30,30
1650703781944,MATH 193A,A04,083782,Staff,0,7,30,30
1650703787969,MATH 197,001,091859,McAuley; Julian John,9998,0,9999,1
1650703794033,COGS 9,A01,083615,Staff,1,15,60,59
1650703800152,COGS 11,A01,083617,Boyle; Mary E. T.,16,0,40,24
1650703806180,COGS 13,A01,083071,Staff,0,38,40,40
1650703812204,COGS 14A,A01,092681,Staff,0,35,100,100
1650703818229,COGS 14B,A01,083073,Cheng; Tzu-Han,1,13,50,49
1650703824254,COGS 17,A01,092677,Staff,13,0,75,62
1650703830281,COGS 100,A01,083619,Staff,0,28,60,60
1650703836309,COGS 101A,A01,083621,Davis; Joshua Daniel,0,27,60,60
1650703842332,COGS 101B,A01,091572,Staff,0,4,60,60
1650703848356,COGS 101C,A01,083625,Delgado; Tania,14,0,30,16
1650703854379,COGS 107A,A01,083627,Boyle; Mary E. T.,0,16,60,60
1650703860405,COGS 118A,A01,083075,Staff,0,8,60,60
1650703866430,CSE 3,A50,083646,Miranda; Gregory Joseph,18,0,38,20
1650703866430,CSE 3,A51,083647,Miranda; Gregory Joseph,36,0,37,1
1650703872455,CSE 8A,A50,083650,Miranda; Gregory Joseph,0,30,40,40
1650703878477,CSE 11,A01,083080,Cao; Yingjun,0,96,40,40
1650703884505,CSE 12,A01,083652,Staff,0,21,100,100
1650703890529,CSE 15L,A01,083654,Staff,0,3,50,50
1650703890529,CSE 15L,A02,083655,Staff,0,2,50,50
1650703896562,CSE 20,A01,083657,Staff,49,0,80,31
1650703902589,CSE 30,A01,083084,Eldon; John,0,77,40,40
1650703908612,CSE 100,A01,083659,Cao; Yingjun,0,70,50,50
1650703914637,CSE 134B,A01,083661,Powell; Thomas Allan,0,38,65,65
1650703920664,CSE 140,A01,083663,Staff,0,11,75,75
1650703926692,CSE 140L,A01,083088,Eldon; John,0,20,75,75
1650703932715,CSE 175,A01,083665,Kumar; Rakesh,7,0,25,18
1650703938738,CSE 190,A00,092507,Dubnov; Shlomo,10,0,20,10
1650703944766,ECE 45,A01,083139,Staff,1,2,60,59
1650703950791,ECE 65,A50,083695,Staff,0,5,30,30
1650703956819,ECE 109,A01,091882,Touri; Behrouz,33,0,70,37
1650703962842,ECE 180,A00,083140,Abi Samra; Nicholas Camill,20,0,30,10
1650703962842,ECE 180,B00,083141,Abi Samra; Nicholas Camill,0,0,30,30
1650703968873,MATH 10A,A01,083735,Patchell; Gregory David,2,0,30,28
1650703968873,MATH 10A,A02,083736,Patchell; Gregory David,27,0,30,3
1650703968873,MATH 10A,A03,083737,Patchell; Gregory David,24,0,30,6
1650703974898,MATH 10B,A01,083207,Staff,0,9,30,30
1650703974898,MATH 10B,A02,083208,Staff,1,7,30,29
1650703974898,MATH 10B,B01,083739,Staff,11,0,30,19
1650703974898,MATH 10B,B02,083740,Staff,28,0,30,2
1650703980938,MATH 18,A01,083743,Staff,0,0,30,30
1650703980938,MATH 18,A02,083744,Staff,23,0,30,7
1650703980938,MATH 18,A03,083745,Staff,21,0,30,9
1650703980938,MATH 18,A04,083746,Staff,26,0,30,4
1650703980938,MATH 18,B01,083748,Staff,0,15,30,30
1650703980938,MATH 18,B02,083749,Staff,0,12,30,30
1650703980938,MATH 18,B03,083750,Staff,0,12,30,30
1650703980938,MATH 18,B04,083751,Staff,0,12,30,30
1650703986974,MATH 20A,A01,083754,Staff,19,0,40,21
1650703993005,MATH 20B,A01,083756,Staff,0,11,30,30
1650703993005,MATH 20B,A02,083757,Staff,0,12,30,30
1650703999030,MATH 20C,A01,083760,Staff,0,16,30,30
1650703999030,MATH 20C,A02,083761,Staff,0,15,30,30
1650703999030,MATH 20C,B01,083762,Staff,9,0,30,21
1650703999030,MATH 20C,B02,083763,Staff,28,0,30,2
1650704005058,MATH 20D,A01,083765,Staff,2,1,30,28
1650704005058,MATH 20D,A02,083766,Staff,6,0,30,24
1650704005058,MATH 20D,A03,083767,Staff,24,0,30,6
1650704011085,MATH 20E,A01,083771,Staff,3,0,30,27
1650704011085,MATH 20E,A02,083772,Staff,16,0,30,14
1650704011085,MATH 20E,B01,083773,Staff,0,0,30,30
1650704011085,MATH 20E,B02,083774,Staff,6,0,30,24
1650704017116,MATH 103A,A01,083777,Staff,0,15,30,30
1650704017116,MATH 103A,A02,083778,Staff,0,15,30,30
1650704017116,MATH 103A,B01,083779,Staff,0,15,30,30
1650704017116,MATH 103A,B02,083780,Staff,0,15,30,30
1650704023144,MATH 105,A01,085443,Staff,0,22,30,30
1650704029170,MATH 109,A01,083213,Anzaldo; Leesa B,0,7,30,30
1650704029170,MATH 109,A02,083214,Anzaldo; Leesa B,0,7,30,30
1650704029170,MATH 109,B01,083215,Anzaldo; Leesa B,0,8,30,30
1650704029170,MATH 109,B02,083216,Anzaldo; Leesa B,0,6,30,30
1650704035194,MATH 142A,A01,083219,Chow; Bennett,0,16,30,30
1650704035194,MATH 142A,A02,083220,Chow; Bennett,0,15,30,30
1650704035194,MATH 142A,B01,083221,Chow; Bennett,0,15,30,30
1650704035194,MATH 142A,B02,083222,Chow; Bennett,0,14,30,30
1650704041222,MATH 193A,A01,083224,Staff,0,5,30,30
1650704041222,MATH 193A,A02,083225,Staff,0,6,30,30
1650704041222,MATH 193A,A03,083781,Staff,0,6,30,30
1650704041222,MATH 193A,A04,083782,Staff,0,7,30,30
1650704047245,MATH 197,001,091859,McAuley; Julian John,9998,0,9999,1
1650704053315,COGS 9,A01,083615,Staff,1,15,60,59
1650704059336,COGS 11,A01,083617,Boyle; Mary E. T.,16,0,40,24
1650704065361,COGS 13,A01,083071,Staff,0,38,40,40
1650704071389,COGS 14A,A01,092681,Staff,0,35,100,100
1650704077413,COGS 14B,A01,083073,Cheng; Tzu-Han,1,13,50,49
1650704083435,COGS 17,A01,092677,Staff,13,0,75,62
1650704089460,COGS 100,A01,083619,Staff,0,28,60,60
1650704095490,COGS 101A,A01,083621,Davis; Joshua Daniel,0,27,60,60
1650704101512,COGS 101B,A01,091572,Staff,0,4,60,60
1650704107540,COGS 101C,A01,083625,Delgado; Tania,14,0,30,16
1650704113565,COGS 107A,A01,083627,Boyle; Mary E. T.,0,16,60,60
1650704119591,COGS 118A,A01,083075,Staff,0,8,60,60
1650704125614,CSE 3,A50,083646,Miranda; Gregory Joseph,18,0,38,20
1650704125614,CSE 3,A51,083647,Miranda; Gregory Joseph,36,0,37,1
1650704131642,CSE 8A,A50,083650,Miranda; Gregory Joseph,0,30,40,40
1650704137668,CSE 11,A01,083080,Cao; Yingjun,0,96,40,40
1650704143694,CSE 12,A01,083652,Staff,0,21,100,100
1650704149718,CSE 15L,A01,083654,Staff,0,3,50,50
1650704149718,CSE 15L,A02,083655,Staff,0,2,50,50
1650704155744,CSE 20,A01,083657,Staff,49,0,80,31
1650704161767,CSE 30,A01,083084,Eldon; John,0,77,40,40
1650704167794,CSE 100,A01,083659,Cao; Yingjun,0,70,50,50
1650704173818,CSE 134B,A01,083661,Powell; Thomas Allan,0,38,65,65
1650704179843,CSE 140,A01,083663,Staff,0,11,75,75
1650704185870,CSE 140L,A01,083088,Eldon; John,0,20,75,75
1650704191893,CSE 175,A01,083665,Kumar; Rakesh,7,0,25,18
1650704197918,CSE 190,A00,092507,Dubnov; Shlomo,10,0,20,10
1650704203942,ECE 45,A01,083139,Staff,1,2,60,59
1650704209970,ECE 65,A50,083695,Staff,0,5,30,30
1650704215995,ECE 109,A01,091882,Touri; Behrouz,33,0,70,37
1650704222020,ECE 180,A00,083140,Abi Samra; Nicholas Camill,20,0,30,10
1650704222020,ECE 180,B00,083141,Abi Samra; Nicholas Camill,0,0,30,30
1650704228045,MATH 10A,A01,083735,Patchell; Gregory David,2,0,30,28
1650704228045,MATH 10A,A02,083736,Patchell; Gregory David,27,0,30,3
1650704228045,MATH 10A,A03,083737,Patchell; Gregory David,24,0,30,6
1650704234069,MATH 10B,A01,083207,Staff,0,9,30,30
1650704234069,MATH 10B,A02,083208,Staff,1,7,30,29
1650704234069,MATH 10B,B01,083739,Staff,11,0,30,19
1650704234069,MATH 10B,B02,083740,Staff,28,0,30,2
1650704240094,MATH 18,A01,083743,Staff,0,0,30,30
1650704240094,MATH 18,A02,083744,Staff,23,0,30,7
1650704240094,MATH 18,A03,083745,Staff,21,0,30,9
1650704240094,MATH 18,A04,083746,Staff,26,0,30,4
1650704240094,MATH 18,B01,083748,Staff,0,15,30,30
1650704240094,MATH 18,B02,083749,Staff,0,12,30,30
1650704240094,MATH 18,B03,083750,Staff,0,12,30,30
1650704240094,MATH 18,B04,083751,Staff,0,12,30,30
1650704246120,MATH 20A,A01,083754,Staff,19,0,40,21
1650704252143,MATH 20B,A01,083756,Staff,0,11,30,30
1650704252143,MATH 20B,A02,083757,Staff,0,12,30,30
1650704258171,MATH 20C,A01,083760,Staff,0,16,30,30
1650704258171,MATH 20C,A02,083761,Staff,0,15,30,30
1650704258171,MATH 20C,B01,083762,Staff,9,0,30,21
1650704258171,MATH 20C,B02,083763,Staff,28,0,30,2
1650704264197,MATH 20D,A01,083765,Staff,2,1,30,28
1650704264197,MATH 20D,A02,083766,Staff,6,0,30,24
1650704264197,MATH 20D,A03,083767,Staff,24,0,30,6
1650704270231,MATH 20E,A01,083771,Staff,3,0,30,27
1650704270231,MATH 20E,A02,083772,Staff,16,0,30,14
1650704270231,MATH 20E,B01,083773,Staff,0,0,30,30
1650704270231,MATH 20E,B02,083774,Staff,6,0,30,24
1650704276261,MATH 103A,A01,083777,Staff,0,15,30,30
1650704276261,MATH 103A,A02,083778,Staff,0,15,30,30
1650704276261,MATH 103A,B01,083779,Staff,0,15,30,30
1650704276261,MATH 103A,B02,083780,Staff,0,15,30,30
1650704282288,MATH 105,A01,085443,Staff,0,22,30,30
1650704288313,MATH 109,A01,083213,Anzaldo; Leesa B,0,7,30,30
1650704288313,MATH 109,A02,083214,Anzaldo; Leesa B,0,7,30,30
1650704288313,MATH 109,B01,083215,Anzaldo; Leesa B,0,8,30,30
1650704288313,MATH 109,B02,083216,Anzaldo; Leesa B,0,6,30,30
1650704294336,MATH 142A,A01,083219,Chow; Bennett,0,16,30,30
1650704294336,MATH 142A,A02,083220,Chow; Bennett,0,15,30,30
1650704294336,MATH 142A,B01,083221,Chow; Bennett,0,15,30,30
1650704294336,MATH 142A,B02,083222,Chow; Bennett,0,14,30,30
1650704300365,MATH 193A,A01,083224,Staff,0,5,30,30
1650704300365,MATH 193A,A02,083225,Staff,0,6,30,30
1650704300365,MATH 193A,A03,083781,Staff,0,6,30,30
1650704300365,MATH 193A,A04,083782,Staff,0,7,30,30
1650704306398,MATH 197,001,091859,McAuley; Julian John,9998,0,9999,1
1650704312460,COGS 9,A01,083615,Staff,1,15,60,59
1650704318483,COGS 11,A01,083617,Boyle; Mary E. T.,16,0,40,24
1650704324506,COGS 13,A01,083071,Staff,0,38,40,40
1650704330530,COGS 14A,A01,092681,Staff,0,35,100,100
1650704336554,COGS 14B,A01,083073,Cheng; Tzu-Han,1,13,50,49
1650704342580,COGS 17,A01,092677,Staff,13,0,75,62
1650704348604,COGS 100,A01,083619,Staff,0,28,60,60
1650704354631,COGS 101A,A01,083621,Davis; Joshua Daniel,0,27,60,60
1650704360656,COGS 101B,A01,091572,Staff,0,4,60,60
1650704366681,COGS 101C,A01,083625,Delgado; Tania,14,0,30,16
1650704372704,COGS 107A,A01,083627,Boyle; Mary E. T.,0,16,60,60
1650704378727,COGS 118A,A01,083075,Staff,0,8,60,60
1650704384760,CSE 3,A50,083646,Miranda; Gregory Joseph,18,0,38,20
1650704384760,CSE 3,A51,083647,Miranda; Gregory Joseph,36,0,37,1
1650704390793,CSE 8A,A50,083650,Miranda; Gregory Joseph,0,30,40,40
1650704396905,CSE 11,A01,083080,Cao; Yingjun,0,96,40,40
1650704402928,CSE 12,A01,083652,Staff,0,21,100,100
1650704408952,CSE 15L,A01,083654,Staff,0,3,50,50
1650704408952,CSE 15L,A02,083655,Staff,0,2,50,50
1650704414980,CSE 20,A01,083657,Staff,49,0,80,31
1650704421006,CSE 30,A01,083084,Eldon; John,0,77,40,40
1650704427037,CSE 100,A01,083659,Cao; Yingjun,0,70,50,50
1650704433061,CSE 134B,A01,083661,Powell; Thomas Allan,0,38,65,65
1650704439084,CSE 140,A01,083663,Staff,0,11,75,75
1650704445107,CSE 140L,A01,083088,Eldon; John,0,20,75,75
1650704451130,CSE 175,A01,083665,Kumar; Rakesh,7,0,25,18
1650704457157,CSE 190,A00,092507,Dubnov; Shlomo,10,0,20,10
1650704463185,ECE 45,A01,083139,Staff,1,2,60,59
1650704469215,ECE 65,A50,083695,Staff,0,5,30,30
1650704475242,ECE 109,A01,091882,Touri; Behrouz,33,0,70,37
1650704481271,ECE 180,A00,083140,Abi Samra; Nicholas Camill,20,0,30,10
1650704481271,ECE 180,B00,083141,Abi Samra; Nicholas Camill,0,0,30,30
1650704487296,MATH 10A,A01,083735,Patchell; Gregory David,2,0,30,28
1650704487296,MATH 10A,A02,083736,Patchell; Gregory David,27,0,30,3
1650704487296,MATH 10A,A03,083737,Patchell; Gregory David,24,0,30,6
1650704493322,MATH 10B,A01,083207,Staff,0,9,30,30
1650704493322,MATH 10B,A02,083208,Staff,1,7,30,29
1650704493322,MATH 10B,B01,083739,Staff,11,0,30,19
1650704493322,MATH 10B,B02,083740,Staff,28,0,30,2
1650704499356,MATH 18,A01,083743,Staff,0,0,30,30
1650704499356,MATH 18,A02,083744,Staff,23,0,30,7
1650704499356,MATH 18,A03,083745,Staff,21,0,30,9
1650704499356,MATH 18,A04,083746,Staff,26,0,30,4
1650704499356,MATH 18,B01,083748,Staff,0,15,30,30
1650704499356,MATH 18,B02,083749,Staff,0,12,30,30
1650704499356,MATH 18,B03,083750,Staff,0,12,30,30
1650704499356,MATH 18,B04,083751,Staff,0,12,30,30
1650704505384,MATH 20A,A01,083754,Staff,19,0,40,21
1650704511409,MATH 20B,A01,083756,Staff,0,11,30,30
1650704511409,MATH 20B,A02,083757,Staff,0,12,30,30
1650704517447,MATH 20C,A01,083760,Staff,0,16,30,30
1650704517447,MATH 20C,A02,083761,Staff,0,15,30,30
1650704517447,MATH 20C,B01,083762,Staff,9,0,30,21
1650704517447,MATH 20C,B02,083763,Staff,28,0,30,2
1650704523472,MATH 20D,A01,083765,Staff,2,1,30,28
1650704523472,MATH 20D,A02,083766,Staff,6,0,30,24
1650704523472,MATH 20D,A03,083767,Staff,24,0,30,6
1650704529498,MATH 20E,A01,083771,Staff,3,0,30,27
1650704529498,MATH 20E,A02,083772,Staff,16,0,30,14
1650704529498,MATH 20E,B01,083773,Staff,0,0,30,30
1650704529498,MATH 20E,B02,083774,Staff,6,0,30,24
1650704535520,MATH 103A,A01,083777,Staff,0,15,30,30
1650704535520,MATH 103A,A02,083778,Staff,0,15,30,30
1650704535520,MATH 103A,B01,083779,Staff,0,15,30,30
1650704535520,MATH 103A,B02,083780,Staff,0,15,30,30
1650704541547,MATH 105,A01,085443,Staff,0,22,30,30
1650704547574,MATH 109,A01,083213,Anzaldo; Leesa B,0,7,30,30
1650704547574,MATH 109,A02,083214,Anzaldo; Leesa B,0,7,30,30
1650704547574,MATH 109,B01,083215,Anzaldo; Leesa B,0,8,30,30
1650704547574,MATH 109,B02,083216,Anzaldo; Leesa B,0,6,30,30
1650704553598,MATH 142A,A01,083219,Chow; Bennett,0,16,30,30
1650704553598,MATH 142A,A02,083220,Chow; Bennett,0,15,30,30
1650704553598,MATH 142A,B01,083221,Chow; Bennett,0,15,30,30
1650704553598,MATH 142A,B02,083222,Chow; Bennett,0,14,30,30
1650704559633,MATH 193A,A01,083224,Staff,0,5,30,30
1650704559633,MATH 193A,A02,083225,Staff,0,6,30,30
1650704559633,MATH 193A,A03,083781,Staff,0,6,30,30
1650704559633,MATH 193A,A04,083782,Staff,0,7,30,30
1650704565658,MATH 197,001,091859,McAuley; Julian John,9998,0,9999,1
1650704571716,COGS 9,A01,083615,Staff,1,15,60,59
1650704577743,COGS 11,A01,083617,Boyle; Mary E. T.,16,0,40,24
1650704583780,COGS 13,A01,083071,Staff,0,38,40,40
1650704589805,COGS 14A,A01,092681,Staff,0,35,100,100
1650704595832,COGS 14B,A01,083073,Cheng; Tzu-Han,1,13,50,49
1650704601859,COGS 17,A01,092677,Staff,13,0,75,62
1650704607883,COGS 100,A01,083619,Staff,0,28,60,60
1650704613908,COGS 101A,A01,083621,Davis; Joshua Daniel,0,27,60,60
1650704619932,COGS 101B,A01,091572,Staff,0,4,60,60
1650704625957,COGS 101C,A01,083625,Delgado; Tania,14,0,30,16
1650704631984,COGS 107A,A01,083627,Boyle; Mary E. T.,0,16,60,60
1650704638011,COGS 118A,A01,083075,Staff,0,8,60,60
1650704644037,CSE 3,A50,083646,Miranda; Gregory Joseph,18,0,38,20
1650704644037,CSE 3,A51,083647,Miranda; Gregory Joseph,36,0,37,1
1650704650062,CSE 8A,A50,083650,Miranda; Gregory Joseph,0,30,40,40
1650704656087,CSE 11,A01,083080,Cao; Yingjun,0,96,40,40
1650704662112,CSE 12,A01,083652,Staff,0,21,100,100
1650704668137,CSE 15L,A01,083654,Staff,0,3,50,50
1650704668137,CSE 15L,A02,083655,Staff,0,2,50,50
1650704674159,CSE 20,A01,083657,Staff,49,0,80,31
1650704680186,CSE 30,A01,083084,Eldon; John,0,77,40,40
1650704686214,CSE 100,A01,083659,Cao; Yingjun,0,70,50,50
1650704692241,CSE 134B,A01,083661,Powell; Thomas Allan,0,38,65,65
1650704698265,CSE 140,A01,083663,Staff,0,11,75,75
1650704704290,CSE 140L,A01,083088,Eldon; John,0,20,75,75
1650704710313,CSE 175,A01,083665,Kumar; Rakesh,7,0,25,18
1650704716336,CSE 190,A00,092507,Dubnov; Shlomo,10,0,20,10
1650704722360,ECE 45,A01,083139,Staff,1,2,60,59
1650704728385,ECE 65,A50,083695,Staff,0,5,30,30
1650704734409,ECE 109,A01,091882,Touri; Behrouz,33,0,70,37
1650704740433,ECE 180,A00,083140,Abi Samra; Nicholas Camill,20,0,30,10
1650704740433,ECE 180,B00,083141,Abi Samra; Nicholas Camill,0,0,30,30
1650704746458,MATH 10A,A01,083735,Patchell; Gregory David,2,0,30,28
1650704746458,MATH 10A,A02,083736,Patchell; Gregory David,27,0,30,3
1650704746458,MATH 10A,A03,083737,Patchell; Gregory David,24,0,30,6
1650704752486,MATH 10B,A01,083207,Staff,0,9,30,30
1650704752486,MATH 10B,A02,083208,Staff,1,7,30,29
1650704752486,MATH 10B,B01,083739,Staff,11,0,30,19
1650704752486,MATH 10B,B02,083740,Staff,28,0,30,2
1650704758512,MATH 18,A01,083743,Staff,0,0,30,30
1650704758512,MATH 18,A02,083744,Staff,23,0,30,7
1650704758512,MATH 18,A03,083745,Staff,21,0,30,9
1650704758512,MATH 18,A04,083746,Staff,26,0,30,4
1650704758512,MATH 18,B01,083748,Staff,0,15,30,30
1650704758512,MATH 18,B02,083749,Staff,0,12,30,30
1650704758512,MATH 18,B03,083750,Staff,0,12,30,30
1650704758512,MATH 18,B04,083751,Staff,0,12,30,30
1650704764537,MATH 20A,A01,083754,Staff,19,0,40,21
1650704770560,MATH 20B,A01,083756,Staff,0,11,30,30
1650704770560,MATH 20B,A02,083757,Staff,0,12,30,30
1650704776584,MATH 20C,A01,083760,Staff,0,16,30,30
1650704776584,MATH 20C,A02,083761,Staff,0,15,30,30
1650704776584,MATH 20C,B01,083762,Staff,9,0,30,21
1650704776584,MATH 20C,B02,083763,Staff,28,0,30,2
1650704782609,MATH 20D,A01,083765,Staff,2,1,30,28
1650704782609,MATH 20D,A02,083766,Staff,6,0,30,24
1650704782609,MATH 20D,A03,083767,Staff,24,0,30,6
1650704788631,MATH 20E,A01,083771,Staff,3,0,30,27
1650704788631,MATH 20E,A02,083772,Staff,16,0,30,14
1650704788631,MATH 20E,B01,083773,Staff,0,0,30,30
1650704788631,MATH 20E,B02,083774,Staff,6,0,30,24
1650704794657,MATH 103A,A01,083777,Staff,0,15,30,30
1650704794657,MATH 103A,A02,083778,Staff,0,15,30,30
1650704794657,MATH 103A,B01,083779,Staff,0,15,30,30
1650704794657,MATH 103A,B02,083780,Staff,0,15,30,30
1650704800683,MATH 105,A01,085443,Staff,0,22,30,30
1650704806711,MATH 109,A01,083213,Anzaldo; Leesa B,0,7,30,30
1650704806711,MATH 109,A02,083214,Anzaldo; Leesa B,0,7,30,30
1650704806711,MATH 109,B01,083215,Anzaldo; Leesa B,0,8,30,30
1650704806711,MATH 109,B02,083216,Anzaldo; Leesa B,0,6,30,30
1650704812741,MATH 142A,A01,083219,Chow; Bennett,0,16,30,30
1650704812741,MATH 142A,A02,083220,Chow; Bennett,0,15,30,30
1650704812741,MATH 142A,B01,083221,Chow; Bennett,0,15,30,30
1650704812741,MATH 142A,B02,083222,Chow; Bennett,0,14,30,30
1650704818766,MATH 193A,A01,083224,Staff,0,5,30,30
1650704818766,MATH 193A,A02,083225,Staff,0,6,30,30
1650704818766,MATH 193A,A03,083781,Staff,0,6,30,30
1650704818766,MATH 193A,A04,083782,Staff,0,7,30,30
1650704824790,MATH 197,001,091859,McAuley; Julian John,9998,0,9999,1
1650704830837,COGS 9,A01,083615,Staff,1,15,60,59
1650704836862,COGS 11,A01,083617,Boyle; Mary E. T.,16,0,40,24
1650704842884,COGS 13,A01,083071,Staff,0,38,40,40
1650704848910,COGS 14A,A01,092681,Staff,0,35,100,100
1650704854934,COGS 14B,A01,083073,Cheng; Tzu-Han,1,13,50,49
1650704860960,COGS 17,A01,092677,Staff,13,0,75,62
1650704866983,COGS 100,A01,083619,Staff,0,28,60,60
1650704873008,COGS 101A,A01,083621,Davis; Joshua Daniel,0,27,60,60
1650704879032,COGS 101B,A01,091572,Staff,0,4,60,60
1650704885061,COGS 101C,A01,083625,Delgado; Tania,14,0,30,16
1650704891086,COGS 107A,A01,083627,Boyle; Mary E. T.,0,16,60,60
1650704897110,COGS 118A,A01,083075,Staff,0,8,60,60
1650704903134,CSE 3,A50,083646,Miranda; Gregory Joseph,18,0,38,20
1650704903134,CSE 3,A51,083647,Miranda; Gregory Joseph,36,0,37,1
1650704909168,CSE 8A,A50,083650,Miranda; Gregory Joseph,0,30,40,40
1650704915194,CSE 11,A01,083080,Cao; Yingjun,0,96,40,40
1650704921219,CSE 12,A01,083652,Staff,0,21,100,100
1650704927244,CSE 15L,A01,083654,Staff,0,3,50,50
1650704927244,CSE 15L,A02,083655,Staff,0,2,50,50
1650704933269,CSE 20,A01,083657,Staff,49,0,80,31
1650704939294,CSE 30,A01,083084,Eldon; John,0,77,40,40
1650704945318,CSE 100,A01,083659,Cao; Yingjun,0,70,50,50
1650704951342,CSE 134B,A01,083661,Powell; Thomas Allan,0,38,65,65
1650704957365,CSE 140,A01,083663,Staff,0,11,75,75
1650704963389,CSE 140L,A01,083088,Eldon; John,0,20,75,75
1650704969416,CSE 175,A01,083665,Kumar; Rakesh,7,0,25,18
1650704975439,CSE 190,A00,092507,Dubnov; Shlomo,10,0,20,10
1650704981466,ECE 45,A01,083139,Staff,1,2,60,59
1650704987489,ECE 65,A50,083695,Staff,0,5,30,30
1650704993585,ECE 109,A01,091882,Touri; Behrouz,33,0,70,37
1650704999611,ECE 180,A00,083140,Abi Samra; Nicholas Camill,20,0,30,10
1650704999611,ECE 180,B00,083141,Abi Samra; Nicholas Camill,0,0,30,30
1650705005635,MATH 10A,A01,083735,Patchell; Gregory David,2,0,30,28
1650705005635,MATH 10A,A02,083736,Patchell; Gregory David,27,0,30,3
1650705005635,MATH 10A,A03,083737,Patchell; Gregory David,24,0,30,6
1650705011660,MATH 10B,A01,083207,Staff,0,9,30,30
1650705011660,MATH 10B,A02,083208,Staff,1,7,30,29
1650705011660,MATH 10B,B01,083739,Staff,11,0,30,19
1650705011660,MATH 10B,B02,083740,Staff,28,0,30,2
1650705017685,MATH 18,A01,083743,Staff,0,0,30,30
1650705017685,MATH 18,A02,083744,Staff,23,0,30,7
1650705017685,MATH 18,A03,083745,Staff,21,0,30,9
1650705017685,MATH 18,A04,083746,Staff,26,0,30,4
1650705017685,MATH 18,B01,083748,Staff,0,15,30,30
1650705017685,MATH 18,B02,083749,Staff,0,12,30,30
1650705017685,MATH 18,B03,083750,Staff,0,12,30,30
1650705017685,MATH 18,B04,083751,Staff,0,12,30,30
1650705023709,MATH 20A,A01,083754,Staff,19,0,40,21
1650705029738,MATH 20B,A01,083756,Staff,0,11,30,30
1650705029738,MATH 20B,A02,083757,Staff,0,12,30,30
1650705035762,MATH 20C,A01,083760,Staff,0,16,30,30
1650705035762,MATH 20C,A02,083761,Staff,0,15,30,30
1650705035762,MATH 20C,B01,083762,Staff,9,0,30,21
1650705035762,MATH 20C,B02,083763,Staff,28,0,30,2
1650705041790,MATH 20D,A01,083765,Staff,2,1,30,28
1650705041790,MATH 20D,A02,083766,Staff,6,0,30,24
1650705041790,MATH 20D,A03,083767,Staff,24,0,30,6
1650705047819,MATH 20E,A01,083771,Staff,3,0,30,27
1650705047819,MATH 20E,A02,083772,Staff,16,0,30,14
1650705047819,MATH 20E,B01,083773,Staff,0,0,30,30
1650705047819,MATH 20E,B02,083774,Staff,6,0,30,24
1650705053847,MATH 103A,A01,083777,Staff,0,15,30,30
1650705053847,MATH 103A,A02,083778,Staff,0,15,30,30
1650705053847,MATH 103A,B01,083779,Staff,0,15,30,30
1650705053847,MATH 103A,B02,083780,Staff,0,15,30,30
1650705059873,MATH 105,A01,085443,Staff,0,22,30,30
1650705065897,MATH 109,A01,083213,Anzaldo; Leesa B,0,7,30,30
1650705065897,MATH 109,A02,083214,Anzaldo; Leesa B,0,7,30,30
1650705065897,MATH 109,B01,083215,Anzaldo; Leesa B,0,8,30,30
1650705065897,MATH 109,B02,083216,Anzaldo; Leesa B,0,6,30,30
1650705071922,MATH 142A,A01,083219,Chow; Bennett,0,16,30,30
1650705071922,MATH 142A,A02,083220,Chow; Bennett,0,15,30,30
1650705071922,MATH 142A,B01,083221,Chow; Bennett,0,15,30,30
1650705071922,MATH 142A,B02,083222,Chow; Bennett,0,14,30,30
1650705077952,MATH 193A,A01,083224,Staff,0,5,30,30
1650705077952,MATH 193A,A02,083225,Staff,0,6,30,30
1650705077952,MATH 193A,A03,083781,Staff,0,6,30,30
1650705077952,MATH 193A,A04,083782,Staff,0,7,30,30
1650705083975,MATH 197,001,091859,McAuley; Julian John,9998,0,9999,1
1650705090035,COGS 9,A01,083615,Staff,1,15,60,59
1650705096058,COGS 11,A01,083617,Boyle; Mary E. T.,16,0,40,24
1650705102084,COGS 13,A01,083071,Staff,0,38,40,40
1650705108108,COGS 14A,A01,092681,Staff,0,35,100,100
1650705114133,COGS 14B,A01,083073,Cheng; Tzu-Han,1,13,50,49
1650705120155,COGS 17,A01,092677,Staff,13,0,75,62
1650705126179,COGS 100,A01,083619,Staff,0,28,60,60
1650705132206,COGS 101A,A01,083621,Davis; Joshua Daniel,0,27,60,60
1650705138229,COGS 101B,A01,091572,Staff,0,4,60,60
1650705144253,COGS 101C,A01,083625,Delgado; Tania,14,0,30,16
1650705150280,COGS 107A,A01,083627,Boyle; Mary E. T.,0,16,60,60
1650705156305,COGS 118A,A01,083075,Staff,0,8,60,60
1650705162333,CSE 3,A50,083646,Miranda; Gregory Joseph,18,0,38,20
1650705162333,CSE 3,A51,083647,Miranda; Gregory Joseph,36,0,37,1
1650705168358,CSE 8A,A50,083650,Miranda; Gregory Joseph,0,30,40,40
1650705174384,CSE 11,A01,083080,Cao; Yingjun,0,96,40,40
1650705180412,CSE 12,A01,083652,Staff,0,21,100,100
1650705186434,CSE 15L,A01,083654,Staff,0,3,50,50
1650705186434,CSE 15L,A02,083655,Staff,0,2,50,50
1650705192460,CSE 20,A01,083657,Staff,49,0,80,31
1650705198483,CSE 30,A01,083084,Eldon; John,0,77,40,40
1650705204508,CSE 100,A01,083659,Cao; Yingjun,0,70,50,50
1650705210538,CSE 134B,A01,083661,Powell; Thomas Allan,0,38,65,65
1650705216560,CSE 140,A01,083663,Staff,0,11,75,75
1650705222583,CSE 140L,A01,083088,Eldon; John,0,20,75,75
1650705228617,CSE 175,A01,083665,Kumar; Rakesh,7,0,25,18
1650705234641,CSE 190,A00,092507,Dubnov; Shlomo,10,0,20,10
1650705240668,ECE 45,A01,083139,Staff,1,2,60,59
1650705246695,ECE 65,A50,083695,Staff,0,5,30,30
1650705252718,ECE 109,A01,091882,Touri; Behrouz,33,0,70,37
1650705258742,ECE 180,A00,083140,Abi Samra; Nicholas Camill,20,0,30,10
1650705258742,ECE 180,B00,083141,Abi Samra; Nicholas Camill,0,0,30,30
1650705264766,MATH 10A,A01,083735,Patchell; Gregory David,2,0,30,28
1650705264766,MATH 10A,A02,083736,Patchell; Gregory David,27,0,30,3
1650705264766,MATH 10A,A03,083737,Patchell; Gregory David,24,0,30,6
1650705270793,MATH 10B,A01,083207,Staff,0,9,30,30
1650705270793,MATH 10B,A02,083208,Staff,1,7,30,29
1650705270793,MATH 10B,B01,083739,Staff,11,0,30,19
1650705270793,MATH 10B,B02,083740,Staff,28,0,30,2
1650705276819,MATH 18,A01,083743,Staff,0,0,30,30
1650705276819,MATH 18,A02,083744,Staff,23,0,30,7
1650705276819,MATH 18,A03,083745,Staff,21,0,30,9
1650705276819,MATH 18,A04,083746,Staff,26,0,30,4
1650705276819,MATH 18,B01,083748,Staff,0,15,30,30
1650705276819,MATH 18,B02,083749,Staff,0,12,30,30
1650705276819,MATH 18,B03,083750,Staff,0,12,30,30
1650705276819,MATH 18,B04,083751,Staff,0,12,30,30
1650705282844,MATH 20A,A01,083754,Staff,19,0,40,21
1650705288869,MATH 20B,A01,083756,Staff,0,11,30,30
1650705288869,MATH 20B,A02,083757,Staff,0,12,30,30
1650705294896,MATH 20C,A01,083760,Staff,0,16,30,30
1650705294896,MATH 20C,A02,083761,Staff,0,15,30,30
1650705294896,MATH 20C,B01,083762,Staff,9,0,30,21
1650705294896,MATH 20C,B02,083763,Staff,28,0,30,2
1650705300920,MATH 20D,A01,083765,Staff,2,1,30,28
1650705300920,MATH 20D,A02,083766,Staff,6,0,30,24
1650705300920,MATH 20D,A03,083767,Staff,24,0,30,6
1650705306944,MATH 20E,A01,083771,Staff,3,0,30,27
1650705306944,MATH 20E,A02,083772,Staff,16,0,30,14
1650705306944,MATH 20E,B01,083773,Staff,0,0,30,30
1650705306944,MATH 20E,B02,083774,Staff,6,0,30,24
1650705312967,MATH 103A,A01,083777,Staff,0,15,30,30
1650705312967,MATH 103A,A02,083778,Staff,0,15,30,30
1650705312967,MATH 103A,B01,083779,Staff,0,15,30,30
1650705312967,MATH 103A,B02,083780,Staff,0,15,30,30
1650705318989,MATH 105,A01,085443,Staff,0,22,30,30
1650705325016,MATH 109,A01,083213,Anzaldo; Leesa B,0,7,30,30
1650705325016,MATH 109,A02,083214,Anzaldo; Leesa B,0,7,30,30
1650705325016,MATH 109,B01,083215,Anzaldo; Leesa B,0,8,30,30
1650705325016,MATH 109,B02,083216,Anzaldo; Leesa B,0,6,30,30
1650705331041,MATH 142A,A01,083219,Chow; Bennett,0,16,30,30
1650705331041,MATH 142A,A02,083220,Chow; Bennett,0,15,30,30
1650705331041,MATH 142A,B01,083221,Chow; Bennett,0,15,30,30
1650705331041,MATH 142A,B02,083222,Chow; Bennett,0,14,30,30
1650705337064,MATH 193A,A01,083224,Staff,0,5,30,30
1650705337064,MATH 193A,A02,083225,Staff,0,6,30,30
1650705337064,MATH 193A,A03,083781,Staff,0,6,30,30
1650705337064,MATH 193A,A04,083782,Staff,0,7,30,30
1650705343087,MATH 197,001,091859,McAuley; Julian John,9998,0,9999,1
1650705349150,COGS 9,A01,083615,Staff,1,15,60,59
1650705355175,COGS 11,A01,083617,Boyle; Mary E. T.,16,0,40,24
1650705361198,COGS 13,A01,083071,Staff,0,38,40,40
1650705367221,COGS 14A,A01,092681,Staff,0,35,100,100
1650705373248,COGS 14B,A01,083073,Cheng; Tzu-Han,1,13,50,49
1650705379272,COGS 17,A01,092677,Staff,13,0,75,62
1650705385296,COGS 100,A01,083619,Staff,0,28,60,60
1650705391327,COGS 101A,A01,083621,Davis; Joshua Daniel,0,27,60,60
1650705397378,COGS 101B,A01,091572,Staff,0,4,60,60
1650705403411,COGS 101C,A01,083625,Delgado; Tania,14,0,30,16
1650705409438,COGS 107A,A01,083627,Boyle; Mary E. T.,0,16,60,60
1650705415466,COGS 118A,A01,083075,Staff,0,8,60,60
1650705421493,CSE 3,A50,083646,Miranda; Gregory Joseph,18,0,38,20
1650705421493,CSE 3,A51,083647,Miranda; Gregory Joseph,36,0,37,1
1650705427522,CSE 8A,A50,083650,Miranda; Gregory Joseph,0,30,40,40
1650705433549,CSE 11,A01,083080,Cao; Yingjun,0,96,40,40
1650705439573,CSE 12,A01,083652,Staff,0,21,100,100
1650705445596,CSE 15L,A01,083654,Staff,0,3,50,50
1650705445596,CSE 15L,A02,083655,Staff,0,2,50,50
1650705451622,CSE 20,A01,083657,Staff,49,0,80,31
1650705457645,CSE 30,A01,083084,Eldon; John,0,77,40,40
1650705463672,CSE 100,A01,083659,Cao; Yingjun,0,70,50,50
1650705469709,CSE 134B,A01,083661,Powell; Thomas Allan,0,38,65,65
1650705475736,CSE 140,A01,083663,Staff,0,11,75,75
1650705481760,CSE 140L,A01,083088,Eldon; John,0,20,75,75
1650705487782,CSE 175,A01,083665,Kumar; Rakesh,7,0,25,18
1650705493806,CSE 190,A00,092507,Dubnov; Shlomo,10,0,20,10
1650705499840,ECE 45,A01,083139,Staff,1,2,60,59
1650705505867,ECE 65,A50,083695,Staff,0,5,30,30
1650705511892,ECE 109,A01,091882,Touri; Behrouz,33,0,70,37
1650705517916,ECE 180,A00,083140,Abi Samra; Nicholas Camill,20,0,30,10
1650705517916,ECE 180,B00,083141,Abi Samra; Nicholas Camill,0,0,30,30
1650705523941,MATH 10A,A01,083735,Patchell; Gregory David,2,0,30,28
1650705523941,MATH 10A,A02,083736,Patchell; Gregory David,27,0,30,3
1650705523941,MATH 10A,A03,083737,Patchell; Gregory David,24,0,30,6
1650705529965,MATH 10B,A01,083207,Staff,0,9,30,30
1650705529965,MATH 10B,A02,083208,Staff,1,7,30,29
1650705529965,MATH 10B,B01,083739,Staff,11,0,30,19
1650705529965,MATH 10B,B02,083740,Staff,28,0,30,2
1650705535991,MATH 18,A01,083743,Staff,0,0,30,30
1650705535991,MATH 18,A02,083744,Staff,23,0,30,7
1650705535991,MATH 18,A03,083745,Staff,21,0,30,9
1650705535991,MATH 18,A04,083746,Staff,26,0,30,4
1650705535991,MATH 18,B01,083748,Staff,0,15,30,30
1650705535991,MATH 18,B02,083749,Staff,0,12,30,30
1650705535991,MATH 18,B03,083750,Staff,0,12,30,30
1650705535991,MATH 18,B04,083751,Staff,0,12,30,30
1650705542013,MATH 20A,A01,083754,Staff,19,0,40,21
1650705548037,MATH 20B,A01,083756,Staff,0,11,30,30
1650705548037,MATH 20B,A02,083757,Staff,0,12,30,30
1650705554065,MATH 20C,A01,083760,Staff,0,16,30,30
1650705554065,MATH 20C,A02,083761,Staff,0,15,30,30
1650705554065,MATH 20C,B01,083762,Staff,9,0,30,21
1650705554065,MATH 20C,B02,083763,Staff,28,0,30,2
1650705560089,MATH 20D,A01,083765,Staff,2,1,30,28
1650705560089,MATH 20D,A02,083766,Staff,6,0,30,24
1650705560089,MATH 20D,A03,083767,Staff,24,0,30,6
1650705566115,MATH 20E,A01,083771,Staff,3,0,30,27
1650705566115,MATH 20E,A02,083772,Staff,16,0,30,14
1650705566115,MATH 20E,B01,083773,Staff,0,0,30,30
1650705566115,MATH 20E,B02,083774,Staff,6,0,30,24
1650705572139,MATH 103A,A01,083777,Staff,0,15,30,30
1650705572139,MATH 103A,A02,083778,Staff,0,15,30,30
1650705572139,MATH 103A,B01,083779,Staff,0,15,30,30
1650705572139,MATH 103A,B02,083780,Staff,0,15,30,30
1650705578164,MATH 105,A01,085443,Staff,0,22,30,30
1650705584191,MATH 109,A01,083213,Anzaldo; Leesa B,0,7,30,30
1650705584191,MATH 109,A02,083214,Anzaldo; Leesa B,0,7,30,30
1650705584191,MATH 109,B01,083215,Anzaldo; Leesa B,0,8,30,30
1650705584191,MATH 109,B02,083216,Anzaldo; Leesa B,0,6,30,30
1650705590307,MATH 142A,A01,083219,Chow; Bennett,0,16,30,30
1650705590307,MATH 142A,A02,083220,Chow; Bennett,0,15,30,30
1650705590307,MATH 142A,B01,083221,Chow; Bennett,0,15,30,30
1650705590307,MATH 142A,B02,083222,Chow; Bennett,0,14,30,30
1650705596331,MATH 193A,A01,083224,Staff,0,5,30,30
1650705596331,MATH 193A,A02,083225,Staff,0,6,30,30
1650705596331,MATH 193A,A03,083781,Staff,0,6,30,30
1650705596331,MATH 193A,A04,083782,Staff,0,7,30,30
1650705602356,MATH 197,001,091859,McAuley; Julian John,9998,0,9999,1
1650705608405,COGS 9,A01,083615,Staff,1,15,60,59
1650705614433,COGS 11,A01,083617,Boyle; Mary E. T.,16,0,40,24
1650705620458,COGS 13,A01,083071,Staff,0,38,40,40
1650705626482,COGS 14A,A01,092681,Staff,0,35,100,100
1650705632511,COGS 14B,A01,083073,Cheng; Tzu-Han,1,13,50,49
1650705638537,COGS 17,A01,092677,Staff,13,0,75,62
1650705644563,COGS 100,A01,083619,Staff,0,28,60,60
1650705650586,COGS 101A,A01,083621,Davis; Joshua Daniel,0,27,60,60
1650705656613,COGS 101B,A01,091572,Staff,0,4,60,60
1650705662639,COGS 101C,A01,083625,Delgado; Tania,14,0,30,16
1650705668668,COGS 107A,A01,083627,Boyle; Mary E. T.,0,16,60,60
1650705674692,COGS 118A,A01,083075,Staff,0,8,60,60
1650705680717,CSE 3,A50,083646,Miranda; Gregory Joseph,18,0,38,20
1650705680717,CSE 3,A51,083647,Miranda; Gregory Joseph,36,0,37,1
1650705686743,CSE 8A,A50,083650,Miranda; Gregory Joseph,0,30,40,40
1650705692767,CSE 11,A01,083080,Cao; Yingjun,0,96,40,40
1650705698793,CSE 12,A01,083652,Staff,0,21,100,100
1650705704837,CSE 15L,A01,083654,Staff,0,3,50,50
1650705704837,CSE 15L,A02,083655,Staff,0,2,50,50
1650705710865,CSE 20,A01,083657,Staff,49,0,80,31
1650705716888,CSE 30,A01,083084,Eldon; John,0,77,40,40
1650705722913,CSE 100,A01,083659,Cao; Yingjun,0,70,50,50
1650705728940,CSE 134B,A01,083661,Powell; Thomas Allan,0,38,65,65
1650705734964,CSE 140,A01,083663,Staff,0,11,75,75
1650705740992,CSE 140L,A01,083088,Eldon; John,0,20,75,75
1650705747016,CSE 175,A01,083665,Kumar; Rakesh,7,0,25,18
1650705753040,CSE 190,A00,092507,Dubnov; Shlomo,10,0,20,10
1650705759065,ECE 45,A01,083139,Staff,1,2,60,59
1650705765093,ECE 65,A50,083695,Staff,0,5,30,30
1650705771119,ECE 109,A01,091882,Touri; Behrouz,33,0,70,37
1650705777145,ECE 180,A00,083140,Abi Samra; Nicholas Camill,20,0,30,10
1650705777145,ECE 180,B00,083141,Abi Samra; Nicholas Camill,0,0,30,30
1650705783171,MATH 10A,A01,083735,Patchell; Gregory David,2,0,30,28
1650705783171,MATH 10A,A02,083736,Patchell; Gregory David,27,0,30,3
1650705783171,MATH 10A,A03,083737,Patchell; Gregory David,24,0,30,6
1650705789199,MATH 10B,A01,083207,Staff,0,9,30,30
1650705789199,MATH 10B,A02,083208,Staff,1,7,30,29
1650705789199,MATH 10B,B01,083739,Staff,11,0,30,19
1650705789199,MATH 10B,B02,083740,Staff,28,0,30,2
1650705795228,MATH 18,A01,083743,Staff,0,0,30,30
1650705795228,MATH 18,A02,083744,Staff,23,0,30,7
1650705795228,MATH 18,A03,083745,Staff,21,0,30,9
1650705795228,MATH 18,A04,083746,Staff,26,0,30,4
1650705795228,MATH 18,B01,083748,Staff,0,15,30,30
1650705795228,MATH 18,B02,083749,Staff,0,12,30,30
1650705795228,MATH 18,B03,083750,Staff,0,12,30,30
1650705795228,MATH 18,B04,083751,Staff,0,12,30,30
1650705801256,MATH 20A,A01,083754,Staff,19,0,40,21
1650705807282,MATH 20B,A01,083756,Staff,0,11,30,30
1650705807282,MATH 20B,A02,083757,Staff,0,12,30,30
1650705813310,MATH 20C,A01,083760,Staff,0,16,30,30
1650705813310,MATH 20C,A02,083761,Staff,0,15,30,30
1650705813310,MATH 20C,B01,083762,Staff,9,0,30,21
1650705813310,MATH 20C,B02,083763,Staff,28,0,30,2
1650705819343,MATH 20D,A01,083765,Staff,2,1,30,28
1650705819343,MATH 20D,A02,083766,Staff,6,0,30,24
1650705819343,MATH 20D,A03,083767,Staff,24,0,30,6
1650705825367,MATH 20E,A01,083771,Staff,3,0,30,27
1650705825367,MATH 20E,A02,083772,Staff,16,0,30,14
1650705825367,MATH 20E,B01,083773,Staff,0,0,30,30
1650705825367,MATH 20E,B02,083774,Staff,6,0,30,24
1650705831393,MATH 103A,A01,083777,Staff,0,15,30,30
1650705831393,MATH 103A,A02,083778,Staff,0,15,30,30
1650705831393,MATH 103A,B01,083779,Staff,0,15,30,30
1650705831393,MATH 103A,B02,083780,Staff,0,15,30,30
1650705837416,MATH 105,A01,085443,Staff,0,22,30,30
1650705843441,MATH 109,A01,083213,Anzaldo; Leesa B,0,7,30,30
1650705843441,MATH 109,A02,083214,Anzaldo; Leesa B,0,7,30,30
1650705843441,MATH 109,B01,083215,Anzaldo; Leesa B,0,8,30,30
1650705843441,MATH 109,B02,083216,Anzaldo; Leesa B,0,6,30,30
1650705849470,MATH 142A,A01,083219,Chow; Bennett,0,16,30,30
1650705849470,MATH 142A,A02,083220,Chow; Bennett,0,15,30,30
1650705849470,MATH 142A,B01,083221,Chow; Bennett,0,15,30,30
1650705849470,MATH 142A,B02,083222,Chow; Bennett,0,14,30,30
1650705855498,MATH 193A,A01,083224,Staff,0,5,30,30
1650705855498,MATH 193A,A02,083225,Staff,0,6,30,30
1650705855498,MATH 193A,A03,083781,Staff,0,6,30,30
1650705855498,MATH 193A,A04,083782,Staff,0,7,30,30
1650705861520,MATH 197,001,091859,McAuley; Julian John,9998,0,9999,1
1650705867584,COGS 9,A01,083615,Staff,1,15,60,59
1650705873607,COGS 11,A01,083617,Boyle; Mary E. T.,16,0,40,24
1650705879630,COGS 13,A01,083071,Staff,0,38,40,40
1650705885653,COGS 14A,A01,092681,Staff,0,35,100,100
1650705891680,COGS 14B,A01,083073,Cheng; Tzu-Han,1,13,50,49
1650705897704,COGS 17,A01,092677,Staff,13,0,75,62
1650705903734,COGS 100,A01,083619,Staff,0,28,60,60
1650705909761,COGS 101A,A01,083621,Davis; Joshua Daniel,0,27,60,60
1650705915788,COGS 101B,A01,091572,Staff,0,4,60,60
1650705921810,COGS 101C,A01,083625,Delgado; Tania,14,0,30,16
1650705927836,COGS 107A,A01,083627,Boyle; Mary E. T.,0,16,60,60
1650705933870,COGS 118A,A01,083075,Staff,0,8,60,60
1650705939895,CSE 3,A50,083646,Miranda; Gregory Joseph,18,0,38,20
1650705939895,CSE 3,A51,083647,Miranda; Gregory Joseph,36,0,37,1
1650705945925,CSE 8A,A50,083650,Miranda; Gregory Joseph,0,30,40,40
1650705951950,CSE 11,A01,083080,Cao; Yingjun,0,96,40,40
1650705957973,CSE 12,A01,083652,Staff,0,21,100,100
1650705963997,CSE 15L,A01,083654,Staff,0,3,50,50
1650705963997,CSE 15L,A02,083655,Staff,0,2,50,50
1650705970022,CSE 20,A01,083657,Staff,49,0,80,31
1650705976048,CSE 30,A01,083084,Eldon; John,0,77,40,40
1650705982072,CSE 100,A01,083659,Cao; Yingjun,0,70,50,50
1650705988098,CSE 134B,A01,083661,Powell; Thomas Allan,0,38,65,65
1650705994123,CSE 140,A01,083663,Staff,0,11,75,75
1650706000145,CSE 140L,A01,083088,Eldon; John,0,20,75,75
1650706006168,CSE 175,A01,083665,Kumar; Rakesh,7,0,25,18
1650706012193,CSE 190,A00,092507,Dubnov; Shlomo,10,0,20,10
1650706018217,ECE 45,A01,083139,Staff,1,2,60,59
1650706024242,ECE 65,A50,083695,Staff,0,5,30,30
1650706030269,ECE 109,A01,091882,Touri; Behrouz,33,0,70,37
1650706036294,ECE 180,A00,083140,Abi Samra; Nicholas Camill,20,0,30,10
1650706036294,ECE 180,B00,083141,Abi Samra; Nicholas Camill,0,0,30,30
1650706042323,MATH 10A,A01,083735,Patchell; Gregory David,2,0,30,28
1650706042323,MATH 10A,A02,083736,Patchell; Gregory David,27,0,30,3
1650706042323,MATH 10A,A03,083737,Patchell; Gregory David,24,0,30,6
1650706048346,MATH 10B,A01,083207,Staff,0,9,30,30
1650706048346,MATH 10B,A02,083208,Staff,1,7,30,29
1650706048346,MATH 10B,B01,083739,Staff,11,0,30,19
1650706048346,MATH 10B,B02,083740,Staff,28,0,30,2
1650706054372,MATH 18,A01,083743,Staff,0,0,30,30
1650706054372,MATH 18,A02,083744,Staff,23,0,30,7
1650706054372,MATH 18,A03,083745,Staff,21,0,30,9
1650706054372,MATH 18,A04,083746,Staff,26,0,30,4
1650706054372,MATH 18,B01,083748,Staff,0,15,30,30
1650706054372,MATH 18,B02,083749,Staff,0,12,30,30
1650706054372,MATH 18,B03,083750,Staff,0,12,30,30
1650706054372,MATH 18,B04,083751,Staff,0,12,30,30
1650706060398,MATH 20A,A01,083754,Staff,19,0,40,21
1650706066427,MATH 20B,A01,083756,Staff,0,11,30,30
1650706066427,MATH 20B,A02,083757,Staff,0,12,30,30
1650706072452,MATH 20C,A01,083760,Staff,0,16,30,30
1650706072452,MATH 20C,A02,083761,Staff,0,15,30,30
1650706072452,MATH 20C,B01,083762,Staff,9,0,30,21
1650706072452,MATH 20C,B02,083763,Staff,28,0,30,2
1650706078476,MATH 20D,A01,083765,Staff,2,1,30,28
1650706078476,MATH 20D,A02,083766,Staff,6,0,30,24
1650706078476,MATH 20D,A03,083767,Staff,24,0,30,6
1650706084510,MATH 20E,A01,083771,Staff,3,0,30,27
1650706084510,MATH 20E,A02,083772,Staff,16,0,30,14
1650706084510,MATH 20E,B01,083773,Staff,0,0,30,30
1650706084510,MATH 20E,B02,083774,Staff,6,0,30,24
1650706090537,MATH 103A,A01,083777,Staff,0,15,30,30
1650706090537,MATH 103A,A02,083778,Staff,0,15,30,30
1650706090537,MATH 103A,B01,083779,Staff,0,15,30,30
1650706090537,MATH 103A,B02,083780,Staff,0,15,30,30
1650706096561,MATH 105,A01,085443,Staff,0,22,30,30
1650706102586,MATH 109,A01,083213,Anzaldo; Leesa B,0,7,30,30
1650706102586,MATH 109,A02,083214,Anzaldo; Leesa B,0,7,30,30
1650706102586,MATH 109,B01,083215,Anzaldo; Leesa B,0,8,30,30
1650706102586,MATH 109,B02,083216,Anzaldo; Leesa B,0,6,30,30
1650706108608,MATH 142A,A01,083219,Chow; Bennett,0,16,30,30
1650706108608,MATH 142A,A02,083220,Chow; Bennett,0,15,30,30
1650706108608,MATH 142A,B01,083221,Chow; Bennett,0,15,30,30
1650706108608,MATH 142A,B02,083222,Chow; Bennett,0,14,30,30
1650706114634,MATH 193A,A01,083224,Staff,0,5,30,30
1650706114634,MATH 193A,A02,083225,Staff,0,6,30,30
1650706114634,MATH 193A,A03,083781,Staff,0,6,30,30
1650706114634,MATH 193A,A04,083782,Staff,0,7,30,30
1650706120661,MATH 197,001,091859,McAuley; Julian John,9998,0,9999,1
1650706126722,COGS 9,A01,083615,Staff,1,15,60,59
1650706132748,COGS 11,A01,083617,Boyle; Mary E. T.,16,0,40,24
1650706138773,COGS 13,A01,083071,Staff,0,38,40,40
1650706144800,COGS 14A,A01,092681,Staff,0,35,100,100
1650706150821,COGS 14B,A01,083073,Cheng; Tzu-Han,1,13,50,49
1650706156843,COGS 17,A01,092677,Staff,13,0,75,62
1650706162866,COGS 100,A01,083619,Staff,0,28,60,60
1650706168890,COGS 101A,A01,083621,Davis; Joshua Daniel,0,27,60,60
1650706174917,COGS 101B,A01,091572,Staff,0,4,60,60
1650706181027,COGS 101C,A01,083625,Delgado; Tania,14,0,30,16
1650706187053,COGS 107A,A01,083627,Boyle; Mary E. T.,0,16,60,60
1650706193077,COGS 118A,A01,083075,Staff,0,8,60,60
1650706199105,CSE 3,A50,083646,Miranda; Gregory Joseph,18,0,38,20
1650706199105,CSE 3,A51,083647,Miranda; Gregory Joseph,36,0,37,1
1650706205128,CSE 8A,A50,083650,Miranda; Gregory Joseph,0,30,40,40
1650706211151,CSE 11,A01,083080,Cao; Yingjun,0,96,40,40
1650706217177,CSE 12,A01,083652,Staff,0,21,100,100
1650706223199,CSE 15L,A01,083654,Staff,0,3,50,50
1650706223199,CSE 15L,A02,083655,Staff,0,2,50,50
1650706229226,CSE 20,A01,083657,Staff,49,0,80,31
1650706235259,CSE 30,A01,083084,Eldon; John,0,77,40,40
1650706241296,CSE 100,A01,083659,Cao; Yingjun,0,70,50,50
1650706247321,CSE 134B,A01,083661,Powell; Thomas Allan,0,38,65,65
1650706253346,CSE 140,A01,083663,Staff,0,11,75,75
1650706259368,CSE 140L,A01,083088,Eldon; John,0,20,75,75
1650706265393,CSE 175,A01,083665,Kumar; Rakesh,7,0,25,18
1650706271419,CSE 190,A00,092507,Dubnov; Shlomo,10,0,20,10
1650706277446,ECE 45,A01,083139,Staff,1,2,60,59
1650706283473,ECE 65,A50,083695,Staff,0,5,30,30
1650706289499,ECE 109,A01,091882,Touri; Behrouz,33,0,70,37
1650706295524,ECE 180,A00,083140,Abi Samra; Nicholas Camill,20,0,30,10
1650706295524,ECE 180,B00,083141,Abi Samra; Nicholas Camill,0,0,30,30
1650706301553,MATH 10A,A01,083735,Patchell; Gregory David,2,0,30,28
1650706301553,MATH 10A,A02,083736,Patchell; Gregory David,27,0,30,3
1650706301553,MATH 10A,A03,083737,Patchell; Gregory David,24,0,30,6
1650706307576,MATH 10B,A01,083207,Staff,0,9,30,30
1650706307576,MATH 10B,A02,083208,Staff,1,7,30,29
1650706307576,MATH 10B,B01,083739,Staff,11,0,30,19
1650706307576,MATH 10B,B02,083740,Staff,28,0,30,2
1650706313606,MATH 18,A01,083743,Staff,0,0,30,30
1650706313606,MATH 18,A02,083744,Staff,23,0,30,7
1650706313606,MATH 18,A03,083745,Staff,21,0,30,9
1650706313606,MATH 18,A04,083746,Staff,26,0,30,4
1650706313606,MATH 18,B01,083748,Staff,0,15,30,30
1650706313606,MATH 18,B02,083749,Staff,0,12,30,30
1650706313606,MATH 18,B03,083750,Staff,0,12,30,30
1650706313606,MATH 18,B04,083751,Staff,0,12,30,30
1650706319632,MATH 20A,A01,083754,Staff,19,0,40,21
1650706325663,MATH 20B,A01,083756,Staff,0,11,30,30
1650706325663,MATH 20B,A02,083757,Staff,0,12,30,30
1650706331687,MATH 20C,A01,083760,Staff,0,16,30,30
1650706331687,MATH 20C,A02,083761,Staff,0,15,30,30
1650706331687,MATH 20C,B01,083762,Staff,9,0,30,21
1650706331687,MATH 20C,B02,083763,Staff,28,0,30,2
1650706337714,MATH 20D,A01,083765,Staff,2,1,30,28
1650706337714,MATH 20D,A02,083766,Staff,6,0,30,24
1650706337714,MATH 20D,A03,083767,Staff,24,0,30,6
1650706343741,MATH 20E,A01,083771,Staff,3,0,30,27
1650706343741,MATH 20E,A02,083772,Staff,16,0,30,14
1650706343741,MATH 20E,B01,083773,Staff,0,0,30,30
1650706343741,MATH 20E,B02,083774,Staff,6,0,30,24
1650706349765,MATH 103A,A01,083777,Staff,0,15,30,30
1650706349765,MATH 103A,A02,083778,Staff,0,15,30,30
1650706349765,MATH 103A,B01,083779,Staff,0,15,30,30
1650706349765,MATH 103A,B02,083780,Staff,0,15,30,30
1650706355789,MATH 105,A01,085443,Staff,0,22,30,30
1650706361812,MATH 109,A01,083213,Anzaldo; Leesa B,0,7,30,30
1650706361812,MATH 109,A02,083214,Anzaldo; Leesa B,0,7,30,30
1650706361812,MATH 109,B01,083215,Anzaldo; Leesa B,0,8,30,30
1650706361812,MATH 109,B02,083216,Anzaldo; Leesa B,0,6,30,30
1650706367836,MATH 142A,A01,083219,Chow; Bennett,0,16,30,30
1650706367836,MATH 142A,A02,083220,Chow; Bennett,0,15,30,30
1650706367836,MATH 142A,B01,083221,Chow; Bennett,0,15,30,30
1650706367836,MATH 142A,B02,083222,Chow; Bennett,0,14,30,30
1650706373858,MATH 193A,A01,083224,Staff,0,5,30,30
1650706373858,MATH 193A,A02,083225,Staff,0,6,30,30
1650706373858,MATH 193A,A03,083781,Staff,0,6,30,30
1650706373858,MATH 193A,A04,083782,Staff,0,7,30,30
1650706379884,MATH 197,001,091859,McAuley; Julian John,9998,0,9999,1
1650706385944,COGS 9,A01,083615,Staff,1,15,60,59
1650706391966,COGS 11,A01,083617,Boyle; Mary E. T.,16,0,40,24
1650706397990,COGS 13,A01,083071,Staff,0,38,40,40
1650706404014,COGS 14A,A01,092681,Staff,0,35,100,100
1650706410049,COGS 14B,A01,083073,Cheng; Tzu-Han,1,13,50,49
1650706416076,COGS 17,A01,092677,Staff,13,0,75,62
1650706422104,COGS 100,A01,083619,Staff,0,28,60,60
1650706428132,COGS 101A,A01,083621,Davis; Joshua Daniel,0,27,60,60
1650706434160,COGS 101B,A01,091572,Staff,0,4,60,60
1650706440186,COGS 101C,A01,083625,Delgado; Tania,14,0,30,16
1650706446215,COGS 107A,A01,083627,Boyle; Mary E. T.,0,16,60,60
1650706452243,COGS 118A,A01,083075,Staff,0,8,60,60
1650706458277,CSE 3,A50,083646,Miranda; Gregory Joseph,18,0,38,20
1650706458277,CSE 3,A51,083647,Miranda; Gregory Joseph,36,0,37,1
1650706464301,CSE 8A,A50,083650,Miranda; Gregory Joseph,0,30,40,40
1650706470324,CSE 11,A01,083080,Cao; Yingjun,0,96,40,40
1650706476349,CSE 12,A01,083652,Staff,0,21,100,100
1650706482373,CSE 15L,A01,083654,Staff,0,3,50,50
1650706482373,CSE 15L,A02,083655,Staff,0,2,50,50
1650706488400,CSE 20,A01,083657,Staff,49,0,80,31
1650706494427,CSE 30,A01,083084,Eldon; John,0,77,40,40
1650706500457,CSE 100,A01,083659,Cao; Yingjun,0,70,50,50
1650706506480,CSE 134B,A01,083661,Powell; Thomas Allan,0,38,65,65
1650706512504,CSE 140,A01,083663,Staff,0,11,75,75
1650706518527,CSE 140L,A01,083088,Eldon; John,0,20,75,75
1650706524551,CSE 175,A01,083665,Kumar; Rakesh,7,0,25,18
1650706530574,CSE 190,A00,092507,Dubnov; Shlomo,10,0,20,10
1650706536596,ECE 45,A01,083139,Staff,1,2,60,59
1650706542621,ECE 65,A50,083695,Staff,0,5,30,30
1650706548648,ECE 109,A01,091882,Touri; Behrouz,33,0,70,37
1650706554673,ECE 180,A00,083140,Abi Samra; Nicholas Camill,20,0,30,10
1650706554673,ECE 180,B00,083141,Abi Samra; Nicholas Camill,0,0,30,30
1650706560706,MATH 10A,A01,083735,Patchell; Gregory David,2,0,30,28
1650706560706,MATH 10A,A02,083736,Patchell; Gregory David,27,0,30,3
1650706560706,MATH 10A,A03,083737,Patchell; Gregory David,24,0,30,6
1650706566733,MATH 10B,A01,083207,Staff,0,9,30,30
1650706566733,MATH 10B,A02,083208,Staff,1,7,30,29
1650706566733,MATH 10B,B01,083739,Staff,11,0,30,19
1650706566733,MATH 10B,B02,083740,Staff,28,0,30,2
1650706572766,MATH 18,A01,083743,Staff,0,0,30,30
1650706572766,MATH 18,A02,083744,Staff,23,0,30,7
1650706572766,MATH 18,A03,083745,Staff,21,0,30,9
1650706572766,MATH 18,A04,083746,Staff,26,0,30,4
1650706572766,MATH 18,B01,083748,Staff,0,15,30,30
1650706572766,MATH 18,B02,083749,Staff,0,12,30,30
1650706572766,MATH 18,B03,083750,Staff,0,12,30,30
1650706572766,MATH 18,B04,083751,Staff,0,12,30,30
1650706578791,MATH 20A,A01,083754,Staff,19,0,40,21
1650706584813,MATH 20B,A01,083756,Staff,0,11,30,30
1650706584813,MATH 20B,A02,083757,Staff,0,12,30,30
1650706590842,MATH 20C,A01,083760,Staff,0,16,30,30
1650706590842,MATH 20C,A02,083761,Staff,0,15,30,30
1650706590842,MATH 20C,B01,083762,Staff,9,0,30,21
1650706590842,MATH 20C,B02,083763,Staff,28,0,30,2
1650706596869,MATH 20D,A01,083765,Staff,2,1,30,28
1650706596869,MATH 20D,A02,083766,Staff,6,0,30,24
1650706596869,MATH 20D,A03,083767,Staff,24,0,30,6
1650706602896,MATH 20E,A01,083771,Staff,3,0,30,27
1650706602896,MATH 20E,A02,083772,Staff,16,0,30,14
1650706602896,MATH 20E,B01,083773,Staff,0,0,30,30
1650706602896,MATH 20E,B02,083774,Staff,6,0,30,24
1650706608924,MATH 103A,A01,083777,Staff,0,15,30,30
1650706608924,MATH 103A,A02,083778,Staff,0,15,30,30
1650706608924,MATH 103A,B01,083779,Staff,0,15,30,30
1650706608924,MATH 103A,B02,083780,Staff,0,15,30,30
1650706614951,MATH 105,A01,085443,Staff,0,22,30,30
1650706620979,MATH 109,A01,083213,Anzaldo; Leesa B,0,7,30,30
1650706620979,MATH 109,A02,083214,Anzaldo; Leesa B,0,7,30,30
1650706620979,MATH 109,B01,083215,Anzaldo; Leesa B,0,8,30,30
1650706620979,MATH 109,B02,083216,Anzaldo; Leesa B,0,6,30,30
1650706627015,MATH 142A,A01,083219,Chow; Bennett,0,16,30,30
1650706627015,MATH 142A,A02,083220,Chow; Bennett,0,15,30,30
1650706627015,MATH 142A,B01,083221,Chow; Bennett,0,15,30,30
1650706627015,MATH 142A,B02,083222,Chow; Bennett,0,14,30,30
1650706633041,MATH 193A,A01,083224,Staff,0,5,30,30
1650706633041,MATH 193A,A02,083225,Staff,0,6,30,30
1650706633041,MATH 193A,A03,083781,Staff,0,6,30,30
1650706633041,MATH 193A,A04,083782,Staff,0,7,30,30
1650706639063,MATH 197,001,091859,McAuley; Julian John,9998,0,9999,1
1650706645111,COGS 9,A01,083615,Staff,1,15,60,59
1650706651137,COGS 11,A01,083617,Boyle; Mary E. T.,16,0,40,24
1650706657171,COGS 13,A01,083071,Staff,0,38,40,40
1650706663199,COGS 14A,A01,092681,Staff,0,35,100,100
1650706669227,COGS 14B,A01,083073,Cheng; Tzu-Han,1,13,50,49
1650706675252,COGS 17,A01,092677,Staff,13,0,75,62
1650706681280,COGS 100,A01,083619,Staff,0,28,60,60
1650706687302,COGS 101A,A01,083621,Davis; Joshua Daniel,0,27,60,60
1650706693327,COGS 101B,A01,091572,Staff,0,4,60,60
1650706699351,COGS 101C,A01,083625,Delgado; Tania,14,0,30,16
1650706705374,COGS 107A,A01,083627,Boyle; Mary E. T.,0,16,60,60
1650706711398,COGS 118A,A01,083075,Staff,0,8,60,60
1650706717430,CSE 3,A50,083646,Miranda; Gregory Joseph,18,0,38,20
1650706717430,CSE 3,A51,083647,Miranda; Gregory Joseph,36,0,37,1
1650706723453,CSE 8A,A50,083650,Miranda; Gregory Joseph,0,30,40,40
1650706729480,CSE 11,A01,083080,Cao; Yingjun,0,96,40,40
1650706735503,CSE 12,A01,083652,Staff,0,21,100,100
1650706741525,CSE 15L,A01,083654,Staff,0,3,50,50
1650706741525,CSE 15L,A02,083655,Staff,0,2,50,50
1650706747550,CSE 20,A01,083657,Staff,49,0,80,31
1650706753577,CSE 30,A01,083084,Eldon; John,0,77,40,40
1650706759604,CSE 100,A01,083659,Cao; Yingjun,0,70,50,50
1650706765630,CSE 134B,A01,083661,Powell; Thomas Allan,0,38,65,65
1650706771656,CSE 140,A01,083663,Staff,0,11,75,75
1650706777767,CSE 140L,A01,083088,Eldon; John,0,20,75,75
1650706783793,CSE 175,A01,083665,Kumar; Rakesh,7,0,25,18
1650706789817,CSE 190,A00,092507,Dubnov; Shlomo,10,0,20,10
1650706795843,ECE 45,A01,083139,Staff,1,2,60,59
1650706801867,ECE 65,A50,083695,Staff,0,5,30,30
1650706807894,ECE 109,A01,091882,Touri; Behrouz,33,0,70,37
1650706813917,ECE 180,A00,083140,Abi Samra; Nicholas Camill,20,0,30,10
1650706813917,ECE 180,B00,083141,Abi Samra; Nicholas Camill,0,0,30,30
1650706819943,MATH 10A,A01,083735,Patchell; Gregory David,2,0,30,28
1650706819943,MATH 10A,A02,083736,Patchell; Gregory David,27,0,30,3
1650706819943,MATH 10A,A03,083737,Patchell; Gregory David,24,0,30,6
1650706825970,MATH 10B,A01,083207,Staff,0,9,30,30
1650706825970,MATH 10B,A02,083208,Staff,1,7,30,29
1650706825970,MATH 10B,B01,083739,Staff,11,0,30,19
1650706825970,MATH 10B,B02,083740,Staff,28,0,30,2
1650706832003,MATH 18,A01,083743,Staff,0,0,30,30
1650706832003,MATH 18,A02,083744,Staff,23,0,30,7
1650706832003,MATH 18,A03,083745,Staff,21,0,30,9
1650706832003,MATH 18,A04,083746,Staff,26,0,30,4
1650706832003,MATH 18,B01,083748,Staff,0,15,30,30
1650706832003,MATH 18,B02,083749,Staff,0,12,30,30
1650706832003,MATH 18,B03,083750,Staff,0,12,30,30
1650706832003,MATH 18,B04,083751,Staff,0,12,30,30
1650706838051,MATH 20A,A01,083754,Staff,19,0,40,21
1650706844077,MATH 20B,A01,083756,Staff,0,11,30,30
1650706844077,MATH 20B,A02,083757,Staff,0,12,30,30
1650706850106,MATH 20C,A01,083760,Staff,0,16,30,30
1650706850106,MATH 20C,A02,083761,Staff,0,15,30,30
1650706850106,MATH 20C,B01,083762,Staff,9,0,30,21
1650706850106,MATH 20C,B02,083763,Staff,28,0,30,2
1650706856129,MATH 20D,A01,083765,Staff,2,1,30,28
1650706856129,MATH 20D,A02,083766,Staff,6,0,30,24
1650706856129,MATH 20D,A03,083767,Staff,24,0,30,6
1650706862153,MATH 20E,A01,083771,Staff,3,0,30,27
1650706862153,MATH 20E,A02,083772,Staff,16,0,30,14
1650706862153,MATH 20E,B01,083773,Staff,0,0,30,30
1650706862153,MATH 20E,B02,083774,Staff,6,0,30,24
1650706868181,MATH 103A,A01,083777,Staff,0,15,30,30
1650706868181,MATH 103A,A02,083778,Staff,0,15,30,30
1650706868181,MATH 103A,B01,083779,Staff,0,15,30,30
1650706868181,MATH 103A,B02,083780,Staff,0,15,30,30
1650706874206,MATH 105,A01,085443,Staff,0,22,30,30
1650706880229,MATH 109,A01,083213,Anzaldo; Leesa B,0,7,30,30
1650706880229,MATH 109,A02,083214,Anzaldo; Leesa B,0,7,30,30
1650706880229,MATH 109,B01,083215,Anzaldo; Leesa B,0,8,30,30
1650706880229,MATH 109,B02,083216,Anzaldo; Leesa B,0,6,30,30
1650706886254,MATH 142A,A01,083219,Chow; Bennett,0,16,30,30
1650706886254,MATH 142A,A02,083220,Chow; Bennett,0,15,30,30
1650706886254,MATH 142A,B01,083221,Chow; Bennett,0,15,30,30
1650706886254,MATH 142A,B02,083222,Chow; Bennett,0,14,30,30
1650706892277,MATH 193A,A01,083224,Staff,0,5,30,30
1650706892277,MATH 193A,A02,083225,Staff,0,6,30,30
1650706892277,MATH 193A,A03,083781,Staff,0,6,30,30
1650706892277,MATH 193A,A04,083782,Staff,0,7,30,30
1650706898300,MATH 197,001,091859,McAuley; Julian John,9998,0,9999,1
1650706904363,COGS 9,A01,083615,Staff,1,15,60,59
1650706910394,COGS 11,A01,083617,Boyle; Mary E. T.,16,0,40,24
1650706916421,COGS 13,A01,083071,Staff,0,38,40,40
1650706922445,COGS 14A,A01,092681,Staff,0,35,100,100
1650706928470,COGS 14B,A01,083073,Cheng; Tzu-Han,1,13,50,49
1650706934495,COGS 17,A01,092677,Staff,13,0,75,62
1650706940521,COGS 100,A01,083619,Staff,0,28,60,60
1650706946545,COGS 101A,A01,083621,Davis; Joshua Daniel,0,27,60,60
1650706952569,COGS 101B,A01,091572,Staff,0,4,60,60
1650706958591,COGS 101C,A01,083625,Delgado; Tania,14,0,30,16
1650706964617,COGS 107A,A01,083627,Boyle; Mary E. T.,0,16,60,60
1650706970642,COGS 118A,A01,083075,Staff,0,8,60,60
1650706976671,CSE 3,A50,083646,Miranda; Gregory Joseph,18,0,38,20
1650706976671,CSE 3,A51,083647,Miranda; Gregory Joseph,36,0,37,1
1650706982694,CSE 8A,A50,083650,Miranda; Gregory Joseph,0,30,40,40
1650706988717,CSE 11,A01,083080,Cao; Yingjun,0,96,40,40
1650706994742,CSE 12,A01,083652,Staff,0,21,100,100
1650707000769,CSE 15L,A01,083654,Staff,0,3,50,50
1650707000769,CSE 15L,A02,083655,Staff,0,2,50,50
1650707006792,CSE 20,A01,083657,Staff,49,0,80,31
1650707012819,CSE 30,A01,083084,Eldon; John,0,77,40,40
1650707018842,CSE 100,A01,083659,Cao; Yingjun,0,70,50,50
1650707024867,CSE 134B,A01,083661,Powell; Thomas Allan,0,38,65,65
1650707030892,CSE 140,A01,083663,Staff,0,11,75,75
1650707036915,CSE 140L,A01,083088,Eldon; John,0,20,75,75
1650707042938,CSE 175,A01,083665,Kumar; Rakesh,7,0,25,18
1650707048961,CSE 190,A00,092507,Dubnov; Shlomo,10,0,20,10
1650707054988,ECE 45,A01,083139,Staff,1,2,60,59
1650707061013,ECE 65,A50,083695,Staff,0,5,30,30
1650707067040,ECE 109,A01,091882,Touri; Behrouz,33,0,70,37
1650707073066,ECE 180,A00,083140,Abi Samra; Nicholas Camill,20,0,30,10
1650707073066,ECE 180,B00,083141,Abi Samra; Nicholas Camill,0,0,30,30
1650707079090,MATH 10A,A01,083735,Patchell; Gregory David,2,0,30,28
1650707079090,MATH 10A,A02,083736,Patchell; Gregory David,27,0,30,3
1650707079090,MATH 10A,A03,083737,Patchell; Gregory David,24,0,30,6
1650707085115,MATH 10B,A01,083207,Staff,0,9,30,30
1650707085115,MATH 10B,A02,083208,Staff,1,7,30,29
1650707085115,MATH 10B,B01,083739,Staff,11,0,30,19
1650707085115,MATH 10B,B02,083740,Staff,28,0,30,2
1650707091143,MATH 18,A01,083743,Staff,0,0,30,30
1650707091143,MATH 18,A02,083744,Staff,23,0,30,7
1650707091143,MATH 18,A03,083745,Staff,21,0,30,9
1650707091143,MATH 18,A04,083746,Staff,26,0,30,4
1650707091143,MATH 18,B01,083748,Staff,0,15,30,30
1650707091143,MATH 18,B02,083749,Staff,0,12,30,30
1650707091143,MATH 18,B03,083750,Staff,0,12,30,30
1650707091143,MATH 18,B04,083751,Staff,0,12,30,30
1650707097169,MATH 20A,A01,083754,Staff,19,0,40,21
1650707103195,MATH 20B,A01,083756,Staff,0,11,30,30
1650707103195,MATH 20B,A02,083757,Staff,0,12,30,30
1650707109222,MATH 20C,A01,083760,Staff,0,16,30,30
1650707109222,MATH 20C,A02,083761,Staff,0,15,30,30
1650707109222,MATH 20C,B01,083762,Staff,9,0,30,21
1650707109222,MATH 20C,B02,083763,Staff,28,0,30,2
1650707115254,MATH 20D,A01,083765,Staff,2,1,30,28
1650707115254,MATH 20D,A02,083766,Staff,6,0,30,24
1650707115254,MATH 20D,A03,083767,Staff,24,0,30,6
1650707121281,MATH 20E,A01,083771,Staff,3,0,30,27
1650707121281,MATH 20E,A02,083772,Staff,16,0,30,14
1650707121281,MATH 20E,B01,083773,Staff,0,0,30,30
1650707121281,MATH 20E,B02,083774,Staff,6,0,30,24
1650707127305,MATH 103A,A01,083777,Staff,0,15,30,30
1650707127305,MATH 103A,A02,083778,Staff,0,15,30,30
1650707127305,MATH 103A,B01,083779,Staff,0,15,30,30
1650707127305,MATH 103A,B02,083780,Staff,0,15,30,30
1650707133329,MATH 105,A01,085443,Staff,0,22,30,30
1650707139352,MATH 109,A01,083213,Anzaldo; Leesa B,0,7,30,30
1650707139352,MATH 109,A02,083214,Anzaldo; Leesa B,0,7,30,30
1650707139352,MATH 109,B01,083215,Anzaldo; Leesa B,0,8,30,30
1650707139352,MATH 109,B02,083216,Anzaldo; Leesa B,0,6,30,30
1650707145378,MATH 142A,A01,083219,Chow; Bennett,0,16,30,30
1650707145378,MATH 142A,A02,083220,Chow; Bennett,0,15,30,30
1650707145378,MATH 142A,B01,083221,Chow; Bennett,0,15,30,30
1650707145378,MATH 142A,B02,083222,Chow; Bennett,0,14,30,30
1650707151402,MATH 193A,A01,083224,Staff,0,5,30,30
1650707151402,MATH 193A,A02,083225,Staff,0,6,30,30
1650707151402,MATH 193A,A03,083781,Staff,0,6,30,30
1650707151402,MATH 193A,A04,083782,Staff,0,7,30,30
1650707157424,MATH 197,001,091859,McAuley; Julian John,9998,0,9999,1
1650707163475,COGS 9,A01,083615,Staff,1,15,60,59
1650707169499,COGS 11,A01,083617,Boyle; Mary E. T.,16,0,40,24
1650707175523,COGS 13,A01,083071,Staff,0,38,40,40
1650707181547,COGS 14A,A01,092681,Staff,0,35,100,100
1650707187571,COGS 14B,A01,083073,Cheng; Tzu-Han,1,13,50,49
1650707193596,COGS 17,A01,092677,Staff,13,0,75,62
1650707199622,COGS 100,A01,083619,Staff,0,28,60,60
1650707205646,COGS 101A,A01,083621,Davis; Joshua Daniel,0,27,60,60
1650707211669,COGS 101B,A01,091572,Staff,0,4,60,60
1650707217696,COGS 101C,A01,083625,Delgado; Tania,14,0,30,16
1650707223725,COGS 107A,A01,083627,Boyle; Mary E. T.,0,16,60,60
1650707229748,COGS 118A,A01,083075,Staff,0,8,60,60
1650707235772,CSE 3,A50,083646,Miranda; Gregory Joseph,18,0,38,20
1650707235772,CSE 3,A51,083647,Miranda; Gregory Joseph,36,0,37,1
1650707241795,CSE 8A,A50,083650,Miranda; Gregory Joseph,0,30,40,40
1650707247823,CSE 11,A01,083080,Cao; Yingjun,0,96,40,40
1650707253850,CSE 12,A01,083652,Staff,0,21,100,100
1650707259877,CSE 15L,A01,083654,Staff,0,3,50,50
1650707259877,CSE 15L,A02,083655,Staff,0,2,50,50
1650707265907,CSE 20,A01,083657,Staff,49,0,80,31
1650707271931,CSE 30,A01,083084,Eldon; John,0,77,40,40
1650707277956,CSE 100,A01,083659,Cao; Yingjun,0,70,50,50
1650707283983,CSE 134B,A01,083661,Powell; Thomas Allan,0,38,65,65
1650707290005,CSE 140,A01,083663,Staff,0,11,75,75
1650707296033,CSE 140L,A01,083088,Eldon; John,0,20,75,75
1650707302065,CSE 175,A01,083665,Kumar; Rakesh,7,0,25,18
1650707308097,CSE 190,A00,092507,Dubnov; Shlomo,10,0,20,10
1650707314123,ECE 45,A01,083139,Staff,1,2,60,59
1650707320146,ECE 65,A50,083695,Staff,0,5,30,30
1650707326168,ECE 109,A01,091882,Touri; Behrouz,33,0,70,37
1650707332191,ECE 180,A00,083140,Abi Samra; Nicholas Camill,20,0,30,10
1650707332191,ECE 180,B00,083141,Abi Samra; Nicholas Camill,0,0,30,30
1650707338214,MATH 10A,A01,083735,Patchell; Gregory David,2,0,30,28
1650707338214,MATH 10A,A02,083736,Patchell; Gregory David,27,0,30,3
1650707338214,MATH 10A,A03,083737,Patchell; Gregory David,24,0,30,6
1650707344238,MATH 10B,A01,083207,Staff,0,9,30,30
1650707344238,MATH 10B,A02,083208,Staff,1,7,30,29
1650707344238,MATH 10B,B01,083739,Staff,11,0,30,19
1650707344238,MATH 10B,B02,083740,Staff,28,0,30,2
1650707350263,MATH 18,A01,083743,Staff,0,0,30,30
1650707350263,MATH 18,A02,083744,Staff,23,0,30,7
1650707350263,MATH 18,A03,083745,Staff,21,0,30,9
1650707350263,MATH 18,A04,083746,Staff,26,0,30,4
1650707350263,MATH 18,B01,083748,Staff,0,15,30,30
1650707350263,MATH 18,B02,083749,Staff,0,12,30,30
1650707350263,MATH 18,B03,083750,Staff,0,12,30,30
1650707350263,MATH 18,B04,083751,Staff,0,12,30,30
1650707356290,MATH 20A,A01,083754,Staff,19,0,40,21
1650707362314,MATH 20B,A01,083756,Staff,0,11,30,30
1650707362314,MATH 20B,A02,083757,Staff,0,12,30,30
1650707368337,MATH 20C,A01,083760,Staff,0,16,30,30
1650707368337,MATH 20C,A02,083761,Staff,0,15,30,30
1650707368337,MATH 20C,B01,083762,Staff,9,0,30,21
1650707368337,MATH 20C,B02,083763,Staff,28,0,30,2
1650707374449,MATH 20D,A01,083765,Staff,2,1,30,28
1650707374449,MATH 20D,A02,083766,Staff,6,0,30,24
1650707374449,MATH 20D,A03,083767,Staff,24,0,30,6
1650707380476,MATH 20E,A01,083771,Staff,3,0,30,27
1650707380476,MATH 20E,A02,083772,Staff,16,0,30,14
1650707380476,MATH 20E,B01,083773,Staff,0,0,30,30
1650707380476,MATH 20E,B02,083774,Staff,6,0,30,24
1650707386503,MATH 103A,A01,083777,Staff,0,15,30,30
1650707386503,MATH 103A,A02,083778,Staff,0,15,30,30
1650707386503,MATH 103A,B01,083779,Staff,0,15,30,30
1650707386503,MATH 103A,B02,083780,Staff,0,15,30,30
1650707392528,MATH 105,A01,085443,Staff,0,22,30,30
1650707398556,MATH 109,A01,083213,Anzaldo; Leesa B,0,7,30,30
1650707398556,MATH 109,A02,083214,Anzaldo; Leesa B,0,7,30,30
1650707398556,MATH 109,B01,083215,Anzaldo; Leesa B,0,8,30,30
1650707398556,MATH 109,B02,083216,Anzaldo; Leesa B,0,6,30,30
1650707404580,MATH 142A,A01,083219,Chow; Bennett,0,16,30,30
1650707404580,MATH 142A,A02,083220,Chow; Bennett,0,15,30,30
1650707404580,MATH 142A,B01,083221,Chow; Bennett,0,15,30,30
1650707404580,MATH 142A,B02,083222,Chow; Bennett,0,14,30,30
1650707410603,MATH 193A,A01,083224,Staff,0,5,30,30
1650707410603,MATH 193A,A02,083225,Staff,0,6,30,30
1650707410603,MATH 193A,A03,083781,Staff,0,6,30,30
1650707410603,MATH 193A,A04,083782,Staff,0,7,30,30
1650707416632,MATH 197,001,091859,McAuley; Julian John,9998,0,9999,1
1650707422682,COGS 9,A01,083615,Staff,1,15,60,59
1650707428706,COGS 11,A01,083617,Boyle; Mary E. T.,16,0,40,24
1650707434734,COGS 13,A01,083071,Staff,0,38,40,40
1650707440760,COGS 14A,A01,092681,Staff,0,35,100,100
1650707446783,COGS 14B,A01,083073,Cheng; Tzu-Han,1,13,50,49
1650707452807,COGS 17,A01,092677,Staff,13,0,75,62
1650707458840,COGS 100,A01,083619,Staff,0,28,60,60
1650707464862,COGS 101A,A01,083621,Davis; Joshua Daniel,0,27,60,60
1650707470885,COGS 101B,A01,091572,Staff,0,4,60,60
1650707476916,COGS 101C,A01,083625,Delgado; Tania,14,0,30,16
1650707482940,COGS 107A,A01,083627,Boyle; Mary E. T.,0,16,60,60
1650707488965,COGS 118A,A01,083075,Staff,0,8,60,60
1650707494994,CSE 3,A50,083646,Miranda; Gregory Joseph,18,0,38,20
1650707494994,CSE 3,A51,083647,Miranda; Gregory Joseph,36,0,37,1
1650707501020,CSE 8A,A50,083650,Miranda; Gregory Joseph,0,30,40,40
1650707507047,CSE 11,A01,083080,Cao; Yingjun,0,96,40,40
1650707513071,CSE 12,A01,083652,Staff,0,21,100,100
1650707519095,CSE 15L,A01,083654,Staff,0,3,50,50
1650707519095,CSE 15L,A02,083655,Staff,0,2,50,50
1650707525119,CSE 20,A01,083657,Staff,49,0,80,31
1650707531141,CSE 30,A01,083084,Eldon; John,0,77,40,40
1650707537166,CSE 100,A01,083659,Cao; Yingjun,0,70,50,50
1650707543192,CSE 134B,A01,083661,Powell; Thomas Allan,0,38,65,65
1650707549216,CSE 140,A01,083663,Staff,0,11,75,75
1650707555242,CSE 140L,A01,083088,Eldon; John,0,20,75,75
1650707561272,CSE 175,A01,083665,Kumar; Rakesh,7,0,25,18
1650707567293,CSE 190,A00,092507,Dubnov; Shlomo,10,0,20,10
1650707573317,ECE 45,A01,083139,Staff,1,2,60,59
1650707579344,ECE 65,A50,083695,Staff,0,5,30,30
1650707585371,ECE 109,A01,091882,Touri; Behrouz,33,0,70,37
1650707591399,ECE 180,A00,083140,Abi Samra; Nicholas Camill,20,0,30,10
1650707591399,ECE 180,B00,083141,Abi Samra; Nicholas Camill,0,0,30,30
1650707597424,MATH 10A,A01,083735,Patchell; Gregory David,2,0,30,28
1650707597424,MATH 10A,A02,083736,Patchell; Gregory David,27,0,30,3
1650707597424,MATH 10A,A03,083737,Patchell; Gregory David,24,0,30,6
1650707603452,MATH 10B,A01,083207,Staff,0,9,30,30
1650707603452,MATH 10B,A02,083208,Staff,1,7,30,29
1650707603452,MATH 10B,B01,083739,Staff,11,0,30,19
1650707603452,MATH 10B,B02,083740,Staff,28,0,30,2
1650707609486,MATH 18,A01,083743,Staff,0,0,30,30
1650707609486,MATH 18,A02,083744,Staff,23,0,30,7
1650707609486,MATH 18,A03,083745,Staff,21,0,30,9
1650707609486,MATH 18,A04,083746,Staff,26,0,30,4
1650707609486,MATH 18,B01,083748,Staff,0,15,30,30
1650707609486,MATH 18,B02,083749,Staff,0,12,30,30
1650707609486,MATH 18,B03,083750,Staff,0,12,30,30
1650707609486,MATH 18,B04,083751,Staff,0,12,30,30
1650707615509,MATH 20A,A01,083754,Staff,19,0,40,21
1650707621534,MATH 20B,A01,083756,Staff,0,11,30,30
1650707621534,MATH 20B,A02,083757,Staff,0,12,30,30
1650707627559,MATH 20C,A01,083760,Staff,0,16,30,30
1650707627559,MATH 20C,A02,083761,Staff,0,15,30,30
1650707627559,MATH 20C,B01,083762,Staff,9,0,30,21
1650707627559,MATH 20C,B02,083763,Staff,28,0,30,2
1650707633586,MATH 20D,A01,083765,Staff,2,1,30,28
1650707633586,MATH 20D,A02,083766,Staff,6,0,30,24
1650707633586,MATH 20D,A03,083767,Staff,24,0,30,6
1650707639610,MATH 20E,A01,083771,Staff,3,0,30,27
1650707639610,MATH 20E,A02,083772,Staff,16,0,30,14
1650707639610,MATH 20E,B01,083773,Staff,0,0,30,30
1650707639610,MATH 20E,B02,083774,Staff,6,0,30,24
1650707645635,MATH 103A,A01,083777,Staff,0,15,30,30
1650707645635,MATH 103A,A02,083778,Staff,0,15,30,30
1650707645635,MATH 103A,B01,083779,Staff,0,15,30,30
1650707645635,MATH 103A,B02,083780,Staff,0,15,30,30
1650707651659,MATH 105,A01,085443,Staff,0,22,30,30
1650707657682,MATH 109,A01,083213,Anzaldo; Leesa B,0,7,30,30
1650707657682,MATH 109,A02,083214,Anzaldo; Leesa B,0,7,30,30
1650707657682,MATH 109,B01,083215,Anzaldo; Leesa B,0,8,30,30
1650707657682,MATH 109,B02,083216,Anzaldo; Leesa B,0,6,30,30
1650707663719,MATH 142A,A01,083219,Chow; Bennett,0,16,30,30
1650707663719,MATH 142A,A02,083220,Chow; Bennett,0,15,30,30
1650707663719,MATH 142A,B01,083221,Chow; Bennett,0,15,30,30
1650707663719,MATH 142A,B02,083222,Chow; Bennett,0,14,30,30
1650707669743,MATH 193A,A01,083224,Staff,0,5,30,30
1650707669743,MATH 193A,A02,083225,Staff,0,6,30,30
1650707669743,MATH 193A,A03,083781,Staff,0,6,30,30
1650707669743,MATH 193A,A04,083782,Staff,0,7,30,30
1650707675768,MATH 197,001,091859,McAuley; Julian John,9998,0,9999,1
1650707681826,COGS 9,A01,083615,Staff,1,15,60,59
1650707687852,COGS 11,A01,083617,Boyle; Mary E. T.,16,0,40,24
1650707693876,COGS 13,A01,083071,Staff,0,38,40,40
1650707699899,COGS 14A,A01,092681,Staff,0,35,100,100
1650707705926,COGS 14B,A01,083073,Cheng; Tzu-Han,1,13,50,49
1650707711949,COGS 17,A01,092677,Staff,13,0,75,62
1650707717976,COGS 100,A01,083619,Staff,0,28,60,60
1650707724006,COGS 101A,A01,083621,Davis; Joshua Daniel,0,27,60,60
1650707730032,COGS 101B,A01,091572,Staff,0,4,60,60
1650707736057,COGS 101C,A01,083625,Delgado; Tania,14,0,30,16
1650707742087,COGS 107A,A01,083627,Boyle; Mary E. T.,0,16,60,60
1650707748111,COGS 118A,A01,083075,Staff,0,8,60,60
1650707754135,CSE 3,A50,083646,Miranda; Gregory Joseph,18,0,38,20
1650707754135,CSE 3,A51,083647,Miranda; Gregory Joseph,36,0,37,1
1650707760164,CSE 8A,A50,083650,Miranda; Gregory Joseph,0,30,40,40
1650707766187,CSE 11,A01,083080,Cao; Yingjun,0,96,40,40
1650707772210,CSE 12,A01,083652,Staff,0,21,100,100
1650707778234,CSE 15L,A01,083654,Staff,0,3,50,50
1650707778234,CSE 15L,A02,083655,Staff,0,2,50,50
1650707784262,CSE 20,A01,083657,Staff,49,0,80,31
1650707790284,CSE 30,A01,083084,Eldon; John,0,77,40,40
1650707796309,CSE 100,A01,083659,Cao; Yingjun,0,70,50,50
1650707802336,CSE 134B,A01,083661,Powell; Thomas Allan,0,38,65,65
1650707808364,CSE 140,A01,083663,Staff,0,11,75,75
1650707814389,CSE 140L,A01,083088,Eldon; John,0,20,75,75
1650707820413,CSE 175,A01,083665,Kumar; Rakesh,7,0,25,18
1650707826435,CSE 190,A00,092507,Dubnov; Shlomo,10,0,20,10
1650707832457,ECE 45,A01,083139,Staff,1,2,60,59
1650707838497,ECE 65,A50,083695,Staff,0,5,30,30
1650707844521,ECE 109,A01,091882,Touri; Behrouz,33,0,70,37
1650707850543,ECE 180,A00,083140,Abi Samra; Nicholas Camill,20,0,30,10
1650707850543,ECE 180,B00,083141,Abi Samra; Nicholas Camill,0,0,30,30
1650707856569,MATH 10A,A01,083735,Patchell; Gregory David,2,0,30,28
1650707856569,MATH 10A,A02,083736,Patchell; Gregory David,27,0,30,3
1650707856569,MATH 10A,A03,083737,Patchell; Gregory David,24,0,30,6
1650707862593,MATH 10B,A01,083207,Staff,0,9,30,30
1650707862593,MATH 10B,A02,083208,Staff,1,7,30,29
1650707862593,MATH 10B,B01,083739,Staff,11,0,30,19
1650707862593,MATH 10B,B02,083740,Staff,28,0,30,2
1650707868616,MATH 18,A01,083743,Staff,0,0,30,30
1650707868616,MATH 18,A02,083744,Staff,23,0,30,7
1650707868616,MATH 18,A03,083745,Staff,21,0,30,9
1650707868616,MATH 18,A04,083746,Staff,26,0,30,4
1650707868616,MATH 18,B01,083748,Staff,0,15,30,30
1650707868616,MATH 18,B02,083749,Staff,0,12,30,30
1650707868616,MATH 18,B03,083750,Staff,0,12,30,30
1650707868616,MATH 18,B04,083751,Staff,0,12,30,30
1650707874640,MATH 20A,A01,083754,Staff,19,0,40,21
1650707880664,MATH 20B,A01,083756,Staff,0,11,30,30
1650707880664,MATH 20B,A02,083757,Staff,0,12,30,30
1650707886689,MATH 20C,A01,083760,Staff,0,16,30,30
1650707886689,MATH 20C,A02,083761,Staff,0,15,30,30
1650707886689,MATH 20C,B01,083762,Staff,9,0,30,21
1650707886689,MATH 20C,B02,083763,Staff,28,0,30,2
1650707892713,MATH 20D,A01,083765,Staff,2,1,30,28
1650707892713,MATH 20D,A02,083766,Staff,6,0,30,24
1650707892713,MATH 20D,A03,083767,Staff,24,0,30,6
1650707898738,MATH 20E,A01,083771,Staff,3,0,30,27
1650707898738,MATH 20E,A02,083772,Staff,16,0,30,14
1650707898738,MATH 20E,B01,083773,Staff,0,0,30,30
1650707898738,MATH 20E,B02,083774,Staff,6,0,30,24
1650707904766,MATH 103A,A01,083777,Staff,0,15,30,30
1650707904766,MATH 103A,A02,083778,Staff,0,15,30,30
1650707904766,MATH 103A,B01,083779,Staff,0,15,30,30
1650707904766,MATH 103A,B02,083780,Staff,0,15,30,30
1650707910790,MATH 105,A01,085443,Staff,0,22,30,30
1650707916815,MATH 109,A01,083213,Anzaldo; Leesa B,0,7,30,30
1650707916815,MATH 109,A02,083214,Anzaldo; Leesa B,0,7,30,30
1650707916815,MATH 109,B01,083215,Anzaldo; Leesa B,0,8,30,30
1650707916815,MATH 109,B02,083216,Anzaldo; Leesa B,0,6,30,30
1650707922840,MATH 142A,A01,083219,Chow; Bennett,0,16,30,30
1650707922840,MATH 142A,A02,083220,Chow; Bennett,0,15,30,30
1650707922840,MATH 142A,B01,083221,Chow; Bennett,0,15,30,30
1650707922840,MATH 142A,B02,083222,Chow; Bennett,0,14,30,30
1650707928879,MATH 193A,A01,083224,Staff,0,5,30,30
1650707928879,MATH 193A,A02,083225,Staff,0,6,30,30
1650707928879,MATH 193A,A03,083781,Staff,0,6,30,30
1650707928879,MATH 193A,A04,083782,Staff,0,7,30,30
1650707934903,MATH 197,001,091859,McAuley; Julian John,9998,0,9999,1
1650707940997,COGS 9,A01,083615,Staff,1,15,60,59
1650707947024,COGS 11,A01,083617,Boyle; Mary E. T.,16,0,40,24
1650707953048,COGS 13,A01,083071,Staff,0,38,40,40
1650707959076,COGS 14A,A01,092681,Staff,0,35,100,100
1650707965195,COGS 14B,A01,083073,Cheng; Tzu-Han,1,13,50,49
1650707971219,COGS 17,A01,092677,Staff,13,0,75,62
1650707977249,COGS 100,A01,083619,Staff,0,28,60,60
1650707983276,COGS 101A,A01,083621,Davis; Joshua Daniel,0,27,60,60
1650707989303,COGS 101B,A01,091572,Staff,0,4,60,60
1650707995330,COGS 101C,A01,083625,Delgado; Tania,14,0,30,16
1650708001364,COGS 107A,A01,083627,Boyle; Mary E. T.,0,16,60,60
1650708007393,COGS 118A,A01,083075,Staff,0,8,60,60
1650708013432,CSE 3,A50,083646,Miranda; Gregory Joseph,18,0,38,20
1650708013432,CSE 3,A51,083647,Miranda; Gregory Joseph,36,0,37,1
1650708019456,CSE 8A,A50,083650,Miranda; Gregory Joseph,0,30,40,40
1650708025483,CSE 11,A01,083080,Cao; Yingjun,0,96,40,40
1650708031512,CSE 12,A01,083652,Staff,0,21,100,100
1650708037536,CSE 15L,A01,083654,Staff,0,3,50,50
1650708037536,CSE 15L,A02,083655,Staff,0,2,50,50
1650708043573,CSE 20,A01,083657,Staff,49,0,80,31
1650708049603,CSE 30,A01,083084,Eldon; John,0,77,40,40
1650708055628,CSE 100,A01,083659,Cao; Yingjun,0,70,50,50
1650708061658,CSE 134B,A01,083661,Powell; Thomas Allan,0,38,65,65
1650708067680,CSE 140,A01,083663,Staff,0,11,75,75
1650708073712,CSE 140L,A01,083088,Eldon; John,0,20,75,75
1650708079738,CSE 175,A01,083665,Kumar; Rakesh,7,0,25,18
1650708085763,CSE 190,A00,092507,Dubnov; Shlomo,10,0,20,10
1650708091794,ECE 45,A01,083139,Staff,1,2,60,59
1650708097824,ECE 65,A50,083695,Staff,0,5,30,30
1650708103854,ECE 109,A01,091882,Touri; Behrouz,33,0,70,37
1650708109878,ECE 180,A00,083140,Abi Samra; Nicholas Camill,20,0,30,10
1650708109878,ECE 180,B00,083141,Abi Samra; Nicholas Camill,0,0,30,30
1650708115906,MATH 10A,A01,083735,Patchell; Gregory David,2,0,30,28
1650708115906,MATH 10A,A02,083736,Patchell; Gregory David,27,0,30,3
1650708115906,MATH 10A,A03,083737,Patchell; Gregory David,24,0,30,6
1650708121940,MATH 10B,A01,083207,Staff,0,9,30,30
1650708121940,MATH 10B,A02,083208,Staff,1,7,30,29
1650708121940,MATH 10B,B01,083739,Staff,11,0,30,19
1650708121940,MATH 10B,B02,083740,Staff,28,0,30,2
1650708127976,MATH 18,A01,083743,Staff,0,0,30,30
1650708127976,MATH 18,A02,083744,Staff,23,0,30,7
1650708127976,MATH 18,A03,083745,Staff,21,0,30,9
1650708127976,MATH 18,A04,083746,Staff,26,0,30,4
1650708127976,MATH 18,B01,083748,Staff,0,15,30,30
1650708127976,MATH 18,B02,083749,Staff,0,12,30,30
1650708127976,MATH 18,B03,083750,Staff,0,12,30,30
1650708127976,MATH 18,B04,083751,Staff,0,12,30,30
1650708134010,MATH 20A,A01,083754,Staff,19,0,40,21
1650708140041,MATH 20B,A01,083756,Staff,0,11,30,30
1650708140041,MATH 20B,A02,083757,Staff,0,12,30,30
1650708146071,MATH 20C,A01,083760,Staff,0,16,30,30
1650708146071,MATH 20C,A02,083761,Staff,0,15,30,30
1650708146071,MATH 20C,B01,083762,Staff,9,0,30,21
1650708146071,MATH 20C,B02,083763,Staff,28,0,30,2
1650708152099,MATH 20D,A01,083765,Staff,2,1,30,28
1650708152099,MATH 20D,A02,083766,Staff,6,0,30,24
1650708152099,MATH 20D,A03,083767,Staff,24,0,30,6
1650708158130,MATH 20E,A01,083771,Staff,3,0,30,27
1650708158130,MATH 20E,A02,083772,Staff,16,0,30,14
1650708158130,MATH 20E,B01,083773,Staff,0,0,30,30
1650708158130,MATH 20E,B02,083774,Staff,6,0,30,24
1650708164156,MATH 103A,A01,083777,Staff,0,15,30,30
1650708164156,MATH 103A,A02,083778,Staff,0,15,30,30
1650708164156,MATH 103A,B01,083779,Staff,0,15,30,30
1650708164156,MATH 103A,B02,083780,Staff,0,15,30,30
1650708170181,MATH 105,A01,085443,Staff,0,22,30,30
1650708176207,MATH 109,A01,083213,Anzaldo; Leesa B,0,7,30,30
1650708176207,MATH 109,A02,083214,Anzaldo; Leesa B,0,7,30,30
1650708176207,MATH 109,B01,083215,Anzaldo; Leesa B,0,8,30,30
1650708176207,MATH 109,B02,083216,Anzaldo; Leesa B,0,6,30,30
1650708182234,MATH 142A,A01,083219,Chow; Bennett,0,16,30,30
1650708182234,MATH 142A,A02,083220,Chow; Bennett,0,15,30,30
1650708182234,MATH 142A,B01,083221,Chow; Bennett,0,15,30,30
1650708182234,MATH 142A,B02,083222,Chow; Bennett,0,14,30,30
1650708188269,MATH 193A,A01,083224,Staff,0,5,30,30
1650708188269,MATH 193A,A02,083225,Staff,0,6,30,30
1650708188269,MATH 193A,A03,083781,Staff,0,6,30,30
1650708188269,MATH 193A,A04,083782,Staff,0,7,30,30
1650708194294,MATH 197,001,091859,McAuley; Julian John,9998,0,9999,1
1650708200392,COGS 9,A01,083615,Staff,1,15,60,59
1650708206418,COGS 11,A01,083617,Boyle; Mary E. T.,16,0,40,24
1650708212462,COGS 13,A01,083071,Staff,0,38,40,40
1650708218489,COGS 14A,A01,092681,Staff,0,35,100,100
1650708224515,COGS 14B,A01,083073,Cheng; Tzu-Han,1,13,50,49
1650708230546,COGS 17,A01,092677,Staff,13,0,75,62
1650708236574,COGS 100,A01,083619,Staff,0,28,60,60
1650708242606,COGS 101A,A01,083621,Davis; Joshua Daniel,0,27,60,60
1650708248631,COGS 101B,A01,091572,Staff,0,4,60,60
1650708254658,COGS 101C,A01,083625,Delgado; Tania,14,0,30,16
1650708260687,COGS 107A,A01,083627,Boyle; Mary E. T.,0,16,60,60
1650708266709,COGS 118A,A01,083075,Staff,0,8,60,60
1650708272734,CSE 3,A50,083646,Miranda; Gregory Joseph,18,0,38,20
1650708272734,CSE 3,A51,083647,Miranda; Gregory Joseph,36,0,37,1
1650708278761,CSE 8A,A50,083650,Miranda; Gregory Joseph,0,30,40,40
1650708284787,CSE 11,A01,083080,Cao; Yingjun,0,96,40,40
1650708290813,CSE 12,A01,083652,Staff,0,21,100,100
1650708296836,CSE 15L,A01,083654,Staff,0,3,50,50
1650708296836,CSE 15L,A02,083655,Staff,0,2,50,50
1650708302861,CSE 20,A01,083657,Staff,49,0,80,31
1650708308886,CSE 30,A01,083084,Eldon; John,0,77,40,40
1650708314915,CSE 100,A01,083659,Cao; Yingjun,0,70,50,50
1650708320940,CSE 134B,A01,083661,Powell; Thomas Allan,0,38,65,65
1650708326964,CSE 140,A01,083663,Staff,0,11,75,75
1650708332995,CSE 140L,A01,083088,Eldon; John,0,20,75,75
1650708339020,CSE 175,A01,083665,Kumar; Rakesh,7,0,25,18
1650708345044,CSE 190,A00,092507,Dubnov; Shlomo,10,0,20,10
1650708351070,ECE 45,A01,083139,Staff,1,2,60,59
1650708357104,ECE 65,A50,083695,Staff,0,5,30,30
1650708363129,ECE 109,A01,091882,Touri; Behrouz,33,0,70,37
1650708369155,ECE 180,A00,083140,Abi Samra; Nicholas Camill,20,0,30,10
1650708369155,ECE 180,B00,083141,Abi Samra; Nicholas Camill,0,0,30,30
1650708375188,MATH 10A,A01,083735,Patchell; Gregory David,2,0,30,28
1650708375188,MATH 10A,A02,083736,Patchell; Gregory David,27,0,30,3
1650708375188,MATH 10A,A03,083737,Patchell; Gregory David,24,0,30,6
1650708381215,MATH 10B,A01,083207,Staff,0,9,30,30
1650708381215,MATH 10B,A02,083208,Staff,1,7,30,29
1650708381215,MATH 10B,B01,083739,Staff,11,0,30,19
1650708381215,MATH 10B,B02,083740,Staff,28,0,30,2
1650708387251,MATH 18,A01,083743,Staff,0,0,30,30
1650708387251,MATH 18,A02,083744,Staff,23,0,30,7
1650708387251,MATH 18,A03,083745,Staff,21,0,30,9
1650708387251,MATH 18,A04,083746,Staff,26,0,30,4
1650708387251,MATH 18,B01,083748,Staff,0,15,30,30
1650708387251,MATH 18,B02,083749,Staff,0,12,30,30
1650708387251,MATH 18,B03,083750,Staff,0,12,30,30
1650708387251,MATH 18,B04,083751,Staff,0,12,30,30
1650708393275,MATH 20A,A01,083754,Staff,19,0,40,21
1650708399305,MATH 20B,A01,083756,Staff,0,11,30,30
1650708399305,MATH 20B,A02,083757,Staff,0,12,30,30
1650708405331,MATH 20C,A01,083760,Staff,0,16,30,30
1650708405331,MATH 20C,A02,083761,Staff,0,15,30,30
1650708405331,MATH 20C,B01,083762,Staff,9,0,30,21
1650708405331,MATH 20C,B02,083763,Staff,28,0,30,2
1650708411356,MATH 20D,A01,083765,Staff,2,1,30,28
1650708411356,MATH 20D,A02,083766,Staff,6,0,30,24
1650708411356,MATH 20D,A03,083767,Staff,24,0,30,6
1650708417397,MATH 20E,A01,083771,Staff,3,0,30,27
1650708417397,MATH 20E,A02,083772,Staff,16,0,30,14
1650708417397,MATH 20E,B01,083773,Staff,0,0,30,30
1650708417397,MATH 20E,B02,083774,Staff,6,0,30,24
1650708423433,MATH 103A,A01,083777,Staff,0,15,30,30
1650708423433,MATH 103A,A02,083778,Staff,0,15,30,30
1650708423433,MATH 103A,B01,083779,Staff,0,15,30,30
1650708423433,MATH 103A,B02,083780,Staff,0,15,30,30
1650708429461,MATH 105,A01,085443,Staff,0,22,30,30
1650708435487,MATH 109,A01,083213,Anzaldo; Leesa B,0,7,30,30
1650708435487,MATH 109,A02,083214,Anzaldo; Leesa B,0,7,30,30
1650708435487,MATH 109,B01,083215,Anzaldo; Leesa B,0,8,30,30
1650708435487,MATH 109,B02,083216,Anzaldo; Leesa B,0,6,30,30
1650708441514,MATH 142A,A01,083219,Chow; Bennett,0,16,30,30
1650708441514,MATH 142A,A02,083220,Chow; Bennett,0,15,30,30
1650708441514,MATH 142A,B01,083221,Chow; Bennett,0,15,30,30
1650708441514,MATH 142A,B02,083222,Chow; Bennett,0,14,30,30
1650708447544,MATH 193A,A01,083224,Staff,0,5,30,30
1650708447544,MATH 193A,A02,083225,Staff,0,6,30,30
1650708447544,MATH 193A,A03,083781,Staff,0,6,30,30
1650708447544,MATH 193A,A04,083782,Staff,0,7,30,30
1650708453568,MATH 197,001,091859,McAuley; Julian John,9998,0,9999,1
1650708459634,COGS 9,A01,083615,Staff,1,15,60,59
1650708465662,COGS 11,A01,083617,Boyle; Mary E. T.,16,0,40,24
1650708471702,COGS 13,A01,083071,Staff,0,38,40,40
1650708477727,COGS 14A,A01,092681,Staff,0,35,100,100
1650708483753,COGS 14B,A01,083073,Cheng; Tzu-Han,1,13,50,49
1650708489777,COGS 17,A01,092677,Staff,13,0,75,62
1650708495803,COGS 100,A01,083619,Staff,0,28,60,60
1650708501848,COGS 101A,A01,083621,Davis; Joshua Daniel,0,27,60,60
1650708507896,COGS 101B,A01,091572,Staff,0,4,60,60
1650708513922,COGS 101C,A01,083625,Delgado; Tania,14,0,30,16
1650708519947,COGS 107A,A01,083627,Boyle; Mary E. T.,0,16,60,60
1650708525981,COGS 118A,A01,083075,Staff,0,8,60,60
1650708532015,CSE 3,A50,083646,Miranda; Gregory Joseph,18,0,38,20
1650708532015,CSE 3,A51,083647,Miranda; Gregory Joseph,36,0,37,1
1650708538039,CSE 8A,A50,083650,Miranda; Gregory Joseph,0,30,40,40
1650708544066,CSE 11,A01,083080,Cao; Yingjun,0,96,40,40
1650708550091,CSE 12,A01,083652,Staff,0,21,100,100
1650708556120,CSE 15L,A01,083654,Staff,0,3,50,50
1650708556120,CSE 15L,A02,083655,Staff,0,2,50,50
1650708562230,CSE 20,A01,083657,Staff,49,0,80,31
1650708568255,CSE 30,A01,083084,Eldon; John,0,77,40,40
1650708574294,CSE 100,A01,083659,Cao; Yingjun,0,70,50,50
1650708580324,CSE 134B,A01,083661,Powell; Thomas Allan,0,38,65,65
1650708586356,CSE 140,A01,083663,Staff,0,11,75,75
1650708592390,CSE 140L,A01,083088,Eldon; John,0,20,75,75
1650708598425,CSE 175,A01,083665,Kumar; Rakesh,7,0,25,18
1650708604461,CSE 190,A00,092507,Dubnov; Shlomo,10,0,20,10
1650708610486,ECE 45,A01,083139,Staff,1,2,60,59
1650708616518,ECE 65,A50,083695,Staff,0,5,30,30
1650708622545,ECE 109,A01,091882,Touri; Behrouz,33,0,70,37
1650708628569,ECE 180,A00,083140,Abi Samra; Nicholas Camill,20,0,30,10
1650708628569,ECE 180,B00,083141,Abi Samra; Nicholas Camill,0,0,30,30
1650708634605,MATH 10A,A01,083735,Patchell; Gregory David,2,0,30,28
1650708634605,MATH 10A,A02,083736,Patchell; Gregory David,27,0,30,3
1650708634605,MATH 10A,A03,083737,Patchell; Gregory David,24,0,30,6
1650708640648,MATH 10B,A01,083207,Staff,0,9,30,30
1650708640648,MATH 10B,A02,083208,Staff,1,7,30,29
1650708640648,MATH 10B,B01,083739,Staff,11,0,30,19
1650708640648,MATH 10B,B02,083740,Staff,28,0,30,2
1650708646685,MATH 18,A01,083743,Staff,0,0,30,30
1650708646685,MATH 18,A02,083744,Staff,23,0,30,7
1650708646685,MATH 18,A03,083745,Staff,21,0,30,9
1650708646685,MATH 18,A04,083746,Staff,26,0,30,4
1650708646685,MATH 18,B01,083748,Staff,0,15,30,30
1650708646685,MATH 18,B02,083749,Staff,0,12,30,30
1650708646685,MATH 18,B03,083750,Staff,0,12,30,30
1650708646685,MATH 18,B04,083751,Staff,0,12,30,30
1650708652727,MATH 20A,A01,083754,Staff,19,0,40,21
1650708658767,MATH 20B,A01,083756,Staff,0,11,30,30
1650708658767,MATH 20B,A02,083757,Staff,0,12,30,30
1650708664800,MATH 20C,A01,083760,Staff,0,16,30,30
1650708664800,MATH 20C,A02,083761,Staff,0,15,30,30
1650708664800,MATH 20C,B01,083762,Staff,9,0,30,21
1650708664800,MATH 20C,B02,083763,Staff,28,0,30,2
1650708670835,MATH 20D,A01,083765,Staff,2,1,30,28
1650708670835,MATH 20D,A02,083766,Staff,6,0,30,24
1650708670835,MATH 20D,A03,083767,Staff,24,0,30,6
1650708676867,MATH 20E,A01,083771,Staff,3,0,30,27
1650708676867,MATH 20E,A02,083772,Staff,16,0,30,14
1650708676867,MATH 20E,B01,083773,Staff,0,0,30,30
1650708676867,MATH 20E,B02,083774,Staff,6,0,30,24
1650708682900,MATH 103A,A01,083777,Staff,0,15,30,30
1650708682900,MATH 103A,A02,083778,Staff,0,15,30,30
1650708682900,MATH 103A,B01,083779,Staff,0,15,30,30
1650708682900,MATH 103A,B02,083780,Staff,0,15,30,30
1650708688926,MATH 105,A01,085443,Staff,0,22,30,30
1650708694952,MATH 109,A01,083213,Anzaldo; Leesa B,0,7,30,30
1650708694952,MATH 109,A02,083214,Anzaldo; Leesa B,0,7,30,30
1650708694952,MATH 109,B01,083215,Anzaldo; Leesa B,0,8,30,30
1650708694952,MATH 109,B02,083216,Anzaldo; Leesa B,0,6,30,30
1650708700979,MATH 142A,A01,083219,Chow; Bennett,0,16,30,30
1650708700979,MATH 142A,A02,083220,Chow; Bennett,0,15,30,30
1650708700979,MATH 142A,B01,083221,Chow; Bennett,0,15,30,30
1650708700979,MATH 142A,B02,083222,Chow; Bennett,0,14,30,30
1650708707004,MATH 193A,A01,083224,Staff,0,5,30,30
1650708707004,MATH 193A,A02,083225,Staff,0,6,30,30
1650708707004,MATH 193A,A03,083781,Staff,0,6,30,30
1650708707004,MATH 193A,A04,083782,Staff,0,7,30,30
1650708713032,MATH 197,001,091859,McAuley; Julian John,9998,0,9999,1
1650708719111,COGS 9,A01,083615,Staff,1,15,60,59
1650708725149,COGS 11,A01,083617,Boyle; Mary E. T.,16,0,40,24
1650708731179,COGS 13,A01,083071,Staff,0,38,40,40
1650708737219,COGS 14A,A01,092681,Staff,0,35,100,100
1650708743267,COGS 14B,A01,083073,Cheng; Tzu-Han,1,13,50,49
1650708749300,COGS 17,A01,092677,Staff,13,0,75,62
1650708755326,COGS 100,A01,083619,Staff,0,28,60,60
1650708761352,COGS 101A,A01,083621,Davis; Joshua Daniel,0,27,60,60
1650708767378,COGS 101B,A01,091572,Staff,0,4,60,60
1650708773404,COGS 101C,A01,083625,Delgado; Tania,14,0,30,16
1650708779430,COGS 107A,A01,083627,Boyle; Mary E. T.,0,16,60,60
1650708785459,COGS 118A,A01,083075,Staff,0,8,60,60
1650708791487,CSE 3,A50,083646,Miranda; Gregory Joseph,18,0,38,20
1650708791487,CSE 3,A51,083647,Miranda; Gregory Joseph,36,0,37,1
1650708797535,CSE 8A,A50,083650,Miranda; Gregory Joseph,0,30,40,40
1650708803562,CSE 11,A01,083080,Cao; Yingjun,0,96,40,40
1650708809597,CSE 12,A01,083652,Staff,0,21,100,100
1650708815624,CSE 15L,A01,083654,Staff,0,3,50,50
1650708815624,CSE 15L,A02,083655,Staff,0,2,50,50
1650708821663,CSE 20,A01,083657,Staff,49,0,80,31
1650708827690,CSE 30,A01,083084,Eldon; John,0,77,40,40
1650708833738,CSE 100,A01,083659,Cao; Yingjun,0,70,50,50
1650708839762,CSE 134B,A01,083661,Powell; Thomas Allan,0,38,65,65
1650708845796,CSE 140,A01,083663,Staff,0,11,75,75
1650708851826,CSE 140L,A01,083088,Eldon; John,0,20,75,75
1650708857851,CSE 175,A01,083665,Kumar; Rakesh,7,0,25,18
1650708863890,CSE 190,A00,092507,Dubnov; Shlomo,10,0,20,10
1650708869923,ECE 45,A01,083139,Staff,1,2,60,59
1650708875970,ECE 65,A50,083695,Staff,0,5,30,30
1650708881995,ECE 109,A01,091882,Touri; Behrouz,33,0,70,37
1650708888021,ECE 180,A00,083140,Abi Samra; Nicholas Camill,20,0,30,10
1650708888021,ECE 180,B00,083141,Abi Samra; Nicholas Camill,0,0,30,30
1650708894057,MATH 10A,A01,083735,Patchell; Gregory David,2,0,30,28
1650708894057,MATH 10A,A02,083736,Patchell; Gregory David,27,0,30,3
1650708894057,MATH 10A,A03,083737,Patchell; Gregory David,24,0,30,6
1650708900086,MATH 10B,A01,083207,Staff,0,9,30,30
1650708900086,MATH 10B,A02,083208,Staff,1,7,30,29
1650708900086,MATH 10B,B01,083739,Staff,11,0,30,19
1650708900086,MATH 10B,B02,083740,Staff,28,0,30,2
1650708906119,MATH 18,A01,083743,Staff,0,0,30,30
1650708906119,MATH 18,A02,083744,Staff,23,0,30,7
1650708906119,MATH 18,A03,083745,Staff,21,0,30,9
1650708906119,MATH 18,A04,083746,Staff,26,0,30,4
1650708906119,MATH 18,B01,083748,Staff,0,15,30,30
1650708906119,MATH 18,B02,083749,Staff,0,12,30,30
1650708906119,MATH 18,B03,083750,Staff,0,12,30,30
1650708906119,MATH 18,B04,083751,Staff,0,12,30,30
1650708912148,MATH 20A,A01,083754,Staff,19,0,40,21
1650708918171,MATH 20B,A01,083756,Staff,0,11,30,30
1650708918171,MATH 20B,A02,083757,Staff,0,12,30,30
1650708924207,MATH 20C,A01,083760,Staff,0,16,30,30
1650708924207,MATH 20C,A02,083761,Staff,0,15,30,30
1650708924207,MATH 20C,B01,083762,Staff,9,0,30,21
1650708924207,MATH 20C,B02,083763,Staff,28,0,30,2
1650708930235,MATH 20D,A01,083765,Staff,2,1,30,28
1650708930235,MATH 20D,A02,083766,Staff,6,0,30,24
1650708930235,MATH 20D,A03,083767,Staff,24,0,30,6
1650708936260,MATH 20E,A01,083771,Staff,3,0,30,27
1650708936260,MATH 20E,A02,083772,Staff,16,0,30,14
1650708936260,MATH 20E,B01,083773,Staff,0,0,30,30
1650708936260,MATH 20E,B02,083774,Staff,6,0,30,24
1650708942287,MATH 103A,A01,083777,Staff,0,15,30,30
1650708942287,MATH 103A,A02,083778,Staff,0,15,30,30
1650708942287,MATH 103A,B01,083779,Staff,0,15,30,30
1650708942287,MATH 103A,B02,083780,Staff,0,15,30,30
1650708948313,MATH 105,A01,085443,Staff,0,22,30,30
1650708954338,MATH 109,A01,083213,Anzaldo; Leesa B,0,7,30,30
1650708954338,MATH 109,A02,083214,Anzaldo; Leesa B,0,7,30,30
1650708954338,MATH 109,B01,083215,Anzaldo; Leesa B,0,8,30,30
1650708954338,MATH 109,B02,083216,Anzaldo; Leesa B,0,6,30,30
1650708960374,MATH 142A,A01,083219,Chow; Bennett,0,16,30,30
1650708960374,MATH 142A,A02,083220,Chow; Bennett,0,15,30,30
1650708960374,MATH 142A,B01,083221,Chow; Bennett,0,15,30,30
1650708960374,MATH 142A,B02,083222,Chow; Bennett,0,14,30,30
1650708966415,MATH 193A,A01,083224,Staff,0,5,30,30
1650708966415,MATH 193A,A02,083225,Staff,0,6,30,30
1650708966415,MATH 193A,A03,083781,Staff,0,6,30,30
1650708966415,MATH 193A,A04,083782,Staff,0,7,30,30
1650708972438,MATH 197,001,091859,McAuley; Julian John,9998,0,9999,1
1650708978500,COGS 9,A01,083615,Staff,1,15,60,59
1650708984526,COGS 11,A01,083617,Boyle; Mary E. T.,16,0,40,24
1650708990553,COGS 13,A01,083071,Staff,0,38,40,40
1650708996586,COGS 14A,A01,092681,Staff,0,35,100,100
1650709002611,COGS 14B,A01,083073,Cheng; Tzu-Han,1,13,50,49
1650709008636,COGS 17,A01,092677,Staff,13,0,75,62
1650709014661,COGS 100,A01,083619,Staff,0,28,60,60
1650709020689,COGS 101A,A01,083621,Davis; Joshua Daniel,0,27,60,60
1650709026721,COGS 101B,A01,091572,Staff,0,4,60,60
1650709032757,COGS 101C,A01,083625,Delgado; Tania,14,0,30,16
1650709038792,COGS 107A,A01,083627,Boyle; Mary E. T.,0,16,60,60
1650709044816,COGS 118A,A01,083075,Staff,0,8,60,60
1650709050843,CSE 3,A50,083646,Miranda; Gregory Joseph,18,0,38,20
1650709050843,CSE 3,A51,083647,Miranda; Gregory Joseph,36,0,37,1
1650709056878,CSE 8A,A50,083650,Miranda; Gregory Joseph,0,30,40,40
1650709062905,CSE 11,A01,083080,Cao; Yingjun,0,96,40,40
1650709068930,CSE 12,A01,083652,Staff,0,21,100,100
1650709074956,CSE 15L,A01,083654,Staff,0,3,50,50
1650709074956,CSE 15L,A02,083655,Staff,0,2,50,50
1650709080981,CSE 20,A01,083657,Staff,49,0,80,31
1650709087009,CSE 30,A01,083084,Eldon; John,0,77,40,40
1650709093040,CSE 100,A01,083659,Cao; Yingjun,0,70,50,50
1650709099075,CSE 134B,A01,083661,Powell; Thomas Allan,0,38,65,65
1650709105101,CSE 140,A01,083663,Staff,0,11,75,75
1650709111127,CSE 140L,A01,083088,Eldon; John,0,20,75,75
1650709117152,CSE 175,A01,083665,Kumar; Rakesh,7,0,25,18
1650709123180,CSE 190,A00,092507,Dubnov; Shlomo,10,0,20,10
1650709129210,ECE 45,A01,083139,Staff,1,2,60,59
1650709135239,ECE 65,A50,083695,Staff,0,5,30,30
1650709141271,ECE 109,A01,091882,Touri; Behrouz,33,0,70,37
1650709147300,ECE 180,A00,083140,Abi Samra; Nicholas Camill,20,0,30,10
1650709147300,ECE 180,B00,083141,Abi Samra; Nicholas Camill,0,0,30,30
1650709153334,MATH 10A,A01,083735,Patchell; Gregory David,2,0,30,28
1650709153334,MATH 10A,A02,083736,Patchell; Gregory David,27,0,30,3
1650709153334,MATH 10A,A03,083737,Patchell; Gregory David,24,0,30,6
1650709159466,MATH 10B,A01,083207,Staff,0,9,30,30
1650709159466,MATH 10B,A02,083208,Staff,1,7,30,29
1650709159466,MATH 10B,B01,083739,Staff,11,0,30,19
1650709159466,MATH 10B,B02,083740,Staff,28,0,30,2
1650709165495,MATH 18,A01,083743,Staff,0,0,30,30
1650709165495,MATH 18,A02,083744,Staff,23,0,30,7
1650709165495,MATH 18,A03,083745,Staff,21,0,30,9
1650709165495,MATH 18,A04,083746,Staff,26,0,30,4
1650709165495,MATH 18,B01,083748,Staff,0,15,30,30
1650709165495,MATH 18,B02,083749,Staff,0,12,30,30
1650709165495,MATH 18,B03,083750,Staff,0,12,30,30
1650709165495,MATH 18,B04,083751,Staff,0,12,30,30
1650709171518,MATH 20A,A01,083754,Staff,19,0,40,21
1650709177543,MATH 20B,A01,083756,Staff,0,11,30,30
1650709177543,MATH 20B,A02,083757,Staff,0,12,30,30
1650709183569,MATH 20C,A01,083760,Staff,0,16,30,30
1650709183569,MATH 20C,A02,083761,Staff,0,15,30,30
1650709183569,MATH 20C,B01,083762,Staff,9,0,30,21
1650709183569,MATH 20C,B02,083763,Staff,28,0,30,2
1650709189594,MATH 20D,A01,083765,Staff,2,1,30,28
1650709189594,MATH 20D,A02,083766,Staff,6,0,30,24
1650709189594,MATH 20D,A03,083767,Staff,24,0,30,6
1650709195636,MATH 20E,A01,083771,Staff,3,0,30,27
1650709195636,MATH 20E,A02,083772,Staff,16,0,30,14
1650709195636,MATH 20E,B01,083773,Staff,0,0,30,30
1650709195636,MATH 20E,B02,083774,Staff,6,0,30,24
1650709201663,MATH 103A,A01,083777,Staff,0,15,30,30
1650709201663,MATH 103A,A02,083778,Staff,0,15,30,30
1650709201663,MATH 103A,B01,083779,Staff,0,15,30,30
1650709201663,MATH 103A,B02,083780,Staff,0,15,30,30
1650709207688,MATH 105,A01,085443,Staff,0,22,30,30
1650709213722,MATH 109,A01,083213,Anzaldo; Leesa B,0,7,30,30
1650709213722,MATH 109,A02,083214,Anzaldo; Leesa B,0,7,30,30
1650709213722,MATH 109,B01,083215,Anzaldo; Leesa B,0,8,30,30
1650709213722,MATH 109,B02,083216,Anzaldo; Leesa B,0,6,30,30
1650709219752,MATH 142A,A01,083219,Chow; Bennett,0,16,30,30
1650709219752,MATH 142A,A02,083220,Chow; Bennett,0,15,30,30
1650709219752,MATH 142A,B01,083221,Chow; Bennett,0,15,30,30
1650709219752,MATH 142A,B02,083222,Chow; Bennett,0,14,30,30
1650709225777,MATH 193A,A01,083224,Staff,0,5,30,30
1650709225777,MATH 193A,A02,083225,Staff,0,6,30,30
1650709225777,MATH 193A,A03,083781,Staff,0,6,30,30
1650709225777,MATH 193A,A04,083782,Staff,0,7,30,30
1650709231805,MATH 197,001,091859,McAuley; Julian John,9998,0,9999,1
1650709237876,COGS 9,A01,083615,Staff,1,15,60,59
1650709243902,COGS 11,A01,083617,Boyle; Mary E. T.,16,0,40,24
1650709249927,COGS 13,A01,083071,Staff,0,38,40,40
1650709255957,COGS 14A,A01,092681,Staff,0,35,100,100
1650709261985,COGS 14B,A01,083073,Cheng; Tzu-Han,1,13,50,49
1650709268014,COGS 17,A01,092677,Staff,13,0,75,62
1650709274042,COGS 100,A01,083619,Staff,0,28,60,60
1650709280074,COGS 101A,A01,083621,Davis; Joshua Daniel,0,27,60,60
1650709286100,COGS 101B,A01,091572,Staff,0,4,60,60
1650709292126,COGS 101C,A01,083625,Delgado; Tania,14,0,30,16
1650709298152,COGS 107A,A01,083627,Boyle; Mary E. T.,0,16,60,60
1650709304189,COGS 118A,A01,083075,Staff,0,8,60,60
1650709310222,CSE 3,A50,083646,Miranda; Gregory Joseph,18,0,38,20
1650709310222,CSE 3,A51,083647,Miranda; Gregory Joseph,36,0,37,1
1650709316250,CSE 8A,A50,083650,Miranda; Gregory Joseph,0,30,40,40
1650709322278,CSE 11,A01,083080,Cao; Yingjun,0,96,40,40
1650709328302,CSE 12,A01,083652,Staff,0,21,100,100
1650709334326,CSE 15L,A01,083654,Staff,0,3,50,50
1650709334326,CSE 15L,A02,083655,Staff,0,2,50,50
1650709340352,CSE 20,A01,083657,Staff,49,0,80,31
1650709346379,CSE 30,A01,083084,Eldon; John,0,77,40,40
1650709352410,CSE 100,A01,083659,Cao; Yingjun,0,70,50,50
1650709358436,CSE 134B,A01,083661,Powell; Thomas Allan,0,38,65,65
1650709364462,CSE 140,A01,083663,Staff,0,11,75,75
1650709370487,CSE 140L,A01,083088,Eldon; John,0,20,75,75
1650709376516,CSE 175,A01,083665,Kumar; Rakesh,7,0,25,18
1650709382546,CSE 190,A00,092507,Dubnov; Shlomo,10,0,20,10
1650709388571,ECE 45,A01,083139,Staff,1,2,60,59
1650709394602,ECE 65,A50,083695,Staff,0,5,30,30
1650709400631,ECE 109,A01,091882,Touri; Behrouz,33,0,70,37
1650709406659,ECE 180,A00,083140,Abi Samra; Nicholas Camill,20,0,30,10
1650709406659,ECE 180,B00,083141,Abi Samra; Nicholas Camill,0,0,30,30
1650709412692,MATH 10A,A01,083735,Patchell; Gregory David,2,0,30,28
1650709412692,MATH 10A,A02,083736,Patchell; Gregory David,27,0,30,3
1650709412692,MATH 10A,A03,083737,Patchell; Gregory David,24,0,30,6
1650709418719,MATH 10B,A01,083207,Staff,0,9,30,30
1650709418719,MATH 10B,A02,083208,Staff,1,7,30,29
1650709418719,MATH 10B,B01,083739,Staff,11,0,30,19
1650709418719,MATH 10B,B02,083740,Staff,28,0,30,2
1650709424754,MATH 18,A01,083743,Staff,0,0,30,30
1650709424754,MATH 18,A02,083744,Staff,23,0,30,7
1650709424754,MATH 18,A03,083745,Staff,21,0,30,9
1650709424754,MATH 18,A04,083746,Staff,26,0,30,4
1650709424754,MATH 18,B01,083748,Staff,0,15,30,30
1650709424754,MATH 18,B02,083749,Staff,0,12,30,30
1650709424754,MATH 18,B03,083750,Staff,0,12,30,30
1650709424754,MATH 18,B04,083751,Staff,0,12,30,30
1650709430781,MATH 20A,A01,083754,Staff,19,0,40,21
1650709436807,MATH 20B,A01,083756,Staff,0,11,30,30
1650709436807,MATH 20B,A02,083757,Staff,0,12,30,30
1650709442838,MATH 20C,A01,083760,Staff,0,16,30,30
1650709442838,MATH 20C,A02,083761,Staff,0,15,30,30
1650709442838,MATH 20C,B01,083762,Staff,9,0,30,21
1650709442838,MATH 20C,B02,083763,Staff,28,0,30,2
1650709448862,MATH 20D,A01,083765,Staff,2,1,30,28
1650709448862,MATH 20D,A02,083766,Staff,6,0,30,24
1650709448862,MATH 20D,A03,083767,Staff,24,0,30,6
1650709454891,MATH 20E,A01,083771,Staff,3,0,30,27
1650709454891,MATH 20E,A02,083772,Staff,16,0,30,14
1650709454891,MATH 20E,B01,083773,Staff,0,0,30,30
1650709454891,MATH 20E,B02,083774,Staff,6,0,30,24
1650709460916,MATH 103A,A01,083777,Staff,0,15,30,30
1650709460916,MATH 103A,A02,083778,Staff,0,15,30,30
1650709460916,MATH 103A,B01,083779,Staff,0,15,30,30
1650709460916,MATH 103A,B02,083780,Staff,0,15,30,30
1650709466944,MATH 105,A01,085443,Staff,0,22,30,30
1650709472971,MATH 109,A01,083213,Anzaldo; Leesa B,0,7,30,30
1650709472971,MATH 109,A02,083214,Anzaldo; Leesa B,0,7,30,30
1650709472971,MATH 109,B01,083215,Anzaldo; Leesa B,0,8,30,30
1650709472971,MATH 109,B02,083216,Anzaldo; Leesa B,0,6,30,30
1650709479001,MATH 142A,A01,083219,Chow; Bennett,0,16,30,30
1650709479001,MATH 142A,A02,083220,Chow; Bennett,0,15,30,30
1650709479001,MATH 142A,B01,083221,Chow; Bennett,0,15,30,30
1650709479001,MATH 142A,B02,083222,Chow; Bennett,0,14,30,30
1650709485027,MATH 193A,A01,083224,Staff,0,5,30,30
1650709485027,MATH 193A,A02,083225,Staff,0,6,30,30
1650709485027,MATH 193A,A03,083781,Staff,0,6,30,30
1650709485027,MATH 193A,A04,083782,Staff,0,7,30,30
1650709491054,MATH 197,001,091859,McAuley; Julian John,9998,0,9999,1
1650709497136,COGS 9,A01,083615,Staff,1,15,60,59
1650709503165,COGS 11,A01,083617,Boyle; Mary E. T.,16,0,40,24
1650709509189,COGS 13,A01,083071,Staff,0,38,40,40
1650709515218,COGS 14A,A01,092681,Staff,0,35,100,100
1650709521243,COGS 14B,A01,083073,Cheng; Tzu-Han,1,13,50,49
1650709527269,COGS 17,A01,092677,Staff,13,0,75,62
1650709533294,COGS 100,A01,083619,Staff,0,28,60,60
1650709539322,COGS 101A,A01,083621,Davis; Joshua Daniel,0,27,60,60
1650709545351,COGS 101B,A01,091572,Staff,0,4,60,60
1650709551375,COGS 101C,A01,083625,Delgado; Tania,14,0,30,16
1650709557403,COGS 107A,A01,083627,Boyle; Mary E. T.,0,16,60,60
1650709563433,COGS 118A,A01,083075,Staff,0,8,60,60
1650709569458,CSE 3,A50,083646,Miranda; Gregory Joseph,18,0,38,20
1650709569458,CSE 3,A51,083647,Miranda; Gregory Joseph,36,0,37,1
1650709575482,CSE 8A,A50,083650,Miranda; Gregory Joseph,0,30,40,40
1650709581505,CSE 11,A01,083080,Cao; Yingjun,0,96,40,40
1650709587531,CSE 12,A01,083652,Staff,0,21,100,100
1650709593559,CSE 15L,A01,083654,Staff,0,3,50,50
1650709593559,CSE 15L,A02,083655,Staff,0,2,50,50
1650709599587,CSE 20,A01,083657,Staff,49,0,80,31
1650709605612,CSE 30,A01,083084,Eldon; John,0,77,40,40
1650709611642,CSE 100,A01,083659,Cao; Yingjun,0,70,50,50
1650709617669,CSE 134B,A01,083661,Powell; Thomas Allan,0,38,65,65
1650709623692,CSE 140,A01,083663,Staff,0,11,75,75
1650709629723,CSE 140L,A01,083088,Eldon; John,0,20,75,75
1650709635753,CSE 175,A01,083665,Kumar; Rakesh,7,0,25,18
1650709641782,CSE 190,A00,092507,Dubnov; Shlomo,10,0,20,10
1650709647807,ECE 45,A01,083139,Staff,1,2,60,59
1650709653837,ECE 65,A50,083695,Staff,0,5,30,30
1650709659863,ECE 109,A01,091882,Touri; Behrouz,33,0,70,37
1650709665889,ECE 180,A00,083140,Abi Samra; Nicholas Camill,20,0,30,10
1650709665889,ECE 180,B00,083141,Abi Samra; Nicholas Camill,0,0,30,30
1650709671924,MATH 10A,A01,083735,Patchell; Gregory David,2,0,30,28
1650709671924,MATH 10A,A02,083736,Patchell; Gregory David,27,0,30,3
1650709671924,MATH 10A,A03,083737,Patchell; Gregory David,24,0,30,6
1650709677950,MATH 10B,A01,083207,Staff,0,9,30,30
1650709677950,MATH 10B,A02,083208,Staff,1,7,30,29
1650709677950,MATH 10B,B01,083739,Staff,11,0,30,19
1650709677950,MATH 10B,B02,083740,Staff,28,0,30,2
1650709683986,MATH 18,A01,083743,Staff,0,0,30,30
1650709683986,MATH 18,A02,083744,Staff,23,0,30,7
1650709683986,MATH 18,A03,083745,Staff,21,0,30,9
1650709683986,MATH 18,A04,083746,Staff,26,0,30,4
1650709683986,MATH 18,B01,083748,Staff,0,15,30,30
1650709683986,MATH 18,B02,083749,Staff,0,12,30,30
1650709683986,MATH 18,B03,083750,Staff,0,12,30,30
1650709683986,MATH 18,B04,083751,Staff,0,12,30,30
1650709690012,MATH 20A,A01,083754,Staff,19,0,40,21
1650709696037,MATH 20B,A01,083756,Staff,0,11,30,30
1650709696037,MATH 20B,A02,083757,Staff,0,12,30,30
1650709702074,MATH 20C,A01,083760,Staff,0,16,30,30
1650709702074,MATH 20C,A02,083761,Staff,0,15,30,30
1650709702074,MATH 20C,B01,083762,Staff,9,0,30,21
1650709702074,MATH 20C,B02,083763,Staff,28,0,30,2
1650709708104,MATH 20D,A01,083765,Staff,2,1,30,28
1650709708104,MATH 20D,A02,083766,Staff,6,0,30,24
1650709708104,MATH 20D,A03,083767,Staff,24,0,30,6
1650709714138,MATH 20E,A01,083771,Staff,3,0,30,27
1650709714138,MATH 20E,A02,083772,Staff,16,0,30,14
1650709714138,MATH 20E,B01,083773,Staff,0,0,30,30
1650709714138,MATH 20E,B02,083774,Staff,6,0,30,24
1650709720164,MATH 103A,A01,083777,Staff,0,15,30,30
1650709720164,MATH 103A,A02,083778,Staff,0,15,30,30
1650709720164,MATH 103A,B01,083779,Staff,0,15,30,30
1650709720164,MATH 103A,B02,083780,Staff,0,15,30,30
1650709726190,MATH 105,A01,085443,Staff,0,22,30,30
1650709732217,MATH 109,A01,083213,Anzaldo; Leesa B,0,7,30,30
1650709732217,MATH 109,A02,083214,Anzaldo; Leesa B,0,7,30,30
1650709732217,MATH 109,B01,083215,Anzaldo; Leesa B,0,8,30,30
1650709732217,MATH 109,B02,083216,Anzaldo; Leesa B,0,6,30,30
1650709738241,MATH 142A,A01,083219,Chow; Bennett,0,16,30,30
1650709738241,MATH 142A,A02,083220,Chow; Bennett,0,15,30,30
1650709738241,MATH 142A,B01,083221,Chow; Bennett,0,15,30,30
1650709738241,MATH 142A,B02,083222,Chow; Bennett,0,14,30,30
1650709744265,MATH 193A,A01,083224,Staff,0,5,30,30
1650709744265,MATH 193A,A02,083225,Staff,0,6,30,30
1650709744265,MATH 193A,A03,083781,Staff,0,6,30,30
1650709744265,MATH 193A,A04,083782,Staff,0,7,30,30
1650709750291,MATH 197,001,091859,McAuley; Julian John,9998,0,9999,1
1650709756448,COGS 9,A01,083615,Staff,1,15,60,59
1650709762478,COGS 11,A01,083617,Boyle; Mary E. T.,16,0,40,24
1650709768508,COGS 13,A01,083071,Staff,0,38,40,40
1650709774536,COGS 14A,A01,092681,Staff,0,35,100,100
1650709780565,COGS 14B,A01,083073,Cheng; Tzu-Han,1,13,50,49
1650709786589,COGS 17,A01,092677,Staff,13,0,75,62
1650709792615,COGS 100,A01,083619,Staff,0,28,60,60
1650709798646,COGS 101A,A01,083621,Davis; Joshua Daniel,0,27,60,60
1650709804669,COGS 101B,A01,091572,Staff,0,4,60,60
1650709810708,COGS 101C,A01,083625,Delgado; Tania,14,0,30,16
1650709816731,COGS 107A,A01,083627,Boyle; Mary E. T.,0,16,60,60
1650709822758,COGS 118A,A01,083075,Staff,0,8,60,60
1650709828784,CSE 3,A50,083646,Miranda; Gregory Joseph,18,0,38,20
1650709828784,CSE 3,A51,083647,Miranda; Gregory Joseph,36,0,37,1
1650709834809,CSE 8A,A50,083650,Miranda; Gregory Joseph,0,30,40,40
1650709840833,CSE 11,A01,083080,Cao; Yingjun,0,96,40,40
1650709846861,CSE 12,A01,083652,Staff,0,21,100,100
1650709852890,CSE 15L,A01,083654,Staff,0,3,50,50
1650709852890,CSE 15L,A02,083655,Staff,0,2,50,50
1650709858925,CSE 20,A01,083657,Staff,49,0,80,31
1650709864950,CSE 30,A01,083084,Eldon; John,0,77,40,40
1650709870979,CSE 100,A01,083659,Cao; Yingjun,0,70,50,50
1650709877007,CSE 134B,A01,083661,Powell; Thomas Allan,0,38,65,65
1650709883030,CSE 140,A01,083663,Staff,0,11,75,75
1650709889061,CSE 140L,A01,083088,Eldon; John,0,20,75,75
1650709895086,CSE 175,A01,083665,Kumar; Rakesh,7,0,25,18
1650709901112,CSE 190,A00,092507,Dubnov; Shlomo,10,0,20,10
1650709907141,ECE 45,A01,083139,Staff,1,2,60,59
1650709913169,ECE 65,A50,083695,Staff,0,5,30,30
1650709919194,ECE 109,A01,091882,Touri; Behrouz,33,0,70,37
1650709925218,ECE 180,A00,083140,Abi Samra; Nicholas Camill,20,0,30,10
1650709925218,ECE 180,B00,083141,Abi Samra; Nicholas Camill,0,0,30,30
1650709931259,MATH 10A,A01,083735,Patchell; Gregory David,2,0,30,28
1650709931259,MATH 10A,A02,083736,Patchell; Gregory David,27,0,30,3
1650709931259,MATH 10A,A03,083737,Patchell; Gregory David,24,0,30,6
1650709937291,MATH 10B,A01,083207,Staff,0,9,30,30
1650709937291,MATH 10B,A02,083208,Staff,1,7,30,29
1650709937291,MATH 10B,B01,083739,Staff,11,0,30,19
1650709937291,MATH 10B,B02,083740,Staff,28,0,30,2
1650709943319,MATH 18,A01,083743,Staff,0,0,30,30
1650709943319,MATH 18,A02,083744,Staff,23,0,30,7
1650709943319,MATH 18,A03,083745,Staff,21,0,30,9
1650709943319,MATH 18,A04,083746,Staff,26,0,30,4
1650709943319,MATH 18,B01,083748,Staff,0,15,30,30
1650709943319,MATH 18,B02,083749,Staff,0,12,30,30
1650709943319,MATH 18,B03,083750,Staff,0,12,30,30
1650709943319,MATH 18,B04,083751,Staff,0,12,30,30
1650709949346,MATH 20A,A01,083754,Staff,19,0,40,21
1650709955372,MATH 20B,A01,083756,Staff,0,11,30,30
1650709955372,MATH 20B,A02,083757,Staff,0,12,30,30
1650709961409,MATH 20C,A01,083760,Staff,0,16,30,30
1650709961409,MATH 20C,A02,083761,Staff,0,15,30,30
1650709961409,MATH 20C,B01,083762,Staff,9,0,30,21
1650709961409,MATH 20C,B02,083763,Staff,28,0,30,2
1650709967442,MATH 20D,A01,083765,Staff,2,1,30,28
1650709967442,MATH 20D,A02,083766,Staff,6,0,30,24
1650709967442,MATH 20D,A03,083767,Staff,24,0,30,6
1650709973470,MATH 20E,A01,083771,Staff,3,0,30,27
1650709973470,MATH 20E,A02,083772,Staff,16,0,30,14
1650709973470,MATH 20E,B01,083773,Staff,0,0,30,30
1650709973470,MATH 20E,B02,083774,Staff,6,0,30,24
1650709979500,MATH 103A,A01,083777,Staff,0,15,30,30
1650709979500,MATH 103A,A02,083778,Staff,0,15,30,30
1650709979500,MATH 103A,B01,083779,Staff,0,15,30,30
1650709979500,MATH 103A,B02,083780,Staff,0,15,30,30
1650709985530,MATH 105,A01,085443,Staff,0,22,30,30
1650709991570,MATH 109,A01,083213,Anzaldo; Leesa B,0,7,30,30
1650709991570,MATH 109,A02,083214,Anzaldo; Leesa B,0,7,30,30
1650709991570,MATH 109,B01,083215,Anzaldo; Leesa B,0,8,30,30
1650709991570,MATH 109,B02,083216,Anzaldo; Leesa B,0,6,30,30
1650709997602,MATH 142A,A01,083219,Chow; Bennett,0,16,30,30
1650709997602,MATH 142A,A02,083220,Chow; Bennett,0,15,30,30
1650709997602,MATH 142A,B01,083221,Chow; Bennett,0,15,30,30
1650709997602,MATH 142A,B02,083222,Chow; Bennett,0,14,30,30
1650710003631,MATH 193A,A01,083224,Staff,0,5,30,30
1650710003631,MATH 193A,A02,083225,Staff,0,6,30,30
1650710003631,MATH 193A,A03,083781,Staff,0,6,30,30
1650710003631,MATH 193A,A04,083782,Staff,0,7,30,30
1650710009661,MATH 197,001,091859,McAuley; Julian John,9998,0,9999,1
1650710015731,COGS 9,A01,083615,Staff,1,15,60,59
1650710021760,COGS 11,A01,083617,Boyle; Mary E. T.,16,0,40,24
1650710027789,COGS 13,A01,083071,Staff,0,38,40,40
1650710033814,COGS 14A,A01,092681,Staff,0,35,100,100
1650710039841,COGS 14B,A01,083073,Cheng; Tzu-Han,1,13,50,49
1650710045865,COGS 17,A01,092677,Staff,13,0,75,62
1650710051897,COGS 100,A01,083619,Staff,0,28,60,60
1650710057936,COGS 101A,A01,083621,Davis; Joshua Daniel,0,27,60,60
1650710063967,COGS 101B,A01,091572,Staff,0,4,60,60
1650710070005,COGS 101C,A01,083625,Delgado; Tania,14,0,30,16
1650710076034,COGS 107A,A01,083627,Boyle; Mary E. T.,0,16,60,60
1650710082063,COGS 118A,A01,083075,Staff,0,8,60,60
1650710088088,CSE 3,A50,083646,Miranda; Gregory Joseph,18,0,38,20
1650710088088,CSE 3,A51,083647,Miranda; Gregory Joseph,36,0,37,1
1650710094113,CSE 8A,A50,083650,Miranda; Gregory Joseph,0,30,40,40
1650710100153,CSE 11,A01,083080,Cao; Yingjun,0,96,40,40
1650710106181,CSE 12,A01,083652,Staff,0,21,100,100
1650710112205,CSE 15L,A01,083654,Staff,0,3,50,50
1650710112205,CSE 15L,A02,083655,Staff,0,2,50,50
1650710118229,CSE 20,A01,083657,Staff,49,0,80,31
1650710124260,CSE 30,A01,083084,Eldon; John,0,77,40,40
1650710130288,CSE 100,A01,083659,Cao; Yingjun,0,70,50,50
1650710136315,CSE 134B,A01,083661,Powell; Thomas Allan,0,38,65,65
1650710142342,CSE 140,A01,083663,Staff,0,11,75,75
1650710148370,CSE 140L,A01,083088,Eldon; John,0,20,75,75
1650710154404,CSE 175,A01,083665,Kumar; Rakesh,7,0,25,18
1650710160433,CSE 190,A00,092507,Dubnov; Shlomo,10,0,20,10
1650710166471,ECE 45,A01,083139,Staff,1,2,60,59
1650710172494,ECE 65,A50,083695,Staff,0,5,30,30
1650710178519,ECE 109,A01,091882,Touri; Behrouz,33,0,70,37
1650710184553,ECE 180,A00,083140,Abi Samra; Nicholas Camill,20,0,30,10
1650710184553,ECE 180,B00,083141,Abi Samra; Nicholas Camill,0,0,30,30
1650710190585,MATH 10A,A01,083735,Patchell; Gregory David,2,0,30,28
1650710190585,MATH 10A,A02,083736,Patchell; Gregory David,27,0,30,3
1650710190585,MATH 10A,A03,083737,Patchell; Gregory David,24,0,30,6
1650710196616,MATH 10B,A01,083207,Staff,0,9,30,30
1650710196616,MATH 10B,A02,083208,Staff,1,7,30,29
1650710196616,MATH 10B,B01,083739,Staff,11,0,30,19
1650710196616,MATH 10B,B02,083740,Staff,28,0,30,2
1650710202651,MATH 18,A01,083743,Staff,0,0,30,30
1650710202651,MATH 18,A02,083744,Staff,23,0,30,7
1650710202651,MATH 18,A03,083745,Staff,21,0,30,9
1650710202651,MATH 18,A04,083746,Staff,26,0,30,4
1650710202651,MATH 18,B01,083748,Staff,0,15,30,30
1650710202651,MATH 18,B02,083749,Staff,0,12,30,30
1650710202651,MATH 18,B03,083750,Staff,0,12,30,30
1650710202651,MATH 18,B04,083751,Staff,0,12,30,30
1650710208689,MATH 20A,A01,083754,Staff,19,0,40,21
1650710214721,MATH 20B,A01,083756,Staff,0,11,30,30
1650710214721,MATH 20B,A02,083757,Staff,0,12,30,30
1650710220746,MATH 20C,A01,083760,Staff,0,16,30,30
1650710220746,MATH 20C,A02,083761,Staff,0,15,30,30
1650710220746,MATH 20C,B01,083762,Staff,9,0,30,21
1650710220746,MATH 20C,B02,083763,Staff,28,0,30,2
1650710226775,MATH 20D,A01,083765,Staff,2,1,30,28
1650710226775,MATH 20D,A02,083766,Staff,6,0,30,24
1650710226775,MATH 20D,A03,083767,Staff,24,0,30,6
1650710232806,MATH 20E,A01,083771,Staff,3,0,30,27
1650710232806,MATH 20E,A02,083772,Staff,16,0,30,14
1650710232806,MATH 20E,B01,083773,Staff,0,0,30,30
1650710232806,MATH 20E,B02,083774,Staff,6,0,30,24
1650710238838,MATH 103A,A01,083777,Staff,0,15,30,30
1650710238838,MATH 103A,A02,083778,Staff,0,15,30,30
1650710238838,MATH 103A,B01,083779,Staff,0,15,30,30
1650710238838,MATH 103A,B02,083780,Staff,0,15,30,30
1650710244863,MATH 105,A01,085443,Staff,0,22,30,30
1650710250890,MATH 109,A01,083213,Anzaldo; Leesa B,0,7,30,30
1650710250890,MATH 109,A02,083214,Anzaldo; Leesa B,0,7,30,30
1650710250890,MATH 109,B01,083215,Anzaldo; Leesa B,0,8,30,30
1650710250890,MATH 109,B02,083216,Anzaldo; Leesa B,0,6,30,30
1650710256914,MATH 142A,A01,083219,Chow; Bennett,0,16,30,30
1650710256914,MATH 142A,A02,083220,Chow; Bennett,0,15,30,30
1650710256914,MATH 142A,B01,083221,Chow; Bennett,0,15,30,30
1650710256914,MATH 142A,B02,083222,Chow; Bennett,0,14,30,30
1650710262952,MATH 193A,A01,083224,Staff,0,5,30,30
1650710262952,MATH 193A,A02,083225,Staff,0,6,30,30
1650710262952,MATH 193A,A03,083781,Staff,0,6,30,30
1650710262952,MATH 193A,A04,083782,Staff,0,7,30,30
1650710268977,MATH 197,001,091859,McAuley; Julian John,9998,0,9999,1
1650710275049,COGS 9,A01,083615,Staff,1,15,60,59
1650710281080,COGS 11,A01,083617,Boyle; Mary E. T.,16,0,40,24
1650710287105,COGS 13,A01,083071,Staff,0,38,40,40
1650710293133,COGS 14A,A01,092681,Staff,0,35,100,100
1650710299162,COGS 14B,A01,083073,Cheng; Tzu-Han,1,13,50,49
1650710305190,COGS 17,A01,092677,Staff,13,0,75,62
1650710311214,COGS 100,A01,083619,Staff,0,28,60,60
1650710317241,COGS 101A,A01,083621,Davis; Joshua Daniel,0,27,60,60
1650710323267,COGS 101B,A01,091572,Staff,0,4,60,60
1650710329298,COGS 101C,A01,083625,Delgado; Tania,14,0,30,16
1650710335321,COGS 107A,A01,083627,Boyle; Mary E. T.,0,16,60,60
1650710341353,COGS 118A,A01,083075,Staff,0,8,60,60
1650710347475,CSE 3,A50,083646,Miranda; Gregory Joseph,18,0,38,20
1650710347475,CSE 3,A51,083647,Miranda; Gregory Joseph,36,0,37,1
1650710353499,CSE 8A,A50,083650,Miranda; Gregory Joseph,0,30,40,40
1650710359528,CSE 11,A01,083080,Cao; Yingjun,0,96,40,40
1650710365557,CSE 12,A01,083652,Staff,0,21,100,100
1650710371581,CSE 15L,A01,083654,Staff,0,3,50,50
1650710371581,CSE 15L,A02,083655,Staff,0,2,50,50
1650710377617,CSE 20,A01,083657,Staff,49,0,80,31
1650710383648,CSE 30,A01,083084,Eldon; John,0,77,40,40
1650710389679,CSE 100,A01,083659,Cao; Yingjun,0,70,50,50
1650710395705,CSE 134B,A01,083661,Powell; Thomas Allan,0,38,65,65
1650710401731,CSE 140,A01,083663,Staff,0,11,75,75
1650710407753,CSE 140L,A01,083088,Eldon; John,0,20,75,75
1650710413779,CSE 175,A01,083665,Kumar; Rakesh,7,0,25,18
1650710419812,CSE 190,A00,092507,Dubnov; Shlomo,10,0,20,10
1650710425842,ECE 45,A01,083139,Staff,1,2,60,59
1650710431868,ECE 65,A50,083695,Staff,0,5,30,30
1650710437894,ECE 109,A01,091882,Touri; Behrouz,33,0,70,37
1650710443925,ECE 180,A00,083140,Abi Samra; Nicholas Camill,20,0,30,10
1650710443925,ECE 180,B00,083141,Abi Samra; Nicholas Camill,0,0,30,30
1650710449953,MATH 10A,A01,083735,Patchell; Gregory David,2,0,30,28
1650710449953,MATH 10A,A02,083736,Patchell; Gregory David,27,0,30,3
1650710449953,MATH 10A,A03,083737,Patchell; Gregory David,24,0,30,6
1650710455979,MATH 10B,A01,083207,Staff,0,9,30,30
1650710455979,MATH 10B,A02,083208,Staff,1,7,30,29
1650710455979,MATH 10B,B01,083739,Staff,11,0,30,19
1650710455979,MATH 10B,B02,083740,Staff,28,0,30,2
1650710462015,MATH 18,A01,083743,Staff,0,0,30,30
1650710462015,MATH 18,A02,083744,Staff,23,0,30,7
1650710462015,MATH 18,A03,083745,Staff,21,0,30,9
1650710462015,MATH 18,A04,083746,Staff,26,0,30,4
1650710462015,MATH 18,B01,083748,Staff,0,15,30,30
1650710462015,MATH 18,B02,083749,Staff,0,12,30,30
1650710462015,MATH 18,B03,083750,Staff,0,12,30,30
1650710462015,MATH 18,B04,083751,Staff,0,12,30,30
1650710468038,MATH 20A,A01,083754,Staff,19,0,40,21
1650710474070,MATH 20B,A01,083756,Staff,0,11,30,30
1650710474070,MATH 20B,A02,083757,Staff,0,12,30,30
1650710480095,MATH 20C,A01,083760,Staff,0,16,30,30
1650710480095,MATH 20C,A02,083761,Staff,0,15,30,30
1650710480095,MATH 20C,B01,083762,Staff,9,0,30,21
1650710480095,MATH 20C,B02,083763,Staff,28,0,30,2
1650710486121,MATH 20D,A01,083765,Staff,2,1,30,28
1650710486121,MATH 20D,A02,083766,Staff,6,0,30,24
1650710486121,MATH 20D,A03,083767,Staff,24,0,30,6
1650710492152,MATH 20E,A01,083771,Staff,3,0,30,27
1650710492152,MATH 20E,A02,083772,Staff,16,0,30,14
1650710492152,MATH 20E,B01,083773,Staff,0,0,30,30
1650710492152,MATH 20E,B02,083774,Staff,6,0,30,24
1650710498177,MATH 103A,A01,083777,Staff,0,15,30,30
1650710498177,MATH 103A,A02,083778,Staff,0,15,30,30
1650710498177,MATH 103A,B01,083779,Staff,0,15,30,30
1650710498177,MATH 103A,B02,083780,Staff,0,15,30,30
1650710504203,MATH 105,A01,085443,Staff,0,22,30,30
1650710510229,MATH 109,A01,083213,Anzaldo; Leesa B,0,7,30,30
1650710510229,MATH 109,A02,083214,Anzaldo; Leesa B,0,7,30,30
1650710510229,MATH 109,B01,083215,Anzaldo; Leesa B,0,8,30,30
1650710510229,MATH 109,B02,083216,Anzaldo; Leesa B,0,6,30,30
1650710516268,MATH 142A,A01,083219,Chow; Bennett,0,16,30,30
1650710516268,MATH 142A,A02,083220,Chow; Bennett,0,15,30,30
1650710516268,MATH 142A,B01,083221,Chow; Bennett,0,15,30,30
1650710516268,MATH 142A,B02,083222,Chow; Bennett,0,14,30,30
1650710522295,MATH 193A,A01,083224,Staff,0,5,30,30
1650710522295,MATH 193A,A02,083225,Staff,0,6,30,30
1650710522295,MATH 193A,A03,083781,Staff,0,6,30,30
1650710522295,MATH 193A,A04,083782,Staff,0,7,30,30
1650710528322,MATH 197,001,091859,McAuley; Julian John,9998,0,9999,1
1650710534409,COGS 9,A01,083615,Staff,1,15,60,59
1650710540435,COGS 11,A01,083617,Boyle; Mary E. T.,16,0,40,24
1650710546460,COGS 13,A01,083071,Staff,0,38,40,40
1650710552485,COGS 14A,A01,092681,Staff,0,35,100,100
1650710558513,COGS 14B,A01,083073,Cheng; Tzu-Han,1,13,50,49
1650710564538,COGS 17,A01,092677,Staff,13,0,75,62
1650710570563,COGS 100,A01,083619,Staff,0,28,60,60
1650710576590,COGS 101A,A01,083621,Davis; Joshua Daniel,0,27,60,60
1650710582623,COGS 101B,A01,091572,Staff,0,4,60,60
1650710588658,COGS 101C,A01,083625,Delgado; Tania,14,0,30,16
1650710594688,COGS 107A,A01,083627,Boyle; Mary E. T.,0,16,60,60
1650710600715,COGS 118A,A01,083075,Staff,0,8,60,60
1650710606750,CSE 3,A50,083646,Miranda; Gregory Joseph,18,0,38,20
1650710606750,CSE 3,A51,083647,Miranda; Gregory Joseph,36,0,37,1
1650710612791,CSE 8A,A50,083650,Miranda; Gregory Joseph,0,30,40,40
1650710618814,CSE 11,A01,083080,Cao; Yingjun,0,96,40,40
1650710624845,CSE 12,A01,083652,Staff,0,21,100,100
1650710630873,CSE 15L,A01,083654,Staff,0,3,50,50
1650710630873,CSE 15L,A02,083655,Staff,0,2,50,50
1650710636901,CSE 20,A01,083657,Staff,49,0,80,31
1650710642933,CSE 30,A01,083084,Eldon; John,0,77,40,40
1650710648964,CSE 100,A01,083659,Cao; Yingjun,0,70,50,50
1650710654991,CSE 134B,A01,083661,Powell; Thomas Allan,0,38,65,65
1650710661016,CSE 140,A01,083663,Staff,0,11,75,75
1650710667042,CSE 140L,A01,083088,Eldon; John,0,20,75,75
1650710673086,CSE 175,A01,083665,Kumar; Rakesh,7,0,25,18
1650710679112,CSE 190,A00,092507,Dubnov; Shlomo,10,0,20,10
1650710685137,ECE 45,A01,083139,Staff,1,2,60,59
1650710691166,ECE 65,A50,083695,Staff,0,5,30,30
1650710697193,ECE 109,A01,091882,Touri; Behrouz,33,0,70,37
1650710703224,ECE 180,A00,083140,Abi Samra; Nicholas Camill,20,0,30,10
1650710703224,ECE 180,B00,083141,Abi Samra; Nicholas Camill,0,0,30,30
1650710709263,MATH 10A,A01,083735,Patchell; Gregory David,2,0,30,28
1650710709263,MATH 10A,A02,083736,Patchell; Gregory David,27,0,30,3
1650710709263,MATH 10A,A03,083737,Patchell; Gregory David,24,0,30,6
1650710715289,MATH 10B,A01,083207,Staff,0,9,30,30
1650710715289,MATH 10B,A02,083208,Staff,1,7,30,29
1650710715289,MATH 10B,B01,083739,Staff,11,0,30,19
1650710715289,MATH 10B,B02,083740,Staff,28,0,30,2
1650710721323,MATH 18,A01,083743,Staff,0,0,30,30
1650710721323,MATH 18,A02,083744,Staff,23,0,30,7
1650710721323,MATH 18,A03,083745,Staff,21,0,30,9
1650710721323,MATH 18,A04,083746,Staff,26,0,30,4
1650710721323,MATH 18,B01,083748,Staff,0,15,30,30
1650710721323,MATH 18,B02,083749,Staff,0,12,30,30
1650710721323,MATH 18,B03,083750,Staff,0,12,30,30
1650710721323,MATH 18,B04,083751,Staff,0,12,30,30
1650710727348,MATH 20A,A01,083754,Staff,19,0,40,21
1650710733374,MATH 20B,A01,083756,Staff,0,11,30,30
1650710733374,MATH 20B,A02,083757,Staff,0,12,30,30
1650710739400,MATH 20C,A01,083760,Staff,0,16,30,30
1650710739400,MATH 20C,A02,083761,Staff,0,15,30,30
1650710739400,MATH 20C,B01,083762,Staff,9,0,30,21
1650710739400,MATH 20C,B02,083763,Staff,28,0,30,2
1650710745425,MATH 20D,A01,083765,Staff,2,1,30,28
1650710745425,MATH 20D,A02,083766,Staff,6,0,30,24
1650710745425,MATH 20D,A03,083767,Staff,24,0,30,6
1650710751450,MATH 20E,A01,083771,Staff,3,0,30,27
1650710751450,MATH 20E,A02,083772,Staff,16,0,30,14
1650710751450,MATH 20E,B01,083773,Staff,0,0,30,30
1650710751450,MATH 20E,B02,083774,Staff,6,0,30,24
1650710757477,MATH 103A,A01,083777,Staff,0,15,30,30
1650710757477,MATH 103A,A02,083778,Staff,0,15,30,30
1650710757477,MATH 103A,B01,083779,Staff,0,15,30,30
1650710757477,MATH 103A,B02,083780,Staff,0,15,30,30
1650710763504,MATH 105,A01,085443,Staff,0,22,30,30
1650710769537,MATH 109,A01,083213,Anzaldo; Leesa B,0,7,30,30
1650710769537,MATH 109,A02,083214,Anzaldo; Leesa B,0,7,30,30
1650710769537,MATH 109,B01,083215,Anzaldo; Leesa B,0,8,30,30
1650710769537,MATH 109,B02,083216,Anzaldo; Leesa B,0,6,30,30
1650710775562,MATH 142A,A01,083219,Chow; Bennett,0,16,30,30
1650710775562,MATH 142A,A02,083220,Chow; Bennett,0,15,30,30
1650710775562,MATH 142A,B01,083221,Chow; Bennett,0,15,30,30
1650710775562,MATH 142A,B02,083222,Chow; Bennett,0,14,30,30
1650710781585,MATH 193A,A01,083224,Staff,0,5,30,30
1650710781585,MATH 193A,A02,083225,Staff,0,6,30,30
1650710781585,MATH 193A,A03,083781,Staff,0,6,30,30
1650710781585,MATH 193A,A04,083782,Staff,0,7,30,30
1650710787613,MATH 197,001,091859,McAuley; Julian John,9998,0,9999,1
1650710793690,COGS 9,A01,083615,Staff,1,15,60,59
1650710799722,COGS 11,A01,083617,Boyle; Mary E. T.,16,0,40,24
1650710805754,COGS 13,A01,083071,Staff,0,38,40,40
1650710811779,COGS 14A,A01,092681,Staff,0,35,100,100
1650710817809,COGS 14B,A01,083073,Cheng; Tzu-Han,1,13,50,49
1650710823841,COGS 17,A01,092677,Staff,13,0,75,62
1650710829867,COGS 100,A01,083619,Staff,0,28,60,60
1650710835893,COGS 101A,A01,083621,Davis; Joshua Daniel,0,27,60,60
1650710841918,COGS 101B,A01,091572,Staff,0,4,60,60
1650710847943,COGS 101C,A01,083625,Delgado; Tania,14,0,30,16
1650710853974,COGS 107A,A01,083627,Boyle; Mary E. T.,0,16,60,60
1650710860003,COGS 118A,A01,083075,Staff,0,8,60,60
1650710866031,CSE 3,A50,083646,Miranda; Gregory Joseph,18,0,38,20
1650710866031,CSE 3,A51,083647,Miranda; Gregory Joseph,36,0,37,1
1650710872060,CSE 8A,A50,083650,Miranda; Gregory Joseph,0,30,40,40
1650710878084,CSE 11,A01,083080,Cao; Yingjun,0,96,40,40
1650710884109,CSE 12,A01,083652,Staff,0,21,100,100
1650710890133,CSE 15L,A01,083654,Staff,0,3,50,50
1650710890133,CSE 15L,A02,083655,Staff,0,2,50,50
1650710896157,CSE 20,A01,083657,Staff,49,0,80,31
1650710902182,CSE 30,A01,083084,Eldon; John,0,77,40,40
1650710908209,CSE 100,A01,083659,Cao; Yingjun,0,70,50,50
1650710914234,CSE 134B,A01,083661,Powell; Thomas Allan,0,38,65,65
1650710920260,CSE 140,A01,083663,Staff,0,11,75,75
1650710926285,CSE 140L,A01,083088,Eldon; John,0,20,75,75
1650710932310,CSE 175,A01,083665,Kumar; Rakesh,7,0,25,18
1650710938342,CSE 190,A00,092507,Dubnov; Shlomo,10,0,20,10
1650710944456,ECE 45,A01,083139,Staff,1,2,60,59
1650710950485,ECE 65,A50,083695,Staff,0,5,30,30
1650710956517,ECE 109,A01,091882,Touri; Behrouz,33,0,70,37
1650710962545,ECE 180,A00,083140,Abi Samra; Nicholas Camill,20,0,30,10
1650710962545,ECE 180,B00,083141,Abi Samra; Nicholas Camill,0,0,30,30
1650710968574,MATH 10A,A01,083735,Patchell; Gregory David,2,0,30,28
1650710968574,MATH 10A,A02,083736,Patchell; Gregory David,27,0,30,3
1650710968574,MATH 10A,A03,083737,Patchell; Gregory David,24,0,30,6
1650710974606,MATH 10B,A01,083207,Staff,0,9,30,30
1650710974606,MATH 10B,A02,083208,Staff,1,7,30,29
1650710974606,MATH 10B,B01,083739,Staff,11,0,30,19
1650710974606,MATH 10B,B02,083740,Staff,28,0,30,2
1650710980635,MATH 18,A01,083743,Staff,0,0,30,30
1650710980635,MATH 18,A02,083744,Staff,23,0,30,7
1650710980635,MATH 18,A03,083745,Staff,21,0,30,9
1650710980635,MATH 18,A04,083746,Staff,26,0,30,4
1650710980635,MATH 18,B01,083748,Staff,0,15,30,30
1650710980635,MATH 18,B02,083749,Staff,0,12,30,30
1650710980635,MATH 18,B03,083750,Staff,0,12,30,30
1650710980635,MATH 18,B04,083751,Staff,0,12,30,30
1650710986662,MATH 20A,A01,083754,Staff,19,0,40,21
1650710992687,MATH 20B,A01,083756,Staff,0,11,30,30
1650710992687,MATH 20B,A02,083757,Staff,0,12,30,30
1650710998718,MATH 20C,A01,083760,Staff,0,16,30,30
1650710998718,MATH 20C,A02,083761,Staff,0,15,30,30
1650710998718,MATH 20C,B01,083762,Staff,9,0,30,21
1650710998718,MATH 20C,B02,083763,Staff,28,0,30,2
1650711004743,MATH 20D,A01,083765,Staff,2,1,30,28
1650711004743,MATH 20D,A02,083766,Staff,6,0,30,24
1650711004743,MATH 20D,A03,083767,Staff,24,0,30,6
1650711010783,MATH 20E,A01,083771,Staff,3,0,30,27
1650711010783,MATH 20E,A02,083772,Staff,16,0,30,14
1650711010783,MATH 20E,B01,083773,Staff,0,0,30,30
1650711010783,MATH 20E,B02,083774,Staff,6,0,30,24
1650711016811,MATH 103A,A01,083777,Staff,0,15,30,30
1650711016811,MATH 103A,A02,083778,Staff,0,15,30,30
1650711016811,MATH 103A,B01,083779,Staff,0,15,30,30
1650711016811,MATH 103A,B02,083780,Staff,0,15,30,30
1650711022837,MATH 105,A01,085443,Staff,0,22,30,30
1650711028868,MATH 109,A01,083213,Anzaldo; Leesa B,0,7,30,30
1650711028868,MATH 109,A02,083214,Anzaldo; Leesa B,0,7,30,30
1650711028868,MATH 109,B01,083215,Anzaldo; Leesa B,0,8,30,30
1650711028868,MATH 109,B02,083216,Anzaldo; Leesa B,0,6,30,30
1650711034893,MATH 142A,A01,083219,Chow; Bennett,0,16,30,30
1650711034893,MATH 142A,A02,083220,Chow; Bennett,0,15,30,30
1650711034893,MATH 142A,B01,083221,Chow; Bennett,0,15,30,30
1650711034893,MATH 142A,B02,083222,Chow; Bennett,0,14,30,30
1650711040919,MATH 193A,A01,083224,Staff,0,5,30,30
1650711040919,MATH 193A,A02,083225,Staff,0,6,30,30
1650711040919,MATH 193A,A03,083781,Staff,0,6,30,30
1650711040919,MATH 193A,A04,083782,Staff,0,7,30,30
1650711046945,MATH 197,001,091859,McAuley; Julian John,9998,0,9999,1
1650711053010,COGS 9,A01,083615,Staff,1,15,60,59
1650711059034,COGS 11,A01,083617,Boyle; Mary E. T.,16,0,40,24
1650711065058,COGS 13,A01,083071,Staff,0,38,40,40
1650711071083,COGS 14A,A01,092681,Staff,0,35,100,100
1650711077113,COGS 14B,A01,083073,Cheng; Tzu-Han,1,13,50,49
1650711083137,COGS 17,A01,092677,Staff,13,0,75,62
1650711089166,COGS 100,A01,083619,Staff,0,28,60,60
1650711095197,COGS 101A,A01,083621,Davis; Joshua Daniel,0,27,60,60
1650711101226,COGS 101B,A01,091572,Staff,0,4,60,60
1650711107252,COGS 101C,A01,083625,Delgado; Tania,14,0,30,16
1650711113281,COGS 107A,A01,083627,Boyle; Mary E. T.,0,16,60,60
1650711119306,COGS 118A,A01,083075,Staff,0,8,60,60
1650711125344,CSE 3,A50,083646,Miranda; Gregory Joseph,18,0,38,20
1650711125344,CSE 3,A51,083647,Miranda; Gregory Joseph,36,0,37,1
1650711131369,CSE 8A,A50,083650,Miranda; Gregory Joseph,0,30,40,40
1650711137400,CSE 11,A01,083080,Cao; Yingjun,0,96,40,40
1650711143429,CSE 12,A01,083652,Staff,0,21,100,100
1650711149458,CSE 15L,A01,083654,Staff,0,3,50,50
1650711149458,CSE 15L,A02,083655,Staff,0,2,50,50
1650711155489,CSE 20,A01,083657,Staff,49,0,80,31
1650711161516,CSE 30,A01,083084,Eldon; John,0,77,40,40
1650711167547,CSE 100,A01,083659,Cao; Yingjun,0,70,50,50
1650711173577,CSE 134B,A01,083661,Powell; Thomas Allan,0,38,65,65
1650711179601,CSE 140,A01,083663,Staff,0,11,75,75
1650711185632,CSE 140L,A01,083088,Eldon; John,0,20,75,75
1650711191665,CSE 175,A01,083665,Kumar; Rakesh,7,0,25,18
1650711197702,CSE 190,A00,092507,Dubnov; Shlomo,10,0,20,10
1650711203728,ECE 45,A01,083139,Staff,1,2,60,59
1650711209757,ECE 65,A50,083695,Staff,0,5,30,30
1650711215786,ECE 109,A01,091882,Touri; Behrouz,33,0,70,37
1650711221813,ECE 180,A00,083140,Abi Samra; Nicholas Camill,20,0,30,10
1650711221813,ECE 180,B00,083141,Abi Samra; Nicholas Camill,0,0,30,30
1650711227841,MATH 10A,A01,083735,Patchell; Gregory David,2,0,30,28
1650711227841,MATH 10A,A02,083736,Patchell; Gregory David,27,0,30,3
1650711227841,MATH 10A,A03,083737,Patchell; Gregory David,24,0,30,6
1650711233867,MATH 10B,A01,083207,Staff,0,9,30,30
1650711233867,MATH 10B,A02,083208,Staff,1,7,30,29
1650711233867,MATH 10B,B01,083739,Staff,11,0,30,19
1650711233867,MATH 10B,B02,083740,Staff,28,0,30,2
1650711239896,MATH 18,A01,083743,Staff,0,0,30,30
1650711239896,MATH 18,A02,083744,Staff,23,0,30,7
1650711239896,MATH 18,A03,083745,Staff,21,0,30,9
1650711239896,MATH 18,A04,083746,Staff,26,0,30,4
1650711239896,MATH 18,B01,083748,Staff,0,15,30,30
1650711239896,MATH 18,B02,083749,Staff,0,12,30,30
1650711239896,MATH 18,B03,083750,Staff,0,12,30,30
1650711239896,MATH 18,B04,083751,Staff,0,12,30,30
1650711245921,MATH 20A,A01,083754,Staff,19,0,40,21
1650711259869,MATH 20B,A01,083756,Staff,0,11,30,30
1650711259869,MATH 20B,A02,083757,Staff,0,12,30,30
1650711265896,MATH 20C,A01,083760,Staff,0,16,30,30
1650711265896,MATH 20C,A02,083761,Staff,0,15,30,30
1650711265896,MATH 20C,B01,083762,Staff,9,0,30,21
1650711265896,MATH 20C,B02,083763,Staff,28,0,30,2
1650711271925,MATH 20D,A01,083765,Staff,2,1,30,28
1650711271925,MATH 20D,A02,083766,Staff,6,0,30,24
1650711271925,MATH 20D,A03,083767,Staff,24,0,30,6
1650711277954,MATH 20E,A01,083771,Staff,3,0,30,27
1650711277954,MATH 20E,A02,083772,Staff,16,0,30,14
1650711277954,MATH 20E,B01,083773,Staff,0,0,30,30
1650711277954,MATH 20E,B02,083774,Staff,6,0,30,24
1650711283979,MATH 103A,A01,083777,Staff,0,15,30,30
1650711283979,MATH 103A,A02,083778,Staff,0,15,30,30
1650711283979,MATH 103A,B01,083779,Staff,0,15,30,30
1650711283979,MATH 103A,B02,083780,Staff,0,15,30,30
1650711290021,MATH 105,A01,085443,Staff,0,22,30,30
1650711296046,MATH 109,A01,083213,Anzaldo; Leesa B,0,7,30,30
1650711296046,MATH 109,A02,083214,Anzaldo; Leesa B,0,7,30,30
1650711296046,MATH 109,B01,083215,Anzaldo; Leesa B,0,8,30,30
1650711296046,MATH 109,B02,083216,Anzaldo; Leesa B,0,6,30,30
1650711302072,MATH 142A,A01,083219,Chow; Bennett,0,16,30,30
1650711302072,MATH 142A,A02,083220,Chow; Bennett,0,15,30,30
1650711302072,MATH 142A,B01,083221,Chow; Bennett,0,15,30,30
1650711302072,MATH 142A,B02,083222,Chow; Bennett,0,14,30,30
1650711308098,MATH 193A,A01,083224,Staff,0,5,30,30
1650711308098,MATH 193A,A02,083225,Staff,0,6,30,30
1650711308098,MATH 193A,A03,083781,Staff,0,6,30,30
1650711308098,MATH 193A,A04,083782,Staff,0,7,30,30
1650711314128,MATH 197,001,091859,McAuley; Julian John,9998,0,9999,1
1650711320193,COGS 9,A01,083615,Staff,1,15,60,59
1650711326218,COGS 11,A01,083617,Boyle; Mary E. T.,16,0,40,24
1650711332251,COGS 13,A01,083071,Staff,0,38,40,40
1650711338277,COGS 14A,A01,092681,Staff,0,35,100,100
1650711344305,COGS 14B,A01,083073,Cheng; Tzu-Han,1,13,50,49
1650711350332,COGS 17,A01,092677,Staff,13,0,75,62
1650711356357,COGS 100,A01,083619,Staff,0,28,60,60
1650711362388,COGS 101A,A01,083621,Davis; Joshua Daniel,0,27,60,60
1650711368413,COGS 101B,A01,091572,Staff,0,4,60,60
1650711374446,COGS 101C,A01,083625,Delgado; Tania,14,0,30,16
1650711380471,COGS 107A,A01,083627,Boyle; Mary E. T.,0,16,60,60
1650711386500,COGS 118A,A01,083075,Staff,0,8,60,60
1650711392534,CSE 3,A50,083646,Miranda; Gregory Joseph,18,0,38,20
1650711392534,CSE 3,A51,083647,Miranda; Gregory Joseph,36,0,37,1
1650711398557,CSE 8A,A50,083650,Miranda; Gregory Joseph,0,30,40,40
1650711404584,CSE 11,A01,083080,Cao; Yingjun,0,96,40,40
1650711410613,CSE 12,A01,083652,Staff,0,21,100,100
1650711416637,CSE 15L,A01,083654,Staff,0,3,50,50
1650711416637,CSE 15L,A02,083655,Staff,0,2,50,50
1650711422664,CSE 20,A01,083657,Staff,49,0,80,31
1650711428689,CSE 30,A01,083084,Eldon; John,0,77,40,40
1650711434727,CSE 100,A01,083659,Cao; Yingjun,0,70,50,50
1650711440758,CSE 134B,A01,083661,Powell; Thomas Allan,0,38,65,65
1650711446782,CSE 140,A01,083663,Staff,0,11,75,75
1650711452806,CSE 140L,A01,083088,Eldon; John,0,20,75,75
1650711458832,CSE 175,A01,083665,Kumar; Rakesh,7,0,25,18
1650711464857,CSE 190,A00,092507,Dubnov; Shlomo,10,0,20,10
1650711470882,ECE 45,A01,083139,Staff,1,2,60,59
1650711476907,ECE 65,A50,083695,Staff,0,5,30,30
1650711482932,ECE 109,A01,091882,Touri; Behrouz,33,0,70,37
1650711488961,ECE 180,A00,083140,Abi Samra; Nicholas Camill,20,0,30,10
1650711488961,ECE 180,B00,083141,Abi Samra; Nicholas Camill,0,0,30,30
1650711494994,MATH 10A,A01,083735,Patchell; Gregory David,2,0,30,28
1650711494994,MATH 10A,A02,083736,Patchell; Gregory David,27,0,30,3
1650711494994,MATH 10A,A03,083737,Patchell; Gregory David,24,0,30,6
1650711501021,MATH 10B,A01,083207,Staff,0,9,30,30
1650711501021,MATH 10B,A02,083208,Staff,1,7,30,29
1650711501021,MATH 10B,B01,083739,Staff,11,0,30,19
1650711501021,MATH 10B,B02,083740,Staff,28,0,30,2
1650711507050,MATH 18,A01,083743,Staff,0,0,30,30
1650711507050,MATH 18,A02,083744,Staff,23,0,30,7
1650711507050,MATH 18,A03,083745,Staff,21,0,30,9
1650711507050,MATH 18,A04,083746,Staff,26,0,30,4
1650711507050,MATH 18,B01,083748,Staff,0,15,30,30
1650711507050,MATH 18,B02,083749,Staff,0,12,30,30
1650711507050,MATH 18,B03,083750,Staff,0,12,30,30
1650711507050,MATH 18,B04,083751,Staff,0,12,30,30
1650711513074,MATH 20A,A01,083754,Staff,19,0,40,21
1650711519105,MATH 20B,A01,083756,Staff,0,11,30,30
1650711519105,MATH 20B,A02,083757,Staff,0,12,30,30
1650711525138,MATH 20C,A01,083760,Staff,0,16,30,30
1650711525138,MATH 20C,A02,083761,Staff,0,15,30,30
1650711525138,MATH 20C,B01,083762,Staff,9,0,30,21
1650711525138,MATH 20C,B02,083763,Staff,28,0,30,2
1650711531165,MATH 20D,A01,083765,Staff,2,1,30,28
1650711531165,MATH 20D,A02,083766,Staff,6,0,30,24
1650711531165,MATH 20D,A03,083767,Staff,24,0,30,6
1650711537195,MATH 20E,A01,083771,Staff,3,0,30,27
1650711537195,MATH 20E,A02,083772,Staff,16,0,30,14
1650711537195,MATH 20E,B01,083773,Staff,0,0,30,30
1650711537195,MATH 20E,B02,083774,Staff,6,0,30,24
1650711543239,MATH 103A,A01,083777,Staff,0,15,30,30
1650711543239,MATH 103A,A02,083778,Staff,0,15,30,30
1650711543239,MATH 103A,B01,083779,Staff,0,15,30,30
1650711543239,MATH 103A,B02,083780,Staff,0,15,30,30
1650711549357,MATH 105,A01,085443,Staff,0,22,30,30
1650711555388,MATH 109,A01,083213,Anzaldo; Leesa B,0,7,30,30
1650711555388,MATH 109,A02,083214,Anzaldo; Leesa B,0,7,30,30
1650711555388,MATH 109,B01,083215,Anzaldo; Leesa B,0,8,30,30
1650711555388,MATH 109,B02,083216,Anzaldo; Leesa B,0,6,30,30
1650711561422,MATH 142A,A01,083219,Chow; Bennett,0,16,30,30
1650711561422,MATH 142A,A02,083220,Chow; Bennett,0,15,30,30
1650711561422,MATH 142A,B01,083221,Chow; Bennett,0,15,30,30
1650711561422,MATH 142A,B02,083222,Chow; Bennett,0,14,30,30
1650711567448,MATH 193A,A01,083224,Staff,0,5,30,30
1650711567448,MATH 193A,A02,083225,Staff,0,6,30,30
1650711567448,MATH 193A,A03,083781,Staff,0,6,30,30
1650711567448,MATH 193A,A04,083782,Staff,0,7,30,30
1650711573475,MATH 197,001,091859,McAuley; Julian John,9998,0,9999,1
1650711579546,COGS 9,A01,083615,Staff,1,15,60,59
1650711585569,COGS 11,A01,083617,Boyle; Mary E. T.,16,0,40,24
1650711591597,COGS 13,A01,083071,Staff,0,38,40,40
1650711597621,COGS 14A,A01,092681,Staff,0,35,100,100
1650711603650,COGS 14B,A01,083073,Cheng; Tzu-Han,1,13,50,49
1650711609681,COGS 17,A01,092677,Staff,13,0,75,62
1650711615714,COGS 100,A01,083619,Staff,0,28,60,60
1650711621738,COGS 101A,A01,083621,Davis; Joshua Daniel,0,27,60,60
1650711627766,COGS 101B,A01,091572,Staff,0,4,60,60
1650711633792,COGS 101C,A01,083625,Delgado; Tania,14,0,30,16
1650711639819,COGS 107A,A01,083627,Boyle; Mary E. T.,0,16,60,60
1650711645842,COGS 118A,A01,083075,Staff,0,8,60,60
1650711651879,CSE 3,A50,083646,Miranda; Gregory Joseph,18,0,38,20
1650711651879,CSE 3,A51,083647,Miranda; Gregory Joseph,36,0,37,1
1650711657904,CSE 8A,A50,083650,Miranda; Gregory Joseph,0,30,40,40
1650711663934,CSE 11,A01,083080,Cao; Yingjun,0,96,40,40
1650711669958,CSE 12,A01,083652,Staff,0,21,100,100
1650711675986,CSE 15L,A01,083654,Staff,0,3,50,50
1650711675986,CSE 15L,A02,083655,Staff,0,2,50,50
1650711682015,CSE 20,A01,083657,Staff,49,0,80,31
1650711688048,CSE 30,A01,083084,Eldon; John,0,77,40,40
1650711694073,CSE 100,A01,083659,Cao; Yingjun,0,70,50,50
1650711700099,CSE 134B,A01,083661,Powell; Thomas Allan,0,38,65,65
1650711706125,CSE 140,A01,083663,Staff,0,11,75,75
1650711712149,CSE 140L,A01,083088,Eldon; John,0,20,75,75
1650711718185,CSE 175,A01,083665,Kumar; Rakesh,7,0,25,18
1650711724210,CSE 190,A00,092507,Dubnov; Shlomo,10,0,20,10
1650711730241,ECE 45,A01,083139,Staff,1,2,60,59
1650711736271,ECE 65,A50,083695,Staff,0,5,30,30
1650711742296,ECE 109,A01,091882,Touri; Behrouz,33,0,70,37
1650711748327,ECE 180,A00,083140,Abi Samra; Nicholas Camill,20,0,30,10
1650711748327,ECE 180,B00,083141,Abi Samra; Nicholas Camill,0,0,30,30
1650711754355,MATH 10A,A01,083735,Patchell; Gregory David,2,0,30,28
1650711754355,MATH 10A,A02,083736,Patchell; Gregory David,27,0,30,3
1650711754355,MATH 10A,A03,083737,Patchell; Gregory David,24,0,30,6
1650711760386,MATH 10B,A01,083207,Staff,0,9,30,30
1650711760386,MATH 10B,A02,083208,Staff,1,7,30,29
1650711760386,MATH 10B,B01,083739,Staff,11,0,30,19
1650711760386,MATH 10B,B02,083740,Staff,28,0,30,2
1650711766417,MATH 18,A01,083743,Staff,0,0,30,30
1650711766417,MATH 18,A02,083744,Staff,23,0,30,7
1650711766417,MATH 18,A03,083745,Staff,21,0,30,9
1650711766417,MATH 18,A04,083746,Staff,26,0,30,4
1650711766417,MATH 18,B01,083748,Staff,0,15,30,30
1650711766417,MATH 18,B02,083749,Staff,0,12,30,30
1650711766417,MATH 18,B03,083750,Staff,0,12,30,30
1650711766417,MATH 18,B04,083751,Staff,0,12,30,30
1650711772441,MATH 20A,A01,083754,Staff,19,0,40,21
1650711778465,MATH 20B,A01,083756,Staff,0,11,30,30
1650711778465,MATH 20B,A02,083757,Staff,0,12,30,30
1650711784490,MATH 20C,A01,083760,Staff,0,16,30,30
1650711784490,MATH 20C,A02,083761,Staff,0,15,30,30
1650711784490,MATH 20C,B01,083762,Staff,9,0,30,21
1650711784490,MATH 20C,B02,083763,Staff,28,0,30,2
1650711790514,MATH 20D,A01,083765,Staff,2,1,30,28
1650711790514,MATH 20D,A02,083766,Staff,6,0,30,24
1650711790514,MATH 20D,A03,083767,Staff,24,0,30,6
1650711796538,MATH 20E,A01,083771,Staff,3,0,30,27
1650711796538,MATH 20E,A02,083772,Staff,16,0,30,14
1650711796538,MATH 20E,B01,083773,Staff,0,0,30,30
1650711796538,MATH 20E,B02,083774,Staff,6,0,30,24
1650711802563,MATH 103A,A01,083777,Staff,0,15,30,30
1650711802563,MATH 103A,A02,083778,Staff,0,15,30,30
1650711802563,MATH 103A,B01,083779,Staff,0,15,30,30
1650711802563,MATH 103A,B02,083780,Staff,0,15,30,30
1650711808588,MATH 105,A01,085443,Staff,0,22,30,30
1650711814614,MATH 109,A01,083213,Anzaldo; Leesa B,0,7,30,30
1650711814614,MATH 109,A02,083214,Anzaldo; Leesa B,0,7,30,30
1650711814614,MATH 109,B01,083215,Anzaldo; Leesa B,0,8,30,30
1650711814614,MATH 109,B02,083216,Anzaldo; Leesa B,0,6,30,30
1650711820638,MATH 142A,A01,083219,Chow; Bennett,0,16,30,30
1650711820638,MATH 142A,A02,083220,Chow; Bennett,0,15,30,30
1650711820638,MATH 142A,B01,083221,Chow; Bennett,0,15,30,30
1650711820638,MATH 142A,B02,083222,Chow; Bennett,0,14,30,30
1650711826665,MATH 193A,A01,083224,Staff,0,5,30,30
1650711826665,MATH 193A,A02,083225,Staff,0,6,30,30
1650711826665,MATH 193A,A03,083781,Staff,0,6,30,30
1650711826665,MATH 193A,A04,083782,Staff,0,7,30,30
1650711832760,MATH 197,001,091859,McAuley; Julian John,9998,0,9999,1
1650711838859,COGS 9,A01,083615,Staff,1,15,60,59
1650711844888,COGS 11,A01,083617,Boyle; Mary E. T.,16,0,40,24
1650711850913,COGS 13,A01,083071,Staff,0,38,40,40
1650711856940,COGS 14A,A01,092681,Staff,0,35,100,100
1650711862970,COGS 14B,A01,083073,Cheng; Tzu-Han,1,13,50,49
1650711868993,COGS 17,A01,092677,Staff,13,0,75,62
1650711875021,COGS 100,A01,083619,Staff,0,28,60,60
1650711881048,COGS 101A,A01,083621,Davis; Joshua Daniel,0,27,60,60
1650711887071,COGS 101B,A01,091572,Staff,0,4,60,60
1650711893100,COGS 101C,A01,083625,Delgado; Tania,14,0,30,16
1650711899128,COGS 107A,A01,083627,Boyle; Mary E. T.,0,16,60,60
1650711905155,COGS 118A,A01,083075,Staff,0,8,60,60
1650711911190,CSE 3,A50,083646,Miranda; Gregory Joseph,18,0,38,20
1650711911190,CSE 3,A51,083647,Miranda; Gregory Joseph,36,0,37,1
1650711917216,CSE 8A,A50,083650,Miranda; Gregory Joseph,0,30,40,40
1650711923241,CSE 11,A01,083080,Cao; Yingjun,0,96,40,40
1650711929269,CSE 12,A01,083652,Staff,0,21,100,100
1650711935292,CSE 15L,A01,083654,Staff,0,3,50,50
1650711935292,CSE 15L,A02,083655,Staff,0,2,50,50
1650711941320,CSE 20,A01,083657,Staff,49,0,80,31
1650711947352,CSE 30,A01,083084,Eldon; John,0,77,40,40
1650711953384,CSE 100,A01,083659,Cao; Yingjun,0,70,50,50
1650711959409,CSE 134B,A01,083661,Powell; Thomas Allan,0,38,65,65
1650711965437,CSE 140,A01,083663,Staff,0,11,75,75
1650711971471,CSE 140L,A01,083088,Eldon; John,0,20,75,75
1650711977497,CSE 175,A01,083665,Kumar; Rakesh,7,0,25,18
1650711983524,CSE 190,A00,092507,Dubnov; Shlomo,10,0,20,10
