time,subj_course_id,sec_code,sec_id,prof,available,waitlist,total,enrolled_ct
1655983652556,COGS 9,A01,083615,Shannon; Kyle Michael,3,1,75,72
1655983658586,COGS 11,A01,083617,Boyle; Mary E. T.,11,1,48,37
1655983664615,COGS 13,A01,083071,Bastos; Amalia Pinkusfeld,3,2,71,68
1655983670645,COGS 14A,A01,092681,Semenuks; Arturs,4,25,100,96
1655983676674,COGS 14B,A01,083073,Cheng; Tzu-Han,7,0,63,56
1655983682704,COGS 17,A01,092677,Semenuks; Arturs,8,7,81,73
1655983688729,COGS 100,A01,083619,Allen; Michael Gordon,2,2,70,68
1655983694758,COGS 101A,A01,083621,Davis; Joshua Daniel,4,3,68,64
1655983700789,COGS 101B,A01,091572,Allen; Michael Gordon,0,0,65,65
1655983706823,COGS 101C,A01,083625,Delgado; Tania,7,0,35,28
1655983712848,COGS 107A,A01,083627,Boyle; Mary E. T.,1,2,60,59
1655983718879,COGS 118A,A01,083075,Gupta; Anjum,21,16,76,55
1655983724909,CSE 3,A50,083646,Miranda; Gregory Joseph,14,0,50,36
1655983730937,CSE 8A,A50,083650,Miranda; Gregory Joseph,3,11,56,53
1655983736966,CSE 11,A01,083080,Cao; Yingjun,0,65,40,40
1655983742994,CSE 12,A01,083652,Krause-Levy; Sophia Louisa,6,8,120,114
1655983749022,CSE 15L,A01,083654,Morris; Justin Loren,3,1,50,47
1655983749022,CSE 15L,A02,083655,Morris; Justin Loren,1,1,50,49
1655983755050,CSE 20,A01,083657,Tran; Khoa Dang,29,0,80,51
1655983761078,CSE 21,A01,095574,Bach; Quang Tran,23,0,48,25
1655983767110,CSE 30,A01,083084,Eldon; John,2,10,80,78
1655983767110,CSE 30,B01,095061,Bhaskar; Nishant,0,4,50,50
1655983773137,CSE 100,A01,083659,Cao; Yingjun,2,25,70,68
1655983779168,CSE 134B,A01,083661,Powell; Thomas Allan,6,7,100,94
1655983785201,CSE 140,A01,083663,Gungor; Onat,5,0,85,80
1655983791228,CSE 140L,A01,083088,Eldon; John,5,0,100,95
1655983797257,CSE 175,A01,083665,Kumar; Rakesh,1,0,25,24
1655983803287,CSE 190,A00,092507,Dubnov; Shlomo,1,0,20,19
1655983809315,ECE 45,A01,083139,Congero; Spencer William,0,1,75,75
1655983815343,ECE 65,A50,083695,Saad; Andrew S,6,0,30,24
1655983815343,ECE 65,A51,095125,Staff,23,0,26,3
1655983821370,ECE 109,A01,091882,Touri; Behrouz,2,4,70,68
1655983827399,ECE 180,A00,083140,Abi Samra; Nicholas Camill,1,0,30,29
1655983827399,ECE 180,B00,083141,Abi Samra; Nicholas Camill,0,8,28,28
1655983833430,MATH 10A,A01,083735,Patchell; Gregory David,0,0,30,30
1655983833430,MATH 10A,A02,083736,Patchell; Gregory David,21,0,30,9
1655983833430,MATH 10A,A03,083737,Patchell; Gregory David,16,0,30,14
1655983839460,MATH 10B,A01,083207,Lim; Seonhee,1,1,34,33
1655983839460,MATH 10B,A02,083208,Lim; Seonhee,1,1,35,34
1655983839460,MATH 10B,A03,093472,Staff,1,0,34,33
1655983839460,MATH 10B,B01,083739,Sinha; Shubham,9,0,30,21
1655983845490,MATH 18,A01,083743,Cinel; Cameron Alexander,5,0,30,25
1655983845490,MATH 18,A02,083744,Cinel; Cameron Alexander,11,0,30,19
1655983845490,MATH 18,A03,083745,Cinel; Cameron Alexander,1,0,30,29
1655983845490,MATH 18,B01,083748,Ma; Zilu,2,0,36,34
1655983845490,MATH 18,B02,083749,Ma; Zilu,0,0,36,36
1655983845490,MATH 18,B03,083750,Ma; Zilu,0,0,36,36
1655983845490,MATH 18,B04,083751,Ma; Zilu,0,0,36,36
1655983845490,MATH 18,B05,093473,Staff,0,0,36,36
1655983845490,MATH 18,B06,093474,Staff,1,0,36,35
1655983851519,MATH 20A,A01,083754,Zheng; Zequn,10,0,40,30
1655983857555,MATH 20B,A01,083756,Briones; Jor-el Thomas Caparas,0,1,36,36
1655983857555,MATH 20B,A02,083757,Briones; Jor-el Thomas Caparas,1,0,36,35
1655983857555,MATH 20B,A03,093475,Staff,0,0,36,36
1655983863584,MATH 20C,A01,083760,Briones; Jor-el Thomas Caparas,0,2,35,35
1655983863584,MATH 20C,A02,083761,Briones; Jor-el Thomas Caparas,6,1,35,29
1655983863584,MATH 20C,A03,093476,Staff,1,0,35,34
1655983863584,MATH 20C,B01,083762,Bach; Quang Tran,3,0,30,27
1655983869616,MATH 20D,A01,083765,Tran; Brian Kha,1,0,30,29
1655983869616,MATH 20D,A02,083766,Tran; Brian Kha,0,1,30,30
1655983869616,MATH 20D,A03,083767,Tran; Brian Kha,1,0,30,29
1655983875646,MATH 20E,A01,083771,Ganguly; Soumya,0,1,32,32
1655983875646,MATH 20E,A02,083772,Ganguly; Soumya,1,1,32,31
1655983875646,MATH 20E,B01,083773,Ciotti; Benjamin,14,0,35,21
1655983875646,MATH 20E,B02,083774,Ciotti; Benjamin,12,0,35,23
1655983881677,MATH 103A,A01,083777,Greenfeld; Be'Eri,2,1,36,34
1655983881677,MATH 103A,A02,083778,Greenfeld; Be'Eri,2,0,36,34
1655983881677,MATH 103A,A03,093561,Staff,0,1,36,36
1655983881677,MATH 103A,B01,083779,Greenfeld; Be'Eri,7,1,36,29
1655983881677,MATH 103A,B02,083780,Greenfeld; Be'Eri,0,0,36,36
1655983881677,MATH 103A,B03,093562,Staff,0,0,36,36
1655983887706,MATH 105,A01,085443,Carter; Anne Toulson,4,1,35,31
1655983887706,MATH 105,A02,093477,Staff,8,0,35,27
1655983893743,MATH 109,A01,083213,Ganzberger; Geoffrey Michael,0,1,34,34
1655983893743,MATH 109,A02,083214,Ganzberger; Geoffrey Michael,0,0,34,34
1655983893743,MATH 109,A03,093478,Staff,1,0,34,33
1655983893743,MATH 109,B01,083215,Ganzberger; Geoffrey Michael,2,0,32,30
1655983893743,MATH 109,B02,083216,Ganzberger; Geoffrey Michael,0,0,32,32
1655983893743,MATH 109,B03,093479,Staff,4,0,32,28
1655983899777,MATH 142A,A01,083219,Chow; Bennett,0,0,32,32
1655983899777,MATH 142A,A02,083220,Chow; Bennett,7,0,32,25
1655983899777,MATH 142A,A03,093480,Staff,4,0,32,28
1655983899777,MATH 142A,B03,093481,Staff,3,0,32,29
1655983899777,MATH 142A,B04,093558,Staff,6,0,32,26
1655983899777,MATH 142A,B05,093559,Staff,0,0,32,32
1655983905808,MATH 193A,A01,083224,Rotar; Vladimir,1,1,34,33
1655983905808,MATH 193A,A02,083225,Rotar; Vladimir,0,0,34,34
1655983905808,MATH 193A,A03,083781,Rotar; Vladimir,2,0,34,32
1655983905808,MATH 193A,A04,083782,Rotar; Vladimir,3,0,34,31
1655983905808,MATH 193A,A05,093482,Rotar; Vladimir,0,0,34,34
1655983911839,MATH 197,001,091859,McAuley; Julian John,9999,0,9999,0
1655983911839,MATH 197,002,095566,Kedlaya; Kiran S.,9997,0,9999,2
1655983911839,MATH 197,003,095567,Xiao; Ming,9999,0,9999,0
1655983911839,MATH 197,004,095571,Perols; Johan Lars,9998,0,9999,1
1655983918917,COGS 9,A01,083615,Shannon; Kyle Michael,3,1,75,72
1655983924944,COGS 11,A01,083617,Boyle; Mary E. T.,11,1,48,37
1655983930970,COGS 13,A01,083071,Bastos; Amalia Pinkusfeld,3,2,71,68
1655983945713,COGS 14A,A01,092681,Semenuks; Arturs,4,25,100,96
1655983951747,COGS 14B,A01,083073,Cheng; Tzu-Han,7,0,63,56
1655983966324,COGS 17,A01,092677,Semenuks; Arturs,8,7,81,73
1655983972352,COGS 100,A01,083619,Allen; Michael Gordon,2,2,70,68
1655983978379,COGS 101A,A01,083621,Davis; Joshua Daniel,4,3,68,64
1655983984406,COGS 101B,A01,091572,Allen; Michael Gordon,0,0,65,65
1655983990433,COGS 101C,A01,083625,Delgado; Tania,7,0,35,28
1655983996458,COGS 107A,A01,083627,Boyle; Mary E. T.,1,2,60,59
1655984002486,COGS 118A,A01,083075,Gupta; Anjum,21,16,76,55
1655984008521,CSE 3,A50,083646,Miranda; Gregory Joseph,14,0,50,36
1655984014548,CSE 8A,A50,083650,Miranda; Gregory Joseph,3,11,56,53
1655984020576,CSE 11,A01,083080,Cao; Yingjun,0,65,40,40
1655984026604,CSE 12,A01,083652,Krause-Levy; Sophia Louisa,6,8,120,114
1655984032631,CSE 15L,A01,083654,Morris; Justin Loren,3,1,50,47
1655984032631,CSE 15L,A02,083655,Morris; Justin Loren,1,1,50,49
1655984038657,CSE 20,A01,083657,Tran; Khoa Dang,29,0,80,51
1655984044682,CSE 21,A01,095574,Bach; Quang Tran,23,0,48,25
1655984050711,CSE 30,A01,083084,Eldon; John,2,10,80,78
1655984050711,CSE 30,B01,095061,Bhaskar; Nishant,0,4,50,50
1655984056741,CSE 100,A01,083659,Cao; Yingjun,2,25,70,68
1655984062770,CSE 134B,A01,083661,Powell; Thomas Allan,6,7,100,94
1655984068798,CSE 140,A01,083663,Gungor; Onat,5,0,85,80
1655984074826,CSE 140L,A01,083088,Eldon; John,5,0,100,95
1655984080854,CSE 175,A01,083665,Kumar; Rakesh,1,0,25,24
1655984086883,CSE 190,A00,092507,Dubnov; Shlomo,1,0,20,19
1655984092911,ECE 45,A01,083139,Congero; Spencer William,0,1,75,75
1655984098938,ECE 65,A50,083695,Saad; Andrew S,6,0,30,24
1655984098938,ECE 65,A51,095125,Staff,23,0,26,3
1655984104966,ECE 109,A01,091882,Touri; Behrouz,2,4,70,68
1655984110993,ECE 180,A00,083140,Abi Samra; Nicholas Camill,1,0,30,29
1655984110993,ECE 180,B00,083141,Abi Samra; Nicholas Camill,0,8,28,28
1655984117022,MATH 10A,A01,083735,Patchell; Gregory David,0,0,30,30
1655984117022,MATH 10A,A02,083736,Patchell; Gregory David,21,0,30,9
1655984117022,MATH 10A,A03,083737,Patchell; Gregory David,16,0,30,14
1655984123052,MATH 10B,A01,083207,Lim; Seonhee,1,1,34,33
1655984123052,MATH 10B,A02,083208,Lim; Seonhee,1,1,35,34
1655984123052,MATH 10B,A03,093472,Staff,1,0,34,33
1655984123052,MATH 10B,B01,083739,Sinha; Shubham,9,0,30,21
1655984129081,MATH 18,A01,083743,Cinel; Cameron Alexander,5,0,30,25
1655984129081,MATH 18,A02,083744,Cinel; Cameron Alexander,11,0,30,19
1655984129081,MATH 18,A03,083745,Cinel; Cameron Alexander,1,0,30,29
1655984129081,MATH 18,B01,083748,Ma; Zilu,2,0,36,34
1655984129081,MATH 18,B02,083749,Ma; Zilu,0,0,36,36
1655984129081,MATH 18,B03,083750,Ma; Zilu,0,0,36,36
1655984129081,MATH 18,B04,083751,Ma; Zilu,0,0,36,36
1655984129081,MATH 18,B05,093473,Staff,0,0,36,36
1655984129081,MATH 18,B06,093474,Staff,1,0,36,35
1655984135111,MATH 20A,A01,083754,Zheng; Zequn,10,0,40,30
1655984141137,MATH 20B,A01,083756,Briones; Jor-el Thomas Caparas,0,1,36,36
1655984141137,MATH 20B,A02,083757,Briones; Jor-el Thomas Caparas,1,0,36,35
1655984141137,MATH 20B,A03,093475,Staff,0,0,36,36
1655984147167,MATH 20C,A01,083760,Briones; Jor-el Thomas Caparas,0,2,35,35
1655984147167,MATH 20C,A02,083761,Briones; Jor-el Thomas Caparas,6,1,35,29
1655984147167,MATH 20C,A03,093476,Staff,1,0,35,34
1655984147167,MATH 20C,B01,083762,Bach; Quang Tran,3,0,30,27
1655984153196,MATH 20D,A01,083765,Tran; Brian Kha,1,0,30,29
1655984153196,MATH 20D,A02,083766,Tran; Brian Kha,0,1,30,30
1655984153196,MATH 20D,A03,083767,Tran; Brian Kha,1,0,30,29
1655984159224,MATH 20E,A01,083771,Ganguly; Soumya,0,1,32,32
1655984159224,MATH 20E,A02,083772,Ganguly; Soumya,1,1,32,31
1655984159224,MATH 20E,B01,083773,Ciotti; Benjamin,14,0,35,21
1655984159224,MATH 20E,B02,083774,Ciotti; Benjamin,12,0,35,23
1655984165254,MATH 103A,A01,083777,Greenfeld; Be'Eri,2,1,36,34
1655984165254,MATH 103A,A02,083778,Greenfeld; Be'Eri,2,0,36,34
1655984165254,MATH 103A,A03,093561,Staff,0,1,36,36
1655984165254,MATH 103A,B01,083779,Greenfeld; Be'Eri,7,1,36,29
1655984165254,MATH 103A,B02,083780,Greenfeld; Be'Eri,0,0,36,36
1655984165254,MATH 103A,B03,093562,Staff,0,0,36,36
1655984171282,MATH 105,A01,085443,Carter; Anne Toulson,4,1,35,31
1655984171282,MATH 105,A02,093477,Staff,8,0,35,27
1655984177316,MATH 109,A01,083213,Ganzberger; Geoffrey Michael,0,1,34,34
1655984177316,MATH 109,A02,083214,Ganzberger; Geoffrey Michael,0,0,34,34
1655984177316,MATH 109,A03,093478,Staff,1,0,34,33
1655984177316,MATH 109,B01,083215,Ganzberger; Geoffrey Michael,2,0,32,30
1655984177316,MATH 109,B02,083216,Ganzberger; Geoffrey Michael,0,0,32,32
1655984177316,MATH 109,B03,093479,Staff,4,0,32,28
1655984183343,MATH 142A,A01,083219,Chow; Bennett,0,0,32,32
1655984183343,MATH 142A,A02,083220,Chow; Bennett,7,0,32,25
1655984183343,MATH 142A,A03,093480,Staff,4,0,32,28
1655984183343,MATH 142A,B03,093481,Staff,3,0,32,29
1655984183343,MATH 142A,B04,093558,Staff,6,0,32,26
1655984183343,MATH 142A,B05,093559,Staff,0,0,32,32
1655984189375,MATH 193A,A01,083224,Rotar; Vladimir,1,1,34,33
1655984189375,MATH 193A,A02,083225,Rotar; Vladimir,0,0,34,34
1655984189375,MATH 193A,A03,083781,Rotar; Vladimir,2,0,34,32
1655984189375,MATH 193A,A04,083782,Rotar; Vladimir,3,0,34,31
1655984189375,MATH 193A,A05,093482,Rotar; Vladimir,0,0,34,34
1655984195401,MATH 197,001,091859,McAuley; Julian John,9999,0,9999,0
1655984195401,MATH 197,002,095566,Kedlaya; Kiran S.,9997,0,9999,2
1655984195401,MATH 197,003,095567,Xiao; Ming,9999,0,9999,0
1655984195401,MATH 197,004,095571,Perols; Johan Lars,9998,0,9999,1
1655984202466,COGS 9,A01,083615,Shannon; Kyle Michael,3,1,75,72
1655984208496,COGS 11,A01,083617,Boyle; Mary E. T.,11,1,48,37
1655984214526,COGS 13,A01,083071,Bastos; Amalia Pinkusfeld,3,2,71,68
1655984220554,COGS 14A,A01,092681,Semenuks; Arturs,4,25,100,96
1655984226585,COGS 14B,A01,083073,Cheng; Tzu-Han,7,0,63,56
1655984232613,COGS 17,A01,092677,Semenuks; Arturs,8,7,81,73
1655984238645,COGS 100,A01,083619,Allen; Michael Gordon,2,2,70,68
1655984244746,COGS 101A,A01,083621,Davis; Joshua Daniel,4,3,68,64
1655984250773,COGS 101B,A01,091572,Allen; Michael Gordon,0,0,65,65
1655984256801,COGS 101C,A01,083625,Delgado; Tania,7,0,35,28
1655984262828,COGS 107A,A01,083627,Boyle; Mary E. T.,1,2,60,59
1655984268855,COGS 118A,A01,083075,Gupta; Anjum,21,16,76,55
1655984274883,CSE 3,A50,083646,Miranda; Gregory Joseph,14,0,50,36
1655984280914,CSE 8A,A50,083650,Miranda; Gregory Joseph,3,11,56,53
1655984286941,CSE 11,A01,083080,Cao; Yingjun,0,65,40,40
1655984292969,CSE 12,A01,083652,Krause-Levy; Sophia Louisa,6,8,120,114
1655984299005,CSE 15L,A01,083654,Morris; Justin Loren,3,1,50,47
1655984299005,CSE 15L,A02,083655,Morris; Justin Loren,1,1,50,49
1655984305038,CSE 20,A01,083657,Tran; Khoa Dang,29,0,80,51
1655984311065,CSE 21,A01,095574,Bach; Quang Tran,23,0,48,25
1655984317093,CSE 30,A01,083084,Eldon; John,2,10,80,78
1655984317093,CSE 30,B01,095061,Bhaskar; Nishant,0,4,50,50
1655984323123,CSE 100,A01,083659,Cao; Yingjun,2,25,70,68
1655984329150,CSE 134B,A01,083661,Powell; Thomas Allan,6,7,100,94
1655984335182,CSE 140,A01,083663,Gungor; Onat,5,0,85,80
1655984341219,CSE 140L,A01,083088,Eldon; John,5,0,100,95
1655984347260,CSE 175,A01,083665,Kumar; Rakesh,1,0,25,24
1655984353287,CSE 190,A00,092507,Dubnov; Shlomo,1,0,20,19
1655984359318,ECE 45,A01,083139,Congero; Spencer William,0,1,75,75
1655984365347,ECE 65,A50,083695,Saad; Andrew S,6,0,30,24
1655984365347,ECE 65,A51,095125,Staff,23,0,26,3
1655984371386,ECE 109,A01,091882,Touri; Behrouz,2,4,70,68
1655984377413,ECE 180,A00,083140,Abi Samra; Nicholas Camill,1,0,30,29
1655984377413,ECE 180,B00,083141,Abi Samra; Nicholas Camill,0,8,28,28
1655984383441,MATH 10A,A01,083735,Patchell; Gregory David,0,0,30,30
1655984383441,MATH 10A,A02,083736,Patchell; Gregory David,21,0,30,9
1655984383441,MATH 10A,A03,083737,Patchell; Gregory David,16,0,30,14
1655984389473,MATH 10B,A01,083207,Lim; Seonhee,1,1,34,33
1655984389473,MATH 10B,A02,083208,Lim; Seonhee,1,1,35,34
1655984389473,MATH 10B,A03,093472,Staff,1,0,34,33
1655984389473,MATH 10B,B01,083739,Sinha; Shubham,9,0,30,21
1655984395507,MATH 18,A01,083743,Cinel; Cameron Alexander,5,0,30,25
1655984395507,MATH 18,A02,083744,Cinel; Cameron Alexander,11,0,30,19
1655984395507,MATH 18,A03,083745,Cinel; Cameron Alexander,1,0,30,29
1655984395507,MATH 18,B01,083748,Ma; Zilu,2,0,36,34
1655984395507,MATH 18,B02,083749,Ma; Zilu,0,0,36,36
1655984395507,MATH 18,B03,083750,Ma; Zilu,0,0,36,36
1655984395507,MATH 18,B04,083751,Ma; Zilu,0,0,36,36
1655984395507,MATH 18,B05,093473,Staff,0,0,36,36
1655984395507,MATH 18,B06,093474,Staff,1,0,36,35
1655984401531,MATH 20A,A01,083754,Zheng; Zequn,10,0,40,30
1655984407556,MATH 20B,A01,083756,Briones; Jor-el Thomas Caparas,0,1,36,36
1655984407556,MATH 20B,A02,083757,Briones; Jor-el Thomas Caparas,1,0,36,35
1655984407556,MATH 20B,A03,093475,Staff,0,0,36,36
1655984413585,MATH 20C,A01,083760,Briones; Jor-el Thomas Caparas,0,2,35,35
1655984413585,MATH 20C,A02,083761,Briones; Jor-el Thomas Caparas,6,1,35,29
1655984413585,MATH 20C,A03,093476,Staff,1,0,35,34
1655984413585,MATH 20C,B01,083762,Bach; Quang Tran,3,0,30,27
1655984419614,MATH 20D,A01,083765,Tran; Brian Kha,1,0,30,29
1655984419614,MATH 20D,A02,083766,Tran; Brian Kha,0,1,30,30
1655984419614,MATH 20D,A03,083767,Tran; Brian Kha,1,0,30,29
1655984425641,MATH 20E,A01,083771,Ganguly; Soumya,0,1,32,32
1655984425641,MATH 20E,A02,083772,Ganguly; Soumya,1,1,32,31
1655984425641,MATH 20E,B01,083773,Ciotti; Benjamin,14,0,35,21
1655984425641,MATH 20E,B02,083774,Ciotti; Benjamin,12,0,35,23
1655984431672,MATH 103A,A01,083777,Greenfeld; Be'Eri,2,1,36,34
1655984431672,MATH 103A,A02,083778,Greenfeld; Be'Eri,2,0,36,34
1655984431672,MATH 103A,A03,093561,Staff,0,1,36,36
1655984431672,MATH 103A,B01,083779,Greenfeld; Be'Eri,7,1,36,29
1655984431672,MATH 103A,B02,083780,Greenfeld; Be'Eri,0,0,36,36
1655984431672,MATH 103A,B03,093562,Staff,0,0,36,36
1655984437703,MATH 105,A01,085443,Carter; Anne Toulson,4,1,35,31
1655984437703,MATH 105,A02,093477,Staff,8,0,35,27
1655984443731,MATH 109,A01,083213,Ganzberger; Geoffrey Michael,0,1,34,34
1655984443731,MATH 109,A02,083214,Ganzberger; Geoffrey Michael,0,0,34,34
1655984443731,MATH 109,A03,093478,Staff,1,0,34,33
1655984443731,MATH 109,B01,083215,Ganzberger; Geoffrey Michael,2,0,32,30
1655984443731,MATH 109,B02,083216,Ganzberger; Geoffrey Michael,0,0,32,32
1655984443731,MATH 109,B03,093479,Staff,4,0,32,28
1655984449773,MATH 142A,A01,083219,Chow; Bennett,0,0,32,32
1655984449773,MATH 142A,A02,083220,Chow; Bennett,7,0,32,25
1655984449773,MATH 142A,A03,093480,Staff,4,0,32,28
1655984449773,MATH 142A,B03,093481,Staff,3,0,32,29
1655984449773,MATH 142A,B04,093558,Staff,6,0,32,26
1655984449773,MATH 142A,B05,093559,Staff,0,0,32,32
1655984455805,MATH 193A,A01,083224,Rotar; Vladimir,1,1,34,33
1655984455805,MATH 193A,A02,083225,Rotar; Vladimir,0,0,34,34
1655984455805,MATH 193A,A03,083781,Rotar; Vladimir,2,0,34,32
1655984455805,MATH 193A,A04,083782,Rotar; Vladimir,3,0,34,31
1655984455805,MATH 193A,A05,093482,Rotar; Vladimir,0,0,34,34
1655984461835,MATH 197,001,091859,McAuley; Julian John,9999,0,9999,0
1655984461835,MATH 197,002,095566,Kedlaya; Kiran S.,9997,0,9999,2
1655984461835,MATH 197,003,095567,Xiao; Ming,9999,0,9999,0
1655984461835,MATH 197,004,095571,Perols; Johan Lars,9998,0,9999,1
1655984468896,COGS 9,A01,083615,Shannon; Kyle Michael,3,1,75,72
1655984474925,COGS 11,A01,083617,Boyle; Mary E. T.,11,1,48,37
1655984480961,COGS 13,A01,083071,Bastos; Amalia Pinkusfeld,3,2,71,68
1655984486989,COGS 14A,A01,092681,Semenuks; Arturs,4,25,100,96
1655984493017,COGS 14B,A01,083073,Cheng; Tzu-Han,7,0,63,56
1655984499042,COGS 17,A01,092677,Semenuks; Arturs,8,7,81,73
1655984505065,COGS 100,A01,083619,Allen; Michael Gordon,2,2,70,68
1655984511095,COGS 101A,A01,083621,Davis; Joshua Daniel,4,3,68,64
1655984517125,COGS 101B,A01,091572,Allen; Michael Gordon,0,0,65,65
1655984523152,COGS 101C,A01,083625,Delgado; Tania,7,0,35,28
1655984529183,COGS 107A,A01,083627,Boyle; Mary E. T.,1,2,60,59
1655984535216,COGS 118A,A01,083075,Gupta; Anjum,21,16,76,55
1655984541247,CSE 3,A50,083646,Miranda; Gregory Joseph,14,0,50,36
1655984547276,CSE 8A,A50,083650,Miranda; Gregory Joseph,3,11,56,53
1655984553306,CSE 11,A01,083080,Cao; Yingjun,0,65,40,40
1655984559334,CSE 12,A01,083652,Krause-Levy; Sophia Louisa,6,8,120,114
1655984565364,CSE 15L,A01,083654,Morris; Justin Loren,3,1,50,47
1655984565364,CSE 15L,A02,083655,Morris; Justin Loren,1,1,50,49
1655984571389,CSE 20,A01,083657,Tran; Khoa Dang,29,0,80,51
1655984577416,CSE 21,A01,095574,Bach; Quang Tran,23,0,48,25
1655984583446,CSE 30,A01,083084,Eldon; John,2,10,80,78
1655984583446,CSE 30,B01,095061,Bhaskar; Nishant,0,4,50,50
1655984589475,CSE 100,A01,083659,Cao; Yingjun,2,25,70,68
1655984595504,CSE 134B,A01,083661,Powell; Thomas Allan,6,7,100,94
1655984601532,CSE 140,A01,083663,Gungor; Onat,5,0,85,80
1655984607558,CSE 140L,A01,083088,Eldon; John,5,0,100,95
1655984613585,CSE 175,A01,083665,Kumar; Rakesh,1,0,25,24
1655984619614,CSE 190,A00,092507,Dubnov; Shlomo,1,0,20,19
1655984625645,ECE 45,A01,083139,Congero; Spencer William,0,1,75,75
1655984631674,ECE 65,A50,083695,Saad; Andrew S,6,0,30,24
1655984631674,ECE 65,A51,095125,Staff,23,0,26,3
1655984637704,ECE 109,A01,091882,Touri; Behrouz,2,4,70,68
1655984643738,ECE 180,A00,083140,Abi Samra; Nicholas Camill,1,0,30,29
1655984643738,ECE 180,B00,083141,Abi Samra; Nicholas Camill,0,8,28,28
1655984649769,MATH 10A,A01,083735,Patchell; Gregory David,0,0,30,30
1655984649769,MATH 10A,A02,083736,Patchell; Gregory David,21,0,30,9
1655984649769,MATH 10A,A03,083737,Patchell; Gregory David,16,0,30,14
1655984655795,MATH 10B,A01,083207,Lim; Seonhee,1,1,34,33
1655984655795,MATH 10B,A02,083208,Lim; Seonhee,1,1,35,34
1655984655795,MATH 10B,A03,093472,Staff,1,0,34,33
1655984655795,MATH 10B,B01,083739,Sinha; Shubham,9,0,30,21
1655984661822,MATH 18,A01,083743,Cinel; Cameron Alexander,5,0,30,25
1655984661822,MATH 18,A02,083744,Cinel; Cameron Alexander,11,0,30,19
1655984661822,MATH 18,A03,083745,Cinel; Cameron Alexander,1,0,30,29
1655984661822,MATH 18,B01,083748,Ma; Zilu,2,0,36,34
1655984661822,MATH 18,B02,083749,Ma; Zilu,0,0,36,36
1655984661822,MATH 18,B03,083750,Ma; Zilu,0,0,36,36
1655984661822,MATH 18,B04,083751,Ma; Zilu,0,0,36,36
1655984661822,MATH 18,B05,093473,Staff,0,0,36,36
1655984661822,MATH 18,B06,093474,Staff,1,0,36,35
1655984667849,MATH 20A,A01,083754,Zheng; Zequn,10,0,40,30
1655984673880,MATH 20B,A01,083756,Briones; Jor-el Thomas Caparas,0,1,36,36
1655984673880,MATH 20B,A02,083757,Briones; Jor-el Thomas Caparas,1,0,36,35
1655984673880,MATH 20B,A03,093475,Staff,0,0,36,36
1655984679906,MATH 20C,A01,083760,Briones; Jor-el Thomas Caparas,0,2,35,35
1655984679906,MATH 20C,A02,083761,Briones; Jor-el Thomas Caparas,6,1,35,29
1655984679906,MATH 20C,A03,093476,Staff,1,0,35,34
1655984679906,MATH 20C,B01,083762,Bach; Quang Tran,3,0,30,27
1655984685934,MATH 20D,A01,083765,Tran; Brian Kha,1,0,30,29
1655984685934,MATH 20D,A02,083766,Tran; Brian Kha,0,1,30,30
1655984685934,MATH 20D,A03,083767,Tran; Brian Kha,1,0,30,29
1655984691965,MATH 20E,A01,083771,Ganguly; Soumya,0,1,32,32
1655984691965,MATH 20E,A02,083772,Ganguly; Soumya,1,1,32,31
1655984691965,MATH 20E,B01,083773,Ciotti; Benjamin,14,0,35,21
1655984691965,MATH 20E,B02,083774,Ciotti; Benjamin,12,0,35,23
1655984697999,MATH 103A,A01,083777,Greenfeld; Be'Eri,2,1,36,34
1655984697999,MATH 103A,A02,083778,Greenfeld; Be'Eri,2,0,36,34
1655984697999,MATH 103A,A03,093561,Staff,0,1,36,36
1655984697999,MATH 103A,B01,083779,Greenfeld; Be'Eri,7,1,36,29
1655984697999,MATH 103A,B02,083780,Greenfeld; Be'Eri,0,0,36,36
1655984697999,MATH 103A,B03,093562,Staff,0,0,36,36
1655984704027,MATH 105,A01,085443,Carter; Anne Toulson,4,1,35,31
1655984704027,MATH 105,A02,093477,Staff,8,0,35,27
1655984710056,MATH 109,A01,083213,Ganzberger; Geoffrey Michael,0,1,34,34
1655984710056,MATH 109,A02,083214,Ganzberger; Geoffrey Michael,0,0,34,34
1655984710056,MATH 109,A03,093478,Staff,1,0,34,33
1655984710056,MATH 109,B01,083215,Ganzberger; Geoffrey Michael,2,0,32,30
1655984710056,MATH 109,B02,083216,Ganzberger; Geoffrey Michael,0,0,32,32
1655984710056,MATH 109,B03,093479,Staff,4,0,32,28
1655984716084,MATH 142A,A01,083219,Chow; Bennett,0,0,32,32
1655984716084,MATH 142A,A02,083220,Chow; Bennett,7,0,32,25
1655984716084,MATH 142A,A03,093480,Staff,4,0,32,28
1655984716084,MATH 142A,B03,093481,Staff,3,0,32,29
1655984716084,MATH 142A,B04,093558,Staff,6,0,32,26
1655984716084,MATH 142A,B05,093559,Staff,0,0,32,32
1655984722116,MATH 193A,A01,083224,Rotar; Vladimir,1,1,34,33
1655984722116,MATH 193A,A02,083225,Rotar; Vladimir,0,0,34,34
1655984722116,MATH 193A,A03,083781,Rotar; Vladimir,2,0,34,32
1655984722116,MATH 193A,A04,083782,Rotar; Vladimir,3,0,34,31
1655984722116,MATH 193A,A05,093482,Rotar; Vladimir,0,0,34,34
1655984728146,MATH 197,001,091859,McAuley; Julian John,9999,0,9999,0
1655984728146,MATH 197,002,095566,Kedlaya; Kiran S.,9997,0,9999,2
1655984728146,MATH 197,003,095567,Xiao; Ming,9999,0,9999,0
1655984728146,MATH 197,004,095571,Perols; Johan Lars,9998,0,9999,1
1655984735203,COGS 9,A01,083615,Shannon; Kyle Michael,3,1,75,72
1655984741234,COGS 11,A01,083617,Boyle; Mary E. T.,11,1,48,37
1655984747260,COGS 13,A01,083071,Bastos; Amalia Pinkusfeld,3,2,71,68
1655984753288,COGS 14A,A01,092681,Semenuks; Arturs,4,25,100,96
1655984759320,COGS 14B,A01,083073,Cheng; Tzu-Han,7,0,63,56
1655984765343,COGS 17,A01,092677,Semenuks; Arturs,8,7,81,73
1655984771372,COGS 100,A01,083619,Allen; Michael Gordon,2,2,70,68
1655984777405,COGS 101A,A01,083621,Davis; Joshua Daniel,4,3,68,64
1655984783436,COGS 101B,A01,091572,Allen; Michael Gordon,0,0,65,65
1655984789462,COGS 101C,A01,083625,Delgado; Tania,7,0,35,28
1655984795494,COGS 107A,A01,083627,Boyle; Mary E. T.,1,2,60,59
1655984801522,COGS 118A,A01,083075,Gupta; Anjum,21,16,76,55
1655984807555,CSE 3,A50,083646,Miranda; Gregory Joseph,14,0,50,36
1655984813582,CSE 8A,A50,083650,Miranda; Gregory Joseph,3,11,56,53
1655984819612,CSE 11,A01,083080,Cao; Yingjun,0,65,40,40
1655984825639,CSE 12,A01,083652,Krause-Levy; Sophia Louisa,6,8,120,114
1655984831668,CSE 15L,A01,083654,Morris; Justin Loren,3,1,50,47
1655984831668,CSE 15L,A02,083655,Morris; Justin Loren,1,1,50,49
1655984837697,CSE 20,A01,083657,Tran; Khoa Dang,29,0,80,51
1655984843806,CSE 21,A01,095574,Bach; Quang Tran,23,0,48,25
1655984849839,CSE 30,A01,083084,Eldon; John,2,10,80,78
1655984849839,CSE 30,B01,095061,Bhaskar; Nishant,0,4,50,50
1655984855866,CSE 100,A01,083659,Cao; Yingjun,2,25,70,68
1655984861892,CSE 134B,A01,083661,Powell; Thomas Allan,6,7,100,94
1655984867952,CSE 140,A01,083663,Gungor; Onat,5,0,85,80
1655984873976,CSE 140L,A01,083088,Eldon; John,5,0,100,95
1655984880004,CSE 175,A01,083665,Kumar; Rakesh,1,0,25,24
1655984886030,CSE 190,A00,092507,Dubnov; Shlomo,1,0,20,19
1655984892064,ECE 45,A01,083139,Congero; Spencer William,0,1,75,75
1655984898094,ECE 65,A50,083695,Saad; Andrew S,6,0,30,24
1655984898094,ECE 65,A51,095125,Staff,23,0,26,3
1655984904123,ECE 109,A01,091882,Touri; Behrouz,2,4,70,68
1655984910162,ECE 180,A00,083140,Abi Samra; Nicholas Camill,1,0,30,29
1655984910162,ECE 180,B00,083141,Abi Samra; Nicholas Camill,0,8,28,28
1655984916194,MATH 10A,A01,083735,Patchell; Gregory David,0,0,30,30
1655984916194,MATH 10A,A02,083736,Patchell; Gregory David,21,0,30,9
1655984916194,MATH 10A,A03,083737,Patchell; Gregory David,16,0,30,14
1655984922222,MATH 10B,A01,083207,Lim; Seonhee,1,1,34,33
1655984922222,MATH 10B,A02,083208,Lim; Seonhee,1,1,35,34
1655984922222,MATH 10B,A03,093472,Staff,1,0,34,33
1655984922222,MATH 10B,B01,083739,Sinha; Shubham,9,0,30,21
1655984928249,MATH 18,A01,083743,Cinel; Cameron Alexander,5,0,30,25
1655984928249,MATH 18,A02,083744,Cinel; Cameron Alexander,11,0,30,19
1655984928249,MATH 18,A03,083745,Cinel; Cameron Alexander,1,0,30,29
1655984928249,MATH 18,B01,083748,Ma; Zilu,2,0,36,34
1655984928249,MATH 18,B02,083749,Ma; Zilu,0,0,36,36
1655984928249,MATH 18,B03,083750,Ma; Zilu,0,0,36,36
1655984928249,MATH 18,B04,083751,Ma; Zilu,0,0,36,36
1655984928249,MATH 18,B05,093473,Staff,0,0,36,36
1655984928249,MATH 18,B06,093474,Staff,1,0,36,35
1655984934275,MATH 20A,A01,083754,Zheng; Zequn,10,0,40,30
1655984940307,MATH 20B,A01,083756,Briones; Jor-el Thomas Caparas,0,1,36,36
1655984940307,MATH 20B,A02,083757,Briones; Jor-el Thomas Caparas,1,0,36,35
1655984940307,MATH 20B,A03,093475,Staff,0,0,36,36
1655984946339,MATH 20C,A01,083760,Briones; Jor-el Thomas Caparas,0,2,35,35
1655984946339,MATH 20C,A02,083761,Briones; Jor-el Thomas Caparas,6,1,35,29
1655984946339,MATH 20C,A03,093476,Staff,1,0,35,34
1655984946339,MATH 20C,B01,083762,Bach; Quang Tran,3,0,30,27
1655984952378,MATH 20D,A01,083765,Tran; Brian Kha,1,0,30,29
1655984952378,MATH 20D,A02,083766,Tran; Brian Kha,0,1,30,30
1655984952378,MATH 20D,A03,083767,Tran; Brian Kha,1,0,30,29
1655984958404,MATH 20E,A01,083771,Ganguly; Soumya,0,1,32,32
1655984958404,MATH 20E,A02,083772,Ganguly; Soumya,1,1,32,31
1655984958404,MATH 20E,B01,083773,Ciotti; Benjamin,14,0,35,21
1655984958404,MATH 20E,B02,083774,Ciotti; Benjamin,12,0,35,23
1655984964432,MATH 103A,A01,083777,Greenfeld; Be'Eri,2,1,36,34
1655984964432,MATH 103A,A02,083778,Greenfeld; Be'Eri,2,0,36,34
1655984964432,MATH 103A,A03,093561,Staff,0,1,36,36
1655984964432,MATH 103A,B01,083779,Greenfeld; Be'Eri,7,1,36,29
1655984964432,MATH 103A,B02,083780,Greenfeld; Be'Eri,0,0,36,36
1655984964432,MATH 103A,B03,093562,Staff,0,0,36,36
1655984970460,MATH 105,A01,085443,Carter; Anne Toulson,4,1,35,31
1655984970460,MATH 105,A02,093477,Staff,8,0,35,27
1655984976488,MATH 109,A01,083213,Ganzberger; Geoffrey Michael,0,1,34,34
1655984976488,MATH 109,A02,083214,Ganzberger; Geoffrey Michael,0,0,34,34
1655984976488,MATH 109,A03,093478,Staff,1,0,34,33
1655984976488,MATH 109,B01,083215,Ganzberger; Geoffrey Michael,2,0,32,30
1655984976488,MATH 109,B02,083216,Ganzberger; Geoffrey Michael,0,0,32,32
1655984976488,MATH 109,B03,093479,Staff,4,0,32,28
1655984982519,MATH 142A,A01,083219,Chow; Bennett,0,0,32,32
1655984982519,MATH 142A,A02,083220,Chow; Bennett,7,0,32,25
1655984982519,MATH 142A,A03,093480,Staff,4,0,32,28
1655984982519,MATH 142A,B03,093481,Staff,3,0,32,29
1655984982519,MATH 142A,B04,093558,Staff,6,0,32,26
1655984982519,MATH 142A,B05,093559,Staff,0,0,32,32
1655984988546,MATH 193A,A01,083224,Rotar; Vladimir,1,1,34,33
1655984988546,MATH 193A,A02,083225,Rotar; Vladimir,0,0,34,34
1655984988546,MATH 193A,A03,083781,Rotar; Vladimir,2,0,34,32
1655984988546,MATH 193A,A04,083782,Rotar; Vladimir,3,0,34,31
1655984988546,MATH 193A,A05,093482,Rotar; Vladimir,0,0,34,34
1655984994576,MATH 197,001,091859,McAuley; Julian John,9999,0,9999,0
1655984994576,MATH 197,002,095566,Kedlaya; Kiran S.,9997,0,9999,2
1655984994576,MATH 197,003,095567,Xiao; Ming,9999,0,9999,0
1655984994576,MATH 197,004,095571,Perols; Johan Lars,9998,0,9999,1
1655985001637,COGS 9,A01,083615,Shannon; Kyle Michael,3,1,75,72
1655985007663,COGS 11,A01,083617,Boyle; Mary E. T.,11,1,48,37
1655985013689,COGS 13,A01,083071,Bastos; Amalia Pinkusfeld,3,2,71,68
1655985019713,COGS 14A,A01,092681,Semenuks; Arturs,4,25,100,96
1655985025743,COGS 14B,A01,083073,Cheng; Tzu-Han,7,0,63,56
1655985031773,COGS 17,A01,092677,Semenuks; Arturs,8,7,81,73
1655985037806,COGS 100,A01,083619,Allen; Michael Gordon,2,2,70,68
1655985043838,COGS 101A,A01,083621,Davis; Joshua Daniel,4,3,68,64
1655985049863,COGS 101B,A01,091572,Allen; Michael Gordon,0,0,65,65
1655985055889,COGS 101C,A01,083625,Delgado; Tania,7,0,35,28
1655985061918,COGS 107A,A01,083627,Boyle; Mary E. T.,1,2,60,59
1655985067952,COGS 118A,A01,083075,Gupta; Anjum,21,16,76,55
1655985073979,CSE 3,A50,083646,Miranda; Gregory Joseph,14,0,50,36
1655985080008,CSE 8A,A50,083650,Miranda; Gregory Joseph,3,11,56,53
1655985086033,CSE 11,A01,083080,Cao; Yingjun,0,65,40,40
1655985092058,CSE 12,A01,083652,Krause-Levy; Sophia Louisa,6,8,120,114
1655985098084,CSE 15L,A01,083654,Morris; Justin Loren,3,1,50,47
1655985098084,CSE 15L,A02,083655,Morris; Justin Loren,1,1,50,49
1655985104114,CSE 20,A01,083657,Tran; Khoa Dang,29,0,80,51
1655985110140,CSE 21,A01,095574,Bach; Quang Tran,23,0,48,25
1655985116166,CSE 30,A01,083084,Eldon; John,2,10,80,78
1655985116166,CSE 30,B01,095061,Bhaskar; Nishant,0,4,50,50
1655985122195,CSE 100,A01,083659,Cao; Yingjun,2,25,70,68
1655985128221,CSE 134B,A01,083661,Powell; Thomas Allan,6,7,100,94
1655985134247,CSE 140,A01,083663,Gungor; Onat,5,0,85,80
1655985140276,CSE 140L,A01,083088,Eldon; John,5,0,100,95
1655985146304,CSE 175,A01,083665,Kumar; Rakesh,1,0,25,24
1655985152336,CSE 190,A00,092507,Dubnov; Shlomo,1,0,20,19
1655985158362,ECE 45,A01,083139,Congero; Spencer William,0,1,75,75
1655985164387,ECE 65,A50,083695,Saad; Andrew S,6,0,30,24
1655985164387,ECE 65,A51,095125,Staff,23,0,26,3
1655985170412,ECE 109,A01,091882,Touri; Behrouz,2,4,70,68
1655985176441,ECE 180,A00,083140,Abi Samra; Nicholas Camill,1,0,30,29
1655985176441,ECE 180,B00,083141,Abi Samra; Nicholas Camill,0,8,28,28
1655985182467,MATH 10A,A01,083735,Patchell; Gregory David,0,0,30,30
1655985182467,MATH 10A,A02,083736,Patchell; Gregory David,21,0,30,9
1655985182467,MATH 10A,A03,083737,Patchell; Gregory David,16,0,30,14
1655985188500,MATH 10B,A01,083207,Lim; Seonhee,1,1,34,33
1655985188500,MATH 10B,A02,083208,Lim; Seonhee,1,1,35,34
1655985188500,MATH 10B,A03,093472,Staff,1,0,34,33
1655985188500,MATH 10B,B01,083739,Sinha; Shubham,9,0,30,21
1655985194528,MATH 18,A01,083743,Cinel; Cameron Alexander,5,0,30,25
1655985194528,MATH 18,A02,083744,Cinel; Cameron Alexander,11,0,30,19
1655985194528,MATH 18,A03,083745,Cinel; Cameron Alexander,1,0,30,29
1655985194528,MATH 18,B01,083748,Ma; Zilu,2,0,36,34
1655985194528,MATH 18,B02,083749,Ma; Zilu,0,0,36,36
1655985194528,MATH 18,B03,083750,Ma; Zilu,0,0,36,36
1655985194528,MATH 18,B04,083751,Ma; Zilu,0,0,36,36
1655985194528,MATH 18,B05,093473,Staff,0,0,36,36
1655985194528,MATH 18,B06,093474,Staff,1,0,36,35
1655985200554,MATH 20A,A01,083754,Zheng; Zequn,10,0,40,30
1655985206583,MATH 20B,A01,083756,Briones; Jor-el Thomas Caparas,0,1,36,36
1655985206583,MATH 20B,A02,083757,Briones; Jor-el Thomas Caparas,1,0,36,35
1655985206583,MATH 20B,A03,093475,Staff,0,0,36,36
1655985212615,MATH 20C,A01,083760,Briones; Jor-el Thomas Caparas,0,2,35,35
1655985212615,MATH 20C,A02,083761,Briones; Jor-el Thomas Caparas,6,1,35,29
1655985212615,MATH 20C,A03,093476,Staff,1,0,35,34
1655985212615,MATH 20C,B01,083762,Bach; Quang Tran,3,0,30,27
1655985218639,MATH 20D,A01,083765,Tran; Brian Kha,1,0,30,29
1655985218639,MATH 20D,A02,083766,Tran; Brian Kha,0,1,30,30
1655985218639,MATH 20D,A03,083767,Tran; Brian Kha,1,0,30,29
1655985224666,MATH 20E,A01,083771,Ganguly; Soumya,0,1,32,32
1655985224666,MATH 20E,A02,083772,Ganguly; Soumya,1,1,32,31
1655985224666,MATH 20E,B01,083773,Ciotti; Benjamin,14,0,35,21
1655985224666,MATH 20E,B02,083774,Ciotti; Benjamin,12,0,35,23
1655985230693,MATH 103A,A01,083777,Greenfeld; Be'Eri,2,1,36,34
1655985230693,MATH 103A,A02,083778,Greenfeld; Be'Eri,2,0,36,34
1655985230693,MATH 103A,A03,093561,Staff,0,1,36,36
1655985230693,MATH 103A,B01,083779,Greenfeld; Be'Eri,7,1,36,29
1655985230693,MATH 103A,B02,083780,Greenfeld; Be'Eri,0,0,36,36
1655985230693,MATH 103A,B03,093562,Staff,0,0,36,36
1655985236741,MATH 105,A01,085443,Carter; Anne Toulson,4,1,35,31
1655985236741,MATH 105,A02,093477,Staff,8,0,35,27
1655985242766,MATH 109,A01,083213,Ganzberger; Geoffrey Michael,0,1,34,34
1655985242766,MATH 109,A02,083214,Ganzberger; Geoffrey Michael,0,0,34,34
1655985242766,MATH 109,A03,093478,Staff,1,0,34,33
1655985242766,MATH 109,B01,083215,Ganzberger; Geoffrey Michael,2,0,32,30
1655985242766,MATH 109,B02,083216,Ganzberger; Geoffrey Michael,0,0,32,32
1655985242766,MATH 109,B03,093479,Staff,4,0,32,28
1655985248799,MATH 142A,A01,083219,Chow; Bennett,0,0,32,32
1655985248799,MATH 142A,A02,083220,Chow; Bennett,7,0,32,25
1655985248799,MATH 142A,A03,093480,Staff,4,0,32,28
1655985248799,MATH 142A,B03,093481,Staff,3,0,32,29
1655985248799,MATH 142A,B04,093558,Staff,6,0,32,26
1655985248799,MATH 142A,B05,093559,Staff,0,0,32,32
1655985254827,MATH 193A,A01,083224,Rotar; Vladimir,1,1,34,33
1655985254827,MATH 193A,A02,083225,Rotar; Vladimir,0,0,34,34
1655985254827,MATH 193A,A03,083781,Rotar; Vladimir,2,0,34,32
1655985254827,MATH 193A,A04,083782,Rotar; Vladimir,3,0,34,31
1655985254827,MATH 193A,A05,093482,Rotar; Vladimir,0,0,34,34
1655985260854,MATH 197,001,091859,McAuley; Julian John,9999,0,9999,0
1655985260854,MATH 197,002,095566,Kedlaya; Kiran S.,9997,0,9999,2
1655985260854,MATH 197,003,095567,Xiao; Ming,9999,0,9999,0
1655985260854,MATH 197,004,095571,Perols; Johan Lars,9998,0,9999,1
1655985267926,COGS 9,A01,083615,Shannon; Kyle Michael,3,1,75,72
1655985273956,COGS 11,A01,083617,Boyle; Mary E. T.,11,1,48,37
1655985279984,COGS 13,A01,083071,Bastos; Amalia Pinkusfeld,3,2,71,68
1655985286017,COGS 14A,A01,092681,Semenuks; Arturs,4,25,100,96
1655985292044,COGS 14B,A01,083073,Cheng; Tzu-Han,7,0,63,56
1655985298070,COGS 17,A01,092677,Semenuks; Arturs,8,7,81,73
1655985304115,COGS 100,A01,083619,Allen; Michael Gordon,2,2,70,68
1655985310149,COGS 101A,A01,083621,Davis; Joshua Daniel,4,3,68,64
1655985316176,COGS 101B,A01,091572,Allen; Michael Gordon,0,0,65,65
1655985322203,COGS 101C,A01,083625,Delgado; Tania,7,0,35,28
1655985328228,COGS 107A,A01,083627,Boyle; Mary E. T.,1,2,60,59
1655985334258,COGS 118A,A01,083075,Gupta; Anjum,21,16,76,55
1655985340286,CSE 3,A50,083646,Miranda; Gregory Joseph,14,0,50,36
1655985346320,CSE 8A,A50,083650,Miranda; Gregory Joseph,3,11,56,53
1655985352347,CSE 11,A01,083080,Cao; Yingjun,0,65,40,40
1655985358377,CSE 12,A01,083652,Krause-Levy; Sophia Louisa,6,8,120,114
1655985364404,CSE 15L,A01,083654,Morris; Justin Loren,3,1,50,47
1655985364404,CSE 15L,A02,083655,Morris; Justin Loren,1,1,50,49
1655985370429,CSE 20,A01,083657,Tran; Khoa Dang,29,0,80,51
1655985376459,CSE 21,A01,095574,Bach; Quang Tran,23,0,48,25
1655985382489,CSE 30,A01,083084,Eldon; John,2,10,80,78
1655985382489,CSE 30,B01,095061,Bhaskar; Nishant,0,4,50,50
1655985388516,CSE 100,A01,083659,Cao; Yingjun,2,25,70,68
1655985394545,CSE 134B,A01,083661,Powell; Thomas Allan,6,7,100,94
1655985400573,CSE 140,A01,083663,Gungor; Onat,5,0,85,80
1655985406603,CSE 140L,A01,083088,Eldon; John,5,0,100,95
1655985412630,CSE 175,A01,083665,Kumar; Rakesh,1,0,25,24
1655985418655,CSE 190,A00,092507,Dubnov; Shlomo,1,0,20,19
1655985424682,ECE 45,A01,083139,Congero; Spencer William,0,1,75,75
1655985430718,ECE 65,A50,083695,Saad; Andrew S,6,0,30,24
1655985430718,ECE 65,A51,095125,Staff,23,0,26,3
1655985436748,ECE 109,A01,091882,Touri; Behrouz,2,4,70,68
1655985442846,ECE 180,A00,083140,Abi Samra; Nicholas Camill,1,0,30,29
1655985442846,ECE 180,B00,083141,Abi Samra; Nicholas Camill,0,8,28,28
1655985448884,MATH 10A,A01,083735,Patchell; Gregory David,0,0,30,30
1655985448884,MATH 10A,A02,083736,Patchell; Gregory David,21,0,30,9
1655985448884,MATH 10A,A03,083737,Patchell; Gregory David,16,0,30,14
1655985454914,MATH 10B,A01,083207,Lim; Seonhee,1,1,34,33
1655985454914,MATH 10B,A02,083208,Lim; Seonhee,1,1,35,34
1655985454914,MATH 10B,A03,093472,Staff,1,0,34,33
1655985454914,MATH 10B,B01,083739,Sinha; Shubham,9,0,30,21
1655985460944,MATH 18,A01,083743,Cinel; Cameron Alexander,5,0,30,25
1655985460944,MATH 18,A02,083744,Cinel; Cameron Alexander,11,0,30,19
1655985460944,MATH 18,A03,083745,Cinel; Cameron Alexander,1,0,30,29
1655985460944,MATH 18,B01,083748,Ma; Zilu,2,0,36,34
1655985460944,MATH 18,B02,083749,Ma; Zilu,0,0,36,36
1655985460944,MATH 18,B03,083750,Ma; Zilu,0,0,36,36
1655985460944,MATH 18,B04,083751,Ma; Zilu,0,0,36,36
1655985460944,MATH 18,B05,093473,Staff,0,0,36,36
1655985460944,MATH 18,B06,093474,Staff,1,0,36,35
1655985466972,MATH 20A,A01,083754,Zheng; Zequn,10,0,40,30
1655985473004,MATH 20B,A01,083756,Briones; Jor-el Thomas Caparas,0,1,36,36
1655985473004,MATH 20B,A02,083757,Briones; Jor-el Thomas Caparas,1,0,36,35
1655985473004,MATH 20B,A03,093475,Staff,0,0,36,36
1655985479036,MATH 20C,A01,083760,Briones; Jor-el Thomas Caparas,0,2,35,35
1655985479036,MATH 20C,A02,083761,Briones; Jor-el Thomas Caparas,6,1,35,29
1655985479036,MATH 20C,A03,093476,Staff,1,0,35,34
1655985479036,MATH 20C,B01,083762,Bach; Quang Tran,3,0,30,27
1655985485063,MATH 20D,A01,083765,Tran; Brian Kha,1,0,30,29
1655985485063,MATH 20D,A02,083766,Tran; Brian Kha,0,1,30,30
1655985485063,MATH 20D,A03,083767,Tran; Brian Kha,1,0,30,29
1655985491102,MATH 20E,A01,083771,Ganguly; Soumya,0,1,32,32
1655985491102,MATH 20E,A02,083772,Ganguly; Soumya,1,1,32,31
1655985491102,MATH 20E,B01,083773,Ciotti; Benjamin,14,0,35,21
1655985491102,MATH 20E,B02,083774,Ciotti; Benjamin,12,0,35,23
1655985497132,MATH 103A,A01,083777,Greenfeld; Be'Eri,2,1,36,34
1655985497132,MATH 103A,A02,083778,Greenfeld; Be'Eri,2,0,36,34
1655985497132,MATH 103A,A03,093561,Staff,0,1,36,36
1655985497132,MATH 103A,B01,083779,Greenfeld; Be'Eri,7,1,36,29
1655985497132,MATH 103A,B02,083780,Greenfeld; Be'Eri,0,0,36,36
1655985497132,MATH 103A,B03,093562,Staff,0,0,36,36
1655985503159,MATH 105,A01,085443,Carter; Anne Toulson,4,1,35,31
1655985503159,MATH 105,A02,093477,Staff,8,0,35,27
1655985509184,MATH 109,A01,083213,Ganzberger; Geoffrey Michael,0,1,34,34
1655985509184,MATH 109,A02,083214,Ganzberger; Geoffrey Michael,0,0,34,34
1655985509184,MATH 109,A03,093478,Staff,1,0,34,33
1655985509184,MATH 109,B01,083215,Ganzberger; Geoffrey Michael,2,0,32,30
1655985509184,MATH 109,B02,083216,Ganzberger; Geoffrey Michael,0,0,32,32
1655985509184,MATH 109,B03,093479,Staff,4,0,32,28
1655985515219,MATH 142A,A01,083219,Chow; Bennett,0,0,32,32
1655985515219,MATH 142A,A02,083220,Chow; Bennett,7,0,32,25
1655985515219,MATH 142A,A03,093480,Staff,4,0,32,28
1655985515219,MATH 142A,B03,093481,Staff,3,0,32,29
1655985515219,MATH 142A,B04,093558,Staff,6,0,32,26
1655985515219,MATH 142A,B05,093559,Staff,0,0,32,32
1655985521248,MATH 193A,A01,083224,Rotar; Vladimir,1,1,34,33
1655985521248,MATH 193A,A02,083225,Rotar; Vladimir,0,0,34,34
1655985521248,MATH 193A,A03,083781,Rotar; Vladimir,2,0,34,32
1655985521248,MATH 193A,A04,083782,Rotar; Vladimir,3,0,34,31
1655985521248,MATH 193A,A05,093482,Rotar; Vladimir,0,0,34,34
1655985527276,MATH 197,001,091859,McAuley; Julian John,9999,0,9999,0
1655985527276,MATH 197,002,095566,Kedlaya; Kiran S.,9997,0,9999,2
1655985527276,MATH 197,003,095567,Xiao; Ming,9999,0,9999,0
1655985527276,MATH 197,004,095571,Perols; Johan Lars,9998,0,9999,1
1655985534348,COGS 9,A01,083615,Shannon; Kyle Michael,3,1,75,72
1655985540379,COGS 11,A01,083617,Boyle; Mary E. T.,11,1,48,37
1655985546410,COGS 13,A01,083071,Bastos; Amalia Pinkusfeld,3,2,71,68
1655985552443,COGS 14A,A01,092681,Semenuks; Arturs,4,25,100,96
1655985558476,COGS 14B,A01,083073,Cheng; Tzu-Han,7,0,63,56
1655985564506,COGS 17,A01,092677,Semenuks; Arturs,8,7,81,73
1655985570544,COGS 100,A01,083619,Allen; Michael Gordon,2,2,70,68
1655985576568,COGS 101A,A01,083621,Davis; Joshua Daniel,4,3,68,64
1655985582594,COGS 101B,A01,091572,Allen; Michael Gordon,0,0,65,65
1655985588631,COGS 101C,A01,083625,Delgado; Tania,7,0,35,28
1655985594659,COGS 107A,A01,083627,Boyle; Mary E. T.,1,2,60,59
1655985600687,COGS 118A,A01,083075,Gupta; Anjum,21,16,76,55
1655985606723,CSE 3,A50,083646,Miranda; Gregory Joseph,14,0,50,36
1655985612752,CSE 8A,A50,083650,Miranda; Gregory Joseph,3,11,56,53
1655985618780,CSE 11,A01,083080,Cao; Yingjun,0,65,40,40
1655985624804,CSE 12,A01,083652,Krause-Levy; Sophia Louisa,6,8,120,114
1655985630832,CSE 15L,A01,083654,Morris; Justin Loren,3,1,50,47
1655985630832,CSE 15L,A02,083655,Morris; Justin Loren,1,1,50,49
1655985636863,CSE 20,A01,083657,Tran; Khoa Dang,29,0,80,51
1655985642887,CSE 21,A01,095574,Bach; Quang Tran,23,0,48,25
1655985648914,CSE 30,A01,083084,Eldon; John,2,10,80,78
1655985648914,CSE 30,B01,095061,Bhaskar; Nishant,0,4,50,50
1655985654953,CSE 100,A01,083659,Cao; Yingjun,2,25,70,68
1655985660977,CSE 134B,A01,083661,Powell; Thomas Allan,6,7,100,94
1655985667008,CSE 140,A01,083663,Gungor; Onat,5,0,85,80
1655985673037,CSE 140L,A01,083088,Eldon; John,5,0,100,95
1655985679061,CSE 175,A01,083665,Kumar; Rakesh,1,0,25,24
1655985685089,CSE 190,A00,092507,Dubnov; Shlomo,1,0,20,19
1655985691116,ECE 45,A01,083139,Congero; Spencer William,0,1,75,75
1655985697140,ECE 65,A50,083695,Saad; Andrew S,6,0,30,24
1655985697140,ECE 65,A51,095125,Staff,23,0,26,3
1655985703172,ECE 109,A01,091882,Touri; Behrouz,2,4,70,68
1655985709201,ECE 180,A00,083140,Abi Samra; Nicholas Camill,1,0,30,29
1655985709201,ECE 180,B00,083141,Abi Samra; Nicholas Camill,0,8,28,28
1655985715228,MATH 10A,A01,083735,Patchell; Gregory David,0,0,30,30
1655985715228,MATH 10A,A02,083736,Patchell; Gregory David,21,0,30,9
1655985715228,MATH 10A,A03,083737,Patchell; Gregory David,16,0,30,14
1655985721258,MATH 10B,A01,083207,Lim; Seonhee,1,1,34,33
1655985721258,MATH 10B,A02,083208,Lim; Seonhee,1,1,35,34
1655985721258,MATH 10B,A03,093472,Staff,1,0,34,33
1655985721258,MATH 10B,B01,083739,Sinha; Shubham,9,0,30,21
1655985727285,MATH 18,A01,083743,Cinel; Cameron Alexander,5,0,30,25
1655985727285,MATH 18,A02,083744,Cinel; Cameron Alexander,11,0,30,19
1655985727285,MATH 18,A03,083745,Cinel; Cameron Alexander,1,0,30,29
1655985727285,MATH 18,B01,083748,Ma; Zilu,2,0,36,34
1655985727285,MATH 18,B02,083749,Ma; Zilu,0,0,36,36
1655985727285,MATH 18,B03,083750,Ma; Zilu,0,0,36,36
1655985727285,MATH 18,B04,083751,Ma; Zilu,0,0,36,36
1655985727285,MATH 18,B05,093473,Staff,0,0,36,36
1655985727285,MATH 18,B06,093474,Staff,1,0,36,35
1655985733313,MATH 20A,A01,083754,Zheng; Zequn,10,0,40,30
1655985739342,MATH 20B,A01,083756,Briones; Jor-el Thomas Caparas,0,1,36,36
1655985739342,MATH 20B,A02,083757,Briones; Jor-el Thomas Caparas,1,0,36,35
1655985739342,MATH 20B,A03,093475,Staff,0,0,36,36
1655985745368,MATH 20C,A01,083760,Briones; Jor-el Thomas Caparas,0,2,35,35
1655985745368,MATH 20C,A02,083761,Briones; Jor-el Thomas Caparas,6,1,35,29
1655985745368,MATH 20C,A03,093476,Staff,1,0,35,34
1655985745368,MATH 20C,B01,083762,Bach; Quang Tran,3,0,30,27
1655985751400,MATH 20D,A01,083765,Tran; Brian Kha,1,0,30,29
1655985751400,MATH 20D,A02,083766,Tran; Brian Kha,0,1,30,30
1655985751400,MATH 20D,A03,083767,Tran; Brian Kha,1,0,30,29
1655985757424,MATH 20E,A01,083771,Ganguly; Soumya,0,1,32,32
1655985757424,MATH 20E,A02,083772,Ganguly; Soumya,1,1,32,31
1655985757424,MATH 20E,B01,083773,Ciotti; Benjamin,14,0,35,21
1655985757424,MATH 20E,B02,083774,Ciotti; Benjamin,12,0,35,23
1655985763456,MATH 103A,A01,083777,Greenfeld; Be'Eri,2,1,36,34
1655985763456,MATH 103A,A02,083778,Greenfeld; Be'Eri,2,0,36,34
1655985763456,MATH 103A,A03,093561,Staff,0,1,36,36
1655985763456,MATH 103A,B01,083779,Greenfeld; Be'Eri,7,1,36,29
1655985763456,MATH 103A,B02,083780,Greenfeld; Be'Eri,0,0,36,36
1655985763456,MATH 103A,B03,093562,Staff,0,0,36,36
1655985769484,MATH 105,A01,085443,Carter; Anne Toulson,4,1,35,31
1655985769484,MATH 105,A02,093477,Staff,8,0,35,27
1655985775516,MATH 109,A01,083213,Ganzberger; Geoffrey Michael,0,1,34,34
1655985775516,MATH 109,A02,083214,Ganzberger; Geoffrey Michael,0,0,34,34
1655985775516,MATH 109,A03,093478,Staff,1,0,34,33
1655985775516,MATH 109,B01,083215,Ganzberger; Geoffrey Michael,2,0,32,30
1655985775516,MATH 109,B02,083216,Ganzberger; Geoffrey Michael,0,0,32,32
1655985775516,MATH 109,B03,093479,Staff,4,0,32,28
1655985781547,MATH 142A,A01,083219,Chow; Bennett,0,0,32,32
1655985781547,MATH 142A,A02,083220,Chow; Bennett,7,0,32,25
1655985781547,MATH 142A,A03,093480,Staff,4,0,32,28
1655985781547,MATH 142A,B03,093481,Staff,3,0,32,29
1655985781547,MATH 142A,B04,093558,Staff,6,0,32,26
1655985781547,MATH 142A,B05,093559,Staff,0,0,32,32
1655985787577,MATH 193A,A01,083224,Rotar; Vladimir,1,1,34,33
1655985787577,MATH 193A,A02,083225,Rotar; Vladimir,0,0,34,34
1655985787577,MATH 193A,A03,083781,Rotar; Vladimir,2,0,34,32
1655985787577,MATH 193A,A04,083782,Rotar; Vladimir,3,0,34,31
1655985787577,MATH 193A,A05,093482,Rotar; Vladimir,0,0,34,34
1655985793605,MATH 197,001,091859,McAuley; Julian John,9999,0,9999,0
1655985793605,MATH 197,002,095566,Kedlaya; Kiran S.,9997,0,9999,2
1655985793605,MATH 197,003,095567,Xiao; Ming,9999,0,9999,0
1655985793605,MATH 197,004,095571,Perols; Johan Lars,9998,0,9999,1
1655985800693,COGS 9,A01,083615,Shannon; Kyle Michael,3,1,75,72
1655985806719,COGS 11,A01,083617,Boyle; Mary E. T.,11,1,48,37
1655985812762,COGS 13,A01,083071,Bastos; Amalia Pinkusfeld,3,2,71,68
1655985818791,COGS 14A,A01,092681,Semenuks; Arturs,4,25,100,96
1655985824816,COGS 14B,A01,083073,Cheng; Tzu-Han,7,0,63,56
1655985830844,COGS 17,A01,092677,Semenuks; Arturs,8,7,81,73
1655985836881,COGS 100,A01,083619,Allen; Michael Gordon,2,2,70,68
1655985842909,COGS 101A,A01,083621,Davis; Joshua Daniel,4,3,68,64
1655985848949,COGS 101B,A01,091572,Allen; Michael Gordon,0,0,65,65
1655985854988,COGS 101C,A01,083625,Delgado; Tania,7,0,35,28
1655985861015,COGS 107A,A01,083627,Boyle; Mary E. T.,1,2,60,59
1655985867046,COGS 118A,A01,083075,Gupta; Anjum,21,16,76,55
1655985873076,CSE 3,A50,083646,Miranda; Gregory Joseph,14,0,50,36
1655985879108,CSE 8A,A50,083650,Miranda; Gregory Joseph,3,11,56,53
1655985885137,CSE 11,A01,083080,Cao; Yingjun,0,65,40,40
1655985891163,CSE 12,A01,083652,Krause-Levy; Sophia Louisa,6,8,120,114
1655985897196,CSE 15L,A01,083654,Morris; Justin Loren,3,1,50,47
1655985897196,CSE 15L,A02,083655,Morris; Justin Loren,1,1,50,49
1655985903227,CSE 20,A01,083657,Tran; Khoa Dang,29,0,80,51
1655985909253,CSE 21,A01,095574,Bach; Quang Tran,23,0,48,25
1655985915288,CSE 30,A01,083084,Eldon; John,2,10,80,78
1655985915288,CSE 30,B01,095061,Bhaskar; Nishant,0,4,50,50
1655985921316,CSE 100,A01,083659,Cao; Yingjun,2,25,70,68
1655985927342,CSE 134B,A01,083661,Powell; Thomas Allan,6,7,100,94
1655985933376,CSE 140,A01,083663,Gungor; Onat,5,0,85,80
1655985939409,CSE 140L,A01,083088,Eldon; John,5,0,100,95
1655985945438,CSE 175,A01,083665,Kumar; Rakesh,1,0,25,24
1655985951468,CSE 190,A00,092507,Dubnov; Shlomo,1,0,20,19
1655985957498,ECE 45,A01,083139,Congero; Spencer William,0,1,75,75
1655985963535,ECE 65,A50,083695,Saad; Andrew S,6,0,30,24
1655985963535,ECE 65,A51,095125,Staff,23,0,26,3
1655985969561,ECE 109,A01,091882,Touri; Behrouz,2,4,70,68
1655985975594,ECE 180,A00,083140,Abi Samra; Nicholas Camill,1,0,30,29
1655985975594,ECE 180,B00,083141,Abi Samra; Nicholas Camill,0,8,28,28
1655985981622,MATH 10A,A01,083735,Patchell; Gregory David,0,0,30,30
1655985981622,MATH 10A,A02,083736,Patchell; Gregory David,21,0,30,9
1655985981622,MATH 10A,A03,083737,Patchell; Gregory David,16,0,30,14
1655985987652,MATH 10B,A01,083207,Lim; Seonhee,1,1,34,33
1655985987652,MATH 10B,A02,083208,Lim; Seonhee,1,1,35,34
1655985987652,MATH 10B,A03,093472,Staff,1,0,34,33
1655985987652,MATH 10B,B01,083739,Sinha; Shubham,9,0,30,21
1655985993683,MATH 18,A01,083743,Cinel; Cameron Alexander,5,0,30,25
1655985993683,MATH 18,A02,083744,Cinel; Cameron Alexander,11,0,30,19
1655985993683,MATH 18,A03,083745,Cinel; Cameron Alexander,1,0,30,29
1655985993683,MATH 18,B01,083748,Ma; Zilu,2,0,36,34
1655985993683,MATH 18,B02,083749,Ma; Zilu,0,0,36,36
1655985993683,MATH 18,B03,083750,Ma; Zilu,0,0,36,36
1655985993683,MATH 18,B04,083751,Ma; Zilu,0,0,36,36
1655985993683,MATH 18,B05,093473,Staff,0,0,36,36
1655985993683,MATH 18,B06,093474,Staff,1,0,36,35
1655985999708,MATH 20A,A01,083754,Zheng; Zequn,10,0,40,30
1655986005734,MATH 20B,A01,083756,Briones; Jor-el Thomas Caparas,0,1,36,36
1655986005734,MATH 20B,A02,083757,Briones; Jor-el Thomas Caparas,1,0,36,35
1655986005734,MATH 20B,A03,093475,Staff,0,0,36,36
1655986011819,MATH 20C,A01,083760,Briones; Jor-el Thomas Caparas,0,2,35,35
1655986011819,MATH 20C,A02,083761,Briones; Jor-el Thomas Caparas,6,1,35,29
1655986011819,MATH 20C,A03,093476,Staff,1,0,35,34
1655986011819,MATH 20C,B01,083762,Bach; Quang Tran,3,0,30,27
1655986017845,MATH 20D,A01,083765,Tran; Brian Kha,1,0,30,29
1655986017845,MATH 20D,A02,083766,Tran; Brian Kha,0,1,30,30
1655986017845,MATH 20D,A03,083767,Tran; Brian Kha,1,0,30,29
1655986023875,MATH 20E,A01,083771,Ganguly; Soumya,0,1,32,32
1655986023875,MATH 20E,A02,083772,Ganguly; Soumya,1,1,32,31
1655986023875,MATH 20E,B01,083773,Ciotti; Benjamin,14,0,35,21
1655986023875,MATH 20E,B02,083774,Ciotti; Benjamin,12,0,35,23
1655986029913,MATH 103A,A01,083777,Greenfeld; Be'Eri,2,1,36,34
1655986029913,MATH 103A,A02,083778,Greenfeld; Be'Eri,2,0,36,34
1655986029913,MATH 103A,A03,093561,Staff,0,1,36,36
1655986029913,MATH 103A,B01,083779,Greenfeld; Be'Eri,7,1,36,29
1655986029913,MATH 103A,B02,083780,Greenfeld; Be'Eri,0,0,36,36
1655986029913,MATH 103A,B03,093562,Staff,0,0,36,36
1655986035940,MATH 105,A01,085443,Carter; Anne Toulson,4,1,35,31
1655986035940,MATH 105,A02,093477,Staff,8,0,35,27
1655986042068,MATH 109,A01,083213,Ganzberger; Geoffrey Michael,0,1,34,34
1655986042068,MATH 109,A02,083214,Ganzberger; Geoffrey Michael,0,0,34,34
1655986042068,MATH 109,A03,093478,Staff,1,0,34,33
1655986042068,MATH 109,B01,083215,Ganzberger; Geoffrey Michael,2,0,32,30
1655986042068,MATH 109,B02,083216,Ganzberger; Geoffrey Michael,0,0,32,32
1655986042068,MATH 109,B03,093479,Staff,4,0,32,28
1655986048100,MATH 142A,A01,083219,Chow; Bennett,0,0,32,32
1655986048100,MATH 142A,A02,083220,Chow; Bennett,7,0,32,25
1655986048100,MATH 142A,A03,093480,Staff,4,0,32,28
1655986048100,MATH 142A,B03,093481,Staff,3,0,32,29
1655986048100,MATH 142A,B04,093558,Staff,6,0,32,26
1655986048100,MATH 142A,B05,093559,Staff,0,0,32,32
1655986054140,MATH 193A,A01,083224,Rotar; Vladimir,1,1,34,33
1655986054140,MATH 193A,A02,083225,Rotar; Vladimir,0,0,34,34
1655986054140,MATH 193A,A03,083781,Rotar; Vladimir,2,0,34,32
1655986054140,MATH 193A,A04,083782,Rotar; Vladimir,3,0,34,31
1655986054140,MATH 193A,A05,093482,Rotar; Vladimir,0,0,34,34
1655986060172,MATH 197,001,091859,McAuley; Julian John,9999,0,9999,0
1655986060172,MATH 197,002,095566,Kedlaya; Kiran S.,9997,0,9999,2
1655986060172,MATH 197,003,095567,Xiao; Ming,9999,0,9999,0
1655986060172,MATH 197,004,095571,Perols; Johan Lars,9998,0,9999,1
1655986067243,COGS 9,A01,083615,Shannon; Kyle Michael,3,1,75,72
1655986073272,COGS 11,A01,083617,Boyle; Mary E. T.,11,1,48,37
1655986079318,COGS 13,A01,083071,Bastos; Amalia Pinkusfeld,3,2,71,68
1655986085348,COGS 14A,A01,092681,Semenuks; Arturs,4,25,100,96
1655986091384,COGS 14B,A01,083073,Cheng; Tzu-Han,7,0,63,56
1655986097407,COGS 17,A01,092677,Semenuks; Arturs,8,7,81,73
1655986103435,COGS 100,A01,083619,Allen; Michael Gordon,2,2,70,68
1655986109463,COGS 101A,A01,083621,Davis; Joshua Daniel,4,3,68,64
1655986115527,COGS 101B,A01,091572,Allen; Michael Gordon,0,0,65,65
1655986121558,COGS 101C,A01,083625,Delgado; Tania,7,0,35,28
1655986127584,COGS 107A,A01,083627,Boyle; Mary E. T.,1,2,60,59
1655986133611,COGS 118A,A01,083075,Gupta; Anjum,21,16,76,55
1655986139637,CSE 3,A50,083646,Miranda; Gregory Joseph,14,0,50,36
1655986145662,CSE 8A,A50,083650,Miranda; Gregory Joseph,3,11,56,53
1655986151686,CSE 11,A01,083080,Cao; Yingjun,0,65,40,40
1655986157753,CSE 12,A01,083652,Krause-Levy; Sophia Louisa,6,8,120,114
1655986163781,CSE 15L,A01,083654,Morris; Justin Loren,3,1,50,47
1655986163781,CSE 15L,A02,083655,Morris; Justin Loren,1,1,50,49
1655986169808,CSE 20,A01,083657,Tran; Khoa Dang,29,0,80,51
1655986175839,CSE 21,A01,095574,Bach; Quang Tran,23,0,48,25
1655986181867,CSE 30,A01,083084,Eldon; John,2,10,80,78
1655986181867,CSE 30,B01,095061,Bhaskar; Nishant,0,4,50,50
1655986187894,CSE 100,A01,083659,Cao; Yingjun,2,25,70,68
1655986193922,CSE 134B,A01,083661,Powell; Thomas Allan,6,7,100,94
1655986199959,CSE 140,A01,083663,Gungor; Onat,5,0,85,80
1655986205992,CSE 140L,A01,083088,Eldon; John,5,0,100,95
1655986212023,CSE 175,A01,083665,Kumar; Rakesh,1,0,25,24
1655986218052,CSE 190,A00,092507,Dubnov; Shlomo,1,0,20,19
1655986224089,ECE 45,A01,083139,Congero; Spencer William,0,1,75,75
1655986230122,ECE 65,A50,083695,Saad; Andrew S,6,0,30,24
1655986230122,ECE 65,A51,095125,Staff,23,0,26,3
1655986236156,ECE 109,A01,091882,Touri; Behrouz,2,4,70,68
1655986242196,ECE 180,A00,083140,Abi Samra; Nicholas Camill,1,0,30,29
1655986242196,ECE 180,B00,083141,Abi Samra; Nicholas Camill,0,8,28,28
1655986248233,MATH 10A,A01,083735,Patchell; Gregory David,0,0,30,30
1655986248233,MATH 10A,A02,083736,Patchell; Gregory David,21,0,30,9
1655986248233,MATH 10A,A03,083737,Patchell; Gregory David,16,0,30,14
1655986254272,MATH 10B,A01,083207,Lim; Seonhee,1,1,34,33
1655986254272,MATH 10B,A02,083208,Lim; Seonhee,1,1,35,34
1655986254272,MATH 10B,A03,093472,Staff,1,0,34,33
1655986254272,MATH 10B,B01,083739,Sinha; Shubham,9,0,30,21
1655986260303,MATH 18,A01,083743,Cinel; Cameron Alexander,5,0,30,25
1655986260303,MATH 18,A02,083744,Cinel; Cameron Alexander,11,0,30,19
1655986260303,MATH 18,A03,083745,Cinel; Cameron Alexander,1,0,30,29
1655986260303,MATH 18,B01,083748,Ma; Zilu,2,0,36,34
1655986260303,MATH 18,B02,083749,Ma; Zilu,0,0,36,36
1655986260303,MATH 18,B03,083750,Ma; Zilu,0,0,36,36
1655986260303,MATH 18,B04,083751,Ma; Zilu,0,0,36,36
1655986260303,MATH 18,B05,093473,Staff,0,0,36,36
1655986260303,MATH 18,B06,093474,Staff,1,0,36,35
1655986266328,MATH 20A,A01,083754,Zheng; Zequn,10,0,40,30
1655986272363,MATH 20B,A01,083756,Briones; Jor-el Thomas Caparas,0,1,36,36
1655986272363,MATH 20B,A02,083757,Briones; Jor-el Thomas Caparas,1,0,36,35
1655986272363,MATH 20B,A03,093475,Staff,0,0,36,36
1655986278392,MATH 20C,A01,083760,Briones; Jor-el Thomas Caparas,0,2,35,35
1655986278392,MATH 20C,A02,083761,Briones; Jor-el Thomas Caparas,6,1,35,29
1655986278392,MATH 20C,A03,093476,Staff,1,0,35,34
1655986278392,MATH 20C,B01,083762,Bach; Quang Tran,3,0,30,27
1655986284416,MATH 20D,A01,083765,Tran; Brian Kha,1,0,30,29
1655986284416,MATH 20D,A02,083766,Tran; Brian Kha,0,1,30,30
1655986284416,MATH 20D,A03,083767,Tran; Brian Kha,1,0,30,29
1655986290452,MATH 20E,A01,083771,Ganguly; Soumya,0,1,32,32
1655986290452,MATH 20E,A02,083772,Ganguly; Soumya,1,1,32,31
1655986290452,MATH 20E,B01,083773,Ciotti; Benjamin,14,0,35,21
1655986290452,MATH 20E,B02,083774,Ciotti; Benjamin,12,0,35,23
1655986296489,MATH 103A,A01,083777,Greenfeld; Be'Eri,2,1,36,34
1655986296489,MATH 103A,A02,083778,Greenfeld; Be'Eri,2,0,36,34
1655986296489,MATH 103A,A03,093561,Staff,0,1,36,36
1655986296489,MATH 103A,B01,083779,Greenfeld; Be'Eri,7,1,36,29
1655986296489,MATH 103A,B02,083780,Greenfeld; Be'Eri,0,0,36,36
1655986296489,MATH 103A,B03,093562,Staff,0,0,36,36
1655986302522,MATH 105,A01,085443,Carter; Anne Toulson,4,1,35,31
1655986302522,MATH 105,A02,093477,Staff,8,0,35,27
1655986308549,MATH 109,A01,083213,Ganzberger; Geoffrey Michael,0,1,34,34
1655986308549,MATH 109,A02,083214,Ganzberger; Geoffrey Michael,0,0,34,34
1655986308549,MATH 109,A03,093478,Staff,1,0,34,33
1655986308549,MATH 109,B01,083215,Ganzberger; Geoffrey Michael,2,0,32,30
1655986308549,MATH 109,B02,083216,Ganzberger; Geoffrey Michael,0,0,32,32
1655986308549,MATH 109,B03,093479,Staff,4,0,32,28
1655986314585,MATH 142A,A01,083219,Chow; Bennett,0,0,32,32
1655986314585,MATH 142A,A02,083220,Chow; Bennett,7,0,32,25
1655986314585,MATH 142A,A03,093480,Staff,4,0,32,28
1655986314585,MATH 142A,B03,093481,Staff,3,0,32,29
1655986314585,MATH 142A,B04,093558,Staff,6,0,32,26
1655986314585,MATH 142A,B05,093559,Staff,0,0,32,32
1655986320623,MATH 193A,A01,083224,Rotar; Vladimir,1,1,34,33
1655986320623,MATH 193A,A02,083225,Rotar; Vladimir,0,0,34,34
1655986320623,MATH 193A,A03,083781,Rotar; Vladimir,2,0,34,32
1655986320623,MATH 193A,A04,083782,Rotar; Vladimir,3,0,34,31
1655986320623,MATH 193A,A05,093482,Rotar; Vladimir,0,0,34,34
1655986326651,MATH 197,001,091859,McAuley; Julian John,9999,0,9999,0
1655986326651,MATH 197,002,095566,Kedlaya; Kiran S.,9997,0,9999,2
1655986326651,MATH 197,003,095567,Xiao; Ming,9999,0,9999,0
1655986326651,MATH 197,004,095571,Perols; Johan Lars,9998,0,9999,1
1655986333741,COGS 9,A01,083615,Shannon; Kyle Michael,3,1,75,72
1655986339768,COGS 11,A01,083617,Boyle; Mary E. T.,11,1,48,37
1655986345797,COGS 13,A01,083071,Bastos; Amalia Pinkusfeld,3,2,71,68
1655986351834,COGS 14A,A01,092681,Semenuks; Arturs,4,25,100,96
1655986357861,COGS 14B,A01,083073,Cheng; Tzu-Han,7,0,63,56
1655986363886,COGS 17,A01,092677,Semenuks; Arturs,8,7,81,73
1655986369917,COGS 100,A01,083619,Allen; Michael Gordon,2,2,70,68
1655986375950,COGS 101A,A01,083621,Davis; Joshua Daniel,4,3,68,64
1655986381978,COGS 101B,A01,091572,Allen; Michael Gordon,0,0,65,65
1655986388012,COGS 101C,A01,083625,Delgado; Tania,7,0,35,28
1655986394042,COGS 107A,A01,083627,Boyle; Mary E. T.,1,2,60,59
1655986400073,COGS 118A,A01,083075,Gupta; Anjum,21,16,76,55
1655986406115,CSE 3,A50,083646,Miranda; Gregory Joseph,14,0,50,36
1655986412146,CSE 8A,A50,083650,Miranda; Gregory Joseph,3,11,56,53
1655986418171,CSE 11,A01,083080,Cao; Yingjun,0,65,40,40
1655986424198,CSE 12,A01,083652,Krause-Levy; Sophia Louisa,6,8,120,114
1655986430229,CSE 15L,A01,083654,Morris; Justin Loren,3,1,50,47
1655986430229,CSE 15L,A02,083655,Morris; Justin Loren,1,1,50,49
1655986436275,CSE 20,A01,083657,Tran; Khoa Dang,29,0,80,51
1655986442308,CSE 21,A01,095574,Bach; Quang Tran,23,0,48,25
1655986448340,CSE 30,A01,083084,Eldon; John,2,10,80,78
1655986448340,CSE 30,B01,095061,Bhaskar; Nishant,0,4,50,50
1655986454370,CSE 100,A01,083659,Cao; Yingjun,2,25,70,68
1655986460400,CSE 134B,A01,083661,Powell; Thomas Allan,6,7,100,94
1655986466430,CSE 140,A01,083663,Gungor; Onat,5,0,85,80
1655986472461,CSE 140L,A01,083088,Eldon; John,5,0,100,95
1655986478496,CSE 175,A01,083665,Kumar; Rakesh,1,0,25,24
1655986484526,CSE 190,A00,092507,Dubnov; Shlomo,1,0,20,19
1655986490560,ECE 45,A01,083139,Congero; Spencer William,0,1,75,75
1655986496595,ECE 65,A50,083695,Saad; Andrew S,6,0,30,24
1655986496595,ECE 65,A51,095125,Staff,23,0,26,3
1655986502632,ECE 109,A01,091882,Touri; Behrouz,2,4,70,68
1655986508659,ECE 180,A00,083140,Abi Samra; Nicholas Camill,1,0,30,29
1655986508659,ECE 180,B00,083141,Abi Samra; Nicholas Camill,0,8,28,28
1655986514689,MATH 10A,A01,083735,Patchell; Gregory David,0,0,30,30
1655986514689,MATH 10A,A02,083736,Patchell; Gregory David,21,0,30,9
1655986514689,MATH 10A,A03,083737,Patchell; Gregory David,16,0,30,14
1655986520720,MATH 10B,A01,083207,Lim; Seonhee,1,1,34,33
1655986520720,MATH 10B,A02,083208,Lim; Seonhee,1,1,35,34
1655986520720,MATH 10B,A03,093472,Staff,1,0,34,33
1655986520720,MATH 10B,B01,083739,Sinha; Shubham,9,0,30,21
1655986526773,MATH 18,A01,083743,Cinel; Cameron Alexander,5,0,30,25
1655986526773,MATH 18,A02,083744,Cinel; Cameron Alexander,11,0,30,19
1655986526773,MATH 18,A03,083745,Cinel; Cameron Alexander,1,0,30,29
1655986526773,MATH 18,B01,083748,Ma; Zilu,2,0,36,34
1655986526773,MATH 18,B02,083749,Ma; Zilu,0,0,36,36
1655986526773,MATH 18,B03,083750,Ma; Zilu,0,0,36,36
1655986526773,MATH 18,B04,083751,Ma; Zilu,0,0,36,36
1655986526773,MATH 18,B05,093473,Staff,0,0,36,36
1655986526773,MATH 18,B06,093474,Staff,1,0,36,35
1655986532799,MATH 20A,A01,083754,Zheng; Zequn,10,0,40,30
1655986538827,MATH 20B,A01,083756,Briones; Jor-el Thomas Caparas,0,1,36,36
1655986538827,MATH 20B,A02,083757,Briones; Jor-el Thomas Caparas,1,0,36,35
1655986538827,MATH 20B,A03,093475,Staff,0,0,36,36
1655986544862,MATH 20C,A01,083760,Briones; Jor-el Thomas Caparas,0,2,35,35
1655986544862,MATH 20C,A02,083761,Briones; Jor-el Thomas Caparas,6,1,35,29
1655986544862,MATH 20C,A03,093476,Staff,1,0,35,34
1655986544862,MATH 20C,B01,083762,Bach; Quang Tran,3,0,30,27
1655986550890,MATH 20D,A01,083765,Tran; Brian Kha,1,0,30,29
1655986550890,MATH 20D,A02,083766,Tran; Brian Kha,0,1,30,30
1655986550890,MATH 20D,A03,083767,Tran; Brian Kha,1,0,30,29
1655986556925,MATH 20E,A01,083771,Ganguly; Soumya,0,1,32,32
1655986556925,MATH 20E,A02,083772,Ganguly; Soumya,1,1,32,31
1655986556925,MATH 20E,B01,083773,Ciotti; Benjamin,14,0,35,21
1655986556925,MATH 20E,B02,083774,Ciotti; Benjamin,12,0,35,23
1655986562952,MATH 103A,A01,083777,Greenfeld; Be'Eri,2,1,36,34
1655986562952,MATH 103A,A02,083778,Greenfeld; Be'Eri,2,0,36,34
1655986562952,MATH 103A,A03,093561,Staff,0,1,36,36
1655986562952,MATH 103A,B01,083779,Greenfeld; Be'Eri,7,1,36,29
1655986562952,MATH 103A,B02,083780,Greenfeld; Be'Eri,0,0,36,36
1655986562952,MATH 103A,B03,093562,Staff,0,0,36,36
1655986568978,MATH 105,A01,085443,Carter; Anne Toulson,4,1,35,31
1655986568978,MATH 105,A02,093477,Staff,8,0,35,27
1655986575012,MATH 109,A01,083213,Ganzberger; Geoffrey Michael,0,1,34,34
1655986575012,MATH 109,A02,083214,Ganzberger; Geoffrey Michael,0,0,34,34
1655986575012,MATH 109,A03,093478,Staff,1,0,34,33
1655986575012,MATH 109,B01,083215,Ganzberger; Geoffrey Michael,2,0,32,30
1655986575012,MATH 109,B02,083216,Ganzberger; Geoffrey Michael,0,0,32,32
1655986575012,MATH 109,B03,093479,Staff,4,0,32,28
1655986581048,MATH 142A,A01,083219,Chow; Bennett,0,0,32,32
1655986581048,MATH 142A,A02,083220,Chow; Bennett,7,0,32,25
1655986581048,MATH 142A,A03,093480,Staff,4,0,32,28
1655986581048,MATH 142A,B03,093481,Staff,3,0,32,29
1655986581048,MATH 142A,B04,093558,Staff,6,0,32,26
1655986581048,MATH 142A,B05,093559,Staff,0,0,32,32
1655986587074,MATH 193A,A01,083224,Rotar; Vladimir,1,1,34,33
1655986587074,MATH 193A,A02,083225,Rotar; Vladimir,0,0,34,34
1655986587074,MATH 193A,A03,083781,Rotar; Vladimir,2,0,34,32
1655986587074,MATH 193A,A04,083782,Rotar; Vladimir,3,0,34,31
1655986587074,MATH 193A,A05,093482,Rotar; Vladimir,0,0,34,34
1655986593109,MATH 197,001,091859,McAuley; Julian John,9999,0,9999,0
1655986593109,MATH 197,002,095566,Kedlaya; Kiran S.,9997,0,9999,2
1655986593109,MATH 197,003,095567,Xiao; Ming,9999,0,9999,0
1655986593109,MATH 197,004,095571,Perols; Johan Lars,9998,0,9999,1
1655986600202,COGS 9,A01,083615,Shannon; Kyle Michael,3,1,75,72
1655986606231,COGS 11,A01,083617,Boyle; Mary E. T.,11,1,48,37
1655986612264,COGS 13,A01,083071,Bastos; Amalia Pinkusfeld,3,2,71,68
1655986618301,COGS 14A,A01,092681,Semenuks; Arturs,4,25,100,96
1655986624331,COGS 14B,A01,083073,Cheng; Tzu-Han,7,0,63,56
1655986630358,COGS 17,A01,092677,Semenuks; Arturs,8,7,81,73
1655986636474,COGS 100,A01,083619,Allen; Michael Gordon,2,2,70,68
1655986642499,COGS 101A,A01,083621,Davis; Joshua Daniel,4,3,68,64
1655986648537,COGS 101B,A01,091572,Allen; Michael Gordon,0,0,65,65
1655986654567,COGS 101C,A01,083625,Delgado; Tania,7,0,35,28
1655986660593,COGS 107A,A01,083627,Boyle; Mary E. T.,1,2,60,59
1655986666637,COGS 118A,A01,083075,Gupta; Anjum,21,16,76,55
1655986672675,CSE 3,A50,083646,Miranda; Gregory Joseph,14,0,50,36
1655986678708,CSE 8A,A50,083650,Miranda; Gregory Joseph,3,11,56,53
1655986684734,CSE 11,A01,083080,Cao; Yingjun,0,65,40,40
1655986690767,CSE 12,A01,083652,Krause-Levy; Sophia Louisa,6,8,120,114
1655986696798,CSE 15L,A01,083654,Morris; Justin Loren,3,1,50,47
1655986696798,CSE 15L,A02,083655,Morris; Justin Loren,1,1,50,49
1655986702823,CSE 20,A01,083657,Tran; Khoa Dang,29,0,80,51
1655986708865,CSE 21,A01,095574,Bach; Quang Tran,23,0,48,25
1655986714900,CSE 30,A01,083084,Eldon; John,2,10,80,78
1655986714900,CSE 30,B01,095061,Bhaskar; Nishant,0,4,50,50
1655986720926,CSE 100,A01,083659,Cao; Yingjun,2,25,70,68
1655986726954,CSE 134B,A01,083661,Powell; Thomas Allan,6,7,100,94
1655986732988,CSE 140,A01,083663,Gungor; Onat,5,0,85,80
1655986739024,CSE 140L,A01,083088,Eldon; John,5,0,100,95
1655986745049,CSE 175,A01,083665,Kumar; Rakesh,1,0,25,24
1655986751087,CSE 190,A00,092507,Dubnov; Shlomo,1,0,20,19
1655986757116,ECE 45,A01,083139,Congero; Spencer William,0,1,75,75
1655986763144,ECE 65,A50,083695,Saad; Andrew S,6,0,30,24
1655986763144,ECE 65,A51,095125,Staff,23,0,26,3
1655986769173,ECE 109,A01,091882,Touri; Behrouz,2,4,70,68
1655986775201,ECE 180,A00,083140,Abi Samra; Nicholas Camill,1,0,30,29
1655986775201,ECE 180,B00,083141,Abi Samra; Nicholas Camill,0,8,28,28
1655986781229,MATH 10A,A01,083735,Patchell; Gregory David,0,0,30,30
1655986781229,MATH 10A,A02,083736,Patchell; Gregory David,21,0,30,9
1655986781229,MATH 10A,A03,083737,Patchell; Gregory David,16,0,30,14
1655986787265,MATH 10B,A01,083207,Lim; Seonhee,1,1,34,33
1655986787265,MATH 10B,A02,083208,Lim; Seonhee,1,1,35,34
1655986787265,MATH 10B,A03,093472,Staff,1,0,34,33
1655986787265,MATH 10B,B01,083739,Sinha; Shubham,9,0,30,21
1655986793298,MATH 18,A01,083743,Cinel; Cameron Alexander,5,0,30,25
1655986793298,MATH 18,A02,083744,Cinel; Cameron Alexander,11,0,30,19
1655986793298,MATH 18,A03,083745,Cinel; Cameron Alexander,1,0,30,29
1655986793298,MATH 18,B01,083748,Ma; Zilu,2,0,36,34
1655986793298,MATH 18,B02,083749,Ma; Zilu,0,0,36,36
1655986793298,MATH 18,B03,083750,Ma; Zilu,0,0,36,36
1655986793298,MATH 18,B04,083751,Ma; Zilu,0,0,36,36
1655986793298,MATH 18,B05,093473,Staff,0,0,36,36
1655986793298,MATH 18,B06,093474,Staff,1,0,36,35
1655986799323,MATH 20A,A01,083754,Zheng; Zequn,10,0,40,30
1655986805357,MATH 20B,A01,083756,Briones; Jor-el Thomas Caparas,0,1,36,36
1655986805357,MATH 20B,A02,083757,Briones; Jor-el Thomas Caparas,1,0,36,35
1655986805357,MATH 20B,A03,093475,Staff,0,0,36,36
1655986811384,MATH 20C,A01,083760,Briones; Jor-el Thomas Caparas,0,2,35,35
1655986811384,MATH 20C,A02,083761,Briones; Jor-el Thomas Caparas,6,1,35,29
1655986811384,MATH 20C,A03,093476,Staff,1,0,35,34
1655986811384,MATH 20C,B01,083762,Bach; Quang Tran,3,0,30,27
1655986817410,MATH 20D,A01,083765,Tran; Brian Kha,1,0,30,29
1655986817410,MATH 20D,A02,083766,Tran; Brian Kha,0,1,30,30
1655986817410,MATH 20D,A03,083767,Tran; Brian Kha,1,0,30,29
1655986823447,MATH 20E,A01,083771,Ganguly; Soumya,0,1,32,32
1655986823447,MATH 20E,A02,083772,Ganguly; Soumya,1,1,32,31
1655986823447,MATH 20E,B01,083773,Ciotti; Benjamin,14,0,35,21
1655986823447,MATH 20E,B02,083774,Ciotti; Benjamin,12,0,35,23
1655986829476,MATH 103A,A01,083777,Greenfeld; Be'Eri,2,1,36,34
1655986829476,MATH 103A,A02,083778,Greenfeld; Be'Eri,2,0,36,34
1655986829476,MATH 103A,A03,093561,Staff,0,1,36,36
1655986829476,MATH 103A,B01,083779,Greenfeld; Be'Eri,7,1,36,29
1655986829476,MATH 103A,B02,083780,Greenfeld; Be'Eri,0,0,36,36
1655986829476,MATH 103A,B03,093562,Staff,0,0,36,36
1655986835513,MATH 105,A01,085443,Carter; Anne Toulson,4,1,35,31
1655986835513,MATH 105,A02,093477,Staff,8,0,35,27
1655986841540,MATH 109,A01,083213,Ganzberger; Geoffrey Michael,0,1,34,34
1655986841540,MATH 109,A02,083214,Ganzberger; Geoffrey Michael,0,0,34,34
1655986841540,MATH 109,A03,093478,Staff,1,0,34,33
1655986841540,MATH 109,B01,083215,Ganzberger; Geoffrey Michael,2,0,32,30
1655986841540,MATH 109,B02,083216,Ganzberger; Geoffrey Michael,0,0,32,32
1655986841540,MATH 109,B03,093479,Staff,4,0,32,28
1655986847578,MATH 142A,A01,083219,Chow; Bennett,0,0,32,32
1655986847578,MATH 142A,A02,083220,Chow; Bennett,7,0,32,25
1655986847578,MATH 142A,A03,093480,Staff,4,0,32,28
1655986847578,MATH 142A,B03,093481,Staff,3,0,32,29
1655986847578,MATH 142A,B04,093558,Staff,6,0,32,26
1655986847578,MATH 142A,B05,093559,Staff,0,0,32,32
1655986853608,MATH 193A,A01,083224,Rotar; Vladimir,1,1,34,33
1655986853608,MATH 193A,A02,083225,Rotar; Vladimir,0,0,34,34
1655986853608,MATH 193A,A03,083781,Rotar; Vladimir,2,0,34,32
1655986853608,MATH 193A,A04,083782,Rotar; Vladimir,3,0,34,31
1655986853608,MATH 193A,A05,093482,Rotar; Vladimir,0,0,34,34
1655986859636,MATH 197,001,091859,McAuley; Julian John,9999,0,9999,0
1655986859636,MATH 197,002,095566,Kedlaya; Kiran S.,9997,0,9999,2
1655986859636,MATH 197,003,095567,Xiao; Ming,9999,0,9999,0
1655986859636,MATH 197,004,095571,Perols; Johan Lars,9998,0,9999,1
1655986866723,COGS 9,A01,083615,Shannon; Kyle Michael,3,1,75,72
1655986872764,COGS 11,A01,083617,Boyle; Mary E. T.,11,1,48,37
1655986878805,COGS 13,A01,083071,Bastos; Amalia Pinkusfeld,3,2,71,68
1655986884836,COGS 14A,A01,092681,Semenuks; Arturs,4,25,100,96
1655986890860,COGS 14B,A01,083073,Cheng; Tzu-Han,7,0,63,56
1655986896901,COGS 17,A01,092677,Semenuks; Arturs,8,7,81,73
1655986902928,COGS 100,A01,083619,Allen; Michael Gordon,2,2,70,68
1655986908955,COGS 101A,A01,083621,Davis; Joshua Daniel,4,3,68,64
1655986914981,COGS 101B,A01,091572,Allen; Michael Gordon,0,0,65,65
1655986921022,COGS 101C,A01,083625,Delgado; Tania,7,0,35,28
1655986927056,COGS 107A,A01,083627,Boyle; Mary E. T.,1,2,60,59
1655986933083,COGS 118A,A01,083075,Gupta; Anjum,21,16,76,55
1655986939113,CSE 3,A50,083646,Miranda; Gregory Joseph,14,0,50,36
1655986945143,CSE 8A,A50,083650,Miranda; Gregory Joseph,3,11,56,53
1655986951175,CSE 11,A01,083080,Cao; Yingjun,0,65,40,40
1655986957199,CSE 12,A01,083652,Krause-Levy; Sophia Louisa,6,8,120,114
1655986963230,CSE 15L,A01,083654,Morris; Justin Loren,3,1,50,47
1655986963230,CSE 15L,A02,083655,Morris; Justin Loren,1,1,50,49
1655986969268,CSE 20,A01,083657,Tran; Khoa Dang,29,0,80,51
1655986975294,CSE 21,A01,095574,Bach; Quang Tran,23,0,48,25
1655986981333,CSE 30,A01,083084,Eldon; John,2,10,80,78
1655986981333,CSE 30,B01,095061,Bhaskar; Nishant,0,4,50,50
1655986987360,CSE 100,A01,083659,Cao; Yingjun,2,25,70,68
1655986993390,CSE 134B,A01,083661,Powell; Thomas Allan,6,7,100,94
1655986999417,CSE 140,A01,083663,Gungor; Onat,5,0,85,80
1655987005441,CSE 140L,A01,083088,Eldon; John,5,0,100,95
1655987011468,CSE 175,A01,083665,Kumar; Rakesh,1,0,25,24
1655987017492,CSE 190,A00,092507,Dubnov; Shlomo,1,0,20,19
1655987023519,ECE 45,A01,083139,Congero; Spencer William,0,1,75,75
1655987029550,ECE 65,A50,083695,Saad; Andrew S,6,0,30,24
1655987029550,ECE 65,A51,095125,Staff,23,0,26,3
1655987035584,ECE 109,A01,091882,Touri; Behrouz,2,4,70,68
1655987041612,ECE 180,A00,083140,Abi Samra; Nicholas Camill,1,0,30,29
1655987041612,ECE 180,B00,083141,Abi Samra; Nicholas Camill,0,8,28,28
1655987047638,MATH 10A,A01,083735,Patchell; Gregory David,0,0,30,30
1655987047638,MATH 10A,A02,083736,Patchell; Gregory David,21,0,30,9
1655987047638,MATH 10A,A03,083737,Patchell; Gregory David,16,0,30,14
1655987053667,MATH 10B,A01,083207,Lim; Seonhee,1,1,34,33
1655987053667,MATH 10B,A02,083208,Lim; Seonhee,1,1,35,34
1655987053667,MATH 10B,A03,093472,Staff,1,0,34,33
1655987053667,MATH 10B,B01,083739,Sinha; Shubham,9,0,30,21
1655987059697,MATH 18,A01,083743,Cinel; Cameron Alexander,5,0,30,25
1655987059697,MATH 18,A02,083744,Cinel; Cameron Alexander,11,0,30,19
1655987059697,MATH 18,A03,083745,Cinel; Cameron Alexander,1,0,30,29
1655987059697,MATH 18,B01,083748,Ma; Zilu,2,0,36,34
1655987059697,MATH 18,B02,083749,Ma; Zilu,0,0,36,36
1655987059697,MATH 18,B03,083750,Ma; Zilu,0,0,36,36
1655987059697,MATH 18,B04,083751,Ma; Zilu,0,0,36,36
1655987059697,MATH 18,B05,093473,Staff,0,0,36,36
1655987059697,MATH 18,B06,093474,Staff,1,0,36,35
1655987065728,MATH 20A,A01,083754,Zheng; Zequn,10,0,40,30
1655987071756,MATH 20B,A01,083756,Briones; Jor-el Thomas Caparas,0,1,36,36
1655987071756,MATH 20B,A02,083757,Briones; Jor-el Thomas Caparas,1,0,36,35
1655987071756,MATH 20B,A03,093475,Staff,0,0,36,36
1655987077782,MATH 20C,A01,083760,Briones; Jor-el Thomas Caparas,0,2,35,35
1655987077782,MATH 20C,A02,083761,Briones; Jor-el Thomas Caparas,6,1,35,29
1655987077782,MATH 20C,A03,093476,Staff,1,0,35,34
1655987077782,MATH 20C,B01,083762,Bach; Quang Tran,3,0,30,27
1655987083817,MATH 20D,A01,083765,Tran; Brian Kha,1,0,30,29
1655987083817,MATH 20D,A02,083766,Tran; Brian Kha,0,1,30,30
1655987083817,MATH 20D,A03,083767,Tran; Brian Kha,1,0,30,29
1655987089844,MATH 20E,A01,083771,Ganguly; Soumya,0,1,32,32
1655987089844,MATH 20E,A02,083772,Ganguly; Soumya,1,1,32,31
1655987089844,MATH 20E,B01,083773,Ciotti; Benjamin,14,0,35,21
1655987089844,MATH 20E,B02,083774,Ciotti; Benjamin,12,0,35,23
1655987095874,MATH 103A,A01,083777,Greenfeld; Be'Eri,2,1,36,34
1655987095874,MATH 103A,A02,083778,Greenfeld; Be'Eri,2,0,36,34
1655987095874,MATH 103A,A03,093561,Staff,0,1,36,36
1655987095874,MATH 103A,B01,083779,Greenfeld; Be'Eri,7,1,36,29
1655987095874,MATH 103A,B02,083780,Greenfeld; Be'Eri,0,0,36,36
1655987095874,MATH 103A,B03,093562,Staff,0,0,36,36
1655987101906,MATH 105,A01,085443,Carter; Anne Toulson,4,1,35,31
1655987101906,MATH 105,A02,093477,Staff,8,0,35,27
1655987107933,MATH 109,A01,083213,Ganzberger; Geoffrey Michael,0,1,34,34
1655987107933,MATH 109,A02,083214,Ganzberger; Geoffrey Michael,0,0,34,34
1655987107933,MATH 109,A03,093478,Staff,1,0,34,33
1655987107933,MATH 109,B01,083215,Ganzberger; Geoffrey Michael,2,0,32,30
1655987107933,MATH 109,B02,083216,Ganzberger; Geoffrey Michael,0,0,32,32
1655987107933,MATH 109,B03,093479,Staff,4,0,32,28
1655987113963,MATH 142A,A01,083219,Chow; Bennett,0,0,32,32
1655987113963,MATH 142A,A02,083220,Chow; Bennett,7,0,32,25
1655987113963,MATH 142A,A03,093480,Staff,4,0,32,28
1655987113963,MATH 142A,B03,093481,Staff,3,0,32,29
1655987113963,MATH 142A,B04,093558,Staff,6,0,32,26
1655987113963,MATH 142A,B05,093559,Staff,0,0,32,32
1655987120007,MATH 193A,A01,083224,Rotar; Vladimir,1,1,34,33
1655987120007,MATH 193A,A02,083225,Rotar; Vladimir,0,0,34,34
1655987120007,MATH 193A,A03,083781,Rotar; Vladimir,2,0,34,32
1655987120007,MATH 193A,A04,083782,Rotar; Vladimir,3,0,34,31
1655987120007,MATH 193A,A05,093482,Rotar; Vladimir,0,0,34,34
1655987126035,MATH 197,001,091859,McAuley; Julian John,9999,0,9999,0
1655987126035,MATH 197,002,095566,Kedlaya; Kiran S.,9997,0,9999,2
1655987126035,MATH 197,003,095567,Xiao; Ming,9999,0,9999,0
1655987126035,MATH 197,004,095571,Perols; Johan Lars,9998,0,9999,1
1655987133128,COGS 9,A01,083615,Shannon; Kyle Michael,3,1,75,72
1655987139158,COGS 11,A01,083617,Boyle; Mary E. T.,11,1,48,37
1655987145189,COGS 13,A01,083071,Bastos; Amalia Pinkusfeld,3,2,71,68
1655987151215,COGS 14A,A01,092681,Semenuks; Arturs,4,25,100,96
1655987157242,COGS 14B,A01,083073,Cheng; Tzu-Han,7,0,63,56
1655987163266,COGS 17,A01,092677,Semenuks; Arturs,8,7,81,73
1655987169298,COGS 100,A01,083619,Allen; Michael Gordon,2,2,70,68
1655987175325,COGS 101A,A01,083621,Davis; Joshua Daniel,4,3,68,64
1655987181354,COGS 101B,A01,091572,Allen; Michael Gordon,0,0,65,65
1655987187386,COGS 101C,A01,083625,Delgado; Tania,7,0,35,28
1655987193413,COGS 107A,A01,083627,Boyle; Mary E. T.,1,2,60,59
1655987199445,COGS 118A,A01,083075,Gupta; Anjum,21,16,76,55
1655987205479,CSE 3,A50,083646,Miranda; Gregory Joseph,14,0,50,36
1655987211511,CSE 8A,A50,083650,Miranda; Gregory Joseph,3,11,56,53
1655987217541,CSE 11,A01,083080,Cao; Yingjun,0,65,40,40
1655987223576,CSE 12,A01,083652,Krause-Levy; Sophia Louisa,6,8,120,114
1655987229604,CSE 15L,A01,083654,Morris; Justin Loren,3,1,50,47
1655987229604,CSE 15L,A02,083655,Morris; Justin Loren,1,1,50,49
1655987235728,CSE 20,A01,083657,Tran; Khoa Dang,29,0,80,51
1655987241760,CSE 21,A01,095574,Bach; Quang Tran,23,0,48,25
1655987247787,CSE 30,A01,083084,Eldon; John,2,10,80,78
1655987247787,CSE 30,B01,095061,Bhaskar; Nishant,0,4,50,50
1655987253814,CSE 100,A01,083659,Cao; Yingjun,2,25,70,68
1655987259844,CSE 134B,A01,083661,Powell; Thomas Allan,6,7,100,94
1655987265872,CSE 140,A01,083663,Gungor; Onat,5,0,85,80
1655987271901,CSE 140L,A01,083088,Eldon; John,5,0,100,95
1655987277930,CSE 175,A01,083665,Kumar; Rakesh,1,0,25,24
1655987283966,CSE 190,A00,092507,Dubnov; Shlomo,1,0,20,19
1655987290000,ECE 45,A01,083139,Congero; Spencer William,0,1,75,75
1655987296029,ECE 65,A50,083695,Saad; Andrew S,6,0,30,24
1655987296029,ECE 65,A51,095125,Staff,23,0,26,3
1655987302062,ECE 109,A01,091882,Touri; Behrouz,2,4,70,68
1655987308089,ECE 180,A00,083140,Abi Samra; Nicholas Camill,1,0,30,29
1655987308089,ECE 180,B00,083141,Abi Samra; Nicholas Camill,0,8,28,28
1655987314123,MATH 10A,A01,083735,Patchell; Gregory David,0,0,30,30
1655987314123,MATH 10A,A02,083736,Patchell; Gregory David,21,0,30,9
1655987314123,MATH 10A,A03,083737,Patchell; Gregory David,16,0,30,14
1655987320166,MATH 10B,A01,083207,Lim; Seonhee,1,1,34,33
1655987320166,MATH 10B,A02,083208,Lim; Seonhee,1,1,35,34
1655987320166,MATH 10B,A03,093472,Staff,1,0,34,33
1655987320166,MATH 10B,B01,083739,Sinha; Shubham,9,0,30,21
1655987326205,MATH 18,A01,083743,Cinel; Cameron Alexander,5,0,30,25
1655987326205,MATH 18,A02,083744,Cinel; Cameron Alexander,11,0,30,19
1655987326205,MATH 18,A03,083745,Cinel; Cameron Alexander,1,0,30,29
1655987326205,MATH 18,B01,083748,Ma; Zilu,2,0,36,34
1655987326205,MATH 18,B02,083749,Ma; Zilu,0,0,36,36
1655987326205,MATH 18,B03,083750,Ma; Zilu,0,0,36,36
1655987326205,MATH 18,B04,083751,Ma; Zilu,0,0,36,36
1655987326205,MATH 18,B05,093473,Staff,0,0,36,36
1655987326205,MATH 18,B06,093474,Staff,1,0,36,35
1655987332248,MATH 20A,A01,083754,Zheng; Zequn,10,0,40,30
1655987338277,MATH 20B,A01,083756,Briones; Jor-el Thomas Caparas,0,1,36,36
1655987338277,MATH 20B,A02,083757,Briones; Jor-el Thomas Caparas,1,0,36,35
1655987338277,MATH 20B,A03,093475,Staff,0,0,36,36
1655987344306,MATH 20C,A01,083760,Briones; Jor-el Thomas Caparas,0,2,35,35
1655987344306,MATH 20C,A02,083761,Briones; Jor-el Thomas Caparas,6,1,35,29
1655987344306,MATH 20C,A03,093476,Staff,1,0,35,34
1655987344306,MATH 20C,B01,083762,Bach; Quang Tran,3,0,30,27
1655987350331,MATH 20D,A01,083765,Tran; Brian Kha,1,0,30,29
1655987350331,MATH 20D,A02,083766,Tran; Brian Kha,0,1,30,30
1655987350331,MATH 20D,A03,083767,Tran; Brian Kha,1,0,30,29
1655987356365,MATH 20E,A01,083771,Ganguly; Soumya,0,1,32,32
1655987356365,MATH 20E,A02,083772,Ganguly; Soumya,1,1,32,31
1655987356365,MATH 20E,B01,083773,Ciotti; Benjamin,14,0,35,21
1655987356365,MATH 20E,B02,083774,Ciotti; Benjamin,12,0,35,23
1655987362392,MATH 103A,A01,083777,Greenfeld; Be'Eri,2,1,36,34
1655987362392,MATH 103A,A02,083778,Greenfeld; Be'Eri,2,0,36,34
1655987362392,MATH 103A,A03,093561,Staff,0,1,36,36
1655987362392,MATH 103A,B01,083779,Greenfeld; Be'Eri,7,1,36,29
1655987362392,MATH 103A,B02,083780,Greenfeld; Be'Eri,0,0,36,36
1655987362392,MATH 103A,B03,093562,Staff,0,0,36,36
1655987368418,MATH 105,A01,085443,Carter; Anne Toulson,4,1,35,31
1655987368418,MATH 105,A02,093477,Staff,8,0,35,27
1655987374445,MATH 109,A01,083213,Ganzberger; Geoffrey Michael,0,1,34,34
1655987374445,MATH 109,A02,083214,Ganzberger; Geoffrey Michael,0,0,34,34
1655987374445,MATH 109,A03,093478,Staff,1,0,34,33
1655987374445,MATH 109,B01,083215,Ganzberger; Geoffrey Michael,2,0,32,30
1655987374445,MATH 109,B02,083216,Ganzberger; Geoffrey Michael,0,0,32,32
1655987374445,MATH 109,B03,093479,Staff,4,0,32,28
1655987380472,MATH 142A,A01,083219,Chow; Bennett,0,0,32,32
1655987380472,MATH 142A,A02,083220,Chow; Bennett,7,0,32,25
1655987380472,MATH 142A,A03,093480,Staff,4,0,32,28
1655987380472,MATH 142A,B03,093481,Staff,3,0,32,29
1655987380472,MATH 142A,B04,093558,Staff,6,0,32,26
1655987380472,MATH 142A,B05,093559,Staff,0,0,32,32
1655987386498,MATH 193A,A01,083224,Rotar; Vladimir,1,1,34,33
1655987386498,MATH 193A,A02,083225,Rotar; Vladimir,0,0,34,34
1655987386498,MATH 193A,A03,083781,Rotar; Vladimir,2,0,34,32
1655987386498,MATH 193A,A04,083782,Rotar; Vladimir,3,0,34,31
1655987386498,MATH 193A,A05,093482,Rotar; Vladimir,0,0,34,34
1655987392532,MATH 197,001,091859,McAuley; Julian John,9999,0,9999,0
1655987392532,MATH 197,002,095566,Kedlaya; Kiran S.,9997,0,9999,2
1655987392532,MATH 197,003,095567,Xiao; Ming,9999,0,9999,0
1655987392532,MATH 197,004,095571,Perols; Johan Lars,9998,0,9999,1
1655987399598,COGS 9,A01,083615,Shannon; Kyle Michael,3,1,75,72
1655987405625,COGS 11,A01,083617,Boyle; Mary E. T.,11,1,48,37
1655987411654,COGS 13,A01,083071,Bastos; Amalia Pinkusfeld,3,2,71,68
1655987417685,COGS 14A,A01,092681,Semenuks; Arturs,4,25,100,96
1655987423711,COGS 14B,A01,083073,Cheng; Tzu-Han,7,0,63,56
1655987429742,COGS 17,A01,092677,Semenuks; Arturs,8,7,81,73
1655987435768,COGS 100,A01,083619,Allen; Michael Gordon,2,2,70,68
1655987441803,COGS 101A,A01,083621,Davis; Joshua Daniel,4,3,68,64
1655987447828,COGS 101B,A01,091572,Allen; Michael Gordon,0,0,65,65
1655987453870,COGS 101C,A01,083625,Delgado; Tania,7,0,35,28
1655987459897,COGS 107A,A01,083627,Boyle; Mary E. T.,1,2,60,59
1655987465925,COGS 118A,A01,083075,Gupta; Anjum,21,16,76,55
1655987471951,CSE 3,A50,083646,Miranda; Gregory Joseph,14,0,50,36
1655987477992,CSE 8A,A50,083650,Miranda; Gregory Joseph,3,11,56,53
1655987484019,CSE 11,A01,083080,Cao; Yingjun,0,65,40,40
1655987490047,CSE 12,A01,083652,Krause-Levy; Sophia Louisa,6,8,120,114
1655987496088,CSE 15L,A01,083654,Morris; Justin Loren,3,1,50,47
1655987496088,CSE 15L,A02,083655,Morris; Justin Loren,1,1,50,49
1655987502120,CSE 20,A01,083657,Tran; Khoa Dang,29,0,80,51
1655987508152,CSE 21,A01,095574,Bach; Quang Tran,23,0,48,25
1655987514192,CSE 30,A01,083084,Eldon; John,2,10,80,78
1655987514192,CSE 30,B01,095061,Bhaskar; Nishant,0,4,50,50
1655987520223,CSE 100,A01,083659,Cao; Yingjun,2,25,70,68
1655987526252,CSE 134B,A01,083661,Powell; Thomas Allan,6,7,100,94
1655987532287,CSE 140,A01,083663,Gungor; Onat,5,0,85,80
1655987538314,CSE 140L,A01,083088,Eldon; John,5,0,100,95
1655987544341,CSE 175,A01,083665,Kumar; Rakesh,1,0,25,24
1655987550367,CSE 190,A00,092507,Dubnov; Shlomo,1,0,20,19
1655987556405,ECE 45,A01,083139,Congero; Spencer William,0,1,75,75
1655987562434,ECE 65,A50,083695,Saad; Andrew S,6,0,30,24
1655987562434,ECE 65,A51,095125,Staff,23,0,26,3
1655987568462,ECE 109,A01,091882,Touri; Behrouz,2,4,70,68
1655987574488,ECE 180,A00,083140,Abi Samra; Nicholas Camill,1,0,30,29
1655987574488,ECE 180,B00,083141,Abi Samra; Nicholas Camill,0,8,28,28
1655987580529,MATH 10A,A01,083735,Patchell; Gregory David,0,0,30,30
1655987580529,MATH 10A,A02,083736,Patchell; Gregory David,21,0,30,9
1655987580529,MATH 10A,A03,083737,Patchell; Gregory David,16,0,30,14
1655987586570,MATH 10B,A01,083207,Lim; Seonhee,1,1,34,33
1655987586570,MATH 10B,A02,083208,Lim; Seonhee,1,1,35,34
1655987586570,MATH 10B,A03,093472,Staff,1,0,34,33
1655987586570,MATH 10B,B01,083739,Sinha; Shubham,9,0,30,21
1655987592599,MATH 18,A01,083743,Cinel; Cameron Alexander,5,0,30,25
1655987592599,MATH 18,A02,083744,Cinel; Cameron Alexander,11,0,30,19
1655987592599,MATH 18,A03,083745,Cinel; Cameron Alexander,1,0,30,29
1655987592599,MATH 18,B01,083748,Ma; Zilu,2,0,36,34
1655987592599,MATH 18,B02,083749,Ma; Zilu,0,0,36,36
1655987592599,MATH 18,B03,083750,Ma; Zilu,0,0,36,36
1655987592599,MATH 18,B04,083751,Ma; Zilu,0,0,36,36
1655987592599,MATH 18,B05,093473,Staff,0,0,36,36
1655987592599,MATH 18,B06,093474,Staff,1,0,36,35
1655987598627,MATH 20A,A01,083754,Zheng; Zequn,10,0,40,30
1655987604654,MATH 20B,A01,083756,Briones; Jor-el Thomas Caparas,0,1,36,36
1655987604654,MATH 20B,A02,083757,Briones; Jor-el Thomas Caparas,1,0,36,35
1655987604654,MATH 20B,A03,093475,Staff,0,0,36,36
1655987610684,MATH 20C,A01,083760,Briones; Jor-el Thomas Caparas,0,2,35,35
1655987610684,MATH 20C,A02,083761,Briones; Jor-el Thomas Caparas,6,1,35,29
1655987610684,MATH 20C,A03,093476,Staff,1,0,35,34
1655987610684,MATH 20C,B01,083762,Bach; Quang Tran,3,0,30,27
1655987616708,MATH 20D,A01,083765,Tran; Brian Kha,1,0,30,29
1655987616708,MATH 20D,A02,083766,Tran; Brian Kha,0,1,30,30
1655987616708,MATH 20D,A03,083767,Tran; Brian Kha,1,0,30,29
1655987622743,MATH 20E,A01,083771,Ganguly; Soumya,0,1,32,32
1655987622743,MATH 20E,A02,083772,Ganguly; Soumya,1,1,32,31
1655987622743,MATH 20E,B01,083773,Ciotti; Benjamin,14,0,35,21
1655987622743,MATH 20E,B02,083774,Ciotti; Benjamin,12,0,35,23
1655987628777,MATH 103A,A01,083777,Greenfeld; Be'Eri,2,1,36,34
1655987628777,MATH 103A,A02,083778,Greenfeld; Be'Eri,2,0,36,34
1655987628777,MATH 103A,A03,093561,Staff,0,1,36,36
1655987628777,MATH 103A,B01,083779,Greenfeld; Be'Eri,7,1,36,29
1655987628777,MATH 103A,B02,083780,Greenfeld; Be'Eri,0,0,36,36
1655987628777,MATH 103A,B03,093562,Staff,0,0,36,36
1655987634804,MATH 105,A01,085443,Carter; Anne Toulson,4,1,35,31
1655987634804,MATH 105,A02,093477,Staff,8,0,35,27
1655987640836,MATH 109,A01,083213,Ganzberger; Geoffrey Michael,0,1,34,34
1655987640836,MATH 109,A02,083214,Ganzberger; Geoffrey Michael,0,0,34,34
1655987640836,MATH 109,A03,093478,Staff,1,0,34,33
1655987640836,MATH 109,B01,083215,Ganzberger; Geoffrey Michael,2,0,32,30
1655987640836,MATH 109,B02,083216,Ganzberger; Geoffrey Michael,0,0,32,32
1655987640836,MATH 109,B03,093479,Staff,4,0,32,28
1655987646878,MATH 142A,A01,083219,Chow; Bennett,0,0,32,32
1655987646878,MATH 142A,A02,083220,Chow; Bennett,7,0,32,25
1655987646878,MATH 142A,A03,093480,Staff,4,0,32,28
1655987646878,MATH 142A,B03,093481,Staff,3,0,32,29
1655987646878,MATH 142A,B04,093558,Staff,6,0,32,26
1655987646878,MATH 142A,B05,093559,Staff,0,0,32,32
1655987652906,MATH 193A,A01,083224,Rotar; Vladimir,1,1,34,33
1655987652906,MATH 193A,A02,083225,Rotar; Vladimir,0,0,34,34
1655987652906,MATH 193A,A03,083781,Rotar; Vladimir,2,0,34,32
1655987652906,MATH 193A,A04,083782,Rotar; Vladimir,3,0,34,31
1655987652906,MATH 193A,A05,093482,Rotar; Vladimir,0,0,34,34
1655987658937,MATH 197,001,091859,McAuley; Julian John,9999,0,9999,0
1655987658937,MATH 197,002,095566,Kedlaya; Kiran S.,9997,0,9999,2
1655987658937,MATH 197,003,095567,Xiao; Ming,9999,0,9999,0
1655987658937,MATH 197,004,095571,Perols; Johan Lars,9998,0,9999,1
1655987666035,COGS 9,A01,083615,Shannon; Kyle Michael,3,1,75,72
1655987672085,COGS 11,A01,083617,Boyle; Mary E. T.,11,1,48,37
1655987678117,COGS 13,A01,083071,Bastos; Amalia Pinkusfeld,3,2,71,68
1655987684149,COGS 14A,A01,092681,Semenuks; Arturs,4,25,100,96
1655987690177,COGS 14B,A01,083073,Cheng; Tzu-Han,7,0,63,56
1655987696211,COGS 17,A01,092677,Semenuks; Arturs,8,7,81,73
1655987702249,COGS 100,A01,083619,Allen; Michael Gordon,2,2,70,68
1655987708286,COGS 101A,A01,083621,Davis; Joshua Daniel,4,3,68,64
1655987714326,COGS 101B,A01,091572,Allen; Michael Gordon,0,0,65,65
1655987720360,COGS 101C,A01,083625,Delgado; Tania,7,0,35,28
1655987726394,COGS 107A,A01,083627,Boyle; Mary E. T.,1,2,60,59
1655987732435,COGS 118A,A01,083075,Gupta; Anjum,21,16,76,55
1655987738466,CSE 3,A50,083646,Miranda; Gregory Joseph,14,0,50,36
1655987744494,CSE 8A,A50,083650,Miranda; Gregory Joseph,3,11,56,53
1655987750519,CSE 11,A01,083080,Cao; Yingjun,0,65,40,40
1655987756550,CSE 12,A01,083652,Krause-Levy; Sophia Louisa,6,8,120,114
1655987762577,CSE 15L,A01,083654,Morris; Justin Loren,3,1,50,47
1655987762577,CSE 15L,A02,083655,Morris; Justin Loren,1,1,50,49
1655987768604,CSE 20,A01,083657,Tran; Khoa Dang,29,0,80,51
1655987774640,CSE 21,A01,095574,Bach; Quang Tran,23,0,48,25
1655987780680,CSE 30,A01,083084,Eldon; John,2,10,80,78
1655987780680,CSE 30,B01,095061,Bhaskar; Nishant,0,4,50,50
1655987786706,CSE 100,A01,083659,Cao; Yingjun,2,25,70,68
1655987792733,CSE 134B,A01,083661,Powell; Thomas Allan,6,7,100,94
1655987798761,CSE 140,A01,083663,Gungor; Onat,5,0,85,80
1655987804788,CSE 140L,A01,083088,Eldon; John,5,0,100,95
1655987810818,CSE 175,A01,083665,Kumar; Rakesh,1,0,25,24
1655987816853,CSE 190,A00,092507,Dubnov; Shlomo,1,0,20,19
1655987822883,ECE 45,A01,083139,Congero; Spencer William,0,1,75,75
1655987828916,ECE 65,A50,083695,Saad; Andrew S,6,0,30,24
1655987828916,ECE 65,A51,095125,Staff,23,0,26,3
1655987835023,ECE 109,A01,091882,Touri; Behrouz,2,4,70,68
1655987841056,ECE 180,A00,083140,Abi Samra; Nicholas Camill,1,0,30,29
1655987841056,ECE 180,B00,083141,Abi Samra; Nicholas Camill,0,8,28,28
1655987847108,MATH 10A,A01,083735,Patchell; Gregory David,0,0,30,30
1655987847108,MATH 10A,A02,083736,Patchell; Gregory David,21,0,30,9
1655987847108,MATH 10A,A03,083737,Patchell; Gregory David,16,0,30,14
1655987853141,MATH 10B,A01,083207,Lim; Seonhee,1,1,34,33
1655987853141,MATH 10B,A02,083208,Lim; Seonhee,1,1,35,34
1655987853141,MATH 10B,A03,093472,Staff,1,0,34,33
1655987853141,MATH 10B,B01,083739,Sinha; Shubham,9,0,30,21
1655987859178,MATH 18,A01,083743,Cinel; Cameron Alexander,5,0,30,25
1655987859178,MATH 18,A02,083744,Cinel; Cameron Alexander,11,0,30,19
1655987859178,MATH 18,A03,083745,Cinel; Cameron Alexander,1,0,30,29
1655987859178,MATH 18,B01,083748,Ma; Zilu,2,0,36,34
1655987859178,MATH 18,B02,083749,Ma; Zilu,0,0,36,36
1655987859178,MATH 18,B03,083750,Ma; Zilu,0,0,36,36
1655987859178,MATH 18,B04,083751,Ma; Zilu,0,0,36,36
1655987859178,MATH 18,B05,093473,Staff,0,0,36,36
1655987859178,MATH 18,B06,093474,Staff,1,0,36,35
1655987865217,MATH 20A,A01,083754,Zheng; Zequn,10,0,40,30
1655987871245,MATH 20B,A01,083756,Briones; Jor-el Thomas Caparas,0,1,36,36
1655987871245,MATH 20B,A02,083757,Briones; Jor-el Thomas Caparas,1,0,36,35
1655987871245,MATH 20B,A03,093475,Staff,0,0,36,36
1655987877277,MATH 20C,A01,083760,Briones; Jor-el Thomas Caparas,0,2,35,35
1655987877277,MATH 20C,A02,083761,Briones; Jor-el Thomas Caparas,6,1,35,29
1655987877277,MATH 20C,A03,093476,Staff,0,0,35,35
1655987877277,MATH 20C,B01,083762,Bach; Quang Tran,3,0,30,27
1655987883311,MATH 20D,A01,083765,Tran; Brian Kha,1,0,30,29
1655987883311,MATH 20D,A02,083766,Tran; Brian Kha,0,1,30,30
1655987883311,MATH 20D,A03,083767,Tran; Brian Kha,1,0,30,29
1655987889350,MATH 20E,A01,083771,Ganguly; Soumya,0,1,32,32
1655987889350,MATH 20E,A02,083772,Ganguly; Soumya,1,1,32,31
1655987889350,MATH 20E,B01,083773,Ciotti; Benjamin,14,0,35,21
1655987889350,MATH 20E,B02,083774,Ciotti; Benjamin,12,0,35,23
1655987895383,MATH 103A,A01,083777,Greenfeld; Be'Eri,2,1,36,34
1655987895383,MATH 103A,A02,083778,Greenfeld; Be'Eri,2,0,36,34
1655987895383,MATH 103A,A03,093561,Staff,0,1,36,36
1655987895383,MATH 103A,B01,083779,Greenfeld; Be'Eri,7,1,36,29
1655987895383,MATH 103A,B02,083780,Greenfeld; Be'Eri,0,0,36,36
1655987895383,MATH 103A,B03,093562,Staff,0,0,36,36
1655987901441,MATH 105,A01,085443,Carter; Anne Toulson,4,1,35,31
1655987901441,MATH 105,A02,093477,Staff,8,0,35,27
1655987907497,MATH 109,A01,083213,Ganzberger; Geoffrey Michael,0,1,34,34
1655987907497,MATH 109,A02,083214,Ganzberger; Geoffrey Michael,0,0,34,34
1655987907497,MATH 109,A03,093478,Staff,1,0,34,33
1655987907497,MATH 109,B01,083215,Ganzberger; Geoffrey Michael,2,0,32,30
1655987907497,MATH 109,B02,083216,Ganzberger; Geoffrey Michael,0,0,32,32
1655987907497,MATH 109,B03,093479,Staff,4,0,32,28
1655987913527,MATH 142A,A01,083219,Chow; Bennett,0,0,32,32
1655987913527,MATH 142A,A02,083220,Chow; Bennett,7,0,32,25
1655987913527,MATH 142A,A03,093480,Staff,4,0,32,28
1655987913527,MATH 142A,B03,093481,Staff,3,0,32,29
1655987913527,MATH 142A,B04,093558,Staff,6,0,32,26
1655987913527,MATH 142A,B05,093559,Staff,0,0,32,32
1655987919567,MATH 193A,A01,083224,Rotar; Vladimir,1,1,34,33
1655987919567,MATH 193A,A02,083225,Rotar; Vladimir,0,0,34,34
1655987919567,MATH 193A,A03,083781,Rotar; Vladimir,2,0,34,32
1655987919567,MATH 193A,A04,083782,Rotar; Vladimir,3,0,34,31
1655987919567,MATH 193A,A05,093482,Rotar; Vladimir,0,0,34,34
1655987925593,MATH 197,001,091859,McAuley; Julian John,9999,0,9999,0
1655987925593,MATH 197,002,095566,Kedlaya; Kiran S.,9997,0,9999,2
1655987925593,MATH 197,003,095567,Xiao; Ming,9999,0,9999,0
1655987925593,MATH 197,004,095571,Perols; Johan Lars,9998,0,9999,1
1655987932684,COGS 9,A01,083615,Shannon; Kyle Michael,3,1,75,72
1655987938723,COGS 11,A01,083617,Boyle; Mary E. T.,11,1,48,37
1655987944755,COGS 13,A01,083071,Bastos; Amalia Pinkusfeld,3,2,71,68
1655987950792,COGS 14A,A01,092681,Semenuks; Arturs,4,25,100,96
1655987956819,COGS 14B,A01,083073,Cheng; Tzu-Han,7,0,63,56
1655987962844,COGS 17,A01,092677,Semenuks; Arturs,8,7,81,73
1655987968878,COGS 100,A01,083619,Allen; Michael Gordon,2,2,70,68
1655987974913,COGS 101A,A01,083621,Davis; Joshua Daniel,4,3,68,64
1655987980939,COGS 101B,A01,091572,Allen; Michael Gordon,0,0,65,65
1655987986967,COGS 101C,A01,083625,Delgado; Tania,7,0,35,28
1655987992998,COGS 107A,A01,083627,Boyle; Mary E. T.,1,2,60,59
1655987999026,COGS 118A,A01,083075,Gupta; Anjum,21,16,76,55
1655988005055,CSE 3,A50,083646,Miranda; Gregory Joseph,14,0,50,36
1655988011087,CSE 8A,A50,083650,Miranda; Gregory Joseph,3,11,56,53
1655988017118,CSE 11,A01,083080,Cao; Yingjun,0,65,40,40
1655988023145,CSE 12,A01,083652,Krause-Levy; Sophia Louisa,6,8,120,114
1655988029181,CSE 15L,A01,083654,Morris; Justin Loren,3,1,50,47
1655988029181,CSE 15L,A02,083655,Morris; Justin Loren,1,1,50,49
1655988035224,CSE 20,A01,083657,Tran; Khoa Dang,29,0,80,51
1655988041256,CSE 21,A01,095574,Bach; Quang Tran,23,0,48,25
1655988047295,CSE 30,A01,083084,Eldon; John,2,10,80,78
1655988047295,CSE 30,B01,095061,Bhaskar; Nishant,0,4,50,50
1655988053327,CSE 100,A01,083659,Cao; Yingjun,2,25,70,68
1655988059357,CSE 134B,A01,083661,Powell; Thomas Allan,6,7,100,94
1655988065384,CSE 140,A01,083663,Gungor; Onat,5,0,85,80
1655988071413,CSE 140L,A01,083088,Eldon; John,5,0,100,95
1655988077444,CSE 175,A01,083665,Kumar; Rakesh,1,0,25,24
1655988083472,CSE 190,A00,092507,Dubnov; Shlomo,1,0,20,19
1655988089520,ECE 45,A01,083139,Congero; Spencer William,0,1,75,75
1655988095566,ECE 65,A50,083695,Saad; Andrew S,6,0,30,24
1655988095566,ECE 65,A51,095125,Staff,23,0,26,3
1655988101603,ECE 109,A01,091882,Touri; Behrouz,2,4,70,68
1655988107630,ECE 180,A00,083140,Abi Samra; Nicholas Camill,1,0,30,29
1655988107630,ECE 180,B00,083141,Abi Samra; Nicholas Camill,0,8,28,28
1655988113749,MATH 10A,A01,083735,Patchell; Gregory David,0,0,30,30
1655988113749,MATH 10A,A02,083736,Patchell; Gregory David,21,0,30,9
1655988113749,MATH 10A,A03,083737,Patchell; Gregory David,16,0,30,14
1655988119918,MATH 10B,A01,083207,Lim; Seonhee,1,1,34,33
1655988119918,MATH 10B,A02,083208,Lim; Seonhee,1,1,35,34
1655988119918,MATH 10B,A03,093472,Staff,1,0,34,33
1655988119918,MATH 10B,B01,083739,Sinha; Shubham,9,0,30,21
1655988125959,MATH 18,A01,083743,Cinel; Cameron Alexander,5,0,30,25
1655988125959,MATH 18,A02,083744,Cinel; Cameron Alexander,11,0,30,19
1655988125959,MATH 18,A03,083745,Cinel; Cameron Alexander,1,0,30,29
1655988125959,MATH 18,B01,083748,Ma; Zilu,2,0,36,34
1655988125959,MATH 18,B02,083749,Ma; Zilu,0,0,36,36
1655988125959,MATH 18,B03,083750,Ma; Zilu,0,0,36,36
1655988125959,MATH 18,B04,083751,Ma; Zilu,0,0,36,36
1655988125959,MATH 18,B05,093473,Staff,0,0,36,36
1655988125959,MATH 18,B06,093474,Staff,1,0,36,35
1655988131992,MATH 20A,A01,083754,Zheng; Zequn,10,0,40,30
1655988138020,MATH 20B,A01,083756,Briones; Jor-el Thomas Caparas,0,1,36,36
1655988138020,MATH 20B,A02,083757,Briones; Jor-el Thomas Caparas,1,0,36,35
1655988138020,MATH 20B,A03,093475,Staff,0,0,36,36
1655988144068,MATH 20C,A01,083760,Briones; Jor-el Thomas Caparas,0,2,35,35
1655988144068,MATH 20C,A02,083761,Briones; Jor-el Thomas Caparas,6,1,35,29
1655988144068,MATH 20C,A03,093476,Staff,0,0,35,35
1655988144068,MATH 20C,B01,083762,Bach; Quang Tran,3,0,30,27
1655988150095,MATH 20D,A01,083765,Tran; Brian Kha,1,0,30,29
1655988150095,MATH 20D,A02,083766,Tran; Brian Kha,0,1,30,30
1655988150095,MATH 20D,A03,083767,Tran; Brian Kha,1,0,30,29
1655988156150,MATH 20E,A01,083771,Ganguly; Soumya,0,1,32,32
1655988156150,MATH 20E,A02,083772,Ganguly; Soumya,1,1,32,31
1655988156150,MATH 20E,B01,083773,Ciotti; Benjamin,14,0,35,21
1655988156150,MATH 20E,B02,083774,Ciotti; Benjamin,12,0,35,23
1655988162192,MATH 103A,A01,083777,Greenfeld; Be'Eri,2,1,36,34
1655988162192,MATH 103A,A02,083778,Greenfeld; Be'Eri,2,0,36,34
1655988162192,MATH 103A,A03,093561,Staff,0,1,36,36
1655988162192,MATH 103A,B01,083779,Greenfeld; Be'Eri,7,1,36,29
1655988162192,MATH 103A,B02,083780,Greenfeld; Be'Eri,0,0,36,36
1655988162192,MATH 103A,B03,093562,Staff,0,0,36,36
1655988168226,MATH 105,A01,085443,Carter; Anne Toulson,4,1,35,31
1655988168226,MATH 105,A02,093477,Staff,8,0,35,27
1655988174284,MATH 109,A01,083213,Ganzberger; Geoffrey Michael,0,1,34,34
1655988174284,MATH 109,A02,083214,Ganzberger; Geoffrey Michael,0,0,34,34
1655988174284,MATH 109,A03,093478,Staff,1,0,34,33
1655988174284,MATH 109,B01,083215,Ganzberger; Geoffrey Michael,2,0,32,30
1655988174284,MATH 109,B02,083216,Ganzberger; Geoffrey Michael,0,0,32,32
1655988174284,MATH 109,B03,093479,Staff,4,0,32,28
1655988180377,MATH 142A,A01,083219,Chow; Bennett,0,0,32,32
1655988180377,MATH 142A,A02,083220,Chow; Bennett,7,0,32,25
1655988180377,MATH 142A,A03,093480,Staff,4,0,32,28
1655988180377,MATH 142A,B03,093481,Staff,3,0,32,29
1655988180377,MATH 142A,B04,093558,Staff,6,0,32,26
1655988180377,MATH 142A,B05,093559,Staff,0,0,32,32
1655988186414,MATH 193A,A01,083224,Rotar; Vladimir,1,1,34,33
1655988186414,MATH 193A,A02,083225,Rotar; Vladimir,0,0,34,34
1655988186414,MATH 193A,A03,083781,Rotar; Vladimir,2,0,34,32
1655988186414,MATH 193A,A04,083782,Rotar; Vladimir,3,0,34,31
1655988186414,MATH 193A,A05,093482,Rotar; Vladimir,0,0,34,34
1655988192443,MATH 197,001,091859,McAuley; Julian John,9999,0,9999,0
1655988192443,MATH 197,002,095566,Kedlaya; Kiran S.,9997,0,9999,2
1655988192443,MATH 197,003,095567,Xiao; Ming,9999,0,9999,0
1655988192443,MATH 197,004,095571,Perols; Johan Lars,9998,0,9999,1
1655988199520,COGS 9,A01,083615,Shannon; Kyle Michael,3,1,75,72
1655988205546,COGS 11,A01,083617,Boyle; Mary E. T.,11,1,48,37
1655988211608,COGS 13,A01,083071,Bastos; Amalia Pinkusfeld,3,2,71,68
1655988217635,COGS 14A,A01,092681,Semenuks; Arturs,4,25,100,96
1655988223680,COGS 14B,A01,083073,Cheng; Tzu-Han,7,0,63,56
1655988229707,COGS 17,A01,092677,Semenuks; Arturs,8,7,81,73
1655988235744,COGS 100,A01,083619,Allen; Michael Gordon,2,2,70,68
1655988241781,COGS 101A,A01,083621,Davis; Joshua Daniel,4,3,68,64
1655988247808,COGS 101B,A01,091572,Allen; Michael Gordon,0,0,65,65
1655988253842,COGS 101C,A01,083625,Delgado; Tania,7,0,35,28
1655988259889,COGS 107A,A01,083627,Boyle; Mary E. T.,1,2,60,59
1655988265917,COGS 118A,A01,083075,Gupta; Anjum,21,16,76,55
1655988271949,CSE 3,A50,083646,Miranda; Gregory Joseph,14,0,50,36
1655988277982,CSE 8A,A50,083650,Miranda; Gregory Joseph,3,11,56,53
1655988284015,CSE 11,A01,083080,Cao; Yingjun,0,65,40,40
1655988290044,CSE 12,A01,083652,Krause-Levy; Sophia Louisa,6,8,120,114
1655988296080,CSE 15L,A01,083654,Morris; Justin Loren,3,1,50,47
1655988296080,CSE 15L,A02,083655,Morris; Justin Loren,1,1,50,49
1655988302105,CSE 20,A01,083657,Tran; Khoa Dang,29,0,80,51
1655988308132,CSE 21,A01,095574,Bach; Quang Tran,23,0,48,25
1655988314162,CSE 30,A01,083084,Eldon; John,2,10,80,78
1655988314162,CSE 30,B01,095061,Bhaskar; Nishant,0,4,50,50
1655988320215,CSE 100,A01,083659,Cao; Yingjun,2,25,70,68
1655988326246,CSE 134B,A01,083661,Powell; Thomas Allan,6,7,100,94
1655988332277,CSE 140,A01,083663,Gungor; Onat,5,0,85,80
1655988338312,CSE 140L,A01,083088,Eldon; John,5,0,100,95
1655988344340,CSE 175,A01,083665,Kumar; Rakesh,1,0,25,24
1655988350368,CSE 190,A00,092507,Dubnov; Shlomo,1,0,20,19
1655988356402,ECE 45,A01,083139,Congero; Spencer William,0,1,75,75
1655988362429,ECE 65,A50,083695,Saad; Andrew S,6,0,30,24
1655988362429,ECE 65,A51,095125,Staff,23,0,26,3
1655988370328,ECE 109,A01,091882,Touri; Behrouz,2,4,70,68
1655988376355,ECE 180,A00,083140,Abi Samra; Nicholas Camill,1,0,30,29
1655988376355,ECE 180,B00,083141,Abi Samra; Nicholas Camill,0,8,28,28
1655988382393,MATH 10A,A01,083735,Patchell; Gregory David,0,0,30,30
1655988382393,MATH 10A,A02,083736,Patchell; Gregory David,21,0,30,9
1655988382393,MATH 10A,A03,083737,Patchell; Gregory David,16,0,30,14
1655988388429,MATH 10B,A01,083207,Lim; Seonhee,1,1,34,33
1655988388429,MATH 10B,A02,083208,Lim; Seonhee,1,1,35,34
1655988388429,MATH 10B,A03,093472,Staff,1,0,34,33
1655988388429,MATH 10B,B01,083739,Sinha; Shubham,9,0,30,21
1655988394479,MATH 18,A01,083743,Cinel; Cameron Alexander,5,0,30,25
1655988394479,MATH 18,A02,083744,Cinel; Cameron Alexander,11,0,30,19
1655988394479,MATH 18,A03,083745,Cinel; Cameron Alexander,1,0,30,29
1655988394479,MATH 18,B01,083748,Ma; Zilu,2,0,36,34
1655988394479,MATH 18,B02,083749,Ma; Zilu,0,0,36,36
1655988394479,MATH 18,B03,083750,Ma; Zilu,0,0,36,36
1655988394479,MATH 18,B04,083751,Ma; Zilu,0,0,36,36
1655988394479,MATH 18,B05,093473,Staff,0,0,36,36
1655988394479,MATH 18,B06,093474,Staff,1,0,36,35
1655988400509,MATH 20A,A01,083754,Zheng; Zequn,10,0,40,30
1655988406536,MATH 20B,A01,083756,Briones; Jor-el Thomas Caparas,0,1,36,36
1655988406536,MATH 20B,A02,083757,Briones; Jor-el Thomas Caparas,1,0,36,35
1655988406536,MATH 20B,A03,093475,Staff,0,0,36,36
1655988412572,MATH 20C,A01,083760,Briones; Jor-el Thomas Caparas,0,2,35,35
1655988412572,MATH 20C,A02,083761,Briones; Jor-el Thomas Caparas,6,1,35,29
1655988412572,MATH 20C,A03,093476,Staff,0,0,35,35
1655988412572,MATH 20C,B01,083762,Bach; Quang Tran,3,0,30,27
1655988418602,MATH 20D,A01,083765,Tran; Brian Kha,1,0,30,29
1655988418602,MATH 20D,A02,083766,Tran; Brian Kha,0,1,30,30
1655988418602,MATH 20D,A03,083767,Tran; Brian Kha,1,0,30,29
1655988424629,MATH 20E,A01,083771,Ganguly; Soumya,0,1,32,32
1655988424629,MATH 20E,A02,083772,Ganguly; Soumya,1,1,32,31
1655988424629,MATH 20E,B01,083773,Ciotti; Benjamin,14,0,35,21
1655988424629,MATH 20E,B02,083774,Ciotti; Benjamin,12,0,35,23
1655988430657,MATH 103A,A01,083777,Greenfeld; Be'Eri,2,1,36,34
1655988430657,MATH 103A,A02,083778,Greenfeld; Be'Eri,2,0,36,34
1655988430657,MATH 103A,A03,093561,Staff,0,1,36,36
1655988430657,MATH 103A,B01,083779,Greenfeld; Be'Eri,7,1,36,29
1655988430657,MATH 103A,B02,083780,Greenfeld; Be'Eri,0,0,36,36
1655988430657,MATH 103A,B03,093562,Staff,0,0,36,36
1655988440353,MATH 105,A01,085443,Carter; Anne Toulson,4,1,35,31
1655988440353,MATH 105,A02,093477,Staff,8,0,35,27
1655988446382,MATH 109,A01,083213,Ganzberger; Geoffrey Michael,0,1,34,34
1655988446382,MATH 109,A02,083214,Ganzberger; Geoffrey Michael,0,0,34,34
1655988446382,MATH 109,A03,093478,Staff,1,0,34,33
1655988446382,MATH 109,B01,083215,Ganzberger; Geoffrey Michael,2,0,32,30
1655988446382,MATH 109,B02,083216,Ganzberger; Geoffrey Michael,0,0,32,32
1655988446382,MATH 109,B03,093479,Staff,4,0,32,28
1655988452411,MATH 142A,A01,083219,Chow; Bennett,0,0,32,32
1655988452411,MATH 142A,A02,083220,Chow; Bennett,7,0,32,25
1655988452411,MATH 142A,A03,093480,Staff,4,0,32,28
1655988452411,MATH 142A,B03,093481,Staff,3,0,32,29
1655988452411,MATH 142A,B04,093558,Staff,6,0,32,26
1655988452411,MATH 142A,B05,093559,Staff,0,0,32,32
1655988458460,MATH 193A,A01,083224,Rotar; Vladimir,1,1,34,33
1655988458460,MATH 193A,A02,083225,Rotar; Vladimir,0,0,34,34
1655988458460,MATH 193A,A03,083781,Rotar; Vladimir,2,0,34,32
1655988458460,MATH 193A,A04,083782,Rotar; Vladimir,3,0,34,31
1655988458460,MATH 193A,A05,093482,Rotar; Vladimir,0,0,34,34
1655988464488,MATH 197,001,091859,McAuley; Julian John,9999,0,9999,0
1655988464488,MATH 197,002,095566,Kedlaya; Kiran S.,9997,0,9999,2
1655988464488,MATH 197,003,095567,Xiao; Ming,9999,0,9999,0
1655988464488,MATH 197,004,095571,Perols; Johan Lars,9998,0,9999,1
1655988471562,COGS 9,A01,083615,Shannon; Kyle Michael,3,1,75,72
1655988477605,COGS 11,A01,083617,Boyle; Mary E. T.,11,1,48,37
1655988483646,COGS 13,A01,083071,Bastos; Amalia Pinkusfeld,3,2,71,68
1655988489674,COGS 14A,A01,092681,Semenuks; Arturs,4,25,100,96
1655988495700,COGS 14B,A01,083073,Cheng; Tzu-Han,7,0,63,56
1655988501726,COGS 17,A01,092677,Semenuks; Arturs,8,7,81,73
1655988507755,COGS 100,A01,083619,Allen; Michael Gordon,2,2,70,68
1655988513785,COGS 101A,A01,083621,Davis; Joshua Daniel,4,3,68,64
1655988519813,COGS 101B,A01,091572,Allen; Michael Gordon,0,0,65,65
1655988525856,COGS 101C,A01,083625,Delgado; Tania,7,0,35,28
1655988531895,COGS 107A,A01,083627,Boyle; Mary E. T.,1,2,60,59
1655988537931,COGS 118A,A01,083075,Gupta; Anjum,21,16,76,55
1655988543961,CSE 3,A50,083646,Miranda; Gregory Joseph,14,0,50,36
1655988550002,CSE 8A,A50,083650,Miranda; Gregory Joseph,3,11,56,53
1655988556031,CSE 11,A01,083080,Cao; Yingjun,0,65,40,40
1655988562062,CSE 12,A01,083652,Krause-Levy; Sophia Louisa,6,8,120,114
1655988568090,CSE 15L,A01,083654,Morris; Justin Loren,3,1,50,47
1655988568090,CSE 15L,A02,083655,Morris; Justin Loren,1,1,50,49
1655988574121,CSE 20,A01,083657,Tran; Khoa Dang,29,0,80,51
1655988580149,CSE 21,A01,095574,Bach; Quang Tran,23,0,48,25
1655988586180,CSE 30,A01,083084,Eldon; John,2,10,80,78
1655988586180,CSE 30,B01,095061,Bhaskar; Nishant,0,4,50,50
1655988592210,CSE 100,A01,083659,Cao; Yingjun,2,25,70,68
1655988598239,CSE 134B,A01,083661,Powell; Thomas Allan,6,7,100,94
1655988604266,CSE 140,A01,083663,Gungor; Onat,5,0,85,80
1655988610299,CSE 140L,A01,083088,Eldon; John,5,0,100,95
1655988616329,CSE 175,A01,083665,Kumar; Rakesh,1,0,25,24
1655988622358,CSE 190,A00,092507,Dubnov; Shlomo,1,0,20,19
1655988628387,ECE 45,A01,083139,Congero; Spencer William,0,1,75,75
1655988634426,ECE 65,A50,083695,Saad; Andrew S,6,0,30,24
1655988634426,ECE 65,A51,095125,Staff,23,0,26,3
1655988640460,ECE 109,A01,091882,Touri; Behrouz,2,4,70,68
1655988646493,ECE 180,A00,083140,Abi Samra; Nicholas Camill,1,0,30,29
1655988646493,ECE 180,B00,083141,Abi Samra; Nicholas Camill,0,8,28,28
1655988652531,MATH 10A,A01,083735,Patchell; Gregory David,0,0,30,30
1655988652531,MATH 10A,A02,083736,Patchell; Gregory David,21,0,30,9
1655988652531,MATH 10A,A03,083737,Patchell; Gregory David,16,0,30,14
1655988658573,MATH 10B,A01,083207,Lim; Seonhee,1,1,34,33
1655988658573,MATH 10B,A02,083208,Lim; Seonhee,1,1,35,34
1655988658573,MATH 10B,A03,093472,Staff,1,0,34,33
1655988658573,MATH 10B,B01,083739,Sinha; Shubham,9,0,30,21
1655988664621,MATH 18,A01,083743,Cinel; Cameron Alexander,5,0,30,25
1655988664621,MATH 18,A02,083744,Cinel; Cameron Alexander,11,0,30,19
1655988664621,MATH 18,A03,083745,Cinel; Cameron Alexander,1,0,30,29
1655988664621,MATH 18,B01,083748,Ma; Zilu,2,0,36,34
1655988664621,MATH 18,B02,083749,Ma; Zilu,0,0,36,36
1655988664621,MATH 18,B03,083750,Ma; Zilu,0,0,36,36
1655988664621,MATH 18,B04,083751,Ma; Zilu,0,0,36,36
1655988664621,MATH 18,B05,093473,Staff,0,0,36,36
1655988664621,MATH 18,B06,093474,Staff,1,0,36,35
1655988670656,MATH 20A,A01,083754,Zheng; Zequn,10,0,40,30
1655988676686,MATH 20B,A01,083756,Briones; Jor-el Thomas Caparas,0,1,36,36
1655988676686,MATH 20B,A02,083757,Briones; Jor-el Thomas Caparas,1,0,36,35
1655988676686,MATH 20B,A03,093475,Staff,0,0,36,36
1655988682721,MATH 20C,A01,083760,Briones; Jor-el Thomas Caparas,0,2,35,35
1655988682721,MATH 20C,A02,083761,Briones; Jor-el Thomas Caparas,6,1,35,29
1655988682721,MATH 20C,A03,093476,Staff,0,0,35,35
1655988682721,MATH 20C,B01,083762,Bach; Quang Tran,3,0,30,27
1655988688755,MATH 20D,A01,083765,Tran; Brian Kha,1,0,30,29
1655988688755,MATH 20D,A02,083766,Tran; Brian Kha,0,1,30,30
1655988688755,MATH 20D,A03,083767,Tran; Brian Kha,1,0,30,29
1655988694785,MATH 20E,A01,083771,Ganguly; Soumya,0,1,32,32
1655988694785,MATH 20E,A02,083772,Ganguly; Soumya,1,1,32,31
1655988694785,MATH 20E,B01,083773,Ciotti; Benjamin,14,0,35,21
1655988694785,MATH 20E,B02,083774,Ciotti; Benjamin,12,0,35,23
1655988700819,MATH 103A,A01,083777,Greenfeld; Be'Eri,2,1,36,34
1655988700819,MATH 103A,A02,083778,Greenfeld; Be'Eri,2,0,36,34
1655988700819,MATH 103A,A03,093561,Staff,0,1,36,36
1655988700819,MATH 103A,B01,083779,Greenfeld; Be'Eri,7,1,36,29
1655988700819,MATH 103A,B02,083780,Greenfeld; Be'Eri,0,0,36,36
1655988700819,MATH 103A,B03,093562,Staff,0,0,36,36
1655988706849,MATH 105,A01,085443,Carter; Anne Toulson,4,1,35,31
1655988706849,MATH 105,A02,093477,Staff,8,0,35,27
1655988712879,MATH 109,A01,083213,Ganzberger; Geoffrey Michael,0,1,34,34
1655988712879,MATH 109,A02,083214,Ganzberger; Geoffrey Michael,0,0,34,34
1655988712879,MATH 109,A03,093478,Staff,1,0,34,33
1655988712879,MATH 109,B01,083215,Ganzberger; Geoffrey Michael,2,0,32,30
1655988712879,MATH 109,B02,083216,Ganzberger; Geoffrey Michael,0,0,32,32
1655988712879,MATH 109,B03,093479,Staff,4,0,32,28
1655988718917,MATH 142A,A01,083219,Chow; Bennett,0,0,32,32
1655988718917,MATH 142A,A02,083220,Chow; Bennett,7,0,32,25
1655988718917,MATH 142A,A03,093480,Staff,4,0,32,28
1655988718917,MATH 142A,B03,093481,Staff,3,0,32,29
1655988718917,MATH 142A,B04,093558,Staff,6,0,32,26
1655988718917,MATH 142A,B05,093559,Staff,0,0,32,32
1655988724946,MATH 193A,A01,083224,Rotar; Vladimir,1,1,34,33
1655988724946,MATH 193A,A02,083225,Rotar; Vladimir,0,0,34,34
1655988724946,MATH 193A,A03,083781,Rotar; Vladimir,2,0,34,32
1655988724946,MATH 193A,A04,083782,Rotar; Vladimir,3,0,34,31
1655988724946,MATH 193A,A05,093482,Rotar; Vladimir,0,0,34,34
1655988730977,MATH 197,001,091859,McAuley; Julian John,9999,0,9999,0
1655988730977,MATH 197,002,095566,Kedlaya; Kiran S.,9997,0,9999,2
1655988730977,MATH 197,003,095567,Xiao; Ming,9999,0,9999,0
1655988730977,MATH 197,004,095571,Perols; Johan Lars,9998,0,9999,1
1655988738062,COGS 9,A01,083615,Shannon; Kyle Michael,3,1,75,72
1655988744092,COGS 11,A01,083617,Boyle; Mary E. T.,11,1,48,37
1655988750133,COGS 13,A01,083071,Bastos; Amalia Pinkusfeld,3,2,71,68
1655988756162,COGS 14A,A01,092681,Semenuks; Arturs,4,25,100,96
1655988762207,COGS 14B,A01,083073,Cheng; Tzu-Han,7,0,63,56
1655988768239,COGS 17,A01,092677,Semenuks; Arturs,8,7,81,73
1655988774273,COGS 100,A01,083619,Allen; Michael Gordon,2,2,70,68
1655988780307,COGS 101A,A01,083621,Davis; Joshua Daniel,4,3,68,64
1655988786344,COGS 101B,A01,091572,Allen; Michael Gordon,0,0,65,65
1655988792379,COGS 101C,A01,083625,Delgado; Tania,7,0,35,28
1655988798404,COGS 107A,A01,083627,Boyle; Mary E. T.,1,2,60,59
1655988804439,COGS 118A,A01,083075,Gupta; Anjum,21,16,76,55
1655988810474,CSE 3,A50,083646,Miranda; Gregory Joseph,14,0,50,36
1655988816500,CSE 8A,A50,083650,Miranda; Gregory Joseph,3,11,56,53
1655988822528,CSE 11,A01,083080,Cao; Yingjun,0,65,40,40
1655988828561,CSE 12,A01,083652,Krause-Levy; Sophia Louisa,6,8,120,114
1655988834591,CSE 15L,A01,083654,Morris; Justin Loren,3,1,50,47
1655988834591,CSE 15L,A02,083655,Morris; Justin Loren,1,1,50,49
1655988840629,CSE 20,A01,083657,Tran; Khoa Dang,29,0,80,51
1655988846657,CSE 21,A01,095574,Bach; Quang Tran,23,0,48,25
1655988852686,CSE 30,A01,083084,Eldon; John,2,10,80,78
1655988852686,CSE 30,B01,095061,Bhaskar; Nishant,0,4,50,50
1655988858720,CSE 100,A01,083659,Cao; Yingjun,2,25,70,68
1655988864746,CSE 134B,A01,083661,Powell; Thomas Allan,6,7,100,94
1655988870775,CSE 140,A01,083663,Gungor; Onat,5,0,85,80
1655988876801,CSE 140L,A01,083088,Eldon; John,5,0,100,95
1655988882832,CSE 175,A01,083665,Kumar; Rakesh,1,0,25,24
1655988888860,CSE 190,A00,092507,Dubnov; Shlomo,1,0,20,19
1655988894887,ECE 45,A01,083139,Congero; Spencer William,0,1,75,75
1655988900915,ECE 65,A50,083695,Saad; Andrew S,6,0,30,24
1655988900915,ECE 65,A51,095125,Staff,23,0,26,3
1655988906942,ECE 109,A01,091882,Touri; Behrouz,2,4,70,68
1655988912970,ECE 180,A00,083140,Abi Samra; Nicholas Camill,1,0,30,29
1655988912970,ECE 180,B00,083141,Abi Samra; Nicholas Camill,0,8,28,28
1655988918998,MATH 10A,A01,083735,Patchell; Gregory David,0,0,30,30
1655988918998,MATH 10A,A02,083736,Patchell; Gregory David,21,0,30,9
1655988918998,MATH 10A,A03,083737,Patchell; Gregory David,16,0,30,14
1655988925037,MATH 10B,A01,083207,Lim; Seonhee,1,1,34,33
1655988925037,MATH 10B,A02,083208,Lim; Seonhee,1,1,35,34
1655988925037,MATH 10B,A03,093472,Staff,1,0,34,33
1655988925037,MATH 10B,B01,083739,Sinha; Shubham,9,0,30,21
1655988931080,MATH 18,A01,083743,Cinel; Cameron Alexander,5,0,30,25
1655988931080,MATH 18,A02,083744,Cinel; Cameron Alexander,11,0,30,19
1655988931080,MATH 18,A03,083745,Cinel; Cameron Alexander,1,0,30,29
1655988931080,MATH 18,B01,083748,Ma; Zilu,2,0,36,34
1655988931080,MATH 18,B02,083749,Ma; Zilu,0,0,36,36
1655988931080,MATH 18,B03,083750,Ma; Zilu,0,0,36,36
1655988931080,MATH 18,B04,083751,Ma; Zilu,0,0,36,36
1655988931080,MATH 18,B05,093473,Staff,0,0,36,36
1655988931080,MATH 18,B06,093474,Staff,1,0,36,35
1655988937108,MATH 20A,A01,083754,Zheng; Zequn,10,0,40,30
1655988943149,MATH 20B,A01,083756,Briones; Jor-el Thomas Caparas,0,1,36,36
1655988943149,MATH 20B,A02,083757,Briones; Jor-el Thomas Caparas,1,0,36,35
1655988943149,MATH 20B,A03,093475,Staff,0,0,36,36
1655988949185,MATH 20C,A01,083760,Briones; Jor-el Thomas Caparas,0,2,35,35
1655988949185,MATH 20C,A02,083761,Briones; Jor-el Thomas Caparas,6,1,35,29
1655988949185,MATH 20C,A03,093476,Staff,0,0,35,35
1655988949185,MATH 20C,B01,083762,Bach; Quang Tran,3,0,30,27
1655988955218,MATH 20D,A01,083765,Tran; Brian Kha,1,0,30,29
1655988955218,MATH 20D,A02,083766,Tran; Brian Kha,0,1,30,30
1655988955218,MATH 20D,A03,083767,Tran; Brian Kha,1,0,30,29
1655988961247,MATH 20E,A01,083771,Ganguly; Soumya,0,1,32,32
1655988961247,MATH 20E,A02,083772,Ganguly; Soumya,1,1,32,31
1655988961247,MATH 20E,B01,083773,Ciotti; Benjamin,14,0,35,21
1655988961247,MATH 20E,B02,083774,Ciotti; Benjamin,12,0,35,23
1655988967290,MATH 103A,A01,083777,Greenfeld; Be'Eri,2,1,36,34
1655988967290,MATH 103A,A02,083778,Greenfeld; Be'Eri,2,0,36,34
1655988967290,MATH 103A,A03,093561,Staff,0,1,36,36
1655988967290,MATH 103A,B01,083779,Greenfeld; Be'Eri,7,1,36,29
1655988967290,MATH 103A,B02,083780,Greenfeld; Be'Eri,0,0,36,36
1655988967290,MATH 103A,B03,093562,Staff,0,0,36,36
1655988973321,MATH 105,A01,085443,Carter; Anne Toulson,4,1,35,31
1655988973321,MATH 105,A02,093477,Staff,8,0,35,27
1655988979354,MATH 109,A01,083213,Ganzberger; Geoffrey Michael,0,1,34,34
1655988979354,MATH 109,A02,083214,Ganzberger; Geoffrey Michael,0,0,34,34
1655988979354,MATH 109,A03,093478,Staff,1,0,34,33
1655988979354,MATH 109,B01,083215,Ganzberger; Geoffrey Michael,2,0,32,30
1655988979354,MATH 109,B02,083216,Ganzberger; Geoffrey Michael,0,0,32,32
1655988979354,MATH 109,B03,093479,Staff,4,0,32,28
1655988985383,MATH 142A,A01,083219,Chow; Bennett,0,0,32,32
1655988985383,MATH 142A,A02,083220,Chow; Bennett,7,0,32,25
1655988985383,MATH 142A,A03,093480,Staff,4,0,32,28
1655988985383,MATH 142A,B03,093481,Staff,3,0,32,29
1655988985383,MATH 142A,B04,093558,Staff,6,0,32,26
1655988985383,MATH 142A,B05,093559,Staff,0,0,32,32
1655988991414,MATH 193A,A01,083224,Rotar; Vladimir,1,1,34,33
1655988991414,MATH 193A,A02,083225,Rotar; Vladimir,0,0,34,34
1655988991414,MATH 193A,A03,083781,Rotar; Vladimir,2,0,34,32
1655988991414,MATH 193A,A04,083782,Rotar; Vladimir,3,0,34,31
1655988991414,MATH 193A,A05,093482,Rotar; Vladimir,0,0,34,34
1655988997446,MATH 197,001,091859,McAuley; Julian John,9999,0,9999,0
1655988997446,MATH 197,002,095566,Kedlaya; Kiran S.,9997,0,9999,2
1655988997446,MATH 197,003,095567,Xiao; Ming,9999,0,9999,0
1655988997446,MATH 197,004,095571,Perols; Johan Lars,9998,0,9999,1
1655989004518,COGS 9,A01,083615,Shannon; Kyle Michael,3,1,75,72
1655989010546,COGS 11,A01,083617,Boyle; Mary E. T.,11,1,48,37
1655989016580,COGS 13,A01,083071,Bastos; Amalia Pinkusfeld,3,2,71,68
1655989022609,COGS 14A,A01,092681,Semenuks; Arturs,4,25,100,96
1655989028643,COGS 14B,A01,083073,Cheng; Tzu-Han,7,0,63,56
1655989034747,COGS 17,A01,092677,Semenuks; Arturs,8,7,81,73
1655989040778,COGS 100,A01,083619,Allen; Michael Gordon,2,2,70,68
1655989046806,COGS 101A,A01,083621,Davis; Joshua Daniel,4,3,68,64
1655989052834,COGS 101B,A01,091572,Allen; Michael Gordon,0,0,65,65
1655989058862,COGS 101C,A01,083625,Delgado; Tania,7,0,35,28
1655989064890,COGS 107A,A01,083627,Boyle; Mary E. T.,1,2,60,59
1655989070918,COGS 118A,A01,083075,Gupta; Anjum,21,16,76,55
1655989076954,CSE 3,A50,083646,Miranda; Gregory Joseph,14,0,50,36
1655989082980,CSE 8A,A50,083650,Miranda; Gregory Joseph,3,11,56,53
1655989089008,CSE 11,A01,083080,Cao; Yingjun,0,65,40,40
1655989095042,CSE 12,A01,083652,Krause-Levy; Sophia Louisa,6,8,120,114
1655989101070,CSE 15L,A01,083654,Morris; Justin Loren,3,1,50,47
1655989101070,CSE 15L,A02,083655,Morris; Justin Loren,1,1,50,49
1655989107096,CSE 20,A01,083657,Tran; Khoa Dang,29,0,80,51
1655989113124,CSE 21,A01,095574,Bach; Quang Tran,23,0,48,25
1655989119158,CSE 30,A01,083084,Eldon; John,2,10,80,78
1655989119158,CSE 30,B01,095061,Bhaskar; Nishant,0,4,50,50
1655989125195,CSE 100,A01,083659,Cao; Yingjun,2,25,70,68
1655989131222,CSE 134B,A01,083661,Powell; Thomas Allan,6,7,100,94
1655989137248,CSE 140,A01,083663,Gungor; Onat,5,0,85,80
1655989143281,CSE 140L,A01,083088,Eldon; John,5,0,100,95
1655989149314,CSE 175,A01,083665,Kumar; Rakesh,1,0,25,24
1655989155354,CSE 190,A00,092507,Dubnov; Shlomo,1,0,20,19
1655989161388,ECE 45,A01,083139,Congero; Spencer William,0,1,75,75
1655989167422,ECE 65,A50,083695,Saad; Andrew S,6,0,30,24
1655989167422,ECE 65,A51,095125,Staff,23,0,26,3
1655989173453,ECE 109,A01,091882,Touri; Behrouz,2,4,70,68
1655989179481,ECE 180,A00,083140,Abi Samra; Nicholas Camill,1,0,30,29
1655989179481,ECE 180,B00,083141,Abi Samra; Nicholas Camill,0,8,28,28
1655989185509,MATH 10A,A01,083735,Patchell; Gregory David,0,0,30,30
1655989185509,MATH 10A,A02,083736,Patchell; Gregory David,21,0,30,9
1655989185509,MATH 10A,A03,083737,Patchell; Gregory David,16,0,30,14
1655989191537,MATH 10B,A01,083207,Lim; Seonhee,1,1,34,33
1655989191537,MATH 10B,A02,083208,Lim; Seonhee,1,1,35,34
1655989191537,MATH 10B,A03,093472,Staff,1,0,34,33
1655989191537,MATH 10B,B01,083739,Sinha; Shubham,9,0,30,21
1655989197578,MATH 18,A01,083743,Cinel; Cameron Alexander,5,0,30,25
1655989197578,MATH 18,A02,083744,Cinel; Cameron Alexander,11,0,30,19
1655989197578,MATH 18,A03,083745,Cinel; Cameron Alexander,1,0,30,29
1655989197578,MATH 18,B01,083748,Ma; Zilu,2,0,36,34
1655989197578,MATH 18,B02,083749,Ma; Zilu,0,0,36,36
1655989197578,MATH 18,B03,083750,Ma; Zilu,0,0,36,36
1655989197578,MATH 18,B04,083751,Ma; Zilu,0,0,36,36
1655989197578,MATH 18,B05,093473,Staff,0,0,36,36
1655989197578,MATH 18,B06,093474,Staff,1,0,36,35
1655989203602,MATH 20A,A01,083754,Zheng; Zequn,10,0,40,30
1655989209630,MATH 20B,A01,083756,Briones; Jor-el Thomas Caparas,0,1,36,36
1655989209630,MATH 20B,A02,083757,Briones; Jor-el Thomas Caparas,1,0,36,35
1655989209630,MATH 20B,A03,093475,Staff,0,0,36,36
1655989215668,MATH 20C,A01,083760,Briones; Jor-el Thomas Caparas,0,2,35,35
1655989215668,MATH 20C,A02,083761,Briones; Jor-el Thomas Caparas,6,1,35,29
1655989215668,MATH 20C,A03,093476,Staff,0,0,35,35
1655989215668,MATH 20C,B01,083762,Bach; Quang Tran,3,0,30,27
1655989221701,MATH 20D,A01,083765,Tran; Brian Kha,1,0,30,29
1655989221701,MATH 20D,A02,083766,Tran; Brian Kha,0,1,30,30
1655989221701,MATH 20D,A03,083767,Tran; Brian Kha,1,0,30,29
1655989227730,MATH 20E,A01,083771,Ganguly; Soumya,0,1,32,32
1655989227730,MATH 20E,A02,083772,Ganguly; Soumya,1,1,32,31
1655989227730,MATH 20E,B01,083773,Ciotti; Benjamin,14,0,35,21
1655989227730,MATH 20E,B02,083774,Ciotti; Benjamin,12,0,35,23
1655989233762,MATH 103A,A01,083777,Greenfeld; Be'Eri,2,1,36,34
1655989233762,MATH 103A,A02,083778,Greenfeld; Be'Eri,2,0,36,34
1655989233762,MATH 103A,A03,093561,Staff,0,1,36,36
1655989233762,MATH 103A,B01,083779,Greenfeld; Be'Eri,7,1,36,29
1655989233762,MATH 103A,B02,083780,Greenfeld; Be'Eri,0,0,36,36
1655989233762,MATH 103A,B03,093562,Staff,0,0,36,36
1655989239789,MATH 105,A01,085443,Carter; Anne Toulson,4,1,35,31
1655989239789,MATH 105,A02,093477,Staff,8,0,35,27
1655989245815,MATH 109,A01,083213,Ganzberger; Geoffrey Michael,0,1,34,34
1655989245815,MATH 109,A02,083214,Ganzberger; Geoffrey Michael,0,0,34,34
1655989245815,MATH 109,A03,093478,Staff,1,0,34,33
1655989245815,MATH 109,B01,083215,Ganzberger; Geoffrey Michael,2,0,32,30
1655989245815,MATH 109,B02,083216,Ganzberger; Geoffrey Michael,0,0,32,32
1655989245815,MATH 109,B03,093479,Staff,4,0,32,28
1655989251844,MATH 142A,A01,083219,Chow; Bennett,0,0,32,32
1655989251844,MATH 142A,A02,083220,Chow; Bennett,7,0,32,25
1655989251844,MATH 142A,A03,093480,Staff,4,0,32,28
1655989251844,MATH 142A,B03,093481,Staff,3,0,32,29
1655989251844,MATH 142A,B04,093558,Staff,6,0,32,26
1655989251844,MATH 142A,B05,093559,Staff,0,0,32,32
1655989257871,MATH 193A,A01,083224,Rotar; Vladimir,1,1,34,33
1655989257871,MATH 193A,A02,083225,Rotar; Vladimir,0,0,34,34
1655989257871,MATH 193A,A03,083781,Rotar; Vladimir,2,0,34,32
1655989257871,MATH 193A,A04,083782,Rotar; Vladimir,3,0,34,31
1655989257871,MATH 193A,A05,093482,Rotar; Vladimir,0,0,34,34
1655989263898,MATH 197,001,091859,McAuley; Julian John,9999,0,9999,0
1655989263898,MATH 197,002,095566,Kedlaya; Kiran S.,9997,0,9999,2
1655989263898,MATH 197,003,095567,Xiao; Ming,9999,0,9999,0
1655989263898,MATH 197,004,095571,Perols; Johan Lars,9998,0,9999,1
1655989270983,COGS 9,A01,083615,Shannon; Kyle Michael,3,1,75,72
1655989277014,COGS 11,A01,083617,Boyle; Mary E. T.,11,1,48,37
1655989283043,COGS 13,A01,083071,Bastos; Amalia Pinkusfeld,3,2,71,68
1655989289069,COGS 14A,A01,092681,Semenuks; Arturs,4,25,100,96
1655989295095,COGS 14B,A01,083073,Cheng; Tzu-Han,7,0,63,56
1655989301126,COGS 17,A01,092677,Semenuks; Arturs,8,7,81,73
1655989307155,COGS 100,A01,083619,Allen; Michael Gordon,2,2,70,68
1655989313181,COGS 101A,A01,083621,Davis; Joshua Daniel,4,3,68,64
1655989319213,COGS 101B,A01,091572,Allen; Michael Gordon,0,0,65,65
1655989325256,COGS 101C,A01,083625,Delgado; Tania,7,0,35,28
1655989331284,COGS 107A,A01,083627,Boyle; Mary E. T.,1,2,60,59
1655989337315,COGS 118A,A01,083075,Gupta; Anjum,21,16,76,55
1655989343352,CSE 3,A50,083646,Miranda; Gregory Joseph,14,0,50,36
1655989349378,CSE 8A,A50,083650,Miranda; Gregory Joseph,3,11,56,53
1655989355403,CSE 11,A01,083080,Cao; Yingjun,0,65,40,40
1655989361443,CSE 12,A01,083652,Krause-Levy; Sophia Louisa,6,8,120,114
1655989367473,CSE 15L,A01,083654,Morris; Justin Loren,3,1,50,47
1655989367473,CSE 15L,A02,083655,Morris; Justin Loren,1,1,50,49
1655989373498,CSE 20,A01,083657,Tran; Khoa Dang,29,0,80,51
1655989379525,CSE 21,A01,095574,Bach; Quang Tran,23,0,48,25
1655989385553,CSE 30,A01,083084,Eldon; John,2,10,80,78
1655989385553,CSE 30,B01,095061,Bhaskar; Nishant,0,4,50,50
1655989391584,CSE 100,A01,083659,Cao; Yingjun,2,25,70,68
1655989397613,CSE 134B,A01,083661,Powell; Thomas Allan,6,7,100,94
1655989403639,CSE 140,A01,083663,Gungor; Onat,5,0,85,80
1655989409672,CSE 140L,A01,083088,Eldon; John,5,0,100,95
1655989415700,CSE 175,A01,083665,Kumar; Rakesh,1,0,25,24
1655989421728,CSE 190,A00,092507,Dubnov; Shlomo,1,0,20,19
1655989427759,ECE 45,A01,083139,Congero; Spencer William,0,1,75,75
1655989433785,ECE 65,A50,083695,Saad; Andrew S,6,0,30,24
1655989433785,ECE 65,A51,095125,Staff,23,0,26,3
1655989439811,ECE 109,A01,091882,Touri; Behrouz,2,4,70,68
1655989445840,ECE 180,A00,083140,Abi Samra; Nicholas Camill,1,0,30,29
1655989445840,ECE 180,B00,083141,Abi Samra; Nicholas Camill,0,8,28,28
1655989451877,MATH 10A,A01,083735,Patchell; Gregory David,0,0,30,30
1655989451877,MATH 10A,A02,083736,Patchell; Gregory David,21,0,30,9
1655989451877,MATH 10A,A03,083737,Patchell; Gregory David,16,0,30,14
1655989457907,MATH 10B,A01,083207,Lim; Seonhee,1,1,34,33
1655989457907,MATH 10B,A02,083208,Lim; Seonhee,1,1,35,34
1655989457907,MATH 10B,A03,093472,Staff,1,0,34,33
1655989457907,MATH 10B,B01,083739,Sinha; Shubham,9,0,30,21
1655989463939,MATH 18,A01,083743,Cinel; Cameron Alexander,5,0,30,25
1655989463939,MATH 18,A02,083744,Cinel; Cameron Alexander,11,0,30,19
1655989463939,MATH 18,A03,083745,Cinel; Cameron Alexander,1,0,30,29
1655989463939,MATH 18,B01,083748,Ma; Zilu,2,0,36,34
1655989463939,MATH 18,B02,083749,Ma; Zilu,0,0,36,36
1655989463939,MATH 18,B03,083750,Ma; Zilu,0,0,36,36
1655989463939,MATH 18,B04,083751,Ma; Zilu,0,0,36,36
1655989463939,MATH 18,B05,093473,Staff,0,0,36,36
1655989463939,MATH 18,B06,093474,Staff,1,0,36,35
1655989469966,MATH 20A,A01,083754,Zheng; Zequn,10,0,40,30
1655989475993,MATH 20B,A01,083756,Briones; Jor-el Thomas Caparas,0,1,36,36
1655989475993,MATH 20B,A02,083757,Briones; Jor-el Thomas Caparas,1,0,36,35
1655989475993,MATH 20B,A03,093475,Staff,0,0,36,36
1655989482020,MATH 20C,A01,083760,Briones; Jor-el Thomas Caparas,0,2,35,35
1655989482020,MATH 20C,A02,083761,Briones; Jor-el Thomas Caparas,6,1,35,29
1655989482020,MATH 20C,A03,093476,Staff,0,0,35,35
1655989482020,MATH 20C,B01,083762,Bach; Quang Tran,3,0,30,27
1655989488046,MATH 20D,A01,083765,Tran; Brian Kha,1,0,30,29
1655989488046,MATH 20D,A02,083766,Tran; Brian Kha,0,1,30,30
1655989488046,MATH 20D,A03,083767,Tran; Brian Kha,1,0,30,29
1655989494081,MATH 20E,A01,083771,Ganguly; Soumya,0,1,32,32
1655989494081,MATH 20E,A02,083772,Ganguly; Soumya,1,1,32,31
1655989494081,MATH 20E,B01,083773,Ciotti; Benjamin,14,0,35,21
1655989494081,MATH 20E,B02,083774,Ciotti; Benjamin,12,0,35,23
1655989500121,MATH 103A,A01,083777,Greenfeld; Be'Eri,2,1,36,34
1655989500121,MATH 103A,A02,083778,Greenfeld; Be'Eri,2,0,36,34
1655989500121,MATH 103A,A03,093561,Staff,0,1,36,36
1655989500121,MATH 103A,B01,083779,Greenfeld; Be'Eri,7,1,36,29
1655989500121,MATH 103A,B02,083780,Greenfeld; Be'Eri,0,0,36,36
1655989500121,MATH 103A,B03,093562,Staff,0,0,36,36
1655989506148,MATH 105,A01,085443,Carter; Anne Toulson,4,1,35,31
1655989506148,MATH 105,A02,093477,Staff,8,0,35,27
1655989512183,MATH 109,A01,083213,Ganzberger; Geoffrey Michael,0,1,34,34
1655989512183,MATH 109,A02,083214,Ganzberger; Geoffrey Michael,0,0,34,34
1655989512183,MATH 109,A03,093478,Staff,1,0,34,33
1655989512183,MATH 109,B01,083215,Ganzberger; Geoffrey Michael,2,0,32,30
1655989512183,MATH 109,B02,083216,Ganzberger; Geoffrey Michael,0,0,32,32
1655989512183,MATH 109,B03,093479,Staff,4,0,32,28
1655989518210,MATH 142A,A01,083219,Chow; Bennett,0,0,32,32
1655989518210,MATH 142A,A02,083220,Chow; Bennett,7,0,32,25
1655989518210,MATH 142A,A03,093480,Staff,4,0,32,28
1655989518210,MATH 142A,B03,093481,Staff,3,0,32,29
1655989518210,MATH 142A,B04,093558,Staff,6,0,32,26
1655989518210,MATH 142A,B05,093559,Staff,0,0,32,32
1655989524242,MATH 193A,A01,083224,Rotar; Vladimir,1,1,34,33
1655989524242,MATH 193A,A02,083225,Rotar; Vladimir,0,0,34,34
1655989524242,MATH 193A,A03,083781,Rotar; Vladimir,2,0,34,32
1655989524242,MATH 193A,A04,083782,Rotar; Vladimir,3,0,34,31
1655989524242,MATH 193A,A05,093482,Rotar; Vladimir,0,0,34,34
1655989530276,MATH 197,001,091859,McAuley; Julian John,9999,0,9999,0
1655989530276,MATH 197,002,095566,Kedlaya; Kiran S.,9997,0,9999,2
1655989530276,MATH 197,003,095567,Xiao; Ming,9999,0,9999,0
1655989530276,MATH 197,004,095571,Perols; Johan Lars,9998,0,9999,1
1655989537362,COGS 9,A01,083615,Shannon; Kyle Michael,3,1,75,72
1655989543386,COGS 11,A01,083617,Boyle; Mary E. T.,11,1,48,37
1655989549417,COGS 13,A01,083071,Bastos; Amalia Pinkusfeld,3,2,71,68
1655989555445,COGS 14A,A01,092681,Semenuks; Arturs,4,25,100,96
1655989561477,COGS 14B,A01,083073,Cheng; Tzu-Han,7,0,63,56
1655989567501,COGS 17,A01,092677,Semenuks; Arturs,8,7,81,73
1655989573525,COGS 100,A01,083619,Allen; Michael Gordon,2,2,70,68
1655989579556,COGS 101A,A01,083621,Davis; Joshua Daniel,4,3,68,64
1655989585587,COGS 101B,A01,091572,Allen; Michael Gordon,0,0,65,65
1655989591613,COGS 101C,A01,083625,Delgado; Tania,7,0,35,28
1655989597636,COGS 107A,A01,083627,Boyle; Mary E. T.,1,2,60,59
1655989603661,COGS 118A,A01,083075,Gupta; Anjum,21,16,76,55
1655989609696,CSE 3,A50,083646,Miranda; Gregory Joseph,14,0,50,36
1655989615724,CSE 8A,A50,083650,Miranda; Gregory Joseph,3,11,56,53
1655989621751,CSE 11,A01,083080,Cao; Yingjun,0,65,40,40
1655989627783,CSE 12,A01,083652,Krause-Levy; Sophia Louisa,6,8,120,114
1655989633903,CSE 15L,A01,083654,Morris; Justin Loren,3,1,50,47
1655989633903,CSE 15L,A02,083655,Morris; Justin Loren,1,1,50,49
1655989639934,CSE 20,A01,083657,Tran; Khoa Dang,29,0,80,51
1655989645960,CSE 21,A01,095574,Bach; Quang Tran,23,0,48,25
1655989651988,CSE 30,A01,083084,Eldon; John,2,10,80,78
1655989651988,CSE 30,B01,095061,Bhaskar; Nishant,0,4,50,50
1655989658020,CSE 100,A01,083659,Cao; Yingjun,2,25,70,68
1655989664045,CSE 134B,A01,083661,Powell; Thomas Allan,6,7,100,94
1655989670071,CSE 140,A01,083663,Gungor; Onat,5,0,85,80
1655989676104,CSE 140L,A01,083088,Eldon; John,5,0,100,95
1655989682136,CSE 175,A01,083665,Kumar; Rakesh,1,0,25,24
1655989688168,CSE 190,A00,092507,Dubnov; Shlomo,1,0,20,19
1655989694196,ECE 45,A01,083139,Congero; Spencer William,0,1,75,75
1655989700225,ECE 65,A50,083695,Saad; Andrew S,6,0,30,24
1655989700225,ECE 65,A51,095125,Staff,23,0,26,3
1655989706252,ECE 109,A01,091882,Touri; Behrouz,2,4,70,68
1655989712279,ECE 180,A00,083140,Abi Samra; Nicholas Camill,1,0,30,29
1655989712279,ECE 180,B00,083141,Abi Samra; Nicholas Camill,0,8,28,28
1655989718307,MATH 10A,A01,083735,Patchell; Gregory David,0,0,30,30
1655989718307,MATH 10A,A02,083736,Patchell; Gregory David,21,0,30,9
1655989718307,MATH 10A,A03,083737,Patchell; Gregory David,16,0,30,14
1655989724349,MATH 10B,A01,083207,Lim; Seonhee,1,1,34,33
1655989724349,MATH 10B,A02,083208,Lim; Seonhee,1,1,35,34
1655989724349,MATH 10B,A03,093472,Staff,1,0,34,33
1655989724349,MATH 10B,B01,083739,Sinha; Shubham,9,0,30,21
1655989730379,MATH 18,A01,083743,Cinel; Cameron Alexander,5,0,30,25
1655989730379,MATH 18,A02,083744,Cinel; Cameron Alexander,11,0,30,19
1655989730379,MATH 18,A03,083745,Cinel; Cameron Alexander,1,0,30,29
1655989730379,MATH 18,B01,083748,Ma; Zilu,2,0,36,34
1655989730379,MATH 18,B02,083749,Ma; Zilu,0,0,36,36
1655989730379,MATH 18,B03,083750,Ma; Zilu,0,0,36,36
1655989730379,MATH 18,B04,083751,Ma; Zilu,0,0,36,36
1655989730379,MATH 18,B05,093473,Staff,0,0,36,36
1655989730379,MATH 18,B06,093474,Staff,1,0,36,35
1655989736410,MATH 20A,A01,083754,Zheng; Zequn,10,0,40,30
1655989742437,MATH 20B,A01,083756,Briones; Jor-el Thomas Caparas,0,1,36,36
1655989742437,MATH 20B,A02,083757,Briones; Jor-el Thomas Caparas,1,0,36,35
1655989742437,MATH 20B,A03,093475,Staff,0,0,36,36
1655989748466,MATH 20C,A01,083760,Briones; Jor-el Thomas Caparas,0,2,35,35
1655989748466,MATH 20C,A02,083761,Briones; Jor-el Thomas Caparas,6,1,35,29
1655989748466,MATH 20C,A03,093476,Staff,0,0,35,35
1655989748466,MATH 20C,B01,083762,Bach; Quang Tran,3,0,30,27
1655989754492,MATH 20D,A01,083765,Tran; Brian Kha,1,0,30,29
1655989754492,MATH 20D,A02,083766,Tran; Brian Kha,0,1,30,30
1655989754492,MATH 20D,A03,083767,Tran; Brian Kha,1,0,30,29
1655989760520,MATH 20E,A01,083771,Ganguly; Soumya,0,1,32,32
1655989760520,MATH 20E,A02,083772,Ganguly; Soumya,1,1,32,31
1655989760520,MATH 20E,B01,083773,Ciotti; Benjamin,14,0,35,21
1655989760520,MATH 20E,B02,083774,Ciotti; Benjamin,12,0,35,23
1655989766551,MATH 103A,A01,083777,Greenfeld; Be'Eri,2,1,36,34
1655989766551,MATH 103A,A02,083778,Greenfeld; Be'Eri,2,0,36,34
1655989766551,MATH 103A,A03,093561,Staff,0,1,36,36
1655989766551,MATH 103A,B01,083779,Greenfeld; Be'Eri,7,1,36,29
1655989766551,MATH 103A,B02,083780,Greenfeld; Be'Eri,0,0,36,36
1655989766551,MATH 103A,B03,093562,Staff,0,0,36,36
1655989772587,MATH 105,A01,085443,Carter; Anne Toulson,4,1,35,31
1655989772587,MATH 105,A02,093477,Staff,8,0,35,27
1655989778614,MATH 109,A01,083213,Ganzberger; Geoffrey Michael,0,1,34,34
1655989778614,MATH 109,A02,083214,Ganzberger; Geoffrey Michael,0,0,34,34
1655989778614,MATH 109,A03,093478,Staff,1,0,34,33
1655989778614,MATH 109,B01,083215,Ganzberger; Geoffrey Michael,2,0,32,30
1655989778614,MATH 109,B02,083216,Ganzberger; Geoffrey Michael,0,0,32,32
1655989778614,MATH 109,B03,093479,Staff,4,0,32,28
1655989784642,MATH 142A,A01,083219,Chow; Bennett,0,0,32,32
1655989784642,MATH 142A,A02,083220,Chow; Bennett,7,0,32,25
1655989784642,MATH 142A,A03,093480,Staff,4,0,32,28
1655989784642,MATH 142A,B03,093481,Staff,3,0,32,29
1655989784642,MATH 142A,B04,093558,Staff,6,0,32,26
1655989784642,MATH 142A,B05,093559,Staff,0,0,32,32
1655989790670,MATH 193A,A01,083224,Rotar; Vladimir,1,1,34,33
1655989790670,MATH 193A,A02,083225,Rotar; Vladimir,0,0,34,34
1655989790670,MATH 193A,A03,083781,Rotar; Vladimir,2,0,34,32
1655989790670,MATH 193A,A04,083782,Rotar; Vladimir,3,0,34,31
1655989790670,MATH 193A,A05,093482,Rotar; Vladimir,0,0,34,34
1655989796698,MATH 197,001,091859,McAuley; Julian John,9999,0,9999,0
1655989796698,MATH 197,002,095566,Kedlaya; Kiran S.,9997,0,9999,2
1655989796698,MATH 197,003,095567,Xiao; Ming,9999,0,9999,0
1655989796698,MATH 197,004,095571,Perols; Johan Lars,9998,0,9999,1
1655989803780,COGS 9,A01,083615,Shannon; Kyle Michael,3,1,75,72
1655989809823,COGS 11,A01,083617,Boyle; Mary E. T.,11,1,48,37
1655989815850,COGS 13,A01,083071,Bastos; Amalia Pinkusfeld,3,2,71,68
1655989821884,COGS 14A,A01,092681,Semenuks; Arturs,4,25,100,96
1655989827918,COGS 14B,A01,083073,Cheng; Tzu-Han,7,0,63,56
1655989833967,COGS 17,A01,092677,Semenuks; Arturs,8,7,81,73
1655989840015,COGS 100,A01,083619,Allen; Michael Gordon,2,2,70,68
1655989846054,COGS 101A,A01,083621,Davis; Joshua Daniel,4,3,68,64
1655989852084,COGS 101B,A01,091572,Allen; Michael Gordon,0,0,65,65
1655989858144,COGS 101C,A01,083625,Delgado; Tania,7,0,35,28
1655989864175,COGS 107A,A01,083627,Boyle; Mary E. T.,1,2,60,59
1655989870204,COGS 118A,A01,083075,Gupta; Anjum,21,16,76,55
1655989876241,CSE 3,A50,083646,Miranda; Gregory Joseph,14,0,50,36
1655989882269,CSE 8A,A50,083650,Miranda; Gregory Joseph,3,11,56,53
1655989888295,CSE 11,A01,083080,Cao; Yingjun,0,65,40,40
1655989894323,CSE 12,A01,083652,Krause-Levy; Sophia Louisa,6,8,120,114
1655989900348,CSE 15L,A01,083654,Morris; Justin Loren,3,1,50,47
1655989900348,CSE 15L,A02,083655,Morris; Justin Loren,1,1,50,49
1655989906374,CSE 20,A01,083657,Tran; Khoa Dang,29,0,80,51
1655989912410,CSE 21,A01,095574,Bach; Quang Tran,23,0,48,25
1655989918440,CSE 30,A01,083084,Eldon; John,2,10,80,78
1655989918440,CSE 30,B01,095061,Bhaskar; Nishant,0,4,50,50
1655989924471,CSE 100,A01,083659,Cao; Yingjun,2,25,70,68
1655989930495,CSE 134B,A01,083661,Powell; Thomas Allan,6,7,100,94
1655989936521,CSE 140,A01,083663,Gungor; Onat,5,0,85,80
1655989942546,CSE 140L,A01,083088,Eldon; John,5,0,100,95
1655989948575,CSE 175,A01,083665,Kumar; Rakesh,1,0,25,24
1655989954602,CSE 190,A00,092507,Dubnov; Shlomo,1,0,20,19
1655989960635,ECE 45,A01,083139,Congero; Spencer William,0,1,75,75
1655989966676,ECE 65,A50,083695,Saad; Andrew S,6,0,30,24
1655989966676,ECE 65,A51,095125,Staff,23,0,26,3
1655989972705,ECE 109,A01,091882,Touri; Behrouz,2,4,70,68
1655989978739,ECE 180,A00,083140,Abi Samra; Nicholas Camill,1,0,30,29
1655989978739,ECE 180,B00,083141,Abi Samra; Nicholas Camill,0,8,28,28
1655989984768,MATH 10A,A01,083735,Patchell; Gregory David,0,0,30,30
1655989984768,MATH 10A,A02,083736,Patchell; Gregory David,21,0,30,9
1655989984768,MATH 10A,A03,083737,Patchell; Gregory David,16,0,30,14
1655989990811,MATH 10B,A01,083207,Lim; Seonhee,1,1,34,33
1655989990811,MATH 10B,A02,083208,Lim; Seonhee,1,1,35,34
1655989990811,MATH 10B,A03,093472,Staff,1,0,34,33
1655989990811,MATH 10B,B01,083739,Sinha; Shubham,9,0,30,21
1655989996845,MATH 18,A01,083743,Cinel; Cameron Alexander,5,0,30,25
1655989996845,MATH 18,A02,083744,Cinel; Cameron Alexander,11,0,30,19
1655989996845,MATH 18,A03,083745,Cinel; Cameron Alexander,1,0,30,29
1655989996845,MATH 18,B01,083748,Ma; Zilu,2,0,36,34
1655989996845,MATH 18,B02,083749,Ma; Zilu,0,0,36,36
1655989996845,MATH 18,B03,083750,Ma; Zilu,0,0,36,36
1655989996845,MATH 18,B04,083751,Ma; Zilu,0,0,36,36
1655989996845,MATH 18,B05,093473,Staff,0,0,36,36
1655989996845,MATH 18,B06,093474,Staff,1,0,36,35
1655990002879,MATH 20A,A01,083754,Zheng; Zequn,10,0,40,30
1655990008917,MATH 20B,A01,083756,Briones; Jor-el Thomas Caparas,0,1,36,36
1655990008917,MATH 20B,A02,083757,Briones; Jor-el Thomas Caparas,1,0,36,35
1655990008917,MATH 20B,A03,093475,Staff,0,0,36,36
1655990014949,MATH 20C,A01,083760,Briones; Jor-el Thomas Caparas,0,2,35,35
1655990014949,MATH 20C,A02,083761,Briones; Jor-el Thomas Caparas,6,1,35,29
1655990014949,MATH 20C,A03,093476,Staff,0,0,35,35
1655990014949,MATH 20C,B01,083762,Bach; Quang Tran,3,0,30,27
1655990020976,MATH 20D,A01,083765,Tran; Brian Kha,1,0,30,29
1655990020976,MATH 20D,A02,083766,Tran; Brian Kha,0,1,30,30
1655990020976,MATH 20D,A03,083767,Tran; Brian Kha,1,0,30,29
1655990027005,MATH 20E,A01,083771,Ganguly; Soumya,0,1,32,32
1655990027005,MATH 20E,A02,083772,Ganguly; Soumya,1,1,32,31
1655990027005,MATH 20E,B01,083773,Ciotti; Benjamin,14,0,35,21
1655990027005,MATH 20E,B02,083774,Ciotti; Benjamin,12,0,35,23
1655990033050,MATH 103A,A01,083777,Greenfeld; Be'Eri,2,1,36,34
1655990033050,MATH 103A,A02,083778,Greenfeld; Be'Eri,2,0,36,34
1655990033050,MATH 103A,A03,093561,Staff,0,1,36,36
1655990033050,MATH 103A,B01,083779,Greenfeld; Be'Eri,7,1,36,29
1655990033050,MATH 103A,B02,083780,Greenfeld; Be'Eri,0,0,36,36
1655990033050,MATH 103A,B03,093562,Staff,0,0,36,36
1655990039078,MATH 105,A01,085443,Carter; Anne Toulson,4,1,35,31
1655990039078,MATH 105,A02,093477,Staff,8,0,35,27
1655990045107,MATH 109,A01,083213,Ganzberger; Geoffrey Michael,0,1,34,34
1655990045107,MATH 109,A02,083214,Ganzberger; Geoffrey Michael,0,0,34,34
1655990045107,MATH 109,A03,093478,Staff,1,0,34,33
1655990045107,MATH 109,B01,083215,Ganzberger; Geoffrey Michael,2,0,32,30
1655990045107,MATH 109,B02,083216,Ganzberger; Geoffrey Michael,0,0,32,32
1655990045107,MATH 109,B03,093479,Staff,4,0,32,28
1655990051136,MATH 142A,A01,083219,Chow; Bennett,0,0,32,32
1655990051136,MATH 142A,A02,083220,Chow; Bennett,7,0,32,25
1655990051136,MATH 142A,A03,093480,Staff,4,0,32,28
1655990051136,MATH 142A,B03,093481,Staff,3,0,32,29
1655990051136,MATH 142A,B04,093558,Staff,6,0,32,26
1655990051136,MATH 142A,B05,093559,Staff,0,0,32,32
1655990057167,MATH 193A,A01,083224,Rotar; Vladimir,1,1,34,33
1655990057167,MATH 193A,A02,083225,Rotar; Vladimir,0,0,34,34
1655990057167,MATH 193A,A03,083781,Rotar; Vladimir,2,0,34,32
1655990057167,MATH 193A,A04,083782,Rotar; Vladimir,3,0,34,31
1655990057167,MATH 193A,A05,093482,Rotar; Vladimir,0,0,34,34
1655990063197,MATH 197,001,091859,McAuley; Julian John,9999,0,9999,0
1655990063197,MATH 197,002,095566,Kedlaya; Kiran S.,9997,0,9999,2
1655990063197,MATH 197,003,095567,Xiao; Ming,9999,0,9999,0
1655990063197,MATH 197,004,095571,Perols; Johan Lars,9998,0,9999,1
1655990070287,COGS 9,A01,083615,Shannon; Kyle Michael,3,1,75,72
1655990076319,COGS 11,A01,083617,Boyle; Mary E. T.,11,1,48,37
1655990082350,COGS 13,A01,083071,Bastos; Amalia Pinkusfeld,3,2,71,68
1655990088383,COGS 14A,A01,092681,Semenuks; Arturs,4,25,100,96
1655990094417,COGS 14B,A01,083073,Cheng; Tzu-Han,7,0,63,56
1655990100443,COGS 17,A01,092677,Semenuks; Arturs,8,7,81,73
1655990106474,COGS 100,A01,083619,Allen; Michael Gordon,2,2,70,68
1655990112504,COGS 101A,A01,083621,Davis; Joshua Daniel,4,3,68,64
1655990118531,COGS 101B,A01,091572,Allen; Michael Gordon,0,0,65,65
1655990124569,COGS 101C,A01,083625,Delgado; Tania,7,0,35,28
1655990130595,COGS 107A,A01,083627,Boyle; Mary E. T.,1,2,60,59
1655990136621,COGS 118A,A01,083075,Gupta; Anjum,21,16,76,55
1655990142659,CSE 3,A50,083646,Miranda; Gregory Joseph,14,0,50,36
1655990148686,CSE 8A,A50,083650,Miranda; Gregory Joseph,3,11,56,53
1655990154713,CSE 11,A01,083080,Cao; Yingjun,0,65,40,40
1655990160755,CSE 12,A01,083652,Krause-Levy; Sophia Louisa,6,8,120,114
1655990166790,CSE 15L,A01,083654,Morris; Justin Loren,3,1,50,47
1655990166790,CSE 15L,A02,083655,Morris; Justin Loren,1,1,50,49
1655990172826,CSE 20,A01,083657,Tran; Khoa Dang,29,0,80,51
1655990178858,CSE 21,A01,095574,Bach; Quang Tran,23,0,48,25
1655990184906,CSE 30,A01,083084,Eldon; John,2,10,80,78
1655990184906,CSE 30,B01,095061,Bhaskar; Nishant,0,4,50,50
1655990190933,CSE 100,A01,083659,Cao; Yingjun,2,25,70,68
1655990196961,CSE 134B,A01,083661,Powell; Thomas Allan,6,7,100,94
1655990202993,CSE 140,A01,083663,Gungor; Onat,5,0,85,80
1655990209024,CSE 140L,A01,083088,Eldon; John,5,0,100,95
1655990215056,CSE 175,A01,083665,Kumar; Rakesh,1,0,25,24
1655990221088,CSE 190,A00,092507,Dubnov; Shlomo,1,0,20,19
1655990227119,ECE 45,A01,083139,Congero; Spencer William,0,1,75,75
1655990233242,ECE 65,A50,083695,Saad; Andrew S,6,0,30,24
1655990233242,ECE 65,A51,095125,Staff,23,0,26,3
1655990239274,ECE 109,A01,091882,Touri; Behrouz,2,4,70,68
1655990245299,ECE 180,A00,083140,Abi Samra; Nicholas Camill,1,0,30,29
1655990245299,ECE 180,B00,083141,Abi Samra; Nicholas Camill,0,8,28,28
1655990251326,MATH 10A,A01,083735,Patchell; Gregory David,0,0,30,30
1655990251326,MATH 10A,A02,083736,Patchell; Gregory David,21,0,30,9
1655990251326,MATH 10A,A03,083737,Patchell; Gregory David,16,0,30,14
1655990257369,MATH 10B,A01,083207,Lim; Seonhee,1,1,34,33
1655990257369,MATH 10B,A02,083208,Lim; Seonhee,1,1,35,34
1655990257369,MATH 10B,A03,093472,Staff,1,0,34,33
1655990257369,MATH 10B,B01,083739,Sinha; Shubham,9,0,30,21
1655990263400,MATH 18,A01,083743,Cinel; Cameron Alexander,5,0,30,25
1655990263400,MATH 18,A02,083744,Cinel; Cameron Alexander,11,0,30,19
1655990263400,MATH 18,A03,083745,Cinel; Cameron Alexander,1,0,30,29
1655990263400,MATH 18,B01,083748,Ma; Zilu,2,0,36,34
1655990263400,MATH 18,B02,083749,Ma; Zilu,0,0,36,36
1655990263400,MATH 18,B03,083750,Ma; Zilu,0,0,36,36
1655990263400,MATH 18,B04,083751,Ma; Zilu,0,0,36,36
1655990263400,MATH 18,B05,093473,Staff,0,0,36,36
1655990263400,MATH 18,B06,093474,Staff,1,0,36,35
1655990269442,MATH 20A,A01,083754,Zheng; Zequn,10,0,40,30
1655990275474,MATH 20B,A01,083756,Briones; Jor-el Thomas Caparas,0,1,36,36
1655990275474,MATH 20B,A02,083757,Briones; Jor-el Thomas Caparas,1,0,36,35
1655990275474,MATH 20B,A03,093475,Staff,0,0,36,36
1655990281511,MATH 20C,A01,083760,Briones; Jor-el Thomas Caparas,0,2,35,35
1655990281511,MATH 20C,A02,083761,Briones; Jor-el Thomas Caparas,6,1,35,29
1655990281511,MATH 20C,A03,093476,Staff,0,0,35,35
1655990281511,MATH 20C,B01,083762,Bach; Quang Tran,3,0,30,27
1655990287540,MATH 20D,A01,083765,Tran; Brian Kha,1,0,30,29
1655990287540,MATH 20D,A02,083766,Tran; Brian Kha,0,1,30,30
1655990287540,MATH 20D,A03,083767,Tran; Brian Kha,1,0,30,29
1655990293576,MATH 20E,A01,083771,Ganguly; Soumya,0,1,32,32
1655990293576,MATH 20E,A02,083772,Ganguly; Soumya,1,1,32,31
1655990293576,MATH 20E,B01,083773,Ciotti; Benjamin,14,0,35,21
1655990293576,MATH 20E,B02,083774,Ciotti; Benjamin,12,0,35,23
1655990299605,MATH 103A,A01,083777,Greenfeld; Be'Eri,2,1,36,34
1655990299605,MATH 103A,A02,083778,Greenfeld; Be'Eri,2,0,36,34
1655990299605,MATH 103A,A03,093561,Staff,0,1,36,36
1655990299605,MATH 103A,B01,083779,Greenfeld; Be'Eri,7,1,36,29
1655990299605,MATH 103A,B02,083780,Greenfeld; Be'Eri,0,0,36,36
1655990299605,MATH 103A,B03,093562,Staff,0,0,36,36
1655990305637,MATH 105,A01,085443,Carter; Anne Toulson,4,1,35,31
1655990305637,MATH 105,A02,093477,Staff,8,0,35,27
1655990311665,MATH 109,A01,083213,Ganzberger; Geoffrey Michael,0,1,34,34
1655990311665,MATH 109,A02,083214,Ganzberger; Geoffrey Michael,0,0,34,34
1655990311665,MATH 109,A03,093478,Staff,1,0,34,33
1655990311665,MATH 109,B01,083215,Ganzberger; Geoffrey Michael,2,0,32,30
1655990311665,MATH 109,B02,083216,Ganzberger; Geoffrey Michael,0,0,32,32
1655990311665,MATH 109,B03,093479,Staff,4,0,32,28
1655990317694,MATH 142A,A01,083219,Chow; Bennett,0,0,32,32
1655990317694,MATH 142A,A02,083220,Chow; Bennett,7,0,32,25
1655990317694,MATH 142A,A03,093480,Staff,4,0,32,28
1655990317694,MATH 142A,B03,093481,Staff,3,0,32,29
1655990317694,MATH 142A,B04,093558,Staff,6,0,32,26
1655990317694,MATH 142A,B05,093559,Staff,0,0,32,32
1655990323722,MATH 193A,A01,083224,Rotar; Vladimir,1,1,34,33
1655990323722,MATH 193A,A02,083225,Rotar; Vladimir,0,0,34,34
1655990323722,MATH 193A,A03,083781,Rotar; Vladimir,2,0,34,32
1655990323722,MATH 193A,A04,083782,Rotar; Vladimir,3,0,34,31
1655990323722,MATH 193A,A05,093482,Rotar; Vladimir,0,0,34,34
1655990329877,MATH 197,001,091859,McAuley; Julian John,9999,0,9999,0
1655990329877,MATH 197,002,095566,Kedlaya; Kiran S.,9997,0,9999,2
1655990329877,MATH 197,003,095567,Xiao; Ming,9999,0,9999,0
1655990329877,MATH 197,004,095571,Perols; Johan Lars,9998,0,9999,1
1655990336983,COGS 9,A01,083615,Shannon; Kyle Michael,3,1,75,72
1655990343014,COGS 11,A01,083617,Boyle; Mary E. T.,11,1,48,37
1655990349042,COGS 13,A01,083071,Bastos; Amalia Pinkusfeld,3,2,71,68
1655990355070,COGS 14A,A01,092681,Semenuks; Arturs,4,25,100,96
1655990361101,COGS 14B,A01,083073,Cheng; Tzu-Han,7,0,63,56
1655990367132,COGS 17,A01,092677,Semenuks; Arturs,8,7,81,73
1655990373168,COGS 100,A01,083619,Allen; Michael Gordon,2,2,70,68
1655990379196,COGS 101A,A01,083621,Davis; Joshua Daniel,4,3,68,64
1655990385227,COGS 101B,A01,091572,Allen; Michael Gordon,0,0,65,65
1655990391253,COGS 101C,A01,083625,Delgado; Tania,7,0,35,28
1655990397279,COGS 107A,A01,083627,Boyle; Mary E. T.,1,2,60,59
1655990403310,COGS 118A,A01,083075,Gupta; Anjum,21,16,76,55
1655990409338,CSE 3,A50,083646,Miranda; Gregory Joseph,14,0,50,36
1655990415369,CSE 8A,A50,083650,Miranda; Gregory Joseph,3,11,56,53
1655990421395,CSE 11,A01,083080,Cao; Yingjun,0,65,40,40
1655990427435,CSE 12,A01,083652,Krause-Levy; Sophia Louisa,6,8,120,114
1655990433466,CSE 15L,A01,083654,Morris; Justin Loren,3,1,50,47
1655990433466,CSE 15L,A02,083655,Morris; Justin Loren,1,1,50,49
1655990439496,CSE 20,A01,083657,Tran; Khoa Dang,29,0,80,51
1655990445526,CSE 21,A01,095574,Bach; Quang Tran,23,0,48,25
1655990451553,CSE 30,A01,083084,Eldon; John,2,10,80,78
1655990451553,CSE 30,B01,095061,Bhaskar; Nishant,0,4,50,50
1655990457579,CSE 100,A01,083659,Cao; Yingjun,2,25,70,68
1655990463610,CSE 134B,A01,083661,Powell; Thomas Allan,6,7,100,94
1655990469641,CSE 140,A01,083663,Gungor; Onat,5,0,85,80
1655990475667,CSE 140L,A01,083088,Eldon; John,5,0,100,95
1655990481702,CSE 175,A01,083665,Kumar; Rakesh,1,0,25,24
1655990487742,CSE 190,A00,092507,Dubnov; Shlomo,1,0,20,19
1655990493770,ECE 45,A01,083139,Congero; Spencer William,0,1,75,75
1655990499798,ECE 65,A50,083695,Saad; Andrew S,6,0,30,24
1655990499798,ECE 65,A51,095125,Staff,23,0,26,3
1655990505831,ECE 109,A01,091882,Touri; Behrouz,2,4,70,68
1655990511864,ECE 180,A00,083140,Abi Samra; Nicholas Camill,1,0,30,29
1655990511864,ECE 180,B00,083141,Abi Samra; Nicholas Camill,0,8,28,28
1655990517894,MATH 10A,A01,083735,Patchell; Gregory David,0,0,30,30
1655990517894,MATH 10A,A02,083736,Patchell; Gregory David,21,0,30,9
1655990517894,MATH 10A,A03,083737,Patchell; Gregory David,16,0,30,14
1655990523923,MATH 10B,A01,083207,Lim; Seonhee,1,1,34,33
1655990523923,MATH 10B,A02,083208,Lim; Seonhee,1,1,35,34
1655990523923,MATH 10B,A03,093472,Staff,1,0,34,33
1655990523923,MATH 10B,B01,083739,Sinha; Shubham,9,0,30,21
1655990529963,MATH 18,A01,083743,Cinel; Cameron Alexander,5,0,30,25
1655990529963,MATH 18,A02,083744,Cinel; Cameron Alexander,11,0,30,19
1655990529963,MATH 18,A03,083745,Cinel; Cameron Alexander,1,0,30,29
1655990529963,MATH 18,B01,083748,Ma; Zilu,2,0,36,34
1655990529963,MATH 18,B02,083749,Ma; Zilu,0,0,36,36
1655990529963,MATH 18,B03,083750,Ma; Zilu,0,0,36,36
1655990529963,MATH 18,B04,083751,Ma; Zilu,0,0,36,36
1655990529963,MATH 18,B05,093473,Staff,0,0,36,36
1655990529963,MATH 18,B06,093474,Staff,1,0,36,35
1655990535993,MATH 20A,A01,083754,Zheng; Zequn,10,0,40,30
1655990542021,MATH 20B,A01,083756,Briones; Jor-el Thomas Caparas,0,1,36,36
1655990542021,MATH 20B,A02,083757,Briones; Jor-el Thomas Caparas,1,0,36,35
1655990542021,MATH 20B,A03,093475,Staff,0,0,36,36
1655990548049,MATH 20C,A01,083760,Briones; Jor-el Thomas Caparas,0,2,35,35
1655990548049,MATH 20C,A02,083761,Briones; Jor-el Thomas Caparas,6,1,35,29
1655990548049,MATH 20C,A03,093476,Staff,0,0,35,35
1655990548049,MATH 20C,B01,083762,Bach; Quang Tran,3,0,30,27
1655990554076,MATH 20D,A01,083765,Tran; Brian Kha,1,0,30,29
1655990554076,MATH 20D,A02,083766,Tran; Brian Kha,0,1,30,30
1655990554076,MATH 20D,A03,083767,Tran; Brian Kha,1,0,30,29
1655990560106,MATH 20E,A01,083771,Ganguly; Soumya,0,1,32,32
1655990560106,MATH 20E,A02,083772,Ganguly; Soumya,1,1,32,31
1655990560106,MATH 20E,B01,083773,Ciotti; Benjamin,14,0,35,21
1655990560106,MATH 20E,B02,083774,Ciotti; Benjamin,12,0,35,23
1655990566143,MATH 103A,A01,083777,Greenfeld; Be'Eri,2,1,36,34
1655990566143,MATH 103A,A02,083778,Greenfeld; Be'Eri,2,0,36,34
1655990566143,MATH 103A,A03,093561,Staff,0,1,36,36
1655990566143,MATH 103A,B01,083779,Greenfeld; Be'Eri,7,1,36,29
1655990566143,MATH 103A,B02,083780,Greenfeld; Be'Eri,0,0,36,36
1655990566143,MATH 103A,B03,093562,Staff,0,0,36,36
1655990572170,MATH 105,A01,085443,Carter; Anne Toulson,4,1,35,31
1655990572170,MATH 105,A02,093477,Staff,8,0,35,27
1655990578205,MATH 109,A01,083213,Ganzberger; Geoffrey Michael,0,1,34,34
1655990578205,MATH 109,A02,083214,Ganzberger; Geoffrey Michael,0,0,34,34
1655990578205,MATH 109,A03,093478,Staff,1,0,34,33
1655990578205,MATH 109,B01,083215,Ganzberger; Geoffrey Michael,2,0,32,30
1655990578205,MATH 109,B02,083216,Ganzberger; Geoffrey Michael,0,0,32,32
1655990578205,MATH 109,B03,093479,Staff,4,0,32,28
1655990584243,MATH 142A,A01,083219,Chow; Bennett,0,0,32,32
1655990584243,MATH 142A,A02,083220,Chow; Bennett,7,0,32,25
1655990584243,MATH 142A,A03,093480,Staff,4,0,32,28
1655990584243,MATH 142A,B03,093481,Staff,3,0,32,29
1655990584243,MATH 142A,B04,093558,Staff,6,0,32,26
1655990584243,MATH 142A,B05,093559,Staff,0,0,32,32
1655990590270,MATH 193A,A01,083224,Rotar; Vladimir,1,1,34,33
1655990590270,MATH 193A,A02,083225,Rotar; Vladimir,0,0,34,34
1655990590270,MATH 193A,A03,083781,Rotar; Vladimir,2,0,34,32
1655990590270,MATH 193A,A04,083782,Rotar; Vladimir,3,0,34,31
1655990590270,MATH 193A,A05,093482,Rotar; Vladimir,0,0,34,34
1655990596295,MATH 197,001,091859,McAuley; Julian John,9999,0,9999,0
1655990596295,MATH 197,002,095566,Kedlaya; Kiran S.,9997,0,9999,2
1655990596295,MATH 197,003,095567,Xiao; Ming,9999,0,9999,0
1655990596295,MATH 197,004,095571,Perols; Johan Lars,9998,0,9999,1
1655990603380,COGS 9,A01,083615,Shannon; Kyle Michael,3,1,75,72
1655990609405,COGS 11,A01,083617,Boyle; Mary E. T.,11,1,48,37
1655990615435,COGS 13,A01,083071,Bastos; Amalia Pinkusfeld,3,2,71,68
1655990621462,COGS 14A,A01,092681,Semenuks; Arturs,4,25,100,96
1655990627490,COGS 14B,A01,083073,Cheng; Tzu-Han,7,0,63,56
1655990633515,COGS 17,A01,092677,Semenuks; Arturs,8,7,81,73
1655990639542,COGS 100,A01,083619,Allen; Michael Gordon,2,2,70,68
1655990645569,COGS 101A,A01,083621,Davis; Joshua Daniel,4,3,68,64
1655990651600,COGS 101B,A01,091572,Allen; Michael Gordon,0,0,65,65
1655990657627,COGS 101C,A01,083625,Delgado; Tania,7,0,35,28
1655990663652,COGS 107A,A01,083627,Boyle; Mary E. T.,1,2,60,59
1655990669692,COGS 118A,A01,083075,Gupta; Anjum,21,16,76,55
1655990675727,CSE 3,A50,083646,Miranda; Gregory Joseph,14,0,50,36
1655990681757,CSE 8A,A50,083650,Miranda; Gregory Joseph,3,11,56,53
1655990687785,CSE 11,A01,083080,Cao; Yingjun,0,65,40,40
1655990693819,CSE 12,A01,083652,Krause-Levy; Sophia Louisa,6,8,120,114
1655990699845,CSE 15L,A01,083654,Morris; Justin Loren,3,1,50,47
1655990699845,CSE 15L,A02,083655,Morris; Justin Loren,1,1,50,49
1655990705879,CSE 20,A01,083657,Tran; Khoa Dang,29,0,80,51
1655990711906,CSE 21,A01,095574,Bach; Quang Tran,23,0,48,25
1655990717940,CSE 30,A01,083084,Eldon; John,2,10,80,78
1655990717940,CSE 30,B01,095061,Bhaskar; Nishant,0,4,50,50
1655990723980,CSE 100,A01,083659,Cao; Yingjun,2,25,70,68
1655990730011,CSE 134B,A01,083661,Powell; Thomas Allan,6,7,100,94
1655990736041,CSE 140,A01,083663,Gungor; Onat,5,0,85,80
1655990742069,CSE 140L,A01,083088,Eldon; John,5,0,100,95
1655990748101,CSE 175,A01,083665,Kumar; Rakesh,1,0,25,24
1655990754134,CSE 190,A00,092507,Dubnov; Shlomo,1,0,20,19
1655990760169,ECE 45,A01,083139,Congero; Spencer William,0,1,75,75
1655990766196,ECE 65,A50,083695,Saad; Andrew S,6,0,30,24
1655990766196,ECE 65,A51,095125,Staff,23,0,26,3
1655990772222,ECE 109,A01,091882,Touri; Behrouz,2,4,70,68
1655990778254,ECE 180,A00,083140,Abi Samra; Nicholas Camill,1,0,30,29
1655990778254,ECE 180,B00,083141,Abi Samra; Nicholas Camill,0,8,28,28
1655990784283,MATH 10A,A01,083735,Patchell; Gregory David,0,0,30,30
1655990784283,MATH 10A,A02,083736,Patchell; Gregory David,21,0,30,9
1655990784283,MATH 10A,A03,083737,Patchell; Gregory David,16,0,30,14
1655990790312,MATH 10B,A01,083207,Lim; Seonhee,1,1,34,33
1655990790312,MATH 10B,A02,083208,Lim; Seonhee,1,1,35,34
1655990790312,MATH 10B,A03,093472,Staff,1,0,34,33
1655990790312,MATH 10B,B01,083739,Sinha; Shubham,9,0,30,21
1655990796343,MATH 18,A01,083743,Cinel; Cameron Alexander,5,0,30,25
1655990796343,MATH 18,A02,083744,Cinel; Cameron Alexander,11,0,30,19
1655990796343,MATH 18,A03,083745,Cinel; Cameron Alexander,1,0,30,29
1655990796343,MATH 18,B01,083748,Ma; Zilu,2,0,36,34
1655990796343,MATH 18,B02,083749,Ma; Zilu,0,0,36,36
1655990796343,MATH 18,B03,083750,Ma; Zilu,0,0,36,36
1655990796343,MATH 18,B04,083751,Ma; Zilu,0,0,36,36
1655990796343,MATH 18,B05,093473,Staff,0,0,36,36
1655990796343,MATH 18,B06,093474,Staff,1,0,36,35
1655990802369,MATH 20A,A01,083754,Zheng; Zequn,10,0,40,30
1655990808404,MATH 20B,A01,083756,Briones; Jor-el Thomas Caparas,0,1,36,36
1655990808404,MATH 20B,A02,083757,Briones; Jor-el Thomas Caparas,1,0,36,35
1655990808404,MATH 20B,A03,093475,Staff,0,0,36,36
1655990814430,MATH 20C,A01,083760,Briones; Jor-el Thomas Caparas,0,2,35,35
1655990814430,MATH 20C,A02,083761,Briones; Jor-el Thomas Caparas,6,1,35,29
1655990814430,MATH 20C,A03,093476,Staff,0,0,35,35
1655990814430,MATH 20C,B01,083762,Bach; Quang Tran,3,0,30,27
1655990820458,MATH 20D,A01,083765,Tran; Brian Kha,1,0,30,29
1655990820458,MATH 20D,A02,083766,Tran; Brian Kha,0,1,30,30
1655990820458,MATH 20D,A03,083767,Tran; Brian Kha,1,0,30,29
1655990826485,MATH 20E,A01,083771,Ganguly; Soumya,0,1,32,32
1655990826485,MATH 20E,A02,083772,Ganguly; Soumya,1,1,32,31
1655990826485,MATH 20E,B01,083773,Ciotti; Benjamin,14,0,35,21
1655990826485,MATH 20E,B02,083774,Ciotti; Benjamin,12,0,35,23
1655990832603,MATH 103A,A01,083777,Greenfeld; Be'Eri,2,1,36,34
1655990832603,MATH 103A,A02,083778,Greenfeld; Be'Eri,2,0,36,34
1655990832603,MATH 103A,A03,093561,Staff,0,1,36,36
1655990832603,MATH 103A,B01,083779,Greenfeld; Be'Eri,7,1,36,29
1655990832603,MATH 103A,B02,083780,Greenfeld; Be'Eri,0,0,36,36
1655990832603,MATH 103A,B03,093562,Staff,0,0,36,36
1655990838637,MATH 105,A01,085443,Carter; Anne Toulson,4,1,35,31
1655990838637,MATH 105,A02,093477,Staff,8,0,35,27
1655990844670,MATH 109,A01,083213,Ganzberger; Geoffrey Michael,0,1,34,34
1655990844670,MATH 109,A02,083214,Ganzberger; Geoffrey Michael,0,0,34,34
1655990844670,MATH 109,A03,093478,Staff,1,0,34,33
1655990844670,MATH 109,B01,083215,Ganzberger; Geoffrey Michael,2,0,32,30
1655990844670,MATH 109,B02,083216,Ganzberger; Geoffrey Michael,0,0,32,32
1655990844670,MATH 109,B03,093479,Staff,4,0,32,28
1655990850698,MATH 142A,A01,083219,Chow; Bennett,0,0,32,32
1655990850698,MATH 142A,A02,083220,Chow; Bennett,7,0,32,25
1655990850698,MATH 142A,A03,093480,Staff,4,0,32,28
1655990850698,MATH 142A,B03,093481,Staff,3,0,32,29
1655990850698,MATH 142A,B04,093558,Staff,6,0,32,26
1655990850698,MATH 142A,B05,093559,Staff,0,0,32,32
1655990856726,MATH 193A,A01,083224,Rotar; Vladimir,1,1,34,33
1655990856726,MATH 193A,A02,083225,Rotar; Vladimir,0,0,34,34
1655990856726,MATH 193A,A03,083781,Rotar; Vladimir,2,0,34,32
1655990856726,MATH 193A,A04,083782,Rotar; Vladimir,3,0,34,31
1655990856726,MATH 193A,A05,093482,Rotar; Vladimir,0,0,34,34
1655990862752,MATH 197,001,091859,McAuley; Julian John,9999,0,9999,0
1655990862752,MATH 197,002,095566,Kedlaya; Kiran S.,9997,0,9999,2
1655990862752,MATH 197,003,095567,Xiao; Ming,9999,0,9999,0
1655990862752,MATH 197,004,095571,Perols; Johan Lars,9998,0,9999,1
1655990869846,COGS 9,A01,083615,Shannon; Kyle Michael,3,1,75,72
1655990875873,COGS 11,A01,083617,Boyle; Mary E. T.,11,1,48,37
1655990881899,COGS 13,A01,083071,Bastos; Amalia Pinkusfeld,3,2,71,68
1655990887930,COGS 14A,A01,092681,Semenuks; Arturs,4,25,100,96
1655990893958,COGS 14B,A01,083073,Cheng; Tzu-Han,7,0,63,56
1655990899996,COGS 17,A01,092677,Semenuks; Arturs,8,7,81,73
1655990906022,COGS 100,A01,083619,Allen; Michael Gordon,2,2,70,68
1655990912057,COGS 101A,A01,083621,Davis; Joshua Daniel,4,3,68,64
1655990918083,COGS 101B,A01,091572,Allen; Michael Gordon,0,0,65,65
1655990924110,COGS 101C,A01,083625,Delgado; Tania,7,0,35,28
1655990930135,COGS 107A,A01,083627,Boyle; Mary E. T.,1,2,60,59
1655990936165,COGS 118A,A01,083075,Gupta; Anjum,21,16,76,55
1655990942193,CSE 3,A50,083646,Miranda; Gregory Joseph,14,0,50,36
1655990948220,CSE 8A,A50,083650,Miranda; Gregory Joseph,3,11,56,53
1655990954250,CSE 11,A01,083080,Cao; Yingjun,0,65,40,40
1655990960281,CSE 12,A01,083652,Krause-Levy; Sophia Louisa,6,8,120,114
1655990966310,CSE 15L,A01,083654,Morris; Justin Loren,3,1,50,47
1655990966310,CSE 15L,A02,083655,Morris; Justin Loren,1,1,50,49
1655990972344,CSE 20,A01,083657,Tran; Khoa Dang,29,0,80,51
1655990978375,CSE 21,A01,095574,Bach; Quang Tran,23,0,48,25
1655990984404,CSE 30,A01,083084,Eldon; John,2,10,80,78
1655990984404,CSE 30,B01,095061,Bhaskar; Nishant,0,4,50,50
1655990990431,CSE 100,A01,083659,Cao; Yingjun,2,25,70,68
1655990996462,CSE 134B,A01,083661,Powell; Thomas Allan,6,7,100,94
1655991002485,CSE 140,A01,083663,Gungor; Onat,5,0,85,80
1655991008511,CSE 140L,A01,083088,Eldon; John,5,0,100,95
1655991014537,CSE 175,A01,083665,Kumar; Rakesh,1,0,25,24
1655991020562,CSE 190,A00,092507,Dubnov; Shlomo,1,0,20,19
1655991026595,ECE 45,A01,083139,Congero; Spencer William,0,1,75,75
1655991032630,ECE 65,A50,083695,Saad; Andrew S,6,0,30,24
1655991032630,ECE 65,A51,095125,Staff,23,0,26,3
1655991038663,ECE 109,A01,091882,Touri; Behrouz,2,4,70,68
1655991044689,ECE 180,A00,083140,Abi Samra; Nicholas Camill,1,0,30,29
1655991044689,ECE 180,B00,083141,Abi Samra; Nicholas Camill,0,8,28,28
1655991050719,MATH 10A,A01,083735,Patchell; Gregory David,0,0,30,30
1655991050719,MATH 10A,A02,083736,Patchell; Gregory David,21,0,30,9
1655991050719,MATH 10A,A03,083737,Patchell; Gregory David,16,0,30,14
1655991056754,MATH 10B,A01,083207,Lim; Seonhee,1,1,34,33
1655991056754,MATH 10B,A02,083208,Lim; Seonhee,1,1,35,34
1655991056754,MATH 10B,A03,093472,Staff,1,0,34,33
1655991056754,MATH 10B,B01,083739,Sinha; Shubham,9,0,30,21
1655991062805,MATH 18,A01,083743,Cinel; Cameron Alexander,5,0,30,25
1655991062805,MATH 18,A02,083744,Cinel; Cameron Alexander,11,0,30,19
1655991062805,MATH 18,A03,083745,Cinel; Cameron Alexander,1,0,30,29
1655991062805,MATH 18,B01,083748,Ma; Zilu,2,0,36,34
1655991062805,MATH 18,B02,083749,Ma; Zilu,0,0,36,36
1655991062805,MATH 18,B03,083750,Ma; Zilu,0,0,36,36
1655991062805,MATH 18,B04,083751,Ma; Zilu,0,0,36,36
1655991062805,MATH 18,B05,093473,Staff,0,0,36,36
1655991062805,MATH 18,B06,093474,Staff,1,0,36,35
1655991068837,MATH 20A,A01,083754,Zheng; Zequn,10,0,40,30
1655991074873,MATH 20B,A01,083756,Briones; Jor-el Thomas Caparas,0,1,36,36
1655991074873,MATH 20B,A02,083757,Briones; Jor-el Thomas Caparas,1,0,36,35
1655991074873,MATH 20B,A03,093475,Staff,0,0,36,36
1655991080902,MATH 20C,A01,083760,Briones; Jor-el Thomas Caparas,0,2,35,35
1655991080902,MATH 20C,A02,083761,Briones; Jor-el Thomas Caparas,6,1,35,29
1655991080902,MATH 20C,A03,093476,Staff,0,0,35,35
1655991080902,MATH 20C,B01,083762,Bach; Quang Tran,3,0,30,27
1655991086934,MATH 20D,A01,083765,Tran; Brian Kha,1,0,30,29
1655991086934,MATH 20D,A02,083766,Tran; Brian Kha,0,1,30,30
1655991086934,MATH 20D,A03,083767,Tran; Brian Kha,1,0,30,29
1655991092971,MATH 20E,A01,083771,Ganguly; Soumya,0,1,32,32
1655991092971,MATH 20E,A02,083772,Ganguly; Soumya,1,1,32,31
1655991092971,MATH 20E,B01,083773,Ciotti; Benjamin,14,0,35,21
1655991092971,MATH 20E,B02,083774,Ciotti; Benjamin,12,0,35,23
1655991099008,MATH 103A,A01,083777,Greenfeld; Be'Eri,2,1,36,34
1655991099008,MATH 103A,A02,083778,Greenfeld; Be'Eri,2,0,36,34
1655991099008,MATH 103A,A03,093561,Staff,0,1,36,36
1655991099008,MATH 103A,B01,083779,Greenfeld; Be'Eri,7,1,36,29
1655991099008,MATH 103A,B02,083780,Greenfeld; Be'Eri,0,0,36,36
1655991099008,MATH 103A,B03,093562,Staff,0,0,36,36
1655991105034,MATH 105,A01,085443,Carter; Anne Toulson,4,1,35,31
1655991105034,MATH 105,A02,093477,Staff,8,0,35,27
1655991111072,MATH 109,A01,083213,Ganzberger; Geoffrey Michael,0,1,34,34
1655991111072,MATH 109,A02,083214,Ganzberger; Geoffrey Michael,0,0,34,34
1655991111072,MATH 109,A03,093478,Staff,1,0,34,33
1655991111072,MATH 109,B01,083215,Ganzberger; Geoffrey Michael,2,0,32,30
1655991111072,MATH 109,B02,083216,Ganzberger; Geoffrey Michael,0,0,32,32
1655991111072,MATH 109,B03,093479,Staff,4,0,32,28
1655991117101,MATH 142A,A01,083219,Chow; Bennett,0,0,32,32
1655991117101,MATH 142A,A02,083220,Chow; Bennett,7,0,32,25
1655991117101,MATH 142A,A03,093480,Staff,4,0,32,28
1655991117101,MATH 142A,B03,093481,Staff,3,0,32,29
1655991117101,MATH 142A,B04,093558,Staff,6,0,32,26
1655991117101,MATH 142A,B05,093559,Staff,0,0,32,32
1655991123133,MATH 193A,A01,083224,Rotar; Vladimir,1,1,34,33
1655991123133,MATH 193A,A02,083225,Rotar; Vladimir,0,0,34,34
1655991123133,MATH 193A,A03,083781,Rotar; Vladimir,2,0,34,32
1655991123133,MATH 193A,A04,083782,Rotar; Vladimir,3,0,34,31
1655991123133,MATH 193A,A05,093482,Rotar; Vladimir,0,0,34,34
1655991129164,MATH 197,001,091859,McAuley; Julian John,9999,0,9999,0
1655991129164,MATH 197,002,095566,Kedlaya; Kiran S.,9997,0,9999,2
1655991129164,MATH 197,003,095567,Xiao; Ming,9999,0,9999,0
1655991129164,MATH 197,004,095571,Perols; Johan Lars,9998,0,9999,1
1655991136234,COGS 9,A01,083615,Shannon; Kyle Michael,3,1,75,72
1655991142260,COGS 11,A01,083617,Boyle; Mary E. T.,11,1,48,37
1655991148286,COGS 13,A01,083071,Bastos; Amalia Pinkusfeld,3,2,71,68
1655991154312,COGS 14A,A01,092681,Semenuks; Arturs,4,25,100,96
1655991160342,COGS 14B,A01,083073,Cheng; Tzu-Han,7,0,63,56
1655991166373,COGS 17,A01,092677,Semenuks; Arturs,8,7,81,73
1655991172397,COGS 100,A01,083619,Allen; Michael Gordon,2,2,70,68
1655991178428,COGS 101A,A01,083621,Davis; Joshua Daniel,4,3,68,64
1655991184452,COGS 101B,A01,091572,Allen; Michael Gordon,0,0,65,65
1655991190483,COGS 101C,A01,083625,Delgado; Tania,7,0,35,28
1655991196508,COGS 107A,A01,083627,Boyle; Mary E. T.,1,2,60,59
1655991202536,COGS 118A,A01,083075,Gupta; Anjum,21,16,76,55
1655991208563,CSE 3,A50,083646,Miranda; Gregory Joseph,14,0,50,36
1655991214588,CSE 8A,A50,083650,Miranda; Gregory Joseph,3,11,56,53
1655991220612,CSE 11,A01,083080,Cao; Yingjun,0,65,40,40
1655991226648,CSE 12,A01,083652,Krause-Levy; Sophia Louisa,6,8,120,114
1655991232676,CSE 15L,A01,083654,Morris; Justin Loren,3,1,50,47
1655991232676,CSE 15L,A02,083655,Morris; Justin Loren,1,1,50,49
1655991238707,CSE 20,A01,083657,Tran; Khoa Dang,29,0,80,51
1655991244737,CSE 21,A01,095574,Bach; Quang Tran,23,0,48,25
1655991250772,CSE 30,A01,083084,Eldon; John,2,10,80,78
1655991250772,CSE 30,B01,095061,Bhaskar; Nishant,0,4,50,50
1655991256799,CSE 100,A01,083659,Cao; Yingjun,2,25,70,68
1655991262830,CSE 134B,A01,083661,Powell; Thomas Allan,6,7,100,94
1655991268862,CSE 140,A01,083663,Gungor; Onat,5,0,85,80
1655991274890,CSE 140L,A01,083088,Eldon; John,5,0,100,95
1655991280919,CSE 175,A01,083665,Kumar; Rakesh,1,0,25,24
1655991286945,CSE 190,A00,092507,Dubnov; Shlomo,1,0,20,19
1655991292974,ECE 45,A01,083139,Congero; Spencer William,0,1,75,75
1655991299007,ECE 65,A50,083695,Saad; Andrew S,6,0,30,24
1655991299007,ECE 65,A51,095125,Staff,23,0,26,3
1655991305035,ECE 109,A01,091882,Touri; Behrouz,2,4,70,68
1655991311067,ECE 180,A00,083140,Abi Samra; Nicholas Camill,1,0,30,29
1655991311067,ECE 180,B00,083141,Abi Samra; Nicholas Camill,0,8,28,28
1655991317097,MATH 10A,A01,083735,Patchell; Gregory David,0,0,30,30
1655991317097,MATH 10A,A02,083736,Patchell; Gregory David,21,0,30,9
1655991317097,MATH 10A,A03,083737,Patchell; Gregory David,16,0,30,14
1655991323128,MATH 10B,A01,083207,Lim; Seonhee,1,1,34,33
1655991323128,MATH 10B,A02,083208,Lim; Seonhee,1,1,35,34
1655991323128,MATH 10B,A03,093472,Staff,1,0,34,33
1655991323128,MATH 10B,B01,083739,Sinha; Shubham,9,0,30,21
1655991329168,MATH 18,A01,083743,Cinel; Cameron Alexander,5,0,30,25
1655991329168,MATH 18,A02,083744,Cinel; Cameron Alexander,11,0,30,19
1655991329168,MATH 18,A03,083745,Cinel; Cameron Alexander,1,0,30,29
1655991329168,MATH 18,B01,083748,Ma; Zilu,2,0,36,34
1655991329168,MATH 18,B02,083749,Ma; Zilu,0,0,36,36
1655991329168,MATH 18,B03,083750,Ma; Zilu,0,0,36,36
1655991329168,MATH 18,B04,083751,Ma; Zilu,0,0,36,36
1655991329168,MATH 18,B05,093473,Staff,0,0,36,36
1655991329168,MATH 18,B06,093474,Staff,1,0,36,35
1655991335202,MATH 20A,A01,083754,Zheng; Zequn,10,0,40,30
1655991341244,MATH 20B,A01,083756,Briones; Jor-el Thomas Caparas,0,1,36,36
1655991341244,MATH 20B,A02,083757,Briones; Jor-el Thomas Caparas,1,0,36,35
1655991341244,MATH 20B,A03,093475,Staff,0,0,36,36
1655991347281,MATH 20C,A01,083760,Briones; Jor-el Thomas Caparas,0,2,35,35
1655991347281,MATH 20C,A02,083761,Briones; Jor-el Thomas Caparas,6,1,35,29
1655991347281,MATH 20C,A03,093476,Staff,0,0,35,35
1655991347281,MATH 20C,B01,083762,Bach; Quang Tran,3,0,30,27
1655991353308,MATH 20D,A01,083765,Tran; Brian Kha,1,0,30,29
1655991353308,MATH 20D,A02,083766,Tran; Brian Kha,0,1,30,30
1655991353308,MATH 20D,A03,083767,Tran; Brian Kha,1,0,30,29
1655991359344,MATH 20E,A01,083771,Ganguly; Soumya,0,1,32,32
1655991359344,MATH 20E,A02,083772,Ganguly; Soumya,1,1,32,31
1655991359344,MATH 20E,B01,083773,Ciotti; Benjamin,14,0,35,21
1655991359344,MATH 20E,B02,083774,Ciotti; Benjamin,12,0,35,23
1655991365385,MATH 103A,A01,083777,Greenfeld; Be'Eri,2,1,36,34
1655991365385,MATH 103A,A02,083778,Greenfeld; Be'Eri,2,0,36,34
1655991365385,MATH 103A,A03,093561,Staff,0,1,36,36
1655991365385,MATH 103A,B01,083779,Greenfeld; Be'Eri,7,1,36,29
1655991365385,MATH 103A,B02,083780,Greenfeld; Be'Eri,0,0,36,36
1655991365385,MATH 103A,B03,093562,Staff,0,0,36,36
1655991371419,MATH 105,A01,085443,Carter; Anne Toulson,4,1,35,31
1655991371419,MATH 105,A02,093477,Staff,8,0,35,27
1655991377447,MATH 109,A01,083213,Ganzberger; Geoffrey Michael,0,1,34,34
1655991377447,MATH 109,A02,083214,Ganzberger; Geoffrey Michael,0,0,34,34
1655991377447,MATH 109,A03,093478,Staff,1,0,34,33
1655991377447,MATH 109,B01,083215,Ganzberger; Geoffrey Michael,2,0,32,30
1655991377447,MATH 109,B02,083216,Ganzberger; Geoffrey Michael,0,0,32,32
1655991377447,MATH 109,B03,093479,Staff,4,0,32,28
1655991383476,MATH 142A,A01,083219,Chow; Bennett,0,0,32,32
1655991383476,MATH 142A,A02,083220,Chow; Bennett,7,0,32,25
1655991383476,MATH 142A,A03,093480,Staff,4,0,32,28
1655991383476,MATH 142A,B03,093481,Staff,3,0,32,29
1655991383476,MATH 142A,B04,093558,Staff,6,0,32,26
1655991383476,MATH 142A,B05,093559,Staff,0,0,32,32
1655991389512,MATH 193A,A01,083224,Rotar; Vladimir,1,1,34,33
1655991389512,MATH 193A,A02,083225,Rotar; Vladimir,0,0,34,34
1655991389512,MATH 193A,A03,083781,Rotar; Vladimir,2,0,34,32
1655991389512,MATH 193A,A04,083782,Rotar; Vladimir,3,0,34,31
1655991389512,MATH 193A,A05,093482,Rotar; Vladimir,0,0,34,34
1655991395543,MATH 197,001,091859,McAuley; Julian John,9999,0,9999,0
1655991395543,MATH 197,002,095566,Kedlaya; Kiran S.,9997,0,9999,2
1655991395543,MATH 197,003,095567,Xiao; Ming,9999,0,9999,0
1655991395543,MATH 197,004,095571,Perols; Johan Lars,9998,0,9999,1
1655991402624,COGS 9,A01,083615,Shannon; Kyle Michael,3,1,75,72
1655991408654,COGS 11,A01,083617,Boyle; Mary E. T.,11,1,48,37
1655991414680,COGS 13,A01,083071,Bastos; Amalia Pinkusfeld,3,2,71,68
1655991420708,COGS 14A,A01,092681,Semenuks; Arturs,4,25,100,96
1655991426830,COGS 14B,A01,083073,Cheng; Tzu-Han,7,0,63,56
1655991432862,COGS 17,A01,092677,Semenuks; Arturs,8,7,81,73
1655991438888,COGS 100,A01,083619,Allen; Michael Gordon,2,2,70,68
1655991444915,COGS 101A,A01,083621,Davis; Joshua Daniel,4,3,68,64
1655991450940,COGS 101B,A01,091572,Allen; Michael Gordon,0,0,65,65
1655991456965,COGS 101C,A01,083625,Delgado; Tania,7,0,35,28
1655991462993,COGS 107A,A01,083627,Boyle; Mary E. T.,1,2,60,59
1655991469023,COGS 118A,A01,083075,Gupta; Anjum,21,16,76,55
1655991475051,CSE 3,A50,083646,Miranda; Gregory Joseph,14,0,50,36
1655991481080,CSE 8A,A50,083650,Miranda; Gregory Joseph,3,11,56,53
1655991487106,CSE 11,A01,083080,Cao; Yingjun,0,65,40,40
1655991493133,CSE 12,A01,083652,Krause-Levy; Sophia Louisa,6,8,120,114
1655991499168,CSE 15L,A01,083654,Morris; Justin Loren,3,1,50,47
1655991499168,CSE 15L,A02,083655,Morris; Justin Loren,1,1,50,49
1655991505225,CSE 20,A01,083657,Tran; Khoa Dang,29,0,80,51
1655991511250,CSE 21,A01,095574,Bach; Quang Tran,23,0,48,25
1655991517283,CSE 30,A01,083084,Eldon; John,2,10,80,78
1655991517283,CSE 30,B01,095061,Bhaskar; Nishant,0,4,50,50
1655991523307,CSE 100,A01,083659,Cao; Yingjun,2,25,70,68
1655991529336,CSE 134B,A01,083661,Powell; Thomas Allan,6,7,100,94
1655991535361,CSE 140,A01,083663,Gungor; Onat,5,0,85,80
1655991541386,CSE 140L,A01,083088,Eldon; John,5,0,100,95
1655991547412,CSE 175,A01,083665,Kumar; Rakesh,1,0,25,24
1655991553439,CSE 190,A00,092507,Dubnov; Shlomo,1,0,20,19
1655991559464,ECE 45,A01,083139,Congero; Spencer William,0,1,75,75
1655991565508,ECE 65,A50,083695,Saad; Andrew S,6,0,30,24
1655991565508,ECE 65,A51,095125,Staff,23,0,26,3
1655991571532,ECE 109,A01,091882,Touri; Behrouz,2,4,70,68
1655991577570,ECE 180,A00,083140,Abi Samra; Nicholas Camill,1,0,30,29
1655991577570,ECE 180,B00,083141,Abi Samra; Nicholas Camill,0,8,28,28
1655991583601,MATH 10A,A01,083735,Patchell; Gregory David,0,0,30,30
1655991583601,MATH 10A,A02,083736,Patchell; Gregory David,21,0,30,9
1655991583601,MATH 10A,A03,083737,Patchell; Gregory David,16,0,30,14
1655991589632,MATH 10B,A01,083207,Lim; Seonhee,1,1,34,33
1655991589632,MATH 10B,A02,083208,Lim; Seonhee,1,1,35,34
1655991589632,MATH 10B,A03,093472,Staff,1,0,34,33
1655991589632,MATH 10B,B01,083739,Sinha; Shubham,9,0,30,21
1655991595665,MATH 18,A01,083743,Cinel; Cameron Alexander,5,0,30,25
1655991595665,MATH 18,A02,083744,Cinel; Cameron Alexander,11,0,30,19
1655991595665,MATH 18,A03,083745,Cinel; Cameron Alexander,1,0,30,29
1655991595665,MATH 18,B01,083748,Ma; Zilu,2,0,36,34
1655991595665,MATH 18,B02,083749,Ma; Zilu,0,0,36,36
1655991595665,MATH 18,B03,083750,Ma; Zilu,0,0,36,36
1655991595665,MATH 18,B04,083751,Ma; Zilu,0,0,36,36
1655991595665,MATH 18,B05,093473,Staff,0,0,36,36
1655991595665,MATH 18,B06,093474,Staff,1,0,36,35
1655991601694,MATH 20A,A01,083754,Zheng; Zequn,10,0,40,30
1655991607723,MATH 20B,A01,083756,Briones; Jor-el Thomas Caparas,0,1,36,36
1655991607723,MATH 20B,A02,083757,Briones; Jor-el Thomas Caparas,1,0,36,35
1655991607723,MATH 20B,A03,093475,Staff,0,0,36,36
1655991613753,MATH 20C,A01,083760,Briones; Jor-el Thomas Caparas,0,2,35,35
1655991613753,MATH 20C,A02,083761,Briones; Jor-el Thomas Caparas,6,1,35,29
1655991613753,MATH 20C,A03,093476,Staff,0,0,35,35
1655991613753,MATH 20C,B01,083762,Bach; Quang Tran,3,0,30,27
1655991619777,MATH 20D,A01,083765,Tran; Brian Kha,1,0,30,29
1655991619777,MATH 20D,A02,083766,Tran; Brian Kha,0,1,30,30
1655991619777,MATH 20D,A03,083767,Tran; Brian Kha,1,0,30,29
1655991625806,MATH 20E,A01,083771,Ganguly; Soumya,0,1,32,32
1655991625806,MATH 20E,A02,083772,Ganguly; Soumya,1,1,32,31
1655991625806,MATH 20E,B01,083773,Ciotti; Benjamin,14,0,35,21
1655991625806,MATH 20E,B02,083774,Ciotti; Benjamin,12,0,35,23
1655991631836,MATH 103A,A01,083777,Greenfeld; Be'Eri,2,1,36,34
1655991631836,MATH 103A,A02,083778,Greenfeld; Be'Eri,2,0,36,34
1655991631836,MATH 103A,A03,093561,Staff,0,1,36,36
1655991631836,MATH 103A,B01,083779,Greenfeld; Be'Eri,7,1,36,29
1655991631836,MATH 103A,B02,083780,Greenfeld; Be'Eri,0,0,36,36
1655991631836,MATH 103A,B03,093562,Staff,0,0,36,36
1655991637863,MATH 105,A01,085443,Carter; Anne Toulson,4,1,35,31
1655991637863,MATH 105,A02,093477,Staff,8,0,35,27
1655991643893,MATH 109,A01,083213,Ganzberger; Geoffrey Michael,0,1,34,34
1655991643893,MATH 109,A02,083214,Ganzberger; Geoffrey Michael,0,0,34,34
1655991643893,MATH 109,A03,093478,Staff,1,0,34,33
1655991643893,MATH 109,B01,083215,Ganzberger; Geoffrey Michael,2,0,32,30
1655991643893,MATH 109,B02,083216,Ganzberger; Geoffrey Michael,0,0,32,32
1655991643893,MATH 109,B03,093479,Staff,4,0,32,28
1655991649923,MATH 142A,A01,083219,Chow; Bennett,0,0,32,32
1655991649923,MATH 142A,A02,083220,Chow; Bennett,7,0,32,25
1655991649923,MATH 142A,A03,093480,Staff,4,0,32,28
1655991649923,MATH 142A,B03,093481,Staff,3,0,32,29
1655991649923,MATH 142A,B04,093558,Staff,6,0,32,26
1655991649923,MATH 142A,B05,093559,Staff,0,0,32,32
1655991655961,MATH 193A,A01,083224,Rotar; Vladimir,1,1,34,33
1655991655961,MATH 193A,A02,083225,Rotar; Vladimir,0,0,34,34
1655991655961,MATH 193A,A03,083781,Rotar; Vladimir,2,0,34,32
1655991655961,MATH 193A,A04,083782,Rotar; Vladimir,3,0,34,31
1655991655961,MATH 193A,A05,093482,Rotar; Vladimir,0,0,34,34
1655991661989,MATH 197,001,091859,McAuley; Julian John,9999,0,9999,0
1655991661989,MATH 197,002,095566,Kedlaya; Kiran S.,9997,0,9999,2
1655991661989,MATH 197,003,095567,Xiao; Ming,9999,0,9999,0
1655991661989,MATH 197,004,095571,Perols; Johan Lars,9998,0,9999,1
1655991669072,COGS 9,A01,083615,Shannon; Kyle Michael,3,1,75,72
1655991675098,COGS 11,A01,083617,Boyle; Mary E. T.,11,1,48,37
1655991681142,COGS 13,A01,083071,Bastos; Amalia Pinkusfeld,3,2,71,68
1655991687168,COGS 14A,A01,092681,Semenuks; Arturs,4,25,100,96
1655991693197,COGS 14B,A01,083073,Cheng; Tzu-Han,7,0,63,56
1655991699224,COGS 17,A01,092677,Semenuks; Arturs,8,7,81,73
1655991705255,COGS 100,A01,083619,Allen; Michael Gordon,2,2,70,68
1655991711283,COGS 101A,A01,083621,Davis; Joshua Daniel,4,3,68,64
1655991717312,COGS 101B,A01,091572,Allen; Michael Gordon,0,0,65,65
1655991723344,COGS 101C,A01,083625,Delgado; Tania,7,0,35,28
1655991729367,COGS 107A,A01,083627,Boyle; Mary E. T.,1,2,60,59
1655991735394,COGS 118A,A01,083075,Gupta; Anjum,21,16,76,55
1655991741426,CSE 3,A50,083646,Miranda; Gregory Joseph,14,0,50,36
1655991747476,CSE 8A,A50,083650,Miranda; Gregory Joseph,3,11,56,53
1655991753501,CSE 11,A01,083080,Cao; Yingjun,0,65,40,40
1655991759529,CSE 12,A01,083652,Krause-Levy; Sophia Louisa,6,8,120,114
1655991765560,CSE 15L,A01,083654,Morris; Justin Loren,3,1,50,47
1655991765560,CSE 15L,A02,083655,Morris; Justin Loren,1,1,50,49
1655991771592,CSE 20,A01,083657,Tran; Khoa Dang,29,0,80,51
1655991777622,CSE 21,A01,095574,Bach; Quang Tran,23,0,48,25
1655991783655,CSE 30,A01,083084,Eldon; John,2,10,80,78
1655991783655,CSE 30,B01,095061,Bhaskar; Nishant,0,4,50,50
1655991789688,CSE 100,A01,083659,Cao; Yingjun,2,25,70,68
1655991795714,CSE 134B,A01,083661,Powell; Thomas Allan,6,7,100,94
1655991801744,CSE 140,A01,083663,Gungor; Onat,5,0,85,80
1655991807769,CSE 140L,A01,083088,Eldon; John,5,0,100,95
1655991813798,CSE 175,A01,083665,Kumar; Rakesh,1,0,25,24
1655991819832,CSE 190,A00,092507,Dubnov; Shlomo,1,0,20,19
1655991825861,ECE 45,A01,083139,Congero; Spencer William,0,1,75,75
1655991831889,ECE 65,A50,083695,Saad; Andrew S,6,0,30,24
1655991831889,ECE 65,A51,095125,Staff,23,0,26,3
1655991837917,ECE 109,A01,091882,Touri; Behrouz,2,4,70,68
1655991843944,ECE 180,A00,083140,Abi Samra; Nicholas Camill,1,0,30,29
1655991843944,ECE 180,B00,083141,Abi Samra; Nicholas Camill,0,8,28,28
1655991849972,MATH 10A,A01,083735,Patchell; Gregory David,0,0,30,30
1655991849972,MATH 10A,A02,083736,Patchell; Gregory David,21,0,30,9
1655991849972,MATH 10A,A03,083737,Patchell; Gregory David,16,0,30,14
1655991856002,MATH 10B,A01,083207,Lim; Seonhee,1,1,34,33
1655991856002,MATH 10B,A02,083208,Lim; Seonhee,1,1,35,34
1655991856002,MATH 10B,A03,093472,Staff,1,0,34,33
1655991856002,MATH 10B,B01,083739,Sinha; Shubham,9,0,30,21
1655991862034,MATH 18,A01,083743,Cinel; Cameron Alexander,5,0,30,25
1655991862034,MATH 18,A02,083744,Cinel; Cameron Alexander,11,0,30,19
1655991862034,MATH 18,A03,083745,Cinel; Cameron Alexander,1,0,30,29
1655991862034,MATH 18,B01,083748,Ma; Zilu,2,0,36,34
1655991862034,MATH 18,B02,083749,Ma; Zilu,0,0,36,36
1655991862034,MATH 18,B03,083750,Ma; Zilu,0,0,36,36
1655991862034,MATH 18,B04,083751,Ma; Zilu,0,0,36,36
1655991862034,MATH 18,B05,093473,Staff,0,0,36,36
1655991862034,MATH 18,B06,093474,Staff,1,0,36,35
1655991868065,MATH 20A,A01,083754,Zheng; Zequn,10,0,40,30
1655991874103,MATH 20B,A01,083756,Briones; Jor-el Thomas Caparas,0,1,36,36
1655991874103,MATH 20B,A02,083757,Briones; Jor-el Thomas Caparas,1,0,36,35
1655991874103,MATH 20B,A03,093475,Staff,0,0,36,36
1655991880139,MATH 20C,A01,083760,Briones; Jor-el Thomas Caparas,0,2,35,35
1655991880139,MATH 20C,A02,083761,Briones; Jor-el Thomas Caparas,6,1,35,29
1655991880139,MATH 20C,A03,093476,Staff,0,0,35,35
1655991880139,MATH 20C,B01,083762,Bach; Quang Tran,3,0,30,27
1655991886171,MATH 20D,A01,083765,Tran; Brian Kha,1,0,30,29
1655991886171,MATH 20D,A02,083766,Tran; Brian Kha,0,1,30,30
1655991886171,MATH 20D,A03,083767,Tran; Brian Kha,1,0,30,29
1655991892200,MATH 20E,A01,083771,Ganguly; Soumya,0,1,32,32
1655991892200,MATH 20E,A02,083772,Ganguly; Soumya,1,1,32,31
1655991892200,MATH 20E,B01,083773,Ciotti; Benjamin,14,0,35,21
1655991892200,MATH 20E,B02,083774,Ciotti; Benjamin,12,0,35,23
1655991898230,MATH 103A,A01,083777,Greenfeld; Be'Eri,2,1,36,34
1655991898230,MATH 103A,A02,083778,Greenfeld; Be'Eri,2,0,36,34
1655991898230,MATH 103A,A03,093561,Staff,0,1,36,36
1655991898230,MATH 103A,B01,083779,Greenfeld; Be'Eri,7,1,36,29
1655991898230,MATH 103A,B02,083780,Greenfeld; Be'Eri,0,0,36,36
1655991898230,MATH 103A,B03,093562,Staff,0,0,36,36
1655991904263,MATH 105,A01,085443,Carter; Anne Toulson,4,1,35,31
1655991904263,MATH 105,A02,093477,Staff,8,0,35,27
1655991910300,MATH 109,A01,083213,Ganzberger; Geoffrey Michael,0,1,34,34
1655991910300,MATH 109,A02,083214,Ganzberger; Geoffrey Michael,0,0,34,34
1655991910300,MATH 109,A03,093478,Staff,1,0,34,33
1655991910300,MATH 109,B01,083215,Ganzberger; Geoffrey Michael,2,0,32,30
1655991910300,MATH 109,B02,083216,Ganzberger; Geoffrey Michael,0,0,32,32
1655991910300,MATH 109,B03,093479,Staff,4,0,32,28
1655991916326,MATH 142A,A01,083219,Chow; Bennett,0,0,32,32
1655991916326,MATH 142A,A02,083220,Chow; Bennett,7,0,32,25
1655991916326,MATH 142A,A03,093480,Staff,4,0,32,28
1655991916326,MATH 142A,B03,093481,Staff,3,0,32,29
1655991916326,MATH 142A,B04,093558,Staff,6,0,32,26
1655991916326,MATH 142A,B05,093559,Staff,0,0,32,32
1655991922355,MATH 193A,A01,083224,Rotar; Vladimir,1,1,34,33
1655991922355,MATH 193A,A02,083225,Rotar; Vladimir,0,0,34,34
1655991922355,MATH 193A,A03,083781,Rotar; Vladimir,2,0,34,32
1655991922355,MATH 193A,A04,083782,Rotar; Vladimir,3,0,34,31
1655991922355,MATH 193A,A05,093482,Rotar; Vladimir,0,0,34,34
1655991928391,MATH 197,001,091859,McAuley; Julian John,9999,0,9999,0
1655991928391,MATH 197,002,095566,Kedlaya; Kiran S.,9997,0,9999,2
1655991928391,MATH 197,003,095567,Xiao; Ming,9999,0,9999,0
1655991928391,MATH 197,004,095571,Perols; Johan Lars,9998,0,9999,1
1655991935480,COGS 9,A01,083615,Shannon; Kyle Michael,3,1,75,72
1655991941511,COGS 11,A01,083617,Boyle; Mary E. T.,11,1,48,37
1655991947543,COGS 13,A01,083071,Bastos; Amalia Pinkusfeld,3,2,71,68
1655991953576,COGS 14A,A01,092681,Semenuks; Arturs,4,25,100,96
1655991959602,COGS 14B,A01,083073,Cheng; Tzu-Han,7,0,63,56
1655991965628,COGS 17,A01,092677,Semenuks; Arturs,8,7,81,73
1655991971656,COGS 100,A01,083619,Allen; Michael Gordon,2,2,70,68
1655991977682,COGS 101A,A01,083621,Davis; Joshua Daniel,4,3,68,64
1655991983714,COGS 101B,A01,091572,Allen; Michael Gordon,0,0,65,65
1655991989747,COGS 101C,A01,083625,Delgado; Tania,7,0,35,28
1655991995777,COGS 107A,A01,083627,Boyle; Mary E. T.,1,2,60,59
1655992001805,COGS 118A,A01,083075,Gupta; Anjum,21,16,76,55
1655992007832,CSE 3,A50,083646,Miranda; Gregory Joseph,14,0,50,36
1655992013858,CSE 8A,A50,083650,Miranda; Gregory Joseph,3,11,56,53
1655992019885,CSE 11,A01,083080,Cao; Yingjun,0,65,40,40
1655992025981,CSE 12,A01,083652,Krause-Levy; Sophia Louisa,6,8,120,114
1655992032010,CSE 15L,A01,083654,Morris; Justin Loren,3,1,50,47
1655992032010,CSE 15L,A02,083655,Morris; Justin Loren,1,1,50,49
1655992038038,CSE 20,A01,083657,Tran; Khoa Dang,29,0,80,51
1655992044070,CSE 21,A01,095574,Bach; Quang Tran,23,0,48,25
1655992050098,CSE 30,A01,083084,Eldon; John,2,10,80,78
1655992050098,CSE 30,B01,095061,Bhaskar; Nishant,0,4,50,50
1655992056128,CSE 100,A01,083659,Cao; Yingjun,2,25,70,68
1655992062154,CSE 134B,A01,083661,Powell; Thomas Allan,6,7,100,94
1655992068181,CSE 140,A01,083663,Gungor; Onat,5,0,85,80
1655992074215,CSE 140L,A01,083088,Eldon; John,5,0,100,95
1655992080252,CSE 175,A01,083665,Kumar; Rakesh,1,0,25,24
1655992086279,CSE 190,A00,092507,Dubnov; Shlomo,1,0,20,19
1655992092316,ECE 45,A01,083139,Congero; Spencer William,0,1,75,75
1655992098344,ECE 65,A50,083695,Saad; Andrew S,6,0,30,24
1655992098344,ECE 65,A51,095125,Staff,23,0,26,3
1655992104373,ECE 109,A01,091882,Touri; Behrouz,2,4,70,68
1655992110400,ECE 180,A00,083140,Abi Samra; Nicholas Camill,1,0,30,29
1655992110400,ECE 180,B00,083141,Abi Samra; Nicholas Camill,0,8,28,28
1655992116436,MATH 10A,A01,083735,Patchell; Gregory David,0,0,30,30
1655992116436,MATH 10A,A02,083736,Patchell; Gregory David,21,0,30,9
1655992116436,MATH 10A,A03,083737,Patchell; Gregory David,16,0,30,14
1655992122477,MATH 10B,A01,083207,Lim; Seonhee,1,1,34,33
1655992122477,MATH 10B,A02,083208,Lim; Seonhee,1,1,35,34
1655992122477,MATH 10B,A03,093472,Staff,1,0,34,33
1655992122477,MATH 10B,B01,083739,Sinha; Shubham,9,0,30,21
1655992128507,MATH 18,A01,083743,Cinel; Cameron Alexander,5,0,30,25
1655992128507,MATH 18,A02,083744,Cinel; Cameron Alexander,11,0,30,19
1655992128507,MATH 18,A03,083745,Cinel; Cameron Alexander,1,0,30,29
1655992128507,MATH 18,B01,083748,Ma; Zilu,2,0,36,34
1655992128507,MATH 18,B02,083749,Ma; Zilu,0,0,36,36
1655992128507,MATH 18,B03,083750,Ma; Zilu,0,0,36,36
1655992128507,MATH 18,B04,083751,Ma; Zilu,0,0,36,36
1655992128507,MATH 18,B05,093473,Staff,0,0,36,36
1655992128507,MATH 18,B06,093474,Staff,1,0,36,35
1655992134542,MATH 20A,A01,083754,Zheng; Zequn,10,0,40,30
1655992140575,MATH 20B,A01,083756,Briones; Jor-el Thomas Caparas,0,1,36,36
1655992140575,MATH 20B,A02,083757,Briones; Jor-el Thomas Caparas,1,0,36,35
1655992140575,MATH 20B,A03,093475,Staff,0,0,36,36
1655992146605,MATH 20C,A01,083760,Briones; Jor-el Thomas Caparas,0,2,35,35
1655992146605,MATH 20C,A02,083761,Briones; Jor-el Thomas Caparas,6,1,35,29
1655992146605,MATH 20C,A03,093476,Staff,0,0,35,35
1655992146605,MATH 20C,B01,083762,Bach; Quang Tran,3,0,30,27
1655992152631,MATH 20D,A01,083765,Tran; Brian Kha,1,0,30,29
1655992152631,MATH 20D,A02,083766,Tran; Brian Kha,0,1,30,30
1655992152631,MATH 20D,A03,083767,Tran; Brian Kha,1,0,30,29
1655992158660,MATH 20E,A01,083771,Ganguly; Soumya,0,1,32,32
1655992158660,MATH 20E,A02,083772,Ganguly; Soumya,1,1,32,31
1655992158660,MATH 20E,B01,083773,Ciotti; Benjamin,14,0,35,21
1655992158660,MATH 20E,B02,083774,Ciotti; Benjamin,12,0,35,23
1655992164692,MATH 103A,A01,083777,Greenfeld; Be'Eri,2,1,36,34
1655992164692,MATH 103A,A02,083778,Greenfeld; Be'Eri,2,0,36,34
1655992164692,MATH 103A,A03,093561,Staff,0,1,36,36
1655992164692,MATH 103A,B01,083779,Greenfeld; Be'Eri,7,1,36,29
1655992164692,MATH 103A,B02,083780,Greenfeld; Be'Eri,0,0,36,36
1655992164692,MATH 103A,B03,093562,Staff,0,0,36,36
1655992170719,MATH 105,A01,085443,Carter; Anne Toulson,4,1,35,31
1655992170719,MATH 105,A02,093477,Staff,8,0,35,27
1655992176745,MATH 109,A01,083213,Ganzberger; Geoffrey Michael,0,1,34,34
1655992176745,MATH 109,A02,083214,Ganzberger; Geoffrey Michael,0,0,34,34
1655992176745,MATH 109,A03,093478,Staff,1,0,34,33
1655992176745,MATH 109,B01,083215,Ganzberger; Geoffrey Michael,2,0,32,30
1655992176745,MATH 109,B02,083216,Ganzberger; Geoffrey Michael,0,0,32,32
1655992176745,MATH 109,B03,093479,Staff,4,0,32,28
1655992182771,MATH 142A,A01,083219,Chow; Bennett,0,0,32,32
1655992182771,MATH 142A,A02,083220,Chow; Bennett,7,0,32,25
1655992182771,MATH 142A,A03,093480,Staff,4,0,32,28
1655992182771,MATH 142A,B03,093481,Staff,3,0,32,29
1655992182771,MATH 142A,B04,093558,Staff,6,0,32,26
1655992182771,MATH 142A,B05,093559,Staff,0,0,32,32
1655992188799,MATH 193A,A01,083224,Rotar; Vladimir,1,1,34,33
1655992188799,MATH 193A,A02,083225,Rotar; Vladimir,0,0,34,34
1655992188799,MATH 193A,A03,083781,Rotar; Vladimir,2,0,34,32
1655992188799,MATH 193A,A04,083782,Rotar; Vladimir,3,0,34,31
1655992188799,MATH 193A,A05,093482,Rotar; Vladimir,0,0,34,34
1655992194825,MATH 197,001,091859,McAuley; Julian John,9999,0,9999,0
1655992194825,MATH 197,002,095566,Kedlaya; Kiran S.,9997,0,9999,2
1655992194825,MATH 197,003,095567,Xiao; Ming,9999,0,9999,0
1655992194825,MATH 197,004,095571,Perols; Johan Lars,9998,0,9999,1
1655992201898,COGS 9,A01,083615,Shannon; Kyle Michael,3,1,75,72
1655992207925,COGS 11,A01,083617,Boyle; Mary E. T.,11,1,48,37
1655992213957,COGS 13,A01,083071,Bastos; Amalia Pinkusfeld,3,2,71,68
1655992219989,COGS 14A,A01,092681,Semenuks; Arturs,4,25,100,96
1655992226021,COGS 14B,A01,083073,Cheng; Tzu-Han,7,0,63,56
1655992232047,COGS 17,A01,092677,Semenuks; Arturs,8,7,81,73
1655992238073,COGS 100,A01,083619,Allen; Michael Gordon,2,2,70,68
1655992244107,COGS 101A,A01,083621,Davis; Joshua Daniel,4,3,68,64
1655992250137,COGS 101B,A01,091572,Allen; Michael Gordon,0,0,65,65
1655992256168,COGS 101C,A01,083625,Delgado; Tania,7,0,35,28
1655992262195,COGS 107A,A01,083627,Boyle; Mary E. T.,1,2,60,59
1655992268230,COGS 118A,A01,083075,Gupta; Anjum,21,16,76,55
1655992274266,CSE 3,A50,083646,Miranda; Gregory Joseph,14,0,50,36
1655992280295,CSE 8A,A50,083650,Miranda; Gregory Joseph,3,11,56,53
1655992286326,CSE 11,A01,083080,Cao; Yingjun,0,65,40,40
1655992292352,CSE 12,A01,083652,Krause-Levy; Sophia Louisa,6,8,120,114
1655992298379,CSE 15L,A01,083654,Morris; Justin Loren,3,1,50,47
1655992298379,CSE 15L,A02,083655,Morris; Justin Loren,1,1,50,49
1655992304406,CSE 20,A01,083657,Tran; Khoa Dang,29,0,80,51
1655992310431,CSE 21,A01,095574,Bach; Quang Tran,23,0,48,25
1655992316465,CSE 30,A01,083084,Eldon; John,2,10,80,78
1655992316465,CSE 30,B01,095061,Bhaskar; Nishant,0,4,50,50
1655992322490,CSE 100,A01,083659,Cao; Yingjun,2,25,70,68
1655992328516,CSE 134B,A01,083661,Powell; Thomas Allan,6,7,100,94
1655992334545,CSE 140,A01,083663,Gungor; Onat,5,0,85,80
1655992340587,CSE 140L,A01,083088,Eldon; John,5,0,100,95
1655992346619,CSE 175,A01,083665,Kumar; Rakesh,1,0,25,24
1655992352645,CSE 190,A00,092507,Dubnov; Shlomo,1,0,20,19
1655992358672,ECE 45,A01,083139,Congero; Spencer William,0,1,75,75
1655992364705,ECE 65,A50,083695,Saad; Andrew S,6,0,30,24
1655992364705,ECE 65,A51,095125,Staff,23,0,26,3
1655992370735,ECE 109,A01,091882,Touri; Behrouz,2,4,70,68
1655992376765,ECE 180,A00,083140,Abi Samra; Nicholas Camill,1,0,30,29
1655992376765,ECE 180,B00,083141,Abi Samra; Nicholas Camill,0,8,28,28
1655992382794,MATH 10A,A01,083735,Patchell; Gregory David,0,0,30,30
1655992382794,MATH 10A,A02,083736,Patchell; Gregory David,21,0,30,9
1655992382794,MATH 10A,A03,083737,Patchell; Gregory David,16,0,30,14
1655992388830,MATH 10B,A01,083207,Lim; Seonhee,1,1,34,33
1655992388830,MATH 10B,A02,083208,Lim; Seonhee,1,1,35,34
1655992388830,MATH 10B,A03,093472,Staff,1,0,34,33
1655992388830,MATH 10B,B01,083739,Sinha; Shubham,9,0,30,21
1655992394861,MATH 18,A01,083743,Cinel; Cameron Alexander,5,0,30,25
1655992394861,MATH 18,A02,083744,Cinel; Cameron Alexander,11,0,30,19
1655992394861,MATH 18,A03,083745,Cinel; Cameron Alexander,1,0,30,29
1655992394861,MATH 18,B01,083748,Ma; Zilu,2,0,36,34
1655992394861,MATH 18,B02,083749,Ma; Zilu,0,0,36,36
1655992394861,MATH 18,B03,083750,Ma; Zilu,0,0,36,36
1655992394861,MATH 18,B04,083751,Ma; Zilu,0,0,36,36
1655992394861,MATH 18,B05,093473,Staff,0,0,36,36
1655992394861,MATH 18,B06,093474,Staff,1,0,36,35
1655992400886,MATH 20A,A01,083754,Zheng; Zequn,10,0,40,30
1655992406922,MATH 20B,A01,083756,Briones; Jor-el Thomas Caparas,0,1,36,36
1655992406922,MATH 20B,A02,083757,Briones; Jor-el Thomas Caparas,1,0,36,35
1655992406922,MATH 20B,A03,093475,Staff,0,0,36,36
1655992412947,MATH 20C,A01,083760,Briones; Jor-el Thomas Caparas,0,2,35,35
1655992412947,MATH 20C,A02,083761,Briones; Jor-el Thomas Caparas,6,1,35,29
1655992412947,MATH 20C,A03,093476,Staff,0,0,35,35
1655992412947,MATH 20C,B01,083762,Bach; Quang Tran,3,0,30,27
1655992418973,MATH 20D,A01,083765,Tran; Brian Kha,1,0,30,29
1655992418973,MATH 20D,A02,083766,Tran; Brian Kha,0,1,30,30
1655992418973,MATH 20D,A03,083767,Tran; Brian Kha,1,0,30,29
1655992425002,MATH 20E,A01,083771,Ganguly; Soumya,0,1,32,32
1655992425002,MATH 20E,A02,083772,Ganguly; Soumya,1,1,32,31
1655992425002,MATH 20E,B01,083773,Ciotti; Benjamin,14,0,35,21
1655992425002,MATH 20E,B02,083774,Ciotti; Benjamin,12,0,35,23
1655992431047,MATH 103A,A01,083777,Greenfeld; Be'Eri,2,1,36,34
1655992431047,MATH 103A,A02,083778,Greenfeld; Be'Eri,2,0,36,34
1655992431047,MATH 103A,A03,093561,Staff,0,1,36,36
1655992431047,MATH 103A,B01,083779,Greenfeld; Be'Eri,7,1,36,29
1655992431047,MATH 103A,B02,083780,Greenfeld; Be'Eri,0,0,36,36
1655992431047,MATH 103A,B03,093562,Staff,0,0,36,36
1655992437081,MATH 105,A01,085443,Carter; Anne Toulson,4,1,35,31
1655992437081,MATH 105,A02,093477,Staff,8,0,35,27
1655992443114,MATH 109,A01,083213,Ganzberger; Geoffrey Michael,0,1,34,34
1655992443114,MATH 109,A02,083214,Ganzberger; Geoffrey Michael,0,0,34,34
1655992443114,MATH 109,A03,093478,Staff,1,0,34,33
1655992443114,MATH 109,B01,083215,Ganzberger; Geoffrey Michael,2,0,32,30
1655992443114,MATH 109,B02,083216,Ganzberger; Geoffrey Michael,0,0,32,32
1655992443114,MATH 109,B03,093479,Staff,4,0,32,28
1655992449151,MATH 142A,A01,083219,Chow; Bennett,0,0,32,32
1655992449151,MATH 142A,A02,083220,Chow; Bennett,7,0,32,25
1655992449151,MATH 142A,A03,093480,Staff,4,0,32,28
1655992449151,MATH 142A,B03,093481,Staff,3,0,32,29
1655992449151,MATH 142A,B04,093558,Staff,6,0,32,26
1655992449151,MATH 142A,B05,093559,Staff,0,0,32,32
1655992455178,MATH 193A,A01,083224,Rotar; Vladimir,1,1,34,33
1655992455178,MATH 193A,A02,083225,Rotar; Vladimir,0,0,34,34
1655992455178,MATH 193A,A03,083781,Rotar; Vladimir,2,0,34,32
1655992455178,MATH 193A,A04,083782,Rotar; Vladimir,3,0,34,31
1655992455178,MATH 193A,A05,093482,Rotar; Vladimir,0,0,34,34
1655992461209,MATH 197,001,091859,McAuley; Julian John,9999,0,9999,0
1655992461209,MATH 197,002,095566,Kedlaya; Kiran S.,9997,0,9999,2
1655992461209,MATH 197,003,095567,Xiao; Ming,9999,0,9999,0
1655992461209,MATH 197,004,095571,Perols; Johan Lars,9998,0,9999,1
1655992468295,COGS 9,A01,083615,Shannon; Kyle Michael,3,1,75,72
1655992474322,COGS 11,A01,083617,Boyle; Mary E. T.,11,1,48,37
1655992480353,COGS 13,A01,083071,Bastos; Amalia Pinkusfeld,3,2,71,68
1655992486384,COGS 14A,A01,092681,Semenuks; Arturs,4,25,100,96
1655992492410,COGS 14B,A01,083073,Cheng; Tzu-Han,7,0,63,56
1655992498440,COGS 17,A01,092677,Semenuks; Arturs,8,7,81,73
1655992504466,COGS 100,A01,083619,Allen; Michael Gordon,2,2,70,68
1655992510495,COGS 101A,A01,083621,Davis; Joshua Daniel,4,3,68,64
1655992516521,COGS 101B,A01,091572,Allen; Michael Gordon,0,0,65,65
1655992522547,COGS 101C,A01,083625,Delgado; Tania,7,0,35,28
1655992528573,COGS 107A,A01,083627,Boyle; Mary E. T.,1,2,60,59
1655992534599,COGS 118A,A01,083075,Gupta; Anjum,21,16,76,55
1655992540628,CSE 3,A50,083646,Miranda; Gregory Joseph,14,0,50,36
1655992546653,CSE 8A,A50,083650,Miranda; Gregory Joseph,3,11,56,53
1655992552678,CSE 11,A01,083080,Cao; Yingjun,0,65,40,40
1655992558711,CSE 12,A01,083652,Krause-Levy; Sophia Louisa,6,8,120,114
1655992564737,CSE 15L,A01,083654,Morris; Justin Loren,3,1,50,47
1655992564737,CSE 15L,A02,083655,Morris; Justin Loren,1,1,50,49
1655992570768,CSE 20,A01,083657,Tran; Khoa Dang,29,0,80,51
1655992576798,CSE 21,A01,095574,Bach; Quang Tran,23,0,48,25
1655992582824,CSE 30,A01,083084,Eldon; John,2,10,80,78
1655992582824,CSE 30,B01,095061,Bhaskar; Nishant,0,4,50,50
1655992588851,CSE 100,A01,083659,Cao; Yingjun,2,25,70,68
1655992594876,CSE 134B,A01,083661,Powell; Thomas Allan,6,7,100,94
1655992600902,CSE 140,A01,083663,Gungor; Onat,5,0,85,80
1655992606931,CSE 140L,A01,083088,Eldon; John,5,0,100,95
1655992612959,CSE 175,A01,083665,Kumar; Rakesh,1,0,25,24
1655992618992,CSE 190,A00,092507,Dubnov; Shlomo,1,0,20,19
1655992625127,ECE 45,A01,083139,Congero; Spencer William,0,1,75,75
1655992631155,ECE 65,A50,083695,Saad; Andrew S,6,0,30,24
1655992631155,ECE 65,A51,095125,Staff,23,0,26,3
1655992637182,ECE 109,A01,091882,Touri; Behrouz,2,4,70,68
1655992643215,ECE 180,A00,083140,Abi Samra; Nicholas Camill,1,0,30,29
1655992643215,ECE 180,B00,083141,Abi Samra; Nicholas Camill,0,8,28,28
1655992649243,MATH 10A,A01,083735,Patchell; Gregory David,0,0,30,30
1655992649243,MATH 10A,A02,083736,Patchell; Gregory David,21,0,30,9
1655992649243,MATH 10A,A03,083737,Patchell; Gregory David,16,0,30,14
1655992655276,MATH 10B,A01,083207,Lim; Seonhee,1,1,34,33
1655992655276,MATH 10B,A02,083208,Lim; Seonhee,1,1,35,34
1655992655276,MATH 10B,A03,093472,Staff,1,0,34,33
1655992655276,MATH 10B,B01,083739,Sinha; Shubham,9,0,30,21
1655992661303,MATH 18,A01,083743,Cinel; Cameron Alexander,5,0,30,25
1655992661303,MATH 18,A02,083744,Cinel; Cameron Alexander,11,0,30,19
1655992661303,MATH 18,A03,083745,Cinel; Cameron Alexander,1,0,30,29
1655992661303,MATH 18,B01,083748,Ma; Zilu,2,0,36,34
1655992661303,MATH 18,B02,083749,Ma; Zilu,0,0,36,36
1655992661303,MATH 18,B03,083750,Ma; Zilu,0,0,36,36
1655992661303,MATH 18,B04,083751,Ma; Zilu,0,0,36,36
1655992661303,MATH 18,B05,093473,Staff,0,0,36,36
1655992661303,MATH 18,B06,093474,Staff,1,0,36,35
1655992667332,MATH 20A,A01,083754,Zheng; Zequn,10,0,40,30
1655992673366,MATH 20B,A01,083756,Briones; Jor-el Thomas Caparas,0,1,36,36
1655992673366,MATH 20B,A02,083757,Briones; Jor-el Thomas Caparas,1,0,36,35
1655992673366,MATH 20B,A03,093475,Staff,0,0,36,36
1655992679396,MATH 20C,A01,083760,Briones; Jor-el Thomas Caparas,0,2,35,35
1655992679396,MATH 20C,A02,083761,Briones; Jor-el Thomas Caparas,6,1,35,29
1655992679396,MATH 20C,A03,093476,Staff,0,0,35,35
1655992679396,MATH 20C,B01,083762,Bach; Quang Tran,3,0,30,27
1655992685441,MATH 20D,A01,083765,Tran; Brian Kha,1,0,30,29
1655992685441,MATH 20D,A02,083766,Tran; Brian Kha,0,1,30,30
1655992685441,MATH 20D,A03,083767,Tran; Brian Kha,1,0,30,29
1655992691467,MATH 20E,A01,083771,Ganguly; Soumya,0,1,32,32
1655992691467,MATH 20E,A02,083772,Ganguly; Soumya,1,1,32,31
1655992691467,MATH 20E,B01,083773,Ciotti; Benjamin,14,0,35,21
1655992691467,MATH 20E,B02,083774,Ciotti; Benjamin,12,0,35,23
1655992697505,MATH 103A,A01,083777,Greenfeld; Be'Eri,2,1,36,34
1655992697505,MATH 103A,A02,083778,Greenfeld; Be'Eri,2,0,36,34
1655992697505,MATH 103A,A03,093561,Staff,0,1,36,36
1655992697505,MATH 103A,B01,083779,Greenfeld; Be'Eri,7,1,36,29
1655992697505,MATH 103A,B02,083780,Greenfeld; Be'Eri,0,0,36,36
1655992697505,MATH 103A,B03,093562,Staff,0,0,36,36
1655992703537,MATH 105,A01,085443,Carter; Anne Toulson,4,1,35,31
1655992703537,MATH 105,A02,093477,Staff,8,0,35,27
1655992709569,MATH 109,A01,083213,Ganzberger; Geoffrey Michael,0,1,34,34
1655992709569,MATH 109,A02,083214,Ganzberger; Geoffrey Michael,0,0,34,34
1655992709569,MATH 109,A03,093478,Staff,1,0,34,33
1655992709569,MATH 109,B01,083215,Ganzberger; Geoffrey Michael,2,0,32,30
1655992709569,MATH 109,B02,083216,Ganzberger; Geoffrey Michael,0,0,32,32
1655992709569,MATH 109,B03,093479,Staff,4,0,32,28
1655992715601,MATH 142A,A01,083219,Chow; Bennett,0,0,32,32
1655992715601,MATH 142A,A02,083220,Chow; Bennett,7,0,32,25
1655992715601,MATH 142A,A03,093480,Staff,4,0,32,28
1655992715601,MATH 142A,B03,093481,Staff,3,0,32,29
1655992715601,MATH 142A,B04,093558,Staff,6,0,32,26
1655992715601,MATH 142A,B05,093559,Staff,0,0,32,32
1655992721627,MATH 193A,A01,083224,Rotar; Vladimir,1,1,34,33
1655992721627,MATH 193A,A02,083225,Rotar; Vladimir,0,0,34,34
1655992721627,MATH 193A,A03,083781,Rotar; Vladimir,2,0,34,32
1655992721627,MATH 193A,A04,083782,Rotar; Vladimir,3,0,34,31
1655992721627,MATH 193A,A05,093482,Rotar; Vladimir,0,0,34,34
1655992727661,MATH 197,001,091859,McAuley; Julian John,9999,0,9999,0
1655992727661,MATH 197,002,095566,Kedlaya; Kiran S.,9997,0,9999,2
1655992727661,MATH 197,003,095567,Xiao; Ming,9999,0,9999,0
1655992727661,MATH 197,004,095571,Perols; Johan Lars,9998,0,9999,1
1655992734749,COGS 9,A01,083615,Shannon; Kyle Michael,3,1,75,72
1655992740777,COGS 11,A01,083617,Boyle; Mary E. T.,11,1,48,37
1655992746820,COGS 13,A01,083071,Bastos; Amalia Pinkusfeld,3,2,71,68
1655992752845,COGS 14A,A01,092681,Semenuks; Arturs,4,25,100,96
1655992758876,COGS 14B,A01,083073,Cheng; Tzu-Han,7,0,63,56
1655992764904,COGS 17,A01,092677,Semenuks; Arturs,8,7,81,73
1655992770934,COGS 100,A01,083619,Allen; Michael Gordon,2,2,70,68
1655992776965,COGS 101A,A01,083621,Davis; Joshua Daniel,4,3,68,64
1655992782999,COGS 101B,A01,091572,Allen; Michael Gordon,0,0,65,65
1655992789030,COGS 101C,A01,083625,Delgado; Tania,7,0,35,28
1655992795063,COGS 107A,A01,083627,Boyle; Mary E. T.,1,2,60,59
1655992801101,COGS 118A,A01,083075,Gupta; Anjum,21,16,76,55
1655992807128,CSE 3,A50,083646,Miranda; Gregory Joseph,14,0,50,36
1655992813155,CSE 8A,A50,083650,Miranda; Gregory Joseph,3,11,56,53
1655992819185,CSE 11,A01,083080,Cao; Yingjun,0,65,40,40
1655992825223,CSE 12,A01,083652,Krause-Levy; Sophia Louisa,6,8,120,114
1655992831250,CSE 15L,A01,083654,Morris; Justin Loren,3,1,50,47
1655992831250,CSE 15L,A02,083655,Morris; Justin Loren,1,1,50,49
1655992837277,CSE 20,A01,083657,Tran; Khoa Dang,29,0,80,51
1655992843301,CSE 21,A01,095574,Bach; Quang Tran,23,0,48,25
1655992849335,CSE 30,A01,083084,Eldon; John,2,10,80,78
1655992849335,CSE 30,B01,095061,Bhaskar; Nishant,0,4,50,50
1655992855361,CSE 100,A01,083659,Cao; Yingjun,2,25,70,68
1655992861391,CSE 134B,A01,083661,Powell; Thomas Allan,6,7,100,94
1655992867415,CSE 140,A01,083663,Gungor; Onat,5,0,85,80
1655992873443,CSE 140L,A01,083088,Eldon; John,5,0,100,95
1655992879468,CSE 175,A01,083665,Kumar; Rakesh,1,0,25,24
1655992885499,CSE 190,A00,092507,Dubnov; Shlomo,1,0,20,19
1655992891528,ECE 45,A01,083139,Congero; Spencer William,0,1,75,75
1655992897564,ECE 65,A50,083695,Saad; Andrew S,6,0,30,24
1655992897564,ECE 65,A51,095125,Staff,23,0,26,3
1655992903595,ECE 109,A01,091882,Touri; Behrouz,2,4,70,68
1655992909626,ECE 180,A00,083140,Abi Samra; Nicholas Camill,1,0,30,29
1655992909626,ECE 180,B00,083141,Abi Samra; Nicholas Camill,0,8,28,28
1655992915653,MATH 10A,A01,083735,Patchell; Gregory David,0,0,30,30
1655992915653,MATH 10A,A02,083736,Patchell; Gregory David,21,0,30,9
1655992915653,MATH 10A,A03,083737,Patchell; Gregory David,16,0,30,14
1655992921716,MATH 10B,A01,083207,Lim; Seonhee,1,1,34,33
1655992921716,MATH 10B,A02,083208,Lim; Seonhee,1,1,35,34
1655992921716,MATH 10B,A03,093472,Staff,1,0,34,33
1655992921716,MATH 10B,B01,083739,Sinha; Shubham,9,0,30,21
1655992927749,MATH 18,A01,083743,Cinel; Cameron Alexander,5,0,30,25
1655992927749,MATH 18,A02,083744,Cinel; Cameron Alexander,11,0,30,19
1655992927749,MATH 18,A03,083745,Cinel; Cameron Alexander,1,0,30,29
1655992927749,MATH 18,B01,083748,Ma; Zilu,2,0,36,34
1655992927749,MATH 18,B02,083749,Ma; Zilu,0,0,36,36
1655992927749,MATH 18,B03,083750,Ma; Zilu,0,0,36,36
1655992927749,MATH 18,B04,083751,Ma; Zilu,0,0,36,36
1655992927749,MATH 18,B05,093473,Staff,0,0,36,36
1655992927749,MATH 18,B06,093474,Staff,1,0,36,35
1655992933796,MATH 20A,A01,083754,Zheng; Zequn,10,0,40,30
1655992939837,MATH 20B,A01,083756,Briones; Jor-el Thomas Caparas,0,1,36,36
1655992939837,MATH 20B,A02,083757,Briones; Jor-el Thomas Caparas,1,0,36,35
1655992939837,MATH 20B,A03,093475,Staff,0,0,36,36
1655992945870,MATH 20C,A01,083760,Briones; Jor-el Thomas Caparas,0,2,35,35
1655992945870,MATH 20C,A02,083761,Briones; Jor-el Thomas Caparas,6,1,35,29
1655992945870,MATH 20C,A03,093476,Staff,0,0,35,35
1655992945870,MATH 20C,B01,083762,Bach; Quang Tran,3,0,30,27
1655992951896,MATH 20D,A01,083765,Tran; Brian Kha,1,0,30,29
1655992951896,MATH 20D,A02,083766,Tran; Brian Kha,0,1,30,30
1655992951896,MATH 20D,A03,083767,Tran; Brian Kha,1,0,30,29
1655992957941,MATH 20E,A01,083771,Ganguly; Soumya,0,1,32,32
1655992957941,MATH 20E,A02,083772,Ganguly; Soumya,1,1,32,31
1655992957941,MATH 20E,B01,083773,Ciotti; Benjamin,14,0,35,21
1655992957941,MATH 20E,B02,083774,Ciotti; Benjamin,12,0,35,23
1655992963969,MATH 103A,A01,083777,Greenfeld; Be'Eri,2,1,36,34
1655992963969,MATH 103A,A02,083778,Greenfeld; Be'Eri,2,0,36,34
1655992963969,MATH 103A,A03,093561,Staff,0,1,36,36
1655992963969,MATH 103A,B01,083779,Greenfeld; Be'Eri,7,1,36,29
1655992963969,MATH 103A,B02,083780,Greenfeld; Be'Eri,0,0,36,36
1655992963969,MATH 103A,B03,093562,Staff,0,0,36,36
1655992969997,MATH 105,A01,085443,Carter; Anne Toulson,4,1,35,31
1655992969997,MATH 105,A02,093477,Staff,8,0,35,27
1655992976039,MATH 109,A01,083213,Ganzberger; Geoffrey Michael,0,1,34,34
1655992976039,MATH 109,A02,083214,Ganzberger; Geoffrey Michael,0,0,34,34
1655992976039,MATH 109,A03,093478,Staff,1,0,34,33
1655992976039,MATH 109,B01,083215,Ganzberger; Geoffrey Michael,2,0,32,30
1655992976039,MATH 109,B02,083216,Ganzberger; Geoffrey Michael,0,0,32,32
1655992976039,MATH 109,B03,093479,Staff,4,0,32,28
1655992982082,MATH 142A,A01,083219,Chow; Bennett,0,0,32,32
1655992982082,MATH 142A,A02,083220,Chow; Bennett,7,0,32,25
1655992982082,MATH 142A,A03,093480,Staff,4,0,32,28
1655992982082,MATH 142A,B03,093481,Staff,3,0,32,29
1655992982082,MATH 142A,B04,093558,Staff,6,0,32,26
1655992982082,MATH 142A,B05,093559,Staff,0,0,32,32
1655992988112,MATH 193A,A01,083224,Rotar; Vladimir,1,1,34,33
1655992988112,MATH 193A,A02,083225,Rotar; Vladimir,0,0,34,34
1655992988112,MATH 193A,A03,083781,Rotar; Vladimir,2,0,34,32
1655992988112,MATH 193A,A04,083782,Rotar; Vladimir,3,0,34,31
1655992988112,MATH 193A,A05,093482,Rotar; Vladimir,0,0,34,34
1655992994139,MATH 197,001,091859,McAuley; Julian John,9999,0,9999,0
1655992994139,MATH 197,002,095566,Kedlaya; Kiran S.,9997,0,9999,2
1655992994139,MATH 197,003,095567,Xiao; Ming,9999,0,9999,0
1655992994139,MATH 197,004,095571,Perols; Johan Lars,9998,0,9999,1
1655993001230,COGS 9,A01,083615,Shannon; Kyle Michael,3,1,75,72
1655993007263,COGS 11,A01,083617,Boyle; Mary E. T.,11,1,48,37
1655993013301,COGS 13,A01,083071,Bastos; Amalia Pinkusfeld,3,2,71,68
1655993019328,COGS 14A,A01,092681,Semenuks; Arturs,4,25,100,96
1655993025368,COGS 14B,A01,083073,Cheng; Tzu-Han,7,0,63,56
1655993031401,COGS 17,A01,092677,Semenuks; Arturs,8,7,81,73
1655993037428,COGS 100,A01,083619,Allen; Michael Gordon,2,2,70,68
1655993043455,COGS 101A,A01,083621,Davis; Joshua Daniel,4,3,68,64
1655993049482,COGS 101B,A01,091572,Allen; Michael Gordon,0,0,65,65
1655993055518,COGS 101C,A01,083625,Delgado; Tania,7,0,35,28
1655993061550,COGS 107A,A01,083627,Boyle; Mary E. T.,1,2,60,59
1655993067584,COGS 118A,A01,083075,Gupta; Anjum,21,16,76,55
1655993073627,CSE 3,A50,083646,Miranda; Gregory Joseph,14,0,50,36
1655993079660,CSE 8A,A50,083650,Miranda; Gregory Joseph,3,11,56,53
1655993085694,CSE 11,A01,083080,Cao; Yingjun,0,65,40,40
1655993091727,CSE 12,A01,083652,Krause-Levy; Sophia Louisa,6,8,120,114
1655993097755,CSE 15L,A01,083654,Morris; Justin Loren,3,1,50,47
1655993097755,CSE 15L,A02,083655,Morris; Justin Loren,1,1,50,49
1655993103783,CSE 20,A01,083657,Tran; Khoa Dang,29,0,80,51
1655993109808,CSE 21,A01,095574,Bach; Quang Tran,23,0,48,25
1655993116442,CSE 30,A01,083084,Eldon; John,2,10,80,78
1655993116442,CSE 30,B01,095061,Bhaskar; Nishant,0,4,50,50
1655993122467,CSE 100,A01,083659,Cao; Yingjun,2,25,70,68
1655993128493,CSE 134B,A01,083661,Powell; Thomas Allan,6,7,100,94
1655993134523,CSE 140,A01,083663,Gungor; Onat,5,0,85,80
1655993140547,CSE 140L,A01,083088,Eldon; John,5,0,100,95
1655993146579,CSE 175,A01,083665,Kumar; Rakesh,1,0,25,24
1655993152612,CSE 190,A00,092507,Dubnov; Shlomo,1,0,20,19
1655993158646,ECE 45,A01,083139,Congero; Spencer William,0,1,75,75
1655993164676,ECE 65,A50,083695,Saad; Andrew S,6,0,30,24
1655993164676,ECE 65,A51,095125,Staff,23,0,26,3
1655993170706,ECE 109,A01,091882,Touri; Behrouz,2,4,70,68
1655993176731,ECE 180,A00,083140,Abi Samra; Nicholas Camill,1,0,30,29
1655993176731,ECE 180,B00,083141,Abi Samra; Nicholas Camill,0,8,28,28
1655993182757,MATH 10A,A01,083735,Patchell; Gregory David,0,0,30,30
1655993182757,MATH 10A,A02,083736,Patchell; Gregory David,21,0,30,9
1655993182757,MATH 10A,A03,083737,Patchell; Gregory David,16,0,30,14
1655993188785,MATH 10B,A01,083207,Lim; Seonhee,1,1,34,33
1655993188785,MATH 10B,A02,083208,Lim; Seonhee,1,1,35,34
1655993188785,MATH 10B,A03,093472,Staff,1,0,34,33
1655993188785,MATH 10B,B01,083739,Sinha; Shubham,9,0,30,21
1655993194831,MATH 18,A01,083743,Cinel; Cameron Alexander,5,0,30,25
1655993194831,MATH 18,A02,083744,Cinel; Cameron Alexander,11,0,30,19
1655993194831,MATH 18,A03,083745,Cinel; Cameron Alexander,1,0,30,29
1655993194831,MATH 18,B01,083748,Ma; Zilu,2,0,36,34
1655993194831,MATH 18,B02,083749,Ma; Zilu,0,0,36,36
1655993194831,MATH 18,B03,083750,Ma; Zilu,0,0,36,36
1655993194831,MATH 18,B04,083751,Ma; Zilu,0,0,36,36
1655993194831,MATH 18,B05,093473,Staff,0,0,36,36
1655993194831,MATH 18,B06,093474,Staff,1,0,36,35
1655993200868,MATH 20A,A01,083754,Zheng; Zequn,10,0,40,30
1655993206902,MATH 20B,A01,083756,Briones; Jor-el Thomas Caparas,0,1,36,36
1655993206902,MATH 20B,A02,083757,Briones; Jor-el Thomas Caparas,1,0,36,35
1655993206902,MATH 20B,A03,093475,Staff,0,0,36,36
1655993212928,MATH 20C,A01,083760,Briones; Jor-el Thomas Caparas,0,2,35,35
1655993212928,MATH 20C,A02,083761,Briones; Jor-el Thomas Caparas,6,1,35,29
1655993212928,MATH 20C,A03,093476,Staff,0,0,35,35
1655993212928,MATH 20C,B01,083762,Bach; Quang Tran,3,0,30,27
1655993218960,MATH 20D,A01,083765,Tran; Brian Kha,1,0,30,29
1655993218960,MATH 20D,A02,083766,Tran; Brian Kha,0,1,30,30
1655993218960,MATH 20D,A03,083767,Tran; Brian Kha,1,0,30,29
1655993225074,MATH 20E,A01,083771,Ganguly; Soumya,0,1,32,32
1655993225074,MATH 20E,A02,083772,Ganguly; Soumya,1,1,32,31
1655993225074,MATH 20E,B01,083773,Ciotti; Benjamin,14,0,35,21
1655993225074,MATH 20E,B02,083774,Ciotti; Benjamin,12,0,35,23
1655993231103,MATH 103A,A01,083777,Greenfeld; Be'Eri,2,1,36,34
1655993231103,MATH 103A,A02,083778,Greenfeld; Be'Eri,2,0,36,34
1655993231103,MATH 103A,A03,093561,Staff,0,1,36,36
1655993231103,MATH 103A,B01,083779,Greenfeld; Be'Eri,7,1,36,29
1655993231103,MATH 103A,B02,083780,Greenfeld; Be'Eri,0,0,36,36
1655993231103,MATH 103A,B03,093562,Staff,0,0,36,36
1655993237133,MATH 105,A01,085443,Carter; Anne Toulson,4,1,35,31
1655993237133,MATH 105,A02,093477,Staff,8,0,35,27
1655993243171,MATH 109,A01,083213,Ganzberger; Geoffrey Michael,0,1,34,34
1655993243171,MATH 109,A02,083214,Ganzberger; Geoffrey Michael,0,0,34,34
1655993243171,MATH 109,A03,093478,Staff,1,0,34,33
1655993243171,MATH 109,B01,083215,Ganzberger; Geoffrey Michael,2,0,32,30
1655993243171,MATH 109,B02,083216,Ganzberger; Geoffrey Michael,0,0,32,32
1655993243171,MATH 109,B03,093479,Staff,4,0,32,28
1655993249206,MATH 142A,A01,083219,Chow; Bennett,0,0,32,32
1655993249206,MATH 142A,A02,083220,Chow; Bennett,7,0,32,25
1655993249206,MATH 142A,A03,093480,Staff,4,0,32,28
1655993249206,MATH 142A,B03,093481,Staff,3,0,32,29
1655993249206,MATH 142A,B04,093558,Staff,6,0,32,26
1655993249206,MATH 142A,B05,093559,Staff,0,0,32,32
1655993255230,MATH 193A,A01,083224,Rotar; Vladimir,1,1,34,33
1655993255230,MATH 193A,A02,083225,Rotar; Vladimir,0,0,34,34
1655993255230,MATH 193A,A03,083781,Rotar; Vladimir,2,0,34,32
1655993255230,MATH 193A,A04,083782,Rotar; Vladimir,3,0,34,31
1655993255230,MATH 193A,A05,093482,Rotar; Vladimir,0,0,34,34
1655993261255,MATH 197,001,091859,McAuley; Julian John,9999,0,9999,0
1655993261255,MATH 197,002,095566,Kedlaya; Kiran S.,9997,0,9999,2
1655993261255,MATH 197,003,095567,Xiao; Ming,9999,0,9999,0
1655993261255,MATH 197,004,095571,Perols; Johan Lars,9998,0,9999,1
1655993268337,COGS 9,A01,083615,Shannon; Kyle Michael,3,1,75,72
1655993274362,COGS 11,A01,083617,Boyle; Mary E. T.,11,1,48,37
1655993280391,COGS 13,A01,083071,Bastos; Amalia Pinkusfeld,3,2,71,68
1655993286425,COGS 14A,A01,092681,Semenuks; Arturs,4,25,100,96
1655993292450,COGS 14B,A01,083073,Cheng; Tzu-Han,7,0,63,56
1655993298475,COGS 17,A01,092677,Semenuks; Arturs,8,7,81,73
1655993304502,COGS 100,A01,083619,Allen; Michael Gordon,2,2,70,68
1655993310532,COGS 101A,A01,083621,Davis; Joshua Daniel,4,3,68,64
1655993316561,COGS 101B,A01,091572,Allen; Michael Gordon,0,0,65,65
1655993322586,COGS 101C,A01,083625,Delgado; Tania,7,0,35,28
1655993328611,COGS 107A,A01,083627,Boyle; Mary E. T.,1,2,60,59
1655993334635,COGS 118A,A01,083075,Gupta; Anjum,21,16,76,55
1655993340662,CSE 3,A50,083646,Miranda; Gregory Joseph,14,0,50,36
1655993346692,CSE 8A,A50,083650,Miranda; Gregory Joseph,3,11,56,53
1655993352719,CSE 11,A01,083080,Cao; Yingjun,0,65,40,40
1655993358744,CSE 12,A01,083652,Krause-Levy; Sophia Louisa,6,8,120,114
1655993364768,CSE 15L,A01,083654,Morris; Justin Loren,3,1,50,47
1655993364768,CSE 15L,A02,083655,Morris; Justin Loren,1,1,50,49
1655993370794,CSE 20,A01,083657,Tran; Khoa Dang,29,0,80,51
1655993376822,CSE 21,A01,095574,Bach; Quang Tran,23,0,48,25
1655993382854,CSE 30,A01,083084,Eldon; John,2,10,80,78
1655993382854,CSE 30,B01,095061,Bhaskar; Nishant,0,4,50,50
1655993388891,CSE 100,A01,083659,Cao; Yingjun,2,25,70,68
1655993394915,CSE 134B,A01,083661,Powell; Thomas Allan,6,7,100,94
1655993400940,CSE 140,A01,083663,Gungor; Onat,5,0,85,80
1655993406966,CSE 140L,A01,083088,Eldon; John,5,0,100,95
1655993412990,CSE 175,A01,083665,Kumar; Rakesh,1,0,25,24
1655993419018,CSE 190,A00,092507,Dubnov; Shlomo,1,0,20,19
1655993425043,ECE 45,A01,083139,Congero; Spencer William,0,1,75,75
1655993431079,ECE 65,A50,083695,Saad; Andrew S,6,0,30,24
1655993431079,ECE 65,A51,095125,Staff,23,0,26,3
1655993437105,ECE 109,A01,091882,Touri; Behrouz,2,4,70,68
1655993443134,ECE 180,A00,083140,Abi Samra; Nicholas Camill,1,0,30,29
1655993443134,ECE 180,B00,083141,Abi Samra; Nicholas Camill,0,8,28,28
1655993449178,MATH 10A,A01,083735,Patchell; Gregory David,0,0,30,30
1655993449178,MATH 10A,A02,083736,Patchell; Gregory David,21,0,30,9
1655993449178,MATH 10A,A03,083737,Patchell; Gregory David,16,0,30,14
1655993455205,MATH 10B,A01,083207,Lim; Seonhee,1,1,34,33
1655993455205,MATH 10B,A02,083208,Lim; Seonhee,1,1,35,34
1655993455205,MATH 10B,A03,093472,Staff,1,0,34,33
1655993455205,MATH 10B,B01,083739,Sinha; Shubham,9,0,30,21
1655993461232,MATH 18,A01,083743,Cinel; Cameron Alexander,5,0,30,25
1655993461232,MATH 18,A02,083744,Cinel; Cameron Alexander,11,0,30,19
1655993461232,MATH 18,A03,083745,Cinel; Cameron Alexander,1,0,30,29
1655993461232,MATH 18,B01,083748,Ma; Zilu,2,0,36,34
1655993461232,MATH 18,B02,083749,Ma; Zilu,0,0,36,36
1655993461232,MATH 18,B03,083750,Ma; Zilu,0,0,36,36
1655993461232,MATH 18,B04,083751,Ma; Zilu,0,0,36,36
1655993461232,MATH 18,B05,093473,Staff,0,0,36,36
1655993461232,MATH 18,B06,093474,Staff,1,0,36,35
1655993467255,MATH 20A,A01,083754,Zheng; Zequn,10,0,40,30
1655993473280,MATH 20B,A01,083756,Briones; Jor-el Thomas Caparas,0,1,36,36
1655993473280,MATH 20B,A02,083757,Briones; Jor-el Thomas Caparas,1,0,36,35
1655993473280,MATH 20B,A03,093475,Staff,0,0,36,36
1655993479309,MATH 20C,A01,083760,Briones; Jor-el Thomas Caparas,0,2,35,35
1655993479309,MATH 20C,A02,083761,Briones; Jor-el Thomas Caparas,6,1,35,29
1655993479309,MATH 20C,A03,093476,Staff,0,0,35,35
1655993479309,MATH 20C,B01,083762,Bach; Quang Tran,3,0,30,27
1655993485335,MATH 20D,A01,083765,Tran; Brian Kha,1,0,30,29
1655993485335,MATH 20D,A02,083766,Tran; Brian Kha,0,1,30,30
1655993485335,MATH 20D,A03,083767,Tran; Brian Kha,1,0,30,29
1655993491366,MATH 20E,A01,083771,Ganguly; Soumya,0,1,32,32
1655993491366,MATH 20E,A02,083772,Ganguly; Soumya,1,1,32,31
1655993491366,MATH 20E,B01,083773,Ciotti; Benjamin,14,0,35,21
1655993491366,MATH 20E,B02,083774,Ciotti; Benjamin,12,0,35,23
1655993497399,MATH 103A,A01,083777,Greenfeld; Be'Eri,2,1,36,34
1655993497399,MATH 103A,A02,083778,Greenfeld; Be'Eri,2,0,36,34
1655993497399,MATH 103A,A03,093561,Staff,0,1,36,36
1655993497399,MATH 103A,B01,083779,Greenfeld; Be'Eri,7,1,36,29
1655993497399,MATH 103A,B02,083780,Greenfeld; Be'Eri,0,0,36,36
1655993497399,MATH 103A,B03,093562,Staff,0,0,36,36
1655993503426,MATH 105,A01,085443,Carter; Anne Toulson,4,1,35,31
1655993503426,MATH 105,A02,093477,Staff,8,0,35,27
1655993509457,MATH 109,A01,083213,Ganzberger; Geoffrey Michael,0,1,34,34
1655993509457,MATH 109,A02,083214,Ganzberger; Geoffrey Michael,0,0,34,34
1655993509457,MATH 109,A03,093478,Staff,1,0,34,33
1655993509457,MATH 109,B01,083215,Ganzberger; Geoffrey Michael,2,0,32,30
1655993509457,MATH 109,B02,083216,Ganzberger; Geoffrey Michael,0,0,32,32
1655993509457,MATH 109,B03,093479,Staff,4,0,32,28
1655993515479,MATH 142A,A01,083219,Chow; Bennett,0,0,32,32
1655993515479,MATH 142A,A02,083220,Chow; Bennett,7,0,32,25
1655993515479,MATH 142A,A03,093480,Staff,4,0,32,28
1655993515479,MATH 142A,B03,093481,Staff,3,0,32,29
1655993515479,MATH 142A,B04,093558,Staff,6,0,32,26
1655993515479,MATH 142A,B05,093559,Staff,0,0,32,32
1655993521509,MATH 193A,A01,083224,Rotar; Vladimir,1,1,34,33
1655993521509,MATH 193A,A02,083225,Rotar; Vladimir,0,0,34,34
1655993521509,MATH 193A,A03,083781,Rotar; Vladimir,2,0,34,32
1655993521509,MATH 193A,A04,083782,Rotar; Vladimir,3,0,34,31
1655993521509,MATH 193A,A05,093482,Rotar; Vladimir,0,0,34,34
1655993527532,MATH 197,001,091859,McAuley; Julian John,9999,0,9999,0
1655993527532,MATH 197,002,095566,Kedlaya; Kiran S.,9997,0,9999,2
1655993527532,MATH 197,003,095567,Xiao; Ming,9999,0,9999,0
1655993527532,MATH 197,004,095571,Perols; Johan Lars,9998,0,9999,1
1655993534592,COGS 9,A01,083615,Shannon; Kyle Michael,3,1,75,72
1655993540621,COGS 11,A01,083617,Boyle; Mary E. T.,11,1,48,37
1655993546649,COGS 13,A01,083071,Bastos; Amalia Pinkusfeld,3,2,71,68
1655993552672,COGS 14A,A01,092681,Semenuks; Arturs,4,25,100,96
1655993558698,COGS 14B,A01,083073,Cheng; Tzu-Han,7,0,63,56
1655993564730,COGS 17,A01,092677,Semenuks; Arturs,8,7,81,73
1655993570760,COGS 100,A01,083619,Allen; Michael Gordon,2,2,70,68
1655993576789,COGS 101A,A01,083621,Davis; Joshua Daniel,4,3,68,64
1655993582814,COGS 101B,A01,091572,Allen; Michael Gordon,0,0,65,65
1655993588839,COGS 101C,A01,083625,Delgado; Tania,7,0,35,28
1655993594872,COGS 107A,A01,083627,Boyle; Mary E. T.,1,2,60,59
1655993600895,COGS 118A,A01,083075,Gupta; Anjum,21,16,76,55
1655993606920,CSE 3,A50,083646,Miranda; Gregory Joseph,14,0,50,36
1655993612945,CSE 8A,A50,083650,Miranda; Gregory Joseph,3,11,56,53
1655993618972,CSE 11,A01,083080,Cao; Yingjun,0,65,40,40
1655993624997,CSE 12,A01,083652,Krause-Levy; Sophia Louisa,6,8,120,114
1655993631022,CSE 15L,A01,083654,Morris; Justin Loren,3,1,50,47
1655993631022,CSE 15L,A02,083655,Morris; Justin Loren,1,1,50,49
1655993637048,CSE 20,A01,083657,Tran; Khoa Dang,29,0,80,51
1655993643076,CSE 21,A01,095574,Bach; Quang Tran,23,0,48,25
1655993649107,CSE 30,A01,083084,Eldon; John,2,10,80,78
1655993649107,CSE 30,B01,095061,Bhaskar; Nishant,0,4,50,50
1655993655132,CSE 100,A01,083659,Cao; Yingjun,2,25,70,68
1655993661159,CSE 134B,A01,083661,Powell; Thomas Allan,6,7,100,94
1655993667185,CSE 140,A01,083663,Gungor; Onat,5,0,85,80
1655993673210,CSE 140L,A01,083088,Eldon; John,5,0,100,95
1655993679236,CSE 175,A01,083665,Kumar; Rakesh,1,0,25,24
1655993685261,CSE 190,A00,092507,Dubnov; Shlomo,1,0,20,19
1655993691287,ECE 45,A01,083139,Congero; Spencer William,0,1,75,75
1655993697323,ECE 65,A50,083695,Saad; Andrew S,6,0,30,24
1655993697323,ECE 65,A51,095125,Staff,23,0,26,3
1655993703359,ECE 109,A01,091882,Touri; Behrouz,2,4,70,68
1655993709394,ECE 180,A00,083140,Abi Samra; Nicholas Camill,1,0,30,29
1655993709394,ECE 180,B00,083141,Abi Samra; Nicholas Camill,0,8,28,28
1655993715418,MATH 10A,A01,083735,Patchell; Gregory David,0,0,30,30
1655993715418,MATH 10A,A02,083736,Patchell; Gregory David,21,0,30,9
1655993715418,MATH 10A,A03,083737,Patchell; Gregory David,16,0,30,14
1655993721444,MATH 10B,A01,083207,Lim; Seonhee,1,1,34,33
1655993721444,MATH 10B,A02,083208,Lim; Seonhee,1,1,35,34
1655993721444,MATH 10B,A03,093472,Staff,1,0,34,33
1655993721444,MATH 10B,B01,083739,Sinha; Shubham,9,0,30,21
1655993727470,MATH 18,A01,083743,Cinel; Cameron Alexander,5,0,30,25
1655993727470,MATH 18,A02,083744,Cinel; Cameron Alexander,11,0,30,19
1655993727470,MATH 18,A03,083745,Cinel; Cameron Alexander,1,0,30,29
1655993727470,MATH 18,B01,083748,Ma; Zilu,2,0,36,34
1655993727470,MATH 18,B02,083749,Ma; Zilu,0,0,36,36
1655993727470,MATH 18,B03,083750,Ma; Zilu,0,0,36,36
1655993727470,MATH 18,B04,083751,Ma; Zilu,0,0,36,36
1655993727470,MATH 18,B05,093473,Staff,0,0,36,36
1655993727470,MATH 18,B06,093474,Staff,1,0,36,35
1655993733499,MATH 20A,A01,083754,Zheng; Zequn,10,0,40,30
1655993739524,MATH 20B,A01,083756,Briones; Jor-el Thomas Caparas,0,1,36,36
1655993739524,MATH 20B,A02,083757,Briones; Jor-el Thomas Caparas,1,0,36,35
1655993739524,MATH 20B,A03,093475,Staff,0,0,36,36
1655993745550,MATH 20C,A01,083760,Briones; Jor-el Thomas Caparas,0,2,35,35
1655993745550,MATH 20C,A02,083761,Briones; Jor-el Thomas Caparas,6,1,35,29
1655993745550,MATH 20C,A03,093476,Staff,0,0,35,35
1655993745550,MATH 20C,B01,083762,Bach; Quang Tran,3,0,30,27
1655993751575,MATH 20D,A01,083765,Tran; Brian Kha,1,0,30,29
1655993751575,MATH 20D,A02,083766,Tran; Brian Kha,0,1,30,30
1655993751575,MATH 20D,A03,083767,Tran; Brian Kha,1,0,30,29
1655993757609,MATH 20E,A01,083771,Ganguly; Soumya,0,1,32,32
1655993757609,MATH 20E,A02,083772,Ganguly; Soumya,1,1,32,31
1655993757609,MATH 20E,B01,083773,Ciotti; Benjamin,14,0,35,21
1655993757609,MATH 20E,B02,083774,Ciotti; Benjamin,12,0,35,23
1655993763636,MATH 103A,A01,083777,Greenfeld; Be'Eri,2,1,36,34
1655993763636,MATH 103A,A02,083778,Greenfeld; Be'Eri,2,0,36,34
1655993763636,MATH 103A,A03,093561,Staff,0,1,36,36
1655993763636,MATH 103A,B01,083779,Greenfeld; Be'Eri,7,1,36,29
1655993763636,MATH 103A,B02,083780,Greenfeld; Be'Eri,0,0,36,36
1655993763636,MATH 103A,B03,093562,Staff,0,0,36,36
1655993769665,MATH 105,A01,085443,Carter; Anne Toulson,4,1,35,31
1655993769665,MATH 105,A02,093477,Staff,8,0,35,27
1655993775696,MATH 109,A01,083213,Ganzberger; Geoffrey Michael,0,1,34,34
1655993775696,MATH 109,A02,083214,Ganzberger; Geoffrey Michael,0,0,34,34
1655993775696,MATH 109,A03,093478,Staff,1,0,34,33
1655993775696,MATH 109,B01,083215,Ganzberger; Geoffrey Michael,2,0,32,30
1655993775696,MATH 109,B02,083216,Ganzberger; Geoffrey Michael,0,0,32,32
1655993775696,MATH 109,B03,093479,Staff,4,0,32,28
1655993781723,MATH 142A,A01,083219,Chow; Bennett,0,0,32,32
1655993781723,MATH 142A,A02,083220,Chow; Bennett,7,0,32,25
1655993781723,MATH 142A,A03,093480,Staff,4,0,32,28
1655993781723,MATH 142A,B03,093481,Staff,3,0,32,29
1655993781723,MATH 142A,B04,093558,Staff,6,0,32,26
1655993781723,MATH 142A,B05,093559,Staff,0,0,32,32
1655993787749,MATH 193A,A01,083224,Rotar; Vladimir,1,1,34,33
1655993787749,MATH 193A,A02,083225,Rotar; Vladimir,0,0,34,34
1655993787749,MATH 193A,A03,083781,Rotar; Vladimir,2,0,34,32
1655993787749,MATH 193A,A04,083782,Rotar; Vladimir,3,0,34,31
1655993787749,MATH 193A,A05,093482,Rotar; Vladimir,0,0,34,34
1655993793785,MATH 197,001,091859,McAuley; Julian John,9999,0,9999,0
1655993793785,MATH 197,002,095566,Kedlaya; Kiran S.,9997,0,9999,2
1655993793785,MATH 197,003,095567,Xiao; Ming,9999,0,9999,0
1655993793785,MATH 197,004,095571,Perols; Johan Lars,9998,0,9999,1
1655993800844,COGS 9,A01,083615,Shannon; Kyle Michael,3,1,75,72
1655993806873,COGS 11,A01,083617,Boyle; Mary E. T.,11,1,48,37
1655993812900,COGS 13,A01,083071,Bastos; Amalia Pinkusfeld,3,2,71,68
1655993819021,COGS 14A,A01,092681,Semenuks; Arturs,4,25,100,96
1655993825050,COGS 14B,A01,083073,Cheng; Tzu-Han,7,0,63,56
1655993831078,COGS 17,A01,092677,Semenuks; Arturs,8,7,81,73
1655993837103,COGS 100,A01,083619,Allen; Michael Gordon,2,2,70,68
1655993843128,COGS 101A,A01,083621,Davis; Joshua Daniel,4,3,68,64
1655993849161,COGS 101B,A01,091572,Allen; Michael Gordon,0,0,65,65
1655993855199,COGS 101C,A01,083625,Delgado; Tania,7,0,35,28
1655993861226,COGS 107A,A01,083627,Boyle; Mary E. T.,1,2,60,59
1655993867255,COGS 118A,A01,083075,Gupta; Anjum,21,16,76,55
1655993873281,CSE 3,A50,083646,Miranda; Gregory Joseph,14,0,50,36
1655993879318,CSE 8A,A50,083650,Miranda; Gregory Joseph,3,11,56,53
1655993885345,CSE 11,A01,083080,Cao; Yingjun,0,65,40,40
1655993891373,CSE 12,A01,083652,Krause-Levy; Sophia Louisa,6,8,120,114
1655993897398,CSE 15L,A01,083654,Morris; Justin Loren,3,1,50,47
1655993897398,CSE 15L,A02,083655,Morris; Justin Loren,1,1,50,49
1655993903423,CSE 20,A01,083657,Tran; Khoa Dang,29,0,80,51
1655993909452,CSE 21,A01,095574,Bach; Quang Tran,23,0,48,25
1655993915477,CSE 30,A01,083084,Eldon; John,2,10,80,78
1655993915477,CSE 30,B01,095061,Bhaskar; Nishant,0,4,50,50
1655993921502,CSE 100,A01,083659,Cao; Yingjun,2,25,70,68
1655993927530,CSE 134B,A01,083661,Powell; Thomas Allan,6,7,100,94
1655993933554,CSE 140,A01,083663,Gungor; Onat,5,0,85,80
1655993939579,CSE 140L,A01,083088,Eldon; John,5,0,100,95
1655993945612,CSE 175,A01,083665,Kumar; Rakesh,1,0,25,24
1655993951636,CSE 190,A00,092507,Dubnov; Shlomo,1,0,20,19
1655993957660,ECE 45,A01,083139,Congero; Spencer William,0,1,75,75
1655993963691,ECE 65,A50,083695,Saad; Andrew S,6,0,30,24
1655993963691,ECE 65,A51,095125,Staff,23,0,26,3
1655993969719,ECE 109,A01,091882,Touri; Behrouz,2,4,70,68
1655993975744,ECE 180,A00,083140,Abi Samra; Nicholas Camill,1,0,30,29
1655993975744,ECE 180,B00,083141,Abi Samra; Nicholas Camill,0,8,28,28
1655993981780,MATH 10A,A01,083735,Patchell; Gregory David,0,0,30,30
1655993981780,MATH 10A,A02,083736,Patchell; Gregory David,21,0,30,9
1655993981780,MATH 10A,A03,083737,Patchell; Gregory David,16,0,30,14
1655993987811,MATH 10B,A01,083207,Lim; Seonhee,1,1,34,33
1655993987811,MATH 10B,A02,083208,Lim; Seonhee,1,1,35,34
1655993987811,MATH 10B,A03,093472,Staff,1,0,34,33
1655993987811,MATH 10B,B01,083739,Sinha; Shubham,9,0,30,21
1655993993844,MATH 18,A01,083743,Cinel; Cameron Alexander,5,0,30,25
1655993993844,MATH 18,A02,083744,Cinel; Cameron Alexander,11,0,30,19
1655993993844,MATH 18,A03,083745,Cinel; Cameron Alexander,1,0,30,29
1655993993844,MATH 18,B01,083748,Ma; Zilu,2,0,36,34
1655993993844,MATH 18,B02,083749,Ma; Zilu,0,0,36,36
1655993993844,MATH 18,B03,083750,Ma; Zilu,0,0,36,36
1655993993844,MATH 18,B04,083751,Ma; Zilu,0,0,36,36
1655993993844,MATH 18,B05,093473,Staff,0,0,36,36
1655993993844,MATH 18,B06,093474,Staff,1,0,36,35
1655993999880,MATH 20A,A01,083754,Zheng; Zequn,10,0,40,30
1655994005911,MATH 20B,A01,083756,Briones; Jor-el Thomas Caparas,0,1,36,36
1655994005911,MATH 20B,A02,083757,Briones; Jor-el Thomas Caparas,1,0,36,35
1655994005911,MATH 20B,A03,093475,Staff,0,0,36,36
1655994011941,MATH 20C,A01,083760,Briones; Jor-el Thomas Caparas,0,2,35,35
1655994011941,MATH 20C,A02,083761,Briones; Jor-el Thomas Caparas,6,1,35,29
1655994011941,MATH 20C,A03,093476,Staff,0,0,35,35
1655994011941,MATH 20C,B01,083762,Bach; Quang Tran,3,0,30,27
1655994017966,MATH 20D,A01,083765,Tran; Brian Kha,1,0,30,29
1655994017966,MATH 20D,A02,083766,Tran; Brian Kha,0,1,30,30
1655994017966,MATH 20D,A03,083767,Tran; Brian Kha,1,0,30,29
1655994023992,MATH 20E,A01,083771,Ganguly; Soumya,0,1,32,32
1655994023992,MATH 20E,A02,083772,Ganguly; Soumya,1,1,32,31
1655994023992,MATH 20E,B01,083773,Ciotti; Benjamin,14,0,35,21
1655994023992,MATH 20E,B02,083774,Ciotti; Benjamin,12,0,35,23
1655994030019,MATH 103A,A01,083777,Greenfeld; Be'Eri,2,1,36,34
1655994030019,MATH 103A,A02,083778,Greenfeld; Be'Eri,2,0,36,34
1655994030019,MATH 103A,A03,093561,Staff,0,1,36,36
1655994030019,MATH 103A,B01,083779,Greenfeld; Be'Eri,7,1,36,29
1655994030019,MATH 103A,B02,083780,Greenfeld; Be'Eri,0,0,36,36
1655994030019,MATH 103A,B03,093562,Staff,0,0,36,36
1655994036045,MATH 105,A01,085443,Carter; Anne Toulson,4,1,35,31
1655994036045,MATH 105,A02,093477,Staff,8,0,35,27
1655994042083,MATH 109,A01,083213,Ganzberger; Geoffrey Michael,0,1,34,34
1655994042083,MATH 109,A02,083214,Ganzberger; Geoffrey Michael,0,0,34,34
1655994042083,MATH 109,A03,093478,Staff,1,0,34,33
1655994042083,MATH 109,B01,083215,Ganzberger; Geoffrey Michael,2,0,32,30
1655994042083,MATH 109,B02,083216,Ganzberger; Geoffrey Michael,0,0,32,32
1655994042083,MATH 109,B03,093479,Staff,4,0,32,28
1655994048107,MATH 142A,A01,083219,Chow; Bennett,0,0,32,32
1655994048107,MATH 142A,A02,083220,Chow; Bennett,7,0,32,25
1655994048107,MATH 142A,A03,093480,Staff,4,0,32,28
1655994048107,MATH 142A,B03,093481,Staff,3,0,32,29
1655994048107,MATH 142A,B04,093558,Staff,6,0,32,26
1655994048107,MATH 142A,B05,093559,Staff,0,0,32,32
1655994054134,MATH 193A,A01,083224,Rotar; Vladimir,1,1,34,33
1655994054134,MATH 193A,A02,083225,Rotar; Vladimir,0,0,34,34
1655994054134,MATH 193A,A03,083781,Rotar; Vladimir,2,0,34,32
1655994054134,MATH 193A,A04,083782,Rotar; Vladimir,3,0,34,31
1655994054134,MATH 193A,A05,093482,Rotar; Vladimir,0,0,34,34
1655994060164,MATH 197,001,091859,McAuley; Julian John,9999,0,9999,0
1655994060164,MATH 197,002,095566,Kedlaya; Kiran S.,9997,0,9999,2
1655994060164,MATH 197,003,095567,Xiao; Ming,9999,0,9999,0
1655994060164,MATH 197,004,095571,Perols; Johan Lars,9998,0,9999,1
1655994067225,COGS 9,A01,083615,Shannon; Kyle Michael,3,1,75,72
1655994073251,COGS 11,A01,083617,Boyle; Mary E. T.,11,1,48,37
1655994079280,COGS 13,A01,083071,Bastos; Amalia Pinkusfeld,3,2,71,68
1655994085308,COGS 14A,A01,092681,Semenuks; Arturs,4,25,100,96
1655994091334,COGS 14B,A01,083073,Cheng; Tzu-Han,7,0,63,56
1655994097357,COGS 17,A01,092677,Semenuks; Arturs,8,7,81,73
1655994103384,COGS 100,A01,083619,Allen; Michael Gordon,2,2,70,68
1655994109407,COGS 101A,A01,083621,Davis; Joshua Daniel,4,3,68,64
1655994115434,COGS 101B,A01,091572,Allen; Michael Gordon,0,0,65,65
1655994121463,COGS 101C,A01,083625,Delgado; Tania,7,0,35,28
1655994127492,COGS 107A,A01,083627,Boyle; Mary E. T.,1,2,60,59
1655994133515,COGS 118A,A01,083075,Gupta; Anjum,21,16,76,55
1655994139540,CSE 3,A50,083646,Miranda; Gregory Joseph,14,0,50,36
1655994145566,CSE 8A,A50,083650,Miranda; Gregory Joseph,3,11,56,53
1655994151595,CSE 11,A01,083080,Cao; Yingjun,0,65,40,40
1655994157619,CSE 12,A01,083652,Krause-Levy; Sophia Louisa,6,8,120,114
1655994163650,CSE 15L,A01,083654,Morris; Justin Loren,3,1,50,47
1655994163650,CSE 15L,A02,083655,Morris; Justin Loren,1,1,50,49
1655994169688,CSE 20,A01,083657,Tran; Khoa Dang,29,0,80,51
1655994175714,CSE 21,A01,095574,Bach; Quang Tran,23,0,48,25
1655994181745,CSE 30,A01,083084,Eldon; John,2,10,80,78
1655994181745,CSE 30,B01,095061,Bhaskar; Nishant,0,4,50,50
1655994187773,CSE 100,A01,083659,Cao; Yingjun,2,25,70,68
1655994193799,CSE 134B,A01,083661,Powell; Thomas Allan,6,7,100,94
1655994199825,CSE 140,A01,083663,Gungor; Onat,5,0,85,80
1655994205851,CSE 140L,A01,083088,Eldon; John,5,0,100,95
1655994211877,CSE 175,A01,083665,Kumar; Rakesh,1,0,25,24
1655994217904,CSE 190,A00,092507,Dubnov; Shlomo,1,0,20,19
1655994223935,ECE 45,A01,083139,Congero; Spencer William,0,1,75,75
1655994229962,ECE 65,A50,083695,Saad; Andrew S,6,0,30,24
1655994229962,ECE 65,A51,095125,Staff,23,0,26,3
1655994235988,ECE 109,A01,091882,Touri; Behrouz,2,4,70,68
1655994242020,ECE 180,A00,083140,Abi Samra; Nicholas Camill,1,0,30,29
1655994242020,ECE 180,B00,083141,Abi Samra; Nicholas Camill,0,8,28,28
1655994248047,MATH 10A,A01,083735,Patchell; Gregory David,0,0,30,30
1655994248047,MATH 10A,A02,083736,Patchell; Gregory David,21,0,30,9
1655994248047,MATH 10A,A03,083737,Patchell; Gregory David,16,0,30,14
1655994254082,MATH 10B,A01,083207,Lim; Seonhee,1,1,34,33
1655994254082,MATH 10B,A02,083208,Lim; Seonhee,1,1,35,34
1655994254082,MATH 10B,A03,093472,Staff,1,0,34,33
1655994254082,MATH 10B,B01,083739,Sinha; Shubham,9,0,30,21
1655994260110,MATH 18,A01,083743,Cinel; Cameron Alexander,5,0,30,25
1655994260110,MATH 18,A02,083744,Cinel; Cameron Alexander,11,0,30,19
1655994260110,MATH 18,A03,083745,Cinel; Cameron Alexander,1,0,30,29
1655994260110,MATH 18,B01,083748,Ma; Zilu,2,0,36,34
1655994260110,MATH 18,B02,083749,Ma; Zilu,0,0,36,36
1655994260110,MATH 18,B03,083750,Ma; Zilu,0,0,36,36
1655994260110,MATH 18,B04,083751,Ma; Zilu,0,0,36,36
1655994260110,MATH 18,B05,093473,Staff,0,0,36,36
1655994260110,MATH 18,B06,093474,Staff,1,0,36,35
1655994266134,MATH 20A,A01,083754,Zheng; Zequn,10,0,40,30
1655994272165,MATH 20B,A01,083756,Briones; Jor-el Thomas Caparas,0,1,36,36
1655994272165,MATH 20B,A02,083757,Briones; Jor-el Thomas Caparas,1,0,36,35
1655994272165,MATH 20B,A03,093475,Staff,0,0,36,36
1655994278195,MATH 20C,A01,083760,Briones; Jor-el Thomas Caparas,0,2,35,35
1655994278195,MATH 20C,A02,083761,Briones; Jor-el Thomas Caparas,6,1,35,29
1655994278195,MATH 20C,A03,093476,Staff,0,0,35,35
1655994278195,MATH 20C,B01,083762,Bach; Quang Tran,3,0,30,27
1655994284227,MATH 20D,A01,083765,Tran; Brian Kha,1,0,30,29
1655994284227,MATH 20D,A02,083766,Tran; Brian Kha,0,1,30,30
1655994284227,MATH 20D,A03,083767,Tran; Brian Kha,1,0,30,29
1655994290260,MATH 20E,A01,083771,Ganguly; Soumya,0,1,32,32
1655994290260,MATH 20E,A02,083772,Ganguly; Soumya,1,1,32,31
1655994290260,MATH 20E,B01,083773,Ciotti; Benjamin,14,0,35,21
1655994290260,MATH 20E,B02,083774,Ciotti; Benjamin,12,0,35,23
1655994296287,MATH 103A,A01,083777,Greenfeld; Be'Eri,2,1,36,34
1655994296287,MATH 103A,A02,083778,Greenfeld; Be'Eri,2,0,36,34
1655994296287,MATH 103A,A03,093561,Staff,0,1,36,36
1655994296287,MATH 103A,B01,083779,Greenfeld; Be'Eri,7,1,36,29
1655994296287,MATH 103A,B02,083780,Greenfeld; Be'Eri,0,0,36,36
1655994296287,MATH 103A,B03,093562,Staff,0,0,36,36
1655994302312,MATH 105,A01,085443,Carter; Anne Toulson,4,1,35,31
1655994302312,MATH 105,A02,093477,Staff,8,0,35,27
1655994308339,MATH 109,A01,083213,Ganzberger; Geoffrey Michael,0,1,34,34
1655994308339,MATH 109,A02,083214,Ganzberger; Geoffrey Michael,0,0,34,34
1655994308339,MATH 109,A03,093478,Staff,1,0,34,33
1655994308339,MATH 109,B01,083215,Ganzberger; Geoffrey Michael,2,0,32,30
1655994308339,MATH 109,B02,083216,Ganzberger; Geoffrey Michael,0,0,32,32
1655994308339,MATH 109,B03,093479,Staff,4,0,32,28
1655994314365,MATH 142A,A01,083219,Chow; Bennett,0,0,32,32
1655994314365,MATH 142A,A02,083220,Chow; Bennett,7,0,32,25
1655994314365,MATH 142A,A03,093480,Staff,4,0,32,28
1655994314365,MATH 142A,B03,093481,Staff,3,0,32,29
1655994314365,MATH 142A,B04,093558,Staff,6,0,32,26
1655994314365,MATH 142A,B05,093559,Staff,0,0,32,32
1655994320391,MATH 193A,A01,083224,Rotar; Vladimir,1,1,34,33
1655994320391,MATH 193A,A02,083225,Rotar; Vladimir,0,0,34,34
1655994320391,MATH 193A,A03,083781,Rotar; Vladimir,2,0,34,32
1655994320391,MATH 193A,A04,083782,Rotar; Vladimir,3,0,34,31
1655994320391,MATH 193A,A05,093482,Rotar; Vladimir,0,0,34,34
1655994326418,MATH 197,001,091859,McAuley; Julian John,9999,0,9999,0
1655994326418,MATH 197,002,095566,Kedlaya; Kiran S.,9997,0,9999,2
1655994326418,MATH 197,003,095567,Xiao; Ming,9999,0,9999,0
1655994326418,MATH 197,004,095571,Perols; Johan Lars,9998,0,9999,1
1655994333497,COGS 9,A01,083615,Shannon; Kyle Michael,3,1,75,72
1655994339525,COGS 11,A01,083617,Boyle; Mary E. T.,11,1,48,37
1655994345561,COGS 13,A01,083071,Bastos; Amalia Pinkusfeld,3,2,71,68
1655994351586,COGS 14A,A01,092681,Semenuks; Arturs,4,25,100,96
1655994357613,COGS 14B,A01,083073,Cheng; Tzu-Han,7,0,63,56
1655994363640,COGS 17,A01,092677,Semenuks; Arturs,8,7,81,73
1655994369681,COGS 100,A01,083619,Allen; Michael Gordon,2,2,70,68
1655994375708,COGS 101A,A01,083621,Davis; Joshua Daniel,4,3,68,64
1655994381737,COGS 101B,A01,091572,Allen; Michael Gordon,0,0,65,65
1655994387773,COGS 101C,A01,083625,Delgado; Tania,7,0,35,28
1655994393802,COGS 107A,A01,083627,Boyle; Mary E. T.,1,2,60,59
1655994399826,COGS 118A,A01,083075,Gupta; Anjum,21,16,76,55
1655994405852,CSE 3,A50,083646,Miranda; Gregory Joseph,14,0,50,36
1655994411879,CSE 8A,A50,083650,Miranda; Gregory Joseph,3,11,56,53
1655994417988,CSE 11,A01,083080,Cao; Yingjun,0,65,40,40
1655994424015,CSE 12,A01,083652,Krause-Levy; Sophia Louisa,6,8,120,114
1655994430040,CSE 15L,A01,083654,Morris; Justin Loren,3,1,50,47
1655994430040,CSE 15L,A02,083655,Morris; Justin Loren,1,1,50,49
1655994436066,CSE 20,A01,083657,Tran; Khoa Dang,29,0,80,51
1655994442090,CSE 21,A01,095574,Bach; Quang Tran,23,0,48,25
1655994448119,CSE 30,A01,083084,Eldon; John,2,10,80,78
1655994448119,CSE 30,B01,095061,Bhaskar; Nishant,0,4,50,50
1655994454143,CSE 100,A01,083659,Cao; Yingjun,2,25,70,68
1655994460168,CSE 134B,A01,083661,Powell; Thomas Allan,6,7,100,94
1655994466195,CSE 140,A01,083663,Gungor; Onat,5,0,85,80
1655994472220,CSE 140L,A01,083088,Eldon; John,5,0,100,95
1655994478248,CSE 175,A01,083665,Kumar; Rakesh,1,0,25,24
1655994484277,CSE 190,A00,092507,Dubnov; Shlomo,1,0,20,19
1655994490304,ECE 45,A01,083139,Congero; Spencer William,0,1,75,75
1655994496331,ECE 65,A50,083695,Saad; Andrew S,6,0,30,24
1655994496331,ECE 65,A51,095125,Staff,23,0,26,3
1655994502355,ECE 109,A01,091882,Touri; Behrouz,2,4,70,68
1655994508388,ECE 180,A00,083140,Abi Samra; Nicholas Camill,1,0,30,29
1655994508388,ECE 180,B00,083141,Abi Samra; Nicholas Camill,0,8,28,28
1655994514413,MATH 10A,A01,083735,Patchell; Gregory David,0,0,30,30
1655994514413,MATH 10A,A02,083736,Patchell; Gregory David,21,0,30,9
1655994514413,MATH 10A,A03,083737,Patchell; Gregory David,16,0,30,14
1655994520453,MATH 10B,A01,083207,Lim; Seonhee,1,1,34,33
1655994520453,MATH 10B,A02,083208,Lim; Seonhee,1,1,35,34
1655994520453,MATH 10B,A03,093472,Staff,1,0,34,33
1655994520453,MATH 10B,B01,083739,Sinha; Shubham,9,0,30,21
1655994526487,MATH 18,A01,083743,Cinel; Cameron Alexander,5,0,30,25
1655994526487,MATH 18,A02,083744,Cinel; Cameron Alexander,11,0,30,19
1655994526487,MATH 18,A03,083745,Cinel; Cameron Alexander,1,0,30,29
1655994526487,MATH 18,B01,083748,Ma; Zilu,2,0,36,34
1655994526487,MATH 18,B02,083749,Ma; Zilu,0,0,36,36
1655994526487,MATH 18,B03,083750,Ma; Zilu,0,0,36,36
1655994526487,MATH 18,B04,083751,Ma; Zilu,0,0,36,36
1655994526487,MATH 18,B05,093473,Staff,0,0,36,36
1655994526487,MATH 18,B06,093474,Staff,1,0,36,35
1655994532517,MATH 20A,A01,083754,Zheng; Zequn,10,0,40,30
1655994538541,MATH 20B,A01,083756,Briones; Jor-el Thomas Caparas,0,1,36,36
1655994538541,MATH 20B,A02,083757,Briones; Jor-el Thomas Caparas,1,0,36,35
1655994538541,MATH 20B,A03,093475,Staff,0,0,36,36
1655994544569,MATH 20C,A01,083760,Briones; Jor-el Thomas Caparas,0,2,35,35
1655994544569,MATH 20C,A02,083761,Briones; Jor-el Thomas Caparas,6,1,35,29
1655994544569,MATH 20C,A03,093476,Staff,0,0,35,35
1655994544569,MATH 20C,B01,083762,Bach; Quang Tran,3,0,30,27
1655994550599,MATH 20D,A01,083765,Tran; Brian Kha,1,0,30,29
1655994550599,MATH 20D,A02,083766,Tran; Brian Kha,0,1,30,30
1655994550599,MATH 20D,A03,083767,Tran; Brian Kha,1,0,30,29
1655994556635,MATH 20E,A01,083771,Ganguly; Soumya,0,1,32,32
1655994556635,MATH 20E,A02,083772,Ganguly; Soumya,1,1,32,31
1655994556635,MATH 20E,B01,083773,Ciotti; Benjamin,14,0,35,21
1655994556635,MATH 20E,B02,083774,Ciotti; Benjamin,12,0,35,23
1655994562663,MATH 103A,A01,083777,Greenfeld; Be'Eri,2,1,36,34
1655994562663,MATH 103A,A02,083778,Greenfeld; Be'Eri,2,0,36,34
1655994562663,MATH 103A,A03,093561,Staff,0,1,36,36
1655994562663,MATH 103A,B01,083779,Greenfeld; Be'Eri,7,1,36,29
1655994562663,MATH 103A,B02,083780,Greenfeld; Be'Eri,0,0,36,36
1655994562663,MATH 103A,B03,093562,Staff,0,0,36,36
1655994568689,MATH 105,A01,085443,Carter; Anne Toulson,4,1,35,31
1655994568689,MATH 105,A02,093477,Staff,8,0,35,27
1655994574716,MATH 109,A01,083213,Ganzberger; Geoffrey Michael,0,1,34,34
1655994574716,MATH 109,A02,083214,Ganzberger; Geoffrey Michael,0,0,34,34
1655994574716,MATH 109,A03,093478,Staff,1,0,34,33
1655994574716,MATH 109,B01,083215,Ganzberger; Geoffrey Michael,2,0,32,30
1655994574716,MATH 109,B02,083216,Ganzberger; Geoffrey Michael,0,0,32,32
1655994574716,MATH 109,B03,093479,Staff,4,0,32,28
1655994580747,MATH 142A,A01,083219,Chow; Bennett,0,0,32,32
1655994580747,MATH 142A,A02,083220,Chow; Bennett,7,0,32,25
1655994580747,MATH 142A,A03,093480,Staff,4,0,32,28
1655994580747,MATH 142A,B03,093481,Staff,3,0,32,29
1655994580747,MATH 142A,B04,093558,Staff,6,0,32,26
1655994580747,MATH 142A,B05,093559,Staff,0,0,32,32
1655994586772,MATH 193A,A01,083224,Rotar; Vladimir,1,1,34,33
1655994586772,MATH 193A,A02,083225,Rotar; Vladimir,0,0,34,34
1655994586772,MATH 193A,A03,083781,Rotar; Vladimir,2,0,34,32
1655994586772,MATH 193A,A04,083782,Rotar; Vladimir,3,0,34,31
1655994586772,MATH 193A,A05,093482,Rotar; Vladimir,0,0,34,34
1655994592799,MATH 197,001,091859,McAuley; Julian John,9999,0,9999,0
1655994592799,MATH 197,002,095566,Kedlaya; Kiran S.,9997,0,9999,2
1655994592799,MATH 197,003,095567,Xiao; Ming,9999,0,9999,0
1655994592799,MATH 197,004,095571,Perols; Johan Lars,9998,0,9999,1
1655994599857,COGS 9,A01,083615,Shannon; Kyle Michael,3,1,75,72
1655994605885,COGS 11,A01,083617,Boyle; Mary E. T.,11,1,48,37
1655994611907,COGS 13,A01,083071,Bastos; Amalia Pinkusfeld,3,2,71,68
1655994617932,COGS 14A,A01,092681,Semenuks; Arturs,4,25,100,96
1655994623965,COGS 14B,A01,083073,Cheng; Tzu-Han,7,0,63,56
1655994629989,COGS 17,A01,092677,Semenuks; Arturs,8,7,81,73
1655994636018,COGS 100,A01,083619,Allen; Michael Gordon,2,2,70,68
1655994642048,COGS 101A,A01,083621,Davis; Joshua Daniel,4,3,68,64
1655994648074,COGS 101B,A01,091572,Allen; Michael Gordon,0,0,65,65
1655994654105,COGS 101C,A01,083625,Delgado; Tania,7,0,35,28
1655994660134,COGS 107A,A01,083627,Boyle; Mary E. T.,1,2,60,59
1655994666164,COGS 118A,A01,083075,Gupta; Anjum,21,16,76,55
1655994672194,CSE 3,A50,083646,Miranda; Gregory Joseph,14,0,50,36
1655994678229,CSE 8A,A50,083650,Miranda; Gregory Joseph,3,11,56,53
1655994684258,CSE 11,A01,083080,Cao; Yingjun,0,65,40,40
1655994690294,CSE 12,A01,083652,Krause-Levy; Sophia Louisa,6,8,120,114
1655994696321,CSE 15L,A01,083654,Morris; Justin Loren,3,1,50,47
1655994696321,CSE 15L,A02,083655,Morris; Justin Loren,1,1,50,49
1655994702350,CSE 20,A01,083657,Tran; Khoa Dang,29,0,80,51
1655994708384,CSE 21,A01,095574,Bach; Quang Tran,23,0,48,25
1655994714414,CSE 30,A01,083084,Eldon; John,2,10,80,78
1655994714414,CSE 30,B01,095061,Bhaskar; Nishant,0,4,50,50
1655994720440,CSE 100,A01,083659,Cao; Yingjun,2,25,70,68
1655994726472,CSE 134B,A01,083661,Powell; Thomas Allan,6,7,100,94
1655994732497,CSE 140,A01,083663,Gungor; Onat,5,0,85,80
1655994738540,CSE 140L,A01,083088,Eldon; John,5,0,100,95
1655994744564,CSE 175,A01,083665,Kumar; Rakesh,1,0,25,24
1655994750600,CSE 190,A00,092507,Dubnov; Shlomo,1,0,20,19
1655994756625,ECE 45,A01,083139,Congero; Spencer William,0,1,75,75
1655994762654,ECE 65,A50,083695,Saad; Andrew S,6,0,30,24
1655994762654,ECE 65,A51,095125,Staff,23,0,26,3
1655994768683,ECE 109,A01,091882,Touri; Behrouz,2,4,70,68
1655994774707,ECE 180,A00,083140,Abi Samra; Nicholas Camill,1,0,30,29
1655994774707,ECE 180,B00,083141,Abi Samra; Nicholas Camill,0,8,28,28
1655994780744,MATH 10A,A01,083735,Patchell; Gregory David,0,0,30,30
1655994780744,MATH 10A,A02,083736,Patchell; Gregory David,21,0,30,9
1655994780744,MATH 10A,A03,083737,Patchell; Gregory David,16,0,30,14
1655994786785,MATH 10B,A01,083207,Lim; Seonhee,1,1,34,33
1655994786785,MATH 10B,A02,083208,Lim; Seonhee,1,1,35,34
1655994786785,MATH 10B,A03,093472,Staff,1,0,34,33
1655994786785,MATH 10B,B01,083739,Sinha; Shubham,9,0,30,21
1655994792822,MATH 18,A01,083743,Cinel; Cameron Alexander,5,0,30,25
1655994792822,MATH 18,A02,083744,Cinel; Cameron Alexander,11,0,30,19
1655994792822,MATH 18,A03,083745,Cinel; Cameron Alexander,1,0,30,29
1655994792822,MATH 18,B01,083748,Ma; Zilu,2,0,36,34
1655994792822,MATH 18,B02,083749,Ma; Zilu,0,0,36,36
1655994792822,MATH 18,B03,083750,Ma; Zilu,0,0,36,36
1655994792822,MATH 18,B04,083751,Ma; Zilu,0,0,36,36
1655994792822,MATH 18,B05,093473,Staff,0,0,36,36
1655994792822,MATH 18,B06,093474,Staff,1,0,36,35
1655994798847,MATH 20A,A01,083754,Zheng; Zequn,10,0,40,30
1655994804877,MATH 20B,A01,083756,Briones; Jor-el Thomas Caparas,0,1,36,36
1655994804877,MATH 20B,A02,083757,Briones; Jor-el Thomas Caparas,1,0,36,35
1655994804877,MATH 20B,A03,093475,Staff,0,0,36,36
1655994810906,MATH 20C,A01,083760,Briones; Jor-el Thomas Caparas,0,2,35,35
1655994810906,MATH 20C,A02,083761,Briones; Jor-el Thomas Caparas,6,1,35,29
1655994810906,MATH 20C,A03,093476,Staff,0,0,35,35
1655994810906,MATH 20C,B01,083762,Bach; Quang Tran,3,0,30,27
1655994816943,MATH 20D,A01,083765,Tran; Brian Kha,1,0,30,29
1655994816943,MATH 20D,A02,083766,Tran; Brian Kha,0,1,30,30
1655994816943,MATH 20D,A03,083767,Tran; Brian Kha,1,0,30,29
1655994822978,MATH 20E,A01,083771,Ganguly; Soumya,0,1,32,32
1655994822978,MATH 20E,A02,083772,Ganguly; Soumya,1,1,32,31
1655994822978,MATH 20E,B01,083773,Ciotti; Benjamin,14,0,35,21
1655994822978,MATH 20E,B02,083774,Ciotti; Benjamin,12,0,35,23
1655994829012,MATH 103A,A01,083777,Greenfeld; Be'Eri,2,1,36,34
1655994829012,MATH 103A,A02,083778,Greenfeld; Be'Eri,2,0,36,34
1655994829012,MATH 103A,A03,093561,Staff,0,1,36,36
1655994829012,MATH 103A,B01,083779,Greenfeld; Be'Eri,7,1,36,29
1655994829012,MATH 103A,B02,083780,Greenfeld; Be'Eri,0,0,36,36
1655994829012,MATH 103A,B03,093562,Staff,0,0,36,36
1655994835038,MATH 105,A01,085443,Carter; Anne Toulson,4,1,35,31
1655994835038,MATH 105,A02,093477,Staff,8,0,35,27
1655994841062,MATH 109,A01,083213,Ganzberger; Geoffrey Michael,0,1,34,34
1655994841062,MATH 109,A02,083214,Ganzberger; Geoffrey Michael,0,0,34,34
1655994841062,MATH 109,A03,093478,Staff,1,0,34,33
1655994841062,MATH 109,B01,083215,Ganzberger; Geoffrey Michael,2,0,32,30
1655994841062,MATH 109,B02,083216,Ganzberger; Geoffrey Michael,0,0,32,32
1655994841062,MATH 109,B03,093479,Staff,4,0,32,28
1655994847114,MATH 142A,A01,083219,Chow; Bennett,0,0,32,32
1655994847114,MATH 142A,A02,083220,Chow; Bennett,7,0,32,25
1655994847114,MATH 142A,A03,093480,Staff,4,0,32,28
1655994847114,MATH 142A,B03,093481,Staff,3,0,32,29
1655994847114,MATH 142A,B04,093558,Staff,6,0,32,26
1655994847114,MATH 142A,B05,093559,Staff,0,0,32,32
1655994853146,MATH 193A,A01,083224,Rotar; Vladimir,1,1,34,33
1655994853146,MATH 193A,A02,083225,Rotar; Vladimir,0,0,34,34
1655994853146,MATH 193A,A03,083781,Rotar; Vladimir,2,0,34,32
1655994853146,MATH 193A,A04,083782,Rotar; Vladimir,3,0,34,31
1655994853146,MATH 193A,A05,093482,Rotar; Vladimir,0,0,34,34
1655994859170,MATH 197,001,091859,McAuley; Julian John,9999,0,9999,0
1655994859170,MATH 197,002,095566,Kedlaya; Kiran S.,9997,0,9999,2
1655994859170,MATH 197,003,095567,Xiao; Ming,9999,0,9999,0
1655994859170,MATH 197,004,095571,Perols; Johan Lars,9998,0,9999,1
1655994866234,COGS 9,A01,083615,Shannon; Kyle Michael,3,1,75,72
1655994872261,COGS 11,A01,083617,Boyle; Mary E. T.,11,1,48,37
1655994878288,COGS 13,A01,083071,Bastos; Amalia Pinkusfeld,3,2,71,68
1655994884314,COGS 14A,A01,092681,Semenuks; Arturs,4,25,100,96
1655994890346,COGS 14B,A01,083073,Cheng; Tzu-Han,7,0,63,56
1655994896373,COGS 17,A01,092677,Semenuks; Arturs,8,7,81,73
1655994902398,COGS 100,A01,083619,Allen; Michael Gordon,2,2,70,68
1655994908429,COGS 101A,A01,083621,Davis; Joshua Daniel,4,3,68,64
1655994914454,COGS 101B,A01,091572,Allen; Michael Gordon,0,0,65,65
1655994920481,COGS 101C,A01,083625,Delgado; Tania,7,0,35,28
1655994926516,COGS 107A,A01,083627,Boyle; Mary E. T.,1,2,60,59
1655994932541,COGS 118A,A01,083075,Gupta; Anjum,21,16,76,55
1655994938565,CSE 3,A50,083646,Miranda; Gregory Joseph,14,0,50,36
1655994944594,CSE 8A,A50,083650,Miranda; Gregory Joseph,3,11,56,53
1655994950618,CSE 11,A01,083080,Cao; Yingjun,0,65,40,40
1655994956655,CSE 12,A01,083652,Krause-Levy; Sophia Louisa,6,8,120,114
1655994962680,CSE 15L,A01,083654,Morris; Justin Loren,3,1,50,47
1655994962680,CSE 15L,A02,083655,Morris; Justin Loren,1,1,50,49
1655994968722,CSE 20,A01,083657,Tran; Khoa Dang,29,0,80,51
1655994974768,CSE 21,A01,095574,Bach; Quang Tran,23,0,48,25
1655994980797,CSE 30,A01,083084,Eldon; John,2,10,80,78
1655994980797,CSE 30,B01,095061,Bhaskar; Nishant,0,4,50,50
1655994986845,CSE 100,A01,083659,Cao; Yingjun,2,25,70,68
1655994992874,CSE 134B,A01,083661,Powell; Thomas Allan,6,7,100,94
1655994998904,CSE 140,A01,083663,Gungor; Onat,5,0,85,80
1655995004932,CSE 140L,A01,083088,Eldon; John,5,0,100,95
1655995010967,CSE 175,A01,083665,Kumar; Rakesh,1,0,25,24
1655995017100,CSE 190,A00,092507,Dubnov; Shlomo,1,0,20,19
1655995023129,ECE 45,A01,083139,Congero; Spencer William,0,1,75,75
1655995029174,ECE 65,A50,083695,Saad; Andrew S,6,0,30,24
1655995029174,ECE 65,A51,095125,Staff,23,0,26,3
1655995035202,ECE 109,A01,091882,Touri; Behrouz,2,4,70,68
1655995041227,ECE 180,A00,083140,Abi Samra; Nicholas Camill,1,0,30,29
1655995041227,ECE 180,B00,083141,Abi Samra; Nicholas Camill,0,8,28,28
1655995047252,MATH 10A,A01,083735,Patchell; Gregory David,0,0,30,30
1655995047252,MATH 10A,A02,083736,Patchell; Gregory David,21,0,30,9
1655995047252,MATH 10A,A03,083737,Patchell; Gregory David,16,0,30,14
1655995053290,MATH 10B,A01,083207,Lim; Seonhee,1,1,34,33
1655995053290,MATH 10B,A02,083208,Lim; Seonhee,1,1,35,34
1655995053290,MATH 10B,A03,093472,Staff,1,0,34,33
1655995053290,MATH 10B,B01,083739,Sinha; Shubham,9,0,30,21
1655995059327,MATH 18,A01,083743,Cinel; Cameron Alexander,5,0,30,25
1655995059327,MATH 18,A02,083744,Cinel; Cameron Alexander,11,0,30,19
1655995059327,MATH 18,A03,083745,Cinel; Cameron Alexander,1,0,30,29
1655995059327,MATH 18,B01,083748,Ma; Zilu,2,0,36,34
1655995059327,MATH 18,B02,083749,Ma; Zilu,0,0,36,36
1655995059327,MATH 18,B03,083750,Ma; Zilu,0,0,36,36
1655995059327,MATH 18,B04,083751,Ma; Zilu,0,0,36,36
1655995059327,MATH 18,B05,093473,Staff,0,0,36,36
1655995059327,MATH 18,B06,093474,Staff,1,0,36,35
1655995065357,MATH 20A,A01,083754,Zheng; Zequn,10,0,40,30
1655995071398,MATH 20B,A01,083756,Briones; Jor-el Thomas Caparas,0,1,36,36
1655995071398,MATH 20B,A02,083757,Briones; Jor-el Thomas Caparas,1,0,36,35
1655995071398,MATH 20B,A03,093475,Staff,0,0,36,36
1655995077423,MATH 20C,A01,083760,Briones; Jor-el Thomas Caparas,0,2,35,35
1655995077423,MATH 20C,A02,083761,Briones; Jor-el Thomas Caparas,6,1,35,29
1655995077423,MATH 20C,A03,093476,Staff,0,0,35,35
1655995077423,MATH 20C,B01,083762,Bach; Quang Tran,3,0,30,27
1655995083464,MATH 20D,A01,083765,Tran; Brian Kha,1,0,30,29
1655995083464,MATH 20D,A02,083766,Tran; Brian Kha,0,1,30,30
1655995083464,MATH 20D,A03,083767,Tran; Brian Kha,1,0,30,29
1655995089506,MATH 20E,A01,083771,Ganguly; Soumya,0,1,32,32
1655995089506,MATH 20E,A02,083772,Ganguly; Soumya,1,1,32,31
1655995089506,MATH 20E,B01,083773,Ciotti; Benjamin,14,0,35,21
1655995089506,MATH 20E,B02,083774,Ciotti; Benjamin,12,0,35,23
1655995095538,MATH 103A,A01,083777,Greenfeld; Be'Eri,2,1,36,34
1655995095538,MATH 103A,A02,083778,Greenfeld; Be'Eri,2,0,36,34
1655995095538,MATH 103A,A03,093561,Staff,0,1,36,36
1655995095538,MATH 103A,B01,083779,Greenfeld; Be'Eri,7,1,36,29
1655995095538,MATH 103A,B02,083780,Greenfeld; Be'Eri,0,0,36,36
1655995095538,MATH 103A,B03,093562,Staff,0,0,36,36
1655995101566,MATH 105,A01,085443,Carter; Anne Toulson,4,1,35,31
1655995101566,MATH 105,A02,093477,Staff,8,0,35,27
1655995107598,MATH 109,A01,083213,Ganzberger; Geoffrey Michael,0,1,34,34
1655995107598,MATH 109,A02,083214,Ganzberger; Geoffrey Michael,0,0,34,34
1655995107598,MATH 109,A03,093478,Staff,1,0,34,33
1655995107598,MATH 109,B01,083215,Ganzberger; Geoffrey Michael,2,0,32,30
1655995107598,MATH 109,B02,083216,Ganzberger; Geoffrey Michael,0,0,32,32
1655995107598,MATH 109,B03,093479,Staff,4,0,32,28
1655995113635,MATH 142A,A01,083219,Chow; Bennett,0,0,32,32
1655995113635,MATH 142A,A02,083220,Chow; Bennett,7,0,32,25
1655995113635,MATH 142A,A03,093480,Staff,4,0,32,28
1655995113635,MATH 142A,B03,093481,Staff,3,0,32,29
1655995113635,MATH 142A,B04,093558,Staff,6,0,32,26
1655995113635,MATH 142A,B05,093559,Staff,0,0,32,32
1655995119659,MATH 193A,A01,083224,Rotar; Vladimir,1,1,34,33
1655995119659,MATH 193A,A02,083225,Rotar; Vladimir,0,0,34,34
1655995119659,MATH 193A,A03,083781,Rotar; Vladimir,2,0,34,32
1655995119659,MATH 193A,A04,083782,Rotar; Vladimir,3,0,34,31
1655995119659,MATH 193A,A05,093482,Rotar; Vladimir,0,0,34,34
1655995125688,MATH 197,001,091859,McAuley; Julian John,9999,0,9999,0
1655995125688,MATH 197,002,095566,Kedlaya; Kiran S.,9997,0,9999,2
1655995125688,MATH 197,003,095567,Xiao; Ming,9999,0,9999,0
1655995125688,MATH 197,004,095571,Perols; Johan Lars,9998,0,9999,1
1655995132756,COGS 9,A01,083615,Shannon; Kyle Michael,3,1,75,72
1655995138785,COGS 11,A01,083617,Boyle; Mary E. T.,11,1,48,37
1655995144808,COGS 13,A01,083071,Bastos; Amalia Pinkusfeld,3,2,71,68
1655995150840,COGS 14A,A01,092681,Semenuks; Arturs,4,25,100,96
1655995156870,COGS 14B,A01,083073,Cheng; Tzu-Han,7,0,63,56
1655995162905,COGS 17,A01,092677,Semenuks; Arturs,8,7,81,73
1655995168934,COGS 100,A01,083619,Allen; Michael Gordon,2,2,70,68
1655995174968,COGS 101A,A01,083621,Davis; Joshua Daniel,4,3,68,64
1655995181019,COGS 101B,A01,091572,Allen; Michael Gordon,0,0,65,65
1655995187049,COGS 101C,A01,083625,Delgado; Tania,7,0,35,28
1655995193076,COGS 107A,A01,083627,Boyle; Mary E. T.,1,2,60,59
1655995199113,COGS 118A,A01,083075,Gupta; Anjum,21,16,76,55
1655995205159,CSE 3,A50,083646,Miranda; Gregory Joseph,14,0,50,36
1655995211184,CSE 8A,A50,083650,Miranda; Gregory Joseph,3,11,56,53
1655995217210,CSE 11,A01,083080,Cao; Yingjun,0,65,40,40
1655995223235,CSE 12,A01,083652,Krause-Levy; Sophia Louisa,6,8,120,114
1655995229269,CSE 15L,A01,083654,Morris; Justin Loren,3,1,50,47
1655995229269,CSE 15L,A02,083655,Morris; Justin Loren,1,1,50,49
1655995235313,CSE 20,A01,083657,Tran; Khoa Dang,29,0,80,51
1655995241354,CSE 21,A01,095574,Bach; Quang Tran,23,0,48,25
1655995247413,CSE 30,A01,083084,Eldon; John,2,10,80,78
1655995247413,CSE 30,B01,095061,Bhaskar; Nishant,0,4,50,50
1655995253446,CSE 100,A01,083659,Cao; Yingjun,2,25,70,68
1655995259486,CSE 134B,A01,083661,Powell; Thomas Allan,6,7,100,94
1655995265511,CSE 140,A01,083663,Gungor; Onat,5,0,85,80
1655995271537,CSE 140L,A01,083088,Eldon; John,5,0,100,95
1655995277574,CSE 175,A01,083665,Kumar; Rakesh,1,0,25,24
1655995283602,CSE 190,A00,092507,Dubnov; Shlomo,1,0,20,19
1655995289637,ECE 45,A01,083139,Congero; Spencer William,0,1,75,75
1655995295675,ECE 65,A50,083695,Saad; Andrew S,6,0,30,24
1655995295675,ECE 65,A51,095125,Staff,23,0,26,3
1655995301704,ECE 109,A01,091882,Touri; Behrouz,2,4,70,68
1655995307728,ECE 180,A00,083140,Abi Samra; Nicholas Camill,1,0,30,29
1655995307728,ECE 180,B00,083141,Abi Samra; Nicholas Camill,0,8,28,28
1655995313764,MATH 10A,A01,083735,Patchell; Gregory David,0,0,30,30
1655995313764,MATH 10A,A02,083736,Patchell; Gregory David,21,0,30,9
1655995313764,MATH 10A,A03,083737,Patchell; Gregory David,16,0,30,14
1655995319797,MATH 10B,A01,083207,Lim; Seonhee,1,1,34,33
1655995319797,MATH 10B,A02,083208,Lim; Seonhee,1,1,35,34
1655995319797,MATH 10B,A03,093472,Staff,1,0,34,33
1655995319797,MATH 10B,B01,083739,Sinha; Shubham,9,0,30,21
1655995325826,MATH 18,A01,083743,Cinel; Cameron Alexander,5,0,30,25
1655995325826,MATH 18,A02,083744,Cinel; Cameron Alexander,11,0,30,19
1655995325826,MATH 18,A03,083745,Cinel; Cameron Alexander,1,0,30,29
1655995325826,MATH 18,B01,083748,Ma; Zilu,2,0,36,34
1655995325826,MATH 18,B02,083749,Ma; Zilu,0,0,36,36
1655995325826,MATH 18,B03,083750,Ma; Zilu,0,0,36,36
1655995325826,MATH 18,B04,083751,Ma; Zilu,0,0,36,36
1655995325826,MATH 18,B05,093473,Staff,0,0,36,36
1655995325826,MATH 18,B06,093474,Staff,1,0,36,35
1655995331873,MATH 20A,A01,083754,Zheng; Zequn,10,0,40,30
1655995337902,MATH 20B,A01,083756,Briones; Jor-el Thomas Caparas,0,1,36,36
1655995337902,MATH 20B,A02,083757,Briones; Jor-el Thomas Caparas,1,0,36,35
1655995337902,MATH 20B,A03,093475,Staff,0,0,36,36
1655995343939,MATH 20C,A01,083760,Briones; Jor-el Thomas Caparas,0,2,35,35
1655995343939,MATH 20C,A02,083761,Briones; Jor-el Thomas Caparas,6,1,35,29
1655995343939,MATH 20C,A03,093476,Staff,0,0,35,35
1655995343939,MATH 20C,B01,083762,Bach; Quang Tran,3,0,30,27
1655995349981,MATH 20D,A01,083765,Tran; Brian Kha,1,0,30,29
1655995349981,MATH 20D,A02,083766,Tran; Brian Kha,0,1,30,30
1655995349981,MATH 20D,A03,083767,Tran; Brian Kha,1,0,30,29
1655995356009,MATH 20E,A01,083771,Ganguly; Soumya,0,1,32,32
1655995356009,MATH 20E,A02,083772,Ganguly; Soumya,1,1,32,31
1655995356009,MATH 20E,B01,083773,Ciotti; Benjamin,14,0,35,21
1655995356009,MATH 20E,B02,083774,Ciotti; Benjamin,12,0,35,23
1655995362042,MATH 103A,A01,083777,Greenfeld; Be'Eri,2,1,36,34
1655995362042,MATH 103A,A02,083778,Greenfeld; Be'Eri,2,0,36,34
1655995362042,MATH 103A,A03,093561,Staff,0,1,36,36
1655995362042,MATH 103A,B01,083779,Greenfeld; Be'Eri,7,1,36,29
1655995362042,MATH 103A,B02,083780,Greenfeld; Be'Eri,0,0,36,36
1655995362042,MATH 103A,B03,093562,Staff,0,0,36,36
1655995368076,MATH 105,A01,085443,Carter; Anne Toulson,4,1,35,31
1655995368076,MATH 105,A02,093477,Staff,8,0,35,27
1655995374123,MATH 109,A01,083213,Ganzberger; Geoffrey Michael,0,1,34,34
1655995374123,MATH 109,A02,083214,Ganzberger; Geoffrey Michael,0,0,34,34
1655995374123,MATH 109,A03,093478,Staff,1,0,34,33
1655995374123,MATH 109,B01,083215,Ganzberger; Geoffrey Michael,2,0,32,30
1655995374123,MATH 109,B02,083216,Ganzberger; Geoffrey Michael,0,0,32,32
1655995374123,MATH 109,B03,093479,Staff,4,0,32,28
1655995380149,MATH 142A,A01,083219,Chow; Bennett,0,0,32,32
1655995380149,MATH 142A,A02,083220,Chow; Bennett,7,0,32,25
1655995380149,MATH 142A,A03,093480,Staff,4,0,32,28
1655995380149,MATH 142A,B03,093481,Staff,3,0,32,29
1655995380149,MATH 142A,B04,093558,Staff,6,0,32,26
1655995380149,MATH 142A,B05,093559,Staff,0,0,32,32
1655995386189,MATH 193A,A01,083224,Rotar; Vladimir,1,1,34,33
1655995386189,MATH 193A,A02,083225,Rotar; Vladimir,0,0,34,34
1655995386189,MATH 193A,A03,083781,Rotar; Vladimir,2,0,34,32
1655995386189,MATH 193A,A04,083782,Rotar; Vladimir,3,0,34,31
1655995386189,MATH 193A,A05,093482,Rotar; Vladimir,0,0,34,34
1655995392214,MATH 197,001,091859,McAuley; Julian John,9999,0,9999,0
1655995392214,MATH 197,002,095566,Kedlaya; Kiran S.,9997,0,9999,2
1655995392214,MATH 197,003,095567,Xiao; Ming,9999,0,9999,0
1655995392214,MATH 197,004,095571,Perols; Johan Lars,9998,0,9999,1
1655995399276,COGS 9,A01,083615,Shannon; Kyle Michael,3,1,75,72
1655995405314,COGS 11,A01,083617,Boyle; Mary E. T.,11,1,48,37
1655995411339,COGS 13,A01,083071,Bastos; Amalia Pinkusfeld,3,2,71,68
1655995417369,COGS 14A,A01,092681,Semenuks; Arturs,4,25,100,96
1655995423411,COGS 14B,A01,083073,Cheng; Tzu-Han,7,0,63,56
1655995429449,COGS 17,A01,092677,Semenuks; Arturs,8,7,81,73
1655995435492,COGS 100,A01,083619,Allen; Michael Gordon,2,2,70,68
1655995441530,COGS 101A,A01,083621,Davis; Joshua Daniel,4,3,68,64
1655995447552,COGS 101B,A01,091572,Allen; Michael Gordon,0,0,65,65
1655995453577,COGS 101C,A01,083625,Delgado; Tania,7,0,35,28
1655995459608,COGS 107A,A01,083627,Boyle; Mary E. T.,1,2,60,59
1655995465637,COGS 118A,A01,083075,Gupta; Anjum,21,16,76,55
1655995471678,CSE 3,A50,083646,Miranda; Gregory Joseph,14,0,50,36
1655995477708,CSE 8A,A50,083650,Miranda; Gregory Joseph,3,11,56,53
1655995483748,CSE 11,A01,083080,Cao; Yingjun,0,65,40,40
1655995489776,CSE 12,A01,083652,Krause-Levy; Sophia Louisa,6,8,120,114
1655995495801,CSE 15L,A01,083654,Morris; Justin Loren,3,1,50,47
1655995495801,CSE 15L,A02,083655,Morris; Justin Loren,1,1,50,49
1655995501826,CSE 20,A01,083657,Tran; Khoa Dang,29,0,80,51
1655995507851,CSE 21,A01,095574,Bach; Quang Tran,23,0,48,25
1655995513899,CSE 30,A01,083084,Eldon; John,2,10,80,78
1655995513899,CSE 30,B01,095061,Bhaskar; Nishant,0,4,50,50
1655995519931,CSE 100,A01,083659,Cao; Yingjun,2,25,70,68
1655995525959,CSE 134B,A01,083661,Powell; Thomas Allan,6,7,100,94
1655995531990,CSE 140,A01,083663,Gungor; Onat,5,0,85,80
1655995538020,CSE 140L,A01,083088,Eldon; John,5,0,100,95
1655995544057,CSE 175,A01,083665,Kumar; Rakesh,1,0,25,24
1655995550081,CSE 190,A00,092507,Dubnov; Shlomo,1,0,20,19
1655995556109,ECE 45,A01,083139,Congero; Spencer William,0,1,75,75
1655995562136,ECE 65,A50,083695,Saad; Andrew S,6,0,30,24
1655995562136,ECE 65,A51,095125,Staff,23,0,26,3
1655995568166,ECE 109,A01,091882,Touri; Behrouz,2,4,70,68
1655995574192,ECE 180,A00,083140,Abi Samra; Nicholas Camill,1,0,30,29
1655995574192,ECE 180,B00,083141,Abi Samra; Nicholas Camill,0,8,28,28
1655995580225,MATH 10A,A01,083735,Patchell; Gregory David,0,0,30,30
1655995580225,MATH 10A,A02,083736,Patchell; Gregory David,21,0,30,9
1655995580225,MATH 10A,A03,083737,Patchell; Gregory David,16,0,30,14
1655995586262,MATH 10B,A01,083207,Lim; Seonhee,1,1,34,33
1655995586262,MATH 10B,A02,083208,Lim; Seonhee,1,1,35,34
1655995586262,MATH 10B,A03,093472,Staff,1,0,34,33
1655995586262,MATH 10B,B01,083739,Sinha; Shubham,9,0,30,21
1655995592295,MATH 18,A01,083743,Cinel; Cameron Alexander,5,0,30,25
1655995592295,MATH 18,A02,083744,Cinel; Cameron Alexander,11,0,30,19
1655995592295,MATH 18,A03,083745,Cinel; Cameron Alexander,1,0,30,29
1655995592295,MATH 18,B01,083748,Ma; Zilu,2,0,36,34
1655995592295,MATH 18,B02,083749,Ma; Zilu,0,0,36,36
1655995592295,MATH 18,B03,083750,Ma; Zilu,0,0,36,36
1655995592295,MATH 18,B04,083751,Ma; Zilu,0,0,36,36
1655995592295,MATH 18,B05,093473,Staff,0,0,36,36
1655995592295,MATH 18,B06,093474,Staff,1,0,36,35
1655995598344,MATH 20A,A01,083754,Zheng; Zequn,10,0,40,30
1655995604372,MATH 20B,A01,083756,Briones; Jor-el Thomas Caparas,0,1,36,36
1655995604372,MATH 20B,A02,083757,Briones; Jor-el Thomas Caparas,1,0,36,35
1655995604372,MATH 20B,A03,093475,Staff,0,0,36,36
1655995610402,MATH 20C,A01,083760,Briones; Jor-el Thomas Caparas,0,2,35,35
1655995610402,MATH 20C,A02,083761,Briones; Jor-el Thomas Caparas,6,1,35,29
1655995610402,MATH 20C,A03,093476,Staff,0,0,35,35
1655995610402,MATH 20C,B01,083762,Bach; Quang Tran,3,0,30,27
1655995616546,MATH 20D,A01,083765,Tran; Brian Kha,1,0,30,29
1655995616546,MATH 20D,A02,083766,Tran; Brian Kha,0,1,30,30
1655995616546,MATH 20D,A03,083767,Tran; Brian Kha,1,0,30,29
1655995622590,MATH 20E,A01,083771,Ganguly; Soumya,0,1,32,32
1655995622590,MATH 20E,A02,083772,Ganguly; Soumya,1,1,32,31
1655995622590,MATH 20E,B01,083773,Ciotti; Benjamin,14,0,35,21
1655995622590,MATH 20E,B02,083774,Ciotti; Benjamin,12,0,35,23
1655995628615,MATH 103A,A01,083777,Greenfeld; Be'Eri,2,1,36,34
1655995628615,MATH 103A,A02,083778,Greenfeld; Be'Eri,2,0,36,34
1655995628615,MATH 103A,A03,093561,Staff,0,1,36,36
1655995628615,MATH 103A,B01,083779,Greenfeld; Be'Eri,7,1,36,29
1655995628615,MATH 103A,B02,083780,Greenfeld; Be'Eri,0,0,36,36
1655995628615,MATH 103A,B03,093562,Staff,0,0,36,36
1655995634649,MATH 105,A01,085443,Carter; Anne Toulson,4,1,35,31
1655995634649,MATH 105,A02,093477,Staff,8,0,35,27
1655995640674,MATH 109,A01,083213,Ganzberger; Geoffrey Michael,0,1,34,34
1655995640674,MATH 109,A02,083214,Ganzberger; Geoffrey Michael,0,0,34,34
1655995640674,MATH 109,A03,093478,Staff,1,0,34,33
1655995640674,MATH 109,B01,083215,Ganzberger; Geoffrey Michael,2,0,32,30
1655995640674,MATH 109,B02,083216,Ganzberger; Geoffrey Michael,0,0,32,32
1655995640674,MATH 109,B03,093479,Staff,4,0,32,28
1655995646712,MATH 142A,A01,083219,Chow; Bennett,0,0,32,32
1655995646712,MATH 142A,A02,083220,Chow; Bennett,7,0,32,25
1655995646712,MATH 142A,A03,093480,Staff,4,0,32,28
1655995646712,MATH 142A,B03,093481,Staff,3,0,32,29
1655995646712,MATH 142A,B04,093558,Staff,6,0,32,26
1655995646712,MATH 142A,B05,093559,Staff,0,0,32,32
1655995652739,MATH 193A,A01,083224,Rotar; Vladimir,1,1,34,33
1655995652739,MATH 193A,A02,083225,Rotar; Vladimir,0,0,34,34
1655995652739,MATH 193A,A03,083781,Rotar; Vladimir,2,0,34,32
1655995652739,MATH 193A,A04,083782,Rotar; Vladimir,3,0,34,31
1655995652739,MATH 193A,A05,093482,Rotar; Vladimir,0,0,34,34
1655995658764,MATH 197,001,091859,McAuley; Julian John,9999,0,9999,0
1655995658764,MATH 197,002,095566,Kedlaya; Kiran S.,9997,0,9999,2
1655995658764,MATH 197,003,095567,Xiao; Ming,9999,0,9999,0
1655995658764,MATH 197,004,095571,Perols; Johan Lars,9998,0,9999,1
1655995665847,COGS 9,A01,083615,Shannon; Kyle Michael,3,1,75,72
1655995671876,COGS 11,A01,083617,Boyle; Mary E. T.,11,1,48,37
1655995677918,COGS 13,A01,083071,Bastos; Amalia Pinkusfeld,3,2,71,68
1655995683948,COGS 14A,A01,092681,Semenuks; Arturs,4,25,100,96
1655995689974,COGS 14B,A01,083073,Cheng; Tzu-Han,7,0,63,56
1655995696004,COGS 17,A01,092677,Semenuks; Arturs,8,7,81,73
1655995702029,COGS 100,A01,083619,Allen; Michael Gordon,2,2,70,68
1655995708053,COGS 101A,A01,083621,Davis; Joshua Daniel,4,3,68,64
1655995714085,COGS 101B,A01,091572,Allen; Michael Gordon,0,0,65,65
1655995720123,COGS 101C,A01,083625,Delgado; Tania,7,0,35,28
1655995726147,COGS 107A,A01,083627,Boyle; Mary E. T.,1,2,60,59
1655995732180,COGS 118A,A01,083075,Gupta; Anjum,21,16,76,55
1655995738207,CSE 3,A50,083646,Miranda; Gregory Joseph,14,0,50,36
1655995744238,CSE 8A,A50,083650,Miranda; Gregory Joseph,3,11,56,53
1655995750266,CSE 11,A01,083080,Cao; Yingjun,0,65,40,40
1655995756291,CSE 12,A01,083652,Krause-Levy; Sophia Louisa,6,8,120,114
1655995762322,CSE 15L,A01,083654,Morris; Justin Loren,3,1,50,47
1655995762322,CSE 15L,A02,083655,Morris; Justin Loren,1,1,50,49
1655995768347,CSE 20,A01,083657,Tran; Khoa Dang,29,0,80,51
1655995774384,CSE 21,A01,095574,Bach; Quang Tran,23,0,48,25
1655995780418,CSE 30,A01,083084,Eldon; John,2,10,80,78
1655995780418,CSE 30,B01,095061,Bhaskar; Nishant,0,4,50,50
1655995786447,CSE 100,A01,083659,Cao; Yingjun,2,25,70,68
1655995792472,CSE 134B,A01,083661,Powell; Thomas Allan,6,7,100,94
1655995798500,CSE 140,A01,083663,Gungor; Onat,5,0,85,80
1655995804526,CSE 140L,A01,083088,Eldon; John,5,0,100,95
1655995810561,CSE 175,A01,083665,Kumar; Rakesh,1,0,25,24
1655995816600,CSE 190,A00,092507,Dubnov; Shlomo,1,0,20,19
1655995822634,ECE 45,A01,083139,Congero; Spencer William,0,1,75,75
1655995828674,ECE 65,A50,083695,Saad; Andrew S,6,0,30,24
1655995828674,ECE 65,A51,095125,Staff,23,0,26,3
1655995834701,ECE 109,A01,091882,Touri; Behrouz,2,4,70,68
1655995840729,ECE 180,A00,083140,Abi Samra; Nicholas Camill,1,0,30,29
1655995840729,ECE 180,B00,083141,Abi Samra; Nicholas Camill,0,8,28,28
1655995846767,MATH 10A,A01,083735,Patchell; Gregory David,0,0,30,30
1655995846767,MATH 10A,A02,083736,Patchell; Gregory David,21,0,30,9
1655995846767,MATH 10A,A03,083737,Patchell; Gregory David,16,0,30,14
1655995852794,MATH 10B,A01,083207,Lim; Seonhee,1,1,34,33
1655995852794,MATH 10B,A02,083208,Lim; Seonhee,1,1,35,34
1655995852794,MATH 10B,A03,093472,Staff,1,0,34,33
1655995852794,MATH 10B,B01,083739,Sinha; Shubham,9,0,30,21
1655995858822,MATH 18,A01,083743,Cinel; Cameron Alexander,5,0,30,25
1655995858822,MATH 18,A02,083744,Cinel; Cameron Alexander,11,0,30,19
1655995858822,MATH 18,A03,083745,Cinel; Cameron Alexander,1,0,30,29
1655995858822,MATH 18,B01,083748,Ma; Zilu,2,0,36,34
1655995858822,MATH 18,B02,083749,Ma; Zilu,0,0,36,36
1655995858822,MATH 18,B03,083750,Ma; Zilu,0,0,36,36
1655995858822,MATH 18,B04,083751,Ma; Zilu,0,0,36,36
1655995858822,MATH 18,B05,093473,Staff,0,0,36,36
1655995858822,MATH 18,B06,093474,Staff,1,0,36,35
1655995864852,MATH 20A,A01,083754,Zheng; Zequn,10,0,40,30
1655995870880,MATH 20B,A01,083756,Briones; Jor-el Thomas Caparas,0,1,36,36
1655995870880,MATH 20B,A02,083757,Briones; Jor-el Thomas Caparas,1,0,36,35
1655995870880,MATH 20B,A03,093475,Staff,0,0,36,36
1655995876910,MATH 20C,A01,083760,Briones; Jor-el Thomas Caparas,0,2,35,35
1655995876910,MATH 20C,A02,083761,Briones; Jor-el Thomas Caparas,6,1,35,29
1655995876910,MATH 20C,A03,093476,Staff,0,0,35,35
1655995876910,MATH 20C,B01,083762,Bach; Quang Tran,3,0,30,27
1655995882952,MATH 20D,A01,083765,Tran; Brian Kha,1,0,30,29
1655995882952,MATH 20D,A02,083766,Tran; Brian Kha,0,1,30,30
1655995882952,MATH 20D,A03,083767,Tran; Brian Kha,1,0,30,29
1655995888979,MATH 20E,A01,083771,Ganguly; Soumya,0,1,32,32
1655995888979,MATH 20E,A02,083772,Ganguly; Soumya,1,1,32,31
1655995888979,MATH 20E,B01,083773,Ciotti; Benjamin,14,0,35,21
1655995888979,MATH 20E,B02,083774,Ciotti; Benjamin,12,0,35,23
1655995895010,MATH 103A,A01,083777,Greenfeld; Be'Eri,2,1,36,34
1655995895010,MATH 103A,A02,083778,Greenfeld; Be'Eri,2,0,36,34
1655995895010,MATH 103A,A03,093561,Staff,0,1,36,36
1655995895010,MATH 103A,B01,083779,Greenfeld; Be'Eri,7,1,36,29
1655995895010,MATH 103A,B02,083780,Greenfeld; Be'Eri,0,0,36,36
1655995895010,MATH 103A,B03,093562,Staff,0,0,36,36
1655995901050,MATH 105,A01,085443,Carter; Anne Toulson,4,1,35,31
1655995901050,MATH 105,A02,093477,Staff,8,0,35,27
1655995907080,MATH 109,A01,083213,Ganzberger; Geoffrey Michael,0,1,34,34
1655995907080,MATH 109,A02,083214,Ganzberger; Geoffrey Michael,0,0,34,34
1655995907080,MATH 109,A03,093478,Staff,1,0,34,33
1655995907080,MATH 109,B01,083215,Ganzberger; Geoffrey Michael,2,0,32,30
1655995907080,MATH 109,B02,083216,Ganzberger; Geoffrey Michael,0,0,32,32
1655995907080,MATH 109,B03,093479,Staff,4,0,32,28
1655995913111,MATH 142A,A01,083219,Chow; Bennett,0,0,32,32
1655995913111,MATH 142A,A02,083220,Chow; Bennett,7,0,32,25
1655995913111,MATH 142A,A03,093480,Staff,4,0,32,28
1655995913111,MATH 142A,B03,093481,Staff,3,0,32,29
1655995913111,MATH 142A,B04,093558,Staff,6,0,32,26
1655995913111,MATH 142A,B05,093559,Staff,0,0,32,32
1655995919137,MATH 193A,A01,083224,Rotar; Vladimir,1,1,34,33
1655995919137,MATH 193A,A02,083225,Rotar; Vladimir,0,0,34,34
1655995919137,MATH 193A,A03,083781,Rotar; Vladimir,2,0,34,32
1655995919137,MATH 193A,A04,083782,Rotar; Vladimir,3,0,34,31
1655995919137,MATH 193A,A05,093482,Rotar; Vladimir,0,0,34,34
1655995925165,MATH 197,001,091859,McAuley; Julian John,9999,0,9999,0
1655995925165,MATH 197,002,095566,Kedlaya; Kiran S.,9997,0,9999,2
1655995925165,MATH 197,003,095567,Xiao; Ming,9999,0,9999,0
1655995925165,MATH 197,004,095571,Perols; Johan Lars,9998,0,9999,1
1655995932242,COGS 9,A01,083615,Shannon; Kyle Michael,3,1,75,72
1655995938274,COGS 11,A01,083617,Boyle; Mary E. T.,11,1,48,37
1655995944308,COGS 13,A01,083071,Bastos; Amalia Pinkusfeld,3,2,71,68
1655995950332,COGS 14A,A01,092681,Semenuks; Arturs,4,25,100,96
1655995956364,COGS 14B,A01,083073,Cheng; Tzu-Han,7,0,63,56
1655995962392,COGS 17,A01,092677,Semenuks; Arturs,8,7,81,73
1655995968422,COGS 100,A01,083619,Allen; Michael Gordon,2,2,70,68
1655995974450,COGS 101A,A01,083621,Davis; Joshua Daniel,4,3,68,64
1655995980486,COGS 101B,A01,091572,Allen; Michael Gordon,0,0,65,65
1655995986523,COGS 101C,A01,083625,Delgado; Tania,7,0,35,28
1655995992549,COGS 107A,A01,083627,Boyle; Mary E. T.,1,2,60,59
1655995998572,COGS 118A,A01,083075,Gupta; Anjum,21,16,76,55
1655996004599,CSE 3,A50,083646,Miranda; Gregory Joseph,14,0,50,36
1655996010631,CSE 8A,A50,083650,Miranda; Gregory Joseph,3,11,56,53
1655996016672,CSE 11,A01,083080,Cao; Yingjun,0,65,40,40
1655996022710,CSE 12,A01,083652,Krause-Levy; Sophia Louisa,6,8,120,114
1655996028744,CSE 15L,A01,083654,Morris; Justin Loren,3,1,50,47
1655996028744,CSE 15L,A02,083655,Morris; Justin Loren,1,1,50,49
1655996034780,CSE 20,A01,083657,Tran; Khoa Dang,29,0,80,51
1655996040815,CSE 21,A01,095574,Bach; Quang Tran,23,0,48,25
1655996046844,CSE 30,A01,083084,Eldon; John,2,10,80,78
1655996046844,CSE 30,B01,095061,Bhaskar; Nishant,0,4,50,50
1655996052869,CSE 100,A01,083659,Cao; Yingjun,2,25,70,68
1655996058911,CSE 134B,A01,083661,Powell; Thomas Allan,6,7,100,94
1655996064936,CSE 140,A01,083663,Gungor; Onat,5,0,85,80
1655996070970,CSE 140L,A01,083088,Eldon; John,5,0,100,95
1655996076994,CSE 175,A01,083665,Kumar; Rakesh,1,0,25,24
1655996083020,CSE 190,A00,092507,Dubnov; Shlomo,1,0,20,19
1655996089047,ECE 45,A01,083139,Congero; Spencer William,0,1,75,75
1655996095072,ECE 65,A50,083695,Saad; Andrew S,6,0,30,24
1655996095072,ECE 65,A51,095125,Staff,23,0,26,3
1655996101105,ECE 109,A01,091882,Touri; Behrouz,2,4,70,68
1655996107139,ECE 180,A00,083140,Abi Samra; Nicholas Camill,1,0,30,29
1655996107139,ECE 180,B00,083141,Abi Samra; Nicholas Camill,0,8,28,28
1655996113180,MATH 10A,A01,083735,Patchell; Gregory David,0,0,30,30
1655996113180,MATH 10A,A02,083736,Patchell; Gregory David,21,0,30,9
1655996113180,MATH 10A,A03,083737,Patchell; Gregory David,16,0,30,14
1655996119225,MATH 10B,A01,083207,Lim; Seonhee,1,1,34,33
1655996119225,MATH 10B,A02,083208,Lim; Seonhee,1,1,35,34
1655996119225,MATH 10B,A03,093472,Staff,1,0,34,33
1655996119225,MATH 10B,B01,083739,Sinha; Shubham,9,0,30,21
1655996125252,MATH 18,A01,083743,Cinel; Cameron Alexander,5,0,30,25
1655996125252,MATH 18,A02,083744,Cinel; Cameron Alexander,11,0,30,19
1655996125252,MATH 18,A03,083745,Cinel; Cameron Alexander,1,0,30,29
1655996125252,MATH 18,B01,083748,Ma; Zilu,2,0,36,34
1655996125252,MATH 18,B02,083749,Ma; Zilu,0,0,36,36
1655996125252,MATH 18,B03,083750,Ma; Zilu,0,0,36,36
1655996125252,MATH 18,B04,083751,Ma; Zilu,0,0,36,36
1655996125252,MATH 18,B05,093473,Staff,0,0,36,36
1655996125252,MATH 18,B06,093474,Staff,1,0,36,35
1655996131295,MATH 20A,A01,083754,Zheng; Zequn,10,0,40,30
1655996137325,MATH 20B,A01,083756,Briones; Jor-el Thomas Caparas,0,1,36,36
1655996137325,MATH 20B,A02,083757,Briones; Jor-el Thomas Caparas,1,0,36,35
1655996137325,MATH 20B,A03,093475,Staff,0,0,36,36
1655996143357,MATH 20C,A01,083760,Briones; Jor-el Thomas Caparas,0,2,35,35
1655996143357,MATH 20C,A02,083761,Briones; Jor-el Thomas Caparas,6,1,35,29
1655996143357,MATH 20C,A03,093476,Staff,0,0,35,35
1655996143357,MATH 20C,B01,083762,Bach; Quang Tran,3,0,30,27
1655996149382,MATH 20D,A01,083765,Tran; Brian Kha,1,0,30,29
1655996149382,MATH 20D,A02,083766,Tran; Brian Kha,0,1,30,30
1655996149382,MATH 20D,A03,083767,Tran; Brian Kha,1,0,30,29
1655996155421,MATH 20E,A01,083771,Ganguly; Soumya,0,1,32,32
1655996155421,MATH 20E,A02,083772,Ganguly; Soumya,1,1,32,31
1655996155421,MATH 20E,B01,083773,Ciotti; Benjamin,14,0,35,21
1655996155421,MATH 20E,B02,083774,Ciotti; Benjamin,12,0,35,23
1655996161451,MATH 103A,A01,083777,Greenfeld; Be'Eri,2,1,36,34
1655996161451,MATH 103A,A02,083778,Greenfeld; Be'Eri,2,0,36,34
1655996161451,MATH 103A,A03,093561,Staff,0,1,36,36
1655996161451,MATH 103A,B01,083779,Greenfeld; Be'Eri,7,1,36,29
1655996161451,MATH 103A,B02,083780,Greenfeld; Be'Eri,0,0,36,36
1655996161451,MATH 103A,B03,093562,Staff,0,0,36,36
1655996167491,MATH 105,A01,085443,Carter; Anne Toulson,4,1,35,31
1655996167491,MATH 105,A02,093477,Staff,8,0,35,27
1655996173515,MATH 109,A01,083213,Ganzberger; Geoffrey Michael,0,1,34,34
1655996173515,MATH 109,A02,083214,Ganzberger; Geoffrey Michael,0,0,34,34
1655996173515,MATH 109,A03,093478,Staff,1,0,34,33
1655996173515,MATH 109,B01,083215,Ganzberger; Geoffrey Michael,2,0,32,30
1655996173515,MATH 109,B02,083216,Ganzberger; Geoffrey Michael,0,0,32,32
1655996173515,MATH 109,B03,093479,Staff,4,0,32,28
1655996179546,MATH 142A,A01,083219,Chow; Bennett,0,0,32,32
1655996179546,MATH 142A,A02,083220,Chow; Bennett,7,0,32,25
1655996179546,MATH 142A,A03,093480,Staff,4,0,32,28
1655996179546,MATH 142A,B03,093481,Staff,3,0,32,29
1655996179546,MATH 142A,B04,093558,Staff,6,0,32,26
1655996179546,MATH 142A,B05,093559,Staff,0,0,32,32
1655996185587,MATH 193A,A01,083224,Rotar; Vladimir,1,1,34,33
1655996185587,MATH 193A,A02,083225,Rotar; Vladimir,0,0,34,34
1655996185587,MATH 193A,A03,083781,Rotar; Vladimir,2,0,34,32
1655996185587,MATH 193A,A04,083782,Rotar; Vladimir,3,0,34,31
1655996185587,MATH 193A,A05,093482,Rotar; Vladimir,0,0,34,34
1655996191614,MATH 197,001,091859,McAuley; Julian John,9999,0,9999,0
1655996191614,MATH 197,002,095566,Kedlaya; Kiran S.,9997,0,9999,2
1655996191614,MATH 197,003,095567,Xiao; Ming,9999,0,9999,0
1655996191614,MATH 197,004,095571,Perols; Johan Lars,9998,0,9999,1
1655996198683,COGS 9,A01,083615,Shannon; Kyle Michael,3,1,75,72
1655996204708,COGS 11,A01,083617,Boyle; Mary E. T.,11,1,48,37
1655996210826,COGS 13,A01,083071,Bastos; Amalia Pinkusfeld,3,2,71,68
1655996216853,COGS 14A,A01,092681,Semenuks; Arturs,4,25,100,96
1655996222890,COGS 14B,A01,083073,Cheng; Tzu-Han,7,0,63,56
1655996228929,COGS 17,A01,092677,Semenuks; Arturs,8,7,81,73
1655996234958,COGS 100,A01,083619,Allen; Michael Gordon,2,2,70,68
1655996241001,COGS 101A,A01,083621,Davis; Joshua Daniel,4,3,68,64
1655996247029,COGS 101B,A01,091572,Allen; Michael Gordon,0,0,65,65
1655996253053,COGS 101C,A01,083625,Delgado; Tania,7,0,35,28
1655996259086,COGS 107A,A01,083627,Boyle; Mary E. T.,1,2,60,59
1655996265113,COGS 118A,A01,083075,Gupta; Anjum,21,16,76,55
1655996271138,CSE 3,A50,083646,Miranda; Gregory Joseph,14,0,50,36
1655996277170,CSE 8A,A50,083650,Miranda; Gregory Joseph,3,11,56,53
1655996283207,CSE 11,A01,083080,Cao; Yingjun,0,65,40,40
1655996289239,CSE 12,A01,083652,Krause-Levy; Sophia Louisa,6,8,120,114
1655996295264,CSE 15L,A01,083654,Morris; Justin Loren,3,1,50,47
1655996295264,CSE 15L,A02,083655,Morris; Justin Loren,1,1,50,49
1655996301302,CSE 20,A01,083657,Tran; Khoa Dang,29,0,80,51
1655996307326,CSE 21,A01,095574,Bach; Quang Tran,23,0,48,25
1655996313357,CSE 30,A01,083084,Eldon; John,2,10,80,78
1655996313357,CSE 30,B01,095061,Bhaskar; Nishant,0,4,50,50
1655996319389,CSE 100,A01,083659,Cao; Yingjun,2,25,70,68
1655996325428,CSE 134B,A01,083661,Powell; Thomas Allan,6,7,100,94
1655996331471,CSE 140,A01,083663,Gungor; Onat,5,0,85,80
1655996337495,CSE 140L,A01,083088,Eldon; John,5,0,100,95
1655996343535,CSE 175,A01,083665,Kumar; Rakesh,1,0,25,24
1655996349564,CSE 190,A00,092507,Dubnov; Shlomo,1,0,20,19
1655996355602,ECE 45,A01,083139,Congero; Spencer William,0,1,75,75
1655996361635,ECE 65,A50,083695,Saad; Andrew S,6,0,30,24
1655996361635,ECE 65,A51,095125,Staff,23,0,26,3
1655996367665,ECE 109,A01,091882,Touri; Behrouz,2,4,70,68
1655996373689,ECE 180,A00,083140,Abi Samra; Nicholas Camill,1,0,30,29
1655996373689,ECE 180,B00,083141,Abi Samra; Nicholas Camill,0,8,28,28
1655996379716,MATH 10A,A01,083735,Patchell; Gregory David,0,0,30,30
1655996379716,MATH 10A,A02,083736,Patchell; Gregory David,21,0,30,9
1655996379716,MATH 10A,A03,083737,Patchell; Gregory David,16,0,30,14
1655996385752,MATH 10B,A01,083207,Lim; Seonhee,1,1,34,33
1655996385752,MATH 10B,A02,083208,Lim; Seonhee,1,1,35,34
1655996385752,MATH 10B,A03,093472,Staff,1,0,34,33
1655996385752,MATH 10B,B01,083739,Sinha; Shubham,9,0,30,21
1655996391778,MATH 18,A01,083743,Cinel; Cameron Alexander,5,0,30,25
1655996391778,MATH 18,A02,083744,Cinel; Cameron Alexander,11,0,30,19
1655996391778,MATH 18,A03,083745,Cinel; Cameron Alexander,1,0,30,29
1655996391778,MATH 18,B01,083748,Ma; Zilu,2,0,36,34
1655996391778,MATH 18,B02,083749,Ma; Zilu,0,0,36,36
1655996391778,MATH 18,B03,083750,Ma; Zilu,0,0,36,36
1655996391778,MATH 18,B04,083751,Ma; Zilu,0,0,36,36
1655996391778,MATH 18,B05,093473,Staff,0,0,36,36
1655996391778,MATH 18,B06,093474,Staff,1,0,36,35
1655996397806,MATH 20A,A01,083754,Zheng; Zequn,10,0,40,30
1655996403849,MATH 20B,A01,083756,Briones; Jor-el Thomas Caparas,0,1,36,36
1655996403849,MATH 20B,A02,083757,Briones; Jor-el Thomas Caparas,1,0,36,35
1655996403849,MATH 20B,A03,093475,Staff,0,0,36,36
1655996409887,MATH 20C,A01,083760,Briones; Jor-el Thomas Caparas,0,2,35,35
1655996409887,MATH 20C,A02,083761,Briones; Jor-el Thomas Caparas,6,1,35,29
1655996409887,MATH 20C,A03,093476,Staff,0,0,35,35
1655996409887,MATH 20C,B01,083762,Bach; Quang Tran,3,0,30,27
1655996415912,MATH 20D,A01,083765,Tran; Brian Kha,1,0,30,29
1655996415912,MATH 20D,A02,083766,Tran; Brian Kha,0,1,30,30
1655996415912,MATH 20D,A03,083767,Tran; Brian Kha,1,0,30,29
1655996421947,MATH 20E,A01,083771,Ganguly; Soumya,0,1,32,32
1655996421947,MATH 20E,A02,083772,Ganguly; Soumya,1,1,32,31
1655996421947,MATH 20E,B01,083773,Ciotti; Benjamin,14,0,35,21
1655996421947,MATH 20E,B02,083774,Ciotti; Benjamin,12,0,35,23
1655996427978,MATH 103A,A01,083777,Greenfeld; Be'Eri,2,1,36,34
1655996427978,MATH 103A,A02,083778,Greenfeld; Be'Eri,2,0,36,34
1655996427978,MATH 103A,A03,093561,Staff,0,1,36,36
1655996427978,MATH 103A,B01,083779,Greenfeld; Be'Eri,7,1,36,29
1655996427978,MATH 103A,B02,083780,Greenfeld; Be'Eri,0,0,36,36
1655996427978,MATH 103A,B03,093562,Staff,0,0,36,36
1655996434005,MATH 105,A01,085443,Carter; Anne Toulson,4,1,35,31
1655996434005,MATH 105,A02,093477,Staff,8,0,35,27
1655996440030,MATH 109,A01,083213,Ganzberger; Geoffrey Michael,0,1,34,34
1655996440030,MATH 109,A02,083214,Ganzberger; Geoffrey Michael,0,0,34,34
1655996440030,MATH 109,A03,093478,Staff,1,0,34,33
1655996440030,MATH 109,B01,083215,Ganzberger; Geoffrey Michael,2,0,32,30
1655996440030,MATH 109,B02,083216,Ganzberger; Geoffrey Michael,0,0,32,32
1655996440030,MATH 109,B03,093479,Staff,4,0,32,28
1655996446062,MATH 142A,A01,083219,Chow; Bennett,0,0,32,32
1655996446062,MATH 142A,A02,083220,Chow; Bennett,7,0,32,25
1655996446062,MATH 142A,A03,093480,Staff,4,0,32,28
1655996446062,MATH 142A,B03,093481,Staff,3,0,32,29
1655996446062,MATH 142A,B04,093558,Staff,6,0,32,26
1655996446062,MATH 142A,B05,093559,Staff,0,0,32,32
1655996452093,MATH 193A,A01,083224,Rotar; Vladimir,1,1,34,33
1655996452093,MATH 193A,A02,083225,Rotar; Vladimir,0,0,34,34
1655996452093,MATH 193A,A03,083781,Rotar; Vladimir,2,0,34,32
1655996452093,MATH 193A,A04,083782,Rotar; Vladimir,3,0,34,31
1655996452093,MATH 193A,A05,093482,Rotar; Vladimir,0,0,34,34
1655996458124,MATH 197,001,091859,McAuley; Julian John,9999,0,9999,0
1655996458124,MATH 197,002,095566,Kedlaya; Kiran S.,9997,0,9999,2
1655996458124,MATH 197,003,095567,Xiao; Ming,9999,0,9999,0
1655996458124,MATH 197,004,095571,Perols; Johan Lars,9998,0,9999,1
1655996465204,COGS 9,A01,083615,Shannon; Kyle Michael,3,1,75,72
1655996471238,COGS 11,A01,083617,Boyle; Mary E. T.,11,1,48,37
1655996477265,COGS 13,A01,083071,Bastos; Amalia Pinkusfeld,3,2,71,68
1655996483305,COGS 14A,A01,092681,Semenuks; Arturs,4,25,100,96
1655996489335,COGS 14B,A01,083073,Cheng; Tzu-Han,7,0,63,56
1655996495371,COGS 17,A01,092677,Semenuks; Arturs,8,7,81,73
1655996501396,COGS 100,A01,083619,Allen; Michael Gordon,2,2,70,68
1655996507422,COGS 101A,A01,083621,Davis; Joshua Daniel,4,3,68,64
1655996513446,COGS 101B,A01,091572,Allen; Michael Gordon,0,0,65,65
1655996519475,COGS 101C,A01,083625,Delgado; Tania,7,0,35,28
1655996525500,COGS 107A,A01,083627,Boyle; Mary E. T.,1,2,60,59
1655996531544,COGS 118A,A01,083075,Gupta; Anjum,21,16,76,55
1655996537587,CSE 3,A50,083646,Miranda; Gregory Joseph,14,0,50,36
1655996543613,CSE 8A,A50,083650,Miranda; Gregory Joseph,3,11,56,53
1655996549637,CSE 11,A01,083080,Cao; Yingjun,0,65,40,40
1655996555662,CSE 12,A01,083652,Krause-Levy; Sophia Louisa,6,8,120,114
1655996561689,CSE 15L,A01,083654,Morris; Justin Loren,3,1,50,47
1655996561689,CSE 15L,A02,083655,Morris; Justin Loren,1,1,50,49
1655996567734,CSE 20,A01,083657,Tran; Khoa Dang,29,0,80,51
1655996573759,CSE 21,A01,095574,Bach; Quang Tran,23,0,48,25
1655996579795,CSE 30,A01,083084,Eldon; John,2,10,80,78
1655996579795,CSE 30,B01,095061,Bhaskar; Nishant,0,4,50,50
1655996585822,CSE 100,A01,083659,Cao; Yingjun,2,25,70,68
1655996591848,CSE 134B,A01,083661,Powell; Thomas Allan,6,7,100,94
1655996597887,CSE 140,A01,083663,Gungor; Onat,5,0,85,80
1655996603922,CSE 140L,A01,083088,Eldon; John,5,0,100,95
1655996609952,CSE 175,A01,083665,Kumar; Rakesh,1,0,25,24
1655996615979,CSE 190,A00,092507,Dubnov; Shlomo,1,0,20,19
1655996622004,ECE 45,A01,083139,Congero; Spencer William,0,1,75,75
1655996628035,ECE 65,A50,083695,Saad; Andrew S,6,0,30,24
1655996628035,ECE 65,A51,095125,Staff,23,0,26,3
1655996634078,ECE 109,A01,091882,Touri; Behrouz,2,4,70,68
1655996640102,ECE 180,A00,083140,Abi Samra; Nicholas Camill,1,0,30,29
1655996640102,ECE 180,B00,083141,Abi Samra; Nicholas Camill,0,8,28,28
1655996646128,MATH 10A,A01,083735,Patchell; Gregory David,0,0,30,30
1655996646128,MATH 10A,A02,083736,Patchell; Gregory David,21,0,30,9
1655996646128,MATH 10A,A03,083737,Patchell; Gregory David,16,0,30,14
1655996652162,MATH 10B,A01,083207,Lim; Seonhee,1,1,34,33
1655996652162,MATH 10B,A02,083208,Lim; Seonhee,1,1,35,34
1655996652162,MATH 10B,A03,093472,Staff,1,0,34,33
1655996652162,MATH 10B,B01,083739,Sinha; Shubham,9,0,30,21
1655996658190,MATH 18,A01,083743,Cinel; Cameron Alexander,5,0,30,25
1655996658190,MATH 18,A02,083744,Cinel; Cameron Alexander,11,0,30,19
1655996658190,MATH 18,A03,083745,Cinel; Cameron Alexander,1,0,30,29
1655996658190,MATH 18,B01,083748,Ma; Zilu,2,0,36,34
1655996658190,MATH 18,B02,083749,Ma; Zilu,0,0,36,36
1655996658190,MATH 18,B03,083750,Ma; Zilu,0,0,36,36
1655996658190,MATH 18,B04,083751,Ma; Zilu,0,0,36,36
1655996658190,MATH 18,B05,093473,Staff,0,0,36,36
1655996658190,MATH 18,B06,093474,Staff,1,0,36,35
1655996664218,MATH 20A,A01,083754,Zheng; Zequn,10,0,40,30
1655996670244,MATH 20B,A01,083756,Briones; Jor-el Thomas Caparas,0,1,36,36
1655996670244,MATH 20B,A02,083757,Briones; Jor-el Thomas Caparas,1,0,36,35
1655996670244,MATH 20B,A03,093475,Staff,0,0,36,36
1655996676267,MATH 20C,A01,083760,Briones; Jor-el Thomas Caparas,0,2,35,35
1655996676267,MATH 20C,A02,083761,Briones; Jor-el Thomas Caparas,6,1,35,29
1655996676267,MATH 20C,A03,093476,Staff,0,0,35,35
1655996676267,MATH 20C,B01,083762,Bach; Quang Tran,3,0,30,27
1655996682292,MATH 20D,A01,083765,Tran; Brian Kha,1,0,30,29
1655996682292,MATH 20D,A02,083766,Tran; Brian Kha,0,1,30,30
1655996682292,MATH 20D,A03,083767,Tran; Brian Kha,1,0,30,29
1655996688319,MATH 20E,A01,083771,Ganguly; Soumya,0,1,32,32
1655996688319,MATH 20E,A02,083772,Ganguly; Soumya,1,1,32,31
1655996688319,MATH 20E,B01,083773,Ciotti; Benjamin,14,0,35,21
1655996688319,MATH 20E,B02,083774,Ciotti; Benjamin,12,0,35,23
1655996694356,MATH 103A,A01,083777,Greenfeld; Be'Eri,2,1,36,34
1655996694356,MATH 103A,A02,083778,Greenfeld; Be'Eri,2,0,36,34
1655996694356,MATH 103A,A03,093561,Staff,0,1,36,36
1655996694356,MATH 103A,B01,083779,Greenfeld; Be'Eri,7,1,36,29
1655996694356,MATH 103A,B02,083780,Greenfeld; Be'Eri,0,0,36,36
1655996694356,MATH 103A,B03,093562,Staff,0,0,36,36
1655996700391,MATH 105,A01,085443,Carter; Anne Toulson,4,1,35,31
1655996700391,MATH 105,A02,093477,Staff,8,0,35,27
1655996706423,MATH 109,A01,083213,Ganzberger; Geoffrey Michael,0,1,34,34
1655996706423,MATH 109,A02,083214,Ganzberger; Geoffrey Michael,0,0,34,34
1655996706423,MATH 109,A03,093478,Staff,1,0,34,33
1655996706423,MATH 109,B01,083215,Ganzberger; Geoffrey Michael,2,0,32,30
1655996706423,MATH 109,B02,083216,Ganzberger; Geoffrey Michael,0,0,32,32
1655996706423,MATH 109,B03,093479,Staff,4,0,32,28
1655996712479,MATH 142A,A01,083219,Chow; Bennett,0,0,32,32
1655996712479,MATH 142A,A02,083220,Chow; Bennett,7,0,32,25
1655996712479,MATH 142A,A03,093480,Staff,4,0,32,28
1655996712479,MATH 142A,B03,093481,Staff,3,0,32,29
1655996712479,MATH 142A,B04,093558,Staff,6,0,32,26
1655996712479,MATH 142A,B05,093559,Staff,0,0,32,32
1655996718502,MATH 193A,A01,083224,Rotar; Vladimir,1,1,34,33
1655996718502,MATH 193A,A02,083225,Rotar; Vladimir,0,0,34,34
1655996718502,MATH 193A,A03,083781,Rotar; Vladimir,2,0,34,32
1655996718502,MATH 193A,A04,083782,Rotar; Vladimir,3,0,34,31
1655996718502,MATH 193A,A05,093482,Rotar; Vladimir,0,0,34,34
1655996724549,MATH 197,001,091859,McAuley; Julian John,9999,0,9999,0
1655996724549,MATH 197,002,095566,Kedlaya; Kiran S.,9997,0,9999,2
1655996724549,MATH 197,003,095567,Xiao; Ming,9999,0,9999,0
1655996724549,MATH 197,004,095571,Perols; Johan Lars,9998,0,9999,1
1655996731624,COGS 9,A01,083615,Shannon; Kyle Michael,3,1,75,72
1655996737647,COGS 11,A01,083617,Boyle; Mary E. T.,11,1,48,37
1655996743688,COGS 13,A01,083071,Bastos; Amalia Pinkusfeld,3,2,71,68
1655996749733,COGS 14A,A01,092681,Semenuks; Arturs,4,25,100,96
1655996755766,COGS 14B,A01,083073,Cheng; Tzu-Han,7,0,63,56
1655996761811,COGS 17,A01,092677,Semenuks; Arturs,8,7,81,73
1655996767835,COGS 100,A01,083619,Allen; Michael Gordon,2,2,70,68
1655996773884,COGS 101A,A01,083621,Davis; Joshua Daniel,4,3,68,64
1655996779910,COGS 101B,A01,091572,Allen; Michael Gordon,0,0,65,65
1655996785941,COGS 101C,A01,083625,Delgado; Tania,7,0,35,28
1655996791965,COGS 107A,A01,083627,Boyle; Mary E. T.,1,2,60,59
1655996798002,COGS 118A,A01,083075,Gupta; Anjum,21,16,76,55
1655996804037,CSE 3,A50,083646,Miranda; Gregory Joseph,14,0,50,36
1655996810160,CSE 8A,A50,083650,Miranda; Gregory Joseph,3,11,56,53
1655996816187,CSE 11,A01,083080,Cao; Yingjun,0,65,40,40
1655996822227,CSE 12,A01,083652,Krause-Levy; Sophia Louisa,6,8,120,114
1655996828252,CSE 15L,A01,083654,Morris; Justin Loren,3,1,50,47
1655996828252,CSE 15L,A02,083655,Morris; Justin Loren,1,1,50,49
1655996834276,CSE 20,A01,083657,Tran; Khoa Dang,29,0,80,51
1655996840304,CSE 21,A01,095574,Bach; Quang Tran,23,0,48,25
1655996846340,CSE 30,A01,083084,Eldon; John,2,10,80,78
1655996846340,CSE 30,B01,095061,Bhaskar; Nishant,0,4,50,50
1655996852366,CSE 100,A01,083659,Cao; Yingjun,2,25,70,68
1655996858406,CSE 134B,A01,083661,Powell; Thomas Allan,6,7,100,94
1655996864440,CSE 140,A01,083663,Gungor; Onat,5,0,85,80
1655996870466,CSE 140L,A01,083088,Eldon; John,5,0,100,95
1655996876499,CSE 175,A01,083665,Kumar; Rakesh,1,0,25,24
1655996882526,CSE 190,A00,092507,Dubnov; Shlomo,1,0,20,19
1655996888565,ECE 45,A01,083139,Congero; Spencer William,0,1,75,75
1655996894589,ECE 65,A50,083695,Saad; Andrew S,6,0,30,24
1655996894589,ECE 65,A51,095125,Staff,23,0,26,3
1655996900617,ECE 109,A01,091882,Touri; Behrouz,2,4,70,68
1655996906651,ECE 180,A00,083140,Abi Samra; Nicholas Camill,1,0,30,29
1655996906651,ECE 180,B00,083141,Abi Samra; Nicholas Camill,0,8,28,28
1655996912685,MATH 10A,A01,083735,Patchell; Gregory David,0,0,30,30
1655996912685,MATH 10A,A02,083736,Patchell; Gregory David,21,0,30,9
1655996912685,MATH 10A,A03,083737,Patchell; Gregory David,16,0,30,14
1655996918711,MATH 10B,A01,083207,Lim; Seonhee,1,1,34,33
1655996918711,MATH 10B,A02,083208,Lim; Seonhee,1,1,35,34
1655996918711,MATH 10B,A03,093472,Staff,1,0,34,33
1655996918711,MATH 10B,B01,083739,Sinha; Shubham,9,0,30,21
1655996924738,MATH 18,A01,083743,Cinel; Cameron Alexander,5,0,30,25
1655996924738,MATH 18,A02,083744,Cinel; Cameron Alexander,11,0,30,19
1655996924738,MATH 18,A03,083745,Cinel; Cameron Alexander,1,0,30,29
1655996924738,MATH 18,B01,083748,Ma; Zilu,2,0,36,34
1655996924738,MATH 18,B02,083749,Ma; Zilu,0,0,36,36
1655996924738,MATH 18,B03,083750,Ma; Zilu,0,0,36,36
1655996924738,MATH 18,B04,083751,Ma; Zilu,0,0,36,36
1655996924738,MATH 18,B05,093473,Staff,0,0,36,36
1655996924738,MATH 18,B06,093474,Staff,1,0,36,35
1655996930764,MATH 20A,A01,083754,Zheng; Zequn,10,0,40,30
1655996936794,MATH 20B,A01,083756,Briones; Jor-el Thomas Caparas,0,1,36,36
1655996936794,MATH 20B,A02,083757,Briones; Jor-el Thomas Caparas,1,0,36,35
1655996936794,MATH 20B,A03,093475,Staff,0,0,36,36
1655996942827,MATH 20C,A01,083760,Briones; Jor-el Thomas Caparas,0,2,35,35
1655996942827,MATH 20C,A02,083761,Briones; Jor-el Thomas Caparas,6,1,35,29
1655996942827,MATH 20C,A03,093476,Staff,0,0,35,35
1655996942827,MATH 20C,B01,083762,Bach; Quang Tran,3,0,30,27
1655996948864,MATH 20D,A01,083765,Tran; Brian Kha,1,0,30,29
1655996948864,MATH 20D,A02,083766,Tran; Brian Kha,0,1,30,30
1655996948864,MATH 20D,A03,083767,Tran; Brian Kha,1,0,30,29
1655996954912,MATH 20E,A01,083771,Ganguly; Soumya,0,1,32,32
1655996954912,MATH 20E,A02,083772,Ganguly; Soumya,1,1,32,31
1655996954912,MATH 20E,B01,083773,Ciotti; Benjamin,14,0,35,21
1655996954912,MATH 20E,B02,083774,Ciotti; Benjamin,12,0,35,23
1655996960946,MATH 103A,A01,083777,Greenfeld; Be'Eri,2,1,36,34
1655996960946,MATH 103A,A02,083778,Greenfeld; Be'Eri,2,0,36,34
1655996960946,MATH 103A,A03,093561,Staff,0,1,36,36
1655996960946,MATH 103A,B01,083779,Greenfeld; Be'Eri,7,1,36,29
1655996960946,MATH 103A,B02,083780,Greenfeld; Be'Eri,0,0,36,36
1655996960946,MATH 103A,B03,093562,Staff,0,0,36,36
1655996966970,MATH 105,A01,085443,Carter; Anne Toulson,4,1,35,31
1655996966970,MATH 105,A02,093477,Staff,8,0,35,27
1655996973001,MATH 109,A01,083213,Ganzberger; Geoffrey Michael,0,1,34,34
1655996973001,MATH 109,A02,083214,Ganzberger; Geoffrey Michael,0,0,34,34
1655996973001,MATH 109,A03,093478,Staff,1,0,34,33
1655996973001,MATH 109,B01,083215,Ganzberger; Geoffrey Michael,2,0,32,30
1655996973001,MATH 109,B02,083216,Ganzberger; Geoffrey Michael,0,0,32,32
1655996973001,MATH 109,B03,093479,Staff,4,0,32,28
1655996979035,MATH 142A,A01,083219,Chow; Bennett,0,0,32,32
1655996979035,MATH 142A,A02,083220,Chow; Bennett,7,0,32,25
1655996979035,MATH 142A,A03,093480,Staff,4,0,32,28
1655996979035,MATH 142A,B03,093481,Staff,3,0,32,29
1655996979035,MATH 142A,B04,093558,Staff,6,0,32,26
1655996979035,MATH 142A,B05,093559,Staff,0,0,32,32
1655996985058,MATH 193A,A01,083224,Rotar; Vladimir,1,1,34,33
1655996985058,MATH 193A,A02,083225,Rotar; Vladimir,0,0,34,34
1655996985058,MATH 193A,A03,083781,Rotar; Vladimir,2,0,34,32
1655996985058,MATH 193A,A04,083782,Rotar; Vladimir,3,0,34,31
1655996985058,MATH 193A,A05,093482,Rotar; Vladimir,0,0,34,34
1655996991081,MATH 197,001,091859,McAuley; Julian John,9999,0,9999,0
1655996991081,MATH 197,002,095566,Kedlaya; Kiran S.,9997,0,9999,2
1655996991081,MATH 197,003,095567,Xiao; Ming,9999,0,9999,0
1655996991081,MATH 197,004,095571,Perols; Johan Lars,9998,0,9999,1
1655996998136,COGS 9,A01,083615,Shannon; Kyle Michael,3,1,75,72
1655997004189,COGS 11,A01,083617,Boyle; Mary E. T.,11,1,48,37
1655997010215,COGS 13,A01,083071,Bastos; Amalia Pinkusfeld,3,2,71,68
1655997016240,COGS 14A,A01,092681,Semenuks; Arturs,4,25,100,96
1655997022276,COGS 14B,A01,083073,Cheng; Tzu-Han,7,0,63,56
1655997028303,COGS 17,A01,092677,Semenuks; Arturs,8,7,81,73
1655997034326,COGS 100,A01,083619,Allen; Michael Gordon,2,2,70,68
1655997040356,COGS 101A,A01,083621,Davis; Joshua Daniel,4,3,68,64
1655997046391,COGS 101B,A01,091572,Allen; Michael Gordon,0,0,65,65
1655997052423,COGS 101C,A01,083625,Delgado; Tania,7,0,35,28
1655997058449,COGS 107A,A01,083627,Boyle; Mary E. T.,1,2,60,59
1655997064474,COGS 118A,A01,083075,Gupta; Anjum,21,16,76,55
1655997070496,CSE 3,A50,083646,Miranda; Gregory Joseph,14,0,50,36
1655997076522,CSE 8A,A50,083650,Miranda; Gregory Joseph,3,11,56,53
1655997082559,CSE 11,A01,083080,Cao; Yingjun,0,65,40,40
1655997088584,CSE 12,A01,083652,Krause-Levy; Sophia Louisa,6,8,120,114
1655997094608,CSE 15L,A01,083654,Morris; Justin Loren,3,1,50,47
1655997094608,CSE 15L,A02,083655,Morris; Justin Loren,1,1,50,49
1655997100642,CSE 20,A01,083657,Tran; Khoa Dang,29,0,80,51
1655997106664,CSE 21,A01,095574,Bach; Quang Tran,23,0,48,25
1655997112699,CSE 30,A01,083084,Eldon; John,2,10,80,78
1655997112699,CSE 30,B01,095061,Bhaskar; Nishant,0,4,50,50
1655997118744,CSE 100,A01,083659,Cao; Yingjun,2,25,70,68
1655997124769,CSE 134B,A01,083661,Powell; Thomas Allan,6,7,100,94
1655997130805,CSE 140,A01,083663,Gungor; Onat,5,0,85,80
1655997136830,CSE 140L,A01,083088,Eldon; John,5,0,100,95
1655997142870,CSE 175,A01,083665,Kumar; Rakesh,1,0,25,24
1655997148896,CSE 190,A00,092507,Dubnov; Shlomo,1,0,20,19
1655997154933,ECE 45,A01,083139,Congero; Spencer William,0,1,75,75
1655997160958,ECE 65,A50,083695,Saad; Andrew S,6,0,30,24
1655997160958,ECE 65,A51,095125,Staff,23,0,26,3
1655997166994,ECE 109,A01,091882,Touri; Behrouz,2,4,70,68
1655997173017,ECE 180,A00,083140,Abi Samra; Nicholas Camill,1,0,30,29
1655997173017,ECE 180,B00,083141,Abi Samra; Nicholas Camill,0,8,28,28
1655997179046,MATH 10A,A01,083735,Patchell; Gregory David,0,0,30,30
1655997179046,MATH 10A,A02,083736,Patchell; Gregory David,21,0,30,9
1655997179046,MATH 10A,A03,083737,Patchell; Gregory David,16,0,30,14
1655997185084,MATH 10B,A01,083207,Lim; Seonhee,1,1,34,33
1655997185084,MATH 10B,A02,083208,Lim; Seonhee,1,1,35,34
1655997185084,MATH 10B,A03,093472,Staff,1,0,34,33
1655997185084,MATH 10B,B01,083739,Sinha; Shubham,9,0,30,21
1655997191116,MATH 18,A01,083743,Cinel; Cameron Alexander,5,0,30,25
1655997191116,MATH 18,A02,083744,Cinel; Cameron Alexander,11,0,30,19
1655997191116,MATH 18,A03,083745,Cinel; Cameron Alexander,1,0,30,29
1655997191116,MATH 18,B01,083748,Ma; Zilu,2,0,36,34
1655997191116,MATH 18,B02,083749,Ma; Zilu,0,0,36,36
1655997191116,MATH 18,B03,083750,Ma; Zilu,0,0,36,36
1655997191116,MATH 18,B04,083751,Ma; Zilu,0,0,36,36
1655997191116,MATH 18,B05,093473,Staff,0,0,36,36
1655997191116,MATH 18,B06,093474,Staff,1,0,36,35
1655997197146,MATH 20A,A01,083754,Zheng; Zequn,10,0,40,30
1655997203181,MATH 20B,A01,083756,Briones; Jor-el Thomas Caparas,0,1,36,36
1655997203181,MATH 20B,A02,083757,Briones; Jor-el Thomas Caparas,1,0,36,35
1655997203181,MATH 20B,A03,093475,Staff,0,0,36,36
1655997209206,MATH 20C,A01,083760,Briones; Jor-el Thomas Caparas,0,2,35,35
1655997209206,MATH 20C,A02,083761,Briones; Jor-el Thomas Caparas,6,1,35,29
1655997209206,MATH 20C,A03,093476,Staff,0,0,35,35
1655997209206,MATH 20C,B01,083762,Bach; Quang Tran,3,0,30,27
1655997215229,MATH 20D,A01,083765,Tran; Brian Kha,1,0,30,29
1655997215229,MATH 20D,A02,083766,Tran; Brian Kha,0,1,30,30
1655997215229,MATH 20D,A03,083767,Tran; Brian Kha,1,0,30,29
1655997221259,MATH 20E,A01,083771,Ganguly; Soumya,0,1,32,32
1655997221259,MATH 20E,A02,083772,Ganguly; Soumya,1,1,32,31
1655997221259,MATH 20E,B01,083773,Ciotti; Benjamin,14,0,35,21
1655997221259,MATH 20E,B02,083774,Ciotti; Benjamin,12,0,35,23
1655997227305,MATH 103A,A01,083777,Greenfeld; Be'Eri,2,1,36,34
1655997227305,MATH 103A,A02,083778,Greenfeld; Be'Eri,2,0,36,34
1655997227305,MATH 103A,A03,093561,Staff,0,1,36,36
1655997227305,MATH 103A,B01,083779,Greenfeld; Be'Eri,7,1,36,29
1655997227305,MATH 103A,B02,083780,Greenfeld; Be'Eri,0,0,36,36
1655997227305,MATH 103A,B03,093562,Staff,0,0,36,36
1655997233330,MATH 105,A01,085443,Carter; Anne Toulson,4,1,35,31
1655997233330,MATH 105,A02,093477,Staff,8,0,35,27
1655997239356,MATH 109,A01,083213,Ganzberger; Geoffrey Michael,0,1,34,34
1655997239356,MATH 109,A02,083214,Ganzberger; Geoffrey Michael,0,0,34,34
1655997239356,MATH 109,A03,093478,Staff,1,0,34,33
1655997239356,MATH 109,B01,083215,Ganzberger; Geoffrey Michael,2,0,32,30
1655997239356,MATH 109,B02,083216,Ganzberger; Geoffrey Michael,0,0,32,32
1655997239356,MATH 109,B03,093479,Staff,4,0,32,28
1655997245402,MATH 142A,A01,083219,Chow; Bennett,0,0,32,32
1655997245402,MATH 142A,A02,083220,Chow; Bennett,7,0,32,25
1655997245402,MATH 142A,A03,093480,Staff,4,0,32,28
1655997245402,MATH 142A,B03,093481,Staff,3,0,32,29
1655997245402,MATH 142A,B04,093558,Staff,6,0,32,26
1655997245402,MATH 142A,B05,093559,Staff,0,0,32,32
1655997251427,MATH 193A,A01,083224,Rotar; Vladimir,1,1,34,33
1655997251427,MATH 193A,A02,083225,Rotar; Vladimir,0,0,34,34
1655997251427,MATH 193A,A03,083781,Rotar; Vladimir,2,0,34,32
1655997251427,MATH 193A,A04,083782,Rotar; Vladimir,3,0,34,31
1655997251427,MATH 193A,A05,093482,Rotar; Vladimir,0,0,34,34
1655997257470,MATH 197,001,091859,McAuley; Julian John,9999,0,9999,0
1655997257470,MATH 197,002,095566,Kedlaya; Kiran S.,9997,0,9999,2
1655997257470,MATH 197,003,095567,Xiao; Ming,9999,0,9999,0
1655997257470,MATH 197,004,095571,Perols; Johan Lars,9998,0,9999,1
1655997264559,COGS 9,A01,083615,Shannon; Kyle Michael,3,1,75,72
1655997270585,COGS 11,A01,083617,Boyle; Mary E. T.,11,1,48,37
1655997276609,COGS 13,A01,083071,Bastos; Amalia Pinkusfeld,3,2,71,68
1655997282640,COGS 14A,A01,092681,Semenuks; Arturs,4,25,100,96
1655997288674,COGS 14B,A01,083073,Cheng; Tzu-Han,7,0,63,56
1655997294705,COGS 17,A01,092677,Semenuks; Arturs,8,7,81,73
1655997300750,COGS 100,A01,083619,Allen; Michael Gordon,2,2,70,68
1655997306778,COGS 101A,A01,083621,Davis; Joshua Daniel,4,3,68,64
1655997312806,COGS 101B,A01,091572,Allen; Michael Gordon,0,0,65,65
1655997318832,COGS 101C,A01,083625,Delgado; Tania,7,0,35,28
1655997324877,COGS 107A,A01,083627,Boyle; Mary E. T.,1,2,60,59
1655997330907,COGS 118A,A01,083075,Gupta; Anjum,21,16,76,55
1655997336954,CSE 3,A50,083646,Miranda; Gregory Joseph,14,0,50,36
1655997342990,CSE 8A,A50,083650,Miranda; Gregory Joseph,3,11,56,53
1655997349025,CSE 11,A01,083080,Cao; Yingjun,0,65,40,40
1655997355051,CSE 12,A01,083652,Krause-Levy; Sophia Louisa,6,8,120,114
1655997361084,CSE 15L,A01,083654,Morris; Justin Loren,3,1,50,47
1655997361084,CSE 15L,A02,083655,Morris; Justin Loren,1,1,50,49
1655997367138,CSE 20,A01,083657,Tran; Khoa Dang,29,0,80,51
1655997373173,CSE 21,A01,095574,Bach; Quang Tran,23,0,48,25
1655997379202,CSE 30,A01,083084,Eldon; John,2,10,80,78
1655997379202,CSE 30,B01,095061,Bhaskar; Nishant,0,4,50,50
1655997385228,CSE 100,A01,083659,Cao; Yingjun,2,25,70,68
1655997391260,CSE 134B,A01,083661,Powell; Thomas Allan,6,7,100,94
1655997397283,CSE 140,A01,083663,Gungor; Onat,5,0,85,80
1655997403310,CSE 140L,A01,083088,Eldon; John,5,0,100,95
1655997409421,CSE 175,A01,083665,Kumar; Rakesh,1,0,25,24
1655997415463,CSE 190,A00,092507,Dubnov; Shlomo,1,0,20,19
1655997421499,ECE 45,A01,083139,Congero; Spencer William,0,1,75,75
1655997427528,ECE 65,A50,083695,Saad; Andrew S,6,0,30,24
1655997427528,ECE 65,A51,095125,Staff,23,0,26,3
1655997433554,ECE 109,A01,091882,Touri; Behrouz,2,4,70,68
1655997439579,ECE 180,A00,083140,Abi Samra; Nicholas Camill,1,0,30,29
1655997439579,ECE 180,B00,083141,Abi Samra; Nicholas Camill,0,8,28,28
1655997445606,MATH 10A,A01,083735,Patchell; Gregory David,0,0,30,30
1655997445606,MATH 10A,A02,083736,Patchell; Gregory David,21,0,30,9
1655997445606,MATH 10A,A03,083737,Patchell; Gregory David,16,0,30,14
1655997451636,MATH 10B,A01,083207,Lim; Seonhee,1,1,34,33
1655997451636,MATH 10B,A02,083208,Lim; Seonhee,1,1,35,34
1655997451636,MATH 10B,A03,093472,Staff,1,0,34,33
1655997451636,MATH 10B,B01,083739,Sinha; Shubham,9,0,30,21
1655997457664,MATH 18,A01,083743,Cinel; Cameron Alexander,5,0,30,25
1655997457664,MATH 18,A02,083744,Cinel; Cameron Alexander,11,0,30,19
1655997457664,MATH 18,A03,083745,Cinel; Cameron Alexander,1,0,30,29
1655997457664,MATH 18,B01,083748,Ma; Zilu,2,0,36,34
1655997457664,MATH 18,B02,083749,Ma; Zilu,0,0,36,36
1655997457664,MATH 18,B03,083750,Ma; Zilu,0,0,36,36
1655997457664,MATH 18,B04,083751,Ma; Zilu,0,0,36,36
1655997457664,MATH 18,B05,093473,Staff,0,0,36,36
1655997457664,MATH 18,B06,093474,Staff,1,0,36,35
1655997463689,MATH 20A,A01,083754,Zheng; Zequn,10,0,40,30
1655997469717,MATH 20B,A01,083756,Briones; Jor-el Thomas Caparas,0,1,36,36
1655997469717,MATH 20B,A02,083757,Briones; Jor-el Thomas Caparas,1,0,36,35
1655997469717,MATH 20B,A03,093475,Staff,0,0,36,36
1655997475741,MATH 20C,A01,083760,Briones; Jor-el Thomas Caparas,0,2,35,35
1655997475741,MATH 20C,A02,083761,Briones; Jor-el Thomas Caparas,6,1,35,29
1655997475741,MATH 20C,A03,093476,Staff,0,0,35,35
1655997475741,MATH 20C,B01,083762,Bach; Quang Tran,3,0,30,27
1655997481770,MATH 20D,A01,083765,Tran; Brian Kha,1,0,30,29
1655997481770,MATH 20D,A02,083766,Tran; Brian Kha,0,1,30,30
1655997481770,MATH 20D,A03,083767,Tran; Brian Kha,1,0,30,29
1655997487804,MATH 20E,A01,083771,Ganguly; Soumya,0,1,32,32
1655997487804,MATH 20E,A02,083772,Ganguly; Soumya,1,1,32,31
1655997487804,MATH 20E,B01,083773,Ciotti; Benjamin,14,0,35,21
1655997487804,MATH 20E,B02,083774,Ciotti; Benjamin,12,0,35,23
1655997493843,MATH 103A,A01,083777,Greenfeld; Be'Eri,2,1,36,34
1655997493843,MATH 103A,A02,083778,Greenfeld; Be'Eri,2,0,36,34
1655997493843,MATH 103A,A03,093561,Staff,0,1,36,36
1655997493843,MATH 103A,B01,083779,Greenfeld; Be'Eri,7,1,36,29
1655997493843,MATH 103A,B02,083780,Greenfeld; Be'Eri,0,0,36,36
1655997493843,MATH 103A,B03,093562,Staff,0,0,36,36
1655997499885,MATH 105,A01,085443,Carter; Anne Toulson,4,1,35,31
1655997499885,MATH 105,A02,093477,Staff,8,0,35,27
1655997505915,MATH 109,A01,083213,Ganzberger; Geoffrey Michael,0,1,34,34
1655997505915,MATH 109,A02,083214,Ganzberger; Geoffrey Michael,0,0,34,34
1655997505915,MATH 109,A03,093478,Staff,1,0,34,33
1655997505915,MATH 109,B01,083215,Ganzberger; Geoffrey Michael,2,0,32,30
1655997505915,MATH 109,B02,083216,Ganzberger; Geoffrey Michael,0,0,32,32
1655997505915,MATH 109,B03,093479,Staff,4,0,32,28
1655997511946,MATH 142A,A01,083219,Chow; Bennett,0,0,32,32
1655997511946,MATH 142A,A02,083220,Chow; Bennett,7,0,32,25
1655997511946,MATH 142A,A03,093480,Staff,4,0,32,28
1655997511946,MATH 142A,B03,093481,Staff,3,0,32,29
1655997511946,MATH 142A,B04,093558,Staff,6,0,32,26
1655997511946,MATH 142A,B05,093559,Staff,0,0,32,32
1655997517974,MATH 193A,A01,083224,Rotar; Vladimir,1,1,34,33
1655997517974,MATH 193A,A02,083225,Rotar; Vladimir,0,0,34,34
1655997517974,MATH 193A,A03,083781,Rotar; Vladimir,2,0,34,32
1655997517974,MATH 193A,A04,083782,Rotar; Vladimir,3,0,34,31
1655997517974,MATH 193A,A05,093482,Rotar; Vladimir,0,0,34,34
1655997524016,MATH 197,001,091859,McAuley; Julian John,9999,0,9999,0
1655997524016,MATH 197,002,095566,Kedlaya; Kiran S.,9997,0,9999,2
1655997524016,MATH 197,003,095567,Xiao; Ming,9999,0,9999,0
1655997524016,MATH 197,004,095571,Perols; Johan Lars,9998,0,9999,1
1655997531083,COGS 9,A01,083615,Shannon; Kyle Michael,3,1,75,72
1655997537119,COGS 11,A01,083617,Boyle; Mary E. T.,11,1,48,37
1655997543146,COGS 13,A01,083071,Bastos; Amalia Pinkusfeld,3,2,71,68
1655997549185,COGS 14A,A01,092681,Semenuks; Arturs,4,25,100,96
1655997555225,COGS 14B,A01,083073,Cheng; Tzu-Han,7,0,63,56
1655997561250,COGS 17,A01,092677,Semenuks; Arturs,8,7,81,73
1655997567286,COGS 100,A01,083619,Allen; Michael Gordon,2,2,70,68
1655997573311,COGS 101A,A01,083621,Davis; Joshua Daniel,4,3,68,64
1655997579339,COGS 101B,A01,091572,Allen; Michael Gordon,0,0,65,65
1655997585373,COGS 101C,A01,083625,Delgado; Tania,7,0,35,28
1655997591399,COGS 107A,A01,083627,Boyle; Mary E. T.,1,2,60,59
1655997597428,COGS 118A,A01,083075,Gupta; Anjum,21,16,76,55
1655997603458,CSE 3,A50,083646,Miranda; Gregory Joseph,14,0,50,36
1655997609488,CSE 8A,A50,083650,Miranda; Gregory Joseph,3,11,56,53
1655997615515,CSE 11,A01,083080,Cao; Yingjun,0,65,40,40
1655997621545,CSE 12,A01,083652,Krause-Levy; Sophia Louisa,6,8,120,114
1655997627588,CSE 15L,A01,083654,Morris; Justin Loren,3,1,50,47
1655997627588,CSE 15L,A02,083655,Morris; Justin Loren,1,1,50,49
1655997633637,CSE 20,A01,083657,Tran; Khoa Dang,29,0,80,51
1655997639683,CSE 21,A01,095574,Bach; Quang Tran,23,0,48,25
1655997645742,CSE 30,A01,083084,Eldon; John,2,10,80,78
1655997645742,CSE 30,B01,095061,Bhaskar; Nishant,0,4,50,50
1655997651773,CSE 100,A01,083659,Cao; Yingjun,2,25,70,68
1655997657812,CSE 134B,A01,083661,Powell; Thomas Allan,6,7,100,94
1655997663840,CSE 140,A01,083663,Gungor; Onat,5,0,85,80
1655997669871,CSE 140L,A01,083088,Eldon; John,5,0,100,95
1655997675904,CSE 175,A01,083665,Kumar; Rakesh,1,0,25,24
1655997681946,CSE 190,A00,092507,Dubnov; Shlomo,1,0,20,19
1655997687989,ECE 45,A01,083139,Congero; Spencer William,0,1,75,75
1655997694033,ECE 65,A50,083695,Saad; Andrew S,6,0,30,24
1655997694033,ECE 65,A51,095125,Staff,23,0,26,3
1655997700058,ECE 109,A01,091882,Touri; Behrouz,2,4,70,68
1655997706084,ECE 180,A00,083140,Abi Samra; Nicholas Camill,1,0,30,29
1655997706084,ECE 180,B00,083141,Abi Samra; Nicholas Camill,0,8,28,28
1655997712114,MATH 10A,A01,083735,Patchell; Gregory David,0,0,30,30
1655997712114,MATH 10A,A02,083736,Patchell; Gregory David,21,0,30,9
1655997712114,MATH 10A,A03,083737,Patchell; Gregory David,16,0,30,14
1655997718153,MATH 10B,A01,083207,Lim; Seonhee,1,1,34,33
1655997718153,MATH 10B,A02,083208,Lim; Seonhee,1,1,35,34
1655997718153,MATH 10B,A03,093472,Staff,1,0,34,33
1655997718153,MATH 10B,B01,083739,Sinha; Shubham,9,0,30,21
1655997724188,MATH 18,A01,083743,Cinel; Cameron Alexander,5,0,30,25
1655997724188,MATH 18,A02,083744,Cinel; Cameron Alexander,11,0,30,19
1655997724188,MATH 18,A03,083745,Cinel; Cameron Alexander,1,0,30,29
1655997724188,MATH 18,B01,083748,Ma; Zilu,2,0,36,34
1655997724188,MATH 18,B02,083749,Ma; Zilu,0,0,36,36
1655997724188,MATH 18,B03,083750,Ma; Zilu,0,0,36,36
1655997724188,MATH 18,B04,083751,Ma; Zilu,0,0,36,36
1655997724188,MATH 18,B05,093473,Staff,0,0,36,36
1655997724188,MATH 18,B06,093474,Staff,1,0,36,35
1655997730231,MATH 20A,A01,083754,Zheng; Zequn,10,0,40,30
1655997736257,MATH 20B,A01,083756,Briones; Jor-el Thomas Caparas,0,1,36,36
1655997736257,MATH 20B,A02,083757,Briones; Jor-el Thomas Caparas,1,0,36,35
1655997736257,MATH 20B,A03,093475,Staff,0,0,36,36
1655997742304,MATH 20C,A01,083760,Briones; Jor-el Thomas Caparas,0,2,35,35
1655997742304,MATH 20C,A02,083761,Briones; Jor-el Thomas Caparas,6,1,35,29
1655997742304,MATH 20C,A03,093476,Staff,0,0,35,35
1655997742304,MATH 20C,B01,083762,Bach; Quang Tran,3,0,30,27
1655997748340,MATH 20D,A01,083765,Tran; Brian Kha,1,0,30,29
1655997748340,MATH 20D,A02,083766,Tran; Brian Kha,0,1,30,30
1655997748340,MATH 20D,A03,083767,Tran; Brian Kha,1,0,30,29
1655997754381,MATH 20E,A01,083771,Ganguly; Soumya,0,1,32,32
1655997754381,MATH 20E,A02,083772,Ganguly; Soumya,1,1,32,31
1655997754381,MATH 20E,B01,083773,Ciotti; Benjamin,14,0,35,21
1655997754381,MATH 20E,B02,083774,Ciotti; Benjamin,12,0,35,23
1655997760424,MATH 103A,A01,083777,Greenfeld; Be'Eri,2,1,36,34
1655997760424,MATH 103A,A02,083778,Greenfeld; Be'Eri,2,0,36,34
1655997760424,MATH 103A,A03,093561,Staff,0,1,36,36
1655997760424,MATH 103A,B01,083779,Greenfeld; Be'Eri,7,1,36,29
1655997760424,MATH 103A,B02,083780,Greenfeld; Be'Eri,0,0,36,36
1655997760424,MATH 103A,B03,093562,Staff,0,0,36,36
1655997766455,MATH 105,A01,085443,Carter; Anne Toulson,4,1,35,31
1655997766455,MATH 105,A02,093477,Staff,8,0,35,27
1655997772480,MATH 109,A01,083213,Ganzberger; Geoffrey Michael,0,1,34,34
1655997772480,MATH 109,A02,083214,Ganzberger; Geoffrey Michael,0,0,34,34
1655997772480,MATH 109,A03,093478,Staff,1,0,34,33
1655997772480,MATH 109,B01,083215,Ganzberger; Geoffrey Michael,2,0,32,30
1655997772480,MATH 109,B02,083216,Ganzberger; Geoffrey Michael,0,0,32,32
1655997772480,MATH 109,B03,093479,Staff,4,0,32,28
1655997778504,MATH 142A,A01,083219,Chow; Bennett,0,0,32,32
1655997778504,MATH 142A,A02,083220,Chow; Bennett,7,0,32,25
1655997778504,MATH 142A,A03,093480,Staff,4,0,32,28
1655997778504,MATH 142A,B03,093481,Staff,3,0,32,29
1655997778504,MATH 142A,B04,093558,Staff,6,0,32,26
1655997778504,MATH 142A,B05,093559,Staff,0,0,32,32
1655997784534,MATH 193A,A01,083224,Rotar; Vladimir,1,1,34,33
1655997784534,MATH 193A,A02,083225,Rotar; Vladimir,0,0,34,34
1655997784534,MATH 193A,A03,083781,Rotar; Vladimir,2,0,34,32
1655997784534,MATH 193A,A04,083782,Rotar; Vladimir,3,0,34,31
1655997784534,MATH 193A,A05,093482,Rotar; Vladimir,0,0,34,34
1655997790571,MATH 197,001,091859,McAuley; Julian John,9999,0,9999,0
1655997790571,MATH 197,002,095566,Kedlaya; Kiran S.,9997,0,9999,2
1655997790571,MATH 197,003,095567,Xiao; Ming,9999,0,9999,0
1655997790571,MATH 197,004,095571,Perols; Johan Lars,9998,0,9999,1
1655997797629,COGS 9,A01,083615,Shannon; Kyle Michael,3,1,75,72
1655997803676,COGS 11,A01,083617,Boyle; Mary E. T.,11,1,48,37
1655997809705,COGS 13,A01,083071,Bastos; Amalia Pinkusfeld,3,2,71,68
1655997815733,COGS 14A,A01,092681,Semenuks; Arturs,4,25,100,96
1655997821775,COGS 14B,A01,083073,Cheng; Tzu-Han,7,0,63,56
1655997827800,COGS 17,A01,092677,Semenuks; Arturs,8,7,81,73
1655997833838,COGS 100,A01,083619,Allen; Michael Gordon,2,2,70,68
1655997839890,COGS 101A,A01,083621,Davis; Joshua Daniel,4,3,68,64
1655997845922,COGS 101B,A01,091572,Allen; Michael Gordon,0,0,65,65
1655997851953,COGS 101C,A01,083625,Delgado; Tania,7,0,35,28
1655997857978,COGS 107A,A01,083627,Boyle; Mary E. T.,1,2,60,59
1655997864015,COGS 118A,A01,083075,Gupta; Anjum,21,16,76,55
1655997870051,CSE 3,A50,083646,Miranda; Gregory Joseph,14,0,50,36
1655997876088,CSE 8A,A50,083650,Miranda; Gregory Joseph,3,11,56,53
1655997882122,CSE 11,A01,083080,Cao; Yingjun,0,65,40,40
1655997888166,CSE 12,A01,083652,Krause-Levy; Sophia Louisa,6,8,120,114
1655997894198,CSE 15L,A01,083654,Morris; Justin Loren,3,1,50,47
1655997894198,CSE 15L,A02,083655,Morris; Justin Loren,1,1,50,49
1655997900222,CSE 20,A01,083657,Tran; Khoa Dang,29,0,80,51
1655997906272,CSE 21,A01,095574,Bach; Quang Tran,23,0,48,25
1655997912305,CSE 30,A01,083084,Eldon; John,2,10,80,78
1655997912305,CSE 30,B01,095061,Bhaskar; Nishant,0,4,50,50
1655997918331,CSE 100,A01,083659,Cao; Yingjun,2,25,70,68
1655997924357,CSE 134B,A01,083661,Powell; Thomas Allan,6,7,100,94
1655997930381,CSE 140,A01,083663,Gungor; Onat,5,0,85,80
1655997936421,CSE 140L,A01,083088,Eldon; John,5,0,100,95
1655997942457,CSE 175,A01,083665,Kumar; Rakesh,1,0,25,24
1655997948482,CSE 190,A00,092507,Dubnov; Shlomo,1,0,20,19
1655997954511,ECE 45,A01,083139,Congero; Spencer William,0,1,75,75
1655997960564,ECE 65,A50,083695,Saad; Andrew S,6,0,30,24
1655997960564,ECE 65,A51,095125,Staff,23,0,26,3
1655997966609,ECE 109,A01,091882,Touri; Behrouz,2,4,70,68
1655997972634,ECE 180,A00,083140,Abi Samra; Nicholas Camill,1,0,30,29
1655997972634,ECE 180,B00,083141,Abi Samra; Nicholas Camill,0,8,28,28
1655997978679,MATH 10A,A01,083735,Patchell; Gregory David,0,0,30,30
1655997978679,MATH 10A,A02,083736,Patchell; Gregory David,21,0,30,9
1655997978679,MATH 10A,A03,083737,Patchell; Gregory David,16,0,30,14
1655997984708,MATH 10B,A01,083207,Lim; Seonhee,1,1,34,33
1655997984708,MATH 10B,A02,083208,Lim; Seonhee,1,1,35,34
1655997984708,MATH 10B,A03,093472,Staff,1,0,34,33
1655997984708,MATH 10B,B01,083739,Sinha; Shubham,9,0,30,21
1655997990752,MATH 18,A01,083743,Cinel; Cameron Alexander,5,0,30,25
1655997990752,MATH 18,A02,083744,Cinel; Cameron Alexander,11,0,30,19
1655997990752,MATH 18,A03,083745,Cinel; Cameron Alexander,1,0,30,29
1655997990752,MATH 18,B01,083748,Ma; Zilu,2,0,36,34
1655997990752,MATH 18,B02,083749,Ma; Zilu,0,0,36,36
1655997990752,MATH 18,B03,083750,Ma; Zilu,0,0,36,36
1655997990752,MATH 18,B04,083751,Ma; Zilu,0,0,36,36
1655997990752,MATH 18,B05,093473,Staff,0,0,36,36
1655997990752,MATH 18,B06,093474,Staff,1,0,36,35
1655997996783,MATH 20A,A01,083754,Zheng; Zequn,10,0,40,30
1655998002818,MATH 20B,A01,083756,Briones; Jor-el Thomas Caparas,0,1,36,36
1655998002818,MATH 20B,A02,083757,Briones; Jor-el Thomas Caparas,1,0,36,35
1655998002818,MATH 20B,A03,093475,Staff,0,0,36,36
1655998008966,MATH 20C,A01,083760,Briones; Jor-el Thomas Caparas,0,2,35,35
1655998008966,MATH 20C,A02,083761,Briones; Jor-el Thomas Caparas,6,1,35,29
1655998008966,MATH 20C,A03,093476,Staff,0,0,35,35
1655998008966,MATH 20C,B01,083762,Bach; Quang Tran,3,0,30,27
1655998014998,MATH 20D,A01,083765,Tran; Brian Kha,1,0,30,29
1655998014998,MATH 20D,A02,083766,Tran; Brian Kha,0,1,30,30
1655998014998,MATH 20D,A03,083767,Tran; Brian Kha,1,0,30,29
1655998021041,MATH 20E,A01,083771,Ganguly; Soumya,0,1,32,32
1655998021041,MATH 20E,A02,083772,Ganguly; Soumya,1,1,32,31
1655998021041,MATH 20E,B01,083773,Ciotti; Benjamin,14,0,35,21
1655998021041,MATH 20E,B02,083774,Ciotti; Benjamin,12,0,35,23
1655998027078,MATH 103A,A01,083777,Greenfeld; Be'Eri,2,1,36,34
1655998027078,MATH 103A,A02,083778,Greenfeld; Be'Eri,2,0,36,34
1655998027078,MATH 103A,A03,093561,Staff,0,1,36,36
1655998027078,MATH 103A,B01,083779,Greenfeld; Be'Eri,7,1,36,29
1655998027078,MATH 103A,B02,083780,Greenfeld; Be'Eri,0,0,36,36
1655998027078,MATH 103A,B03,093562,Staff,0,0,36,36
1655998033105,MATH 105,A01,085443,Carter; Anne Toulson,4,1,35,31
1655998033105,MATH 105,A02,093477,Staff,8,0,35,27
1655998039136,MATH 109,A01,083213,Ganzberger; Geoffrey Michael,0,1,34,34
1655998039136,MATH 109,A02,083214,Ganzberger; Geoffrey Michael,0,0,34,34
1655998039136,MATH 109,A03,093478,Staff,1,0,34,33
1655998039136,MATH 109,B01,083215,Ganzberger; Geoffrey Michael,2,0,32,30
1655998039136,MATH 109,B02,083216,Ganzberger; Geoffrey Michael,0,0,32,32
1655998039136,MATH 109,B03,093479,Staff,4,0,32,28
1655998045165,MATH 142A,A01,083219,Chow; Bennett,0,0,32,32
1655998045165,MATH 142A,A02,083220,Chow; Bennett,7,0,32,25
1655998045165,MATH 142A,A03,093480,Staff,4,0,32,28
1655998045165,MATH 142A,B03,093481,Staff,3,0,32,29
1655998045165,MATH 142A,B04,093558,Staff,6,0,32,26
1655998045165,MATH 142A,B05,093559,Staff,0,0,32,32
1655998051196,MATH 193A,A01,083224,Rotar; Vladimir,1,1,34,33
1655998051196,MATH 193A,A02,083225,Rotar; Vladimir,0,0,34,34
1655998051196,MATH 193A,A03,083781,Rotar; Vladimir,2,0,34,32
1655998051196,MATH 193A,A04,083782,Rotar; Vladimir,3,0,34,31
1655998051196,MATH 193A,A05,093482,Rotar; Vladimir,0,0,34,34
1655998057239,MATH 197,001,091859,McAuley; Julian John,9999,0,9999,0
1655998057239,MATH 197,002,095566,Kedlaya; Kiran S.,9997,0,9999,2
1655998057239,MATH 197,003,095567,Xiao; Ming,9999,0,9999,0
1655998057239,MATH 197,004,095571,Perols; Johan Lars,9998,0,9999,1
1655998064317,COGS 9,A01,083615,Shannon; Kyle Michael,3,1,75,72
1655998070340,COGS 11,A01,083617,Boyle; Mary E. T.,11,1,48,37
1655998076368,COGS 13,A01,083071,Bastos; Amalia Pinkusfeld,3,2,71,68
1655998082394,COGS 14A,A01,092681,Semenuks; Arturs,4,25,100,96
1655998088422,COGS 14B,A01,083073,Cheng; Tzu-Han,7,0,63,56
1655998094450,COGS 17,A01,092677,Semenuks; Arturs,8,7,81,73
1655998100478,COGS 100,A01,083619,Allen; Michael Gordon,2,2,70,68
1655998106502,COGS 101A,A01,083621,Davis; Joshua Daniel,4,3,68,64
1655998112535,COGS 101B,A01,091572,Allen; Michael Gordon,0,0,65,65
1655998118570,COGS 101C,A01,083625,Delgado; Tania,7,0,35,28
1655998124612,COGS 107A,A01,083627,Boyle; Mary E. T.,1,2,60,59
1655998130643,COGS 118A,A01,083075,Gupta; Anjum,21,16,76,55
1655998136668,CSE 3,A50,083646,Miranda; Gregory Joseph,14,0,50,36
1655998143143,CSE 8A,A50,083650,Miranda; Gregory Joseph,3,11,56,53
1655998149176,CSE 11,A01,083080,Cao; Yingjun,0,65,40,40
1655998155205,CSE 12,A01,083652,Krause-Levy; Sophia Louisa,6,8,120,114
1655998161245,CSE 15L,A01,083654,Morris; Justin Loren,3,1,50,47
1655998161245,CSE 15L,A02,083655,Morris; Justin Loren,1,1,50,49
1655998167271,CSE 20,A01,083657,Tran; Khoa Dang,29,0,80,51
1655998173301,CSE 21,A01,095574,Bach; Quang Tran,23,0,48,25
1655998179336,CSE 30,A01,083084,Eldon; John,2,10,80,78
1655998179336,CSE 30,B01,095061,Bhaskar; Nishant,0,4,50,50
1655998185365,CSE 100,A01,083659,Cao; Yingjun,2,25,70,68
1655998191405,CSE 134B,A01,083661,Powell; Thomas Allan,6,7,100,94
1655998197430,CSE 140,A01,083663,Gungor; Onat,5,0,85,80
1655998203478,CSE 140L,A01,083088,Eldon; John,5,0,100,95
1655998209507,CSE 175,A01,083665,Kumar; Rakesh,1,0,25,24
1655998215530,CSE 190,A00,092507,Dubnov; Shlomo,1,0,20,19
1655998221566,ECE 45,A01,083139,Congero; Spencer William,0,1,75,75
1655998227604,ECE 65,A50,083695,Saad; Andrew S,6,0,30,24
1655998227604,ECE 65,A51,095125,Staff,23,0,26,3
1655998233626,ECE 109,A01,091882,Touri; Behrouz,2,4,70,68
1655998239659,ECE 180,A00,083140,Abi Samra; Nicholas Camill,1,0,30,29
1655998239659,ECE 180,B00,083141,Abi Samra; Nicholas Camill,0,8,28,28
1655998245690,MATH 10A,A01,083735,Patchell; Gregory David,0,0,30,30
1655998245690,MATH 10A,A02,083736,Patchell; Gregory David,21,0,30,9
1655998245690,MATH 10A,A03,083737,Patchell; Gregory David,16,0,30,14
1655998251717,MATH 10B,A01,083207,Lim; Seonhee,1,1,34,33
1655998251717,MATH 10B,A02,083208,Lim; Seonhee,1,1,35,34
1655998251717,MATH 10B,A03,093472,Staff,1,0,34,33
1655998251717,MATH 10B,B01,083739,Sinha; Shubham,9,0,30,21
1655998257751,MATH 18,A01,083743,Cinel; Cameron Alexander,5,0,30,25
1655998257751,MATH 18,A02,083744,Cinel; Cameron Alexander,11,0,30,19
1655998257751,MATH 18,A03,083745,Cinel; Cameron Alexander,1,0,30,29
1655998257751,MATH 18,B01,083748,Ma; Zilu,2,0,36,34
1655998257751,MATH 18,B02,083749,Ma; Zilu,0,0,36,36
1655998257751,MATH 18,B03,083750,Ma; Zilu,0,0,36,36
1655998257751,MATH 18,B04,083751,Ma; Zilu,0,0,36,36
1655998257751,MATH 18,B05,093473,Staff,0,0,36,36
1655998257751,MATH 18,B06,093474,Staff,1,0,36,35
1655998263794,MATH 20A,A01,083754,Zheng; Zequn,10,0,40,30
1655998269820,MATH 20B,A01,083756,Briones; Jor-el Thomas Caparas,0,1,36,36
1655998269820,MATH 20B,A02,083757,Briones; Jor-el Thomas Caparas,1,0,36,35
1655998269820,MATH 20B,A03,093475,Staff,0,0,36,36
1655998275852,MATH 20C,A01,083760,Briones; Jor-el Thomas Caparas,0,2,35,35
1655998275852,MATH 20C,A02,083761,Briones; Jor-el Thomas Caparas,6,1,35,29
1655998275852,MATH 20C,A03,093476,Staff,0,0,35,35
1655998275852,MATH 20C,B01,083762,Bach; Quang Tran,3,0,30,27
1655998281885,MATH 20D,A01,083765,Tran; Brian Kha,1,0,30,29
1655998281885,MATH 20D,A02,083766,Tran; Brian Kha,0,1,30,30
1655998281885,MATH 20D,A03,083767,Tran; Brian Kha,1,0,30,29
1655998287926,MATH 20E,A01,083771,Ganguly; Soumya,0,1,32,32
1655998287926,MATH 20E,A02,083772,Ganguly; Soumya,1,1,32,31
1655998287926,MATH 20E,B01,083773,Ciotti; Benjamin,14,0,35,21
1655998287926,MATH 20E,B02,083774,Ciotti; Benjamin,12,0,35,23
1655998293974,MATH 103A,A01,083777,Greenfeld; Be'Eri,2,1,36,34
1655998293974,MATH 103A,A02,083778,Greenfeld; Be'Eri,2,0,36,34
1655998293974,MATH 103A,A03,093561,Staff,0,1,36,36
1655998293974,MATH 103A,B01,083779,Greenfeld; Be'Eri,7,1,36,29
1655998293974,MATH 103A,B02,083780,Greenfeld; Be'Eri,0,0,36,36
1655998293974,MATH 103A,B03,093562,Staff,0,0,36,36
1655998300008,MATH 105,A01,085443,Carter; Anne Toulson,4,1,35,31
1655998300008,MATH 105,A02,093477,Staff,8,0,35,27
1655998306056,MATH 109,A01,083213,Ganzberger; Geoffrey Michael,0,1,34,34
1655998306056,MATH 109,A02,083214,Ganzberger; Geoffrey Michael,0,0,34,34
1655998306056,MATH 109,A03,093478,Staff,1,0,34,33
1655998306056,MATH 109,B01,083215,Ganzberger; Geoffrey Michael,2,0,32,30
1655998306056,MATH 109,B02,083216,Ganzberger; Geoffrey Michael,0,0,32,32
1655998306056,MATH 109,B03,093479,Staff,4,0,32,28
1655998312092,MATH 142A,A01,083219,Chow; Bennett,0,0,32,32
1655998312092,MATH 142A,A02,083220,Chow; Bennett,7,0,32,25
1655998312092,MATH 142A,A03,093480,Staff,4,0,32,28
1655998312092,MATH 142A,B03,093481,Staff,3,0,32,29
1655998312092,MATH 142A,B04,093558,Staff,6,0,32,26
1655998312092,MATH 142A,B05,093559,Staff,0,0,32,32
1655998318133,MATH 193A,A01,083224,Rotar; Vladimir,1,1,34,33
1655998318133,MATH 193A,A02,083225,Rotar; Vladimir,0,0,34,34
1655998318133,MATH 193A,A03,083781,Rotar; Vladimir,2,0,34,32
1655998318133,MATH 193A,A04,083782,Rotar; Vladimir,3,0,34,31
1655998318133,MATH 193A,A05,093482,Rotar; Vladimir,0,0,34,34
1655998324175,MATH 197,001,091859,McAuley; Julian John,9999,0,9999,0
1655998324175,MATH 197,002,095566,Kedlaya; Kiran S.,9997,0,9999,2
1655998324175,MATH 197,003,095567,Xiao; Ming,9999,0,9999,0
1655998324175,MATH 197,004,095571,Perols; Johan Lars,9998,0,9999,1
1655998331240,COGS 9,A01,083615,Shannon; Kyle Michael,3,1,75,72
1655998337272,COGS 11,A01,083617,Boyle; Mary E. T.,11,1,48,37
1655998343299,COGS 13,A01,083071,Bastos; Amalia Pinkusfeld,3,2,71,68
1655998349324,COGS 14A,A01,092681,Semenuks; Arturs,4,25,100,96
1655998355352,COGS 14B,A01,083073,Cheng; Tzu-Han,7,0,63,56
1655998361374,COGS 17,A01,092677,Semenuks; Arturs,8,7,81,73
1655998367400,COGS 100,A01,083619,Allen; Michael Gordon,2,2,70,68
1655998373426,COGS 101A,A01,083621,Davis; Joshua Daniel,4,3,68,64
1655998379462,COGS 101B,A01,091572,Allen; Michael Gordon,0,0,65,65
1655998385502,COGS 101C,A01,083625,Delgado; Tania,7,0,35,28
1655998391539,COGS 107A,A01,083627,Boyle; Mary E. T.,1,2,60,59
1655998397561,COGS 118A,A01,083075,Gupta; Anjum,21,16,76,55
1655998403586,CSE 3,A50,083646,Miranda; Gregory Joseph,14,0,50,36
1655998409613,CSE 8A,A50,083650,Miranda; Gregory Joseph,3,11,56,53
1655998415637,CSE 11,A01,083080,Cao; Yingjun,0,65,40,40
1655998421674,CSE 12,A01,083652,Krause-Levy; Sophia Louisa,6,8,120,114
1655998427715,CSE 15L,A01,083654,Morris; Justin Loren,3,1,50,47
1655998427715,CSE 15L,A02,083655,Morris; Justin Loren,1,1,50,49
1655998433742,CSE 20,A01,083657,Tran; Khoa Dang,29,0,80,51
1655998439766,CSE 21,A01,095574,Bach; Quang Tran,23,0,48,25
1655998445792,CSE 30,A01,083084,Eldon; John,2,10,80,78
1655998445792,CSE 30,B01,095061,Bhaskar; Nishant,0,4,50,50
1655998451817,CSE 100,A01,083659,Cao; Yingjun,2,25,70,68
1655998457845,CSE 134B,A01,083661,Powell; Thomas Allan,6,7,100,94
1655998463868,CSE 140,A01,083663,Gungor; Onat,5,0,85,80
1655998469903,CSE 140L,A01,083088,Eldon; John,5,0,100,95
1655998475939,CSE 175,A01,083665,Kumar; Rakesh,1,0,25,24
1655998481973,CSE 190,A00,092507,Dubnov; Shlomo,1,0,20,19
1655998487999,ECE 45,A01,083139,Congero; Spencer William,0,1,75,75
1655998494029,ECE 65,A50,083695,Saad; Andrew S,6,0,30,24
1655998494029,ECE 65,A51,095125,Staff,23,0,26,3
1655998500056,ECE 109,A01,091882,Touri; Behrouz,2,4,70,68
1655998506087,ECE 180,A00,083140,Abi Samra; Nicholas Camill,1,0,30,29
1655998506087,ECE 180,B00,083141,Abi Samra; Nicholas Camill,0,8,28,28
1655998512120,MATH 10A,A01,083735,Patchell; Gregory David,0,0,30,30
1655998512120,MATH 10A,A02,083736,Patchell; Gregory David,21,0,30,9
1655998512120,MATH 10A,A03,083737,Patchell; Gregory David,16,0,30,14
1655998518147,MATH 10B,A01,083207,Lim; Seonhee,1,1,34,33
1655998518147,MATH 10B,A02,083208,Lim; Seonhee,1,1,35,34
1655998518147,MATH 10B,A03,093472,Staff,1,0,34,33
1655998518147,MATH 10B,B01,083739,Sinha; Shubham,9,0,30,21
1655998524181,MATH 18,A01,083743,Cinel; Cameron Alexander,5,0,30,25
1655998524181,MATH 18,A02,083744,Cinel; Cameron Alexander,11,0,30,19
1655998524181,MATH 18,A03,083745,Cinel; Cameron Alexander,1,0,30,29
1655998524181,MATH 18,B01,083748,Ma; Zilu,2,0,36,34
1655998524181,MATH 18,B02,083749,Ma; Zilu,0,0,36,36
1655998524181,MATH 18,B03,083750,Ma; Zilu,0,0,36,36
1655998524181,MATH 18,B04,083751,Ma; Zilu,0,0,36,36
1655998524181,MATH 18,B05,093473,Staff,0,0,36,36
1655998524181,MATH 18,B06,093474,Staff,1,0,36,35
1655998530209,MATH 20A,A01,083754,Zheng; Zequn,10,0,40,30
1655998536241,MATH 20B,A01,083756,Briones; Jor-el Thomas Caparas,0,1,36,36
1655998536241,MATH 20B,A02,083757,Briones; Jor-el Thomas Caparas,1,0,36,35
1655998536241,MATH 20B,A03,093475,Staff,0,0,36,36
1655998542263,MATH 20C,A01,083760,Briones; Jor-el Thomas Caparas,0,2,35,35
1655998542263,MATH 20C,A02,083761,Briones; Jor-el Thomas Caparas,6,1,35,29
1655998542263,MATH 20C,A03,093476,Staff,0,0,35,35
1655998542263,MATH 20C,B01,083762,Bach; Quang Tran,3,0,30,27
1655998548304,MATH 20D,A01,083765,Tran; Brian Kha,1,0,30,29
1655998548304,MATH 20D,A02,083766,Tran; Brian Kha,0,1,30,30
1655998548304,MATH 20D,A03,083767,Tran; Brian Kha,1,0,30,29
1655998554342,MATH 20E,A01,083771,Ganguly; Soumya,0,1,32,32
1655998554342,MATH 20E,A02,083772,Ganguly; Soumya,1,1,32,31
1655998554342,MATH 20E,B01,083773,Ciotti; Benjamin,14,0,35,21
1655998554342,MATH 20E,B02,083774,Ciotti; Benjamin,12,0,35,23
1655998560368,MATH 103A,A01,083777,Greenfeld; Be'Eri,2,1,36,34
1655998560368,MATH 103A,A02,083778,Greenfeld; Be'Eri,2,0,36,34
1655998560368,MATH 103A,A03,093561,Staff,0,1,36,36
1655998560368,MATH 103A,B01,083779,Greenfeld; Be'Eri,7,1,36,29
1655998560368,MATH 103A,B02,083780,Greenfeld; Be'Eri,0,0,36,36
1655998560368,MATH 103A,B03,093562,Staff,0,0,36,36
1655998566397,MATH 105,A01,085443,Carter; Anne Toulson,4,1,35,31
1655998566397,MATH 105,A02,093477,Staff,8,0,35,27
1655998572428,MATH 109,A01,083213,Ganzberger; Geoffrey Michael,0,1,34,34
1655998572428,MATH 109,A02,083214,Ganzberger; Geoffrey Michael,0,0,34,34
1655998572428,MATH 109,A03,093478,Staff,1,0,34,33
1655998572428,MATH 109,B01,083215,Ganzberger; Geoffrey Michael,2,0,32,30
1655998572428,MATH 109,B02,083216,Ganzberger; Geoffrey Michael,0,0,32,32
1655998572428,MATH 109,B03,093479,Staff,4,0,32,28
1655998578458,MATH 142A,A01,083219,Chow; Bennett,0,0,32,32
1655998578458,MATH 142A,A02,083220,Chow; Bennett,7,0,32,25
1655998578458,MATH 142A,A03,093480,Staff,4,0,32,28
1655998578458,MATH 142A,B03,093481,Staff,3,0,32,29
1655998578458,MATH 142A,B04,093558,Staff,6,0,32,26
1655998578458,MATH 142A,B05,093559,Staff,0,0,32,32
1655998584493,MATH 193A,A01,083224,Rotar; Vladimir,1,1,34,33
1655998584493,MATH 193A,A02,083225,Rotar; Vladimir,0,0,34,34
1655998584493,MATH 193A,A03,083781,Rotar; Vladimir,2,0,34,32
1655998584493,MATH 193A,A04,083782,Rotar; Vladimir,3,0,34,31
1655998584493,MATH 193A,A05,093482,Rotar; Vladimir,0,0,34,34
1655998590518,MATH 197,001,091859,McAuley; Julian John,9999,0,9999,0
1655998590518,MATH 197,002,095566,Kedlaya; Kiran S.,9997,0,9999,2
1655998590518,MATH 197,003,095567,Xiao; Ming,9999,0,9999,0
1655998590518,MATH 197,004,095571,Perols; Johan Lars,9998,0,9999,1
1655998597599,COGS 9,A01,083615,Shannon; Kyle Michael,3,1,75,72
1655998603737,COGS 11,A01,083617,Boyle; Mary E. T.,11,1,48,37
1655998609761,COGS 13,A01,083071,Bastos; Amalia Pinkusfeld,3,2,71,68
1655998615786,COGS 14A,A01,092681,Semenuks; Arturs,4,25,100,96
1655998621817,COGS 14B,A01,083073,Cheng; Tzu-Han,7,0,63,56
1655998627844,COGS 17,A01,092677,Semenuks; Arturs,8,7,81,73
1655998633869,COGS 100,A01,083619,Allen; Michael Gordon,2,2,70,68
1655998639901,COGS 101A,A01,083621,Davis; Joshua Daniel,4,3,68,64
1655998645930,COGS 101B,A01,091572,Allen; Michael Gordon,0,0,65,65
1655998651955,COGS 101C,A01,083625,Delgado; Tania,7,0,35,28
1655998657983,COGS 107A,A01,083627,Boyle; Mary E. T.,1,2,60,59
1655998664011,COGS 118A,A01,083075,Gupta; Anjum,21,16,76,55
1655998670035,CSE 3,A50,083646,Miranda; Gregory Joseph,14,0,50,36
1655998676064,CSE 8A,A50,083650,Miranda; Gregory Joseph,3,11,56,53
1655998682104,CSE 11,A01,083080,Cao; Yingjun,0,65,40,40
1655998688129,CSE 12,A01,083652,Krause-Levy; Sophia Louisa,6,8,120,114
1655998694152,CSE 15L,A01,083654,Morris; Justin Loren,3,1,50,47
1655998694152,CSE 15L,A02,083655,Morris; Justin Loren,1,1,50,49
1655998700178,CSE 20,A01,083657,Tran; Khoa Dang,29,0,80,51
1655998706211,CSE 21,A01,095574,Bach; Quang Tran,23,0,48,25
1655998712238,CSE 30,A01,083084,Eldon; John,2,10,80,78
1655998712238,CSE 30,B01,095061,Bhaskar; Nishant,0,4,50,50
1655998718273,CSE 100,A01,083659,Cao; Yingjun,2,25,70,68
1655998724309,CSE 134B,A01,083661,Powell; Thomas Allan,6,7,100,94
1655998730336,CSE 140,A01,083663,Gungor; Onat,5,0,85,80
1655998736361,CSE 140L,A01,083088,Eldon; John,5,0,100,95
1655998742414,CSE 175,A01,083665,Kumar; Rakesh,1,0,25,24
1655998748447,CSE 190,A00,092507,Dubnov; Shlomo,1,0,20,19
1655998754477,ECE 45,A01,083139,Congero; Spencer William,0,1,75,75
1655998760508,ECE 65,A50,083695,Saad; Andrew S,6,0,30,24
1655998760508,ECE 65,A51,095125,Staff,23,0,26,3
1655998766544,ECE 109,A01,091882,Touri; Behrouz,2,4,70,68
1655998772580,ECE 180,A00,083140,Abi Samra; Nicholas Camill,1,0,30,29
1655998772580,ECE 180,B00,083141,Abi Samra; Nicholas Camill,0,8,28,28
1655998778606,MATH 10A,A01,083735,Patchell; Gregory David,0,0,30,30
1655998778606,MATH 10A,A02,083736,Patchell; Gregory David,21,0,30,9
1655998778606,MATH 10A,A03,083737,Patchell; Gregory David,16,0,30,14
1655998784646,MATH 10B,A01,083207,Lim; Seonhee,1,1,34,33
1655998784646,MATH 10B,A02,083208,Lim; Seonhee,1,1,35,34
1655998784646,MATH 10B,A03,093472,Staff,1,0,34,33
1655998784646,MATH 10B,B01,083739,Sinha; Shubham,9,0,30,21
1655998790681,MATH 18,A01,083743,Cinel; Cameron Alexander,5,0,30,25
1655998790681,MATH 18,A02,083744,Cinel; Cameron Alexander,11,0,30,19
1655998790681,MATH 18,A03,083745,Cinel; Cameron Alexander,1,0,30,29
1655998790681,MATH 18,B01,083748,Ma; Zilu,2,0,36,34
1655998790681,MATH 18,B02,083749,Ma; Zilu,0,0,36,36
1655998790681,MATH 18,B03,083750,Ma; Zilu,0,0,36,36
1655998790681,MATH 18,B04,083751,Ma; Zilu,0,0,36,36
1655998790681,MATH 18,B05,093473,Staff,0,0,36,36
1655998790681,MATH 18,B06,093474,Staff,1,0,36,35
1655998796710,MATH 20A,A01,083754,Zheng; Zequn,10,0,40,30
1655998802745,MATH 20B,A01,083756,Briones; Jor-el Thomas Caparas,0,1,36,36
1655998802745,MATH 20B,A02,083757,Briones; Jor-el Thomas Caparas,1,0,36,35
1655998802745,MATH 20B,A03,093475,Staff,0,0,36,36
1655998808770,MATH 20C,A01,083760,Briones; Jor-el Thomas Caparas,0,2,35,35
1655998808770,MATH 20C,A02,083761,Briones; Jor-el Thomas Caparas,6,1,35,29
1655998808770,MATH 20C,A03,093476,Staff,0,0,35,35
1655998808770,MATH 20C,B01,083762,Bach; Quang Tran,3,0,30,27
1655998814795,MATH 20D,A01,083765,Tran; Brian Kha,1,0,30,29
1655998814795,MATH 20D,A02,083766,Tran; Brian Kha,0,1,30,30
1655998814795,MATH 20D,A03,083767,Tran; Brian Kha,1,0,30,29
1655998820828,MATH 20E,A01,083771,Ganguly; Soumya,0,1,32,32
1655998820828,MATH 20E,A02,083772,Ganguly; Soumya,1,1,32,31
1655998820828,MATH 20E,B01,083773,Ciotti; Benjamin,14,0,35,21
1655998820828,MATH 20E,B02,083774,Ciotti; Benjamin,12,0,35,23
1655998826873,MATH 103A,A01,083777,Greenfeld; Be'Eri,2,1,36,34
1655998826873,MATH 103A,A02,083778,Greenfeld; Be'Eri,2,0,36,34
1655998826873,MATH 103A,A03,093561,Staff,0,1,36,36
1655998826873,MATH 103A,B01,083779,Greenfeld; Be'Eri,7,1,36,29
1655998826873,MATH 103A,B02,083780,Greenfeld; Be'Eri,0,0,36,36
1655998826873,MATH 103A,B03,093562,Staff,0,0,36,36
1655998832900,MATH 105,A01,085443,Carter; Anne Toulson,4,1,35,31
1655998832900,MATH 105,A02,093477,Staff,8,0,35,27
1655998838924,MATH 109,A01,083213,Ganzberger; Geoffrey Michael,0,1,34,34
1655998838924,MATH 109,A02,083214,Ganzberger; Geoffrey Michael,0,0,34,34
1655998838924,MATH 109,A03,093478,Staff,1,0,34,33
1655998838924,MATH 109,B01,083215,Ganzberger; Geoffrey Michael,2,0,32,30
1655998838924,MATH 109,B02,083216,Ganzberger; Geoffrey Michael,0,0,32,32
1655998838924,MATH 109,B03,093479,Staff,4,0,32,28
1655998844969,MATH 142A,A01,083219,Chow; Bennett,0,0,32,32
1655998844969,MATH 142A,A02,083220,Chow; Bennett,7,0,32,25
1655998844969,MATH 142A,A03,093480,Staff,4,0,32,28
1655998844969,MATH 142A,B03,093481,Staff,3,0,32,29
1655998844969,MATH 142A,B04,093558,Staff,6,0,32,26
1655998844969,MATH 142A,B05,093559,Staff,0,0,32,32
1655998850995,MATH 193A,A01,083224,Rotar; Vladimir,1,1,34,33
1655998850995,MATH 193A,A02,083225,Rotar; Vladimir,0,0,34,34
1655998850995,MATH 193A,A03,083781,Rotar; Vladimir,2,0,34,32
1655998850995,MATH 193A,A04,083782,Rotar; Vladimir,3,0,34,31
1655998850995,MATH 193A,A05,093482,Rotar; Vladimir,0,0,34,34
1655998857023,MATH 197,001,091859,McAuley; Julian John,9999,0,9999,0
1655998857023,MATH 197,002,095566,Kedlaya; Kiran S.,9997,0,9999,2
1655998857023,MATH 197,003,095567,Xiao; Ming,9999,0,9999,0
1655998857023,MATH 197,004,095571,Perols; Johan Lars,9998,0,9999,1
1655998864093,COGS 9,A01,083615,Shannon; Kyle Michael,3,1,75,72
1655998870119,COGS 11,A01,083617,Boyle; Mary E. T.,11,1,48,37
1655998876152,COGS 13,A01,083071,Bastos; Amalia Pinkusfeld,3,2,71,68
1655998882182,COGS 14A,A01,092681,Semenuks; Arturs,4,25,100,96
1655998888205,COGS 14B,A01,083073,Cheng; Tzu-Han,7,0,63,56
1655998894240,COGS 17,A01,092677,Semenuks; Arturs,8,7,81,73
1655998900271,COGS 100,A01,083619,Allen; Michael Gordon,2,2,70,68
1655998906297,COGS 101A,A01,083621,Davis; Joshua Daniel,4,3,68,64
1655998912321,COGS 101B,A01,091572,Allen; Michael Gordon,0,0,65,65
1655998918355,COGS 101C,A01,083625,Delgado; Tania,7,0,35,28
1655998924393,COGS 107A,A01,083627,Boyle; Mary E. T.,1,2,60,59
1655998930441,COGS 118A,A01,083075,Gupta; Anjum,21,16,76,55
1655998936480,CSE 3,A50,083646,Miranda; Gregory Joseph,14,0,50,36
1655998942509,CSE 8A,A50,083650,Miranda; Gregory Joseph,3,11,56,53
1655998948534,CSE 11,A01,083080,Cao; Yingjun,0,65,40,40
1655998954562,CSE 12,A01,083652,Krause-Levy; Sophia Louisa,6,8,120,114
1655998960597,CSE 15L,A01,083654,Morris; Justin Loren,3,1,50,47
1655998960597,CSE 15L,A02,083655,Morris; Justin Loren,1,1,50,49
1655998966640,CSE 20,A01,083657,Tran; Khoa Dang,29,0,80,51
1655998972667,CSE 21,A01,095574,Bach; Quang Tran,23,0,48,25
1655998978698,CSE 30,A01,083084,Eldon; John,2,10,80,78
1655998978698,CSE 30,B01,095061,Bhaskar; Nishant,0,4,50,50
1655998984731,CSE 100,A01,083659,Cao; Yingjun,2,25,70,68
1655998990766,CSE 134B,A01,083661,Powell; Thomas Allan,6,7,100,94
1655998996793,CSE 140,A01,083663,Gungor; Onat,5,0,85,80
1655999002821,CSE 140L,A01,083088,Eldon; John,5,0,100,95
1655999008847,CSE 175,A01,083665,Kumar; Rakesh,1,0,25,24
1655999014871,CSE 190,A00,092507,Dubnov; Shlomo,1,0,20,19
1655999020894,ECE 45,A01,083139,Congero; Spencer William,0,1,75,75
1655999026924,ECE 65,A50,083695,Saad; Andrew S,6,0,30,24
1655999026924,ECE 65,A51,095125,Staff,23,0,26,3
1655999032952,ECE 109,A01,091882,Touri; Behrouz,2,4,70,68
1655999038976,ECE 180,A00,083140,Abi Samra; Nicholas Camill,1,0,30,29
1655999038976,ECE 180,B00,083141,Abi Samra; Nicholas Camill,0,8,28,28
1655999045022,MATH 10A,A01,083735,Patchell; Gregory David,0,0,30,30
1655999045022,MATH 10A,A02,083736,Patchell; Gregory David,21,0,30,9
1655999045022,MATH 10A,A03,083737,Patchell; Gregory David,16,0,30,14
1655999051046,MATH 10B,A01,083207,Lim; Seonhee,1,1,34,33
1655999051046,MATH 10B,A02,083208,Lim; Seonhee,1,1,35,34
1655999051046,MATH 10B,A03,093472,Staff,1,0,34,33
1655999051046,MATH 10B,B01,083739,Sinha; Shubham,9,0,30,21
1655999057079,MATH 18,A01,083743,Cinel; Cameron Alexander,5,0,30,25
1655999057079,MATH 18,A02,083744,Cinel; Cameron Alexander,11,0,30,19
1655999057079,MATH 18,A03,083745,Cinel; Cameron Alexander,1,0,30,29
1655999057079,MATH 18,B01,083748,Ma; Zilu,2,0,36,34
1655999057079,MATH 18,B02,083749,Ma; Zilu,0,0,36,36
1655999057079,MATH 18,B03,083750,Ma; Zilu,0,0,36,36
1655999057079,MATH 18,B04,083751,Ma; Zilu,0,0,36,36
1655999057079,MATH 18,B05,093473,Staff,0,0,36,36
1655999057079,MATH 18,B06,093474,Staff,1,0,36,35
1655999063102,MATH 20A,A01,083754,Zheng; Zequn,10,0,40,30
1655999069126,MATH 20B,A01,083756,Briones; Jor-el Thomas Caparas,0,1,36,36
1655999069126,MATH 20B,A02,083757,Briones; Jor-el Thomas Caparas,1,0,36,35
1655999069126,MATH 20B,A03,093475,Staff,0,0,36,36
1655999075152,MATH 20C,A01,083760,Briones; Jor-el Thomas Caparas,0,2,35,35
1655999075152,MATH 20C,A02,083761,Briones; Jor-el Thomas Caparas,6,1,35,29
1655999075152,MATH 20C,A03,093476,Staff,0,0,35,35
1655999075152,MATH 20C,B01,083762,Bach; Quang Tran,3,0,30,27
1655999081192,MATH 20D,A01,083765,Tran; Brian Kha,1,0,30,29
1655999081192,MATH 20D,A02,083766,Tran; Brian Kha,0,1,30,30
1655999081192,MATH 20D,A03,083767,Tran; Brian Kha,1,0,30,29
1655999087219,MATH 20E,A01,083771,Ganguly; Soumya,0,1,32,32
1655999087219,MATH 20E,A02,083772,Ganguly; Soumya,1,1,32,31
1655999087219,MATH 20E,B01,083773,Ciotti; Benjamin,14,0,35,21
1655999087219,MATH 20E,B02,083774,Ciotti; Benjamin,12,0,35,23
1655999093253,MATH 103A,A01,083777,Greenfeld; Be'Eri,2,1,36,34
1655999093253,MATH 103A,A02,083778,Greenfeld; Be'Eri,2,0,36,34
1655999093253,MATH 103A,A03,093561,Staff,0,1,36,36
1655999093253,MATH 103A,B01,083779,Greenfeld; Be'Eri,7,1,36,29
1655999093253,MATH 103A,B02,083780,Greenfeld; Be'Eri,0,0,36,36
1655999093253,MATH 103A,B03,093562,Staff,0,0,36,36
1655999099282,MATH 105,A01,085443,Carter; Anne Toulson,4,1,35,31
1655999099282,MATH 105,A02,093477,Staff,8,0,35,27
1655999105322,MATH 109,A01,083213,Ganzberger; Geoffrey Michael,0,1,34,34
1655999105322,MATH 109,A02,083214,Ganzberger; Geoffrey Michael,0,0,34,34
1655999105322,MATH 109,A03,093478,Staff,1,0,34,33
1655999105322,MATH 109,B01,083215,Ganzberger; Geoffrey Michael,2,0,32,30
1655999105322,MATH 109,B02,083216,Ganzberger; Geoffrey Michael,0,0,32,32
1655999105322,MATH 109,B03,093479,Staff,4,0,32,28
1655999111347,MATH 142A,A01,083219,Chow; Bennett,0,0,32,32
1655999111347,MATH 142A,A02,083220,Chow; Bennett,7,0,32,25
1655999111347,MATH 142A,A03,093480,Staff,4,0,32,28
1655999111347,MATH 142A,B03,093481,Staff,3,0,32,29
1655999111347,MATH 142A,B04,093558,Staff,6,0,32,26
1655999111347,MATH 142A,B05,093559,Staff,0,0,32,32
1655999117372,MATH 193A,A01,083224,Rotar; Vladimir,1,1,34,33
1655999117372,MATH 193A,A02,083225,Rotar; Vladimir,0,0,34,34
1655999117372,MATH 193A,A03,083781,Rotar; Vladimir,2,0,34,32
1655999117372,MATH 193A,A04,083782,Rotar; Vladimir,3,0,34,31
1655999117372,MATH 193A,A05,093482,Rotar; Vladimir,0,0,34,34
1655999123419,MATH 197,001,091859,McAuley; Julian John,9999,0,9999,0
1655999123419,MATH 197,002,095566,Kedlaya; Kiran S.,9997,0,9999,2
1655999123419,MATH 197,003,095567,Xiao; Ming,9999,0,9999,0
1655999123419,MATH 197,004,095571,Perols; Johan Lars,9998,0,9999,1
1655999130503,COGS 9,A01,083615,Shannon; Kyle Michael,3,1,75,72
1655999136533,COGS 11,A01,083617,Boyle; Mary E. T.,11,1,48,37
1655999142558,COGS 13,A01,083071,Bastos; Amalia Pinkusfeld,3,2,71,68
1655999148589,COGS 14A,A01,092681,Semenuks; Arturs,4,25,100,96
1655999154625,COGS 14B,A01,083073,Cheng; Tzu-Han,7,0,63,56
1655999160671,COGS 17,A01,092677,Semenuks; Arturs,8,7,81,73
1655999166697,COGS 100,A01,083619,Allen; Michael Gordon,2,2,70,68
1655999172731,COGS 101A,A01,083621,Davis; Joshua Daniel,4,3,68,64
1655999178759,COGS 101B,A01,091572,Allen; Michael Gordon,0,0,65,65
1655999184795,COGS 101C,A01,083625,Delgado; Tania,7,0,35,28
1655999190841,COGS 107A,A01,083627,Boyle; Mary E. T.,1,2,60,59
1655999196885,COGS 118A,A01,083075,Gupta; Anjum,21,16,76,55
1655999203012,CSE 3,A50,083646,Miranda; Gregory Joseph,14,0,50,36
1655999209050,CSE 8A,A50,083650,Miranda; Gregory Joseph,3,11,56,53
1655999215076,CSE 11,A01,083080,Cao; Yingjun,0,65,40,40
1655999221100,CSE 12,A01,083652,Krause-Levy; Sophia Louisa,6,8,120,114
1655999227147,CSE 15L,A01,083654,Morris; Justin Loren,3,1,50,47
1655999227147,CSE 15L,A02,083655,Morris; Justin Loren,1,1,50,49
1655999233189,CSE 20,A01,083657,Tran; Khoa Dang,29,0,80,51
1655999239231,CSE 21,A01,095574,Bach; Quang Tran,23,0,48,25
1655999245268,CSE 30,A01,083084,Eldon; John,2,10,80,78
1655999245268,CSE 30,B01,095061,Bhaskar; Nishant,0,4,50,50
1655999251301,CSE 100,A01,083659,Cao; Yingjun,2,25,70,68
1655999257346,CSE 134B,A01,083661,Powell; Thomas Allan,6,7,100,94
1655999263397,CSE 140,A01,083663,Gungor; Onat,5,0,85,80
1655999269420,CSE 140L,A01,083088,Eldon; John,5,0,100,95
1655999275464,CSE 175,A01,083665,Kumar; Rakesh,1,0,25,24
1655999281486,CSE 190,A00,092507,Dubnov; Shlomo,1,0,20,19
1655999287514,ECE 45,A01,083139,Congero; Spencer William,0,1,75,75
1655999293550,ECE 65,A50,083695,Saad; Andrew S,6,0,30,24
1655999293550,ECE 65,A51,095125,Staff,23,0,26,3
1655999299578,ECE 109,A01,091882,Touri; Behrouz,2,4,70,68
1655999305611,ECE 180,A00,083140,Abi Samra; Nicholas Camill,1,0,30,29
1655999305611,ECE 180,B00,083141,Abi Samra; Nicholas Camill,0,8,28,28
1655999311637,MATH 10A,A01,083735,Patchell; Gregory David,0,0,30,30
1655999311637,MATH 10A,A02,083736,Patchell; Gregory David,21,0,30,9
1655999311637,MATH 10A,A03,083737,Patchell; Gregory David,16,0,30,14
1655999317679,MATH 10B,A01,083207,Lim; Seonhee,1,1,34,33
1655999317679,MATH 10B,A02,083208,Lim; Seonhee,1,1,35,34
1655999317679,MATH 10B,A03,093472,Staff,1,0,34,33
1655999317679,MATH 10B,B01,083739,Sinha; Shubham,9,0,30,21
1655999323714,MATH 18,A01,083743,Cinel; Cameron Alexander,5,0,30,25
1655999323714,MATH 18,A02,083744,Cinel; Cameron Alexander,11,0,30,19
1655999323714,MATH 18,A03,083745,Cinel; Cameron Alexander,1,0,30,29
1655999323714,MATH 18,B01,083748,Ma; Zilu,2,0,36,34
1655999323714,MATH 18,B02,083749,Ma; Zilu,0,0,36,36
1655999323714,MATH 18,B03,083750,Ma; Zilu,0,0,36,36
1655999323714,MATH 18,B04,083751,Ma; Zilu,0,0,36,36
1655999323714,MATH 18,B05,093473,Staff,0,0,36,36
1655999323714,MATH 18,B06,093474,Staff,1,0,36,35
1655999329764,MATH 20A,A01,083754,Zheng; Zequn,10,0,40,30
1655999335806,MATH 20B,A01,083756,Briones; Jor-el Thomas Caparas,0,1,36,36
1655999335806,MATH 20B,A02,083757,Briones; Jor-el Thomas Caparas,1,0,36,35
1655999335806,MATH 20B,A03,093475,Staff,0,0,36,36
1655999341828,MATH 20C,A01,083760,Briones; Jor-el Thomas Caparas,0,2,35,35
1655999341828,MATH 20C,A02,083761,Briones; Jor-el Thomas Caparas,6,1,35,29
1655999341828,MATH 20C,A03,093476,Staff,0,0,35,35
1655999341828,MATH 20C,B01,083762,Bach; Quang Tran,3,0,30,27
1655999347857,MATH 20D,A01,083765,Tran; Brian Kha,1,0,30,29
1655999347857,MATH 20D,A02,083766,Tran; Brian Kha,0,1,30,30
1655999347857,MATH 20D,A03,083767,Tran; Brian Kha,1,0,30,29
1655999353887,MATH 20E,A01,083771,Ganguly; Soumya,0,1,32,32
1655999353887,MATH 20E,A02,083772,Ganguly; Soumya,1,1,32,31
1655999353887,MATH 20E,B01,083773,Ciotti; Benjamin,14,0,35,21
1655999353887,MATH 20E,B02,083774,Ciotti; Benjamin,12,0,35,23
1655999359931,MATH 103A,A01,083777,Greenfeld; Be'Eri,2,1,36,34
1655999359931,MATH 103A,A02,083778,Greenfeld; Be'Eri,2,0,36,34
1655999359931,MATH 103A,A03,093561,Staff,0,1,36,36
1655999359931,MATH 103A,B01,083779,Greenfeld; Be'Eri,7,1,36,29
1655999359931,MATH 103A,B02,083780,Greenfeld; Be'Eri,0,0,36,36
1655999359931,MATH 103A,B03,093562,Staff,0,0,36,36
1655999365967,MATH 105,A01,085443,Carter; Anne Toulson,4,1,35,31
1655999365967,MATH 105,A02,093477,Staff,8,0,35,27
1655999371993,MATH 109,A01,083213,Ganzberger; Geoffrey Michael,0,1,34,34
1655999371993,MATH 109,A02,083214,Ganzberger; Geoffrey Michael,0,0,34,34
1655999371993,MATH 109,A03,093478,Staff,1,0,34,33
1655999371993,MATH 109,B01,083215,Ganzberger; Geoffrey Michael,2,0,32,30
1655999371993,MATH 109,B02,083216,Ganzberger; Geoffrey Michael,0,0,32,32
1655999371993,MATH 109,B03,093479,Staff,4,0,32,28
1655999378031,MATH 142A,A01,083219,Chow; Bennett,0,0,32,32
1655999378031,MATH 142A,A02,083220,Chow; Bennett,7,0,32,25
1655999378031,MATH 142A,A03,093480,Staff,4,0,32,28
1655999378031,MATH 142A,B03,093481,Staff,3,0,32,29
1655999378031,MATH 142A,B04,093558,Staff,6,0,32,26
1655999378031,MATH 142A,B05,093559,Staff,0,0,32,32
1655999384067,MATH 193A,A01,083224,Rotar; Vladimir,1,1,34,33
1655999384067,MATH 193A,A02,083225,Rotar; Vladimir,0,0,34,34
1655999384067,MATH 193A,A03,083781,Rotar; Vladimir,2,0,34,32
1655999384067,MATH 193A,A04,083782,Rotar; Vladimir,3,0,34,31
1655999384067,MATH 193A,A05,093482,Rotar; Vladimir,0,0,34,34
1655999390104,MATH 197,001,091859,McAuley; Julian John,9999,0,9999,0
1655999390104,MATH 197,002,095566,Kedlaya; Kiran S.,9997,0,9999,2
1655999390104,MATH 197,003,095567,Xiao; Ming,9999,0,9999,0
1655999390104,MATH 197,004,095571,Perols; Johan Lars,9998,0,9999,1
1655999397188,COGS 9,A01,083615,Shannon; Kyle Michael,3,1,75,72
1655999403220,COGS 11,A01,083617,Boyle; Mary E. T.,11,1,48,37
1655999409256,COGS 13,A01,083071,Bastos; Amalia Pinkusfeld,3,2,71,68
1655999415288,COGS 14A,A01,092681,Semenuks; Arturs,4,25,100,96
1655999421313,COGS 14B,A01,083073,Cheng; Tzu-Han,7,0,63,56
1655999427361,COGS 17,A01,092677,Semenuks; Arturs,8,7,81,73
1655999433387,COGS 100,A01,083619,Allen; Michael Gordon,2,2,70,68
1655999439413,COGS 101A,A01,083621,Davis; Joshua Daniel,4,3,68,64
1655999445449,COGS 101B,A01,091572,Allen; Michael Gordon,0,0,65,65
1655999451481,COGS 101C,A01,083625,Delgado; Tania,7,0,35,28
1655999457518,COGS 107A,A01,083627,Boyle; Mary E. T.,1,2,60,59
1655999463563,COGS 118A,A01,083075,Gupta; Anjum,21,16,76,55
1655999469599,CSE 3,A50,083646,Miranda; Gregory Joseph,14,0,50,36
1655999475627,CSE 8A,A50,083650,Miranda; Gregory Joseph,3,11,56,53
1655999481670,CSE 11,A01,083080,Cao; Yingjun,0,65,40,40
1655999487709,CSE 12,A01,083652,Krause-Levy; Sophia Louisa,6,8,120,114
1655999493764,CSE 15L,A01,083654,Morris; Justin Loren,3,1,50,47
1655999493764,CSE 15L,A02,083655,Morris; Justin Loren,1,1,50,49
1655999499801,CSE 20,A01,083657,Tran; Khoa Dang,29,0,80,51
1655999505827,CSE 21,A01,095574,Bach; Quang Tran,23,0,48,25
1655999511856,CSE 30,A01,083084,Eldon; John,2,10,80,78
1655999511856,CSE 30,B01,095061,Bhaskar; Nishant,0,4,50,50
1655999517882,CSE 100,A01,083659,Cao; Yingjun,2,25,70,68
1655999523912,CSE 134B,A01,083661,Powell; Thomas Allan,6,7,100,94
1655999529946,CSE 140,A01,083663,Gungor; Onat,5,0,85,80
1655999535971,CSE 140L,A01,083088,Eldon; John,5,0,100,95
1655999541997,CSE 175,A01,083665,Kumar; Rakesh,1,0,25,24
1655999548027,CSE 190,A00,092507,Dubnov; Shlomo,1,0,20,19
1655999554053,ECE 45,A01,083139,Congero; Spencer William,0,1,75,75
1655999560085,ECE 65,A50,083695,Saad; Andrew S,6,0,30,24
1655999560085,ECE 65,A51,095125,Staff,23,0,26,3
1655999566110,ECE 109,A01,091882,Touri; Behrouz,2,4,70,68
1655999572143,ECE 180,A00,083140,Abi Samra; Nicholas Camill,1,0,30,29
1655999572143,ECE 180,B00,083141,Abi Samra; Nicholas Camill,0,8,28,28
1655999578179,MATH 10A,A01,083735,Patchell; Gregory David,0,0,30,30
1655999578179,MATH 10A,A02,083736,Patchell; Gregory David,21,0,30,9
1655999578179,MATH 10A,A03,083737,Patchell; Gregory David,16,0,30,14
1655999584209,MATH 10B,A01,083207,Lim; Seonhee,1,1,34,33
1655999584209,MATH 10B,A02,083208,Lim; Seonhee,1,1,35,34
1655999584209,MATH 10B,A03,093472,Staff,1,0,34,33
1655999584209,MATH 10B,B01,083739,Sinha; Shubham,9,0,30,21
1655999590262,MATH 18,A01,083743,Cinel; Cameron Alexander,5,0,30,25
1655999590262,MATH 18,A02,083744,Cinel; Cameron Alexander,11,0,30,19
1655999590262,MATH 18,A03,083745,Cinel; Cameron Alexander,1,0,30,29
1655999590262,MATH 18,B01,083748,Ma; Zilu,2,0,36,34
1655999590262,MATH 18,B02,083749,Ma; Zilu,0,0,36,36
1655999590262,MATH 18,B03,083750,Ma; Zilu,0,0,36,36
1655999590262,MATH 18,B04,083751,Ma; Zilu,0,0,36,36
1655999590262,MATH 18,B05,093473,Staff,0,0,36,36
1655999590262,MATH 18,B06,093474,Staff,1,0,36,35
1655999596295,MATH 20A,A01,083754,Zheng; Zequn,10,0,40,30
1655999602321,MATH 20B,A01,083756,Briones; Jor-el Thomas Caparas,0,1,36,36
1655999602321,MATH 20B,A02,083757,Briones; Jor-el Thomas Caparas,1,0,36,35
1655999602321,MATH 20B,A03,093475,Staff,0,0,36,36
1655999608357,MATH 20C,A01,083760,Briones; Jor-el Thomas Caparas,0,2,35,35
1655999608357,MATH 20C,A02,083761,Briones; Jor-el Thomas Caparas,6,1,35,29
1655999608357,MATH 20C,A03,093476,Staff,0,0,35,35
1655999608357,MATH 20C,B01,083762,Bach; Quang Tran,3,0,30,27
1655999614398,MATH 20D,A01,083765,Tran; Brian Kha,1,0,30,29
1655999614398,MATH 20D,A02,083766,Tran; Brian Kha,0,1,30,30
1655999614398,MATH 20D,A03,083767,Tran; Brian Kha,1,0,30,29
1655999620435,MATH 20E,A01,083771,Ganguly; Soumya,0,1,32,32
1655999620435,MATH 20E,A02,083772,Ganguly; Soumya,1,1,32,31
1655999620435,MATH 20E,B01,083773,Ciotti; Benjamin,14,0,35,21
1655999620435,MATH 20E,B02,083774,Ciotti; Benjamin,12,0,35,23
1655999626473,MATH 103A,A01,083777,Greenfeld; Be'Eri,2,1,36,34
1655999626473,MATH 103A,A02,083778,Greenfeld; Be'Eri,2,0,36,34
1655999626473,MATH 103A,A03,093561,Staff,0,1,36,36
1655999626473,MATH 103A,B01,083779,Greenfeld; Be'Eri,7,1,36,29
1655999626473,MATH 103A,B02,083780,Greenfeld; Be'Eri,0,0,36,36
1655999626473,MATH 103A,B03,093562,Staff,0,0,36,36
1655999632503,MATH 105,A01,085443,Carter; Anne Toulson,4,1,35,31
1655999632503,MATH 105,A02,093477,Staff,8,0,35,27
1655999638527,MATH 109,A01,083213,Ganzberger; Geoffrey Michael,0,1,34,34
1655999638527,MATH 109,A02,083214,Ganzberger; Geoffrey Michael,0,0,34,34
1655999638527,MATH 109,A03,093478,Staff,1,0,34,33
1655999638527,MATH 109,B01,083215,Ganzberger; Geoffrey Michael,2,0,32,30
1655999638527,MATH 109,B02,083216,Ganzberger; Geoffrey Michael,0,0,32,32
1655999638527,MATH 109,B03,093479,Staff,4,0,32,28
1655999644552,MATH 142A,A01,083219,Chow; Bennett,0,0,32,32
1655999644552,MATH 142A,A02,083220,Chow; Bennett,7,0,32,25
1655999644552,MATH 142A,A03,093480,Staff,4,0,32,28
1655999644552,MATH 142A,B03,093481,Staff,3,0,32,29
1655999644552,MATH 142A,B04,093558,Staff,6,0,32,26
1655999644552,MATH 142A,B05,093559,Staff,0,0,32,32
1655999650580,MATH 193A,A01,083224,Rotar; Vladimir,1,1,34,33
1655999650580,MATH 193A,A02,083225,Rotar; Vladimir,0,0,34,34
1655999650580,MATH 193A,A03,083781,Rotar; Vladimir,2,0,34,32
1655999650580,MATH 193A,A04,083782,Rotar; Vladimir,3,0,34,31
1655999650580,MATH 193A,A05,093482,Rotar; Vladimir,0,0,34,34
1655999656623,MATH 197,001,091859,McAuley; Julian John,9999,0,9999,0
1655999656623,MATH 197,002,095566,Kedlaya; Kiran S.,9997,0,9999,2
1655999656623,MATH 197,003,095567,Xiao; Ming,9999,0,9999,0
1655999656623,MATH 197,004,095571,Perols; Johan Lars,9998,0,9999,1
1655999663729,COGS 9,A01,083615,Shannon; Kyle Michael,3,1,75,72
1655999669758,COGS 11,A01,083617,Boyle; Mary E. T.,11,1,48,37
1655999675803,COGS 13,A01,083071,Bastos; Amalia Pinkusfeld,3,2,71,68
1655999681838,COGS 14A,A01,092681,Semenuks; Arturs,4,25,100,96
1655999687868,COGS 14B,A01,083073,Cheng; Tzu-Han,7,0,63,56
1655999693900,COGS 17,A01,092677,Semenuks; Arturs,8,7,81,73
1655999699931,COGS 100,A01,083619,Allen; Michael Gordon,2,2,70,68
1655999705959,COGS 101A,A01,083621,Davis; Joshua Daniel,4,3,68,64
1655999711997,COGS 101B,A01,091572,Allen; Michael Gordon,0,0,65,65
1655999718038,COGS 101C,A01,083625,Delgado; Tania,7,0,35,28
1655999724067,COGS 107A,A01,083627,Boyle; Mary E. T.,1,2,60,59
1655999730098,COGS 118A,A01,083075,Gupta; Anjum,21,16,76,55
1655999736125,CSE 3,A50,083646,Miranda; Gregory Joseph,14,0,50,36
1655999742161,CSE 8A,A50,083650,Miranda; Gregory Joseph,3,11,56,53
1655999748205,CSE 11,A01,083080,Cao; Yingjun,0,65,40,40
1655999754240,CSE 12,A01,083652,Krause-Levy; Sophia Louisa,6,8,120,114
1655999760268,CSE 15L,A01,083654,Morris; Justin Loren,3,1,50,47
1655999760268,CSE 15L,A02,083655,Morris; Justin Loren,1,1,50,49
1655999766293,CSE 20,A01,083657,Tran; Khoa Dang,29,0,80,51
1655999772337,CSE 21,A01,095574,Bach; Quang Tran,23,0,48,25
1655999778398,CSE 30,A01,083084,Eldon; John,2,10,80,78
1655999778398,CSE 30,B01,095061,Bhaskar; Nishant,0,4,50,50
1655999784421,CSE 100,A01,083659,Cao; Yingjun,2,25,70,68
1655999790456,CSE 134B,A01,083661,Powell; Thomas Allan,6,7,100,94
1655999796506,CSE 140,A01,083663,Gungor; Onat,5,0,85,80
1655999802642,CSE 140L,A01,083088,Eldon; John,5,0,100,95
1655999808667,CSE 175,A01,083665,Kumar; Rakesh,1,0,25,24
1655999814730,CSE 190,A00,092507,Dubnov; Shlomo,1,0,20,19
1655999820787,ECE 45,A01,083139,Congero; Spencer William,0,1,75,75
1655999826840,ECE 65,A50,083695,Saad; Andrew S,6,0,30,24
1655999826840,ECE 65,A51,095125,Staff,23,0,26,3
1655999832896,ECE 109,A01,091882,Touri; Behrouz,2,4,70,68
1655999838922,ECE 180,A00,083140,Abi Samra; Nicholas Camill,1,0,30,29
1655999838922,ECE 180,B00,083141,Abi Samra; Nicholas Camill,0,8,28,28
1655999844954,MATH 10A,A01,083735,Patchell; Gregory David,0,0,30,30
1655999844954,MATH 10A,A02,083736,Patchell; Gregory David,21,0,30,9
1655999844954,MATH 10A,A03,083737,Patchell; Gregory David,16,0,30,14
1655999850992,MATH 10B,A01,083207,Lim; Seonhee,1,1,34,33
1655999850992,MATH 10B,A02,083208,Lim; Seonhee,1,1,35,34
1655999850992,MATH 10B,A03,093472,Staff,1,0,34,33
1655999850992,MATH 10B,B01,083739,Sinha; Shubham,9,0,30,21
1655999857038,MATH 18,A01,083743,Cinel; Cameron Alexander,5,0,30,25
1655999857038,MATH 18,A02,083744,Cinel; Cameron Alexander,11,0,30,19
1655999857038,MATH 18,A03,083745,Cinel; Cameron Alexander,1,0,30,29
1655999857038,MATH 18,B01,083748,Ma; Zilu,2,0,36,34
1655999857038,MATH 18,B02,083749,Ma; Zilu,0,0,36,36
1655999857038,MATH 18,B03,083750,Ma; Zilu,0,0,36,36
1655999857038,MATH 18,B04,083751,Ma; Zilu,0,0,36,36
1655999857038,MATH 18,B05,093473,Staff,0,0,36,36
1655999857038,MATH 18,B06,093474,Staff,1,0,36,35
1655999863067,MATH 20A,A01,083754,Zheng; Zequn,10,0,40,30
1655999869118,MATH 20B,A01,083756,Briones; Jor-el Thomas Caparas,0,1,36,36
1655999869118,MATH 20B,A02,083757,Briones; Jor-el Thomas Caparas,1,0,36,35
1655999869118,MATH 20B,A03,093475,Staff,0,0,36,36
1655999875143,MATH 20C,A01,083760,Briones; Jor-el Thomas Caparas,0,2,35,35
1655999875143,MATH 20C,A02,083761,Briones; Jor-el Thomas Caparas,6,1,35,29
1655999875143,MATH 20C,A03,093476,Staff,0,0,35,35
1655999875143,MATH 20C,B01,083762,Bach; Quang Tran,3,0,30,27
1655999881180,MATH 20D,A01,083765,Tran; Brian Kha,1,0,30,29
1655999881180,MATH 20D,A02,083766,Tran; Brian Kha,0,1,30,30
1655999881180,MATH 20D,A03,083767,Tran; Brian Kha,1,0,30,29
1655999887235,MATH 20E,A01,083771,Ganguly; Soumya,0,1,32,32
1655999887235,MATH 20E,A02,083772,Ganguly; Soumya,1,1,32,31
1655999887235,MATH 20E,B01,083773,Ciotti; Benjamin,14,0,35,21
1655999887235,MATH 20E,B02,083774,Ciotti; Benjamin,12,0,35,23
1655999893298,MATH 103A,A01,083777,Greenfeld; Be'Eri,2,1,36,34
1655999893298,MATH 103A,A02,083778,Greenfeld; Be'Eri,2,0,36,34
1655999893298,MATH 103A,A03,093561,Staff,0,1,36,36
1655999893298,MATH 103A,B01,083779,Greenfeld; Be'Eri,7,1,36,29
1655999893298,MATH 103A,B02,083780,Greenfeld; Be'Eri,0,0,36,36
1655999893298,MATH 103A,B03,093562,Staff,0,0,36,36
1655999899329,MATH 105,A01,085443,Carter; Anne Toulson,4,1,35,31
1655999899329,MATH 105,A02,093477,Staff,8,0,35,27
1655999905373,MATH 109,A01,083213,Ganzberger; Geoffrey Michael,0,1,34,34
1655999905373,MATH 109,A02,083214,Ganzberger; Geoffrey Michael,0,0,34,34
1655999905373,MATH 109,A03,093478,Staff,1,0,34,33
1655999905373,MATH 109,B01,083215,Ganzberger; Geoffrey Michael,2,0,32,30
1655999905373,MATH 109,B02,083216,Ganzberger; Geoffrey Michael,0,0,32,32
1655999905373,MATH 109,B03,093479,Staff,4,0,32,28
1655999911399,MATH 142A,A01,083219,Chow; Bennett,0,0,32,32
1655999911399,MATH 142A,A02,083220,Chow; Bennett,7,0,32,25
1655999911399,MATH 142A,A03,093480,Staff,4,0,32,28
1655999911399,MATH 142A,B03,093481,Staff,3,0,32,29
1655999911399,MATH 142A,B04,093558,Staff,6,0,32,26
1655999911399,MATH 142A,B05,093559,Staff,0,0,32,32
1655999917426,MATH 193A,A01,083224,Rotar; Vladimir,1,1,34,33
1655999917426,MATH 193A,A02,083225,Rotar; Vladimir,0,0,34,34
1655999917426,MATH 193A,A03,083781,Rotar; Vladimir,2,0,34,32
1655999917426,MATH 193A,A04,083782,Rotar; Vladimir,3,0,34,31
1655999917426,MATH 193A,A05,093482,Rotar; Vladimir,0,0,34,34
1655999923473,MATH 197,001,091859,McAuley; Julian John,9999,0,9999,0
1655999923473,MATH 197,002,095566,Kedlaya; Kiran S.,9997,0,9999,2
1655999923473,MATH 197,003,095567,Xiao; Ming,9999,0,9999,0
1655999923473,MATH 197,004,095571,Perols; Johan Lars,9998,0,9999,1
1655999930544,COGS 9,A01,083615,Shannon; Kyle Michael,3,1,75,72
1655999936584,COGS 11,A01,083617,Boyle; Mary E. T.,11,1,48,37
1655999942613,COGS 13,A01,083071,Bastos; Amalia Pinkusfeld,3,2,71,68
1655999948640,COGS 14A,A01,092681,Semenuks; Arturs,4,25,100,96
1655999954680,COGS 14B,A01,083073,Cheng; Tzu-Han,7,0,63,56
1655999960720,COGS 17,A01,092677,Semenuks; Arturs,8,7,81,73
1655999966753,COGS 100,A01,083619,Allen; Michael Gordon,2,2,70,68
1655999972808,COGS 101A,A01,083621,Davis; Joshua Daniel,4,3,68,64
1655999978838,COGS 101B,A01,091572,Allen; Michael Gordon,0,0,65,65
1655999984868,COGS 101C,A01,083625,Delgado; Tania,7,0,35,28
1655999990895,COGS 107A,A01,083627,Boyle; Mary E. T.,1,2,60,59
1655999996940,COGS 118A,A01,083075,Gupta; Anjum,21,16,76,55
1656000002973,CSE 3,A50,083646,Miranda; Gregory Joseph,14,0,50,36
1656000009015,CSE 8A,A50,083650,Miranda; Gregory Joseph,3,11,56,53
1656000015040,CSE 11,A01,083080,Cao; Yingjun,0,65,40,40
1656000021081,CSE 12,A01,083652,Krause-Levy; Sophia Louisa,6,8,120,114
1656000027127,CSE 15L,A01,083654,Morris; Justin Loren,3,1,50,47
1656000027127,CSE 15L,A02,083655,Morris; Justin Loren,1,1,50,49
1656000033159,CSE 20,A01,083657,Tran; Khoa Dang,29,0,80,51
1656000039196,CSE 21,A01,095574,Bach; Quang Tran,23,0,48,25
1656000045223,CSE 30,A01,083084,Eldon; John,2,10,80,78
1656000045223,CSE 30,B01,095061,Bhaskar; Nishant,0,4,50,50
1656000051265,CSE 100,A01,083659,Cao; Yingjun,2,25,70,68
1656000057310,CSE 134B,A01,083661,Powell; Thomas Allan,6,7,100,94
1656000063335,CSE 140,A01,083663,Gungor; Onat,5,0,85,80
1656000069359,CSE 140L,A01,083088,Eldon; John,5,0,100,95
1656000075403,CSE 175,A01,083665,Kumar; Rakesh,1,0,25,24
1656000081451,CSE 190,A00,092507,Dubnov; Shlomo,1,0,20,19
1656000087479,ECE 45,A01,083139,Congero; Spencer William,0,1,75,75
1656000093504,ECE 65,A50,083695,Saad; Andrew S,6,0,30,24
1656000093504,ECE 65,A51,095125,Staff,23,0,26,3
1656000099546,ECE 109,A01,091882,Touri; Behrouz,2,4,70,68
1656000105570,ECE 180,A00,083140,Abi Samra; Nicholas Camill,1,0,30,29
1656000105570,ECE 180,B00,083141,Abi Samra; Nicholas Camill,0,8,28,28
1656000111602,MATH 10A,A01,083735,Patchell; Gregory David,0,0,30,30
1656000111602,MATH 10A,A02,083736,Patchell; Gregory David,21,0,30,9
1656000111602,MATH 10A,A03,083737,Patchell; Gregory David,16,0,30,14
1656000117647,MATH 10B,A01,083207,Lim; Seonhee,1,1,34,33
1656000117647,MATH 10B,A02,083208,Lim; Seonhee,1,1,35,34
1656000117647,MATH 10B,A03,093472,Staff,1,0,34,33
1656000117647,MATH 10B,B01,083739,Sinha; Shubham,9,0,30,21
1656000123677,MATH 18,A01,083743,Cinel; Cameron Alexander,5,0,30,25
1656000123677,MATH 18,A02,083744,Cinel; Cameron Alexander,11,0,30,19
1656000123677,MATH 18,A03,083745,Cinel; Cameron Alexander,1,0,30,29
1656000123677,MATH 18,B01,083748,Ma; Zilu,2,0,36,34
1656000123677,MATH 18,B02,083749,Ma; Zilu,0,0,36,36
1656000123677,MATH 18,B03,083750,Ma; Zilu,0,0,36,36
1656000123677,MATH 18,B04,083751,Ma; Zilu,0,0,36,36
1656000123677,MATH 18,B05,093473,Staff,0,0,36,36
1656000123677,MATH 18,B06,093474,Staff,1,0,36,35
1656000129706,MATH 20A,A01,083754,Zheng; Zequn,10,0,40,30
1656000135747,MATH 20B,A01,083756,Briones; Jor-el Thomas Caparas,0,1,36,36
1656000135747,MATH 20B,A02,083757,Briones; Jor-el Thomas Caparas,1,0,36,35
1656000135747,MATH 20B,A03,093475,Staff,0,0,36,36
1656000141780,MATH 20C,A01,083760,Briones; Jor-el Thomas Caparas,0,2,35,35
1656000141780,MATH 20C,A02,083761,Briones; Jor-el Thomas Caparas,6,1,35,29
1656000141780,MATH 20C,A03,093476,Staff,0,0,35,35
1656000141780,MATH 20C,B01,083762,Bach; Quang Tran,3,0,30,27
1656000147813,MATH 20D,A01,083765,Tran; Brian Kha,1,0,30,29
1656000147813,MATH 20D,A02,083766,Tran; Brian Kha,0,1,30,30
1656000147813,MATH 20D,A03,083767,Tran; Brian Kha,1,0,30,29
1656000153855,MATH 20E,A01,083771,Ganguly; Soumya,0,1,32,32
1656000153855,MATH 20E,A02,083772,Ganguly; Soumya,1,1,32,31
1656000153855,MATH 20E,B01,083773,Ciotti; Benjamin,14,0,35,21
1656000153855,MATH 20E,B02,083774,Ciotti; Benjamin,12,0,35,23
1656000159886,MATH 103A,A01,083777,Greenfeld; Be'Eri,2,1,36,34
1656000159886,MATH 103A,A02,083778,Greenfeld; Be'Eri,2,0,36,34
1656000159886,MATH 103A,A03,093561,Staff,0,1,36,36
1656000159886,MATH 103A,B01,083779,Greenfeld; Be'Eri,7,1,36,29
1656000159886,MATH 103A,B02,083780,Greenfeld; Be'Eri,0,0,36,36
1656000159886,MATH 103A,B03,093562,Staff,0,0,36,36
1656000165924,MATH 105,A01,085443,Carter; Anne Toulson,4,1,35,31
1656000165924,MATH 105,A02,093477,Staff,8,0,35,27
1656000171955,MATH 109,A01,083213,Ganzberger; Geoffrey Michael,0,1,34,34
1656000171955,MATH 109,A02,083214,Ganzberger; Geoffrey Michael,0,0,34,34
1656000171955,MATH 109,A03,093478,Staff,1,0,34,33
1656000171955,MATH 109,B01,083215,Ganzberger; Geoffrey Michael,2,0,32,30
1656000171955,MATH 109,B02,083216,Ganzberger; Geoffrey Michael,0,0,32,32
1656000171955,MATH 109,B03,093479,Staff,4,0,32,28
1656000177994,MATH 142A,A01,083219,Chow; Bennett,0,0,32,32
1656000177994,MATH 142A,A02,083220,Chow; Bennett,7,0,32,25
1656000177994,MATH 142A,A03,093480,Staff,4,0,32,28
1656000177994,MATH 142A,B03,093481,Staff,3,0,32,29
1656000177994,MATH 142A,B04,093558,Staff,6,0,32,26
1656000177994,MATH 142A,B05,093559,Staff,0,0,32,32
1656000184026,MATH 193A,A01,083224,Rotar; Vladimir,1,1,34,33
1656000184026,MATH 193A,A02,083225,Rotar; Vladimir,0,0,34,34
1656000184026,MATH 193A,A03,083781,Rotar; Vladimir,2,0,34,32
1656000184026,MATH 193A,A04,083782,Rotar; Vladimir,3,0,34,31
1656000184026,MATH 193A,A05,093482,Rotar; Vladimir,0,0,34,34
1656000190051,MATH 197,001,091859,McAuley; Julian John,9999,0,9999,0
1656000190051,MATH 197,002,095566,Kedlaya; Kiran S.,9997,0,9999,2
1656000190051,MATH 197,003,095567,Xiao; Ming,9999,0,9999,0
1656000190051,MATH 197,004,095571,Perols; Johan Lars,9998,0,9999,1
1656000197131,COGS 9,A01,083615,Shannon; Kyle Michael,3,1,75,72
1656000203161,COGS 11,A01,083617,Boyle; Mary E. T.,11,1,48,37
1656000209191,COGS 13,A01,083071,Bastos; Amalia Pinkusfeld,3,2,71,68
1656000215214,COGS 14A,A01,092681,Semenuks; Arturs,4,25,100,96
1656000221245,COGS 14B,A01,083073,Cheng; Tzu-Han,7,0,63,56
1656000227271,COGS 17,A01,092677,Semenuks; Arturs,8,7,81,73
1656000233300,COGS 100,A01,083619,Allen; Michael Gordon,2,2,70,68
1656000239338,COGS 101A,A01,083621,Davis; Joshua Daniel,4,3,68,64
1656000245370,COGS 101B,A01,091572,Allen; Michael Gordon,0,0,65,65
1656000251398,COGS 101C,A01,083625,Delgado; Tania,7,0,35,28
1656000257441,COGS 107A,A01,083627,Boyle; Mary E. T.,1,2,60,59
1656000263492,COGS 118A,A01,083075,Gupta; Anjum,21,16,76,55
1656000269528,CSE 3,A50,083646,Miranda; Gregory Joseph,14,0,50,36
1656000275553,CSE 8A,A50,083650,Miranda; Gregory Joseph,3,11,56,53
1656000281581,CSE 11,A01,083080,Cao; Yingjun,0,65,40,40
1656000287605,CSE 12,A01,083652,Krause-Levy; Sophia Louisa,6,8,120,114
1656000293637,CSE 15L,A01,083654,Morris; Justin Loren,3,1,50,47
1656000293637,CSE 15L,A02,083655,Morris; Justin Loren,1,1,50,49
1656000299672,CSE 20,A01,083657,Tran; Khoa Dang,29,0,80,51
1656000305698,CSE 21,A01,095574,Bach; Quang Tran,23,0,48,25
1656000311734,CSE 30,A01,083084,Eldon; John,2,10,80,78
1656000311734,CSE 30,B01,095061,Bhaskar; Nishant,0,4,50,50
1656000317765,CSE 100,A01,083659,Cao; Yingjun,2,25,70,68
1656000323789,CSE 134B,A01,083661,Powell; Thomas Allan,6,7,100,94
1656000329814,CSE 140,A01,083663,Gungor; Onat,5,0,85,80
1656000335855,CSE 140L,A01,083088,Eldon; John,5,0,100,95
1656000341882,CSE 175,A01,083665,Kumar; Rakesh,1,0,25,24
1656000347913,CSE 190,A00,092507,Dubnov; Shlomo,1,0,20,19
1656000353940,ECE 45,A01,083139,Congero; Spencer William,0,1,75,75
1656000359983,ECE 65,A50,083695,Saad; Andrew S,6,0,30,24
1656000359983,ECE 65,A51,095125,Staff,23,0,26,3
1656000366011,ECE 109,A01,091882,Touri; Behrouz,2,4,70,68
1656000372049,ECE 180,A00,083140,Abi Samra; Nicholas Camill,1,0,30,29
1656000372049,ECE 180,B00,083141,Abi Samra; Nicholas Camill,0,8,28,28
1656000378083,MATH 10A,A01,083735,Patchell; Gregory David,0,0,30,30
1656000378083,MATH 10A,A02,083736,Patchell; Gregory David,21,0,30,9
1656000378083,MATH 10A,A03,083737,Patchell; Gregory David,16,0,30,14
1656000384130,MATH 10B,A01,083207,Lim; Seonhee,1,1,34,33
1656000384130,MATH 10B,A02,083208,Lim; Seonhee,1,1,35,34
1656000384130,MATH 10B,A03,093472,Staff,1,0,34,33
1656000384130,MATH 10B,B01,083739,Sinha; Shubham,9,0,30,21
1656000390167,MATH 18,A01,083743,Cinel; Cameron Alexander,5,0,30,25
1656000390167,MATH 18,A02,083744,Cinel; Cameron Alexander,11,0,30,19
1656000390167,MATH 18,A03,083745,Cinel; Cameron Alexander,1,0,30,29
1656000390167,MATH 18,B01,083748,Ma; Zilu,2,0,36,34
1656000390167,MATH 18,B02,083749,Ma; Zilu,0,0,36,36
1656000390167,MATH 18,B03,083750,Ma; Zilu,0,0,36,36
1656000390167,MATH 18,B04,083751,Ma; Zilu,0,0,36,36
1656000390167,MATH 18,B05,093473,Staff,0,0,36,36
1656000390167,MATH 18,B06,093474,Staff,1,0,36,35
1656000396217,MATH 20A,A01,083754,Zheng; Zequn,10,0,40,30
1656000402361,MATH 20B,A01,083756,Briones; Jor-el Thomas Caparas,0,1,36,36
1656000402361,MATH 20B,A02,083757,Briones; Jor-el Thomas Caparas,1,0,36,35
1656000402361,MATH 20B,A03,093475,Staff,0,0,36,36
1656000408397,MATH 20C,A01,083760,Briones; Jor-el Thomas Caparas,0,2,35,35
1656000408397,MATH 20C,A02,083761,Briones; Jor-el Thomas Caparas,6,1,35,29
1656000408397,MATH 20C,A03,093476,Staff,0,0,35,35
1656000408397,MATH 20C,B01,083762,Bach; Quang Tran,3,0,30,27
1656000414432,MATH 20D,A01,083765,Tran; Brian Kha,1,0,30,29
1656000414432,MATH 20D,A02,083766,Tran; Brian Kha,0,1,30,30
1656000414432,MATH 20D,A03,083767,Tran; Brian Kha,1,0,30,29
1656000420459,MATH 20E,A01,083771,Ganguly; Soumya,0,1,32,32
1656000420459,MATH 20E,A02,083772,Ganguly; Soumya,1,1,32,31
1656000420459,MATH 20E,B01,083773,Ciotti; Benjamin,14,0,35,21
1656000420459,MATH 20E,B02,083774,Ciotti; Benjamin,12,0,35,23
1656000426494,MATH 103A,A01,083777,Greenfeld; Be'Eri,2,1,36,34
1656000426494,MATH 103A,A02,083778,Greenfeld; Be'Eri,2,0,36,34
1656000426494,MATH 103A,A03,093561,Staff,0,1,36,36
1656000426494,MATH 103A,B01,083779,Greenfeld; Be'Eri,7,1,36,29
1656000426494,MATH 103A,B02,083780,Greenfeld; Be'Eri,0,0,36,36
1656000426494,MATH 103A,B03,093562,Staff,0,0,36,36
1656000432528,MATH 105,A01,085443,Carter; Anne Toulson,4,1,35,31
1656000432528,MATH 105,A02,093477,Staff,8,0,35,27
1656000438554,MATH 109,A01,083213,Ganzberger; Geoffrey Michael,0,1,34,34
1656000438554,MATH 109,A02,083214,Ganzberger; Geoffrey Michael,0,0,34,34
1656000438554,MATH 109,A03,093478,Staff,1,0,34,33
1656000438554,MATH 109,B01,083215,Ganzberger; Geoffrey Michael,2,0,32,30
1656000438554,MATH 109,B02,083216,Ganzberger; Geoffrey Michael,0,0,32,32
1656000438554,MATH 109,B03,093479,Staff,4,0,32,28
1656000444587,MATH 142A,A01,083219,Chow; Bennett,0,0,32,32
1656000444587,MATH 142A,A02,083220,Chow; Bennett,7,0,32,25
1656000444587,MATH 142A,A03,093480,Staff,4,0,32,28
1656000444587,MATH 142A,B03,093481,Staff,3,0,32,29
1656000444587,MATH 142A,B04,093558,Staff,6,0,32,26
1656000444587,MATH 142A,B05,093559,Staff,0,0,32,32
1656000450630,MATH 193A,A01,083224,Rotar; Vladimir,1,1,34,33
1656000450630,MATH 193A,A02,083225,Rotar; Vladimir,0,0,34,34
1656000450630,MATH 193A,A03,083781,Rotar; Vladimir,2,0,34,32
1656000450630,MATH 193A,A04,083782,Rotar; Vladimir,3,0,34,31
1656000450630,MATH 193A,A05,093482,Rotar; Vladimir,0,0,34,34
1656000456663,MATH 197,001,091859,McAuley; Julian John,9999,0,9999,0
1656000456663,MATH 197,002,095566,Kedlaya; Kiran S.,9997,0,9999,2
1656000456663,MATH 197,003,095567,Xiao; Ming,9999,0,9999,0
1656000456663,MATH 197,004,095571,Perols; Johan Lars,9998,0,9999,1
1656000463763,COGS 9,A01,083615,Shannon; Kyle Michael,3,1,75,72
1656000469808,COGS 11,A01,083617,Boyle; Mary E. T.,11,1,48,37
1656000475834,COGS 13,A01,083071,Bastos; Amalia Pinkusfeld,3,2,71,68
1656000481857,COGS 14A,A01,092681,Semenuks; Arturs,4,25,100,96
1656000487885,COGS 14B,A01,083073,Cheng; Tzu-Han,7,0,63,56
1656000493922,COGS 17,A01,092677,Semenuks; Arturs,8,7,81,73
1656000499949,COGS 100,A01,083619,Allen; Michael Gordon,2,2,70,68
1656000505986,COGS 101A,A01,083621,Davis; Joshua Daniel,4,3,68,64
1656000512011,COGS 101B,A01,091572,Allen; Michael Gordon,0,0,65,65
1656000518044,COGS 101C,A01,083625,Delgado; Tania,7,0,35,28
1656000524076,COGS 107A,A01,083627,Boyle; Mary E. T.,1,2,60,59
1656000530109,COGS 118A,A01,083075,Gupta; Anjum,21,16,76,55
1656000536138,CSE 3,A50,083646,Miranda; Gregory Joseph,14,0,50,36
1656000542169,CSE 8A,A50,083650,Miranda; Gregory Joseph,3,11,56,53
1656000548192,CSE 11,A01,083080,Cao; Yingjun,0,65,40,40
1656000554217,CSE 12,A01,083652,Krause-Levy; Sophia Louisa,6,8,120,114
1656000560255,CSE 15L,A01,083654,Morris; Justin Loren,3,1,50,47
1656000560255,CSE 15L,A02,083655,Morris; Justin Loren,1,1,50,49
1656000566284,CSE 20,A01,083657,Tran; Khoa Dang,29,0,80,51
1656000572312,CSE 21,A01,095574,Bach; Quang Tran,23,0,48,25
1656000578348,CSE 30,A01,083084,Eldon; John,2,10,80,78
1656000578348,CSE 30,B01,095061,Bhaskar; Nishant,0,4,50,50
1656000584373,CSE 100,A01,083659,Cao; Yingjun,2,25,70,68
1656000590409,CSE 134B,A01,083661,Powell; Thomas Allan,6,7,100,94
1656000596454,CSE 140,A01,083663,Gungor; Onat,5,0,85,80
1656000602495,CSE 140L,A01,083088,Eldon; John,5,0,100,95
1656000608518,CSE 175,A01,083665,Kumar; Rakesh,1,0,25,24
1656000614545,CSE 190,A00,092507,Dubnov; Shlomo,1,0,20,19
1656000620579,ECE 45,A01,083139,Congero; Spencer William,0,1,75,75
1656000626608,ECE 65,A50,083695,Saad; Andrew S,6,0,30,24
1656000626608,ECE 65,A51,095125,Staff,23,0,26,3
1656000632647,ECE 109,A01,091882,Touri; Behrouz,2,4,70,68
1656000638670,ECE 180,A00,083140,Abi Samra; Nicholas Camill,1,0,30,29
1656000638670,ECE 180,B00,083141,Abi Samra; Nicholas Camill,0,8,28,28
1656000644700,MATH 10A,A01,083735,Patchell; Gregory David,0,0,30,30
1656000644700,MATH 10A,A02,083736,Patchell; Gregory David,21,0,30,9
1656000644700,MATH 10A,A03,083737,Patchell; Gregory David,16,0,30,14
1656000650730,MATH 10B,A01,083207,Lim; Seonhee,1,1,34,33
1656000650730,MATH 10B,A02,083208,Lim; Seonhee,1,1,35,34
1656000650730,MATH 10B,A03,093472,Staff,1,0,34,33
1656000650730,MATH 10B,B01,083739,Sinha; Shubham,9,0,30,21
1656000656773,MATH 18,A01,083743,Cinel; Cameron Alexander,5,0,30,25
1656000656773,MATH 18,A02,083744,Cinel; Cameron Alexander,11,0,30,19
1656000656773,MATH 18,A03,083745,Cinel; Cameron Alexander,1,0,30,29
1656000656773,MATH 18,B01,083748,Ma; Zilu,2,0,36,34
1656000656773,MATH 18,B02,083749,Ma; Zilu,0,0,36,36
1656000656773,MATH 18,B03,083750,Ma; Zilu,0,0,36,36
1656000656773,MATH 18,B04,083751,Ma; Zilu,0,0,36,36
1656000656773,MATH 18,B05,093473,Staff,0,0,36,36
1656000656773,MATH 18,B06,093474,Staff,1,0,36,35
1656000662799,MATH 20A,A01,083754,Zheng; Zequn,10,0,40,30
1656000668823,MATH 20B,A01,083756,Briones; Jor-el Thomas Caparas,0,1,36,36
1656000668823,MATH 20B,A02,083757,Briones; Jor-el Thomas Caparas,1,0,36,35
1656000668823,MATH 20B,A03,093475,Staff,0,0,36,36
1656000674858,MATH 20C,A01,083760,Briones; Jor-el Thomas Caparas,0,2,35,35
1656000674858,MATH 20C,A02,083761,Briones; Jor-el Thomas Caparas,6,1,35,29
1656000674858,MATH 20C,A03,093476,Staff,0,0,35,35
1656000674858,MATH 20C,B01,083762,Bach; Quang Tran,3,0,30,27
1656000680888,MATH 20D,A01,083765,Tran; Brian Kha,1,0,30,29
1656000680888,MATH 20D,A02,083766,Tran; Brian Kha,0,1,30,30
1656000680888,MATH 20D,A03,083767,Tran; Brian Kha,1,0,30,29
1656000686925,MATH 20E,A01,083771,Ganguly; Soumya,0,1,32,32
1656000686925,MATH 20E,A02,083772,Ganguly; Soumya,1,1,32,31
1656000686925,MATH 20E,B01,083773,Ciotti; Benjamin,14,0,35,21
1656000686925,MATH 20E,B02,083774,Ciotti; Benjamin,12,0,35,23
1656000692951,MATH 103A,A01,083777,Greenfeld; Be'Eri,2,1,36,34
1656000692951,MATH 103A,A02,083778,Greenfeld; Be'Eri,2,0,36,34
1656000692951,MATH 103A,A03,093561,Staff,0,1,36,36
1656000692951,MATH 103A,B01,083779,Greenfeld; Be'Eri,7,1,36,29
1656000692951,MATH 103A,B02,083780,Greenfeld; Be'Eri,0,0,36,36
1656000692951,MATH 103A,B03,093562,Staff,0,0,36,36
1656000698981,MATH 105,A01,085443,Carter; Anne Toulson,4,1,35,31
1656000698981,MATH 105,A02,093477,Staff,8,0,35,27
1656000705018,MATH 109,A01,083213,Ganzberger; Geoffrey Michael,0,1,34,34
1656000705018,MATH 109,A02,083214,Ganzberger; Geoffrey Michael,0,0,34,34
1656000705018,MATH 109,A03,093478,Staff,1,0,34,33
1656000705018,MATH 109,B01,083215,Ganzberger; Geoffrey Michael,2,0,32,30
1656000705018,MATH 109,B02,083216,Ganzberger; Geoffrey Michael,0,0,32,32
1656000705018,MATH 109,B03,093479,Staff,4,0,32,28
1656000711050,MATH 142A,A01,083219,Chow; Bennett,0,0,32,32
1656000711050,MATH 142A,A02,083220,Chow; Bennett,7,0,32,25
1656000711050,MATH 142A,A03,093480,Staff,4,0,32,28
1656000711050,MATH 142A,B03,093481,Staff,3,0,32,29
1656000711050,MATH 142A,B04,093558,Staff,6,0,32,26
1656000711050,MATH 142A,B05,093559,Staff,0,0,32,32
1656000717075,MATH 193A,A01,083224,Rotar; Vladimir,1,1,34,33
1656000717075,MATH 193A,A02,083225,Rotar; Vladimir,0,0,34,34
1656000717075,MATH 193A,A03,083781,Rotar; Vladimir,2,0,34,32
1656000717075,MATH 193A,A04,083782,Rotar; Vladimir,3,0,34,31
1656000717075,MATH 193A,A05,093482,Rotar; Vladimir,0,0,34,34
1656000723111,MATH 197,001,091859,McAuley; Julian John,9999,0,9999,0
1656000723111,MATH 197,002,095566,Kedlaya; Kiran S.,9997,0,9999,2
1656000723111,MATH 197,003,095567,Xiao; Ming,9999,0,9999,0
1656000723111,MATH 197,004,095571,Perols; Johan Lars,9998,0,9999,1
1656000730183,COGS 9,A01,083615,Shannon; Kyle Michael,3,1,75,72
1656000736221,COGS 11,A01,083617,Boyle; Mary E. T.,11,1,48,37
1656000742266,COGS 13,A01,083071,Bastos; Amalia Pinkusfeld,3,2,71,68
1656000748291,COGS 14A,A01,092681,Semenuks; Arturs,4,25,100,96
1656000754326,COGS 14B,A01,083073,Cheng; Tzu-Han,7,0,63,56
1656000760353,COGS 17,A01,092677,Semenuks; Arturs,8,7,81,73
1656000766386,COGS 100,A01,083619,Allen; Michael Gordon,2,2,70,68
1656000772409,COGS 101A,A01,083621,Davis; Joshua Daniel,4,3,68,64
1656000778442,COGS 101B,A01,091572,Allen; Michael Gordon,0,0,65,65
1656000784474,COGS 101C,A01,083625,Delgado; Tania,7,0,35,28
1656000790517,COGS 107A,A01,083627,Boyle; Mary E. T.,1,2,60,59
1656000796556,COGS 118A,A01,083075,Gupta; Anjum,21,16,76,55
1656000802585,CSE 3,A50,083646,Miranda; Gregory Joseph,14,0,50,36
1656000808608,CSE 8A,A50,083650,Miranda; Gregory Joseph,3,11,56,53
1656000814637,CSE 11,A01,083080,Cao; Yingjun,0,65,40,40
1656000820681,CSE 12,A01,083652,Krause-Levy; Sophia Louisa,6,8,120,114
1656000826713,CSE 15L,A01,083654,Morris; Justin Loren,3,1,50,47
1656000826713,CSE 15L,A02,083655,Morris; Justin Loren,1,1,50,49
1656000832739,CSE 20,A01,083657,Tran; Khoa Dang,29,0,80,51
1656000838768,CSE 21,A01,095574,Bach; Quang Tran,23,0,48,25
1656000844803,CSE 30,A01,083084,Eldon; John,2,10,80,78
1656000844803,CSE 30,B01,095061,Bhaskar; Nishant,0,4,50,50
1656000850837,CSE 100,A01,083659,Cao; Yingjun,2,25,70,68
1656000856868,CSE 134B,A01,083661,Powell; Thomas Allan,6,7,100,94
1656000862893,CSE 140,A01,083663,Gungor; Onat,5,0,85,80
1656000868928,CSE 140L,A01,083088,Eldon; John,5,0,100,95
1656000874985,CSE 175,A01,083665,Kumar; Rakesh,1,0,25,24
1656000881021,CSE 190,A00,092507,Dubnov; Shlomo,1,0,20,19
1656000887056,ECE 45,A01,083139,Congero; Spencer William,0,1,75,75
1656000893088,ECE 65,A50,083695,Saad; Andrew S,6,0,30,24
1656000893088,ECE 65,A51,095125,Staff,23,0,26,3
1656000899134,ECE 109,A01,091882,Touri; Behrouz,2,4,70,68
1656000905161,ECE 180,A00,083140,Abi Samra; Nicholas Camill,1,0,30,29
1656000905161,ECE 180,B00,083141,Abi Samra; Nicholas Camill,0,8,28,28
1656000911208,MATH 10A,A01,083735,Patchell; Gregory David,0,0,30,30
1656000911208,MATH 10A,A02,083736,Patchell; Gregory David,21,0,30,9
1656000911208,MATH 10A,A03,083737,Patchell; Gregory David,16,0,30,14
1656000917243,MATH 10B,A01,083207,Lim; Seonhee,1,1,34,33
1656000917243,MATH 10B,A02,083208,Lim; Seonhee,1,1,35,34
1656000917243,MATH 10B,A03,093472,Staff,1,0,34,33
1656000917243,MATH 10B,B01,083739,Sinha; Shubham,9,0,30,21
1656000923283,MATH 18,A01,083743,Cinel; Cameron Alexander,5,0,30,25
1656000923283,MATH 18,A02,083744,Cinel; Cameron Alexander,11,0,30,19
1656000923283,MATH 18,A03,083745,Cinel; Cameron Alexander,1,0,30,29
1656000923283,MATH 18,B01,083748,Ma; Zilu,2,0,36,34
1656000923283,MATH 18,B02,083749,Ma; Zilu,0,0,36,36
1656000923283,MATH 18,B03,083750,Ma; Zilu,0,0,36,36
1656000923283,MATH 18,B04,083751,Ma; Zilu,0,0,36,36
1656000923283,MATH 18,B05,093473,Staff,0,0,36,36
1656000923283,MATH 18,B06,093474,Staff,1,0,36,35
1656000929323,MATH 20A,A01,083754,Zheng; Zequn,10,0,40,30
1656000935372,MATH 20B,A01,083756,Briones; Jor-el Thomas Caparas,0,1,36,36
1656000935372,MATH 20B,A02,083757,Briones; Jor-el Thomas Caparas,1,0,36,35
1656000935372,MATH 20B,A03,093475,Staff,0,0,36,36
1656000941403,MATH 20C,A01,083760,Briones; Jor-el Thomas Caparas,0,2,35,35
1656000941403,MATH 20C,A02,083761,Briones; Jor-el Thomas Caparas,6,1,35,29
1656000941403,MATH 20C,A03,093476,Staff,0,0,35,35
1656000941403,MATH 20C,B01,083762,Bach; Quang Tran,3,0,30,27
1656000947427,MATH 20D,A01,083765,Tran; Brian Kha,1,0,30,29
1656000947427,MATH 20D,A02,083766,Tran; Brian Kha,0,1,30,30
1656000947427,MATH 20D,A03,083767,Tran; Brian Kha,1,0,30,29
1656000953454,MATH 20E,A01,083771,Ganguly; Soumya,0,1,32,32
1656000953454,MATH 20E,A02,083772,Ganguly; Soumya,1,1,32,31
1656000953454,MATH 20E,B01,083773,Ciotti; Benjamin,14,0,35,21
1656000953454,MATH 20E,B02,083774,Ciotti; Benjamin,12,0,35,23
1656000959480,MATH 103A,A01,083777,Greenfeld; Be'Eri,2,1,36,34
1656000959480,MATH 103A,A02,083778,Greenfeld; Be'Eri,2,0,36,34
1656000959480,MATH 103A,A03,093561,Staff,0,1,36,36
1656000959480,MATH 103A,B01,083779,Greenfeld; Be'Eri,7,1,36,29
1656000959480,MATH 103A,B02,083780,Greenfeld; Be'Eri,0,0,36,36
1656000959480,MATH 103A,B03,093562,Staff,0,0,36,36
1656000965519,MATH 105,A01,085443,Carter; Anne Toulson,4,1,35,31
1656000965519,MATH 105,A02,093477,Staff,8,0,35,27
1656000971558,MATH 109,A01,083213,Ganzberger; Geoffrey Michael,0,1,34,34
1656000971558,MATH 109,A02,083214,Ganzberger; Geoffrey Michael,0,0,34,34
1656000971558,MATH 109,A03,093478,Staff,1,0,34,33
1656000971558,MATH 109,B01,083215,Ganzberger; Geoffrey Michael,2,0,32,30
1656000971558,MATH 109,B02,083216,Ganzberger; Geoffrey Michael,0,0,32,32
1656000971558,MATH 109,B03,093479,Staff,4,0,32,28
1656000977604,MATH 142A,A01,083219,Chow; Bennett,0,0,32,32
1656000977604,MATH 142A,A02,083220,Chow; Bennett,7,0,32,25
1656000977604,MATH 142A,A03,093480,Staff,4,0,32,28
1656000977604,MATH 142A,B03,093481,Staff,3,0,32,29
1656000977604,MATH 142A,B04,093558,Staff,6,0,32,26
1656000977604,MATH 142A,B05,093559,Staff,0,0,32,32
1656000983637,MATH 193A,A01,083224,Rotar; Vladimir,1,1,34,33
1656000983637,MATH 193A,A02,083225,Rotar; Vladimir,0,0,34,34
1656000983637,MATH 193A,A03,083781,Rotar; Vladimir,2,0,34,32
1656000983637,MATH 193A,A04,083782,Rotar; Vladimir,3,0,34,31
1656000983637,MATH 193A,A05,093482,Rotar; Vladimir,0,0,34,34
1656000989667,MATH 197,001,091859,McAuley; Julian John,9999,0,9999,0
1656000989667,MATH 197,002,095566,Kedlaya; Kiran S.,9997,0,9999,2
1656000989667,MATH 197,003,095567,Xiao; Ming,9999,0,9999,0
1656000989667,MATH 197,004,095571,Perols; Johan Lars,9998,0,9999,1
1656000996813,COGS 9,A01,083615,Shannon; Kyle Michael,3,1,75,72
1656001002843,COGS 11,A01,083617,Boyle; Mary E. T.,11,1,48,37
1656001008888,COGS 13,A01,083071,Bastos; Amalia Pinkusfeld,3,2,71,68
1656001014927,COGS 14A,A01,092681,Semenuks; Arturs,4,25,100,96
1656001020951,COGS 14B,A01,083073,Cheng; Tzu-Han,7,0,63,56
1656001027002,COGS 17,A01,092677,Semenuks; Arturs,8,7,81,73
1656001033045,COGS 100,A01,083619,Allen; Michael Gordon,2,2,70,68
1656001039088,COGS 101A,A01,083621,Davis; Joshua Daniel,4,3,68,64
1656001045111,COGS 101B,A01,091572,Allen; Michael Gordon,0,0,65,65
1656001051135,COGS 101C,A01,083625,Delgado; Tania,7,0,35,28
1656001057168,COGS 107A,A01,083627,Boyle; Mary E. T.,1,2,60,59
1656001063197,COGS 118A,A01,083075,Gupta; Anjum,21,16,76,55
1656001069227,CSE 3,A50,083646,Miranda; Gregory Joseph,14,0,50,36
1656001075251,CSE 8A,A50,083650,Miranda; Gregory Joseph,3,11,56,53
1656001081287,CSE 11,A01,083080,Cao; Yingjun,0,65,40,40
1656001087318,CSE 12,A01,083652,Krause-Levy; Sophia Louisa,6,8,120,114
1656001093362,CSE 15L,A01,083654,Morris; Justin Loren,3,1,50,47
1656001093362,CSE 15L,A02,083655,Morris; Justin Loren,1,1,50,49
1656001099386,CSE 20,A01,083657,Tran; Khoa Dang,29,0,80,51
1656001105419,CSE 21,A01,095574,Bach; Quang Tran,23,0,48,25
1656001111468,CSE 30,A01,083084,Eldon; John,2,10,80,78
1656001111468,CSE 30,B01,095061,Bhaskar; Nishant,0,4,50,50
1656001117505,CSE 100,A01,083659,Cao; Yingjun,2,25,70,68
1656001123533,CSE 134B,A01,083661,Powell; Thomas Allan,6,7,100,94
1656001129568,CSE 140,A01,083663,Gungor; Onat,5,0,85,80
1656001135605,CSE 140L,A01,083088,Eldon; John,5,0,100,95
1656001141633,CSE 175,A01,083665,Kumar; Rakesh,1,0,25,24
1656001147659,CSE 190,A00,092507,Dubnov; Shlomo,1,0,20,19
1656001153697,ECE 45,A01,083139,Congero; Spencer William,0,1,75,75
1656001159728,ECE 65,A50,083695,Saad; Andrew S,6,0,30,24
1656001159728,ECE 65,A51,095125,Staff,23,0,26,3
1656001165758,ECE 109,A01,091882,Touri; Behrouz,2,4,70,68
1656001171781,ECE 180,A00,083140,Abi Samra; Nicholas Camill,1,0,30,29
1656001171781,ECE 180,B00,083141,Abi Samra; Nicholas Camill,0,8,28,28
1656001177812,MATH 10A,A01,083735,Patchell; Gregory David,0,0,30,30
1656001177812,MATH 10A,A02,083736,Patchell; Gregory David,21,0,30,9
1656001177812,MATH 10A,A03,083737,Patchell; Gregory David,16,0,30,14
1656001183847,MATH 10B,A01,083207,Lim; Seonhee,1,1,34,33
1656001183847,MATH 10B,A02,083208,Lim; Seonhee,1,1,35,34
1656001183847,MATH 10B,A03,093472,Staff,1,0,34,33
1656001183847,MATH 10B,B01,083739,Sinha; Shubham,9,0,30,21
1656001189881,MATH 18,A01,083743,Cinel; Cameron Alexander,5,0,30,25
1656001189881,MATH 18,A02,083744,Cinel; Cameron Alexander,11,0,30,19
1656001189881,MATH 18,A03,083745,Cinel; Cameron Alexander,1,0,30,29
1656001189881,MATH 18,B01,083748,Ma; Zilu,2,0,36,34
1656001189881,MATH 18,B02,083749,Ma; Zilu,0,0,36,36
1656001189881,MATH 18,B03,083750,Ma; Zilu,0,0,36,36
1656001189881,MATH 18,B04,083751,Ma; Zilu,0,0,36,36
1656001189881,MATH 18,B05,093473,Staff,0,0,36,36
1656001189881,MATH 18,B06,093474,Staff,1,0,36,35
1656001195908,MATH 20A,A01,083754,Zheng; Zequn,10,0,40,30
1656001201933,MATH 20B,A01,083756,Briones; Jor-el Thomas Caparas,0,1,36,36
1656001201933,MATH 20B,A02,083757,Briones; Jor-el Thomas Caparas,1,0,36,35
1656001201933,MATH 20B,A03,093475,Staff,0,0,36,36
1656001207958,MATH 20C,A01,083760,Briones; Jor-el Thomas Caparas,0,2,35,35
1656001207958,MATH 20C,A02,083761,Briones; Jor-el Thomas Caparas,6,1,35,29
1656001207958,MATH 20C,A03,093476,Staff,0,0,35,35
1656001207958,MATH 20C,B01,083762,Bach; Quang Tran,3,0,30,27
1656001213987,MATH 20D,A01,083765,Tran; Brian Kha,1,0,30,29
1656001213987,MATH 20D,A02,083766,Tran; Brian Kha,0,1,30,30
1656001213987,MATH 20D,A03,083767,Tran; Brian Kha,1,0,30,29
1656001220016,MATH 20E,A01,083771,Ganguly; Soumya,0,1,32,32
1656001220016,MATH 20E,A02,083772,Ganguly; Soumya,1,1,32,31
1656001220016,MATH 20E,B01,083773,Ciotti; Benjamin,14,0,35,21
1656001220016,MATH 20E,B02,083774,Ciotti; Benjamin,12,0,35,23
1656001226066,MATH 103A,A01,083777,Greenfeld; Be'Eri,2,1,36,34
1656001226066,MATH 103A,A02,083778,Greenfeld; Be'Eri,2,0,36,34
1656001226066,MATH 103A,A03,093561,Staff,0,1,36,36
1656001226066,MATH 103A,B01,083779,Greenfeld; Be'Eri,7,1,36,29
1656001226066,MATH 103A,B02,083780,Greenfeld; Be'Eri,0,0,36,36
1656001226066,MATH 103A,B03,093562,Staff,0,0,36,36
1656001232112,MATH 105,A01,085443,Carter; Anne Toulson,4,1,35,31
1656001232112,MATH 105,A02,093477,Staff,8,0,35,27
1656001238134,MATH 109,A01,083213,Ganzberger; Geoffrey Michael,0,1,34,34
1656001238134,MATH 109,A02,083214,Ganzberger; Geoffrey Michael,0,0,34,34
1656001238134,MATH 109,A03,093478,Staff,1,0,34,33
1656001238134,MATH 109,B01,083215,Ganzberger; Geoffrey Michael,2,0,32,30
1656001238134,MATH 109,B02,083216,Ganzberger; Geoffrey Michael,0,0,32,32
1656001238134,MATH 109,B03,093479,Staff,4,0,32,28
1656001244164,MATH 142A,A01,083219,Chow; Bennett,0,0,32,32
1656001244164,MATH 142A,A02,083220,Chow; Bennett,7,0,32,25
1656001244164,MATH 142A,A03,093480,Staff,4,0,32,28
1656001244164,MATH 142A,B03,093481,Staff,3,0,32,29
1656001244164,MATH 142A,B04,093558,Staff,6,0,32,26
1656001244164,MATH 142A,B05,093559,Staff,0,0,32,32
1656001250190,MATH 193A,A01,083224,Rotar; Vladimir,1,1,34,33
1656001250190,MATH 193A,A02,083225,Rotar; Vladimir,0,0,34,34
1656001250190,MATH 193A,A03,083781,Rotar; Vladimir,2,0,34,32
1656001250190,MATH 193A,A04,083782,Rotar; Vladimir,3,0,34,31
1656001250190,MATH 193A,A05,093482,Rotar; Vladimir,0,0,34,34
1656001256218,MATH 197,001,091859,McAuley; Julian John,9999,0,9999,0
1656001256218,MATH 197,002,095566,Kedlaya; Kiran S.,9997,0,9999,2
1656001256218,MATH 197,003,095567,Xiao; Ming,9999,0,9999,0
1656001256218,MATH 197,004,095571,Perols; Johan Lars,9998,0,9999,1
1656001263291,COGS 9,A01,083615,Shannon; Kyle Michael,3,1,75,72
1656001269324,COGS 11,A01,083617,Boyle; Mary E. T.,11,1,48,37
1656001275350,COGS 13,A01,083071,Bastos; Amalia Pinkusfeld,3,2,71,68
1656001281376,COGS 14A,A01,092681,Semenuks; Arturs,4,25,100,96
1656001287419,COGS 14B,A01,083073,Cheng; Tzu-Han,7,0,63,56
1656001293441,COGS 17,A01,092677,Semenuks; Arturs,8,7,81,73
1656001299483,COGS 100,A01,083619,Allen; Michael Gordon,2,2,70,68
1656001305521,COGS 101A,A01,083621,Davis; Joshua Daniel,4,3,68,64
1656001311546,COGS 101B,A01,091572,Allen; Michael Gordon,0,0,65,65
1656001317574,COGS 101C,A01,083625,Delgado; Tania,7,0,35,28
1656001323607,COGS 107A,A01,083627,Boyle; Mary E. T.,1,2,60,59
1656001329631,COGS 118A,A01,083075,Gupta; Anjum,21,16,76,55
1656001335660,CSE 3,A50,083646,Miranda; Gregory Joseph,14,0,50,36
1656001341697,CSE 8A,A50,083650,Miranda; Gregory Joseph,3,11,56,53
1656001347734,CSE 11,A01,083080,Cao; Yingjun,0,65,40,40
1656001353757,CSE 12,A01,083652,Krause-Levy; Sophia Louisa,6,8,120,114
1656001359784,CSE 15L,A01,083654,Morris; Justin Loren,3,1,50,47
1656001359784,CSE 15L,A02,083655,Morris; Justin Loren,1,1,50,49
1656001365823,CSE 20,A01,083657,Tran; Khoa Dang,29,0,80,51
1656001371850,CSE 21,A01,095574,Bach; Quang Tran,23,0,48,25
1656001377897,CSE 30,A01,083084,Eldon; John,2,10,80,78
1656001377897,CSE 30,B01,095061,Bhaskar; Nishant,0,4,50,50
1656001383921,CSE 100,A01,083659,Cao; Yingjun,2,25,70,68
1656001389955,CSE 134B,A01,083661,Powell; Thomas Allan,6,7,100,94
1656001395989,CSE 140,A01,083663,Gungor; Onat,5,0,85,80
1656001402013,CSE 140L,A01,083088,Eldon; John,5,0,100,95
1656001408040,CSE 175,A01,083665,Kumar; Rakesh,1,0,25,24
1656001414065,CSE 190,A00,092507,Dubnov; Shlomo,1,0,20,19
1656001420100,ECE 45,A01,083139,Congero; Spencer William,0,1,75,75
1656001426149,ECE 65,A50,083695,Saad; Andrew S,6,0,30,24
1656001426149,ECE 65,A51,095125,Staff,23,0,26,3
1656001432175,ECE 109,A01,091882,Touri; Behrouz,2,4,70,68
1656001438199,ECE 180,A00,083140,Abi Samra; Nicholas Camill,1,0,30,29
1656001438199,ECE 180,B00,083141,Abi Samra; Nicholas Camill,0,8,28,28
1656001444237,MATH 10A,A01,083735,Patchell; Gregory David,0,0,30,30
1656001444237,MATH 10A,A02,083736,Patchell; Gregory David,21,0,30,9
1656001444237,MATH 10A,A03,083737,Patchell; Gregory David,16,0,30,14
1656001450274,MATH 10B,A01,083207,Lim; Seonhee,1,1,34,33
1656001450274,MATH 10B,A02,083208,Lim; Seonhee,1,1,35,34
1656001450274,MATH 10B,A03,093472,Staff,1,0,34,33
1656001450274,MATH 10B,B01,083739,Sinha; Shubham,9,0,30,21
1656001456314,MATH 18,A01,083743,Cinel; Cameron Alexander,5,0,30,25
1656001456314,MATH 18,A02,083744,Cinel; Cameron Alexander,11,0,30,19
1656001456314,MATH 18,A03,083745,Cinel; Cameron Alexander,1,0,30,29
1656001456314,MATH 18,B01,083748,Ma; Zilu,2,0,36,34
1656001456314,MATH 18,B02,083749,Ma; Zilu,0,0,36,36
1656001456314,MATH 18,B03,083750,Ma; Zilu,0,0,36,36
1656001456314,MATH 18,B04,083751,Ma; Zilu,0,0,36,36
1656001456314,MATH 18,B05,093473,Staff,0,0,36,36
1656001456314,MATH 18,B06,093474,Staff,1,0,36,35
1656001462337,MATH 20A,A01,083754,Zheng; Zequn,10,0,40,30
1656001468362,MATH 20B,A01,083756,Briones; Jor-el Thomas Caparas,0,1,36,36
1656001468362,MATH 20B,A02,083757,Briones; Jor-el Thomas Caparas,1,0,36,35
1656001468362,MATH 20B,A03,093475,Staff,0,0,36,36
1656001474392,MATH 20C,A01,083760,Briones; Jor-el Thomas Caparas,0,2,35,35
1656001474392,MATH 20C,A02,083761,Briones; Jor-el Thomas Caparas,6,1,35,29
1656001474392,MATH 20C,A03,093476,Staff,0,0,35,35
1656001474392,MATH 20C,B01,083762,Bach; Quang Tran,3,0,30,27
1656001480419,MATH 20D,A01,083765,Tran; Brian Kha,1,0,30,29
1656001480419,MATH 20D,A02,083766,Tran; Brian Kha,0,1,30,30
1656001480419,MATH 20D,A03,083767,Tran; Brian Kha,1,0,30,29
1656001486461,MATH 20E,A01,083771,Ganguly; Soumya,0,1,32,32
1656001486461,MATH 20E,A02,083772,Ganguly; Soumya,1,1,32,31
1656001486461,MATH 20E,B01,083773,Ciotti; Benjamin,14,0,35,21
1656001486461,MATH 20E,B02,083774,Ciotti; Benjamin,12,0,35,23
1656001492503,MATH 103A,A01,083777,Greenfeld; Be'Eri,2,1,36,34
1656001492503,MATH 103A,A02,083778,Greenfeld; Be'Eri,2,0,36,34
1656001492503,MATH 103A,A03,093561,Staff,0,1,36,36
1656001492503,MATH 103A,B01,083779,Greenfeld; Be'Eri,7,1,36,29
1656001492503,MATH 103A,B02,083780,Greenfeld; Be'Eri,0,0,36,36
1656001492503,MATH 103A,B03,093562,Staff,0,0,36,36
1656001498527,MATH 105,A01,085443,Carter; Anne Toulson,4,1,35,31
1656001498527,MATH 105,A02,093477,Staff,8,0,35,27
1656001504560,MATH 109,A01,083213,Ganzberger; Geoffrey Michael,0,1,34,34
1656001504560,MATH 109,A02,083214,Ganzberger; Geoffrey Michael,0,0,34,34
1656001504560,MATH 109,A03,093478,Staff,1,0,34,33
1656001504560,MATH 109,B01,083215,Ganzberger; Geoffrey Michael,2,0,32,30
1656001504560,MATH 109,B02,083216,Ganzberger; Geoffrey Michael,0,0,32,32
1656001504560,MATH 109,B03,093479,Staff,4,0,32,28
1656001510703,MATH 142A,A01,083219,Chow; Bennett,0,0,32,32
1656001510703,MATH 142A,A02,083220,Chow; Bennett,7,0,32,25
1656001510703,MATH 142A,A03,093480,Staff,4,0,32,28
1656001510703,MATH 142A,B03,093481,Staff,3,0,32,29
1656001510703,MATH 142A,B04,093558,Staff,6,0,32,26
1656001510703,MATH 142A,B05,093559,Staff,0,0,32,32
1656001516734,MATH 193A,A01,083224,Rotar; Vladimir,1,1,34,33
1656001516734,MATH 193A,A02,083225,Rotar; Vladimir,0,0,34,34
1656001516734,MATH 193A,A03,083781,Rotar; Vladimir,2,0,34,32
1656001516734,MATH 193A,A04,083782,Rotar; Vladimir,3,0,34,31
1656001516734,MATH 193A,A05,093482,Rotar; Vladimir,0,0,34,34
1656001522763,MATH 197,001,091859,McAuley; Julian John,9999,0,9999,0
1656001522763,MATH 197,002,095566,Kedlaya; Kiran S.,9997,0,9999,2
1656001522763,MATH 197,003,095567,Xiao; Ming,9999,0,9999,0
1656001522763,MATH 197,004,095571,Perols; Johan Lars,9998,0,9999,1
1656001529834,COGS 9,A01,083615,Shannon; Kyle Michael,3,1,75,72
1656001535862,COGS 11,A01,083617,Boyle; Mary E. T.,11,1,48,37
1656001541888,COGS 13,A01,083071,Bastos; Amalia Pinkusfeld,3,2,71,68
1656001547924,COGS 14A,A01,092681,Semenuks; Arturs,4,25,100,96
1656001553951,COGS 14B,A01,083073,Cheng; Tzu-Han,7,0,63,56
1656001559977,COGS 17,A01,092677,Semenuks; Arturs,8,7,81,73
1656001566011,COGS 100,A01,083619,Allen; Michael Gordon,2,2,70,68
1656001572037,COGS 101A,A01,083621,Davis; Joshua Daniel,4,3,68,64
1656001578064,COGS 101B,A01,091572,Allen; Michael Gordon,0,0,65,65
1656001584089,COGS 101C,A01,083625,Delgado; Tania,7,0,35,28
1656001590125,COGS 107A,A01,083627,Boyle; Mary E. T.,1,2,60,59
1656001596231,COGS 118A,A01,083075,Gupta; Anjum,21,16,76,55
1656001602280,CSE 3,A50,083646,Miranda; Gregory Joseph,14,0,50,36
1656001608316,CSE 8A,A50,083650,Miranda; Gregory Joseph,3,11,56,53
1656001614341,CSE 11,A01,083080,Cao; Yingjun,0,65,40,40
1656001620367,CSE 12,A01,083652,Krause-Levy; Sophia Louisa,6,8,120,114
1656001626398,CSE 15L,A01,083654,Morris; Justin Loren,3,1,50,47
1656001626398,CSE 15L,A02,083655,Morris; Justin Loren,1,1,50,49
1656001632429,CSE 20,A01,083657,Tran; Khoa Dang,29,0,80,51
1656001638479,CSE 21,A01,095574,Bach; Quang Tran,23,0,48,25
1656001644512,CSE 30,A01,083084,Eldon; John,2,10,80,78
1656001644512,CSE 30,B01,095061,Bhaskar; Nishant,0,4,50,50
1656001650536,CSE 100,A01,083659,Cao; Yingjun,2,25,70,68
1656001656566,CSE 134B,A01,083661,Powell; Thomas Allan,6,7,100,94
1656001662591,CSE 140,A01,083663,Gungor; Onat,5,0,85,80
1656001668633,CSE 140L,A01,083088,Eldon; John,5,0,100,95
1656001674662,CSE 175,A01,083665,Kumar; Rakesh,1,0,25,24
1656001680700,CSE 190,A00,092507,Dubnov; Shlomo,1,0,20,19
1656001686735,ECE 45,A01,083139,Congero; Spencer William,0,1,75,75
1656001692787,ECE 65,A50,083695,Saad; Andrew S,6,0,30,24
1656001692787,ECE 65,A51,095125,Staff,23,0,26,3
1656001698835,ECE 109,A01,091882,Touri; Behrouz,2,4,70,68
1656001704889,ECE 180,A00,083140,Abi Samra; Nicholas Camill,1,0,30,29
1656001704889,ECE 180,B00,083141,Abi Samra; Nicholas Camill,0,8,28,28
1656001710947,MATH 10A,A01,083735,Patchell; Gregory David,0,0,30,30
1656001710947,MATH 10A,A02,083736,Patchell; Gregory David,21,0,30,9
1656001710947,MATH 10A,A03,083737,Patchell; Gregory David,16,0,30,14
1656001716988,MATH 10B,A01,083207,Lim; Seonhee,1,1,34,33
1656001716988,MATH 10B,A02,083208,Lim; Seonhee,1,1,35,34
1656001716988,MATH 10B,A03,093472,Staff,1,0,34,33
1656001716988,MATH 10B,B01,083739,Sinha; Shubham,9,0,30,21
1656001723025,MATH 18,A01,083743,Cinel; Cameron Alexander,5,0,30,25
1656001723025,MATH 18,A02,083744,Cinel; Cameron Alexander,11,0,30,19
1656001723025,MATH 18,A03,083745,Cinel; Cameron Alexander,1,0,30,29
1656001723025,MATH 18,B01,083748,Ma; Zilu,2,0,36,34
1656001723025,MATH 18,B02,083749,Ma; Zilu,0,0,36,36
1656001723025,MATH 18,B03,083750,Ma; Zilu,0,0,36,36
1656001723025,MATH 18,B04,083751,Ma; Zilu,0,0,36,36
1656001723025,MATH 18,B05,093473,Staff,0,0,36,36
1656001723025,MATH 18,B06,093474,Staff,1,0,36,35
1656001729048,MATH 20A,A01,083754,Zheng; Zequn,10,0,40,30
1656001735103,MATH 20B,A01,083756,Briones; Jor-el Thomas Caparas,0,1,36,36
1656001735103,MATH 20B,A02,083757,Briones; Jor-el Thomas Caparas,1,0,36,35
1656001735103,MATH 20B,A03,093475,Staff,0,0,36,36
1656001741147,MATH 20C,A01,083760,Briones; Jor-el Thomas Caparas,0,2,35,35
1656001741147,MATH 20C,A02,083761,Briones; Jor-el Thomas Caparas,6,1,35,29
1656001741147,MATH 20C,A03,093476,Staff,0,0,35,35
1656001741147,MATH 20C,B01,083762,Bach; Quang Tran,3,0,30,27
1656001747176,MATH 20D,A01,083765,Tran; Brian Kha,1,0,30,29
1656001747176,MATH 20D,A02,083766,Tran; Brian Kha,0,1,30,30
1656001747176,MATH 20D,A03,083767,Tran; Brian Kha,1,0,30,29
1656001753220,MATH 20E,A01,083771,Ganguly; Soumya,0,1,32,32
1656001753220,MATH 20E,A02,083772,Ganguly; Soumya,1,1,32,31
1656001753220,MATH 20E,B01,083773,Ciotti; Benjamin,14,0,35,21
1656001753220,MATH 20E,B02,083774,Ciotti; Benjamin,12,0,35,23
1656001759254,MATH 103A,A01,083777,Greenfeld; Be'Eri,2,1,36,34
1656001759254,MATH 103A,A02,083778,Greenfeld; Be'Eri,2,0,36,34
1656001759254,MATH 103A,A03,093561,Staff,0,1,36,36
1656001759254,MATH 103A,B01,083779,Greenfeld; Be'Eri,7,1,36,29
1656001759254,MATH 103A,B02,083780,Greenfeld; Be'Eri,0,0,36,36
1656001759254,MATH 103A,B03,093562,Staff,0,0,36,36
1656001765288,MATH 105,A01,085443,Carter; Anne Toulson,4,1,35,31
1656001765288,MATH 105,A02,093477,Staff,8,0,35,27
1656001771318,MATH 109,A01,083213,Ganzberger; Geoffrey Michael,0,1,34,34
1656001771318,MATH 109,A02,083214,Ganzberger; Geoffrey Michael,0,0,34,34
1656001771318,MATH 109,A03,093478,Staff,1,0,34,33
1656001771318,MATH 109,B01,083215,Ganzberger; Geoffrey Michael,2,0,32,30
1656001771318,MATH 109,B02,083216,Ganzberger; Geoffrey Michael,0,0,32,32
1656001771318,MATH 109,B03,093479,Staff,4,0,32,28
1656001777369,MATH 142A,A01,083219,Chow; Bennett,0,0,32,32
1656001777369,MATH 142A,A02,083220,Chow; Bennett,7,0,32,25
1656001777369,MATH 142A,A03,093480,Staff,4,0,32,28
1656001777369,MATH 142A,B03,093481,Staff,3,0,32,29
1656001777369,MATH 142A,B04,093558,Staff,6,0,32,26
1656001777369,MATH 142A,B05,093559,Staff,0,0,32,32
1656001783406,MATH 193A,A01,083224,Rotar; Vladimir,1,1,34,33
1656001783406,MATH 193A,A02,083225,Rotar; Vladimir,0,0,34,34
1656001783406,MATH 193A,A03,083781,Rotar; Vladimir,2,0,34,32
1656001783406,MATH 193A,A04,083782,Rotar; Vladimir,3,0,34,31
1656001783406,MATH 193A,A05,093482,Rotar; Vladimir,0,0,34,34
1656001789456,MATH 197,001,091859,McAuley; Julian John,9999,0,9999,0
1656001789456,MATH 197,002,095566,Kedlaya; Kiran S.,9997,0,9999,2
1656001789456,MATH 197,003,095567,Xiao; Ming,9999,0,9999,0
1656001789456,MATH 197,004,095571,Perols; Johan Lars,9998,0,9999,1
1656001796545,COGS 9,A01,083615,Shannon; Kyle Michael,3,1,75,72
1656001802591,COGS 11,A01,083617,Boyle; Mary E. T.,11,1,48,37
1656001808644,COGS 13,A01,083071,Bastos; Amalia Pinkusfeld,3,2,71,68
1656001814684,COGS 14A,A01,092681,Semenuks; Arturs,4,25,100,96
1656001820723,COGS 14B,A01,083073,Cheng; Tzu-Han,7,0,63,56
1656001826778,COGS 17,A01,092677,Semenuks; Arturs,8,7,81,73
1656001832823,COGS 100,A01,083619,Allen; Michael Gordon,2,2,70,68
1656001838868,COGS 101A,A01,083621,Davis; Joshua Daniel,4,3,68,64
1656001844912,COGS 101B,A01,091572,Allen; Michael Gordon,0,0,65,65
1656001850961,COGS 101C,A01,083625,Delgado; Tania,7,0,35,28
1656001857005,COGS 107A,A01,083627,Boyle; Mary E. T.,1,2,60,59
1656001863051,COGS 118A,A01,083075,Gupta; Anjum,21,16,76,55
1656001869089,CSE 3,A50,083646,Miranda; Gregory Joseph,14,0,50,36
1656001875116,CSE 8A,A50,083650,Miranda; Gregory Joseph,3,11,56,53
1656001881146,CSE 11,A01,083080,Cao; Yingjun,0,65,40,40
1656001887183,CSE 12,A01,083652,Krause-Levy; Sophia Louisa,6,8,120,114
1656001893219,CSE 15L,A01,083654,Morris; Justin Loren,3,1,50,47
1656001893219,CSE 15L,A02,083655,Morris; Justin Loren,1,1,50,49
1656001899281,CSE 20,A01,083657,Tran; Khoa Dang,29,0,80,51
1656001905307,CSE 21,A01,095574,Bach; Quang Tran,23,0,48,25
1656001911340,CSE 30,A01,083084,Eldon; John,2,10,80,78
1656001911340,CSE 30,B01,095061,Bhaskar; Nishant,0,4,50,50
1656001917372,CSE 100,A01,083659,Cao; Yingjun,2,25,70,68
1656001923395,CSE 134B,A01,083661,Powell; Thomas Allan,6,7,100,94
1656001929442,CSE 140,A01,083663,Gungor; Onat,5,0,85,80
1656001935494,CSE 140L,A01,083088,Eldon; John,5,0,100,95
1656001941542,CSE 175,A01,083665,Kumar; Rakesh,1,0,25,24
1656001947587,CSE 190,A00,092507,Dubnov; Shlomo,1,0,20,19
1656001953627,ECE 45,A01,083139,Congero; Spencer William,0,1,75,75
1656001959676,ECE 65,A50,083695,Saad; Andrew S,6,0,30,24
1656001959676,ECE 65,A51,095125,Staff,23,0,26,3
1656001965716,ECE 109,A01,091882,Touri; Behrouz,2,4,70,68
1656001971738,ECE 180,A00,083140,Abi Samra; Nicholas Camill,1,0,30,29
1656001971738,ECE 180,B00,083141,Abi Samra; Nicholas Camill,0,8,28,28
1656001977768,MATH 10A,A01,083735,Patchell; Gregory David,0,0,30,30
1656001977768,MATH 10A,A02,083736,Patchell; Gregory David,21,0,30,9
1656001977768,MATH 10A,A03,083737,Patchell; Gregory David,16,0,30,14
1656001983803,MATH 10B,A01,083207,Lim; Seonhee,1,1,34,33
1656001983803,MATH 10B,A02,083208,Lim; Seonhee,1,1,35,34
1656001983803,MATH 10B,A03,093472,Staff,1,0,34,33
1656001983803,MATH 10B,B01,083739,Sinha; Shubham,9,0,30,21
1656001989837,MATH 18,A01,083743,Cinel; Cameron Alexander,5,0,30,25
1656001989837,MATH 18,A02,083744,Cinel; Cameron Alexander,11,0,30,19
1656001989837,MATH 18,A03,083745,Cinel; Cameron Alexander,1,0,30,29
1656001989837,MATH 18,B01,083748,Ma; Zilu,2,0,36,34
1656001989837,MATH 18,B02,083749,Ma; Zilu,0,0,36,36
1656001989837,MATH 18,B03,083750,Ma; Zilu,0,0,36,36
1656001989837,MATH 18,B04,083751,Ma; Zilu,0,0,36,36
1656001989837,MATH 18,B05,093473,Staff,0,0,36,36
1656001989837,MATH 18,B06,093474,Staff,1,0,36,35
1656001995863,MATH 20A,A01,083754,Zheng; Zequn,10,0,40,30
1656002001920,MATH 20B,A01,083756,Briones; Jor-el Thomas Caparas,0,1,36,36
1656002001920,MATH 20B,A02,083757,Briones; Jor-el Thomas Caparas,1,0,36,35
1656002001920,MATH 20B,A03,093475,Staff,0,0,36,36
1656002007972,MATH 20C,A01,083760,Briones; Jor-el Thomas Caparas,0,2,35,35
1656002007972,MATH 20C,A02,083761,Briones; Jor-el Thomas Caparas,6,1,35,29
1656002007972,MATH 20C,A03,093476,Staff,0,0,35,35
1656002007972,MATH 20C,B01,083762,Bach; Quang Tran,3,0,30,27
1656002013999,MATH 20D,A01,083765,Tran; Brian Kha,1,0,30,29
1656002013999,MATH 20D,A02,083766,Tran; Brian Kha,0,1,30,30
1656002013999,MATH 20D,A03,083767,Tran; Brian Kha,1,0,30,29
1656002020023,MATH 20E,A01,083771,Ganguly; Soumya,0,1,32,32
1656002020023,MATH 20E,A02,083772,Ganguly; Soumya,1,1,32,31
1656002020023,MATH 20E,B01,083773,Ciotti; Benjamin,14,0,35,21
1656002020023,MATH 20E,B02,083774,Ciotti; Benjamin,12,0,35,23
1656002026049,MATH 103A,A01,083777,Greenfeld; Be'Eri,2,1,36,34
1656002026049,MATH 103A,A02,083778,Greenfeld; Be'Eri,2,0,36,34
1656002026049,MATH 103A,A03,093561,Staff,0,1,36,36
1656002026049,MATH 103A,B01,083779,Greenfeld; Be'Eri,7,1,36,29
1656002026049,MATH 103A,B02,083780,Greenfeld; Be'Eri,0,0,36,36
1656002026049,MATH 103A,B03,093562,Staff,0,0,36,36
1656002032089,MATH 105,A01,085443,Carter; Anne Toulson,4,1,35,31
1656002032089,MATH 105,A02,093477,Staff,8,0,35,27
1656002038122,MATH 109,A01,083213,Ganzberger; Geoffrey Michael,0,1,34,34
1656002038122,MATH 109,A02,083214,Ganzberger; Geoffrey Michael,0,0,34,34
1656002038122,MATH 109,A03,093478,Staff,1,0,34,33
1656002038122,MATH 109,B01,083215,Ganzberger; Geoffrey Michael,2,0,32,30
1656002038122,MATH 109,B02,083216,Ganzberger; Geoffrey Michael,0,0,32,32
1656002038122,MATH 109,B03,093479,Staff,4,0,32,28
1656002044146,MATH 142A,A01,083219,Chow; Bennett,0,0,32,32
1656002044146,MATH 142A,A02,083220,Chow; Bennett,7,0,32,25
1656002044146,MATH 142A,A03,093480,Staff,4,0,32,28
1656002044146,MATH 142A,B03,093481,Staff,3,0,32,29
1656002044146,MATH 142A,B04,093558,Staff,6,0,32,26
1656002044146,MATH 142A,B05,093559,Staff,0,0,32,32
1656002050185,MATH 193A,A01,083224,Rotar; Vladimir,1,1,34,33
1656002050185,MATH 193A,A02,083225,Rotar; Vladimir,0,0,34,34
1656002050185,MATH 193A,A03,083781,Rotar; Vladimir,2,0,34,32
1656002050185,MATH 193A,A04,083782,Rotar; Vladimir,3,0,34,31
1656002050185,MATH 193A,A05,093482,Rotar; Vladimir,0,0,34,34
1656002056233,MATH 197,001,091859,McAuley; Julian John,9999,0,9999,0
1656002056233,MATH 197,002,095566,Kedlaya; Kiran S.,9997,0,9999,2
1656002056233,MATH 197,003,095567,Xiao; Ming,9999,0,9999,0
1656002056233,MATH 197,004,095571,Perols; Johan Lars,9998,0,9999,1
1656002063296,COGS 9,A01,083615,Shannon; Kyle Michael,3,1,75,72
1656002069328,COGS 11,A01,083617,Boyle; Mary E. T.,11,1,48,37
1656002075355,COGS 13,A01,083071,Bastos; Amalia Pinkusfeld,3,2,71,68
1656002081401,COGS 14A,A01,092681,Semenuks; Arturs,4,25,100,96
1656002087438,COGS 14B,A01,083073,Cheng; Tzu-Han,7,0,63,56
1656002093471,COGS 17,A01,092677,Semenuks; Arturs,8,7,81,73
1656002099499,COGS 100,A01,083619,Allen; Michael Gordon,2,2,70,68
1656002105531,COGS 101A,A01,083621,Davis; Joshua Daniel,4,3,68,64
1656002111574,COGS 101B,A01,091572,Allen; Michael Gordon,0,0,65,65
1656002117601,COGS 101C,A01,083625,Delgado; Tania,7,0,35,28
1656002123649,COGS 107A,A01,083627,Boyle; Mary E. T.,1,2,60,59
1656002129675,COGS 118A,A01,083075,Gupta; Anjum,21,16,76,55
1656002135717,CSE 3,A50,083646,Miranda; Gregory Joseph,14,0,50,36
1656002141774,CSE 8A,A50,083650,Miranda; Gregory Joseph,3,11,56,53
1656002147805,CSE 11,A01,083080,Cao; Yingjun,0,65,40,40
1656002153832,CSE 12,A01,083652,Krause-Levy; Sophia Louisa,6,8,120,114
1656002159859,CSE 15L,A01,083654,Morris; Justin Loren,3,1,50,47
1656002159859,CSE 15L,A02,083655,Morris; Justin Loren,1,1,50,49
1656002165896,CSE 20,A01,083657,Tran; Khoa Dang,29,0,80,51
1656002171937,CSE 21,A01,095574,Bach; Quang Tran,23,0,48,25
1656002177976,CSE 30,A01,083084,Eldon; John,2,10,80,78
1656002177976,CSE 30,B01,095061,Bhaskar; Nishant,0,4,50,50
1656002184004,CSE 100,A01,083659,Cao; Yingjun,2,25,70,68
1656002190037,CSE 134B,A01,083661,Powell; Thomas Allan,6,7,100,94
1656002196149,CSE 140,A01,083663,Gungor; Onat,5,0,85,80
1656002202183,CSE 140L,A01,083088,Eldon; John,5,0,100,95
1656002208224,CSE 175,A01,083665,Kumar; Rakesh,1,0,25,24
1656002214262,CSE 190,A00,092507,Dubnov; Shlomo,1,0,20,19
1656002220301,ECE 45,A01,083139,Congero; Spencer William,0,1,75,75
1656002226324,ECE 65,A50,083695,Saad; Andrew S,6,0,30,24
1656002226324,ECE 65,A51,095125,Staff,23,0,26,3
1656002232358,ECE 109,A01,091882,Touri; Behrouz,2,4,70,68
1656002238411,ECE 180,A00,083140,Abi Samra; Nicholas Camill,1,0,30,29
1656002238411,ECE 180,B00,083141,Abi Samra; Nicholas Camill,0,8,28,28
1656002244452,MATH 10A,A01,083735,Patchell; Gregory David,0,0,30,30
1656002244452,MATH 10A,A02,083736,Patchell; Gregory David,21,0,30,9
1656002244452,MATH 10A,A03,083737,Patchell; Gregory David,16,0,30,14
1656002250490,MATH 10B,A01,083207,Lim; Seonhee,1,1,34,33
1656002250490,MATH 10B,A02,083208,Lim; Seonhee,1,1,35,34
1656002250490,MATH 10B,A03,093472,Staff,1,0,34,33
1656002250490,MATH 10B,B01,083739,Sinha; Shubham,9,0,30,21
1656002256519,MATH 18,A01,083743,Cinel; Cameron Alexander,5,0,30,25
1656002256519,MATH 18,A02,083744,Cinel; Cameron Alexander,11,0,30,19
1656002256519,MATH 18,A03,083745,Cinel; Cameron Alexander,1,0,30,29
1656002256519,MATH 18,B01,083748,Ma; Zilu,2,0,36,34
1656002256519,MATH 18,B02,083749,Ma; Zilu,0,0,36,36
1656002256519,MATH 18,B03,083750,Ma; Zilu,0,0,36,36
1656002256519,MATH 18,B04,083751,Ma; Zilu,0,0,36,36
1656002256519,MATH 18,B05,093473,Staff,0,0,36,36
1656002256519,MATH 18,B06,093474,Staff,1,0,36,35
1656002262549,MATH 20A,A01,083754,Zheng; Zequn,10,0,40,30
1656002268576,MATH 20B,A01,083756,Briones; Jor-el Thomas Caparas,0,1,36,36
1656002268576,MATH 20B,A02,083757,Briones; Jor-el Thomas Caparas,1,0,36,35
1656002268576,MATH 20B,A03,093475,Staff,0,0,36,36
1656002274622,MATH 20C,A01,083760,Briones; Jor-el Thomas Caparas,0,2,35,35
1656002274622,MATH 20C,A02,083761,Briones; Jor-el Thomas Caparas,6,1,35,29
1656002274622,MATH 20C,A03,093476,Staff,0,0,35,35
1656002274622,MATH 20C,B01,083762,Bach; Quang Tran,3,0,30,27
1656002280651,MATH 20D,A01,083765,Tran; Brian Kha,1,0,30,29
1656002280651,MATH 20D,A02,083766,Tran; Brian Kha,0,1,30,30
1656002280651,MATH 20D,A03,083767,Tran; Brian Kha,1,0,30,29
1656002286683,MATH 20E,A01,083771,Ganguly; Soumya,0,1,32,32
1656002286683,MATH 20E,A02,083772,Ganguly; Soumya,1,1,32,31
1656002286683,MATH 20E,B01,083773,Ciotti; Benjamin,14,0,35,21
1656002286683,MATH 20E,B02,083774,Ciotti; Benjamin,12,0,35,23
1656002292728,MATH 103A,A01,083777,Greenfeld; Be'Eri,2,1,36,34
1656002292728,MATH 103A,A02,083778,Greenfeld; Be'Eri,2,0,36,34
1656002292728,MATH 103A,A03,093561,Staff,0,1,36,36
1656002292728,MATH 103A,B01,083779,Greenfeld; Be'Eri,7,1,36,29
1656002292728,MATH 103A,B02,083780,Greenfeld; Be'Eri,0,0,36,36
1656002292728,MATH 103A,B03,093562,Staff,0,0,36,36
1656002298781,MATH 105,A01,085443,Carter; Anne Toulson,4,1,35,31
1656002298781,MATH 105,A02,093477,Staff,8,0,35,27
1656002304805,MATH 109,A01,083213,Ganzberger; Geoffrey Michael,0,1,34,34
1656002304805,MATH 109,A02,083214,Ganzberger; Geoffrey Michael,0,0,34,34
1656002304805,MATH 109,A03,093478,Staff,1,0,34,33
1656002304805,MATH 109,B01,083215,Ganzberger; Geoffrey Michael,2,0,32,30
1656002304805,MATH 109,B02,083216,Ganzberger; Geoffrey Michael,0,0,32,32
1656002304805,MATH 109,B03,093479,Staff,4,0,32,28
1656002310836,MATH 142A,A01,083219,Chow; Bennett,0,0,32,32
1656002310836,MATH 142A,A02,083220,Chow; Bennett,7,0,32,25
1656002310836,MATH 142A,A03,093480,Staff,4,0,32,28
1656002310836,MATH 142A,B03,093481,Staff,3,0,32,29
1656002310836,MATH 142A,B04,093558,Staff,6,0,32,26
1656002310836,MATH 142A,B05,093559,Staff,0,0,32,32
1656002316874,MATH 193A,A01,083224,Rotar; Vladimir,1,1,34,33
1656002316874,MATH 193A,A02,083225,Rotar; Vladimir,0,0,34,34
1656002316874,MATH 193A,A03,083781,Rotar; Vladimir,2,0,34,32
1656002316874,MATH 193A,A04,083782,Rotar; Vladimir,3,0,34,31
1656002316874,MATH 193A,A05,093482,Rotar; Vladimir,0,0,34,34
1656002322920,MATH 197,001,091859,McAuley; Julian John,9999,0,9999,0
1656002322920,MATH 197,002,095566,Kedlaya; Kiran S.,9997,0,9999,2
1656002322920,MATH 197,003,095567,Xiao; Ming,9999,0,9999,0
1656002322920,MATH 197,004,095571,Perols; Johan Lars,9998,0,9999,1
1656002329984,COGS 9,A01,083615,Shannon; Kyle Michael,3,1,75,72
1656002336006,COGS 11,A01,083617,Boyle; Mary E. T.,11,1,48,37
1656002342042,COGS 13,A01,083071,Bastos; Amalia Pinkusfeld,3,2,71,68
1656002348066,COGS 14A,A01,092681,Semenuks; Arturs,4,25,100,96
1656002354088,COGS 14B,A01,083073,Cheng; Tzu-Han,7,0,63,56
1656002360135,COGS 17,A01,092677,Semenuks; Arturs,8,7,81,73
1656002366171,COGS 100,A01,083619,Allen; Michael Gordon,2,2,70,68
1656002372208,COGS 101A,A01,083621,Davis; Joshua Daniel,4,3,68,64
1656002378233,COGS 101B,A01,091572,Allen; Michael Gordon,0,0,65,65
1656002384282,COGS 101C,A01,083625,Delgado; Tania,7,0,35,28
1656002390319,COGS 107A,A01,083627,Boyle; Mary E. T.,1,2,60,59
1656002396348,COGS 118A,A01,083075,Gupta; Anjum,21,16,76,55
1656002402387,CSE 3,A50,083646,Miranda; Gregory Joseph,14,0,50,36
1656002408439,CSE 8A,A50,083650,Miranda; Gregory Joseph,3,11,56,53
1656002414469,CSE 11,A01,083080,Cao; Yingjun,0,65,40,40
1656002420516,CSE 12,A01,083652,Krause-Levy; Sophia Louisa,6,8,120,114
1656002426545,CSE 15L,A01,083654,Morris; Justin Loren,3,1,50,47
1656002426545,CSE 15L,A02,083655,Morris; Justin Loren,1,1,50,49
1656002432569,CSE 20,A01,083657,Tran; Khoa Dang,29,0,80,51
1656002438595,CSE 21,A01,095574,Bach; Quang Tran,23,0,48,25
1656002444640,CSE 30,A01,083084,Eldon; John,2,10,80,78
1656002444640,CSE 30,B01,095061,Bhaskar; Nishant,0,4,50,50
1656002450688,CSE 100,A01,083659,Cao; Yingjun,2,25,70,68
1656002456713,CSE 134B,A01,083661,Powell; Thomas Allan,6,7,100,94
1656002462739,CSE 140,A01,083663,Gungor; Onat,5,0,85,80
1656002468780,CSE 140L,A01,083088,Eldon; John,5,0,100,95
1656002474817,CSE 175,A01,083665,Kumar; Rakesh,1,0,25,24
1656002480849,CSE 190,A00,092507,Dubnov; Shlomo,1,0,20,19
1656002486898,ECE 45,A01,083139,Congero; Spencer William,0,1,75,75
1656002492922,ECE 65,A50,083695,Saad; Andrew S,6,0,30,24
1656002492922,ECE 65,A51,095125,Staff,23,0,26,3
1656002498959,ECE 109,A01,091882,Touri; Behrouz,2,4,70,68
1656002505008,ECE 180,A00,083140,Abi Samra; Nicholas Camill,1,0,30,29
1656002505008,ECE 180,B00,083141,Abi Samra; Nicholas Camill,0,8,28,28
1656002511046,MATH 10A,A01,083735,Patchell; Gregory David,0,0,30,30
1656002511046,MATH 10A,A02,083736,Patchell; Gregory David,21,0,30,9
1656002511046,MATH 10A,A03,083737,Patchell; Gregory David,16,0,30,14
1656002517071,MATH 10B,A01,083207,Lim; Seonhee,1,1,34,33
1656002517071,MATH 10B,A02,083208,Lim; Seonhee,1,1,35,34
1656002517071,MATH 10B,A03,093472,Staff,1,0,34,33
1656002517071,MATH 10B,B01,083739,Sinha; Shubham,9,0,30,21
1656002523103,MATH 18,A01,083743,Cinel; Cameron Alexander,5,0,30,25
1656002523103,MATH 18,A02,083744,Cinel; Cameron Alexander,11,0,30,19
1656002523103,MATH 18,A03,083745,Cinel; Cameron Alexander,1,0,30,29
1656002523103,MATH 18,B01,083748,Ma; Zilu,2,0,36,34
1656002523103,MATH 18,B02,083749,Ma; Zilu,0,0,36,36
1656002523103,MATH 18,B03,083750,Ma; Zilu,0,0,36,36
1656002523103,MATH 18,B04,083751,Ma; Zilu,0,0,36,36
1656002523103,MATH 18,B05,093473,Staff,0,0,36,36
1656002523103,MATH 18,B06,093474,Staff,1,0,36,35
1656002529147,MATH 20A,A01,083754,Zheng; Zequn,10,0,40,30
1656002535180,MATH 20B,A01,083756,Briones; Jor-el Thomas Caparas,0,1,36,36
1656002535180,MATH 20B,A02,083757,Briones; Jor-el Thomas Caparas,1,0,36,35
1656002535180,MATH 20B,A03,093475,Staff,0,0,36,36
1656002541220,MATH 20C,A01,083760,Briones; Jor-el Thomas Caparas,0,2,35,35
1656002541220,MATH 20C,A02,083761,Briones; Jor-el Thomas Caparas,6,1,35,29
1656002541220,MATH 20C,A03,093476,Staff,0,0,35,35
1656002541220,MATH 20C,B01,083762,Bach; Quang Tran,3,0,30,27
1656002547243,MATH 20D,A01,083765,Tran; Brian Kha,1,0,30,29
1656002547243,MATH 20D,A02,083766,Tran; Brian Kha,0,1,30,30
1656002547243,MATH 20D,A03,083767,Tran; Brian Kha,1,0,30,29
1656002553291,MATH 20E,A01,083771,Ganguly; Soumya,0,1,32,32
1656002553291,MATH 20E,A02,083772,Ganguly; Soumya,1,1,32,31
1656002553291,MATH 20E,B01,083773,Ciotti; Benjamin,14,0,35,21
1656002553291,MATH 20E,B02,083774,Ciotti; Benjamin,12,0,35,23
1656002559325,MATH 103A,A01,083777,Greenfeld; Be'Eri,2,1,36,34
1656002559325,MATH 103A,A02,083778,Greenfeld; Be'Eri,2,0,36,34
1656002559325,MATH 103A,A03,093561,Staff,0,1,36,36
1656002559325,MATH 103A,B01,083779,Greenfeld; Be'Eri,7,1,36,29
1656002559325,MATH 103A,B02,083780,Greenfeld; Be'Eri,0,0,36,36
1656002559325,MATH 103A,B03,093562,Staff,0,0,36,36
1656002565372,MATH 105,A01,085443,Carter; Anne Toulson,4,1,35,31
1656002565372,MATH 105,A02,093477,Staff,8,0,35,27
1656002571404,MATH 109,A01,083213,Ganzberger; Geoffrey Michael,0,1,34,34
1656002571404,MATH 109,A02,083214,Ganzberger; Geoffrey Michael,0,0,34,34
1656002571404,MATH 109,A03,093478,Staff,1,0,34,33
1656002571404,MATH 109,B01,083215,Ganzberger; Geoffrey Michael,2,0,32,30
1656002571404,MATH 109,B02,083216,Ganzberger; Geoffrey Michael,0,0,32,32
1656002571404,MATH 109,B03,093479,Staff,4,0,32,28
1656002577428,MATH 142A,A01,083219,Chow; Bennett,0,0,32,32
1656002577428,MATH 142A,A02,083220,Chow; Bennett,7,0,32,25
1656002577428,MATH 142A,A03,093480,Staff,4,0,32,28
1656002577428,MATH 142A,B03,093481,Staff,3,0,32,29
1656002577428,MATH 142A,B04,093558,Staff,6,0,32,26
1656002577428,MATH 142A,B05,093559,Staff,0,0,32,32
1656002583471,MATH 193A,A01,083224,Rotar; Vladimir,1,1,34,33
1656002583471,MATH 193A,A02,083225,Rotar; Vladimir,0,0,34,34
1656002583471,MATH 193A,A03,083781,Rotar; Vladimir,2,0,34,32
1656002583471,MATH 193A,A04,083782,Rotar; Vladimir,3,0,34,31
1656002583471,MATH 193A,A05,093482,Rotar; Vladimir,0,0,34,34
1656002589512,MATH 197,001,091859,McAuley; Julian John,9999,0,9999,0
1656002589512,MATH 197,002,095566,Kedlaya; Kiran S.,9997,0,9999,2
1656002589512,MATH 197,003,095567,Xiao; Ming,9999,0,9999,0
1656002589512,MATH 197,004,095571,Perols; Johan Lars,9998,0,9999,1
1656002596586,COGS 9,A01,083615,Shannon; Kyle Michael,3,1,75,72
1656002602623,COGS 11,A01,083617,Boyle; Mary E. T.,11,1,48,37
1656002608671,COGS 13,A01,083071,Bastos; Amalia Pinkusfeld,3,2,71,68
1656002614701,COGS 14A,A01,092681,Semenuks; Arturs,4,25,100,96
1656002620728,COGS 14B,A01,083073,Cheng; Tzu-Han,7,0,63,56
1656002626762,COGS 17,A01,092677,Semenuks; Arturs,8,7,81,73
1656002632790,COGS 100,A01,083619,Allen; Michael Gordon,2,2,70,68
1656002638816,COGS 101A,A01,083621,Davis; Joshua Daniel,4,3,68,64
1656002644841,COGS 101B,A01,091572,Allen; Michael Gordon,0,0,65,65
1656002650880,COGS 101C,A01,083625,Delgado; Tania,7,0,35,28
1656002656910,COGS 107A,A01,083627,Boyle; Mary E. T.,1,2,60,59
1656002662953,COGS 118A,A01,083075,Gupta; Anjum,21,16,76,55
1656002668982,CSE 3,A50,083646,Miranda; Gregory Joseph,14,0,50,36
1656002675014,CSE 8A,A50,083650,Miranda; Gregory Joseph,3,11,56,53
1656002681037,CSE 11,A01,083080,Cao; Yingjun,0,65,40,40
1656002687067,CSE 12,A01,083652,Krause-Levy; Sophia Louisa,6,8,120,114
1656002693095,CSE 15L,A01,083654,Morris; Justin Loren,3,1,50,47
1656002693095,CSE 15L,A02,083655,Morris; Justin Loren,1,1,50,49
1656002699128,CSE 20,A01,083657,Tran; Khoa Dang,29,0,80,51
1656002705154,CSE 21,A01,095574,Bach; Quang Tran,23,0,48,25
1656002711180,CSE 30,A01,083084,Eldon; John,2,10,80,78
1656002711180,CSE 30,B01,095061,Bhaskar; Nishant,0,4,50,50
1656002717209,CSE 100,A01,083659,Cao; Yingjun,2,25,70,68
1656002723243,CSE 134B,A01,083661,Powell; Thomas Allan,6,7,100,94
1656002729266,CSE 140,A01,083663,Gungor; Onat,5,0,85,80
1656002735295,CSE 140L,A01,083088,Eldon; John,5,0,100,95
1656002741344,CSE 175,A01,083665,Kumar; Rakesh,1,0,25,24
1656002747396,CSE 190,A00,092507,Dubnov; Shlomo,1,0,20,19
1656002753450,ECE 45,A01,083139,Congero; Spencer William,0,1,75,75
1656002759472,ECE 65,A50,083695,Saad; Andrew S,6,0,30,24
1656002759472,ECE 65,A51,095125,Staff,23,0,26,3
1656002765503,ECE 109,A01,091882,Touri; Behrouz,2,4,70,68
1656002771526,ECE 180,A00,083140,Abi Samra; Nicholas Camill,1,0,30,29
1656002771526,ECE 180,B00,083141,Abi Samra; Nicholas Camill,0,8,28,28
1656002777550,MATH 10A,A01,083735,Patchell; Gregory David,0,0,30,30
1656002777550,MATH 10A,A02,083736,Patchell; Gregory David,21,0,30,9
1656002777550,MATH 10A,A03,083737,Patchell; Gregory David,16,0,30,14
1656002783578,MATH 10B,A01,083207,Lim; Seonhee,1,1,34,33
1656002783578,MATH 10B,A02,083208,Lim; Seonhee,1,1,35,34
1656002783578,MATH 10B,A03,093472,Staff,1,0,34,33
1656002783578,MATH 10B,B01,083739,Sinha; Shubham,9,0,30,21
1656002789606,MATH 18,A01,083743,Cinel; Cameron Alexander,5,0,30,25
1656002789606,MATH 18,A02,083744,Cinel; Cameron Alexander,11,0,30,19
1656002789606,MATH 18,A03,083745,Cinel; Cameron Alexander,1,0,30,29
1656002789606,MATH 18,B01,083748,Ma; Zilu,2,0,36,34
1656002789606,MATH 18,B02,083749,Ma; Zilu,0,0,36,36
1656002789606,MATH 18,B03,083750,Ma; Zilu,0,0,36,36
1656002789606,MATH 18,B04,083751,Ma; Zilu,0,0,36,36
1656002789606,MATH 18,B05,093473,Staff,0,0,36,36
1656002789606,MATH 18,B06,093474,Staff,1,0,36,35
1656002795717,MATH 20A,A01,083754,Zheng; Zequn,10,0,40,30
1656002801762,MATH 20B,A01,083756,Briones; Jor-el Thomas Caparas,0,1,36,36
1656002801762,MATH 20B,A02,083757,Briones; Jor-el Thomas Caparas,1,0,36,35
1656002801762,MATH 20B,A03,093475,Staff,0,0,36,36
1656002807796,MATH 20C,A01,083760,Briones; Jor-el Thomas Caparas,0,2,35,35
1656002807796,MATH 20C,A02,083761,Briones; Jor-el Thomas Caparas,6,1,35,29
1656002807796,MATH 20C,A03,093476,Staff,0,0,35,35
1656002807796,MATH 20C,B01,083762,Bach; Quang Tran,3,0,30,27
1656002813822,MATH 20D,A01,083765,Tran; Brian Kha,1,0,30,29
1656002813822,MATH 20D,A02,083766,Tran; Brian Kha,0,1,30,30
1656002813822,MATH 20D,A03,083767,Tran; Brian Kha,1,0,30,29
1656002819856,MATH 20E,A01,083771,Ganguly; Soumya,0,1,32,32
1656002819856,MATH 20E,A02,083772,Ganguly; Soumya,1,1,32,31
1656002819856,MATH 20E,B01,083773,Ciotti; Benjamin,14,0,35,21
1656002819856,MATH 20E,B02,083774,Ciotti; Benjamin,12,0,35,23
1656002825891,MATH 103A,A01,083777,Greenfeld; Be'Eri,2,1,36,34
1656002825891,MATH 103A,A02,083778,Greenfeld; Be'Eri,2,0,36,34
1656002825891,MATH 103A,A03,093561,Staff,0,1,36,36
1656002825891,MATH 103A,B01,083779,Greenfeld; Be'Eri,7,1,36,29
1656002825891,MATH 103A,B02,083780,Greenfeld; Be'Eri,0,0,36,36
1656002825891,MATH 103A,B03,093562,Staff,0,0,36,36
1656002831933,MATH 105,A01,085443,Carter; Anne Toulson,4,1,35,31
1656002831933,MATH 105,A02,093477,Staff,8,0,35,27
1656002837961,MATH 109,A01,083213,Ganzberger; Geoffrey Michael,0,1,34,34
1656002837961,MATH 109,A02,083214,Ganzberger; Geoffrey Michael,0,0,34,34
1656002837961,MATH 109,A03,093478,Staff,1,0,34,33
1656002837961,MATH 109,B01,083215,Ganzberger; Geoffrey Michael,2,0,32,30
1656002837961,MATH 109,B02,083216,Ganzberger; Geoffrey Michael,0,0,32,32
1656002837961,MATH 109,B03,093479,Staff,4,0,32,28
1656002844000,MATH 142A,A01,083219,Chow; Bennett,0,0,32,32
1656002844000,MATH 142A,A02,083220,Chow; Bennett,7,0,32,25
1656002844000,MATH 142A,A03,093480,Staff,4,0,32,28
1656002844000,MATH 142A,B03,093481,Staff,3,0,32,29
1656002844000,MATH 142A,B04,093558,Staff,6,0,32,26
1656002844000,MATH 142A,B05,093559,Staff,0,0,32,32
1656002850031,MATH 193A,A01,083224,Rotar; Vladimir,1,1,34,33
1656002850031,MATH 193A,A02,083225,Rotar; Vladimir,0,0,34,34
1656002850031,MATH 193A,A03,083781,Rotar; Vladimir,2,0,34,32
1656002850031,MATH 193A,A04,083782,Rotar; Vladimir,3,0,34,31
1656002850031,MATH 193A,A05,093482,Rotar; Vladimir,0,0,34,34
1656002856068,MATH 197,001,091859,McAuley; Julian John,9999,0,9999,0
1656002856068,MATH 197,002,095566,Kedlaya; Kiran S.,9997,0,9999,2
1656002856068,MATH 197,003,095567,Xiao; Ming,9999,0,9999,0
1656002856068,MATH 197,004,095571,Perols; Johan Lars,9998,0,9999,1
1656002863141,COGS 9,A01,083615,Shannon; Kyle Michael,3,1,75,72
1656002869181,COGS 11,A01,083617,Boyle; Mary E. T.,11,1,48,37
1656002875216,COGS 13,A01,083071,Bastos; Amalia Pinkusfeld,3,2,71,68
1656002881245,COGS 14A,A01,092681,Semenuks; Arturs,4,25,100,96
1656002887279,COGS 14B,A01,083073,Cheng; Tzu-Han,7,0,63,56
1656002893306,COGS 17,A01,092677,Semenuks; Arturs,8,7,81,73
1656002899334,COGS 100,A01,083619,Allen; Michael Gordon,2,2,70,68
1656002905371,COGS 101A,A01,083621,Davis; Joshua Daniel,4,3,68,64
1656002911394,COGS 101B,A01,091572,Allen; Michael Gordon,0,0,65,65
1656002917438,COGS 101C,A01,083625,Delgado; Tania,7,0,35,28
1656002923473,COGS 107A,A01,083627,Boyle; Mary E. T.,1,2,60,59
1656002929520,COGS 118A,A01,083075,Gupta; Anjum,21,16,76,55
1656002935548,CSE 3,A50,083646,Miranda; Gregory Joseph,14,0,50,36
1656002941576,CSE 8A,A50,083650,Miranda; Gregory Joseph,3,11,56,53
1656002947603,CSE 11,A01,083080,Cao; Yingjun,0,65,40,40
1656002953642,CSE 12,A01,083652,Krause-Levy; Sophia Louisa,6,8,120,114
1656002959674,CSE 15L,A01,083654,Morris; Justin Loren,3,1,50,47
1656002959674,CSE 15L,A02,083655,Morris; Justin Loren,1,1,50,49
1656002965724,CSE 20,A01,083657,Tran; Khoa Dang,29,0,80,51
1656002971762,CSE 21,A01,095574,Bach; Quang Tran,23,0,48,25
1656002977801,CSE 30,A01,083084,Eldon; John,2,10,80,78
1656002977801,CSE 30,B01,095061,Bhaskar; Nishant,0,4,50,50
1656002983824,CSE 100,A01,083659,Cao; Yingjun,2,25,70,68
1656002989851,CSE 134B,A01,083661,Powell; Thomas Allan,6,7,100,94
1656002995897,CSE 140,A01,083663,Gungor; Onat,5,0,85,80
1656003001936,CSE 140L,A01,083088,Eldon; John,5,0,100,95
1656003007962,CSE 175,A01,083665,Kumar; Rakesh,1,0,25,24
1656003013985,CSE 190,A00,092507,Dubnov; Shlomo,1,0,20,19
1656003020020,ECE 45,A01,083139,Congero; Spencer William,0,1,75,75
1656003026045,ECE 65,A50,083695,Saad; Andrew S,6,0,30,24
1656003026045,ECE 65,A51,095125,Staff,23,0,26,3
1656003032095,ECE 109,A01,091882,Touri; Behrouz,2,4,70,68
1656003038138,ECE 180,A00,083140,Abi Samra; Nicholas Camill,1,0,30,29
1656003038138,ECE 180,B00,083141,Abi Samra; Nicholas Camill,0,8,28,28
1656003044161,MATH 10A,A01,083735,Patchell; Gregory David,0,0,30,30
1656003044161,MATH 10A,A02,083736,Patchell; Gregory David,21,0,30,9
1656003044161,MATH 10A,A03,083737,Patchell; Gregory David,16,0,30,14
1656003050217,MATH 10B,A01,083207,Lim; Seonhee,1,1,34,33
1656003050217,MATH 10B,A02,083208,Lim; Seonhee,1,1,35,34
1656003050217,MATH 10B,A03,093472,Staff,1,0,34,33
1656003050217,MATH 10B,B01,083739,Sinha; Shubham,9,0,30,21
1656003056264,MATH 18,A01,083743,Cinel; Cameron Alexander,5,0,30,25
1656003056264,MATH 18,A02,083744,Cinel; Cameron Alexander,11,0,30,19
1656003056264,MATH 18,A03,083745,Cinel; Cameron Alexander,1,0,30,29
1656003056264,MATH 18,B01,083748,Ma; Zilu,2,0,36,34
1656003056264,MATH 18,B02,083749,Ma; Zilu,0,0,36,36
1656003056264,MATH 18,B03,083750,Ma; Zilu,0,0,36,36
1656003056264,MATH 18,B04,083751,Ma; Zilu,0,0,36,36
1656003056264,MATH 18,B05,093473,Staff,0,0,36,36
1656003056264,MATH 18,B06,093474,Staff,1,0,36,35
1656003062286,MATH 20A,A01,083754,Zheng; Zequn,10,0,40,30
1656003068325,MATH 20B,A01,083756,Briones; Jor-el Thomas Caparas,0,1,36,36
1656003068325,MATH 20B,A02,083757,Briones; Jor-el Thomas Caparas,1,0,36,35
1656003068325,MATH 20B,A03,093475,Staff,0,0,36,36
1656003074355,MATH 20C,A01,083760,Briones; Jor-el Thomas Caparas,0,2,35,35
1656003074355,MATH 20C,A02,083761,Briones; Jor-el Thomas Caparas,6,1,35,29
1656003074355,MATH 20C,A03,093476,Staff,0,0,35,35
1656003074355,MATH 20C,B01,083762,Bach; Quang Tran,3,0,30,27
1656003080392,MATH 20D,A01,083765,Tran; Brian Kha,1,0,30,29
1656003080392,MATH 20D,A02,083766,Tran; Brian Kha,0,1,30,30
1656003080392,MATH 20D,A03,083767,Tran; Brian Kha,1,0,30,29
1656003086425,MATH 20E,A01,083771,Ganguly; Soumya,0,1,32,32
1656003086425,MATH 20E,A02,083772,Ganguly; Soumya,1,1,32,31
1656003086425,MATH 20E,B01,083773,Ciotti; Benjamin,14,0,35,21
1656003086425,MATH 20E,B02,083774,Ciotti; Benjamin,12,0,35,23
1656003092450,MATH 103A,A01,083777,Greenfeld; Be'Eri,2,1,36,34
1656003092450,MATH 103A,A02,083778,Greenfeld; Be'Eri,2,0,36,34
1656003092450,MATH 103A,A03,093561,Staff,0,1,36,36
1656003092450,MATH 103A,B01,083779,Greenfeld; Be'Eri,7,1,36,29
1656003092450,MATH 103A,B02,083780,Greenfeld; Be'Eri,0,0,36,36
1656003092450,MATH 103A,B03,093562,Staff,0,0,36,36
1656003098474,MATH 105,A01,085443,Carter; Anne Toulson,4,1,35,31
1656003098474,MATH 105,A02,093477,Staff,8,0,35,27
1656003104497,MATH 109,A01,083213,Ganzberger; Geoffrey Michael,0,1,34,34
1656003104497,MATH 109,A02,083214,Ganzberger; Geoffrey Michael,0,0,34,34
1656003104497,MATH 109,A03,093478,Staff,1,0,34,33
1656003104497,MATH 109,B01,083215,Ganzberger; Geoffrey Michael,2,0,32,30
1656003104497,MATH 109,B02,083216,Ganzberger; Geoffrey Michael,0,0,32,32
1656003104497,MATH 109,B03,093479,Staff,4,0,32,28
1656003110556,MATH 142A,A01,083219,Chow; Bennett,0,0,32,32
1656003110556,MATH 142A,A02,083220,Chow; Bennett,7,0,32,25
1656003110556,MATH 142A,A03,093480,Staff,4,0,32,28
1656003110556,MATH 142A,B03,093481,Staff,3,0,32,29
1656003110556,MATH 142A,B04,093558,Staff,6,0,32,26
1656003110556,MATH 142A,B05,093559,Staff,0,0,32,32
1656003116610,MATH 193A,A01,083224,Rotar; Vladimir,1,1,34,33
1656003116610,MATH 193A,A02,083225,Rotar; Vladimir,0,0,34,34
1656003116610,MATH 193A,A03,083781,Rotar; Vladimir,2,0,34,32
1656003116610,MATH 193A,A04,083782,Rotar; Vladimir,3,0,34,31
1656003116610,MATH 193A,A05,093482,Rotar; Vladimir,0,0,34,34
1656003122650,MATH 197,001,091859,McAuley; Julian John,9999,0,9999,0
1656003122650,MATH 197,002,095566,Kedlaya; Kiran S.,9997,0,9999,2
1656003122650,MATH 197,003,095567,Xiao; Ming,9999,0,9999,0
1656003122650,MATH 197,004,095571,Perols; Johan Lars,9998,0,9999,1
1656003129728,COGS 9,A01,083615,Shannon; Kyle Michael,3,1,75,72
1656003135785,COGS 11,A01,083617,Boyle; Mary E. T.,11,1,48,37
1656003141818,COGS 13,A01,083071,Bastos; Amalia Pinkusfeld,3,2,71,68
1656003147854,COGS 14A,A01,092681,Semenuks; Arturs,4,25,100,96
1656003153890,COGS 14B,A01,083073,Cheng; Tzu-Han,7,0,63,56
1656003159917,COGS 17,A01,092677,Semenuks; Arturs,8,7,81,73
1656003165944,COGS 100,A01,083619,Allen; Michael Gordon,2,2,70,68
1656003171968,COGS 101A,A01,083621,Davis; Joshua Daniel,4,3,68,64
1656003178005,COGS 101B,A01,091572,Allen; Michael Gordon,0,0,65,65
1656003184041,COGS 101C,A01,083625,Delgado; Tania,7,0,35,28
1656003190092,COGS 107A,A01,083627,Boyle; Mary E. T.,1,2,60,59
1656003196122,COGS 118A,A01,083075,Gupta; Anjum,21,16,76,55
1656003202154,CSE 3,A50,083646,Miranda; Gregory Joseph,14,0,50,36
1656003208197,CSE 8A,A50,083650,Miranda; Gregory Joseph,3,11,56,53
1656003214286,CSE 11,A01,083080,Cao; Yingjun,0,65,40,40
1656003220308,CSE 12,A01,083652,Krause-Levy; Sophia Louisa,6,8,120,114
1656003226335,CSE 15L,A01,083654,Morris; Justin Loren,3,1,50,47
1656003226335,CSE 15L,A02,083655,Morris; Justin Loren,1,1,50,49
1656003232391,CSE 20,A01,083657,Tran; Khoa Dang,29,0,80,51
1656003238432,CSE 21,A01,095574,Bach; Quang Tran,23,0,48,25
1656003244481,CSE 30,A01,083084,Eldon; John,2,10,80,78
1656003244481,CSE 30,B01,095061,Bhaskar; Nishant,0,4,50,50
1656003250510,CSE 100,A01,083659,Cao; Yingjun,2,25,70,68
1656003256534,CSE 134B,A01,083661,Powell; Thomas Allan,6,7,100,94
1656003262574,CSE 140,A01,083663,Gungor; Onat,5,0,85,80
1656003268597,CSE 140L,A01,083088,Eldon; John,5,0,100,95
1656003274649,CSE 175,A01,083665,Kumar; Rakesh,1,0,25,24
1656003280701,CSE 190,A00,092507,Dubnov; Shlomo,1,0,20,19
1656003286731,ECE 45,A01,083139,Congero; Spencer William,0,1,75,75
1656003292782,ECE 65,A50,083695,Saad; Andrew S,6,0,30,24
1656003292782,ECE 65,A51,095125,Staff,23,0,26,3
1656003298812,ECE 109,A01,091882,Touri; Behrouz,2,4,70,68
1656003304839,ECE 180,A00,083140,Abi Samra; Nicholas Camill,1,0,30,29
1656003304839,ECE 180,B00,083141,Abi Samra; Nicholas Camill,0,8,28,28
1656003310862,MATH 10A,A01,083735,Patchell; Gregory David,0,0,30,30
1656003310862,MATH 10A,A02,083736,Patchell; Gregory David,21,0,30,9
1656003310862,MATH 10A,A03,083737,Patchell; Gregory David,16,0,30,14
1656003316907,MATH 10B,A01,083207,Lim; Seonhee,1,1,34,33
1656003316907,MATH 10B,A02,083208,Lim; Seonhee,1,1,35,34
1656003316907,MATH 10B,A03,093472,Staff,1,0,34,33
1656003316907,MATH 10B,B01,083739,Sinha; Shubham,9,0,30,21
1656003322935,MATH 18,A01,083743,Cinel; Cameron Alexander,5,0,30,25
1656003322935,MATH 18,A02,083744,Cinel; Cameron Alexander,11,0,30,19
1656003322935,MATH 18,A03,083745,Cinel; Cameron Alexander,1,0,30,29
1656003322935,MATH 18,B01,083748,Ma; Zilu,2,0,36,34
1656003322935,MATH 18,B02,083749,Ma; Zilu,0,0,36,36
1656003322935,MATH 18,B03,083750,Ma; Zilu,0,0,36,36
1656003322935,MATH 18,B04,083751,Ma; Zilu,0,0,36,36
1656003322935,MATH 18,B05,093473,Staff,0,0,36,36
1656003322935,MATH 18,B06,093474,Staff,1,0,36,35
1656003328971,MATH 20A,A01,083754,Zheng; Zequn,10,0,40,30
1656003335015,MATH 20B,A01,083756,Briones; Jor-el Thomas Caparas,0,1,36,36
1656003335015,MATH 20B,A02,083757,Briones; Jor-el Thomas Caparas,1,0,36,35
1656003335015,MATH 20B,A03,093475,Staff,0,0,36,36
1656003341062,MATH 20C,A01,083760,Briones; Jor-el Thomas Caparas,0,2,35,35
1656003341062,MATH 20C,A02,083761,Briones; Jor-el Thomas Caparas,6,1,35,29
1656003341062,MATH 20C,A03,093476,Staff,0,0,35,35
1656003341062,MATH 20C,B01,083762,Bach; Quang Tran,3,0,30,27
1656003347085,MATH 20D,A01,083765,Tran; Brian Kha,1,0,30,29
1656003347085,MATH 20D,A02,083766,Tran; Brian Kha,0,1,30,30
1656003347085,MATH 20D,A03,083767,Tran; Brian Kha,1,0,30,29
1656003353110,MATH 20E,A01,083771,Ganguly; Soumya,0,1,32,32
1656003353110,MATH 20E,A02,083772,Ganguly; Soumya,1,1,32,31
1656003353110,MATH 20E,B01,083773,Ciotti; Benjamin,14,0,35,21
1656003353110,MATH 20E,B02,083774,Ciotti; Benjamin,12,0,35,23
1656003359136,MATH 103A,A01,083777,Greenfeld; Be'Eri,2,1,36,34
1656003359136,MATH 103A,A02,083778,Greenfeld; Be'Eri,2,0,36,34
1656003359136,MATH 103A,A03,093561,Staff,0,1,36,36
1656003359136,MATH 103A,B01,083779,Greenfeld; Be'Eri,7,1,36,29
1656003359136,MATH 103A,B02,083780,Greenfeld; Be'Eri,0,0,36,36
1656003359136,MATH 103A,B03,093562,Staff,0,0,36,36
1656003365177,MATH 105,A01,085443,Carter; Anne Toulson,4,1,35,31
1656003365177,MATH 105,A02,093477,Staff,8,0,35,27
1656003371209,MATH 109,A01,083213,Ganzberger; Geoffrey Michael,0,1,34,34
1656003371209,MATH 109,A02,083214,Ganzberger; Geoffrey Michael,0,0,34,34
1656003371209,MATH 109,A03,093478,Staff,1,0,34,33
1656003371209,MATH 109,B01,083215,Ganzberger; Geoffrey Michael,2,0,32,30
1656003371209,MATH 109,B02,083216,Ganzberger; Geoffrey Michael,0,0,32,32
1656003371209,MATH 109,B03,093479,Staff,4,0,32,28
1656003377236,MATH 142A,A01,083219,Chow; Bennett,0,0,32,32
1656003377236,MATH 142A,A02,083220,Chow; Bennett,7,0,32,25
1656003377236,MATH 142A,A03,093480,Staff,4,0,32,28
1656003377236,MATH 142A,B03,093481,Staff,3,0,32,29
1656003377236,MATH 142A,B04,093558,Staff,6,0,32,26
1656003377236,MATH 142A,B05,093559,Staff,0,0,32,32
1656003383278,MATH 193A,A01,083224,Rotar; Vladimir,1,1,34,33
1656003383278,MATH 193A,A02,083225,Rotar; Vladimir,0,0,34,34
1656003383278,MATH 193A,A03,083781,Rotar; Vladimir,2,0,34,32
1656003383278,MATH 193A,A04,083782,Rotar; Vladimir,3,0,34,31
1656003383278,MATH 193A,A05,093482,Rotar; Vladimir,0,0,34,34
1656003389323,MATH 197,001,091859,McAuley; Julian John,9999,0,9999,0
1656003389323,MATH 197,002,095566,Kedlaya; Kiran S.,9997,0,9999,2
1656003389323,MATH 197,003,095567,Xiao; Ming,9999,0,9999,0
1656003389323,MATH 197,004,095571,Perols; Johan Lars,9998,0,9999,1
1656003396492,COGS 9,A01,083615,Shannon; Kyle Michael,3,1,75,72
1656003402528,COGS 11,A01,083617,Boyle; Mary E. T.,11,1,48,37
1656003408580,COGS 13,A01,083071,Bastos; Amalia Pinkusfeld,3,2,71,68
1656003414632,COGS 14A,A01,092681,Semenuks; Arturs,4,25,100,96
1656003420677,COGS 14B,A01,083073,Cheng; Tzu-Han,7,0,63,56
1656003426705,COGS 17,A01,092677,Semenuks; Arturs,8,7,81,73
1656003432728,COGS 100,A01,083619,Allen; Michael Gordon,2,2,70,68
1656003438756,COGS 101A,A01,083621,Davis; Joshua Daniel,4,3,68,64
1656003444810,COGS 101B,A01,091572,Allen; Michael Gordon,0,0,65,65
1656003450852,COGS 101C,A01,083625,Delgado; Tania,7,0,35,28
1656003456905,COGS 107A,A01,083627,Boyle; Mary E. T.,1,2,60,59
1656003462958,COGS 118A,A01,083075,Gupta; Anjum,21,16,76,55
1656003469009,CSE 3,A50,083646,Miranda; Gregory Joseph,14,0,50,36
1656003475039,CSE 8A,A50,083650,Miranda; Gregory Joseph,3,11,56,53
1656003481071,CSE 11,A01,083080,Cao; Yingjun,0,65,40,40
1656003487118,CSE 12,A01,083652,Krause-Levy; Sophia Louisa,6,8,120,114
1656003493151,CSE 15L,A01,083654,Morris; Justin Loren,3,1,50,47
1656003493151,CSE 15L,A02,083655,Morris; Justin Loren,1,1,50,49
1656003499185,CSE 20,A01,083657,Tran; Khoa Dang,29,0,80,51
1656003505207,CSE 21,A01,095574,Bach; Quang Tran,23,0,48,25
1656003511231,CSE 30,A01,083084,Eldon; John,2,10,80,78
1656003511231,CSE 30,B01,095061,Bhaskar; Nishant,0,4,50,50
1656003517271,CSE 100,A01,083659,Cao; Yingjun,2,25,70,68
1656003523325,CSE 134B,A01,083661,Powell; Thomas Allan,6,7,100,94
1656003529354,CSE 140,A01,083663,Gungor; Onat,5,0,85,80
1656003535396,CSE 140L,A01,083088,Eldon; John,5,0,100,95
1656003541441,CSE 175,A01,083665,Kumar; Rakesh,1,0,25,24
1656003547495,CSE 190,A00,092507,Dubnov; Shlomo,1,0,20,19
1656003553542,ECE 45,A01,083139,Congero; Spencer William,0,1,75,75
1656003559578,ECE 65,A50,083695,Saad; Andrew S,6,0,30,24
1656003559578,ECE 65,A51,095125,Staff,23,0,26,3
1656003565630,ECE 109,A01,091882,Touri; Behrouz,2,4,70,68
1656003571671,ECE 180,A00,083140,Abi Samra; Nicholas Camill,1,0,30,29
1656003571671,ECE 180,B00,083141,Abi Samra; Nicholas Camill,0,8,28,28
1656003577711,MATH 10A,A01,083735,Patchell; Gregory David,0,0,30,30
1656003577711,MATH 10A,A02,083736,Patchell; Gregory David,21,0,30,9
1656003577711,MATH 10A,A03,083737,Patchell; Gregory David,16,0,30,14
1656003583763,MATH 10B,A01,083207,Lim; Seonhee,1,1,34,33
1656003583763,MATH 10B,A02,083208,Lim; Seonhee,1,1,35,34
1656003583763,MATH 10B,A03,093472,Staff,1,0,34,33
1656003583763,MATH 10B,B01,083739,Sinha; Shubham,9,0,30,21
1656003589791,MATH 18,A01,083743,Cinel; Cameron Alexander,5,0,30,25
1656003589791,MATH 18,A02,083744,Cinel; Cameron Alexander,11,0,30,19
1656003589791,MATH 18,A03,083745,Cinel; Cameron Alexander,1,0,30,29
1656003589791,MATH 18,B01,083748,Ma; Zilu,2,0,36,34
1656003589791,MATH 18,B02,083749,Ma; Zilu,0,0,36,36
1656003589791,MATH 18,B03,083750,Ma; Zilu,0,0,36,36
1656003589791,MATH 18,B04,083751,Ma; Zilu,0,0,36,36
1656003589791,MATH 18,B05,093473,Staff,0,0,36,36
1656003589791,MATH 18,B06,093474,Staff,1,0,36,35
1656003595814,MATH 20A,A01,083754,Zheng; Zequn,10,0,40,30
1656003601843,MATH 20B,A01,083756,Briones; Jor-el Thomas Caparas,0,1,36,36
1656003601843,MATH 20B,A02,083757,Briones; Jor-el Thomas Caparas,1,0,36,35
1656003601843,MATH 20B,A03,093475,Staff,0,0,36,36
1656003607875,MATH 20C,A01,083760,Briones; Jor-el Thomas Caparas,0,2,35,35
1656003607875,MATH 20C,A02,083761,Briones; Jor-el Thomas Caparas,6,1,35,29
1656003607875,MATH 20C,A03,093476,Staff,0,0,35,35
1656003607875,MATH 20C,B01,083762,Bach; Quang Tran,3,0,30,27
1656003613911,MATH 20D,A01,083765,Tran; Brian Kha,1,0,30,29
1656003613911,MATH 20D,A02,083766,Tran; Brian Kha,0,1,30,30
1656003613911,MATH 20D,A03,083767,Tran; Brian Kha,1,0,30,29
1656003619938,MATH 20E,A01,083771,Ganguly; Soumya,0,1,32,32
1656003619938,MATH 20E,A02,083772,Ganguly; Soumya,1,1,32,31
1656003619938,MATH 20E,B01,083773,Ciotti; Benjamin,14,0,35,21
1656003619938,MATH 20E,B02,083774,Ciotti; Benjamin,12,0,35,23
1656003625963,MATH 103A,A01,083777,Greenfeld; Be'Eri,2,1,36,34
1656003625963,MATH 103A,A02,083778,Greenfeld; Be'Eri,2,0,36,34
1656003625963,MATH 103A,A03,093561,Staff,0,1,36,36
1656003625963,MATH 103A,B01,083779,Greenfeld; Be'Eri,7,1,36,29
1656003625963,MATH 103A,B02,083780,Greenfeld; Be'Eri,0,0,36,36
1656003625963,MATH 103A,B03,093562,Staff,0,0,36,36
1656003631990,MATH 105,A01,085443,Carter; Anne Toulson,4,1,35,31
1656003631990,MATH 105,A02,093477,Staff,8,0,35,27
1656003638036,MATH 109,A01,083213,Ganzberger; Geoffrey Michael,0,1,34,34
1656003638036,MATH 109,A02,083214,Ganzberger; Geoffrey Michael,0,0,34,34
1656003638036,MATH 109,A03,093478,Staff,1,0,34,33
1656003638036,MATH 109,B01,083215,Ganzberger; Geoffrey Michael,2,0,32,30
1656003638036,MATH 109,B02,083216,Ganzberger; Geoffrey Michael,0,0,32,32
1656003638036,MATH 109,B03,093479,Staff,4,0,32,28
1656003644074,MATH 142A,A01,083219,Chow; Bennett,0,0,32,32
1656003644074,MATH 142A,A02,083220,Chow; Bennett,7,0,32,25
1656003644074,MATH 142A,A03,093480,Staff,4,0,32,28
1656003644074,MATH 142A,B03,093481,Staff,3,0,32,29
1656003644074,MATH 142A,B04,093558,Staff,6,0,32,26
1656003644074,MATH 142A,B05,093559,Staff,0,0,32,32
1656003650107,MATH 193A,A01,083224,Rotar; Vladimir,1,1,34,33
1656003650107,MATH 193A,A02,083225,Rotar; Vladimir,0,0,34,34
1656003650107,MATH 193A,A03,083781,Rotar; Vladimir,2,0,34,32
1656003650107,MATH 193A,A04,083782,Rotar; Vladimir,3,0,34,31
1656003650107,MATH 193A,A05,093482,Rotar; Vladimir,0,0,34,34
1656003656129,MATH 197,001,091859,McAuley; Julian John,9999,0,9999,0
1656003656129,MATH 197,002,095566,Kedlaya; Kiran S.,9997,0,9999,2
1656003656129,MATH 197,003,095567,Xiao; Ming,9999,0,9999,0
1656003656129,MATH 197,004,095571,Perols; Johan Lars,9998,0,9999,1
1656003663238,COGS 9,A01,083615,Shannon; Kyle Michael,3,1,75,72
1656003669271,COGS 11,A01,083617,Boyle; Mary E. T.,11,1,48,37
1656003675305,COGS 13,A01,083071,Bastos; Amalia Pinkusfeld,3,2,71,68
1656003681327,COGS 14A,A01,092681,Semenuks; Arturs,4,25,100,96
1656003687350,COGS 14B,A01,083073,Cheng; Tzu-Han,7,0,63,56
1656003693377,COGS 17,A01,092677,Semenuks; Arturs,8,7,81,73
1656003699413,COGS 100,A01,083619,Allen; Michael Gordon,2,2,70,68
1656003705478,COGS 101A,A01,083621,Davis; Joshua Daniel,4,3,68,64
1656003711516,COGS 101B,A01,091572,Allen; Michael Gordon,0,0,65,65
1656003717563,COGS 101C,A01,083625,Delgado; Tania,7,0,35,28
1656003723606,COGS 107A,A01,083627,Boyle; Mary E. T.,1,2,60,59
1656003729632,COGS 118A,A01,083075,Gupta; Anjum,21,16,76,55
1656003735658,CSE 3,A50,083646,Miranda; Gregory Joseph,14,0,50,36
1656003741685,CSE 8A,A50,083650,Miranda; Gregory Joseph,3,11,56,53
1656003747731,CSE 11,A01,083080,Cao; Yingjun,0,65,40,40
1656003753785,CSE 12,A01,083652,Krause-Levy; Sophia Louisa,6,8,120,114
1656003759838,CSE 15L,A01,083654,Morris; Justin Loren,3,1,50,47
1656003759838,CSE 15L,A02,083655,Morris; Justin Loren,1,1,50,49
1656003765864,CSE 20,A01,083657,Tran; Khoa Dang,29,0,80,51
1656003771898,CSE 21,A01,095574,Bach; Quang Tran,23,0,48,25
1656003777925,CSE 30,A01,083084,Eldon; John,2,10,80,78
1656003777925,CSE 30,B01,095061,Bhaskar; Nishant,0,4,50,50
1656003783948,CSE 100,A01,083659,Cao; Yingjun,2,25,70,68
1656003789972,CSE 134B,A01,083661,Powell; Thomas Allan,6,7,100,94
1656003795994,CSE 140,A01,083663,Gungor; Onat,5,0,85,80
1656003802030,CSE 140L,A01,083088,Eldon; John,5,0,100,95
1656003808085,CSE 175,A01,083665,Kumar; Rakesh,1,0,25,24
1656003814134,CSE 190,A00,092507,Dubnov; Shlomo,1,0,20,19
1656003820175,ECE 45,A01,083139,Congero; Spencer William,0,1,75,75
1656003826220,ECE 65,A50,083695,Saad; Andrew S,6,0,30,24
1656003826220,ECE 65,A51,095125,Staff,23,0,26,3
1656003832276,ECE 109,A01,091882,Touri; Behrouz,2,4,70,68
1656003838334,ECE 180,A00,083140,Abi Samra; Nicholas Camill,1,0,30,29
1656003838334,ECE 180,B00,083141,Abi Samra; Nicholas Camill,0,8,28,28
1656003844385,MATH 10A,A01,083735,Patchell; Gregory David,0,0,30,30
1656003844385,MATH 10A,A02,083736,Patchell; Gregory David,21,0,30,9
1656003844385,MATH 10A,A03,083737,Patchell; Gregory David,16,0,30,14
1656003850426,MATH 10B,A01,083207,Lim; Seonhee,1,1,34,33
1656003850426,MATH 10B,A02,083208,Lim; Seonhee,1,1,35,34
1656003850426,MATH 10B,A03,093472,Staff,1,0,34,33
1656003850426,MATH 10B,B01,083739,Sinha; Shubham,9,0,30,21
1656003867043,MATH 18,A01,083743,Cinel; Cameron Alexander,5,0,30,25
1656003867043,MATH 18,A02,083744,Cinel; Cameron Alexander,11,0,30,19
1656003867043,MATH 18,A03,083745,Cinel; Cameron Alexander,1,0,30,29
1656003867043,MATH 18,B01,083748,Ma; Zilu,2,0,36,34
1656003867043,MATH 18,B02,083749,Ma; Zilu,0,0,36,36
1656003867043,MATH 18,B03,083750,Ma; Zilu,0,0,36,36
1656003867043,MATH 18,B04,083751,Ma; Zilu,0,0,36,36
1656003867043,MATH 18,B05,093473,Staff,0,0,36,36
1656003867043,MATH 18,B06,093474,Staff,1,0,36,35
1656003873105,MATH 20A,A01,083754,Zheng; Zequn,10,0,40,30
1656003879155,MATH 20B,A01,083756,Briones; Jor-el Thomas Caparas,0,1,36,36
1656003879155,MATH 20B,A02,083757,Briones; Jor-el Thomas Caparas,1,0,36,35
1656003879155,MATH 20B,A03,093475,Staff,0,0,36,36
1656003885213,MATH 20C,A01,083760,Briones; Jor-el Thomas Caparas,0,2,35,35
1656003885213,MATH 20C,A02,083761,Briones; Jor-el Thomas Caparas,6,1,35,29
1656003885213,MATH 20C,A03,093476,Staff,0,0,35,35
1656003885213,MATH 20C,B01,083762,Bach; Quang Tran,3,0,30,27
1656003891249,MATH 20D,A01,083765,Tran; Brian Kha,1,0,30,29
1656003891249,MATH 20D,A02,083766,Tran; Brian Kha,0,1,30,30
1656003891249,MATH 20D,A03,083767,Tran; Brian Kha,1,0,30,29
1656003897298,MATH 20E,A01,083771,Ganguly; Soumya,0,1,32,32
1656003897298,MATH 20E,A02,083772,Ganguly; Soumya,1,1,32,31
1656003897298,MATH 20E,B01,083773,Ciotti; Benjamin,14,0,35,21
1656003897298,MATH 20E,B02,083774,Ciotti; Benjamin,12,0,35,23
1656003903350,MATH 103A,A01,083777,Greenfeld; Be'Eri,2,1,36,34
1656003903350,MATH 103A,A02,083778,Greenfeld; Be'Eri,2,0,36,34
1656003903350,MATH 103A,A03,093561,Staff,0,1,36,36
1656003903350,MATH 103A,B01,083779,Greenfeld; Be'Eri,7,1,36,29
1656003903350,MATH 103A,B02,083780,Greenfeld; Be'Eri,0,0,36,36
1656003903350,MATH 103A,B03,093562,Staff,0,0,36,36
1656003909376,MATH 105,A01,085443,Carter; Anne Toulson,4,1,35,31
1656003909376,MATH 105,A02,093477,Staff,8,0,35,27
1656003915440,MATH 109,A01,083213,Ganzberger; Geoffrey Michael,0,1,34,34
1656003915440,MATH 109,A02,083214,Ganzberger; Geoffrey Michael,0,0,34,34
1656003915440,MATH 109,A03,093478,Staff,1,0,34,33
1656003915440,MATH 109,B01,083215,Ganzberger; Geoffrey Michael,2,0,32,30
1656003915440,MATH 109,B02,083216,Ganzberger; Geoffrey Michael,0,0,32,32
1656003915440,MATH 109,B03,093479,Staff,4,0,32,28
1656003921469,MATH 142A,A01,083219,Chow; Bennett,0,0,32,32
1656003921469,MATH 142A,A02,083220,Chow; Bennett,7,0,32,25
1656003921469,MATH 142A,A03,093480,Staff,4,0,32,28
1656003921469,MATH 142A,B03,093481,Staff,3,0,32,29
1656003921469,MATH 142A,B04,093558,Staff,6,0,32,26
1656003921469,MATH 142A,B05,093559,Staff,0,0,32,32
1656003927492,MATH 193A,A01,083224,Rotar; Vladimir,1,1,34,33
1656003927492,MATH 193A,A02,083225,Rotar; Vladimir,0,0,34,34
1656003927492,MATH 193A,A03,083781,Rotar; Vladimir,2,0,34,32
1656003927492,MATH 193A,A04,083782,Rotar; Vladimir,3,0,34,31
1656003927492,MATH 193A,A05,093482,Rotar; Vladimir,0,0,34,34
1656003933519,MATH 197,001,091859,McAuley; Julian John,9999,0,9999,0
1656003933519,MATH 197,002,095566,Kedlaya; Kiran S.,9997,0,9999,2
1656003933519,MATH 197,003,095567,Xiao; Ming,9999,0,9999,0
1656003933519,MATH 197,004,095571,Perols; Johan Lars,9998,0,9999,1
1656003940602,COGS 9,A01,083615,Shannon; Kyle Michael,3,1,75,72
1656003946649,COGS 11,A01,083617,Boyle; Mary E. T.,11,1,48,37
1656003952710,COGS 13,A01,083071,Bastos; Amalia Pinkusfeld,3,2,71,68
1656003958758,COGS 14A,A01,092681,Semenuks; Arturs,4,25,100,96
1656003964810,COGS 14B,A01,083073,Cheng; Tzu-Han,7,0,63,56
1656003970861,COGS 17,A01,092677,Semenuks; Arturs,8,7,81,73
1656003976886,COGS 100,A01,083619,Allen; Michael Gordon,2,2,70,68
1656003982915,COGS 101A,A01,083621,Davis; Joshua Daniel,4,3,68,64
1656003988947,COGS 101B,A01,091572,Allen; Michael Gordon,0,0,65,65
1656003994973,COGS 101C,A01,083625,Delgado; Tania,7,0,35,28
1656004001101,COGS 107A,A01,083627,Boyle; Mary E. T.,1,2,60,59
1656004007137,COGS 118A,A01,083075,Gupta; Anjum,21,16,76,55
1656004013172,CSE 3,A50,083646,Miranda; Gregory Joseph,14,0,50,36
1656004019206,CSE 8A,A50,083650,Miranda; Gregory Joseph,3,11,56,53
1656004025235,CSE 11,A01,083080,Cao; Yingjun,0,65,40,40
1656004031281,CSE 12,A01,083652,Krause-Levy; Sophia Louisa,6,8,120,114
1656004037331,CSE 15L,A01,083654,Morris; Justin Loren,3,1,50,47
1656004037331,CSE 15L,A02,083655,Morris; Justin Loren,1,1,50,49
1656004043365,CSE 20,A01,083657,Tran; Khoa Dang,29,0,80,51
1656004049388,CSE 21,A01,095574,Bach; Quang Tran,23,0,48,25
1656004055420,CSE 30,A01,083084,Eldon; John,2,10,80,78
1656004055420,CSE 30,B01,095061,Bhaskar; Nishant,0,4,50,50
1656004061444,CSE 100,A01,083659,Cao; Yingjun,2,25,70,68
1656004067493,CSE 134B,A01,083661,Powell; Thomas Allan,6,7,100,94
1656004073520,CSE 140,A01,083663,Gungor; Onat,5,0,85,80
1656004079551,CSE 140L,A01,083088,Eldon; John,5,0,100,95
1656004085578,CSE 175,A01,083665,Kumar; Rakesh,1,0,25,24
1656004091605,CSE 190,A00,092507,Dubnov; Shlomo,1,0,20,19
1656004097651,ECE 45,A01,083139,Congero; Spencer William,0,1,75,75
1656004103679,ECE 65,A50,083695,Saad; Andrew S,6,0,30,24
1656004103679,ECE 65,A51,095125,Staff,23,0,26,3
1656004109703,ECE 109,A01,091882,Touri; Behrouz,2,4,70,68
1656004115748,ECE 180,A00,083140,Abi Samra; Nicholas Camill,1,0,30,29
1656004115748,ECE 180,B00,083141,Abi Samra; Nicholas Camill,0,8,28,28
1656004121794,MATH 10A,A01,083735,Patchell; Gregory David,0,0,30,30
1656004121794,MATH 10A,A02,083736,Patchell; Gregory David,21,0,30,9
1656004121794,MATH 10A,A03,083737,Patchell; Gregory David,16,0,30,14
1656004127820,MATH 10B,A01,083207,Lim; Seonhee,1,1,34,33
1656004127820,MATH 10B,A02,083208,Lim; Seonhee,1,1,35,34
1656004127820,MATH 10B,A03,093472,Staff,1,0,34,33
1656004127820,MATH 10B,B01,083739,Sinha; Shubham,9,0,30,21
1656004133863,MATH 18,A01,083743,Cinel; Cameron Alexander,5,0,30,25
1656004133863,MATH 18,A02,083744,Cinel; Cameron Alexander,11,0,30,19
1656004133863,MATH 18,A03,083745,Cinel; Cameron Alexander,1,0,30,29
1656004133863,MATH 18,B01,083748,Ma; Zilu,2,0,36,34
1656004133863,MATH 18,B02,083749,Ma; Zilu,0,0,36,36
1656004133863,MATH 18,B03,083750,Ma; Zilu,0,0,36,36
1656004133863,MATH 18,B04,083751,Ma; Zilu,0,0,36,36
1656004133863,MATH 18,B05,093473,Staff,0,0,36,36
1656004133863,MATH 18,B06,093474,Staff,1,0,36,35
1656004139905,MATH 20A,A01,083754,Zheng; Zequn,10,0,40,30
1656004145943,MATH 20B,A01,083756,Briones; Jor-el Thomas Caparas,0,1,36,36
1656004145943,MATH 20B,A02,083757,Briones; Jor-el Thomas Caparas,1,0,36,35
1656004145943,MATH 20B,A03,093475,Staff,0,0,36,36
1656004151973,MATH 20C,A01,083760,Briones; Jor-el Thomas Caparas,0,2,35,35
1656004151973,MATH 20C,A02,083761,Briones; Jor-el Thomas Caparas,6,1,35,29
1656004151973,MATH 20C,A03,093476,Staff,0,0,35,35
1656004151973,MATH 20C,B01,083762,Bach; Quang Tran,3,0,30,27
1656004158019,MATH 20D,A01,083765,Tran; Brian Kha,1,0,30,29
1656004158019,MATH 20D,A02,083766,Tran; Brian Kha,0,1,30,30
1656004158019,MATH 20D,A03,083767,Tran; Brian Kha,1,0,30,29
1656004164050,MATH 20E,A01,083771,Ganguly; Soumya,0,1,32,32
1656004164050,MATH 20E,A02,083772,Ganguly; Soumya,1,1,32,31
1656004164050,MATH 20E,B01,083773,Ciotti; Benjamin,14,0,35,21
1656004164050,MATH 20E,B02,083774,Ciotti; Benjamin,12,0,35,23
1656004170075,MATH 103A,A01,083777,Greenfeld; Be'Eri,2,1,36,34
1656004170075,MATH 103A,A02,083778,Greenfeld; Be'Eri,2,0,36,34
1656004170075,MATH 103A,A03,093561,Staff,0,1,36,36
1656004170075,MATH 103A,B01,083779,Greenfeld; Be'Eri,7,1,36,29
1656004170075,MATH 103A,B02,083780,Greenfeld; Be'Eri,0,0,36,36
1656004170075,MATH 103A,B03,093562,Staff,0,0,36,36
1656004176118,MATH 105,A01,085443,Carter; Anne Toulson,4,1,35,31
1656004176118,MATH 105,A02,093477,Staff,8,0,35,27
1656004182175,MATH 109,A01,083213,Ganzberger; Geoffrey Michael,0,1,34,34
1656004182175,MATH 109,A02,083214,Ganzberger; Geoffrey Michael,0,0,34,34
1656004182175,MATH 109,A03,093478,Staff,1,0,34,33
1656004182175,MATH 109,B01,083215,Ganzberger; Geoffrey Michael,2,0,32,30
1656004182175,MATH 109,B02,083216,Ganzberger; Geoffrey Michael,0,0,32,32
1656004182175,MATH 109,B03,093479,Staff,4,0,32,28
1656004188224,MATH 142A,A01,083219,Chow; Bennett,0,0,32,32
1656004188224,MATH 142A,A02,083220,Chow; Bennett,7,0,32,25
1656004188224,MATH 142A,A03,093480,Staff,4,0,32,28
1656004188224,MATH 142A,B03,093481,Staff,3,0,32,29
1656004188224,MATH 142A,B04,093558,Staff,6,0,32,26
1656004188224,MATH 142A,B05,093559,Staff,0,0,32,32
1656004194270,MATH 193A,A01,083224,Rotar; Vladimir,1,1,34,33
1656004194270,MATH 193A,A02,083225,Rotar; Vladimir,0,0,34,34
1656004194270,MATH 193A,A03,083781,Rotar; Vladimir,2,0,34,32
1656004194270,MATH 193A,A04,083782,Rotar; Vladimir,3,0,34,31
1656004194270,MATH 193A,A05,093482,Rotar; Vladimir,0,0,34,34
1656004200306,MATH 197,001,091859,McAuley; Julian John,9999,0,9999,0
1656004200306,MATH 197,002,095566,Kedlaya; Kiran S.,9997,0,9999,2
1656004200306,MATH 197,003,095567,Xiao; Ming,9999,0,9999,0
1656004200306,MATH 197,004,095571,Perols; Johan Lars,9998,0,9999,1
1656004207380,COGS 9,A01,083615,Shannon; Kyle Michael,3,1,75,72
1656004213435,COGS 11,A01,083617,Boyle; Mary E. T.,11,1,48,37
1656004219465,COGS 13,A01,083071,Bastos; Amalia Pinkusfeld,3,2,71,68
1656004225493,COGS 14A,A01,092681,Semenuks; Arturs,4,25,100,96
1656004231546,COGS 14B,A01,083073,Cheng; Tzu-Han,7,0,63,56
1656004237582,COGS 17,A01,092677,Semenuks; Arturs,8,7,81,73
1656004243617,COGS 100,A01,083619,Allen; Michael Gordon,2,2,70,68
1656004249644,COGS 101A,A01,083621,Davis; Joshua Daniel,4,3,68,64
1656004255667,COGS 101B,A01,091572,Allen; Michael Gordon,0,0,65,65
1656004261711,COGS 101C,A01,083625,Delgado; Tania,7,0,35,28
1656004267750,COGS 107A,A01,083627,Boyle; Mary E. T.,1,2,60,59
1656004273801,COGS 118A,A01,083075,Gupta; Anjum,21,16,76,55
1656004279837,CSE 3,A50,083646,Miranda; Gregory Joseph,14,0,50,36
1656004285878,CSE 8A,A50,083650,Miranda; Gregory Joseph,3,11,56,53
1656004291908,CSE 11,A01,083080,Cao; Yingjun,0,65,40,40
1656004297935,CSE 12,A01,083652,Krause-Levy; Sophia Louisa,6,8,120,114
1656004303968,CSE 15L,A01,083654,Morris; Justin Loren,3,1,50,47
1656004303968,CSE 15L,A02,083655,Morris; Justin Loren,1,1,50,49
1656004309991,CSE 20,A01,083657,Tran; Khoa Dang,29,0,80,51
1656004316039,CSE 21,A01,095574,Bach; Quang Tran,23,0,48,25
1656004322062,CSE 30,A01,083084,Eldon; John,2,10,80,78
1656004322062,CSE 30,B01,095061,Bhaskar; Nishant,0,4,50,50
1656004328092,CSE 100,A01,083659,Cao; Yingjun,2,25,70,68
1656004334116,CSE 134B,A01,083661,Powell; Thomas Allan,6,7,100,94
1656004340139,CSE 140,A01,083663,Gungor; Onat,5,0,85,80
1656004346170,CSE 140L,A01,083088,Eldon; John,5,0,100,95
1656004352191,CSE 175,A01,083665,Kumar; Rakesh,1,0,25,24
1656004358221,CSE 190,A00,092507,Dubnov; Shlomo,1,0,20,19
1656004364242,ECE 45,A01,083139,Congero; Spencer William,0,1,75,75
1656004370266,ECE 65,A50,083695,Saad; Andrew S,6,0,30,24
1656004370266,ECE 65,A51,095125,Staff,23,0,26,3
1656004376291,ECE 109,A01,091882,Touri; Behrouz,2,4,70,68
1656004382314,ECE 180,A00,083140,Abi Samra; Nicholas Camill,1,0,30,29
1656004382314,ECE 180,B00,083141,Abi Samra; Nicholas Camill,0,8,28,28
1656004388339,MATH 10A,A01,083735,Patchell; Gregory David,0,0,30,30
1656004388339,MATH 10A,A02,083736,Patchell; Gregory David,21,0,30,9
1656004388339,MATH 10A,A03,083737,Patchell; Gregory David,16,0,30,14
1656004394369,MATH 10B,A01,083207,Lim; Seonhee,1,1,34,33
1656004394369,MATH 10B,A02,083208,Lim; Seonhee,1,1,35,34
1656004394369,MATH 10B,A03,093472,Staff,1,0,34,33
1656004394369,MATH 10B,B01,083739,Sinha; Shubham,9,0,30,21
1656004400392,MATH 18,A01,083743,Cinel; Cameron Alexander,5,0,30,25
1656004400392,MATH 18,A02,083744,Cinel; Cameron Alexander,11,0,30,19
1656004400392,MATH 18,A03,083745,Cinel; Cameron Alexander,1,0,30,29
1656004400392,MATH 18,B01,083748,Ma; Zilu,2,0,36,34
1656004400392,MATH 18,B02,083749,Ma; Zilu,0,0,36,36
1656004400392,MATH 18,B03,083750,Ma; Zilu,0,0,36,36
1656004400392,MATH 18,B04,083751,Ma; Zilu,0,0,36,36
1656004400392,MATH 18,B05,093473,Staff,0,0,36,36
1656004400392,MATH 18,B06,093474,Staff,2,0,36,34
1656004406416,MATH 20A,A01,083754,Zheng; Zequn,10,0,40,30
1656004412444,MATH 20B,A01,083756,Briones; Jor-el Thomas Caparas,0,1,36,36
1656004412444,MATH 20B,A02,083757,Briones; Jor-el Thomas Caparas,1,0,36,35
1656004412444,MATH 20B,A03,093475,Staff,0,0,36,36
1656004418481,MATH 20C,A01,083760,Briones; Jor-el Thomas Caparas,0,2,35,35
1656004418481,MATH 20C,A02,083761,Briones; Jor-el Thomas Caparas,6,1,35,29
1656004418481,MATH 20C,A03,093476,Staff,0,0,35,35
1656004418481,MATH 20C,B01,083762,Bach; Quang Tran,3,0,30,27
1656004424505,MATH 20D,A01,083765,Tran; Brian Kha,1,0,30,29
1656004424505,MATH 20D,A02,083766,Tran; Brian Kha,0,1,30,30
1656004424505,MATH 20D,A03,083767,Tran; Brian Kha,1,0,30,29
1656004430540,MATH 20E,A01,083771,Ganguly; Soumya,0,1,32,32
1656004430540,MATH 20E,A02,083772,Ganguly; Soumya,1,1,32,31
1656004430540,MATH 20E,B01,083773,Ciotti; Benjamin,14,0,35,21
1656004430540,MATH 20E,B02,083774,Ciotti; Benjamin,12,0,35,23
1656004436572,MATH 103A,A01,083777,Greenfeld; Be'Eri,2,1,36,34
1656004436572,MATH 103A,A02,083778,Greenfeld; Be'Eri,2,0,36,34
1656004436572,MATH 103A,A03,093561,Staff,0,1,36,36
1656004436572,MATH 103A,B01,083779,Greenfeld; Be'Eri,7,1,36,29
1656004436572,MATH 103A,B02,083780,Greenfeld; Be'Eri,0,0,36,36
1656004436572,MATH 103A,B03,093562,Staff,0,0,36,36
1656004442603,MATH 105,A01,085443,Carter; Anne Toulson,4,1,35,31
1656004442603,MATH 105,A02,093477,Staff,8,0,35,27
1656004448632,MATH 109,A01,083213,Ganzberger; Geoffrey Michael,0,1,34,34
1656004448632,MATH 109,A02,083214,Ganzberger; Geoffrey Michael,0,0,34,34
1656004448632,MATH 109,A03,093478,Staff,1,0,34,33
1656004448632,MATH 109,B01,083215,Ganzberger; Geoffrey Michael,2,0,32,30
1656004448632,MATH 109,B02,083216,Ganzberger; Geoffrey Michael,0,0,32,32
1656004448632,MATH 109,B03,093479,Staff,4,0,32,28
1656004454677,MATH 142A,A01,083219,Chow; Bennett,0,0,32,32
1656004454677,MATH 142A,A02,083220,Chow; Bennett,7,0,32,25
1656004454677,MATH 142A,A03,093480,Staff,4,0,32,28
1656004454677,MATH 142A,B03,093481,Staff,3,0,32,29
1656004454677,MATH 142A,B04,093558,Staff,6,0,32,26
1656004454677,MATH 142A,B05,093559,Staff,0,0,32,32
1656004460715,MATH 193A,A01,083224,Rotar; Vladimir,1,1,34,33
1656004460715,MATH 193A,A02,083225,Rotar; Vladimir,0,0,34,34
1656004460715,MATH 193A,A03,083781,Rotar; Vladimir,2,0,34,32
1656004460715,MATH 193A,A04,083782,Rotar; Vladimir,3,0,34,31
1656004460715,MATH 193A,A05,093482,Rotar; Vladimir,0,0,34,34
1656004466749,MATH 197,001,091859,McAuley; Julian John,9999,0,9999,0
1656004466749,MATH 197,002,095566,Kedlaya; Kiran S.,9997,0,9999,2
1656004466749,MATH 197,003,095567,Xiao; Ming,9999,0,9999,0
1656004466749,MATH 197,004,095571,Perols; Johan Lars,9998,0,9999,1
1656004473820,COGS 9,A01,083615,Shannon; Kyle Michael,3,1,75,72
1656004479846,COGS 11,A01,083617,Boyle; Mary E. T.,11,1,48,37
1656004485877,COGS 13,A01,083071,Bastos; Amalia Pinkusfeld,3,2,71,68
1656004491902,COGS 14A,A01,092681,Semenuks; Arturs,4,25,100,96
1656004497938,COGS 14B,A01,083073,Cheng; Tzu-Han,7,0,63,56
1656004503962,COGS 17,A01,092677,Semenuks; Arturs,8,7,81,73
1656004510006,COGS 100,A01,083619,Allen; Michael Gordon,2,2,70,68
1656004516056,COGS 101A,A01,083621,Davis; Joshua Daniel,4,3,68,64
1656004522103,COGS 101B,A01,091572,Allen; Michael Gordon,0,0,65,65
1656004528128,COGS 101C,A01,083625,Delgado; Tania,7,0,35,28
1656004534170,COGS 107A,A01,083627,Boyle; Mary E. T.,1,2,60,59
1656004540193,COGS 118A,A01,083075,Gupta; Anjum,21,16,76,55
1656004546231,CSE 3,A50,083646,Miranda; Gregory Joseph,14,0,50,36
1656004552286,CSE 8A,A50,083650,Miranda; Gregory Joseph,3,11,56,53
1656004558309,CSE 11,A01,083080,Cao; Yingjun,0,65,40,40
1656004564342,CSE 12,A01,083652,Krause-Levy; Sophia Louisa,6,8,120,114
1656004570370,CSE 15L,A01,083654,Morris; Justin Loren,3,1,50,47
1656004570370,CSE 15L,A02,083655,Morris; Justin Loren,1,1,50,49
1656004576426,CSE 20,A01,083657,Tran; Khoa Dang,29,0,80,51
1656004582468,CSE 21,A01,095574,Bach; Quang Tran,23,0,48,25
1656004588497,CSE 30,A01,083084,Eldon; John,2,10,80,78
1656004588497,CSE 30,B01,095061,Bhaskar; Nishant,0,4,50,50
1656004594522,CSE 100,A01,083659,Cao; Yingjun,2,25,70,68
1656004600685,CSE 134B,A01,083661,Powell; Thomas Allan,6,7,100,94
1656004606712,CSE 140,A01,083663,Gungor; Onat,5,0,85,80
1656004612754,CSE 140L,A01,083088,Eldon; John,5,0,100,95
1656004618777,CSE 175,A01,083665,Kumar; Rakesh,1,0,25,24
1656004624826,CSE 190,A00,092507,Dubnov; Shlomo,1,0,20,19
1656004630850,ECE 45,A01,083139,Congero; Spencer William,0,1,75,75
1656004636872,ECE 65,A50,083695,Saad; Andrew S,6,0,30,24
1656004636872,ECE 65,A51,095125,Staff,23,0,26,3
1656004642899,ECE 109,A01,091882,Touri; Behrouz,2,4,70,68
1656004648923,ECE 180,A00,083140,Abi Samra; Nicholas Camill,1,0,30,29
1656004648923,ECE 180,B00,083141,Abi Samra; Nicholas Camill,0,8,28,28
1656004654951,MATH 10A,A01,083735,Patchell; Gregory David,0,0,30,30
1656004654951,MATH 10A,A02,083736,Patchell; Gregory David,21,0,30,9
1656004654951,MATH 10A,A03,083737,Patchell; Gregory David,16,0,30,14
1656004660988,MATH 10B,A01,083207,Lim; Seonhee,1,1,34,33
1656004660988,MATH 10B,A02,083208,Lim; Seonhee,1,1,35,34
1656004660988,MATH 10B,A03,093472,Staff,1,0,34,33
1656004660988,MATH 10B,B01,083739,Sinha; Shubham,9,0,30,21
1656004667012,MATH 18,A01,083743,Cinel; Cameron Alexander,5,0,30,25
1656004667012,MATH 18,A02,083744,Cinel; Cameron Alexander,11,0,30,19
1656004667012,MATH 18,A03,083745,Cinel; Cameron Alexander,1,0,30,29
1656004667012,MATH 18,B01,083748,Ma; Zilu,1,0,36,35
1656004667012,MATH 18,B02,083749,Ma; Zilu,0,0,36,36
1656004667012,MATH 18,B03,083750,Ma; Zilu,0,0,36,36
1656004667012,MATH 18,B04,083751,Ma; Zilu,0,0,36,36
1656004667012,MATH 18,B05,093473,Staff,0,0,36,36
1656004667012,MATH 18,B06,093474,Staff,3,0,36,33
1656004673042,MATH 20A,A01,083754,Zheng; Zequn,10,0,40,30
1656004679078,MATH 20B,A01,083756,Briones; Jor-el Thomas Caparas,0,1,36,36
1656004679078,MATH 20B,A02,083757,Briones; Jor-el Thomas Caparas,1,0,36,35
1656004679078,MATH 20B,A03,093475,Staff,0,0,36,36
1656004685114,MATH 20C,A01,083760,Briones; Jor-el Thomas Caparas,0,2,35,35
1656004685114,MATH 20C,A02,083761,Briones; Jor-el Thomas Caparas,6,1,35,29
1656004685114,MATH 20C,A03,093476,Staff,0,0,35,35
1656004685114,MATH 20C,B01,083762,Bach; Quang Tran,3,0,30,27
1656004691145,MATH 20D,A01,083765,Tran; Brian Kha,1,0,30,29
1656004691145,MATH 20D,A02,083766,Tran; Brian Kha,0,1,30,30
1656004691145,MATH 20D,A03,083767,Tran; Brian Kha,1,0,30,29
1656004697179,MATH 20E,A01,083771,Ganguly; Soumya,0,1,32,32
1656004697179,MATH 20E,A02,083772,Ganguly; Soumya,1,1,32,31
1656004697179,MATH 20E,B01,083773,Ciotti; Benjamin,14,0,35,21
1656004697179,MATH 20E,B02,083774,Ciotti; Benjamin,12,0,35,23
1656004703204,MATH 103A,A01,083777,Greenfeld; Be'Eri,2,1,36,34
1656004703204,MATH 103A,A02,083778,Greenfeld; Be'Eri,2,0,36,34
1656004703204,MATH 103A,A03,093561,Staff,0,1,36,36
1656004703204,MATH 103A,B01,083779,Greenfeld; Be'Eri,7,1,36,29
1656004703204,MATH 103A,B02,083780,Greenfeld; Be'Eri,0,0,36,36
1656004703204,MATH 103A,B03,093562,Staff,0,0,36,36
1656004709240,MATH 105,A01,085443,Carter; Anne Toulson,4,1,35,31
1656004709240,MATH 105,A02,093477,Staff,8,0,35,27
1656004715274,MATH 109,A01,083213,Ganzberger; Geoffrey Michael,0,1,34,34
1656004715274,MATH 109,A02,083214,Ganzberger; Geoffrey Michael,0,0,34,34
1656004715274,MATH 109,A03,093478,Staff,1,0,34,33
1656004715274,MATH 109,B01,083215,Ganzberger; Geoffrey Michael,2,0,32,30
1656004715274,MATH 109,B02,083216,Ganzberger; Geoffrey Michael,0,0,32,32
1656004715274,MATH 109,B03,093479,Staff,4,0,32,28
1656004721323,MATH 142A,A01,083219,Chow; Bennett,0,0,32,32
1656004721323,MATH 142A,A02,083220,Chow; Bennett,7,0,32,25
1656004721323,MATH 142A,A03,093480,Staff,4,0,32,28
1656004721323,MATH 142A,B03,093481,Staff,3,0,32,29
1656004721323,MATH 142A,B04,093558,Staff,6,0,32,26
1656004721323,MATH 142A,B05,093559,Staff,0,0,32,32
1656004727347,MATH 193A,A01,083224,Rotar; Vladimir,1,1,34,33
1656004727347,MATH 193A,A02,083225,Rotar; Vladimir,0,0,34,34
1656004727347,MATH 193A,A03,083781,Rotar; Vladimir,2,0,34,32
1656004727347,MATH 193A,A04,083782,Rotar; Vladimir,3,0,34,31
1656004727347,MATH 193A,A05,093482,Rotar; Vladimir,0,0,34,34
1656004733401,MATH 197,001,091859,McAuley; Julian John,9999,0,9999,0
1656004733401,MATH 197,002,095566,Kedlaya; Kiran S.,9997,0,9999,2
1656004733401,MATH 197,003,095567,Xiao; Ming,9999,0,9999,0
1656004733401,MATH 197,004,095571,Perols; Johan Lars,9998,0,9999,1
1656004740472,COGS 9,A01,083615,Shannon; Kyle Michael,3,1,75,72
1656004746499,COGS 11,A01,083617,Boyle; Mary E. T.,11,1,48,37
1656004752538,COGS 13,A01,083071,Bastos; Amalia Pinkusfeld,3,2,71,68
1656004758589,COGS 14A,A01,092681,Semenuks; Arturs,4,25,100,96
1656004764628,COGS 14B,A01,083073,Cheng; Tzu-Han,7,0,63,56
1656004770664,COGS 17,A01,092677,Semenuks; Arturs,8,7,81,73
1656004776703,COGS 100,A01,083619,Allen; Michael Gordon,2,2,70,68
1656004782730,COGS 101A,A01,083621,Davis; Joshua Daniel,4,3,68,64
1656004788753,COGS 101B,A01,091572,Allen; Michael Gordon,0,0,65,65
1656004794776,COGS 101C,A01,083625,Delgado; Tania,7,0,35,28
1656004800798,COGS 107A,A01,083627,Boyle; Mary E. T.,1,2,60,59
1656004806834,COGS 118A,A01,083075,Gupta; Anjum,21,16,76,55
1656004812875,CSE 3,A50,083646,Miranda; Gregory Joseph,14,0,50,36
1656004818924,CSE 8A,A50,083650,Miranda; Gregory Joseph,3,11,56,53
1656004824970,CSE 11,A01,083080,Cao; Yingjun,0,65,40,40
1656004830996,CSE 12,A01,083652,Krause-Levy; Sophia Louisa,6,8,120,114
1656004837028,CSE 15L,A01,083654,Morris; Justin Loren,3,1,50,47
1656004837028,CSE 15L,A02,083655,Morris; Justin Loren,1,1,50,49
1656004843057,CSE 20,A01,083657,Tran; Khoa Dang,29,0,80,51
1656004849080,CSE 21,A01,095574,Bach; Quang Tran,23,0,48,25
1656004855120,CSE 30,A01,083084,Eldon; John,2,10,80,78
1656004855120,CSE 30,B01,095061,Bhaskar; Nishant,0,4,50,50
1656004861153,CSE 100,A01,083659,Cao; Yingjun,2,25,70,68
1656004867200,CSE 134B,A01,083661,Powell; Thomas Allan,6,7,100,94
1656004873242,CSE 140,A01,083663,Gungor; Onat,5,0,85,80
1656004879265,CSE 140L,A01,083088,Eldon; John,5,0,100,95
1656004885293,CSE 175,A01,083665,Kumar; Rakesh,1,0,25,24
1656004891334,CSE 190,A00,092507,Dubnov; Shlomo,1,0,20,19
1656004897356,ECE 45,A01,083139,Congero; Spencer William,0,1,75,75
1656004903385,ECE 65,A50,083695,Saad; Andrew S,6,0,30,24
1656004903385,ECE 65,A51,095125,Staff,23,0,26,3
1656004909407,ECE 109,A01,091882,Touri; Behrouz,2,4,70,68
1656004915442,ECE 180,A00,083140,Abi Samra; Nicholas Camill,1,0,30,29
1656004915442,ECE 180,B00,083141,Abi Samra; Nicholas Camill,0,8,28,28
1656004921479,MATH 10A,A01,083735,Patchell; Gregory David,0,0,30,30
1656004921479,MATH 10A,A02,083736,Patchell; Gregory David,21,0,30,9
1656004921479,MATH 10A,A03,083737,Patchell; Gregory David,16,0,30,14
1656004927509,MATH 10B,A01,083207,Lim; Seonhee,1,1,34,33
1656004927509,MATH 10B,A02,083208,Lim; Seonhee,1,1,35,34
1656004927509,MATH 10B,A03,093472,Staff,1,0,34,33
1656004927509,MATH 10B,B01,083739,Sinha; Shubham,9,0,30,21
1656004933546,MATH 18,A01,083743,Cinel; Cameron Alexander,5,0,30,25
1656004933546,MATH 18,A02,083744,Cinel; Cameron Alexander,11,0,30,19
1656004933546,MATH 18,A03,083745,Cinel; Cameron Alexander,1,0,30,29
1656004933546,MATH 18,B01,083748,Ma; Zilu,1,0,36,35
1656004933546,MATH 18,B02,083749,Ma; Zilu,0,0,36,36
1656004933546,MATH 18,B03,083750,Ma; Zilu,0,0,36,36
1656004933546,MATH 18,B04,083751,Ma; Zilu,0,0,36,36
1656004933546,MATH 18,B05,093473,Staff,0,0,36,36
1656004933546,MATH 18,B06,093474,Staff,3,0,36,33
1656004939578,MATH 20A,A01,083754,Zheng; Zequn,10,0,40,30
1656004945604,MATH 20B,A01,083756,Briones; Jor-el Thomas Caparas,0,1,36,36
1656004945604,MATH 20B,A02,083757,Briones; Jor-el Thomas Caparas,1,0,36,35
1656004945604,MATH 20B,A03,093475,Staff,0,0,36,36
1656004951626,MATH 20C,A01,083760,Briones; Jor-el Thomas Caparas,0,2,35,35
1656004951626,MATH 20C,A02,083761,Briones; Jor-el Thomas Caparas,6,1,35,29
1656004951626,MATH 20C,A03,093476,Staff,0,0,35,35
1656004951626,MATH 20C,B01,083762,Bach; Quang Tran,3,0,30,27
1656004957652,MATH 20D,A01,083765,Tran; Brian Kha,1,0,30,29
1656004957652,MATH 20D,A02,083766,Tran; Brian Kha,0,1,30,30
1656004957652,MATH 20D,A03,083767,Tran; Brian Kha,1,0,30,29
1656004963677,MATH 20E,A01,083771,Ganguly; Soumya,0,1,32,32
1656004963677,MATH 20E,A02,083772,Ganguly; Soumya,1,1,32,31
1656004963677,MATH 20E,B01,083773,Ciotti; Benjamin,14,0,35,21
1656004963677,MATH 20E,B02,083774,Ciotti; Benjamin,12,0,35,23
1656004969725,MATH 103A,A01,083777,Greenfeld; Be'Eri,2,1,36,34
1656004969725,MATH 103A,A02,083778,Greenfeld; Be'Eri,2,0,36,34
1656004969725,MATH 103A,A03,093561,Staff,0,1,36,36
1656004969725,MATH 103A,B01,083779,Greenfeld; Be'Eri,7,1,36,29
1656004969725,MATH 103A,B02,083780,Greenfeld; Be'Eri,0,0,36,36
1656004969725,MATH 103A,B03,093562,Staff,0,0,36,36
1656004975752,MATH 105,A01,085443,Carter; Anne Toulson,4,1,35,31
1656004975752,MATH 105,A02,093477,Staff,8,0,35,27
1656004981780,MATH 109,A01,083213,Ganzberger; Geoffrey Michael,0,1,34,34
1656004981780,MATH 109,A02,083214,Ganzberger; Geoffrey Michael,0,0,34,34
1656004981780,MATH 109,A03,093478,Staff,1,0,34,33
1656004981780,MATH 109,B01,083215,Ganzberger; Geoffrey Michael,2,0,32,30
1656004981780,MATH 109,B02,083216,Ganzberger; Geoffrey Michael,0,0,32,32
1656004981780,MATH 109,B03,093479,Staff,4,0,32,28
1656004987805,MATH 142A,A01,083219,Chow; Bennett,0,0,32,32
1656004987805,MATH 142A,A02,083220,Chow; Bennett,7,0,32,25
1656004987805,MATH 142A,A03,093480,Staff,4,0,32,28
1656004987805,MATH 142A,B03,093481,Staff,3,0,32,29
1656004987805,MATH 142A,B04,093558,Staff,6,0,32,26
1656004987805,MATH 142A,B05,093559,Staff,0,0,32,32
1656004993841,MATH 193A,A01,083224,Rotar; Vladimir,1,1,34,33
1656004993841,MATH 193A,A02,083225,Rotar; Vladimir,0,0,34,34
1656004993841,MATH 193A,A03,083781,Rotar; Vladimir,2,0,34,32
1656004993841,MATH 193A,A04,083782,Rotar; Vladimir,3,0,34,31
1656004993841,MATH 193A,A05,093482,Rotar; Vladimir,0,0,34,34
1656004999879,MATH 197,001,091859,McAuley; Julian John,9999,0,9999,0
1656004999879,MATH 197,002,095566,Kedlaya; Kiran S.,9997,0,9999,2
1656004999879,MATH 197,003,095567,Xiao; Ming,9999,0,9999,0
1656004999879,MATH 197,004,095571,Perols; Johan Lars,9998,0,9999,1
1656005006972,COGS 9,A01,083615,Shannon; Kyle Michael,3,1,75,72
1656005012998,COGS 11,A01,083617,Boyle; Mary E. T.,11,1,48,37
1656005019030,COGS 13,A01,083071,Bastos; Amalia Pinkusfeld,3,2,71,68
1656005025066,COGS 14A,A01,092681,Semenuks; Arturs,4,25,100,96
1656005031121,COGS 14B,A01,083073,Cheng; Tzu-Han,7,0,63,56
1656005037145,COGS 17,A01,092677,Semenuks; Arturs,8,7,81,73
1656005043172,COGS 100,A01,083619,Allen; Michael Gordon,2,2,70,68
1656005049200,COGS 101A,A01,083621,Davis; Joshua Daniel,4,3,68,64
1656005055237,COGS 101B,A01,091572,Allen; Michael Gordon,0,0,65,65
1656005061265,COGS 101C,A01,083625,Delgado; Tania,7,0,35,28
1656005067300,COGS 107A,A01,083627,Boyle; Mary E. T.,1,2,60,59
1656005073334,COGS 118A,A01,083075,Gupta; Anjum,21,16,76,55
1656005079369,CSE 3,A50,083646,Miranda; Gregory Joseph,14,0,50,36
1656005085402,CSE 8A,A50,083650,Miranda; Gregory Joseph,3,11,56,53
1656005091425,CSE 11,A01,083080,Cao; Yingjun,0,65,40,40
1656005097446,CSE 12,A01,083652,Krause-Levy; Sophia Louisa,6,8,120,114
1656005103476,CSE 15L,A01,083654,Morris; Justin Loren,3,1,50,47
1656005103476,CSE 15L,A02,083655,Morris; Justin Loren,1,1,50,49
1656005109510,CSE 20,A01,083657,Tran; Khoa Dang,29,0,80,51
1656005115535,CSE 21,A01,095574,Bach; Quang Tran,23,0,48,25
1656005121574,CSE 30,A01,083084,Eldon; John,2,10,80,78
1656005121574,CSE 30,B01,095061,Bhaskar; Nishant,0,4,50,50
1656005127628,CSE 100,A01,083659,Cao; Yingjun,2,25,70,68
1656005133650,CSE 134B,A01,083661,Powell; Thomas Allan,6,7,100,94
1656005139673,CSE 140,A01,083663,Gungor; Onat,5,0,85,80
1656005145697,CSE 140L,A01,083088,Eldon; John,5,0,100,95
1656005151729,CSE 175,A01,083665,Kumar; Rakesh,1,0,25,24
1656005157778,CSE 190,A00,092507,Dubnov; Shlomo,1,0,20,19
1656005163820,ECE 45,A01,083139,Congero; Spencer William,0,1,75,75
1656005169848,ECE 65,A50,083695,Saad; Andrew S,6,0,30,24
1656005169848,ECE 65,A51,095125,Staff,23,0,26,3
1656005175886,ECE 109,A01,091882,Touri; Behrouz,2,4,70,68
1656005181911,ECE 180,A00,083140,Abi Samra; Nicholas Camill,1,0,30,29
1656005181911,ECE 180,B00,083141,Abi Samra; Nicholas Camill,0,8,28,28
1656005187935,MATH 10A,A01,083735,Patchell; Gregory David,0,0,30,30
1656005187935,MATH 10A,A02,083736,Patchell; Gregory David,21,0,30,9
1656005187935,MATH 10A,A03,083737,Patchell; Gregory David,16,0,30,14
1656005193975,MATH 10B,A01,083207,Lim; Seonhee,1,1,34,33
1656005193975,MATH 10B,A02,083208,Lim; Seonhee,1,1,35,34
1656005193975,MATH 10B,A03,093472,Staff,1,0,34,33
1656005193975,MATH 10B,B01,083739,Sinha; Shubham,9,0,30,21
1656005200127,MATH 18,A01,083743,Cinel; Cameron Alexander,5,0,30,25
1656005200127,MATH 18,A02,083744,Cinel; Cameron Alexander,11,0,30,19
1656005200127,MATH 18,A03,083745,Cinel; Cameron Alexander,1,0,30,29
1656005200127,MATH 18,B01,083748,Ma; Zilu,1,0,36,35
1656005200127,MATH 18,B02,083749,Ma; Zilu,0,0,36,36
1656005200127,MATH 18,B03,083750,Ma; Zilu,0,0,36,36
1656005200127,MATH 18,B04,083751,Ma; Zilu,0,0,36,36
1656005200127,MATH 18,B05,093473,Staff,0,0,36,36
1656005200127,MATH 18,B06,093474,Staff,3,0,36,33
1656005206157,MATH 20A,A01,083754,Zheng; Zequn,10,0,40,30
1656005212189,MATH 20B,A01,083756,Briones; Jor-el Thomas Caparas,0,1,36,36
1656005212189,MATH 20B,A02,083757,Briones; Jor-el Thomas Caparas,1,0,36,35
1656005212189,MATH 20B,A03,093475,Staff,0,0,36,36
1656005218220,MATH 20C,A01,083760,Briones; Jor-el Thomas Caparas,0,2,35,35
1656005218220,MATH 20C,A02,083761,Briones; Jor-el Thomas Caparas,6,1,35,29
1656005218220,MATH 20C,A03,093476,Staff,0,0,35,35
1656005218220,MATH 20C,B01,083762,Bach; Quang Tran,3,0,30,27
1656005224263,MATH 20D,A01,083765,Tran; Brian Kha,1,0,30,29
1656005224263,MATH 20D,A02,083766,Tran; Brian Kha,0,1,30,30
1656005224263,MATH 20D,A03,083767,Tran; Brian Kha,1,0,30,29
1656005230298,MATH 20E,A01,083771,Ganguly; Soumya,0,1,32,32
1656005230298,MATH 20E,A02,083772,Ganguly; Soumya,1,1,32,31
1656005230298,MATH 20E,B01,083773,Ciotti; Benjamin,14,0,35,21
1656005230298,MATH 20E,B02,083774,Ciotti; Benjamin,12,0,35,23
1656005236333,MATH 103A,A01,083777,Greenfeld; Be'Eri,2,1,36,34
1656005236333,MATH 103A,A02,083778,Greenfeld; Be'Eri,2,0,36,34
1656005236333,MATH 103A,A03,093561,Staff,0,1,36,36
1656005236333,MATH 103A,B01,083779,Greenfeld; Be'Eri,7,1,36,29
1656005236333,MATH 103A,B02,083780,Greenfeld; Be'Eri,0,0,36,36
1656005236333,MATH 103A,B03,093562,Staff,0,0,36,36
1656005242363,MATH 105,A01,085443,Carter; Anne Toulson,4,1,35,31
1656005242363,MATH 105,A02,093477,Staff,8,0,35,27
1656005248404,MATH 109,A01,083213,Ganzberger; Geoffrey Michael,0,1,34,34
1656005248404,MATH 109,A02,083214,Ganzberger; Geoffrey Michael,0,0,34,34
1656005248404,MATH 109,A03,093478,Staff,1,0,34,33
1656005248404,MATH 109,B01,083215,Ganzberger; Geoffrey Michael,2,0,32,30
1656005248404,MATH 109,B02,083216,Ganzberger; Geoffrey Michael,0,0,32,32
1656005248404,MATH 109,B03,093479,Staff,4,0,32,28
1656005254431,MATH 142A,A01,083219,Chow; Bennett,0,0,32,32
1656005254431,MATH 142A,A02,083220,Chow; Bennett,7,0,32,25
1656005254431,MATH 142A,A03,093480,Staff,4,0,32,28
1656005254431,MATH 142A,B03,093481,Staff,3,0,32,29
1656005254431,MATH 142A,B04,093558,Staff,6,0,32,26
1656005254431,MATH 142A,B05,093559,Staff,0,0,32,32
1656005260474,MATH 193A,A01,083224,Rotar; Vladimir,1,1,34,33
1656005260474,MATH 193A,A02,083225,Rotar; Vladimir,0,0,34,34
1656005260474,MATH 193A,A03,083781,Rotar; Vladimir,2,0,34,32
1656005260474,MATH 193A,A04,083782,Rotar; Vladimir,3,0,34,31
1656005260474,MATH 193A,A05,093482,Rotar; Vladimir,0,0,34,34
1656005266521,MATH 197,001,091859,McAuley; Julian John,9999,0,9999,0
1656005266521,MATH 197,002,095566,Kedlaya; Kiran S.,9997,0,9999,2
1656005266521,MATH 197,003,095567,Xiao; Ming,9999,0,9999,0
1656005266521,MATH 197,004,095571,Perols; Johan Lars,9998,0,9999,1
1656005273586,COGS 9,A01,083615,Shannon; Kyle Michael,3,1,75,72
1656005279613,COGS 11,A01,083617,Boyle; Mary E. T.,11,1,48,37
1656005285642,COGS 13,A01,083071,Bastos; Amalia Pinkusfeld,3,2,71,68
1656005291698,COGS 14A,A01,092681,Semenuks; Arturs,4,25,100,96
1656005297733,COGS 14B,A01,083073,Cheng; Tzu-Han,7,0,63,56
1656005303766,COGS 17,A01,092677,Semenuks; Arturs,8,7,81,73
1656005309817,COGS 100,A01,083619,Allen; Michael Gordon,2,2,70,68
1656005315861,COGS 101A,A01,083621,Davis; Joshua Daniel,4,3,68,64
1656005321887,COGS 101B,A01,091572,Allen; Michael Gordon,0,0,65,65
1656005327915,COGS 101C,A01,083625,Delgado; Tania,7,0,35,28
1656005333942,COGS 107A,A01,083627,Boyle; Mary E. T.,1,2,60,59
1656005339970,COGS 118A,A01,083075,Gupta; Anjum,21,16,76,55
1656005346005,CSE 3,A50,083646,Miranda; Gregory Joseph,14,0,50,36
1656005352038,CSE 8A,A50,083650,Miranda; Gregory Joseph,3,11,56,53
1656005358061,CSE 11,A01,083080,Cao; Yingjun,0,65,40,40
1656005364125,CSE 12,A01,083652,Krause-Levy; Sophia Louisa,6,8,120,114
1656005370153,CSE 15L,A01,083654,Morris; Justin Loren,3,1,50,47
1656005370153,CSE 15L,A02,083655,Morris; Justin Loren,1,1,50,49
1656005376176,CSE 20,A01,083657,Tran; Khoa Dang,29,0,80,51
1656005382206,CSE 21,A01,095574,Bach; Quang Tran,23,0,48,25
1656005388250,CSE 30,A01,083084,Eldon; John,2,10,80,78
1656005388250,CSE 30,B01,095061,Bhaskar; Nishant,0,4,50,50
1656005394283,CSE 100,A01,083659,Cao; Yingjun,2,25,70,68
1656005400306,CSE 134B,A01,083661,Powell; Thomas Allan,6,7,100,94
1656005406342,CSE 140,A01,083663,Gungor; Onat,5,0,85,80
1656005412365,CSE 140L,A01,083088,Eldon; John,5,0,100,95
1656005418389,CSE 175,A01,083665,Kumar; Rakesh,1,0,25,24
1656005424421,CSE 190,A00,092507,Dubnov; Shlomo,1,0,20,19
1656005430445,ECE 45,A01,083139,Congero; Spencer William,0,1,75,75
1656005436489,ECE 65,A50,083695,Saad; Andrew S,6,0,30,24
1656005436489,ECE 65,A51,095125,Staff,23,0,26,3
1656005442513,ECE 109,A01,091882,Touri; Behrouz,2,4,70,68
1656005448540,ECE 180,A00,083140,Abi Samra; Nicholas Camill,1,0,30,29
1656005448540,ECE 180,B00,083141,Abi Samra; Nicholas Camill,0,8,28,28
1656005454564,MATH 10A,A01,083735,Patchell; Gregory David,0,0,30,30
1656005454564,MATH 10A,A02,083736,Patchell; Gregory David,21,0,30,9
1656005454564,MATH 10A,A03,083737,Patchell; Gregory David,16,0,30,14
1656005460609,MATH 10B,A01,083207,Lim; Seonhee,1,1,34,33
1656005460609,MATH 10B,A02,083208,Lim; Seonhee,1,1,35,34
1656005460609,MATH 10B,A03,093472,Staff,1,0,34,33
1656005460609,MATH 10B,B01,083739,Sinha; Shubham,9,0,30,21
1656005466642,MATH 18,A01,083743,Cinel; Cameron Alexander,5,0,30,25
1656005466642,MATH 18,A02,083744,Cinel; Cameron Alexander,11,0,30,19
1656005466642,MATH 18,A03,083745,Cinel; Cameron Alexander,1,0,30,29
1656005466642,MATH 18,B01,083748,Ma; Zilu,1,0,36,35
1656005466642,MATH 18,B02,083749,Ma; Zilu,0,0,36,36
1656005466642,MATH 18,B03,083750,Ma; Zilu,0,0,36,36
1656005466642,MATH 18,B04,083751,Ma; Zilu,0,0,36,36
1656005466642,MATH 18,B05,093473,Staff,0,0,36,36
1656005466642,MATH 18,B06,093474,Staff,3,0,36,33
1656005472666,MATH 20A,A01,083754,Zheng; Zequn,10,0,40,30
1656005478715,MATH 20B,A01,083756,Briones; Jor-el Thomas Caparas,0,1,36,36
1656005478715,MATH 20B,A02,083757,Briones; Jor-el Thomas Caparas,1,0,36,35
1656005478715,MATH 20B,A03,093475,Staff,0,0,36,36
1656005484739,MATH 20C,A01,083760,Briones; Jor-el Thomas Caparas,0,2,35,35
1656005484739,MATH 20C,A02,083761,Briones; Jor-el Thomas Caparas,6,1,35,29
1656005484739,MATH 20C,A03,093476,Staff,0,0,35,35
1656005484739,MATH 20C,B01,083762,Bach; Quang Tran,3,0,30,27
1656005490765,MATH 20D,A01,083765,Tran; Brian Kha,1,0,30,29
1656005490765,MATH 20D,A02,083766,Tran; Brian Kha,0,1,30,30
1656005490765,MATH 20D,A03,083767,Tran; Brian Kha,1,0,30,29
1656005496801,MATH 20E,A01,083771,Ganguly; Soumya,0,1,32,32
1656005496801,MATH 20E,A02,083772,Ganguly; Soumya,1,1,32,31
1656005496801,MATH 20E,B01,083773,Ciotti; Benjamin,14,0,35,21
1656005496801,MATH 20E,B02,083774,Ciotti; Benjamin,12,0,35,23
1656005502838,MATH 103A,A01,083777,Greenfeld; Be'Eri,2,1,36,34
1656005502838,MATH 103A,A02,083778,Greenfeld; Be'Eri,2,0,36,34
1656005502838,MATH 103A,A03,093561,Staff,0,1,36,36
1656005502838,MATH 103A,B01,083779,Greenfeld; Be'Eri,7,1,36,29
1656005502838,MATH 103A,B02,083780,Greenfeld; Be'Eri,0,0,36,36
1656005502838,MATH 103A,B03,093562,Staff,0,0,36,36
1656005508860,MATH 105,A01,085443,Carter; Anne Toulson,4,1,35,31
1656005508860,MATH 105,A02,093477,Staff,8,0,35,27
1656005514900,MATH 109,A01,083213,Ganzberger; Geoffrey Michael,0,1,34,34
1656005514900,MATH 109,A02,083214,Ganzberger; Geoffrey Michael,0,0,34,34
1656005514900,MATH 109,A03,093478,Staff,1,0,34,33
1656005514900,MATH 109,B01,083215,Ganzberger; Geoffrey Michael,2,0,32,30
1656005514900,MATH 109,B02,083216,Ganzberger; Geoffrey Michael,0,0,32,32
1656005514900,MATH 109,B03,093479,Staff,4,0,32,28
1656005520929,MATH 142A,A01,083219,Chow; Bennett,0,0,32,32
1656005520929,MATH 142A,A02,083220,Chow; Bennett,7,0,32,25
1656005520929,MATH 142A,A03,093480,Staff,4,0,32,28
1656005520929,MATH 142A,B03,093481,Staff,3,0,32,29
1656005520929,MATH 142A,B04,093558,Staff,6,0,32,26
1656005520929,MATH 142A,B05,093559,Staff,0,0,32,32
1656005526962,MATH 193A,A01,083224,Rotar; Vladimir,1,1,34,33
1656005526962,MATH 193A,A02,083225,Rotar; Vladimir,0,0,34,34
1656005526962,MATH 193A,A03,083781,Rotar; Vladimir,2,0,34,32
1656005526962,MATH 193A,A04,083782,Rotar; Vladimir,3,0,34,31
1656005526962,MATH 193A,A05,093482,Rotar; Vladimir,0,0,34,34
1656005532988,MATH 197,001,091859,McAuley; Julian John,9999,0,9999,0
1656005532988,MATH 197,002,095566,Kedlaya; Kiran S.,9997,0,9999,2
1656005532988,MATH 197,003,095567,Xiao; Ming,9999,0,9999,0
1656005532988,MATH 197,004,095571,Perols; Johan Lars,9998,0,9999,1
1656005540050,COGS 9,A01,083615,Shannon; Kyle Michael,3,1,75,72
1656005546077,COGS 11,A01,083617,Boyle; Mary E. T.,11,1,48,37
1656005552111,COGS 13,A01,083071,Bastos; Amalia Pinkusfeld,3,2,71,68
1656005558137,COGS 14A,A01,092681,Semenuks; Arturs,4,25,100,96
1656005564167,COGS 14B,A01,083073,Cheng; Tzu-Han,7,0,63,56
1656005570202,COGS 17,A01,092677,Semenuks; Arturs,8,7,81,73
1656005576235,COGS 100,A01,083619,Allen; Michael Gordon,2,2,70,68
1656005582269,COGS 101A,A01,083621,Davis; Joshua Daniel,4,3,68,64
1656005588292,COGS 101B,A01,091572,Allen; Michael Gordon,0,0,65,65
1656005594329,COGS 101C,A01,083625,Delgado; Tania,7,0,35,28
1656005600354,COGS 107A,A01,083627,Boyle; Mary E. T.,1,2,60,59
1656005606379,COGS 118A,A01,083075,Gupta; Anjum,21,16,76,55
1656005612415,CSE 3,A50,083646,Miranda; Gregory Joseph,14,0,50,36
1656005618453,CSE 8A,A50,083650,Miranda; Gregory Joseph,3,11,56,53
1656005624477,CSE 11,A01,083080,Cao; Yingjun,0,65,40,40
1656005630501,CSE 12,A01,083652,Krause-Levy; Sophia Louisa,6,8,120,114
1656005636527,CSE 15L,A01,083654,Morris; Justin Loren,3,1,50,47
1656005636527,CSE 15L,A02,083655,Morris; Justin Loren,1,1,50,49
1656005642555,CSE 20,A01,083657,Tran; Khoa Dang,29,0,80,51
1656005648584,CSE 21,A01,095574,Bach; Quang Tran,23,0,48,25
1656005654609,CSE 30,A01,083084,Eldon; John,2,10,80,78
1656005654609,CSE 30,B01,095061,Bhaskar; Nishant,0,4,50,50
1656005660660,CSE 100,A01,083659,Cao; Yingjun,2,25,70,68
1656005666683,CSE 134B,A01,083661,Powell; Thomas Allan,6,7,100,94
1656005672718,CSE 140,A01,083663,Gungor; Onat,5,0,85,80
1656005678750,CSE 140L,A01,083088,Eldon; John,5,0,100,95
1656005684792,CSE 175,A01,083665,Kumar; Rakesh,1,0,25,24
1656005690816,CSE 190,A00,092507,Dubnov; Shlomo,1,0,20,19
1656005696852,ECE 45,A01,083139,Congero; Spencer William,0,1,75,75
1656005702876,ECE 65,A50,083695,Saad; Andrew S,6,0,30,24
1656005702876,ECE 65,A51,095125,Staff,23,0,26,3
1656005708911,ECE 109,A01,091882,Touri; Behrouz,2,4,70,68
1656005714946,ECE 180,A00,083140,Abi Samra; Nicholas Camill,1,0,30,29
1656005714946,ECE 180,B00,083141,Abi Samra; Nicholas Camill,0,8,28,28
1656005720983,MATH 10A,A01,083735,Patchell; Gregory David,0,0,30,30
1656005720983,MATH 10A,A02,083736,Patchell; Gregory David,21,0,30,9
1656005720983,MATH 10A,A03,083737,Patchell; Gregory David,16,0,30,14
1656005727031,MATH 10B,A01,083207,Lim; Seonhee,1,1,34,33
1656005727031,MATH 10B,A02,083208,Lim; Seonhee,1,1,35,34
1656005727031,MATH 10B,A03,093472,Staff,1,0,34,33
1656005727031,MATH 10B,B01,083739,Sinha; Shubham,9,0,30,21
1656005733069,MATH 18,A01,083743,Cinel; Cameron Alexander,5,0,30,25
1656005733069,MATH 18,A02,083744,Cinel; Cameron Alexander,11,0,30,19
1656005733069,MATH 18,A03,083745,Cinel; Cameron Alexander,1,0,30,29
1656005733069,MATH 18,B01,083748,Ma; Zilu,1,0,36,35
1656005733069,MATH 18,B02,083749,Ma; Zilu,0,0,36,36
1656005733069,MATH 18,B03,083750,Ma; Zilu,0,0,36,36
1656005733069,MATH 18,B04,083751,Ma; Zilu,0,0,36,36
1656005733069,MATH 18,B05,093473,Staff,0,0,36,36
1656005733069,MATH 18,B06,093474,Staff,3,0,36,33
1656005739098,MATH 20A,A01,083754,Zheng; Zequn,10,0,40,30
1656005745125,MATH 20B,A01,083756,Briones; Jor-el Thomas Caparas,0,1,36,36
1656005745125,MATH 20B,A02,083757,Briones; Jor-el Thomas Caparas,1,0,36,35
1656005745125,MATH 20B,A03,093475,Staff,0,0,36,36
1656005751162,MATH 20C,A01,083760,Briones; Jor-el Thomas Caparas,0,2,35,35
1656005751162,MATH 20C,A02,083761,Briones; Jor-el Thomas Caparas,6,1,35,29
1656005751162,MATH 20C,A03,093476,Staff,0,0,35,35
1656005751162,MATH 20C,B01,083762,Bach; Quang Tran,3,0,30,27
1656005757184,MATH 20D,A01,083765,Tran; Brian Kha,1,0,30,29
1656005757184,MATH 20D,A02,083766,Tran; Brian Kha,0,1,30,30
1656005757184,MATH 20D,A03,083767,Tran; Brian Kha,1,0,30,29
1656005763209,MATH 20E,A01,083771,Ganguly; Soumya,0,1,32,32
1656005763209,MATH 20E,A02,083772,Ganguly; Soumya,1,1,32,31
1656005763209,MATH 20E,B01,083773,Ciotti; Benjamin,14,0,35,21
1656005763209,MATH 20E,B02,083774,Ciotti; Benjamin,12,0,35,23
1656005769231,MATH 103A,A01,083777,Greenfeld; Be'Eri,2,1,36,34
1656005769231,MATH 103A,A02,083778,Greenfeld; Be'Eri,2,0,36,34
1656005769231,MATH 103A,A03,093561,Staff,0,1,36,36
1656005769231,MATH 103A,B01,083779,Greenfeld; Be'Eri,7,1,36,29
1656005769231,MATH 103A,B02,083780,Greenfeld; Be'Eri,0,0,36,36
1656005769231,MATH 103A,B03,093562,Staff,0,0,36,36
1656005775256,MATH 105,A01,085443,Carter; Anne Toulson,4,1,35,31
1656005775256,MATH 105,A02,093477,Staff,8,0,35,27
1656005781294,MATH 109,A01,083213,Ganzberger; Geoffrey Michael,0,1,34,34
1656005781294,MATH 109,A02,083214,Ganzberger; Geoffrey Michael,0,0,34,34
1656005781294,MATH 109,A03,093478,Staff,1,0,34,33
1656005781294,MATH 109,B01,083215,Ganzberger; Geoffrey Michael,2,0,32,30
1656005781294,MATH 109,B02,083216,Ganzberger; Geoffrey Michael,0,0,32,32
1656005781294,MATH 109,B03,093479,Staff,4,0,32,28
1656005787336,MATH 142A,A01,083219,Chow; Bennett,0,0,32,32
1656005787336,MATH 142A,A02,083220,Chow; Bennett,7,0,32,25
1656005787336,MATH 142A,A03,093480,Staff,4,0,32,28
1656005787336,MATH 142A,B03,093481,Staff,3,0,32,29
1656005787336,MATH 142A,B04,093558,Staff,6,0,32,26
1656005787336,MATH 142A,B05,093559,Staff,0,0,32,32
1656005793368,MATH 193A,A01,083224,Rotar; Vladimir,1,1,34,33
1656005793368,MATH 193A,A02,083225,Rotar; Vladimir,0,0,34,34
1656005793368,MATH 193A,A03,083781,Rotar; Vladimir,2,0,34,32
1656005793368,MATH 193A,A04,083782,Rotar; Vladimir,3,0,34,31
1656005793368,MATH 193A,A05,093482,Rotar; Vladimir,0,0,34,34
1656005799481,MATH 197,001,091859,McAuley; Julian John,9999,0,9999,0
1656005799481,MATH 197,002,095566,Kedlaya; Kiran S.,9997,0,9999,2
1656005799481,MATH 197,003,095567,Xiao; Ming,9999,0,9999,0
1656005799481,MATH 197,004,095571,Perols; Johan Lars,9998,0,9999,1
1656005806585,COGS 9,A01,083615,Shannon; Kyle Michael,3,1,75,72
1656005812642,COGS 11,A01,083617,Boyle; Mary E. T.,11,1,48,37
1656005818674,COGS 13,A01,083071,Bastos; Amalia Pinkusfeld,3,2,71,68
1656005824702,COGS 14A,A01,092681,Semenuks; Arturs,4,25,100,96
1656005830735,COGS 14B,A01,083073,Cheng; Tzu-Han,7,0,63,56
1656005836762,COGS 17,A01,092677,Semenuks; Arturs,8,7,81,73
1656005842805,COGS 100,A01,083619,Allen; Michael Gordon,2,2,70,68
1656005848836,COGS 101A,A01,083621,Davis; Joshua Daniel,4,3,68,64
1656005854868,COGS 101B,A01,091572,Allen; Michael Gordon,0,0,65,65
1656005860910,COGS 101C,A01,083625,Delgado; Tania,7,0,35,28
1656005866937,COGS 107A,A01,083627,Boyle; Mary E. T.,1,2,60,59
1656005872975,COGS 118A,A01,083075,Gupta; Anjum,21,16,76,55
1656005879004,CSE 3,A50,083646,Miranda; Gregory Joseph,14,0,50,36
1656005885055,CSE 8A,A50,083650,Miranda; Gregory Joseph,3,11,56,53
1656005891097,CSE 11,A01,083080,Cao; Yingjun,0,65,40,40
1656005897130,CSE 12,A01,083652,Krause-Levy; Sophia Louisa,6,8,120,114
1656005903154,CSE 15L,A01,083654,Morris; Justin Loren,3,1,50,47
1656005903154,CSE 15L,A02,083655,Morris; Justin Loren,1,1,50,49
1656005909193,CSE 20,A01,083657,Tran; Khoa Dang,29,0,80,51
1656005915219,CSE 21,A01,095574,Bach; Quang Tran,23,0,48,25
1656005921249,CSE 30,A01,083084,Eldon; John,2,10,80,78
1656005921249,CSE 30,B01,095061,Bhaskar; Nishant,0,4,50,50
1656005927275,CSE 100,A01,083659,Cao; Yingjun,2,25,70,68
1656005933297,CSE 134B,A01,083661,Powell; Thomas Allan,6,7,100,94
1656005939329,CSE 140,A01,083663,Gungor; Onat,5,0,85,80
1656005945352,CSE 140L,A01,083088,Eldon; John,5,0,100,95
1656005951384,CSE 175,A01,083665,Kumar; Rakesh,1,0,25,24
1656005957415,CSE 190,A00,092507,Dubnov; Shlomo,1,0,20,19
1656005963449,ECE 45,A01,083139,Congero; Spencer William,0,1,75,75
1656005969472,ECE 65,A50,083695,Saad; Andrew S,6,0,30,24
1656005969472,ECE 65,A51,095125,Staff,23,0,26,3
1656005975516,ECE 109,A01,091882,Touri; Behrouz,2,4,70,68
1656005981541,ECE 180,A00,083140,Abi Samra; Nicholas Camill,1,0,30,29
1656005981541,ECE 180,B00,083141,Abi Samra; Nicholas Camill,0,8,28,28
1656005987602,MATH 10A,A01,083735,Patchell; Gregory David,0,0,30,30
1656005987602,MATH 10A,A02,083736,Patchell; Gregory David,21,0,30,9
1656005987602,MATH 10A,A03,083737,Patchell; Gregory David,16,0,30,14
1656005993628,MATH 10B,A01,083207,Lim; Seonhee,1,1,34,33
1656005993628,MATH 10B,A02,083208,Lim; Seonhee,1,1,35,34
1656005993628,MATH 10B,A03,093472,Staff,1,0,34,33
1656005993628,MATH 10B,B01,083739,Sinha; Shubham,9,0,30,21
1656005999652,MATH 18,A01,083743,Cinel; Cameron Alexander,5,0,30,25
1656005999652,MATH 18,A02,083744,Cinel; Cameron Alexander,11,0,30,19
1656005999652,MATH 18,A03,083745,Cinel; Cameron Alexander,1,0,30,29
1656005999652,MATH 18,B01,083748,Ma; Zilu,1,0,36,35
1656005999652,MATH 18,B02,083749,Ma; Zilu,0,0,36,36
1656005999652,MATH 18,B03,083750,Ma; Zilu,0,0,36,36
1656005999652,MATH 18,B04,083751,Ma; Zilu,0,0,36,36
1656005999652,MATH 18,B05,093473,Staff,0,0,36,36
1656005999652,MATH 18,B06,093474,Staff,3,0,36,33
1656006005676,MATH 20A,A01,083754,Zheng; Zequn,10,0,40,30
1656006011704,MATH 20B,A01,083756,Briones; Jor-el Thomas Caparas,0,1,36,36
1656006011704,MATH 20B,A02,083757,Briones; Jor-el Thomas Caparas,1,0,36,35
1656006011704,MATH 20B,A03,093475,Staff,0,0,36,36
1656006017760,MATH 20C,A01,083760,Briones; Jor-el Thomas Caparas,0,2,35,35
1656006017760,MATH 20C,A02,083761,Briones; Jor-el Thomas Caparas,6,1,35,29
1656006017760,MATH 20C,A03,093476,Staff,0,0,35,35
1656006017760,MATH 20C,B01,083762,Bach; Quang Tran,3,0,30,27
1656006023785,MATH 20D,A01,083765,Tran; Brian Kha,1,0,30,29
1656006023785,MATH 20D,A02,083766,Tran; Brian Kha,0,1,30,30
1656006023785,MATH 20D,A03,083767,Tran; Brian Kha,1,0,30,29
1656006029829,MATH 20E,A01,083771,Ganguly; Soumya,0,1,32,32
1656006029829,MATH 20E,A02,083772,Ganguly; Soumya,1,1,32,31
1656006029829,MATH 20E,B01,083773,Ciotti; Benjamin,14,0,35,21
1656006029829,MATH 20E,B02,083774,Ciotti; Benjamin,12,0,35,23
1656006035863,MATH 103A,A01,083777,Greenfeld; Be'Eri,2,1,36,34
1656006035863,MATH 103A,A02,083778,Greenfeld; Be'Eri,2,0,36,34
1656006035863,MATH 103A,A03,093561,Staff,0,1,36,36
1656006035863,MATH 103A,B01,083779,Greenfeld; Be'Eri,7,1,36,29
1656006035863,MATH 103A,B02,083780,Greenfeld; Be'Eri,0,0,36,36
1656006035863,MATH 103A,B03,093562,Staff,0,0,36,36
1656006041911,MATH 105,A01,085443,Carter; Anne Toulson,4,1,35,31
1656006041911,MATH 105,A02,093477,Staff,8,0,35,27
1656006047947,MATH 109,A01,083213,Ganzberger; Geoffrey Michael,0,1,34,34
1656006047947,MATH 109,A02,083214,Ganzberger; Geoffrey Michael,0,0,34,34
1656006047947,MATH 109,A03,093478,Staff,1,0,34,33
1656006047947,MATH 109,B01,083215,Ganzberger; Geoffrey Michael,2,0,32,30
1656006047947,MATH 109,B02,083216,Ganzberger; Geoffrey Michael,0,0,32,32
1656006047947,MATH 109,B03,093479,Staff,4,0,32,28
1656006053971,MATH 142A,A01,083219,Chow; Bennett,0,0,32,32
1656006053971,MATH 142A,A02,083220,Chow; Bennett,7,0,32,25
1656006053971,MATH 142A,A03,093480,Staff,4,0,32,28
1656006053971,MATH 142A,B03,093481,Staff,3,0,32,29
1656006053971,MATH 142A,B04,093558,Staff,6,0,32,26
1656006053971,MATH 142A,B05,093559,Staff,0,0,32,32
1656006060004,MATH 193A,A01,083224,Rotar; Vladimir,1,1,34,33
1656006060004,MATH 193A,A02,083225,Rotar; Vladimir,0,0,34,34
1656006060004,MATH 193A,A03,083781,Rotar; Vladimir,2,0,34,32
1656006060004,MATH 193A,A04,083782,Rotar; Vladimir,3,0,34,31
1656006060004,MATH 193A,A05,093482,Rotar; Vladimir,0,0,34,34
1656006066057,MATH 197,001,091859,McAuley; Julian John,9999,0,9999,0
1656006066057,MATH 197,002,095566,Kedlaya; Kiran S.,9997,0,9999,2
1656006066057,MATH 197,003,095567,Xiao; Ming,9999,0,9999,0
1656006066057,MATH 197,004,095571,Perols; Johan Lars,9998,0,9999,1
1656006073119,COGS 9,A01,083615,Shannon; Kyle Michael,3,1,75,72
1656006079142,COGS 11,A01,083617,Boyle; Mary E. T.,11,1,48,37
1656006085167,COGS 13,A01,083071,Bastos; Amalia Pinkusfeld,3,2,71,68
1656006091200,COGS 14A,A01,092681,Semenuks; Arturs,4,25,100,96
1656006097226,COGS 14B,A01,083073,Cheng; Tzu-Han,7,0,63,56
1656006103275,COGS 17,A01,092677,Semenuks; Arturs,8,7,81,73
1656006109301,COGS 100,A01,083619,Allen; Michael Gordon,2,2,70,68
1656006115327,COGS 101A,A01,083621,Davis; Joshua Daniel,4,3,68,64
1656006121351,COGS 101B,A01,091572,Allen; Michael Gordon,0,0,65,65
1656006127386,COGS 101C,A01,083625,Delgado; Tania,7,0,35,28
1656006133410,COGS 107A,A01,083627,Boyle; Mary E. T.,1,2,60,59
1656006139439,COGS 118A,A01,083075,Gupta; Anjum,21,16,76,55
1656006145466,CSE 3,A50,083646,Miranda; Gregory Joseph,14,0,50,36
1656006151499,CSE 8A,A50,083650,Miranda; Gregory Joseph,3,11,56,53
1656006157520,CSE 11,A01,083080,Cao; Yingjun,0,65,40,40
1656006163546,CSE 12,A01,083652,Krause-Levy; Sophia Louisa,6,8,120,114
1656006169576,CSE 15L,A01,083654,Morris; Justin Loren,3,1,50,47
1656006169576,CSE 15L,A02,083655,Morris; Justin Loren,1,1,50,49
1656006175605,CSE 20,A01,083657,Tran; Khoa Dang,29,0,80,51
1656006181649,CSE 21,A01,095574,Bach; Quang Tran,23,0,48,25
1656006187678,CSE 30,A01,083084,Eldon; John,2,10,80,78
1656006187678,CSE 30,B01,095061,Bhaskar; Nishant,0,4,50,50
1656006193703,CSE 100,A01,083659,Cao; Yingjun,2,25,70,68
1656006199759,CSE 134B,A01,083661,Powell; Thomas Allan,6,7,100,94
1656006205785,CSE 140,A01,083663,Gungor; Onat,5,0,85,80
1656006211821,CSE 140L,A01,083088,Eldon; John,5,0,100,95
1656006217845,CSE 175,A01,083665,Kumar; Rakesh,1,0,25,24
1656006223868,CSE 190,A00,092507,Dubnov; Shlomo,1,0,20,19
1656006229897,ECE 45,A01,083139,Congero; Spencer William,0,1,75,75
1656006235925,ECE 65,A50,083695,Saad; Andrew S,6,0,30,24
1656006235925,ECE 65,A51,095125,Staff,23,0,26,3
1656006241976,ECE 109,A01,091882,Touri; Behrouz,2,4,70,68
1656006248002,ECE 180,A00,083140,Abi Samra; Nicholas Camill,1,0,30,29
1656006248002,ECE 180,B00,083141,Abi Samra; Nicholas Camill,0,8,28,28
1656006254034,MATH 10A,A01,083735,Patchell; Gregory David,0,0,30,30
1656006254034,MATH 10A,A02,083736,Patchell; Gregory David,21,0,30,9
1656006254034,MATH 10A,A03,083737,Patchell; Gregory David,16,0,30,14
1656006260060,MATH 10B,A01,083207,Lim; Seonhee,1,1,34,33
1656006260060,MATH 10B,A02,083208,Lim; Seonhee,1,1,35,34
1656006260060,MATH 10B,A03,093472,Staff,1,0,34,33
1656006260060,MATH 10B,B01,083739,Sinha; Shubham,9,0,30,21
1656006266091,MATH 18,A01,083743,Cinel; Cameron Alexander,5,0,30,25
1656006266091,MATH 18,A02,083744,Cinel; Cameron Alexander,11,0,30,19
1656006266091,MATH 18,A03,083745,Cinel; Cameron Alexander,1,0,30,29
1656006266091,MATH 18,B01,083748,Ma; Zilu,1,0,36,35
1656006266091,MATH 18,B02,083749,Ma; Zilu,0,0,36,36
1656006266091,MATH 18,B03,083750,Ma; Zilu,0,0,36,36
1656006266091,MATH 18,B04,083751,Ma; Zilu,0,0,36,36
1656006266091,MATH 18,B05,093473,Staff,0,0,36,36
1656006266091,MATH 18,B06,093474,Staff,3,0,36,33
1656006272117,MATH 20A,A01,083754,Zheng; Zequn,10,0,40,30
1656006278155,MATH 20B,A01,083756,Briones; Jor-el Thomas Caparas,0,1,36,36
1656006278155,MATH 20B,A02,083757,Briones; Jor-el Thomas Caparas,1,0,36,35
1656006278155,MATH 20B,A03,093475,Staff,0,0,36,36
1656006284177,MATH 20C,A01,083760,Briones; Jor-el Thomas Caparas,0,2,35,35
1656006284177,MATH 20C,A02,083761,Briones; Jor-el Thomas Caparas,6,1,35,29
1656006284177,MATH 20C,A03,093476,Staff,0,0,35,35
1656006284177,MATH 20C,B01,083762,Bach; Quang Tran,3,0,30,27
1656006290231,MATH 20D,A01,083765,Tran; Brian Kha,1,0,30,29
1656006290231,MATH 20D,A02,083766,Tran; Brian Kha,0,1,30,30
1656006290231,MATH 20D,A03,083767,Tran; Brian Kha,1,0,30,29
1656006296258,MATH 20E,A01,083771,Ganguly; Soumya,0,1,32,32
1656006296258,MATH 20E,A02,083772,Ganguly; Soumya,1,1,32,31
1656006296258,MATH 20E,B01,083773,Ciotti; Benjamin,14,0,35,21
1656006296258,MATH 20E,B02,083774,Ciotti; Benjamin,12,0,35,23
1656006302300,MATH 103A,A01,083777,Greenfeld; Be'Eri,2,1,36,34
1656006302300,MATH 103A,A02,083778,Greenfeld; Be'Eri,2,0,36,34
1656006302300,MATH 103A,A03,093561,Staff,0,1,36,36
1656006302300,MATH 103A,B01,083779,Greenfeld; Be'Eri,7,1,36,29
1656006302300,MATH 103A,B02,083780,Greenfeld; Be'Eri,0,0,36,36
1656006302300,MATH 103A,B03,093562,Staff,0,0,36,36
1656006308328,MATH 105,A01,085443,Carter; Anne Toulson,4,1,35,31
1656006308328,MATH 105,A02,093477,Staff,8,0,35,27
1656006314357,MATH 109,A01,083213,Ganzberger; Geoffrey Michael,0,1,34,34
1656006314357,MATH 109,A02,083214,Ganzberger; Geoffrey Michael,0,0,34,34
1656006314357,MATH 109,A03,093478,Staff,1,0,34,33
1656006314357,MATH 109,B01,083215,Ganzberger; Geoffrey Michael,2,0,32,30
1656006314357,MATH 109,B02,083216,Ganzberger; Geoffrey Michael,0,0,32,32
1656006314357,MATH 109,B03,093479,Staff,4,0,32,28
1656006320381,MATH 142A,A01,083219,Chow; Bennett,0,0,32,32
1656006320381,MATH 142A,A02,083220,Chow; Bennett,7,0,32,25
1656006320381,MATH 142A,A03,093480,Staff,4,0,32,28
1656006320381,MATH 142A,B03,093481,Staff,3,0,32,29
1656006320381,MATH 142A,B04,093558,Staff,6,0,32,26
1656006320381,MATH 142A,B05,093559,Staff,0,0,32,32
1656006326407,MATH 193A,A01,083224,Rotar; Vladimir,1,1,34,33
1656006326407,MATH 193A,A02,083225,Rotar; Vladimir,0,0,34,34
1656006326407,MATH 193A,A03,083781,Rotar; Vladimir,2,0,34,32
1656006326407,MATH 193A,A04,083782,Rotar; Vladimir,3,0,34,31
1656006326407,MATH 193A,A05,093482,Rotar; Vladimir,0,0,34,34
1656006332439,MATH 197,001,091859,McAuley; Julian John,9999,0,9999,0
1656006332439,MATH 197,002,095566,Kedlaya; Kiran S.,9997,0,9999,2
1656006332439,MATH 197,003,095567,Xiao; Ming,9999,0,9999,0
1656006332439,MATH 197,004,095571,Perols; Johan Lars,9998,0,9999,1
1656006339508,COGS 9,A01,083615,Shannon; Kyle Michael,3,1,75,72
1656006345533,COGS 11,A01,083617,Boyle; Mary E. T.,11,1,48,37
1656006351558,COGS 13,A01,083071,Bastos; Amalia Pinkusfeld,3,2,71,68
1656006357585,COGS 14A,A01,092681,Semenuks; Arturs,4,25,100,96
1656006363629,COGS 14B,A01,083073,Cheng; Tzu-Han,7,0,63,56
1656006369658,COGS 17,A01,092677,Semenuks; Arturs,8,7,81,73
1656006375709,COGS 100,A01,083619,Allen; Michael Gordon,2,2,70,68
1656006381732,COGS 101A,A01,083621,Davis; Joshua Daniel,4,3,68,64
1656006387756,COGS 101B,A01,091572,Allen; Michael Gordon,0,0,65,65
1656006393866,COGS 101C,A01,083625,Delgado; Tania,7,0,35,28
1656006399911,COGS 107A,A01,083627,Boyle; Mary E. T.,1,2,60,59
1656006405945,COGS 118A,A01,083075,Gupta; Anjum,21,16,76,55
1656006411992,CSE 3,A50,083646,Miranda; Gregory Joseph,14,0,50,36
1656006418024,CSE 8A,A50,083650,Miranda; Gregory Joseph,3,11,56,53
1656006424077,CSE 11,A01,083080,Cao; Yingjun,0,65,40,40
1656006430100,CSE 12,A01,083652,Krause-Levy; Sophia Louisa,6,8,120,114
1656006436123,CSE 15L,A01,083654,Morris; Justin Loren,3,1,50,47
1656006436123,CSE 15L,A02,083655,Morris; Justin Loren,1,1,50,49
1656006442146,CSE 20,A01,083657,Tran; Khoa Dang,29,0,80,51
1656006448178,CSE 21,A01,095574,Bach; Quang Tran,23,0,48,25
1656006454224,CSE 30,A01,083084,Eldon; John,2,10,80,78
1656006454224,CSE 30,B01,095061,Bhaskar; Nishant,0,4,50,50
1656006460251,CSE 100,A01,083659,Cao; Yingjun,2,25,70,68
1656006466299,CSE 134B,A01,083661,Powell; Thomas Allan,6,7,100,94
1656006472322,CSE 140,A01,083663,Gungor; Onat,5,0,85,80
1656006478370,CSE 140L,A01,083088,Eldon; John,5,0,100,95
1656006484413,CSE 175,A01,083665,Kumar; Rakesh,1,0,25,24
1656006490455,CSE 190,A00,092507,Dubnov; Shlomo,1,0,20,19
1656006496481,ECE 45,A01,083139,Congero; Spencer William,0,1,75,75
1656006502508,ECE 65,A50,083695,Saad; Andrew S,6,0,30,24
1656006502508,ECE 65,A51,095125,Staff,23,0,26,3
1656006508531,ECE 109,A01,091882,Touri; Behrouz,2,4,70,68
1656006514588,ECE 180,A00,083140,Abi Samra; Nicholas Camill,1,0,30,29
1656006514588,ECE 180,B00,083141,Abi Samra; Nicholas Camill,0,8,28,28
1656006520610,MATH 10A,A01,083735,Patchell; Gregory David,0,0,30,30
1656006520610,MATH 10A,A02,083736,Patchell; Gregory David,21,0,30,9
1656006520610,MATH 10A,A03,083737,Patchell; Gregory David,16,0,30,14
1656006526654,MATH 10B,A01,083207,Lim; Seonhee,1,1,34,33
1656006526654,MATH 10B,A02,083208,Lim; Seonhee,1,1,35,34
1656006526654,MATH 10B,A03,093472,Staff,1,0,34,33
1656006526654,MATH 10B,B01,083739,Sinha; Shubham,9,0,30,21
1656006532695,MATH 18,A01,083743,Cinel; Cameron Alexander,5,0,30,25
1656006532695,MATH 18,A02,083744,Cinel; Cameron Alexander,11,0,30,19
1656006532695,MATH 18,A03,083745,Cinel; Cameron Alexander,1,0,30,29
1656006532695,MATH 18,B01,083748,Ma; Zilu,1,0,36,35
1656006532695,MATH 18,B02,083749,Ma; Zilu,0,0,36,36
1656006532695,MATH 18,B03,083750,Ma; Zilu,0,0,36,36
1656006532695,MATH 18,B04,083751,Ma; Zilu,0,0,36,36
1656006532695,MATH 18,B05,093473,Staff,0,0,36,36
1656006532695,MATH 18,B06,093474,Staff,3,0,36,33
1656006538727,MATH 20A,A01,083754,Zheng; Zequn,10,0,40,30
1656006544765,MATH 20B,A01,083756,Briones; Jor-el Thomas Caparas,0,1,36,36
1656006544765,MATH 20B,A02,083757,Briones; Jor-el Thomas Caparas,1,0,36,35
1656006544765,MATH 20B,A03,093475,Staff,0,0,36,36
1656006550798,MATH 20C,A01,083760,Briones; Jor-el Thomas Caparas,0,2,35,35
1656006550798,MATH 20C,A02,083761,Briones; Jor-el Thomas Caparas,6,1,35,29
1656006550798,MATH 20C,A03,093476,Staff,0,0,35,35
1656006550798,MATH 20C,B01,083762,Bach; Quang Tran,3,0,30,27
1656006556822,MATH 20D,A01,083765,Tran; Brian Kha,1,0,30,29
1656006556822,MATH 20D,A02,083766,Tran; Brian Kha,0,1,30,30
1656006556822,MATH 20D,A03,083767,Tran; Brian Kha,1,0,30,29
1656006562853,MATH 20E,A01,083771,Ganguly; Soumya,0,1,32,32
1656006562853,MATH 20E,A02,083772,Ganguly; Soumya,1,1,32,31
1656006562853,MATH 20E,B01,083773,Ciotti; Benjamin,14,0,35,21
1656006562853,MATH 20E,B02,083774,Ciotti; Benjamin,12,0,35,23
1656006568878,MATH 103A,A01,083777,Greenfeld; Be'Eri,2,1,36,34
1656006568878,MATH 103A,A02,083778,Greenfeld; Be'Eri,2,0,36,34
1656006568878,MATH 103A,A03,093561,Staff,0,1,36,36
1656006568878,MATH 103A,B01,083779,Greenfeld; Be'Eri,7,1,36,29
1656006568878,MATH 103A,B02,083780,Greenfeld; Be'Eri,0,0,36,36
1656006568878,MATH 103A,B03,093562,Staff,0,0,36,36
1656006574933,MATH 105,A01,085443,Carter; Anne Toulson,4,1,35,31
1656006574933,MATH 105,A02,093477,Staff,8,0,35,27
1656006580970,MATH 109,A01,083213,Ganzberger; Geoffrey Michael,0,1,34,34
1656006580970,MATH 109,A02,083214,Ganzberger; Geoffrey Michael,0,0,34,34
1656006580970,MATH 109,A03,093478,Staff,1,0,34,33
1656006580970,MATH 109,B01,083215,Ganzberger; Geoffrey Michael,2,0,32,30
1656006580970,MATH 109,B02,083216,Ganzberger; Geoffrey Michael,0,0,32,32
1656006580970,MATH 109,B03,093479,Staff,4,0,32,28
1656006586995,MATH 142A,A01,083219,Chow; Bennett,0,0,32,32
1656006586995,MATH 142A,A02,083220,Chow; Bennett,7,0,32,25
1656006586995,MATH 142A,A03,093480,Staff,4,0,32,28
1656006586995,MATH 142A,B03,093481,Staff,3,0,32,29
1656006586995,MATH 142A,B04,093558,Staff,6,0,32,26
1656006586995,MATH 142A,B05,093559,Staff,0,0,32,32
1656006593043,MATH 193A,A01,083224,Rotar; Vladimir,1,1,34,33
1656006593043,MATH 193A,A02,083225,Rotar; Vladimir,0,0,34,34
1656006593043,MATH 193A,A03,083781,Rotar; Vladimir,2,0,34,32
1656006593043,MATH 193A,A04,083782,Rotar; Vladimir,3,0,34,31
1656006593043,MATH 193A,A05,093482,Rotar; Vladimir,0,0,34,34
1656006599071,MATH 197,001,091859,McAuley; Julian John,9999,0,9999,0
1656006599071,MATH 197,002,095566,Kedlaya; Kiran S.,9997,0,9999,2
1656006599071,MATH 197,003,095567,Xiao; Ming,9999,0,9999,0
1656006599071,MATH 197,004,095571,Perols; Johan Lars,9998,0,9999,1
1656006606132,COGS 9,A01,083615,Shannon; Kyle Michael,3,1,75,72
1656006612169,COGS 11,A01,083617,Boyle; Mary E. T.,11,1,48,37
1656006618198,COGS 13,A01,083071,Bastos; Amalia Pinkusfeld,3,2,71,68
1656006624249,COGS 14A,A01,092681,Semenuks; Arturs,4,25,100,96
1656006630272,COGS 14B,A01,083073,Cheng; Tzu-Han,7,0,63,56
1656006636297,COGS 17,A01,092677,Semenuks; Arturs,8,7,81,73
1656006642322,COGS 100,A01,083619,Allen; Michael Gordon,2,2,70,68
1656006648359,COGS 101A,A01,083621,Davis; Joshua Daniel,4,3,68,64
1656006654383,COGS 101B,A01,091572,Allen; Michael Gordon,0,0,65,65
1656006660407,COGS 101C,A01,083625,Delgado; Tania,7,0,35,28
1656006666431,COGS 107A,A01,083627,Boyle; Mary E. T.,1,2,60,59
1656006672459,COGS 118A,A01,083075,Gupta; Anjum,21,16,76,55
1656006678491,CSE 3,A50,083646,Miranda; Gregory Joseph,14,0,50,36
1656006684536,CSE 8A,A50,083650,Miranda; Gregory Joseph,3,11,56,53
1656006690577,CSE 11,A01,083080,Cao; Yingjun,0,65,40,40
1656006696613,CSE 12,A01,083652,Krause-Levy; Sophia Louisa,6,8,120,114
1656006702637,CSE 15L,A01,083654,Morris; Justin Loren,3,1,50,47
1656006702637,CSE 15L,A02,083655,Morris; Justin Loren,1,1,50,49
1656006708664,CSE 20,A01,083657,Tran; Khoa Dang,29,0,80,51
1656006714691,CSE 21,A01,095574,Bach; Quang Tran,23,0,48,25
1656006720735,CSE 30,A01,083084,Eldon; John,2,10,80,78
1656006720735,CSE 30,B01,095061,Bhaskar; Nishant,0,4,50,50
1656006726786,CSE 100,A01,083659,Cao; Yingjun,2,25,70,68
1656006732810,CSE 134B,A01,083661,Powell; Thomas Allan,6,7,100,94
1656006738858,CSE 140,A01,083663,Gungor; Onat,5,0,85,80
1656006744880,CSE 140L,A01,083088,Eldon; John,5,0,100,95
1656006750906,CSE 175,A01,083665,Kumar; Rakesh,1,0,25,24
1656006756931,CSE 190,A00,092507,Dubnov; Shlomo,1,0,20,19
1656006762969,ECE 45,A01,083139,Congero; Spencer William,0,1,75,75
1656006769014,ECE 65,A50,083695,Saad; Andrew S,6,0,30,24
1656006769014,ECE 65,A51,095125,Staff,23,0,26,3
1656006775065,ECE 109,A01,091882,Touri; Behrouz,2,4,70,68
1656006781093,ECE 180,A00,083140,Abi Samra; Nicholas Camill,1,0,30,29
1656006781093,ECE 180,B00,083141,Abi Samra; Nicholas Camill,0,8,28,28
1656006787115,MATH 10A,A01,083735,Patchell; Gregory David,0,0,30,30
1656006787115,MATH 10A,A02,083736,Patchell; Gregory David,21,0,30,9
1656006787115,MATH 10A,A03,083737,Patchell; Gregory David,16,0,30,14
1656006793139,MATH 10B,A01,083207,Lim; Seonhee,1,1,34,33
1656006793139,MATH 10B,A02,083208,Lim; Seonhee,1,1,35,34
1656006793139,MATH 10B,A03,093472,Staff,1,0,34,33
1656006793139,MATH 10B,B01,083739,Sinha; Shubham,9,0,30,21
1656006799194,MATH 18,A01,083743,Cinel; Cameron Alexander,5,0,30,25
1656006799194,MATH 18,A02,083744,Cinel; Cameron Alexander,11,0,30,19
1656006799194,MATH 18,A03,083745,Cinel; Cameron Alexander,1,0,30,29
1656006799194,MATH 18,B01,083748,Ma; Zilu,1,0,36,35
1656006799194,MATH 18,B02,083749,Ma; Zilu,0,0,36,36
1656006799194,MATH 18,B03,083750,Ma; Zilu,0,0,36,36
1656006799194,MATH 18,B04,083751,Ma; Zilu,0,0,36,36
1656006799194,MATH 18,B05,093473,Staff,0,0,36,36
1656006799194,MATH 18,B06,093474,Staff,3,0,36,33
1656006805220,MATH 20A,A01,083754,Zheng; Zequn,10,0,40,30
1656006811256,MATH 20B,A01,083756,Briones; Jor-el Thomas Caparas,0,1,36,36
1656006811256,MATH 20B,A02,083757,Briones; Jor-el Thomas Caparas,1,0,36,35
1656006811256,MATH 20B,A03,093475,Staff,0,0,36,36
1656006817279,MATH 20C,A01,083760,Briones; Jor-el Thomas Caparas,0,2,35,35
1656006817279,MATH 20C,A02,083761,Briones; Jor-el Thomas Caparas,6,1,35,29
1656006817279,MATH 20C,A03,093476,Staff,0,0,35,35
1656006817279,MATH 20C,B01,083762,Bach; Quang Tran,3,0,30,27
1656006823331,MATH 20D,A01,083765,Tran; Brian Kha,1,0,30,29
1656006823331,MATH 20D,A02,083766,Tran; Brian Kha,0,1,30,30
1656006823331,MATH 20D,A03,083767,Tran; Brian Kha,1,0,30,29
1656006829358,MATH 20E,A01,083771,Ganguly; Soumya,0,1,32,32
1656006829358,MATH 20E,A02,083772,Ganguly; Soumya,1,1,32,31
1656006829358,MATH 20E,B01,083773,Ciotti; Benjamin,14,0,35,21
1656006829358,MATH 20E,B02,083774,Ciotti; Benjamin,12,0,35,23
1656006835381,MATH 103A,A01,083777,Greenfeld; Be'Eri,2,1,36,34
1656006835381,MATH 103A,A02,083778,Greenfeld; Be'Eri,2,0,36,34
1656006835381,MATH 103A,A03,093561,Staff,0,1,36,36
1656006835381,MATH 103A,B01,083779,Greenfeld; Be'Eri,7,1,36,29
1656006835381,MATH 103A,B02,083780,Greenfeld; Be'Eri,0,0,36,36
1656006835381,MATH 103A,B03,093562,Staff,0,0,36,36
1656006841409,MATH 105,A01,085443,Carter; Anne Toulson,4,1,35,31
1656006841409,MATH 105,A02,093477,Staff,8,0,35,27
1656006847432,MATH 109,A01,083213,Ganzberger; Geoffrey Michael,0,1,34,34
1656006847432,MATH 109,A02,083214,Ganzberger; Geoffrey Michael,0,0,34,34
1656006847432,MATH 109,A03,093478,Staff,1,0,34,33
1656006847432,MATH 109,B01,083215,Ganzberger; Geoffrey Michael,2,0,32,30
1656006847432,MATH 109,B02,083216,Ganzberger; Geoffrey Michael,0,0,32,32
1656006847432,MATH 109,B03,093479,Staff,4,0,32,28
1656006853456,MATH 142A,A01,083219,Chow; Bennett,0,0,32,32
1656006853456,MATH 142A,A02,083220,Chow; Bennett,7,0,32,25
1656006853456,MATH 142A,A03,093480,Staff,4,0,32,28
1656006853456,MATH 142A,B03,093481,Staff,3,0,32,29
1656006853456,MATH 142A,B04,093558,Staff,6,0,32,26
1656006853456,MATH 142A,B05,093559,Staff,0,0,32,32
1656006859492,MATH 193A,A01,083224,Rotar; Vladimir,1,1,34,33
1656006859492,MATH 193A,A02,083225,Rotar; Vladimir,0,0,34,34
1656006859492,MATH 193A,A03,083781,Rotar; Vladimir,2,0,34,32
1656006859492,MATH 193A,A04,083782,Rotar; Vladimir,3,0,34,31
1656006859492,MATH 193A,A05,093482,Rotar; Vladimir,0,0,34,34
1656006865516,MATH 197,001,091859,McAuley; Julian John,9999,0,9999,0
1656006865516,MATH 197,002,095566,Kedlaya; Kiran S.,9997,0,9999,2
1656006865516,MATH 197,003,095567,Xiao; Ming,9999,0,9999,0
1656006865516,MATH 197,004,095571,Perols; Johan Lars,9998,0,9999,1
1656006872594,COGS 9,A01,083615,Shannon; Kyle Michael,3,1,75,72
1656006878618,COGS 11,A01,083617,Boyle; Mary E. T.,11,1,48,37
1656006884651,COGS 13,A01,083071,Bastos; Amalia Pinkusfeld,3,2,71,68
1656006890683,COGS 14A,A01,092681,Semenuks; Arturs,4,25,100,96
1656006896706,COGS 14B,A01,083073,Cheng; Tzu-Han,7,0,63,56
1656006902739,COGS 17,A01,092677,Semenuks; Arturs,8,7,81,73
1656006908768,COGS 100,A01,083619,Allen; Michael Gordon,2,2,70,68
1656006914802,COGS 101A,A01,083621,Davis; Joshua Daniel,4,3,68,64
1656006920825,COGS 101B,A01,091572,Allen; Michael Gordon,0,0,65,65
1656006926860,COGS 101C,A01,083625,Delgado; Tania,7,0,35,28
1656006932887,COGS 107A,A01,083627,Boyle; Mary E. T.,1,2,60,59
1656006938911,COGS 118A,A01,083075,Gupta; Anjum,21,16,76,55
1656006944947,CSE 3,A50,083646,Miranda; Gregory Joseph,14,0,50,36
1656006950971,CSE 8A,A50,083650,Miranda; Gregory Joseph,3,11,56,53
1656006957003,CSE 11,A01,083080,Cao; Yingjun,0,65,40,40
1656006963040,CSE 12,A01,083652,Krause-Levy; Sophia Louisa,6,8,120,114
1656006969063,CSE 15L,A01,083654,Morris; Justin Loren,3,1,50,47
1656006969063,CSE 15L,A02,083655,Morris; Justin Loren,1,1,50,49
1656006975102,CSE 20,A01,083657,Tran; Khoa Dang,29,0,80,51
1656006981139,CSE 21,A01,095574,Bach; Quang Tran,23,0,48,25
1656006987181,CSE 30,A01,083084,Eldon; John,2,10,80,78
1656006987181,CSE 30,B01,095061,Bhaskar; Nishant,0,4,50,50
1656006993309,CSE 100,A01,083659,Cao; Yingjun,2,25,70,68
1656006999336,CSE 134B,A01,083661,Powell; Thomas Allan,6,7,100,94
1656007005385,CSE 140,A01,083663,Gungor; Onat,5,0,85,80
1656007011411,CSE 140L,A01,083088,Eldon; John,5,0,100,95
1656007017436,CSE 175,A01,083665,Kumar; Rakesh,1,0,25,24
1656007023470,CSE 190,A00,092507,Dubnov; Shlomo,1,0,20,19
1656007029498,ECE 45,A01,083139,Congero; Spencer William,0,1,75,75
1656007035532,ECE 65,A50,083695,Saad; Andrew S,6,0,30,24
1656007035532,ECE 65,A51,095125,Staff,23,0,26,3
1656007041558,ECE 109,A01,091882,Touri; Behrouz,2,4,70,68
1656007047581,ECE 180,A00,083140,Abi Samra; Nicholas Camill,1,0,30,29
1656007047581,ECE 180,B00,083141,Abi Samra; Nicholas Camill,0,8,28,28
1656007053623,MATH 10A,A01,083735,Patchell; Gregory David,0,0,30,30
1656007053623,MATH 10A,A02,083736,Patchell; Gregory David,21,0,30,9
1656007053623,MATH 10A,A03,083737,Patchell; Gregory David,16,0,30,14
1656007059647,MATH 10B,A01,083207,Lim; Seonhee,1,1,34,33
1656007059647,MATH 10B,A02,083208,Lim; Seonhee,1,1,35,34
1656007059647,MATH 10B,A03,093472,Staff,1,0,34,33
1656007059647,MATH 10B,B01,083739,Sinha; Shubham,9,0,30,21
1656007065679,MATH 18,A01,083743,Cinel; Cameron Alexander,5,0,30,25
1656007065679,MATH 18,A02,083744,Cinel; Cameron Alexander,11,0,30,19
1656007065679,MATH 18,A03,083745,Cinel; Cameron Alexander,1,0,30,29
1656007065679,MATH 18,B01,083748,Ma; Zilu,1,0,36,35
1656007065679,MATH 18,B02,083749,Ma; Zilu,0,0,36,36
1656007065679,MATH 18,B03,083750,Ma; Zilu,0,0,36,36
1656007065679,MATH 18,B04,083751,Ma; Zilu,0,0,36,36
1656007065679,MATH 18,B05,093473,Staff,0,0,36,36
1656007065679,MATH 18,B06,093474,Staff,3,0,36,33
1656007071705,MATH 20A,A01,083754,Zheng; Zequn,10,0,40,30
1656007077729,MATH 20B,A01,083756,Briones; Jor-el Thomas Caparas,0,1,36,36
1656007077729,MATH 20B,A02,083757,Briones; Jor-el Thomas Caparas,1,0,36,35
1656007077729,MATH 20B,A03,093475,Staff,0,0,36,36
1656007083773,MATH 20C,A01,083760,Briones; Jor-el Thomas Caparas,0,2,35,35
1656007083773,MATH 20C,A02,083761,Briones; Jor-el Thomas Caparas,6,1,35,29
1656007083773,MATH 20C,A03,093476,Staff,0,0,35,35
1656007083773,MATH 20C,B01,083762,Bach; Quang Tran,3,0,30,27
1656007089817,MATH 20D,A01,083765,Tran; Brian Kha,1,0,30,29
1656007089817,MATH 20D,A02,083766,Tran; Brian Kha,0,1,30,30
1656007089817,MATH 20D,A03,083767,Tran; Brian Kha,1,0,30,29
1656007095866,MATH 20E,A01,083771,Ganguly; Soumya,0,1,32,32
1656007095866,MATH 20E,A02,083772,Ganguly; Soumya,1,1,32,31
1656007095866,MATH 20E,B01,083773,Ciotti; Benjamin,14,0,35,21
1656007095866,MATH 20E,B02,083774,Ciotti; Benjamin,12,0,35,23
1656007101889,MATH 103A,A01,083777,Greenfeld; Be'Eri,2,1,36,34
1656007101889,MATH 103A,A02,083778,Greenfeld; Be'Eri,2,0,36,34
1656007101889,MATH 103A,A03,093561,Staff,0,1,36,36
1656007101889,MATH 103A,B01,083779,Greenfeld; Be'Eri,7,1,36,29
1656007101889,MATH 103A,B02,083780,Greenfeld; Be'Eri,0,0,36,36
1656007101889,MATH 103A,B03,093562,Staff,0,0,36,36
1656007107913,MATH 105,A01,085443,Carter; Anne Toulson,4,1,35,31
1656007107913,MATH 105,A02,093477,Staff,8,0,35,27
1656007113942,MATH 109,A01,083213,Ganzberger; Geoffrey Michael,0,1,34,34
1656007113942,MATH 109,A02,083214,Ganzberger; Geoffrey Michael,0,0,34,34
1656007113942,MATH 109,A03,093478,Staff,1,0,34,33
1656007113942,MATH 109,B01,083215,Ganzberger; Geoffrey Michael,2,0,32,30
1656007113942,MATH 109,B02,083216,Ganzberger; Geoffrey Michael,0,0,32,32
1656007113942,MATH 109,B03,093479,Staff,4,0,32,28
1656007119983,MATH 142A,A01,083219,Chow; Bennett,0,0,32,32
1656007119983,MATH 142A,A02,083220,Chow; Bennett,7,0,32,25
1656007119983,MATH 142A,A03,093480,Staff,4,0,32,28
1656007119983,MATH 142A,B03,093481,Staff,3,0,32,29
1656007119983,MATH 142A,B04,093558,Staff,6,0,32,26
1656007119983,MATH 142A,B05,093559,Staff,0,0,32,32
1656007126028,MATH 193A,A01,083224,Rotar; Vladimir,1,1,34,33
1656007126028,MATH 193A,A02,083225,Rotar; Vladimir,0,0,34,34
1656007126028,MATH 193A,A03,083781,Rotar; Vladimir,2,0,34,32
1656007126028,MATH 193A,A04,083782,Rotar; Vladimir,3,0,34,31
1656007126028,MATH 193A,A05,093482,Rotar; Vladimir,0,0,34,34
1656007132050,MATH 197,001,091859,McAuley; Julian John,9999,0,9999,0
1656007132050,MATH 197,002,095566,Kedlaya; Kiran S.,9997,0,9999,2
1656007132050,MATH 197,003,095567,Xiao; Ming,9999,0,9999,0
1656007132050,MATH 197,004,095571,Perols; Johan Lars,9998,0,9999,1
1656007139120,COGS 9,A01,083615,Shannon; Kyle Michael,3,1,75,72
1656007145150,COGS 11,A01,083617,Boyle; Mary E. T.,11,1,48,37
1656007151173,COGS 13,A01,083071,Bastos; Amalia Pinkusfeld,3,2,71,68
1656007157201,COGS 14A,A01,092681,Semenuks; Arturs,4,25,100,96
1656007163225,COGS 14B,A01,083073,Cheng; Tzu-Han,7,0,63,56
1656007169249,COGS 17,A01,092677,Semenuks; Arturs,8,7,81,73
1656007175272,COGS 100,A01,083619,Allen; Michael Gordon,2,2,70,68
1656007181301,COGS 101A,A01,083621,Davis; Joshua Daniel,4,3,68,64
1656007187342,COGS 101B,A01,091572,Allen; Michael Gordon,0,0,65,65
1656007193370,COGS 101C,A01,083625,Delgado; Tania,7,0,35,28
1656007199403,COGS 107A,A01,083627,Boyle; Mary E. T.,1,2,60,59
1656007205426,COGS 118A,A01,083075,Gupta; Anjum,21,16,76,55
1656007211455,CSE 3,A50,083646,Miranda; Gregory Joseph,14,0,50,36
1656007217500,CSE 8A,A50,083650,Miranda; Gregory Joseph,3,11,56,53
1656007223524,CSE 11,A01,083080,Cao; Yingjun,0,65,40,40
1656007229546,CSE 12,A01,083652,Krause-Levy; Sophia Louisa,6,8,120,114
1656007235575,CSE 15L,A01,083654,Morris; Justin Loren,3,1,50,47
1656007235575,CSE 15L,A02,083655,Morris; Justin Loren,1,1,50,49
1656007241600,CSE 20,A01,083657,Tran; Khoa Dang,29,0,80,51
1656007247645,CSE 21,A01,095574,Bach; Quang Tran,23,0,48,25
1656007253674,CSE 30,A01,083084,Eldon; John,2,10,80,78
1656007253674,CSE 30,B01,095061,Bhaskar; Nishant,0,4,50,50
1656007259697,CSE 100,A01,083659,Cao; Yingjun,2,25,70,68
1656007265724,CSE 134B,A01,083661,Powell; Thomas Allan,6,7,100,94
1656007271746,CSE 140,A01,083663,Gungor; Onat,5,0,85,80
1656007277770,CSE 140L,A01,083088,Eldon; John,5,0,100,95
1656007283795,CSE 175,A01,083665,Kumar; Rakesh,1,0,25,24
1656007289820,CSE 190,A00,092507,Dubnov; Shlomo,1,0,20,19
1656007295842,ECE 45,A01,083139,Congero; Spencer William,0,1,75,75
1656007301870,ECE 65,A50,083695,Saad; Andrew S,6,0,30,24
1656007301870,ECE 65,A51,095125,Staff,23,0,26,3
1656007307899,ECE 109,A01,091882,Touri; Behrouz,2,4,70,68
1656007313927,ECE 180,A00,083140,Abi Samra; Nicholas Camill,1,0,30,29
1656007313927,ECE 180,B00,083141,Abi Samra; Nicholas Camill,0,8,28,28
1656007319959,MATH 10A,A01,083735,Patchell; Gregory David,0,0,30,30
1656007319959,MATH 10A,A02,083736,Patchell; Gregory David,21,0,30,9
1656007319959,MATH 10A,A03,083737,Patchell; Gregory David,16,0,30,14
1656007325986,MATH 10B,A01,083207,Lim; Seonhee,1,1,34,33
1656007325986,MATH 10B,A02,083208,Lim; Seonhee,1,1,35,34
1656007325986,MATH 10B,A03,093472,Staff,1,0,34,33
1656007325986,MATH 10B,B01,083739,Sinha; Shubham,9,0,30,21
1656007332017,MATH 18,A01,083743,Cinel; Cameron Alexander,5,0,30,25
1656007332017,MATH 18,A02,083744,Cinel; Cameron Alexander,11,0,30,19
1656007332017,MATH 18,A03,083745,Cinel; Cameron Alexander,1,0,30,29
1656007332017,MATH 18,B01,083748,Ma; Zilu,1,0,36,35
1656007332017,MATH 18,B02,083749,Ma; Zilu,0,0,36,36
1656007332017,MATH 18,B03,083750,Ma; Zilu,0,0,36,36
1656007332017,MATH 18,B04,083751,Ma; Zilu,0,0,36,36
1656007332017,MATH 18,B05,093473,Staff,0,0,36,36
1656007332017,MATH 18,B06,093474,Staff,3,0,36,33
1656007338040,MATH 20A,A01,083754,Zheng; Zequn,10,0,40,30
1656007344067,MATH 20B,A01,083756,Briones; Jor-el Thomas Caparas,0,1,36,36
1656007344067,MATH 20B,A02,083757,Briones; Jor-el Thomas Caparas,1,0,36,35
1656007344067,MATH 20B,A03,093475,Staff,0,0,36,36
1656007350105,MATH 20C,A01,083760,Briones; Jor-el Thomas Caparas,0,2,35,35
1656007350105,MATH 20C,A02,083761,Briones; Jor-el Thomas Caparas,6,1,35,29
1656007350105,MATH 20C,A03,093476,Staff,0,0,35,35
1656007350105,MATH 20C,B01,083762,Bach; Quang Tran,3,0,30,27
1656007356128,MATH 20D,A01,083765,Tran; Brian Kha,1,0,30,29
1656007356128,MATH 20D,A02,083766,Tran; Brian Kha,0,1,30,30
1656007356128,MATH 20D,A03,083767,Tran; Brian Kha,1,0,30,29
1656007362158,MATH 20E,A01,083771,Ganguly; Soumya,0,1,32,32
1656007362158,MATH 20E,A02,083772,Ganguly; Soumya,1,1,32,31
1656007362158,MATH 20E,B01,083773,Ciotti; Benjamin,14,0,35,21
1656007362158,MATH 20E,B02,083774,Ciotti; Benjamin,12,0,35,23
1656007368201,MATH 103A,A01,083777,Greenfeld; Be'Eri,2,1,36,34
1656007368201,MATH 103A,A02,083778,Greenfeld; Be'Eri,2,0,36,34
1656007368201,MATH 103A,A03,093561,Staff,0,1,36,36
1656007368201,MATH 103A,B01,083779,Greenfeld; Be'Eri,7,1,36,29
1656007368201,MATH 103A,B02,083780,Greenfeld; Be'Eri,0,0,36,36
1656007368201,MATH 103A,B03,093562,Staff,0,0,36,36
1656007374224,MATH 105,A01,085443,Carter; Anne Toulson,4,1,35,31
1656007374224,MATH 105,A02,093477,Staff,8,0,35,27
1656007380255,MATH 109,A01,083213,Ganzberger; Geoffrey Michael,0,1,34,34
1656007380255,MATH 109,A02,083214,Ganzberger; Geoffrey Michael,0,0,34,34
1656007380255,MATH 109,A03,093478,Staff,1,0,34,33
1656007380255,MATH 109,B01,083215,Ganzberger; Geoffrey Michael,2,0,32,30
1656007380255,MATH 109,B02,083216,Ganzberger; Geoffrey Michael,0,0,32,32
1656007380255,MATH 109,B03,093479,Staff,4,0,32,28
1656007386285,MATH 142A,A01,083219,Chow; Bennett,0,0,32,32
1656007386285,MATH 142A,A02,083220,Chow; Bennett,7,0,32,25
1656007386285,MATH 142A,A03,093480,Staff,4,0,32,28
1656007386285,MATH 142A,B03,093481,Staff,3,0,32,29
1656007386285,MATH 142A,B04,093558,Staff,6,0,32,26
1656007386285,MATH 142A,B05,093559,Staff,0,0,32,32
1656007392319,MATH 193A,A01,083224,Rotar; Vladimir,1,1,34,33
1656007392319,MATH 193A,A02,083225,Rotar; Vladimir,0,0,34,34
1656007392319,MATH 193A,A03,083781,Rotar; Vladimir,2,0,34,32
1656007392319,MATH 193A,A04,083782,Rotar; Vladimir,3,0,34,31
1656007392319,MATH 193A,A05,093482,Rotar; Vladimir,0,0,34,34
1656007398342,MATH 197,001,091859,McAuley; Julian John,9999,0,9999,0
1656007398342,MATH 197,002,095566,Kedlaya; Kiran S.,9997,0,9999,2
1656007398342,MATH 197,003,095567,Xiao; Ming,9999,0,9999,0
1656007398342,MATH 197,004,095571,Perols; Johan Lars,9998,0,9999,1
1656007405435,COGS 9,A01,083615,Shannon; Kyle Michael,3,1,75,72
1656007411462,COGS 11,A01,083617,Boyle; Mary E. T.,11,1,48,37
1656007417491,COGS 13,A01,083071,Bastos; Amalia Pinkusfeld,4,2,71,67
1656007423514,COGS 14A,A01,092681,Semenuks; Arturs,4,25,100,96
1656007429546,COGS 14B,A01,083073,Cheng; Tzu-Han,7,0,63,56
1656007435575,COGS 17,A01,092677,Semenuks; Arturs,8,7,81,73
1656007441599,COGS 100,A01,083619,Allen; Michael Gordon,2,2,70,68
1656007447630,COGS 101A,A01,083621,Davis; Joshua Daniel,4,3,68,64
1656007453662,COGS 101B,A01,091572,Allen; Michael Gordon,0,0,65,65
1656007459690,COGS 101C,A01,083625,Delgado; Tania,7,0,35,28
1656007465715,COGS 107A,A01,083627,Boyle; Mary E. T.,1,2,60,59
1656007471740,COGS 118A,A01,083075,Gupta; Anjum,21,16,76,55
1656007477765,CSE 3,A50,083646,Miranda; Gregory Joseph,14,0,50,36
1656007483795,CSE 8A,A50,083650,Miranda; Gregory Joseph,3,11,56,53
1656007489817,CSE 11,A01,083080,Cao; Yingjun,0,65,40,40
1656007495854,CSE 12,A01,083652,Krause-Levy; Sophia Louisa,6,8,120,114
1656007501893,CSE 15L,A01,083654,Morris; Justin Loren,3,1,50,47
1656007501893,CSE 15L,A02,083655,Morris; Justin Loren,1,1,50,49
1656007507920,CSE 20,A01,083657,Tran; Khoa Dang,29,0,80,51
1656007513954,CSE 21,A01,095574,Bach; Quang Tran,23,0,48,25
1656007519977,CSE 30,A01,083084,Eldon; John,2,10,80,78
1656007519977,CSE 30,B01,095061,Bhaskar; Nishant,0,4,50,50
1656007526008,CSE 100,A01,083659,Cao; Yingjun,2,25,70,68
1656007532036,CSE 134B,A01,083661,Powell; Thomas Allan,6,7,100,94
1656007538057,CSE 140,A01,083663,Gungor; Onat,5,0,85,80
1656007544084,CSE 140L,A01,083088,Eldon; John,5,0,100,95
1656007550110,CSE 175,A01,083665,Kumar; Rakesh,1,0,25,24
1656007556140,CSE 190,A00,092507,Dubnov; Shlomo,1,0,20,19
1656007562169,ECE 45,A01,083139,Congero; Spencer William,0,1,75,75
1656007568195,ECE 65,A50,083695,Saad; Andrew S,6,0,30,24
1656007568195,ECE 65,A51,095125,Staff,23,0,26,3
1656007574217,ECE 109,A01,091882,Touri; Behrouz,3,4,70,67
1656007580247,ECE 180,A00,083140,Abi Samra; Nicholas Camill,1,0,30,29
1656007580247,ECE 180,B00,083141,Abi Samra; Nicholas Camill,0,8,28,28
1656007586269,MATH 10A,A01,083735,Patchell; Gregory David,0,0,30,30
1656007586269,MATH 10A,A02,083736,Patchell; Gregory David,21,0,30,9
1656007586269,MATH 10A,A03,083737,Patchell; Gregory David,16,0,30,14
1656007592410,MATH 10B,A01,083207,Lim; Seonhee,1,1,34,33
1656007592410,MATH 10B,A02,083208,Lim; Seonhee,1,1,35,34
1656007592410,MATH 10B,A03,093472,Staff,1,0,34,33
1656007592410,MATH 10B,B01,083739,Sinha; Shubham,9,0,30,21
1656007598454,MATH 18,A01,083743,Cinel; Cameron Alexander,5,0,30,25
1656007598454,MATH 18,A02,083744,Cinel; Cameron Alexander,11,0,30,19
1656007598454,MATH 18,A03,083745,Cinel; Cameron Alexander,1,0,30,29
1656007598454,MATH 18,B01,083748,Ma; Zilu,1,0,36,35
1656007598454,MATH 18,B02,083749,Ma; Zilu,0,0,36,36
1656007598454,MATH 18,B03,083750,Ma; Zilu,0,0,36,36
1656007598454,MATH 18,B04,083751,Ma; Zilu,0,0,36,36
1656007598454,MATH 18,B05,093473,Staff,0,0,36,36
1656007598454,MATH 18,B06,093474,Staff,3,0,36,33
1656007604481,MATH 20A,A01,083754,Zheng; Zequn,10,0,40,30
1656007610519,MATH 20B,A01,083756,Briones; Jor-el Thomas Caparas,0,1,36,36
1656007610519,MATH 20B,A02,083757,Briones; Jor-el Thomas Caparas,1,0,36,35
1656007610519,MATH 20B,A03,093475,Staff,0,0,36,36
1656007616544,MATH 20C,A01,083760,Briones; Jor-el Thomas Caparas,0,2,35,35
1656007616544,MATH 20C,A02,083761,Briones; Jor-el Thomas Caparas,6,1,35,29
1656007616544,MATH 20C,A03,093476,Staff,0,0,35,35
1656007616544,MATH 20C,B01,083762,Bach; Quang Tran,3,0,30,27
1656007622568,MATH 20D,A01,083765,Tran; Brian Kha,1,0,30,29
1656007622568,MATH 20D,A02,083766,Tran; Brian Kha,0,1,30,30
1656007622568,MATH 20D,A03,083767,Tran; Brian Kha,1,0,30,29
1656007628602,MATH 20E,A01,083771,Ganguly; Soumya,0,1,32,32
1656007628602,MATH 20E,A02,083772,Ganguly; Soumya,1,1,32,31
1656007628602,MATH 20E,B01,083773,Ciotti; Benjamin,14,0,35,21
1656007628602,MATH 20E,B02,083774,Ciotti; Benjamin,12,0,35,23
1656007634645,MATH 103A,A01,083777,Greenfeld; Be'Eri,2,1,36,34
1656007634645,MATH 103A,A02,083778,Greenfeld; Be'Eri,2,0,36,34
1656007634645,MATH 103A,A03,093561,Staff,0,1,36,36
1656007634645,MATH 103A,B01,083779,Greenfeld; Be'Eri,7,1,36,29
1656007634645,MATH 103A,B02,083780,Greenfeld; Be'Eri,0,0,36,36
1656007634645,MATH 103A,B03,093562,Staff,0,0,36,36
1656007640671,MATH 105,A01,085443,Carter; Anne Toulson,4,1,35,31
1656007640671,MATH 105,A02,093477,Staff,8,0,35,27
1656007646726,MATH 109,A01,083213,Ganzberger; Geoffrey Michael,0,1,34,34
1656007646726,MATH 109,A02,083214,Ganzberger; Geoffrey Michael,0,0,34,34
1656007646726,MATH 109,A03,093478,Staff,1,0,34,33
1656007646726,MATH 109,B01,083215,Ganzberger; Geoffrey Michael,2,0,32,30
1656007646726,MATH 109,B02,083216,Ganzberger; Geoffrey Michael,0,0,32,32
1656007646726,MATH 109,B03,093479,Staff,4,0,32,28
1656007652755,MATH 142A,A01,083219,Chow; Bennett,0,0,32,32
1656007652755,MATH 142A,A02,083220,Chow; Bennett,7,0,32,25
1656007652755,MATH 142A,A03,093480,Staff,4,0,32,28
1656007652755,MATH 142A,B03,093481,Staff,3,0,32,29
1656007652755,MATH 142A,B04,093558,Staff,6,0,32,26
1656007652755,MATH 142A,B05,093559,Staff,0,0,32,32
1656007658786,MATH 193A,A01,083224,Rotar; Vladimir,1,1,34,33
1656007658786,MATH 193A,A02,083225,Rotar; Vladimir,0,0,34,34
1656007658786,MATH 193A,A03,083781,Rotar; Vladimir,2,0,34,32
1656007658786,MATH 193A,A04,083782,Rotar; Vladimir,3,0,34,31
1656007658786,MATH 193A,A05,093482,Rotar; Vladimir,0,0,34,34
1656007664814,MATH 197,001,091859,McAuley; Julian John,9999,0,9999,0
1656007664814,MATH 197,002,095566,Kedlaya; Kiran S.,9997,0,9999,2
1656007664814,MATH 197,003,095567,Xiao; Ming,9999,0,9999,0
1656007664814,MATH 197,004,095571,Perols; Johan Lars,9998,0,9999,1
1656007671889,COGS 9,A01,083615,Shannon; Kyle Michael,3,1,75,72
1656007677924,COGS 11,A01,083617,Boyle; Mary E. T.,11,1,48,37
1656007683948,COGS 13,A01,083071,Bastos; Amalia Pinkusfeld,4,2,71,67
1656007689971,COGS 14A,A01,092681,Semenuks; Arturs,4,25,100,96
1656007696000,COGS 14B,A01,083073,Cheng; Tzu-Han,7,0,63,56
1656007702038,COGS 17,A01,092677,Semenuks; Arturs,8,7,81,73
1656007708064,COGS 100,A01,083619,Allen; Michael Gordon,2,2,70,68
1656007714095,COGS 101A,A01,083621,Davis; Joshua Daniel,4,3,68,64
1656007720132,COGS 101B,A01,091572,Allen; Michael Gordon,0,0,65,65
1656007726158,COGS 101C,A01,083625,Delgado; Tania,7,0,35,28
1656007732187,COGS 107A,A01,083627,Boyle; Mary E. T.,1,2,60,59
1656007738211,COGS 118A,A01,083075,Gupta; Anjum,21,16,76,55
1656007744238,CSE 3,A50,083646,Miranda; Gregory Joseph,14,0,50,36
1656007750260,CSE 8A,A50,083650,Miranda; Gregory Joseph,3,11,56,53
1656007756284,CSE 11,A01,083080,Cao; Yingjun,0,65,40,40
1656007762308,CSE 12,A01,083652,Krause-Levy; Sophia Louisa,6,8,120,114
1656007768333,CSE 15L,A01,083654,Morris; Justin Loren,3,1,50,47
1656007768333,CSE 15L,A02,083655,Morris; Justin Loren,1,1,50,49
1656007774354,CSE 20,A01,083657,Tran; Khoa Dang,29,0,80,51
1656007780381,CSE 21,A01,095574,Bach; Quang Tran,23,0,48,25
1656007786422,CSE 30,A01,083084,Eldon; John,2,10,80,78
1656007786422,CSE 30,B01,095061,Bhaskar; Nishant,0,4,50,50
1656007792453,CSE 100,A01,083659,Cao; Yingjun,2,25,70,68
1656007798475,CSE 134B,A01,083661,Powell; Thomas Allan,6,7,100,94
1656007804497,CSE 140,A01,083663,Gungor; Onat,5,0,85,80
1656007810555,CSE 140L,A01,083088,Eldon; John,5,0,100,95
1656007816578,CSE 175,A01,083665,Kumar; Rakesh,1,0,25,24
1656007822602,CSE 190,A00,092507,Dubnov; Shlomo,1,0,20,19
1656007828636,ECE 45,A01,083139,Congero; Spencer William,0,1,75,75
1656007834662,ECE 65,A50,083695,Saad; Andrew S,6,0,30,24
1656007834662,ECE 65,A51,095125,Staff,23,0,26,3
1656007840685,ECE 109,A01,091882,Touri; Behrouz,3,4,70,67
1656007846735,ECE 180,A00,083140,Abi Samra; Nicholas Camill,1,0,30,29
1656007846735,ECE 180,B00,083141,Abi Samra; Nicholas Camill,0,8,28,28
1656007852759,MATH 10A,A01,083735,Patchell; Gregory David,0,0,30,30
1656007852759,MATH 10A,A02,083736,Patchell; Gregory David,21,0,30,9
1656007852759,MATH 10A,A03,083737,Patchell; Gregory David,16,0,30,14
1656007858783,MATH 10B,A01,083207,Lim; Seonhee,1,1,34,33
1656007858783,MATH 10B,A02,083208,Lim; Seonhee,1,1,35,34
1656007858783,MATH 10B,A03,093472,Staff,1,0,34,33
1656007858783,MATH 10B,B01,083739,Sinha; Shubham,9,0,30,21
1656007864809,MATH 18,A01,083743,Cinel; Cameron Alexander,5,0,30,25
1656007864809,MATH 18,A02,083744,Cinel; Cameron Alexander,11,0,30,19
1656007864809,MATH 18,A03,083745,Cinel; Cameron Alexander,1,0,30,29
1656007864809,MATH 18,B01,083748,Ma; Zilu,0,0,36,36
1656007864809,MATH 18,B02,083749,Ma; Zilu,0,0,36,36
1656007864809,MATH 18,B03,083750,Ma; Zilu,0,0,36,36
1656007864809,MATH 18,B04,083751,Ma; Zilu,0,0,36,36
1656007864809,MATH 18,B05,093473,Staff,0,0,36,36
1656007864809,MATH 18,B06,093474,Staff,3,0,36,33
1656007870839,MATH 20A,A01,083754,Zheng; Zequn,10,0,40,30
1656007876862,MATH 20B,A01,083756,Briones; Jor-el Thomas Caparas,0,1,36,36
1656007876862,MATH 20B,A02,083757,Briones; Jor-el Thomas Caparas,1,0,36,35
1656007876862,MATH 20B,A03,093475,Staff,0,0,36,36
1656007882887,MATH 20C,A01,083760,Briones; Jor-el Thomas Caparas,0,2,35,35
1656007882887,MATH 20C,A02,083761,Briones; Jor-el Thomas Caparas,6,1,35,29
1656007882887,MATH 20C,A03,093476,Staff,0,0,35,35
1656007882887,MATH 20C,B01,083762,Bach; Quang Tran,3,0,30,27
1656007888914,MATH 20D,A01,083765,Tran; Brian Kha,1,0,30,29
1656007888914,MATH 20D,A02,083766,Tran; Brian Kha,0,1,30,30
1656007888914,MATH 20D,A03,083767,Tran; Brian Kha,1,0,30,29
1656007894959,MATH 20E,A01,083771,Ganguly; Soumya,0,1,32,32
1656007894959,MATH 20E,A02,083772,Ganguly; Soumya,1,1,32,31
1656007894959,MATH 20E,B01,083773,Ciotti; Benjamin,14,0,35,21
1656007894959,MATH 20E,B02,083774,Ciotti; Benjamin,12,0,35,23
1656007900987,MATH 103A,A01,083777,Greenfeld; Be'Eri,2,1,36,34
1656007900987,MATH 103A,A02,083778,Greenfeld; Be'Eri,2,0,36,34
1656007900987,MATH 103A,A03,093561,Staff,0,1,36,36
1656007900987,MATH 103A,B01,083779,Greenfeld; Be'Eri,7,1,36,29
1656007900987,MATH 103A,B02,083780,Greenfeld; Be'Eri,0,0,36,36
1656007900987,MATH 103A,B03,093562,Staff,0,0,36,36
1656007907017,MATH 105,A01,085443,Carter; Anne Toulson,4,1,35,31
1656007907017,MATH 105,A02,093477,Staff,8,0,35,27
1656007913042,MATH 109,A01,083213,Ganzberger; Geoffrey Michael,0,1,34,34
1656007913042,MATH 109,A02,083214,Ganzberger; Geoffrey Michael,0,0,34,34
1656007913042,MATH 109,A03,093478,Staff,1,0,34,33
1656007913042,MATH 109,B01,083215,Ganzberger; Geoffrey Michael,2,0,32,30
1656007913042,MATH 109,B02,083216,Ganzberger; Geoffrey Michael,0,0,32,32
1656007913042,MATH 109,B03,093479,Staff,4,0,32,28
1656007919079,MATH 142A,A01,083219,Chow; Bennett,0,0,32,32
1656007919079,MATH 142A,A02,083220,Chow; Bennett,7,0,32,25
1656007919079,MATH 142A,A03,093480,Staff,4,0,32,28
1656007919079,MATH 142A,B03,093481,Staff,3,0,32,29
1656007919079,MATH 142A,B04,093558,Staff,6,0,32,26
1656007919079,MATH 142A,B05,093559,Staff,0,0,32,32
1656007925105,MATH 193A,A01,083224,Rotar; Vladimir,1,1,34,33
1656007925105,MATH 193A,A02,083225,Rotar; Vladimir,0,0,34,34
1656007925105,MATH 193A,A03,083781,Rotar; Vladimir,2,0,34,32
1656007925105,MATH 193A,A04,083782,Rotar; Vladimir,3,0,34,31
1656007925105,MATH 193A,A05,093482,Rotar; Vladimir,0,0,34,34
1656007931150,MATH 197,001,091859,McAuley; Julian John,9999,0,9999,0
1656007931150,MATH 197,002,095566,Kedlaya; Kiran S.,9997,0,9999,2
1656007931150,MATH 197,003,095567,Xiao; Ming,9999,0,9999,0
1656007931150,MATH 197,004,095571,Perols; Johan Lars,9998,0,9999,1
1656007938226,COGS 9,A01,083615,Shannon; Kyle Michael,3,1,75,72
1656007944267,COGS 11,A01,083617,Boyle; Mary E. T.,11,1,48,37
1656007950292,COGS 13,A01,083071,Bastos; Amalia Pinkusfeld,4,2,71,67
1656007956316,COGS 14A,A01,092681,Semenuks; Arturs,4,25,100,96
1656007962350,COGS 14B,A01,083073,Cheng; Tzu-Han,7,0,63,56
1656007968376,COGS 17,A01,092677,Semenuks; Arturs,8,7,81,73
1656007974432,COGS 100,A01,083619,Allen; Michael Gordon,2,2,70,68
1656007980463,COGS 101A,A01,083621,Davis; Joshua Daniel,4,3,68,64
1656007986487,COGS 101B,A01,091572,Allen; Michael Gordon,0,0,65,65
1656007992510,COGS 101C,A01,083625,Delgado; Tania,7,0,35,28
1656007998534,COGS 107A,A01,083627,Boyle; Mary E. T.,1,2,60,59
1656008004559,COGS 118A,A01,083075,Gupta; Anjum,21,16,76,55
1656008010586,CSE 3,A50,083646,Miranda; Gregory Joseph,14,0,50,36
1656008016610,CSE 8A,A50,083650,Miranda; Gregory Joseph,3,11,56,53
1656008022633,CSE 11,A01,083080,Cao; Yingjun,0,65,40,40
1656008028674,CSE 12,A01,083652,Krause-Levy; Sophia Louisa,6,8,120,114
1656008034696,CSE 15L,A01,083654,Morris; Justin Loren,3,1,50,47
1656008034696,CSE 15L,A02,083655,Morris; Justin Loren,1,1,50,49
1656008040719,CSE 20,A01,083657,Tran; Khoa Dang,29,0,80,51
1656008046742,CSE 21,A01,095574,Bach; Quang Tran,23,0,48,25
1656008052769,CSE 30,A01,083084,Eldon; John,2,10,80,78
1656008052769,CSE 30,B01,095061,Bhaskar; Nishant,0,4,50,50
1656008058803,CSE 100,A01,083659,Cao; Yingjun,2,25,70,68
1656008064851,CSE 134B,A01,083661,Powell; Thomas Allan,6,7,100,94
1656008070876,CSE 140,A01,083663,Gungor; Onat,5,0,85,80
1656008076903,CSE 140L,A01,083088,Eldon; John,5,0,100,95
1656008082941,CSE 175,A01,083665,Kumar; Rakesh,1,0,25,24
1656008088964,CSE 190,A00,092507,Dubnov; Shlomo,1,0,20,19
1656008094996,ECE 45,A01,083139,Congero; Spencer William,0,1,75,75
1656008101020,ECE 65,A50,083695,Saad; Andrew S,6,0,30,24
1656008101020,ECE 65,A51,095125,Staff,23,0,26,3
1656008107042,ECE 109,A01,091882,Touri; Behrouz,3,4,70,67
1656008113069,ECE 180,A00,083140,Abi Samra; Nicholas Camill,1,0,30,29
1656008113069,ECE 180,B00,083141,Abi Samra; Nicholas Camill,0,8,28,28
1656008119099,MATH 10A,A01,083735,Patchell; Gregory David,0,0,30,30
1656008119099,MATH 10A,A02,083736,Patchell; Gregory David,21,0,30,9
1656008119099,MATH 10A,A03,083737,Patchell; Gregory David,16,0,30,14
1656008125124,MATH 10B,A01,083207,Lim; Seonhee,1,1,34,33
1656008125124,MATH 10B,A02,083208,Lim; Seonhee,1,1,35,34
1656008125124,MATH 10B,A03,093472,Staff,1,0,34,33
1656008125124,MATH 10B,B01,083739,Sinha; Shubham,9,0,30,21
1656008131174,MATH 18,A01,083743,Cinel; Cameron Alexander,5,0,30,25
1656008131174,MATH 18,A02,083744,Cinel; Cameron Alexander,11,0,30,19
1656008131174,MATH 18,A03,083745,Cinel; Cameron Alexander,1,0,30,29
1656008131174,MATH 18,B01,083748,Ma; Zilu,0,0,36,36
1656008131174,MATH 18,B02,083749,Ma; Zilu,0,0,36,36
1656008131174,MATH 18,B03,083750,Ma; Zilu,0,0,36,36
1656008131174,MATH 18,B04,083751,Ma; Zilu,0,0,36,36
1656008131174,MATH 18,B05,093473,Staff,0,0,36,36
1656008131174,MATH 18,B06,093474,Staff,3,0,36,33
1656008137208,MATH 20A,A01,083754,Zheng; Zequn,10,0,40,30
1656008143236,MATH 20B,A01,083756,Briones; Jor-el Thomas Caparas,0,1,36,36
1656008143236,MATH 20B,A02,083757,Briones; Jor-el Thomas Caparas,1,0,36,35
1656008143236,MATH 20B,A03,093475,Staff,0,0,36,36
1656008149260,MATH 20C,A01,083760,Briones; Jor-el Thomas Caparas,0,2,35,35
1656008149260,MATH 20C,A02,083761,Briones; Jor-el Thomas Caparas,6,1,35,29
1656008149260,MATH 20C,A03,093476,Staff,0,0,35,35
1656008149260,MATH 20C,B01,083762,Bach; Quang Tran,3,0,30,27
1656008155295,MATH 20D,A01,083765,Tran; Brian Kha,1,0,30,29
1656008155295,MATH 20D,A02,083766,Tran; Brian Kha,0,1,30,30
1656008155295,MATH 20D,A03,083767,Tran; Brian Kha,1,0,30,29
1656008161342,MATH 20E,A01,083771,Ganguly; Soumya,0,1,32,32
1656008161342,MATH 20E,A02,083772,Ganguly; Soumya,1,1,32,31
1656008161342,MATH 20E,B01,083773,Ciotti; Benjamin,14,0,35,21
1656008161342,MATH 20E,B02,083774,Ciotti; Benjamin,12,0,35,23
1656008167364,MATH 103A,A01,083777,Greenfeld; Be'Eri,2,1,36,34
1656008167364,MATH 103A,A02,083778,Greenfeld; Be'Eri,2,0,36,34
1656008167364,MATH 103A,A03,093561,Staff,0,1,36,36
1656008167364,MATH 103A,B01,083779,Greenfeld; Be'Eri,7,1,36,29
1656008167364,MATH 103A,B02,083780,Greenfeld; Be'Eri,0,0,36,36
1656008167364,MATH 103A,B03,093562,Staff,0,0,36,36
1656008173389,MATH 105,A01,085443,Carter; Anne Toulson,4,1,35,31
1656008173389,MATH 105,A02,093477,Staff,8,0,35,27
1656008179423,MATH 109,A01,083213,Ganzberger; Geoffrey Michael,0,1,34,34
1656008179423,MATH 109,A02,083214,Ganzberger; Geoffrey Michael,0,0,34,34
1656008179423,MATH 109,A03,093478,Staff,1,0,34,33
1656008179423,MATH 109,B01,083215,Ganzberger; Geoffrey Michael,2,0,32,30
1656008179423,MATH 109,B02,083216,Ganzberger; Geoffrey Michael,0,0,32,32
1656008179423,MATH 109,B03,093479,Staff,4,0,32,28
1656008185451,MATH 142A,A01,083219,Chow; Bennett,0,0,32,32
1656008185451,MATH 142A,A02,083220,Chow; Bennett,7,0,32,25
1656008185451,MATH 142A,A03,093480,Staff,4,0,32,28
1656008185451,MATH 142A,B03,093481,Staff,3,0,32,29
1656008185451,MATH 142A,B04,093558,Staff,6,0,32,26
1656008185451,MATH 142A,B05,093559,Staff,0,0,32,32
1656008191553,MATH 193A,A01,083224,Rotar; Vladimir,1,1,34,33
1656008191553,MATH 193A,A02,083225,Rotar; Vladimir,0,0,34,34
1656008191553,MATH 193A,A03,083781,Rotar; Vladimir,2,0,34,32
1656008191553,MATH 193A,A04,083782,Rotar; Vladimir,3,0,34,31
1656008191553,MATH 193A,A05,093482,Rotar; Vladimir,0,0,34,34
1656008197577,MATH 197,001,091859,McAuley; Julian John,9999,0,9999,0
1656008197577,MATH 197,002,095566,Kedlaya; Kiran S.,9997,0,9999,2
1656008197577,MATH 197,003,095567,Xiao; Ming,9999,0,9999,0
1656008197577,MATH 197,004,095571,Perols; Johan Lars,9998,0,9999,1
1656008204659,COGS 9,A01,083615,Shannon; Kyle Michael,3,1,75,72
1656008210682,COGS 11,A01,083617,Boyle; Mary E. T.,11,1,48,37
1656008216706,COGS 13,A01,083071,Bastos; Amalia Pinkusfeld,4,2,71,67
1656008222729,COGS 14A,A01,092681,Semenuks; Arturs,4,25,100,96
1656008228769,COGS 14B,A01,083073,Cheng; Tzu-Han,7,0,63,56
1656008234795,COGS 17,A01,092677,Semenuks; Arturs,8,7,81,73
1656008240818,COGS 100,A01,083619,Allen; Michael Gordon,2,2,70,68
1656008246841,COGS 101A,A01,083621,Davis; Joshua Daniel,4,3,68,64
1656008252870,COGS 101B,A01,091572,Allen; Michael Gordon,0,0,65,65
1656008258897,COGS 101C,A01,083625,Delgado; Tania,7,0,35,28
1656008264942,COGS 107A,A01,083627,Boyle; Mary E. T.,1,2,60,59
1656008270968,COGS 118A,A01,083075,Gupta; Anjum,21,16,76,55
1656008277003,CSE 3,A50,083646,Miranda; Gregory Joseph,14,0,50,36
1656008283041,CSE 8A,A50,083650,Miranda; Gregory Joseph,3,11,56,53
1656008289066,CSE 11,A01,083080,Cao; Yingjun,0,65,40,40
1656008295101,CSE 12,A01,083652,Krause-Levy; Sophia Louisa,6,8,120,114
1656008301127,CSE 15L,A01,083654,Morris; Justin Loren,3,1,50,47
1656008301127,CSE 15L,A02,083655,Morris; Justin Loren,1,1,50,49
1656008307152,CSE 20,A01,083657,Tran; Khoa Dang,29,0,80,51
1656008313175,CSE 21,A01,095574,Bach; Quang Tran,23,0,48,25
1656008319202,CSE 30,A01,083084,Eldon; John,2,10,80,78
1656008319202,CSE 30,B01,095061,Bhaskar; Nishant,0,4,50,50
1656008325238,CSE 100,A01,083659,Cao; Yingjun,2,25,70,68
1656008331272,CSE 134B,A01,083661,Powell; Thomas Allan,6,7,100,94
1656008337302,CSE 140,A01,083663,Gungor; Onat,5,0,85,80
1656008343346,CSE 140L,A01,083088,Eldon; John,5,0,100,95
1656008349370,CSE 175,A01,083665,Kumar; Rakesh,1,0,25,24
1656008355400,CSE 190,A00,092507,Dubnov; Shlomo,1,0,20,19
1656008361427,ECE 45,A01,083139,Congero; Spencer William,0,1,75,75
1656008367474,ECE 65,A50,083695,Saad; Andrew S,6,0,30,24
1656008367474,ECE 65,A51,095125,Staff,23,0,26,3
1656008373498,ECE 109,A01,091882,Touri; Behrouz,3,4,70,67
1656008379531,ECE 180,A00,083140,Abi Samra; Nicholas Camill,1,0,30,29
1656008379531,ECE 180,B00,083141,Abi Samra; Nicholas Camill,0,8,28,28
1656008385561,MATH 10A,A01,083735,Patchell; Gregory David,0,0,30,30
1656008385561,MATH 10A,A02,083736,Patchell; Gregory David,21,0,30,9
1656008385561,MATH 10A,A03,083737,Patchell; Gregory David,16,0,30,14
1656008391584,MATH 10B,A01,083207,Lim; Seonhee,1,1,34,33
1656008391584,MATH 10B,A02,083208,Lim; Seonhee,1,1,35,34
1656008391584,MATH 10B,A03,093472,Staff,1,0,34,33
1656008391584,MATH 10B,B01,083739,Sinha; Shubham,9,0,30,21
1656008397610,MATH 18,A01,083743,Cinel; Cameron Alexander,5,0,30,25
1656008397610,MATH 18,A02,083744,Cinel; Cameron Alexander,11,0,30,19
1656008397610,MATH 18,A03,083745,Cinel; Cameron Alexander,1,0,30,29
1656008397610,MATH 18,B01,083748,Ma; Zilu,0,0,36,36
1656008397610,MATH 18,B02,083749,Ma; Zilu,0,0,36,36
1656008397610,MATH 18,B03,083750,Ma; Zilu,0,0,36,36
1656008397610,MATH 18,B04,083751,Ma; Zilu,0,0,36,36
1656008397610,MATH 18,B05,093473,Staff,0,0,36,36
1656008397610,MATH 18,B06,093474,Staff,3,0,36,33
1656008403643,MATH 20A,A01,083754,Zheng; Zequn,10,0,40,30
1656008409667,MATH 20B,A01,083756,Briones; Jor-el Thomas Caparas,0,1,36,36
1656008409667,MATH 20B,A02,083757,Briones; Jor-el Thomas Caparas,1,0,36,35
1656008409667,MATH 20B,A03,093475,Staff,0,0,36,36
1656008415719,MATH 20C,A01,083760,Briones; Jor-el Thomas Caparas,0,2,35,35
1656008415719,MATH 20C,A02,083761,Briones; Jor-el Thomas Caparas,6,1,35,29
1656008415719,MATH 20C,A03,093476,Staff,0,0,35,35
1656008415719,MATH 20C,B01,083762,Bach; Quang Tran,3,0,30,27
1656008421745,MATH 20D,A01,083765,Tran; Brian Kha,1,0,30,29
1656008421745,MATH 20D,A02,083766,Tran; Brian Kha,0,1,30,30
1656008421745,MATH 20D,A03,083767,Tran; Brian Kha,1,0,30,29
1656008427777,MATH 20E,A01,083771,Ganguly; Soumya,0,1,32,32
1656008427777,MATH 20E,A02,083772,Ganguly; Soumya,1,1,32,31
1656008427777,MATH 20E,B01,083773,Ciotti; Benjamin,14,0,35,21
1656008427777,MATH 20E,B02,083774,Ciotti; Benjamin,12,0,35,23
1656008433809,MATH 103A,A01,083777,Greenfeld; Be'Eri,2,1,36,34
1656008433809,MATH 103A,A02,083778,Greenfeld; Be'Eri,2,0,36,34
1656008433809,MATH 103A,A03,093561,Staff,0,1,36,36
1656008433809,MATH 103A,B01,083779,Greenfeld; Be'Eri,7,1,36,29
1656008433809,MATH 103A,B02,083780,Greenfeld; Be'Eri,0,0,36,36
1656008433809,MATH 103A,B03,093562,Staff,0,0,36,36
1656008439841,MATH 105,A01,085443,Carter; Anne Toulson,4,1,35,31
1656008439841,MATH 105,A02,093477,Staff,8,0,35,27
1656008445870,MATH 109,A01,083213,Ganzberger; Geoffrey Michael,0,1,34,34
1656008445870,MATH 109,A02,083214,Ganzberger; Geoffrey Michael,0,0,34,34
1656008445870,MATH 109,A03,093478,Staff,1,0,34,33
1656008445870,MATH 109,B01,083215,Ganzberger; Geoffrey Michael,2,0,32,30
1656008445870,MATH 109,B02,083216,Ganzberger; Geoffrey Michael,0,0,32,32
1656008445870,MATH 109,B03,093479,Staff,4,0,32,28
1656008451892,MATH 142A,A01,083219,Chow; Bennett,0,0,32,32
1656008451892,MATH 142A,A02,083220,Chow; Bennett,7,0,32,25
1656008451892,MATH 142A,A03,093480,Staff,4,0,32,28
1656008451892,MATH 142A,B03,093481,Staff,3,0,32,29
1656008451892,MATH 142A,B04,093558,Staff,6,0,32,26
1656008451892,MATH 142A,B05,093559,Staff,0,0,32,32
1656008457914,MATH 193A,A01,083224,Rotar; Vladimir,1,1,34,33
1656008457914,MATH 193A,A02,083225,Rotar; Vladimir,0,0,34,34
1656008457914,MATH 193A,A03,083781,Rotar; Vladimir,2,0,34,32
1656008457914,MATH 193A,A04,083782,Rotar; Vladimir,3,0,34,31
1656008457914,MATH 193A,A05,093482,Rotar; Vladimir,0,0,34,34
1656008463943,MATH 197,001,091859,McAuley; Julian John,9999,0,9999,0
1656008463943,MATH 197,002,095566,Kedlaya; Kiran S.,9997,0,9999,2
1656008463943,MATH 197,003,095567,Xiao; Ming,9999,0,9999,0
1656008463943,MATH 197,004,095571,Perols; Johan Lars,9998,0,9999,1
1656008471008,COGS 9,A01,083615,Shannon; Kyle Michael,3,1,75,72
1656008477034,COGS 11,A01,083617,Boyle; Mary E. T.,11,1,48,37
1656008483061,COGS 13,A01,083071,Bastos; Amalia Pinkusfeld,4,2,71,67
1656008489091,COGS 14A,A01,092681,Semenuks; Arturs,4,25,100,96
1656008495120,COGS 14B,A01,083073,Cheng; Tzu-Han,7,0,63,56
1656008501156,COGS 17,A01,092677,Semenuks; Arturs,8,7,81,73
1656008507185,COGS 100,A01,083619,Allen; Michael Gordon,2,2,70,68
1656008513219,COGS 101A,A01,083621,Davis; Joshua Daniel,4,3,68,64
1656008519242,COGS 101B,A01,091572,Allen; Michael Gordon,0,0,65,65
1656008525269,COGS 101C,A01,083625,Delgado; Tania,7,0,35,28
1656008531294,COGS 107A,A01,083627,Boyle; Mary E. T.,1,2,60,59
1656008537343,COGS 118A,A01,083075,Gupta; Anjum,21,16,76,55
1656008543379,CSE 3,A50,083646,Miranda; Gregory Joseph,14,0,50,36
1656008549420,CSE 8A,A50,083650,Miranda; Gregory Joseph,3,11,56,53
1656008555456,CSE 11,A01,083080,Cao; Yingjun,0,65,40,40
1656008561478,CSE 12,A01,083652,Krause-Levy; Sophia Louisa,6,8,120,114
1656008567503,CSE 15L,A01,083654,Morris; Justin Loren,3,1,50,47
1656008567503,CSE 15L,A02,083655,Morris; Justin Loren,1,1,50,49
1656008573526,CSE 20,A01,083657,Tran; Khoa Dang,29,0,80,51
1656008579549,CSE 21,A01,095574,Bach; Quang Tran,23,0,48,25
1656008585576,CSE 30,A01,083084,Eldon; John,2,10,80,78
1656008585576,CSE 30,B01,095061,Bhaskar; Nishant,0,4,50,50
1656008591614,CSE 100,A01,083659,Cao; Yingjun,2,25,70,68
1656008597634,CSE 134B,A01,083661,Powell; Thomas Allan,6,7,100,94
1656008603657,CSE 140,A01,083663,Gungor; Onat,5,0,85,80
1656008609681,CSE 140L,A01,083088,Eldon; John,5,0,100,95
1656008615725,CSE 175,A01,083665,Kumar; Rakesh,1,0,25,24
1656008621770,CSE 190,A00,092507,Dubnov; Shlomo,1,0,20,19
1656008627798,ECE 45,A01,083139,Congero; Spencer William,0,1,75,75
1656008633837,ECE 65,A50,083695,Saad; Andrew S,6,0,30,24
1656008633837,ECE 65,A51,095125,Staff,23,0,26,3
1656008639870,ECE 109,A01,091882,Touri; Behrouz,3,4,70,67
1656008645895,ECE 180,A00,083140,Abi Samra; Nicholas Camill,1,0,30,29
1656008645895,ECE 180,B00,083141,Abi Samra; Nicholas Camill,0,8,28,28
1656008652045,MATH 10A,A01,083735,Patchell; Gregory David,0,0,30,30
1656008652045,MATH 10A,A02,083736,Patchell; Gregory David,21,0,30,9
1656008652045,MATH 10A,A03,083737,Patchell; Gregory David,16,0,30,14
1656008658079,MATH 10B,A01,083207,Lim; Seonhee,1,1,34,33
1656008658079,MATH 10B,A02,083208,Lim; Seonhee,1,1,35,34
1656008658079,MATH 10B,A03,093472,Staff,1,0,34,33
1656008658079,MATH 10B,B01,083739,Sinha; Shubham,9,0,30,21
1656008664104,MATH 18,A01,083743,Cinel; Cameron Alexander,5,0,30,25
1656008664104,MATH 18,A02,083744,Cinel; Cameron Alexander,11,0,30,19
1656008664104,MATH 18,A03,083745,Cinel; Cameron Alexander,1,0,30,29
1656008664104,MATH 18,B01,083748,Ma; Zilu,0,0,36,36
1656008664104,MATH 18,B02,083749,Ma; Zilu,0,0,36,36
1656008664104,MATH 18,B03,083750,Ma; Zilu,0,0,36,36
1656008664104,MATH 18,B04,083751,Ma; Zilu,0,0,36,36
1656008664104,MATH 18,B05,093473,Staff,0,0,36,36
1656008664104,MATH 18,B06,093474,Staff,3,0,36,33
1656008670128,MATH 20A,A01,083754,Zheng; Zequn,10,0,40,30
1656008676163,MATH 20B,A01,083756,Briones; Jor-el Thomas Caparas,0,1,36,36
1656008676163,MATH 20B,A02,083757,Briones; Jor-el Thomas Caparas,1,0,36,35
1656008676163,MATH 20B,A03,093475,Staff,0,0,36,36
1656008682193,MATH 20C,A01,083760,Briones; Jor-el Thomas Caparas,0,2,35,35
1656008682193,MATH 20C,A02,083761,Briones; Jor-el Thomas Caparas,6,1,35,29
1656008682193,MATH 20C,A03,093476,Staff,0,0,35,35
1656008682193,MATH 20C,B01,083762,Bach; Quang Tran,3,0,30,27
1656008688223,MATH 20D,A01,083765,Tran; Brian Kha,1,0,30,29
1656008688223,MATH 20D,A02,083766,Tran; Brian Kha,0,1,30,30
1656008688223,MATH 20D,A03,083767,Tran; Brian Kha,1,0,30,29
1656008694251,MATH 20E,A01,083771,Ganguly; Soumya,0,1,32,32
1656008694251,MATH 20E,A02,083772,Ganguly; Soumya,1,1,32,31
1656008694251,MATH 20E,B01,083773,Ciotti; Benjamin,14,0,35,21
1656008694251,MATH 20E,B02,083774,Ciotti; Benjamin,12,0,35,23
1656008700292,MATH 103A,A01,083777,Greenfeld; Be'Eri,2,1,36,34
1656008700292,MATH 103A,A02,083778,Greenfeld; Be'Eri,2,0,36,34
1656008700292,MATH 103A,A03,093561,Staff,0,1,36,36
1656008700292,MATH 103A,B01,083779,Greenfeld; Be'Eri,7,1,36,29
1656008700292,MATH 103A,B02,083780,Greenfeld; Be'Eri,0,0,36,36
1656008700292,MATH 103A,B03,093562,Staff,0,0,36,36
1656008706316,MATH 105,A01,085443,Carter; Anne Toulson,4,1,35,31
1656008706316,MATH 105,A02,093477,Staff,8,0,35,27
1656008712349,MATH 109,A01,083213,Ganzberger; Geoffrey Michael,0,1,34,34
1656008712349,MATH 109,A02,083214,Ganzberger; Geoffrey Michael,0,0,34,34
1656008712349,MATH 109,A03,093478,Staff,1,0,34,33
1656008712349,MATH 109,B01,083215,Ganzberger; Geoffrey Michael,2,0,32,30
1656008712349,MATH 109,B02,083216,Ganzberger; Geoffrey Michael,0,0,32,32
1656008712349,MATH 109,B03,093479,Staff,4,0,32,28
1656008718387,MATH 142A,A01,083219,Chow; Bennett,0,0,32,32
1656008718387,MATH 142A,A02,083220,Chow; Bennett,7,0,32,25
1656008718387,MATH 142A,A03,093480,Staff,4,0,32,28
1656008718387,MATH 142A,B03,093481,Staff,3,0,32,29
1656008718387,MATH 142A,B04,093558,Staff,6,0,32,26
1656008718387,MATH 142A,B05,093559,Staff,0,0,32,32
1656008724411,MATH 193A,A01,083224,Rotar; Vladimir,1,1,34,33
1656008724411,MATH 193A,A02,083225,Rotar; Vladimir,0,0,34,34
1656008724411,MATH 193A,A03,083781,Rotar; Vladimir,2,0,34,32
1656008724411,MATH 193A,A04,083782,Rotar; Vladimir,3,0,34,31
1656008724411,MATH 193A,A05,093482,Rotar; Vladimir,0,0,34,34
1656008730460,MATH 197,001,091859,McAuley; Julian John,9999,0,9999,0
1656008730460,MATH 197,002,095566,Kedlaya; Kiran S.,9997,0,9999,2
1656008730460,MATH 197,003,095567,Xiao; Ming,9999,0,9999,0
1656008730460,MATH 197,004,095571,Perols; Johan Lars,9998,0,9999,1
1656008737524,COGS 9,A01,083615,Shannon; Kyle Michael,3,1,75,72
1656008743558,COGS 11,A01,083617,Boyle; Mary E. T.,11,1,48,37
1656008749581,COGS 13,A01,083071,Bastos; Amalia Pinkusfeld,4,2,71,67
1656008755617,COGS 14A,A01,092681,Semenuks; Arturs,4,25,100,96
1656008761639,COGS 14B,A01,083073,Cheng; Tzu-Han,7,0,63,56
1656008767668,COGS 17,A01,092677,Semenuks; Arturs,8,7,81,73
1656008773691,COGS 100,A01,083619,Allen; Michael Gordon,2,2,70,68
1656008779718,COGS 101A,A01,083621,Davis; Joshua Daniel,4,3,68,64
1656008785814,COGS 101B,A01,091572,Allen; Michael Gordon,0,0,65,65
1656008791845,COGS 101C,A01,083625,Delgado; Tania,7,0,35,28
1656008797869,COGS 107A,A01,083627,Boyle; Mary E. T.,1,2,60,59
1656008803895,COGS 118A,A01,083075,Gupta; Anjum,21,16,76,55
1656008809918,CSE 3,A50,083646,Miranda; Gregory Joseph,14,0,50,36
1656008815947,CSE 8A,A50,083650,Miranda; Gregory Joseph,3,11,56,53
1656008821982,CSE 11,A01,083080,Cao; Yingjun,0,65,40,40
1656008828012,CSE 12,A01,083652,Krause-Levy; Sophia Louisa,6,8,120,114
1656008834038,CSE 15L,A01,083654,Morris; Justin Loren,3,1,50,47
1656008834038,CSE 15L,A02,083655,Morris; Justin Loren,1,1,50,49
1656008840065,CSE 20,A01,083657,Tran; Khoa Dang,29,0,80,51
1656008846101,CSE 21,A01,095574,Bach; Quang Tran,23,0,48,25
1656008852130,CSE 30,A01,083084,Eldon; John,2,10,80,78
1656008852130,CSE 30,B01,095061,Bhaskar; Nishant,0,4,50,50
1656008858160,CSE 100,A01,083659,Cao; Yingjun,2,25,70,68
1656008864207,CSE 134B,A01,083661,Powell; Thomas Allan,6,7,100,94
1656008870235,CSE 140,A01,083663,Gungor; Onat,5,0,85,80
1656008876263,CSE 140L,A01,083088,Eldon; John,5,0,100,95
1656008882293,CSE 175,A01,083665,Kumar; Rakesh,1,0,25,24
1656008888318,CSE 190,A00,092507,Dubnov; Shlomo,1,0,20,19
1656008894346,ECE 45,A01,083139,Congero; Spencer William,0,1,75,75
1656008900371,ECE 65,A50,083695,Saad; Andrew S,6,0,30,24
1656008900371,ECE 65,A51,095125,Staff,23,0,26,3
1656008906404,ECE 109,A01,091882,Touri; Behrouz,3,5,70,67
1656008912428,ECE 180,A00,083140,Abi Samra; Nicholas Camill,1,0,30,29
1656008912428,ECE 180,B00,083141,Abi Samra; Nicholas Camill,0,8,28,28
1656008918464,MATH 10A,A01,083735,Patchell; Gregory David,0,0,30,30
1656008918464,MATH 10A,A02,083736,Patchell; Gregory David,21,0,30,9
1656008918464,MATH 10A,A03,083737,Patchell; Gregory David,16,0,30,14
1656008924494,MATH 10B,A01,083207,Lim; Seonhee,1,1,34,33
1656008924494,MATH 10B,A02,083208,Lim; Seonhee,1,1,35,34
1656008924494,MATH 10B,A03,093472,Staff,1,0,34,33
1656008924494,MATH 10B,B01,083739,Sinha; Shubham,9,0,30,21
1656008930518,MATH 18,A01,083743,Cinel; Cameron Alexander,5,0,30,25
1656008930518,MATH 18,A02,083744,Cinel; Cameron Alexander,11,0,30,19
1656008930518,MATH 18,A03,083745,Cinel; Cameron Alexander,1,0,30,29
1656008930518,MATH 18,B01,083748,Ma; Zilu,0,0,36,36
1656008930518,MATH 18,B02,083749,Ma; Zilu,0,0,36,36
1656008930518,MATH 18,B03,083750,Ma; Zilu,0,0,36,36
1656008930518,MATH 18,B04,083751,Ma; Zilu,0,0,36,36
1656008930518,MATH 18,B05,093473,Staff,0,0,36,36
1656008930518,MATH 18,B06,093474,Staff,3,0,36,33
1656008936544,MATH 20A,A01,083754,Zheng; Zequn,10,0,40,30
1656008942574,MATH 20B,A01,083756,Briones; Jor-el Thomas Caparas,0,1,36,36
1656008942574,MATH 20B,A02,083757,Briones; Jor-el Thomas Caparas,1,0,36,35
1656008942574,MATH 20B,A03,093475,Staff,0,0,36,36
1656008948612,MATH 20C,A01,083760,Briones; Jor-el Thomas Caparas,0,2,35,35
1656008948612,MATH 20C,A02,083761,Briones; Jor-el Thomas Caparas,6,1,35,29
1656008948612,MATH 20C,A03,093476,Staff,0,0,35,35
1656008948612,MATH 20C,B01,083762,Bach; Quang Tran,3,0,30,27
1656008954636,MATH 20D,A01,083765,Tran; Brian Kha,1,0,30,29
1656008954636,MATH 20D,A02,083766,Tran; Brian Kha,0,1,30,30
1656008954636,MATH 20D,A03,083767,Tran; Brian Kha,1,0,30,29
1656008960659,MATH 20E,A01,083771,Ganguly; Soumya,0,1,32,32
1656008960659,MATH 20E,A02,083772,Ganguly; Soumya,1,1,32,31
1656008960659,MATH 20E,B01,083773,Ciotti; Benjamin,14,0,35,21
1656008960659,MATH 20E,B02,083774,Ciotti; Benjamin,12,0,35,23
1656008966682,MATH 103A,A01,083777,Greenfeld; Be'Eri,2,1,36,34
1656008966682,MATH 103A,A02,083778,Greenfeld; Be'Eri,2,0,36,34
1656008966682,MATH 103A,A03,093561,Staff,0,1,36,36
1656008966682,MATH 103A,B01,083779,Greenfeld; Be'Eri,7,1,36,29
1656008966682,MATH 103A,B02,083780,Greenfeld; Be'Eri,0,0,36,36
1656008966682,MATH 103A,B03,093562,Staff,0,0,36,36
1656008972705,MATH 105,A01,085443,Carter; Anne Toulson,4,1,35,31
1656008972705,MATH 105,A02,093477,Staff,8,0,35,27
1656008978730,MATH 109,A01,083213,Ganzberger; Geoffrey Michael,0,1,34,34
1656008978730,MATH 109,A02,083214,Ganzberger; Geoffrey Michael,0,0,34,34
1656008978730,MATH 109,A03,093478,Staff,1,0,34,33
1656008978730,MATH 109,B01,083215,Ganzberger; Geoffrey Michael,2,0,32,30
1656008978730,MATH 109,B02,083216,Ganzberger; Geoffrey Michael,0,0,32,32
1656008978730,MATH 109,B03,093479,Staff,4,0,32,28
1656008984753,MATH 142A,A01,083219,Chow; Bennett,0,0,32,32
1656008984753,MATH 142A,A02,083220,Chow; Bennett,7,0,32,25
1656008984753,MATH 142A,A03,093480,Staff,4,0,32,28
1656008984753,MATH 142A,B03,093481,Staff,3,0,32,29
1656008984753,MATH 142A,B04,093558,Staff,6,0,32,26
1656008984753,MATH 142A,B05,093559,Staff,0,0,32,32
1656008990785,MATH 193A,A01,083224,Rotar; Vladimir,1,1,34,33
1656008990785,MATH 193A,A02,083225,Rotar; Vladimir,0,0,34,34
1656008990785,MATH 193A,A03,083781,Rotar; Vladimir,2,0,34,32
1656008990785,MATH 193A,A04,083782,Rotar; Vladimir,3,0,34,31
1656008990785,MATH 193A,A05,093482,Rotar; Vladimir,0,0,34,34
1656008996808,MATH 197,001,091859,McAuley; Julian John,9999,0,9999,0
1656008996808,MATH 197,002,095566,Kedlaya; Kiran S.,9997,0,9999,2
1656008996808,MATH 197,003,095567,Xiao; Ming,9999,0,9999,0
1656008996808,MATH 197,004,095571,Perols; Johan Lars,9998,0,9999,1
1656009003869,COGS 9,A01,083615,Shannon; Kyle Michael,3,1,75,72
1656009009903,COGS 11,A01,083617,Boyle; Mary E. T.,11,1,48,37
1656009015936,COGS 13,A01,083071,Bastos; Amalia Pinkusfeld,4,2,71,67
1656009021964,COGS 14A,A01,092681,Semenuks; Arturs,4,25,100,96
1656009027993,COGS 14B,A01,083073,Cheng; Tzu-Han,7,0,63,56
1656009034022,COGS 17,A01,092677,Semenuks; Arturs,8,7,81,73
1656009040051,COGS 100,A01,083619,Allen; Michael Gordon,2,2,70,68
1656009046082,COGS 101A,A01,083621,Davis; Joshua Daniel,4,3,68,64
1656009052107,COGS 101B,A01,091572,Allen; Michael Gordon,0,0,65,65
1656009058133,COGS 101C,A01,083625,Delgado; Tania,7,0,35,28
1656009064173,COGS 107A,A01,083627,Boyle; Mary E. T.,1,2,60,59
1656009070205,COGS 118A,A01,083075,Gupta; Anjum,21,16,76,55
1656009076248,CSE 3,A50,083646,Miranda; Gregory Joseph,14,0,50,36
1656009082273,CSE 8A,A50,083650,Miranda; Gregory Joseph,3,11,56,53
1656009088294,CSE 11,A01,083080,Cao; Yingjun,0,65,40,40
1656009094321,CSE 12,A01,083652,Krause-Levy; Sophia Louisa,6,8,120,114
1656009100344,CSE 15L,A01,083654,Morris; Justin Loren,3,1,50,47
1656009100344,CSE 15L,A02,083655,Morris; Justin Loren,1,1,50,49
1656009106369,CSE 20,A01,083657,Tran; Khoa Dang,29,0,80,51
1656009112395,CSE 21,A01,095574,Bach; Quang Tran,23,0,48,25
1656009118422,CSE 30,A01,083084,Eldon; John,2,10,80,78
1656009118422,CSE 30,B01,095061,Bhaskar; Nishant,0,4,50,50
1656009124447,CSE 100,A01,083659,Cao; Yingjun,2,25,70,68
1656009130469,CSE 134B,A01,083661,Powell; Thomas Allan,6,7,100,94
1656009136498,CSE 140,A01,083663,Gungor; Onat,5,0,85,80
1656009142528,CSE 140L,A01,083088,Eldon; John,5,0,100,95
1656009148561,CSE 175,A01,083665,Kumar; Rakesh,1,0,25,24
1656009154590,CSE 190,A00,092507,Dubnov; Shlomo,1,0,20,19
1656009160617,ECE 45,A01,083139,Congero; Spencer William,0,1,75,75
1656009166642,ECE 65,A50,083695,Saad; Andrew S,6,0,30,24
1656009166642,ECE 65,A51,095125,Staff,23,0,26,3
1656009172664,ECE 109,A01,091882,Touri; Behrouz,3,5,70,67
1656009178688,ECE 180,A00,083140,Abi Samra; Nicholas Camill,1,0,30,29
1656009178688,ECE 180,B00,083141,Abi Samra; Nicholas Camill,0,8,28,28
1656009184712,MATH 10A,A01,083735,Patchell; Gregory David,0,0,30,30
1656009184712,MATH 10A,A02,083736,Patchell; Gregory David,21,0,30,9
1656009184712,MATH 10A,A03,083737,Patchell; Gregory David,16,0,30,14
1656009190741,MATH 10B,A01,083207,Lim; Seonhee,1,1,34,33
1656009190741,MATH 10B,A02,083208,Lim; Seonhee,1,1,35,34
1656009190741,MATH 10B,A03,093472,Staff,1,0,34,33
1656009190741,MATH 10B,B01,083739,Sinha; Shubham,9,0,30,21
1656009196767,MATH 18,A01,083743,Cinel; Cameron Alexander,5,0,30,25
1656009196767,MATH 18,A02,083744,Cinel; Cameron Alexander,11,0,30,19
1656009196767,MATH 18,A03,083745,Cinel; Cameron Alexander,1,0,30,29
1656009196767,MATH 18,B01,083748,Ma; Zilu,0,0,36,36
1656009196767,MATH 18,B02,083749,Ma; Zilu,0,0,36,36
1656009196767,MATH 18,B03,083750,Ma; Zilu,0,0,36,36
1656009196767,MATH 18,B04,083751,Ma; Zilu,0,0,36,36
1656009196767,MATH 18,B05,093473,Staff,0,0,36,36
1656009196767,MATH 18,B06,093474,Staff,3,0,36,33
1656009202790,MATH 20A,A01,083754,Zheng; Zequn,10,0,40,30
1656009208817,MATH 20B,A01,083756,Briones; Jor-el Thomas Caparas,0,1,36,36
1656009208817,MATH 20B,A02,083757,Briones; Jor-el Thomas Caparas,1,0,36,35
1656009208817,MATH 20B,A03,093475,Staff,0,0,36,36
1656009214840,MATH 20C,A01,083760,Briones; Jor-el Thomas Caparas,0,2,35,35
1656009214840,MATH 20C,A02,083761,Briones; Jor-el Thomas Caparas,6,1,35,29
1656009214840,MATH 20C,A03,093476,Staff,0,0,35,35
1656009214840,MATH 20C,B01,083762,Bach; Quang Tran,3,0,30,27
1656009220874,MATH 20D,A01,083765,Tran; Brian Kha,1,0,30,29
1656009220874,MATH 20D,A02,083766,Tran; Brian Kha,0,1,30,30
1656009220874,MATH 20D,A03,083767,Tran; Brian Kha,1,0,30,29
1656009226919,MATH 20E,A01,083771,Ganguly; Soumya,0,1,32,32
1656009226919,MATH 20E,A02,083772,Ganguly; Soumya,1,1,32,31
1656009226919,MATH 20E,B01,083773,Ciotti; Benjamin,14,0,35,21
1656009226919,MATH 20E,B02,083774,Ciotti; Benjamin,12,0,35,23
1656009232952,MATH 103A,A01,083777,Greenfeld; Be'Eri,2,1,36,34
1656009232952,MATH 103A,A02,083778,Greenfeld; Be'Eri,2,0,36,34
1656009232952,MATH 103A,A03,093561,Staff,0,1,36,36
1656009232952,MATH 103A,B01,083779,Greenfeld; Be'Eri,7,1,36,29
1656009232952,MATH 103A,B02,083780,Greenfeld; Be'Eri,0,0,36,36
1656009232952,MATH 103A,B03,093562,Staff,0,0,36,36
1656009238975,MATH 105,A01,085443,Carter; Anne Toulson,4,1,35,31
1656009238975,MATH 105,A02,093477,Staff,8,0,35,27
1656009245011,MATH 109,A01,083213,Ganzberger; Geoffrey Michael,0,1,34,34
1656009245011,MATH 109,A02,083214,Ganzberger; Geoffrey Michael,0,0,34,34
1656009245011,MATH 109,A03,093478,Staff,1,0,34,33
1656009245011,MATH 109,B01,083215,Ganzberger; Geoffrey Michael,2,0,32,30
1656009245011,MATH 109,B02,083216,Ganzberger; Geoffrey Michael,0,0,32,32
1656009245011,MATH 109,B03,093479,Staff,4,0,32,28
1656009251035,MATH 142A,A01,083219,Chow; Bennett,0,0,32,32
1656009251035,MATH 142A,A02,083220,Chow; Bennett,7,0,32,25
1656009251035,MATH 142A,A03,093480,Staff,4,0,32,28
1656009251035,MATH 142A,B03,093481,Staff,3,0,32,29
1656009251035,MATH 142A,B04,093558,Staff,6,0,32,26
1656009251035,MATH 142A,B05,093559,Staff,0,0,32,32
1656009257062,MATH 193A,A01,083224,Rotar; Vladimir,1,1,34,33
1656009257062,MATH 193A,A02,083225,Rotar; Vladimir,0,0,34,34
1656009257062,MATH 193A,A03,083781,Rotar; Vladimir,2,0,34,32
1656009257062,MATH 193A,A04,083782,Rotar; Vladimir,3,0,34,31
1656009257062,MATH 193A,A05,093482,Rotar; Vladimir,0,0,34,34
1656009263087,MATH 197,001,091859,McAuley; Julian John,9999,0,9999,0
1656009263087,MATH 197,002,095566,Kedlaya; Kiran S.,9997,0,9999,2
1656009263087,MATH 197,003,095567,Xiao; Ming,9999,0,9999,0
1656009263087,MATH 197,004,095571,Perols; Johan Lars,9998,0,9999,1
1656009270144,COGS 9,A01,083615,Shannon; Kyle Michael,3,1,75,72
1656009276170,COGS 11,A01,083617,Boyle; Mary E. T.,11,1,48,37
1656009282192,COGS 13,A01,083071,Bastos; Amalia Pinkusfeld,4,2,71,67
1656009288217,COGS 14A,A01,092681,Semenuks; Arturs,4,25,100,96
1656009294242,COGS 14B,A01,083073,Cheng; Tzu-Han,7,0,63,56
1656009300278,COGS 17,A01,092677,Semenuks; Arturs,8,7,81,73
1656009306301,COGS 100,A01,083619,Allen; Michael Gordon,2,2,70,68
1656009312328,COGS 101A,A01,083621,Davis; Joshua Daniel,4,3,68,64
1656009318355,COGS 101B,A01,091572,Allen; Michael Gordon,0,0,65,65
1656009324380,COGS 101C,A01,083625,Delgado; Tania,7,0,35,28
1656009330406,COGS 107A,A01,083627,Boyle; Mary E. T.,1,2,60,59
1656009336428,COGS 118A,A01,083075,Gupta; Anjum,21,16,76,55
1656009342457,CSE 3,A50,083646,Miranda; Gregory Joseph,14,0,50,36
1656009348485,CSE 8A,A50,083650,Miranda; Gregory Joseph,3,11,56,53
1656009354511,CSE 11,A01,083080,Cao; Yingjun,0,65,40,40
1656009360534,CSE 12,A01,083652,Krause-Levy; Sophia Louisa,6,8,120,114
1656009366561,CSE 15L,A01,083654,Morris; Justin Loren,3,1,50,47
1656009366561,CSE 15L,A02,083655,Morris; Justin Loren,1,1,50,49
1656009372587,CSE 20,A01,083657,Tran; Khoa Dang,29,0,80,51
1656009378617,CSE 21,A01,095574,Bach; Quang Tran,23,0,48,25
1656009384729,CSE 30,A01,083084,Eldon; John,2,10,80,78
1656009384729,CSE 30,B01,095061,Bhaskar; Nishant,0,4,50,50
1656009390755,CSE 100,A01,083659,Cao; Yingjun,2,25,70,68
1656009396785,CSE 134B,A01,083661,Powell; Thomas Allan,6,7,100,94
1656009402814,CSE 140,A01,083663,Gungor; Onat,5,0,85,80
1656009408849,CSE 140L,A01,083088,Eldon; John,5,0,100,95
1656009414877,CSE 175,A01,083665,Kumar; Rakesh,1,0,25,24
1656009420902,CSE 190,A00,092507,Dubnov; Shlomo,1,0,20,19
1656009426937,ECE 45,A01,083139,Congero; Spencer William,0,1,75,75
1656009432965,ECE 65,A50,083695,Saad; Andrew S,6,0,30,24
1656009432965,ECE 65,A51,095125,Staff,23,0,26,3
1656009438989,ECE 109,A01,091882,Touri; Behrouz,3,5,70,67
1656009445029,ECE 180,A00,083140,Abi Samra; Nicholas Camill,1,0,30,29
1656009445029,ECE 180,B00,083141,Abi Samra; Nicholas Camill,0,8,28,28
1656009451059,MATH 10A,A01,083735,Patchell; Gregory David,0,0,30,30
1656009451059,MATH 10A,A02,083736,Patchell; Gregory David,21,0,30,9
1656009451059,MATH 10A,A03,083737,Patchell; Gregory David,16,0,30,14
1656009457088,MATH 10B,A01,083207,Lim; Seonhee,1,1,34,33
1656009457088,MATH 10B,A02,083208,Lim; Seonhee,1,1,35,34
1656009457088,MATH 10B,A03,093472,Staff,1,0,34,33
1656009457088,MATH 10B,B01,083739,Sinha; Shubham,9,0,30,21
1656009463116,MATH 18,A01,083743,Cinel; Cameron Alexander,5,0,30,25
1656009463116,MATH 18,A02,083744,Cinel; Cameron Alexander,11,0,30,19
1656009463116,MATH 18,A03,083745,Cinel; Cameron Alexander,1,0,30,29
1656009463116,MATH 18,B01,083748,Ma; Zilu,0,0,36,36
1656009463116,MATH 18,B02,083749,Ma; Zilu,0,0,36,36
1656009463116,MATH 18,B03,083750,Ma; Zilu,0,0,36,36
1656009463116,MATH 18,B04,083751,Ma; Zilu,0,0,36,36
1656009463116,MATH 18,B05,093473,Staff,0,0,36,36
1656009463116,MATH 18,B06,093474,Staff,3,0,36,33
1656009469141,MATH 20A,A01,083754,Zheng; Zequn,10,0,40,30
1656009475177,MATH 20B,A01,083756,Briones; Jor-el Thomas Caparas,0,1,36,36
1656009475177,MATH 20B,A02,083757,Briones; Jor-el Thomas Caparas,1,0,36,35
1656009475177,MATH 20B,A03,093475,Staff,0,0,36,36
1656009481200,MATH 20C,A01,083760,Briones; Jor-el Thomas Caparas,0,2,35,35
1656009481200,MATH 20C,A02,083761,Briones; Jor-el Thomas Caparas,6,1,35,29
1656009481200,MATH 20C,A03,093476,Staff,0,0,35,35
1656009481200,MATH 20C,B01,083762,Bach; Quang Tran,3,0,30,27
1656009487230,MATH 20D,A01,083765,Tran; Brian Kha,1,0,30,29
1656009487230,MATH 20D,A02,083766,Tran; Brian Kha,0,1,30,30
1656009487230,MATH 20D,A03,083767,Tran; Brian Kha,1,0,30,29
1656009493262,MATH 20E,A01,083771,Ganguly; Soumya,0,1,32,32
1656009493262,MATH 20E,A02,083772,Ganguly; Soumya,1,1,32,31
1656009493262,MATH 20E,B01,083773,Ciotti; Benjamin,14,0,35,21
1656009493262,MATH 20E,B02,083774,Ciotti; Benjamin,12,0,35,23
1656009499293,MATH 103A,A01,083777,Greenfeld; Be'Eri,2,1,36,34
1656009499293,MATH 103A,A02,083778,Greenfeld; Be'Eri,2,0,36,34
1656009499293,MATH 103A,A03,093561,Staff,0,1,36,36
1656009499293,MATH 103A,B01,083779,Greenfeld; Be'Eri,7,1,36,29
1656009499293,MATH 103A,B02,083780,Greenfeld; Be'Eri,0,0,36,36
1656009499293,MATH 103A,B03,093562,Staff,0,0,36,36
1656009505325,MATH 105,A01,085443,Carter; Anne Toulson,4,1,35,31
1656009505325,MATH 105,A02,093477,Staff,8,0,35,27
1656009511350,MATH 109,A01,083213,Ganzberger; Geoffrey Michael,0,1,34,34
1656009511350,MATH 109,A02,083214,Ganzberger; Geoffrey Michael,0,0,34,34
1656009511350,MATH 109,A03,093478,Staff,1,0,34,33
1656009511350,MATH 109,B01,083215,Ganzberger; Geoffrey Michael,2,0,32,30
1656009511350,MATH 109,B02,083216,Ganzberger; Geoffrey Michael,0,0,32,32
1656009511350,MATH 109,B03,093479,Staff,4,0,32,28
1656009517380,MATH 142A,A01,083219,Chow; Bennett,0,0,32,32
1656009517380,MATH 142A,A02,083220,Chow; Bennett,7,0,32,25
1656009517380,MATH 142A,A03,093480,Staff,4,0,32,28
1656009517380,MATH 142A,B03,093481,Staff,3,0,32,29
1656009517380,MATH 142A,B04,093558,Staff,6,0,32,26
1656009517380,MATH 142A,B05,093559,Staff,0,0,32,32
1656009523407,MATH 193A,A01,083224,Rotar; Vladimir,1,1,34,33
1656009523407,MATH 193A,A02,083225,Rotar; Vladimir,0,0,34,34
1656009523407,MATH 193A,A03,083781,Rotar; Vladimir,2,0,34,32
1656009523407,MATH 193A,A04,083782,Rotar; Vladimir,3,0,34,31
1656009523407,MATH 193A,A05,093482,Rotar; Vladimir,0,0,34,34
1656009529436,MATH 197,001,091859,McAuley; Julian John,9999,0,9999,0
1656009529436,MATH 197,002,095566,Kedlaya; Kiran S.,9997,0,9999,2
1656009529436,MATH 197,003,095567,Xiao; Ming,9999,0,9999,0
1656009529436,MATH 197,004,095571,Perols; Johan Lars,9998,0,9999,1
1656009536488,COGS 9,A01,083615,Shannon; Kyle Michael,3,1,75,72
1656009542515,COGS 11,A01,083617,Boyle; Mary E. T.,11,1,48,37
1656009548539,COGS 13,A01,083071,Bastos; Amalia Pinkusfeld,4,2,71,67
1656009554562,COGS 14A,A01,092681,Semenuks; Arturs,4,25,100,96
1656009560587,COGS 14B,A01,083073,Cheng; Tzu-Han,7,0,63,56
1656009566618,COGS 17,A01,092677,Semenuks; Arturs,8,7,81,73
1656009572653,COGS 100,A01,083619,Allen; Michael Gordon,2,2,70,68
1656009578684,COGS 101A,A01,083621,Davis; Joshua Daniel,4,3,68,64
1656009584708,COGS 101B,A01,091572,Allen; Michael Gordon,0,0,65,65
1656009590730,COGS 101C,A01,083625,Delgado; Tania,7,0,35,28
1656009596756,COGS 107A,A01,083627,Boyle; Mary E. T.,1,2,60,59
1656009602780,COGS 118A,A01,083075,Gupta; Anjum,21,16,76,55
1656009608808,CSE 3,A50,083646,Miranda; Gregory Joseph,14,0,50,36
1656009614831,CSE 8A,A50,083650,Miranda; Gregory Joseph,3,11,56,53
1656009620855,CSE 11,A01,083080,Cao; Yingjun,0,65,40,40
1656009626876,CSE 12,A01,083652,Krause-Levy; Sophia Louisa,6,8,120,114
1656009632898,CSE 15L,A01,083654,Morris; Justin Loren,3,1,50,47
1656009632898,CSE 15L,A02,083655,Morris; Justin Loren,1,1,50,49
1656009638927,CSE 20,A01,083657,Tran; Khoa Dang,29,0,80,51
1656009644957,CSE 21,A01,095574,Bach; Quang Tran,23,0,48,25
1656009650979,CSE 30,A01,083084,Eldon; John,2,10,80,78
1656009650979,CSE 30,B01,095061,Bhaskar; Nishant,0,4,50,50
1656009657004,CSE 100,A01,083659,Cao; Yingjun,2,25,70,68
1656009663031,CSE 134B,A01,083661,Powell; Thomas Allan,6,7,100,94
1656009669056,CSE 140,A01,083663,Gungor; Onat,5,0,85,80
1656009675084,CSE 140L,A01,083088,Eldon; John,5,0,100,95
1656009681110,CSE 175,A01,083665,Kumar; Rakesh,1,0,25,24
1656009687145,CSE 190,A00,092507,Dubnov; Shlomo,1,0,20,19
1656009693172,ECE 45,A01,083139,Congero; Spencer William,0,1,75,75
1656009699199,ECE 65,A50,083695,Saad; Andrew S,6,0,30,24
1656009699199,ECE 65,A51,095125,Staff,23,0,26,3
1656009705228,ECE 109,A01,091882,Touri; Behrouz,3,5,70,67
1656009711251,ECE 180,A00,083140,Abi Samra; Nicholas Camill,1,0,30,29
1656009711251,ECE 180,B00,083141,Abi Samra; Nicholas Camill,0,8,28,28
1656009717273,MATH 10A,A01,083735,Patchell; Gregory David,0,0,30,30
1656009717273,MATH 10A,A02,083736,Patchell; Gregory David,21,0,30,9
1656009717273,MATH 10A,A03,083737,Patchell; Gregory David,16,0,30,14
1656009723300,MATH 10B,A01,083207,Lim; Seonhee,1,1,34,33
1656009723300,MATH 10B,A02,083208,Lim; Seonhee,1,1,35,34
1656009723300,MATH 10B,A03,093472,Staff,1,0,34,33
1656009723300,MATH 10B,B01,083739,Sinha; Shubham,9,0,30,21
1656009729331,MATH 18,A01,083743,Cinel; Cameron Alexander,5,0,30,25
1656009729331,MATH 18,A02,083744,Cinel; Cameron Alexander,11,0,30,19
1656009729331,MATH 18,A03,083745,Cinel; Cameron Alexander,1,0,30,29
1656009729331,MATH 18,B01,083748,Ma; Zilu,0,0,36,36
1656009729331,MATH 18,B02,083749,Ma; Zilu,0,0,36,36
1656009729331,MATH 18,B03,083750,Ma; Zilu,0,0,36,36
1656009729331,MATH 18,B04,083751,Ma; Zilu,0,0,36,36
1656009729331,MATH 18,B05,093473,Staff,0,0,36,36
1656009729331,MATH 18,B06,093474,Staff,3,0,36,33
1656009735355,MATH 20A,A01,083754,Zheng; Zequn,10,0,40,30
1656009741383,MATH 20B,A01,083756,Briones; Jor-el Thomas Caparas,0,1,36,36
1656009741383,MATH 20B,A02,083757,Briones; Jor-el Thomas Caparas,1,0,36,35
1656009741383,MATH 20B,A03,093475,Staff,0,0,36,36
1656009747409,MATH 20C,A01,083760,Briones; Jor-el Thomas Caparas,0,2,35,35
1656009747409,MATH 20C,A02,083761,Briones; Jor-el Thomas Caparas,6,1,35,29
1656009747409,MATH 20C,A03,093476,Staff,0,0,35,35
1656009747409,MATH 20C,B01,083762,Bach; Quang Tran,3,0,30,27
1656009753432,MATH 20D,A01,083765,Tran; Brian Kha,1,0,30,29
1656009753432,MATH 20D,A02,083766,Tran; Brian Kha,0,1,30,30
1656009753432,MATH 20D,A03,083767,Tran; Brian Kha,1,0,30,29
1656009759455,MATH 20E,A01,083771,Ganguly; Soumya,0,1,32,32
1656009759455,MATH 20E,A02,083772,Ganguly; Soumya,1,1,32,31
1656009759455,MATH 20E,B01,083773,Ciotti; Benjamin,14,0,35,21
1656009759455,MATH 20E,B02,083774,Ciotti; Benjamin,12,0,35,23
1656009765482,MATH 103A,A01,083777,Greenfeld; Be'Eri,2,1,36,34
1656009765482,MATH 103A,A02,083778,Greenfeld; Be'Eri,2,0,36,34
1656009765482,MATH 103A,A03,093561,Staff,0,1,36,36
1656009765482,MATH 103A,B01,083779,Greenfeld; Be'Eri,7,1,36,29
1656009765482,MATH 103A,B02,083780,Greenfeld; Be'Eri,0,0,36,36
1656009765482,MATH 103A,B03,093562,Staff,0,0,36,36
1656009771506,MATH 105,A01,085443,Carter; Anne Toulson,4,1,35,31
1656009771506,MATH 105,A02,093477,Staff,8,0,35,27
1656009777533,MATH 109,A01,083213,Ganzberger; Geoffrey Michael,0,1,34,34
1656009777533,MATH 109,A02,083214,Ganzberger; Geoffrey Michael,0,0,34,34
1656009777533,MATH 109,A03,093478,Staff,1,0,34,33
1656009777533,MATH 109,B01,083215,Ganzberger; Geoffrey Michael,2,0,32,30
1656009777533,MATH 109,B02,083216,Ganzberger; Geoffrey Michael,0,0,32,32
1656009777533,MATH 109,B03,093479,Staff,4,0,32,28
1656009783558,MATH 142A,A01,083219,Chow; Bennett,0,0,32,32
1656009783558,MATH 142A,A02,083220,Chow; Bennett,7,0,32,25
1656009783558,MATH 142A,A03,093480,Staff,4,0,32,28
1656009783558,MATH 142A,B03,093481,Staff,3,0,32,29
1656009783558,MATH 142A,B04,093558,Staff,6,0,32,26
1656009783558,MATH 142A,B05,093559,Staff,0,0,32,32
1656009789582,MATH 193A,A01,083224,Rotar; Vladimir,1,1,34,33
1656009789582,MATH 193A,A02,083225,Rotar; Vladimir,0,0,34,34
1656009789582,MATH 193A,A03,083781,Rotar; Vladimir,2,0,34,32
1656009789582,MATH 193A,A04,083782,Rotar; Vladimir,3,0,34,31
1656009789582,MATH 193A,A05,093482,Rotar; Vladimir,0,0,34,34
1656009795614,MATH 197,001,091859,McAuley; Julian John,9999,0,9999,0
1656009795614,MATH 197,002,095566,Kedlaya; Kiran S.,9997,0,9999,2
1656009795614,MATH 197,003,095567,Xiao; Ming,9999,0,9999,0
1656009795614,MATH 197,004,095571,Perols; Johan Lars,9998,0,9999,1
1656009802673,COGS 9,A01,083615,Shannon; Kyle Michael,3,1,75,72
1656009808696,COGS 11,A01,083617,Boyle; Mary E. T.,11,1,48,37
1656009814723,COGS 13,A01,083071,Bastos; Amalia Pinkusfeld,4,2,71,67
1656009820755,COGS 14A,A01,092681,Semenuks; Arturs,4,25,100,96
1656009826782,COGS 14B,A01,083073,Cheng; Tzu-Han,7,0,63,56
1656009832806,COGS 17,A01,092677,Semenuks; Arturs,8,7,81,73
1656009838828,COGS 100,A01,083619,Allen; Michael Gordon,2,2,70,68
1656009844850,COGS 101A,A01,083621,Davis; Joshua Daniel,4,3,68,64
1656009850890,COGS 101B,A01,091572,Allen; Michael Gordon,0,0,65,65
1656009856923,COGS 101C,A01,083625,Delgado; Tania,7,0,35,28
1656009862948,COGS 107A,A01,083627,Boyle; Mary E. T.,1,2,60,59
1656009868976,COGS 118A,A01,083075,Gupta; Anjum,21,16,76,55
1656009875005,CSE 3,A50,083646,Miranda; Gregory Joseph,14,0,50,36
1656009881028,CSE 8A,A50,083650,Miranda; Gregory Joseph,3,11,56,53
1656009887055,CSE 11,A01,083080,Cao; Yingjun,0,65,40,40
1656009893079,CSE 12,A01,083652,Krause-Levy; Sophia Louisa,6,8,120,114
1656009899109,CSE 15L,A01,083654,Morris; Justin Loren,3,1,50,47
1656009899109,CSE 15L,A02,083655,Morris; Justin Loren,1,1,50,49
1656009905144,CSE 20,A01,083657,Tran; Khoa Dang,29,0,80,51
1656009911175,CSE 21,A01,095574,Bach; Quang Tran,23,0,48,25
1656009917217,CSE 30,A01,083084,Eldon; John,2,10,80,78
1656009917217,CSE 30,B01,095061,Bhaskar; Nishant,0,4,50,50
1656009923239,CSE 100,A01,083659,Cao; Yingjun,2,25,70,68
1656009929263,CSE 134B,A01,083661,Powell; Thomas Allan,6,7,100,94
1656009935292,CSE 140,A01,083663,Gungor; Onat,5,0,85,80
1656009941315,CSE 140L,A01,083088,Eldon; John,5,0,100,95
1656009947341,CSE 175,A01,083665,Kumar; Rakesh,1,0,25,24
1656009953364,CSE 190,A00,092507,Dubnov; Shlomo,1,0,20,19
1656009959392,ECE 45,A01,083139,Congero; Spencer William,0,1,75,75
1656009965419,ECE 65,A50,083695,Saad; Andrew S,6,0,30,24
1656009965419,ECE 65,A51,095125,Staff,23,0,26,3
1656009971442,ECE 109,A01,091882,Touri; Behrouz,3,5,70,67
1656009977465,ECE 180,A00,083140,Abi Samra; Nicholas Camill,1,0,30,29
1656009977465,ECE 180,B00,083141,Abi Samra; Nicholas Camill,0,8,28,28
1656009983560,MATH 10A,A01,083735,Patchell; Gregory David,0,0,30,30
1656009983560,MATH 10A,A02,083736,Patchell; Gregory David,21,0,30,9
1656009983560,MATH 10A,A03,083737,Patchell; Gregory David,16,0,30,14
1656009989591,MATH 10B,A01,083207,Lim; Seonhee,1,1,34,33
1656009989591,MATH 10B,A02,083208,Lim; Seonhee,1,1,35,34
1656009989591,MATH 10B,A03,093472,Staff,1,0,34,33
1656009989591,MATH 10B,B01,083739,Sinha; Shubham,9,0,30,21
1656009995622,MATH 18,A01,083743,Cinel; Cameron Alexander,5,0,30,25
1656009995622,MATH 18,A02,083744,Cinel; Cameron Alexander,11,0,30,19
1656009995622,MATH 18,A03,083745,Cinel; Cameron Alexander,1,0,30,29
1656009995622,MATH 18,B01,083748,Ma; Zilu,0,0,36,36
1656009995622,MATH 18,B02,083749,Ma; Zilu,0,0,36,36
1656009995622,MATH 18,B03,083750,Ma; Zilu,0,0,36,36
1656009995622,MATH 18,B04,083751,Ma; Zilu,0,0,36,36
1656009995622,MATH 18,B05,093473,Staff,0,0,36,36
1656009995622,MATH 18,B06,093474,Staff,3,0,36,33
1656010001650,MATH 20A,A01,083754,Zheng; Zequn,10,0,40,30
1656010007679,MATH 20B,A01,083756,Briones; Jor-el Thomas Caparas,0,1,36,36
1656010007679,MATH 20B,A02,083757,Briones; Jor-el Thomas Caparas,1,0,36,35
1656010007679,MATH 20B,A03,093475,Staff,0,0,36,36
1656010013707,MATH 20C,A01,083760,Briones; Jor-el Thomas Caparas,0,2,35,35
1656010013707,MATH 20C,A02,083761,Briones; Jor-el Thomas Caparas,6,1,35,29
1656010013707,MATH 20C,A03,093476,Staff,0,0,35,35
1656010013707,MATH 20C,B01,083762,Bach; Quang Tran,3,0,30,27
1656010019731,MATH 20D,A01,083765,Tran; Brian Kha,1,0,30,29
1656010019731,MATH 20D,A02,083766,Tran; Brian Kha,0,1,30,30
1656010019731,MATH 20D,A03,083767,Tran; Brian Kha,1,0,30,29
1656010025760,MATH 20E,A01,083771,Ganguly; Soumya,0,1,32,32
1656010025760,MATH 20E,A02,083772,Ganguly; Soumya,1,1,32,31
1656010025760,MATH 20E,B01,083773,Ciotti; Benjamin,14,0,35,21
1656010025760,MATH 20E,B02,083774,Ciotti; Benjamin,12,0,35,23
1656010031782,MATH 103A,A01,083777,Greenfeld; Be'Eri,2,1,36,34
1656010031782,MATH 103A,A02,083778,Greenfeld; Be'Eri,2,0,36,34
1656010031782,MATH 103A,A03,093561,Staff,0,1,36,36
1656010031782,MATH 103A,B01,083779,Greenfeld; Be'Eri,7,1,36,29
1656010031782,MATH 103A,B02,083780,Greenfeld; Be'Eri,0,0,36,36
1656010031782,MATH 103A,B03,093562,Staff,0,0,36,36
1656010037806,MATH 105,A01,085443,Carter; Anne Toulson,4,1,35,31
1656010037806,MATH 105,A02,093477,Staff,8,0,35,27
1656010043835,MATH 109,A01,083213,Ganzberger; Geoffrey Michael,0,1,34,34
1656010043835,MATH 109,A02,083214,Ganzberger; Geoffrey Michael,0,0,34,34
1656010043835,MATH 109,A03,093478,Staff,1,0,34,33
1656010043835,MATH 109,B01,083215,Ganzberger; Geoffrey Michael,2,0,32,30
1656010043835,MATH 109,B02,083216,Ganzberger; Geoffrey Michael,0,0,32,32
1656010043835,MATH 109,B03,093479,Staff,4,0,32,28
1656010049859,MATH 142A,A01,083219,Chow; Bennett,0,0,32,32
1656010049859,MATH 142A,A02,083220,Chow; Bennett,7,0,32,25
1656010049859,MATH 142A,A03,093480,Staff,4,0,32,28
1656010049859,MATH 142A,B03,093481,Staff,3,0,32,29
1656010049859,MATH 142A,B04,093558,Staff,6,0,32,26
1656010049859,MATH 142A,B05,093559,Staff,0,0,32,32
1656010055891,MATH 193A,A01,083224,Rotar; Vladimir,1,1,34,33
1656010055891,MATH 193A,A02,083225,Rotar; Vladimir,0,0,34,34
1656010055891,MATH 193A,A03,083781,Rotar; Vladimir,2,0,34,32
1656010055891,MATH 193A,A04,083782,Rotar; Vladimir,3,0,34,31
1656010055891,MATH 193A,A05,093482,Rotar; Vladimir,0,0,34,34
1656010061919,MATH 197,001,091859,McAuley; Julian John,9999,0,9999,0
1656010061919,MATH 197,002,095566,Kedlaya; Kiran S.,9997,0,9999,2
1656010061919,MATH 197,003,095567,Xiao; Ming,9999,0,9999,0
1656010061919,MATH 197,004,095571,Perols; Johan Lars,9998,0,9999,1
1656010068971,COGS 9,A01,083615,Shannon; Kyle Michael,3,1,75,72
1656010075000,COGS 11,A01,083617,Boyle; Mary E. T.,11,1,48,37
1656010081028,COGS 13,A01,083071,Bastos; Amalia Pinkusfeld,4,2,71,67
1656010087051,COGS 14A,A01,092681,Semenuks; Arturs,4,25,100,96
1656010093077,COGS 14B,A01,083073,Cheng; Tzu-Han,7,0,63,56
1656010099099,COGS 17,A01,092677,Semenuks; Arturs,8,7,81,73
1656010105123,COGS 100,A01,083619,Allen; Michael Gordon,2,2,70,68
1656010111148,COGS 101A,A01,083621,Davis; Joshua Daniel,4,3,68,64
1656010117171,COGS 101B,A01,091572,Allen; Michael Gordon,0,0,65,65
1656010123199,COGS 101C,A01,083625,Delgado; Tania,7,0,35,28
1656010129233,COGS 107A,A01,083627,Boyle; Mary E. T.,1,2,60,59
1656010135256,COGS 118A,A01,083075,Gupta; Anjum,21,16,76,55
1656010141280,CSE 3,A50,083646,Miranda; Gregory Joseph,14,0,50,36
1656010147307,CSE 8A,A50,083650,Miranda; Gregory Joseph,3,11,56,53
1656010153330,CSE 11,A01,083080,Cao; Yingjun,0,65,40,40
1656010159352,CSE 12,A01,083652,Krause-Levy; Sophia Louisa,6,8,120,114
1656010165377,CSE 15L,A01,083654,Morris; Justin Loren,3,1,50,47
1656010165377,CSE 15L,A02,083655,Morris; Justin Loren,1,1,50,49
1656010171404,CSE 20,A01,083657,Tran; Khoa Dang,29,0,80,51
1656010177439,CSE 21,A01,095574,Bach; Quang Tran,23,0,48,25
1656010183460,CSE 30,A01,083084,Eldon; John,2,10,80,78
1656010183460,CSE 30,B01,095061,Bhaskar; Nishant,0,4,50,50
1656010189483,CSE 100,A01,083659,Cao; Yingjun,2,25,70,68
1656010195509,CSE 134B,A01,083661,Powell; Thomas Allan,6,7,100,94
1656010201533,CSE 140,A01,083663,Gungor; Onat,5,0,85,80
1656010207556,CSE 140L,A01,083088,Eldon; John,5,0,100,95
1656010213581,CSE 175,A01,083665,Kumar; Rakesh,1,0,25,24
1656010219607,CSE 190,A00,092507,Dubnov; Shlomo,1,0,20,19
1656010225633,ECE 45,A01,083139,Congero; Spencer William,0,1,75,75
1656010231694,ECE 65,A50,083695,Saad; Andrew S,6,0,30,24
1656010231694,ECE 65,A51,095125,Staff,23,0,26,3
1656010237727,ECE 109,A01,091882,Touri; Behrouz,3,5,70,67
1656010243750,ECE 180,A00,083140,Abi Samra; Nicholas Camill,1,0,30,29
1656010243750,ECE 180,B00,083141,Abi Samra; Nicholas Camill,0,8,28,28
1656010249781,MATH 10A,A01,083735,Patchell; Gregory David,0,0,30,30
1656010249781,MATH 10A,A02,083736,Patchell; Gregory David,21,0,30,9
1656010249781,MATH 10A,A03,083737,Patchell; Gregory David,16,0,30,14
1656010255806,MATH 10B,A01,083207,Lim; Seonhee,1,1,34,33
1656010255806,MATH 10B,A02,083208,Lim; Seonhee,1,1,35,34
1656010255806,MATH 10B,A03,093472,Staff,1,0,34,33
1656010255806,MATH 10B,B01,083739,Sinha; Shubham,9,0,30,21
1656010261835,MATH 18,A01,083743,Cinel; Cameron Alexander,5,0,30,25
1656010261835,MATH 18,A02,083744,Cinel; Cameron Alexander,11,0,30,19
1656010261835,MATH 18,A03,083745,Cinel; Cameron Alexander,1,0,30,29
1656010261835,MATH 18,B01,083748,Ma; Zilu,0,0,36,36
1656010261835,MATH 18,B02,083749,Ma; Zilu,0,0,36,36
1656010261835,MATH 18,B03,083750,Ma; Zilu,0,0,36,36
1656010261835,MATH 18,B04,083751,Ma; Zilu,0,0,36,36
1656010261835,MATH 18,B05,093473,Staff,0,0,36,36
1656010261835,MATH 18,B06,093474,Staff,3,0,36,33
1656010267864,MATH 20A,A01,083754,Zheng; Zequn,10,0,40,30
1656010273892,MATH 20B,A01,083756,Briones; Jor-el Thomas Caparas,0,1,36,36
1656010273892,MATH 20B,A02,083757,Briones; Jor-el Thomas Caparas,1,0,36,35
1656010273892,MATH 20B,A03,093475,Staff,0,0,36,36
1656010279917,MATH 20C,A01,083760,Briones; Jor-el Thomas Caparas,0,2,35,35
1656010279917,MATH 20C,A02,083761,Briones; Jor-el Thomas Caparas,6,1,35,29
1656010279917,MATH 20C,A03,093476,Staff,0,0,35,35
1656010279917,MATH 20C,B01,083762,Bach; Quang Tran,3,0,30,27
1656010285944,MATH 20D,A01,083765,Tran; Brian Kha,1,0,30,29
1656010285944,MATH 20D,A02,083766,Tran; Brian Kha,0,1,30,30
1656010285944,MATH 20D,A03,083767,Tran; Brian Kha,1,0,30,29
1656010291974,MATH 20E,A01,083771,Ganguly; Soumya,0,1,32,32
1656010291974,MATH 20E,A02,083772,Ganguly; Soumya,1,1,32,31
1656010291974,MATH 20E,B01,083773,Ciotti; Benjamin,14,0,35,21
1656010291974,MATH 20E,B02,083774,Ciotti; Benjamin,12,0,35,23
1656010298008,MATH 103A,A01,083777,Greenfeld; Be'Eri,2,1,36,34
1656010298008,MATH 103A,A02,083778,Greenfeld; Be'Eri,2,0,36,34
1656010298008,MATH 103A,A03,093561,Staff,0,1,36,36
1656010298008,MATH 103A,B01,083779,Greenfeld; Be'Eri,7,1,36,29
1656010298008,MATH 103A,B02,083780,Greenfeld; Be'Eri,0,0,36,36
1656010298008,MATH 103A,B03,093562,Staff,0,0,36,36
1656010304078,MATH 105,A01,085443,Carter; Anne Toulson,4,1,35,31
1656010304078,MATH 105,A02,093477,Staff,8,0,35,27
1656010310103,MATH 109,A01,083213,Ganzberger; Geoffrey Michael,0,1,34,34
1656010310103,MATH 109,A02,083214,Ganzberger; Geoffrey Michael,0,0,34,34
1656010310103,MATH 109,A03,093478,Staff,1,0,34,33
1656010310103,MATH 109,B01,083215,Ganzberger; Geoffrey Michael,2,0,32,30
1656010310103,MATH 109,B02,083216,Ganzberger; Geoffrey Michael,0,0,32,32
1656010310103,MATH 109,B03,093479,Staff,4,0,32,28
1656010316132,MATH 142A,A01,083219,Chow; Bennett,0,0,32,32
1656010316132,MATH 142A,A02,083220,Chow; Bennett,7,0,32,25
1656010316132,MATH 142A,A03,093480,Staff,4,0,32,28
1656010316132,MATH 142A,B03,093481,Staff,3,0,32,29
1656010316132,MATH 142A,B04,093558,Staff,6,0,32,26
1656010316132,MATH 142A,B05,093559,Staff,0,0,32,32
1656010322156,MATH 193A,A01,083224,Rotar; Vladimir,1,1,34,33
1656010322156,MATH 193A,A02,083225,Rotar; Vladimir,0,0,34,34
1656010322156,MATH 193A,A03,083781,Rotar; Vladimir,2,0,34,32
1656010322156,MATH 193A,A04,083782,Rotar; Vladimir,3,0,34,31
1656010322156,MATH 193A,A05,093482,Rotar; Vladimir,0,0,34,34
1656010328183,MATH 197,001,091859,McAuley; Julian John,9999,0,9999,0
1656010328183,MATH 197,002,095566,Kedlaya; Kiran S.,9997,0,9999,2
1656010328183,MATH 197,003,095567,Xiao; Ming,9999,0,9999,0
1656010328183,MATH 197,004,095571,Perols; Johan Lars,9998,0,9999,1
1656010335244,COGS 9,A01,083615,Shannon; Kyle Michael,3,1,75,72
1656010341267,COGS 11,A01,083617,Boyle; Mary E. T.,11,1,48,37
1656010347291,COGS 13,A01,083071,Bastos; Amalia Pinkusfeld,4,2,71,67
1656010353327,COGS 14A,A01,092681,Semenuks; Arturs,4,25,100,96
1656010359351,COGS 14B,A01,083073,Cheng; Tzu-Han,7,0,63,56
1656010365384,COGS 17,A01,092677,Semenuks; Arturs,8,7,81,73
1656010371411,COGS 100,A01,083619,Allen; Michael Gordon,2,2,70,68
1656010377442,COGS 101A,A01,083621,Davis; Joshua Daniel,4,3,68,64
1656010383466,COGS 101B,A01,091572,Allen; Michael Gordon,0,0,65,65
1656010389500,COGS 101C,A01,083625,Delgado; Tania,7,0,35,28
1656010395521,COGS 107A,A01,083627,Boyle; Mary E. T.,1,2,60,59
1656010401548,COGS 118A,A01,083075,Gupta; Anjum,21,16,76,55
1656010407572,CSE 3,A50,083646,Miranda; Gregory Joseph,14,0,50,36
1656010413598,CSE 8A,A50,083650,Miranda; Gregory Joseph,3,11,56,53
1656010419621,CSE 11,A01,083080,Cao; Yingjun,0,65,40,40
1656010425645,CSE 12,A01,083652,Krause-Levy; Sophia Louisa,6,8,120,114
1656010431673,CSE 15L,A01,083654,Morris; Justin Loren,3,1,50,47
1656010431673,CSE 15L,A02,083655,Morris; Justin Loren,1,1,50,49
1656010437697,CSE 20,A01,083657,Tran; Khoa Dang,29,0,80,51
1656010443723,CSE 21,A01,095574,Bach; Quang Tran,23,0,48,25
1656010449747,CSE 30,A01,083084,Eldon; John,2,10,80,78
1656010449747,CSE 30,B01,095061,Bhaskar; Nishant,0,4,50,50
1656010455783,CSE 100,A01,083659,Cao; Yingjun,2,25,70,68
1656010461809,CSE 134B,A01,083661,Powell; Thomas Allan,6,7,100,94
1656010467841,CSE 140,A01,083663,Gungor; Onat,5,0,85,80
1656010473878,CSE 140L,A01,083088,Eldon; John,5,0,100,95
1656010479917,CSE 175,A01,083665,Kumar; Rakesh,1,0,25,24
1656010485943,CSE 190,A00,092507,Dubnov; Shlomo,1,0,20,19
1656010491967,ECE 45,A01,083139,Congero; Spencer William,0,1,75,75
1656010497991,ECE 65,A50,083695,Saad; Andrew S,6,0,30,24
1656010497991,ECE 65,A51,095125,Staff,23,0,26,3
1656010504014,ECE 109,A01,091882,Touri; Behrouz,3,5,70,67
1656010510041,ECE 180,A00,083140,Abi Samra; Nicholas Camill,1,0,30,29
1656010510041,ECE 180,B00,083141,Abi Samra; Nicholas Camill,0,8,28,28
1656010516064,MATH 10A,A01,083735,Patchell; Gregory David,0,0,30,30
1656010516064,MATH 10A,A02,083736,Patchell; Gregory David,21,0,30,9
1656010516064,MATH 10A,A03,083737,Patchell; Gregory David,16,0,30,14
1656010522105,MATH 10B,A01,083207,Lim; Seonhee,1,1,34,33
1656010522105,MATH 10B,A02,083208,Lim; Seonhee,1,1,35,34
1656010522105,MATH 10B,A03,093472,Staff,1,0,34,33
1656010522105,MATH 10B,B01,083739,Sinha; Shubham,9,0,30,21
1656010528129,MATH 18,A01,083743,Cinel; Cameron Alexander,5,0,30,25
1656010528129,MATH 18,A02,083744,Cinel; Cameron Alexander,11,0,30,19
1656010528129,MATH 18,A03,083745,Cinel; Cameron Alexander,1,0,30,29
1656010528129,MATH 18,B01,083748,Ma; Zilu,0,0,36,36
1656010528129,MATH 18,B02,083749,Ma; Zilu,0,0,36,36
1656010528129,MATH 18,B03,083750,Ma; Zilu,0,0,36,36
1656010528129,MATH 18,B04,083751,Ma; Zilu,0,0,36,36
1656010528129,MATH 18,B05,093473,Staff,0,0,36,36
1656010528129,MATH 18,B06,093474,Staff,3,0,36,33
1656010534156,MATH 20A,A01,083754,Zheng; Zequn,10,0,40,30
1656010540184,MATH 20B,A01,083756,Briones; Jor-el Thomas Caparas,0,1,36,36
1656010540184,MATH 20B,A02,083757,Briones; Jor-el Thomas Caparas,1,0,36,35
1656010540184,MATH 20B,A03,093475,Staff,0,0,36,36
1656010546215,MATH 20C,A01,083760,Briones; Jor-el Thomas Caparas,0,2,35,35
1656010546215,MATH 20C,A02,083761,Briones; Jor-el Thomas Caparas,6,1,35,29
1656010546215,MATH 20C,A03,093476,Staff,0,0,35,35
1656010546215,MATH 20C,B01,083762,Bach; Quang Tran,3,0,30,27
1656010552247,MATH 20D,A01,083765,Tran; Brian Kha,1,0,30,29
1656010552247,MATH 20D,A02,083766,Tran; Brian Kha,0,1,30,30
1656010552247,MATH 20D,A03,083767,Tran; Brian Kha,1,0,30,29
1656010558272,MATH 20E,A01,083771,Ganguly; Soumya,0,1,32,32
1656010558272,MATH 20E,A02,083772,Ganguly; Soumya,1,1,32,31
1656010558272,MATH 20E,B01,083773,Ciotti; Benjamin,14,0,35,21
1656010558272,MATH 20E,B02,083774,Ciotti; Benjamin,12,0,35,23
1656010564301,MATH 103A,A01,083777,Greenfeld; Be'Eri,2,1,36,34
1656010564301,MATH 103A,A02,083778,Greenfeld; Be'Eri,2,0,36,34
1656010564301,MATH 103A,A03,093561,Staff,0,1,36,36
1656010564301,MATH 103A,B01,083779,Greenfeld; Be'Eri,7,1,36,29
1656010564301,MATH 103A,B02,083780,Greenfeld; Be'Eri,0,0,36,36
1656010564301,MATH 103A,B03,093562,Staff,0,0,36,36
1656010570334,MATH 105,A01,085443,Carter; Anne Toulson,4,1,35,31
1656010570334,MATH 105,A02,093477,Staff,8,0,35,27
1656010576361,MATH 109,A01,083213,Ganzberger; Geoffrey Michael,0,1,34,34
1656010576361,MATH 109,A02,083214,Ganzberger; Geoffrey Michael,0,0,34,34
1656010576361,MATH 109,A03,093478,Staff,1,0,34,33
1656010576361,MATH 109,B01,083215,Ganzberger; Geoffrey Michael,2,0,32,30
1656010576361,MATH 109,B02,083216,Ganzberger; Geoffrey Michael,0,0,32,32
1656010576361,MATH 109,B03,093479,Staff,4,0,32,28
1656010582489,MATH 142A,A01,083219,Chow; Bennett,0,0,32,32
1656010582489,MATH 142A,A02,083220,Chow; Bennett,7,0,32,25
1656010582489,MATH 142A,A03,093480,Staff,4,0,32,28
1656010582489,MATH 142A,B03,093481,Staff,3,0,32,29
1656010582489,MATH 142A,B04,093558,Staff,6,0,32,26
1656010582489,MATH 142A,B05,093559,Staff,0,0,32,32
1656010588515,MATH 193A,A01,083224,Rotar; Vladimir,1,1,34,33
1656010588515,MATH 193A,A02,083225,Rotar; Vladimir,0,0,34,34
1656010588515,MATH 193A,A03,083781,Rotar; Vladimir,2,0,34,32
1656010588515,MATH 193A,A04,083782,Rotar; Vladimir,3,0,34,31
1656010588515,MATH 193A,A05,093482,Rotar; Vladimir,0,0,34,34
1656010594538,MATH 197,001,091859,McAuley; Julian John,9999,0,9999,0
1656010594538,MATH 197,002,095566,Kedlaya; Kiran S.,9997,0,9999,2
1656010594538,MATH 197,003,095567,Xiao; Ming,9999,0,9999,0
1656010594538,MATH 197,004,095571,Perols; Johan Lars,9998,0,9999,1
1656010601594,COGS 9,A01,083615,Shannon; Kyle Michael,3,1,75,72
1656010607619,COGS 11,A01,083617,Boyle; Mary E. T.,11,1,48,37
1656010613654,COGS 13,A01,083071,Bastos; Amalia Pinkusfeld,4,2,71,67
1656010619687,COGS 14A,A01,092681,Semenuks; Arturs,4,25,100,96
1656010625709,COGS 14B,A01,083073,Cheng; Tzu-Han,7,0,63,56
1656010631733,COGS 17,A01,092677,Semenuks; Arturs,8,7,81,73
1656010637756,COGS 100,A01,083619,Allen; Michael Gordon,2,2,70,68
1656010643786,COGS 101A,A01,083621,Davis; Joshua Daniel,4,3,68,64
1656010649809,COGS 101B,A01,091572,Allen; Michael Gordon,0,0,65,65
1656010655833,COGS 101C,A01,083625,Delgado; Tania,7,0,35,28
1656010661857,COGS 107A,A01,083627,Boyle; Mary E. T.,1,2,60,59
1656010667890,COGS 118A,A01,083075,Gupta; Anjum,21,16,76,55
1656010673920,CSE 3,A50,083646,Miranda; Gregory Joseph,14,0,50,36
1656010679953,CSE 8A,A50,083650,Miranda; Gregory Joseph,3,11,56,53
1656010685988,CSE 11,A01,083080,Cao; Yingjun,0,65,40,40
1656010692010,CSE 12,A01,083652,Krause-Levy; Sophia Louisa,6,8,120,114
1656010698034,CSE 15L,A01,083654,Morris; Justin Loren,3,1,50,47
1656010698034,CSE 15L,A02,083655,Morris; Justin Loren,1,1,50,49
1656010704057,CSE 20,A01,083657,Tran; Khoa Dang,29,0,80,51
1656010710084,CSE 21,A01,095574,Bach; Quang Tran,23,0,48,25
1656010716109,CSE 30,A01,083084,Eldon; John,2,10,80,78
1656010716109,CSE 30,B01,095061,Bhaskar; Nishant,0,4,50,50
1656010722142,CSE 100,A01,083659,Cao; Yingjun,2,25,70,68
1656010728170,CSE 134B,A01,083661,Powell; Thomas Allan,6,7,100,94
1656010734194,CSE 140,A01,083663,Gungor; Onat,5,0,85,80
1656010740231,CSE 140L,A01,083088,Eldon; John,5,0,100,95
1656010746258,CSE 175,A01,083665,Kumar; Rakesh,1,0,25,24
1656010752281,CSE 190,A00,092507,Dubnov; Shlomo,1,0,20,19
1656010758314,ECE 45,A01,083139,Congero; Spencer William,0,1,75,75
1656010764343,ECE 65,A50,083695,Saad; Andrew S,6,0,30,24
1656010764343,ECE 65,A51,095125,Staff,23,0,26,3
1656010770368,ECE 109,A01,091882,Touri; Behrouz,3,5,70,67
1656010776395,ECE 180,A00,083140,Abi Samra; Nicholas Camill,1,0,30,29
1656010776395,ECE 180,B00,083141,Abi Samra; Nicholas Camill,0,8,28,28
1656010782420,MATH 10A,A01,083735,Patchell; Gregory David,0,0,30,30
1656010782420,MATH 10A,A02,083736,Patchell; Gregory David,21,0,30,9
1656010782420,MATH 10A,A03,083737,Patchell; Gregory David,16,0,30,14
1656010788444,MATH 10B,A01,083207,Lim; Seonhee,1,1,34,33
1656010788444,MATH 10B,A02,083208,Lim; Seonhee,1,1,35,34
1656010788444,MATH 10B,A03,093472,Staff,1,0,34,33
1656010788444,MATH 10B,B01,083739,Sinha; Shubham,9,0,30,21
1656010794470,MATH 18,A01,083743,Cinel; Cameron Alexander,5,0,30,25
1656010794470,MATH 18,A02,083744,Cinel; Cameron Alexander,11,0,30,19
1656010794470,MATH 18,A03,083745,Cinel; Cameron Alexander,1,0,30,29
1656010794470,MATH 18,B01,083748,Ma; Zilu,0,0,36,36
1656010794470,MATH 18,B02,083749,Ma; Zilu,0,0,36,36
1656010794470,MATH 18,B03,083750,Ma; Zilu,0,0,36,36
1656010794470,MATH 18,B04,083751,Ma; Zilu,0,0,36,36
1656010794470,MATH 18,B05,093473,Staff,0,0,36,36
1656010794470,MATH 18,B06,093474,Staff,3,0,36,33
1656010800496,MATH 20A,A01,083754,Zheng; Zequn,10,0,40,30
1656010806519,MATH 20B,A01,083756,Briones; Jor-el Thomas Caparas,0,1,36,36
1656010806519,MATH 20B,A02,083757,Briones; Jor-el Thomas Caparas,1,0,36,35
1656010806519,MATH 20B,A03,093475,Staff,0,0,36,36
1656010812542,MATH 20C,A01,083760,Briones; Jor-el Thomas Caparas,0,2,35,35
1656010812542,MATH 20C,A02,083761,Briones; Jor-el Thomas Caparas,6,1,35,29
1656010812542,MATH 20C,A03,093476,Staff,0,0,35,35
1656010812542,MATH 20C,B01,083762,Bach; Quang Tran,3,0,30,27
1656010818574,MATH 20D,A01,083765,Tran; Brian Kha,1,0,30,29
1656010818574,MATH 20D,A02,083766,Tran; Brian Kha,0,1,30,30
1656010818574,MATH 20D,A03,083767,Tran; Brian Kha,1,0,30,29
1656010824601,MATH 20E,A01,083771,Ganguly; Soumya,0,1,32,32
1656010824601,MATH 20E,A02,083772,Ganguly; Soumya,1,1,32,31
1656010824601,MATH 20E,B01,083773,Ciotti; Benjamin,14,0,35,21
1656010824601,MATH 20E,B02,083774,Ciotti; Benjamin,12,0,35,23
1656010830625,MATH 103A,A01,083777,Greenfeld; Be'Eri,2,1,36,34
1656010830625,MATH 103A,A02,083778,Greenfeld; Be'Eri,2,0,36,34
1656010830625,MATH 103A,A03,093561,Staff,0,1,36,36
1656010830625,MATH 103A,B01,083779,Greenfeld; Be'Eri,7,1,36,29
1656010830625,MATH 103A,B02,083780,Greenfeld; Be'Eri,0,0,36,36
1656010830625,MATH 103A,B03,093562,Staff,0,0,36,36
1656010836654,MATH 105,A01,085443,Carter; Anne Toulson,4,1,35,31
1656010836654,MATH 105,A02,093477,Staff,8,0,35,27
1656010842685,MATH 109,A01,083213,Ganzberger; Geoffrey Michael,0,1,34,34
1656010842685,MATH 109,A02,083214,Ganzberger; Geoffrey Michael,0,0,34,34
1656010842685,MATH 109,A03,093478,Staff,1,0,34,33
1656010842685,MATH 109,B01,083215,Ganzberger; Geoffrey Michael,2,0,32,30
1656010842685,MATH 109,B02,083216,Ganzberger; Geoffrey Michael,0,0,32,32
1656010842685,MATH 109,B03,093479,Staff,4,0,32,28
1656010848712,MATH 142A,A01,083219,Chow; Bennett,0,0,32,32
1656010848712,MATH 142A,A02,083220,Chow; Bennett,7,0,32,25
1656010848712,MATH 142A,A03,093480,Staff,4,0,32,28
1656010848712,MATH 142A,B03,093481,Staff,3,0,32,29
1656010848712,MATH 142A,B04,093558,Staff,6,0,32,26
1656010848712,MATH 142A,B05,093559,Staff,0,0,32,32
1656010854735,MATH 193A,A01,083224,Rotar; Vladimir,1,1,34,33
1656010854735,MATH 193A,A02,083225,Rotar; Vladimir,0,0,34,34
1656010854735,MATH 193A,A03,083781,Rotar; Vladimir,2,0,34,32
1656010854735,MATH 193A,A04,083782,Rotar; Vladimir,3,0,34,31
1656010854735,MATH 193A,A05,093482,Rotar; Vladimir,0,0,34,34
1656010860760,MATH 197,001,091859,McAuley; Julian John,9999,0,9999,0
1656010860760,MATH 197,002,095566,Kedlaya; Kiran S.,9997,0,9999,2
1656010860760,MATH 197,003,095567,Xiao; Ming,9999,0,9999,0
1656010860760,MATH 197,004,095571,Perols; Johan Lars,9998,0,9999,1
1656010867825,COGS 9,A01,083615,Shannon; Kyle Michael,3,1,75,72
1656010873848,COGS 11,A01,083617,Boyle; Mary E. T.,11,1,48,37
1656010879874,COGS 13,A01,083071,Bastos; Amalia Pinkusfeld,4,2,71,67
1656010885898,COGS 14A,A01,092681,Semenuks; Arturs,4,25,100,96
1656010891922,COGS 14B,A01,083073,Cheng; Tzu-Han,7,0,63,56
1656010897961,COGS 17,A01,092677,Semenuks; Arturs,8,7,81,73
1656010903985,COGS 100,A01,083619,Allen; Michael Gordon,2,2,70,68
1656010910010,COGS 101A,A01,083621,Davis; Joshua Daniel,4,3,68,64
1656010916033,COGS 101B,A01,091572,Allen; Michael Gordon,0,0,65,65
1656010922070,COGS 101C,A01,083625,Delgado; Tania,7,0,35,28
1656010928096,COGS 107A,A01,083627,Boyle; Mary E. T.,1,2,60,59
1656010934126,COGS 118A,A01,083075,Gupta; Anjum,21,16,76,55
1656010940155,CSE 3,A50,083646,Miranda; Gregory Joseph,14,0,50,36
1656010946184,CSE 8A,A50,083650,Miranda; Gregory Joseph,3,11,56,53
1656010961504,CSE 11,A01,083080,Cao; Yingjun,0,65,40,40
1656010967539,CSE 12,A01,083652,Krause-Levy; Sophia Louisa,6,8,120,114
1656010973563,CSE 15L,A01,083654,Morris; Justin Loren,3,1,50,47
1656010973563,CSE 15L,A02,083655,Morris; Justin Loren,1,1,50,49
1656010979586,CSE 20,A01,083657,Tran; Khoa Dang,29,0,80,51
1656010985617,CSE 21,A01,095574,Bach; Quang Tran,23,0,48,25
1656010991645,CSE 30,A01,083084,Eldon; John,2,10,80,78
1656010991645,CSE 30,B01,095061,Bhaskar; Nishant,0,4,50,50
1656010997674,CSE 100,A01,083659,Cao; Yingjun,2,25,70,68
1656011003711,CSE 134B,A01,083661,Powell; Thomas Allan,6,7,100,94
1656011009736,CSE 140,A01,083663,Gungor; Onat,5,0,85,80
1656011015767,CSE 140L,A01,083088,Eldon; John,5,0,100,95
1656011021790,CSE 175,A01,083665,Kumar; Rakesh,1,0,25,24
1656011027812,CSE 190,A00,092507,Dubnov; Shlomo,1,0,20,19
1656011033843,ECE 45,A01,083139,Congero; Spencer William,0,1,75,75
1656011039874,ECE 65,A50,083695,Saad; Andrew S,6,0,30,24
1656011039874,ECE 65,A51,095125,Staff,23,0,26,3
1656011045910,ECE 109,A01,091882,Touri; Behrouz,3,5,70,67
1656011051938,ECE 180,A00,083140,Abi Samra; Nicholas Camill,1,0,30,29
1656011051938,ECE 180,B00,083141,Abi Samra; Nicholas Camill,0,8,28,28
1656011057961,MATH 10A,A01,083735,Patchell; Gregory David,0,0,30,30
1656011057961,MATH 10A,A02,083736,Patchell; Gregory David,21,0,30,9
1656011057961,MATH 10A,A03,083737,Patchell; Gregory David,16,0,30,14
1656011063987,MATH 10B,A01,083207,Lim; Seonhee,1,1,34,33
1656011063987,MATH 10B,A02,083208,Lim; Seonhee,1,1,35,34
1656011063987,MATH 10B,A03,093472,Staff,1,0,34,33
1656011063987,MATH 10B,B01,083739,Sinha; Shubham,9,0,30,21
1656011070012,MATH 18,A01,083743,Cinel; Cameron Alexander,5,0,30,25
1656011070012,MATH 18,A02,083744,Cinel; Cameron Alexander,11,0,30,19
1656011070012,MATH 18,A03,083745,Cinel; Cameron Alexander,1,0,30,29
1656011070012,MATH 18,B01,083748,Ma; Zilu,0,0,36,36
1656011070012,MATH 18,B02,083749,Ma; Zilu,0,0,36,36
1656011070012,MATH 18,B03,083750,Ma; Zilu,0,0,36,36
1656011070012,MATH 18,B04,083751,Ma; Zilu,0,0,36,36
1656011070012,MATH 18,B05,093473,Staff,0,0,36,36
1656011070012,MATH 18,B06,093474,Staff,3,0,36,33
1656011076048,MATH 20A,A01,083754,Zheng; Zequn,10,0,40,30
1656011082072,MATH 20B,A01,083756,Briones; Jor-el Thomas Caparas,0,1,36,36
1656011082072,MATH 20B,A02,083757,Briones; Jor-el Thomas Caparas,1,0,36,35
1656011082072,MATH 20B,A03,093475,Staff,0,0,36,36
1656011088100,MATH 20C,A01,083760,Briones; Jor-el Thomas Caparas,0,2,35,35
1656011088100,MATH 20C,A02,083761,Briones; Jor-el Thomas Caparas,6,1,35,29
1656011088100,MATH 20C,A03,093476,Staff,0,0,35,35
1656011088100,MATH 20C,B01,083762,Bach; Quang Tran,3,0,30,27
1656011094130,MATH 20D,A01,083765,Tran; Brian Kha,1,0,30,29
1656011094130,MATH 20D,A02,083766,Tran; Brian Kha,0,1,30,30
1656011094130,MATH 20D,A03,083767,Tran; Brian Kha,1,0,30,29
1656011100162,MATH 20E,A01,083771,Ganguly; Soumya,0,1,32,32
1656011100162,MATH 20E,A02,083772,Ganguly; Soumya,1,1,32,31
1656011100162,MATH 20E,B01,083773,Ciotti; Benjamin,14,0,35,21
1656011100162,MATH 20E,B02,083774,Ciotti; Benjamin,12,0,35,23
1656011106193,MATH 103A,A01,083777,Greenfeld; Be'Eri,2,1,36,34
1656011106193,MATH 103A,A02,083778,Greenfeld; Be'Eri,2,0,36,34
1656011106193,MATH 103A,A03,093561,Staff,0,1,36,36
1656011106193,MATH 103A,B01,083779,Greenfeld; Be'Eri,7,1,36,29
1656011106193,MATH 103A,B02,083780,Greenfeld; Be'Eri,0,0,36,36
1656011106193,MATH 103A,B03,093562,Staff,0,0,36,36
1656011112215,MATH 105,A01,085443,Carter; Anne Toulson,4,1,35,31
1656011112215,MATH 105,A02,093477,Staff,8,0,35,27
1656011118238,MATH 109,A01,083213,Ganzberger; Geoffrey Michael,0,1,34,34
1656011118238,MATH 109,A02,083214,Ganzberger; Geoffrey Michael,0,0,34,34
1656011118238,MATH 109,A03,093478,Staff,1,0,34,33
1656011118238,MATH 109,B01,083215,Ganzberger; Geoffrey Michael,2,0,32,30
1656011118238,MATH 109,B02,083216,Ganzberger; Geoffrey Michael,0,0,32,32
1656011118238,MATH 109,B03,093479,Staff,4,0,32,28
1656011124261,MATH 142A,A01,083219,Chow; Bennett,0,0,32,32
1656011124261,MATH 142A,A02,083220,Chow; Bennett,7,0,32,25
1656011124261,MATH 142A,A03,093480,Staff,4,0,32,28
1656011124261,MATH 142A,B03,093481,Staff,3,0,32,29
1656011124261,MATH 142A,B04,093558,Staff,6,0,32,26
1656011124261,MATH 142A,B05,093559,Staff,0,0,32,32
1656011130287,MATH 193A,A01,083224,Rotar; Vladimir,1,1,34,33
1656011130287,MATH 193A,A02,083225,Rotar; Vladimir,0,0,34,34
1656011130287,MATH 193A,A03,083781,Rotar; Vladimir,2,0,34,32
1656011130287,MATH 193A,A04,083782,Rotar; Vladimir,3,0,34,31
1656011130287,MATH 193A,A05,093482,Rotar; Vladimir,0,0,34,34
1656011136309,MATH 197,001,091859,McAuley; Julian John,9999,0,9999,0
1656011136309,MATH 197,002,095566,Kedlaya; Kiran S.,9997,0,9999,2
1656011136309,MATH 197,003,095567,Xiao; Ming,9999,0,9999,0
1656011136309,MATH 197,004,095571,Perols; Johan Lars,9998,0,9999,1
1656011143370,COGS 9,A01,083615,Shannon; Kyle Michael,3,1,75,72
1656011149396,COGS 11,A01,083617,Boyle; Mary E. T.,11,1,48,37
1656011155420,COGS 13,A01,083071,Bastos; Amalia Pinkusfeld,4,2,71,67
1656011161448,COGS 14A,A01,092681,Semenuks; Arturs,4,25,100,96
1656011167473,COGS 14B,A01,083073,Cheng; Tzu-Han,7,0,63,56
1656011173497,COGS 17,A01,092677,Semenuks; Arturs,8,7,81,73
1656011179521,COGS 100,A01,083619,Allen; Michael Gordon,2,2,70,68
1656011185642,COGS 101A,A01,083621,Davis; Joshua Daniel,4,3,68,64
1656011191671,COGS 101B,A01,091572,Allen; Michael Gordon,0,0,65,65
1656011197707,COGS 101C,A01,083625,Delgado; Tania,7,0,35,28
1656011203734,COGS 107A,A01,083627,Boyle; Mary E. T.,1,2,60,59
1656011209757,COGS 118A,A01,083075,Gupta; Anjum,21,16,76,55
1656011215784,CSE 3,A50,083646,Miranda; Gregory Joseph,14,0,50,36
1656011221811,CSE 8A,A50,083650,Miranda; Gregory Joseph,3,11,56,53
1656011227838,CSE 11,A01,083080,Cao; Yingjun,0,65,40,40
1656011233867,CSE 12,A01,083652,Krause-Levy; Sophia Louisa,6,8,120,114
1656011239891,CSE 15L,A01,083654,Morris; Justin Loren,3,1,50,47
1656011239891,CSE 15L,A02,083655,Morris; Justin Loren,1,1,50,49
1656011245916,CSE 20,A01,083657,Tran; Khoa Dang,29,0,80,51
1656011251944,CSE 21,A01,095574,Bach; Quang Tran,23,0,48,25
1656011257975,CSE 30,A01,083084,Eldon; John,2,10,80,78
1656011257975,CSE 30,B01,095061,Bhaskar; Nishant,0,4,50,50
1656011264000,CSE 100,A01,083659,Cao; Yingjun,2,25,70,68
1656011270025,CSE 134B,A01,083661,Powell; Thomas Allan,6,7,100,94
1656011276052,CSE 140,A01,083663,Gungor; Onat,5,0,85,80
1656011282076,CSE 140L,A01,083088,Eldon; John,5,0,100,95
1656011288099,CSE 175,A01,083665,Kumar; Rakesh,1,0,25,24
1656011294122,CSE 190,A00,092507,Dubnov; Shlomo,1,0,20,19
1656011300145,ECE 45,A01,083139,Congero; Spencer William,0,1,75,75
1656011306169,ECE 65,A50,083695,Saad; Andrew S,6,0,30,24
1656011306169,ECE 65,A51,095125,Staff,23,0,26,3
1656011312192,ECE 109,A01,091882,Touri; Behrouz,3,5,70,67
1656011318216,ECE 180,A00,083140,Abi Samra; Nicholas Camill,1,0,30,29
1656011318216,ECE 180,B00,083141,Abi Samra; Nicholas Camill,0,8,28,28
1656011324240,MATH 10A,A01,083735,Patchell; Gregory David,0,0,30,30
1656011324240,MATH 10A,A02,083736,Patchell; Gregory David,21,0,30,9
1656011324240,MATH 10A,A03,083737,Patchell; Gregory David,16,0,30,14
1656011330265,MATH 10B,A01,083207,Lim; Seonhee,1,1,34,33
1656011330265,MATH 10B,A02,083208,Lim; Seonhee,1,1,35,34
1656011330265,MATH 10B,A03,093472,Staff,1,0,34,33
1656011330265,MATH 10B,B01,083739,Sinha; Shubham,9,0,30,21
1656011336307,MATH 18,A01,083743,Cinel; Cameron Alexander,5,0,30,25
1656011336307,MATH 18,A02,083744,Cinel; Cameron Alexander,11,0,30,19
1656011336307,MATH 18,A03,083745,Cinel; Cameron Alexander,1,0,30,29
1656011336307,MATH 18,B01,083748,Ma; Zilu,0,0,36,36
1656011336307,MATH 18,B02,083749,Ma; Zilu,0,0,36,36
1656011336307,MATH 18,B03,083750,Ma; Zilu,0,0,36,36
1656011336307,MATH 18,B04,083751,Ma; Zilu,0,0,36,36
1656011336307,MATH 18,B05,093473,Staff,0,0,36,36
1656011336307,MATH 18,B06,093474,Staff,3,0,36,33
1656011342331,MATH 20A,A01,083754,Zheng; Zequn,10,0,40,30
1656011348360,MATH 20B,A01,083756,Briones; Jor-el Thomas Caparas,0,1,36,36
1656011348360,MATH 20B,A02,083757,Briones; Jor-el Thomas Caparas,1,0,36,35
1656011348360,MATH 20B,A03,093475,Staff,0,0,36,36
1656011354389,MATH 20C,A01,083760,Briones; Jor-el Thomas Caparas,0,2,35,35
1656011354389,MATH 20C,A02,083761,Briones; Jor-el Thomas Caparas,6,1,35,29
1656011354389,MATH 20C,A03,093476,Staff,0,0,35,35
1656011354389,MATH 20C,B01,083762,Bach; Quang Tran,3,0,30,27
1656011360428,MATH 20D,A01,083765,Tran; Brian Kha,1,0,30,29
1656011360428,MATH 20D,A02,083766,Tran; Brian Kha,0,1,30,30
1656011360428,MATH 20D,A03,083767,Tran; Brian Kha,1,0,30,29
1656011366466,MATH 20E,A01,083771,Ganguly; Soumya,0,1,32,32
1656011366466,MATH 20E,A02,083772,Ganguly; Soumya,1,1,32,31
1656011366466,MATH 20E,B01,083773,Ciotti; Benjamin,14,0,35,21
1656011366466,MATH 20E,B02,083774,Ciotti; Benjamin,12,0,35,23
1656011372488,MATH 103A,A01,083777,Greenfeld; Be'Eri,2,1,36,34
1656011372488,MATH 103A,A02,083778,Greenfeld; Be'Eri,2,0,36,34
1656011372488,MATH 103A,A03,093561,Staff,0,1,36,36
1656011372488,MATH 103A,B01,083779,Greenfeld; Be'Eri,7,1,36,29
1656011372488,MATH 103A,B02,083780,Greenfeld; Be'Eri,0,0,36,36
1656011372488,MATH 103A,B03,093562,Staff,0,0,36,36
1656011378512,MATH 105,A01,085443,Carter; Anne Toulson,4,1,35,31
1656011378512,MATH 105,A02,093477,Staff,8,0,35,27
1656011384541,MATH 109,A01,083213,Ganzberger; Geoffrey Michael,0,1,34,34
1656011384541,MATH 109,A02,083214,Ganzberger; Geoffrey Michael,0,0,34,34
1656011384541,MATH 109,A03,093478,Staff,1,0,34,33
1656011384541,MATH 109,B01,083215,Ganzberger; Geoffrey Michael,2,0,32,30
1656011384541,MATH 109,B02,083216,Ganzberger; Geoffrey Michael,0,0,32,32
1656011384541,MATH 109,B03,093479,Staff,4,0,32,28
1656011390565,MATH 142A,A01,083219,Chow; Bennett,0,0,32,32
1656011390565,MATH 142A,A02,083220,Chow; Bennett,7,0,32,25
1656011390565,MATH 142A,A03,093480,Staff,4,0,32,28
1656011390565,MATH 142A,B03,093481,Staff,3,0,32,29
1656011390565,MATH 142A,B04,093558,Staff,6,0,32,26
1656011390565,MATH 142A,B05,093559,Staff,0,0,32,32
1656011396593,MATH 193A,A01,083224,Rotar; Vladimir,1,1,34,33
1656011396593,MATH 193A,A02,083225,Rotar; Vladimir,0,0,34,34
1656011396593,MATH 193A,A03,083781,Rotar; Vladimir,2,0,34,32
1656011396593,MATH 193A,A04,083782,Rotar; Vladimir,3,0,34,31
1656011396593,MATH 193A,A05,093482,Rotar; Vladimir,0,0,34,34
1656011402622,MATH 197,001,091859,McAuley; Julian John,9999,0,9999,0
1656011402622,MATH 197,002,095566,Kedlaya; Kiran S.,9997,0,9999,2
1656011402622,MATH 197,003,095567,Xiao; Ming,9999,0,9999,0
1656011402622,MATH 197,004,095571,Perols; Johan Lars,9998,0,9999,1
1656011409686,COGS 9,A01,083615,Shannon; Kyle Michael,3,1,75,72
1656011415711,COGS 11,A01,083617,Boyle; Mary E. T.,11,1,48,37
1656011421735,COGS 13,A01,083071,Bastos; Amalia Pinkusfeld,4,2,71,67
1656011427762,COGS 14A,A01,092681,Semenuks; Arturs,4,25,100,96
1656011433786,COGS 14B,A01,083073,Cheng; Tzu-Han,7,0,63,56
1656011439810,COGS 17,A01,092677,Semenuks; Arturs,8,7,81,73
1656011445833,COGS 100,A01,083619,Allen; Michael Gordon,2,2,70,68
1656011451861,COGS 101A,A01,083621,Davis; Joshua Daniel,4,3,68,64
1656011457889,COGS 101B,A01,091572,Allen; Michael Gordon,0,0,65,65
1656011463920,COGS 101C,A01,083625,Delgado; Tania,7,0,35,28
1656011469944,COGS 107A,A01,083627,Boyle; Mary E. T.,1,2,60,59
1656011475971,COGS 118A,A01,083075,Gupta; Anjum,21,16,76,55
1656011482004,CSE 3,A50,083646,Miranda; Gregory Joseph,14,0,50,36
1656011488032,CSE 8A,A50,083650,Miranda; Gregory Joseph,3,11,56,53
1656011494065,CSE 11,A01,083080,Cao; Yingjun,0,65,40,40
1656011500098,CSE 12,A01,083652,Krause-Levy; Sophia Louisa,6,8,120,114
1656011506126,CSE 15L,A01,083654,Morris; Justin Loren,3,1,50,47
1656011506126,CSE 15L,A02,083655,Morris; Justin Loren,1,1,50,49
1656011512155,CSE 20,A01,083657,Tran; Khoa Dang,29,0,80,51
1656011518179,CSE 21,A01,095574,Bach; Quang Tran,23,0,48,25
1656011524203,CSE 30,A01,083084,Eldon; John,2,10,80,78
1656011524203,CSE 30,B01,095061,Bhaskar; Nishant,0,4,50,50
1656011530231,CSE 100,A01,083659,Cao; Yingjun,2,25,70,68
1656011536257,CSE 134B,A01,083661,Powell; Thomas Allan,6,7,100,94
1656011542295,CSE 140,A01,083663,Gungor; Onat,5,0,85,80
1656011548324,CSE 140L,A01,083088,Eldon; John,5,0,100,95
1656011554349,CSE 175,A01,083665,Kumar; Rakesh,1,0,25,24
1656011560378,CSE 190,A00,092507,Dubnov; Shlomo,1,0,20,19
1656011566415,ECE 45,A01,083139,Congero; Spencer William,0,1,75,75
1656011572439,ECE 65,A50,083695,Saad; Andrew S,6,0,30,24
1656011572439,ECE 65,A51,095125,Staff,23,0,26,3
1656011578468,ECE 109,A01,091882,Touri; Behrouz,3,5,70,67
1656011584494,ECE 180,A00,083140,Abi Samra; Nicholas Camill,1,0,30,29
1656011584494,ECE 180,B00,083141,Abi Samra; Nicholas Camill,0,8,28,28
1656011590522,MATH 10A,A01,083735,Patchell; Gregory David,0,0,30,30
1656011590522,MATH 10A,A02,083736,Patchell; Gregory David,21,0,30,9
1656011590522,MATH 10A,A03,083737,Patchell; Gregory David,16,0,30,14
1656011596550,MATH 10B,A01,083207,Lim; Seonhee,1,1,34,33
1656011596550,MATH 10B,A02,083208,Lim; Seonhee,1,1,35,34
1656011596550,MATH 10B,A03,093472,Staff,1,0,34,33
1656011596550,MATH 10B,B01,083739,Sinha; Shubham,9,0,30,21
1656011602580,MATH 18,A01,083743,Cinel; Cameron Alexander,5,0,30,25
1656011602580,MATH 18,A02,083744,Cinel; Cameron Alexander,11,0,30,19
1656011602580,MATH 18,A03,083745,Cinel; Cameron Alexander,1,0,30,29
1656011602580,MATH 18,B01,083748,Ma; Zilu,0,0,36,36
1656011602580,MATH 18,B02,083749,Ma; Zilu,0,0,36,36
1656011602580,MATH 18,B03,083750,Ma; Zilu,0,0,36,36
1656011602580,MATH 18,B04,083751,Ma; Zilu,0,0,36,36
1656011602580,MATH 18,B05,093473,Staff,0,0,36,36
1656011602580,MATH 18,B06,093474,Staff,3,0,36,33
1656011608603,MATH 20A,A01,083754,Zheng; Zequn,10,0,40,30
1656011614627,MATH 20B,A01,083756,Briones; Jor-el Thomas Caparas,0,1,36,36
1656011614627,MATH 20B,A02,083757,Briones; Jor-el Thomas Caparas,1,0,36,35
1656011614627,MATH 20B,A03,093475,Staff,0,0,36,36
1656011620662,MATH 20C,A01,083760,Briones; Jor-el Thomas Caparas,0,2,35,35
1656011620662,MATH 20C,A02,083761,Briones; Jor-el Thomas Caparas,6,1,35,29
1656011620662,MATH 20C,A03,093476,Staff,0,0,35,35
1656011620662,MATH 20C,B01,083762,Bach; Quang Tran,3,0,30,27
1656011626689,MATH 20D,A01,083765,Tran; Brian Kha,1,0,30,29
1656011626689,MATH 20D,A02,083766,Tran; Brian Kha,0,1,30,30
1656011626689,MATH 20D,A03,083767,Tran; Brian Kha,1,0,30,29
1656011632717,MATH 20E,A01,083771,Ganguly; Soumya,0,1,32,32
1656011632717,MATH 20E,A02,083772,Ganguly; Soumya,1,1,32,31
1656011632717,MATH 20E,B01,083773,Ciotti; Benjamin,14,0,35,21
1656011632717,MATH 20E,B02,083774,Ciotti; Benjamin,12,0,35,23
1656011638742,MATH 103A,A01,083777,Greenfeld; Be'Eri,2,1,36,34
1656011638742,MATH 103A,A02,083778,Greenfeld; Be'Eri,2,0,36,34
1656011638742,MATH 103A,A03,093561,Staff,0,1,36,36
1656011638742,MATH 103A,B01,083779,Greenfeld; Be'Eri,7,1,36,29
1656011638742,MATH 103A,B02,083780,Greenfeld; Be'Eri,0,0,36,36
1656011638742,MATH 103A,B03,093562,Staff,0,0,36,36
1656011644764,MATH 105,A01,085443,Carter; Anne Toulson,4,1,35,31
1656011644764,MATH 105,A02,093477,Staff,8,0,35,27
1656011650792,MATH 109,A01,083213,Ganzberger; Geoffrey Michael,0,1,34,34
1656011650792,MATH 109,A02,083214,Ganzberger; Geoffrey Michael,0,0,34,34
1656011650792,MATH 109,A03,093478,Staff,1,0,34,33
1656011650792,MATH 109,B01,083215,Ganzberger; Geoffrey Michael,2,0,32,30
1656011650792,MATH 109,B02,083216,Ganzberger; Geoffrey Michael,0,0,32,32
1656011650792,MATH 109,B03,093479,Staff,4,0,32,28
1656011656821,MATH 142A,A01,083219,Chow; Bennett,0,0,32,32
1656011656821,MATH 142A,A02,083220,Chow; Bennett,7,0,32,25
1656011656821,MATH 142A,A03,093480,Staff,4,0,32,28
1656011656821,MATH 142A,B03,093481,Staff,3,0,32,29
1656011656821,MATH 142A,B04,093558,Staff,6,0,32,26
1656011656821,MATH 142A,B05,093559,Staff,0,0,32,32
1656011662845,MATH 193A,A01,083224,Rotar; Vladimir,1,1,34,33
1656011662845,MATH 193A,A02,083225,Rotar; Vladimir,0,0,34,34
1656011662845,MATH 193A,A03,083781,Rotar; Vladimir,2,0,34,32
1656011662845,MATH 193A,A04,083782,Rotar; Vladimir,3,0,34,31
1656011662845,MATH 193A,A05,093482,Rotar; Vladimir,0,0,34,34
1656011668868,MATH 197,001,091859,McAuley; Julian John,9999,0,9999,0
1656011668868,MATH 197,002,095566,Kedlaya; Kiran S.,9997,0,9999,2
1656011668868,MATH 197,003,095567,Xiao; Ming,9999,0,9999,0
1656011668868,MATH 197,004,095571,Perols; Johan Lars,9998,0,9999,1
1656011675922,COGS 9,A01,083615,Shannon; Kyle Michael,3,1,75,72
1656011681955,COGS 11,A01,083617,Boyle; Mary E. T.,11,1,48,37
1656011687985,COGS 13,A01,083071,Bastos; Amalia Pinkusfeld,4,2,71,67
1656011694016,COGS 14A,A01,092681,Semenuks; Arturs,4,25,100,96
1656011700049,COGS 14B,A01,083073,Cheng; Tzu-Han,7,0,63,56
1656011706071,COGS 17,A01,092677,Semenuks; Arturs,8,7,81,73
1656011712095,COGS 100,A01,083619,Allen; Michael Gordon,2,2,70,68
1656011718121,COGS 101A,A01,083621,Davis; Joshua Daniel,4,3,68,64
1656011724145,COGS 101B,A01,091572,Allen; Michael Gordon,0,0,65,65
1656011730181,COGS 101C,A01,083625,Delgado; Tania,7,0,35,28
1656011736211,COGS 107A,A01,083627,Boyle; Mary E. T.,1,2,60,59
1656011742235,COGS 118A,A01,083075,Gupta; Anjum,21,16,76,55
1656011748262,CSE 3,A50,083646,Miranda; Gregory Joseph,14,0,50,36
1656011754291,CSE 8A,A50,083650,Miranda; Gregory Joseph,3,11,56,53
1656011760314,CSE 11,A01,083080,Cao; Yingjun,0,65,40,40
1656011766342,CSE 12,A01,083652,Krause-Levy; Sophia Louisa,6,8,120,114
1656011772367,CSE 15L,A01,083654,Morris; Justin Loren,3,1,50,47
1656011772367,CSE 15L,A02,083655,Morris; Justin Loren,1,1,50,49
1656011778391,CSE 20,A01,083657,Tran; Khoa Dang,29,0,80,51
1656011784507,CSE 21,A01,095574,Bach; Quang Tran,23,0,48,25
1656011790534,CSE 30,A01,083084,Eldon; John,2,10,80,78
1656011790534,CSE 30,B01,095061,Bhaskar; Nishant,0,4,50,50
1656011796569,CSE 100,A01,083659,Cao; Yingjun,2,25,70,68
1656011802596,CSE 134B,A01,083661,Powell; Thomas Allan,6,7,100,94
1656011808618,CSE 140,A01,083663,Gungor; Onat,5,0,85,80
1656011814656,CSE 140L,A01,083088,Eldon; John,5,0,100,95
1656011820683,CSE 175,A01,083665,Kumar; Rakesh,1,0,25,24
1656011826708,CSE 190,A00,092507,Dubnov; Shlomo,1,0,20,19
1656011832736,ECE 45,A01,083139,Congero; Spencer William,0,1,75,75
1656011838760,ECE 65,A50,083695,Saad; Andrew S,6,0,30,24
1656011838760,ECE 65,A51,095125,Staff,23,0,26,3
1656011844789,ECE 109,A01,091882,Touri; Behrouz,3,5,70,67
1656011850813,ECE 180,A00,083140,Abi Samra; Nicholas Camill,1,0,30,29
1656011850813,ECE 180,B00,083141,Abi Samra; Nicholas Camill,0,8,28,28
1656011856849,MATH 10A,A01,083735,Patchell; Gregory David,0,0,30,30
1656011856849,MATH 10A,A02,083736,Patchell; Gregory David,21,0,30,9
1656011856849,MATH 10A,A03,083737,Patchell; Gregory David,16,0,30,14
1656011862913,MATH 10B,A01,083207,Lim; Seonhee,1,1,34,33
1656011862913,MATH 10B,A02,083208,Lim; Seonhee,1,1,35,34
1656011862913,MATH 10B,A03,093472,Staff,1,0,34,33
1656011862913,MATH 10B,B01,083739,Sinha; Shubham,9,0,30,21
1656011868937,MATH 18,A01,083743,Cinel; Cameron Alexander,5,0,30,25
1656011868937,MATH 18,A02,083744,Cinel; Cameron Alexander,11,0,30,19
1656011868937,MATH 18,A03,083745,Cinel; Cameron Alexander,1,0,30,29
1656011868937,MATH 18,B01,083748,Ma; Zilu,0,0,36,36
1656011868937,MATH 18,B02,083749,Ma; Zilu,0,0,36,36
1656011868937,MATH 18,B03,083750,Ma; Zilu,0,0,36,36
1656011868937,MATH 18,B04,083751,Ma; Zilu,0,0,36,36
1656011868937,MATH 18,B05,093473,Staff,0,0,36,36
1656011868937,MATH 18,B06,093474,Staff,3,0,36,33
1656011874961,MATH 20A,A01,083754,Zheng; Zequn,10,0,40,30
1656011881002,MATH 20B,A01,083756,Briones; Jor-el Thomas Caparas,0,1,36,36
1656011881002,MATH 20B,A02,083757,Briones; Jor-el Thomas Caparas,1,0,36,35
1656011881002,MATH 20B,A03,093475,Staff,0,0,36,36
1656011887027,MATH 20C,A01,083760,Briones; Jor-el Thomas Caparas,0,2,35,35
1656011887027,MATH 20C,A02,083761,Briones; Jor-el Thomas Caparas,6,1,35,29
1656011887027,MATH 20C,A03,093476,Staff,0,0,35,35
1656011887027,MATH 20C,B01,083762,Bach; Quang Tran,3,0,30,27
1656011893051,MATH 20D,A01,083765,Tran; Brian Kha,1,0,30,29
1656011893051,MATH 20D,A02,083766,Tran; Brian Kha,0,1,30,30
1656011893051,MATH 20D,A03,083767,Tran; Brian Kha,1,0,30,29
1656011899079,MATH 20E,A01,083771,Ganguly; Soumya,0,1,32,32
1656011899079,MATH 20E,A02,083772,Ganguly; Soumya,1,1,32,31
1656011899079,MATH 20E,B01,083773,Ciotti; Benjamin,14,0,35,21
1656011899079,MATH 20E,B02,083774,Ciotti; Benjamin,12,0,35,23
1656011905104,MATH 103A,A01,083777,Greenfeld; Be'Eri,2,1,36,34
1656011905104,MATH 103A,A02,083778,Greenfeld; Be'Eri,2,0,36,34
1656011905104,MATH 103A,A03,093561,Staff,0,1,36,36
1656011905104,MATH 103A,B01,083779,Greenfeld; Be'Eri,7,1,36,29
1656011905104,MATH 103A,B02,083780,Greenfeld; Be'Eri,0,0,36,36
1656011905104,MATH 103A,B03,093562,Staff,0,0,36,36
1656011911132,MATH 105,A01,085443,Carter; Anne Toulson,4,1,35,31
1656011911132,MATH 105,A02,093477,Staff,8,0,35,27
1656011917156,MATH 109,A01,083213,Ganzberger; Geoffrey Michael,0,1,34,34
1656011917156,MATH 109,A02,083214,Ganzberger; Geoffrey Michael,0,0,34,34
1656011917156,MATH 109,A03,093478,Staff,1,0,34,33
1656011917156,MATH 109,B01,083215,Ganzberger; Geoffrey Michael,2,0,32,30
1656011917156,MATH 109,B02,083216,Ganzberger; Geoffrey Michael,0,0,32,32
1656011917156,MATH 109,B03,093479,Staff,4,0,32,28
1656011923180,MATH 142A,A01,083219,Chow; Bennett,0,0,32,32
1656011923180,MATH 142A,A02,083220,Chow; Bennett,7,0,32,25
1656011923180,MATH 142A,A03,093480,Staff,4,0,32,28
1656011923180,MATH 142A,B03,093481,Staff,3,0,32,29
1656011923180,MATH 142A,B04,093558,Staff,6,0,32,26
1656011923180,MATH 142A,B05,093559,Staff,0,0,32,32
1656011929204,MATH 193A,A01,083224,Rotar; Vladimir,1,1,34,33
1656011929204,MATH 193A,A02,083225,Rotar; Vladimir,0,0,34,34
1656011929204,MATH 193A,A03,083781,Rotar; Vladimir,2,0,34,32
1656011929204,MATH 193A,A04,083782,Rotar; Vladimir,3,0,34,31
1656011929204,MATH 193A,A05,093482,Rotar; Vladimir,0,0,34,34
1656011935227,MATH 197,001,091859,McAuley; Julian John,9999,0,9999,0
1656011935227,MATH 197,002,095566,Kedlaya; Kiran S.,9997,0,9999,2
1656011935227,MATH 197,003,095567,Xiao; Ming,9999,0,9999,0
1656011935227,MATH 197,004,095571,Perols; Johan Lars,9998,0,9999,1
1656011942287,COGS 9,A01,083615,Shannon; Kyle Michael,3,1,75,72
1656011948311,COGS 11,A01,083617,Boyle; Mary E. T.,11,1,48,37
1656011954335,COGS 13,A01,083071,Bastos; Amalia Pinkusfeld,4,2,71,67
1656011960366,COGS 14A,A01,092681,Semenuks; Arturs,4,25,100,96
1656011966391,COGS 14B,A01,083073,Cheng; Tzu-Han,7,0,63,56
1656011972415,COGS 17,A01,092677,Semenuks; Arturs,8,7,81,73
1656011978444,COGS 100,A01,083619,Allen; Michael Gordon,2,2,70,68
1656011984467,COGS 101A,A01,083621,Davis; Joshua Daniel,4,3,68,64
1656011990503,COGS 101B,A01,091572,Allen; Michael Gordon,0,0,65,65
1656011996529,COGS 101C,A01,083625,Delgado; Tania,7,0,35,28
1656012002556,COGS 107A,A01,083627,Boyle; Mary E. T.,1,2,60,59
1656012008599,COGS 118A,A01,083075,Gupta; Anjum,21,16,76,55
1656012014623,CSE 3,A50,083646,Miranda; Gregory Joseph,14,0,50,36
1656012020647,CSE 8A,A50,083650,Miranda; Gregory Joseph,3,11,56,53
1656012026674,CSE 11,A01,083080,Cao; Yingjun,0,65,40,40
1656012032703,CSE 12,A01,083652,Krause-Levy; Sophia Louisa,6,8,120,114
1656012038727,CSE 15L,A01,083654,Morris; Justin Loren,3,1,50,47
1656012038727,CSE 15L,A02,083655,Morris; Justin Loren,1,1,50,49
1656012044768,CSE 20,A01,083657,Tran; Khoa Dang,29,0,80,51
1656012050792,CSE 21,A01,095574,Bach; Quang Tran,23,0,48,25
1656012056824,CSE 30,A01,083084,Eldon; John,2,10,80,78
1656012056824,CSE 30,B01,095061,Bhaskar; Nishant,0,4,50,50
1656012062857,CSE 100,A01,083659,Cao; Yingjun,2,25,70,68
1656012068898,CSE 134B,A01,083661,Powell; Thomas Allan,6,7,100,94
1656012074923,CSE 140,A01,083663,Gungor; Onat,5,0,85,80
1656012080950,CSE 140L,A01,083088,Eldon; John,5,0,100,95
1656012086977,CSE 175,A01,083665,Kumar; Rakesh,1,0,25,24
1656012093003,CSE 190,A00,092507,Dubnov; Shlomo,1,0,20,19
1656012099040,ECE 45,A01,083139,Congero; Spencer William,0,1,75,75
1656012105063,ECE 65,A50,083695,Saad; Andrew S,6,0,30,24
1656012105063,ECE 65,A51,095125,Staff,23,0,26,3
1656012111089,ECE 109,A01,091882,Touri; Behrouz,3,5,70,67
1656012117116,ECE 180,A00,083140,Abi Samra; Nicholas Camill,1,0,30,29
1656012117116,ECE 180,B00,083141,Abi Samra; Nicholas Camill,0,8,28,28
1656012123151,MATH 10A,A01,083735,Patchell; Gregory David,0,0,30,30
1656012123151,MATH 10A,A02,083736,Patchell; Gregory David,21,0,30,9
1656012123151,MATH 10A,A03,083737,Patchell; Gregory David,16,0,30,14
1656012129184,MATH 10B,A01,083207,Lim; Seonhee,1,1,34,33
1656012129184,MATH 10B,A02,083208,Lim; Seonhee,1,1,35,34
1656012129184,MATH 10B,A03,093472,Staff,1,0,34,33
1656012129184,MATH 10B,B01,083739,Sinha; Shubham,9,0,30,21
1656012135220,MATH 18,A01,083743,Cinel; Cameron Alexander,5,0,30,25
1656012135220,MATH 18,A02,083744,Cinel; Cameron Alexander,11,0,30,19
1656012135220,MATH 18,A03,083745,Cinel; Cameron Alexander,1,0,30,29
1656012135220,MATH 18,B01,083748,Ma; Zilu,0,0,36,36
1656012135220,MATH 18,B02,083749,Ma; Zilu,0,0,36,36
1656012135220,MATH 18,B03,083750,Ma; Zilu,0,0,36,36
1656012135220,MATH 18,B04,083751,Ma; Zilu,0,0,36,36
1656012135220,MATH 18,B05,093473,Staff,0,0,36,36
1656012135220,MATH 18,B06,093474,Staff,3,0,36,33
1656012141246,MATH 20A,A01,083754,Zheng; Zequn,10,0,40,30
1656012147282,MATH 20B,A01,083756,Briones; Jor-el Thomas Caparas,0,1,36,36
1656012147282,MATH 20B,A02,083757,Briones; Jor-el Thomas Caparas,1,0,36,35
1656012147282,MATH 20B,A03,093475,Staff,0,0,36,36
1656012153310,MATH 20C,A01,083760,Briones; Jor-el Thomas Caparas,0,2,35,35
1656012153310,MATH 20C,A02,083761,Briones; Jor-el Thomas Caparas,6,1,35,29
1656012153310,MATH 20C,A03,093476,Staff,0,0,35,35
1656012153310,MATH 20C,B01,083762,Bach; Quang Tran,3,0,30,27
1656012159336,MATH 20D,A01,083765,Tran; Brian Kha,1,0,30,29
1656012159336,MATH 20D,A02,083766,Tran; Brian Kha,0,1,30,30
1656012159336,MATH 20D,A03,083767,Tran; Brian Kha,1,0,30,29
1656012165364,MATH 20E,A01,083771,Ganguly; Soumya,0,1,32,32
1656012165364,MATH 20E,A02,083772,Ganguly; Soumya,1,1,32,31
1656012165364,MATH 20E,B01,083773,Ciotti; Benjamin,14,0,35,21
1656012165364,MATH 20E,B02,083774,Ciotti; Benjamin,12,0,35,23
1656012171400,MATH 103A,A01,083777,Greenfeld; Be'Eri,2,1,36,34
1656012171400,MATH 103A,A02,083778,Greenfeld; Be'Eri,2,0,36,34
1656012171400,MATH 103A,A03,093561,Staff,0,1,36,36
1656012171400,MATH 103A,B01,083779,Greenfeld; Be'Eri,7,1,36,29
1656012171400,MATH 103A,B02,083780,Greenfeld; Be'Eri,0,0,36,36
1656012171400,MATH 103A,B03,093562,Staff,0,0,36,36
1656012177427,MATH 105,A01,085443,Carter; Anne Toulson,4,1,35,31
1656012177427,MATH 105,A02,093477,Staff,8,0,35,27
1656012183451,MATH 109,A01,083213,Ganzberger; Geoffrey Michael,0,1,34,34
1656012183451,MATH 109,A02,083214,Ganzberger; Geoffrey Michael,0,0,34,34
1656012183451,MATH 109,A03,093478,Staff,1,0,34,33
1656012183451,MATH 109,B01,083215,Ganzberger; Geoffrey Michael,2,0,32,30
1656012183451,MATH 109,B02,083216,Ganzberger; Geoffrey Michael,0,0,32,32
1656012183451,MATH 109,B03,093479,Staff,4,0,32,28
1656012189487,MATH 142A,A01,083219,Chow; Bennett,0,0,32,32
1656012189487,MATH 142A,A02,083220,Chow; Bennett,7,0,32,25
1656012189487,MATH 142A,A03,093480,Staff,4,0,32,28
1656012189487,MATH 142A,B03,093481,Staff,3,0,32,29
1656012189487,MATH 142A,B04,093558,Staff,6,0,32,26
1656012189487,MATH 142A,B05,093559,Staff,0,0,32,32
1656012195510,MATH 193A,A01,083224,Rotar; Vladimir,1,1,34,33
1656012195510,MATH 193A,A02,083225,Rotar; Vladimir,0,0,34,34
1656012195510,MATH 193A,A03,083781,Rotar; Vladimir,2,0,34,32
1656012195510,MATH 193A,A04,083782,Rotar; Vladimir,3,0,34,31
1656012195510,MATH 193A,A05,093482,Rotar; Vladimir,0,0,34,34
1656012201533,MATH 197,001,091859,McAuley; Julian John,9999,0,9999,0
1656012201533,MATH 197,002,095566,Kedlaya; Kiran S.,9997,0,9999,2
1656012201533,MATH 197,003,095567,Xiao; Ming,9999,0,9999,0
1656012201533,MATH 197,004,095571,Perols; Johan Lars,9998,0,9999,1
1656012208584,COGS 9,A01,083615,Shannon; Kyle Michael,3,1,75,72
1656012214606,COGS 11,A01,083617,Boyle; Mary E. T.,11,1,48,37
1656012220630,COGS 13,A01,083071,Bastos; Amalia Pinkusfeld,4,2,71,67
1656012226653,COGS 14A,A01,092681,Semenuks; Arturs,4,25,100,96
1656012232679,COGS 14B,A01,083073,Cheng; Tzu-Han,7,0,63,56
1656012238702,COGS 17,A01,092677,Semenuks; Arturs,8,7,81,73
1656012244734,COGS 100,A01,083619,Allen; Michael Gordon,2,2,70,68
1656012250759,COGS 101A,A01,083621,Davis; Joshua Daniel,4,3,68,64
1656012256782,COGS 101B,A01,091572,Allen; Michael Gordon,0,0,65,65
1656012262806,COGS 101C,A01,083625,Delgado; Tania,7,0,35,28
1656012268830,COGS 107A,A01,083627,Boyle; Mary E. T.,1,2,60,59
1656012274866,COGS 118A,A01,083075,Gupta; Anjum,21,16,76,55
1656012280890,CSE 3,A50,083646,Miranda; Gregory Joseph,14,0,50,36
1656012286915,CSE 8A,A50,083650,Miranda; Gregory Joseph,3,11,56,53
1656012292942,CSE 11,A01,083080,Cao; Yingjun,0,65,40,40
1656012298972,CSE 12,A01,083652,Krause-Levy; Sophia Louisa,6,8,120,114
1656012304997,CSE 15L,A01,083654,Morris; Justin Loren,3,1,50,47
1656012304997,CSE 15L,A02,083655,Morris; Justin Loren,1,1,50,49
1656012311023,CSE 20,A01,083657,Tran; Khoa Dang,29,0,80,51
1656012317055,CSE 21,A01,095574,Bach; Quang Tran,23,0,48,25
1656012323084,CSE 30,A01,083084,Eldon; John,2,10,80,78
1656012323084,CSE 30,B01,095061,Bhaskar; Nishant,0,4,50,50
1656012329108,CSE 100,A01,083659,Cao; Yingjun,2,25,70,68
1656012335130,CSE 134B,A01,083661,Powell; Thomas Allan,6,7,100,94
1656012341155,CSE 140,A01,083663,Gungor; Onat,5,0,85,80
1656012347179,CSE 140L,A01,083088,Eldon; John,5,0,100,95
1656012353206,CSE 175,A01,083665,Kumar; Rakesh,1,0,25,24
1656012359242,CSE 190,A00,092507,Dubnov; Shlomo,1,0,20,19
1656012365265,ECE 45,A01,083139,Congero; Spencer William,0,1,75,75
1656012371305,ECE 65,A50,083695,Saad; Andrew S,6,0,30,24
1656012371305,ECE 65,A51,095125,Staff,23,0,26,3
1656012377331,ECE 109,A01,091882,Touri; Behrouz,3,5,70,67
1656012383448,ECE 180,A00,083140,Abi Samra; Nicholas Camill,1,0,30,29
1656012383448,ECE 180,B00,083141,Abi Samra; Nicholas Camill,0,8,28,28
1656012389476,MATH 10A,A01,083735,Patchell; Gregory David,0,0,30,30
1656012389476,MATH 10A,A02,083736,Patchell; Gregory David,21,0,30,9
1656012389476,MATH 10A,A03,083737,Patchell; Gregory David,16,0,30,14
1656012395504,MATH 10B,A01,083207,Lim; Seonhee,1,1,34,33
1656012395504,MATH 10B,A02,083208,Lim; Seonhee,1,1,35,34
1656012395504,MATH 10B,A03,093472,Staff,1,0,34,33
1656012395504,MATH 10B,B01,083739,Sinha; Shubham,9,0,30,21
1656012401534,MATH 18,A01,083743,Cinel; Cameron Alexander,5,0,30,25
1656012401534,MATH 18,A02,083744,Cinel; Cameron Alexander,11,0,30,19
1656012401534,MATH 18,A03,083745,Cinel; Cameron Alexander,1,0,30,29
1656012401534,MATH 18,B01,083748,Ma; Zilu,0,0,36,36
1656012401534,MATH 18,B02,083749,Ma; Zilu,0,0,36,36
1656012401534,MATH 18,B03,083750,Ma; Zilu,0,0,36,36
1656012401534,MATH 18,B04,083751,Ma; Zilu,0,0,36,36
1656012401534,MATH 18,B05,093473,Staff,0,0,36,36
1656012401534,MATH 18,B06,093474,Staff,3,0,36,33
1656012407564,MATH 20A,A01,083754,Zheng; Zequn,10,0,40,30
1656012413591,MATH 20B,A01,083756,Briones; Jor-el Thomas Caparas,0,1,36,36
1656012413591,MATH 20B,A02,083757,Briones; Jor-el Thomas Caparas,1,0,36,35
1656012413591,MATH 20B,A03,093475,Staff,0,0,36,36
1656012419628,MATH 20C,A01,083760,Briones; Jor-el Thomas Caparas,0,2,35,35
1656012419628,MATH 20C,A02,083761,Briones; Jor-el Thomas Caparas,6,1,35,29
1656012419628,MATH 20C,A03,093476,Staff,0,0,35,35
1656012419628,MATH 20C,B01,083762,Bach; Quang Tran,3,0,30,27
1656012425657,MATH 20D,A01,083765,Tran; Brian Kha,1,0,30,29
1656012425657,MATH 20D,A02,083766,Tran; Brian Kha,0,1,30,30
1656012425657,MATH 20D,A03,083767,Tran; Brian Kha,1,0,30,29
1656012431683,MATH 20E,A01,083771,Ganguly; Soumya,0,1,32,32
1656012431683,MATH 20E,A02,083772,Ganguly; Soumya,1,1,32,31
1656012431683,MATH 20E,B01,083773,Ciotti; Benjamin,14,0,35,21
1656012431683,MATH 20E,B02,083774,Ciotti; Benjamin,12,0,35,23
1656012437708,MATH 103A,A01,083777,Greenfeld; Be'Eri,2,1,36,34
1656012437708,MATH 103A,A02,083778,Greenfeld; Be'Eri,2,0,36,34
1656012437708,MATH 103A,A03,093561,Staff,0,1,36,36
1656012437708,MATH 103A,B01,083779,Greenfeld; Be'Eri,7,1,36,29
1656012437708,MATH 103A,B02,083780,Greenfeld; Be'Eri,0,0,36,36
1656012437708,MATH 103A,B03,093562,Staff,0,0,36,36
1656012443732,MATH 105,A01,085443,Carter; Anne Toulson,4,1,35,31
1656012443732,MATH 105,A02,093477,Staff,8,0,35,27
1656012449761,MATH 109,A01,083213,Ganzberger; Geoffrey Michael,0,1,34,34
1656012449761,MATH 109,A02,083214,Ganzberger; Geoffrey Michael,0,0,34,34
1656012449761,MATH 109,A03,093478,Staff,1,0,34,33
1656012449761,MATH 109,B01,083215,Ganzberger; Geoffrey Michael,2,0,32,30
1656012449761,MATH 109,B02,083216,Ganzberger; Geoffrey Michael,0,0,32,32
1656012449761,MATH 109,B03,093479,Staff,4,0,32,28
1656012455791,MATH 142A,A01,083219,Chow; Bennett,0,0,32,32
1656012455791,MATH 142A,A02,083220,Chow; Bennett,7,0,32,25
1656012455791,MATH 142A,A03,093480,Staff,4,0,32,28
1656012455791,MATH 142A,B03,093481,Staff,3,0,32,29
1656012455791,MATH 142A,B04,093558,Staff,6,0,32,26
1656012455791,MATH 142A,B05,093559,Staff,0,0,32,32
1656012461820,MATH 193A,A01,083224,Rotar; Vladimir,1,1,34,33
1656012461820,MATH 193A,A02,083225,Rotar; Vladimir,0,0,34,34
1656012461820,MATH 193A,A03,083781,Rotar; Vladimir,2,0,34,32
1656012461820,MATH 193A,A04,083782,Rotar; Vladimir,3,0,34,31
1656012461820,MATH 193A,A05,093482,Rotar; Vladimir,0,0,34,34
1656012467843,MATH 197,001,091859,McAuley; Julian John,9999,0,9999,0
1656012467843,MATH 197,002,095566,Kedlaya; Kiran S.,9997,0,9999,2
1656012467843,MATH 197,003,095567,Xiao; Ming,9999,0,9999,0
1656012467843,MATH 197,004,095571,Perols; Johan Lars,9998,0,9999,1
1656012474897,COGS 9,A01,083615,Shannon; Kyle Michael,3,1,75,72
1656012480919,COGS 11,A01,083617,Boyle; Mary E. T.,11,1,48,37
1656012486944,COGS 13,A01,083071,Bastos; Amalia Pinkusfeld,4,2,71,67
1656012492970,COGS 14A,A01,092681,Semenuks; Arturs,4,25,100,96
1656012498993,COGS 14B,A01,083073,Cheng; Tzu-Han,7,0,63,56
1656012505027,COGS 17,A01,092677,Semenuks; Arturs,8,7,81,73
1656012511059,COGS 100,A01,083619,Allen; Michael Gordon,2,2,70,68
1656012517082,COGS 101A,A01,083621,Davis; Joshua Daniel,4,3,68,64
1656012523117,COGS 101B,A01,091572,Allen; Michael Gordon,0,0,65,65
1656012529145,COGS 101C,A01,083625,Delgado; Tania,7,0,35,28
1656012535169,COGS 107A,A01,083627,Boyle; Mary E. T.,1,2,60,59
1656012541201,COGS 118A,A01,083075,Gupta; Anjum,21,16,76,55
1656012547224,CSE 3,A50,083646,Miranda; Gregory Joseph,14,0,50,36
1656012553252,CSE 8A,A50,083650,Miranda; Gregory Joseph,3,11,56,53
1656012559286,CSE 11,A01,083080,Cao; Yingjun,0,65,40,40
1656012565343,CSE 12,A01,083652,Krause-Levy; Sophia Louisa,6,8,120,114
1656012571366,CSE 15L,A01,083654,Morris; Justin Loren,3,1,50,47
1656012571366,CSE 15L,A02,083655,Morris; Justin Loren,1,1,50,49
1656012577392,CSE 20,A01,083657,Tran; Khoa Dang,29,0,80,51
1656012583416,CSE 21,A01,095574,Bach; Quang Tran,23,0,48,25
1656012589448,CSE 30,A01,083084,Eldon; John,2,10,80,78
1656012589448,CSE 30,B01,095061,Bhaskar; Nishant,0,4,50,50
1656012595472,CSE 100,A01,083659,Cao; Yingjun,2,25,70,68
1656012601497,CSE 134B,A01,083661,Powell; Thomas Allan,6,6,100,94
1656012607518,CSE 140,A01,083663,Gungor; Onat,5,0,85,80
1656012613542,CSE 140L,A01,083088,Eldon; John,5,0,100,95
1656012619568,CSE 175,A01,083665,Kumar; Rakesh,1,0,25,24
1656012625591,CSE 190,A00,092507,Dubnov; Shlomo,1,0,20,19
1656012631614,ECE 45,A01,083139,Congero; Spencer William,0,1,75,75
1656012637645,ECE 65,A50,083695,Saad; Andrew S,6,0,30,24
1656012637645,ECE 65,A51,095125,Staff,23,0,26,3
1656012643692,ECE 109,A01,091882,Touri; Behrouz,3,5,70,67
1656012649718,ECE 180,A00,083140,Abi Samra; Nicholas Camill,1,0,30,29
1656012649718,ECE 180,B00,083141,Abi Samra; Nicholas Camill,0,8,28,28
1656012655748,MATH 10A,A01,083735,Patchell; Gregory David,0,0,30,30
1656012655748,MATH 10A,A02,083736,Patchell; Gregory David,21,0,30,9
1656012655748,MATH 10A,A03,083737,Patchell; Gregory David,16,0,30,14
1656012661774,MATH 10B,A01,083207,Lim; Seonhee,1,1,34,33
1656012661774,MATH 10B,A02,083208,Lim; Seonhee,1,1,35,34
1656012661774,MATH 10B,A03,093472,Staff,1,0,34,33
1656012661774,MATH 10B,B01,083739,Sinha; Shubham,9,0,30,21
1656012667806,MATH 18,A01,083743,Cinel; Cameron Alexander,5,0,30,25
1656012667806,MATH 18,A02,083744,Cinel; Cameron Alexander,11,0,30,19
1656012667806,MATH 18,A03,083745,Cinel; Cameron Alexander,1,0,30,29
1656012667806,MATH 18,B01,083748,Ma; Zilu,0,0,36,36
1656012667806,MATH 18,B02,083749,Ma; Zilu,0,0,36,36
1656012667806,MATH 18,B03,083750,Ma; Zilu,0,0,36,36
1656012667806,MATH 18,B04,083751,Ma; Zilu,0,0,36,36
1656012667806,MATH 18,B05,093473,Staff,0,0,36,36
1656012667806,MATH 18,B06,093474,Staff,3,0,36,33
1656012673830,MATH 20A,A01,083754,Zheng; Zequn,10,0,40,30
1656012679854,MATH 20B,A01,083756,Briones; Jor-el Thomas Caparas,0,1,36,36
1656012679854,MATH 20B,A02,083757,Briones; Jor-el Thomas Caparas,1,0,36,35
1656012679854,MATH 20B,A03,093475,Staff,0,0,36,36
1656012685882,MATH 20C,A01,083760,Briones; Jor-el Thomas Caparas,0,2,35,35
1656012685882,MATH 20C,A02,083761,Briones; Jor-el Thomas Caparas,6,1,35,29
1656012685882,MATH 20C,A03,093476,Staff,0,0,35,35
1656012685882,MATH 20C,B01,083762,Bach; Quang Tran,3,0,30,27
1656012691918,MATH 20D,A01,083765,Tran; Brian Kha,1,0,30,29
1656012691918,MATH 20D,A02,083766,Tran; Brian Kha,0,1,30,30
1656012691918,MATH 20D,A03,083767,Tran; Brian Kha,1,0,30,29
1656012697945,MATH 20E,A01,083771,Ganguly; Soumya,0,1,32,32
1656012697945,MATH 20E,A02,083772,Ganguly; Soumya,1,1,32,31
1656012697945,MATH 20E,B01,083773,Ciotti; Benjamin,14,0,35,21
1656012697945,MATH 20E,B02,083774,Ciotti; Benjamin,12,0,35,23
1656012703976,MATH 103A,A01,083777,Greenfeld; Be'Eri,2,1,36,34
1656012703976,MATH 103A,A02,083778,Greenfeld; Be'Eri,2,0,36,34
1656012703976,MATH 103A,A03,093561,Staff,0,1,36,36
1656012703976,MATH 103A,B01,083779,Greenfeld; Be'Eri,7,1,36,29
1656012703976,MATH 103A,B02,083780,Greenfeld; Be'Eri,0,0,36,36
1656012703976,MATH 103A,B03,093562,Staff,0,0,36,36
1656012709999,MATH 105,A01,085443,Carter; Anne Toulson,4,1,35,31
1656012709999,MATH 105,A02,093477,Staff,8,0,35,27
1656012716028,MATH 109,A01,083213,Ganzberger; Geoffrey Michael,0,1,34,34
1656012716028,MATH 109,A02,083214,Ganzberger; Geoffrey Michael,0,0,34,34
1656012716028,MATH 109,A03,093478,Staff,1,0,34,33
1656012716028,MATH 109,B01,083215,Ganzberger; Geoffrey Michael,2,0,32,30
1656012716028,MATH 109,B02,083216,Ganzberger; Geoffrey Michael,0,0,32,32
1656012716028,MATH 109,B03,093479,Staff,4,0,32,28
1656012722066,MATH 142A,A01,083219,Chow; Bennett,0,0,32,32
1656012722066,MATH 142A,A02,083220,Chow; Bennett,7,0,32,25
1656012722066,MATH 142A,A03,093480,Staff,4,0,32,28
1656012722066,MATH 142A,B03,093481,Staff,3,0,32,29
1656012722066,MATH 142A,B04,093558,Staff,6,0,32,26
1656012722066,MATH 142A,B05,093559,Staff,0,0,32,32
1656012728098,MATH 193A,A01,083224,Rotar; Vladimir,1,1,34,33
1656012728098,MATH 193A,A02,083225,Rotar; Vladimir,0,0,34,34
1656012728098,MATH 193A,A03,083781,Rotar; Vladimir,2,0,34,32
1656012728098,MATH 193A,A04,083782,Rotar; Vladimir,3,0,34,31
1656012728098,MATH 193A,A05,093482,Rotar; Vladimir,0,0,34,34
1656012734122,MATH 197,001,091859,McAuley; Julian John,9999,0,9999,0
1656012734122,MATH 197,002,095566,Kedlaya; Kiran S.,9997,0,9999,2
1656012734122,MATH 197,003,095567,Xiao; Ming,9999,0,9999,0
1656012734122,MATH 197,004,095571,Perols; Johan Lars,9998,0,9999,1
1656012741179,COGS 9,A01,083615,Shannon; Kyle Michael,3,1,75,72
1656012747202,COGS 11,A01,083617,Boyle; Mary E. T.,11,1,48,37
1656012753228,COGS 13,A01,083071,Bastos; Amalia Pinkusfeld,4,2,71,67
1656012759251,COGS 14A,A01,092681,Semenuks; Arturs,4,25,100,96
1656012765275,COGS 14B,A01,083073,Cheng; Tzu-Han,7,0,63,56
1656012771299,COGS 17,A01,092677,Semenuks; Arturs,8,7,81,73
1656012777322,COGS 100,A01,083619,Allen; Michael Gordon,2,2,70,68
1656012783348,COGS 101A,A01,083621,Davis; Joshua Daniel,4,3,68,64
1656012789371,COGS 101B,A01,091572,Allen; Michael Gordon,0,0,65,65
1656012795394,COGS 101C,A01,083625,Delgado; Tania,7,0,35,28
1656012801421,COGS 107A,A01,083627,Boyle; Mary E. T.,1,2,60,59
1656012807445,COGS 118A,A01,083075,Gupta; Anjum,21,16,76,55
1656012813470,CSE 3,A50,083646,Miranda; Gregory Joseph,14,0,50,36
1656012819499,CSE 8A,A50,083650,Miranda; Gregory Joseph,3,11,56,53
1656012825532,CSE 11,A01,083080,Cao; Yingjun,0,65,40,40
1656012831568,CSE 12,A01,083652,Krause-Levy; Sophia Louisa,6,8,120,114
1656012837595,CSE 15L,A01,083654,Morris; Justin Loren,3,1,50,47
1656012837595,CSE 15L,A02,083655,Morris; Justin Loren,1,1,50,49
1656012843619,CSE 20,A01,083657,Tran; Khoa Dang,29,0,80,51
1656012849656,CSE 21,A01,095574,Bach; Quang Tran,23,0,48,25
1656012855681,CSE 30,A01,083084,Eldon; John,2,10,80,78
1656012855681,CSE 30,B01,095061,Bhaskar; Nishant,0,4,50,50
1656012861720,CSE 100,A01,083659,Cao; Yingjun,2,25,70,68
1656012867747,CSE 134B,A01,083661,Powell; Thomas Allan,6,6,100,94
1656012873778,CSE 140,A01,083663,Gungor; Onat,5,0,85,80
1656012879803,CSE 140L,A01,083088,Eldon; John,5,0,100,95
1656012885829,CSE 175,A01,083665,Kumar; Rakesh,1,0,25,24
1656012891851,CSE 190,A00,092507,Dubnov; Shlomo,1,0,20,19
1656012897880,ECE 45,A01,083139,Congero; Spencer William,0,1,75,75
1656012903904,ECE 65,A50,083695,Saad; Andrew S,6,0,30,24
1656012903904,ECE 65,A51,095125,Staff,23,0,26,3
1656012909928,ECE 109,A01,091882,Touri; Behrouz,3,5,70,67
1656012915956,ECE 180,A00,083140,Abi Samra; Nicholas Camill,1,0,30,29
1656012915956,ECE 180,B00,083141,Abi Samra; Nicholas Camill,0,8,28,28
1656012921984,MATH 10A,A01,083735,Patchell; Gregory David,0,0,30,30
1656012921984,MATH 10A,A02,083736,Patchell; Gregory David,21,0,30,9
1656012921984,MATH 10A,A03,083737,Patchell; Gregory David,16,0,30,14
1656012928016,MATH 10B,A01,083207,Lim; Seonhee,1,1,34,33
1656012928016,MATH 10B,A02,083208,Lim; Seonhee,1,1,35,34
1656012928016,MATH 10B,A03,093472,Staff,1,0,34,33
1656012928016,MATH 10B,B01,083739,Sinha; Shubham,9,0,30,21
1656012934048,MATH 18,A01,083743,Cinel; Cameron Alexander,5,0,30,25
1656012934048,MATH 18,A02,083744,Cinel; Cameron Alexander,11,0,30,19
1656012934048,MATH 18,A03,083745,Cinel; Cameron Alexander,1,0,30,29
1656012934048,MATH 18,B01,083748,Ma; Zilu,0,0,36,36
1656012934048,MATH 18,B02,083749,Ma; Zilu,0,0,36,36
1656012934048,MATH 18,B03,083750,Ma; Zilu,0,0,36,36
1656012934048,MATH 18,B04,083751,Ma; Zilu,0,0,36,36
1656012934048,MATH 18,B05,093473,Staff,0,0,36,36
1656012934048,MATH 18,B06,093474,Staff,3,0,36,33
1656012940074,MATH 20A,A01,083754,Zheng; Zequn,10,0,40,30
1656012946111,MATH 20B,A01,083756,Briones; Jor-el Thomas Caparas,0,1,36,36
1656012946111,MATH 20B,A02,083757,Briones; Jor-el Thomas Caparas,1,0,36,35
1656012946111,MATH 20B,A03,093475,Staff,0,0,36,36
1656012952136,MATH 20C,A01,083760,Briones; Jor-el Thomas Caparas,0,2,35,35
1656012952136,MATH 20C,A02,083761,Briones; Jor-el Thomas Caparas,6,1,35,29
1656012952136,MATH 20C,A03,093476,Staff,0,0,35,35
1656012952136,MATH 20C,B01,083762,Bach; Quang Tran,3,0,30,27
1656012958164,MATH 20D,A01,083765,Tran; Brian Kha,1,0,30,29
1656012958164,MATH 20D,A02,083766,Tran; Brian Kha,0,1,30,30
1656012958164,MATH 20D,A03,083767,Tran; Brian Kha,1,0,30,29
1656012964188,MATH 20E,A01,083771,Ganguly; Soumya,0,1,32,32
1656012964188,MATH 20E,A02,083772,Ganguly; Soumya,1,1,32,31
1656012964188,MATH 20E,B01,083773,Ciotti; Benjamin,13,0,35,22
1656012964188,MATH 20E,B02,083774,Ciotti; Benjamin,12,0,35,23
1656012970213,MATH 103A,A01,083777,Greenfeld; Be'Eri,2,1,36,34
1656012970213,MATH 103A,A02,083778,Greenfeld; Be'Eri,2,0,36,34
1656012970213,MATH 103A,A03,093561,Staff,0,1,36,36
1656012970213,MATH 103A,B01,083779,Greenfeld; Be'Eri,7,1,36,29
1656012970213,MATH 103A,B02,083780,Greenfeld; Be'Eri,0,0,36,36
1656012970213,MATH 103A,B03,093562,Staff,0,0,36,36
1656012976237,MATH 105,A01,085443,Carter; Anne Toulson,4,1,35,31
1656012976237,MATH 105,A02,093477,Staff,8,0,35,27
1656012982343,MATH 109,A01,083213,Ganzberger; Geoffrey Michael,0,1,34,34
1656012982343,MATH 109,A02,083214,Ganzberger; Geoffrey Michael,0,0,34,34
1656012982343,MATH 109,A03,093478,Staff,1,0,34,33
1656012982343,MATH 109,B01,083215,Ganzberger; Geoffrey Michael,2,0,32,30
1656012982343,MATH 109,B02,083216,Ganzberger; Geoffrey Michael,0,0,32,32
1656012982343,MATH 109,B03,093479,Staff,4,0,32,28
1656012988368,MATH 142A,A01,083219,Chow; Bennett,1,0,32,31
1656012988368,MATH 142A,A02,083220,Chow; Bennett,7,0,32,25
1656012988368,MATH 142A,A03,093480,Staff,4,0,32,28
1656012988368,MATH 142A,B03,093481,Staff,3,0,32,29
1656012988368,MATH 142A,B04,093558,Staff,6,0,32,26
1656012988368,MATH 142A,B05,093559,Staff,0,0,32,32
1656012994395,MATH 193A,A01,083224,Rotar; Vladimir,1,1,34,33
1656012994395,MATH 193A,A02,083225,Rotar; Vladimir,0,0,34,34
1656012994395,MATH 193A,A03,083781,Rotar; Vladimir,2,0,34,32
1656012994395,MATH 193A,A04,083782,Rotar; Vladimir,3,0,34,31
1656012994395,MATH 193A,A05,093482,Rotar; Vladimir,0,0,34,34
1656013000419,MATH 197,001,091859,McAuley; Julian John,9999,0,9999,0
1656013000419,MATH 197,002,095566,Kedlaya; Kiran S.,9997,0,9999,2
1656013000419,MATH 197,003,095567,Xiao; Ming,9999,0,9999,0
1656013000419,MATH 197,004,095571,Perols; Johan Lars,9998,0,9999,1
1656013007470,COGS 9,A01,083615,Shannon; Kyle Michael,3,1,75,72
1656013013492,COGS 11,A01,083617,Boyle; Mary E. T.,11,1,48,37
1656013019516,COGS 13,A01,083071,Bastos; Amalia Pinkusfeld,4,2,71,67
1656013025544,COGS 14A,A01,092681,Semenuks; Arturs,4,25,100,96
1656013031575,COGS 14B,A01,083073,Cheng; Tzu-Han,7,0,63,56
1656013037601,COGS 17,A01,092677,Semenuks; Arturs,8,7,81,73
1656013043638,COGS 100,A01,083619,Allen; Michael Gordon,2,2,70,68
1656013049667,COGS 101A,A01,083621,Davis; Joshua Daniel,4,3,68,64
1656013055692,COGS 101B,A01,091572,Allen; Michael Gordon,0,0,65,65
1656013061729,COGS 101C,A01,083625,Delgado; Tania,7,0,35,28
1656013067756,COGS 107A,A01,083627,Boyle; Mary E. T.,1,2,60,59
1656013073782,COGS 118A,A01,083075,Gupta; Anjum,21,16,76,55
1656013079804,CSE 3,A50,083646,Miranda; Gregory Joseph,14,0,50,36
1656013085837,CSE 8A,A50,083650,Miranda; Gregory Joseph,3,11,56,53
1656013091865,CSE 11,A01,083080,Cao; Yingjun,0,65,40,40
1656013097892,CSE 12,A01,083652,Krause-Levy; Sophia Louisa,6,8,120,114
1656013103914,CSE 15L,A01,083654,Morris; Justin Loren,3,1,50,47
1656013103914,CSE 15L,A02,083655,Morris; Justin Loren,1,1,50,49
1656013109941,CSE 20,A01,083657,Tran; Khoa Dang,29,0,80,51
1656013115973,CSE 21,A01,095574,Bach; Quang Tran,23,0,48,25
1656013121998,CSE 30,A01,083084,Eldon; John,2,10,80,78
1656013121998,CSE 30,B01,095061,Bhaskar; Nishant,0,4,50,50
1656013128032,CSE 100,A01,083659,Cao; Yingjun,2,25,70,68
1656013134055,CSE 134B,A01,083661,Powell; Thomas Allan,6,6,100,94
1656013140078,CSE 140,A01,083663,Gungor; Onat,5,0,85,80
1656013146107,CSE 140L,A01,083088,Eldon; John,5,0,100,95
1656013152130,CSE 175,A01,083665,Kumar; Rakesh,0,0,25,25
1656013158156,CSE 190,A00,092507,Dubnov; Shlomo,1,0,20,19
1656013164187,ECE 45,A01,083139,Congero; Spencer William,0,1,75,75
1656013170210,ECE 65,A50,083695,Saad; Andrew S,6,0,30,24
1656013170210,ECE 65,A51,095125,Staff,23,0,26,3
1656013176240,ECE 109,A01,091882,Touri; Behrouz,3,5,70,67
1656013182267,ECE 180,A00,083140,Abi Samra; Nicholas Camill,1,0,30,29
1656013182267,ECE 180,B00,083141,Abi Samra; Nicholas Camill,0,8,28,28
1656013188292,MATH 10A,A01,083735,Patchell; Gregory David,0,0,30,30
1656013188292,MATH 10A,A02,083736,Patchell; Gregory David,21,0,30,9
1656013188292,MATH 10A,A03,083737,Patchell; Gregory David,16,0,30,14
1656013194316,MATH 10B,A01,083207,Lim; Seonhee,1,1,34,33
1656013194316,MATH 10B,A02,083208,Lim; Seonhee,1,1,35,34
1656013194316,MATH 10B,A03,093472,Staff,1,0,34,33
1656013194316,MATH 10B,B01,083739,Sinha; Shubham,9,0,30,21
1656013200344,MATH 18,A01,083743,Cinel; Cameron Alexander,5,0,30,25
1656013200344,MATH 18,A02,083744,Cinel; Cameron Alexander,11,0,30,19
1656013200344,MATH 18,A03,083745,Cinel; Cameron Alexander,1,0,30,29
1656013200344,MATH 18,B01,083748,Ma; Zilu,0,0,36,36
1656013200344,MATH 18,B02,083749,Ma; Zilu,0,0,36,36
1656013200344,MATH 18,B03,083750,Ma; Zilu,0,0,36,36
1656013200344,MATH 18,B04,083751,Ma; Zilu,0,0,36,36
1656013200344,MATH 18,B05,093473,Staff,0,0,36,36
1656013200344,MATH 18,B06,093474,Staff,3,0,36,33
1656013206371,MATH 20A,A01,083754,Zheng; Zequn,10,0,40,30
1656013212399,MATH 20B,A01,083756,Briones; Jor-el Thomas Caparas,0,1,36,36
1656013212399,MATH 20B,A02,083757,Briones; Jor-el Thomas Caparas,1,0,36,35
1656013212399,MATH 20B,A03,093475,Staff,0,0,36,36
1656013218433,MATH 20C,A01,083760,Briones; Jor-el Thomas Caparas,0,2,35,35
1656013218433,MATH 20C,A02,083761,Briones; Jor-el Thomas Caparas,6,1,35,29
1656013218433,MATH 20C,A03,093476,Staff,0,0,35,35
1656013218433,MATH 20C,B01,083762,Bach; Quang Tran,3,0,30,27
1656013224483,MATH 20D,A01,083765,Tran; Brian Kha,1,0,30,29
1656013224483,MATH 20D,A02,083766,Tran; Brian Kha,0,1,30,30
1656013224483,MATH 20D,A03,083767,Tran; Brian Kha,1,0,30,29
1656013230508,MATH 20E,A01,083771,Ganguly; Soumya,0,1,32,32
1656013230508,MATH 20E,A02,083772,Ganguly; Soumya,1,1,32,31
1656013230508,MATH 20E,B01,083773,Ciotti; Benjamin,13,0,35,22
1656013230508,MATH 20E,B02,083774,Ciotti; Benjamin,12,0,35,23
1656013236532,MATH 103A,A01,083777,Greenfeld; Be'Eri,2,1,36,34
1656013236532,MATH 103A,A02,083778,Greenfeld; Be'Eri,2,0,36,34
1656013236532,MATH 103A,A03,093561,Staff,0,1,36,36
1656013236532,MATH 103A,B01,083779,Greenfeld; Be'Eri,7,1,36,29
1656013236532,MATH 103A,B02,083780,Greenfeld; Be'Eri,0,0,36,36
1656013236532,MATH 103A,B03,093562,Staff,0,0,36,36
1656013242556,MATH 105,A01,085443,Carter; Anne Toulson,4,1,35,31
1656013242556,MATH 105,A02,093477,Staff,8,0,35,27
1656013248586,MATH 109,A01,083213,Ganzberger; Geoffrey Michael,0,1,34,34
1656013248586,MATH 109,A02,083214,Ganzberger; Geoffrey Michael,0,0,34,34
1656013248586,MATH 109,A03,093478,Staff,1,0,34,33
1656013248586,MATH 109,B01,083215,Ganzberger; Geoffrey Michael,2,0,32,30
1656013248586,MATH 109,B02,083216,Ganzberger; Geoffrey Michael,0,0,32,32
1656013248586,MATH 109,B03,093479,Staff,4,0,32,28
1656013254614,MATH 142A,A01,083219,Chow; Bennett,1,0,32,31
1656013254614,MATH 142A,A02,083220,Chow; Bennett,7,0,32,25
1656013254614,MATH 142A,A03,093480,Staff,4,0,32,28
1656013254614,MATH 142A,B03,093481,Staff,3,0,32,29
1656013254614,MATH 142A,B04,093558,Staff,6,0,32,26
1656013254614,MATH 142A,B05,093559,Staff,0,0,32,32
1656013260649,MATH 193A,A01,083224,Rotar; Vladimir,1,1,34,33
1656013260649,MATH 193A,A02,083225,Rotar; Vladimir,0,0,34,34
1656013260649,MATH 193A,A03,083781,Rotar; Vladimir,2,0,34,32
1656013260649,MATH 193A,A04,083782,Rotar; Vladimir,3,0,34,31
1656013260649,MATH 193A,A05,093482,Rotar; Vladimir,0,0,34,34
1656013266675,MATH 197,001,091859,McAuley; Julian John,9999,0,9999,0
1656013266675,MATH 197,002,095566,Kedlaya; Kiran S.,9997,0,9999,2
1656013266675,MATH 197,003,095567,Xiao; Ming,9999,0,9999,0
1656013266675,MATH 197,004,095571,Perols; Johan Lars,9998,0,9999,1
1656013273738,COGS 9,A01,083615,Shannon; Kyle Michael,3,1,75,72
1656013279765,COGS 11,A01,083617,Boyle; Mary E. T.,11,1,48,37
1656013285792,COGS 13,A01,083071,Bastos; Amalia Pinkusfeld,4,2,71,67
1656013291818,COGS 14A,A01,092681,Semenuks; Arturs,4,25,100,96
1656013297842,COGS 14B,A01,083073,Cheng; Tzu-Han,7,0,63,56
1656013303869,COGS 17,A01,092677,Semenuks; Arturs,8,7,81,73
1656013309897,COGS 100,A01,083619,Allen; Michael Gordon,2,2,70,68
1656013315925,COGS 101A,A01,083621,Davis; Joshua Daniel,4,3,68,64
1656013321948,COGS 101B,A01,091572,Allen; Michael Gordon,0,0,65,65
1656013327970,COGS 101C,A01,083625,Delgado; Tania,7,0,35,28
1656013333998,COGS 107A,A01,083627,Boyle; Mary E. T.,1,2,60,59
1656013340026,COGS 118A,A01,083075,Gupta; Anjum,21,16,76,55
1656013346050,CSE 3,A50,083646,Miranda; Gregory Joseph,14,0,50,36
1656013352082,CSE 8A,A50,083650,Miranda; Gregory Joseph,3,11,56,53
1656013358123,CSE 11,A01,083080,Cao; Yingjun,0,65,40,40
1656013364157,CSE 12,A01,083652,Krause-Levy; Sophia Louisa,6,8,120,114
1656013370180,CSE 15L,A01,083654,Morris; Justin Loren,3,1,50,47
1656013370180,CSE 15L,A02,083655,Morris; Justin Loren,1,1,50,49
1656013376207,CSE 20,A01,083657,Tran; Khoa Dang,29,0,80,51
1656013382232,CSE 21,A01,095574,Bach; Quang Tran,23,0,48,25
1656013388256,CSE 30,A01,083084,Eldon; John,2,10,80,78
1656013388256,CSE 30,B01,095061,Bhaskar; Nishant,0,4,50,50
1656013394288,CSE 100,A01,083659,Cao; Yingjun,2,25,70,68
1656013400311,CSE 134B,A01,083661,Powell; Thomas Allan,6,6,100,94
1656013406349,CSE 140,A01,083663,Gungor; Onat,5,0,85,80
1656013412376,CSE 140L,A01,083088,Eldon; John,5,0,100,95
1656013418400,CSE 175,A01,083665,Kumar; Rakesh,0,0,25,25
1656013424425,CSE 190,A00,092507,Dubnov; Shlomo,1,0,20,19
1656013430449,ECE 45,A01,083139,Congero; Spencer William,0,1,75,75
1656013436472,ECE 65,A50,083695,Saad; Andrew S,6,0,30,24
1656013436472,ECE 65,A51,095125,Staff,23,0,26,3
1656013442496,ECE 109,A01,091882,Touri; Behrouz,3,5,70,67
1656013448540,ECE 180,A00,083140,Abi Samra; Nicholas Camill,1,0,30,29
1656013448540,ECE 180,B00,083141,Abi Samra; Nicholas Camill,0,8,28,28
1656013454569,MATH 10A,A01,083735,Patchell; Gregory David,0,0,30,30
1656013454569,MATH 10A,A02,083736,Patchell; Gregory David,21,0,30,9
1656013454569,MATH 10A,A03,083737,Patchell; Gregory David,16,0,30,14
1656013460598,MATH 10B,A01,083207,Lim; Seonhee,1,1,34,33
1656013460598,MATH 10B,A02,083208,Lim; Seonhee,1,1,35,34
1656013460598,MATH 10B,A03,093472,Staff,1,0,34,33
1656013460598,MATH 10B,B01,083739,Sinha; Shubham,9,0,30,21
1656013466624,MATH 18,A01,083743,Cinel; Cameron Alexander,5,0,30,25
1656013466624,MATH 18,A02,083744,Cinel; Cameron Alexander,11,0,30,19
1656013466624,MATH 18,A03,083745,Cinel; Cameron Alexander,1,0,30,29
1656013466624,MATH 18,B01,083748,Ma; Zilu,0,0,36,36
1656013466624,MATH 18,B02,083749,Ma; Zilu,0,0,36,36
1656013466624,MATH 18,B03,083750,Ma; Zilu,0,0,36,36
1656013466624,MATH 18,B04,083751,Ma; Zilu,0,0,36,36
1656013466624,MATH 18,B05,093473,Staff,0,0,36,36
1656013466624,MATH 18,B06,093474,Staff,3,0,36,33
1656013472651,MATH 20A,A01,083754,Zheng; Zequn,10,0,40,30
1656013478674,MATH 20B,A01,083756,Briones; Jor-el Thomas Caparas,0,1,36,36
1656013478674,MATH 20B,A02,083757,Briones; Jor-el Thomas Caparas,1,0,36,35
1656013478674,MATH 20B,A03,093475,Staff,0,0,36,36
1656013484698,MATH 20C,A01,083760,Briones; Jor-el Thomas Caparas,0,2,35,35
1656013484698,MATH 20C,A02,083761,Briones; Jor-el Thomas Caparas,6,1,35,29
1656013484698,MATH 20C,A03,093476,Staff,0,0,35,35
1656013484698,MATH 20C,B01,083762,Bach; Quang Tran,3,0,30,27
1656013490735,MATH 20D,A01,083765,Tran; Brian Kha,2,0,30,28
1656013490735,MATH 20D,A02,083766,Tran; Brian Kha,0,1,30,30
1656013490735,MATH 20D,A03,083767,Tran; Brian Kha,1,0,30,29
1656013496763,MATH 20E,A01,083771,Ganguly; Soumya,0,1,32,32
1656013496763,MATH 20E,A02,083772,Ganguly; Soumya,1,1,32,31
1656013496763,MATH 20E,B01,083773,Ciotti; Benjamin,13,0,35,22
1656013496763,MATH 20E,B02,083774,Ciotti; Benjamin,12,0,35,23
1656013502794,MATH 103A,A01,083777,Greenfeld; Be'Eri,2,1,36,34
1656013502794,MATH 103A,A02,083778,Greenfeld; Be'Eri,2,0,36,34
1656013502794,MATH 103A,A03,093561,Staff,0,1,36,36
1656013502794,MATH 103A,B01,083779,Greenfeld; Be'Eri,7,1,36,29
1656013502794,MATH 103A,B02,083780,Greenfeld; Be'Eri,0,0,36,36
1656013502794,MATH 103A,B03,093562,Staff,0,0,36,36
1656013508817,MATH 105,A01,085443,Carter; Anne Toulson,4,1,35,31
1656013508817,MATH 105,A02,093477,Staff,8,0,35,27
1656013514849,MATH 109,A01,083213,Ganzberger; Geoffrey Michael,0,1,34,34
1656013514849,MATH 109,A02,083214,Ganzberger; Geoffrey Michael,0,0,34,34
1656013514849,MATH 109,A03,093478,Staff,1,0,34,33
1656013514849,MATH 109,B01,083215,Ganzberger; Geoffrey Michael,2,0,32,30
1656013514849,MATH 109,B02,083216,Ganzberger; Geoffrey Michael,0,0,32,32
1656013514849,MATH 109,B03,093479,Staff,4,0,32,28
1656013520880,MATH 142A,A01,083219,Chow; Bennett,1,0,32,31
1656013520880,MATH 142A,A02,083220,Chow; Bennett,7,0,32,25
1656013520880,MATH 142A,A03,093480,Staff,4,0,32,28
1656013520880,MATH 142A,B03,093481,Staff,3,0,32,29
1656013520880,MATH 142A,B04,093558,Staff,6,0,32,26
1656013520880,MATH 142A,B05,093559,Staff,0,0,32,32
1656013526912,MATH 193A,A01,083224,Rotar; Vladimir,1,1,34,33
1656013526912,MATH 193A,A02,083225,Rotar; Vladimir,0,0,34,34
1656013526912,MATH 193A,A03,083781,Rotar; Vladimir,2,0,34,32
1656013526912,MATH 193A,A04,083782,Rotar; Vladimir,3,0,34,31
1656013526912,MATH 193A,A05,093482,Rotar; Vladimir,0,0,34,34
1656013532936,MATH 197,001,091859,McAuley; Julian John,9999,0,9999,0
1656013532936,MATH 197,002,095566,Kedlaya; Kiran S.,9997,0,9999,2
1656013532936,MATH 197,003,095567,Xiao; Ming,9999,0,9999,0
1656013532936,MATH 197,004,095571,Perols; Johan Lars,9998,0,9999,1
1656013539994,COGS 9,A01,083615,Shannon; Kyle Michael,3,1,75,72
1656013546020,COGS 11,A01,083617,Boyle; Mary E. T.,11,1,48,37
1656013552048,COGS 13,A01,083071,Bastos; Amalia Pinkusfeld,4,2,71,67
1656013558072,COGS 14A,A01,092681,Semenuks; Arturs,4,25,100,96
1656013564099,COGS 14B,A01,083073,Cheng; Tzu-Han,7,0,63,56
1656013570133,COGS 17,A01,092677,Semenuks; Arturs,8,7,81,73
1656013576239,COGS 100,A01,083619,Allen; Michael Gordon,2,2,70,68
1656013582263,COGS 101A,A01,083621,Davis; Joshua Daniel,4,3,68,64
1656013588288,COGS 101B,A01,091572,Allen; Michael Gordon,0,0,65,65
1656013594315,COGS 101C,A01,083625,Delgado; Tania,7,0,35,28
1656013600346,COGS 107A,A01,083627,Boyle; Mary E. T.,1,2,60,59
1656013606369,COGS 118A,A01,083075,Gupta; Anjum,21,16,76,55
1656013612393,CSE 3,A50,083646,Miranda; Gregory Joseph,14,0,50,36
1656013618425,CSE 8A,A50,083650,Miranda; Gregory Joseph,3,11,56,53
1656013624451,CSE 11,A01,083080,Cao; Yingjun,0,65,40,40
1656013630474,CSE 12,A01,083652,Krause-Levy; Sophia Louisa,6,8,120,114
1656013636497,CSE 15L,A01,083654,Morris; Justin Loren,3,1,50,47
1656013636497,CSE 15L,A02,083655,Morris; Justin Loren,1,1,50,49
1656013642522,CSE 20,A01,083657,Tran; Khoa Dang,29,0,80,51
1656013648546,CSE 21,A01,095574,Bach; Quang Tran,23,0,48,25
1656013654568,CSE 30,A01,083084,Eldon; John,2,10,80,78
1656013654568,CSE 30,B01,095061,Bhaskar; Nishant,0,4,50,50
1656013660592,CSE 100,A01,083659,Cao; Yingjun,2,25,70,68
1656013666623,CSE 134B,A01,083661,Powell; Thomas Allan,6,6,100,94
1656013672652,CSE 140,A01,083663,Gungor; Onat,5,0,85,80
1656013678677,CSE 140L,A01,083088,Eldon; John,5,0,100,95
1656013684700,CSE 175,A01,083665,Kumar; Rakesh,0,0,25,25
1656013690724,CSE 190,A00,092507,Dubnov; Shlomo,1,0,20,19
1656013696753,ECE 45,A01,083139,Congero; Spencer William,0,1,75,75
1656013702777,ECE 65,A50,083695,Saad; Andrew S,6,0,30,24
1656013702777,ECE 65,A51,095125,Staff,23,0,26,3
1656013708804,ECE 109,A01,091882,Touri; Behrouz,3,5,70,67
1656013714835,ECE 180,A00,083140,Abi Samra; Nicholas Camill,1,0,30,29
1656013714835,ECE 180,B00,083141,Abi Samra; Nicholas Camill,0,8,28,28
1656013720862,MATH 10A,A01,083735,Patchell; Gregory David,0,0,30,30
1656013720862,MATH 10A,A02,083736,Patchell; Gregory David,21,0,30,9
1656013720862,MATH 10A,A03,083737,Patchell; Gregory David,16,0,30,14
1656013726890,MATH 10B,A01,083207,Lim; Seonhee,1,1,34,33
1656013726890,MATH 10B,A02,083208,Lim; Seonhee,1,1,35,34
1656013726890,MATH 10B,A03,093472,Staff,1,0,34,33
1656013726890,MATH 10B,B01,083739,Sinha; Shubham,9,0,30,21
1656013732915,MATH 18,A01,083743,Cinel; Cameron Alexander,5,0,30,25
1656013732915,MATH 18,A02,083744,Cinel; Cameron Alexander,11,0,30,19
1656013732915,MATH 18,A03,083745,Cinel; Cameron Alexander,1,0,30,29
1656013732915,MATH 18,B01,083748,Ma; Zilu,0,0,36,36
1656013732915,MATH 18,B02,083749,Ma; Zilu,0,0,36,36
1656013732915,MATH 18,B03,083750,Ma; Zilu,0,0,36,36
1656013732915,MATH 18,B04,083751,Ma; Zilu,0,0,36,36
1656013732915,MATH 18,B05,093473,Staff,0,0,36,36
1656013732915,MATH 18,B06,093474,Staff,3,0,36,33
1656013738937,MATH 20A,A01,083754,Zheng; Zequn,10,0,40,30
1656013744961,MATH 20B,A01,083756,Briones; Jor-el Thomas Caparas,0,1,36,36
1656013744961,MATH 20B,A02,083757,Briones; Jor-el Thomas Caparas,1,0,36,35
1656013744961,MATH 20B,A03,093475,Staff,0,0,36,36
1656013750989,MATH 20C,A01,083760,Briones; Jor-el Thomas Caparas,0,2,35,35
1656013750989,MATH 20C,A02,083761,Briones; Jor-el Thomas Caparas,6,1,35,29
1656013750989,MATH 20C,A03,093476,Staff,0,0,35,35
1656013750989,MATH 20C,B01,083762,Bach; Quang Tran,3,0,30,27
1656013757014,MATH 20D,A01,083765,Tran; Brian Kha,2,0,30,28
1656013757014,MATH 20D,A02,083766,Tran; Brian Kha,0,1,30,30
1656013757014,MATH 20D,A03,083767,Tran; Brian Kha,1,0,30,29
1656013763037,MATH 20E,A01,083771,Ganguly; Soumya,0,1,32,32
1656013763037,MATH 20E,A02,083772,Ganguly; Soumya,1,1,32,31
1656013763037,MATH 20E,B01,083773,Ciotti; Benjamin,13,0,35,22
1656013763037,MATH 20E,B02,083774,Ciotti; Benjamin,12,0,35,23
1656013769061,MATH 103A,A01,083777,Greenfeld; Be'Eri,2,1,36,34
1656013769061,MATH 103A,A02,083778,Greenfeld; Be'Eri,2,0,36,34
1656013769061,MATH 103A,A03,093561,Staff,0,1,36,36
1656013769061,MATH 103A,B01,083779,Greenfeld; Be'Eri,7,1,36,29
1656013769061,MATH 103A,B02,083780,Greenfeld; Be'Eri,0,0,36,36
1656013769061,MATH 103A,B03,093562,Staff,0,0,36,36
1656013775090,MATH 105,A01,085443,Carter; Anne Toulson,4,1,35,31
1656013775090,MATH 105,A02,093477,Staff,8,0,35,27
1656013781121,MATH 109,A01,083213,Ganzberger; Geoffrey Michael,0,1,34,34
1656013781121,MATH 109,A02,083214,Ganzberger; Geoffrey Michael,0,0,34,34
1656013781121,MATH 109,A03,093478,Staff,1,0,34,33
1656013781121,MATH 109,B01,083215,Ganzberger; Geoffrey Michael,2,0,32,30
1656013781121,MATH 109,B02,083216,Ganzberger; Geoffrey Michael,0,0,32,32
1656013781121,MATH 109,B03,093479,Staff,4,0,32,28
1656013787146,MATH 142A,A01,083219,Chow; Bennett,1,0,32,31
1656013787146,MATH 142A,A02,083220,Chow; Bennett,7,0,32,25
1656013787146,MATH 142A,A03,093480,Staff,4,0,32,28
1656013787146,MATH 142A,B03,093481,Staff,3,0,32,29
1656013787146,MATH 142A,B04,093558,Staff,6,0,32,26
1656013787146,MATH 142A,B05,093559,Staff,0,0,32,32
1656013793174,MATH 193A,A01,083224,Rotar; Vladimir,1,1,34,33
1656013793174,MATH 193A,A02,083225,Rotar; Vladimir,0,0,34,34
1656013793174,MATH 193A,A03,083781,Rotar; Vladimir,2,0,34,32
1656013793174,MATH 193A,A04,083782,Rotar; Vladimir,3,0,34,31
1656013793174,MATH 193A,A05,093482,Rotar; Vladimir,0,0,34,34
1656013799204,MATH 197,001,091859,McAuley; Julian John,9999,0,9999,0
1656013799204,MATH 197,002,095566,Kedlaya; Kiran S.,9997,0,9999,2
1656013799204,MATH 197,003,095567,Xiao; Ming,9999,0,9999,0
1656013799204,MATH 197,004,095571,Perols; Johan Lars,9998,0,9999,1
1656013806260,COGS 9,A01,083615,Shannon; Kyle Michael,3,1,75,72
1656013812285,COGS 11,A01,083617,Boyle; Mary E. T.,11,1,48,37
1656013818312,COGS 13,A01,083071,Bastos; Amalia Pinkusfeld,4,2,71,67
1656013824340,COGS 14A,A01,092681,Semenuks; Arturs,4,25,100,96
1656013830363,COGS 14B,A01,083073,Cheng; Tzu-Han,7,0,63,56
1656013836386,COGS 17,A01,092677,Semenuks; Arturs,8,7,81,73
1656013842411,COGS 100,A01,083619,Allen; Michael Gordon,2,2,70,68
1656013848433,COGS 101A,A01,083621,Davis; Joshua Daniel,4,3,68,64
1656013854466,COGS 101B,A01,091572,Allen; Michael Gordon,0,0,65,65
1656013860493,COGS 101C,A01,083625,Delgado; Tania,7,0,35,28
1656013866525,COGS 107A,A01,083627,Boyle; Mary E. T.,1,2,60,59
1656013872557,COGS 118A,A01,083075,Gupta; Anjum,21,16,76,55
1656013878580,CSE 3,A50,083646,Miranda; Gregory Joseph,14,0,50,36
1656013884625,CSE 8A,A50,083650,Miranda; Gregory Joseph,3,11,56,53
1656013890651,CSE 11,A01,083080,Cao; Yingjun,0,65,40,40
1656013896684,CSE 12,A01,083652,Krause-Levy; Sophia Louisa,6,8,120,114
1656013902711,CSE 15L,A01,083654,Morris; Justin Loren,3,1,50,47
1656013902711,CSE 15L,A02,083655,Morris; Justin Loren,1,1,50,49
1656013908737,CSE 20,A01,083657,Tran; Khoa Dang,29,0,80,51
1656013914764,CSE 21,A01,095574,Bach; Quang Tran,23,0,48,25
1656013920788,CSE 30,A01,083084,Eldon; John,2,10,80,78
1656013920788,CSE 30,B01,095061,Bhaskar; Nishant,0,4,50,50
1656013926819,CSE 100,A01,083659,Cao; Yingjun,2,25,70,68
1656013932848,CSE 134B,A01,083661,Powell; Thomas Allan,6,6,100,94
1656013938871,CSE 140,A01,083663,Gungor; Onat,5,0,85,80
1656013944901,CSE 140L,A01,083088,Eldon; John,5,0,100,95
1656013950923,CSE 175,A01,083665,Kumar; Rakesh,0,0,25,25
1656013956945,CSE 190,A00,092507,Dubnov; Shlomo,1,0,20,19
1656013962970,ECE 45,A01,083139,Congero; Spencer William,0,1,75,75
1656013968999,ECE 65,A50,083695,Saad; Andrew S,6,0,30,24
1656013968999,ECE 65,A51,095125,Staff,23,0,26,3
1656013975023,ECE 109,A01,091882,Touri; Behrouz,3,5,70,67
1656013981058,ECE 180,A00,083140,Abi Samra; Nicholas Camill,1,0,30,29
1656013981058,ECE 180,B00,083141,Abi Samra; Nicholas Camill,0,8,28,28
1656013987082,MATH 10A,A01,083735,Patchell; Gregory David,0,0,30,30
1656013987082,MATH 10A,A02,083736,Patchell; Gregory David,21,0,30,9
1656013987082,MATH 10A,A03,083737,Patchell; Gregory David,16,0,30,14
1656013993115,MATH 10B,A01,083207,Lim; Seonhee,1,1,34,33
1656013993115,MATH 10B,A02,083208,Lim; Seonhee,1,1,35,34
1656013993115,MATH 10B,A03,093472,Staff,1,0,34,33
1656013993115,MATH 10B,B01,083739,Sinha; Shubham,9,0,30,21
1656013999141,MATH 18,A01,083743,Cinel; Cameron Alexander,5,0,30,25
1656013999141,MATH 18,A02,083744,Cinel; Cameron Alexander,11,0,30,19
1656013999141,MATH 18,A03,083745,Cinel; Cameron Alexander,1,0,30,29
1656013999141,MATH 18,B01,083748,Ma; Zilu,0,0,36,36
1656013999141,MATH 18,B02,083749,Ma; Zilu,0,0,36,36
1656013999141,MATH 18,B03,083750,Ma; Zilu,0,0,36,36
1656013999141,MATH 18,B04,083751,Ma; Zilu,0,0,36,36
1656013999141,MATH 18,B05,093473,Staff,0,0,36,36
1656013999141,MATH 18,B06,093474,Staff,3,0,36,33
1656014005163,MATH 20A,A01,083754,Zheng; Zequn,10,0,40,30
1656014011191,MATH 20B,A01,083756,Briones; Jor-el Thomas Caparas,0,1,36,36
1656014011191,MATH 20B,A02,083757,Briones; Jor-el Thomas Caparas,1,0,36,35
1656014011191,MATH 20B,A03,093475,Staff,0,0,36,36
1656014017221,MATH 20C,A01,083760,Briones; Jor-el Thomas Caparas,0,2,35,35
1656014017221,MATH 20C,A02,083761,Briones; Jor-el Thomas Caparas,6,1,35,29
1656014017221,MATH 20C,A03,093476,Staff,0,0,35,35
1656014017221,MATH 20C,B01,083762,Bach; Quang Tran,3,0,30,27
1656014023249,MATH 20D,A01,083765,Tran; Brian Kha,2,0,30,28
1656014023249,MATH 20D,A02,083766,Tran; Brian Kha,0,1,30,30
1656014023249,MATH 20D,A03,083767,Tran; Brian Kha,1,0,30,29
1656014029276,MATH 20E,A01,083771,Ganguly; Soumya,0,1,32,32
1656014029276,MATH 20E,A02,083772,Ganguly; Soumya,1,1,32,31
1656014029276,MATH 20E,B01,083773,Ciotti; Benjamin,13,0,35,22
1656014029276,MATH 20E,B02,083774,Ciotti; Benjamin,12,0,35,23
1656014035306,MATH 103A,A01,083777,Greenfeld; Be'Eri,2,1,36,34
1656014035306,MATH 103A,A02,083778,Greenfeld; Be'Eri,2,0,36,34
1656014035306,MATH 103A,A03,093561,Staff,0,1,36,36
1656014035306,MATH 103A,B01,083779,Greenfeld; Be'Eri,7,1,36,29
1656014035306,MATH 103A,B02,083780,Greenfeld; Be'Eri,0,0,36,36
1656014035306,MATH 103A,B03,093562,Staff,0,0,36,36
1656014041328,MATH 105,A01,085443,Carter; Anne Toulson,4,1,35,31
1656014041328,MATH 105,A02,093477,Staff,8,0,35,27
1656014047356,MATH 109,A01,083213,Ganzberger; Geoffrey Michael,0,1,34,34
1656014047356,MATH 109,A02,083214,Ganzberger; Geoffrey Michael,0,0,34,34
1656014047356,MATH 109,A03,093478,Staff,1,0,34,33
1656014047356,MATH 109,B01,083215,Ganzberger; Geoffrey Michael,2,0,32,30
1656014047356,MATH 109,B02,083216,Ganzberger; Geoffrey Michael,0,0,32,32
1656014047356,MATH 109,B03,093479,Staff,4,0,32,28
1656014053381,MATH 142A,A01,083219,Chow; Bennett,1,0,32,31
1656014053381,MATH 142A,A02,083220,Chow; Bennett,7,0,32,25
1656014053381,MATH 142A,A03,093480,Staff,4,0,32,28
1656014053381,MATH 142A,B03,093481,Staff,3,0,32,29
1656014053381,MATH 142A,B04,093558,Staff,6,0,32,26
1656014053381,MATH 142A,B05,093559,Staff,0,0,32,32
1656014059409,MATH 193A,A01,083224,Rotar; Vladimir,1,1,34,33
1656014059409,MATH 193A,A02,083225,Rotar; Vladimir,0,0,34,34
1656014059409,MATH 193A,A03,083781,Rotar; Vladimir,2,0,34,32
1656014059409,MATH 193A,A04,083782,Rotar; Vladimir,3,0,34,31
1656014059409,MATH 193A,A05,093482,Rotar; Vladimir,0,0,34,34
1656014065434,MATH 197,001,091859,McAuley; Julian John,9999,0,9999,0
1656014065434,MATH 197,002,095566,Kedlaya; Kiran S.,9997,0,9999,2
1656014065434,MATH 197,003,095567,Xiao; Ming,9999,0,9999,0
1656014065434,MATH 197,004,095571,Perols; Johan Lars,9998,0,9999,1
1656014072496,COGS 9,A01,083615,Shannon; Kyle Michael,3,1,75,72
1656014078520,COGS 11,A01,083617,Boyle; Mary E. T.,11,1,48,37
1656014084544,COGS 13,A01,083071,Bastos; Amalia Pinkusfeld,4,2,71,67
1656014090571,COGS 14A,A01,092681,Semenuks; Arturs,4,25,100,96
1656014096600,COGS 14B,A01,083073,Cheng; Tzu-Han,7,0,63,56
1656014102634,COGS 17,A01,092677,Semenuks; Arturs,8,7,81,73
1656014108661,COGS 100,A01,083619,Allen; Michael Gordon,2,2,70,68
1656014114685,COGS 101A,A01,083621,Davis; Joshua Daniel,4,3,68,64
1656014120712,COGS 101B,A01,091572,Allen; Michael Gordon,0,0,65,65
1656014126739,COGS 101C,A01,083625,Delgado; Tania,7,0,35,28
1656014132771,COGS 107A,A01,083627,Boyle; Mary E. T.,1,2,60,59
1656014138796,COGS 118A,A01,083075,Gupta; Anjum,21,16,76,55
1656014144825,CSE 3,A50,083646,Miranda; Gregory Joseph,14,0,50,36
1656014150862,CSE 8A,A50,083650,Miranda; Gregory Joseph,3,11,56,53
1656014156886,CSE 11,A01,083080,Cao; Yingjun,0,65,40,40
1656014162913,CSE 12,A01,083652,Krause-Levy; Sophia Louisa,6,8,120,114
1656014168942,CSE 15L,A01,083654,Morris; Justin Loren,3,1,50,47
1656014168942,CSE 15L,A02,083655,Morris; Justin Loren,1,1,50,49
1656014175065,CSE 20,A01,083657,Tran; Khoa Dang,29,0,80,51
1656014181097,CSE 21,A01,095574,Bach; Quang Tran,23,0,48,25
1656014187123,CSE 30,A01,083084,Eldon; John,2,10,80,78
1656014187123,CSE 30,B01,095061,Bhaskar; Nishant,0,4,50,50
1656014193147,CSE 100,A01,083659,Cao; Yingjun,2,25,70,68
1656014199170,CSE 134B,A01,083661,Powell; Thomas Allan,6,6,100,94
1656014205195,CSE 140,A01,083663,Gungor; Onat,5,0,85,80
1656014211220,CSE 140L,A01,083088,Eldon; John,5,0,100,95
1656014217247,CSE 175,A01,083665,Kumar; Rakesh,0,0,25,25
1656014223270,CSE 190,A00,092507,Dubnov; Shlomo,1,0,20,19
1656014229297,ECE 45,A01,083139,Congero; Spencer William,0,1,75,75
1656014235321,ECE 65,A50,083695,Saad; Andrew S,6,0,30,24
1656014235321,ECE 65,A51,095125,Staff,23,0,26,3
1656014241354,ECE 109,A01,091882,Touri; Behrouz,3,5,70,67
1656014247393,ECE 180,A00,083140,Abi Samra; Nicholas Camill,1,0,30,29
1656014247393,ECE 180,B00,083141,Abi Samra; Nicholas Camill,0,8,28,28
1656014253416,MATH 10A,A01,083735,Patchell; Gregory David,0,0,30,30
1656014253416,MATH 10A,A02,083736,Patchell; Gregory David,21,0,30,9
1656014253416,MATH 10A,A03,083737,Patchell; Gregory David,16,0,30,14
1656014259454,MATH 10B,A01,083207,Lim; Seonhee,1,1,34,33
1656014259454,MATH 10B,A02,083208,Lim; Seonhee,1,1,35,34
1656014259454,MATH 10B,A03,093472,Staff,1,0,34,33
1656014259454,MATH 10B,B01,083739,Sinha; Shubham,9,0,30,21
1656014265485,MATH 18,A01,083743,Cinel; Cameron Alexander,5,0,30,25
1656014265485,MATH 18,A02,083744,Cinel; Cameron Alexander,11,0,30,19
1656014265485,MATH 18,A03,083745,Cinel; Cameron Alexander,1,0,30,29
1656014265485,MATH 18,B01,083748,Ma; Zilu,0,0,36,36
1656014265485,MATH 18,B02,083749,Ma; Zilu,0,0,36,36
1656014265485,MATH 18,B03,083750,Ma; Zilu,0,0,36,36
1656014265485,MATH 18,B04,083751,Ma; Zilu,0,0,36,36
1656014265485,MATH 18,B05,093473,Staff,0,0,36,36
1656014265485,MATH 18,B06,093474,Staff,3,0,36,33
1656014271508,MATH 20A,A01,083754,Zheng; Zequn,10,0,40,30
1656014277536,MATH 20B,A01,083756,Briones; Jor-el Thomas Caparas,0,1,36,36
1656014277536,MATH 20B,A02,083757,Briones; Jor-el Thomas Caparas,1,0,36,35
1656014277536,MATH 20B,A03,093475,Staff,0,0,36,36
1656014283565,MATH 20C,A01,083760,Briones; Jor-el Thomas Caparas,0,2,35,35
1656014283565,MATH 20C,A02,083761,Briones; Jor-el Thomas Caparas,6,1,35,29
1656014283565,MATH 20C,A03,093476,Staff,0,0,35,35
1656014283565,MATH 20C,B01,083762,Bach; Quang Tran,3,0,30,27
1656014289590,MATH 20D,A01,083765,Tran; Brian Kha,2,0,30,28
1656014289590,MATH 20D,A02,083766,Tran; Brian Kha,0,1,30,30
1656014289590,MATH 20D,A03,083767,Tran; Brian Kha,1,0,30,29
1656014295616,MATH 20E,A01,083771,Ganguly; Soumya,0,1,32,32
1656014295616,MATH 20E,A02,083772,Ganguly; Soumya,1,1,32,31
1656014295616,MATH 20E,B01,083773,Ciotti; Benjamin,13,0,35,22
1656014295616,MATH 20E,B02,083774,Ciotti; Benjamin,12,0,35,23
1656014301648,MATH 103A,A01,083777,Greenfeld; Be'Eri,2,1,36,34
1656014301648,MATH 103A,A02,083778,Greenfeld; Be'Eri,2,0,36,34
1656014301648,MATH 103A,A03,093561,Staff,0,1,36,36
1656014301648,MATH 103A,B01,083779,Greenfeld; Be'Eri,7,1,36,29
1656014301648,MATH 103A,B02,083780,Greenfeld; Be'Eri,0,0,36,36
1656014301648,MATH 103A,B03,093562,Staff,0,0,36,36
1656014307683,MATH 105,A01,085443,Carter; Anne Toulson,4,1,35,31
1656014307683,MATH 105,A02,093477,Staff,8,0,35,27
1656014313723,MATH 109,A01,083213,Ganzberger; Geoffrey Michael,0,1,34,34
1656014313723,MATH 109,A02,083214,Ganzberger; Geoffrey Michael,0,0,34,34
1656014313723,MATH 109,A03,093478,Staff,1,0,34,33
1656014313723,MATH 109,B01,083215,Ganzberger; Geoffrey Michael,2,0,32,30
1656014313723,MATH 109,B02,083216,Ganzberger; Geoffrey Michael,0,0,32,32
1656014313723,MATH 109,B03,093479,Staff,4,0,32,28
1656014319754,MATH 142A,A01,083219,Chow; Bennett,1,0,32,31
1656014319754,MATH 142A,A02,083220,Chow; Bennett,7,0,32,25
1656014319754,MATH 142A,A03,093480,Staff,4,0,32,28
1656014319754,MATH 142A,B03,093481,Staff,3,0,32,29
1656014319754,MATH 142A,B04,093558,Staff,6,0,32,26
1656014319754,MATH 142A,B05,093559,Staff,0,0,32,32
1656014325778,MATH 193A,A01,083224,Rotar; Vladimir,1,1,34,33
1656014325778,MATH 193A,A02,083225,Rotar; Vladimir,0,0,34,34
1656014325778,MATH 193A,A03,083781,Rotar; Vladimir,2,0,34,32
1656014325778,MATH 193A,A04,083782,Rotar; Vladimir,3,0,34,31
1656014325778,MATH 193A,A05,093482,Rotar; Vladimir,0,0,34,34
1656014331800,MATH 197,001,091859,McAuley; Julian John,9999,0,9999,0
1656014331800,MATH 197,002,095566,Kedlaya; Kiran S.,9997,0,9999,2
1656014331800,MATH 197,003,095567,Xiao; Ming,9999,0,9999,0
1656014331800,MATH 197,004,095571,Perols; Johan Lars,9998,0,9999,1
1656014338851,COGS 9,A01,083615,Shannon; Kyle Michael,3,1,75,72
1656014344874,COGS 11,A01,083617,Boyle; Mary E. T.,11,1,48,37
1656014350898,COGS 13,A01,083071,Bastos; Amalia Pinkusfeld,4,2,71,67
1656014356923,COGS 14A,A01,092681,Semenuks; Arturs,4,25,100,96
1656014362973,COGS 14B,A01,083073,Cheng; Tzu-Han,7,0,63,56
1656014369000,COGS 17,A01,092677,Semenuks; Arturs,8,7,81,73
1656014375023,COGS 100,A01,083619,Allen; Michael Gordon,2,2,70,68
1656014381059,COGS 101A,A01,083621,Davis; Joshua Daniel,4,3,68,64
1656014387086,COGS 101B,A01,091572,Allen; Michael Gordon,0,0,65,65
1656014393118,COGS 101C,A01,083625,Delgado; Tania,7,0,35,28
1656014399147,COGS 107A,A01,083627,Boyle; Mary E. T.,1,2,60,59
1656014405172,COGS 118A,A01,083075,Gupta; Anjum,21,16,76,55
1656014411198,CSE 3,A50,083646,Miranda; Gregory Joseph,14,0,50,36
1656014417223,CSE 8A,A50,083650,Miranda; Gregory Joseph,3,11,56,53
1656014423246,CSE 11,A01,083080,Cao; Yingjun,0,65,40,40
1656014429269,CSE 12,A01,083652,Krause-Levy; Sophia Louisa,6,8,120,114
1656014435299,CSE 15L,A01,083654,Morris; Justin Loren,3,1,50,47
1656014435299,CSE 15L,A02,083655,Morris; Justin Loren,1,1,50,49
1656014441331,CSE 20,A01,083657,Tran; Khoa Dang,29,0,80,51
1656014447357,CSE 21,A01,095574,Bach; Quang Tran,23,0,48,25
1656014453380,CSE 30,A01,083084,Eldon; John,2,10,80,78
1656014453380,CSE 30,B01,095061,Bhaskar; Nishant,0,4,50,50
1656014459402,CSE 100,A01,083659,Cao; Yingjun,2,25,70,68
1656014465435,CSE 134B,A01,083661,Powell; Thomas Allan,6,6,100,94
1656014471459,CSE 140,A01,083663,Gungor; Onat,5,0,85,80
1656014477484,CSE 140L,A01,083088,Eldon; John,5,0,100,95
1656014483511,CSE 175,A01,083665,Kumar; Rakesh,0,0,25,25
1656014489539,CSE 190,A00,092507,Dubnov; Shlomo,1,0,20,19
1656014495563,ECE 45,A01,083139,Congero; Spencer William,0,1,75,75
1656014501587,ECE 65,A50,083695,Saad; Andrew S,6,0,30,24
1656014501587,ECE 65,A51,095125,Staff,23,0,26,3
1656014507612,ECE 109,A01,091882,Touri; Behrouz,3,5,70,67
1656014513648,ECE 180,A00,083140,Abi Samra; Nicholas Camill,1,0,30,29
1656014513648,ECE 180,B00,083141,Abi Samra; Nicholas Camill,0,8,28,28
1656014519673,MATH 10A,A01,083735,Patchell; Gregory David,0,0,30,30
1656014519673,MATH 10A,A02,083736,Patchell; Gregory David,21,0,30,9
1656014519673,MATH 10A,A03,083737,Patchell; Gregory David,16,0,30,14
1656014525697,MATH 10B,A01,083207,Lim; Seonhee,1,1,34,33
1656014525697,MATH 10B,A02,083208,Lim; Seonhee,1,1,35,34
1656014525697,MATH 10B,A03,093472,Staff,1,0,34,33
1656014525697,MATH 10B,B01,083739,Sinha; Shubham,9,0,30,21
1656014531725,MATH 18,A01,083743,Cinel; Cameron Alexander,5,0,30,25
1656014531725,MATH 18,A02,083744,Cinel; Cameron Alexander,11,0,30,19
1656014531725,MATH 18,A03,083745,Cinel; Cameron Alexander,1,0,30,29
1656014531725,MATH 18,B01,083748,Ma; Zilu,0,0,36,36
1656014531725,MATH 18,B02,083749,Ma; Zilu,0,0,36,36
1656014531725,MATH 18,B03,083750,Ma; Zilu,0,0,36,36
1656014531725,MATH 18,B04,083751,Ma; Zilu,0,0,36,36
1656014531725,MATH 18,B05,093473,Staff,0,0,36,36
1656014531725,MATH 18,B06,093474,Staff,3,0,36,33
1656014537752,MATH 20A,A01,083754,Zheng; Zequn,10,0,40,30
1656014543777,MATH 20B,A01,083756,Briones; Jor-el Thomas Caparas,0,1,36,36
1656014543777,MATH 20B,A02,083757,Briones; Jor-el Thomas Caparas,1,0,36,35
1656014543777,MATH 20B,A03,093475,Staff,0,0,36,36
1656014549802,MATH 20C,A01,083760,Briones; Jor-el Thomas Caparas,0,2,35,35
1656014549802,MATH 20C,A02,083761,Briones; Jor-el Thomas Caparas,6,1,35,29
1656014549802,MATH 20C,A03,093476,Staff,0,0,35,35
1656014549802,MATH 20C,B01,083762,Bach; Quang Tran,3,0,30,27
1656014555826,MATH 20D,A01,083765,Tran; Brian Kha,2,0,30,28
1656014555826,MATH 20D,A02,083766,Tran; Brian Kha,0,1,30,30
1656014555826,MATH 20D,A03,083767,Tran; Brian Kha,1,0,30,29
1656014561851,MATH 20E,A01,083771,Ganguly; Soumya,0,1,32,32
1656014561851,MATH 20E,A02,083772,Ganguly; Soumya,1,1,32,31
1656014561851,MATH 20E,B01,083773,Ciotti; Benjamin,13,0,35,22
1656014561851,MATH 20E,B02,083774,Ciotti; Benjamin,12,0,35,23
1656014567881,MATH 103A,A01,083777,Greenfeld; Be'Eri,2,1,36,34
1656014567881,MATH 103A,A02,083778,Greenfeld; Be'Eri,2,0,36,34
1656014567881,MATH 103A,A03,093561,Staff,0,1,36,36
1656014567881,MATH 103A,B01,083779,Greenfeld; Be'Eri,7,1,36,29
1656014567881,MATH 103A,B02,083780,Greenfeld; Be'Eri,0,0,36,36
1656014567881,MATH 103A,B03,093562,Staff,0,0,36,36
1656014573906,MATH 105,A01,085443,Carter; Anne Toulson,4,1,35,31
1656014573906,MATH 105,A02,093477,Staff,8,0,35,27
1656014579931,MATH 109,A01,083213,Ganzberger; Geoffrey Michael,0,1,34,34
1656014579931,MATH 109,A02,083214,Ganzberger; Geoffrey Michael,0,0,34,34
1656014579931,MATH 109,A03,093478,Staff,1,0,34,33
1656014579931,MATH 109,B01,083215,Ganzberger; Geoffrey Michael,2,0,32,30
1656014579931,MATH 109,B02,083216,Ganzberger; Geoffrey Michael,0,0,32,32
1656014579931,MATH 109,B03,093479,Staff,4,0,32,28
1656014585955,MATH 142A,A01,083219,Chow; Bennett,1,0,32,31
1656014585955,MATH 142A,A02,083220,Chow; Bennett,7,0,32,25
1656014585955,MATH 142A,A03,093480,Staff,4,0,32,28
1656014585955,MATH 142A,B03,093481,Staff,3,0,32,29
1656014585955,MATH 142A,B04,093558,Staff,6,0,32,26
1656014585955,MATH 142A,B05,093559,Staff,0,0,32,32
1656014591985,MATH 193A,A01,083224,Rotar; Vladimir,1,1,34,33
1656014591985,MATH 193A,A02,083225,Rotar; Vladimir,0,0,34,34
1656014591985,MATH 193A,A03,083781,Rotar; Vladimir,2,0,34,32
1656014591985,MATH 193A,A04,083782,Rotar; Vladimir,3,0,34,31
1656014591985,MATH 193A,A05,093482,Rotar; Vladimir,0,0,34,34
1656014598014,MATH 197,001,091859,McAuley; Julian John,9999,0,9999,0
1656014598014,MATH 197,002,095566,Kedlaya; Kiran S.,9997,0,9999,2
1656014598014,MATH 197,003,095567,Xiao; Ming,9999,0,9999,0
1656014598014,MATH 197,004,095571,Perols; Johan Lars,9998,0,9999,1
1656014605079,COGS 9,A01,083615,Shannon; Kyle Michael,3,1,75,72
1656014611104,COGS 11,A01,083617,Boyle; Mary E. T.,11,1,48,37
1656014617128,COGS 13,A01,083071,Bastos; Amalia Pinkusfeld,4,2,71,67
1656014623151,COGS 14A,A01,092681,Semenuks; Arturs,4,25,100,96
1656014629173,COGS 14B,A01,083073,Cheng; Tzu-Han,7,0,63,56
1656014635199,COGS 17,A01,092677,Semenuks; Arturs,8,7,81,73
1656014641227,COGS 100,A01,083619,Allen; Michael Gordon,2,2,70,68
1656014647264,COGS 101A,A01,083621,Davis; Joshua Daniel,4,3,68,64
1656014653290,COGS 101B,A01,091572,Allen; Michael Gordon,0,0,65,65
1656014659318,COGS 101C,A01,083625,Delgado; Tania,7,0,35,28
1656014665368,COGS 107A,A01,083627,Boyle; Mary E. T.,1,2,60,59
1656014671390,COGS 118A,A01,083075,Gupta; Anjum,21,16,76,55
1656014677419,CSE 3,A50,083646,Miranda; Gregory Joseph,14,0,50,36
1656014683445,CSE 8A,A50,083650,Miranda; Gregory Joseph,3,11,56,53
1656014689471,CSE 11,A01,083080,Cao; Yingjun,0,65,40,40
1656014695494,CSE 12,A01,083652,Krause-Levy; Sophia Louisa,6,8,120,114
1656014701520,CSE 15L,A01,083654,Morris; Justin Loren,3,1,50,47
1656014701520,CSE 15L,A02,083655,Morris; Justin Loren,1,1,50,49
1656014707543,CSE 20,A01,083657,Tran; Khoa Dang,29,0,80,51
1656014713570,CSE 21,A01,095574,Bach; Quang Tran,23,0,48,25
1656014719594,CSE 30,A01,083084,Eldon; John,2,10,80,78
1656014719594,CSE 30,B01,095061,Bhaskar; Nishant,0,4,50,50
1656014725616,CSE 100,A01,083659,Cao; Yingjun,2,25,70,68
1656014731646,CSE 134B,A01,083661,Powell; Thomas Allan,6,6,100,94
1656014737669,CSE 140,A01,083663,Gungor; Onat,5,0,85,80
1656014743690,CSE 140L,A01,083088,Eldon; John,5,0,100,95
1656014749731,CSE 175,A01,083665,Kumar; Rakesh,0,0,25,25
1656014755758,CSE 190,A00,092507,Dubnov; Shlomo,1,0,20,19
1656014761787,ECE 45,A01,083139,Congero; Spencer William,0,1,75,75
1656014767829,ECE 65,A50,083695,Saad; Andrew S,6,0,30,24
1656014767829,ECE 65,A51,095125,Staff,23,0,26,3
1656014773926,ECE 109,A01,091882,Touri; Behrouz,3,5,70,67
1656014779968,ECE 180,A00,083140,Abi Samra; Nicholas Camill,1,0,30,29
1656014779968,ECE 180,B00,083141,Abi Samra; Nicholas Camill,0,8,28,28
1656014785996,MATH 10A,A01,083735,Patchell; Gregory David,0,0,30,30
1656014785996,MATH 10A,A02,083736,Patchell; Gregory David,21,0,30,9
1656014785996,MATH 10A,A03,083737,Patchell; Gregory David,16,0,30,14
1656014792021,MATH 10B,A01,083207,Lim; Seonhee,1,1,34,33
1656014792021,MATH 10B,A02,083208,Lim; Seonhee,1,1,35,34
1656014792021,MATH 10B,A03,093472,Staff,1,0,34,33
1656014792021,MATH 10B,B01,083739,Sinha; Shubham,9,0,30,21
1656014798046,MATH 18,A01,083743,Cinel; Cameron Alexander,5,0,30,25
1656014798046,MATH 18,A02,083744,Cinel; Cameron Alexander,11,0,30,19
1656014798046,MATH 18,A03,083745,Cinel; Cameron Alexander,1,0,30,29
1656014798046,MATH 18,B01,083748,Ma; Zilu,0,0,36,36
1656014798046,MATH 18,B02,083749,Ma; Zilu,0,0,36,36
1656014798046,MATH 18,B03,083750,Ma; Zilu,0,0,36,36
1656014798046,MATH 18,B04,083751,Ma; Zilu,0,0,36,36
1656014798046,MATH 18,B05,093473,Staff,0,0,36,36
1656014798046,MATH 18,B06,093474,Staff,3,0,36,33
1656014804073,MATH 20A,A01,083754,Zheng; Zequn,10,0,40,30
1656014810097,MATH 20B,A01,083756,Briones; Jor-el Thomas Caparas,0,1,36,36
1656014810097,MATH 20B,A02,083757,Briones; Jor-el Thomas Caparas,1,0,36,35
1656014810097,MATH 20B,A03,093475,Staff,0,0,36,36
1656014816119,MATH 20C,A01,083760,Briones; Jor-el Thomas Caparas,0,2,35,35
1656014816119,MATH 20C,A02,083761,Briones; Jor-el Thomas Caparas,6,1,35,29
1656014816119,MATH 20C,A03,093476,Staff,0,0,35,35
1656014816119,MATH 20C,B01,083762,Bach; Quang Tran,3,0,30,27
1656014822150,MATH 20D,A01,083765,Tran; Brian Kha,2,0,30,28
1656014822150,MATH 20D,A02,083766,Tran; Brian Kha,0,1,30,30
1656014822150,MATH 20D,A03,083767,Tran; Brian Kha,1,0,30,29
1656014828175,MATH 20E,A01,083771,Ganguly; Soumya,0,1,32,32
1656014828175,MATH 20E,A02,083772,Ganguly; Soumya,1,1,32,31
1656014828175,MATH 20E,B01,083773,Ciotti; Benjamin,13,0,35,22
1656014828175,MATH 20E,B02,083774,Ciotti; Benjamin,12,0,35,23
1656014834220,MATH 103A,A01,083777,Greenfeld; Be'Eri,2,1,36,34
1656014834220,MATH 103A,A02,083778,Greenfeld; Be'Eri,2,0,36,34
1656014834220,MATH 103A,A03,093561,Staff,0,1,36,36
1656014834220,MATH 103A,B01,083779,Greenfeld; Be'Eri,7,1,36,29
1656014834220,MATH 103A,B02,083780,Greenfeld; Be'Eri,0,0,36,36
1656014834220,MATH 103A,B03,093562,Staff,0,0,36,36
1656014840260,MATH 105,A01,085443,Carter; Anne Toulson,4,1,35,31
1656014840260,MATH 105,A02,093477,Staff,8,0,35,27
1656014846292,MATH 109,A01,083213,Ganzberger; Geoffrey Michael,0,1,34,34
1656014846292,MATH 109,A02,083214,Ganzberger; Geoffrey Michael,0,0,34,34
1656014846292,MATH 109,A03,093478,Staff,1,0,34,33
1656014846292,MATH 109,B01,083215,Ganzberger; Geoffrey Michael,2,0,32,30
1656014846292,MATH 109,B02,083216,Ganzberger; Geoffrey Michael,0,0,32,32
1656014846292,MATH 109,B03,093479,Staff,4,0,32,28
1656014852329,MATH 142A,A01,083219,Chow; Bennett,1,0,32,31
1656014852329,MATH 142A,A02,083220,Chow; Bennett,7,0,32,25
1656014852329,MATH 142A,A03,093480,Staff,4,0,32,28
1656014852329,MATH 142A,B03,093481,Staff,3,0,32,29
1656014852329,MATH 142A,B04,093558,Staff,6,0,32,26
1656014852329,MATH 142A,B05,093559,Staff,0,0,32,32
1656014858367,MATH 193A,A01,083224,Rotar; Vladimir,1,1,34,33
1656014858367,MATH 193A,A02,083225,Rotar; Vladimir,0,0,34,34
1656014858367,MATH 193A,A03,083781,Rotar; Vladimir,2,0,34,32
1656014858367,MATH 193A,A04,083782,Rotar; Vladimir,3,0,34,31
1656014858367,MATH 193A,A05,093482,Rotar; Vladimir,0,0,34,34
1656014864393,MATH 197,001,091859,McAuley; Julian John,9999,0,9999,0
1656014864393,MATH 197,002,095566,Kedlaya; Kiran S.,9997,0,9999,2
1656014864393,MATH 197,003,095567,Xiao; Ming,9999,0,9999,0
1656014864393,MATH 197,004,095571,Perols; Johan Lars,9998,0,9999,1
1656014871458,COGS 9,A01,083615,Shannon; Kyle Michael,3,1,75,72
1656014877486,COGS 11,A01,083617,Boyle; Mary E. T.,11,1,48,37
1656014883514,COGS 13,A01,083071,Bastos; Amalia Pinkusfeld,4,2,71,67
1656014889542,COGS 14A,A01,092681,Semenuks; Arturs,4,25,100,96
1656014895579,COGS 14B,A01,083073,Cheng; Tzu-Han,7,0,63,56
1656014901602,COGS 17,A01,092677,Semenuks; Arturs,8,7,81,73
1656014907626,COGS 100,A01,083619,Allen; Michael Gordon,2,2,70,68
1656014913653,COGS 101A,A01,083621,Davis; Joshua Daniel,4,3,68,64
1656014919678,COGS 101B,A01,091572,Allen; Michael Gordon,0,0,65,65
1656014925700,COGS 101C,A01,083625,Delgado; Tania,7,0,35,28
1656014931726,COGS 107A,A01,083627,Boyle; Mary E. T.,1,2,60,59
1656014937753,COGS 118A,A01,083075,Gupta; Anjum,21,16,76,55
1656014943778,CSE 3,A50,083646,Miranda; Gregory Joseph,14,0,50,36
1656014949808,CSE 8A,A50,083650,Miranda; Gregory Joseph,3,11,56,53
1656014955833,CSE 11,A01,083080,Cao; Yingjun,0,65,40,40
1656014961855,CSE 12,A01,083652,Krause-Levy; Sophia Louisa,6,8,120,114
1656014967877,CSE 15L,A01,083654,Morris; Justin Loren,3,1,50,47
1656014967877,CSE 15L,A02,083655,Morris; Justin Loren,1,1,50,49
1656014973900,CSE 20,A01,083657,Tran; Khoa Dang,29,0,80,51
1656014979926,CSE 21,A01,095574,Bach; Quang Tran,23,0,48,25
1656014985950,CSE 30,A01,083084,Eldon; John,2,10,80,78
1656014985950,CSE 30,B01,095061,Bhaskar; Nishant,0,4,50,50
1656014991973,CSE 100,A01,083659,Cao; Yingjun,2,25,70,68
1656014998001,CSE 134B,A01,083661,Powell; Thomas Allan,6,6,100,94
1656015004025,CSE 140,A01,083663,Gungor; Onat,5,0,85,80
1656015010052,CSE 140L,A01,083088,Eldon; John,5,0,100,95
1656015016075,CSE 175,A01,083665,Kumar; Rakesh,0,0,25,25
1656015022098,CSE 190,A00,092507,Dubnov; Shlomo,1,0,20,19
1656015028122,ECE 45,A01,083139,Congero; Spencer William,0,1,75,75
1656015034146,ECE 65,A50,083695,Saad; Andrew S,6,0,30,24
1656015034146,ECE 65,A51,095125,Staff,23,0,26,3
1656015040171,ECE 109,A01,091882,Touri; Behrouz,3,5,70,67
1656015046198,ECE 180,A00,083140,Abi Samra; Nicholas Camill,1,0,30,29
1656015046198,ECE 180,B00,083141,Abi Samra; Nicholas Camill,0,8,28,28
1656015052221,MATH 10A,A01,083735,Patchell; Gregory David,0,0,30,30
1656015052221,MATH 10A,A02,083736,Patchell; Gregory David,21,0,30,9
1656015052221,MATH 10A,A03,083737,Patchell; Gregory David,16,0,30,14
1656015058245,MATH 10B,A01,083207,Lim; Seonhee,1,1,34,33
1656015058245,MATH 10B,A02,083208,Lim; Seonhee,1,1,35,34
1656015058245,MATH 10B,A03,093472,Staff,1,0,34,33
1656015058245,MATH 10B,B01,083739,Sinha; Shubham,9,0,30,21
1656015064281,MATH 18,A01,083743,Cinel; Cameron Alexander,5,0,30,25
1656015064281,MATH 18,A02,083744,Cinel; Cameron Alexander,11,0,30,19
1656015064281,MATH 18,A03,083745,Cinel; Cameron Alexander,1,0,30,29
1656015064281,MATH 18,B01,083748,Ma; Zilu,0,0,36,36
1656015064281,MATH 18,B02,083749,Ma; Zilu,0,0,36,36
1656015064281,MATH 18,B03,083750,Ma; Zilu,0,0,36,36
1656015064281,MATH 18,B04,083751,Ma; Zilu,0,0,36,36
1656015064281,MATH 18,B05,093473,Staff,0,0,36,36
1656015064281,MATH 18,B06,093474,Staff,3,0,36,33
1656015070306,MATH 20A,A01,083754,Zheng; Zequn,10,0,40,30
1656015076339,MATH 20B,A01,083756,Briones; Jor-el Thomas Caparas,0,1,36,36
1656015076339,MATH 20B,A02,083757,Briones; Jor-el Thomas Caparas,1,0,36,35
1656015076339,MATH 20B,A03,093475,Staff,0,0,36,36
1656015082377,MATH 20C,A01,083760,Briones; Jor-el Thomas Caparas,0,2,35,35
1656015082377,MATH 20C,A02,083761,Briones; Jor-el Thomas Caparas,6,1,35,29
1656015082377,MATH 20C,A03,093476,Staff,0,0,35,35
1656015082377,MATH 20C,B01,083762,Bach; Quang Tran,3,0,30,27
1656015088405,MATH 20D,A01,083765,Tran; Brian Kha,2,0,30,28
1656015088405,MATH 20D,A02,083766,Tran; Brian Kha,0,1,30,30
1656015088405,MATH 20D,A03,083767,Tran; Brian Kha,1,0,30,29
1656015094428,MATH 20E,A01,083771,Ganguly; Soumya,0,1,32,32
1656015094428,MATH 20E,A02,083772,Ganguly; Soumya,1,1,32,31
1656015094428,MATH 20E,B01,083773,Ciotti; Benjamin,13,0,35,22
1656015094428,MATH 20E,B02,083774,Ciotti; Benjamin,12,0,35,23
1656015100454,MATH 103A,A01,083777,Greenfeld; Be'Eri,2,1,36,34
1656015100454,MATH 103A,A02,083778,Greenfeld; Be'Eri,2,0,36,34
1656015100454,MATH 103A,A03,093561,Staff,0,1,36,36
1656015100454,MATH 103A,B01,083779,Greenfeld; Be'Eri,7,1,36,29
1656015100454,MATH 103A,B02,083780,Greenfeld; Be'Eri,0,0,36,36
1656015100454,MATH 103A,B03,093562,Staff,0,0,36,36
1656015106477,MATH 105,A01,085443,Carter; Anne Toulson,4,1,35,31
1656015106477,MATH 105,A02,093477,Staff,8,0,35,27
1656015112501,MATH 109,A01,083213,Ganzberger; Geoffrey Michael,0,1,34,34
1656015112501,MATH 109,A02,083214,Ganzberger; Geoffrey Michael,0,0,34,34
1656015112501,MATH 109,A03,093478,Staff,1,0,34,33
1656015112501,MATH 109,B01,083215,Ganzberger; Geoffrey Michael,2,0,32,30
1656015112501,MATH 109,B02,083216,Ganzberger; Geoffrey Michael,0,0,32,32
1656015112501,MATH 109,B03,093479,Staff,4,0,32,28
1656015118522,MATH 142A,A01,083219,Chow; Bennett,1,0,32,31
1656015118522,MATH 142A,A02,083220,Chow; Bennett,7,0,32,25
1656015118522,MATH 142A,A03,093480,Staff,4,0,32,28
1656015118522,MATH 142A,B03,093481,Staff,3,0,32,29
1656015118522,MATH 142A,B04,093558,Staff,6,0,32,26
1656015118522,MATH 142A,B05,093559,Staff,0,0,32,32
1656015124550,MATH 193A,A01,083224,Rotar; Vladimir,1,1,34,33
1656015124550,MATH 193A,A02,083225,Rotar; Vladimir,0,0,34,34
1656015124550,MATH 193A,A03,083781,Rotar; Vladimir,2,0,34,32
1656015124550,MATH 193A,A04,083782,Rotar; Vladimir,3,0,34,31
1656015124550,MATH 193A,A05,093482,Rotar; Vladimir,0,0,34,34
1656015130574,MATH 197,001,091859,McAuley; Julian John,9999,0,9999,0
1656015130574,MATH 197,002,095566,Kedlaya; Kiran S.,9997,0,9999,2
1656015130574,MATH 197,003,095567,Xiao; Ming,9999,0,9999,0
1656015130574,MATH 197,004,095571,Perols; Johan Lars,9998,0,9999,1
1656015137637,COGS 9,A01,083615,Shannon; Kyle Michael,3,1,75,72
1656015143661,COGS 11,A01,083617,Boyle; Mary E. T.,11,1,48,37
1656015149698,COGS 13,A01,083071,Bastos; Amalia Pinkusfeld,4,2,71,67
1656015155738,COGS 14A,A01,092681,Semenuks; Arturs,4,25,100,96
1656015161765,COGS 14B,A01,083073,Cheng; Tzu-Han,7,0,63,56
1656015167789,COGS 17,A01,092677,Semenuks; Arturs,8,7,81,73
1656015173812,COGS 100,A01,083619,Allen; Michael Gordon,2,2,70,68
1656015179835,COGS 101A,A01,083621,Davis; Joshua Daniel,4,3,68,64
1656015185868,COGS 101B,A01,091572,Allen; Michael Gordon,0,0,65,65
1656015191901,COGS 101C,A01,083625,Delgado; Tania,7,0,35,28
1656015197924,COGS 107A,A01,083627,Boyle; Mary E. T.,1,2,60,59
1656015203956,COGS 118A,A01,083075,Gupta; Anjum,21,16,76,55
1656015209980,CSE 3,A50,083646,Miranda; Gregory Joseph,14,0,50,36
1656015216003,CSE 8A,A50,083650,Miranda; Gregory Joseph,3,11,56,53
1656015222058,CSE 11,A01,083080,Cao; Yingjun,0,65,40,40
1656015228081,CSE 12,A01,083652,Krause-Levy; Sophia Louisa,6,8,120,114
1656015234105,CSE 15L,A01,083654,Morris; Justin Loren,3,1,50,47
1656015234105,CSE 15L,A02,083655,Morris; Justin Loren,1,1,50,49
1656015240133,CSE 20,A01,083657,Tran; Khoa Dang,29,0,80,51
1656015246165,CSE 21,A01,095574,Bach; Quang Tran,23,0,48,25
1656015252193,CSE 30,A01,083084,Eldon; John,2,10,80,78
1656015252193,CSE 30,B01,095061,Bhaskar; Nishant,0,4,50,50
1656015258218,CSE 100,A01,083659,Cao; Yingjun,2,25,70,68
1656015264252,CSE 134B,A01,083661,Powell; Thomas Allan,6,6,100,94
1656015270276,CSE 140,A01,083663,Gungor; Onat,5,0,85,80
1656015276309,CSE 140L,A01,083088,Eldon; John,5,0,100,95
1656015282340,CSE 175,A01,083665,Kumar; Rakesh,0,0,25,25
1656015288369,CSE 190,A00,092507,Dubnov; Shlomo,1,0,20,19
1656015294393,ECE 45,A01,083139,Congero; Spencer William,0,1,75,75
1656015300425,ECE 65,A50,083695,Saad; Andrew S,6,0,30,24
1656015300425,ECE 65,A51,095125,Staff,23,0,26,3
1656015306450,ECE 109,A01,091882,Touri; Behrouz,3,5,70,67
1656015312476,ECE 180,A00,083140,Abi Samra; Nicholas Camill,1,0,30,29
1656015312476,ECE 180,B00,083141,Abi Samra; Nicholas Camill,0,8,28,28
1656015318506,MATH 10A,A01,083735,Patchell; Gregory David,0,0,30,30
1656015318506,MATH 10A,A02,083736,Patchell; Gregory David,21,0,30,9
1656015318506,MATH 10A,A03,083737,Patchell; Gregory David,16,0,30,14
1656015324536,MATH 10B,A01,083207,Lim; Seonhee,1,1,34,33
1656015324536,MATH 10B,A02,083208,Lim; Seonhee,1,1,35,34
1656015324536,MATH 10B,A03,093472,Staff,1,0,34,33
1656015324536,MATH 10B,B01,083739,Sinha; Shubham,9,0,30,21
1656015330566,MATH 18,A01,083743,Cinel; Cameron Alexander,5,0,30,25
1656015330566,MATH 18,A02,083744,Cinel; Cameron Alexander,11,0,30,19
1656015330566,MATH 18,A03,083745,Cinel; Cameron Alexander,1,0,30,29
1656015330566,MATH 18,B01,083748,Ma; Zilu,0,0,36,36
1656015330566,MATH 18,B02,083749,Ma; Zilu,0,0,36,36
1656015330566,MATH 18,B03,083750,Ma; Zilu,0,0,36,36
1656015330566,MATH 18,B04,083751,Ma; Zilu,0,0,36,36
1656015330566,MATH 18,B05,093473,Staff,0,0,36,36
1656015330566,MATH 18,B06,093474,Staff,3,0,36,33
1656015336589,MATH 20A,A01,083754,Zheng; Zequn,10,0,40,30
1656015342618,MATH 20B,A01,083756,Briones; Jor-el Thomas Caparas,0,1,36,36
1656015342618,MATH 20B,A02,083757,Briones; Jor-el Thomas Caparas,1,0,36,35
1656015342618,MATH 20B,A03,093475,Staff,0,0,36,36
1656015348666,MATH 20C,A01,083760,Briones; Jor-el Thomas Caparas,0,2,35,35
1656015348666,MATH 20C,A02,083761,Briones; Jor-el Thomas Caparas,6,1,35,29
1656015348666,MATH 20C,A03,093476,Staff,0,0,35,35
1656015348666,MATH 20C,B01,083762,Bach; Quang Tran,3,0,30,27
1656015354690,MATH 20D,A01,083765,Tran; Brian Kha,2,0,30,28
1656015354690,MATH 20D,A02,083766,Tran; Brian Kha,0,1,30,30
1656015354690,MATH 20D,A03,083767,Tran; Brian Kha,1,0,30,29
1656015360724,MATH 20E,A01,083771,Ganguly; Soumya,0,1,32,32
1656015360724,MATH 20E,A02,083772,Ganguly; Soumya,1,1,32,31
1656015360724,MATH 20E,B01,083773,Ciotti; Benjamin,13,0,35,22
1656015360724,MATH 20E,B02,083774,Ciotti; Benjamin,12,0,35,23
1656015366764,MATH 103A,A01,083777,Greenfeld; Be'Eri,2,1,36,34
1656015366764,MATH 103A,A02,083778,Greenfeld; Be'Eri,2,0,36,34
1656015366764,MATH 103A,A03,093561,Staff,0,1,36,36
1656015366764,MATH 103A,B01,083779,Greenfeld; Be'Eri,7,1,36,29
1656015366764,MATH 103A,B02,083780,Greenfeld; Be'Eri,0,0,36,36
1656015366764,MATH 103A,B03,093562,Staff,0,0,36,36
1656015372866,MATH 105,A01,085443,Carter; Anne Toulson,4,1,35,31
1656015372866,MATH 105,A02,093477,Staff,8,0,35,27
1656015378889,MATH 109,A01,083213,Ganzberger; Geoffrey Michael,0,1,34,34
1656015378889,MATH 109,A02,083214,Ganzberger; Geoffrey Michael,0,0,34,34
1656015378889,MATH 109,A03,093478,Staff,1,0,34,33
1656015378889,MATH 109,B01,083215,Ganzberger; Geoffrey Michael,2,0,32,30
1656015378889,MATH 109,B02,083216,Ganzberger; Geoffrey Michael,0,0,32,32
1656015378889,MATH 109,B03,093479,Staff,4,0,32,28
1656015384921,MATH 142A,A01,083219,Chow; Bennett,1,0,32,31
1656015384921,MATH 142A,A02,083220,Chow; Bennett,7,0,32,25
1656015384921,MATH 142A,A03,093480,Staff,4,0,32,28
1656015384921,MATH 142A,B03,093481,Staff,3,0,32,29
1656015384921,MATH 142A,B04,093558,Staff,6,0,32,26
1656015384921,MATH 142A,B05,093559,Staff,0,0,32,32
1656015390950,MATH 193A,A01,083224,Rotar; Vladimir,1,1,34,33
1656015390950,MATH 193A,A02,083225,Rotar; Vladimir,0,0,34,34
1656015390950,MATH 193A,A03,083781,Rotar; Vladimir,2,0,34,32
1656015390950,MATH 193A,A04,083782,Rotar; Vladimir,3,0,34,31
1656015390950,MATH 193A,A05,093482,Rotar; Vladimir,0,0,34,34
1656015396978,MATH 197,001,091859,McAuley; Julian John,9999,0,9999,0
1656015396978,MATH 197,002,095566,Kedlaya; Kiran S.,9997,0,9999,2
1656015396978,MATH 197,003,095567,Xiao; Ming,9999,0,9999,0
1656015396978,MATH 197,004,095571,Perols; Johan Lars,9998,0,9999,1
1656015404051,COGS 9,A01,083615,Shannon; Kyle Michael,3,1,75,72
1656015410079,COGS 11,A01,083617,Boyle; Mary E. T.,11,1,48,37
1656015416102,COGS 13,A01,083071,Bastos; Amalia Pinkusfeld,4,2,71,67
1656015422130,COGS 14A,A01,092681,Semenuks; Arturs,4,25,100,96
1656015428160,COGS 14B,A01,083073,Cheng; Tzu-Han,7,0,63,56
1656015434187,COGS 17,A01,092677,Semenuks; Arturs,8,7,81,73
1656015440215,COGS 100,A01,083619,Allen; Michael Gordon,2,2,70,68
1656015446238,COGS 101A,A01,083621,Davis; Joshua Daniel,4,3,68,64
1656015452262,COGS 101B,A01,091572,Allen; Michael Gordon,0,0,65,65
1656015458286,COGS 101C,A01,083625,Delgado; Tania,7,0,35,28
1656015464312,COGS 107A,A01,083627,Boyle; Mary E. T.,1,2,60,59
1656015470339,COGS 118A,A01,083075,Gupta; Anjum,21,16,76,55
1656015476376,CSE 3,A50,083646,Miranda; Gregory Joseph,14,0,50,36
1656015482404,CSE 8A,A50,083650,Miranda; Gregory Joseph,3,11,56,53
1656015488435,CSE 11,A01,083080,Cao; Yingjun,0,65,40,40
1656015494458,CSE 12,A01,083652,Krause-Levy; Sophia Louisa,6,8,120,114
1656015500483,CSE 15L,A01,083654,Morris; Justin Loren,3,1,50,47
1656015500483,CSE 15L,A02,083655,Morris; Justin Loren,1,1,50,49
1656015506505,CSE 20,A01,083657,Tran; Khoa Dang,29,0,80,51
1656015512527,CSE 21,A01,095574,Bach; Quang Tran,23,0,48,25
1656015518552,CSE 30,A01,083084,Eldon; John,2,10,80,78
1656015518552,CSE 30,B01,095061,Bhaskar; Nishant,0,4,50,50
1656015524579,CSE 100,A01,083659,Cao; Yingjun,2,25,70,68
1656015530606,CSE 134B,A01,083661,Powell; Thomas Allan,6,6,100,94
1656015536630,CSE 140,A01,083663,Gungor; Onat,5,0,85,80
1656015542654,CSE 140L,A01,083088,Eldon; John,5,0,100,95
1656015548679,CSE 175,A01,083665,Kumar; Rakesh,0,0,25,25
1656015554707,CSE 190,A00,092507,Dubnov; Shlomo,1,0,20,19
1656015560732,ECE 45,A01,083139,Congero; Spencer William,0,1,75,75
1656015566759,ECE 65,A50,083695,Saad; Andrew S,6,0,30,24
1656015566759,ECE 65,A51,095125,Staff,23,0,26,3
1656015572782,ECE 109,A01,091882,Touri; Behrouz,3,5,70,67
1656015578817,ECE 180,A00,083140,Abi Samra; Nicholas Camill,1,0,30,29
1656015578817,ECE 180,B00,083141,Abi Samra; Nicholas Camill,0,8,28,28
1656015584840,MATH 10A,A01,083735,Patchell; Gregory David,0,0,30,30
1656015584840,MATH 10A,A02,083736,Patchell; Gregory David,21,0,30,9
1656015584840,MATH 10A,A03,083737,Patchell; Gregory David,16,0,30,14
1656015590870,MATH 10B,A01,083207,Lim; Seonhee,1,1,34,33
1656015590870,MATH 10B,A02,083208,Lim; Seonhee,1,1,35,34
1656015590870,MATH 10B,A03,093472,Staff,1,0,34,33
1656015590870,MATH 10B,B01,083739,Sinha; Shubham,9,0,30,21
1656015596894,MATH 18,A01,083743,Cinel; Cameron Alexander,5,0,30,25
1656015596894,MATH 18,A02,083744,Cinel; Cameron Alexander,11,0,30,19
1656015596894,MATH 18,A03,083745,Cinel; Cameron Alexander,1,0,30,29
1656015596894,MATH 18,B01,083748,Ma; Zilu,0,0,36,36
1656015596894,MATH 18,B02,083749,Ma; Zilu,0,0,36,36
1656015596894,MATH 18,B03,083750,Ma; Zilu,0,0,36,36
1656015596894,MATH 18,B04,083751,Ma; Zilu,0,0,36,36
1656015596894,MATH 18,B05,093473,Staff,0,0,36,36
1656015596894,MATH 18,B06,093474,Staff,3,0,36,33
1656015602924,MATH 20A,A01,083754,Zheng; Zequn,10,0,40,30
1656015608946,MATH 20B,A01,083756,Briones; Jor-el Thomas Caparas,0,1,36,36
1656015608946,MATH 20B,A02,083757,Briones; Jor-el Thomas Caparas,1,0,36,35
1656015608946,MATH 20B,A03,093475,Staff,0,0,36,36
1656015614970,MATH 20C,A01,083760,Briones; Jor-el Thomas Caparas,0,2,35,35
1656015614970,MATH 20C,A02,083761,Briones; Jor-el Thomas Caparas,6,1,35,29
1656015614970,MATH 20C,A03,093476,Staff,0,0,35,35
1656015614970,MATH 20C,B01,083762,Bach; Quang Tran,3,0,30,27
1656015620993,MATH 20D,A01,083765,Tran; Brian Kha,2,0,30,28
1656015620993,MATH 20D,A02,083766,Tran; Brian Kha,0,1,30,30
1656015620993,MATH 20D,A03,083767,Tran; Brian Kha,1,0,30,29
1656015627025,MATH 20E,A01,083771,Ganguly; Soumya,0,1,32,32
1656015627025,MATH 20E,A02,083772,Ganguly; Soumya,1,1,32,31
1656015627025,MATH 20E,B01,083773,Ciotti; Benjamin,13,0,35,22
1656015627025,MATH 20E,B02,083774,Ciotti; Benjamin,12,0,35,23
1656015633053,MATH 103A,A01,083777,Greenfeld; Be'Eri,2,1,36,34
1656015633053,MATH 103A,A02,083778,Greenfeld; Be'Eri,2,0,36,34
1656015633053,MATH 103A,A03,093561,Staff,0,1,36,36
1656015633053,MATH 103A,B01,083779,Greenfeld; Be'Eri,7,1,36,29
1656015633053,MATH 103A,B02,083780,Greenfeld; Be'Eri,0,0,36,36
1656015633053,MATH 103A,B03,093562,Staff,0,0,36,36
1656015639077,MATH 105,A01,085443,Carter; Anne Toulson,4,1,35,31
1656015639077,MATH 105,A02,093477,Staff,8,0,35,27
1656015645101,MATH 109,A01,083213,Ganzberger; Geoffrey Michael,0,1,34,34
1656015645101,MATH 109,A02,083214,Ganzberger; Geoffrey Michael,0,0,34,34
1656015645101,MATH 109,A03,093478,Staff,1,0,34,33
1656015645101,MATH 109,B01,083215,Ganzberger; Geoffrey Michael,2,0,32,30
1656015645101,MATH 109,B02,083216,Ganzberger; Geoffrey Michael,0,0,32,32
1656015645101,MATH 109,B03,093479,Staff,4,0,32,28
1656015651132,MATH 142A,A01,083219,Chow; Bennett,1,0,32,31
1656015651132,MATH 142A,A02,083220,Chow; Bennett,7,0,32,25
1656015651132,MATH 142A,A03,093480,Staff,4,0,32,28
1656015651132,MATH 142A,B03,093481,Staff,3,0,32,29
1656015651132,MATH 142A,B04,093558,Staff,6,0,32,26
1656015651132,MATH 142A,B05,093559,Staff,0,0,32,32
1656015657160,MATH 193A,A01,083224,Rotar; Vladimir,1,1,34,33
1656015657160,MATH 193A,A02,083225,Rotar; Vladimir,0,0,34,34
1656015657160,MATH 193A,A03,083781,Rotar; Vladimir,2,0,34,32
1656015657160,MATH 193A,A04,083782,Rotar; Vladimir,3,0,34,31
1656015657160,MATH 193A,A05,093482,Rotar; Vladimir,0,0,34,34
1656015663199,MATH 197,001,091859,McAuley; Julian John,9999,0,9999,0
1656015663199,MATH 197,002,095566,Kedlaya; Kiran S.,9997,0,9999,2
1656015663199,MATH 197,003,095567,Xiao; Ming,9999,0,9999,0
1656015663199,MATH 197,004,095571,Perols; Johan Lars,9998,0,9999,1
1656015670266,COGS 9,A01,083615,Shannon; Kyle Michael,3,1,75,72
1656015676288,COGS 11,A01,083617,Boyle; Mary E. T.,11,1,48,37
1656015682314,COGS 13,A01,083071,Bastos; Amalia Pinkusfeld,4,2,71,67
1656015688340,COGS 14A,A01,092681,Semenuks; Arturs,4,25,100,96
1656015694364,COGS 14B,A01,083073,Cheng; Tzu-Han,7,0,63,56
1656015700392,COGS 17,A01,092677,Semenuks; Arturs,8,7,81,73
1656015706414,COGS 100,A01,083619,Allen; Michael Gordon,2,2,70,68
1656015712450,COGS 101A,A01,083621,Davis; Joshua Daniel,4,3,68,64
1656015718475,COGS 101B,A01,091572,Allen; Michael Gordon,0,0,65,65
1656015724500,COGS 101C,A01,083625,Delgado; Tania,7,0,35,28
1656015730524,COGS 107A,A01,083627,Boyle; Mary E. T.,1,2,60,59
1656015736547,COGS 118A,A01,083075,Gupta; Anjum,21,16,76,55
1656015742579,CSE 3,A50,083646,Miranda; Gregory Joseph,14,0,50,36
1656015748613,CSE 8A,A50,083650,Miranda; Gregory Joseph,3,11,56,53
1656015754636,CSE 11,A01,083080,Cao; Yingjun,0,66,40,40
1656015760664,CSE 12,A01,083652,Krause-Levy; Sophia Louisa,6,8,120,114
1656015766687,CSE 15L,A01,083654,Morris; Justin Loren,3,1,50,47
1656015766687,CSE 15L,A02,083655,Morris; Justin Loren,1,1,50,49
1656015772711,CSE 20,A01,083657,Tran; Khoa Dang,29,0,80,51
1656015778747,CSE 21,A01,095574,Bach; Quang Tran,23,0,48,25
1656015784771,CSE 30,A01,083084,Eldon; John,2,10,80,78
1656015784771,CSE 30,B01,095061,Bhaskar; Nishant,0,4,50,50
1656015790795,CSE 100,A01,083659,Cao; Yingjun,2,25,70,68
1656015796819,CSE 134B,A01,083661,Powell; Thomas Allan,6,6,100,94
1656015802841,CSE 140,A01,083663,Gungor; Onat,5,0,85,80
1656015808863,CSE 140L,A01,083088,Eldon; John,5,0,100,95
1656015814890,CSE 175,A01,083665,Kumar; Rakesh,0,0,25,25
1656015820916,CSE 190,A00,092507,Dubnov; Shlomo,1,0,20,19
1656015826939,ECE 45,A01,083139,Congero; Spencer William,0,1,75,75
1656015832960,ECE 65,A50,083695,Saad; Andrew S,6,0,30,24
1656015832960,ECE 65,A51,095125,Staff,23,0,26,3
1656015838984,ECE 109,A01,091882,Touri; Behrouz,3,5,70,67
1656015845010,ECE 180,A00,083140,Abi Samra; Nicholas Camill,1,0,30,29
1656015845010,ECE 180,B00,083141,Abi Samra; Nicholas Camill,0,8,28,28
1656015851053,MATH 10A,A01,083735,Patchell; Gregory David,0,0,30,30
1656015851053,MATH 10A,A02,083736,Patchell; Gregory David,21,0,30,9
1656015851053,MATH 10A,A03,083737,Patchell; Gregory David,16,0,30,14
1656015857083,MATH 10B,A01,083207,Lim; Seonhee,1,1,34,33
1656015857083,MATH 10B,A02,083208,Lim; Seonhee,1,1,35,34
1656015857083,MATH 10B,A03,093472,Staff,1,0,34,33
1656015857083,MATH 10B,B01,083739,Sinha; Shubham,9,0,30,21
1656015863110,MATH 18,A01,083743,Cinel; Cameron Alexander,5,0,30,25
1656015863110,MATH 18,A02,083744,Cinel; Cameron Alexander,11,0,30,19
1656015863110,MATH 18,A03,083745,Cinel; Cameron Alexander,1,0,30,29
1656015863110,MATH 18,B01,083748,Ma; Zilu,0,0,36,36
1656015863110,MATH 18,B02,083749,Ma; Zilu,0,0,36,36
1656015863110,MATH 18,B03,083750,Ma; Zilu,0,0,36,36
1656015863110,MATH 18,B04,083751,Ma; Zilu,0,0,36,36
1656015863110,MATH 18,B05,093473,Staff,0,0,36,36
1656015863110,MATH 18,B06,093474,Staff,3,0,36,33
1656015869135,MATH 20A,A01,083754,Zheng; Zequn,10,0,40,30
1656015875162,MATH 20B,A01,083756,Briones; Jor-el Thomas Caparas,0,1,36,36
1656015875162,MATH 20B,A02,083757,Briones; Jor-el Thomas Caparas,1,0,36,35
1656015875162,MATH 20B,A03,093475,Staff,0,0,36,36
1656015881195,MATH 20C,A01,083760,Briones; Jor-el Thomas Caparas,0,2,35,35
1656015881195,MATH 20C,A02,083761,Briones; Jor-el Thomas Caparas,6,1,35,29
1656015881195,MATH 20C,A03,093476,Staff,0,0,35,35
1656015881195,MATH 20C,B01,083762,Bach; Quang Tran,3,0,30,27
1656015887220,MATH 20D,A01,083765,Tran; Brian Kha,2,0,30,28
1656015887220,MATH 20D,A02,083766,Tran; Brian Kha,0,1,30,30
1656015887220,MATH 20D,A03,083767,Tran; Brian Kha,1,0,30,29
1656015893249,MATH 20E,A01,083771,Ganguly; Soumya,0,1,32,32
1656015893249,MATH 20E,A02,083772,Ganguly; Soumya,1,1,32,31
1656015893249,MATH 20E,B01,083773,Ciotti; Benjamin,13,0,35,22
1656015893249,MATH 20E,B02,083774,Ciotti; Benjamin,12,0,35,23
1656015899273,MATH 103A,A01,083777,Greenfeld; Be'Eri,2,1,36,34
1656015899273,MATH 103A,A02,083778,Greenfeld; Be'Eri,2,0,36,34
1656015899273,MATH 103A,A03,093561,Staff,0,1,36,36
1656015899273,MATH 103A,B01,083779,Greenfeld; Be'Eri,7,1,36,29
1656015899273,MATH 103A,B02,083780,Greenfeld; Be'Eri,0,0,36,36
1656015899273,MATH 103A,B03,093562,Staff,0,0,36,36
1656015905299,MATH 105,A01,085443,Carter; Anne Toulson,4,1,35,31
1656015905299,MATH 105,A02,093477,Staff,8,0,35,27
1656015911332,MATH 109,A01,083213,Ganzberger; Geoffrey Michael,0,1,34,34
1656015911332,MATH 109,A02,083214,Ganzberger; Geoffrey Michael,0,0,34,34
1656015911332,MATH 109,A03,093478,Staff,1,0,34,33
1656015911332,MATH 109,B01,083215,Ganzberger; Geoffrey Michael,2,0,32,30
1656015911332,MATH 109,B02,083216,Ganzberger; Geoffrey Michael,0,0,32,32
1656015911332,MATH 109,B03,093479,Staff,4,0,32,28
1656015917357,MATH 142A,A01,083219,Chow; Bennett,1,0,32,31
1656015917357,MATH 142A,A02,083220,Chow; Bennett,7,0,32,25
1656015917357,MATH 142A,A03,093480,Staff,4,0,32,28
1656015917357,MATH 142A,B03,093481,Staff,3,0,32,29
1656015917357,MATH 142A,B04,093558,Staff,6,0,32,26
1656015917357,MATH 142A,B05,093559,Staff,0,0,32,32
1656015923387,MATH 193A,A01,083224,Rotar; Vladimir,1,1,34,33
1656015923387,MATH 193A,A02,083225,Rotar; Vladimir,0,0,34,34
1656015923387,MATH 193A,A03,083781,Rotar; Vladimir,2,0,34,32
1656015923387,MATH 193A,A04,083782,Rotar; Vladimir,3,0,34,31
1656015923387,MATH 193A,A05,093482,Rotar; Vladimir,0,0,34,34
1656015929412,MATH 197,001,091859,McAuley; Julian John,9999,0,9999,0
1656015929412,MATH 197,002,095566,Kedlaya; Kiran S.,9997,0,9999,2
1656015929412,MATH 197,003,095567,Xiao; Ming,9999,0,9999,0
1656015929412,MATH 197,004,095571,Perols; Johan Lars,9998,0,9999,1
1656015936461,COGS 9,A01,083615,Shannon; Kyle Michael,3,1,75,72
1656015942491,COGS 11,A01,083617,Boyle; Mary E. T.,11,1,48,37
1656015948515,COGS 13,A01,083071,Bastos; Amalia Pinkusfeld,4,2,71,67
1656015954544,COGS 14A,A01,092681,Semenuks; Arturs,4,25,100,96
1656015960586,COGS 14B,A01,083073,Cheng; Tzu-Han,7,0,63,56
1656015966701,COGS 17,A01,092677,Semenuks; Arturs,8,7,81,73
1656015972725,COGS 100,A01,083619,Allen; Michael Gordon,2,2,70,68
1656015978753,COGS 101A,A01,083621,Davis; Joshua Daniel,4,3,68,64
1656015984776,COGS 101B,A01,091572,Allen; Michael Gordon,0,0,65,65
1656015990802,COGS 101C,A01,083625,Delgado; Tania,7,0,35,28
1656015996831,COGS 107A,A01,083627,Boyle; Mary E. T.,1,2,60,59
1656016002854,COGS 118A,A01,083075,Gupta; Anjum,21,16,76,55
1656016008877,CSE 3,A50,083646,Miranda; Gregory Joseph,14,0,50,36
1656016014906,CSE 8A,A50,083650,Miranda; Gregory Joseph,3,11,56,53
1656016020932,CSE 11,A01,083080,Cao; Yingjun,0,66,40,40
1656016026959,CSE 12,A01,083652,Krause-Levy; Sophia Louisa,6,8,120,114
1656016032987,CSE 15L,A01,083654,Morris; Justin Loren,3,1,50,47
1656016032987,CSE 15L,A02,083655,Morris; Justin Loren,1,1,50,49
1656016039027,CSE 20,A01,083657,Tran; Khoa Dang,29,0,80,51
1656016045049,CSE 21,A01,095574,Bach; Quang Tran,23,0,48,25
1656016051077,CSE 30,A01,083084,Eldon; John,2,10,80,78
1656016051077,CSE 30,B01,095061,Bhaskar; Nishant,0,4,50,50
1656016057107,CSE 100,A01,083659,Cao; Yingjun,2,25,70,68
1656016063131,CSE 134B,A01,083661,Powell; Thomas Allan,6,6,100,94
1656016069158,CSE 140,A01,083663,Gungor; Onat,5,0,85,80
1656016075186,CSE 140L,A01,083088,Eldon; John,5,0,100,95
1656016081210,CSE 175,A01,083665,Kumar; Rakesh,0,0,25,25
1656016087248,CSE 190,A00,092507,Dubnov; Shlomo,1,0,20,19
1656016093282,ECE 45,A01,083139,Congero; Spencer William,0,1,75,75
1656016099313,ECE 65,A50,083695,Saad; Andrew S,6,0,30,24
1656016099313,ECE 65,A51,095125,Staff,23,0,26,3
1656016105346,ECE 109,A01,091882,Touri; Behrouz,3,5,70,67
1656016111370,ECE 180,A00,083140,Abi Samra; Nicholas Camill,1,0,30,29
1656016111370,ECE 180,B00,083141,Abi Samra; Nicholas Camill,0,8,28,28
1656016117393,MATH 10A,A01,083735,Patchell; Gregory David,0,0,30,30
1656016117393,MATH 10A,A02,083736,Patchell; Gregory David,21,0,30,9
1656016117393,MATH 10A,A03,083737,Patchell; Gregory David,16,0,30,14
1656016123423,MATH 10B,A01,083207,Lim; Seonhee,1,1,34,33
1656016123423,MATH 10B,A02,083208,Lim; Seonhee,1,1,35,34
1656016123423,MATH 10B,A03,093472,Staff,1,0,34,33
1656016123423,MATH 10B,B01,083739,Sinha; Shubham,9,0,30,21
1656016129446,MATH 18,A01,083743,Cinel; Cameron Alexander,5,0,30,25
1656016129446,MATH 18,A02,083744,Cinel; Cameron Alexander,11,0,30,19
1656016129446,MATH 18,A03,083745,Cinel; Cameron Alexander,1,0,30,29
1656016129446,MATH 18,B01,083748,Ma; Zilu,0,0,36,36
1656016129446,MATH 18,B02,083749,Ma; Zilu,0,0,36,36
1656016129446,MATH 18,B03,083750,Ma; Zilu,0,0,36,36
1656016129446,MATH 18,B04,083751,Ma; Zilu,0,0,36,36
1656016129446,MATH 18,B05,093473,Staff,0,0,36,36
1656016129446,MATH 18,B06,093474,Staff,3,0,36,33
1656016135471,MATH 20A,A01,083754,Zheng; Zequn,10,0,40,30
1656016141501,MATH 20B,A01,083756,Briones; Jor-el Thomas Caparas,0,1,36,36
1656016141501,MATH 20B,A02,083757,Briones; Jor-el Thomas Caparas,1,0,36,35
1656016141501,MATH 20B,A03,093475,Staff,0,0,36,36
1656016147532,MATH 20C,A01,083760,Briones; Jor-el Thomas Caparas,0,2,35,35
1656016147532,MATH 20C,A02,083761,Briones; Jor-el Thomas Caparas,6,1,35,29
1656016147532,MATH 20C,A03,093476,Staff,0,0,35,35
1656016147532,MATH 20C,B01,083762,Bach; Quang Tran,3,0,30,27
1656016153568,MATH 20D,A01,083765,Tran; Brian Kha,2,0,30,28
1656016153568,MATH 20D,A02,083766,Tran; Brian Kha,0,1,30,30
1656016153568,MATH 20D,A03,083767,Tran; Brian Kha,1,0,30,29
1656016159593,MATH 20E,A01,083771,Ganguly; Soumya,0,1,32,32
1656016159593,MATH 20E,A02,083772,Ganguly; Soumya,1,1,32,31
1656016159593,MATH 20E,B01,083773,Ciotti; Benjamin,13,0,35,22
1656016159593,MATH 20E,B02,083774,Ciotti; Benjamin,12,0,35,23
1656016165618,MATH 103A,A01,083777,Greenfeld; Be'Eri,2,1,36,34
1656016165618,MATH 103A,A02,083778,Greenfeld; Be'Eri,2,0,36,34
1656016165618,MATH 103A,A03,093561,Staff,0,1,36,36
1656016165618,MATH 103A,B01,083779,Greenfeld; Be'Eri,7,1,36,29
1656016165618,MATH 103A,B02,083780,Greenfeld; Be'Eri,0,0,36,36
1656016165618,MATH 103A,B03,093562,Staff,0,0,36,36
1656016171646,MATH 105,A01,085443,Carter; Anne Toulson,4,1,35,31
1656016171646,MATH 105,A02,093477,Staff,8,0,35,27
1656016177682,MATH 109,A01,083213,Ganzberger; Geoffrey Michael,0,1,34,34
1656016177682,MATH 109,A02,083214,Ganzberger; Geoffrey Michael,0,0,34,34
1656016177682,MATH 109,A03,093478,Staff,1,0,34,33
1656016177682,MATH 109,B01,083215,Ganzberger; Geoffrey Michael,2,0,32,30
1656016177682,MATH 109,B02,083216,Ganzberger; Geoffrey Michael,0,0,32,32
1656016177682,MATH 109,B03,093479,Staff,4,0,32,28
1656016183706,MATH 142A,A01,083219,Chow; Bennett,1,0,32,31
1656016183706,MATH 142A,A02,083220,Chow; Bennett,7,0,32,25
1656016183706,MATH 142A,A03,093480,Staff,4,0,32,28
1656016183706,MATH 142A,B03,093481,Staff,3,0,32,29
1656016183706,MATH 142A,B04,093558,Staff,6,0,32,26
1656016183706,MATH 142A,B05,093559,Staff,0,0,32,32
1656016189730,MATH 193A,A01,083224,Rotar; Vladimir,1,1,34,33
1656016189730,MATH 193A,A02,083225,Rotar; Vladimir,0,0,34,34
1656016189730,MATH 193A,A03,083781,Rotar; Vladimir,2,0,34,32
1656016189730,MATH 193A,A04,083782,Rotar; Vladimir,3,0,34,31
1656016189730,MATH 193A,A05,093482,Rotar; Vladimir,0,0,34,34
1656016195754,MATH 197,001,091859,McAuley; Julian John,9999,0,9999,0
1656016195754,MATH 197,002,095566,Kedlaya; Kiran S.,9997,0,9999,2
1656016195754,MATH 197,003,095567,Xiao; Ming,9999,0,9999,0
1656016195754,MATH 197,004,095571,Perols; Johan Lars,9998,0,9999,1
1656016202816,COGS 9,A01,083615,Shannon; Kyle Michael,3,1,75,72
1656016208840,COGS 11,A01,083617,Boyle; Mary E. T.,11,1,48,37
1656016214872,COGS 13,A01,083071,Bastos; Amalia Pinkusfeld,4,2,71,67
1656016220897,COGS 14A,A01,092681,Semenuks; Arturs,4,25,100,96
1656016226923,COGS 14B,A01,083073,Cheng; Tzu-Han,7,0,63,56
1656016232946,COGS 17,A01,092677,Semenuks; Arturs,8,7,81,73
1656016238970,COGS 100,A01,083619,Allen; Michael Gordon,2,2,70,68
1656016244993,COGS 101A,A01,083621,Davis; Joshua Daniel,4,3,68,64
1656016251026,COGS 101B,A01,091572,Allen; Michael Gordon,0,0,65,65
1656016257050,COGS 101C,A01,083625,Delgado; Tania,7,0,35,28
1656016263078,COGS 107A,A01,083627,Boyle; Mary E. T.,1,2,60,59
1656016269102,COGS 118A,A01,083075,Gupta; Anjum,21,16,76,55
1656016275127,CSE 3,A50,083646,Miranda; Gregory Joseph,14,0,50,36
1656016281151,CSE 8A,A50,083650,Miranda; Gregory Joseph,3,11,56,53
1656016287183,CSE 11,A01,083080,Cao; Yingjun,0,66,40,40
1656016293207,CSE 12,A01,083652,Krause-Levy; Sophia Louisa,6,8,120,114
1656016299234,CSE 15L,A01,083654,Morris; Justin Loren,3,1,50,47
1656016299234,CSE 15L,A02,083655,Morris; Justin Loren,1,1,50,49
1656016305258,CSE 20,A01,083657,Tran; Khoa Dang,29,0,80,51
1656016311280,CSE 21,A01,095574,Bach; Quang Tran,23,0,48,25
1656016317316,CSE 30,A01,083084,Eldon; John,2,10,80,78
1656016317316,CSE 30,B01,095061,Bhaskar; Nishant,0,4,50,50
1656016323347,CSE 100,A01,083659,Cao; Yingjun,2,25,70,68
1656016329373,CSE 134B,A01,083661,Powell; Thomas Allan,6,6,100,94
1656016335396,CSE 140,A01,083663,Gungor; Onat,5,0,85,80
1656016341420,CSE 140L,A01,083088,Eldon; John,5,0,100,95
1656016347444,CSE 175,A01,083665,Kumar; Rakesh,0,0,25,25
1656016353471,CSE 190,A00,092507,Dubnov; Shlomo,1,0,20,19
1656016359500,ECE 45,A01,083139,Congero; Spencer William,0,1,75,75
1656016365536,ECE 65,A50,083695,Saad; Andrew S,6,0,30,24
1656016365536,ECE 65,A51,095125,Staff,23,0,26,3
1656016371562,ECE 109,A01,091882,Touri; Behrouz,3,5,70,67
1656016377597,ECE 180,A00,083140,Abi Samra; Nicholas Camill,1,0,30,29
1656016377597,ECE 180,B00,083141,Abi Samra; Nicholas Camill,0,8,28,28
1656016383621,MATH 10A,A01,083735,Patchell; Gregory David,0,0,30,30
1656016383621,MATH 10A,A02,083736,Patchell; Gregory David,21,0,30,9
1656016383621,MATH 10A,A03,083737,Patchell; Gregory David,16,0,30,14
1656016389645,MATH 10B,A01,083207,Lim; Seonhee,1,1,34,33
1656016389645,MATH 10B,A02,083208,Lim; Seonhee,1,1,35,34
1656016389645,MATH 10B,A03,093472,Staff,1,0,34,33
1656016389645,MATH 10B,B01,083739,Sinha; Shubham,9,0,30,21
1656016395671,MATH 18,A01,083743,Cinel; Cameron Alexander,5,0,30,25
1656016395671,MATH 18,A02,083744,Cinel; Cameron Alexander,11,0,30,19
1656016395671,MATH 18,A03,083745,Cinel; Cameron Alexander,1,0,30,29
1656016395671,MATH 18,B01,083748,Ma; Zilu,0,0,36,36
1656016395671,MATH 18,B02,083749,Ma; Zilu,0,0,36,36
1656016395671,MATH 18,B03,083750,Ma; Zilu,0,0,36,36
1656016395671,MATH 18,B04,083751,Ma; Zilu,0,0,36,36
1656016395671,MATH 18,B05,093473,Staff,0,0,36,36
1656016395671,MATH 18,B06,093474,Staff,3,0,36,33
1656016401699,MATH 20A,A01,083754,Zheng; Zequn,10,0,40,30
1656016407725,MATH 20B,A01,083756,Briones; Jor-el Thomas Caparas,0,1,36,36
1656016407725,MATH 20B,A02,083757,Briones; Jor-el Thomas Caparas,1,0,36,35
1656016407725,MATH 20B,A03,093475,Staff,0,0,36,36
1656016413756,MATH 20C,A01,083760,Briones; Jor-el Thomas Caparas,0,2,35,35
1656016413756,MATH 20C,A02,083761,Briones; Jor-el Thomas Caparas,6,1,35,29
1656016413756,MATH 20C,A03,093476,Staff,0,0,35,35
1656016413756,MATH 20C,B01,083762,Bach; Quang Tran,3,0,30,27
1656016419792,MATH 20D,A01,083765,Tran; Brian Kha,2,0,30,28
1656016419792,MATH 20D,A02,083766,Tran; Brian Kha,0,1,30,30
1656016419792,MATH 20D,A03,083767,Tran; Brian Kha,1,0,30,29
1656016425816,MATH 20E,A01,083771,Ganguly; Soumya,0,1,32,32
1656016425816,MATH 20E,A02,083772,Ganguly; Soumya,1,1,32,31
1656016425816,MATH 20E,B01,083773,Ciotti; Benjamin,13,0,35,22
1656016425816,MATH 20E,B02,083774,Ciotti; Benjamin,12,0,35,23
1656016431841,MATH 103A,A01,083777,Greenfeld; Be'Eri,2,1,36,34
1656016431841,MATH 103A,A02,083778,Greenfeld; Be'Eri,2,0,36,34
1656016431841,MATH 103A,A03,093561,Staff,0,1,36,36
1656016431841,MATH 103A,B01,083779,Greenfeld; Be'Eri,7,1,36,29
1656016431841,MATH 103A,B02,083780,Greenfeld; Be'Eri,0,0,36,36
1656016431841,MATH 103A,B03,093562,Staff,0,0,36,36
1656016437874,MATH 105,A01,085443,Carter; Anne Toulson,4,1,35,31
1656016437874,MATH 105,A02,093477,Staff,8,0,35,27
1656016443898,MATH 109,A01,083213,Ganzberger; Geoffrey Michael,0,1,34,34
1656016443898,MATH 109,A02,083214,Ganzberger; Geoffrey Michael,0,0,34,34
1656016443898,MATH 109,A03,093478,Staff,1,0,34,33
1656016443898,MATH 109,B01,083215,Ganzberger; Geoffrey Michael,2,0,32,30
1656016443898,MATH 109,B02,083216,Ganzberger; Geoffrey Michael,0,0,32,32
1656016443898,MATH 109,B03,093479,Staff,4,0,32,28
1656016449930,MATH 142A,A01,083219,Chow; Bennett,1,0,32,31
1656016449930,MATH 142A,A02,083220,Chow; Bennett,7,0,32,25
1656016449930,MATH 142A,A03,093480,Staff,4,0,32,28
1656016449930,MATH 142A,B03,093481,Staff,3,0,32,29
1656016449930,MATH 142A,B04,093558,Staff,6,0,32,26
1656016449930,MATH 142A,B05,093559,Staff,0,0,32,32
1656016455959,MATH 193A,A01,083224,Rotar; Vladimir,1,1,34,33
1656016455959,MATH 193A,A02,083225,Rotar; Vladimir,0,0,34,34
1656016455959,MATH 193A,A03,083781,Rotar; Vladimir,2,0,34,32
1656016455959,MATH 193A,A04,083782,Rotar; Vladimir,3,0,34,31
1656016455959,MATH 193A,A05,093482,Rotar; Vladimir,0,0,34,34
1656016461999,MATH 197,001,091859,McAuley; Julian John,9999,0,9999,0
1656016461999,MATH 197,002,095566,Kedlaya; Kiran S.,9997,0,9999,2
1656016461999,MATH 197,003,095567,Xiao; Ming,9999,0,9999,0
1656016461999,MATH 197,004,095571,Perols; Johan Lars,9998,0,9999,1
1656016469050,COGS 9,A01,083615,Shannon; Kyle Michael,3,1,75,72
1656016475074,COGS 11,A01,083617,Boyle; Mary E. T.,11,1,48,37
1656016481098,COGS 13,A01,083071,Bastos; Amalia Pinkusfeld,4,2,71,67
1656016487126,COGS 14A,A01,092681,Semenuks; Arturs,4,25,100,96
1656016493163,COGS 14B,A01,083073,Cheng; Tzu-Han,7,0,63,56
1656016499189,COGS 17,A01,092677,Semenuks; Arturs,8,7,81,73
1656016505218,COGS 100,A01,083619,Allen; Michael Gordon,2,2,70,68
1656016511242,COGS 101A,A01,083621,Davis; Joshua Daniel,4,3,68,64
1656016517266,COGS 101B,A01,091572,Allen; Michael Gordon,0,0,65,65
1656016523291,COGS 101C,A01,083625,Delgado; Tania,7,0,35,28
1656016529314,COGS 107A,A01,083627,Boyle; Mary E. T.,1,2,60,59
1656016535348,COGS 118A,A01,083075,Gupta; Anjum,21,16,76,55
1656016541385,CSE 3,A50,083646,Miranda; Gregory Joseph,14,0,50,36
1656016547414,CSE 8A,A50,083650,Miranda; Gregory Joseph,3,11,56,53
1656016553445,CSE 11,A01,083080,Cao; Yingjun,0,66,40,40
1656016559476,CSE 12,A01,083652,Krause-Levy; Sophia Louisa,6,8,120,114
1656016565576,CSE 15L,A01,083654,Morris; Justin Loren,3,1,50,47
1656016565576,CSE 15L,A02,083655,Morris; Justin Loren,1,1,50,49
1656016571612,CSE 20,A01,083657,Tran; Khoa Dang,29,0,80,51
1656016577657,CSE 21,A01,095574,Bach; Quang Tran,23,0,48,25
1656016583681,CSE 30,A01,083084,Eldon; John,2,10,80,78
1656016583681,CSE 30,B01,095061,Bhaskar; Nishant,0,4,50,50
1656016589707,CSE 100,A01,083659,Cao; Yingjun,2,25,70,68
1656016595731,CSE 134B,A01,083661,Powell; Thomas Allan,6,6,100,94
1656016601759,CSE 140,A01,083663,Gungor; Onat,5,0,85,80
1656016607793,CSE 140L,A01,083088,Eldon; John,5,0,100,95
1656016613816,CSE 175,A01,083665,Kumar; Rakesh,0,0,25,25
1656016619839,CSE 190,A00,092507,Dubnov; Shlomo,1,0,20,19
1656016625862,ECE 45,A01,083139,Congero; Spencer William,0,1,75,75
1656016631889,ECE 65,A50,083695,Saad; Andrew S,6,0,30,24
1656016631889,ECE 65,A51,095125,Staff,23,0,26,3
1656016637917,ECE 109,A01,091882,Touri; Behrouz,3,5,70,67
1656016643947,ECE 180,A00,083140,Abi Samra; Nicholas Camill,1,0,30,29
1656016643947,ECE 180,B00,083141,Abi Samra; Nicholas Camill,0,8,28,28
1656016649976,MATH 10A,A01,083735,Patchell; Gregory David,0,0,30,30
1656016649976,MATH 10A,A02,083736,Patchell; Gregory David,21,0,30,9
1656016649976,MATH 10A,A03,083737,Patchell; Gregory David,16,0,30,14
1656016656004,MATH 10B,A01,083207,Lim; Seonhee,1,1,34,33
1656016656004,MATH 10B,A02,083208,Lim; Seonhee,1,1,35,34
1656016656004,MATH 10B,A03,093472,Staff,1,0,34,33
1656016656004,MATH 10B,B01,083739,Sinha; Shubham,9,0,30,21
1656016662030,MATH 18,A01,083743,Cinel; Cameron Alexander,5,0,30,25
1656016662030,MATH 18,A02,083744,Cinel; Cameron Alexander,11,0,30,19
1656016662030,MATH 18,A03,083745,Cinel; Cameron Alexander,1,0,30,29
1656016662030,MATH 18,B01,083748,Ma; Zilu,0,0,36,36
1656016662030,MATH 18,B02,083749,Ma; Zilu,0,0,36,36
1656016662030,MATH 18,B03,083750,Ma; Zilu,0,0,36,36
1656016662030,MATH 18,B04,083751,Ma; Zilu,0,0,36,36
1656016662030,MATH 18,B05,093473,Staff,0,0,36,36
1656016662030,MATH 18,B06,093474,Staff,3,0,36,33
1656016668054,MATH 20A,A01,083754,Zheng; Zequn,10,0,40,30
1656016674078,MATH 20B,A01,083756,Briones; Jor-el Thomas Caparas,0,1,36,36
1656016674078,MATH 20B,A02,083757,Briones; Jor-el Thomas Caparas,1,0,36,35
1656016674078,MATH 20B,A03,093475,Staff,0,0,36,36
1656016680104,MATH 20C,A01,083760,Briones; Jor-el Thomas Caparas,0,2,35,35
1656016680104,MATH 20C,A02,083761,Briones; Jor-el Thomas Caparas,6,1,35,29
1656016680104,MATH 20C,A03,093476,Staff,0,0,35,35
1656016680104,MATH 20C,B01,083762,Bach; Quang Tran,3,0,30,27
1656016686132,MATH 20D,A01,083765,Tran; Brian Kha,2,0,30,28
1656016686132,MATH 20D,A02,083766,Tran; Brian Kha,0,1,30,30
1656016686132,MATH 20D,A03,083767,Tran; Brian Kha,1,0,30,29
1656016692156,MATH 20E,A01,083771,Ganguly; Soumya,0,1,32,32
1656016692156,MATH 20E,A02,083772,Ganguly; Soumya,1,1,32,31
1656016692156,MATH 20E,B01,083773,Ciotti; Benjamin,13,0,35,22
1656016692156,MATH 20E,B02,083774,Ciotti; Benjamin,12,0,35,23
1656016698183,MATH 103A,A01,083777,Greenfeld; Be'Eri,2,1,36,34
1656016698183,MATH 103A,A02,083778,Greenfeld; Be'Eri,2,0,36,34
1656016698183,MATH 103A,A03,093561,Staff,0,1,36,36
1656016698183,MATH 103A,B01,083779,Greenfeld; Be'Eri,7,1,36,29
1656016698183,MATH 103A,B02,083780,Greenfeld; Be'Eri,0,0,36,36
1656016698183,MATH 103A,B03,093562,Staff,0,0,36,36
1656016704213,MATH 105,A01,085443,Carter; Anne Toulson,4,1,35,31
1656016704213,MATH 105,A02,093477,Staff,8,0,35,27
1656016710237,MATH 109,A01,083213,Ganzberger; Geoffrey Michael,0,1,34,34
1656016710237,MATH 109,A02,083214,Ganzberger; Geoffrey Michael,0,0,34,34
1656016710237,MATH 109,A03,093478,Staff,1,0,34,33
1656016710237,MATH 109,B01,083215,Ganzberger; Geoffrey Michael,2,0,32,30
1656016710237,MATH 109,B02,083216,Ganzberger; Geoffrey Michael,0,0,32,32
1656016710237,MATH 109,B03,093479,Staff,4,0,32,28
1656016716266,MATH 142A,A01,083219,Chow; Bennett,1,0,32,31
1656016716266,MATH 142A,A02,083220,Chow; Bennett,7,0,32,25
1656016716266,MATH 142A,A03,093480,Staff,4,0,32,28
1656016716266,MATH 142A,B03,093481,Staff,3,0,32,29
1656016716266,MATH 142A,B04,093558,Staff,6,0,32,26
1656016716266,MATH 142A,B05,093559,Staff,0,0,32,32
1656016722307,MATH 193A,A01,083224,Rotar; Vladimir,1,1,34,33
1656016722307,MATH 193A,A02,083225,Rotar; Vladimir,0,0,34,34
1656016722307,MATH 193A,A03,083781,Rotar; Vladimir,2,0,34,32
1656016722307,MATH 193A,A04,083782,Rotar; Vladimir,3,0,34,31
1656016722307,MATH 193A,A05,093482,Rotar; Vladimir,0,0,34,34
1656016728342,MATH 197,001,091859,McAuley; Julian John,9999,0,9999,0
1656016728342,MATH 197,002,095566,Kedlaya; Kiran S.,9997,0,9999,2
1656016728342,MATH 197,003,095567,Xiao; Ming,9999,0,9999,0
1656016728342,MATH 197,004,095571,Perols; Johan Lars,9998,0,9999,1
1656016735410,COGS 9,A01,083615,Shannon; Kyle Michael,3,1,75,72
1656016741447,COGS 11,A01,083617,Boyle; Mary E. T.,11,1,48,37
1656016747472,COGS 13,A01,083071,Bastos; Amalia Pinkusfeld,4,2,71,67
1656016753495,COGS 14A,A01,092681,Semenuks; Arturs,4,25,100,96
1656016759517,COGS 14B,A01,083073,Cheng; Tzu-Han,7,0,63,56
1656016765539,COGS 17,A01,092677,Semenuks; Arturs,8,7,81,73
1656016771565,COGS 100,A01,083619,Allen; Michael Gordon,2,2,70,68
1656016777594,COGS 101A,A01,083621,Davis; Joshua Daniel,4,3,68,64
1656016783620,COGS 101B,A01,091572,Allen; Michael Gordon,0,0,65,65
1656016789646,COGS 101C,A01,083625,Delgado; Tania,7,0,35,28
1656016795669,COGS 107A,A01,083627,Boyle; Mary E. T.,1,2,60,59
1656016801697,COGS 118A,A01,083075,Gupta; Anjum,21,16,76,55
1656016807721,CSE 3,A50,083646,Miranda; Gregory Joseph,14,0,50,36
1656016813750,CSE 8A,A50,083650,Miranda; Gregory Joseph,3,11,56,53
1656016819774,CSE 11,A01,083080,Cao; Yingjun,0,66,40,40
1656016825799,CSE 12,A01,083652,Krause-Levy; Sophia Louisa,6,8,120,114
1656016831831,CSE 15L,A01,083654,Morris; Justin Loren,3,1,50,47
1656016831831,CSE 15L,A02,083655,Morris; Justin Loren,1,1,50,49
1656016837859,CSE 20,A01,083657,Tran; Khoa Dang,29,0,80,51
1656016843883,CSE 21,A01,095574,Bach; Quang Tran,23,0,48,25
1656016849906,CSE 30,A01,083084,Eldon; John,2,10,80,78
1656016849906,CSE 30,B01,095061,Bhaskar; Nishant,0,4,50,50
1656016855933,CSE 100,A01,083659,Cao; Yingjun,2,25,70,68
1656016861958,CSE 134B,A01,083661,Powell; Thomas Allan,6,6,100,94
1656016867990,CSE 140,A01,083663,Gungor; Onat,5,0,85,80
1656016874020,CSE 140L,A01,083088,Eldon; John,5,0,100,95
1656016880045,CSE 175,A01,083665,Kumar; Rakesh,0,0,25,25
1656016886075,CSE 190,A00,092507,Dubnov; Shlomo,1,0,20,19
1656016892099,ECE 45,A01,083139,Congero; Spencer William,0,1,75,75
1656016898134,ECE 65,A50,083695,Saad; Andrew S,6,0,30,24
1656016898134,ECE 65,A51,095125,Staff,23,0,26,3
1656016904163,ECE 109,A01,091882,Touri; Behrouz,3,5,70,67
1656016910191,ECE 180,A00,083140,Abi Samra; Nicholas Camill,1,0,30,29
1656016910191,ECE 180,B00,083141,Abi Samra; Nicholas Camill,0,8,28,28
1656016916218,MATH 10A,A01,083735,Patchell; Gregory David,0,0,30,30
1656016916218,MATH 10A,A02,083736,Patchell; Gregory David,21,0,30,9
1656016916218,MATH 10A,A03,083737,Patchell; Gregory David,16,0,30,14
1656016922242,MATH 10B,A01,083207,Lim; Seonhee,1,1,34,33
1656016922242,MATH 10B,A02,083208,Lim; Seonhee,1,1,35,34
1656016922242,MATH 10B,A03,093472,Staff,1,0,34,33
1656016922242,MATH 10B,B01,083739,Sinha; Shubham,9,0,30,21
1656016928268,MATH 18,A01,083743,Cinel; Cameron Alexander,5,0,30,25
1656016928268,MATH 18,A02,083744,Cinel; Cameron Alexander,11,0,30,19
1656016928268,MATH 18,A03,083745,Cinel; Cameron Alexander,1,0,30,29
1656016928268,MATH 18,B01,083748,Ma; Zilu,0,0,36,36
1656016928268,MATH 18,B02,083749,Ma; Zilu,0,0,36,36
1656016928268,MATH 18,B03,083750,Ma; Zilu,0,0,36,36
1656016928268,MATH 18,B04,083751,Ma; Zilu,0,0,36,36
1656016928268,MATH 18,B05,093473,Staff,0,0,36,36
1656016928268,MATH 18,B06,093474,Staff,3,0,36,33
1656016934294,MATH 20A,A01,083754,Zheng; Zequn,10,0,40,30
1656016940320,MATH 20B,A01,083756,Briones; Jor-el Thomas Caparas,0,1,36,36
1656016940320,MATH 20B,A02,083757,Briones; Jor-el Thomas Caparas,1,0,36,35
1656016940320,MATH 20B,A03,093475,Staff,0,0,36,36
1656016946347,MATH 20C,A01,083760,Briones; Jor-el Thomas Caparas,0,2,35,35
1656016946347,MATH 20C,A02,083761,Briones; Jor-el Thomas Caparas,6,1,35,29
1656016946347,MATH 20C,A03,093476,Staff,0,0,35,35
1656016946347,MATH 20C,B01,083762,Bach; Quang Tran,3,0,30,27
1656016952377,MATH 20D,A01,083765,Tran; Brian Kha,2,0,30,28
1656016952377,MATH 20D,A02,083766,Tran; Brian Kha,0,1,30,30
1656016952377,MATH 20D,A03,083767,Tran; Brian Kha,1,0,30,29
1656016958405,MATH 20E,A01,083771,Ganguly; Soumya,0,1,32,32
1656016958405,MATH 20E,A02,083772,Ganguly; Soumya,1,1,32,31
1656016958405,MATH 20E,B01,083773,Ciotti; Benjamin,13,0,35,22
1656016958405,MATH 20E,B02,083774,Ciotti; Benjamin,12,0,35,23
1656016964434,MATH 103A,A01,083777,Greenfeld; Be'Eri,2,1,36,34
1656016964434,MATH 103A,A02,083778,Greenfeld; Be'Eri,2,0,36,34
1656016964434,MATH 103A,A03,093561,Staff,0,1,36,36
1656016964434,MATH 103A,B01,083779,Greenfeld; Be'Eri,8,1,36,28
1656016964434,MATH 103A,B02,083780,Greenfeld; Be'Eri,0,0,36,36
1656016964434,MATH 103A,B03,093562,Staff,0,0,36,36
1656016970458,MATH 105,A01,085443,Carter; Anne Toulson,4,1,35,31
1656016970458,MATH 105,A02,093477,Staff,8,0,35,27
1656016976490,MATH 109,A01,083213,Ganzberger; Geoffrey Michael,0,1,34,34
1656016976490,MATH 109,A02,083214,Ganzberger; Geoffrey Michael,0,0,34,34
1656016976490,MATH 109,A03,093478,Staff,1,0,34,33
1656016976490,MATH 109,B01,083215,Ganzberger; Geoffrey Michael,2,0,32,30
1656016976490,MATH 109,B02,083216,Ganzberger; Geoffrey Michael,0,0,32,32
1656016976490,MATH 109,B03,093479,Staff,4,0,32,28
1656016982512,MATH 142A,A01,083219,Chow; Bennett,1,0,32,31
1656016982512,MATH 142A,A02,083220,Chow; Bennett,7,0,32,25
1656016982512,MATH 142A,A03,093480,Staff,4,0,32,28
1656016982512,MATH 142A,B03,093481,Staff,3,0,32,29
1656016982512,MATH 142A,B04,093558,Staff,6,0,32,26
1656016982512,MATH 142A,B05,093559,Staff,0,0,32,32
1656016988542,MATH 193A,A01,083224,Rotar; Vladimir,1,2,34,33
1656016988542,MATH 193A,A02,083225,Rotar; Vladimir,0,0,34,34
1656016988542,MATH 193A,A03,083781,Rotar; Vladimir,2,0,34,32
1656016988542,MATH 193A,A04,083782,Rotar; Vladimir,3,0,34,31
1656016988542,MATH 193A,A05,093482,Rotar; Vladimir,0,0,34,34
1656016994565,MATH 197,001,091859,McAuley; Julian John,9999,0,9999,0
1656016994565,MATH 197,002,095566,Kedlaya; Kiran S.,9997,0,9999,2
1656016994565,MATH 197,003,095567,Xiao; Ming,9999,0,9999,0
1656016994565,MATH 197,004,095571,Perols; Johan Lars,9998,0,9999,1
1656017001632,COGS 9,A01,083615,Shannon; Kyle Michael,3,1,75,72
1656017007672,COGS 11,A01,083617,Boyle; Mary E. T.,11,1,48,37
1656017013700,COGS 13,A01,083071,Bastos; Amalia Pinkusfeld,4,2,71,67
1656017019723,COGS 14A,A01,092681,Semenuks; Arturs,4,25,100,96
1656017025753,COGS 14B,A01,083073,Cheng; Tzu-Han,7,0,63,56
1656017031774,COGS 17,A01,092677,Semenuks; Arturs,8,7,81,73
1656017037805,COGS 100,A01,083619,Allen; Michael Gordon,2,2,70,68
1656017043833,COGS 101A,A01,083621,Davis; Joshua Daniel,4,3,68,64
1656017049860,COGS 101B,A01,091572,Allen; Michael Gordon,0,0,65,65
1656017055892,COGS 101C,A01,083625,Delgado; Tania,7,0,35,28
1656017061919,COGS 107A,A01,083627,Boyle; Mary E. T.,1,2,60,59
1656017067944,COGS 118A,A01,083075,Gupta; Anjum,21,16,76,55
1656017073998,CSE 3,A50,083646,Miranda; Gregory Joseph,14,0,50,36
1656017080025,CSE 8A,A50,083650,Miranda; Gregory Joseph,4,11,56,52
1656017086053,CSE 11,A01,083080,Cao; Yingjun,0,66,40,40
1656017092084,CSE 12,A01,083652,Krause-Levy; Sophia Louisa,6,8,120,114
1656017098108,CSE 15L,A01,083654,Morris; Justin Loren,3,1,50,47
1656017098108,CSE 15L,A02,083655,Morris; Justin Loren,1,1,50,49
1656017104136,CSE 20,A01,083657,Tran; Khoa Dang,29,0,80,51
1656017110172,CSE 21,A01,095574,Bach; Quang Tran,23,0,48,25
1656017116197,CSE 30,A01,083084,Eldon; John,2,10,80,78
1656017116197,CSE 30,B01,095061,Bhaskar; Nishant,0,4,50,50
1656017122224,CSE 100,A01,083659,Cao; Yingjun,2,25,70,68
1656017128252,CSE 134B,A01,083661,Powell; Thomas Allan,6,6,100,94
1656017134274,CSE 140,A01,083663,Gungor; Onat,5,0,85,80
1656017140297,CSE 140L,A01,083088,Eldon; John,5,0,100,95
1656017146335,CSE 175,A01,083665,Kumar; Rakesh,0,0,25,25
1656017152357,CSE 190,A00,092507,Dubnov; Shlomo,1,0,20,19
1656017158384,ECE 45,A01,083139,Congero; Spencer William,0,1,75,75
1656017164495,ECE 65,A50,083695,Saad; Andrew S,6,0,30,24
1656017164495,ECE 65,A51,095125,Staff,23,0,26,3
1656017170524,ECE 109,A01,091882,Touri; Behrouz,3,5,70,67
1656017176549,ECE 180,A00,083140,Abi Samra; Nicholas Camill,1,0,30,29
1656017176549,ECE 180,B00,083141,Abi Samra; Nicholas Camill,0,8,28,28
1656017182573,MATH 10A,A01,083735,Patchell; Gregory David,0,0,30,30
1656017182573,MATH 10A,A02,083736,Patchell; Gregory David,21,0,30,9
1656017182573,MATH 10A,A03,083737,Patchell; Gregory David,16,0,30,14
1656017188603,MATH 10B,A01,083207,Lim; Seonhee,1,1,34,33
1656017188603,MATH 10B,A02,083208,Lim; Seonhee,1,1,35,34
1656017188603,MATH 10B,A03,093472,Staff,1,0,34,33
1656017188603,MATH 10B,B01,083739,Sinha; Shubham,9,0,30,21
1656017194635,MATH 18,A01,083743,Cinel; Cameron Alexander,5,0,30,25
1656017194635,MATH 18,A02,083744,Cinel; Cameron Alexander,11,0,30,19
1656017194635,MATH 18,A03,083745,Cinel; Cameron Alexander,1,0,30,29
1656017194635,MATH 18,B01,083748,Ma; Zilu,0,0,36,36
1656017194635,MATH 18,B02,083749,Ma; Zilu,0,0,36,36
1656017194635,MATH 18,B03,083750,Ma; Zilu,0,0,36,36
1656017194635,MATH 18,B04,083751,Ma; Zilu,0,0,36,36
1656017194635,MATH 18,B05,093473,Staff,0,0,36,36
1656017194635,MATH 18,B06,093474,Staff,3,0,36,33
1656017200664,MATH 20A,A01,083754,Zheng; Zequn,10,0,40,30
1656017206699,MATH 20B,A01,083756,Briones; Jor-el Thomas Caparas,0,1,36,36
1656017206699,MATH 20B,A02,083757,Briones; Jor-el Thomas Caparas,1,0,36,35
1656017206699,MATH 20B,A03,093475,Staff,0,0,36,36
1656017212724,MATH 20C,A01,083760,Briones; Jor-el Thomas Caparas,0,2,35,35
1656017212724,MATH 20C,A02,083761,Briones; Jor-el Thomas Caparas,6,1,35,29
1656017212724,MATH 20C,A03,093476,Staff,0,0,35,35
1656017212724,MATH 20C,B01,083762,Bach; Quang Tran,3,0,30,27
1656017218749,MATH 20D,A01,083765,Tran; Brian Kha,2,0,30,28
1656017218749,MATH 20D,A02,083766,Tran; Brian Kha,0,1,30,30
1656017218749,MATH 20D,A03,083767,Tran; Brian Kha,1,0,30,29
1656017224778,MATH 20E,A01,083771,Ganguly; Soumya,0,1,32,32
1656017224778,MATH 20E,A02,083772,Ganguly; Soumya,1,1,32,31
1656017224778,MATH 20E,B01,083773,Ciotti; Benjamin,13,0,35,22
1656017224778,MATH 20E,B02,083774,Ciotti; Benjamin,12,0,35,23
1656017230802,MATH 103A,A01,083777,Greenfeld; Be'Eri,2,1,36,34
1656017230802,MATH 103A,A02,083778,Greenfeld; Be'Eri,2,0,36,34
1656017230802,MATH 103A,A03,093561,Staff,0,1,36,36
1656017230802,MATH 103A,B01,083779,Greenfeld; Be'Eri,8,1,36,28
1656017230802,MATH 103A,B02,083780,Greenfeld; Be'Eri,0,0,36,36
1656017230802,MATH 103A,B03,093562,Staff,0,0,36,36
1656017236846,MATH 105,A01,085443,Carter; Anne Toulson,4,1,35,31
1656017236846,MATH 105,A02,093477,Staff,8,0,35,27
1656017242877,MATH 109,A01,083213,Ganzberger; Geoffrey Michael,0,1,34,34
1656017242877,MATH 109,A02,083214,Ganzberger; Geoffrey Michael,0,0,34,34
1656017242877,MATH 109,A03,093478,Staff,1,0,34,33
1656017242877,MATH 109,B01,083215,Ganzberger; Geoffrey Michael,2,0,32,30
1656017242877,MATH 109,B02,083216,Ganzberger; Geoffrey Michael,0,0,32,32
1656017242877,MATH 109,B03,093479,Staff,4,0,32,28
1656017248910,MATH 142A,A01,083219,Chow; Bennett,1,0,32,31
1656017248910,MATH 142A,A02,083220,Chow; Bennett,7,0,32,25
1656017248910,MATH 142A,A03,093480,Staff,4,0,32,28
1656017248910,MATH 142A,B03,093481,Staff,3,0,32,29
1656017248910,MATH 142A,B04,093558,Staff,6,0,32,26
1656017248910,MATH 142A,B05,093559,Staff,0,0,32,32
1656017254934,MATH 193A,A01,083224,Rotar; Vladimir,1,2,34,33
1656017254934,MATH 193A,A02,083225,Rotar; Vladimir,0,0,34,34
1656017254934,MATH 193A,A03,083781,Rotar; Vladimir,2,0,34,32
1656017254934,MATH 193A,A04,083782,Rotar; Vladimir,3,0,34,31
1656017254934,MATH 193A,A05,093482,Rotar; Vladimir,0,0,34,34
1656017260958,MATH 197,001,091859,McAuley; Julian John,9999,0,9999,0
1656017260958,MATH 197,002,095566,Kedlaya; Kiran S.,9997,0,9999,2
1656017260958,MATH 197,003,095567,Xiao; Ming,9999,0,9999,0
1656017260958,MATH 197,004,095571,Perols; Johan Lars,9998,0,9999,1
1656017268024,COGS 9,A01,083615,Shannon; Kyle Michael,3,1,75,72
1656017274052,COGS 11,A01,083617,Boyle; Mary E. T.,11,1,48,37
1656017280091,COGS 13,A01,083071,Bastos; Amalia Pinkusfeld,4,2,71,67
1656017286118,COGS 14A,A01,092681,Semenuks; Arturs,4,25,100,96
1656017292154,COGS 14B,A01,083073,Cheng; Tzu-Han,7,0,63,56
1656017298184,COGS 17,A01,092677,Semenuks; Arturs,8,7,81,73
1656017304208,COGS 100,A01,083619,Allen; Michael Gordon,2,2,70,68
1656017310232,COGS 101A,A01,083621,Davis; Joshua Daniel,4,3,68,64
1656017316269,COGS 101B,A01,091572,Allen; Michael Gordon,0,0,65,65
1656017322301,COGS 101C,A01,083625,Delgado; Tania,7,0,35,28
1656017328339,COGS 107A,A01,083627,Boyle; Mary E. T.,1,2,60,59
1656017334363,COGS 118A,A01,083075,Gupta; Anjum,21,16,76,55
1656017340407,CSE 3,A50,083646,Miranda; Gregory Joseph,14,0,50,36
1656017346433,CSE 8A,A50,083650,Miranda; Gregory Joseph,4,11,56,52
1656017352457,CSE 11,A01,083080,Cao; Yingjun,0,65,40,40
1656017358487,CSE 12,A01,083652,Krause-Levy; Sophia Louisa,6,8,120,114
1656017364516,CSE 15L,A01,083654,Morris; Justin Loren,3,1,50,47
1656017364516,CSE 15L,A02,083655,Morris; Justin Loren,1,1,50,49
1656017370543,CSE 20,A01,083657,Tran; Khoa Dang,29,0,80,51
1656017376566,CSE 21,A01,095574,Bach; Quang Tran,23,0,48,25
1656017382594,CSE 30,A01,083084,Eldon; John,2,10,80,78
1656017382594,CSE 30,B01,095061,Bhaskar; Nishant,0,4,50,50
1656017388617,CSE 100,A01,083659,Cao; Yingjun,2,25,70,68
1656017394644,CSE 134B,A01,083661,Powell; Thomas Allan,6,6,100,94
1656017400668,CSE 140,A01,083663,Gungor; Onat,5,0,85,80
1656017406696,CSE 140L,A01,083088,Eldon; John,5,0,100,95
1656017412732,CSE 175,A01,083665,Kumar; Rakesh,0,0,25,25
1656017418755,CSE 190,A00,092507,Dubnov; Shlomo,1,0,20,19
1656017424779,ECE 45,A01,083139,Congero; Spencer William,0,1,75,75
1656017430810,ECE 65,A50,083695,Saad; Andrew S,6,0,30,24
1656017430810,ECE 65,A51,095125,Staff,23,0,26,3
1656017436836,ECE 109,A01,091882,Touri; Behrouz,3,5,70,67
1656017442862,ECE 180,A00,083140,Abi Samra; Nicholas Camill,1,0,30,29
1656017442862,ECE 180,B00,083141,Abi Samra; Nicholas Camill,0,8,28,28
1656017448886,MATH 10A,A01,083735,Patchell; Gregory David,0,0,30,30
1656017448886,MATH 10A,A02,083736,Patchell; Gregory David,21,0,30,9
1656017448886,MATH 10A,A03,083737,Patchell; Gregory David,16,0,30,14
1656017454923,MATH 10B,A01,083207,Lim; Seonhee,1,1,34,33
1656017454923,MATH 10B,A02,083208,Lim; Seonhee,1,1,35,34
1656017454923,MATH 10B,A03,093472,Staff,1,0,34,33
1656017454923,MATH 10B,B01,083739,Sinha; Shubham,9,0,30,21
1656017460955,MATH 18,A01,083743,Cinel; Cameron Alexander,5,0,30,25
1656017460955,MATH 18,A02,083744,Cinel; Cameron Alexander,11,0,30,19
1656017460955,MATH 18,A03,083745,Cinel; Cameron Alexander,1,0,30,29
1656017460955,MATH 18,B01,083748,Ma; Zilu,0,0,36,36
1656017460955,MATH 18,B02,083749,Ma; Zilu,0,0,36,36
1656017460955,MATH 18,B03,083750,Ma; Zilu,0,0,36,36
1656017460955,MATH 18,B04,083751,Ma; Zilu,0,0,36,36
1656017460955,MATH 18,B05,093473,Staff,0,0,36,36
1656017460955,MATH 18,B06,093474,Staff,3,0,36,33
1656017466979,MATH 20A,A01,083754,Zheng; Zequn,10,0,40,30
1656017473003,MATH 20B,A01,083756,Briones; Jor-el Thomas Caparas,0,1,36,36
1656017473003,MATH 20B,A02,083757,Briones; Jor-el Thomas Caparas,1,0,36,35
1656017473003,MATH 20B,A03,093475,Staff,0,0,36,36
1656017479027,MATH 20C,A01,083760,Briones; Jor-el Thomas Caparas,0,2,35,35
1656017479027,MATH 20C,A02,083761,Briones; Jor-el Thomas Caparas,6,1,35,29
1656017479027,MATH 20C,A03,093476,Staff,0,0,35,35
1656017479027,MATH 20C,B01,083762,Bach; Quang Tran,3,0,30,27
1656017485051,MATH 20D,A01,083765,Tran; Brian Kha,2,0,30,28
1656017485051,MATH 20D,A02,083766,Tran; Brian Kha,0,1,30,30
1656017485051,MATH 20D,A03,083767,Tran; Brian Kha,1,0,30,29
1656017491091,MATH 20E,A01,083771,Ganguly; Soumya,0,1,32,32
1656017491091,MATH 20E,A02,083772,Ganguly; Soumya,1,1,32,31
1656017491091,MATH 20E,B01,083773,Ciotti; Benjamin,13,0,35,22
1656017491091,MATH 20E,B02,083774,Ciotti; Benjamin,12,0,35,23
1656017497117,MATH 103A,A01,083777,Greenfeld; Be'Eri,2,1,36,34
1656017497117,MATH 103A,A02,083778,Greenfeld; Be'Eri,2,0,36,34
1656017497117,MATH 103A,A03,093561,Staff,0,1,36,36
1656017497117,MATH 103A,B01,083779,Greenfeld; Be'Eri,8,1,36,28
1656017497117,MATH 103A,B02,083780,Greenfeld; Be'Eri,0,0,36,36
1656017497117,MATH 103A,B03,093562,Staff,0,0,36,36
1656017503147,MATH 105,A01,085443,Carter; Anne Toulson,4,1,35,31
1656017503147,MATH 105,A02,093477,Staff,8,0,35,27
1656017509196,MATH 109,A01,083213,Ganzberger; Geoffrey Michael,0,1,34,34
1656017509196,MATH 109,A02,083214,Ganzberger; Geoffrey Michael,0,0,34,34
1656017509196,MATH 109,A03,093478,Staff,1,0,34,33
1656017509196,MATH 109,B01,083215,Ganzberger; Geoffrey Michael,2,0,32,30
1656017509196,MATH 109,B02,083216,Ganzberger; Geoffrey Michael,0,0,32,32
1656017509196,MATH 109,B03,093479,Staff,4,0,32,28
1656017515221,MATH 142A,A01,083219,Chow; Bennett,1,0,32,31
1656017515221,MATH 142A,A02,083220,Chow; Bennett,7,0,32,25
1656017515221,MATH 142A,A03,093480,Staff,4,0,32,28
1656017515221,MATH 142A,B03,093481,Staff,3,0,32,29
1656017515221,MATH 142A,B04,093558,Staff,6,0,32,26
1656017515221,MATH 142A,B05,093559,Staff,0,0,32,32
1656017521244,MATH 193A,A01,083224,Rotar; Vladimir,1,2,34,33
1656017521244,MATH 193A,A02,083225,Rotar; Vladimir,0,0,34,34
1656017521244,MATH 193A,A03,083781,Rotar; Vladimir,2,0,34,32
1656017521244,MATH 193A,A04,083782,Rotar; Vladimir,3,0,34,31
1656017521244,MATH 193A,A05,093482,Rotar; Vladimir,0,0,34,34
1656017527267,MATH 197,001,091859,McAuley; Julian John,9999,0,9999,0
1656017527267,MATH 197,002,095566,Kedlaya; Kiran S.,9997,0,9999,2
1656017527267,MATH 197,003,095567,Xiao; Ming,9999,0,9999,0
1656017527267,MATH 197,004,095571,Perols; Johan Lars,9998,0,9999,1
1656017534343,COGS 9,A01,083615,Shannon; Kyle Michael,3,1,75,72
1656017540369,COGS 11,A01,083617,Boyle; Mary E. T.,11,1,48,37
1656017546395,COGS 13,A01,083071,Bastos; Amalia Pinkusfeld,4,2,71,67
1656017552423,COGS 14A,A01,092681,Semenuks; Arturs,4,25,100,96
1656017558450,COGS 14B,A01,083073,Cheng; Tzu-Han,7,0,63,56
1656017564474,COGS 17,A01,092677,Semenuks; Arturs,8,7,81,73
1656017570500,COGS 100,A01,083619,Allen; Michael Gordon,2,2,70,68
1656017576522,COGS 101A,A01,083621,Davis; Joshua Daniel,4,3,68,64
1656017582546,COGS 101B,A01,091572,Allen; Michael Gordon,0,0,65,65
1656017588572,COGS 101C,A01,083625,Delgado; Tania,7,0,35,28
1656017594595,COGS 107A,A01,083627,Boyle; Mary E. T.,1,2,60,59
1656017600619,COGS 118A,A01,083075,Gupta; Anjum,21,16,76,55
1656017606646,CSE 3,A50,083646,Miranda; Gregory Joseph,14,0,50,36
1656017612681,CSE 8A,A50,083650,Miranda; Gregory Joseph,4,11,56,52
1656017618715,CSE 11,A01,083080,Cao; Yingjun,0,65,40,40
1656017624742,CSE 12,A01,083652,Krause-Levy; Sophia Louisa,6,8,120,114
1656017630766,CSE 15L,A01,083654,Morris; Justin Loren,3,1,50,47
1656017630766,CSE 15L,A02,083655,Morris; Justin Loren,1,1,50,49
1656017636790,CSE 20,A01,083657,Tran; Khoa Dang,29,0,80,51
1656017642827,CSE 21,A01,095574,Bach; Quang Tran,23,0,48,25
1656017648853,CSE 30,A01,083084,Eldon; John,2,10,80,78
1656017648853,CSE 30,B01,095061,Bhaskar; Nishant,1,4,50,49
1656017654876,CSE 100,A01,083659,Cao; Yingjun,2,25,70,68
1656017660898,CSE 134B,A01,083661,Powell; Thomas Allan,6,6,100,94
1656017666921,CSE 140,A01,083663,Gungor; Onat,5,0,85,80
1656017672948,CSE 140L,A01,083088,Eldon; John,5,0,100,95
1656017678971,CSE 175,A01,083665,Kumar; Rakesh,0,0,25,25
1656017684994,CSE 190,A00,092507,Dubnov; Shlomo,1,0,20,19
1656017691017,ECE 45,A01,083139,Congero; Spencer William,0,1,75,75
1656017697051,ECE 65,A50,083695,Saad; Andrew S,6,0,30,24
1656017697051,ECE 65,A51,095125,Staff,23,0,26,3
1656017703078,ECE 109,A01,091882,Touri; Behrouz,3,5,70,67
1656017709119,ECE 180,A00,083140,Abi Samra; Nicholas Camill,1,0,30,29
1656017709119,ECE 180,B00,083141,Abi Samra; Nicholas Camill,0,8,28,28
1656017715156,MATH 10A,A01,083735,Patchell; Gregory David,0,0,30,30
1656017715156,MATH 10A,A02,083736,Patchell; Gregory David,21,0,30,9
1656017715156,MATH 10A,A03,083737,Patchell; Gregory David,16,0,30,14
1656017721191,MATH 10B,A01,083207,Lim; Seonhee,1,1,34,33
1656017721191,MATH 10B,A02,083208,Lim; Seonhee,1,1,35,34
1656017721191,MATH 10B,A03,093472,Staff,1,0,34,33
1656017721191,MATH 10B,B01,083739,Sinha; Shubham,9,0,30,21
1656017727283,MATH 18,A01,083743,Cinel; Cameron Alexander,5,0,30,25
1656017727283,MATH 18,A02,083744,Cinel; Cameron Alexander,11,0,30,19
1656017727283,MATH 18,A03,083745,Cinel; Cameron Alexander,1,0,30,29
1656017727283,MATH 18,B01,083748,Ma; Zilu,0,0,36,36
1656017727283,MATH 18,B02,083749,Ma; Zilu,0,0,36,36
1656017727283,MATH 18,B03,083750,Ma; Zilu,0,0,36,36
1656017727283,MATH 18,B04,083751,Ma; Zilu,0,0,36,36
1656017727283,MATH 18,B05,093473,Staff,0,0,36,36
1656017727283,MATH 18,B06,093474,Staff,3,0,36,33
1656017733307,MATH 20A,A01,083754,Zheng; Zequn,10,0,40,30
1656017739330,MATH 20B,A01,083756,Briones; Jor-el Thomas Caparas,0,1,36,36
1656017739330,MATH 20B,A02,083757,Briones; Jor-el Thomas Caparas,1,0,36,35
1656017739330,MATH 20B,A03,093475,Staff,0,0,36,36
1656017745355,MATH 20C,A01,083760,Briones; Jor-el Thomas Caparas,0,2,35,35
1656017745355,MATH 20C,A02,083761,Briones; Jor-el Thomas Caparas,6,1,35,29
1656017745355,MATH 20C,A03,093476,Staff,0,0,35,35
1656017745355,MATH 20C,B01,083762,Bach; Quang Tran,3,0,30,27
1656017751379,MATH 20D,A01,083765,Tran; Brian Kha,2,0,30,28
1656017751379,MATH 20D,A02,083766,Tran; Brian Kha,0,1,30,30
1656017751379,MATH 20D,A03,083767,Tran; Brian Kha,1,0,30,29
1656017757403,MATH 20E,A01,083771,Ganguly; Soumya,0,1,32,32
1656017757403,MATH 20E,A02,083772,Ganguly; Soumya,1,1,32,31
1656017757403,MATH 20E,B01,083773,Ciotti; Benjamin,13,0,35,22
1656017757403,MATH 20E,B02,083774,Ciotti; Benjamin,12,0,35,23
1656017763516,MATH 103A,A01,083777,Greenfeld; Be'Eri,2,1,36,34
1656017763516,MATH 103A,A02,083778,Greenfeld; Be'Eri,2,0,36,34
1656017763516,MATH 103A,A03,093561,Staff,0,1,36,36
1656017763516,MATH 103A,B01,083779,Greenfeld; Be'Eri,8,1,36,28
1656017763516,MATH 103A,B02,083780,Greenfeld; Be'Eri,0,0,36,36
1656017763516,MATH 103A,B03,093562,Staff,0,0,36,36
1656017769551,MATH 105,A01,085443,Carter; Anne Toulson,4,1,35,31
1656017769551,MATH 105,A02,093477,Staff,8,0,35,27
1656017775580,MATH 109,A01,083213,Ganzberger; Geoffrey Michael,0,1,34,34
1656017775580,MATH 109,A02,083214,Ganzberger; Geoffrey Michael,0,0,34,34
1656017775580,MATH 109,A03,093478,Staff,1,0,34,33
1656017775580,MATH 109,B01,083215,Ganzberger; Geoffrey Michael,2,0,32,30
1656017775580,MATH 109,B02,083216,Ganzberger; Geoffrey Michael,0,0,32,32
1656017775580,MATH 109,B03,093479,Staff,4,0,32,28
1656017781610,MATH 142A,A01,083219,Chow; Bennett,1,0,32,31
1656017781610,MATH 142A,A02,083220,Chow; Bennett,7,0,32,25
1656017781610,MATH 142A,A03,093480,Staff,4,0,32,28
1656017781610,MATH 142A,B03,093481,Staff,3,0,32,29
1656017781610,MATH 142A,B04,093558,Staff,6,0,32,26
1656017781610,MATH 142A,B05,093559,Staff,0,0,32,32
1656017787638,MATH 193A,A01,083224,Rotar; Vladimir,1,2,34,33
1656017787638,MATH 193A,A02,083225,Rotar; Vladimir,0,0,34,34
1656017787638,MATH 193A,A03,083781,Rotar; Vladimir,2,0,34,32
1656017787638,MATH 193A,A04,083782,Rotar; Vladimir,3,0,34,31
1656017787638,MATH 193A,A05,093482,Rotar; Vladimir,0,0,34,34
1656017793664,MATH 197,001,091859,McAuley; Julian John,9999,0,9999,0
1656017793664,MATH 197,002,095566,Kedlaya; Kiran S.,9997,0,9999,2
1656017793664,MATH 197,003,095567,Xiao; Ming,9999,0,9999,0
1656017793664,MATH 197,004,095571,Perols; Johan Lars,9998,0,9999,1
1656017800727,COGS 9,A01,083615,Shannon; Kyle Michael,3,1,75,72
1656017806751,COGS 11,A01,083617,Boyle; Mary E. T.,11,1,48,37
1656017812786,COGS 13,A01,083071,Bastos; Amalia Pinkusfeld,4,2,71,67
1656017818812,COGS 14A,A01,092681,Semenuks; Arturs,4,25,100,96
1656017824840,COGS 14B,A01,083073,Cheng; Tzu-Han,7,0,63,56
1656017830864,COGS 17,A01,092677,Semenuks; Arturs,8,7,81,73
1656017836892,COGS 100,A01,083619,Allen; Michael Gordon,2,2,70,68
1656017842919,COGS 101A,A01,083621,Davis; Joshua Daniel,4,3,68,64
1656017848942,COGS 101B,A01,091572,Allen; Michael Gordon,0,0,65,65
1656017854972,COGS 101C,A01,083625,Delgado; Tania,7,0,35,28
1656017861005,COGS 107A,A01,083627,Boyle; Mary E. T.,1,2,60,59
1656017867028,COGS 118A,A01,083075,Gupta; Anjum,21,16,76,55
1656017873051,CSE 3,A50,083646,Miranda; Gregory Joseph,14,0,50,36
1656017879073,CSE 8A,A50,083650,Miranda; Gregory Joseph,4,11,56,52
1656017885097,CSE 11,A01,083080,Cao; Yingjun,0,65,40,40
1656017891121,CSE 12,A01,083652,Krause-Levy; Sophia Louisa,6,8,120,114
1656017897151,CSE 15L,A01,083654,Morris; Justin Loren,3,1,50,47
1656017897151,CSE 15L,A02,083655,Morris; Justin Loren,1,1,50,49
1656017903175,CSE 20,A01,083657,Tran; Khoa Dang,29,0,80,51
1656017909205,CSE 21,A01,095574,Bach; Quang Tran,23,0,48,25
1656017915236,CSE 30,A01,083084,Eldon; John,2,10,80,78
1656017915236,CSE 30,B01,095061,Bhaskar; Nishant,1,4,50,49
1656017921268,CSE 100,A01,083659,Cao; Yingjun,2,25,70,68
1656017927293,CSE 134B,A01,083661,Powell; Thomas Allan,6,6,100,94
1656017933320,CSE 140,A01,083663,Gungor; Onat,5,0,85,80
1656017939349,CSE 140L,A01,083088,Eldon; John,5,0,100,95
1656017945372,CSE 175,A01,083665,Kumar; Rakesh,0,0,25,25
1656017951398,CSE 190,A00,092507,Dubnov; Shlomo,1,0,20,19
1656017957420,ECE 45,A01,083139,Congero; Spencer William,0,1,75,75
1656017963443,ECE 65,A50,083695,Saad; Andrew S,6,0,30,24
1656017963443,ECE 65,A51,095125,Staff,23,0,26,3
1656017969469,ECE 109,A01,091882,Touri; Behrouz,3,5,70,67
1656017975504,ECE 180,A00,083140,Abi Samra; Nicholas Camill,1,0,30,29
1656017975504,ECE 180,B00,083141,Abi Samra; Nicholas Camill,0,8,28,28
1656017981561,MATH 10A,A01,083735,Patchell; Gregory David,0,0,30,30
1656017981561,MATH 10A,A02,083736,Patchell; Gregory David,21,0,30,9
1656017981561,MATH 10A,A03,083737,Patchell; Gregory David,16,0,30,14
1656017987587,MATH 10B,A01,083207,Lim; Seonhee,1,1,34,33
1656017987587,MATH 10B,A02,083208,Lim; Seonhee,1,1,35,34
1656017987587,MATH 10B,A03,093472,Staff,1,0,34,33
1656017987587,MATH 10B,B01,083739,Sinha; Shubham,9,0,30,21
1656017993620,MATH 18,A01,083743,Cinel; Cameron Alexander,5,0,30,25
1656017993620,MATH 18,A02,083744,Cinel; Cameron Alexander,11,0,30,19
1656017993620,MATH 18,A03,083745,Cinel; Cameron Alexander,1,0,30,29
1656017993620,MATH 18,B01,083748,Ma; Zilu,0,0,36,36
1656017993620,MATH 18,B02,083749,Ma; Zilu,0,0,36,36
1656017993620,MATH 18,B03,083750,Ma; Zilu,0,0,36,36
1656017993620,MATH 18,B04,083751,Ma; Zilu,0,0,36,36
1656017993620,MATH 18,B05,093473,Staff,0,0,36,36
1656017993620,MATH 18,B06,093474,Staff,3,0,36,33
1656017999648,MATH 20A,A01,083754,Zheng; Zequn,10,0,40,30
1656018005670,MATH 20B,A01,083756,Briones; Jor-el Thomas Caparas,0,1,36,36
1656018005670,MATH 20B,A02,083757,Briones; Jor-el Thomas Caparas,1,0,36,35
1656018005670,MATH 20B,A03,093475,Staff,0,0,36,36
1656018011695,MATH 20C,A01,083760,Briones; Jor-el Thomas Caparas,0,2,35,35
1656018011695,MATH 20C,A02,083761,Briones; Jor-el Thomas Caparas,6,1,35,29
1656018011695,MATH 20C,A03,093476,Staff,0,0,35,35
1656018011695,MATH 20C,B01,083762,Bach; Quang Tran,3,0,30,27
1656018017719,MATH 20D,A01,083765,Tran; Brian Kha,2,0,30,28
1656018017719,MATH 20D,A02,083766,Tran; Brian Kha,0,1,30,30
1656018017719,MATH 20D,A03,083767,Tran; Brian Kha,1,0,30,29
1656018023742,MATH 20E,A01,083771,Ganguly; Soumya,0,1,32,32
1656018023742,MATH 20E,A02,083772,Ganguly; Soumya,1,1,32,31
1656018023742,MATH 20E,B01,083773,Ciotti; Benjamin,13,0,35,22
1656018023742,MATH 20E,B02,083774,Ciotti; Benjamin,12,0,35,23
1656018029768,MATH 103A,A01,083777,Greenfeld; Be'Eri,2,1,36,34
1656018029768,MATH 103A,A02,083778,Greenfeld; Be'Eri,2,0,36,34
1656018029768,MATH 103A,A03,093561,Staff,0,1,36,36
1656018029768,MATH 103A,B01,083779,Greenfeld; Be'Eri,8,1,36,28
1656018029768,MATH 103A,B02,083780,Greenfeld; Be'Eri,0,0,36,36
1656018029768,MATH 103A,B03,093562,Staff,0,0,36,36
1656018035798,MATH 105,A01,085443,Carter; Anne Toulson,4,1,35,31
1656018035798,MATH 105,A02,093477,Staff,8,0,35,27
1656018041821,MATH 109,A01,083213,Ganzberger; Geoffrey Michael,0,1,34,34
1656018041821,MATH 109,A02,083214,Ganzberger; Geoffrey Michael,0,0,34,34
1656018041821,MATH 109,A03,093478,Staff,1,0,34,33
1656018041821,MATH 109,B01,083215,Ganzberger; Geoffrey Michael,2,0,32,30
1656018041821,MATH 109,B02,083216,Ganzberger; Geoffrey Michael,0,0,32,32
1656018041821,MATH 109,B03,093479,Staff,4,0,32,28
1656018047844,MATH 142A,A01,083219,Chow; Bennett,1,0,32,31
1656018047844,MATH 142A,A02,083220,Chow; Bennett,7,0,32,25
1656018047844,MATH 142A,A03,093480,Staff,4,0,32,28
1656018047844,MATH 142A,B03,093481,Staff,3,0,32,29
1656018047844,MATH 142A,B04,093558,Staff,6,0,32,26
1656018047844,MATH 142A,B05,093559,Staff,0,0,32,32
1656018053875,MATH 193A,A01,083224,Rotar; Vladimir,1,2,34,33
1656018053875,MATH 193A,A02,083225,Rotar; Vladimir,0,0,34,34
1656018053875,MATH 193A,A03,083781,Rotar; Vladimir,2,0,34,32
1656018053875,MATH 193A,A04,083782,Rotar; Vladimir,3,0,34,31
1656018053875,MATH 193A,A05,093482,Rotar; Vladimir,0,0,34,34
1656018059902,MATH 197,001,091859,McAuley; Julian John,9999,0,9999,0
1656018059902,MATH 197,002,095566,Kedlaya; Kiran S.,9997,0,9999,2
1656018059902,MATH 197,003,095567,Xiao; Ming,9999,0,9999,0
1656018059902,MATH 197,004,095571,Perols; Johan Lars,9998,0,9999,1
1656018066968,COGS 9,A01,083615,Shannon; Kyle Michael,3,1,75,72
1656018072996,COGS 11,A01,083617,Boyle; Mary E. T.,11,1,48,37
1656018079027,COGS 13,A01,083071,Bastos; Amalia Pinkusfeld,4,2,71,67
1656018085061,COGS 14A,A01,092681,Semenuks; Arturs,4,25,100,96
1656018091087,COGS 14B,A01,083073,Cheng; Tzu-Han,7,0,63,56
1656018097113,COGS 17,A01,092677,Semenuks; Arturs,8,7,81,73
1656018103137,COGS 100,A01,083619,Allen; Michael Gordon,2,2,70,68
1656018109159,COGS 101A,A01,083621,Davis; Joshua Daniel,4,3,68,64
1656018115186,COGS 101B,A01,091572,Allen; Michael Gordon,0,0,65,65
1656018121218,COGS 101C,A01,083625,Delgado; Tania,7,0,35,28
1656018127247,COGS 107A,A01,083627,Boyle; Mary E. T.,1,2,60,59
1656018133270,COGS 118A,A01,083075,Gupta; Anjum,21,16,76,55
1656018139304,CSE 3,A50,083646,Miranda; Gregory Joseph,14,0,50,36
1656018145326,CSE 8A,A50,083650,Miranda; Gregory Joseph,4,11,56,52
1656018151354,CSE 11,A01,083080,Cao; Yingjun,0,65,40,40
1656018157383,CSE 12,A01,083652,Krause-Levy; Sophia Louisa,6,8,120,114
1656018163410,CSE 15L,A01,083654,Morris; Justin Loren,3,1,50,47
1656018163410,CSE 15L,A02,083655,Morris; Justin Loren,1,1,50,49
1656018169436,CSE 20,A01,083657,Tran; Khoa Dang,29,0,80,51
1656018175460,CSE 21,A01,095574,Bach; Quang Tran,23,0,48,25
1656018181496,CSE 30,A01,083084,Eldon; John,2,10,80,78
1656018181496,CSE 30,B01,095061,Bhaskar; Nishant,1,4,50,49
1656018187517,CSE 100,A01,083659,Cao; Yingjun,2,25,70,68
1656018193541,CSE 134B,A01,083661,Powell; Thomas Allan,6,6,100,94
1656018199563,CSE 140,A01,083663,Gungor; Onat,5,0,85,80
1656018205587,CSE 140L,A01,083088,Eldon; John,5,0,100,95
1656018211611,CSE 175,A01,083665,Kumar; Rakesh,0,0,25,25
1656018217637,CSE 190,A00,092507,Dubnov; Shlomo,1,0,20,19
1656018223664,ECE 45,A01,083139,Congero; Spencer William,0,1,75,75
1656018229687,ECE 65,A50,083695,Saad; Andrew S,6,0,30,24
1656018229687,ECE 65,A51,095125,Staff,23,0,26,3
1656018235720,ECE 109,A01,091882,Touri; Behrouz,3,5,70,67
1656018241748,ECE 180,A00,083140,Abi Samra; Nicholas Camill,1,0,30,29
1656018241748,ECE 180,B00,083141,Abi Samra; Nicholas Camill,0,8,28,28
1656018247773,MATH 10A,A01,083735,Patchell; Gregory David,0,0,30,30
1656018247773,MATH 10A,A02,083736,Patchell; Gregory David,21,0,30,9
1656018247773,MATH 10A,A03,083737,Patchell; Gregory David,16,0,30,14
1656018253796,MATH 10B,A01,083207,Lim; Seonhee,1,1,34,33
1656018253796,MATH 10B,A02,083208,Lim; Seonhee,1,1,35,34
1656018253796,MATH 10B,A03,093472,Staff,1,0,34,33
1656018253796,MATH 10B,B01,083739,Sinha; Shubham,9,0,30,21
1656018259821,MATH 18,A01,083743,Cinel; Cameron Alexander,5,0,30,25
1656018259821,MATH 18,A02,083744,Cinel; Cameron Alexander,11,0,30,19
1656018259821,MATH 18,A03,083745,Cinel; Cameron Alexander,1,0,30,29
1656018259821,MATH 18,B01,083748,Ma; Zilu,0,0,36,36
1656018259821,MATH 18,B02,083749,Ma; Zilu,0,0,36,36
1656018259821,MATH 18,B03,083750,Ma; Zilu,0,0,36,36
1656018259821,MATH 18,B04,083751,Ma; Zilu,0,0,36,36
1656018259821,MATH 18,B05,093473,Staff,0,0,36,36
1656018259821,MATH 18,B06,093474,Staff,3,0,36,33
1656018265843,MATH 20A,A01,083754,Zheng; Zequn,10,0,40,30
1656018271866,MATH 20B,A01,083756,Briones; Jor-el Thomas Caparas,0,1,36,36
1656018271866,MATH 20B,A02,083757,Briones; Jor-el Thomas Caparas,1,0,36,35
1656018271866,MATH 20B,A03,093475,Staff,0,0,36,36
1656018277890,MATH 20C,A01,083760,Briones; Jor-el Thomas Caparas,0,2,35,35
1656018277890,MATH 20C,A02,083761,Briones; Jor-el Thomas Caparas,6,1,35,29
1656018277890,MATH 20C,A03,093476,Staff,0,0,35,35
1656018277890,MATH 20C,B01,083762,Bach; Quang Tran,3,0,30,27
1656018283913,MATH 20D,A01,083765,Tran; Brian Kha,2,0,30,28
1656018283913,MATH 20D,A02,083766,Tran; Brian Kha,0,1,30,30
1656018283913,MATH 20D,A03,083767,Tran; Brian Kha,1,0,30,29
1656018289938,MATH 20E,A01,083771,Ganguly; Soumya,0,1,32,32
1656018289938,MATH 20E,A02,083772,Ganguly; Soumya,1,1,32,31
1656018289938,MATH 20E,B01,083773,Ciotti; Benjamin,13,0,35,22
1656018289938,MATH 20E,B02,083774,Ciotti; Benjamin,12,0,35,23
1656018295964,MATH 103A,A01,083777,Greenfeld; Be'Eri,2,1,36,34
1656018295964,MATH 103A,A02,083778,Greenfeld; Be'Eri,2,0,36,34
1656018295964,MATH 103A,A03,093561,Staff,0,1,36,36
1656018295964,MATH 103A,B01,083779,Greenfeld; Be'Eri,8,1,36,28
1656018295964,MATH 103A,B02,083780,Greenfeld; Be'Eri,0,0,36,36
1656018295964,MATH 103A,B03,093562,Staff,0,0,36,36
1656018301991,MATH 105,A01,085443,Carter; Anne Toulson,4,1,35,31
1656018301991,MATH 105,A02,093477,Staff,8,0,35,27
1656018308016,MATH 109,A01,083213,Ganzberger; Geoffrey Michael,0,1,34,34
1656018308016,MATH 109,A02,083214,Ganzberger; Geoffrey Michael,0,0,34,34
1656018308016,MATH 109,A03,093478,Staff,1,0,34,33
1656018308016,MATH 109,B01,083215,Ganzberger; Geoffrey Michael,2,0,32,30
1656018308016,MATH 109,B02,083216,Ganzberger; Geoffrey Michael,0,0,32,32
1656018308016,MATH 109,B03,093479,Staff,4,0,32,28
1656018314050,MATH 142A,A01,083219,Chow; Bennett,1,0,32,31
1656018314050,MATH 142A,A02,083220,Chow; Bennett,7,0,32,25
1656018314050,MATH 142A,A03,093480,Staff,4,0,32,28
1656018314050,MATH 142A,B03,093481,Staff,3,0,32,29
1656018314050,MATH 142A,B04,093558,Staff,6,0,32,26
1656018314050,MATH 142A,B05,093559,Staff,0,0,32,32
1656018320080,MATH 193A,A01,083224,Rotar; Vladimir,1,2,34,33
1656018320080,MATH 193A,A02,083225,Rotar; Vladimir,0,0,34,34
1656018320080,MATH 193A,A03,083781,Rotar; Vladimir,2,0,34,32
1656018320080,MATH 193A,A04,083782,Rotar; Vladimir,3,0,34,31
1656018320080,MATH 193A,A05,093482,Rotar; Vladimir,0,0,34,34
1656018326115,MATH 197,001,091859,McAuley; Julian John,9999,0,9999,0
1656018326115,MATH 197,002,095566,Kedlaya; Kiran S.,9997,0,9999,2
1656018326115,MATH 197,003,095567,Xiao; Ming,9999,0,9999,0
1656018326115,MATH 197,004,095571,Perols; Johan Lars,9998,0,9999,1
1656018333204,COGS 9,A01,083615,Shannon; Kyle Michael,3,1,75,72
1656018339230,COGS 11,A01,083617,Boyle; Mary E. T.,11,1,48,37
1656018345252,COGS 13,A01,083071,Bastos; Amalia Pinkusfeld,4,2,71,67
1656018351277,COGS 14A,A01,092681,Semenuks; Arturs,4,25,100,96
1656018357371,COGS 14B,A01,083073,Cheng; Tzu-Han,7,0,63,56
1656018363404,COGS 17,A01,092677,Semenuks; Arturs,8,7,81,73
1656018369429,COGS 100,A01,083619,Allen; Michael Gordon,2,2,70,68
1656018375465,COGS 101A,A01,083621,Davis; Joshua Daniel,4,3,68,64
1656018381495,COGS 101B,A01,091572,Allen; Michael Gordon,0,0,65,65
1656018387535,COGS 101C,A01,083625,Delgado; Tania,7,0,35,28
1656018393557,COGS 107A,A01,083627,Boyle; Mary E. T.,1,2,60,59
1656018399586,COGS 118A,A01,083075,Gupta; Anjum,21,16,76,55
1656018405615,CSE 3,A50,083646,Miranda; Gregory Joseph,14,0,50,36
1656018411638,CSE 8A,A50,083650,Miranda; Gregory Joseph,4,11,56,52
1656018417662,CSE 11,A01,083080,Cao; Yingjun,0,65,40,40
1656018423685,CSE 12,A01,083652,Krause-Levy; Sophia Louisa,6,8,120,114
1656018429714,CSE 15L,A01,083654,Morris; Justin Loren,3,1,50,47
1656018429714,CSE 15L,A02,083655,Morris; Justin Loren,1,1,50,49
1656018435756,CSE 20,A01,083657,Tran; Khoa Dang,29,0,80,51
1656018441783,CSE 21,A01,095574,Bach; Quang Tran,23,0,48,25
1656018447807,CSE 30,A01,083084,Eldon; John,2,10,80,78
1656018447807,CSE 30,B01,095061,Bhaskar; Nishant,1,4,50,49
1656018453849,CSE 100,A01,083659,Cao; Yingjun,2,25,70,68
1656018459873,CSE 134B,A01,083661,Powell; Thomas Allan,6,6,100,94
1656018465900,CSE 140,A01,083663,Gungor; Onat,5,0,85,80
1656018471931,CSE 140L,A01,083088,Eldon; John,5,0,100,95
1656018477955,CSE 175,A01,083665,Kumar; Rakesh,0,0,25,25
1656018483979,CSE 190,A00,092507,Dubnov; Shlomo,1,0,20,19
1656018490002,ECE 45,A01,083139,Congero; Spencer William,0,1,75,75
1656018496037,ECE 65,A50,083695,Saad; Andrew S,6,0,30,24
1656018496037,ECE 65,A51,095125,Staff,23,0,26,3
1656018502062,ECE 109,A01,091882,Touri; Behrouz,3,5,70,67
1656018508085,ECE 180,A00,083140,Abi Samra; Nicholas Camill,1,0,30,29
1656018508085,ECE 180,B00,083141,Abi Samra; Nicholas Camill,0,8,28,28
1656018514118,MATH 10A,A01,083735,Patchell; Gregory David,0,0,30,30
1656018514118,MATH 10A,A02,083736,Patchell; Gregory David,21,0,30,9
1656018514118,MATH 10A,A03,083737,Patchell; Gregory David,16,0,30,14
1656018520156,MATH 10B,A01,083207,Lim; Seonhee,1,1,34,33
1656018520156,MATH 10B,A02,083208,Lim; Seonhee,1,1,35,34
1656018520156,MATH 10B,A03,093472,Staff,1,0,34,33
1656018520156,MATH 10B,B01,083739,Sinha; Shubham,9,0,30,21
1656018526185,MATH 18,A01,083743,Cinel; Cameron Alexander,5,0,30,25
1656018526185,MATH 18,A02,083744,Cinel; Cameron Alexander,11,0,30,19
1656018526185,MATH 18,A03,083745,Cinel; Cameron Alexander,1,0,30,29
1656018526185,MATH 18,B01,083748,Ma; Zilu,0,0,36,36
1656018526185,MATH 18,B02,083749,Ma; Zilu,0,0,36,36
1656018526185,MATH 18,B03,083750,Ma; Zilu,0,0,36,36
1656018526185,MATH 18,B04,083751,Ma; Zilu,0,0,36,36
1656018526185,MATH 18,B05,093473,Staff,0,0,36,36
1656018526185,MATH 18,B06,093474,Staff,3,0,36,33
1656018532224,MATH 20A,A01,083754,Zheng; Zequn,10,0,40,30
1656018538252,MATH 20B,A01,083756,Briones; Jor-el Thomas Caparas,0,1,36,36
1656018538252,MATH 20B,A02,083757,Briones; Jor-el Thomas Caparas,1,0,36,35
1656018538252,MATH 20B,A03,093475,Staff,0,0,36,36
1656018544276,MATH 20C,A01,083760,Briones; Jor-el Thomas Caparas,0,2,35,35
1656018544276,MATH 20C,A02,083761,Briones; Jor-el Thomas Caparas,6,1,35,29
1656018544276,MATH 20C,A03,093476,Staff,0,0,35,35
1656018544276,MATH 20C,B01,083762,Bach; Quang Tran,3,0,30,27
1656018550309,MATH 20D,A01,083765,Tran; Brian Kha,2,0,30,28
1656018550309,MATH 20D,A02,083766,Tran; Brian Kha,0,1,30,30
1656018550309,MATH 20D,A03,083767,Tran; Brian Kha,1,0,30,29
1656018556336,MATH 20E,A01,083771,Ganguly; Soumya,0,1,32,32
1656018556336,MATH 20E,A02,083772,Ganguly; Soumya,1,1,32,31
1656018556336,MATH 20E,B01,083773,Ciotti; Benjamin,13,0,35,22
1656018556336,MATH 20E,B02,083774,Ciotti; Benjamin,12,0,35,23
1656018562362,MATH 103A,A01,083777,Greenfeld; Be'Eri,2,1,36,34
1656018562362,MATH 103A,A02,083778,Greenfeld; Be'Eri,2,0,36,34
1656018562362,MATH 103A,A03,093561,Staff,0,1,36,36
1656018562362,MATH 103A,B01,083779,Greenfeld; Be'Eri,8,1,36,28
1656018562362,MATH 103A,B02,083780,Greenfeld; Be'Eri,0,0,36,36
1656018562362,MATH 103A,B03,093562,Staff,0,0,36,36
1656018568392,MATH 105,A01,085443,Carter; Anne Toulson,4,1,35,31
1656018568392,MATH 105,A02,093477,Staff,8,0,35,27
1656018574423,MATH 109,A01,083213,Ganzberger; Geoffrey Michael,0,1,34,34
1656018574423,MATH 109,A02,083214,Ganzberger; Geoffrey Michael,0,0,34,34
1656018574423,MATH 109,A03,093478,Staff,1,0,34,33
1656018574423,MATH 109,B01,083215,Ganzberger; Geoffrey Michael,2,0,32,30
1656018574423,MATH 109,B02,083216,Ganzberger; Geoffrey Michael,0,0,32,32
1656018574423,MATH 109,B03,093479,Staff,4,0,32,28
1656018580452,MATH 142A,A01,083219,Chow; Bennett,1,0,32,31
1656018580452,MATH 142A,A02,083220,Chow; Bennett,7,0,32,25
1656018580452,MATH 142A,A03,093480,Staff,4,0,32,28
1656018580452,MATH 142A,B03,093481,Staff,3,0,32,29
1656018580452,MATH 142A,B04,093558,Staff,6,0,32,26
1656018580452,MATH 142A,B05,093559,Staff,0,0,32,32
1656018586476,MATH 193A,A01,083224,Rotar; Vladimir,1,2,34,33
1656018586476,MATH 193A,A02,083225,Rotar; Vladimir,0,0,34,34
1656018586476,MATH 193A,A03,083781,Rotar; Vladimir,2,0,34,32
1656018586476,MATH 193A,A04,083782,Rotar; Vladimir,3,0,34,31
1656018586476,MATH 193A,A05,093482,Rotar; Vladimir,0,0,34,34
1656018592502,MATH 197,001,091859,McAuley; Julian John,9999,0,9999,0
1656018592502,MATH 197,002,095566,Kedlaya; Kiran S.,9997,0,9999,2
1656018592502,MATH 197,003,095567,Xiao; Ming,9999,0,9999,0
1656018592502,MATH 197,004,095571,Perols; Johan Lars,9998,0,9999,1
1656018599565,COGS 9,A01,083615,Shannon; Kyle Michael,3,1,75,72
1656018605595,COGS 11,A01,083617,Boyle; Mary E. T.,11,1,48,37
1656018611622,COGS 13,A01,083071,Bastos; Amalia Pinkusfeld,4,2,71,67
1656018617651,COGS 14A,A01,092681,Semenuks; Arturs,4,25,100,96
1656018623677,COGS 14B,A01,083073,Cheng; Tzu-Han,7,0,63,56
1656018629706,COGS 17,A01,092677,Semenuks; Arturs,8,7,81,73
1656018635731,COGS 100,A01,083619,Allen; Michael Gordon,2,2,70,68
1656018641756,COGS 101A,A01,083621,Davis; Joshua Daniel,4,3,68,64
1656018647784,COGS 101B,A01,091572,Allen; Michael Gordon,0,0,65,65
1656018653818,COGS 101C,A01,083625,Delgado; Tania,7,0,35,28
1656018659842,COGS 107A,A01,083627,Boyle; Mary E. T.,1,2,60,59
1656018665873,COGS 118A,A01,083075,Gupta; Anjum,21,16,76,55
1656018671904,CSE 3,A50,083646,Miranda; Gregory Joseph,14,0,50,36
1656018677931,CSE 8A,A50,083650,Miranda; Gregory Joseph,4,11,56,52
1656018683958,CSE 11,A01,083080,Cao; Yingjun,0,65,40,40
1656018689980,CSE 12,A01,083652,Krause-Levy; Sophia Louisa,6,8,120,114
1656018696003,CSE 15L,A01,083654,Morris; Justin Loren,3,1,50,47
1656018696003,CSE 15L,A02,083655,Morris; Justin Loren,1,1,50,49
1656018702029,CSE 20,A01,083657,Tran; Khoa Dang,29,0,80,51
1656018708056,CSE 21,A01,095574,Bach; Quang Tran,23,0,48,25
1656018714081,CSE 30,A01,083084,Eldon; John,2,10,80,78
1656018714081,CSE 30,B01,095061,Bhaskar; Nishant,1,4,50,49
1656018720109,CSE 100,A01,083659,Cao; Yingjun,2,25,70,68
1656018726135,CSE 134B,A01,083661,Powell; Thomas Allan,6,6,100,94
1656018732158,CSE 140,A01,083663,Gungor; Onat,5,0,85,80
1656018738184,CSE 140L,A01,083088,Eldon; John,5,0,100,95
1656018744206,CSE 175,A01,083665,Kumar; Rakesh,0,0,25,25
1656018750240,CSE 190,A00,092507,Dubnov; Shlomo,1,0,20,19
1656018756264,ECE 45,A01,083139,Congero; Spencer William,0,1,75,75
1656018762288,ECE 65,A50,083695,Saad; Andrew S,6,0,30,24
1656018762288,ECE 65,A51,095125,Staff,23,0,26,3
1656018768314,ECE 109,A01,091882,Touri; Behrouz,3,5,70,67
1656018774337,ECE 180,A00,083140,Abi Samra; Nicholas Camill,1,0,30,29
1656018774337,ECE 180,B00,083141,Abi Samra; Nicholas Camill,0,8,28,28
1656018780376,MATH 10A,A01,083735,Patchell; Gregory David,0,0,30,30
1656018780376,MATH 10A,A02,083736,Patchell; Gregory David,21,0,30,9
1656018780376,MATH 10A,A03,083737,Patchell; Gregory David,16,0,30,14
1656018786399,MATH 10B,A01,083207,Lim; Seonhee,1,1,34,33
1656018786399,MATH 10B,A02,083208,Lim; Seonhee,1,1,35,34
1656018786399,MATH 10B,A03,093472,Staff,1,0,34,33
1656018786399,MATH 10B,B01,083739,Sinha; Shubham,9,0,30,21
1656018792438,MATH 18,A01,083743,Cinel; Cameron Alexander,5,0,30,25
1656018792438,MATH 18,A02,083744,Cinel; Cameron Alexander,11,0,30,19
1656018792438,MATH 18,A03,083745,Cinel; Cameron Alexander,1,0,30,29
1656018792438,MATH 18,B01,083748,Ma; Zilu,0,0,36,36
1656018792438,MATH 18,B02,083749,Ma; Zilu,0,0,36,36
1656018792438,MATH 18,B03,083750,Ma; Zilu,0,0,36,36
1656018792438,MATH 18,B04,083751,Ma; Zilu,0,0,36,36
1656018792438,MATH 18,B05,093473,Staff,0,0,36,36
1656018792438,MATH 18,B06,093474,Staff,3,0,36,33
1656018798464,MATH 20A,A01,083754,Zheng; Zequn,10,0,40,30
1656018804489,MATH 20B,A01,083756,Briones; Jor-el Thomas Caparas,0,1,36,36
1656018804489,MATH 20B,A02,083757,Briones; Jor-el Thomas Caparas,1,0,36,35
1656018804489,MATH 20B,A03,093475,Staff,0,0,36,36
1656018810526,MATH 20C,A01,083760,Briones; Jor-el Thomas Caparas,0,2,35,35
1656018810526,MATH 20C,A02,083761,Briones; Jor-el Thomas Caparas,6,1,35,29
1656018810526,MATH 20C,A03,093476,Staff,0,0,35,35
1656018810526,MATH 20C,B01,083762,Bach; Quang Tran,3,0,30,27
1656018816550,MATH 20D,A01,083765,Tran; Brian Kha,2,0,30,28
1656018816550,MATH 20D,A02,083766,Tran; Brian Kha,0,1,30,30
1656018816550,MATH 20D,A03,083767,Tran; Brian Kha,1,0,30,29
1656018822575,MATH 20E,A01,083771,Ganguly; Soumya,0,1,32,32
1656018822575,MATH 20E,A02,083772,Ganguly; Soumya,1,1,32,31
1656018822575,MATH 20E,B01,083773,Ciotti; Benjamin,13,0,35,22
1656018822575,MATH 20E,B02,083774,Ciotti; Benjamin,12,0,35,23
1656018828611,MATH 103A,A01,083777,Greenfeld; Be'Eri,2,1,36,34
1656018828611,MATH 103A,A02,083778,Greenfeld; Be'Eri,2,0,36,34
1656018828611,MATH 103A,A03,093561,Staff,0,1,36,36
1656018828611,MATH 103A,B01,083779,Greenfeld; Be'Eri,8,1,36,28
1656018828611,MATH 103A,B02,083780,Greenfeld; Be'Eri,0,0,36,36
1656018828611,MATH 103A,B03,093562,Staff,0,0,36,36
1656018834635,MATH 105,A01,085443,Carter; Anne Toulson,4,1,35,31
1656018834635,MATH 105,A02,093477,Staff,8,0,35,27
1656018840664,MATH 109,A01,083213,Ganzberger; Geoffrey Michael,0,1,34,34
1656018840664,MATH 109,A02,083214,Ganzberger; Geoffrey Michael,0,0,34,34
1656018840664,MATH 109,A03,093478,Staff,1,0,34,33
1656018840664,MATH 109,B01,083215,Ganzberger; Geoffrey Michael,2,0,32,30
1656018840664,MATH 109,B02,083216,Ganzberger; Geoffrey Michael,0,0,32,32
1656018840664,MATH 109,B03,093479,Staff,4,0,32,28
1656018846694,MATH 142A,A01,083219,Chow; Bennett,1,0,32,31
1656018846694,MATH 142A,A02,083220,Chow; Bennett,7,0,32,25
1656018846694,MATH 142A,A03,093480,Staff,4,0,32,28
1656018846694,MATH 142A,B03,093481,Staff,3,0,32,29
1656018846694,MATH 142A,B04,093558,Staff,6,0,32,26
1656018846694,MATH 142A,B05,093559,Staff,0,0,32,32
1656018852725,MATH 193A,A01,083224,Rotar; Vladimir,1,2,34,33
1656018852725,MATH 193A,A02,083225,Rotar; Vladimir,0,1,34,34
1656018852725,MATH 193A,A03,083781,Rotar; Vladimir,2,0,34,32
1656018852725,MATH 193A,A04,083782,Rotar; Vladimir,3,0,34,31
1656018852725,MATH 193A,A05,093482,Rotar; Vladimir,0,0,34,34
1656018858749,MATH 197,001,091859,McAuley; Julian John,9999,0,9999,0
1656018858749,MATH 197,002,095566,Kedlaya; Kiran S.,9997,0,9999,2
1656018858749,MATH 197,003,095567,Xiao; Ming,9999,0,9999,0
1656018858749,MATH 197,004,095571,Perols; Johan Lars,9998,0,9999,1
1656018865802,COGS 9,A01,083615,Shannon; Kyle Michael,3,1,75,72
1656018871825,COGS 11,A01,083617,Boyle; Mary E. T.,11,1,48,37
1656018877849,COGS 13,A01,083071,Bastos; Amalia Pinkusfeld,4,2,71,67
1656018883873,COGS 14A,A01,092681,Semenuks; Arturs,4,25,100,96
1656018889905,COGS 14B,A01,083073,Cheng; Tzu-Han,7,0,63,56
1656018895931,COGS 17,A01,092677,Semenuks; Arturs,8,7,81,73
1656018901959,COGS 100,A01,083619,Allen; Michael Gordon,2,2,70,68
1656018907990,COGS 101A,A01,083621,Davis; Joshua Daniel,4,3,68,64
1656018914018,COGS 101B,A01,091572,Allen; Michael Gordon,0,0,65,65
1656018920042,COGS 101C,A01,083625,Delgado; Tania,7,0,35,28
1656018926070,COGS 107A,A01,083627,Boyle; Mary E. T.,1,2,60,59
1656018932097,COGS 118A,A01,083075,Gupta; Anjum,21,16,76,55
1656018938124,CSE 3,A50,083646,Miranda; Gregory Joseph,14,0,50,36
1656018944149,CSE 8A,A50,083650,Miranda; Gregory Joseph,4,11,56,52
1656018950179,CSE 11,A01,083080,Cao; Yingjun,0,65,40,40
1656018956276,CSE 12,A01,083652,Krause-Levy; Sophia Louisa,6,8,120,114
1656018962304,CSE 15L,A01,083654,Morris; Justin Loren,3,1,50,47
1656018962304,CSE 15L,A02,083655,Morris; Justin Loren,1,1,50,49
1656018968344,CSE 20,A01,083657,Tran; Khoa Dang,29,0,80,51
1656018974373,CSE 21,A01,095574,Bach; Quang Tran,23,0,48,25
1656018980406,CSE 30,A01,083084,Eldon; John,2,10,80,78
1656018980406,CSE 30,B01,095061,Bhaskar; Nishant,1,4,50,49
1656018986432,CSE 100,A01,083659,Cao; Yingjun,2,25,70,68
1656018992460,CSE 134B,A01,083661,Powell; Thomas Allan,6,6,100,94
1656018998483,CSE 140,A01,083663,Gungor; Onat,5,0,85,80
1656019004522,CSE 140L,A01,083088,Eldon; John,5,0,100,95
1656019010556,CSE 175,A01,083665,Kumar; Rakesh,0,0,25,25
1656019016580,CSE 190,A00,092507,Dubnov; Shlomo,1,0,20,19
1656019022613,ECE 45,A01,083139,Congero; Spencer William,0,1,75,75
1656019028641,ECE 65,A50,083695,Saad; Andrew S,6,0,30,24
1656019028641,ECE 65,A51,095125,Staff,23,0,26,3
1656019034674,ECE 109,A01,091882,Touri; Behrouz,3,5,70,67
1656019040698,ECE 180,A00,083140,Abi Samra; Nicholas Camill,1,0,30,29
1656019040698,ECE 180,B00,083141,Abi Samra; Nicholas Camill,0,8,28,28
1656019046722,MATH 10A,A01,083735,Patchell; Gregory David,0,0,30,30
1656019046722,MATH 10A,A02,083736,Patchell; Gregory David,21,0,30,9
1656019046722,MATH 10A,A03,083737,Patchell; Gregory David,16,0,30,14
1656019052745,MATH 10B,A01,083207,Lim; Seonhee,1,1,34,33
1656019052745,MATH 10B,A02,083208,Lim; Seonhee,1,1,35,34
1656019052745,MATH 10B,A03,093472,Staff,1,0,34,33
1656019052745,MATH 10B,B01,083739,Sinha; Shubham,9,0,30,21
1656019058771,MATH 18,A01,083743,Cinel; Cameron Alexander,5,0,30,25
1656019058771,MATH 18,A02,083744,Cinel; Cameron Alexander,11,0,30,19
1656019058771,MATH 18,A03,083745,Cinel; Cameron Alexander,1,0,30,29
1656019058771,MATH 18,B01,083748,Ma; Zilu,0,0,36,36
1656019058771,MATH 18,B02,083749,Ma; Zilu,0,0,36,36
1656019058771,MATH 18,B03,083750,Ma; Zilu,0,0,36,36
1656019058771,MATH 18,B04,083751,Ma; Zilu,0,0,36,36
1656019058771,MATH 18,B05,093473,Staff,0,0,36,36
1656019058771,MATH 18,B06,093474,Staff,3,0,36,33
1656019064795,MATH 20A,A01,083754,Zheng; Zequn,10,0,40,30
1656019070820,MATH 20B,A01,083756,Briones; Jor-el Thomas Caparas,0,1,36,36
1656019070820,MATH 20B,A02,083757,Briones; Jor-el Thomas Caparas,1,0,36,35
1656019070820,MATH 20B,A03,093475,Staff,0,0,36,36
1656019076844,MATH 20C,A01,083760,Briones; Jor-el Thomas Caparas,0,2,35,35
1656019076844,MATH 20C,A02,083761,Briones; Jor-el Thomas Caparas,6,1,35,29
1656019076844,MATH 20C,A03,093476,Staff,0,0,35,35
1656019076844,MATH 20C,B01,083762,Bach; Quang Tran,3,0,30,27
1656019082872,MATH 20D,A01,083765,Tran; Brian Kha,2,0,30,28
1656019082872,MATH 20D,A02,083766,Tran; Brian Kha,0,1,30,30
1656019082872,MATH 20D,A03,083767,Tran; Brian Kha,1,0,30,29
1656019088903,MATH 20E,A01,083771,Ganguly; Soumya,0,1,32,32
1656019088903,MATH 20E,A02,083772,Ganguly; Soumya,1,1,32,31
1656019088903,MATH 20E,B01,083773,Ciotti; Benjamin,13,0,35,22
1656019088903,MATH 20E,B02,083774,Ciotti; Benjamin,12,0,35,23
1656019094927,MATH 103A,A01,083777,Greenfeld; Be'Eri,2,1,36,34
1656019094927,MATH 103A,A02,083778,Greenfeld; Be'Eri,1,0,36,35
1656019094927,MATH 103A,A03,093561,Staff,0,1,36,36
1656019094927,MATH 103A,B01,083779,Greenfeld; Be'Eri,8,1,36,28
1656019094927,MATH 103A,B02,083780,Greenfeld; Be'Eri,0,0,36,36
1656019094927,MATH 103A,B03,093562,Staff,0,0,36,36
1656019100958,MATH 105,A01,085443,Carter; Anne Toulson,4,1,35,31
1656019100958,MATH 105,A02,093477,Staff,9,0,35,26
1656019106989,MATH 109,A01,083213,Ganzberger; Geoffrey Michael,0,1,34,34
1656019106989,MATH 109,A02,083214,Ganzberger; Geoffrey Michael,0,0,34,34
1656019106989,MATH 109,A03,093478,Staff,1,0,34,33
1656019106989,MATH 109,B01,083215,Ganzberger; Geoffrey Michael,2,0,32,30
1656019106989,MATH 109,B02,083216,Ganzberger; Geoffrey Michael,0,0,32,32
1656019106989,MATH 109,B03,093479,Staff,3,0,32,29
1656019113018,MATH 142A,A01,083219,Chow; Bennett,1,0,32,31
1656019113018,MATH 142A,A02,083220,Chow; Bennett,7,0,32,25
1656019113018,MATH 142A,A03,093480,Staff,4,0,32,28
1656019113018,MATH 142A,B03,093481,Staff,3,0,32,29
1656019113018,MATH 142A,B04,093558,Staff,6,0,32,26
1656019113018,MATH 142A,B05,093559,Staff,0,0,32,32
1656019119045,MATH 193A,A01,083224,Rotar; Vladimir,1,2,34,33
1656019119045,MATH 193A,A02,083225,Rotar; Vladimir,0,1,34,34
1656019119045,MATH 193A,A03,083781,Rotar; Vladimir,2,0,34,32
1656019119045,MATH 193A,A04,083782,Rotar; Vladimir,3,0,34,31
1656019119045,MATH 193A,A05,093482,Rotar; Vladimir,0,0,34,34
1656019125071,MATH 197,001,091859,McAuley; Julian John,9999,0,9999,0
1656019125071,MATH 197,002,095566,Kedlaya; Kiran S.,9997,0,9999,2
1656019125071,MATH 197,003,095567,Xiao; Ming,9999,0,9999,0
1656019125071,MATH 197,004,095571,Perols; Johan Lars,9998,0,9999,1
1656019132133,COGS 9,A01,083615,Shannon; Kyle Michael,3,1,75,72
1656019138165,COGS 11,A01,083617,Boyle; Mary E. T.,11,1,48,37
1656019144196,COGS 13,A01,083071,Bastos; Amalia Pinkusfeld,4,2,71,67
1656019150218,COGS 14A,A01,092681,Semenuks; Arturs,4,25,100,96
1656019156239,COGS 14B,A01,083073,Cheng; Tzu-Han,7,0,63,56
1656019162262,COGS 17,A01,092677,Semenuks; Arturs,8,7,81,73
1656019168296,COGS 100,A01,083619,Allen; Michael Gordon,2,2,70,68
1656019174322,COGS 101A,A01,083621,Davis; Joshua Daniel,4,3,68,64
1656019180343,COGS 101B,A01,091572,Allen; Michael Gordon,0,0,65,65
1656019186376,COGS 101C,A01,083625,Delgado; Tania,7,0,35,28
1656019192402,COGS 107A,A01,083627,Boyle; Mary E. T.,1,2,60,59
1656019198427,COGS 118A,A01,083075,Gupta; Anjum,21,16,76,55
1656019204467,CSE 3,A50,083646,Miranda; Gregory Joseph,14,0,50,36
1656019210494,CSE 8A,A50,083650,Miranda; Gregory Joseph,4,11,56,52
1656019216516,CSE 11,A01,083080,Cao; Yingjun,0,65,40,40
1656019222537,CSE 12,A01,083652,Krause-Levy; Sophia Louisa,7,8,120,113
1656019228562,CSE 15L,A01,083654,Morris; Justin Loren,3,1,50,47
1656019228562,CSE 15L,A02,083655,Morris; Justin Loren,2,1,50,48
1656019234586,CSE 20,A01,083657,Tran; Khoa Dang,29,0,80,51
1656019240608,CSE 21,A01,095574,Bach; Quang Tran,23,0,48,25
1656019246638,CSE 30,A01,083084,Eldon; John,2,10,80,78
1656019246638,CSE 30,B01,095061,Bhaskar; Nishant,1,4,50,49
1656019252660,CSE 100,A01,083659,Cao; Yingjun,2,25,70,68
1656019258683,CSE 134B,A01,083661,Powell; Thomas Allan,6,6,100,94
1656019264707,CSE 140,A01,083663,Gungor; Onat,5,0,85,80
1656019270733,CSE 140L,A01,083088,Eldon; John,5,0,100,95
1656019276764,CSE 175,A01,083665,Kumar; Rakesh,0,0,25,25
1656019282795,CSE 190,A00,092507,Dubnov; Shlomo,1,0,20,19
1656019288818,ECE 45,A01,083139,Congero; Spencer William,0,1,75,75
1656019294841,ECE 65,A50,083695,Saad; Andrew S,6,0,30,24
1656019294841,ECE 65,A51,095125,Staff,23,0,26,3
1656019300868,ECE 109,A01,091882,Touri; Behrouz,3,5,70,67
1656019306891,ECE 180,A00,083140,Abi Samra; Nicholas Camill,1,0,30,29
1656019306891,ECE 180,B00,083141,Abi Samra; Nicholas Camill,0,8,28,28
1656019312915,MATH 10A,A01,083735,Patchell; Gregory David,0,0,30,30
1656019312915,MATH 10A,A02,083736,Patchell; Gregory David,21,0,30,9
1656019312915,MATH 10A,A03,083737,Patchell; Gregory David,16,0,30,14
1656019318946,MATH 10B,A01,083207,Lim; Seonhee,1,1,34,33
1656019318946,MATH 10B,A02,083208,Lim; Seonhee,1,1,35,34
1656019318946,MATH 10B,A03,093472,Staff,1,0,34,33
1656019318946,MATH 10B,B01,083739,Sinha; Shubham,9,0,30,21
1656019324978,MATH 18,A01,083743,Cinel; Cameron Alexander,5,0,30,25
1656019324978,MATH 18,A02,083744,Cinel; Cameron Alexander,11,0,30,19
1656019324978,MATH 18,A03,083745,Cinel; Cameron Alexander,1,0,30,29
1656019324978,MATH 18,B01,083748,Ma; Zilu,0,0,36,36
1656019324978,MATH 18,B02,083749,Ma; Zilu,0,0,36,36
1656019324978,MATH 18,B03,083750,Ma; Zilu,0,0,36,36
1656019324978,MATH 18,B04,083751,Ma; Zilu,0,0,36,36
1656019324978,MATH 18,B05,093473,Staff,0,0,36,36
1656019324978,MATH 18,B06,093474,Staff,3,0,36,33
1656019331020,MATH 20A,A01,083754,Zheng; Zequn,10,0,40,30
1656019337048,MATH 20B,A01,083756,Briones; Jor-el Thomas Caparas,0,1,36,36
1656019337048,MATH 20B,A02,083757,Briones; Jor-el Thomas Caparas,1,0,36,35
1656019337048,MATH 20B,A03,093475,Staff,0,0,36,36
1656019343073,MATH 20C,A01,083760,Briones; Jor-el Thomas Caparas,0,2,35,35
1656019343073,MATH 20C,A02,083761,Briones; Jor-el Thomas Caparas,6,1,35,29
1656019343073,MATH 20C,A03,093476,Staff,0,0,35,35
1656019343073,MATH 20C,B01,083762,Bach; Quang Tran,3,0,30,27
1656019349096,MATH 20D,A01,083765,Tran; Brian Kha,2,0,30,28
1656019349096,MATH 20D,A02,083766,Tran; Brian Kha,0,1,30,30
1656019349096,MATH 20D,A03,083767,Tran; Brian Kha,1,0,30,29
1656019355125,MATH 20E,A01,083771,Ganguly; Soumya,0,1,32,32
1656019355125,MATH 20E,A02,083772,Ganguly; Soumya,1,1,32,31
1656019355125,MATH 20E,B01,083773,Ciotti; Benjamin,13,0,35,22
1656019355125,MATH 20E,B02,083774,Ciotti; Benjamin,12,0,35,23
1656019361148,MATH 103A,A01,083777,Greenfeld; Be'Eri,2,1,36,34
1656019361148,MATH 103A,A02,083778,Greenfeld; Be'Eri,1,0,36,35
1656019361148,MATH 103A,A03,093561,Staff,0,1,36,36
1656019361148,MATH 103A,B01,083779,Greenfeld; Be'Eri,8,1,36,28
1656019361148,MATH 103A,B02,083780,Greenfeld; Be'Eri,0,0,36,36
1656019361148,MATH 103A,B03,093562,Staff,0,0,36,36
1656019367172,MATH 105,A01,085443,Carter; Anne Toulson,4,1,35,31
1656019367172,MATH 105,A02,093477,Staff,9,0,35,26
1656019373202,MATH 109,A01,083213,Ganzberger; Geoffrey Michael,0,1,34,34
1656019373202,MATH 109,A02,083214,Ganzberger; Geoffrey Michael,0,0,34,34
1656019373202,MATH 109,A03,093478,Staff,1,0,34,33
1656019373202,MATH 109,B01,083215,Ganzberger; Geoffrey Michael,2,0,32,30
1656019373202,MATH 109,B02,083216,Ganzberger; Geoffrey Michael,0,0,32,32
1656019373202,MATH 109,B03,093479,Staff,3,0,32,29
1656019379227,MATH 142A,A01,083219,Chow; Bennett,1,0,32,31
1656019379227,MATH 142A,A02,083220,Chow; Bennett,7,0,32,25
1656019379227,MATH 142A,A03,093480,Staff,4,0,32,28
1656019379227,MATH 142A,B03,093481,Staff,3,0,32,29
1656019379227,MATH 142A,B04,093558,Staff,6,0,32,26
1656019379227,MATH 142A,B05,093559,Staff,0,0,32,32
1656019385251,MATH 193A,A01,083224,Rotar; Vladimir,1,2,34,33
1656019385251,MATH 193A,A02,083225,Rotar; Vladimir,0,1,34,34
1656019385251,MATH 193A,A03,083781,Rotar; Vladimir,2,0,34,32
1656019385251,MATH 193A,A04,083782,Rotar; Vladimir,3,0,34,31
1656019385251,MATH 193A,A05,093482,Rotar; Vladimir,0,0,34,34
1656019391283,MATH 197,001,091859,McAuley; Julian John,9999,0,9999,0
1656019391283,MATH 197,002,095566,Kedlaya; Kiran S.,9997,0,9999,2
1656019391283,MATH 197,003,095567,Xiao; Ming,9999,0,9999,0
1656019391283,MATH 197,004,095571,Perols; Johan Lars,9998,0,9999,1
1656019398355,COGS 9,A01,083615,Shannon; Kyle Michael,3,1,75,72
1656019404380,COGS 11,A01,083617,Boyle; Mary E. T.,11,1,48,37
1656019410402,COGS 13,A01,083071,Bastos; Amalia Pinkusfeld,4,2,71,67
1656019416425,COGS 14A,A01,092681,Semenuks; Arturs,4,25,100,96
1656019422461,COGS 14B,A01,083073,Cheng; Tzu-Han,7,0,63,56
1656019428488,COGS 17,A01,092677,Semenuks; Arturs,8,7,81,73
1656019434515,COGS 100,A01,083619,Allen; Michael Gordon,2,2,70,68
1656019440543,COGS 101A,A01,083621,Davis; Joshua Daniel,4,3,68,64
1656019446567,COGS 101B,A01,091572,Allen; Michael Gordon,0,0,65,65
1656019452595,COGS 101C,A01,083625,Delgado; Tania,7,0,35,28
1656019458626,COGS 107A,A01,083627,Boyle; Mary E. T.,1,2,60,59
1656019464649,COGS 118A,A01,083075,Gupta; Anjum,21,16,76,55
1656019470678,CSE 3,A50,083646,Miranda; Gregory Joseph,14,0,50,36
1656019476702,CSE 8A,A50,083650,Miranda; Gregory Joseph,4,11,56,52
1656019482727,CSE 11,A01,083080,Cao; Yingjun,0,65,40,40
1656019488752,CSE 12,A01,083652,Krause-Levy; Sophia Louisa,7,8,120,113
1656019494781,CSE 15L,A01,083654,Morris; Justin Loren,3,1,50,47
1656019494781,CSE 15L,A02,083655,Morris; Justin Loren,2,1,50,48
1656019500804,CSE 20,A01,083657,Tran; Khoa Dang,29,0,80,51
1656019506835,CSE 21,A01,095574,Bach; Quang Tran,23,0,48,25
1656019512869,CSE 30,A01,083084,Eldon; John,2,10,80,78
1656019512869,CSE 30,B01,095061,Bhaskar; Nishant,1,4,50,49
1656019518895,CSE 100,A01,083659,Cao; Yingjun,2,25,70,68
1656019524928,CSE 134B,A01,083661,Powell; Thomas Allan,6,6,100,94
1656019530954,CSE 140,A01,083663,Gungor; Onat,5,0,85,80
1656019536979,CSE 140L,A01,083088,Eldon; John,5,0,100,95
1656019543005,CSE 175,A01,083665,Kumar; Rakesh,0,0,25,25
1656019549029,CSE 190,A00,092507,Dubnov; Shlomo,1,0,20,19
1656019555170,ECE 45,A01,083139,Congero; Spencer William,0,1,75,75
1656019561200,ECE 65,A50,083695,Saad; Andrew S,6,0,30,24
1656019561200,ECE 65,A51,095125,Staff,23,0,26,3
1656019567226,ECE 109,A01,091882,Touri; Behrouz,3,5,70,67
1656019573253,ECE 180,A00,083140,Abi Samra; Nicholas Camill,1,0,30,29
1656019573253,ECE 180,B00,083141,Abi Samra; Nicholas Camill,0,8,28,28
1656019579283,MATH 10A,A01,083735,Patchell; Gregory David,0,0,30,30
1656019579283,MATH 10A,A02,083736,Patchell; Gregory David,21,0,30,9
1656019579283,MATH 10A,A03,083737,Patchell; Gregory David,16,0,30,14
1656019585311,MATH 10B,A01,083207,Lim; Seonhee,1,1,34,33
1656019585311,MATH 10B,A02,083208,Lim; Seonhee,1,1,35,34
1656019585311,MATH 10B,A03,093472,Staff,1,0,34,33
1656019585311,MATH 10B,B01,083739,Sinha; Shubham,9,0,30,21
1656019591353,MATH 18,A01,083743,Cinel; Cameron Alexander,5,0,30,25
1656019591353,MATH 18,A02,083744,Cinel; Cameron Alexander,11,0,30,19
1656019591353,MATH 18,A03,083745,Cinel; Cameron Alexander,1,0,30,29
1656019591353,MATH 18,B01,083748,Ma; Zilu,0,0,36,36
1656019591353,MATH 18,B02,083749,Ma; Zilu,0,0,36,36
1656019591353,MATH 18,B03,083750,Ma; Zilu,0,0,36,36
1656019591353,MATH 18,B04,083751,Ma; Zilu,0,0,36,36
1656019591353,MATH 18,B05,093473,Staff,0,0,36,36
1656019591353,MATH 18,B06,093474,Staff,3,0,36,33
1656019597379,MATH 20A,A01,083754,Zheng; Zequn,10,0,40,30
1656019603413,MATH 20B,A01,083756,Briones; Jor-el Thomas Caparas,0,1,36,36
1656019603413,MATH 20B,A02,083757,Briones; Jor-el Thomas Caparas,1,0,36,35
1656019603413,MATH 20B,A03,093475,Staff,0,0,36,36
1656019609436,MATH 20C,A01,083760,Briones; Jor-el Thomas Caparas,0,2,35,35
1656019609436,MATH 20C,A02,083761,Briones; Jor-el Thomas Caparas,6,1,35,29
1656019609436,MATH 20C,A03,093476,Staff,0,0,35,35
1656019609436,MATH 20C,B01,083762,Bach; Quang Tran,3,0,30,27
1656019615457,MATH 20D,A01,083765,Tran; Brian Kha,2,0,30,28
1656019615457,MATH 20D,A02,083766,Tran; Brian Kha,0,1,30,30
1656019615457,MATH 20D,A03,083767,Tran; Brian Kha,1,0,30,29
1656019621486,MATH 20E,A01,083771,Ganguly; Soumya,0,1,32,32
1656019621486,MATH 20E,A02,083772,Ganguly; Soumya,1,1,32,31
1656019621486,MATH 20E,B01,083773,Ciotti; Benjamin,13,0,35,22
1656019621486,MATH 20E,B02,083774,Ciotti; Benjamin,12,0,35,23
1656019627515,MATH 103A,A01,083777,Greenfeld; Be'Eri,2,1,36,34
1656019627515,MATH 103A,A02,083778,Greenfeld; Be'Eri,1,0,36,35
1656019627515,MATH 103A,A03,093561,Staff,0,1,36,36
1656019627515,MATH 103A,B01,083779,Greenfeld; Be'Eri,8,1,36,28
1656019627515,MATH 103A,B02,083780,Greenfeld; Be'Eri,0,0,36,36
1656019627515,MATH 103A,B03,093562,Staff,0,0,36,36
1656019633542,MATH 105,A01,085443,Carter; Anne Toulson,4,1,35,31
1656019633542,MATH 105,A02,093477,Staff,9,0,35,26
1656019639574,MATH 109,A01,083213,Ganzberger; Geoffrey Michael,0,1,34,34
1656019639574,MATH 109,A02,083214,Ganzberger; Geoffrey Michael,0,0,34,34
1656019639574,MATH 109,A03,093478,Staff,1,0,34,33
1656019639574,MATH 109,B01,083215,Ganzberger; Geoffrey Michael,2,0,32,30
1656019639574,MATH 109,B02,083216,Ganzberger; Geoffrey Michael,0,0,32,32
1656019639574,MATH 109,B03,093479,Staff,3,0,32,29
1656019645607,MATH 142A,A01,083219,Chow; Bennett,1,0,32,31
1656019645607,MATH 142A,A02,083220,Chow; Bennett,7,0,32,25
1656019645607,MATH 142A,A03,093480,Staff,4,0,32,28
1656019645607,MATH 142A,B03,093481,Staff,3,0,32,29
1656019645607,MATH 142A,B04,093558,Staff,6,0,32,26
1656019645607,MATH 142A,B05,093559,Staff,0,0,32,32
1656019651642,MATH 193A,A01,083224,Rotar; Vladimir,1,2,34,33
1656019651642,MATH 193A,A02,083225,Rotar; Vladimir,0,1,34,34
1656019651642,MATH 193A,A03,083781,Rotar; Vladimir,2,0,34,32
1656019651642,MATH 193A,A04,083782,Rotar; Vladimir,3,0,34,31
1656019651642,MATH 193A,A05,093482,Rotar; Vladimir,0,0,34,34
1656019657664,MATH 197,001,091859,McAuley; Julian John,9999,0,9999,0
1656019657664,MATH 197,002,095566,Kedlaya; Kiran S.,9997,0,9999,2
1656019657664,MATH 197,003,095567,Xiao; Ming,9999,0,9999,0
1656019657664,MATH 197,004,095571,Perols; Johan Lars,9998,0,9999,1
1656019664718,COGS 9,A01,083615,Shannon; Kyle Michael,3,1,75,72
1656019670744,COGS 11,A01,083617,Boyle; Mary E. T.,11,1,48,37
1656019676782,COGS 13,A01,083071,Bastos; Amalia Pinkusfeld,4,2,71,67
1656019682805,COGS 14A,A01,092681,Semenuks; Arturs,4,25,100,96
1656019688829,COGS 14B,A01,083073,Cheng; Tzu-Han,7,0,63,56
1656019694851,COGS 17,A01,092677,Semenuks; Arturs,8,7,81,73
1656019700875,COGS 100,A01,083619,Allen; Michael Gordon,2,2,70,68
1656019706903,COGS 101A,A01,083621,Davis; Joshua Daniel,4,3,68,64
1656019712949,COGS 101B,A01,091572,Allen; Michael Gordon,0,0,65,65
1656019718978,COGS 101C,A01,083625,Delgado; Tania,7,0,35,28
1656019725004,COGS 107A,A01,083627,Boyle; Mary E. T.,1,2,60,59
1656019731032,COGS 118A,A01,083075,Gupta; Anjum,21,16,76,55
1656019737065,CSE 3,A50,083646,Miranda; Gregory Joseph,14,0,50,36
1656019743090,CSE 8A,A50,083650,Miranda; Gregory Joseph,4,11,56,52
1656019749115,CSE 11,A01,083080,Cao; Yingjun,0,65,40,40
1656019755138,CSE 12,A01,083652,Krause-Levy; Sophia Louisa,7,8,120,113
1656019761162,CSE 15L,A01,083654,Morris; Justin Loren,3,1,50,47
1656019761162,CSE 15L,A02,083655,Morris; Justin Loren,2,1,50,48
1656019767201,CSE 20,A01,083657,Tran; Khoa Dang,29,0,80,51
1656019773229,CSE 21,A01,095574,Bach; Quang Tran,23,0,48,25
1656019779257,CSE 30,A01,083084,Eldon; John,2,10,80,78
1656019779257,CSE 30,B01,095061,Bhaskar; Nishant,1,4,50,49
1656019785280,CSE 100,A01,083659,Cao; Yingjun,2,25,70,68
1656019791302,CSE 134B,A01,083661,Powell; Thomas Allan,6,6,100,94
1656019797326,CSE 140,A01,083663,Gungor; Onat,5,0,85,80
1656019803353,CSE 140L,A01,083088,Eldon; John,5,0,100,95
1656019809380,CSE 175,A01,083665,Kumar; Rakesh,0,0,25,25
1656019815404,CSE 190,A00,092507,Dubnov; Shlomo,1,0,20,19
1656019821436,ECE 45,A01,083139,Congero; Spencer William,0,1,75,75
1656019827467,ECE 65,A50,083695,Saad; Andrew S,6,0,30,24
1656019827467,ECE 65,A51,095125,Staff,23,0,26,3
1656019833502,ECE 109,A01,091882,Touri; Behrouz,3,5,70,67
1656019839537,ECE 180,A00,083140,Abi Samra; Nicholas Camill,1,0,30,29
1656019839537,ECE 180,B00,083141,Abi Samra; Nicholas Camill,0,8,28,28
1656019845562,MATH 10A,A01,083735,Patchell; Gregory David,0,0,30,30
1656019845562,MATH 10A,A02,083736,Patchell; Gregory David,21,0,30,9
1656019845562,MATH 10A,A03,083737,Patchell; Gregory David,16,0,30,14
1656019851590,MATH 10B,A01,083207,Lim; Seonhee,1,1,34,33
1656019851590,MATH 10B,A02,083208,Lim; Seonhee,1,1,35,34
1656019851590,MATH 10B,A03,093472,Staff,1,0,34,33
1656019851590,MATH 10B,B01,083739,Sinha; Shubham,9,0,30,21
1656019857621,MATH 18,A01,083743,Cinel; Cameron Alexander,5,0,30,25
1656019857621,MATH 18,A02,083744,Cinel; Cameron Alexander,11,0,30,19
1656019857621,MATH 18,A03,083745,Cinel; Cameron Alexander,1,0,30,29
1656019857621,MATH 18,B01,083748,Ma; Zilu,0,0,36,36
1656019857621,MATH 18,B02,083749,Ma; Zilu,0,0,36,36
1656019857621,MATH 18,B03,083750,Ma; Zilu,0,0,36,36
1656019857621,MATH 18,B04,083751,Ma; Zilu,0,0,36,36
1656019857621,MATH 18,B05,093473,Staff,0,0,36,36
1656019857621,MATH 18,B06,093474,Staff,3,0,36,33
1656019863644,MATH 20A,A01,083754,Zheng; Zequn,10,0,40,30
1656019869666,MATH 20B,A01,083756,Briones; Jor-el Thomas Caparas,0,1,36,36
1656019869666,MATH 20B,A02,083757,Briones; Jor-el Thomas Caparas,1,0,36,35
1656019869666,MATH 20B,A03,093475,Staff,0,0,36,36
1656019875690,MATH 20C,A01,083760,Briones; Jor-el Thomas Caparas,0,2,35,35
1656019875690,MATH 20C,A02,083761,Briones; Jor-el Thomas Caparas,6,1,35,29
1656019875690,MATH 20C,A03,093476,Staff,0,0,35,35
1656019875690,MATH 20C,B01,083762,Bach; Quang Tran,3,0,30,27
1656019881721,MATH 20D,A01,083765,Tran; Brian Kha,2,0,30,28
1656019881721,MATH 20D,A02,083766,Tran; Brian Kha,0,1,30,30
1656019881721,MATH 20D,A03,083767,Tran; Brian Kha,1,0,30,29
1656019887755,MATH 20E,A01,083771,Ganguly; Soumya,0,1,32,32
1656019887755,MATH 20E,A02,083772,Ganguly; Soumya,1,1,32,31
1656019887755,MATH 20E,B01,083773,Ciotti; Benjamin,13,0,35,22
1656019887755,MATH 20E,B02,083774,Ciotti; Benjamin,12,0,35,23
1656019893779,MATH 103A,A01,083777,Greenfeld; Be'Eri,2,1,36,34
1656019893779,MATH 103A,A02,083778,Greenfeld; Be'Eri,1,0,36,35
1656019893779,MATH 103A,A03,093561,Staff,0,1,36,36
1656019893779,MATH 103A,B01,083779,Greenfeld; Be'Eri,8,1,36,28
1656019893779,MATH 103A,B02,083780,Greenfeld; Be'Eri,0,0,36,36
1656019893779,MATH 103A,B03,093562,Staff,0,0,36,36
1656019899815,MATH 105,A01,085443,Carter; Anne Toulson,4,1,35,31
1656019899815,MATH 105,A02,093477,Staff,9,0,35,26
1656019905839,MATH 109,A01,083213,Ganzberger; Geoffrey Michael,0,1,34,34
1656019905839,MATH 109,A02,083214,Ganzberger; Geoffrey Michael,0,0,34,34
1656019905839,MATH 109,A03,093478,Staff,1,0,34,33
1656019905839,MATH 109,B01,083215,Ganzberger; Geoffrey Michael,2,0,32,30
1656019905839,MATH 109,B02,083216,Ganzberger; Geoffrey Michael,0,0,32,32
1656019905839,MATH 109,B03,093479,Staff,3,0,32,29
1656019911867,MATH 142A,A01,083219,Chow; Bennett,1,0,32,31
1656019911867,MATH 142A,A02,083220,Chow; Bennett,7,0,32,25
1656019911867,MATH 142A,A03,093480,Staff,4,0,32,28
1656019911867,MATH 142A,B03,093481,Staff,3,0,32,29
1656019911867,MATH 142A,B04,093558,Staff,6,0,32,26
1656019911867,MATH 142A,B05,093559,Staff,0,0,32,32
1656019917897,MATH 193A,A01,083224,Rotar; Vladimir,1,2,34,33
1656019917897,MATH 193A,A02,083225,Rotar; Vladimir,0,1,34,34
1656019917897,MATH 193A,A03,083781,Rotar; Vladimir,2,0,34,32
1656019917897,MATH 193A,A04,083782,Rotar; Vladimir,3,0,34,31
1656019917897,MATH 193A,A05,093482,Rotar; Vladimir,0,0,34,34
1656019923920,MATH 197,001,091859,McAuley; Julian John,9999,0,9999,0
1656019923920,MATH 197,002,095566,Kedlaya; Kiran S.,9997,0,9999,2
1656019923920,MATH 197,003,095567,Xiao; Ming,9999,0,9999,0
1656019923920,MATH 197,004,095571,Perols; Johan Lars,9998,0,9999,1
1656019930981,COGS 9,A01,083615,Shannon; Kyle Michael,3,1,75,72
1656019937004,COGS 11,A01,083617,Boyle; Mary E. T.,11,1,48,37
1656019943030,COGS 13,A01,083071,Bastos; Amalia Pinkusfeld,4,2,71,67
1656019949056,COGS 14A,A01,092681,Semenuks; Arturs,4,25,100,96
1656019955086,COGS 14B,A01,083073,Cheng; Tzu-Han,7,0,63,56
1656019961127,COGS 17,A01,092677,Semenuks; Arturs,8,7,81,73
1656019967150,COGS 100,A01,083619,Allen; Michael Gordon,2,2,70,68
1656019973173,COGS 101A,A01,083621,Davis; Joshua Daniel,4,3,68,64
1656019979202,COGS 101B,A01,091572,Allen; Michael Gordon,0,0,65,65
1656019985231,COGS 101C,A01,083625,Delgado; Tania,7,0,35,28
1656019991254,COGS 107A,A01,083627,Boyle; Mary E. T.,1,2,60,59
1656019997277,COGS 118A,A01,083075,Gupta; Anjum,21,16,76,55
1656020003310,CSE 3,A50,083646,Miranda; Gregory Joseph,14,0,50,36
1656020009372,CSE 8A,A50,083650,Miranda; Gregory Joseph,4,11,56,52
1656020015396,CSE 11,A01,083080,Cao; Yingjun,0,65,40,40
1656020021432,CSE 12,A01,083652,Krause-Levy; Sophia Louisa,7,8,120,113
1656020027461,CSE 15L,A01,083654,Morris; Justin Loren,3,1,50,47
1656020027461,CSE 15L,A02,083655,Morris; Justin Loren,2,1,50,48
1656020033500,CSE 20,A01,083657,Tran; Khoa Dang,29,0,80,51
1656020039523,CSE 21,A01,095574,Bach; Quang Tran,23,0,48,25
1656020045546,CSE 30,A01,083084,Eldon; John,2,10,80,78
1656020045546,CSE 30,B01,095061,Bhaskar; Nishant,1,4,50,49
1656020051569,CSE 100,A01,083659,Cao; Yingjun,2,25,70,68
1656020057593,CSE 134B,A01,083661,Powell; Thomas Allan,6,6,100,94
1656020063620,CSE 140,A01,083663,Gungor; Onat,5,0,85,80
1656020069654,CSE 140L,A01,083088,Eldon; John,5,0,100,95
1656020075695,CSE 175,A01,083665,Kumar; Rakesh,0,0,25,25
1656020081721,CSE 190,A00,092507,Dubnov; Shlomo,1,0,20,19
1656020087753,ECE 45,A01,083139,Congero; Spencer William,0,1,75,75
1656020093776,ECE 65,A50,083695,Saad; Andrew S,6,0,30,24
1656020093776,ECE 65,A51,095125,Staff,23,0,26,3
1656020099813,ECE 109,A01,091882,Touri; Behrouz,3,5,70,67
1656020105835,ECE 180,A00,083140,Abi Samra; Nicholas Camill,1,0,30,29
1656020105835,ECE 180,B00,083141,Abi Samra; Nicholas Camill,0,8,28,28
1656020111863,MATH 10A,A01,083735,Patchell; Gregory David,0,0,30,30
1656020111863,MATH 10A,A02,083736,Patchell; Gregory David,21,0,30,9
1656020111863,MATH 10A,A03,083737,Patchell; Gregory David,16,0,30,14
1656020117889,MATH 10B,A01,083207,Lim; Seonhee,1,1,34,33
1656020117889,MATH 10B,A02,083208,Lim; Seonhee,1,1,35,34
1656020117889,MATH 10B,A03,093472,Staff,1,0,34,33
1656020117889,MATH 10B,B01,083739,Sinha; Shubham,9,0,30,21
1656020123920,MATH 18,A01,083743,Cinel; Cameron Alexander,5,0,30,25
1656020123920,MATH 18,A02,083744,Cinel; Cameron Alexander,11,0,30,19
1656020123920,MATH 18,A03,083745,Cinel; Cameron Alexander,1,0,30,29
1656020123920,MATH 18,B01,083748,Ma; Zilu,0,0,36,36
1656020123920,MATH 18,B02,083749,Ma; Zilu,0,0,36,36
1656020123920,MATH 18,B03,083750,Ma; Zilu,0,0,36,36
1656020123920,MATH 18,B04,083751,Ma; Zilu,0,0,36,36
1656020123920,MATH 18,B05,093473,Staff,0,0,36,36
1656020123920,MATH 18,B06,093474,Staff,3,0,36,33
1656020129943,MATH 20A,A01,083754,Zheng; Zequn,10,0,40,30
1656020135976,MATH 20B,A01,083756,Briones; Jor-el Thomas Caparas,0,1,36,36
1656020135976,MATH 20B,A02,083757,Briones; Jor-el Thomas Caparas,1,0,36,35
1656020135976,MATH 20B,A03,093475,Staff,0,0,36,36
1656020142000,MATH 20C,A01,083760,Briones; Jor-el Thomas Caparas,0,2,35,35
1656020142000,MATH 20C,A02,083761,Briones; Jor-el Thomas Caparas,6,1,35,29
1656020142000,MATH 20C,A03,093476,Staff,0,0,35,35
1656020142000,MATH 20C,B01,083762,Bach; Quang Tran,3,0,30,27
1656020148031,MATH 20D,A01,083765,Tran; Brian Kha,2,0,30,28
1656020148031,MATH 20D,A02,083766,Tran; Brian Kha,0,1,30,30
1656020148031,MATH 20D,A03,083767,Tran; Brian Kha,1,0,30,29
1656020154134,MATH 20E,A01,083771,Ganguly; Soumya,0,1,32,32
1656020154134,MATH 20E,A02,083772,Ganguly; Soumya,1,1,32,31
1656020154134,MATH 20E,B01,083773,Ciotti; Benjamin,13,0,35,22
1656020154134,MATH 20E,B02,083774,Ciotti; Benjamin,12,0,35,23
1656020160158,MATH 103A,A01,083777,Greenfeld; Be'Eri,2,1,36,34
1656020160158,MATH 103A,A02,083778,Greenfeld; Be'Eri,1,0,36,35
1656020160158,MATH 103A,A03,093561,Staff,0,1,36,36
1656020160158,MATH 103A,B01,083779,Greenfeld; Be'Eri,8,1,36,28
1656020160158,MATH 103A,B02,083780,Greenfeld; Be'Eri,0,0,36,36
1656020160158,MATH 103A,B03,093562,Staff,0,0,36,36
1656020166182,MATH 105,A01,085443,Carter; Anne Toulson,4,1,35,31
1656020166182,MATH 105,A02,093477,Staff,9,0,35,26
1656020172207,MATH 109,A01,083213,Ganzberger; Geoffrey Michael,0,1,34,34
1656020172207,MATH 109,A02,083214,Ganzberger; Geoffrey Michael,0,0,34,34
1656020172207,MATH 109,A03,093478,Staff,1,0,34,33
1656020172207,MATH 109,B01,083215,Ganzberger; Geoffrey Michael,2,0,32,30
1656020172207,MATH 109,B02,083216,Ganzberger; Geoffrey Michael,0,0,32,32
1656020172207,MATH 109,B03,093479,Staff,3,0,32,29
1656020178238,MATH 142A,A01,083219,Chow; Bennett,1,0,32,31
1656020178238,MATH 142A,A02,083220,Chow; Bennett,7,0,32,25
1656020178238,MATH 142A,A03,093480,Staff,4,0,32,28
1656020178238,MATH 142A,B03,093481,Staff,3,0,32,29
1656020178238,MATH 142A,B04,093558,Staff,6,0,32,26
1656020178238,MATH 142A,B05,093559,Staff,0,0,32,32
1656020184261,MATH 193A,A01,083224,Rotar; Vladimir,1,2,34,33
1656020184261,MATH 193A,A02,083225,Rotar; Vladimir,0,1,34,34
1656020184261,MATH 193A,A03,083781,Rotar; Vladimir,2,0,34,32
1656020184261,MATH 193A,A04,083782,Rotar; Vladimir,3,0,34,31
1656020184261,MATH 193A,A05,093482,Rotar; Vladimir,0,0,34,34
1656020190284,MATH 197,001,091859,McAuley; Julian John,9999,0,9999,0
1656020190284,MATH 197,002,095566,Kedlaya; Kiran S.,9997,0,9999,2
1656020190284,MATH 197,003,095567,Xiao; Ming,9999,0,9999,0
1656020190284,MATH 197,004,095571,Perols; Johan Lars,9998,0,9999,1
1656020197349,COGS 9,A01,083615,Shannon; Kyle Michael,3,1,75,72
1656020203373,COGS 11,A01,083617,Boyle; Mary E. T.,11,1,48,37
1656020209399,COGS 13,A01,083071,Bastos; Amalia Pinkusfeld,4,2,71,67
1656020215421,COGS 14A,A01,092681,Semenuks; Arturs,4,25,100,96
1656020221449,COGS 14B,A01,083073,Cheng; Tzu-Han,7,0,63,56
1656020227474,COGS 17,A01,092677,Semenuks; Arturs,8,7,81,73
1656020233502,COGS 100,A01,083619,Allen; Michael Gordon,2,2,70,68
1656020239527,COGS 101A,A01,083621,Davis; Joshua Daniel,4,3,68,64
1656020245563,COGS 101B,A01,091572,Allen; Michael Gordon,0,0,65,65
1656020251586,COGS 101C,A01,083625,Delgado; Tania,7,0,35,28
1656020257613,COGS 107A,A01,083627,Boyle; Mary E. T.,1,2,60,59
1656020263637,COGS 118A,A01,083075,Gupta; Anjum,21,16,76,55
1656020269669,CSE 3,A50,083646,Miranda; Gregory Joseph,14,0,50,36
1656020275698,CSE 8A,A50,083650,Miranda; Gregory Joseph,4,11,56,52
1656020281724,CSE 11,A01,083080,Cao; Yingjun,0,65,40,40
1656020287751,CSE 12,A01,083652,Krause-Levy; Sophia Louisa,7,8,120,113
1656020293784,CSE 15L,A01,083654,Morris; Justin Loren,3,1,50,47
1656020293784,CSE 15L,A02,083655,Morris; Justin Loren,2,1,50,48
1656020299810,CSE 20,A01,083657,Tran; Khoa Dang,29,0,80,51
1656020305834,CSE 21,A01,095574,Bach; Quang Tran,23,0,48,25
1656020311858,CSE 30,A01,083084,Eldon; John,2,10,80,78
1656020311858,CSE 30,B01,095061,Bhaskar; Nishant,1,4,50,49
1656020317882,CSE 100,A01,083659,Cao; Yingjun,2,25,70,68
1656020323906,CSE 134B,A01,083661,Powell; Thomas Allan,6,6,100,94
1656020329932,CSE 140,A01,083663,Gungor; Onat,5,0,85,80
1656020335961,CSE 140L,A01,083088,Eldon; John,5,0,100,95
1656020341992,CSE 175,A01,083665,Kumar; Rakesh,0,0,25,25
1656020348020,CSE 190,A00,092507,Dubnov; Shlomo,1,0,20,19
1656020354044,ECE 45,A01,083139,Congero; Spencer William,0,1,75,75
1656020360079,ECE 65,A50,083695,Saad; Andrew S,6,0,30,24
1656020360079,ECE 65,A51,095125,Staff,23,0,26,3
1656020366110,ECE 109,A01,091882,Touri; Behrouz,3,5,70,67
1656020372135,ECE 180,A00,083140,Abi Samra; Nicholas Camill,1,0,30,29
1656020372135,ECE 180,B00,083141,Abi Samra; Nicholas Camill,0,8,28,28
1656020378161,MATH 10A,A01,083735,Patchell; Gregory David,0,0,30,30
1656020378161,MATH 10A,A02,083736,Patchell; Gregory David,21,0,30,9
1656020378161,MATH 10A,A03,083737,Patchell; Gregory David,16,0,30,14
1656020384186,MATH 10B,A01,083207,Lim; Seonhee,1,1,34,33
1656020384186,MATH 10B,A02,083208,Lim; Seonhee,1,1,35,34
1656020384186,MATH 10B,A03,093472,Staff,1,0,34,33
1656020384186,MATH 10B,B01,083739,Sinha; Shubham,9,0,30,21
1656020390217,MATH 18,A01,083743,Cinel; Cameron Alexander,5,0,30,25
1656020390217,MATH 18,A02,083744,Cinel; Cameron Alexander,11,0,30,19
1656020390217,MATH 18,A03,083745,Cinel; Cameron Alexander,1,0,30,29
1656020390217,MATH 18,B01,083748,Ma; Zilu,0,0,36,36
1656020390217,MATH 18,B02,083749,Ma; Zilu,0,0,36,36
1656020390217,MATH 18,B03,083750,Ma; Zilu,0,0,36,36
1656020390217,MATH 18,B04,083751,Ma; Zilu,0,0,36,36
1656020390217,MATH 18,B05,093473,Staff,0,0,36,36
1656020390217,MATH 18,B06,093474,Staff,3,0,36,33
1656020396242,MATH 20A,A01,083754,Zheng; Zequn,10,0,40,30
1656020402265,MATH 20B,A01,083756,Briones; Jor-el Thomas Caparas,0,1,36,36
1656020402265,MATH 20B,A02,083757,Briones; Jor-el Thomas Caparas,1,0,36,35
1656020402265,MATH 20B,A03,093475,Staff,0,0,36,36
1656020408289,MATH 20C,A01,083760,Briones; Jor-el Thomas Caparas,0,2,35,35
1656020408289,MATH 20C,A02,083761,Briones; Jor-el Thomas Caparas,6,1,35,29
1656020408289,MATH 20C,A03,093476,Staff,0,0,35,35
1656020408289,MATH 20C,B01,083762,Bach; Quang Tran,3,0,30,27
1656020414315,MATH 20D,A01,083765,Tran; Brian Kha,2,0,30,28
1656020414315,MATH 20D,A02,083766,Tran; Brian Kha,0,1,30,30
1656020414315,MATH 20D,A03,083767,Tran; Brian Kha,1,0,30,29
1656020420350,MATH 20E,A01,083771,Ganguly; Soumya,0,1,32,32
1656020420350,MATH 20E,A02,083772,Ganguly; Soumya,1,1,32,31
1656020420350,MATH 20E,B01,083773,Ciotti; Benjamin,13,0,35,22
1656020420350,MATH 20E,B02,083774,Ciotti; Benjamin,12,0,35,23
1656020426380,MATH 103A,A01,083777,Greenfeld; Be'Eri,2,1,36,34
1656020426380,MATH 103A,A02,083778,Greenfeld; Be'Eri,1,0,36,35
1656020426380,MATH 103A,A03,093561,Staff,0,1,36,36
1656020426380,MATH 103A,B01,083779,Greenfeld; Be'Eri,8,1,36,28
1656020426380,MATH 103A,B02,083780,Greenfeld; Be'Eri,0,0,36,36
1656020426380,MATH 103A,B03,093562,Staff,0,0,36,36
1656020432409,MATH 105,A01,085443,Carter; Anne Toulson,4,1,35,31
1656020432409,MATH 105,A02,093477,Staff,9,0,35,26
1656020438443,MATH 109,A01,083213,Ganzberger; Geoffrey Michael,0,1,34,34
1656020438443,MATH 109,A02,083214,Ganzberger; Geoffrey Michael,0,0,34,34
1656020438443,MATH 109,A03,093478,Staff,1,0,34,33
1656020438443,MATH 109,B01,083215,Ganzberger; Geoffrey Michael,2,0,32,30
1656020438443,MATH 109,B02,083216,Ganzberger; Geoffrey Michael,0,0,32,32
1656020438443,MATH 109,B03,093479,Staff,3,0,32,29
1656020444467,MATH 142A,A01,083219,Chow; Bennett,1,0,32,31
1656020444467,MATH 142A,A02,083220,Chow; Bennett,7,0,32,25
1656020444467,MATH 142A,A03,093480,Staff,4,0,32,28
1656020444467,MATH 142A,B03,093481,Staff,3,0,32,29
1656020444467,MATH 142A,B04,093558,Staff,6,0,32,26
1656020444467,MATH 142A,B05,093559,Staff,0,0,32,32
1656020450494,MATH 193A,A01,083224,Rotar; Vladimir,1,2,34,33
1656020450494,MATH 193A,A02,083225,Rotar; Vladimir,0,1,34,34
1656020450494,MATH 193A,A03,083781,Rotar; Vladimir,2,0,34,32
1656020450494,MATH 193A,A04,083782,Rotar; Vladimir,3,0,34,31
1656020450494,MATH 193A,A05,093482,Rotar; Vladimir,0,0,34,34
1656020456517,MATH 197,001,091859,McAuley; Julian John,9999,0,9999,0
1656020456517,MATH 197,002,095566,Kedlaya; Kiran S.,9997,0,9999,2
1656020456517,MATH 197,003,095567,Xiao; Ming,9999,0,9999,0
1656020456517,MATH 197,004,095571,Perols; Johan Lars,9998,0,9999,1
1656020463588,COGS 9,A01,083615,Shannon; Kyle Michael,3,1,75,72
1656020469624,COGS 11,A01,083617,Boyle; Mary E. T.,11,1,48,37
1656020475651,COGS 13,A01,083071,Bastos; Amalia Pinkusfeld,4,2,71,67
1656020481675,COGS 14A,A01,092681,Semenuks; Arturs,4,25,100,96
1656020487698,COGS 14B,A01,083073,Cheng; Tzu-Han,7,0,63,56
1656020493728,COGS 17,A01,092677,Semenuks; Arturs,8,7,81,73
1656020499756,COGS 100,A01,083619,Allen; Michael Gordon,2,2,70,68
1656020505783,COGS 101A,A01,083621,Davis; Joshua Daniel,4,3,68,64
1656020511806,COGS 101B,A01,091572,Allen; Michael Gordon,0,0,65,65
1656020517834,COGS 101C,A01,083625,Delgado; Tania,7,0,35,28
1656020523859,COGS 107A,A01,083627,Boyle; Mary E. T.,1,2,60,59
1656020529884,COGS 118A,A01,083075,Gupta; Anjum,21,16,76,55
1656020535907,CSE 3,A50,083646,Miranda; Gregory Joseph,14,0,50,36
1656020541930,CSE 8A,A50,083650,Miranda; Gregory Joseph,4,11,56,52
1656020547963,CSE 11,A01,083080,Cao; Yingjun,0,65,40,40
1656020553986,CSE 12,A01,083652,Krause-Levy; Sophia Louisa,7,8,120,113
1656020560011,CSE 15L,A01,083654,Morris; Justin Loren,3,1,50,47
1656020560011,CSE 15L,A02,083655,Morris; Justin Loren,2,1,50,48
1656020566034,CSE 20,A01,083657,Tran; Khoa Dang,29,0,80,51
1656020572061,CSE 21,A01,095574,Bach; Quang Tran,23,0,48,25
1656020578089,CSE 30,A01,083084,Eldon; John,2,10,80,78
1656020578089,CSE 30,B01,095061,Bhaskar; Nishant,1,4,50,49
1656020584112,CSE 100,A01,083659,Cao; Yingjun,2,25,70,68
1656020590138,CSE 134B,A01,083661,Powell; Thomas Allan,6,6,100,94
1656020596164,CSE 140,A01,083663,Gungor; Onat,5,0,85,80
1656020602190,CSE 140L,A01,083088,Eldon; John,5,0,100,95
1656020608214,CSE 175,A01,083665,Kumar; Rakesh,0,0,25,25
1656020614237,CSE 190,A00,092507,Dubnov; Shlomo,1,0,20,19
1656020620261,ECE 45,A01,083139,Congero; Spencer William,0,1,75,75
1656020626288,ECE 65,A50,083695,Saad; Andrew S,6,0,30,24
1656020626288,ECE 65,A51,095125,Staff,23,0,26,3
1656020632319,ECE 109,A01,091882,Touri; Behrouz,3,5,70,67
1656020638348,ECE 180,A00,083140,Abi Samra; Nicholas Camill,1,0,30,29
1656020638348,ECE 180,B00,083141,Abi Samra; Nicholas Camill,0,8,28,28
1656020644378,MATH 10A,A01,083735,Patchell; Gregory David,0,0,30,30
1656020644378,MATH 10A,A02,083736,Patchell; Gregory David,21,0,30,9
1656020644378,MATH 10A,A03,083737,Patchell; Gregory David,16,0,30,14
1656020650400,MATH 10B,A01,083207,Lim; Seonhee,1,1,34,33
1656020650400,MATH 10B,A02,083208,Lim; Seonhee,1,1,35,34
1656020650400,MATH 10B,A03,093472,Staff,1,0,34,33
1656020650400,MATH 10B,B01,083739,Sinha; Shubham,9,0,30,21
1656020656429,MATH 18,A01,083743,Cinel; Cameron Alexander,5,0,30,25
1656020656429,MATH 18,A02,083744,Cinel; Cameron Alexander,11,0,30,19
1656020656429,MATH 18,A03,083745,Cinel; Cameron Alexander,1,0,30,29
1656020656429,MATH 18,B01,083748,Ma; Zilu,0,0,36,36
1656020656429,MATH 18,B02,083749,Ma; Zilu,0,0,36,36
1656020656429,MATH 18,B03,083750,Ma; Zilu,0,0,36,36
1656020656429,MATH 18,B04,083751,Ma; Zilu,0,0,36,36
1656020656429,MATH 18,B05,093473,Staff,0,0,36,36
1656020656429,MATH 18,B06,093474,Staff,3,0,36,33
1656020662450,MATH 20A,A01,083754,Zheng; Zequn,10,0,40,30
1656020668474,MATH 20B,A01,083756,Briones; Jor-el Thomas Caparas,0,1,36,36
1656020668474,MATH 20B,A02,083757,Briones; Jor-el Thomas Caparas,1,0,36,35
1656020668474,MATH 20B,A03,093475,Staff,0,0,36,36
1656020674497,MATH 20C,A01,083760,Briones; Jor-el Thomas Caparas,0,2,35,35
1656020674497,MATH 20C,A02,083761,Briones; Jor-el Thomas Caparas,6,1,35,29
1656020674497,MATH 20C,A03,093476,Staff,0,0,35,35
1656020674497,MATH 20C,B01,083762,Bach; Quang Tran,3,0,30,27
1656020680522,MATH 20D,A01,083765,Tran; Brian Kha,2,0,30,28
1656020680522,MATH 20D,A02,083766,Tran; Brian Kha,0,1,30,30
1656020680522,MATH 20D,A03,083767,Tran; Brian Kha,1,0,30,29
1656020686544,MATH 20E,A01,083771,Ganguly; Soumya,0,1,32,32
1656020686544,MATH 20E,A02,083772,Ganguly; Soumya,1,1,32,31
1656020686544,MATH 20E,B01,083773,Ciotti; Benjamin,13,0,35,22
1656020686544,MATH 20E,B02,083774,Ciotti; Benjamin,12,0,35,23
1656020692575,MATH 103A,A01,083777,Greenfeld; Be'Eri,2,1,36,34
1656020692575,MATH 103A,A02,083778,Greenfeld; Be'Eri,1,0,36,35
1656020692575,MATH 103A,A03,093561,Staff,0,1,36,36
1656020692575,MATH 103A,B01,083779,Greenfeld; Be'Eri,8,1,36,28
1656020692575,MATH 103A,B02,083780,Greenfeld; Be'Eri,0,0,36,36
1656020692575,MATH 103A,B03,093562,Staff,0,0,36,36
1656020698602,MATH 105,A01,085443,Carter; Anne Toulson,4,1,35,31
1656020698602,MATH 105,A02,093477,Staff,9,0,35,26
1656020704626,MATH 109,A01,083213,Ganzberger; Geoffrey Michael,0,1,34,34
1656020704626,MATH 109,A02,083214,Ganzberger; Geoffrey Michael,0,0,34,34
1656020704626,MATH 109,A03,093478,Staff,1,0,34,33
1656020704626,MATH 109,B01,083215,Ganzberger; Geoffrey Michael,2,0,32,30
1656020704626,MATH 109,B02,083216,Ganzberger; Geoffrey Michael,0,0,32,32
1656020704626,MATH 109,B03,093479,Staff,3,0,32,29
1656020710656,MATH 142A,A01,083219,Chow; Bennett,1,0,32,31
1656020710656,MATH 142A,A02,083220,Chow; Bennett,7,0,32,25
1656020710656,MATH 142A,A03,093480,Staff,4,0,32,28
1656020710656,MATH 142A,B03,093481,Staff,3,0,32,29
1656020710656,MATH 142A,B04,093558,Staff,6,0,32,26
1656020710656,MATH 142A,B05,093559,Staff,0,0,32,32
1656020716686,MATH 193A,A01,083224,Rotar; Vladimir,1,2,34,33
1656020716686,MATH 193A,A02,083225,Rotar; Vladimir,0,1,34,34
1656020716686,MATH 193A,A03,083781,Rotar; Vladimir,2,0,34,32
1656020716686,MATH 193A,A04,083782,Rotar; Vladimir,3,0,34,31
1656020716686,MATH 193A,A05,093482,Rotar; Vladimir,0,0,34,34
1656020722710,MATH 197,001,091859,McAuley; Julian John,9999,0,9999,0
1656020722710,MATH 197,002,095566,Kedlaya; Kiran S.,9997,0,9999,2
1656020722710,MATH 197,003,095567,Xiao; Ming,9999,0,9999,0
1656020722710,MATH 197,004,095571,Perols; Johan Lars,9998,0,9999,1
1656020729761,COGS 9,A01,083615,Shannon; Kyle Michael,3,1,75,72
1656020735786,COGS 11,A01,083617,Boyle; Mary E. T.,11,1,48,37
1656020741810,COGS 13,A01,083071,Bastos; Amalia Pinkusfeld,4,2,71,67
1656020747909,COGS 14A,A01,092681,Semenuks; Arturs,4,25,100,96
1656020753938,COGS 14B,A01,083073,Cheng; Tzu-Han,7,0,63,56
1656020759974,COGS 17,A01,092677,Semenuks; Arturs,8,7,81,73
1656020765998,COGS 100,A01,083619,Allen; Michael Gordon,2,2,70,68
1656020772022,COGS 101A,A01,083621,Davis; Joshua Daniel,4,3,68,64
1656020778052,COGS 101B,A01,091572,Allen; Michael Gordon,0,0,65,65
1656020784080,COGS 101C,A01,083625,Delgado; Tania,7,0,35,28
1656020790103,COGS 107A,A01,083627,Boyle; Mary E. T.,1,2,60,59
1656020796130,COGS 118A,A01,083075,Gupta; Anjum,21,16,76,55
1656020802158,CSE 3,A50,083646,Miranda; Gregory Joseph,14,0,50,36
1656020808181,CSE 8A,A50,083650,Miranda; Gregory Joseph,4,11,56,52
1656020814209,CSE 11,A01,083080,Cao; Yingjun,0,65,40,40
1656020820234,CSE 12,A01,083652,Krause-Levy; Sophia Louisa,7,8,120,113
1656020826260,CSE 15L,A01,083654,Morris; Justin Loren,3,1,50,47
1656020826260,CSE 15L,A02,083655,Morris; Justin Loren,2,1,50,48
1656020832290,CSE 20,A01,083657,Tran; Khoa Dang,29,0,80,51
1656020838318,CSE 21,A01,095574,Bach; Quang Tran,23,0,48,25
1656020844350,CSE 30,A01,083084,Eldon; John,2,10,80,78
1656020844350,CSE 30,B01,095061,Bhaskar; Nishant,1,4,50,49
1656020850376,CSE 100,A01,083659,Cao; Yingjun,2,25,70,68
1656020856409,CSE 134B,A01,083661,Powell; Thomas Allan,6,6,100,94
1656020862438,CSE 140,A01,083663,Gungor; Onat,5,0,85,80
1656020874694,CSE 140L,A01,083088,Eldon; John,5,0,100,95
1656020880716,CSE 175,A01,083665,Kumar; Rakesh,0,0,25,25
1656020886738,CSE 190,A00,092507,Dubnov; Shlomo,1,0,20,19
1656020892768,ECE 45,A01,083139,Congero; Spencer William,0,1,75,75
1656020898793,ECE 65,A50,083695,Saad; Andrew S,6,0,30,24
1656020898793,ECE 65,A51,095125,Staff,23,0,26,3
1656020904828,ECE 109,A01,091882,Touri; Behrouz,3,5,70,67
1656020910856,ECE 180,A00,083140,Abi Samra; Nicholas Camill,1,0,30,29
1656020910856,ECE 180,B00,083141,Abi Samra; Nicholas Camill,0,8,28,28
1656020916878,MATH 10A,A01,083735,Patchell; Gregory David,0,0,30,30
1656020916878,MATH 10A,A02,083736,Patchell; Gregory David,21,0,30,9
1656020916878,MATH 10A,A03,083737,Patchell; Gregory David,16,0,30,14
1656020922907,MATH 10B,A01,083207,Lim; Seonhee,1,1,34,33
1656020922907,MATH 10B,A02,083208,Lim; Seonhee,1,1,35,34
1656020922907,MATH 10B,A03,093472,Staff,1,0,34,33
1656020922907,MATH 10B,B01,083739,Sinha; Shubham,9,0,30,21
1656020928932,MATH 18,A01,083743,Cinel; Cameron Alexander,5,0,30,25
1656020928932,MATH 18,A02,083744,Cinel; Cameron Alexander,11,0,30,19
1656020928932,MATH 18,A03,083745,Cinel; Cameron Alexander,1,0,30,29
1656020928932,MATH 18,B01,083748,Ma; Zilu,0,0,36,36
1656020928932,MATH 18,B02,083749,Ma; Zilu,0,0,36,36
1656020928932,MATH 18,B03,083750,Ma; Zilu,0,0,36,36
1656020928932,MATH 18,B04,083751,Ma; Zilu,0,0,36,36
1656020928932,MATH 18,B05,093473,Staff,0,0,36,36
1656020928932,MATH 18,B06,093474,Staff,3,0,36,33
1656020934963,MATH 20A,A01,083754,Zheng; Zequn,10,0,40,30
1656020941009,MATH 20B,A01,083756,Briones; Jor-el Thomas Caparas,0,1,36,36
1656020941009,MATH 20B,A02,083757,Briones; Jor-el Thomas Caparas,1,0,36,35
1656020941009,MATH 20B,A03,093475,Staff,0,0,36,36
1656020947037,MATH 20C,A01,083760,Briones; Jor-el Thomas Caparas,0,2,35,35
1656020947037,MATH 20C,A02,083761,Briones; Jor-el Thomas Caparas,6,1,35,29
1656020947037,MATH 20C,A03,093476,Staff,0,0,35,35
1656020947037,MATH 20C,B01,083762,Bach; Quang Tran,3,0,30,27
1656020953061,MATH 20D,A01,083765,Tran; Brian Kha,2,0,30,28
1656020953061,MATH 20D,A02,083766,Tran; Brian Kha,0,1,30,30
1656020953061,MATH 20D,A03,083767,Tran; Brian Kha,1,0,30,29
1656020959090,MATH 20E,A01,083771,Ganguly; Soumya,0,1,32,32
1656020959090,MATH 20E,A02,083772,Ganguly; Soumya,1,1,32,31
1656020959090,MATH 20E,B01,083773,Ciotti; Benjamin,13,0,35,22
1656020959090,MATH 20E,B02,083774,Ciotti; Benjamin,12,0,35,23
1656020965114,MATH 103A,A01,083777,Greenfeld; Be'Eri,2,1,36,34
1656020965114,MATH 103A,A02,083778,Greenfeld; Be'Eri,1,0,36,35
1656020965114,MATH 103A,A03,093561,Staff,0,1,36,36
1656020965114,MATH 103A,B01,083779,Greenfeld; Be'Eri,8,1,36,28
1656020965114,MATH 103A,B02,083780,Greenfeld; Be'Eri,0,0,36,36
1656020965114,MATH 103A,B03,093562,Staff,0,0,36,36
1656020971138,MATH 105,A01,085443,Carter; Anne Toulson,4,1,35,31
1656020971138,MATH 105,A02,093477,Staff,9,0,35,26
1656020977174,MATH 109,A01,083213,Ganzberger; Geoffrey Michael,0,1,34,34
1656020977174,MATH 109,A02,083214,Ganzberger; Geoffrey Michael,0,0,34,34
1656020977174,MATH 109,A03,093478,Staff,1,0,34,33
1656020977174,MATH 109,B01,083215,Ganzberger; Geoffrey Michael,2,0,32,30
1656020977174,MATH 109,B02,083216,Ganzberger; Geoffrey Michael,0,0,32,32
1656020977174,MATH 109,B03,093479,Staff,3,0,32,29
1656020983204,MATH 142A,A01,083219,Chow; Bennett,1,0,32,31
1656020983204,MATH 142A,A02,083220,Chow; Bennett,7,0,32,25
1656020983204,MATH 142A,A03,093480,Staff,4,0,32,28
1656020983204,MATH 142A,B03,093481,Staff,3,0,32,29
1656020983204,MATH 142A,B04,093558,Staff,6,0,32,26
1656020983204,MATH 142A,B05,093559,Staff,0,0,32,32
1656020989227,MATH 193A,A01,083224,Rotar; Vladimir,1,2,34,33
1656020989227,MATH 193A,A02,083225,Rotar; Vladimir,0,1,34,34
1656020989227,MATH 193A,A03,083781,Rotar; Vladimir,2,0,34,32
1656020989227,MATH 193A,A04,083782,Rotar; Vladimir,3,0,34,31
1656020989227,MATH 193A,A05,093482,Rotar; Vladimir,0,0,34,34
1656020995249,MATH 197,001,091859,McAuley; Julian John,9999,0,9999,0
1656020995249,MATH 197,002,095566,Kedlaya; Kiran S.,9997,0,9999,2
1656020995249,MATH 197,003,095567,Xiao; Ming,9999,0,9999,0
1656020995249,MATH 197,004,095571,Perols; Johan Lars,9998,0,9999,1
1656021002319,COGS 9,A01,083615,Shannon; Kyle Michael,3,1,75,72
1656021008342,COGS 11,A01,083617,Boyle; Mary E. T.,11,1,48,37
1656021014372,COGS 13,A01,083071,Bastos; Amalia Pinkusfeld,4,2,71,67
1656021020395,COGS 14A,A01,092681,Semenuks; Arturs,4,25,100,96
1656021026417,COGS 14B,A01,083073,Cheng; Tzu-Han,7,0,63,56
1656021032440,COGS 17,A01,092677,Semenuks; Arturs,8,7,81,73
1656021038466,COGS 100,A01,083619,Allen; Michael Gordon,2,2,70,68
1656021044489,COGS 101A,A01,083621,Davis; Joshua Daniel,4,3,68,64
1656021050512,COGS 101B,A01,091572,Allen; Michael Gordon,0,0,65,65
1656021056540,COGS 101C,A01,083625,Delgado; Tania,7,0,35,28
1656021062567,COGS 107A,A01,083627,Boyle; Mary E. T.,1,2,60,59
1656021068592,COGS 118A,A01,083075,Gupta; Anjum,21,16,76,55
1656021074618,CSE 3,A50,083646,Miranda; Gregory Joseph,14,0,50,36
1656021080648,CSE 8A,A50,083650,Miranda; Gregory Joseph,4,11,56,52
1656021086671,CSE 11,A01,083080,Cao; Yingjun,0,65,40,40
1656021092696,CSE 12,A01,083652,Krause-Levy; Sophia Louisa,7,8,120,113
1656021098719,CSE 15L,A01,083654,Morris; Justin Loren,3,1,50,47
1656021098719,CSE 15L,A02,083655,Morris; Justin Loren,2,1,50,48
1656021104742,CSE 20,A01,083657,Tran; Khoa Dang,29,0,80,51
1656021110769,CSE 21,A01,095574,Bach; Quang Tran,23,0,48,25
1656021116802,CSE 30,A01,083084,Eldon; John,2,10,80,78
1656021116802,CSE 30,B01,095061,Bhaskar; Nishant,1,4,50,49
1656021122844,CSE 100,A01,083659,Cao; Yingjun,2,25,70,68
1656021128866,CSE 134B,A01,083661,Powell; Thomas Allan,6,6,100,94
1656021134894,CSE 140,A01,083663,Gungor; Onat,5,0,85,80
1656021140916,CSE 140L,A01,083088,Eldon; John,5,0,100,95
1656021146944,CSE 175,A01,083665,Kumar; Rakesh,0,0,25,25
1656021152967,CSE 190,A00,092507,Dubnov; Shlomo,1,0,20,19
1656021158992,ECE 45,A01,083139,Congero; Spencer William,0,1,75,75
1656021165025,ECE 65,A50,083695,Saad; Andrew S,6,0,30,24
1656021165025,ECE 65,A51,095125,Staff,23,0,26,3
1656021171052,ECE 109,A01,091882,Touri; Behrouz,3,5,70,67
1656021177076,ECE 180,A00,083140,Abi Samra; Nicholas Camill,1,0,30,29
1656021177076,ECE 180,B00,083141,Abi Samra; Nicholas Camill,0,8,28,28
1656021183100,MATH 10A,A01,083735,Patchell; Gregory David,0,0,30,30
1656021183100,MATH 10A,A02,083736,Patchell; Gregory David,21,0,30,9
1656021183100,MATH 10A,A03,083737,Patchell; Gregory David,16,0,30,14
1656021189130,MATH 10B,A01,083207,Lim; Seonhee,1,1,34,33
1656021189130,MATH 10B,A02,083208,Lim; Seonhee,1,1,35,34
1656021189130,MATH 10B,A03,093472,Staff,1,0,34,33
1656021189130,MATH 10B,B01,083739,Sinha; Shubham,9,0,30,21
1656021195158,MATH 18,A01,083743,Cinel; Cameron Alexander,5,0,30,25
1656021195158,MATH 18,A02,083744,Cinel; Cameron Alexander,11,0,30,19
1656021195158,MATH 18,A03,083745,Cinel; Cameron Alexander,1,0,30,29
1656021195158,MATH 18,B01,083748,Ma; Zilu,0,0,36,36
1656021195158,MATH 18,B02,083749,Ma; Zilu,0,0,36,36
1656021195158,MATH 18,B03,083750,Ma; Zilu,0,0,36,36
1656021195158,MATH 18,B04,083751,Ma; Zilu,0,0,36,36
1656021195158,MATH 18,B05,093473,Staff,0,0,36,36
1656021195158,MATH 18,B06,093474,Staff,3,0,36,33
1656021201183,MATH 20A,A01,083754,Zheng; Zequn,10,0,40,30
1656021207206,MATH 20B,A01,083756,Briones; Jor-el Thomas Caparas,0,1,36,36
1656021207206,MATH 20B,A02,083757,Briones; Jor-el Thomas Caparas,1,0,36,35
1656021207206,MATH 20B,A03,093475,Staff,0,0,36,36
1656021213235,MATH 20C,A01,083760,Briones; Jor-el Thomas Caparas,0,2,35,35
1656021213235,MATH 20C,A02,083761,Briones; Jor-el Thomas Caparas,6,1,35,29
1656021213235,MATH 20C,A03,093476,Staff,0,0,35,35
1656021213235,MATH 20C,B01,083762,Bach; Quang Tran,3,0,30,27
1656021219267,MATH 20D,A01,083765,Tran; Brian Kha,2,0,30,28
1656021219267,MATH 20D,A02,083766,Tran; Brian Kha,0,1,30,30
1656021219267,MATH 20D,A03,083767,Tran; Brian Kha,1,0,30,29
1656021225298,MATH 20E,A01,083771,Ganguly; Soumya,0,1,32,32
1656021225298,MATH 20E,A02,083772,Ganguly; Soumya,1,1,32,31
1656021225298,MATH 20E,B01,083773,Ciotti; Benjamin,13,0,35,22
1656021225298,MATH 20E,B02,083774,Ciotti; Benjamin,12,0,35,23
1656021231329,MATH 103A,A01,083777,Greenfeld; Be'Eri,2,1,36,34
1656021231329,MATH 103A,A02,083778,Greenfeld; Be'Eri,1,0,36,35
1656021231329,MATH 103A,A03,093561,Staff,0,1,36,36
1656021231329,MATH 103A,B01,083779,Greenfeld; Be'Eri,8,1,36,28
1656021231329,MATH 103A,B02,083780,Greenfeld; Be'Eri,0,0,36,36
1656021231329,MATH 103A,B03,093562,Staff,0,0,36,36
1656021237353,MATH 105,A01,085443,Carter; Anne Toulson,4,1,35,31
1656021237353,MATH 105,A02,093477,Staff,9,0,35,26
1656021243377,MATH 109,A01,083213,Ganzberger; Geoffrey Michael,0,1,34,34
1656021243377,MATH 109,A02,083214,Ganzberger; Geoffrey Michael,0,0,34,34
1656021243377,MATH 109,A03,093478,Staff,1,0,34,33
1656021243377,MATH 109,B01,083215,Ganzberger; Geoffrey Michael,2,0,32,30
1656021243377,MATH 109,B02,083216,Ganzberger; Geoffrey Michael,0,0,32,32
1656021243377,MATH 109,B03,093479,Staff,3,0,32,29
1656021249406,MATH 142A,A01,083219,Chow; Bennett,1,0,32,31
1656021249406,MATH 142A,A02,083220,Chow; Bennett,7,0,32,25
1656021249406,MATH 142A,A03,093480,Staff,4,0,32,28
1656021249406,MATH 142A,B03,093481,Staff,3,0,32,29
1656021249406,MATH 142A,B04,093558,Staff,6,0,32,26
1656021249406,MATH 142A,B05,093559,Staff,0,0,32,32
1656021255430,MATH 193A,A01,083224,Rotar; Vladimir,1,2,34,33
1656021255430,MATH 193A,A02,083225,Rotar; Vladimir,0,1,34,34
1656021255430,MATH 193A,A03,083781,Rotar; Vladimir,2,0,34,32
1656021255430,MATH 193A,A04,083782,Rotar; Vladimir,3,0,34,31
1656021255430,MATH 193A,A05,093482,Rotar; Vladimir,0,0,34,34
1656021261455,MATH 197,001,091859,McAuley; Julian John,9999,0,9999,0
1656021261455,MATH 197,002,095566,Kedlaya; Kiran S.,9997,0,9999,2
1656021261455,MATH 197,003,095567,Xiao; Ming,9999,0,9999,0
1656021261455,MATH 197,004,095571,Perols; Johan Lars,9998,0,9999,1
1656021268513,COGS 9,A01,083615,Shannon; Kyle Michael,3,1,75,72
1656021274535,COGS 11,A01,083617,Boyle; Mary E. T.,11,1,48,37
1656021280559,COGS 13,A01,083071,Bastos; Amalia Pinkusfeld,4,2,71,67
1656021286587,COGS 14A,A01,092681,Semenuks; Arturs,4,25,100,96
1656021292611,COGS 14B,A01,083073,Cheng; Tzu-Han,7,0,63,56
1656021298638,COGS 17,A01,092677,Semenuks; Arturs,8,7,81,73
1656021304664,COGS 100,A01,083619,Allen; Michael Gordon,2,2,70,68
1656021310704,COGS 101A,A01,083621,Davis; Joshua Daniel,4,3,68,64
1656021316730,COGS 101B,A01,091572,Allen; Michael Gordon,0,0,65,65
1656021322754,COGS 101C,A01,083625,Delgado; Tania,7,0,35,28
1656021328777,COGS 107A,A01,083627,Boyle; Mary E. T.,1,2,60,59
1656021334804,COGS 118A,A01,083075,Gupta; Anjum,21,16,76,55
1656021340836,CSE 3,A50,083646,Miranda; Gregory Joseph,14,0,50,36
1656021346859,CSE 8A,A50,083650,Miranda; Gregory Joseph,4,11,56,52
1656021352958,CSE 11,A01,083080,Cao; Yingjun,0,65,40,40
1656021358982,CSE 12,A01,083652,Krause-Levy; Sophia Louisa,7,8,120,113
1656021365005,CSE 15L,A01,083654,Morris; Justin Loren,3,1,50,47
1656021365005,CSE 15L,A02,083655,Morris; Justin Loren,2,1,50,48
1656021371028,CSE 20,A01,083657,Tran; Khoa Dang,29,0,80,51
1656021377060,CSE 21,A01,095574,Bach; Quang Tran,23,0,48,25
1656021383083,CSE 30,A01,083084,Eldon; John,2,10,80,78
1656021383083,CSE 30,B01,095061,Bhaskar; Nishant,1,4,50,49
1656021389115,CSE 100,A01,083659,Cao; Yingjun,2,25,70,68
1656021395142,CSE 134B,A01,083661,Powell; Thomas Allan,6,6,100,94
1656021401164,CSE 140,A01,083663,Gungor; Onat,5,0,85,80
1656021407187,CSE 140L,A01,083088,Eldon; John,5,0,100,95
1656021413210,CSE 175,A01,083665,Kumar; Rakesh,0,0,25,25
1656021419233,CSE 190,A00,092507,Dubnov; Shlomo,1,0,20,19
1656021425260,ECE 45,A01,083139,Congero; Spencer William,0,1,75,75
1656021431283,ECE 65,A50,083695,Saad; Andrew S,6,0,30,24
1656021431283,ECE 65,A51,095125,Staff,23,0,26,3
1656021437312,ECE 109,A01,091882,Touri; Behrouz,3,5,70,67
1656021443334,ECE 180,A00,083140,Abi Samra; Nicholas Camill,1,0,30,29
1656021443334,ECE 180,B00,083141,Abi Samra; Nicholas Camill,0,8,28,28
1656021449357,MATH 10A,A01,083735,Patchell; Gregory David,0,0,30,30
1656021449357,MATH 10A,A02,083736,Patchell; Gregory David,21,0,30,9
1656021449357,MATH 10A,A03,083737,Patchell; Gregory David,16,0,30,14
1656021455379,MATH 10B,A01,083207,Lim; Seonhee,1,1,34,33
1656021455379,MATH 10B,A02,083208,Lim; Seonhee,1,1,35,34
1656021455379,MATH 10B,A03,093472,Staff,1,0,34,33
1656021455379,MATH 10B,B01,083739,Sinha; Shubham,9,0,30,21
1656021461409,MATH 18,A01,083743,Cinel; Cameron Alexander,5,0,30,25
1656021461409,MATH 18,A02,083744,Cinel; Cameron Alexander,11,0,30,19
1656021461409,MATH 18,A03,083745,Cinel; Cameron Alexander,1,0,30,29
1656021461409,MATH 18,B01,083748,Ma; Zilu,0,0,36,36
1656021461409,MATH 18,B02,083749,Ma; Zilu,0,0,36,36
1656021461409,MATH 18,B03,083750,Ma; Zilu,0,0,36,36
1656021461409,MATH 18,B04,083751,Ma; Zilu,0,0,36,36
1656021461409,MATH 18,B05,093473,Staff,0,0,36,36
1656021461409,MATH 18,B06,093474,Staff,3,0,36,33
1656021467432,MATH 20A,A01,083754,Zheng; Zequn,10,0,40,30
1656021473460,MATH 20B,A01,083756,Briones; Jor-el Thomas Caparas,0,1,36,36
1656021473460,MATH 20B,A02,083757,Briones; Jor-el Thomas Caparas,1,0,36,35
1656021473460,MATH 20B,A03,093475,Staff,0,0,36,36
1656021479483,MATH 20C,A01,083760,Briones; Jor-el Thomas Caparas,0,2,35,35
1656021479483,MATH 20C,A02,083761,Briones; Jor-el Thomas Caparas,6,1,35,29
1656021479483,MATH 20C,A03,093476,Staff,0,0,35,35
1656021479483,MATH 20C,B01,083762,Bach; Quang Tran,3,0,30,27
1656021485519,MATH 20D,A01,083765,Tran; Brian Kha,2,0,30,28
1656021485519,MATH 20D,A02,083766,Tran; Brian Kha,0,1,30,30
1656021485519,MATH 20D,A03,083767,Tran; Brian Kha,1,0,30,29
1656021491547,MATH 20E,A01,083771,Ganguly; Soumya,0,1,32,32
1656021491547,MATH 20E,A02,083772,Ganguly; Soumya,1,1,32,31
1656021491547,MATH 20E,B01,083773,Ciotti; Benjamin,13,0,35,22
1656021491547,MATH 20E,B02,083774,Ciotti; Benjamin,12,0,35,23
1656021497571,MATH 103A,A01,083777,Greenfeld; Be'Eri,2,1,36,34
1656021497571,MATH 103A,A02,083778,Greenfeld; Be'Eri,1,0,36,35
1656021497571,MATH 103A,A03,093561,Staff,0,1,36,36
1656021497571,MATH 103A,B01,083779,Greenfeld; Be'Eri,8,1,36,28
1656021497571,MATH 103A,B02,083780,Greenfeld; Be'Eri,0,0,36,36
1656021497571,MATH 103A,B03,093562,Staff,0,0,36,36
1656021503597,MATH 105,A01,085443,Carter; Anne Toulson,4,1,35,31
1656021503597,MATH 105,A02,093477,Staff,9,0,35,26
1656021509619,MATH 109,A01,083213,Ganzberger; Geoffrey Michael,0,1,34,34
1656021509619,MATH 109,A02,083214,Ganzberger; Geoffrey Michael,0,0,34,34
1656021509619,MATH 109,A03,093478,Staff,1,0,34,33
1656021509619,MATH 109,B01,083215,Ganzberger; Geoffrey Michael,2,0,32,30
1656021509619,MATH 109,B02,083216,Ganzberger; Geoffrey Michael,0,0,32,32
1656021509619,MATH 109,B03,093479,Staff,3,0,32,29
1656021515652,MATH 142A,A01,083219,Chow; Bennett,1,0,32,31
1656021515652,MATH 142A,A02,083220,Chow; Bennett,7,0,32,25
1656021515652,MATH 142A,A03,093480,Staff,4,0,32,28
1656021515652,MATH 142A,B03,093481,Staff,3,0,32,29
1656021515652,MATH 142A,B04,093558,Staff,6,0,32,26
1656021515652,MATH 142A,B05,093559,Staff,0,0,32,32
1656021521696,MATH 193A,A01,083224,Rotar; Vladimir,1,2,34,33
1656021521696,MATH 193A,A02,083225,Rotar; Vladimir,0,1,34,34
1656021521696,MATH 193A,A03,083781,Rotar; Vladimir,2,0,34,32
1656021521696,MATH 193A,A04,083782,Rotar; Vladimir,3,0,34,31
1656021521696,MATH 193A,A05,093482,Rotar; Vladimir,0,0,34,34
1656021527725,MATH 197,001,091859,McAuley; Julian John,9999,0,9999,0
1656021527725,MATH 197,002,095566,Kedlaya; Kiran S.,9997,0,9999,2
1656021527725,MATH 197,003,095567,Xiao; Ming,9999,0,9999,0
1656021527725,MATH 197,004,095571,Perols; Johan Lars,9998,0,9999,1
1656021534790,COGS 9,A01,083615,Shannon; Kyle Michael,3,1,75,72
1656021540816,COGS 11,A01,083617,Boyle; Mary E. T.,11,1,48,37
1656021546859,COGS 13,A01,083071,Bastos; Amalia Pinkusfeld,4,2,71,67
1656021552885,COGS 14A,A01,092681,Semenuks; Arturs,4,25,100,96
1656021558913,COGS 14B,A01,083073,Cheng; Tzu-Han,7,0,63,56
1656021564938,COGS 17,A01,092677,Semenuks; Arturs,8,7,81,73
1656021570965,COGS 100,A01,083619,Allen; Michael Gordon,2,2,70,68
1656021576992,COGS 101A,A01,083621,Davis; Joshua Daniel,4,3,68,64
1656021583024,COGS 101B,A01,091572,Allen; Michael Gordon,0,0,65,65
1656021589062,COGS 101C,A01,083625,Delgado; Tania,7,0,35,28
1656021595090,COGS 107A,A01,083627,Boyle; Mary E. T.,1,2,60,59
1656021601111,COGS 118A,A01,083075,Gupta; Anjum,21,16,76,55
1656021607141,CSE 3,A50,083646,Miranda; Gregory Joseph,14,0,50,36
1656021613181,CSE 8A,A50,083650,Miranda; Gregory Joseph,4,11,56,52
1656021619213,CSE 11,A01,083080,Cao; Yingjun,0,65,40,40
1656021625239,CSE 12,A01,083652,Krause-Levy; Sophia Louisa,7,8,120,113
1656021631263,CSE 15L,A01,083654,Morris; Justin Loren,3,1,50,47
1656021631263,CSE 15L,A02,083655,Morris; Justin Loren,2,1,50,48
1656021637290,CSE 20,A01,083657,Tran; Khoa Dang,29,0,80,51
1656021643327,CSE 21,A01,095574,Bach; Quang Tran,23,0,48,25
1656021649355,CSE 30,A01,083084,Eldon; John,2,10,80,78
1656021649355,CSE 30,B01,095061,Bhaskar; Nishant,1,4,50,49
1656021655382,CSE 100,A01,083659,Cao; Yingjun,2,25,70,68
1656021661404,CSE 134B,A01,083661,Powell; Thomas Allan,6,6,100,94
1656021667457,CSE 140,A01,083663,Gungor; Onat,5,0,85,80
1656021673485,CSE 140L,A01,083088,Eldon; John,5,0,100,95
1656021679506,CSE 175,A01,083665,Kumar; Rakesh,0,0,25,25
1656021685529,CSE 190,A00,092507,Dubnov; Shlomo,1,0,20,19
1656021691554,ECE 45,A01,083139,Congero; Spencer William,0,1,75,75
1656021697580,ECE 65,A50,083695,Saad; Andrew S,6,0,30,24
1656021697580,ECE 65,A51,095125,Staff,23,0,26,3
1656021703608,ECE 109,A01,091882,Touri; Behrouz,3,5,70,67
1656021709635,ECE 180,A00,083140,Abi Samra; Nicholas Camill,1,0,30,29
1656021709635,ECE 180,B00,083141,Abi Samra; Nicholas Camill,0,8,28,28
1656021715662,MATH 10A,A01,083735,Patchell; Gregory David,0,0,30,30
1656021715662,MATH 10A,A02,083736,Patchell; Gregory David,21,0,30,9
1656021715662,MATH 10A,A03,083737,Patchell; Gregory David,16,0,30,14
1656021721685,MATH 10B,A01,083207,Lim; Seonhee,1,1,34,33
1656021721685,MATH 10B,A02,083208,Lim; Seonhee,1,1,35,34
1656021721685,MATH 10B,A03,093472,Staff,1,0,34,33
1656021721685,MATH 10B,B01,083739,Sinha; Shubham,9,0,30,21
1656021727717,MATH 18,A01,083743,Cinel; Cameron Alexander,5,0,30,25
1656021727717,MATH 18,A02,083744,Cinel; Cameron Alexander,11,0,30,19
1656021727717,MATH 18,A03,083745,Cinel; Cameron Alexander,1,0,30,29
1656021727717,MATH 18,B01,083748,Ma; Zilu,0,0,36,36
1656021727717,MATH 18,B02,083749,Ma; Zilu,0,0,36,36
1656021727717,MATH 18,B03,083750,Ma; Zilu,0,0,36,36
1656021727717,MATH 18,B04,083751,Ma; Zilu,0,0,36,36
1656021727717,MATH 18,B05,093473,Staff,0,0,36,36
1656021727717,MATH 18,B06,093474,Staff,3,0,36,33
1656021733740,MATH 20A,A01,083754,Zheng; Zequn,10,0,40,30
1656021739767,MATH 20B,A01,083756,Briones; Jor-el Thomas Caparas,0,1,36,36
1656021739767,MATH 20B,A02,083757,Briones; Jor-el Thomas Caparas,1,0,36,35
1656021739767,MATH 20B,A03,093475,Staff,0,0,36,36
1656021745795,MATH 20C,A01,083760,Briones; Jor-el Thomas Caparas,0,2,35,35
1656021745795,MATH 20C,A02,083761,Briones; Jor-el Thomas Caparas,6,1,35,29
1656021745795,MATH 20C,A03,093476,Staff,0,0,35,35
1656021745795,MATH 20C,B01,083762,Bach; Quang Tran,3,0,30,27
1656021751827,MATH 20D,A01,083765,Tran; Brian Kha,2,0,30,28
1656021751827,MATH 20D,A02,083766,Tran; Brian Kha,0,1,30,30
1656021751827,MATH 20D,A03,083767,Tran; Brian Kha,1,0,30,29
1656021757870,MATH 20E,A01,083771,Ganguly; Soumya,0,1,32,32
1656021757870,MATH 20E,A02,083772,Ganguly; Soumya,1,1,32,31
1656021757870,MATH 20E,B01,083773,Ciotti; Benjamin,13,0,35,22
1656021757870,MATH 20E,B02,083774,Ciotti; Benjamin,12,0,35,23
1656021763897,MATH 103A,A01,083777,Greenfeld; Be'Eri,2,1,36,34
1656021763897,MATH 103A,A02,083778,Greenfeld; Be'Eri,1,0,36,35
1656021763897,MATH 103A,A03,093561,Staff,0,1,36,36
1656021763897,MATH 103A,B01,083779,Greenfeld; Be'Eri,8,1,36,28
1656021763897,MATH 103A,B02,083780,Greenfeld; Be'Eri,0,0,36,36
1656021763897,MATH 103A,B03,093562,Staff,0,0,36,36
1656021769920,MATH 105,A01,085443,Carter; Anne Toulson,4,1,35,31
1656021769920,MATH 105,A02,093477,Staff,9,0,35,26
1656021775945,MATH 109,A01,083213,Ganzberger; Geoffrey Michael,0,1,34,34
1656021775945,MATH 109,A02,083214,Ganzberger; Geoffrey Michael,0,0,34,34
1656021775945,MATH 109,A03,093478,Staff,1,0,34,33
1656021775945,MATH 109,B01,083215,Ganzberger; Geoffrey Michael,2,0,32,30
1656021775945,MATH 109,B02,083216,Ganzberger; Geoffrey Michael,0,0,32,32
1656021775945,MATH 109,B03,093479,Staff,3,0,32,29
1656021781970,MATH 142A,A01,083219,Chow; Bennett,1,0,32,31
1656021781970,MATH 142A,A02,083220,Chow; Bennett,7,0,32,25
1656021781970,MATH 142A,A03,093480,Staff,4,0,32,28
1656021781970,MATH 142A,B03,093481,Staff,3,0,32,29
1656021781970,MATH 142A,B04,093558,Staff,6,0,32,26
1656021781970,MATH 142A,B05,093559,Staff,0,0,32,32
1656021787997,MATH 193A,A01,083224,Rotar; Vladimir,1,2,34,33
1656021787997,MATH 193A,A02,083225,Rotar; Vladimir,0,1,34,34
1656021787997,MATH 193A,A03,083781,Rotar; Vladimir,2,0,34,32
1656021787997,MATH 193A,A04,083782,Rotar; Vladimir,3,0,34,31
1656021787997,MATH 193A,A05,093482,Rotar; Vladimir,0,0,34,34
1656021794024,MATH 197,001,091859,McAuley; Julian John,9999,0,9999,0
1656021794024,MATH 197,002,095566,Kedlaya; Kiran S.,9997,0,9999,2
1656021794024,MATH 197,003,095567,Xiao; Ming,9999,0,9999,0
1656021794024,MATH 197,004,095571,Perols; Johan Lars,9998,0,9999,1
1656021801101,COGS 9,A01,083615,Shannon; Kyle Michael,3,1,75,72
1656021807132,COGS 11,A01,083617,Boyle; Mary E. T.,11,1,48,37
1656021813157,COGS 13,A01,083071,Bastos; Amalia Pinkusfeld,4,2,71,67
1656021819185,COGS 14A,A01,092681,Semenuks; Arturs,4,25,100,96
1656021825213,COGS 14B,A01,083073,Cheng; Tzu-Han,7,0,63,56
1656021831236,COGS 17,A01,092677,Semenuks; Arturs,8,7,81,73
1656021837259,COGS 100,A01,083619,Allen; Michael Gordon,2,2,70,68
1656021843286,COGS 101A,A01,083621,Davis; Joshua Daniel,4,3,68,64
1656021849312,COGS 101B,A01,091572,Allen; Michael Gordon,0,0,65,65
1656021855349,COGS 101C,A01,083625,Delgado; Tania,7,0,35,28
1656021861375,COGS 107A,A01,083627,Boyle; Mary E. T.,1,2,60,59
1656021867402,COGS 118A,A01,083075,Gupta; Anjum,21,16,76,55
1656021873431,CSE 3,A50,083646,Miranda; Gregory Joseph,14,0,50,36
1656021879460,CSE 8A,A50,083650,Miranda; Gregory Joseph,4,11,56,52
1656021885522,CSE 11,A01,083080,Cao; Yingjun,0,65,40,40
1656021891549,CSE 12,A01,083652,Krause-Levy; Sophia Louisa,7,8,120,113
1656021897576,CSE 15L,A01,083654,Morris; Justin Loren,3,1,50,47
1656021897576,CSE 15L,A02,083655,Morris; Justin Loren,2,1,50,48
1656021903600,CSE 20,A01,083657,Tran; Khoa Dang,29,0,80,51
1656021909622,CSE 21,A01,095574,Bach; Quang Tran,23,0,48,25
1656021915646,CSE 30,A01,083084,Eldon; John,2,10,80,78
1656021915646,CSE 30,B01,095061,Bhaskar; Nishant,1,4,50,49
1656021921669,CSE 100,A01,083659,Cao; Yingjun,2,25,70,68
1656021927691,CSE 134B,A01,083661,Powell; Thomas Allan,6,6,100,94
1656021933715,CSE 140,A01,083663,Gungor; Onat,5,0,85,80
1656021939740,CSE 140L,A01,083088,Eldon; John,5,0,100,95
1656021945779,CSE 175,A01,083665,Kumar; Rakesh,0,0,25,25
1656021951873,CSE 190,A00,092507,Dubnov; Shlomo,1,0,20,19
1656021957897,ECE 45,A01,083139,Congero; Spencer William,0,1,75,75
1656021963921,ECE 65,A50,083695,Saad; Andrew S,6,0,30,24
1656021963921,ECE 65,A51,095125,Staff,23,0,26,3
1656021969945,ECE 109,A01,091882,Touri; Behrouz,3,5,70,67
1656021975972,ECE 180,A00,083140,Abi Samra; Nicholas Camill,1,0,30,29
1656021975972,ECE 180,B00,083141,Abi Samra; Nicholas Camill,0,8,28,28
1656021982002,MATH 10A,A01,083735,Patchell; Gregory David,0,0,30,30
1656021982002,MATH 10A,A02,083736,Patchell; Gregory David,21,0,30,9
1656021982002,MATH 10A,A03,083737,Patchell; Gregory David,16,0,30,14
1656021988034,MATH 10B,A01,083207,Lim; Seonhee,1,1,34,33
1656021988034,MATH 10B,A02,083208,Lim; Seonhee,1,1,35,34
1656021988034,MATH 10B,A03,093472,Staff,1,0,34,33
1656021988034,MATH 10B,B01,083739,Sinha; Shubham,9,0,30,21
1656021994066,MATH 18,A01,083743,Cinel; Cameron Alexander,5,0,30,25
1656021994066,MATH 18,A02,083744,Cinel; Cameron Alexander,11,0,30,19
1656021994066,MATH 18,A03,083745,Cinel; Cameron Alexander,1,0,30,29
1656021994066,MATH 18,B01,083748,Ma; Zilu,0,0,36,36
1656021994066,MATH 18,B02,083749,Ma; Zilu,0,0,36,36
1656021994066,MATH 18,B03,083750,Ma; Zilu,0,0,36,36
1656021994066,MATH 18,B04,083751,Ma; Zilu,0,0,36,36
1656021994066,MATH 18,B05,093473,Staff,0,0,36,36
1656021994066,MATH 18,B06,093474,Staff,3,0,36,33
1656022000092,MATH 20A,A01,083754,Zheng; Zequn,10,0,40,30
1656022006116,MATH 20B,A01,083756,Briones; Jor-el Thomas Caparas,0,1,36,36
1656022006116,MATH 20B,A02,083757,Briones; Jor-el Thomas Caparas,1,0,36,35
1656022006116,MATH 20B,A03,093475,Staff,0,0,36,36
1656022012144,MATH 20C,A01,083760,Briones; Jor-el Thomas Caparas,0,2,35,35
1656022012144,MATH 20C,A02,083761,Briones; Jor-el Thomas Caparas,6,1,35,29
1656022012144,MATH 20C,A03,093476,Staff,0,0,35,35
1656022012144,MATH 20C,B01,083762,Bach; Quang Tran,3,0,30,27
1656022018169,MATH 20D,A01,083765,Tran; Brian Kha,2,0,30,28
1656022018169,MATH 20D,A02,083766,Tran; Brian Kha,0,1,30,30
1656022018169,MATH 20D,A03,083767,Tran; Brian Kha,1,0,30,29
1656022024193,MATH 20E,A01,083771,Ganguly; Soumya,0,1,32,32
1656022024193,MATH 20E,A02,083772,Ganguly; Soumya,1,1,32,31
1656022024193,MATH 20E,B01,083773,Ciotti; Benjamin,13,0,35,22
1656022024193,MATH 20E,B02,083774,Ciotti; Benjamin,12,0,35,23
1656022030222,MATH 103A,A01,083777,Greenfeld; Be'Eri,2,1,36,34
1656022030222,MATH 103A,A02,083778,Greenfeld; Be'Eri,1,0,36,35
1656022030222,MATH 103A,A03,093561,Staff,0,1,36,36
1656022030222,MATH 103A,B01,083779,Greenfeld; Be'Eri,8,1,36,28
1656022030222,MATH 103A,B02,083780,Greenfeld; Be'Eri,0,0,36,36
1656022030222,MATH 103A,B03,093562,Staff,0,0,36,36
1656022036285,MATH 105,A01,085443,Carter; Anne Toulson,4,1,35,31
1656022036285,MATH 105,A02,093477,Staff,9,0,35,26
1656022042309,MATH 109,A01,083213,Ganzberger; Geoffrey Michael,0,1,34,34
1656022042309,MATH 109,A02,083214,Ganzberger; Geoffrey Michael,0,0,34,34
1656022042309,MATH 109,A03,093478,Staff,1,0,34,33
1656022042309,MATH 109,B01,083215,Ganzberger; Geoffrey Michael,2,0,32,30
1656022042309,MATH 109,B02,083216,Ganzberger; Geoffrey Michael,0,0,32,32
1656022042309,MATH 109,B03,093479,Staff,3,0,32,29
1656022048333,MATH 142A,A01,083219,Chow; Bennett,1,0,32,31
1656022048333,MATH 142A,A02,083220,Chow; Bennett,7,0,32,25
1656022048333,MATH 142A,A03,093480,Staff,4,0,32,28
1656022048333,MATH 142A,B03,093481,Staff,3,0,32,29
1656022048333,MATH 142A,B04,093558,Staff,6,0,32,26
1656022048333,MATH 142A,B05,093559,Staff,0,0,32,32
1656022054356,MATH 193A,A01,083224,Rotar; Vladimir,1,2,34,33
1656022054356,MATH 193A,A02,083225,Rotar; Vladimir,0,1,34,34
1656022054356,MATH 193A,A03,083781,Rotar; Vladimir,2,0,34,32
1656022054356,MATH 193A,A04,083782,Rotar; Vladimir,3,0,34,31
1656022054356,MATH 193A,A05,093482,Rotar; Vladimir,0,0,34,34
1656022060378,MATH 197,001,091859,McAuley; Julian John,9999,0,9999,0
1656022060378,MATH 197,002,095566,Kedlaya; Kiran S.,9997,0,9999,2
1656022060378,MATH 197,003,095567,Xiao; Ming,9999,0,9999,0
1656022060378,MATH 197,004,095571,Perols; Johan Lars,9998,0,9999,1
1656022067445,COGS 9,A01,083615,Shannon; Kyle Michael,3,1,75,72
1656022073468,COGS 11,A01,083617,Boyle; Mary E. T.,11,1,48,37
1656022079507,COGS 13,A01,083071,Bastos; Amalia Pinkusfeld,4,2,71,67
1656022085530,COGS 14A,A01,092681,Semenuks; Arturs,4,25,100,96
1656022091557,COGS 14B,A01,083073,Cheng; Tzu-Han,7,0,63,56
1656022097585,COGS 17,A01,092677,Semenuks; Arturs,8,7,81,73
1656022103606,COGS 100,A01,083619,Allen; Michael Gordon,2,2,70,68
1656022109630,COGS 101A,A01,083621,Davis; Joshua Daniel,4,3,68,64
1656022115656,COGS 101B,A01,091572,Allen; Michael Gordon,0,0,65,65
1656022121684,COGS 101C,A01,083625,Delgado; Tania,7,0,35,28
1656022127708,COGS 107A,A01,083627,Boyle; Mary E. T.,1,2,60,59
1656022133733,COGS 118A,A01,083075,Gupta; Anjum,21,16,76,55
1656022139763,CSE 3,A50,083646,Miranda; Gregory Joseph,14,0,50,36
1656022145788,CSE 8A,A50,083650,Miranda; Gregory Joseph,4,11,56,52
1656022151810,CSE 11,A01,083080,Cao; Yingjun,0,65,40,40
1656022157832,CSE 12,A01,083652,Krause-Levy; Sophia Louisa,7,8,120,113
1656022163855,CSE 15L,A01,083654,Morris; Justin Loren,3,1,50,47
1656022163855,CSE 15L,A02,083655,Morris; Justin Loren,2,1,50,48
1656022169880,CSE 20,A01,083657,Tran; Khoa Dang,29,0,80,51
1656022175906,CSE 21,A01,095574,Bach; Quang Tran,23,0,48,25
1656022181930,CSE 30,A01,083084,Eldon; John,2,10,80,78
1656022181930,CSE 30,B01,095061,Bhaskar; Nishant,1,4,50,49
1656022187957,CSE 100,A01,083659,Cao; Yingjun,2,25,70,68
1656022193987,CSE 134B,A01,083661,Powell; Thomas Allan,6,6,100,94
1656022200011,CSE 140,A01,083663,Gungor; Onat,5,0,85,80
1656022206036,CSE 140L,A01,083088,Eldon; John,5,0,100,95
1656022212069,CSE 175,A01,083665,Kumar; Rakesh,0,0,25,25
1656022218100,CSE 190,A00,092507,Dubnov; Shlomo,1,0,20,19
1656022224127,ECE 45,A01,083139,Congero; Spencer William,0,1,75,75
1656022230150,ECE 65,A50,083695,Saad; Andrew S,6,0,30,24
1656022230150,ECE 65,A51,095125,Staff,23,0,26,3
1656022236174,ECE 109,A01,091882,Touri; Behrouz,3,5,70,67
1656022242202,ECE 180,A00,083140,Abi Samra; Nicholas Camill,1,0,30,29
1656022242202,ECE 180,B00,083141,Abi Samra; Nicholas Camill,0,8,28,28
1656022248226,MATH 10A,A01,083735,Patchell; Gregory David,0,0,30,30
1656022248226,MATH 10A,A02,083736,Patchell; Gregory David,21,0,30,9
1656022248226,MATH 10A,A03,083737,Patchell; Gregory David,16,0,30,14
1656022254254,MATH 10B,A01,083207,Lim; Seonhee,1,1,34,33
1656022254254,MATH 10B,A02,083208,Lim; Seonhee,1,1,35,34
1656022254254,MATH 10B,A03,093472,Staff,1,0,34,33
1656022254254,MATH 10B,B01,083739,Sinha; Shubham,9,0,30,21
1656022260286,MATH 18,A01,083743,Cinel; Cameron Alexander,5,0,30,25
1656022260286,MATH 18,A02,083744,Cinel; Cameron Alexander,11,0,30,19
1656022260286,MATH 18,A03,083745,Cinel; Cameron Alexander,1,0,30,29
1656022260286,MATH 18,B01,083748,Ma; Zilu,0,0,36,36
1656022260286,MATH 18,B02,083749,Ma; Zilu,0,0,36,36
1656022260286,MATH 18,B03,083750,Ma; Zilu,0,0,36,36
1656022260286,MATH 18,B04,083751,Ma; Zilu,0,0,36,36
1656022260286,MATH 18,B05,093473,Staff,0,0,36,36
1656022260286,MATH 18,B06,093474,Staff,3,0,36,33
1656022266309,MATH 20A,A01,083754,Zheng; Zequn,10,0,40,30
1656022272336,MATH 20B,A01,083756,Briones; Jor-el Thomas Caparas,0,1,36,36
1656022272336,MATH 20B,A02,083757,Briones; Jor-el Thomas Caparas,1,0,36,35
1656022272336,MATH 20B,A03,093475,Staff,0,0,36,36
1656022278360,MATH 20C,A01,083760,Briones; Jor-el Thomas Caparas,0,2,35,35
1656022278360,MATH 20C,A02,083761,Briones; Jor-el Thomas Caparas,6,1,35,29
1656022278360,MATH 20C,A03,093476,Staff,0,0,35,35
1656022278360,MATH 20C,B01,083762,Bach; Quang Tran,3,0,30,27
1656022284388,MATH 20D,A01,083765,Tran; Brian Kha,2,0,30,28
1656022284388,MATH 20D,A02,083766,Tran; Brian Kha,0,1,30,30
1656022284388,MATH 20D,A03,083767,Tran; Brian Kha,1,0,30,29
1656022290416,MATH 20E,A01,083771,Ganguly; Soumya,0,1,32,32
1656022290416,MATH 20E,A02,083772,Ganguly; Soumya,1,1,32,31
1656022290416,MATH 20E,B01,083773,Ciotti; Benjamin,13,0,35,22
1656022290416,MATH 20E,B02,083774,Ciotti; Benjamin,12,0,35,23
1656022296447,MATH 103A,A01,083777,Greenfeld; Be'Eri,2,1,36,34
1656022296447,MATH 103A,A02,083778,Greenfeld; Be'Eri,1,0,36,35
1656022296447,MATH 103A,A03,093561,Staff,0,1,36,36
1656022296447,MATH 103A,B01,083779,Greenfeld; Be'Eri,8,1,36,28
1656022296447,MATH 103A,B02,083780,Greenfeld; Be'Eri,0,0,36,36
1656022296447,MATH 103A,B03,093562,Staff,0,0,36,36
1656022302470,MATH 105,A01,085443,Carter; Anne Toulson,4,1,35,31
1656022302470,MATH 105,A02,093477,Staff,9,0,35,26
1656022308502,MATH 109,A01,083213,Ganzberger; Geoffrey Michael,0,1,34,34
1656022308502,MATH 109,A02,083214,Ganzberger; Geoffrey Michael,0,0,34,34
1656022308502,MATH 109,A03,093478,Staff,1,0,34,33
1656022308502,MATH 109,B01,083215,Ganzberger; Geoffrey Michael,2,0,32,30
1656022308502,MATH 109,B02,083216,Ganzberger; Geoffrey Michael,0,0,32,32
1656022308502,MATH 109,B03,093479,Staff,3,0,32,29
1656022314525,MATH 142A,A01,083219,Chow; Bennett,1,0,32,31
1656022314525,MATH 142A,A02,083220,Chow; Bennett,7,0,32,25
1656022314525,MATH 142A,A03,093480,Staff,4,0,32,28
1656022314525,MATH 142A,B03,093481,Staff,3,0,32,29
1656022314525,MATH 142A,B04,093558,Staff,6,0,32,26
1656022314525,MATH 142A,B05,093559,Staff,0,0,32,32
1656022320547,MATH 193A,A01,083224,Rotar; Vladimir,1,2,34,33
1656022320547,MATH 193A,A02,083225,Rotar; Vladimir,0,1,34,34
1656022320547,MATH 193A,A03,083781,Rotar; Vladimir,2,0,34,32
1656022320547,MATH 193A,A04,083782,Rotar; Vladimir,3,0,34,31
1656022320547,MATH 193A,A05,093482,Rotar; Vladimir,0,0,34,34
1656022326577,MATH 197,001,091859,McAuley; Julian John,9999,0,9999,0
1656022326577,MATH 197,002,095566,Kedlaya; Kiran S.,9997,0,9999,2
1656022326577,MATH 197,003,095567,Xiao; Ming,9999,0,9999,0
1656022326577,MATH 197,004,095571,Perols; Johan Lars,9998,0,9999,1
1656022333640,COGS 9,A01,083615,Shannon; Kyle Michael,3,1,75,72
1656022339666,COGS 11,A01,083617,Boyle; Mary E. T.,11,1,48,37
1656022345691,COGS 13,A01,083071,Bastos; Amalia Pinkusfeld,4,2,71,67
1656022351714,COGS 14A,A01,092681,Semenuks; Arturs,4,25,100,96
1656022357741,COGS 14B,A01,083073,Cheng; Tzu-Han,7,0,63,56
1656022363773,COGS 17,A01,092677,Semenuks; Arturs,8,7,81,73
1656022369796,COGS 100,A01,083619,Allen; Michael Gordon,2,2,70,68
1656022375820,COGS 101A,A01,083621,Davis; Joshua Daniel,4,3,68,64
1656022381847,COGS 101B,A01,091572,Allen; Michael Gordon,0,0,65,65
1656022387887,COGS 101C,A01,083625,Delgado; Tania,7,0,35,28
1656022393913,COGS 107A,A01,083627,Boyle; Mary E. T.,1,2,60,59
1656022399939,COGS 118A,A01,083075,Gupta; Anjum,21,16,76,55
1656022405970,CSE 3,A50,083646,Miranda; Gregory Joseph,14,0,50,36
1656022412003,CSE 8A,A50,083650,Miranda; Gregory Joseph,4,11,56,52
1656022418028,CSE 11,A01,083080,Cao; Yingjun,0,65,40,40
1656022424052,CSE 12,A01,083652,Krause-Levy; Sophia Louisa,7,8,120,113
1656022430087,CSE 15L,A01,083654,Morris; Justin Loren,3,1,50,47
1656022430087,CSE 15L,A02,083655,Morris; Justin Loren,2,1,50,48
1656022436113,CSE 20,A01,083657,Tran; Khoa Dang,29,0,80,51
1656022442136,CSE 21,A01,095574,Bach; Quang Tran,23,0,48,25
1656022448176,CSE 30,A01,083084,Eldon; John,2,10,80,78
1656022448176,CSE 30,B01,095061,Bhaskar; Nishant,1,4,50,49
1656022454204,CSE 100,A01,083659,Cao; Yingjun,2,25,70,68
1656022460228,CSE 134B,A01,083661,Powell; Thomas Allan,6,6,100,94
1656022466256,CSE 140,A01,083663,Gungor; Onat,5,0,85,80
1656022472278,CSE 140L,A01,083088,Eldon; John,5,0,100,95
1656022478301,CSE 175,A01,083665,Kumar; Rakesh,0,0,25,25
1656022484324,CSE 190,A00,092507,Dubnov; Shlomo,1,0,20,19
1656022490351,ECE 45,A01,083139,Congero; Spencer William,0,1,75,75
1656022496382,ECE 65,A50,083695,Saad; Andrew S,6,0,30,24
1656022496382,ECE 65,A51,095125,Staff,23,0,26,3
1656022502404,ECE 109,A01,091882,Touri; Behrouz,3,5,70,67
1656022508427,ECE 180,A00,083140,Abi Samra; Nicholas Camill,1,0,30,29
1656022508427,ECE 180,B00,083141,Abi Samra; Nicholas Camill,0,8,28,28
1656022514455,MATH 10A,A01,083735,Patchell; Gregory David,0,0,30,30
1656022514455,MATH 10A,A02,083736,Patchell; Gregory David,21,0,30,9
1656022514455,MATH 10A,A03,083737,Patchell; Gregory David,16,0,30,14
1656022520485,MATH 10B,A01,083207,Lim; Seonhee,1,1,34,33
1656022520485,MATH 10B,A02,083208,Lim; Seonhee,1,1,35,34
1656022520485,MATH 10B,A03,093472,Staff,1,0,34,33
1656022520485,MATH 10B,B01,083739,Sinha; Shubham,9,0,30,21
1656022526518,MATH 18,A01,083743,Cinel; Cameron Alexander,5,0,30,25
1656022526518,MATH 18,A02,083744,Cinel; Cameron Alexander,11,0,30,19
1656022526518,MATH 18,A03,083745,Cinel; Cameron Alexander,1,0,30,29
1656022526518,MATH 18,B01,083748,Ma; Zilu,0,0,36,36
1656022526518,MATH 18,B02,083749,Ma; Zilu,0,0,36,36
1656022526518,MATH 18,B03,083750,Ma; Zilu,0,0,36,36
1656022526518,MATH 18,B04,083751,Ma; Zilu,0,0,36,36
1656022526518,MATH 18,B05,093473,Staff,0,0,36,36
1656022526518,MATH 18,B06,093474,Staff,3,0,36,33
1656022532545,MATH 20A,A01,083754,Zheng; Zequn,10,0,40,30
1656022538566,MATH 20B,A01,083756,Briones; Jor-el Thomas Caparas,0,1,36,36
1656022538566,MATH 20B,A02,083757,Briones; Jor-el Thomas Caparas,1,0,36,35
1656022538566,MATH 20B,A03,093475,Staff,0,0,36,36
1656022544590,MATH 20C,A01,083760,Briones; Jor-el Thomas Caparas,0,2,35,35
1656022544590,MATH 20C,A02,083761,Briones; Jor-el Thomas Caparas,6,1,35,29
1656022544590,MATH 20C,A03,093476,Staff,0,0,35,35
1656022544590,MATH 20C,B01,083762,Bach; Quang Tran,3,0,30,27
1656022550691,MATH 20D,A01,083765,Tran; Brian Kha,2,0,30,28
1656022550691,MATH 20D,A02,083766,Tran; Brian Kha,0,1,30,30
1656022550691,MATH 20D,A03,083767,Tran; Brian Kha,1,0,30,29
1656022556714,MATH 20E,A01,083771,Ganguly; Soumya,0,1,32,32
1656022556714,MATH 20E,A02,083772,Ganguly; Soumya,1,1,32,31
1656022556714,MATH 20E,B01,083773,Ciotti; Benjamin,13,0,35,22
1656022556714,MATH 20E,B02,083774,Ciotti; Benjamin,12,0,35,23
1656022562744,MATH 103A,A01,083777,Greenfeld; Be'Eri,2,1,36,34
1656022562744,MATH 103A,A02,083778,Greenfeld; Be'Eri,1,0,36,35
1656022562744,MATH 103A,A03,093561,Staff,0,1,36,36
1656022562744,MATH 103A,B01,083779,Greenfeld; Be'Eri,8,1,36,28
1656022562744,MATH 103A,B02,083780,Greenfeld; Be'Eri,0,0,36,36
1656022562744,MATH 103A,B03,093562,Staff,0,0,36,36
1656022568766,MATH 105,A01,085443,Carter; Anne Toulson,4,1,35,31
1656022568766,MATH 105,A02,093477,Staff,9,0,35,26
1656022574791,MATH 109,A01,083213,Ganzberger; Geoffrey Michael,0,1,34,34
1656022574791,MATH 109,A02,083214,Ganzberger; Geoffrey Michael,0,0,34,34
1656022574791,MATH 109,A03,093478,Staff,1,0,34,33
1656022574791,MATH 109,B01,083215,Ganzberger; Geoffrey Michael,2,0,32,30
1656022574791,MATH 109,B02,083216,Ganzberger; Geoffrey Michael,0,0,32,32
1656022574791,MATH 109,B03,093479,Staff,3,0,32,29
1656022580820,MATH 142A,A01,083219,Chow; Bennett,1,0,32,31
1656022580820,MATH 142A,A02,083220,Chow; Bennett,7,0,32,25
1656022580820,MATH 142A,A03,093480,Staff,4,0,32,28
1656022580820,MATH 142A,B03,093481,Staff,3,0,32,29
1656022580820,MATH 142A,B04,093558,Staff,6,0,32,26
1656022580820,MATH 142A,B05,093559,Staff,0,0,32,32
1656022586845,MATH 193A,A01,083224,Rotar; Vladimir,1,2,34,33
1656022586845,MATH 193A,A02,083225,Rotar; Vladimir,0,1,34,34
1656022586845,MATH 193A,A03,083781,Rotar; Vladimir,2,0,34,32
1656022586845,MATH 193A,A04,083782,Rotar; Vladimir,3,0,34,31
1656022586845,MATH 193A,A05,093482,Rotar; Vladimir,0,0,34,34
1656022592867,MATH 197,001,091859,McAuley; Julian John,9999,0,9999,0
1656022592867,MATH 197,002,095566,Kedlaya; Kiran S.,9997,0,9999,2
1656022592867,MATH 197,003,095567,Xiao; Ming,9999,0,9999,0
1656022592867,MATH 197,004,095571,Perols; Johan Lars,9998,0,9999,1
1656022599934,COGS 9,A01,083615,Shannon; Kyle Michael,3,1,75,72
1656022605960,COGS 11,A01,083617,Boyle; Mary E. T.,11,1,48,37
1656022611984,COGS 13,A01,083071,Bastos; Amalia Pinkusfeld,4,3,71,67
1656022618010,COGS 14A,A01,092681,Semenuks; Arturs,4,25,100,96
1656022624039,COGS 14B,A01,083073,Cheng; Tzu-Han,7,0,63,56
1656022630062,COGS 17,A01,092677,Semenuks; Arturs,8,7,81,73
1656022636088,COGS 100,A01,083619,Allen; Michael Gordon,2,2,70,68
1656022642113,COGS 101A,A01,083621,Davis; Joshua Daniel,4,3,68,64
1656022648135,COGS 101B,A01,091572,Allen; Michael Gordon,0,0,65,65
1656022654159,COGS 101C,A01,083625,Delgado; Tania,7,0,35,28
1656022660191,COGS 107A,A01,083627,Boyle; Mary E. T.,1,2,60,59
1656022666214,COGS 118A,A01,083075,Gupta; Anjum,21,16,76,55
1656022672242,CSE 3,A50,083646,Miranda; Gregory Joseph,14,0,50,36
1656022678271,CSE 8A,A50,083650,Miranda; Gregory Joseph,4,11,56,52
1656022684295,CSE 11,A01,083080,Cao; Yingjun,0,65,40,40
1656022690321,CSE 12,A01,083652,Krause-Levy; Sophia Louisa,7,8,120,113
1656022696346,CSE 15L,A01,083654,Morris; Justin Loren,3,1,50,47
1656022696346,CSE 15L,A02,083655,Morris; Justin Loren,2,1,50,48
1656022702372,CSE 20,A01,083657,Tran; Khoa Dang,29,0,80,51
1656022708405,CSE 21,A01,095574,Bach; Quang Tran,23,0,48,25
1656022714427,CSE 30,A01,083084,Eldon; John,2,10,80,78
1656022714427,CSE 30,B01,095061,Bhaskar; Nishant,1,4,50,49
1656022720455,CSE 100,A01,083659,Cao; Yingjun,2,25,70,68
1656022726478,CSE 134B,A01,083661,Powell; Thomas Allan,6,6,100,94
1656022732500,CSE 140,A01,083663,Gungor; Onat,5,0,85,80
1656022738524,CSE 140L,A01,083088,Eldon; John,5,0,100,95
1656022744553,CSE 175,A01,083665,Kumar; Rakesh,0,0,25,25
1656022750579,CSE 190,A00,092507,Dubnov; Shlomo,1,0,20,19
1656022756605,ECE 45,A01,083139,Congero; Spencer William,0,1,75,75
1656022762638,ECE 65,A50,083695,Saad; Andrew S,6,0,30,24
1656022762638,ECE 65,A51,095125,Staff,23,0,26,3
1656022768662,ECE 109,A01,091882,Touri; Behrouz,3,5,70,67
1656022774691,ECE 180,A00,083140,Abi Samra; Nicholas Camill,1,0,30,29
1656022774691,ECE 180,B00,083141,Abi Samra; Nicholas Camill,0,8,28,28
1656022780719,MATH 10A,A01,083735,Patchell; Gregory David,0,0,30,30
1656022780719,MATH 10A,A02,083736,Patchell; Gregory David,21,0,30,9
1656022780719,MATH 10A,A03,083737,Patchell; Gregory David,16,0,30,14
1656022786744,MATH 10B,A01,083207,Lim; Seonhee,1,1,34,33
1656022786744,MATH 10B,A02,083208,Lim; Seonhee,1,1,35,34
1656022786744,MATH 10B,A03,093472,Staff,1,0,34,33
1656022786744,MATH 10B,B01,083739,Sinha; Shubham,9,0,30,21
1656022792773,MATH 18,A01,083743,Cinel; Cameron Alexander,5,0,30,25
1656022792773,MATH 18,A02,083744,Cinel; Cameron Alexander,11,0,30,19
1656022792773,MATH 18,A03,083745,Cinel; Cameron Alexander,1,0,30,29
1656022792773,MATH 18,B01,083748,Ma; Zilu,0,0,36,36
1656022792773,MATH 18,B02,083749,Ma; Zilu,0,0,36,36
1656022792773,MATH 18,B03,083750,Ma; Zilu,0,0,36,36
1656022792773,MATH 18,B04,083751,Ma; Zilu,0,0,36,36
1656022792773,MATH 18,B05,093473,Staff,0,0,36,36
1656022792773,MATH 18,B06,093474,Staff,3,0,36,33
1656022798810,MATH 20A,A01,083754,Zheng; Zequn,10,0,40,30
1656022804833,MATH 20B,A01,083756,Briones; Jor-el Thomas Caparas,0,1,36,36
1656022804833,MATH 20B,A02,083757,Briones; Jor-el Thomas Caparas,1,0,36,35
1656022804833,MATH 20B,A03,093475,Staff,0,0,36,36
1656022810857,MATH 20C,A01,083760,Briones; Jor-el Thomas Caparas,0,2,35,35
1656022810857,MATH 20C,A02,083761,Briones; Jor-el Thomas Caparas,6,1,35,29
1656022810857,MATH 20C,A03,093476,Staff,0,0,35,35
1656022810857,MATH 20C,B01,083762,Bach; Quang Tran,3,0,30,27
1656022816882,MATH 20D,A01,083765,Tran; Brian Kha,2,0,30,28
1656022816882,MATH 20D,A02,083766,Tran; Brian Kha,0,1,30,30
1656022816882,MATH 20D,A03,083767,Tran; Brian Kha,1,0,30,29
1656022822904,MATH 20E,A01,083771,Ganguly; Soumya,0,1,32,32
1656022822904,MATH 20E,A02,083772,Ganguly; Soumya,1,1,32,31
1656022822904,MATH 20E,B01,083773,Ciotti; Benjamin,13,0,35,22
1656022822904,MATH 20E,B02,083774,Ciotti; Benjamin,12,0,35,23
1656022828934,MATH 103A,A01,083777,Greenfeld; Be'Eri,2,1,36,34
1656022828934,MATH 103A,A02,083778,Greenfeld; Be'Eri,1,0,36,35
1656022828934,MATH 103A,A03,093561,Staff,0,1,36,36
1656022828934,MATH 103A,B01,083779,Greenfeld; Be'Eri,8,1,36,28
1656022828934,MATH 103A,B02,083780,Greenfeld; Be'Eri,0,0,36,36
1656022828934,MATH 103A,B03,093562,Staff,0,0,36,36
1656022834957,MATH 105,A01,085443,Carter; Anne Toulson,4,1,35,31
1656022834957,MATH 105,A02,093477,Staff,9,0,35,26
1656022840980,MATH 109,A01,083213,Ganzberger; Geoffrey Michael,0,1,34,34
1656022840980,MATH 109,A02,083214,Ganzberger; Geoffrey Michael,0,0,34,34
1656022840980,MATH 109,A03,093478,Staff,1,0,34,33
1656022840980,MATH 109,B01,083215,Ganzberger; Geoffrey Michael,2,0,32,30
1656022840980,MATH 109,B02,083216,Ganzberger; Geoffrey Michael,0,0,32,32
1656022840980,MATH 109,B03,093479,Staff,3,0,32,29
1656022847004,MATH 142A,A01,083219,Chow; Bennett,1,0,32,31
1656022847004,MATH 142A,A02,083220,Chow; Bennett,7,0,32,25
1656022847004,MATH 142A,A03,093480,Staff,4,0,32,28
1656022847004,MATH 142A,B03,093481,Staff,3,0,32,29
1656022847004,MATH 142A,B04,093558,Staff,6,0,32,26
1656022847004,MATH 142A,B05,093559,Staff,0,0,32,32
1656022853027,MATH 193A,A01,083224,Rotar; Vladimir,1,2,34,33
1656022853027,MATH 193A,A02,083225,Rotar; Vladimir,0,1,34,34
1656022853027,MATH 193A,A03,083781,Rotar; Vladimir,2,0,34,32
1656022853027,MATH 193A,A04,083782,Rotar; Vladimir,3,0,34,31
1656022853027,MATH 193A,A05,093482,Rotar; Vladimir,0,0,34,34
1656022859056,MATH 197,001,091859,McAuley; Julian John,9999,0,9999,0
1656022859056,MATH 197,002,095566,Kedlaya; Kiran S.,9997,0,9999,2
1656022859056,MATH 197,003,095567,Xiao; Ming,9999,0,9999,0
1656022859056,MATH 197,004,095571,Perols; Johan Lars,9998,0,9999,1
1656022866109,COGS 9,A01,083615,Shannon; Kyle Michael,3,1,75,72
1656022872133,COGS 11,A01,083617,Boyle; Mary E. T.,11,1,48,37
1656022878159,COGS 13,A01,083071,Bastos; Amalia Pinkusfeld,4,3,71,67
1656022884181,COGS 14A,A01,092681,Semenuks; Arturs,4,25,100,96
1656022890204,COGS 14B,A01,083073,Cheng; Tzu-Han,7,0,63,56
1656022896232,COGS 17,A01,092677,Semenuks; Arturs,8,7,81,73
1656022902255,COGS 100,A01,083619,Allen; Michael Gordon,2,2,70,68
1656022908278,COGS 101A,A01,083621,Davis; Joshua Daniel,4,3,68,64
1656022914301,COGS 101B,A01,091572,Allen; Michael Gordon,0,0,65,65
1656022920325,COGS 101C,A01,083625,Delgado; Tania,7,0,35,28
1656022926354,COGS 107A,A01,083627,Boyle; Mary E. T.,1,2,60,59
1656022932391,COGS 118A,A01,083075,Gupta; Anjum,21,16,76,55
1656022938419,CSE 3,A50,083646,Miranda; Gregory Joseph,14,0,50,36
1656022944447,CSE 8A,A50,083650,Miranda; Gregory Joseph,4,11,56,52
1656022950481,CSE 11,A01,083080,Cao; Yingjun,0,65,40,40
1656022956515,CSE 12,A01,083652,Krause-Levy; Sophia Louisa,7,8,120,113
1656022962543,CSE 15L,A01,083654,Morris; Justin Loren,3,1,50,47
1656022962543,CSE 15L,A02,083655,Morris; Justin Loren,2,1,50,48
1656022968566,CSE 20,A01,083657,Tran; Khoa Dang,29,0,80,51
1656022974612,CSE 21,A01,095574,Bach; Quang Tran,23,0,48,25
1656022980637,CSE 30,A01,083084,Eldon; John,2,10,80,78
1656022980637,CSE 30,B01,095061,Bhaskar; Nishant,1,4,50,49
1656022986660,CSE 100,A01,083659,Cao; Yingjun,2,25,70,68
1656022992686,CSE 134B,A01,083661,Powell; Thomas Allan,6,6,100,94
1656022998725,CSE 140,A01,083663,Gungor; Onat,5,0,85,80
1656023004747,CSE 140L,A01,083088,Eldon; John,5,0,100,95
1656023010782,CSE 175,A01,083665,Kumar; Rakesh,0,0,25,25
1656023016806,CSE 190,A00,092507,Dubnov; Shlomo,1,0,20,19
1656023022833,ECE 45,A01,083139,Congero; Spencer William,0,1,75,75
1656023028862,ECE 65,A50,083695,Saad; Andrew S,6,0,30,24
1656023028862,ECE 65,A51,095125,Staff,23,0,26,3
1656023034897,ECE 109,A01,091882,Touri; Behrouz,3,5,70,67
1656023040924,ECE 180,A00,083140,Abi Samra; Nicholas Camill,1,0,30,29
1656023040924,ECE 180,B00,083141,Abi Samra; Nicholas Camill,0,8,28,28
1656023046947,MATH 10A,A01,083735,Patchell; Gregory David,0,0,30,30
1656023046947,MATH 10A,A02,083736,Patchell; Gregory David,21,0,30,9
1656023046947,MATH 10A,A03,083737,Patchell; Gregory David,16,0,30,14
1656023052970,MATH 10B,A01,083207,Lim; Seonhee,1,1,34,33
1656023052970,MATH 10B,A02,083208,Lim; Seonhee,1,1,35,34
1656023052970,MATH 10B,A03,093472,Staff,1,0,34,33
1656023052970,MATH 10B,B01,083739,Sinha; Shubham,9,0,30,21
1656023059002,MATH 18,A01,083743,Cinel; Cameron Alexander,5,0,30,25
1656023059002,MATH 18,A02,083744,Cinel; Cameron Alexander,11,0,30,19
1656023059002,MATH 18,A03,083745,Cinel; Cameron Alexander,1,0,30,29
1656023059002,MATH 18,B01,083748,Ma; Zilu,0,0,36,36
1656023059002,MATH 18,B02,083749,Ma; Zilu,0,0,36,36
1656023059002,MATH 18,B03,083750,Ma; Zilu,0,0,36,36
1656023059002,MATH 18,B04,083751,Ma; Zilu,0,0,36,36
1656023059002,MATH 18,B05,093473,Staff,0,0,36,36
1656023059002,MATH 18,B06,093474,Staff,3,0,36,33
1656023065032,MATH 20A,A01,083754,Zheng; Zequn,10,0,40,30
1656023071056,MATH 20B,A01,083756,Briones; Jor-el Thomas Caparas,0,1,36,36
1656023071056,MATH 20B,A02,083757,Briones; Jor-el Thomas Caparas,1,0,36,35
1656023071056,MATH 20B,A03,093475,Staff,0,0,36,36
1656023077082,MATH 20C,A01,083760,Briones; Jor-el Thomas Caparas,0,2,35,35
1656023077082,MATH 20C,A02,083761,Briones; Jor-el Thomas Caparas,6,1,35,29
1656023077082,MATH 20C,A03,093476,Staff,0,0,35,35
1656023077082,MATH 20C,B01,083762,Bach; Quang Tran,3,0,30,27
1656023083106,MATH 20D,A01,083765,Tran; Brian Kha,2,0,30,28
1656023083106,MATH 20D,A02,083766,Tran; Brian Kha,0,1,30,30
1656023083106,MATH 20D,A03,083767,Tran; Brian Kha,1,0,30,29
1656023089138,MATH 20E,A01,083771,Ganguly; Soumya,0,1,32,32
1656023089138,MATH 20E,A02,083772,Ganguly; Soumya,1,1,32,31
1656023089138,MATH 20E,B01,083773,Ciotti; Benjamin,13,0,35,22
1656023089138,MATH 20E,B02,083774,Ciotti; Benjamin,12,0,35,23
1656023095168,MATH 103A,A01,083777,Greenfeld; Be'Eri,2,1,36,34
1656023095168,MATH 103A,A02,083778,Greenfeld; Be'Eri,1,0,36,35
1656023095168,MATH 103A,A03,093561,Staff,0,1,36,36
1656023095168,MATH 103A,B01,083779,Greenfeld; Be'Eri,8,1,36,28
1656023095168,MATH 103A,B02,083780,Greenfeld; Be'Eri,0,0,36,36
1656023095168,MATH 103A,B03,093562,Staff,0,0,36,36
1656023101251,MATH 105,A01,085443,Carter; Anne Toulson,4,1,35,31
1656023101251,MATH 105,A02,093477,Staff,9,0,35,26
1656023107274,MATH 109,A01,083213,Ganzberger; Geoffrey Michael,0,1,34,34
1656023107274,MATH 109,A02,083214,Ganzberger; Geoffrey Michael,0,0,34,34
1656023107274,MATH 109,A03,093478,Staff,1,0,34,33
1656023107274,MATH 109,B01,083215,Ganzberger; Geoffrey Michael,2,0,32,30
1656023107274,MATH 109,B02,083216,Ganzberger; Geoffrey Michael,0,0,32,32
1656023107274,MATH 109,B03,093479,Staff,3,0,32,29
1656023113311,MATH 142A,A01,083219,Chow; Bennett,1,0,32,31
1656023113311,MATH 142A,A02,083220,Chow; Bennett,7,0,32,25
1656023113311,MATH 142A,A03,093480,Staff,4,0,32,28
1656023113311,MATH 142A,B03,093481,Staff,3,0,32,29
1656023113311,MATH 142A,B04,093558,Staff,6,0,32,26
1656023113311,MATH 142A,B05,093559,Staff,0,0,32,32
1656023119343,MATH 193A,A01,083224,Rotar; Vladimir,1,2,34,33
1656023119343,MATH 193A,A02,083225,Rotar; Vladimir,0,1,34,34
1656023119343,MATH 193A,A03,083781,Rotar; Vladimir,2,0,34,32
1656023119343,MATH 193A,A04,083782,Rotar; Vladimir,3,0,34,31
1656023119343,MATH 193A,A05,093482,Rotar; Vladimir,0,0,34,34
1656023125367,MATH 197,001,091859,McAuley; Julian John,9999,0,9999,0
1656023125367,MATH 197,002,095566,Kedlaya; Kiran S.,9997,0,9999,2
1656023125367,MATH 197,003,095567,Xiao; Ming,9999,0,9999,0
1656023125367,MATH 197,004,095571,Perols; Johan Lars,9998,0,9999,1
1656023132424,COGS 9,A01,083615,Shannon; Kyle Michael,3,1,75,72
1656023138451,COGS 11,A01,083617,Boyle; Mary E. T.,11,1,48,37
1656023144563,COGS 13,A01,083071,Bastos; Amalia Pinkusfeld,4,3,71,67
1656023150589,COGS 14A,A01,092681,Semenuks; Arturs,4,25,100,96
1656023156619,COGS 14B,A01,083073,Cheng; Tzu-Han,7,0,63,56
1656023162642,COGS 17,A01,092677,Semenuks; Arturs,8,7,81,73
1656023168665,COGS 100,A01,083619,Allen; Michael Gordon,2,2,70,68
1656023174688,COGS 101A,A01,083621,Davis; Joshua Daniel,4,3,68,64
1656023180712,COGS 101B,A01,091572,Allen; Michael Gordon,0,0,65,65
1656023186737,COGS 101C,A01,083625,Delgado; Tania,7,0,35,28
1656023192760,COGS 107A,A01,083627,Boyle; Mary E. T.,1,2,60,59
1656023198786,COGS 118A,A01,083075,Gupta; Anjum,21,16,76,55
1656023204810,CSE 3,A50,083646,Miranda; Gregory Joseph,14,0,50,36
1656023210835,CSE 8A,A50,083650,Miranda; Gregory Joseph,4,11,56,52
1656023216859,CSE 11,A01,083080,Cao; Yingjun,0,65,40,40
1656023222883,CSE 12,A01,083652,Krause-Levy; Sophia Louisa,7,8,120,113
1656023228908,CSE 15L,A01,083654,Morris; Justin Loren,3,1,50,47
1656023228908,CSE 15L,A02,083655,Morris; Justin Loren,2,1,50,48
1656023234936,CSE 20,A01,083657,Tran; Khoa Dang,29,0,80,51
1656023240960,CSE 21,A01,095574,Bach; Quang Tran,23,0,48,25
1656023246990,CSE 30,A01,083084,Eldon; John,2,10,80,78
1656023246990,CSE 30,B01,095061,Bhaskar; Nishant,1,4,50,49
1656023253014,CSE 100,A01,083659,Cao; Yingjun,2,25,70,68
1656023259055,CSE 134B,A01,083661,Powell; Thomas Allan,6,6,100,94
1656023265078,CSE 140,A01,083663,Gungor; Onat,5,0,85,80
1656023271107,CSE 140L,A01,083088,Eldon; John,5,0,100,95
1656023277131,CSE 175,A01,083665,Kumar; Rakesh,0,0,25,25
1656023283155,CSE 190,A00,092507,Dubnov; Shlomo,1,0,20,19
1656023289186,ECE 45,A01,083139,Congero; Spencer William,0,1,75,75
1656023295210,ECE 65,A50,083695,Saad; Andrew S,6,0,30,24
1656023295210,ECE 65,A51,095125,Staff,23,0,26,3
1656023301237,ECE 109,A01,091882,Touri; Behrouz,3,5,70,67
1656023307264,ECE 180,A00,083140,Abi Samra; Nicholas Camill,1,0,30,29
1656023307264,ECE 180,B00,083141,Abi Samra; Nicholas Camill,0,8,28,28
1656023313287,MATH 10A,A01,083735,Patchell; Gregory David,0,0,30,30
1656023313287,MATH 10A,A02,083736,Patchell; Gregory David,21,0,30,9
1656023313287,MATH 10A,A03,083737,Patchell; Gregory David,16,0,30,14
1656023319331,MATH 10B,A01,083207,Lim; Seonhee,1,1,34,33
1656023319331,MATH 10B,A02,083208,Lim; Seonhee,1,1,35,34
1656023319331,MATH 10B,A03,093472,Staff,1,0,34,33
1656023319331,MATH 10B,B01,083739,Sinha; Shubham,9,0,30,21
1656023325357,MATH 18,A01,083743,Cinel; Cameron Alexander,5,0,30,25
1656023325357,MATH 18,A02,083744,Cinel; Cameron Alexander,11,0,30,19
1656023325357,MATH 18,A03,083745,Cinel; Cameron Alexander,1,0,30,29
1656023325357,MATH 18,B01,083748,Ma; Zilu,0,0,36,36
1656023325357,MATH 18,B02,083749,Ma; Zilu,0,0,36,36
1656023325357,MATH 18,B03,083750,Ma; Zilu,0,0,36,36
1656023325357,MATH 18,B04,083751,Ma; Zilu,0,0,36,36
1656023325357,MATH 18,B05,093473,Staff,0,0,36,36
1656023325357,MATH 18,B06,093474,Staff,3,0,36,33
1656023331394,MATH 20A,A01,083754,Zheng; Zequn,10,0,40,30
1656023337418,MATH 20B,A01,083756,Briones; Jor-el Thomas Caparas,0,1,36,36
1656023337418,MATH 20B,A02,083757,Briones; Jor-el Thomas Caparas,1,0,36,35
1656023337418,MATH 20B,A03,093475,Staff,0,0,36,36
1656023343447,MATH 20C,A01,083760,Briones; Jor-el Thomas Caparas,0,2,35,35
1656023343447,MATH 20C,A02,083761,Briones; Jor-el Thomas Caparas,6,1,35,29
1656023343447,MATH 20C,A03,093476,Staff,0,0,35,35
1656023343447,MATH 20C,B01,083762,Bach; Quang Tran,3,0,30,27
1656023349473,MATH 20D,A01,083765,Tran; Brian Kha,2,0,30,28
1656023349473,MATH 20D,A02,083766,Tran; Brian Kha,0,1,30,30
1656023349473,MATH 20D,A03,083767,Tran; Brian Kha,1,0,30,29
1656023355495,MATH 20E,A01,083771,Ganguly; Soumya,0,1,32,32
1656023355495,MATH 20E,A02,083772,Ganguly; Soumya,1,1,32,31
1656023355495,MATH 20E,B01,083773,Ciotti; Benjamin,13,0,35,22
1656023355495,MATH 20E,B02,083774,Ciotti; Benjamin,12,0,35,23
1656023361523,MATH 103A,A01,083777,Greenfeld; Be'Eri,2,1,36,34
1656023361523,MATH 103A,A02,083778,Greenfeld; Be'Eri,1,0,36,35
1656023361523,MATH 103A,A03,093561,Staff,0,1,36,36
1656023361523,MATH 103A,B01,083779,Greenfeld; Be'Eri,8,1,36,28
1656023361523,MATH 103A,B02,083780,Greenfeld; Be'Eri,0,0,36,36
1656023361523,MATH 103A,B03,093562,Staff,0,0,36,36
1656023367551,MATH 105,A01,085443,Carter; Anne Toulson,4,1,35,31
1656023367551,MATH 105,A02,093477,Staff,9,0,35,26
1656023373578,MATH 109,A01,083213,Ganzberger; Geoffrey Michael,0,1,34,34
1656023373578,MATH 109,A02,083214,Ganzberger; Geoffrey Michael,0,0,34,34
1656023373578,MATH 109,A03,093478,Staff,1,0,34,33
1656023373578,MATH 109,B01,083215,Ganzberger; Geoffrey Michael,2,0,32,30
1656023373578,MATH 109,B02,083216,Ganzberger; Geoffrey Michael,0,0,32,32
1656023373578,MATH 109,B03,093479,Staff,3,0,32,29
1656023379603,MATH 142A,A01,083219,Chow; Bennett,1,0,32,31
1656023379603,MATH 142A,A02,083220,Chow; Bennett,7,0,32,25
1656023379603,MATH 142A,A03,093480,Staff,4,0,32,28
1656023379603,MATH 142A,B03,093481,Staff,3,0,32,29
1656023379603,MATH 142A,B04,093558,Staff,6,0,32,26
1656023379603,MATH 142A,B05,093559,Staff,0,0,32,32
1656023385627,MATH 193A,A01,083224,Rotar; Vladimir,1,2,34,33
1656023385627,MATH 193A,A02,083225,Rotar; Vladimir,0,1,34,34
1656023385627,MATH 193A,A03,083781,Rotar; Vladimir,2,0,34,32
1656023385627,MATH 193A,A04,083782,Rotar; Vladimir,3,0,34,31
1656023385627,MATH 193A,A05,093482,Rotar; Vladimir,0,0,34,34
1656023391653,MATH 197,001,091859,McAuley; Julian John,9999,0,9999,0
1656023391653,MATH 197,002,095566,Kedlaya; Kiran S.,9997,0,9999,2
1656023391653,MATH 197,003,095567,Xiao; Ming,9999,0,9999,0
1656023391653,MATH 197,004,095571,Perols; Johan Lars,9998,0,9999,1
1656023398724,COGS 9,A01,083615,Shannon; Kyle Michael,3,1,75,72
1656023404755,COGS 11,A01,083617,Boyle; Mary E. T.,11,1,48,37
1656023410789,COGS 13,A01,083071,Bastos; Amalia Pinkusfeld,4,3,71,67
1656023416812,COGS 14A,A01,092681,Semenuks; Arturs,4,25,100,96
1656023422844,COGS 14B,A01,083073,Cheng; Tzu-Han,7,0,63,56
1656023428877,COGS 17,A01,092677,Semenuks; Arturs,8,7,81,73
1656023434901,COGS 100,A01,083619,Allen; Michael Gordon,2,2,70,68
1656023440931,COGS 101A,A01,083621,Davis; Joshua Daniel,4,3,68,64
1656023446954,COGS 101B,A01,091572,Allen; Michael Gordon,0,0,65,65
1656023452985,COGS 101C,A01,083625,Delgado; Tania,7,0,35,28
1656023459015,COGS 107A,A01,083627,Boyle; Mary E. T.,1,2,60,59
1656023465039,COGS 118A,A01,083075,Gupta; Anjum,21,16,76,55
1656023471074,CSE 3,A50,083646,Miranda; Gregory Joseph,14,0,50,36
1656023477097,CSE 8A,A50,083650,Miranda; Gregory Joseph,4,11,56,52
1656023483123,CSE 11,A01,083080,Cao; Yingjun,0,65,40,40
1656023489153,CSE 12,A01,083652,Krause-Levy; Sophia Louisa,7,8,120,113
1656023495178,CSE 15L,A01,083654,Morris; Justin Loren,3,1,50,47
1656023495178,CSE 15L,A02,083655,Morris; Justin Loren,2,1,50,48
1656023501202,CSE 20,A01,083657,Tran; Khoa Dang,29,0,80,51
1656023507226,CSE 21,A01,095574,Bach; Quang Tran,23,0,48,25
1656023513250,CSE 30,A01,083084,Eldon; John,2,10,80,78
1656023513250,CSE 30,B01,095061,Bhaskar; Nishant,1,4,50,49
1656023519277,CSE 100,A01,083659,Cao; Yingjun,2,25,70,68
1656023525311,CSE 134B,A01,083661,Powell; Thomas Allan,6,6,100,94
1656023531336,CSE 140,A01,083663,Gungor; Onat,5,0,85,80
1656023537361,CSE 140L,A01,083088,Eldon; John,5,0,100,95
1656023543387,CSE 175,A01,083665,Kumar; Rakesh,0,0,25,25
1656023549415,CSE 190,A00,092507,Dubnov; Shlomo,1,0,20,19
1656023555456,ECE 45,A01,083139,Congero; Spencer William,0,1,75,75
1656023561484,ECE 65,A50,083695,Saad; Andrew S,6,0,30,24
1656023561484,ECE 65,A51,095125,Staff,23,0,26,3
1656023567512,ECE 109,A01,091882,Touri; Behrouz,3,5,70,67
1656023573533,ECE 180,A00,083140,Abi Samra; Nicholas Camill,1,0,30,29
1656023573533,ECE 180,B00,083141,Abi Samra; Nicholas Camill,0,8,28,28
1656023579562,MATH 10A,A01,083735,Patchell; Gregory David,0,0,30,30
1656023579562,MATH 10A,A02,083736,Patchell; Gregory David,20,0,30,10
1656023579562,MATH 10A,A03,083737,Patchell; Gregory David,16,0,30,14
1656023585592,MATH 10B,A01,083207,Lim; Seonhee,1,1,34,33
1656023585592,MATH 10B,A02,083208,Lim; Seonhee,1,1,35,34
1656023585592,MATH 10B,A03,093472,Staff,1,0,34,33
1656023585592,MATH 10B,B01,083739,Sinha; Shubham,9,0,30,21
1656023591624,MATH 18,A01,083743,Cinel; Cameron Alexander,5,0,30,25
1656023591624,MATH 18,A02,083744,Cinel; Cameron Alexander,11,0,30,19
1656023591624,MATH 18,A03,083745,Cinel; Cameron Alexander,1,0,30,29
1656023591624,MATH 18,B01,083748,Ma; Zilu,0,0,36,36
1656023591624,MATH 18,B02,083749,Ma; Zilu,0,0,36,36
1656023591624,MATH 18,B03,083750,Ma; Zilu,0,0,36,36
1656023591624,MATH 18,B04,083751,Ma; Zilu,0,0,36,36
1656023591624,MATH 18,B05,093473,Staff,0,0,36,36
1656023591624,MATH 18,B06,093474,Staff,3,0,36,33
1656023597645,MATH 20A,A01,083754,Zheng; Zequn,11,0,40,29
1656023603671,MATH 20B,A01,083756,Briones; Jor-el Thomas Caparas,0,1,36,36
1656023603671,MATH 20B,A02,083757,Briones; Jor-el Thomas Caparas,1,0,36,35
1656023603671,MATH 20B,A03,093475,Staff,0,0,36,36
1656023609700,MATH 20C,A01,083760,Briones; Jor-el Thomas Caparas,0,2,35,35
1656023609700,MATH 20C,A02,083761,Briones; Jor-el Thomas Caparas,6,1,35,29
1656023609700,MATH 20C,A03,093476,Staff,0,0,35,35
1656023609700,MATH 20C,B01,083762,Bach; Quang Tran,3,0,30,27
1656023615733,MATH 20D,A01,083765,Tran; Brian Kha,2,0,30,28
1656023615733,MATH 20D,A02,083766,Tran; Brian Kha,0,1,30,30
1656023615733,MATH 20D,A03,083767,Tran; Brian Kha,1,0,30,29
1656023621763,MATH 20E,A01,083771,Ganguly; Soumya,0,1,32,32
1656023621763,MATH 20E,A02,083772,Ganguly; Soumya,1,1,32,31
1656023621763,MATH 20E,B01,083773,Ciotti; Benjamin,13,0,35,22
1656023621763,MATH 20E,B02,083774,Ciotti; Benjamin,12,0,35,23
1656023627801,MATH 103A,A01,083777,Greenfeld; Be'Eri,2,1,36,34
1656023627801,MATH 103A,A02,083778,Greenfeld; Be'Eri,1,0,36,35
1656023627801,MATH 103A,A03,093561,Staff,0,1,36,36
1656023627801,MATH 103A,B01,083779,Greenfeld; Be'Eri,8,1,36,28
1656023627801,MATH 103A,B02,083780,Greenfeld; Be'Eri,0,0,36,36
1656023627801,MATH 103A,B03,093562,Staff,0,0,36,36
1656023633824,MATH 105,A01,085443,Carter; Anne Toulson,4,1,35,31
1656023633824,MATH 105,A02,093477,Staff,9,0,35,26
1656023639853,MATH 109,A01,083213,Ganzberger; Geoffrey Michael,0,1,34,34
1656023639853,MATH 109,A02,083214,Ganzberger; Geoffrey Michael,0,0,34,34
1656023639853,MATH 109,A03,093478,Staff,1,0,34,33
1656023639853,MATH 109,B01,083215,Ganzberger; Geoffrey Michael,2,0,32,30
1656023639853,MATH 109,B02,083216,Ganzberger; Geoffrey Michael,0,0,32,32
1656023639853,MATH 109,B03,093479,Staff,3,0,32,29
1656023645878,MATH 142A,A01,083219,Chow; Bennett,1,0,32,31
1656023645878,MATH 142A,A02,083220,Chow; Bennett,7,0,32,25
1656023645878,MATH 142A,A03,093480,Staff,4,0,32,28
1656023645878,MATH 142A,B03,093481,Staff,3,0,32,29
1656023645878,MATH 142A,B04,093558,Staff,6,0,32,26
1656023645878,MATH 142A,B05,093559,Staff,0,0,32,32
1656023651906,MATH 193A,A01,083224,Rotar; Vladimir,1,2,34,33
1656023651906,MATH 193A,A02,083225,Rotar; Vladimir,0,1,34,34
1656023651906,MATH 193A,A03,083781,Rotar; Vladimir,2,0,34,32
1656023651906,MATH 193A,A04,083782,Rotar; Vladimir,3,0,34,31
1656023651906,MATH 193A,A05,093482,Rotar; Vladimir,0,0,34,34
1656023657930,MATH 197,001,091859,McAuley; Julian John,9999,0,9999,0
1656023657930,MATH 197,002,095566,Kedlaya; Kiran S.,9997,0,9999,2
1656023657930,MATH 197,003,095567,Xiao; Ming,9999,0,9999,0
1656023657930,MATH 197,004,095571,Perols; Johan Lars,9998,0,9999,1
1656023664993,COGS 9,A01,083615,Shannon; Kyle Michael,3,1,75,72
1656023671021,COGS 11,A01,083617,Boyle; Mary E. T.,11,1,48,37
1656023677045,COGS 13,A01,083071,Bastos; Amalia Pinkusfeld,4,3,71,67
1656023683068,COGS 14A,A01,092681,Semenuks; Arturs,4,25,100,96
1656023689099,COGS 14B,A01,083073,Cheng; Tzu-Han,7,0,63,56
1656023695136,COGS 17,A01,092677,Semenuks; Arturs,8,7,81,73
1656023701159,COGS 100,A01,083619,Allen; Michael Gordon,2,2,70,68
1656023707186,COGS 101A,A01,083621,Davis; Joshua Daniel,4,3,68,64
1656023713208,COGS 101B,A01,091572,Allen; Michael Gordon,0,0,65,65
1656023719237,COGS 101C,A01,083625,Delgado; Tania,7,0,35,28
1656023725260,COGS 107A,A01,083627,Boyle; Mary E. T.,1,2,60,59
1656023731286,COGS 118A,A01,083075,Gupta; Anjum,21,16,76,55
1656023737323,CSE 3,A50,083646,Miranda; Gregory Joseph,14,0,50,36
1656023743457,CSE 8A,A50,083650,Miranda; Gregory Joseph,4,11,56,52
1656023749483,CSE 11,A01,083080,Cao; Yingjun,0,65,40,40
1656023755505,CSE 12,A01,083652,Krause-Levy; Sophia Louisa,7,8,120,113
1656023761531,CSE 15L,A01,083654,Morris; Justin Loren,3,1,50,47
1656023761531,CSE 15L,A02,083655,Morris; Justin Loren,2,1,50,48
1656023767554,CSE 20,A01,083657,Tran; Khoa Dang,29,0,80,51
1656023773577,CSE 21,A01,095574,Bach; Quang Tran,23,0,48,25
1656023779607,CSE 30,A01,083084,Eldon; John,2,10,80,78
1656023779607,CSE 30,B01,095061,Bhaskar; Nishant,1,4,50,49
1656023785632,CSE 100,A01,083659,Cao; Yingjun,2,25,70,68
1656023791654,CSE 134B,A01,083661,Powell; Thomas Allan,6,6,100,94
1656023797681,CSE 140,A01,083663,Gungor; Onat,5,0,85,80
1656023803703,CSE 140L,A01,083088,Eldon; John,5,0,100,95
1656023809727,CSE 175,A01,083665,Kumar; Rakesh,0,0,25,25
1656023815754,CSE 190,A00,092507,Dubnov; Shlomo,1,0,20,19
1656023821777,ECE 45,A01,083139,Congero; Spencer William,0,1,75,75
1656023827802,ECE 65,A50,083695,Saad; Andrew S,6,0,30,24
1656023827802,ECE 65,A51,095125,Staff,23,0,26,3
1656023833825,ECE 109,A01,091882,Touri; Behrouz,3,5,70,67
1656023839852,ECE 180,A00,083140,Abi Samra; Nicholas Camill,1,0,30,29
1656023839852,ECE 180,B00,083141,Abi Samra; Nicholas Camill,0,8,28,28
1656023845883,MATH 10A,A01,083735,Patchell; Gregory David,0,0,30,30
1656023845883,MATH 10A,A02,083736,Patchell; Gregory David,20,0,30,10
1656023845883,MATH 10A,A03,083737,Patchell; Gregory David,16,0,30,14
1656023851907,MATH 10B,A01,083207,Lim; Seonhee,1,1,34,33
1656023851907,MATH 10B,A02,083208,Lim; Seonhee,1,1,35,34
1656023851907,MATH 10B,A03,093472,Staff,1,0,34,33
1656023851907,MATH 10B,B01,083739,Sinha; Shubham,9,0,30,21
1656023857939,MATH 18,A01,083743,Cinel; Cameron Alexander,5,0,30,25
1656023857939,MATH 18,A02,083744,Cinel; Cameron Alexander,11,0,30,19
1656023857939,MATH 18,A03,083745,Cinel; Cameron Alexander,1,0,30,29
1656023857939,MATH 18,B01,083748,Ma; Zilu,0,0,36,36
1656023857939,MATH 18,B02,083749,Ma; Zilu,0,0,36,36
1656023857939,MATH 18,B03,083750,Ma; Zilu,0,0,36,36
1656023857939,MATH 18,B04,083751,Ma; Zilu,0,0,36,36
1656023857939,MATH 18,B05,093473,Staff,0,0,36,36
1656023857939,MATH 18,B06,093474,Staff,3,0,36,33
1656023863969,MATH 20A,A01,083754,Zheng; Zequn,11,0,40,29
1656023870002,MATH 20B,A01,083756,Briones; Jor-el Thomas Caparas,0,1,36,36
1656023870002,MATH 20B,A02,083757,Briones; Jor-el Thomas Caparas,1,0,36,35
1656023870002,MATH 20B,A03,093475,Staff,0,0,36,36
1656023876027,MATH 20C,A01,083760,Briones; Jor-el Thomas Caparas,0,2,35,35
1656023876027,MATH 20C,A02,083761,Briones; Jor-el Thomas Caparas,6,1,35,29
1656023876027,MATH 20C,A03,093476,Staff,0,0,35,35
1656023876027,MATH 20C,B01,083762,Bach; Quang Tran,3,0,30,27
1656023882055,MATH 20D,A01,083765,Tran; Brian Kha,2,0,30,28
1656023882055,MATH 20D,A02,083766,Tran; Brian Kha,0,1,30,30
1656023882055,MATH 20D,A03,083767,Tran; Brian Kha,1,0,30,29
1656023888083,MATH 20E,A01,083771,Ganguly; Soumya,0,1,32,32
1656023888083,MATH 20E,A02,083772,Ganguly; Soumya,1,1,32,31
1656023888083,MATH 20E,B01,083773,Ciotti; Benjamin,13,0,35,22
1656023888083,MATH 20E,B02,083774,Ciotti; Benjamin,12,0,35,23
1656023894117,MATH 103A,A01,083777,Greenfeld; Be'Eri,2,1,36,34
1656023894117,MATH 103A,A02,083778,Greenfeld; Be'Eri,1,0,36,35
1656023894117,MATH 103A,A03,093561,Staff,0,1,36,36
1656023894117,MATH 103A,B01,083779,Greenfeld; Be'Eri,8,1,36,28
1656023894117,MATH 103A,B02,083780,Greenfeld; Be'Eri,0,0,36,36
1656023894117,MATH 103A,B03,093562,Staff,0,0,36,36
1656023900141,MATH 105,A01,085443,Carter; Anne Toulson,4,1,35,31
1656023900141,MATH 105,A02,093477,Staff,9,0,35,26
1656023906170,MATH 109,A01,083213,Ganzberger; Geoffrey Michael,0,1,34,34
1656023906170,MATH 109,A02,083214,Ganzberger; Geoffrey Michael,0,0,34,34
1656023906170,MATH 109,A03,093478,Staff,1,0,34,33
1656023906170,MATH 109,B01,083215,Ganzberger; Geoffrey Michael,2,0,32,30
1656023906170,MATH 109,B02,083216,Ganzberger; Geoffrey Michael,0,0,32,32
1656023906170,MATH 109,B03,093479,Staff,3,0,32,29
1656023912214,MATH 142A,A01,083219,Chow; Bennett,1,0,32,31
1656023912214,MATH 142A,A02,083220,Chow; Bennett,7,0,32,25
1656023912214,MATH 142A,A03,093480,Staff,4,0,32,28
1656023912214,MATH 142A,B03,093481,Staff,3,0,32,29
1656023912214,MATH 142A,B04,093558,Staff,6,0,32,26
1656023912214,MATH 142A,B05,093559,Staff,0,0,32,32
1656023918242,MATH 193A,A01,083224,Rotar; Vladimir,1,2,34,33
1656023918242,MATH 193A,A02,083225,Rotar; Vladimir,0,1,34,34
1656023918242,MATH 193A,A03,083781,Rotar; Vladimir,2,0,34,32
1656023918242,MATH 193A,A04,083782,Rotar; Vladimir,3,0,34,31
1656023918242,MATH 193A,A05,093482,Rotar; Vladimir,0,0,34,34
1656023924266,MATH 197,001,091859,McAuley; Julian John,9999,0,9999,0
1656023924266,MATH 197,002,095566,Kedlaya; Kiran S.,9997,0,9999,2
1656023924266,MATH 197,003,095567,Xiao; Ming,9999,0,9999,0
1656023924266,MATH 197,004,095571,Perols; Johan Lars,9998,0,9999,1
1656023931332,COGS 9,A01,083615,Shannon; Kyle Michael,3,1,75,72
1656023937373,COGS 11,A01,083617,Boyle; Mary E. T.,11,1,48,37
1656023943396,COGS 13,A01,083071,Bastos; Amalia Pinkusfeld,4,3,71,67
1656023949421,COGS 14A,A01,092681,Semenuks; Arturs,4,25,100,96
1656023955449,COGS 14B,A01,083073,Cheng; Tzu-Han,7,0,63,56
1656023961483,COGS 17,A01,092677,Semenuks; Arturs,8,7,81,73
1656023967507,COGS 100,A01,083619,Allen; Michael Gordon,2,2,70,68
1656023973535,COGS 101A,A01,083621,Davis; Joshua Daniel,4,3,68,64
1656023979571,COGS 101B,A01,091572,Allen; Michael Gordon,0,0,65,65
1656023985601,COGS 101C,A01,083625,Delgado; Tania,7,0,35,28
1656023991629,COGS 107A,A01,083627,Boyle; Mary E. T.,1,2,60,59
1656023997660,COGS 118A,A01,083075,Gupta; Anjum,21,16,76,55
1656024003684,CSE 3,A50,083646,Miranda; Gregory Joseph,14,0,50,36
1656024009709,CSE 8A,A50,083650,Miranda; Gregory Joseph,4,11,56,52
1656024015739,CSE 11,A01,083080,Cao; Yingjun,0,65,40,40
1656024021764,CSE 12,A01,083652,Krause-Levy; Sophia Louisa,7,8,120,113
1656024027791,CSE 15L,A01,083654,Morris; Justin Loren,3,1,50,47
1656024027791,CSE 15L,A02,083655,Morris; Justin Loren,2,1,50,48
1656024033815,CSE 20,A01,083657,Tran; Khoa Dang,29,0,80,51
1656024039842,CSE 21,A01,095574,Bach; Quang Tran,23,0,48,25
1656024045871,CSE 30,A01,083084,Eldon; John,2,10,80,78
1656024045871,CSE 30,B01,095061,Bhaskar; Nishant,2,4,50,48
1656024051894,CSE 100,A01,083659,Cao; Yingjun,2,25,70,68
1656024057920,CSE 134B,A01,083661,Powell; Thomas Allan,6,6,100,94
1656024063948,CSE 140,A01,083663,Gungor; Onat,5,0,85,80
1656024069975,CSE 140L,A01,083088,Eldon; John,5,0,100,95
1656024076001,CSE 175,A01,083665,Kumar; Rakesh,0,0,25,25
1656024082028,CSE 190,A00,092507,Dubnov; Shlomo,1,0,20,19
1656024088054,ECE 45,A01,083139,Congero; Spencer William,0,1,75,75
1656024094079,ECE 65,A50,083695,Saad; Andrew S,6,0,30,24
1656024094079,ECE 65,A51,095125,Staff,23,0,26,3
1656024100107,ECE 109,A01,091882,Touri; Behrouz,3,5,70,67
1656024106135,ECE 180,A00,083140,Abi Samra; Nicholas Camill,1,0,30,29
1656024106135,ECE 180,B00,083141,Abi Samra; Nicholas Camill,0,8,28,28
1656024112159,MATH 10A,A01,083735,Patchell; Gregory David,0,0,30,30
1656024112159,MATH 10A,A02,083736,Patchell; Gregory David,20,0,30,10
1656024112159,MATH 10A,A03,083737,Patchell; Gregory David,16,0,30,14
1656024118183,MATH 10B,A01,083207,Lim; Seonhee,1,1,34,33
1656024118183,MATH 10B,A02,083208,Lim; Seonhee,1,1,35,34
1656024118183,MATH 10B,A03,093472,Staff,1,0,34,33
1656024118183,MATH 10B,B01,083739,Sinha; Shubham,9,0,30,21
1656024124211,MATH 18,A01,083743,Cinel; Cameron Alexander,5,0,30,25
1656024124211,MATH 18,A02,083744,Cinel; Cameron Alexander,11,0,30,19
1656024124211,MATH 18,A03,083745,Cinel; Cameron Alexander,1,0,30,29
1656024124211,MATH 18,B01,083748,Ma; Zilu,0,0,36,36
1656024124211,MATH 18,B02,083749,Ma; Zilu,0,0,36,36
1656024124211,MATH 18,B03,083750,Ma; Zilu,0,0,36,36
1656024124211,MATH 18,B04,083751,Ma; Zilu,0,0,36,36
1656024124211,MATH 18,B05,093473,Staff,0,0,36,36
1656024124211,MATH 18,B06,093474,Staff,3,0,36,33
1656024130238,MATH 20A,A01,083754,Zheng; Zequn,11,0,40,29
1656024136275,MATH 20B,A01,083756,Briones; Jor-el Thomas Caparas,0,1,36,36
1656024136275,MATH 20B,A02,083757,Briones; Jor-el Thomas Caparas,1,0,36,35
1656024136275,MATH 20B,A03,093475,Staff,0,0,36,36
1656024142303,MATH 20C,A01,083760,Briones; Jor-el Thomas Caparas,0,2,35,35
1656024142303,MATH 20C,A02,083761,Briones; Jor-el Thomas Caparas,6,1,35,29
1656024142303,MATH 20C,A03,093476,Staff,0,0,35,35
1656024142303,MATH 20C,B01,083762,Bach; Quang Tran,3,0,30,27
1656024148326,MATH 20D,A01,083765,Tran; Brian Kha,2,0,30,28
1656024148326,MATH 20D,A02,083766,Tran; Brian Kha,0,1,30,30
1656024148326,MATH 20D,A03,083767,Tran; Brian Kha,1,0,30,29
1656024154353,MATH 20E,A01,083771,Ganguly; Soumya,0,1,32,32
1656024154353,MATH 20E,A02,083772,Ganguly; Soumya,1,1,32,31
1656024154353,MATH 20E,B01,083773,Ciotti; Benjamin,13,0,35,22
1656024154353,MATH 20E,B02,083774,Ciotti; Benjamin,12,0,35,23
1656024160377,MATH 103A,A01,083777,Greenfeld; Be'Eri,2,1,36,34
1656024160377,MATH 103A,A02,083778,Greenfeld; Be'Eri,1,0,36,35
1656024160377,MATH 103A,A03,093561,Staff,0,1,36,36
1656024160377,MATH 103A,B01,083779,Greenfeld; Be'Eri,8,1,36,28
1656024160377,MATH 103A,B02,083780,Greenfeld; Be'Eri,0,0,36,36
1656024160377,MATH 103A,B03,093562,Staff,0,0,36,36
1656024166405,MATH 105,A01,085443,Carter; Anne Toulson,4,1,35,31
1656024166405,MATH 105,A02,093477,Staff,9,0,35,26
1656024172433,MATH 109,A01,083213,Ganzberger; Geoffrey Michael,0,1,34,34
1656024172433,MATH 109,A02,083214,Ganzberger; Geoffrey Michael,0,0,34,34
1656024172433,MATH 109,A03,093478,Staff,1,0,34,33
1656024172433,MATH 109,B01,083215,Ganzberger; Geoffrey Michael,2,0,32,30
1656024172433,MATH 109,B02,083216,Ganzberger; Geoffrey Michael,0,0,32,32
1656024172433,MATH 109,B03,093479,Staff,3,0,32,29
1656024178456,MATH 142A,A01,083219,Chow; Bennett,1,0,32,31
1656024178456,MATH 142A,A02,083220,Chow; Bennett,7,0,32,25
1656024178456,MATH 142A,A03,093480,Staff,4,0,32,28
1656024178456,MATH 142A,B03,093481,Staff,3,0,32,29
1656024178456,MATH 142A,B04,093558,Staff,6,0,32,26
1656024178456,MATH 142A,B05,093559,Staff,0,0,32,32
1656024184499,MATH 193A,A01,083224,Rotar; Vladimir,1,2,34,33
1656024184499,MATH 193A,A02,083225,Rotar; Vladimir,0,1,34,34
1656024184499,MATH 193A,A03,083781,Rotar; Vladimir,2,0,34,32
1656024184499,MATH 193A,A04,083782,Rotar; Vladimir,3,0,34,31
1656024184499,MATH 193A,A05,093482,Rotar; Vladimir,0,0,34,34
1656024190529,MATH 197,001,091859,McAuley; Julian John,9999,0,9999,0
1656024190529,MATH 197,002,095566,Kedlaya; Kiran S.,9997,0,9999,2
1656024190529,MATH 197,003,095567,Xiao; Ming,9999,0,9999,0
1656024190529,MATH 197,004,095571,Perols; Johan Lars,9998,0,9999,1
1656024197583,COGS 9,A01,083615,Shannon; Kyle Michael,3,1,75,72
1656024203606,COGS 11,A01,083617,Boyle; Mary E. T.,11,1,48,37
1656024209630,COGS 13,A01,083071,Bastos; Amalia Pinkusfeld,4,3,71,67
1656024215673,COGS 14A,A01,092681,Semenuks; Arturs,4,25,100,96
1656024221699,COGS 14B,A01,083073,Cheng; Tzu-Han,7,0,63,56
1656024227723,COGS 17,A01,092677,Semenuks; Arturs,8,7,81,73
1656024233748,COGS 100,A01,083619,Allen; Michael Gordon,2,2,70,68
1656024239776,COGS 101A,A01,083621,Davis; Joshua Daniel,4,3,68,64
1656024245801,COGS 101B,A01,091572,Allen; Michael Gordon,0,0,65,65
1656024251825,COGS 101C,A01,083625,Delgado; Tania,7,0,35,28
1656024257861,COGS 107A,A01,083627,Boyle; Mary E. T.,1,2,60,59
1656024263888,COGS 118A,A01,083075,Gupta; Anjum,21,16,76,55
1656024269922,CSE 3,A50,083646,Miranda; Gregory Joseph,14,0,50,36
1656024275950,CSE 8A,A50,083650,Miranda; Gregory Joseph,4,11,56,52
1656024281985,CSE 11,A01,083080,Cao; Yingjun,0,65,40,40
1656024288008,CSE 12,A01,083652,Krause-Levy; Sophia Louisa,7,8,120,113
1656024294031,CSE 15L,A01,083654,Morris; Justin Loren,3,1,50,47
1656024294031,CSE 15L,A02,083655,Morris; Justin Loren,2,1,50,48
1656024300065,CSE 20,A01,083657,Tran; Khoa Dang,29,0,80,51
1656024306087,CSE 21,A01,095574,Bach; Quang Tran,23,0,48,25
1656024312117,CSE 30,A01,083084,Eldon; John,2,10,80,78
1656024312117,CSE 30,B01,095061,Bhaskar; Nishant,2,4,50,48
1656024318151,CSE 100,A01,083659,Cao; Yingjun,2,25,70,68
1656024324178,CSE 134B,A01,083661,Powell; Thomas Allan,6,6,100,94
1656024330209,CSE 140,A01,083663,Gungor; Onat,5,0,85,80
1656024336233,CSE 140L,A01,083088,Eldon; John,5,0,100,95
1656024342335,CSE 175,A01,083665,Kumar; Rakesh,0,0,25,25
1656024348369,CSE 190,A00,092507,Dubnov; Shlomo,1,0,20,19
1656024354392,ECE 45,A01,083139,Congero; Spencer William,0,1,75,75
1656024360417,ECE 65,A50,083695,Saad; Andrew S,6,0,30,24
1656024360417,ECE 65,A51,095125,Staff,23,0,26,3
1656024366442,ECE 109,A01,091882,Touri; Behrouz,3,5,70,67
1656024372467,ECE 180,A00,083140,Abi Samra; Nicholas Camill,1,0,30,29
1656024372467,ECE 180,B00,083141,Abi Samra; Nicholas Camill,0,8,28,28
1656024378489,MATH 10A,A01,083735,Patchell; Gregory David,0,0,30,30
1656024378489,MATH 10A,A02,083736,Patchell; Gregory David,20,0,30,10
1656024378489,MATH 10A,A03,083737,Patchell; Gregory David,16,0,30,14
1656024384519,MATH 10B,A01,083207,Lim; Seonhee,1,1,34,33
1656024384519,MATH 10B,A02,083208,Lim; Seonhee,1,1,35,34
1656024384519,MATH 10B,A03,093472,Staff,1,0,34,33
1656024384519,MATH 10B,B01,083739,Sinha; Shubham,9,0,30,21
1656024390553,MATH 18,A01,083743,Cinel; Cameron Alexander,5,0,30,25
1656024390553,MATH 18,A02,083744,Cinel; Cameron Alexander,11,0,30,19
1656024390553,MATH 18,A03,083745,Cinel; Cameron Alexander,1,0,30,29
1656024390553,MATH 18,B01,083748,Ma; Zilu,0,0,36,36
1656024390553,MATH 18,B02,083749,Ma; Zilu,0,0,36,36
1656024390553,MATH 18,B03,083750,Ma; Zilu,0,0,36,36
1656024390553,MATH 18,B04,083751,Ma; Zilu,0,0,36,36
1656024390553,MATH 18,B05,093473,Staff,0,0,36,36
1656024390553,MATH 18,B06,093474,Staff,3,0,36,33
1656024396577,MATH 20A,A01,083754,Zheng; Zequn,11,0,40,29
1656024402601,MATH 20B,A01,083756,Briones; Jor-el Thomas Caparas,0,1,36,36
1656024402601,MATH 20B,A02,083757,Briones; Jor-el Thomas Caparas,1,0,36,35
1656024402601,MATH 20B,A03,093475,Staff,0,0,36,36
1656024408625,MATH 20C,A01,083760,Briones; Jor-el Thomas Caparas,0,2,35,35
1656024408625,MATH 20C,A02,083761,Briones; Jor-el Thomas Caparas,6,1,35,29
1656024408625,MATH 20C,A03,093476,Staff,0,0,35,35
1656024408625,MATH 20C,B01,083762,Bach; Quang Tran,3,0,30,27
1656024414648,MATH 20D,A01,083765,Tran; Brian Kha,2,0,30,28
1656024414648,MATH 20D,A02,083766,Tran; Brian Kha,0,1,30,30
1656024414648,MATH 20D,A03,083767,Tran; Brian Kha,1,0,30,29
1656024420678,MATH 20E,A01,083771,Ganguly; Soumya,0,1,32,32
1656024420678,MATH 20E,A02,083772,Ganguly; Soumya,1,1,32,31
1656024420678,MATH 20E,B01,083773,Ciotti; Benjamin,13,0,35,22
1656024420678,MATH 20E,B02,083774,Ciotti; Benjamin,12,0,35,23
1656024426717,MATH 103A,A01,083777,Greenfeld; Be'Eri,2,1,36,34
1656024426717,MATH 103A,A02,083778,Greenfeld; Be'Eri,1,0,36,35
1656024426717,MATH 103A,A03,093561,Staff,0,1,36,36
1656024426717,MATH 103A,B01,083779,Greenfeld; Be'Eri,8,1,36,28
1656024426717,MATH 103A,B02,083780,Greenfeld; Be'Eri,0,0,36,36
1656024426717,MATH 103A,B03,093562,Staff,0,0,36,36
1656024432742,MATH 105,A01,085443,Carter; Anne Toulson,4,1,35,31
1656024432742,MATH 105,A02,093477,Staff,9,0,35,26
1656024438772,MATH 109,A01,083213,Ganzberger; Geoffrey Michael,0,1,34,34
1656024438772,MATH 109,A02,083214,Ganzberger; Geoffrey Michael,0,0,34,34
1656024438772,MATH 109,A03,093478,Staff,1,0,34,33
1656024438772,MATH 109,B01,083215,Ganzberger; Geoffrey Michael,2,0,32,30
1656024438772,MATH 109,B02,083216,Ganzberger; Geoffrey Michael,0,0,32,32
1656024438772,MATH 109,B03,093479,Staff,3,0,32,29
1656024444796,MATH 142A,A01,083219,Chow; Bennett,1,0,32,31
1656024444796,MATH 142A,A02,083220,Chow; Bennett,7,0,32,25
1656024444796,MATH 142A,A03,093480,Staff,4,0,32,28
1656024444796,MATH 142A,B03,093481,Staff,3,0,32,29
1656024444796,MATH 142A,B04,093558,Staff,6,0,32,26
1656024444796,MATH 142A,B05,093559,Staff,0,0,32,32
1656024450824,MATH 193A,A01,083224,Rotar; Vladimir,1,2,34,33
1656024450824,MATH 193A,A02,083225,Rotar; Vladimir,0,1,34,34
1656024450824,MATH 193A,A03,083781,Rotar; Vladimir,2,0,34,32
1656024450824,MATH 193A,A04,083782,Rotar; Vladimir,3,0,34,31
1656024450824,MATH 193A,A05,093482,Rotar; Vladimir,0,0,34,34
1656024456847,MATH 197,001,091859,McAuley; Julian John,9999,0,9999,0
1656024456847,MATH 197,002,095566,Kedlaya; Kiran S.,9997,0,9999,2
1656024456847,MATH 197,003,095567,Xiao; Ming,9999,0,9999,0
1656024456847,MATH 197,004,095571,Perols; Johan Lars,9998,0,9999,1
1656024463909,COGS 9,A01,083615,Shannon; Kyle Michael,3,1,75,72
1656024469932,COGS 11,A01,083617,Boyle; Mary E. T.,11,1,48,37
1656024475955,COGS 13,A01,083071,Bastos; Amalia Pinkusfeld,4,3,71,67
1656024481981,COGS 14A,A01,092681,Semenuks; Arturs,4,25,100,96
1656024488011,COGS 14B,A01,083073,Cheng; Tzu-Han,7,0,63,56
1656024494037,COGS 17,A01,092677,Semenuks; Arturs,8,7,81,73
1656024500064,COGS 100,A01,083619,Allen; Michael Gordon,2,2,70,68
1656024506087,COGS 101A,A01,083621,Davis; Joshua Daniel,4,3,68,64
1656024512113,COGS 101B,A01,091572,Allen; Michael Gordon,0,0,65,65
1656024518140,COGS 101C,A01,083625,Delgado; Tania,7,0,35,28
1656024524163,COGS 107A,A01,083627,Boyle; Mary E. T.,1,2,60,59
1656024530195,COGS 118A,A01,083075,Gupta; Anjum,21,16,76,55
1656024536221,CSE 3,A50,083646,Miranda; Gregory Joseph,14,0,50,36
1656024542245,CSE 8A,A50,083650,Miranda; Gregory Joseph,4,11,56,52
1656024548275,CSE 11,A01,083080,Cao; Yingjun,0,65,40,40
1656024554303,CSE 12,A01,083652,Krause-Levy; Sophia Louisa,7,8,120,113
1656024560333,CSE 15L,A01,083654,Morris; Justin Loren,3,1,50,47
1656024560333,CSE 15L,A02,083655,Morris; Justin Loren,2,1,50,48
1656024566357,CSE 20,A01,083657,Tran; Khoa Dang,29,0,80,51
1656024572386,CSE 21,A01,095574,Bach; Quang Tran,23,0,48,25
1656024578411,CSE 30,A01,083084,Eldon; John,2,10,80,78
1656024578411,CSE 30,B01,095061,Bhaskar; Nishant,2,4,50,48
1656024584441,CSE 100,A01,083659,Cao; Yingjun,2,25,70,68
1656024590465,CSE 134B,A01,083661,Powell; Thomas Allan,6,6,100,94
1656024596499,CSE 140,A01,083663,Gungor; Onat,5,0,85,80
1656024602532,CSE 140L,A01,083088,Eldon; John,5,0,100,95
1656024608556,CSE 175,A01,083665,Kumar; Rakesh,0,0,25,25
1656024614592,CSE 190,A00,092507,Dubnov; Shlomo,1,0,20,19
1656024620618,ECE 45,A01,083139,Congero; Spencer William,0,1,75,75
1656024626641,ECE 65,A50,083695,Saad; Andrew S,6,0,30,24
1656024626641,ECE 65,A51,095125,Staff,23,0,26,3
1656024632669,ECE 109,A01,091882,Touri; Behrouz,3,5,70,67
1656024638692,ECE 180,A00,083140,Abi Samra; Nicholas Camill,1,0,30,29
1656024638692,ECE 180,B00,083141,Abi Samra; Nicholas Camill,0,8,28,28
1656024644721,MATH 10A,A01,083735,Patchell; Gregory David,0,0,30,30
1656024644721,MATH 10A,A02,083736,Patchell; Gregory David,20,0,30,10
1656024644721,MATH 10A,A03,083737,Patchell; Gregory David,16,0,30,14
1656024650745,MATH 10B,A01,083207,Lim; Seonhee,1,1,34,33
1656024650745,MATH 10B,A02,083208,Lim; Seonhee,1,1,35,34
1656024650745,MATH 10B,A03,093472,Staff,1,0,34,33
1656024650745,MATH 10B,B01,083739,Sinha; Shubham,9,0,30,21
1656024656770,MATH 18,A01,083743,Cinel; Cameron Alexander,5,0,30,25
1656024656770,MATH 18,A02,083744,Cinel; Cameron Alexander,11,0,30,19
1656024656770,MATH 18,A03,083745,Cinel; Cameron Alexander,1,0,30,29
1656024656770,MATH 18,B01,083748,Ma; Zilu,0,0,36,36
1656024656770,MATH 18,B02,083749,Ma; Zilu,0,0,36,36
1656024656770,MATH 18,B03,083750,Ma; Zilu,0,0,36,36
1656024656770,MATH 18,B04,083751,Ma; Zilu,0,0,36,36
1656024656770,MATH 18,B05,093473,Staff,0,0,36,36
1656024656770,MATH 18,B06,093474,Staff,3,0,36,33
1656024662794,MATH 20A,A01,083754,Zheng; Zequn,11,0,40,29
1656024668821,MATH 20B,A01,083756,Briones; Jor-el Thomas Caparas,0,1,36,36
1656024668821,MATH 20B,A02,083757,Briones; Jor-el Thomas Caparas,1,0,36,35
1656024668821,MATH 20B,A03,093475,Staff,0,0,36,36
1656024674844,MATH 20C,A01,083760,Briones; Jor-el Thomas Caparas,0,2,35,35
1656024674844,MATH 20C,A02,083761,Briones; Jor-el Thomas Caparas,6,1,35,29
1656024674844,MATH 20C,A03,093476,Staff,0,0,35,35
1656024674844,MATH 20C,B01,083762,Bach; Quang Tran,3,0,30,27
1656024680868,MATH 20D,A01,083765,Tran; Brian Kha,2,0,30,28
1656024680868,MATH 20D,A02,083766,Tran; Brian Kha,0,1,30,30
1656024680868,MATH 20D,A03,083767,Tran; Brian Kha,1,0,30,29
1656024686893,MATH 20E,A01,083771,Ganguly; Soumya,0,1,32,32
1656024686893,MATH 20E,A02,083772,Ganguly; Soumya,1,1,32,31
1656024686893,MATH 20E,B01,083773,Ciotti; Benjamin,13,0,35,22
1656024686893,MATH 20E,B02,083774,Ciotti; Benjamin,12,0,35,23
1656024692916,MATH 103A,A01,083777,Greenfeld; Be'Eri,2,1,36,34
1656024692916,MATH 103A,A02,083778,Greenfeld; Be'Eri,1,0,36,35
1656024692916,MATH 103A,A03,093561,Staff,0,1,36,36
1656024692916,MATH 103A,B01,083779,Greenfeld; Be'Eri,8,1,36,28
1656024692916,MATH 103A,B02,083780,Greenfeld; Be'Eri,0,0,36,36
1656024692916,MATH 103A,B03,093562,Staff,0,0,36,36
1656024698957,MATH 105,A01,085443,Carter; Anne Toulson,4,1,35,31
1656024698957,MATH 105,A02,093477,Staff,9,0,35,26
1656024704985,MATH 109,A01,083213,Ganzberger; Geoffrey Michael,0,1,34,34
1656024704985,MATH 109,A02,083214,Ganzberger; Geoffrey Michael,0,0,34,34
1656024704985,MATH 109,A03,093478,Staff,1,0,34,33
1656024704985,MATH 109,B01,083215,Ganzberger; Geoffrey Michael,2,0,32,30
1656024704985,MATH 109,B02,083216,Ganzberger; Geoffrey Michael,0,0,32,32
1656024704985,MATH 109,B03,093479,Staff,3,0,32,29
1656024711022,MATH 142A,A01,083219,Chow; Bennett,1,0,32,31
1656024711022,MATH 142A,A02,083220,Chow; Bennett,7,0,32,25
1656024711022,MATH 142A,A03,093480,Staff,4,0,32,28
1656024711022,MATH 142A,B03,093481,Staff,3,0,32,29
1656024711022,MATH 142A,B04,093558,Staff,6,0,32,26
1656024711022,MATH 142A,B05,093559,Staff,0,0,32,32
1656024717053,MATH 193A,A01,083224,Rotar; Vladimir,1,2,34,33
1656024717053,MATH 193A,A02,083225,Rotar; Vladimir,0,1,34,34
1656024717053,MATH 193A,A03,083781,Rotar; Vladimir,2,0,34,32
1656024717053,MATH 193A,A04,083782,Rotar; Vladimir,3,0,34,31
1656024717053,MATH 193A,A05,093482,Rotar; Vladimir,0,0,34,34
1656024723077,MATH 197,001,091859,McAuley; Julian John,9999,0,9999,0
1656024723077,MATH 197,002,095566,Kedlaya; Kiran S.,9997,0,9999,2
1656024723077,MATH 197,003,095567,Xiao; Ming,9999,0,9999,0
1656024723077,MATH 197,004,095571,Perols; Johan Lars,9998,0,9999,1
1656024730141,COGS 9,A01,083615,Shannon; Kyle Michael,3,1,75,72
1656024736164,COGS 11,A01,083617,Boyle; Mary E. T.,11,1,48,37
1656024742193,COGS 13,A01,083071,Bastos; Amalia Pinkusfeld,4,3,71,67
1656024748224,COGS 14A,A01,092681,Semenuks; Arturs,4,25,100,96
1656024754250,COGS 14B,A01,083073,Cheng; Tzu-Han,7,0,63,56
1656024760277,COGS 17,A01,092677,Semenuks; Arturs,8,7,81,73
1656024766303,COGS 100,A01,083619,Allen; Michael Gordon,2,2,70,68
1656024772325,COGS 101A,A01,083621,Davis; Joshua Daniel,4,3,68,64
1656024778348,COGS 101B,A01,091572,Allen; Michael Gordon,0,0,65,65
1656024784371,COGS 101C,A01,083625,Delgado; Tania,7,0,35,28
1656024790399,COGS 107A,A01,083627,Boyle; Mary E. T.,1,2,60,59
1656024796424,COGS 118A,A01,083075,Gupta; Anjum,21,16,76,55
1656024802449,CSE 3,A50,083646,Miranda; Gregory Joseph,14,0,50,36
1656024808475,CSE 8A,A50,083650,Miranda; Gregory Joseph,4,11,56,52
1656024814507,CSE 11,A01,083080,Cao; Yingjun,0,65,40,40
1656024820531,CSE 12,A01,083652,Krause-Levy; Sophia Louisa,7,8,120,113
1656024826553,CSE 15L,A01,083654,Morris; Justin Loren,3,1,50,47
1656024826553,CSE 15L,A02,083655,Morris; Justin Loren,2,1,50,48
1656024832588,CSE 20,A01,083657,Tran; Khoa Dang,29,0,80,51
1656024838611,CSE 21,A01,095574,Bach; Quang Tran,23,0,48,25
1656024844635,CSE 30,A01,083084,Eldon; John,2,10,80,78
1656024844635,CSE 30,B01,095061,Bhaskar; Nishant,2,4,50,48
1656024850658,CSE 100,A01,083659,Cao; Yingjun,2,25,70,68
1656024856684,CSE 134B,A01,083661,Powell; Thomas Allan,6,6,100,94
1656024862718,CSE 140,A01,083663,Gungor; Onat,5,0,85,80
1656024868744,CSE 140L,A01,083088,Eldon; John,5,0,100,95
1656024874787,CSE 175,A01,083665,Kumar; Rakesh,0,0,25,25
1656024880810,CSE 190,A00,092507,Dubnov; Shlomo,1,0,20,19
1656024886840,ECE 45,A01,083139,Congero; Spencer William,0,1,75,75
1656024892862,ECE 65,A50,083695,Saad; Andrew S,6,0,30,24
1656024892862,ECE 65,A51,095125,Staff,23,0,26,3
1656024898889,ECE 109,A01,091882,Touri; Behrouz,3,5,70,67
1656024904924,ECE 180,A00,083140,Abi Samra; Nicholas Camill,1,0,30,29
1656024904924,ECE 180,B00,083141,Abi Samra; Nicholas Camill,0,8,28,28
1656024910947,MATH 10A,A01,083735,Patchell; Gregory David,0,0,30,30
1656024910947,MATH 10A,A02,083736,Patchell; Gregory David,20,0,30,10
1656024910947,MATH 10A,A03,083737,Patchell; Gregory David,16,0,30,14
1656024916974,MATH 10B,A01,083207,Lim; Seonhee,1,1,34,33
1656024916974,MATH 10B,A02,083208,Lim; Seonhee,1,1,35,34
1656024916974,MATH 10B,A03,093472,Staff,1,0,34,33
1656024916974,MATH 10B,B01,083739,Sinha; Shubham,9,0,30,21
1656024922997,MATH 18,A01,083743,Cinel; Cameron Alexander,5,0,30,25
1656024922997,MATH 18,A02,083744,Cinel; Cameron Alexander,11,0,30,19
1656024922997,MATH 18,A03,083745,Cinel; Cameron Alexander,1,0,30,29
1656024922997,MATH 18,B01,083748,Ma; Zilu,0,0,36,36
1656024922997,MATH 18,B02,083749,Ma; Zilu,0,0,36,36
1656024922997,MATH 18,B03,083750,Ma; Zilu,0,0,36,36
1656024922997,MATH 18,B04,083751,Ma; Zilu,0,0,36,36
1656024922997,MATH 18,B05,093473,Staff,0,0,36,36
1656024922997,MATH 18,B06,093474,Staff,3,0,36,33
1656024929024,MATH 20A,A01,083754,Zheng; Zequn,11,0,40,29
1656024935068,MATH 20B,A01,083756,Briones; Jor-el Thomas Caparas,0,1,36,36
1656024935068,MATH 20B,A02,083757,Briones; Jor-el Thomas Caparas,1,0,36,35
1656024935068,MATH 20B,A03,093475,Staff,0,0,36,36
1656024941165,MATH 20C,A01,083760,Briones; Jor-el Thomas Caparas,0,2,35,35
1656024941165,MATH 20C,A02,083761,Briones; Jor-el Thomas Caparas,6,1,35,29
1656024941165,MATH 20C,A03,093476,Staff,0,0,35,35
1656024941165,MATH 20C,B01,083762,Bach; Quang Tran,3,0,30,27
1656024947188,MATH 20D,A01,083765,Tran; Brian Kha,2,0,30,28
1656024947188,MATH 20D,A02,083766,Tran; Brian Kha,0,1,30,30
1656024947188,MATH 20D,A03,083767,Tran; Brian Kha,1,0,30,29
1656024953215,MATH 20E,A01,083771,Ganguly; Soumya,0,1,32,32
1656024953215,MATH 20E,A02,083772,Ganguly; Soumya,1,1,32,31
1656024953215,MATH 20E,B01,083773,Ciotti; Benjamin,13,0,35,22
1656024953215,MATH 20E,B02,083774,Ciotti; Benjamin,12,0,35,23
1656024959240,MATH 103A,A01,083777,Greenfeld; Be'Eri,2,1,36,34
1656024959240,MATH 103A,A02,083778,Greenfeld; Be'Eri,1,0,36,35
1656024959240,MATH 103A,A03,093561,Staff,0,1,36,36
1656024959240,MATH 103A,B01,083779,Greenfeld; Be'Eri,8,1,36,28
1656024959240,MATH 103A,B02,083780,Greenfeld; Be'Eri,0,0,36,36
1656024959240,MATH 103A,B03,093562,Staff,0,0,36,36
1656024965267,MATH 105,A01,085443,Carter; Anne Toulson,4,1,35,31
1656024965267,MATH 105,A02,093477,Staff,9,0,35,26
1656024971298,MATH 109,A01,083213,Ganzberger; Geoffrey Michael,0,1,34,34
1656024971298,MATH 109,A02,083214,Ganzberger; Geoffrey Michael,0,0,34,34
1656024971298,MATH 109,A03,093478,Staff,1,0,34,33
1656024971298,MATH 109,B01,083215,Ganzberger; Geoffrey Michael,2,0,32,30
1656024971298,MATH 109,B02,083216,Ganzberger; Geoffrey Michael,0,0,32,32
1656024971298,MATH 109,B03,093479,Staff,3,0,32,29
1656024977327,MATH 142A,A01,083219,Chow; Bennett,1,0,32,31
1656024977327,MATH 142A,A02,083220,Chow; Bennett,7,0,32,25
1656024977327,MATH 142A,A03,093480,Staff,4,0,32,28
1656024977327,MATH 142A,B03,093481,Staff,3,0,32,29
1656024977327,MATH 142A,B04,093558,Staff,6,0,32,26
1656024977327,MATH 142A,B05,093559,Staff,0,0,32,32
1656024983380,MATH 193A,A01,083224,Rotar; Vladimir,1,2,34,33
1656024983380,MATH 193A,A02,083225,Rotar; Vladimir,0,1,34,34
1656024983380,MATH 193A,A03,083781,Rotar; Vladimir,2,0,34,32
1656024983380,MATH 193A,A04,083782,Rotar; Vladimir,3,0,34,31
1656024983380,MATH 193A,A05,093482,Rotar; Vladimir,0,0,34,34
1656024989409,MATH 197,001,091859,McAuley; Julian John,9999,0,9999,0
1656024989409,MATH 197,002,095566,Kedlaya; Kiran S.,9997,0,9999,2
1656024989409,MATH 197,003,095567,Xiao; Ming,9999,0,9999,0
1656024989409,MATH 197,004,095571,Perols; Johan Lars,9998,0,9999,1
1656024996515,COGS 9,A01,083615,Shannon; Kyle Michael,3,1,75,72
1656025002541,COGS 11,A01,083617,Boyle; Mary E. T.,11,1,48,37
1656025008564,COGS 13,A01,083071,Bastos; Amalia Pinkusfeld,4,3,71,67
1656025014586,COGS 14A,A01,092681,Semenuks; Arturs,4,25,100,96
1656025020620,COGS 14B,A01,083073,Cheng; Tzu-Han,7,0,63,56
1656025026643,COGS 17,A01,092677,Semenuks; Arturs,8,7,81,73
1656025032666,COGS 100,A01,083619,Allen; Michael Gordon,2,2,70,68
1656025038693,COGS 101A,A01,083621,Davis; Joshua Daniel,4,3,68,64
1656025044716,COGS 101B,A01,091572,Allen; Michael Gordon,0,0,65,65
1656025050740,COGS 101C,A01,083625,Delgado; Tania,7,0,35,28
1656025056763,COGS 107A,A01,083627,Boyle; Mary E. T.,1,2,60,59
1656025062800,COGS 118A,A01,083075,Gupta; Anjum,21,16,76,55
1656025068823,CSE 3,A50,083646,Miranda; Gregory Joseph,14,0,50,36
1656025074857,CSE 8A,A50,083650,Miranda; Gregory Joseph,4,11,56,52
1656025080881,CSE 11,A01,083080,Cao; Yingjun,0,65,40,40
1656025086903,CSE 12,A01,083652,Krause-Levy; Sophia Louisa,7,8,120,113
1656025092928,CSE 15L,A01,083654,Morris; Justin Loren,3,1,50,47
1656025092928,CSE 15L,A02,083655,Morris; Justin Loren,2,1,50,48
1656025098952,CSE 20,A01,083657,Tran; Khoa Dang,29,0,80,51
1656025104975,CSE 21,A01,095574,Bach; Quang Tran,23,0,48,25
1656025110998,CSE 30,A01,083084,Eldon; John,2,10,80,78
1656025110998,CSE 30,B01,095061,Bhaskar; Nishant,2,4,50,48
1656025117028,CSE 100,A01,083659,Cao; Yingjun,2,25,70,68
1656025123052,CSE 134B,A01,083661,Powell; Thomas Allan,6,6,100,94
1656025129085,CSE 140,A01,083663,Gungor; Onat,5,0,85,80
1656025135114,CSE 140L,A01,083088,Eldon; John,5,0,100,95
1656025141138,CSE 175,A01,083665,Kumar; Rakesh,0,0,25,25
1656025147168,CSE 190,A00,092507,Dubnov; Shlomo,1,0,20,19
1656025153201,ECE 45,A01,083139,Congero; Spencer William,0,1,75,75
1656025159229,ECE 65,A50,083695,Saad; Andrew S,6,0,30,24
1656025159229,ECE 65,A51,095125,Staff,23,0,26,3
1656025165252,ECE 109,A01,091882,Touri; Behrouz,3,5,70,67
1656025171284,ECE 180,A00,083140,Abi Samra; Nicholas Camill,1,0,30,29
1656025171284,ECE 180,B00,083141,Abi Samra; Nicholas Camill,0,8,28,28
1656025177313,MATH 10A,A01,083735,Patchell; Gregory David,0,0,30,30
1656025177313,MATH 10A,A02,083736,Patchell; Gregory David,20,0,30,10
1656025177313,MATH 10A,A03,083737,Patchell; Gregory David,16,0,30,14
1656025183341,MATH 10B,A01,083207,Lim; Seonhee,1,1,34,33
1656025183341,MATH 10B,A02,083208,Lim; Seonhee,1,1,35,34
1656025183341,MATH 10B,A03,093472,Staff,1,0,34,33
1656025183341,MATH 10B,B01,083739,Sinha; Shubham,9,0,30,21
1656025189365,MATH 18,A01,083743,Cinel; Cameron Alexander,5,0,30,25
1656025189365,MATH 18,A02,083744,Cinel; Cameron Alexander,11,0,30,19
1656025189365,MATH 18,A03,083745,Cinel; Cameron Alexander,1,0,30,29
1656025189365,MATH 18,B01,083748,Ma; Zilu,0,0,36,36
1656025189365,MATH 18,B02,083749,Ma; Zilu,0,0,36,36
1656025189365,MATH 18,B03,083750,Ma; Zilu,0,0,36,36
1656025189365,MATH 18,B04,083751,Ma; Zilu,0,0,36,36
1656025189365,MATH 18,B05,093473,Staff,0,0,36,36
1656025189365,MATH 18,B06,093474,Staff,3,0,36,33
1656025195387,MATH 20A,A01,083754,Zheng; Zequn,11,0,40,29
1656025201411,MATH 20B,A01,083756,Briones; Jor-el Thomas Caparas,0,1,36,36
1656025201411,MATH 20B,A02,083757,Briones; Jor-el Thomas Caparas,1,0,36,35
1656025201411,MATH 20B,A03,093475,Staff,0,0,36,36
1656025207452,MATH 20C,A01,083760,Briones; Jor-el Thomas Caparas,0,2,35,35
1656025207452,MATH 20C,A02,083761,Briones; Jor-el Thomas Caparas,6,1,35,29
1656025207452,MATH 20C,A03,093476,Staff,0,0,35,35
1656025207452,MATH 20C,B01,083762,Bach; Quang Tran,3,0,30,27
1656025213476,MATH 20D,A01,083765,Tran; Brian Kha,2,0,30,28
1656025213476,MATH 20D,A02,083766,Tran; Brian Kha,0,1,30,30
1656025213476,MATH 20D,A03,083767,Tran; Brian Kha,1,0,30,29
1656025219499,MATH 20E,A01,083771,Ganguly; Soumya,0,1,32,32
1656025219499,MATH 20E,A02,083772,Ganguly; Soumya,1,1,32,31
1656025219499,MATH 20E,B01,083773,Ciotti; Benjamin,13,0,35,22
1656025219499,MATH 20E,B02,083774,Ciotti; Benjamin,12,0,35,23
1656025225526,MATH 103A,A01,083777,Greenfeld; Be'Eri,2,1,36,34
1656025225526,MATH 103A,A02,083778,Greenfeld; Be'Eri,1,0,36,35
1656025225526,MATH 103A,A03,093561,Staff,0,1,36,36
1656025225526,MATH 103A,B01,083779,Greenfeld; Be'Eri,8,1,36,28
1656025225526,MATH 103A,B02,083780,Greenfeld; Be'Eri,0,0,36,36
1656025225526,MATH 103A,B03,093562,Staff,0,0,36,36
1656025231558,MATH 105,A01,085443,Carter; Anne Toulson,4,1,35,31
1656025231558,MATH 105,A02,093477,Staff,9,0,35,26
1656025237581,MATH 109,A01,083213,Ganzberger; Geoffrey Michael,0,1,34,34
1656025237581,MATH 109,A02,083214,Ganzberger; Geoffrey Michael,0,0,34,34
1656025237581,MATH 109,A03,093478,Staff,1,0,34,33
1656025237581,MATH 109,B01,083215,Ganzberger; Geoffrey Michael,2,0,32,30
1656025237581,MATH 109,B02,083216,Ganzberger; Geoffrey Michael,0,0,32,32
1656025237581,MATH 109,B03,093479,Staff,3,0,32,29
1656025243609,MATH 142A,A01,083219,Chow; Bennett,1,0,32,31
1656025243609,MATH 142A,A02,083220,Chow; Bennett,7,0,32,25
1656025243609,MATH 142A,A03,093480,Staff,4,0,32,28
1656025243609,MATH 142A,B03,093481,Staff,3,0,32,29
1656025243609,MATH 142A,B04,093558,Staff,6,0,32,26
1656025243609,MATH 142A,B05,093559,Staff,0,0,32,32
1656025249636,MATH 193A,A01,083224,Rotar; Vladimir,1,2,34,33
1656025249636,MATH 193A,A02,083225,Rotar; Vladimir,0,1,34,34
1656025249636,MATH 193A,A03,083781,Rotar; Vladimir,2,0,34,32
1656025249636,MATH 193A,A04,083782,Rotar; Vladimir,3,0,34,31
1656025249636,MATH 193A,A05,093482,Rotar; Vladimir,0,0,34,34
1656025255660,MATH 197,001,091859,McAuley; Julian John,9999,0,9999,0
1656025255660,MATH 197,002,095566,Kedlaya; Kiran S.,9997,0,9999,2
1656025255660,MATH 197,003,095567,Xiao; Ming,9999,0,9999,0
1656025255660,MATH 197,004,095571,Perols; Johan Lars,9998,0,9999,1
1656025262721,COGS 9,A01,083615,Shannon; Kyle Michael,3,1,75,72
1656025268759,COGS 11,A01,083617,Boyle; Mary E. T.,11,1,48,37
1656025274787,COGS 13,A01,083071,Bastos; Amalia Pinkusfeld,4,3,71,67
1656025280811,COGS 14A,A01,092681,Semenuks; Arturs,4,25,100,96
1656025286832,COGS 14B,A01,083073,Cheng; Tzu-Han,7,0,63,56
1656025292856,COGS 17,A01,092677,Semenuks; Arturs,8,7,81,73
1656025298880,COGS 100,A01,083619,Allen; Michael Gordon,2,2,70,68
1656025304908,COGS 101A,A01,083621,Davis; Joshua Daniel,4,3,68,64
1656025310933,COGS 101B,A01,091572,Allen; Michael Gordon,0,0,65,65
1656025316958,COGS 101C,A01,083625,Delgado; Tania,7,0,35,28
1656025322982,COGS 107A,A01,083627,Boyle; Mary E. T.,1,2,60,59
1656025329009,COGS 118A,A01,083075,Gupta; Anjum,21,16,76,55
1656025335032,CSE 3,A50,083646,Miranda; Gregory Joseph,14,0,50,36
1656025341061,CSE 8A,A50,083650,Miranda; Gregory Joseph,4,11,56,52
1656025347088,CSE 11,A01,083080,Cao; Yingjun,0,65,40,40
1656025353112,CSE 12,A01,083652,Krause-Levy; Sophia Louisa,7,8,120,113
1656025359138,CSE 15L,A01,083654,Morris; Justin Loren,3,1,50,47
1656025359138,CSE 15L,A02,083655,Morris; Justin Loren,2,1,50,48
1656025365168,CSE 20,A01,083657,Tran; Khoa Dang,29,0,80,51
1656025371194,CSE 21,A01,095574,Bach; Quang Tran,23,0,48,25
1656025377223,CSE 30,A01,083084,Eldon; John,2,10,80,78
1656025377223,CSE 30,B01,095061,Bhaskar; Nishant,2,5,50,48
1656025383245,CSE 100,A01,083659,Cao; Yingjun,2,25,70,68
1656025389275,CSE 134B,A01,083661,Powell; Thomas Allan,6,6,100,94
1656025395300,CSE 140,A01,083663,Gungor; Onat,5,0,85,80
1656025401324,CSE 140L,A01,083088,Eldon; John,5,0,100,95
1656025407347,CSE 175,A01,083665,Kumar; Rakesh,0,0,25,25
1656025413369,CSE 190,A00,092507,Dubnov; Shlomo,1,0,20,19
1656025419396,ECE 45,A01,083139,Congero; Spencer William,0,1,75,75
1656025425424,ECE 65,A50,083695,Saad; Andrew S,6,0,30,24
1656025425424,ECE 65,A51,095125,Staff,23,0,26,3
1656025431452,ECE 109,A01,091882,Touri; Behrouz,3,5,70,67
1656025437477,ECE 180,A00,083140,Abi Samra; Nicholas Camill,1,0,30,29
1656025437477,ECE 180,B00,083141,Abi Samra; Nicholas Camill,0,8,28,28
1656025443501,MATH 10A,A01,083735,Patchell; Gregory David,0,0,30,30
1656025443501,MATH 10A,A02,083736,Patchell; Gregory David,20,0,30,10
1656025443501,MATH 10A,A03,083737,Patchell; Gregory David,16,0,30,14
1656025449531,MATH 10B,A01,083207,Lim; Seonhee,1,1,34,33
1656025449531,MATH 10B,A02,083208,Lim; Seonhee,1,1,35,34
1656025449531,MATH 10B,A03,093472,Staff,1,0,34,33
1656025449531,MATH 10B,B01,083739,Sinha; Shubham,9,0,30,21
1656025455562,MATH 18,A01,083743,Cinel; Cameron Alexander,5,0,30,25
1656025455562,MATH 18,A02,083744,Cinel; Cameron Alexander,11,0,30,19
1656025455562,MATH 18,A03,083745,Cinel; Cameron Alexander,1,0,30,29
1656025455562,MATH 18,B01,083748,Ma; Zilu,0,0,36,36
1656025455562,MATH 18,B02,083749,Ma; Zilu,0,0,36,36
1656025455562,MATH 18,B03,083750,Ma; Zilu,0,0,36,36
1656025455562,MATH 18,B04,083751,Ma; Zilu,0,0,36,36
1656025455562,MATH 18,B05,093473,Staff,0,0,36,36
1656025455562,MATH 18,B06,093474,Staff,3,0,36,33
1656025461589,MATH 20A,A01,083754,Zheng; Zequn,11,0,40,29
1656025467613,MATH 20B,A01,083756,Briones; Jor-el Thomas Caparas,0,1,36,36
1656025467613,MATH 20B,A02,083757,Briones; Jor-el Thomas Caparas,1,0,36,35
1656025467613,MATH 20B,A03,093475,Staff,0,0,36,36
1656025473638,MATH 20C,A01,083760,Briones; Jor-el Thomas Caparas,0,2,35,35
1656025473638,MATH 20C,A02,083761,Briones; Jor-el Thomas Caparas,6,1,35,29
1656025473638,MATH 20C,A03,093476,Staff,0,0,35,35
1656025473638,MATH 20C,B01,083762,Bach; Quang Tran,3,0,30,27
1656025479662,MATH 20D,A01,083765,Tran; Brian Kha,2,0,30,28
1656025479662,MATH 20D,A02,083766,Tran; Brian Kha,0,1,30,30
1656025479662,MATH 20D,A03,083767,Tran; Brian Kha,1,0,30,29
1656025485686,MATH 20E,A01,083771,Ganguly; Soumya,0,1,32,32
1656025485686,MATH 20E,A02,083772,Ganguly; Soumya,1,1,32,31
1656025485686,MATH 20E,B01,083773,Ciotti; Benjamin,13,0,35,22
1656025485686,MATH 20E,B02,083774,Ciotti; Benjamin,12,0,35,23
1656025491716,MATH 103A,A01,083777,Greenfeld; Be'Eri,2,1,36,34
1656025491716,MATH 103A,A02,083778,Greenfeld; Be'Eri,1,0,36,35
1656025491716,MATH 103A,A03,093561,Staff,0,1,36,36
1656025491716,MATH 103A,B01,083779,Greenfeld; Be'Eri,8,1,36,28
1656025491716,MATH 103A,B02,083780,Greenfeld; Be'Eri,0,0,36,36
1656025491716,MATH 103A,B03,093562,Staff,0,0,36,36
1656025497743,MATH 105,A01,085443,Carter; Anne Toulson,4,1,35,31
1656025497743,MATH 105,A02,093477,Staff,9,0,35,26
1656025503767,MATH 109,A01,083213,Ganzberger; Geoffrey Michael,0,1,34,34
1656025503767,MATH 109,A02,083214,Ganzberger; Geoffrey Michael,0,0,34,34
1656025503767,MATH 109,A03,093478,Staff,1,0,34,33
1656025503767,MATH 109,B01,083215,Ganzberger; Geoffrey Michael,2,0,32,30
1656025503767,MATH 109,B02,083216,Ganzberger; Geoffrey Michael,0,0,32,32
1656025503767,MATH 109,B03,093479,Staff,3,0,32,29
1656025509797,MATH 142A,A01,083219,Chow; Bennett,1,0,32,31
1656025509797,MATH 142A,A02,083220,Chow; Bennett,7,0,32,25
1656025509797,MATH 142A,A03,093480,Staff,4,0,32,28
1656025509797,MATH 142A,B03,093481,Staff,3,0,32,29
1656025509797,MATH 142A,B04,093558,Staff,6,0,32,26
1656025509797,MATH 142A,B05,093559,Staff,0,0,32,32
1656025515821,MATH 193A,A01,083224,Rotar; Vladimir,1,2,34,33
1656025515821,MATH 193A,A02,083225,Rotar; Vladimir,0,1,34,34
1656025515821,MATH 193A,A03,083781,Rotar; Vladimir,2,0,34,32
1656025515821,MATH 193A,A04,083782,Rotar; Vladimir,3,0,34,31
1656025515821,MATH 193A,A05,093482,Rotar; Vladimir,0,0,34,34
1656025521851,MATH 197,001,091859,McAuley; Julian John,9999,0,9999,0
1656025521851,MATH 197,002,095566,Kedlaya; Kiran S.,9997,0,9999,2
1656025521851,MATH 197,003,095567,Xiao; Ming,9999,0,9999,0
1656025521851,MATH 197,004,095571,Perols; Johan Lars,9998,0,9999,1
1656025528914,COGS 9,A01,083615,Shannon; Kyle Michael,3,1,75,72
1656025535038,COGS 11,A01,083617,Boyle; Mary E. T.,11,1,48,37
1656025541073,COGS 13,A01,083071,Bastos; Amalia Pinkusfeld,4,3,71,67
1656025547097,COGS 14A,A01,092681,Semenuks; Arturs,4,25,100,96
1656025553126,COGS 14B,A01,083073,Cheng; Tzu-Han,7,0,63,56
1656025559160,COGS 17,A01,092677,Semenuks; Arturs,8,7,81,73
1656025565184,COGS 100,A01,083619,Allen; Michael Gordon,2,2,70,68
1656025571209,COGS 101A,A01,083621,Davis; Joshua Daniel,4,3,68,64
1656025577242,COGS 101B,A01,091572,Allen; Michael Gordon,0,0,65,65
1656025583265,COGS 101C,A01,083625,Delgado; Tania,7,0,35,28
1656025589300,COGS 107A,A01,083627,Boyle; Mary E. T.,1,2,60,59
1656025595330,COGS 118A,A01,083075,Gupta; Anjum,21,16,76,55
1656025601359,CSE 3,A50,083646,Miranda; Gregory Joseph,14,0,50,36
1656025607388,CSE 8A,A50,083650,Miranda; Gregory Joseph,4,11,56,52
1656025613414,CSE 11,A01,083080,Cao; Yingjun,0,65,40,40
1656025619438,CSE 12,A01,083652,Krause-Levy; Sophia Louisa,7,8,120,113
1656025625462,CSE 15L,A01,083654,Morris; Justin Loren,3,1,50,47
1656025625462,CSE 15L,A02,083655,Morris; Justin Loren,2,1,50,48
1656025631486,CSE 20,A01,083657,Tran; Khoa Dang,29,0,80,51
1656025637514,CSE 21,A01,095574,Bach; Quang Tran,23,0,48,25
1656025643545,CSE 30,A01,083084,Eldon; John,2,10,80,78
1656025643545,CSE 30,B01,095061,Bhaskar; Nishant,2,5,50,48
1656025649572,CSE 100,A01,083659,Cao; Yingjun,2,25,70,68
1656025655599,CSE 134B,A01,083661,Powell; Thomas Allan,6,6,100,94
1656025661633,CSE 140,A01,083663,Gungor; Onat,5,0,85,80
1656025667659,CSE 140L,A01,083088,Eldon; John,5,0,100,95
1656025673693,CSE 175,A01,083665,Kumar; Rakesh,0,0,25,25
1656025679717,CSE 190,A00,092507,Dubnov; Shlomo,1,0,20,19
1656025685744,ECE 45,A01,083139,Congero; Spencer William,0,1,75,75
1656025691775,ECE 65,A50,083695,Saad; Andrew S,6,0,30,24
1656025691775,ECE 65,A51,095125,Staff,23,0,26,3
1656025697805,ECE 109,A01,091882,Touri; Behrouz,3,5,70,67
1656025703831,ECE 180,A00,083140,Abi Samra; Nicholas Camill,1,0,30,29
1656025703831,ECE 180,B00,083141,Abi Samra; Nicholas Camill,0,8,28,28
1656025709858,MATH 10A,A01,083735,Patchell; Gregory David,0,0,30,30
1656025709858,MATH 10A,A02,083736,Patchell; Gregory David,20,0,30,10
1656025709858,MATH 10A,A03,083737,Patchell; Gregory David,16,0,30,14
1656025715887,MATH 10B,A01,083207,Lim; Seonhee,1,1,34,33
1656025715887,MATH 10B,A02,083208,Lim; Seonhee,1,1,35,34
1656025715887,MATH 10B,A03,093472,Staff,1,0,34,33
1656025715887,MATH 10B,B01,083739,Sinha; Shubham,9,0,30,21
1656025721913,MATH 18,A01,083743,Cinel; Cameron Alexander,5,0,30,25
1656025721913,MATH 18,A02,083744,Cinel; Cameron Alexander,11,0,30,19
1656025721913,MATH 18,A03,083745,Cinel; Cameron Alexander,1,0,30,29
1656025721913,MATH 18,B01,083748,Ma; Zilu,0,0,36,36
1656025721913,MATH 18,B02,083749,Ma; Zilu,0,0,36,36
1656025721913,MATH 18,B03,083750,Ma; Zilu,0,0,36,36
1656025721913,MATH 18,B04,083751,Ma; Zilu,0,0,36,36
1656025721913,MATH 18,B05,093473,Staff,0,0,36,36
1656025721913,MATH 18,B06,093474,Staff,3,0,36,33
1656025727935,MATH 20A,A01,083754,Zheng; Zequn,11,0,40,29
1656025733959,MATH 20B,A01,083756,Briones; Jor-el Thomas Caparas,0,1,36,36
1656025733959,MATH 20B,A02,083757,Briones; Jor-el Thomas Caparas,1,0,36,35
1656025733959,MATH 20B,A03,093475,Staff,0,0,36,36
1656025739991,MATH 20C,A01,083760,Briones; Jor-el Thomas Caparas,0,2,35,35
1656025739991,MATH 20C,A02,083761,Briones; Jor-el Thomas Caparas,6,1,35,29
1656025739991,MATH 20C,A03,093476,Staff,0,0,35,35
1656025739991,MATH 20C,B01,083762,Bach; Quang Tran,3,0,30,27
1656025746018,MATH 20D,A01,083765,Tran; Brian Kha,2,0,30,28
1656025746018,MATH 20D,A02,083766,Tran; Brian Kha,0,1,30,30
1656025746018,MATH 20D,A03,083767,Tran; Brian Kha,1,0,30,29
1656025752043,MATH 20E,A01,083771,Ganguly; Soumya,0,1,32,32
1656025752043,MATH 20E,A02,083772,Ganguly; Soumya,1,1,32,31
1656025752043,MATH 20E,B01,083773,Ciotti; Benjamin,13,0,35,22
1656025752043,MATH 20E,B02,083774,Ciotti; Benjamin,12,0,35,23
1656025758074,MATH 103A,A01,083777,Greenfeld; Be'Eri,2,1,36,34
1656025758074,MATH 103A,A02,083778,Greenfeld; Be'Eri,1,0,36,35
1656025758074,MATH 103A,A03,093561,Staff,0,1,36,36
1656025758074,MATH 103A,B01,083779,Greenfeld; Be'Eri,8,1,36,28
1656025758074,MATH 103A,B02,083780,Greenfeld; Be'Eri,0,0,36,36
1656025758074,MATH 103A,B03,093562,Staff,0,0,36,36
1656025764099,MATH 105,A01,085443,Carter; Anne Toulson,4,1,35,31
1656025764099,MATH 105,A02,093477,Staff,9,0,35,26
1656025770134,MATH 109,A01,083213,Ganzberger; Geoffrey Michael,0,1,34,34
1656025770134,MATH 109,A02,083214,Ganzberger; Geoffrey Michael,0,0,34,34
1656025770134,MATH 109,A03,093478,Staff,1,0,34,33
1656025770134,MATH 109,B01,083215,Ganzberger; Geoffrey Michael,2,0,32,30
1656025770134,MATH 109,B02,083216,Ganzberger; Geoffrey Michael,0,0,32,32
1656025770134,MATH 109,B03,093479,Staff,3,0,32,29
1656025776170,MATH 142A,A01,083219,Chow; Bennett,1,0,32,31
1656025776170,MATH 142A,A02,083220,Chow; Bennett,7,0,32,25
1656025776170,MATH 142A,A03,093480,Staff,4,0,32,28
1656025776170,MATH 142A,B03,093481,Staff,3,0,32,29
1656025776170,MATH 142A,B04,093558,Staff,6,0,32,26
1656025776170,MATH 142A,B05,093559,Staff,0,0,32,32
1656025782197,MATH 193A,A01,083224,Rotar; Vladimir,1,2,34,33
1656025782197,MATH 193A,A02,083225,Rotar; Vladimir,0,1,34,34
1656025782197,MATH 193A,A03,083781,Rotar; Vladimir,2,0,34,32
1656025782197,MATH 193A,A04,083782,Rotar; Vladimir,3,0,34,31
1656025782197,MATH 193A,A05,093482,Rotar; Vladimir,0,0,34,34
1656025788220,MATH 197,001,091859,McAuley; Julian John,9999,0,9999,0
1656025788220,MATH 197,002,095566,Kedlaya; Kiran S.,9997,0,9999,2
1656025788220,MATH 197,003,095567,Xiao; Ming,9999,0,9999,0
1656025788220,MATH 197,004,095571,Perols; Johan Lars,9998,0,9999,1
1656025795278,COGS 9,A01,083615,Shannon; Kyle Michael,3,1,75,72
1656025801306,COGS 11,A01,083617,Boyle; Mary E. T.,11,1,48,37
1656025807330,COGS 13,A01,083071,Bastos; Amalia Pinkusfeld,4,3,71,67
1656025813359,COGS 14A,A01,092681,Semenuks; Arturs,4,25,100,96
1656025819386,COGS 14B,A01,083073,Cheng; Tzu-Han,7,0,63,56
1656025825412,COGS 17,A01,092677,Semenuks; Arturs,8,7,81,73
1656025831433,COGS 100,A01,083619,Allen; Michael Gordon,2,2,70,68
1656025837458,COGS 101A,A01,083621,Davis; Joshua Daniel,4,3,68,64
1656025843480,COGS 101B,A01,091572,Allen; Michael Gordon,0,0,65,65
1656025849503,COGS 101C,A01,083625,Delgado; Tania,7,0,35,28
1656025855533,COGS 107A,A01,083627,Boyle; Mary E. T.,1,2,60,59
1656025861558,COGS 118A,A01,083075,Gupta; Anjum,21,16,76,55
1656025867580,CSE 3,A50,083646,Miranda; Gregory Joseph,14,0,50,36
1656025873611,CSE 8A,A50,083650,Miranda; Gregory Joseph,4,11,56,52
1656025879647,CSE 11,A01,083080,Cao; Yingjun,0,65,40,40
1656025885670,CSE 12,A01,083652,Krause-Levy; Sophia Louisa,7,8,120,113
1656025891692,CSE 15L,A01,083654,Morris; Justin Loren,3,1,50,47
1656025891692,CSE 15L,A02,083655,Morris; Justin Loren,2,1,50,48
1656025897716,CSE 20,A01,083657,Tran; Khoa Dang,29,0,80,51
1656025903739,CSE 21,A01,095574,Bach; Quang Tran,23,0,48,25
1656025909770,CSE 30,A01,083084,Eldon; John,2,10,80,78
1656025909770,CSE 30,B01,095061,Bhaskar; Nishant,2,5,50,48
1656025915798,CSE 100,A01,083659,Cao; Yingjun,2,25,70,68
1656025921825,CSE 134B,A01,083661,Powell; Thomas Allan,6,6,100,94
1656025927850,CSE 140,A01,083663,Gungor; Onat,5,0,85,80
1656025933886,CSE 140L,A01,083088,Eldon; John,5,0,100,95
1656025939911,CSE 175,A01,083665,Kumar; Rakesh,0,0,25,25
1656025945934,CSE 190,A00,092507,Dubnov; Shlomo,1,0,20,19
1656025951962,ECE 45,A01,083139,Congero; Spencer William,1,1,75,74
1656025958013,ECE 65,A50,083695,Saad; Andrew S,6,0,30,24
1656025958013,ECE 65,A51,095125,Staff,23,0,26,3
1656025964040,ECE 109,A01,091882,Touri; Behrouz,3,5,70,67
1656025970079,ECE 180,A00,083140,Abi Samra; Nicholas Camill,1,0,30,29
1656025970079,ECE 180,B00,083141,Abi Samra; Nicholas Camill,0,8,28,28
1656025976111,MATH 10A,A01,083735,Patchell; Gregory David,0,0,30,30
1656025976111,MATH 10A,A02,083736,Patchell; Gregory David,20,0,30,10
1656025976111,MATH 10A,A03,083737,Patchell; Gregory David,16,0,30,14
1656025982140,MATH 10B,A01,083207,Lim; Seonhee,1,1,34,33
1656025982140,MATH 10B,A02,083208,Lim; Seonhee,1,1,35,34
1656025982140,MATH 10B,A03,093472,Staff,1,0,34,33
1656025982140,MATH 10B,B01,083739,Sinha; Shubham,9,0,30,21
1656025988165,MATH 18,A01,083743,Cinel; Cameron Alexander,5,0,30,25
1656025988165,MATH 18,A02,083744,Cinel; Cameron Alexander,11,0,30,19
1656025988165,MATH 18,A03,083745,Cinel; Cameron Alexander,1,0,30,29
1656025988165,MATH 18,B01,083748,Ma; Zilu,0,0,36,36
1656025988165,MATH 18,B02,083749,Ma; Zilu,0,0,36,36
1656025988165,MATH 18,B03,083750,Ma; Zilu,0,0,36,36
1656025988165,MATH 18,B04,083751,Ma; Zilu,0,0,36,36
1656025988165,MATH 18,B05,093473,Staff,0,0,36,36
1656025988165,MATH 18,B06,093474,Staff,3,0,36,33
1656025994188,MATH 20A,A01,083754,Zheng; Zequn,11,0,40,29
1656026000227,MATH 20B,A01,083756,Briones; Jor-el Thomas Caparas,0,1,36,36
1656026000227,MATH 20B,A02,083757,Briones; Jor-el Thomas Caparas,1,0,36,35
1656026000227,MATH 20B,A03,093475,Staff,0,0,36,36
1656026006256,MATH 20C,A01,083760,Briones; Jor-el Thomas Caparas,0,2,35,35
1656026006256,MATH 20C,A02,083761,Briones; Jor-el Thomas Caparas,6,1,35,29
1656026006256,MATH 20C,A03,093476,Staff,0,0,35,35
1656026006256,MATH 20C,B01,083762,Bach; Quang Tran,3,0,30,27
1656026012279,MATH 20D,A01,083765,Tran; Brian Kha,2,0,30,28
1656026012279,MATH 20D,A02,083766,Tran; Brian Kha,0,1,30,30
1656026012279,MATH 20D,A03,083767,Tran; Brian Kha,1,0,30,29
1656026018424,MATH 20E,A01,083771,Ganguly; Soumya,0,1,32,32
1656026018424,MATH 20E,A02,083772,Ganguly; Soumya,1,1,32,31
1656026018424,MATH 20E,B01,083773,Ciotti; Benjamin,13,0,35,22
1656026018424,MATH 20E,B02,083774,Ciotti; Benjamin,12,0,35,23
1656026024448,MATH 103A,A01,083777,Greenfeld; Be'Eri,2,1,36,34
1656026024448,MATH 103A,A02,083778,Greenfeld; Be'Eri,1,0,36,35
1656026024448,MATH 103A,A03,093561,Staff,0,1,36,36
1656026024448,MATH 103A,B01,083779,Greenfeld; Be'Eri,8,1,36,28
1656026024448,MATH 103A,B02,083780,Greenfeld; Be'Eri,0,0,36,36
1656026024448,MATH 103A,B03,093562,Staff,0,0,36,36
1656026030560,MATH 105,A01,085443,Carter; Anne Toulson,4,1,35,31
1656026030560,MATH 105,A02,093477,Staff,9,0,35,26
1656026036584,MATH 109,A01,083213,Ganzberger; Geoffrey Michael,0,1,34,34
1656026036584,MATH 109,A02,083214,Ganzberger; Geoffrey Michael,0,0,34,34
1656026036584,MATH 109,A03,093478,Staff,1,0,34,33
1656026036584,MATH 109,B01,083215,Ganzberger; Geoffrey Michael,2,0,32,30
1656026036584,MATH 109,B02,083216,Ganzberger; Geoffrey Michael,0,0,32,32
1656026036584,MATH 109,B03,093479,Staff,3,0,32,29
1656026042642,MATH 142A,A01,083219,Chow; Bennett,1,0,32,31
1656026042642,MATH 142A,A02,083220,Chow; Bennett,7,0,32,25
1656026042642,MATH 142A,A03,093480,Staff,4,0,32,28
1656026042642,MATH 142A,B03,093481,Staff,3,0,32,29
1656026042642,MATH 142A,B04,093558,Staff,6,0,32,26
1656026042642,MATH 142A,B05,093559,Staff,0,0,32,32
1656026048718,MATH 193A,A01,083224,Rotar; Vladimir,1,2,34,33
1656026048718,MATH 193A,A02,083225,Rotar; Vladimir,0,1,34,34
1656026048718,MATH 193A,A03,083781,Rotar; Vladimir,2,0,34,32
1656026048718,MATH 193A,A04,083782,Rotar; Vladimir,3,0,34,31
1656026048718,MATH 193A,A05,093482,Rotar; Vladimir,0,0,34,34
1656026054741,MATH 197,001,091859,McAuley; Julian John,9999,0,9999,0
1656026054741,MATH 197,002,095566,Kedlaya; Kiran S.,9997,0,9999,2
1656026054741,MATH 197,003,095567,Xiao; Ming,9999,0,9999,0
1656026054741,MATH 197,004,095571,Perols; Johan Lars,9998,0,9999,1
1656026061807,COGS 9,A01,083615,Shannon; Kyle Michael,3,1,75,72
1656026067829,COGS 11,A01,083617,Boyle; Mary E. T.,11,1,48,37
1656026073863,COGS 13,A01,083071,Bastos; Amalia Pinkusfeld,4,3,71,67
1656026079902,COGS 14A,A01,092681,Semenuks; Arturs,4,25,100,96
1656026086019,COGS 14B,A01,083073,Cheng; Tzu-Han,7,0,63,56
1656026092056,COGS 17,A01,092677,Semenuks; Arturs,8,7,81,73
1656026098136,COGS 100,A01,083619,Allen; Michael Gordon,2,2,70,68
1656026104160,COGS 101A,A01,083621,Davis; Joshua Daniel,4,3,68,64
1656026110188,COGS 101B,A01,091572,Allen; Michael Gordon,0,0,65,65
1656026116215,COGS 101C,A01,083625,Delgado; Tania,7,0,35,28
1656026122282,COGS 107A,A01,083627,Boyle; Mary E. T.,1,2,60,59
1656026128415,COGS 118A,A01,083075,Gupta; Anjum,21,16,76,55
1656026134533,CSE 3,A50,083646,Miranda; Gregory Joseph,14,0,50,36
1656026140630,CSE 8A,A50,083650,Miranda; Gregory Joseph,4,11,56,52
1656026146654,CSE 11,A01,083080,Cao; Yingjun,0,65,40,40
1656026152678,CSE 12,A01,083652,Krause-Levy; Sophia Louisa,7,8,120,113
1656026158823,CSE 15L,A01,083654,Morris; Justin Loren,3,1,50,47
1656026158823,CSE 15L,A02,083655,Morris; Justin Loren,2,1,50,48
1656026164992,CSE 20,A01,083657,Tran; Khoa Dang,29,0,80,51
1656026171016,CSE 21,A01,095574,Bach; Quang Tran,23,0,48,25
1656026177041,CSE 30,A01,083084,Eldon; John,2,10,80,78
1656026177041,CSE 30,B01,095061,Bhaskar; Nishant,2,5,50,48
1656026183088,CSE 100,A01,083659,Cao; Yingjun,2,25,70,68
1656026189204,CSE 134B,A01,083661,Powell; Thomas Allan,6,6,100,94
1656026195247,CSE 140,A01,083663,Gungor; Onat,5,0,85,80
1656026201315,CSE 140L,A01,083088,Eldon; John,5,0,100,95
1656026207342,CSE 175,A01,083665,Kumar; Rakesh,0,0,25,25
1656026213450,CSE 190,A00,092507,Dubnov; Shlomo,1,0,20,19
1656026219477,ECE 45,A01,083139,Congero; Spencer William,1,1,75,74
1656026225520,ECE 65,A50,083695,Saad; Andrew S,6,0,30,24
1656026225520,ECE 65,A51,095125,Staff,23,0,26,3
1656026231546,ECE 109,A01,091882,Touri; Behrouz,3,5,70,67
1656026237646,ECE 180,A00,083140,Abi Samra; Nicholas Camill,1,0,30,29
1656026237646,ECE 180,B00,083141,Abi Samra; Nicholas Camill,0,8,28,28
1656026243698,MATH 10A,A01,083735,Patchell; Gregory David,0,0,30,30
1656026243698,MATH 10A,A02,083736,Patchell; Gregory David,20,0,30,10
1656026243698,MATH 10A,A03,083737,Patchell; Gregory David,16,0,30,14
1656026249720,MATH 10B,A01,083207,Lim; Seonhee,1,1,34,33
1656026249720,MATH 10B,A02,083208,Lim; Seonhee,1,1,35,34
1656026249720,MATH 10B,A03,093472,Staff,1,0,34,33
1656026249720,MATH 10B,B01,083739,Sinha; Shubham,9,0,30,21
1656026255768,MATH 18,A01,083743,Cinel; Cameron Alexander,5,0,30,25
1656026255768,MATH 18,A02,083744,Cinel; Cameron Alexander,11,0,30,19
1656026255768,MATH 18,A03,083745,Cinel; Cameron Alexander,1,0,30,29
1656026255768,MATH 18,B01,083748,Ma; Zilu,0,0,36,36
1656026255768,MATH 18,B02,083749,Ma; Zilu,0,0,36,36
1656026255768,MATH 18,B03,083750,Ma; Zilu,0,0,36,36
1656026255768,MATH 18,B04,083751,Ma; Zilu,0,0,36,36
1656026255768,MATH 18,B05,093473,Staff,0,0,36,36
1656026255768,MATH 18,B06,093474,Staff,3,0,36,33
1656026261865,MATH 20A,A01,083754,Zheng; Zequn,11,0,40,29
1656026267887,MATH 20B,A01,083756,Briones; Jor-el Thomas Caparas,0,1,36,36
1656026267887,MATH 20B,A02,083757,Briones; Jor-el Thomas Caparas,1,0,36,35
1656026267887,MATH 20B,A03,093475,Staff,0,0,36,36
1656026273916,MATH 20C,A01,083760,Briones; Jor-el Thomas Caparas,0,2,35,35
1656026273916,MATH 20C,A02,083761,Briones; Jor-el Thomas Caparas,6,1,35,29
1656026273916,MATH 20C,A03,093476,Staff,0,0,35,35
1656026273916,MATH 20C,B01,083762,Bach; Quang Tran,3,0,30,27
1656026279947,MATH 20D,A01,083765,Tran; Brian Kha,1,0,30,29
1656026279947,MATH 20D,A02,083766,Tran; Brian Kha,0,1,30,30
1656026279947,MATH 20D,A03,083767,Tran; Brian Kha,1,0,30,29
1656026286041,MATH 20E,A01,083771,Ganguly; Soumya,0,1,32,32
1656026286041,MATH 20E,A02,083772,Ganguly; Soumya,1,1,32,31
1656026286041,MATH 20E,B01,083773,Ciotti; Benjamin,13,0,35,22
1656026286041,MATH 20E,B02,083774,Ciotti; Benjamin,12,0,35,23
1656026292104,MATH 103A,A01,083777,Greenfeld; Be'Eri,2,1,36,34
1656026292104,MATH 103A,A02,083778,Greenfeld; Be'Eri,1,0,36,35
1656026292104,MATH 103A,A03,093561,Staff,0,1,36,36
1656026292104,MATH 103A,B01,083779,Greenfeld; Be'Eri,8,1,36,28
1656026292104,MATH 103A,B02,083780,Greenfeld; Be'Eri,0,0,36,36
1656026292104,MATH 103A,B03,093562,Staff,0,0,36,36
1656026298130,MATH 105,A01,085443,Carter; Anne Toulson,4,1,35,31
1656026298130,MATH 105,A02,093477,Staff,9,0,35,26
1656026304254,MATH 109,A01,083213,Ganzberger; Geoffrey Michael,0,1,34,34
1656026304254,MATH 109,A02,083214,Ganzberger; Geoffrey Michael,0,0,34,34
1656026304254,MATH 109,A03,093478,Staff,1,0,34,33
1656026304254,MATH 109,B01,083215,Ganzberger; Geoffrey Michael,2,0,32,30
1656026304254,MATH 109,B02,083216,Ganzberger; Geoffrey Michael,0,0,32,32
1656026304254,MATH 109,B03,093479,Staff,3,0,32,29
1656026310426,MATH 142A,A01,083219,Chow; Bennett,1,0,32,31
1656026310426,MATH 142A,A02,083220,Chow; Bennett,7,0,32,25
1656026310426,MATH 142A,A03,093480,Staff,4,0,32,28
1656026310426,MATH 142A,B03,093481,Staff,3,0,32,29
1656026310426,MATH 142A,B04,093558,Staff,6,0,32,26
1656026310426,MATH 142A,B05,093559,Staff,0,0,32,32
1656026316452,MATH 193A,A01,083224,Rotar; Vladimir,1,2,34,33
1656026316452,MATH 193A,A02,083225,Rotar; Vladimir,0,1,34,34
1656026316452,MATH 193A,A03,083781,Rotar; Vladimir,2,0,34,32
1656026316452,MATH 193A,A04,083782,Rotar; Vladimir,3,0,34,31
1656026316452,MATH 193A,A05,093482,Rotar; Vladimir,0,0,34,34
1656026322495,MATH 197,001,091859,McAuley; Julian John,9999,0,9999,0
1656026322495,MATH 197,002,095566,Kedlaya; Kiran S.,9997,0,9999,2
1656026322495,MATH 197,003,095567,Xiao; Ming,9999,0,9999,0
1656026322495,MATH 197,004,095571,Perols; Johan Lars,9998,0,9999,1
1656026329629,COGS 9,A01,083615,Shannon; Kyle Michael,3,1,75,72
1656026335667,COGS 11,A01,083617,Boyle; Mary E. T.,11,1,48,37
1656026341729,COGS 13,A01,083071,Bastos; Amalia Pinkusfeld,4,3,71,67
1656026347821,COGS 14A,A01,092681,Semenuks; Arturs,4,25,100,96
1656026353845,COGS 14B,A01,083073,Cheng; Tzu-Han,7,0,63,56
1656026359869,COGS 17,A01,092677,Semenuks; Arturs,8,7,81,73
1656026365917,COGS 100,A01,083619,Allen; Michael Gordon,2,2,70,68
1656026371987,COGS 101A,A01,083621,Davis; Joshua Daniel,4,3,68,64
1656026378040,COGS 101B,A01,091572,Allen; Michael Gordon,0,0,65,65
1656026384108,COGS 101C,A01,083625,Delgado; Tania,7,0,35,28
1656026390233,COGS 107A,A01,083627,Boyle; Mary E. T.,1,2,60,59
1656026396285,COGS 118A,A01,083075,Gupta; Anjum,21,16,76,55
1656026402317,CSE 3,A50,083646,Miranda; Gregory Joseph,14,0,50,36
1656026408426,CSE 8A,A50,083650,Miranda; Gregory Joseph,4,11,56,52
1656026414496,CSE 11,A01,083080,Cao; Yingjun,0,65,40,40
1656026420579,CSE 12,A01,083652,Krause-Levy; Sophia Louisa,7,8,120,113
1656026426655,CSE 15L,A01,083654,Morris; Justin Loren,3,1,50,47
1656026426655,CSE 15L,A02,083655,Morris; Justin Loren,2,1,50,48
1656026432768,CSE 20,A01,083657,Tran; Khoa Dang,29,0,80,51
1656026438849,CSE 21,A01,095574,Bach; Quang Tran,23,0,48,25
1656026444885,CSE 30,A01,083084,Eldon; John,2,10,80,78
1656026444885,CSE 30,B01,095061,Bhaskar; Nishant,2,5,50,48
1656026450936,CSE 100,A01,083659,Cao; Yingjun,2,25,70,68
1656026457029,CSE 134B,A01,083661,Powell; Thomas Allan,6,6,100,94
1656026463094,CSE 140,A01,083663,Gungor; Onat,5,0,85,80
1656026469199,CSE 140L,A01,083088,Eldon; John,5,0,100,95
1656026475223,CSE 175,A01,083665,Kumar; Rakesh,0,0,25,25
1656026481252,CSE 190,A00,092507,Dubnov; Shlomo,1,0,20,19
1656026487285,ECE 45,A01,083139,Congero; Spencer William,1,1,75,74
1656026493367,ECE 65,A50,083695,Saad; Andrew S,6,0,30,24
1656026493367,ECE 65,A51,095125,Staff,23,0,26,3
1656026499423,ECE 109,A01,091882,Touri; Behrouz,3,5,70,67
1656026505519,ECE 180,A00,083140,Abi Samra; Nicholas Camill,1,0,30,29
1656026505519,ECE 180,B00,083141,Abi Samra; Nicholas Camill,0,8,28,28
1656026511618,MATH 10A,A01,083735,Patchell; Gregory David,0,0,30,30
1656026511618,MATH 10A,A02,083736,Patchell; Gregory David,20,0,30,10
1656026511618,MATH 10A,A03,083737,Patchell; Gregory David,16,0,30,14
1656026517640,MATH 10B,A01,083207,Lim; Seonhee,1,1,34,33
1656026517640,MATH 10B,A02,083208,Lim; Seonhee,1,1,35,34
1656026517640,MATH 10B,A03,093472,Staff,1,0,34,33
1656026517640,MATH 10B,B01,083739,Sinha; Shubham,9,0,30,21
1656026523751,MATH 18,A01,083743,Cinel; Cameron Alexander,5,0,30,25
1656026523751,MATH 18,A02,083744,Cinel; Cameron Alexander,11,0,30,19
1656026523751,MATH 18,A03,083745,Cinel; Cameron Alexander,1,0,30,29
1656026523751,MATH 18,B01,083748,Ma; Zilu,0,0,36,36
1656026523751,MATH 18,B02,083749,Ma; Zilu,0,0,36,36
1656026523751,MATH 18,B03,083750,Ma; Zilu,0,0,36,36
1656026523751,MATH 18,B04,083751,Ma; Zilu,0,0,36,36
1656026523751,MATH 18,B05,093473,Staff,0,0,36,36
1656026523751,MATH 18,B06,093474,Staff,3,0,36,33
1656026529777,MATH 20A,A01,083754,Zheng; Zequn,11,0,40,29
1656026535800,MATH 20B,A01,083756,Briones; Jor-el Thomas Caparas,0,1,36,36
1656026535800,MATH 20B,A02,083757,Briones; Jor-el Thomas Caparas,1,0,36,35
1656026535800,MATH 20B,A03,093475,Staff,0,0,36,36
1656026541828,MATH 20C,A01,083760,Briones; Jor-el Thomas Caparas,0,2,35,35
1656026541828,MATH 20C,A02,083761,Briones; Jor-el Thomas Caparas,6,1,35,29
1656026541828,MATH 20C,A03,093476,Staff,0,0,35,35
1656026541828,MATH 20C,B01,083762,Bach; Quang Tran,3,0,30,27
1656026547878,MATH 20D,A01,083765,Tran; Brian Kha,2,0,30,28
1656026547878,MATH 20D,A02,083766,Tran; Brian Kha,0,1,30,30
1656026547878,MATH 20D,A03,083767,Tran; Brian Kha,1,0,30,29
1656026553967,MATH 20E,A01,083771,Ganguly; Soumya,0,1,32,32
1656026553967,MATH 20E,A02,083772,Ganguly; Soumya,1,1,32,31
1656026553967,MATH 20E,B01,083773,Ciotti; Benjamin,13,0,35,22
1656026553967,MATH 20E,B02,083774,Ciotti; Benjamin,12,0,35,23
1656026560041,MATH 103A,A01,083777,Greenfeld; Be'Eri,2,1,36,34
1656026560041,MATH 103A,A02,083778,Greenfeld; Be'Eri,1,0,36,35
1656026560041,MATH 103A,A03,093561,Staff,0,1,36,36
1656026560041,MATH 103A,B01,083779,Greenfeld; Be'Eri,8,1,36,28
1656026560041,MATH 103A,B02,083780,Greenfeld; Be'Eri,0,0,36,36
1656026560041,MATH 103A,B03,093562,Staff,0,0,36,36
1656026566063,MATH 105,A01,085443,Carter; Anne Toulson,4,1,35,31
1656026566063,MATH 105,A02,093477,Staff,9,0,35,26
1656026572125,MATH 109,A01,083213,Ganzberger; Geoffrey Michael,0,1,34,34
1656026572125,MATH 109,A02,083214,Ganzberger; Geoffrey Michael,0,0,34,34
1656026572125,MATH 109,A03,093478,Staff,1,0,34,33
1656026572125,MATH 109,B01,083215,Ganzberger; Geoffrey Michael,2,0,32,30
1656026572125,MATH 109,B02,083216,Ganzberger; Geoffrey Michael,0,0,32,32
1656026572125,MATH 109,B03,093479,Staff,3,0,32,29
1656026578270,MATH 142A,A01,083219,Chow; Bennett,1,0,32,31
1656026578270,MATH 142A,A02,083220,Chow; Bennett,7,0,32,25
1656026578270,MATH 142A,A03,093480,Staff,4,0,32,28
1656026578270,MATH 142A,B03,093481,Staff,3,0,32,29
1656026578270,MATH 142A,B04,093558,Staff,6,0,32,26
1656026578270,MATH 142A,B05,093559,Staff,0,0,32,32
1656026584341,MATH 193A,A01,083224,Rotar; Vladimir,1,2,34,33
1656026584341,MATH 193A,A02,083225,Rotar; Vladimir,0,1,34,34
1656026584341,MATH 193A,A03,083781,Rotar; Vladimir,2,0,34,32
1656026584341,MATH 193A,A04,083782,Rotar; Vladimir,3,0,34,31
1656026584341,MATH 193A,A05,093482,Rotar; Vladimir,0,0,34,34
1656026590379,MATH 197,001,091859,McAuley; Julian John,9999,0,9999,0
1656026590379,MATH 197,002,095566,Kedlaya; Kiran S.,9997,0,9999,2
1656026590379,MATH 197,003,095567,Xiao; Ming,9999,0,9999,0
1656026590379,MATH 197,004,095571,Perols; Johan Lars,9998,0,9999,1
1656026597513,COGS 9,A01,083615,Shannon; Kyle Michael,3,1,75,72
1656026603590,COGS 11,A01,083617,Boyle; Mary E. T.,11,1,48,37
1656026609689,COGS 13,A01,083071,Bastos; Amalia Pinkusfeld,4,3,71,67
1656026615743,COGS 14A,A01,092681,Semenuks; Arturs,4,25,100,96
1656026621800,COGS 14B,A01,083073,Cheng; Tzu-Han,7,0,63,56
1656026627904,COGS 17,A01,092677,Semenuks; Arturs,8,7,81,73
1656026633945,COGS 100,A01,083619,Allen; Michael Gordon,2,2,70,68
1656026640074,COGS 101A,A01,083621,Davis; Joshua Daniel,4,3,68,64
1656026646188,COGS 101B,A01,091572,Allen; Michael Gordon,0,0,65,65
1656026652227,COGS 101C,A01,083625,Delgado; Tania,7,0,35,28
1656026658269,COGS 107A,A01,083627,Boyle; Mary E. T.,1,2,60,59
1656026664301,COGS 118A,A01,083075,Gupta; Anjum,21,16,76,55
1656026670328,CSE 3,A50,083646,Miranda; Gregory Joseph,14,0,50,36
1656026676350,CSE 8A,A50,083650,Miranda; Gregory Joseph,4,11,56,52
1656026682453,CSE 11,A01,083080,Cao; Yingjun,0,65,40,40
1656026688505,CSE 12,A01,083652,Krause-Levy; Sophia Louisa,7,8,120,113
1656026694615,CSE 15L,A01,083654,Morris; Justin Loren,3,1,50,47
1656026694615,CSE 15L,A02,083655,Morris; Justin Loren,2,1,50,48
1656026700714,CSE 20,A01,083657,Tran; Khoa Dang,29,0,80,51
1656026706839,CSE 21,A01,095574,Bach; Quang Tran,23,0,48,25
1656026712886,CSE 30,A01,083084,Eldon; John,2,10,80,78
1656026712886,CSE 30,B01,095061,Bhaskar; Nishant,2,5,50,48
1656026718907,CSE 100,A01,083659,Cao; Yingjun,2,25,70,68
1656026724929,CSE 134B,A01,083661,Powell; Thomas Allan,6,6,100,94
1656026730971,CSE 140,A01,083663,Gungor; Onat,5,0,85,80
1656026737124,CSE 140L,A01,083088,Eldon; John,5,0,100,95
1656026743190,CSE 175,A01,083665,Kumar; Rakesh,0,0,25,25
1656026749212,CSE 190,A00,092507,Dubnov; Shlomo,1,0,20,19
1656026755356,ECE 45,A01,083139,Congero; Spencer William,1,1,75,74
1656026761381,ECE 65,A50,083695,Saad; Andrew S,6,0,30,24
1656026761381,ECE 65,A51,095125,Staff,23,0,26,3
1656026767459,ECE 109,A01,091882,Touri; Behrouz,3,5,70,67
1656026773607,ECE 180,A00,083140,Abi Samra; Nicholas Camill,1,0,30,29
1656026773607,ECE 180,B00,083141,Abi Samra; Nicholas Camill,0,8,28,28
1656026779650,MATH 10A,A01,083735,Patchell; Gregory David,0,0,30,30
1656026779650,MATH 10A,A02,083736,Patchell; Gregory David,20,0,30,10
1656026779650,MATH 10A,A03,083737,Patchell; Gregory David,16,0,30,14
1656026785743,MATH 10B,A01,083207,Lim; Seonhee,1,1,34,33
1656026785743,MATH 10B,A02,083208,Lim; Seonhee,1,1,35,34
1656026785743,MATH 10B,A03,093472,Staff,1,0,34,33
1656026785743,MATH 10B,B01,083739,Sinha; Shubham,9,0,30,21
1656026791841,MATH 18,A01,083743,Cinel; Cameron Alexander,5,0,30,25
1656026791841,MATH 18,A02,083744,Cinel; Cameron Alexander,11,0,30,19
1656026791841,MATH 18,A03,083745,Cinel; Cameron Alexander,1,0,30,29
1656026791841,MATH 18,B01,083748,Ma; Zilu,0,0,36,36
1656026791841,MATH 18,B02,083749,Ma; Zilu,0,0,36,36
1656026791841,MATH 18,B03,083750,Ma; Zilu,0,0,36,36
1656026791841,MATH 18,B04,083751,Ma; Zilu,0,0,36,36
1656026791841,MATH 18,B05,093473,Staff,0,0,36,36
1656026791841,MATH 18,B06,093474,Staff,3,0,36,33
1656026797955,MATH 20A,A01,083754,Zheng; Zequn,11,0,40,29
1656026803995,MATH 20B,A01,083756,Briones; Jor-el Thomas Caparas,0,1,36,36
1656026803995,MATH 20B,A02,083757,Briones; Jor-el Thomas Caparas,1,0,36,35
1656026803995,MATH 20B,A03,093475,Staff,0,0,36,36
1656026810085,MATH 20C,A01,083760,Briones; Jor-el Thomas Caparas,0,2,35,35
1656026810085,MATH 20C,A02,083761,Briones; Jor-el Thomas Caparas,6,1,35,29
1656026810085,MATH 20C,A03,093476,Staff,0,0,35,35
1656026810085,MATH 20C,B01,083762,Bach; Quang Tran,3,0,30,27
1656026816129,MATH 20D,A01,083765,Tran; Brian Kha,2,0,30,28
1656026816129,MATH 20D,A02,083766,Tran; Brian Kha,0,1,30,30
1656026816129,MATH 20D,A03,083767,Tran; Brian Kha,1,0,30,29
1656026822301,MATH 20E,A01,083771,Ganguly; Soumya,0,1,32,32
1656026822301,MATH 20E,A02,083772,Ganguly; Soumya,1,1,32,31
1656026822301,MATH 20E,B01,083773,Ciotti; Benjamin,13,0,35,22
1656026822301,MATH 20E,B02,083774,Ciotti; Benjamin,12,0,35,23
1656026828380,MATH 103A,A01,083777,Greenfeld; Be'Eri,2,1,36,34
1656026828380,MATH 103A,A02,083778,Greenfeld; Be'Eri,1,0,36,35
1656026828380,MATH 103A,A03,093561,Staff,0,1,36,36
1656026828380,MATH 103A,B01,083779,Greenfeld; Be'Eri,8,1,36,28
1656026828380,MATH 103A,B02,083780,Greenfeld; Be'Eri,0,0,36,36
1656026828380,MATH 103A,B03,093562,Staff,0,0,36,36
1656026834403,MATH 105,A01,085443,Carter; Anne Toulson,4,1,35,31
1656026834403,MATH 105,A02,093477,Staff,9,0,35,26
1656026840497,MATH 109,A01,083213,Ganzberger; Geoffrey Michael,0,1,34,34
1656026840497,MATH 109,A02,083214,Ganzberger; Geoffrey Michael,0,0,34,34
1656026840497,MATH 109,A03,093478,Staff,1,0,34,33
1656026840497,MATH 109,B01,083215,Ganzberger; Geoffrey Michael,2,0,32,30
1656026840497,MATH 109,B02,083216,Ganzberger; Geoffrey Michael,0,0,32,32
1656026840497,MATH 109,B03,093479,Staff,3,0,32,29
1656026846578,MATH 142A,A01,083219,Chow; Bennett,1,0,32,31
1656026846578,MATH 142A,A02,083220,Chow; Bennett,7,0,32,25
1656026846578,MATH 142A,A03,093480,Staff,4,0,32,28
1656026846578,MATH 142A,B03,093481,Staff,3,0,32,29
1656026846578,MATH 142A,B04,093558,Staff,6,0,32,26
1656026846578,MATH 142A,B05,093559,Staff,0,0,32,32
1656026852604,MATH 193A,A01,083224,Rotar; Vladimir,1,2,34,33
1656026852604,MATH 193A,A02,083225,Rotar; Vladimir,0,1,34,34
1656026852604,MATH 193A,A03,083781,Rotar; Vladimir,2,0,34,32
1656026852604,MATH 193A,A04,083782,Rotar; Vladimir,3,0,34,31
1656026852604,MATH 193A,A05,093482,Rotar; Vladimir,0,0,34,34
1656026858630,MATH 197,001,091859,McAuley; Julian John,9999,0,9999,0
1656026858630,MATH 197,002,095566,Kedlaya; Kiran S.,9997,0,9999,2
1656026858630,MATH 197,003,095567,Xiao; Ming,9999,0,9999,0
1656026858630,MATH 197,004,095571,Perols; Johan Lars,9998,0,9999,1
1656026865720,COGS 9,A01,083615,Shannon; Kyle Michael,3,1,75,72
1656026871743,COGS 11,A01,083617,Boyle; Mary E. T.,11,1,48,37
1656026877772,COGS 13,A01,083071,Bastos; Amalia Pinkusfeld,4,3,71,67
1656026883885,COGS 14A,A01,092681,Semenuks; Arturs,4,25,100,96
1656026889963,COGS 14B,A01,083073,Cheng; Tzu-Han,7,0,63,56
1656026896084,COGS 17,A01,092677,Semenuks; Arturs,8,7,81,73
1656026902200,COGS 100,A01,083619,Allen; Michael Gordon,2,2,70,68
1656026908330,COGS 101A,A01,083621,Davis; Joshua Daniel,4,3,68,64
1656026914355,COGS 101B,A01,091572,Allen; Michael Gordon,0,0,65,65
1656026920377,COGS 101C,A01,083625,Delgado; Tania,7,0,35,28
1656026926536,COGS 107A,A01,083627,Boyle; Mary E. T.,1,2,60,59
1656026932583,COGS 118A,A01,083075,Gupta; Anjum,21,16,76,55
1656026938607,CSE 3,A50,083646,Miranda; Gregory Joseph,13,0,50,37
1656026944645,CSE 8A,A50,083650,Miranda; Gregory Joseph,4,11,56,52
1656026950756,CSE 11,A01,083080,Cao; Yingjun,0,65,40,40
1656026956778,CSE 12,A01,083652,Krause-Levy; Sophia Louisa,7,8,120,113
1656026962829,CSE 15L,A01,083654,Morris; Justin Loren,3,1,50,47
1656026962829,CSE 15L,A02,083655,Morris; Justin Loren,2,1,50,48
1656026968864,CSE 20,A01,083657,Tran; Khoa Dang,29,0,80,51
1656026974930,CSE 21,A01,095574,Bach; Quang Tran,23,0,48,25
1656026980957,CSE 30,A01,083084,Eldon; John,2,10,80,78
1656026980957,CSE 30,B01,095061,Bhaskar; Nishant,2,5,50,48
1656026987097,CSE 100,A01,083659,Cao; Yingjun,2,25,70,68
1656026993123,CSE 134B,A01,083661,Powell; Thomas Allan,6,6,100,94
1656026999219,CSE 140,A01,083663,Gungor; Onat,5,0,85,80
1656027005408,CSE 140L,A01,083088,Eldon; John,5,0,100,95
1656027011465,CSE 175,A01,083665,Kumar; Rakesh,0,0,25,25
1656027017486,CSE 190,A00,092507,Dubnov; Shlomo,1,0,20,19
1656027023512,ECE 45,A01,083139,Congero; Spencer William,1,1,75,74
1656027029543,ECE 65,A50,083695,Saad; Andrew S,6,0,30,24
1656027029543,ECE 65,A51,095125,Staff,23,0,26,3
1656027035579,ECE 109,A01,091882,Touri; Behrouz,3,5,70,67
1656027041602,ECE 180,A00,083140,Abi Samra; Nicholas Camill,1,0,30,29
1656027041602,ECE 180,B00,083141,Abi Samra; Nicholas Camill,0,8,28,28
1656027047629,MATH 10A,A01,083735,Patchell; Gregory David,0,0,30,30
1656027047629,MATH 10A,A02,083736,Patchell; Gregory David,20,0,30,10
1656027047629,MATH 10A,A03,083737,Patchell; Gregory David,16,0,30,14
1656027053655,MATH 10B,A01,083207,Lim; Seonhee,1,1,34,33
1656027053655,MATH 10B,A02,083208,Lim; Seonhee,1,1,35,34
1656027053655,MATH 10B,A03,093472,Staff,1,0,34,33
1656027053655,MATH 10B,B01,083739,Sinha; Shubham,9,0,30,21
1656027059685,MATH 18,A01,083743,Cinel; Cameron Alexander,5,0,30,25
1656027059685,MATH 18,A02,083744,Cinel; Cameron Alexander,11,0,30,19
1656027059685,MATH 18,A03,083745,Cinel; Cameron Alexander,1,0,30,29
1656027059685,MATH 18,B01,083748,Ma; Zilu,0,0,36,36
1656027059685,MATH 18,B02,083749,Ma; Zilu,0,0,36,36
1656027059685,MATH 18,B03,083750,Ma; Zilu,0,0,36,36
1656027059685,MATH 18,B04,083751,Ma; Zilu,0,0,36,36
1656027059685,MATH 18,B05,093473,Staff,0,0,36,36
1656027059685,MATH 18,B06,093474,Staff,3,0,36,33
1656027065739,MATH 20A,A01,083754,Zheng; Zequn,11,0,40,29
1656027071769,MATH 20B,A01,083756,Briones; Jor-el Thomas Caparas,0,1,36,36
1656027071769,MATH 20B,A02,083757,Briones; Jor-el Thomas Caparas,1,0,36,35
1656027071769,MATH 20B,A03,093475,Staff,0,0,36,36
1656027077798,MATH 20C,A01,083760,Briones; Jor-el Thomas Caparas,0,2,35,35
1656027077798,MATH 20C,A02,083761,Briones; Jor-el Thomas Caparas,6,1,35,29
1656027077798,MATH 20C,A03,093476,Staff,0,0,35,35
1656027077798,MATH 20C,B01,083762,Bach; Quang Tran,3,0,30,27
1656027083823,MATH 20D,A01,083765,Tran; Brian Kha,2,0,30,28
1656027083823,MATH 20D,A02,083766,Tran; Brian Kha,0,1,30,30
1656027083823,MATH 20D,A03,083767,Tran; Brian Kha,1,0,30,29
1656027089850,MATH 20E,A01,083771,Ganguly; Soumya,0,1,32,32
1656027089850,MATH 20E,A02,083772,Ganguly; Soumya,1,1,32,31
1656027089850,MATH 20E,B01,083773,Ciotti; Benjamin,13,0,35,22
1656027089850,MATH 20E,B02,083774,Ciotti; Benjamin,12,0,35,23
1656027095875,MATH 103A,A01,083777,Greenfeld; Be'Eri,2,1,36,34
1656027095875,MATH 103A,A02,083778,Greenfeld; Be'Eri,1,0,36,35
1656027095875,MATH 103A,A03,093561,Staff,0,1,36,36
1656027095875,MATH 103A,B01,083779,Greenfeld; Be'Eri,8,1,36,28
1656027095875,MATH 103A,B02,083780,Greenfeld; Be'Eri,0,0,36,36
1656027095875,MATH 103A,B03,093562,Staff,0,0,36,36
1656027101904,MATH 105,A01,085443,Carter; Anne Toulson,4,1,35,31
1656027101904,MATH 105,A02,093477,Staff,9,0,35,26
1656027107928,MATH 109,A01,083213,Ganzberger; Geoffrey Michael,0,1,34,34
1656027107928,MATH 109,A02,083214,Ganzberger; Geoffrey Michael,0,0,34,34
1656027107928,MATH 109,A03,093478,Staff,1,0,34,33
1656027107928,MATH 109,B01,083215,Ganzberger; Geoffrey Michael,2,0,32,30
1656027107928,MATH 109,B02,083216,Ganzberger; Geoffrey Michael,0,0,32,32
1656027107928,MATH 109,B03,093479,Staff,3,0,32,29
1656027113957,MATH 142A,A01,083219,Chow; Bennett,1,0,32,31
1656027113957,MATH 142A,A02,083220,Chow; Bennett,7,0,32,25
1656027113957,MATH 142A,A03,093480,Staff,4,0,32,28
1656027113957,MATH 142A,B03,093481,Staff,3,0,32,29
1656027113957,MATH 142A,B04,093558,Staff,6,0,32,26
1656027113957,MATH 142A,B05,093559,Staff,0,0,32,32
1656027119986,MATH 193A,A01,083224,Rotar; Vladimir,1,2,34,33
1656027119986,MATH 193A,A02,083225,Rotar; Vladimir,0,1,34,34
1656027119986,MATH 193A,A03,083781,Rotar; Vladimir,2,0,34,32
1656027119986,MATH 193A,A04,083782,Rotar; Vladimir,3,0,34,31
1656027119986,MATH 193A,A05,093482,Rotar; Vladimir,0,0,34,34
1656027126015,MATH 197,001,091859,McAuley; Julian John,9999,0,9999,0
1656027126015,MATH 197,002,095566,Kedlaya; Kiran S.,9997,0,9999,2
1656027126015,MATH 197,003,095567,Xiao; Ming,9999,0,9999,0
1656027126015,MATH 197,004,095571,Perols; Johan Lars,9998,0,9999,1
1656027133078,COGS 9,A01,083615,Shannon; Kyle Michael,3,1,75,72
1656027139104,COGS 11,A01,083617,Boyle; Mary E. T.,11,1,48,37
1656027145126,COGS 13,A01,083071,Bastos; Amalia Pinkusfeld,4,3,71,67
1656027151150,COGS 14A,A01,092681,Semenuks; Arturs,4,25,100,96
1656027157178,COGS 14B,A01,083073,Cheng; Tzu-Han,7,0,63,56
1656027163208,COGS 17,A01,092677,Semenuks; Arturs,8,7,81,73
1656027169233,COGS 100,A01,083619,Allen; Michael Gordon,2,2,70,68
1656027175256,COGS 101A,A01,083621,Davis; Joshua Daniel,4,3,68,64
1656027181279,COGS 101B,A01,091572,Allen; Michael Gordon,0,0,65,65
1656027187305,COGS 101C,A01,083625,Delgado; Tania,7,0,35,28
1656027193329,COGS 107A,A01,083627,Boyle; Mary E. T.,1,2,60,59
1656027199355,COGS 118A,A01,083075,Gupta; Anjum,21,16,76,55
1656027205385,CSE 3,A50,083646,Miranda; Gregory Joseph,14,0,50,36
1656027211407,CSE 8A,A50,083650,Miranda; Gregory Joseph,4,11,56,52
1656027217432,CSE 11,A01,083080,Cao; Yingjun,0,65,40,40
1656027223454,CSE 12,A01,083652,Krause-Levy; Sophia Louisa,7,8,120,113
1656027229481,CSE 15L,A01,083654,Morris; Justin Loren,3,1,50,47
1656027229481,CSE 15L,A02,083655,Morris; Justin Loren,2,1,50,48
1656027235502,CSE 20,A01,083657,Tran; Khoa Dang,29,0,80,51
1656027241527,CSE 21,A01,095574,Bach; Quang Tran,23,0,48,25
1656027247550,CSE 30,A01,083084,Eldon; John,2,10,80,78
1656027247550,CSE 30,B01,095061,Bhaskar; Nishant,2,5,50,48
1656027253571,CSE 100,A01,083659,Cao; Yingjun,2,25,70,68
1656027259611,CSE 134B,A01,083661,Powell; Thomas Allan,6,6,100,94
1656027265633,CSE 140,A01,083663,Gungor; Onat,5,0,85,80
1656027271660,CSE 140L,A01,083088,Eldon; John,5,0,100,95
1656027277683,CSE 175,A01,083665,Kumar; Rakesh,0,0,25,25
1656027283706,CSE 190,A00,092507,Dubnov; Shlomo,1,0,20,19
1656027289729,ECE 45,A01,083139,Congero; Spencer William,1,1,75,74
1656027295756,ECE 65,A50,083695,Saad; Andrew S,6,0,30,24
1656027295756,ECE 65,A51,095125,Staff,23,0,26,3
1656027301781,ECE 109,A01,091882,Touri; Behrouz,3,5,70,67
1656027307803,ECE 180,A00,083140,Abi Samra; Nicholas Camill,1,0,30,29
1656027307803,ECE 180,B00,083141,Abi Samra; Nicholas Camill,0,8,28,28
1656027313828,MATH 10A,A01,083735,Patchell; Gregory David,0,0,30,30
1656027313828,MATH 10A,A02,083736,Patchell; Gregory David,20,0,30,10
1656027313828,MATH 10A,A03,083737,Patchell; Gregory David,16,0,30,14
1656027319856,MATH 10B,A01,083207,Lim; Seonhee,1,1,34,33
1656027319856,MATH 10B,A02,083208,Lim; Seonhee,1,1,35,34
1656027319856,MATH 10B,A03,093472,Staff,1,0,34,33
1656027319856,MATH 10B,B01,083739,Sinha; Shubham,9,0,30,21
1656027325886,MATH 18,A01,083743,Cinel; Cameron Alexander,5,0,30,25
1656027325886,MATH 18,A02,083744,Cinel; Cameron Alexander,11,0,30,19
1656027325886,MATH 18,A03,083745,Cinel; Cameron Alexander,1,0,30,29
1656027325886,MATH 18,B01,083748,Ma; Zilu,0,0,36,36
1656027325886,MATH 18,B02,083749,Ma; Zilu,0,0,36,36
1656027325886,MATH 18,B03,083750,Ma; Zilu,0,0,36,36
1656027325886,MATH 18,B04,083751,Ma; Zilu,0,0,36,36
1656027325886,MATH 18,B05,093473,Staff,0,0,36,36
1656027325886,MATH 18,B06,093474,Staff,3,0,36,33
1656027331916,MATH 20A,A01,083754,Zheng; Zequn,11,0,40,29
1656027338038,MATH 20B,A01,083756,Briones; Jor-el Thomas Caparas,0,1,36,36
1656027338038,MATH 20B,A02,083757,Briones; Jor-el Thomas Caparas,1,0,36,35
1656027338038,MATH 20B,A03,093475,Staff,0,0,36,36
1656027344069,MATH 20C,A01,083760,Briones; Jor-el Thomas Caparas,0,2,35,35
1656027344069,MATH 20C,A02,083761,Briones; Jor-el Thomas Caparas,6,1,35,29
1656027344069,MATH 20C,A03,093476,Staff,0,0,35,35
1656027344069,MATH 20C,B01,083762,Bach; Quang Tran,3,0,30,27
1656027350109,MATH 20D,A01,083765,Tran; Brian Kha,2,0,30,28
1656027350109,MATH 20D,A02,083766,Tran; Brian Kha,0,1,30,30
1656027350109,MATH 20D,A03,083767,Tran; Brian Kha,1,0,30,29
1656027356138,MATH 20E,A01,083771,Ganguly; Soumya,0,1,32,32
1656027356138,MATH 20E,A02,083772,Ganguly; Soumya,1,1,32,31
1656027356138,MATH 20E,B01,083773,Ciotti; Benjamin,13,0,35,22
1656027356138,MATH 20E,B02,083774,Ciotti; Benjamin,12,0,35,23
1656027362163,MATH 103A,A01,083777,Greenfeld; Be'Eri,2,1,36,34
1656027362163,MATH 103A,A02,083778,Greenfeld; Be'Eri,1,0,36,35
1656027362163,MATH 103A,A03,093561,Staff,0,1,36,36
1656027362163,MATH 103A,B01,083779,Greenfeld; Be'Eri,8,1,36,28
1656027362163,MATH 103A,B02,083780,Greenfeld; Be'Eri,0,0,36,36
1656027362163,MATH 103A,B03,093562,Staff,0,0,36,36
1656027368191,MATH 105,A01,085443,Carter; Anne Toulson,4,1,35,31
1656027368191,MATH 105,A02,093477,Staff,9,0,35,26
1656027374219,MATH 109,A01,083213,Ganzberger; Geoffrey Michael,0,1,34,34
1656027374219,MATH 109,A02,083214,Ganzberger; Geoffrey Michael,0,0,34,34
1656027374219,MATH 109,A03,093478,Staff,1,0,34,33
1656027374219,MATH 109,B01,083215,Ganzberger; Geoffrey Michael,2,0,32,30
1656027374219,MATH 109,B02,083216,Ganzberger; Geoffrey Michael,0,0,32,32
1656027374219,MATH 109,B03,093479,Staff,3,0,32,29
1656027380242,MATH 142A,A01,083219,Chow; Bennett,1,0,32,31
1656027380242,MATH 142A,A02,083220,Chow; Bennett,7,0,32,25
1656027380242,MATH 142A,A03,093480,Staff,4,0,32,28
1656027380242,MATH 142A,B03,093481,Staff,3,0,32,29
1656027380242,MATH 142A,B04,093558,Staff,6,0,32,26
1656027380242,MATH 142A,B05,093559,Staff,0,0,32,32
1656027386266,MATH 193A,A01,083224,Rotar; Vladimir,1,2,34,33
1656027386266,MATH 193A,A02,083225,Rotar; Vladimir,0,1,34,34
1656027386266,MATH 193A,A03,083781,Rotar; Vladimir,2,0,34,32
1656027386266,MATH 193A,A04,083782,Rotar; Vladimir,3,0,34,31
1656027386266,MATH 193A,A05,093482,Rotar; Vladimir,0,0,34,34
1656027392303,MATH 197,001,091859,McAuley; Julian John,9999,0,9999,0
1656027392303,MATH 197,002,095566,Kedlaya; Kiran S.,9997,0,9999,2
1656027392303,MATH 197,003,095567,Xiao; Ming,9999,0,9999,0
1656027392303,MATH 197,004,095571,Perols; Johan Lars,9998,0,9999,1
1656027399371,COGS 9,A01,083615,Shannon; Kyle Michael,3,1,75,72
1656027405399,COGS 11,A01,083617,Boyle; Mary E. T.,11,1,48,37
1656027411422,COGS 13,A01,083071,Bastos; Amalia Pinkusfeld,4,3,71,67
1656027417446,COGS 14A,A01,092681,Semenuks; Arturs,4,25,100,96
1656027423478,COGS 14B,A01,083073,Cheng; Tzu-Han,7,0,63,56
1656027429507,COGS 17,A01,092677,Semenuks; Arturs,8,7,81,73
1656027435534,COGS 100,A01,083619,Allen; Michael Gordon,2,2,70,68
1656027441567,COGS 101A,A01,083621,Davis; Joshua Daniel,4,3,68,64
1656027447590,COGS 101B,A01,091572,Allen; Michael Gordon,0,0,65,65
1656027453614,COGS 101C,A01,083625,Delgado; Tania,7,0,35,28
1656027459638,COGS 107A,A01,083627,Boyle; Mary E. T.,1,2,60,59
1656027465665,COGS 118A,A01,083075,Gupta; Anjum,21,16,76,55
1656027471689,CSE 3,A50,083646,Miranda; Gregory Joseph,14,0,50,36
1656027477711,CSE 8A,A50,083650,Miranda; Gregory Joseph,4,11,56,52
1656027483747,CSE 11,A01,083080,Cao; Yingjun,0,65,40,40
1656027489774,CSE 12,A01,083652,Krause-Levy; Sophia Louisa,7,8,120,113
1656027495798,CSE 15L,A01,083654,Morris; Justin Loren,3,1,50,47
1656027495798,CSE 15L,A02,083655,Morris; Justin Loren,2,1,50,48
1656027501822,CSE 20,A01,083657,Tran; Khoa Dang,29,0,80,51
1656027507850,CSE 21,A01,095574,Bach; Quang Tran,23,0,48,25
1656027513873,CSE 30,A01,083084,Eldon; John,2,10,80,78
1656027513873,CSE 30,B01,095061,Bhaskar; Nishant,2,5,50,48
1656027519896,CSE 100,A01,083659,Cao; Yingjun,2,25,70,68
1656027525920,CSE 134B,A01,083661,Powell; Thomas Allan,6,6,100,94
1656027531958,CSE 140,A01,083663,Gungor; Onat,5,0,85,80
1656027537981,CSE 140L,A01,083088,Eldon; John,5,0,100,95
1656027544005,CSE 175,A01,083665,Kumar; Rakesh,0,0,25,25
1656027550029,CSE 190,A00,092507,Dubnov; Shlomo,1,0,20,19
1656027556066,ECE 45,A01,083139,Congero; Spencer William,1,1,75,74
1656027562101,ECE 65,A50,083695,Saad; Andrew S,6,0,30,24
1656027562101,ECE 65,A51,095125,Staff,23,0,26,3
1656027568127,ECE 109,A01,091882,Touri; Behrouz,3,5,70,67
1656027574155,ECE 180,A00,083140,Abi Samra; Nicholas Camill,1,0,30,29
1656027574155,ECE 180,B00,083141,Abi Samra; Nicholas Camill,0,8,28,28
1656027580179,MATH 10A,A01,083735,Patchell; Gregory David,0,0,30,30
1656027580179,MATH 10A,A02,083736,Patchell; Gregory David,20,0,30,10
1656027580179,MATH 10A,A03,083737,Patchell; Gregory David,16,0,30,14
1656027586210,MATH 10B,A01,083207,Lim; Seonhee,1,1,34,33
1656027586210,MATH 10B,A02,083208,Lim; Seonhee,1,1,35,34
1656027586210,MATH 10B,A03,093472,Staff,1,0,34,33
1656027586210,MATH 10B,B01,083739,Sinha; Shubham,9,0,30,21
1656027592241,MATH 18,A01,083743,Cinel; Cameron Alexander,5,0,30,25
1656027592241,MATH 18,A02,083744,Cinel; Cameron Alexander,11,0,30,19
1656027592241,MATH 18,A03,083745,Cinel; Cameron Alexander,1,0,30,29
1656027592241,MATH 18,B01,083748,Ma; Zilu,0,0,36,36
1656027592241,MATH 18,B02,083749,Ma; Zilu,0,0,36,36
1656027592241,MATH 18,B03,083750,Ma; Zilu,0,0,36,36
1656027592241,MATH 18,B04,083751,Ma; Zilu,0,0,36,36
1656027592241,MATH 18,B05,093473,Staff,0,0,36,36
1656027592241,MATH 18,B06,093474,Staff,3,0,36,33
1656027598264,MATH 20A,A01,083754,Zheng; Zequn,11,0,40,29
1656027604288,MATH 20B,A01,083756,Briones; Jor-el Thomas Caparas,0,1,36,36
1656027604288,MATH 20B,A02,083757,Briones; Jor-el Thomas Caparas,1,0,36,35
1656027604288,MATH 20B,A03,093475,Staff,0,0,36,36
1656027610313,MATH 20C,A01,083760,Briones; Jor-el Thomas Caparas,0,2,35,35
1656027610313,MATH 20C,A02,083761,Briones; Jor-el Thomas Caparas,6,1,35,29
1656027610313,MATH 20C,A03,093476,Staff,0,0,35,35
1656027610313,MATH 20C,B01,083762,Bach; Quang Tran,3,0,30,27
1656027616337,MATH 20D,A01,083765,Tran; Brian Kha,2,0,30,28
1656027616337,MATH 20D,A02,083766,Tran; Brian Kha,0,1,30,30
1656027616337,MATH 20D,A03,083767,Tran; Brian Kha,1,0,30,29
1656027622368,MATH 20E,A01,083771,Ganguly; Soumya,0,1,32,32
1656027622368,MATH 20E,A02,083772,Ganguly; Soumya,1,1,32,31
1656027622368,MATH 20E,B01,083773,Ciotti; Benjamin,13,0,35,22
1656027622368,MATH 20E,B02,083774,Ciotti; Benjamin,12,0,35,23
1656027628397,MATH 103A,A01,083777,Greenfeld; Be'Eri,2,1,36,34
1656027628397,MATH 103A,A02,083778,Greenfeld; Be'Eri,1,0,36,35
1656027628397,MATH 103A,A03,093561,Staff,0,1,36,36
1656027628397,MATH 103A,B01,083779,Greenfeld; Be'Eri,8,1,36,28
1656027628397,MATH 103A,B02,083780,Greenfeld; Be'Eri,0,0,36,36
1656027628397,MATH 103A,B03,093562,Staff,0,0,36,36
1656027634420,MATH 105,A01,085443,Carter; Anne Toulson,4,1,35,31
1656027634420,MATH 105,A02,093477,Staff,9,0,35,26
1656027640449,MATH 109,A01,083213,Ganzberger; Geoffrey Michael,0,1,34,34
1656027640449,MATH 109,A02,083214,Ganzberger; Geoffrey Michael,0,0,34,34
1656027640449,MATH 109,A03,093478,Staff,1,0,34,33
1656027640449,MATH 109,B01,083215,Ganzberger; Geoffrey Michael,2,0,32,30
1656027640449,MATH 109,B02,083216,Ganzberger; Geoffrey Michael,0,0,32,32
1656027640449,MATH 109,B03,093479,Staff,3,0,32,29
1656027646476,MATH 142A,A01,083219,Chow; Bennett,1,0,32,31
1656027646476,MATH 142A,A02,083220,Chow; Bennett,7,0,32,25
1656027646476,MATH 142A,A03,093480,Staff,4,0,32,28
1656027646476,MATH 142A,B03,093481,Staff,3,0,32,29
1656027646476,MATH 142A,B04,093558,Staff,6,0,32,26
1656027646476,MATH 142A,B05,093559,Staff,0,0,32,32
1656027652499,MATH 193A,A01,083224,Rotar; Vladimir,1,2,34,33
1656027652499,MATH 193A,A02,083225,Rotar; Vladimir,0,0,34,34
1656027652499,MATH 193A,A03,083781,Rotar; Vladimir,1,0,34,33
1656027652499,MATH 193A,A04,083782,Rotar; Vladimir,3,0,34,31
1656027652499,MATH 193A,A05,093482,Rotar; Vladimir,0,0,34,34
1656027658522,MATH 197,001,091859,McAuley; Julian John,9999,0,9999,0
1656027658522,MATH 197,002,095566,Kedlaya; Kiran S.,9997,0,9999,2
1656027658522,MATH 197,003,095567,Xiao; Ming,9999,0,9999,0
1656027658522,MATH 197,004,095571,Perols; Johan Lars,9998,0,9999,1
1656027665589,COGS 9,A01,083615,Shannon; Kyle Michael,3,1,75,72
1656027671611,COGS 11,A01,083617,Boyle; Mary E. T.,11,1,48,37
1656027677639,COGS 13,A01,083071,Bastos; Amalia Pinkusfeld,4,3,71,67
1656027683663,COGS 14A,A01,092681,Semenuks; Arturs,4,25,100,96
1656027689689,COGS 14B,A01,083073,Cheng; Tzu-Han,7,0,63,56
1656027695719,COGS 17,A01,092677,Semenuks; Arturs,8,7,81,73
1656027701743,COGS 100,A01,083619,Allen; Michael Gordon,2,2,70,68
1656027707772,COGS 101A,A01,083621,Davis; Joshua Daniel,4,3,68,64
1656027713795,COGS 101B,A01,091572,Allen; Michael Gordon,0,0,65,65
1656027719819,COGS 101C,A01,083625,Delgado; Tania,7,0,35,28
1656027725845,COGS 107A,A01,083627,Boyle; Mary E. T.,1,2,60,59
1656027731871,COGS 118A,A01,083075,Gupta; Anjum,21,16,76,55
1656027737895,CSE 3,A50,083646,Miranda; Gregory Joseph,14,0,50,36
1656027743921,CSE 8A,A50,083650,Miranda; Gregory Joseph,4,11,56,52
1656027749944,CSE 11,A01,083080,Cao; Yingjun,0,65,40,40
1656027755967,CSE 12,A01,083652,Krause-Levy; Sophia Louisa,7,8,120,113
1656027761989,CSE 15L,A01,083654,Morris; Justin Loren,3,1,50,47
1656027761989,CSE 15L,A02,083655,Morris; Justin Loren,2,1,50,48
1656027768016,CSE 20,A01,083657,Tran; Khoa Dang,29,0,80,51
1656027774044,CSE 21,A01,095574,Bach; Quang Tran,23,0,48,25
1656027780067,CSE 30,A01,083084,Eldon; John,2,10,80,78
1656027780067,CSE 30,B01,095061,Bhaskar; Nishant,2,5,50,48
1656027786093,CSE 100,A01,083659,Cao; Yingjun,2,25,70,68
1656027792141,CSE 134B,A01,083661,Powell; Thomas Allan,6,6,100,94
1656027798167,CSE 140,A01,083663,Gungor; Onat,5,0,85,80
1656027804195,CSE 140L,A01,083088,Eldon; John,5,0,100,95
1656027810220,CSE 175,A01,083665,Kumar; Rakesh,0,0,25,25
1656027816247,CSE 190,A00,092507,Dubnov; Shlomo,1,0,20,19
1656027822275,ECE 45,A01,083139,Congero; Spencer William,1,1,75,74
1656027828299,ECE 65,A50,083695,Saad; Andrew S,6,0,30,24
1656027828299,ECE 65,A51,095125,Staff,23,0,26,3
1656027834325,ECE 109,A01,091882,Touri; Behrouz,3,5,70,67
1656027840348,ECE 180,A00,083140,Abi Samra; Nicholas Camill,1,0,30,29
1656027840348,ECE 180,B00,083141,Abi Samra; Nicholas Camill,0,8,28,28
1656027846376,MATH 10A,A01,083735,Patchell; Gregory David,0,0,30,30
1656027846376,MATH 10A,A02,083736,Patchell; Gregory David,20,0,30,10
1656027846376,MATH 10A,A03,083737,Patchell; Gregory David,16,0,30,14
1656027852410,MATH 10B,A01,083207,Lim; Seonhee,1,1,34,33
1656027852410,MATH 10B,A02,083208,Lim; Seonhee,1,1,35,34
1656027852410,MATH 10B,A03,093472,Staff,0,0,34,34
1656027852410,MATH 10B,B01,083739,Sinha; Shubham,10,0,30,20
1656027858442,MATH 18,A01,083743,Cinel; Cameron Alexander,5,0,30,25
1656027858442,MATH 18,A02,083744,Cinel; Cameron Alexander,11,0,30,19
1656027858442,MATH 18,A03,083745,Cinel; Cameron Alexander,1,0,30,29
1656027858442,MATH 18,B01,083748,Ma; Zilu,0,0,36,36
1656027858442,MATH 18,B02,083749,Ma; Zilu,0,0,36,36
1656027858442,MATH 18,B03,083750,Ma; Zilu,0,0,36,36
1656027858442,MATH 18,B04,083751,Ma; Zilu,0,0,36,36
1656027858442,MATH 18,B05,093473,Staff,0,0,36,36
1656027858442,MATH 18,B06,093474,Staff,3,0,36,33
1656027864470,MATH 20A,A01,083754,Zheng; Zequn,11,0,40,29
1656027870502,MATH 20B,A01,083756,Briones; Jor-el Thomas Caparas,0,1,36,36
1656027870502,MATH 20B,A02,083757,Briones; Jor-el Thomas Caparas,1,0,36,35
1656027870502,MATH 20B,A03,093475,Staff,0,0,36,36
1656027876526,MATH 20C,A01,083760,Briones; Jor-el Thomas Caparas,0,2,35,35
1656027876526,MATH 20C,A02,083761,Briones; Jor-el Thomas Caparas,6,1,35,29
1656027876526,MATH 20C,A03,093476,Staff,0,0,35,35
1656027876526,MATH 20C,B01,083762,Bach; Quang Tran,3,0,30,27
1656027882550,MATH 20D,A01,083765,Tran; Brian Kha,2,0,30,28
1656027882550,MATH 20D,A02,083766,Tran; Brian Kha,0,1,30,30
1656027882550,MATH 20D,A03,083767,Tran; Brian Kha,1,0,30,29
1656027888575,MATH 20E,A01,083771,Ganguly; Soumya,0,1,32,32
1656027888575,MATH 20E,A02,083772,Ganguly; Soumya,1,1,32,31
1656027888575,MATH 20E,B01,083773,Ciotti; Benjamin,13,0,35,22
1656027888575,MATH 20E,B02,083774,Ciotti; Benjamin,12,0,35,23
1656027894606,MATH 103A,A01,083777,Greenfeld; Be'Eri,2,1,36,34
1656027894606,MATH 103A,A02,083778,Greenfeld; Be'Eri,1,0,36,35
1656027894606,MATH 103A,A03,093561,Staff,0,1,36,36
1656027894606,MATH 103A,B01,083779,Greenfeld; Be'Eri,8,1,36,28
1656027894606,MATH 103A,B02,083780,Greenfeld; Be'Eri,0,0,36,36
1656027894606,MATH 103A,B03,093562,Staff,0,0,36,36
1656027900636,MATH 105,A01,085443,Carter; Anne Toulson,4,1,35,31
1656027900636,MATH 105,A02,093477,Staff,9,0,35,26
1656027906665,MATH 109,A01,083213,Ganzberger; Geoffrey Michael,0,1,34,34
1656027906665,MATH 109,A02,083214,Ganzberger; Geoffrey Michael,0,0,34,34
1656027906665,MATH 109,A03,093478,Staff,1,0,34,33
1656027906665,MATH 109,B01,083215,Ganzberger; Geoffrey Michael,2,0,32,30
1656027906665,MATH 109,B02,083216,Ganzberger; Geoffrey Michael,0,0,32,32
1656027906665,MATH 109,B03,093479,Staff,3,0,32,29
1656027912692,MATH 142A,A01,083219,Chow; Bennett,1,0,32,31
1656027912692,MATH 142A,A02,083220,Chow; Bennett,7,0,32,25
1656027912692,MATH 142A,A03,093480,Staff,4,0,32,28
1656027912692,MATH 142A,B03,093481,Staff,3,0,32,29
1656027912692,MATH 142A,B04,093558,Staff,6,0,32,26
1656027912692,MATH 142A,B05,093559,Staff,0,0,32,32
1656027918720,MATH 193A,A01,083224,Rotar; Vladimir,1,2,34,33
1656027918720,MATH 193A,A02,083225,Rotar; Vladimir,0,0,34,34
1656027918720,MATH 193A,A03,083781,Rotar; Vladimir,1,0,34,33
1656027918720,MATH 193A,A04,083782,Rotar; Vladimir,3,0,34,31
1656027918720,MATH 193A,A05,093482,Rotar; Vladimir,0,0,34,34
1656027924748,MATH 197,001,091859,McAuley; Julian John,9999,0,9999,0
1656027924748,MATH 197,002,095566,Kedlaya; Kiran S.,9997,0,9999,2
1656027924748,MATH 197,003,095567,Xiao; Ming,9999,0,9999,0
1656027924748,MATH 197,004,095571,Perols; Johan Lars,9998,0,9999,1
1656027931899,COGS 9,A01,083615,Shannon; Kyle Michael,3,1,75,72
1656027937923,COGS 11,A01,083617,Boyle; Mary E. T.,11,1,48,37
1656027943950,COGS 13,A01,083071,Bastos; Amalia Pinkusfeld,4,3,71,67
1656027949976,COGS 14A,A01,092681,Semenuks; Arturs,4,25,100,96
1656027956002,COGS 14B,A01,083073,Cheng; Tzu-Han,7,0,63,56
1656027962036,COGS 17,A01,092677,Semenuks; Arturs,8,7,81,73
1656027968059,COGS 100,A01,083619,Allen; Michael Gordon,2,2,70,68
1656027974087,COGS 101A,A01,083621,Davis; Joshua Daniel,4,3,68,64
1656027980115,COGS 101B,A01,091572,Allen; Michael Gordon,0,0,65,65
1656027986139,COGS 101C,A01,083625,Delgado; Tania,7,0,35,28
1656027992162,COGS 107A,A01,083627,Boyle; Mary E. T.,1,2,60,59
1656027998186,COGS 118A,A01,083075,Gupta; Anjum,21,16,76,55
1656028004208,CSE 3,A50,083646,Miranda; Gregory Joseph,14,0,50,36
1656028010235,CSE 8A,A50,083650,Miranda; Gregory Joseph,4,11,56,52
1656028016264,CSE 11,A01,083080,Cao; Yingjun,0,65,40,40
1656028022291,CSE 12,A01,083652,Krause-Levy; Sophia Louisa,7,8,120,113
1656028028319,CSE 15L,A01,083654,Morris; Justin Loren,3,1,50,47
1656028028319,CSE 15L,A02,083655,Morris; Justin Loren,2,1,50,48
1656028034347,CSE 20,A01,083657,Tran; Khoa Dang,29,0,80,51
1656028040371,CSE 21,A01,095574,Bach; Quang Tran,23,0,48,25
1656028046394,CSE 30,A01,083084,Eldon; John,2,10,80,78
1656028046394,CSE 30,B01,095061,Bhaskar; Nishant,2,5,50,48
1656028052417,CSE 100,A01,083659,Cao; Yingjun,2,25,70,68
1656028058451,CSE 134B,A01,083661,Powell; Thomas Allan,6,6,100,94
1656028064478,CSE 140,A01,083663,Gungor; Onat,5,0,85,80
1656028070510,CSE 140L,A01,083088,Eldon; John,5,0,100,95
1656028076537,CSE 175,A01,083665,Kumar; Rakesh,0,0,25,25
1656028082561,CSE 190,A00,092507,Dubnov; Shlomo,1,0,20,19
1656028088586,ECE 45,A01,083139,Congero; Spencer William,1,1,75,74
1656028094610,ECE 65,A50,083695,Saad; Andrew S,6,0,30,24
1656028094610,ECE 65,A51,095125,Staff,23,0,26,3
1656028100633,ECE 109,A01,091882,Touri; Behrouz,3,5,70,67
1656028106657,ECE 180,A00,083140,Abi Samra; Nicholas Camill,1,0,30,29
1656028106657,ECE 180,B00,083141,Abi Samra; Nicholas Camill,0,8,28,28
1656028112690,MATH 10A,A01,083735,Patchell; Gregory David,0,0,30,30
1656028112690,MATH 10A,A02,083736,Patchell; Gregory David,20,0,30,10
1656028112690,MATH 10A,A03,083737,Patchell; Gregory David,16,0,30,14
1656028118719,MATH 10B,A01,083207,Lim; Seonhee,1,1,34,33
1656028118719,MATH 10B,A02,083208,Lim; Seonhee,1,1,35,34
1656028118719,MATH 10B,A03,093472,Staff,0,0,34,34
1656028118719,MATH 10B,B01,083739,Sinha; Shubham,10,0,30,20
1656028124744,MATH 18,A01,083743,Cinel; Cameron Alexander,5,0,30,25
1656028124744,MATH 18,A02,083744,Cinel; Cameron Alexander,11,0,30,19
1656028124744,MATH 18,A03,083745,Cinel; Cameron Alexander,1,0,30,29
1656028124744,MATH 18,B01,083748,Ma; Zilu,0,0,36,36
1656028124744,MATH 18,B02,083749,Ma; Zilu,0,0,36,36
1656028124744,MATH 18,B03,083750,Ma; Zilu,0,0,36,36
1656028124744,MATH 18,B04,083751,Ma; Zilu,0,0,36,36
1656028124744,MATH 18,B05,093473,Staff,0,0,36,36
1656028124744,MATH 18,B06,093474,Staff,3,0,36,33
1656028130768,MATH 20A,A01,083754,Zheng; Zequn,11,0,40,29
1656028136792,MATH 20B,A01,083756,Briones; Jor-el Thomas Caparas,0,1,36,36
1656028136792,MATH 20B,A02,083757,Briones; Jor-el Thomas Caparas,1,0,36,35
1656028136792,MATH 20B,A03,093475,Staff,0,0,36,36
1656028142816,MATH 20C,A01,083760,Briones; Jor-el Thomas Caparas,0,2,35,35
1656028142816,MATH 20C,A02,083761,Briones; Jor-el Thomas Caparas,6,1,35,29
1656028142816,MATH 20C,A03,093476,Staff,0,0,35,35
1656028142816,MATH 20C,B01,083762,Bach; Quang Tran,3,0,30,27
1656028148839,MATH 20D,A01,083765,Tran; Brian Kha,2,0,30,28
1656028148839,MATH 20D,A02,083766,Tran; Brian Kha,0,1,30,30
1656028148839,MATH 20D,A03,083767,Tran; Brian Kha,1,0,30,29
1656028154874,MATH 20E,A01,083771,Ganguly; Soumya,0,1,32,32
1656028154874,MATH 20E,A02,083772,Ganguly; Soumya,1,1,32,31
1656028154874,MATH 20E,B01,083773,Ciotti; Benjamin,13,0,35,22
1656028154874,MATH 20E,B02,083774,Ciotti; Benjamin,12,0,35,23
1656028160902,MATH 103A,A01,083777,Greenfeld; Be'Eri,2,1,36,34
1656028160902,MATH 103A,A02,083778,Greenfeld; Be'Eri,1,0,36,35
1656028160902,MATH 103A,A03,093561,Staff,0,1,36,36
1656028160902,MATH 103A,B01,083779,Greenfeld; Be'Eri,8,1,36,28
1656028160902,MATH 103A,B02,083780,Greenfeld; Be'Eri,0,0,36,36
1656028160902,MATH 103A,B03,093562,Staff,0,0,36,36
1656028166929,MATH 105,A01,085443,Carter; Anne Toulson,4,1,35,31
1656028166929,MATH 105,A02,093477,Staff,9,0,35,26
1656028172959,MATH 109,A01,083213,Ganzberger; Geoffrey Michael,0,1,34,34
1656028172959,MATH 109,A02,083214,Ganzberger; Geoffrey Michael,0,0,34,34
1656028172959,MATH 109,A03,093478,Staff,1,0,34,33
1656028172959,MATH 109,B01,083215,Ganzberger; Geoffrey Michael,2,0,32,30
1656028172959,MATH 109,B02,083216,Ganzberger; Geoffrey Michael,0,0,32,32
1656028172959,MATH 109,B03,093479,Staff,3,0,32,29
1656028178988,MATH 142A,A01,083219,Chow; Bennett,1,0,32,31
1656028178988,MATH 142A,A02,083220,Chow; Bennett,7,0,32,25
1656028178988,MATH 142A,A03,093480,Staff,4,0,32,28
1656028178988,MATH 142A,B03,093481,Staff,3,0,32,29
1656028178988,MATH 142A,B04,093558,Staff,6,0,32,26
1656028178988,MATH 142A,B05,093559,Staff,0,0,32,32
1656028185017,MATH 193A,A01,083224,Rotar; Vladimir,1,2,34,33
1656028185017,MATH 193A,A02,083225,Rotar; Vladimir,0,0,34,34
1656028185017,MATH 193A,A03,083781,Rotar; Vladimir,1,0,34,33
1656028185017,MATH 193A,A04,083782,Rotar; Vladimir,3,0,34,31
1656028185017,MATH 193A,A05,093482,Rotar; Vladimir,0,0,34,34
1656028191051,MATH 197,001,091859,McAuley; Julian John,9999,0,9999,0
1656028191051,MATH 197,002,095566,Kedlaya; Kiran S.,9997,0,9999,2
1656028191051,MATH 197,003,095567,Xiao; Ming,9999,0,9999,0
1656028191051,MATH 197,004,095571,Perols; Johan Lars,9998,0,9999,1
1656028198108,COGS 9,A01,083615,Shannon; Kyle Michael,3,1,75,72
1656028204133,COGS 11,A01,083617,Boyle; Mary E. T.,11,1,48,37
1656028210160,COGS 13,A01,083071,Bastos; Amalia Pinkusfeld,4,3,71,67
1656028216187,COGS 14A,A01,092681,Semenuks; Arturs,4,25,100,96
1656028222210,COGS 14B,A01,083073,Cheng; Tzu-Han,7,0,63,56
1656028228236,COGS 17,A01,092677,Semenuks; Arturs,8,7,81,73
1656028234258,COGS 100,A01,083619,Allen; Michael Gordon,2,2,70,68
1656028240281,COGS 101A,A01,083621,Davis; Joshua Daniel,4,3,68,64
1656028246310,COGS 101B,A01,091572,Allen; Michael Gordon,0,0,65,65
1656028252334,COGS 101C,A01,083625,Delgado; Tania,7,0,35,28
1656028258359,COGS 107A,A01,083627,Boyle; Mary E. T.,1,2,60,59
1656028264385,COGS 118A,A01,083075,Gupta; Anjum,21,16,76,55
1656028270415,CSE 3,A50,083646,Miranda; Gregory Joseph,14,0,50,36
1656028276440,CSE 8A,A50,083650,Miranda; Gregory Joseph,4,11,56,52
1656028282462,CSE 11,A01,083080,Cao; Yingjun,0,65,40,40
1656028288485,CSE 12,A01,083652,Krause-Levy; Sophia Louisa,7,8,120,113
1656028294508,CSE 15L,A01,083654,Morris; Justin Loren,3,1,50,47
1656028294508,CSE 15L,A02,083655,Morris; Justin Loren,2,1,50,48
1656028300531,CSE 20,A01,083657,Tran; Khoa Dang,29,0,80,51
1656028306555,CSE 21,A01,095574,Bach; Quang Tran,23,0,48,25
1656028312582,CSE 30,A01,083084,Eldon; John,2,10,80,78
1656028312582,CSE 30,B01,095061,Bhaskar; Nishant,2,5,50,48
1656028318607,CSE 100,A01,083659,Cao; Yingjun,2,25,70,68
1656028324630,CSE 134B,A01,083661,Powell; Thomas Allan,6,6,100,94
1656028330653,CSE 140,A01,083663,Gungor; Onat,5,0,85,80
1656028336678,CSE 140L,A01,083088,Eldon; John,5,0,100,95
1656028342706,CSE 175,A01,083665,Kumar; Rakesh,0,0,25,25
1656028348730,CSE 190,A00,092507,Dubnov; Shlomo,1,0,20,19
1656028354753,ECE 45,A01,083139,Congero; Spencer William,1,1,75,74
1656028360777,ECE 65,A50,083695,Saad; Andrew S,6,0,30,24
1656028360777,ECE 65,A51,095125,Staff,23,0,26,3
1656028366802,ECE 109,A01,091882,Touri; Behrouz,3,5,70,67
1656028372825,ECE 180,A00,083140,Abi Samra; Nicholas Camill,1,0,30,29
1656028372825,ECE 180,B00,083141,Abi Samra; Nicholas Camill,0,8,28,28
1656028378853,MATH 10A,A01,083735,Patchell; Gregory David,0,0,30,30
1656028378853,MATH 10A,A02,083736,Patchell; Gregory David,20,0,30,10
1656028378853,MATH 10A,A03,083737,Patchell; Gregory David,16,0,30,14
1656028384877,MATH 10B,A01,083207,Lim; Seonhee,1,1,34,33
1656028384877,MATH 10B,A02,083208,Lim; Seonhee,1,1,35,34
1656028384877,MATH 10B,A03,093472,Staff,0,0,34,34
1656028384877,MATH 10B,B01,083739,Sinha; Shubham,10,0,30,20
1656028390912,MATH 18,A01,083743,Cinel; Cameron Alexander,5,0,30,25
1656028390912,MATH 18,A02,083744,Cinel; Cameron Alexander,11,0,30,19
1656028390912,MATH 18,A03,083745,Cinel; Cameron Alexander,1,0,30,29
1656028390912,MATH 18,B01,083748,Ma; Zilu,0,0,36,36
1656028390912,MATH 18,B02,083749,Ma; Zilu,0,0,36,36
1656028390912,MATH 18,B03,083750,Ma; Zilu,0,0,36,36
1656028390912,MATH 18,B04,083751,Ma; Zilu,0,0,36,36
1656028390912,MATH 18,B05,093473,Staff,0,0,36,36
1656028390912,MATH 18,B06,093474,Staff,3,0,36,33
1656028396939,MATH 20A,A01,083754,Zheng; Zequn,11,0,40,29
1656028402964,MATH 20B,A01,083756,Briones; Jor-el Thomas Caparas,0,1,36,36
1656028402964,MATH 20B,A02,083757,Briones; Jor-el Thomas Caparas,1,0,36,35
1656028402964,MATH 20B,A03,093475,Staff,0,0,36,36
1656028408991,MATH 20C,A01,083760,Briones; Jor-el Thomas Caparas,0,2,35,35
1656028408991,MATH 20C,A02,083761,Briones; Jor-el Thomas Caparas,6,1,35,29
1656028408991,MATH 20C,A03,093476,Staff,0,0,35,35
1656028408991,MATH 20C,B01,083762,Bach; Quang Tran,3,0,30,27
1656028415014,MATH 20D,A01,083765,Tran; Brian Kha,2,0,30,28
1656028415014,MATH 20D,A02,083766,Tran; Brian Kha,0,1,30,30
1656028415014,MATH 20D,A03,083767,Tran; Brian Kha,1,0,30,29
1656028421052,MATH 20E,A01,083771,Ganguly; Soumya,0,1,32,32
1656028421052,MATH 20E,A02,083772,Ganguly; Soumya,1,1,32,31
1656028421052,MATH 20E,B01,083773,Ciotti; Benjamin,13,0,35,22
1656028421052,MATH 20E,B02,083774,Ciotti; Benjamin,12,0,35,23
1656028427076,MATH 103A,A01,083777,Greenfeld; Be'Eri,2,1,36,34
1656028427076,MATH 103A,A02,083778,Greenfeld; Be'Eri,1,0,36,35
1656028427076,MATH 103A,A03,093561,Staff,0,1,36,36
1656028427076,MATH 103A,B01,083779,Greenfeld; Be'Eri,8,1,36,28
1656028427076,MATH 103A,B02,083780,Greenfeld; Be'Eri,0,0,36,36
1656028427076,MATH 103A,B03,093562,Staff,0,0,36,36
1656028433100,MATH 105,A01,085443,Carter; Anne Toulson,4,1,35,31
1656028433100,MATH 105,A02,093477,Staff,9,0,35,26
1656028439131,MATH 109,A01,083213,Ganzberger; Geoffrey Michael,0,1,34,34
1656028439131,MATH 109,A02,083214,Ganzberger; Geoffrey Michael,0,0,34,34
1656028439131,MATH 109,A03,093478,Staff,1,0,34,33
1656028439131,MATH 109,B01,083215,Ganzberger; Geoffrey Michael,2,0,32,30
1656028439131,MATH 109,B02,083216,Ganzberger; Geoffrey Michael,0,0,32,32
1656028439131,MATH 109,B03,093479,Staff,3,0,32,29
1656028445157,MATH 142A,A01,083219,Chow; Bennett,1,0,32,31
1656028445157,MATH 142A,A02,083220,Chow; Bennett,7,0,32,25
1656028445157,MATH 142A,A03,093480,Staff,4,0,32,28
1656028445157,MATH 142A,B03,093481,Staff,3,0,32,29
1656028445157,MATH 142A,B04,093558,Staff,6,0,32,26
1656028445157,MATH 142A,B05,093559,Staff,0,0,32,32
1656028451185,MATH 193A,A01,083224,Rotar; Vladimir,1,2,34,33
1656028451185,MATH 193A,A02,083225,Rotar; Vladimir,0,0,34,34
1656028451185,MATH 193A,A03,083781,Rotar; Vladimir,1,0,34,33
1656028451185,MATH 193A,A04,083782,Rotar; Vladimir,3,0,34,31
1656028451185,MATH 193A,A05,093482,Rotar; Vladimir,0,0,34,34
1656028457217,MATH 197,001,091859,McAuley; Julian John,9999,0,9999,0
1656028457217,MATH 197,002,095566,Kedlaya; Kiran S.,9997,0,9999,2
1656028457217,MATH 197,003,095567,Xiao; Ming,9999,0,9999,0
1656028457217,MATH 197,004,095571,Perols; Johan Lars,9998,0,9999,1
1656028464268,COGS 9,A01,083615,Shannon; Kyle Michael,3,1,75,72
1656028470294,COGS 11,A01,083617,Boyle; Mary E. T.,11,1,48,37
1656028476321,COGS 13,A01,083071,Bastos; Amalia Pinkusfeld,4,3,71,67
1656028482348,COGS 14A,A01,092681,Semenuks; Arturs,4,25,100,96
1656028488375,COGS 14B,A01,083073,Cheng; Tzu-Han,7,0,63,56
1656028494397,COGS 17,A01,092677,Semenuks; Arturs,8,7,81,73
1656028500423,COGS 100,A01,083619,Allen; Michael Gordon,2,2,70,68
1656028506446,COGS 101A,A01,083621,Davis; Joshua Daniel,4,3,68,64
1656028512468,COGS 101B,A01,091572,Allen; Michael Gordon,0,0,65,65
1656028518492,COGS 101C,A01,083625,Delgado; Tania,7,0,35,28
1656028524519,COGS 107A,A01,083627,Boyle; Mary E. T.,1,2,60,59
1656028530638,COGS 118A,A01,083075,Gupta; Anjum,21,16,76,55
1656028536662,CSE 3,A50,083646,Miranda; Gregory Joseph,14,0,50,36
1656028542690,CSE 8A,A50,083650,Miranda; Gregory Joseph,4,11,56,52
1656028548725,CSE 11,A01,083080,Cao; Yingjun,0,65,40,40
1656028554748,CSE 12,A01,083652,Krause-Levy; Sophia Louisa,7,8,120,113
1656028560770,CSE 15L,A01,083654,Morris; Justin Loren,3,1,50,47
1656028560770,CSE 15L,A02,083655,Morris; Justin Loren,2,1,50,48
1656028566814,CSE 20,A01,083657,Tran; Khoa Dang,29,0,80,51
1656028572836,CSE 21,A01,095574,Bach; Quang Tran,23,0,48,25
1656028578861,CSE 30,A01,083084,Eldon; John,2,10,80,78
1656028578861,CSE 30,B01,095061,Bhaskar; Nishant,2,5,50,48
1656028584884,CSE 100,A01,083659,Cao; Yingjun,2,25,70,68
1656028590907,CSE 134B,A01,083661,Powell; Thomas Allan,6,6,100,94
1656028596934,CSE 140,A01,083663,Gungor; Onat,5,0,85,80
1656028602961,CSE 140L,A01,083088,Eldon; John,5,0,100,95
1656028608983,CSE 175,A01,083665,Kumar; Rakesh,0,0,25,25
1656028615006,CSE 190,A00,092507,Dubnov; Shlomo,1,0,20,19
1656028621033,ECE 45,A01,083139,Congero; Spencer William,1,1,75,74
1656028627060,ECE 65,A50,083695,Saad; Andrew S,6,0,30,24
1656028627060,ECE 65,A51,095125,Staff,23,0,26,3
1656028633089,ECE 109,A01,091882,Touri; Behrouz,3,5,70,67
1656028639117,ECE 180,A00,083140,Abi Samra; Nicholas Camill,1,0,30,29
1656028639117,ECE 180,B00,083141,Abi Samra; Nicholas Camill,0,8,28,28
1656028645142,MATH 10A,A01,083735,Patchell; Gregory David,0,0,30,30
1656028645142,MATH 10A,A02,083736,Patchell; Gregory David,20,0,30,10
1656028645142,MATH 10A,A03,083737,Patchell; Gregory David,16,0,30,14
1656028651171,MATH 10B,A01,083207,Lim; Seonhee,1,1,34,33
1656028651171,MATH 10B,A02,083208,Lim; Seonhee,1,1,35,34
1656028651171,MATH 10B,A03,093472,Staff,0,0,34,34
1656028651171,MATH 10B,B01,083739,Sinha; Shubham,10,0,30,20
1656028657201,MATH 18,A01,083743,Cinel; Cameron Alexander,5,0,30,25
1656028657201,MATH 18,A02,083744,Cinel; Cameron Alexander,11,0,30,19
1656028657201,MATH 18,A03,083745,Cinel; Cameron Alexander,1,0,30,29
1656028657201,MATH 18,B01,083748,Ma; Zilu,0,0,36,36
1656028657201,MATH 18,B02,083749,Ma; Zilu,0,0,36,36
1656028657201,MATH 18,B03,083750,Ma; Zilu,0,0,36,36
1656028657201,MATH 18,B04,083751,Ma; Zilu,0,0,36,36
1656028657201,MATH 18,B05,093473,Staff,0,0,36,36
1656028657201,MATH 18,B06,093474,Staff,3,0,36,33
1656028663223,MATH 20A,A01,083754,Zheng; Zequn,11,0,40,29
1656028669246,MATH 20B,A01,083756,Briones; Jor-el Thomas Caparas,0,1,36,36
1656028669246,MATH 20B,A02,083757,Briones; Jor-el Thomas Caparas,1,0,36,35
1656028669246,MATH 20B,A03,093475,Staff,0,0,36,36
1656028675274,MATH 20C,A01,083760,Briones; Jor-el Thomas Caparas,0,2,35,35
1656028675274,MATH 20C,A02,083761,Briones; Jor-el Thomas Caparas,6,1,35,29
1656028675274,MATH 20C,A03,093476,Staff,0,0,35,35
1656028675274,MATH 20C,B01,083762,Bach; Quang Tran,3,0,30,27
1656028681302,MATH 20D,A01,083765,Tran; Brian Kha,2,0,30,28
1656028681302,MATH 20D,A02,083766,Tran; Brian Kha,0,1,30,30
1656028681302,MATH 20D,A03,083767,Tran; Brian Kha,1,0,30,29
1656028687332,MATH 20E,A01,083771,Ganguly; Soumya,0,1,32,32
1656028687332,MATH 20E,A02,083772,Ganguly; Soumya,1,1,32,31
1656028687332,MATH 20E,B01,083773,Ciotti; Benjamin,13,0,35,22
1656028687332,MATH 20E,B02,083774,Ciotti; Benjamin,12,0,35,23
1656028693356,MATH 103A,A01,083777,Greenfeld; Be'Eri,2,1,36,34
1656028693356,MATH 103A,A02,083778,Greenfeld; Be'Eri,1,0,36,35
1656028693356,MATH 103A,A03,093561,Staff,0,1,36,36
1656028693356,MATH 103A,B01,083779,Greenfeld; Be'Eri,8,1,36,28
1656028693356,MATH 103A,B02,083780,Greenfeld; Be'Eri,0,0,36,36
1656028693356,MATH 103A,B03,093562,Staff,0,0,36,36
1656028699381,MATH 105,A01,085443,Carter; Anne Toulson,4,1,35,31
1656028699381,MATH 105,A02,093477,Staff,9,0,35,26
1656028705408,MATH 109,A01,083213,Ganzberger; Geoffrey Michael,0,1,34,34
1656028705408,MATH 109,A02,083214,Ganzberger; Geoffrey Michael,0,0,34,34
1656028705408,MATH 109,A03,093478,Staff,1,0,34,33
1656028705408,MATH 109,B01,083215,Ganzberger; Geoffrey Michael,2,0,32,30
1656028705408,MATH 109,B02,083216,Ganzberger; Geoffrey Michael,0,0,32,32
1656028705408,MATH 109,B03,093479,Staff,3,0,32,29
1656028711437,MATH 142A,A01,083219,Chow; Bennett,1,0,32,31
1656028711437,MATH 142A,A02,083220,Chow; Bennett,7,0,32,25
1656028711437,MATH 142A,A03,093480,Staff,4,0,32,28
1656028711437,MATH 142A,B03,093481,Staff,3,0,32,29
1656028711437,MATH 142A,B04,093558,Staff,6,0,32,26
1656028711437,MATH 142A,B05,093559,Staff,0,0,32,32
1656028717463,MATH 193A,A01,083224,Rotar; Vladimir,1,2,34,33
1656028717463,MATH 193A,A02,083225,Rotar; Vladimir,0,0,34,34
1656028717463,MATH 193A,A03,083781,Rotar; Vladimir,1,0,34,33
1656028717463,MATH 193A,A04,083782,Rotar; Vladimir,3,0,34,31
1656028717463,MATH 193A,A05,093482,Rotar; Vladimir,0,0,34,34
1656028723487,MATH 197,001,091859,McAuley; Julian John,9999,0,9999,0
1656028723487,MATH 197,002,095566,Kedlaya; Kiran S.,9997,0,9999,2
1656028723487,MATH 197,003,095567,Xiao; Ming,9999,0,9999,0
1656028723487,MATH 197,004,095571,Perols; Johan Lars,9998,0,9999,1
1656028730552,COGS 9,A01,083615,Shannon; Kyle Michael,3,1,75,72
1656028736575,COGS 11,A01,083617,Boyle; Mary E. T.,11,1,48,37
1656028742599,COGS 13,A01,083071,Bastos; Amalia Pinkusfeld,4,3,71,67
1656028748621,COGS 14A,A01,092681,Semenuks; Arturs,4,25,100,96
1656028754648,COGS 14B,A01,083073,Cheng; Tzu-Han,7,0,63,56
1656028760672,COGS 17,A01,092677,Semenuks; Arturs,8,7,81,73
1656028766706,COGS 100,A01,083619,Allen; Michael Gordon,2,2,70,68
1656028772734,COGS 101A,A01,083621,Davis; Joshua Daniel,4,3,68,64
1656028778762,COGS 101B,A01,091572,Allen; Michael Gordon,0,0,65,65
1656028784788,COGS 101C,A01,083625,Delgado; Tania,7,0,35,28
1656028790813,COGS 107A,A01,083627,Boyle; Mary E. T.,1,2,60,59
1656028796837,COGS 118A,A01,083075,Gupta; Anjum,21,16,76,55
1656028802869,CSE 3,A50,083646,Miranda; Gregory Joseph,14,0,50,36
1656028808898,CSE 8A,A50,083650,Miranda; Gregory Joseph,4,11,56,52
1656028814923,CSE 11,A01,083080,Cao; Yingjun,0,65,40,40
1656028820947,CSE 12,A01,083652,Krause-Levy; Sophia Louisa,7,8,120,113
1656028826972,CSE 15L,A01,083654,Morris; Justin Loren,3,1,50,47
1656028826972,CSE 15L,A02,083655,Morris; Justin Loren,2,1,50,48
1656028832999,CSE 20,A01,083657,Tran; Khoa Dang,29,0,80,51
1656028839024,CSE 21,A01,095574,Bach; Quang Tran,23,0,48,25
1656028845054,CSE 30,A01,083084,Eldon; John,2,10,80,78
1656028845054,CSE 30,B01,095061,Bhaskar; Nishant,2,5,50,48
1656028851078,CSE 100,A01,083659,Cao; Yingjun,2,25,70,68
1656028857102,CSE 134B,A01,083661,Powell; Thomas Allan,6,6,100,94
1656028863125,CSE 140,A01,083663,Gungor; Onat,5,0,85,80
1656028869155,CSE 140L,A01,083088,Eldon; John,5,0,100,95
1656028875179,CSE 175,A01,083665,Kumar; Rakesh,0,0,25,25
1656028881203,CSE 190,A00,092507,Dubnov; Shlomo,1,0,20,19
1656028887231,ECE 45,A01,083139,Congero; Spencer William,1,1,75,74
1656028893256,ECE 65,A50,083695,Saad; Andrew S,6,0,30,24
1656028893256,ECE 65,A51,095125,Staff,23,0,26,3
1656028899283,ECE 109,A01,091882,Touri; Behrouz,3,5,70,67
1656028905307,ECE 180,A00,083140,Abi Samra; Nicholas Camill,1,0,30,29
1656028905307,ECE 180,B00,083141,Abi Samra; Nicholas Camill,0,8,28,28
1656028911330,MATH 10A,A01,083735,Patchell; Gregory David,0,0,30,30
1656028911330,MATH 10A,A02,083736,Patchell; Gregory David,20,0,30,10
1656028911330,MATH 10A,A03,083737,Patchell; Gregory David,16,0,30,14
1656028917357,MATH 10B,A01,083207,Lim; Seonhee,1,1,34,33
1656028917357,MATH 10B,A02,083208,Lim; Seonhee,1,1,35,34
1656028917357,MATH 10B,A03,093472,Staff,0,0,34,34
1656028917357,MATH 10B,B01,083739,Sinha; Shubham,10,0,30,20
1656028923390,MATH 18,A01,083743,Cinel; Cameron Alexander,5,0,30,25
1656028923390,MATH 18,A02,083744,Cinel; Cameron Alexander,11,0,30,19
1656028923390,MATH 18,A03,083745,Cinel; Cameron Alexander,1,0,30,29
1656028923390,MATH 18,B01,083748,Ma; Zilu,0,0,36,36
1656028923390,MATH 18,B02,083749,Ma; Zilu,0,0,36,36
1656028923390,MATH 18,B03,083750,Ma; Zilu,0,0,36,36
1656028923390,MATH 18,B04,083751,Ma; Zilu,0,0,36,36
1656028923390,MATH 18,B05,093473,Staff,0,0,36,36
1656028923390,MATH 18,B06,093474,Staff,3,0,36,33
1656028929413,MATH 20A,A01,083754,Zheng; Zequn,11,0,40,29
1656028935437,MATH 20B,A01,083756,Briones; Jor-el Thomas Caparas,0,1,36,36
1656028935437,MATH 20B,A02,083757,Briones; Jor-el Thomas Caparas,1,0,36,35
1656028935437,MATH 20B,A03,093475,Staff,0,0,36,36
1656028941462,MATH 20C,A01,083760,Briones; Jor-el Thomas Caparas,0,2,35,35
1656028941462,MATH 20C,A02,083761,Briones; Jor-el Thomas Caparas,6,1,35,29
1656028941462,MATH 20C,A03,093476,Staff,0,0,35,35
1656028941462,MATH 20C,B01,083762,Bach; Quang Tran,3,0,30,27
1656028947491,MATH 20D,A01,083765,Tran; Brian Kha,2,0,30,28
1656028947491,MATH 20D,A02,083766,Tran; Brian Kha,0,1,30,30
1656028947491,MATH 20D,A03,083767,Tran; Brian Kha,1,0,30,29
1656028953517,MATH 20E,A01,083771,Ganguly; Soumya,0,1,32,32
1656028953517,MATH 20E,A02,083772,Ganguly; Soumya,1,1,32,31
1656028953517,MATH 20E,B01,083773,Ciotti; Benjamin,13,0,35,22
1656028953517,MATH 20E,B02,083774,Ciotti; Benjamin,12,0,35,23
1656028959548,MATH 103A,A01,083777,Greenfeld; Be'Eri,2,1,36,34
1656028959548,MATH 103A,A02,083778,Greenfeld; Be'Eri,1,0,36,35
1656028959548,MATH 103A,A03,093561,Staff,0,1,36,36
1656028959548,MATH 103A,B01,083779,Greenfeld; Be'Eri,8,1,36,28
1656028959548,MATH 103A,B02,083780,Greenfeld; Be'Eri,0,0,36,36
1656028959548,MATH 103A,B03,093562,Staff,0,0,36,36
1656028965576,MATH 105,A01,085443,Carter; Anne Toulson,4,1,35,31
1656028965576,MATH 105,A02,093477,Staff,9,0,35,26
1656028971606,MATH 109,A01,083213,Ganzberger; Geoffrey Michael,0,1,34,34
1656028971606,MATH 109,A02,083214,Ganzberger; Geoffrey Michael,0,0,34,34
1656028971606,MATH 109,A03,093478,Staff,1,0,34,33
1656028971606,MATH 109,B01,083215,Ganzberger; Geoffrey Michael,2,0,32,30
1656028971606,MATH 109,B02,083216,Ganzberger; Geoffrey Michael,0,0,32,32
1656028971606,MATH 109,B03,093479,Staff,3,0,32,29
1656028977630,MATH 142A,A01,083219,Chow; Bennett,1,0,32,31
1656028977630,MATH 142A,A02,083220,Chow; Bennett,7,0,32,25
1656028977630,MATH 142A,A03,093480,Staff,4,0,32,28
1656028977630,MATH 142A,B03,093481,Staff,3,0,32,29
1656028977630,MATH 142A,B04,093558,Staff,6,0,32,26
1656028977630,MATH 142A,B05,093559,Staff,0,0,32,32
1656028983655,MATH 193A,A01,083224,Rotar; Vladimir,1,2,34,33
1656028983655,MATH 193A,A02,083225,Rotar; Vladimir,0,0,34,34
1656028983655,MATH 193A,A03,083781,Rotar; Vladimir,1,0,34,33
1656028983655,MATH 193A,A04,083782,Rotar; Vladimir,3,0,34,31
1656028983655,MATH 193A,A05,093482,Rotar; Vladimir,0,0,34,34
1656028989687,MATH 197,001,091859,McAuley; Julian John,9999,0,9999,0
1656028989687,MATH 197,002,095566,Kedlaya; Kiran S.,9997,0,9999,2
1656028989687,MATH 197,003,095567,Xiao; Ming,9999,0,9999,0
1656028989687,MATH 197,004,095571,Perols; Johan Lars,9998,0,9999,1
1656028996766,COGS 9,A01,083615,Shannon; Kyle Michael,3,1,75,72
1656029002794,COGS 11,A01,083617,Boyle; Mary E. T.,11,1,48,37
1656029008817,COGS 13,A01,083071,Bastos; Amalia Pinkusfeld,4,3,71,67
1656029014840,COGS 14A,A01,092681,Semenuks; Arturs,4,25,100,96
1656029020869,COGS 14B,A01,083073,Cheng; Tzu-Han,7,0,63,56
1656029026891,COGS 17,A01,092677,Semenuks; Arturs,8,7,81,73
1656029032921,COGS 100,A01,083619,Allen; Michael Gordon,2,2,70,68
1656029038945,COGS 101A,A01,083621,Davis; Joshua Daniel,4,3,68,64
1656029044968,COGS 101B,A01,091572,Allen; Michael Gordon,0,0,65,65
1656029050992,COGS 101C,A01,083625,Delgado; Tania,7,0,35,28
1656029057021,COGS 107A,A01,083627,Boyle; Mary E. T.,1,2,60,59
1656029063045,COGS 118A,A01,083075,Gupta; Anjum,21,16,76,55
1656029069072,CSE 3,A50,083646,Miranda; Gregory Joseph,14,0,50,36
1656029075096,CSE 8A,A50,083650,Miranda; Gregory Joseph,4,11,56,52
1656029081120,CSE 11,A01,083080,Cao; Yingjun,0,65,40,40
1656029087146,CSE 12,A01,083652,Krause-Levy; Sophia Louisa,7,8,120,113
1656029093173,CSE 15L,A01,083654,Morris; Justin Loren,3,1,50,47
1656029093173,CSE 15L,A02,083655,Morris; Justin Loren,2,1,50,48
1656029099205,CSE 20,A01,083657,Tran; Khoa Dang,29,0,80,51
1656029105237,CSE 21,A01,095574,Bach; Quang Tran,23,0,48,25
1656029111271,CSE 30,A01,083084,Eldon; John,2,10,80,78
1656029111271,CSE 30,B01,095061,Bhaskar; Nishant,2,5,50,48
1656029117298,CSE 100,A01,083659,Cao; Yingjun,2,25,70,68
1656029123322,CSE 134B,A01,083661,Powell; Thomas Allan,6,6,100,94
1656029129446,CSE 140,A01,083663,Gungor; Onat,5,0,85,80
1656029135474,CSE 140L,A01,083088,Eldon; John,5,0,100,95
1656029141497,CSE 175,A01,083665,Kumar; Rakesh,0,0,25,25
1656029147521,CSE 190,A00,092507,Dubnov; Shlomo,1,0,20,19
1656029153546,ECE 45,A01,083139,Congero; Spencer William,1,1,75,74
1656029159571,ECE 65,A50,083695,Saad; Andrew S,6,0,30,24
1656029159571,ECE 65,A51,095125,Staff,23,0,26,3
1656029165594,ECE 109,A01,091882,Touri; Behrouz,3,5,70,67
1656029171618,ECE 180,A00,083140,Abi Samra; Nicholas Camill,1,0,30,29
1656029171618,ECE 180,B00,083141,Abi Samra; Nicholas Camill,0,8,28,28
1656029177643,MATH 10A,A01,083735,Patchell; Gregory David,0,0,30,30
1656029177643,MATH 10A,A02,083736,Patchell; Gregory David,20,0,30,10
1656029177643,MATH 10A,A03,083737,Patchell; Gregory David,16,0,30,14
1656029183672,MATH 10B,A01,083207,Lim; Seonhee,1,1,34,33
1656029183672,MATH 10B,A02,083208,Lim; Seonhee,1,1,35,34
1656029183672,MATH 10B,A03,093472,Staff,0,0,34,34
1656029183672,MATH 10B,B01,083739,Sinha; Shubham,10,0,30,20
1656029189699,MATH 18,A01,083743,Cinel; Cameron Alexander,5,0,30,25
1656029189699,MATH 18,A02,083744,Cinel; Cameron Alexander,11,0,30,19
1656029189699,MATH 18,A03,083745,Cinel; Cameron Alexander,1,0,30,29
1656029189699,MATH 18,B01,083748,Ma; Zilu,0,0,36,36
1656029189699,MATH 18,B02,083749,Ma; Zilu,0,0,36,36
1656029189699,MATH 18,B03,083750,Ma; Zilu,0,0,36,36
1656029189699,MATH 18,B04,083751,Ma; Zilu,0,0,36,36
1656029189699,MATH 18,B05,093473,Staff,0,0,36,36
1656029189699,MATH 18,B06,093474,Staff,3,0,36,33
1656029195723,MATH 20A,A01,083754,Zheng; Zequn,11,0,40,29
1656029201751,MATH 20B,A01,083756,Briones; Jor-el Thomas Caparas,0,1,36,36
1656029201751,MATH 20B,A02,083757,Briones; Jor-el Thomas Caparas,1,0,36,35
1656029201751,MATH 20B,A03,093475,Staff,0,0,36,36
1656029207775,MATH 20C,A01,083760,Briones; Jor-el Thomas Caparas,0,2,35,35
1656029207775,MATH 20C,A02,083761,Briones; Jor-el Thomas Caparas,6,1,35,29
1656029207775,MATH 20C,A03,093476,Staff,0,0,35,35
1656029207775,MATH 20C,B01,083762,Bach; Quang Tran,3,0,30,27
1656029213798,MATH 20D,A01,083765,Tran; Brian Kha,2,0,30,28
1656029213798,MATH 20D,A02,083766,Tran; Brian Kha,0,1,30,30
1656029213798,MATH 20D,A03,083767,Tran; Brian Kha,1,0,30,29
1656029219823,MATH 20E,A01,083771,Ganguly; Soumya,0,1,32,32
1656029219823,MATH 20E,A02,083772,Ganguly; Soumya,1,1,32,31
1656029219823,MATH 20E,B01,083773,Ciotti; Benjamin,13,0,35,22
1656029219823,MATH 20E,B02,083774,Ciotti; Benjamin,12,0,35,23
1656029225863,MATH 103A,A01,083777,Greenfeld; Be'Eri,2,1,36,34
1656029225863,MATH 103A,A02,083778,Greenfeld; Be'Eri,1,0,36,35
1656029225863,MATH 103A,A03,093561,Staff,0,1,36,36
1656029225863,MATH 103A,B01,083779,Greenfeld; Be'Eri,8,1,36,28
1656029225863,MATH 103A,B02,083780,Greenfeld; Be'Eri,0,0,36,36
1656029225863,MATH 103A,B03,093562,Staff,0,0,36,36
1656029231890,MATH 105,A01,085443,Carter; Anne Toulson,4,1,35,31
1656029231890,MATH 105,A02,093477,Staff,9,0,35,26
1656029237923,MATH 109,A01,083213,Ganzberger; Geoffrey Michael,0,1,34,34
1656029237923,MATH 109,A02,083214,Ganzberger; Geoffrey Michael,0,0,34,34
1656029237923,MATH 109,A03,093478,Staff,1,0,34,33
1656029237923,MATH 109,B01,083215,Ganzberger; Geoffrey Michael,2,0,32,30
1656029237923,MATH 109,B02,083216,Ganzberger; Geoffrey Michael,0,0,32,32
1656029237923,MATH 109,B03,093479,Staff,3,0,32,29
1656029243951,MATH 142A,A01,083219,Chow; Bennett,1,0,32,31
1656029243951,MATH 142A,A02,083220,Chow; Bennett,7,0,32,25
1656029243951,MATH 142A,A03,093480,Staff,4,0,32,28
1656029243951,MATH 142A,B03,093481,Staff,3,0,32,29
1656029243951,MATH 142A,B04,093558,Staff,6,0,32,26
1656029243951,MATH 142A,B05,093559,Staff,0,0,32,32
1656029249976,MATH 193A,A01,083224,Rotar; Vladimir,1,2,34,33
1656029249976,MATH 193A,A02,083225,Rotar; Vladimir,0,0,34,34
1656029249976,MATH 193A,A03,083781,Rotar; Vladimir,1,0,34,33
1656029249976,MATH 193A,A04,083782,Rotar; Vladimir,3,0,34,31
1656029249976,MATH 193A,A05,093482,Rotar; Vladimir,0,0,34,34
1656029256001,MATH 197,001,091859,McAuley; Julian John,9999,0,9999,0
1656029256001,MATH 197,002,095566,Kedlaya; Kiran S.,9997,0,9999,2
1656029256001,MATH 197,003,095567,Xiao; Ming,9999,0,9999,0
1656029256001,MATH 197,004,095571,Perols; Johan Lars,9998,0,9999,1
1656029263055,COGS 9,A01,083615,Shannon; Kyle Michael,3,1,75,72
1656029269083,COGS 11,A01,083617,Boyle; Mary E. T.,11,1,48,37
1656029275108,COGS 13,A01,083071,Bastos; Amalia Pinkusfeld,4,3,71,67
1656029281136,COGS 14A,A01,092681,Semenuks; Arturs,4,25,100,96
1656029287160,COGS 14B,A01,083073,Cheng; Tzu-Han,7,0,63,56
1656029293183,COGS 17,A01,092677,Semenuks; Arturs,8,7,81,73
1656029299207,COGS 100,A01,083619,Allen; Michael Gordon,2,2,70,68
1656029305231,COGS 101A,A01,083621,Davis; Joshua Daniel,4,3,68,64
1656029311254,COGS 101B,A01,091572,Allen; Michael Gordon,0,0,65,65
1656029317276,COGS 101C,A01,083625,Delgado; Tania,7,0,35,28
1656029323303,COGS 107A,A01,083627,Boyle; Mary E. T.,1,2,60,59
1656029329329,COGS 118A,A01,083075,Gupta; Anjum,21,16,76,55
1656029335352,CSE 3,A50,083646,Miranda; Gregory Joseph,14,0,50,36
1656029341376,CSE 8A,A50,083650,Miranda; Gregory Joseph,4,11,56,52
1656029347402,CSE 11,A01,083080,Cao; Yingjun,0,65,40,40
1656029353427,CSE 12,A01,083652,Krause-Levy; Sophia Louisa,7,8,120,113
1656029359459,CSE 15L,A01,083654,Morris; Justin Loren,3,1,50,47
1656029359459,CSE 15L,A02,083655,Morris; Justin Loren,2,1,50,48
1656029365481,CSE 20,A01,083657,Tran; Khoa Dang,29,0,80,51
1656029371502,CSE 21,A01,095574,Bach; Quang Tran,23,0,48,25
1656029377524,CSE 30,A01,083084,Eldon; John,2,10,80,78
1656029377524,CSE 30,B01,095061,Bhaskar; Nishant,2,5,50,48
1656029383546,CSE 100,A01,083659,Cao; Yingjun,2,25,70,68
1656029389570,CSE 134B,A01,083661,Powell; Thomas Allan,6,6,100,94
1656029395593,CSE 140,A01,083663,Gungor; Onat,5,0,85,80
1656029401617,CSE 140L,A01,083088,Eldon; John,5,0,100,95
1656029407642,CSE 175,A01,083665,Kumar; Rakesh,0,0,25,25
1656029413668,CSE 190,A00,092507,Dubnov; Shlomo,1,0,20,19
1656029419693,ECE 45,A01,083139,Congero; Spencer William,1,1,75,74
1656029425714,ECE 65,A50,083695,Saad; Andrew S,6,0,30,24
1656029425714,ECE 65,A51,095125,Staff,23,0,26,3
1656029431741,ECE 109,A01,091882,Touri; Behrouz,3,5,70,67
1656029437768,ECE 180,A00,083140,Abi Samra; Nicholas Camill,1,0,30,29
1656029437768,ECE 180,B00,083141,Abi Samra; Nicholas Camill,0,8,28,28
1656029443796,MATH 10A,A01,083735,Patchell; Gregory David,0,0,30,30
1656029443796,MATH 10A,A02,083736,Patchell; Gregory David,20,0,30,10
1656029443796,MATH 10A,A03,083737,Patchell; Gregory David,16,0,30,14
1656029449826,MATH 10B,A01,083207,Lim; Seonhee,1,1,34,33
1656029449826,MATH 10B,A02,083208,Lim; Seonhee,1,1,35,34
1656029449826,MATH 10B,A03,093472,Staff,0,0,34,34
1656029449826,MATH 10B,B01,083739,Sinha; Shubham,10,0,30,20
1656029455851,MATH 18,A01,083743,Cinel; Cameron Alexander,5,0,30,25
1656029455851,MATH 18,A02,083744,Cinel; Cameron Alexander,11,0,30,19
1656029455851,MATH 18,A03,083745,Cinel; Cameron Alexander,1,0,30,29
1656029455851,MATH 18,B01,083748,Ma; Zilu,0,0,36,36
1656029455851,MATH 18,B02,083749,Ma; Zilu,0,0,36,36
1656029455851,MATH 18,B03,083750,Ma; Zilu,0,0,36,36
1656029455851,MATH 18,B04,083751,Ma; Zilu,0,0,36,36
1656029455851,MATH 18,B05,093473,Staff,0,0,36,36
1656029455851,MATH 18,B06,093474,Staff,3,0,36,33
1656029461874,MATH 20A,A01,083754,Zheng; Zequn,11,0,40,29
1656029467903,MATH 20B,A01,083756,Briones; Jor-el Thomas Caparas,0,1,36,36
1656029467903,MATH 20B,A02,083757,Briones; Jor-el Thomas Caparas,1,0,36,35
1656029467903,MATH 20B,A03,093475,Staff,0,0,36,36
1656029473927,MATH 20C,A01,083760,Briones; Jor-el Thomas Caparas,0,2,35,35
1656029473927,MATH 20C,A02,083761,Briones; Jor-el Thomas Caparas,6,1,35,29
1656029473927,MATH 20C,A03,093476,Staff,0,0,35,35
1656029473927,MATH 20C,B01,083762,Bach; Quang Tran,3,0,30,27
1656029479958,MATH 20D,A01,083765,Tran; Brian Kha,2,0,30,28
1656029479958,MATH 20D,A02,083766,Tran; Brian Kha,0,1,30,30
1656029479958,MATH 20D,A03,083767,Tran; Brian Kha,1,0,30,29
1656029485984,MATH 20E,A01,083771,Ganguly; Soumya,0,1,32,32
1656029485984,MATH 20E,A02,083772,Ganguly; Soumya,1,1,32,31
1656029485984,MATH 20E,B01,083773,Ciotti; Benjamin,13,0,35,22
1656029485984,MATH 20E,B02,083774,Ciotti; Benjamin,12,0,35,23
1656029492015,MATH 103A,A01,083777,Greenfeld; Be'Eri,2,1,36,34
1656029492015,MATH 103A,A02,083778,Greenfeld; Be'Eri,1,0,36,35
1656029492015,MATH 103A,A03,093561,Staff,0,1,36,36
1656029492015,MATH 103A,B01,083779,Greenfeld; Be'Eri,8,1,36,28
1656029492015,MATH 103A,B02,083780,Greenfeld; Be'Eri,0,0,36,36
1656029492015,MATH 103A,B03,093562,Staff,0,0,36,36
1656029498038,MATH 105,A01,085443,Carter; Anne Toulson,4,1,35,31
1656029498038,MATH 105,A02,093477,Staff,9,0,35,26
1656029504073,MATH 109,A01,083213,Ganzberger; Geoffrey Michael,0,1,34,34
1656029504073,MATH 109,A02,083214,Ganzberger; Geoffrey Michael,0,0,34,34
1656029504073,MATH 109,A03,093478,Staff,1,0,34,33
1656029504073,MATH 109,B01,083215,Ganzberger; Geoffrey Michael,2,0,32,30
1656029504073,MATH 109,B02,083216,Ganzberger; Geoffrey Michael,0,0,32,32
1656029504073,MATH 109,B03,093479,Staff,3,0,32,29
1656029510098,MATH 142A,A01,083219,Chow; Bennett,1,0,32,31
1656029510098,MATH 142A,A02,083220,Chow; Bennett,7,0,32,25
1656029510098,MATH 142A,A03,093480,Staff,4,0,32,28
1656029510098,MATH 142A,B03,093481,Staff,3,0,32,29
1656029510098,MATH 142A,B04,093558,Staff,6,0,32,26
1656029510098,MATH 142A,B05,093559,Staff,0,0,32,32
1656029516123,MATH 193A,A01,083224,Rotar; Vladimir,1,2,34,33
1656029516123,MATH 193A,A02,083225,Rotar; Vladimir,0,0,34,34
1656029516123,MATH 193A,A03,083781,Rotar; Vladimir,1,0,34,33
1656029516123,MATH 193A,A04,083782,Rotar; Vladimir,3,0,34,31
1656029516123,MATH 193A,A05,093482,Rotar; Vladimir,0,0,34,34
1656029522146,MATH 197,001,091859,McAuley; Julian John,9999,0,9999,0
1656029522146,MATH 197,002,095566,Kedlaya; Kiran S.,9997,0,9999,2
1656029522146,MATH 197,003,095567,Xiao; Ming,9999,0,9999,0
1656029522146,MATH 197,004,095571,Perols; Johan Lars,9998,0,9999,1
1656029529228,COGS 9,A01,083615,Shannon; Kyle Michael,3,1,75,72
1656029535252,COGS 11,A01,083617,Boyle; Mary E. T.,11,1,48,37
1656029541289,COGS 13,A01,083071,Bastos; Amalia Pinkusfeld,4,3,71,67
1656029547318,COGS 14A,A01,092681,Semenuks; Arturs,4,25,100,96
1656029553345,COGS 14B,A01,083073,Cheng; Tzu-Han,7,0,63,56
1656029559373,COGS 17,A01,092677,Semenuks; Arturs,8,7,81,73
1656029565397,COGS 100,A01,083619,Allen; Michael Gordon,2,2,70,68
1656029571426,COGS 101A,A01,083621,Davis; Joshua Daniel,4,3,68,64
1656029577449,COGS 101B,A01,091572,Allen; Michael Gordon,0,0,65,65
1656029583474,COGS 101C,A01,083625,Delgado; Tania,7,0,35,28
1656029589501,COGS 107A,A01,083627,Boyle; Mary E. T.,1,2,60,59
1656029595525,COGS 118A,A01,083075,Gupta; Anjum,21,16,76,55
1656029601557,CSE 3,A50,083646,Miranda; Gregory Joseph,14,0,50,36
1656029607581,CSE 8A,A50,083650,Miranda; Gregory Joseph,4,11,56,52
1656029613611,CSE 11,A01,083080,Cao; Yingjun,0,65,40,40
1656029619638,CSE 12,A01,083652,Krause-Levy; Sophia Louisa,7,8,120,113
1656029625670,CSE 15L,A01,083654,Morris; Justin Loren,3,1,50,47
1656029625670,CSE 15L,A02,083655,Morris; Justin Loren,2,1,50,48
1656029631694,CSE 20,A01,083657,Tran; Khoa Dang,29,0,80,51
1656029637719,CSE 21,A01,095574,Bach; Quang Tran,23,0,48,25
1656029643743,CSE 30,A01,083084,Eldon; John,2,10,80,78
1656029643743,CSE 30,B01,095061,Bhaskar; Nishant,2,5,50,48
1656029649771,CSE 100,A01,083659,Cao; Yingjun,2,25,70,68
1656029655800,CSE 134B,A01,083661,Powell; Thomas Allan,6,6,100,94
1656029661827,CSE 140,A01,083663,Gungor; Onat,5,0,85,80
1656029667852,CSE 140L,A01,083088,Eldon; John,5,0,100,95
1656029673880,CSE 175,A01,083665,Kumar; Rakesh,0,0,25,25
1656029679912,CSE 190,A00,092507,Dubnov; Shlomo,1,0,20,19
1656029685939,ECE 45,A01,083139,Congero; Spencer William,1,1,75,74
1656029691966,ECE 65,A50,083695,Saad; Andrew S,6,0,30,24
1656029691966,ECE 65,A51,095125,Staff,23,0,26,3
1656029697998,ECE 109,A01,091882,Touri; Behrouz,3,5,70,67
1656029704022,ECE 180,A00,083140,Abi Samra; Nicholas Camill,1,0,30,29
1656029704022,ECE 180,B00,083141,Abi Samra; Nicholas Camill,0,8,28,28
1656029710054,MATH 10A,A01,083735,Patchell; Gregory David,0,0,30,30
1656029710054,MATH 10A,A02,083736,Patchell; Gregory David,20,0,30,10
1656029710054,MATH 10A,A03,083737,Patchell; Gregory David,16,0,30,14
1656029716082,MATH 10B,A01,083207,Lim; Seonhee,1,1,34,33
1656029716082,MATH 10B,A02,083208,Lim; Seonhee,1,1,35,34
1656029716082,MATH 10B,A03,093472,Staff,0,0,34,34
1656029716082,MATH 10B,B01,083739,Sinha; Shubham,10,0,30,20
1656029722111,MATH 18,A01,083743,Cinel; Cameron Alexander,5,0,30,25
1656029722111,MATH 18,A02,083744,Cinel; Cameron Alexander,11,0,30,19
1656029722111,MATH 18,A03,083745,Cinel; Cameron Alexander,1,0,30,29
1656029722111,MATH 18,B01,083748,Ma; Zilu,0,0,36,36
1656029722111,MATH 18,B02,083749,Ma; Zilu,0,0,36,36
1656029722111,MATH 18,B03,083750,Ma; Zilu,0,0,36,36
1656029722111,MATH 18,B04,083751,Ma; Zilu,0,0,36,36
1656029722111,MATH 18,B05,093473,Staff,0,0,36,36
1656029722111,MATH 18,B06,093474,Staff,3,0,36,33
1656029728225,MATH 20A,A01,083754,Zheng; Zequn,11,0,40,29
1656029734247,MATH 20B,A01,083756,Briones; Jor-el Thomas Caparas,0,1,36,36
1656029734247,MATH 20B,A02,083757,Briones; Jor-el Thomas Caparas,1,0,36,35
1656029734247,MATH 20B,A03,093475,Staff,0,0,36,36
1656029740272,MATH 20C,A01,083760,Briones; Jor-el Thomas Caparas,0,2,35,35
1656029740272,MATH 20C,A02,083761,Briones; Jor-el Thomas Caparas,6,1,35,29
1656029740272,MATH 20C,A03,093476,Staff,0,0,35,35
1656029740272,MATH 20C,B01,083762,Bach; Quang Tran,3,0,30,27
1656029746301,MATH 20D,A01,083765,Tran; Brian Kha,2,0,30,28
1656029746301,MATH 20D,A02,083766,Tran; Brian Kha,0,1,30,30
1656029746301,MATH 20D,A03,083767,Tran; Brian Kha,1,0,30,29
1656029752325,MATH 20E,A01,083771,Ganguly; Soumya,0,1,32,32
1656029752325,MATH 20E,A02,083772,Ganguly; Soumya,1,1,32,31
1656029752325,MATH 20E,B01,083773,Ciotti; Benjamin,13,0,35,22
1656029752325,MATH 20E,B02,083774,Ciotti; Benjamin,12,0,35,23
1656029758349,MATH 103A,A01,083777,Greenfeld; Be'Eri,2,1,36,34
1656029758349,MATH 103A,A02,083778,Greenfeld; Be'Eri,1,0,36,35
1656029758349,MATH 103A,A03,093561,Staff,0,1,36,36
1656029758349,MATH 103A,B01,083779,Greenfeld; Be'Eri,8,1,36,28
1656029758349,MATH 103A,B02,083780,Greenfeld; Be'Eri,0,0,36,36
1656029758349,MATH 103A,B03,093562,Staff,0,0,36,36
1656029764373,MATH 105,A01,085443,Carter; Anne Toulson,4,1,35,31
1656029764373,MATH 105,A02,093477,Staff,9,0,35,26
1656029770403,MATH 109,A01,083213,Ganzberger; Geoffrey Michael,0,1,34,34
1656029770403,MATH 109,A02,083214,Ganzberger; Geoffrey Michael,0,0,34,34
1656029770403,MATH 109,A03,093478,Staff,1,0,34,33
1656029770403,MATH 109,B01,083215,Ganzberger; Geoffrey Michael,2,0,32,30
1656029770403,MATH 109,B02,083216,Ganzberger; Geoffrey Michael,0,0,32,32
1656029770403,MATH 109,B03,093479,Staff,3,0,32,29
1656029776430,MATH 142A,A01,083219,Chow; Bennett,1,0,32,31
1656029776430,MATH 142A,A02,083220,Chow; Bennett,7,0,32,25
1656029776430,MATH 142A,A03,093480,Staff,4,0,32,28
1656029776430,MATH 142A,B03,093481,Staff,3,0,32,29
1656029776430,MATH 142A,B04,093558,Staff,6,0,32,26
1656029776430,MATH 142A,B05,093559,Staff,0,0,32,32
1656029782455,MATH 193A,A01,083224,Rotar; Vladimir,1,2,34,33
1656029782455,MATH 193A,A02,083225,Rotar; Vladimir,0,0,34,34
1656029782455,MATH 193A,A03,083781,Rotar; Vladimir,1,0,34,33
1656029782455,MATH 193A,A04,083782,Rotar; Vladimir,3,0,34,31
1656029782455,MATH 193A,A05,093482,Rotar; Vladimir,0,0,34,34
1656029788488,MATH 197,001,091859,McAuley; Julian John,9999,0,9999,0
1656029788488,MATH 197,002,095566,Kedlaya; Kiran S.,9997,0,9999,2
1656029788488,MATH 197,003,095567,Xiao; Ming,9999,0,9999,0
1656029788488,MATH 197,004,095571,Perols; Johan Lars,9998,0,9999,1
1656029795551,COGS 9,A01,083615,Shannon; Kyle Michael,3,1,75,72
1656029801577,COGS 11,A01,083617,Boyle; Mary E. T.,11,1,48,37
1656029807601,COGS 13,A01,083071,Bastos; Amalia Pinkusfeld,4,3,71,67
1656029813624,COGS 14A,A01,092681,Semenuks; Arturs,4,25,100,96
1656029819648,COGS 14B,A01,083073,Cheng; Tzu-Han,7,0,63,56
1656029825673,COGS 17,A01,092677,Semenuks; Arturs,8,7,81,73
1656029831703,COGS 100,A01,083619,Allen; Michael Gordon,2,2,70,68
1656029837731,COGS 101A,A01,083621,Davis; Joshua Daniel,4,3,68,64
1656029843757,COGS 101B,A01,091572,Allen; Michael Gordon,0,0,65,65
1656029849782,COGS 101C,A01,083625,Delgado; Tania,7,0,35,28
1656029855804,COGS 107A,A01,083627,Boyle; Mary E. T.,1,2,60,59
1656029861839,COGS 118A,A01,083075,Gupta; Anjum,21,16,76,55
1656029867869,CSE 3,A50,083646,Miranda; Gregory Joseph,14,0,50,36
1656029873896,CSE 8A,A50,083650,Miranda; Gregory Joseph,4,11,56,52
1656029879923,CSE 11,A01,083080,Cao; Yingjun,0,65,40,40
1656029885947,CSE 12,A01,083652,Krause-Levy; Sophia Louisa,7,8,120,113
1656029891976,CSE 15L,A01,083654,Morris; Justin Loren,3,1,50,47
1656029891976,CSE 15L,A02,083655,Morris; Justin Loren,2,1,50,48
1656029898003,CSE 20,A01,083657,Tran; Khoa Dang,29,0,80,51
1656029904031,CSE 21,A01,095574,Bach; Quang Tran,23,0,48,25
1656029910055,CSE 30,A01,083084,Eldon; John,2,10,80,78
1656029910055,CSE 30,B01,095061,Bhaskar; Nishant,2,5,50,48
1656029916080,CSE 100,A01,083659,Cao; Yingjun,2,25,70,68
1656029922102,CSE 134B,A01,083661,Powell; Thomas Allan,6,6,100,94
1656029928126,CSE 140,A01,083663,Gungor; Onat,5,0,85,80
1656029934159,CSE 140L,A01,083088,Eldon; John,5,0,100,95
1656029940188,CSE 175,A01,083665,Kumar; Rakesh,0,0,25,25
1656029946214,CSE 190,A00,092507,Dubnov; Shlomo,1,0,20,19
1656029952254,ECE 45,A01,083139,Congero; Spencer William,1,1,75,74
1656029958283,ECE 65,A50,083695,Saad; Andrew S,6,0,30,24
1656029958283,ECE 65,A51,095125,Staff,23,0,26,3
1656029964307,ECE 109,A01,091882,Touri; Behrouz,3,5,70,67
1656029970331,ECE 180,A00,083140,Abi Samra; Nicholas Camill,1,0,30,29
1656029970331,ECE 180,B00,083141,Abi Samra; Nicholas Camill,0,8,28,28
1656029976359,MATH 10A,A01,083735,Patchell; Gregory David,0,0,30,30
1656029976359,MATH 10A,A02,083736,Patchell; Gregory David,20,0,30,10
1656029976359,MATH 10A,A03,083737,Patchell; Gregory David,16,0,30,14
1656029982384,MATH 10B,A01,083207,Lim; Seonhee,1,1,34,33
1656029982384,MATH 10B,A02,083208,Lim; Seonhee,1,1,35,34
1656029982384,MATH 10B,A03,093472,Staff,0,0,34,34
1656029982384,MATH 10B,B01,083739,Sinha; Shubham,10,0,30,20
1656029988416,MATH 18,A01,083743,Cinel; Cameron Alexander,5,0,30,25
1656029988416,MATH 18,A02,083744,Cinel; Cameron Alexander,11,0,30,19
1656029988416,MATH 18,A03,083745,Cinel; Cameron Alexander,1,0,30,29
1656029988416,MATH 18,B01,083748,Ma; Zilu,0,0,36,36
1656029988416,MATH 18,B02,083749,Ma; Zilu,0,0,36,36
1656029988416,MATH 18,B03,083750,Ma; Zilu,0,0,36,36
1656029988416,MATH 18,B04,083751,Ma; Zilu,0,0,36,36
1656029988416,MATH 18,B05,093473,Staff,0,0,36,36
1656029988416,MATH 18,B06,093474,Staff,3,0,36,33
1656029994440,MATH 20A,A01,083754,Zheng; Zequn,11,0,40,29
1656030000465,MATH 20B,A01,083756,Briones; Jor-el Thomas Caparas,0,1,36,36
1656030000465,MATH 20B,A02,083757,Briones; Jor-el Thomas Caparas,1,0,36,35
1656030000465,MATH 20B,A03,093475,Staff,0,0,36,36
1656030006489,MATH 20C,A01,083760,Briones; Jor-el Thomas Caparas,0,2,35,35
1656030006489,MATH 20C,A02,083761,Briones; Jor-el Thomas Caparas,6,1,35,29
1656030006489,MATH 20C,A03,093476,Staff,0,0,35,35
1656030006489,MATH 20C,B01,083762,Bach; Quang Tran,3,0,30,27
1656030012513,MATH 20D,A01,083765,Tran; Brian Kha,2,0,30,28
1656030012513,MATH 20D,A02,083766,Tran; Brian Kha,0,1,30,30
1656030012513,MATH 20D,A03,083767,Tran; Brian Kha,0,0,30,30
1656030018535,MATH 20E,A01,083771,Ganguly; Soumya,0,1,32,32
1656030018535,MATH 20E,A02,083772,Ganguly; Soumya,1,1,32,31
1656030018535,MATH 20E,B01,083773,Ciotti; Benjamin,13,0,35,22
1656030018535,MATH 20E,B02,083774,Ciotti; Benjamin,12,0,35,23
1656030024560,MATH 103A,A01,083777,Greenfeld; Be'Eri,2,1,36,34
1656030024560,MATH 103A,A02,083778,Greenfeld; Be'Eri,1,0,36,35
1656030024560,MATH 103A,A03,093561,Staff,0,1,36,36
1656030024560,MATH 103A,B01,083779,Greenfeld; Be'Eri,8,1,36,28
1656030024560,MATH 103A,B02,083780,Greenfeld; Be'Eri,0,0,36,36
1656030024560,MATH 103A,B03,093562,Staff,0,0,36,36
1656030030586,MATH 105,A01,085443,Carter; Anne Toulson,4,1,35,31
1656030030586,MATH 105,A02,093477,Staff,9,0,35,26
1656030036614,MATH 109,A01,083213,Ganzberger; Geoffrey Michael,0,1,34,34
1656030036614,MATH 109,A02,083214,Ganzberger; Geoffrey Michael,0,0,34,34
1656030036614,MATH 109,A03,093478,Staff,1,0,34,33
1656030036614,MATH 109,B01,083215,Ganzberger; Geoffrey Michael,2,0,32,30
1656030036614,MATH 109,B02,083216,Ganzberger; Geoffrey Michael,0,0,32,32
1656030036614,MATH 109,B03,093479,Staff,3,0,32,29
1656030042640,MATH 142A,A01,083219,Chow; Bennett,1,0,32,31
1656030042640,MATH 142A,A02,083220,Chow; Bennett,7,0,32,25
1656030042640,MATH 142A,A03,093480,Staff,4,0,32,28
1656030042640,MATH 142A,B03,093481,Staff,3,0,32,29
1656030042640,MATH 142A,B04,093558,Staff,6,0,32,26
1656030042640,MATH 142A,B05,093559,Staff,0,0,32,32
1656030048664,MATH 193A,A01,083224,Rotar; Vladimir,1,2,34,33
1656030048664,MATH 193A,A02,083225,Rotar; Vladimir,0,0,34,34
1656030048664,MATH 193A,A03,083781,Rotar; Vladimir,1,0,34,33
1656030048664,MATH 193A,A04,083782,Rotar; Vladimir,3,0,34,31
1656030048664,MATH 193A,A05,093482,Rotar; Vladimir,0,0,34,34
1656030054688,MATH 197,001,091859,McAuley; Julian John,9999,0,9999,0
1656030054688,MATH 197,002,095566,Kedlaya; Kiran S.,9997,0,9999,2
1656030054688,MATH 197,003,095567,Xiao; Ming,9999,0,9999,0
1656030054688,MATH 197,004,095571,Perols; Johan Lars,9998,0,9999,1
1656030061749,COGS 9,A01,083615,Shannon; Kyle Michael,3,1,75,72
1656030067776,COGS 11,A01,083617,Boyle; Mary E. T.,11,1,48,37
1656030073799,COGS 13,A01,083071,Bastos; Amalia Pinkusfeld,4,3,71,67
1656030079823,COGS 14A,A01,092681,Semenuks; Arturs,4,25,100,96
1656030085864,COGS 14B,A01,083073,Cheng; Tzu-Han,7,0,63,56
1656030091892,COGS 17,A01,092677,Semenuks; Arturs,8,7,81,73
1656030097918,COGS 100,A01,083619,Allen; Michael Gordon,2,2,70,68
1656030103946,COGS 101A,A01,083621,Davis; Joshua Daniel,4,3,68,64
1656030109973,COGS 101B,A01,091572,Allen; Michael Gordon,0,0,65,65
1656030115997,COGS 101C,A01,083625,Delgado; Tania,7,0,35,28
1656030122024,COGS 107A,A01,083627,Boyle; Mary E. T.,1,2,60,59
1656030128048,COGS 118A,A01,083075,Gupta; Anjum,21,16,76,55
1656030134075,CSE 3,A50,083646,Miranda; Gregory Joseph,14,0,50,36
1656030140102,CSE 8A,A50,083650,Miranda; Gregory Joseph,4,11,56,52
1656030146125,CSE 11,A01,083080,Cao; Yingjun,0,65,40,40
1656030152153,CSE 12,A01,083652,Krause-Levy; Sophia Louisa,7,8,120,113
1656030158180,CSE 15L,A01,083654,Morris; Justin Loren,3,1,50,47
1656030158180,CSE 15L,A02,083655,Morris; Justin Loren,2,1,50,48
1656030164217,CSE 20,A01,083657,Tran; Khoa Dang,29,0,80,51
1656030170244,CSE 21,A01,095574,Bach; Quang Tran,23,0,48,25
1656030176268,CSE 30,A01,083084,Eldon; John,2,10,80,78
1656030176268,CSE 30,B01,095061,Bhaskar; Nishant,2,5,50,48
1656030182299,CSE 100,A01,083659,Cao; Yingjun,2,25,70,68
1656030188322,CSE 134B,A01,083661,Powell; Thomas Allan,6,6,100,94
1656030194345,CSE 140,A01,083663,Gungor; Onat,5,0,85,80
1656030200367,CSE 140L,A01,083088,Eldon; John,5,0,100,95
1656030206391,CSE 175,A01,083665,Kumar; Rakesh,0,0,25,25
1656030212417,CSE 190,A00,092507,Dubnov; Shlomo,1,0,20,19
1656030218440,ECE 45,A01,083139,Congero; Spencer William,1,1,75,74
1656030224471,ECE 65,A50,083695,Saad; Andrew S,6,0,30,24
1656030224471,ECE 65,A51,095125,Staff,23,0,26,3
1656030230497,ECE 109,A01,091882,Touri; Behrouz,3,5,70,67
1656030236521,ECE 180,A00,083140,Abi Samra; Nicholas Camill,1,0,30,29
1656030236521,ECE 180,B00,083141,Abi Samra; Nicholas Camill,0,8,28,28
1656030247627,MATH 10A,A01,083735,Patchell; Gregory David,0,0,30,30
1656030247627,MATH 10A,A02,083736,Patchell; Gregory David,20,0,30,10
1656030247627,MATH 10A,A03,083737,Patchell; Gregory David,16,0,30,14
1656030253650,MATH 10B,A01,083207,Lim; Seonhee,1,1,34,33
1656030253650,MATH 10B,A02,083208,Lim; Seonhee,1,1,35,34
1656030253650,MATH 10B,A03,093472,Staff,0,0,34,34
1656030253650,MATH 10B,B01,083739,Sinha; Shubham,10,0,30,20
1656030259682,MATH 18,A01,083743,Cinel; Cameron Alexander,5,0,30,25
1656030259682,MATH 18,A02,083744,Cinel; Cameron Alexander,11,0,30,19
1656030259682,MATH 18,A03,083745,Cinel; Cameron Alexander,1,0,30,29
1656030259682,MATH 18,B01,083748,Ma; Zilu,0,0,36,36
1656030259682,MATH 18,B02,083749,Ma; Zilu,0,0,36,36
1656030259682,MATH 18,B03,083750,Ma; Zilu,0,0,36,36
1656030259682,MATH 18,B04,083751,Ma; Zilu,0,0,36,36
1656030259682,MATH 18,B05,093473,Staff,0,0,36,36
1656030259682,MATH 18,B06,093474,Staff,3,0,36,33
1656030265706,MATH 20A,A01,083754,Zheng; Zequn,11,0,40,29
1656030271733,MATH 20B,A01,083756,Briones; Jor-el Thomas Caparas,0,0,36,36
1656030271733,MATH 20B,A02,083757,Briones; Jor-el Thomas Caparas,1,0,36,35
1656030271733,MATH 20B,A03,093475,Staff,0,0,36,36
1656030277757,MATH 20C,A01,083760,Briones; Jor-el Thomas Caparas,0,2,35,35
1656030277757,MATH 20C,A02,083761,Briones; Jor-el Thomas Caparas,6,1,35,29
1656030277757,MATH 20C,A03,093476,Staff,0,0,35,35
1656030277757,MATH 20C,B01,083762,Bach; Quang Tran,3,0,30,27
1656030283784,MATH 20D,A01,083765,Tran; Brian Kha,2,0,30,28
1656030283784,MATH 20D,A02,083766,Tran; Brian Kha,0,1,30,30
1656030283784,MATH 20D,A03,083767,Tran; Brian Kha,0,0,30,30
1656030289809,MATH 20E,A01,083771,Ganguly; Soumya,0,1,32,32
1656030289809,MATH 20E,A02,083772,Ganguly; Soumya,1,1,32,31
1656030289809,MATH 20E,B01,083773,Ciotti; Benjamin,13,0,35,22
1656030289809,MATH 20E,B02,083774,Ciotti; Benjamin,12,0,35,23
1656030295831,MATH 103A,A01,083777,Greenfeld; Be'Eri,2,1,36,34
1656030295831,MATH 103A,A02,083778,Greenfeld; Be'Eri,1,0,36,35
1656030295831,MATH 103A,A03,093561,Staff,0,1,36,36
1656030295831,MATH 103A,B01,083779,Greenfeld; Be'Eri,8,1,36,28
1656030295831,MATH 103A,B02,083780,Greenfeld; Be'Eri,0,0,36,36
1656030295831,MATH 103A,B03,093562,Staff,0,0,36,36
1656030301861,MATH 105,A01,085443,Carter; Anne Toulson,4,1,35,31
1656030301861,MATH 105,A02,093477,Staff,9,0,35,26
1656030307885,MATH 109,A01,083213,Ganzberger; Geoffrey Michael,0,1,34,34
1656030307885,MATH 109,A02,083214,Ganzberger; Geoffrey Michael,0,0,34,34
1656030307885,MATH 109,A03,093478,Staff,1,0,34,33
1656030307885,MATH 109,B01,083215,Ganzberger; Geoffrey Michael,2,0,32,30
1656030307885,MATH 109,B02,083216,Ganzberger; Geoffrey Michael,0,0,32,32
1656030307885,MATH 109,B03,093479,Staff,3,0,32,29
1656030313920,MATH 142A,A01,083219,Chow; Bennett,1,0,32,31
1656030313920,MATH 142A,A02,083220,Chow; Bennett,7,0,32,25
1656030313920,MATH 142A,A03,093480,Staff,4,0,32,28
1656030313920,MATH 142A,B03,093481,Staff,3,0,32,29
1656030313920,MATH 142A,B04,093558,Staff,6,0,32,26
1656030313920,MATH 142A,B05,093559,Staff,0,0,32,32
1656030319943,MATH 193A,A01,083224,Rotar; Vladimir,1,2,34,33
1656030319943,MATH 193A,A02,083225,Rotar; Vladimir,0,0,34,34
1656030319943,MATH 193A,A03,083781,Rotar; Vladimir,1,0,34,33
1656030319943,MATH 193A,A04,083782,Rotar; Vladimir,3,0,34,31
1656030319943,MATH 193A,A05,093482,Rotar; Vladimir,0,0,34,34
1656030325965,MATH 197,001,091859,McAuley; Julian John,9999,0,9999,0
1656030325965,MATH 197,002,095566,Kedlaya; Kiran S.,9997,0,9999,2
1656030325965,MATH 197,003,095567,Xiao; Ming,9999,0,9999,0
1656030325965,MATH 197,004,095571,Perols; Johan Lars,9998,0,9999,1
1656030333106,COGS 9,A01,083615,Shannon; Kyle Michael,3,1,75,72
1656030339130,COGS 11,A01,083617,Boyle; Mary E. T.,11,1,48,37
1656030345153,COGS 13,A01,083071,Bastos; Amalia Pinkusfeld,4,3,71,67
1656030351177,COGS 14A,A01,092681,Semenuks; Arturs,4,25,100,96
1656030357203,COGS 14B,A01,083073,Cheng; Tzu-Han,7,0,63,56
1656030363226,COGS 17,A01,092677,Semenuks; Arturs,8,7,81,73
1656030369253,COGS 100,A01,083619,Allen; Michael Gordon,2,2,70,68
1656030375280,COGS 101A,A01,083621,Davis; Joshua Daniel,4,3,68,64
1656030381306,COGS 101B,A01,091572,Allen; Michael Gordon,0,0,65,65
1656030387331,COGS 101C,A01,083625,Delgado; Tania,7,0,35,28
1656030393357,COGS 107A,A01,083627,Boyle; Mary E. T.,1,2,60,59
1656030399385,COGS 118A,A01,083075,Gupta; Anjum,21,16,76,55
1656030405417,CSE 3,A50,083646,Miranda; Gregory Joseph,14,0,50,36
1656030411442,CSE 8A,A50,083650,Miranda; Gregory Joseph,4,11,56,52
1656030417465,CSE 11,A01,083080,Cao; Yingjun,0,65,40,40
1656030423492,CSE 12,A01,083652,Krause-Levy; Sophia Louisa,7,8,120,113
1656030429515,CSE 15L,A01,083654,Morris; Justin Loren,3,1,50,47
1656030429515,CSE 15L,A02,083655,Morris; Justin Loren,2,1,50,48
1656030435549,CSE 20,A01,083657,Tran; Khoa Dang,29,0,80,51
1656030441585,CSE 21,A01,095574,Bach; Quang Tran,23,0,48,25
1656030447609,CSE 30,A01,083084,Eldon; John,2,10,80,78
1656030447609,CSE 30,B01,095061,Bhaskar; Nishant,2,5,50,48
1656030453637,CSE 100,A01,083659,Cao; Yingjun,2,25,70,68
1656030459675,CSE 134B,A01,083661,Powell; Thomas Allan,6,6,100,94
1656030465701,CSE 140,A01,083663,Gungor; Onat,5,0,85,80
1656030471726,CSE 140L,A01,083088,Eldon; John,5,0,100,95
1656030477752,CSE 175,A01,083665,Kumar; Rakesh,0,0,25,25
1656030483775,CSE 190,A00,092507,Dubnov; Shlomo,1,0,20,19
1656030489806,ECE 45,A01,083139,Congero; Spencer William,1,1,75,74
1656030495833,ECE 65,A50,083695,Saad; Andrew S,6,0,30,24
1656030495833,ECE 65,A51,095125,Staff,23,0,26,3
1656030501857,ECE 109,A01,091882,Touri; Behrouz,3,5,70,67
1656030507884,ECE 180,A00,083140,Abi Samra; Nicholas Camill,1,0,30,29
1656030507884,ECE 180,B00,083141,Abi Samra; Nicholas Camill,0,8,28,28
1656030513911,MATH 10A,A01,083735,Patchell; Gregory David,0,0,30,30
1656030513911,MATH 10A,A02,083736,Patchell; Gregory David,20,0,30,10
1656030513911,MATH 10A,A03,083737,Patchell; Gregory David,16,0,30,14
1656030519939,MATH 10B,A01,083207,Lim; Seonhee,1,1,34,33
1656030519939,MATH 10B,A02,083208,Lim; Seonhee,1,1,35,34
1656030519939,MATH 10B,A03,093472,Staff,0,0,34,34
1656030519939,MATH 10B,B01,083739,Sinha; Shubham,10,0,30,20
1656030525998,MATH 18,A01,083743,Cinel; Cameron Alexander,5,0,30,25
1656030525998,MATH 18,A02,083744,Cinel; Cameron Alexander,11,0,30,19
1656030525998,MATH 18,A03,083745,Cinel; Cameron Alexander,1,0,30,29
1656030525998,MATH 18,B01,083748,Ma; Zilu,0,0,36,36
1656030525998,MATH 18,B02,083749,Ma; Zilu,0,0,36,36
1656030525998,MATH 18,B03,083750,Ma; Zilu,0,0,36,36
1656030525998,MATH 18,B04,083751,Ma; Zilu,0,0,36,36
1656030525998,MATH 18,B05,093473,Staff,0,0,36,36
1656030525998,MATH 18,B06,093474,Staff,3,0,36,33
1656030532023,MATH 20A,A01,083754,Zheng; Zequn,11,0,40,29
1656030538053,MATH 20B,A01,083756,Briones; Jor-el Thomas Caparas,0,0,36,36
1656030538053,MATH 20B,A02,083757,Briones; Jor-el Thomas Caparas,1,0,36,35
1656030538053,MATH 20B,A03,093475,Staff,0,0,36,36
1656030544081,MATH 20C,A01,083760,Briones; Jor-el Thomas Caparas,0,2,35,35
1656030544081,MATH 20C,A02,083761,Briones; Jor-el Thomas Caparas,6,1,35,29
1656030544081,MATH 20C,A03,093476,Staff,0,1,35,35
1656030544081,MATH 20C,B01,083762,Bach; Quang Tran,3,0,30,27
1656030550112,MATH 20D,A01,083765,Tran; Brian Kha,2,0,30,28
1656030550112,MATH 20D,A02,083766,Tran; Brian Kha,0,1,30,30
1656030550112,MATH 20D,A03,083767,Tran; Brian Kha,0,0,30,30
1656030556138,MATH 20E,A01,083771,Ganguly; Soumya,0,1,32,32
1656030556138,MATH 20E,A02,083772,Ganguly; Soumya,1,1,32,31
1656030556138,MATH 20E,B01,083773,Ciotti; Benjamin,13,0,35,22
1656030556138,MATH 20E,B02,083774,Ciotti; Benjamin,12,0,35,23
1656030562167,MATH 103A,A01,083777,Greenfeld; Be'Eri,2,1,36,34
1656030562167,MATH 103A,A02,083778,Greenfeld; Be'Eri,1,0,36,35
1656030562167,MATH 103A,A03,093561,Staff,0,1,36,36
1656030562167,MATH 103A,B01,083779,Greenfeld; Be'Eri,8,1,36,28
1656030562167,MATH 103A,B02,083780,Greenfeld; Be'Eri,0,0,36,36
1656030562167,MATH 103A,B03,093562,Staff,0,0,36,36
1656030568198,MATH 105,A01,085443,Carter; Anne Toulson,4,1,35,31
1656030568198,MATH 105,A02,093477,Staff,9,0,35,26
1656030574221,MATH 109,A01,083213,Ganzberger; Geoffrey Michael,0,1,34,34
1656030574221,MATH 109,A02,083214,Ganzberger; Geoffrey Michael,0,0,34,34
1656030574221,MATH 109,A03,093478,Staff,1,0,34,33
1656030574221,MATH 109,B01,083215,Ganzberger; Geoffrey Michael,2,0,32,30
1656030574221,MATH 109,B02,083216,Ganzberger; Geoffrey Michael,0,0,32,32
1656030574221,MATH 109,B03,093479,Staff,3,0,32,29
1656030580250,MATH 142A,A01,083219,Chow; Bennett,1,0,32,31
1656030580250,MATH 142A,A02,083220,Chow; Bennett,7,0,32,25
1656030580250,MATH 142A,A03,093480,Staff,4,0,32,28
1656030580250,MATH 142A,B03,093481,Staff,3,0,32,29
1656030580250,MATH 142A,B04,093558,Staff,6,0,32,26
1656030580250,MATH 142A,B05,093559,Staff,0,0,32,32
1656030586273,MATH 193A,A01,083224,Rotar; Vladimir,1,2,34,33
1656030586273,MATH 193A,A02,083225,Rotar; Vladimir,0,0,34,34
1656030586273,MATH 193A,A03,083781,Rotar; Vladimir,1,0,34,33
1656030586273,MATH 193A,A04,083782,Rotar; Vladimir,3,0,34,31
1656030586273,MATH 193A,A05,093482,Rotar; Vladimir,0,0,34,34
1656030592295,MATH 197,001,091859,McAuley; Julian John,9999,0,9999,0
1656030592295,MATH 197,002,095566,Kedlaya; Kiran S.,9997,0,9999,2
1656030592295,MATH 197,003,095567,Xiao; Ming,9999,0,9999,0
1656030592295,MATH 197,004,095571,Perols; Johan Lars,9998,0,9999,1
1656030599358,COGS 9,A01,083615,Shannon; Kyle Michael,3,1,75,72
1656030605381,COGS 11,A01,083617,Boyle; Mary E. T.,11,1,48,37
1656030611404,COGS 13,A01,083071,Bastos; Amalia Pinkusfeld,4,3,71,67
1656030617428,COGS 14A,A01,092681,Semenuks; Arturs,4,25,100,96
1656030623452,COGS 14B,A01,083073,Cheng; Tzu-Han,7,0,63,56
1656030629481,COGS 17,A01,092677,Semenuks; Arturs,8,7,81,73
1656030635508,COGS 100,A01,083619,Allen; Michael Gordon,2,2,70,68
1656030641534,COGS 101A,A01,083621,Davis; Joshua Daniel,4,3,68,64
1656030647556,COGS 101B,A01,091572,Allen; Michael Gordon,0,0,65,65
1656030653583,COGS 101C,A01,083625,Delgado; Tania,7,0,35,28
1656030659607,COGS 107A,A01,083627,Boyle; Mary E. T.,1,2,60,59
1656030665630,COGS 118A,A01,083075,Gupta; Anjum,21,16,76,55
1656030671658,CSE 3,A50,083646,Miranda; Gregory Joseph,14,0,50,36
1656030677682,CSE 8A,A50,083650,Miranda; Gregory Joseph,4,11,56,52
1656030683708,CSE 11,A01,083080,Cao; Yingjun,0,65,40,40
1656030689736,CSE 12,A01,083652,Krause-Levy; Sophia Louisa,7,8,120,113
1656030695764,CSE 15L,A01,083654,Morris; Justin Loren,3,1,50,47
1656030695764,CSE 15L,A02,083655,Morris; Justin Loren,2,1,50,48
1656030701792,CSE 20,A01,083657,Tran; Khoa Dang,29,0,80,51
1656030707814,CSE 21,A01,095574,Bach; Quang Tran,23,0,48,25
1656030713843,CSE 30,A01,083084,Eldon; John,2,10,80,78
1656030713843,CSE 30,B01,095061,Bhaskar; Nishant,2,5,50,48
1656030719866,CSE 100,A01,083659,Cao; Yingjun,2,25,70,68
1656030725893,CSE 134B,A01,083661,Powell; Thomas Allan,6,6,100,94
1656030731916,CSE 140,A01,083663,Gungor; Onat,5,0,85,80
1656030737938,CSE 140L,A01,083088,Eldon; John,5,0,100,95
1656030743961,CSE 175,A01,083665,Kumar; Rakesh,0,0,25,25
1656030749992,CSE 190,A00,092507,Dubnov; Shlomo,1,0,20,19
1656030756019,ECE 45,A01,083139,Congero; Spencer William,1,1,75,74
1656030762045,ECE 65,A50,083695,Saad; Andrew S,6,0,30,24
1656030762045,ECE 65,A51,095125,Staff,23,0,26,3
1656030768070,ECE 109,A01,091882,Touri; Behrouz,3,5,70,67
1656030774094,ECE 180,A00,083140,Abi Samra; Nicholas Camill,1,0,30,29
1656030774094,ECE 180,B00,083141,Abi Samra; Nicholas Camill,0,8,28,28
1656030780130,MATH 10A,A01,083735,Patchell; Gregory David,0,0,30,30
1656030780130,MATH 10A,A02,083736,Patchell; Gregory David,20,0,30,10
1656030780130,MATH 10A,A03,083737,Patchell; Gregory David,16,0,30,14
1656030786154,MATH 10B,A01,083207,Lim; Seonhee,1,1,34,33
1656030786154,MATH 10B,A02,083208,Lim; Seonhee,1,1,35,34
1656030786154,MATH 10B,A03,093472,Staff,0,0,34,34
1656030786154,MATH 10B,B01,083739,Sinha; Shubham,10,0,30,20
1656030792177,MATH 18,A01,083743,Cinel; Cameron Alexander,5,0,30,25
1656030792177,MATH 18,A02,083744,Cinel; Cameron Alexander,11,0,30,19
1656030792177,MATH 18,A03,083745,Cinel; Cameron Alexander,1,0,30,29
1656030792177,MATH 18,B01,083748,Ma; Zilu,0,0,36,36
1656030792177,MATH 18,B02,083749,Ma; Zilu,0,0,36,36
1656030792177,MATH 18,B03,083750,Ma; Zilu,0,0,36,36
1656030792177,MATH 18,B04,083751,Ma; Zilu,0,0,36,36
1656030792177,MATH 18,B05,093473,Staff,0,0,36,36
1656030792177,MATH 18,B06,093474,Staff,3,0,36,33
1656030798200,MATH 20A,A01,083754,Zheng; Zequn,11,0,40,29
1656030804222,MATH 20B,A01,083756,Briones; Jor-el Thomas Caparas,0,0,36,36
1656030804222,MATH 20B,A02,083757,Briones; Jor-el Thomas Caparas,1,0,36,35
1656030804222,MATH 20B,A03,093475,Staff,0,0,36,36
1656030810250,MATH 20C,A01,083760,Briones; Jor-el Thomas Caparas,0,2,35,35
1656030810250,MATH 20C,A02,083761,Briones; Jor-el Thomas Caparas,6,1,35,29
1656030810250,MATH 20C,A03,093476,Staff,0,1,35,35
1656030810250,MATH 20C,B01,083762,Bach; Quang Tran,3,0,30,27
1656030816274,MATH 20D,A01,083765,Tran; Brian Kha,2,0,30,28
1656030816274,MATH 20D,A02,083766,Tran; Brian Kha,0,1,30,30
1656030816274,MATH 20D,A03,083767,Tran; Brian Kha,0,0,30,30
1656030822297,MATH 20E,A01,083771,Ganguly; Soumya,0,1,32,32
1656030822297,MATH 20E,A02,083772,Ganguly; Soumya,1,1,32,31
1656030822297,MATH 20E,B01,083773,Ciotti; Benjamin,13,0,35,22
1656030822297,MATH 20E,B02,083774,Ciotti; Benjamin,12,0,35,23
1656030828327,MATH 103A,A01,083777,Greenfeld; Be'Eri,2,1,36,34
1656030828327,MATH 103A,A02,083778,Greenfeld; Be'Eri,1,0,36,35
1656030828327,MATH 103A,A03,093561,Staff,0,1,36,36
1656030828327,MATH 103A,B01,083779,Greenfeld; Be'Eri,8,1,36,28
1656030828327,MATH 103A,B02,083780,Greenfeld; Be'Eri,0,0,36,36
1656030828327,MATH 103A,B03,093562,Staff,0,0,36,36
1656030834350,MATH 105,A01,085443,Carter; Anne Toulson,4,1,35,31
1656030834350,MATH 105,A02,093477,Staff,9,0,35,26
1656030840374,MATH 109,A01,083213,Ganzberger; Geoffrey Michael,0,1,34,34
1656030840374,MATH 109,A02,083214,Ganzberger; Geoffrey Michael,0,0,34,34
1656030840374,MATH 109,A03,093478,Staff,1,0,34,33
1656030840374,MATH 109,B01,083215,Ganzberger; Geoffrey Michael,2,0,32,30
1656030840374,MATH 109,B02,083216,Ganzberger; Geoffrey Michael,0,0,32,32
1656030840374,MATH 109,B03,093479,Staff,3,0,32,29
1656030846398,MATH 142A,A01,083219,Chow; Bennett,1,0,32,31
1656030846398,MATH 142A,A02,083220,Chow; Bennett,7,0,32,25
1656030846398,MATH 142A,A03,093480,Staff,4,0,32,28
1656030846398,MATH 142A,B03,093481,Staff,3,0,32,29
1656030846398,MATH 142A,B04,093558,Staff,6,0,32,26
1656030846398,MATH 142A,B05,093559,Staff,0,0,32,32
1656030852422,MATH 193A,A01,083224,Rotar; Vladimir,1,2,34,33
1656030852422,MATH 193A,A02,083225,Rotar; Vladimir,0,0,34,34
1656030852422,MATH 193A,A03,083781,Rotar; Vladimir,1,0,34,33
1656030852422,MATH 193A,A04,083782,Rotar; Vladimir,3,0,34,31
1656030852422,MATH 193A,A05,093482,Rotar; Vladimir,0,0,34,34
1656030858446,MATH 197,001,091859,McAuley; Julian John,9999,0,9999,0
1656030858446,MATH 197,002,095566,Kedlaya; Kiran S.,9997,0,9999,2
1656030858446,MATH 197,003,095567,Xiao; Ming,9999,0,9999,0
1656030858446,MATH 197,004,095571,Perols; Johan Lars,9998,0,9999,1
1656030865509,COGS 9,A01,083615,Shannon; Kyle Michael,3,1,75,72
1656030871531,COGS 11,A01,083617,Boyle; Mary E. T.,11,1,48,37
1656030877557,COGS 13,A01,083071,Bastos; Amalia Pinkusfeld,4,3,71,67
1656030883583,COGS 14A,A01,092681,Semenuks; Arturs,4,25,100,96
1656030889608,COGS 14B,A01,083073,Cheng; Tzu-Han,7,0,63,56
1656030895637,COGS 17,A01,092677,Semenuks; Arturs,8,7,81,73
1656030901663,COGS 100,A01,083619,Allen; Michael Gordon,2,2,70,68
1656030907685,COGS 101A,A01,083621,Davis; Joshua Daniel,4,3,68,64
1656030913708,COGS 101B,A01,091572,Allen; Michael Gordon,0,0,65,65
1656030919737,COGS 101C,A01,083625,Delgado; Tania,7,0,35,28
1656030925836,COGS 107A,A01,083627,Boyle; Mary E. T.,1,2,60,59
1656030931870,COGS 118A,A01,083075,Gupta; Anjum,21,16,76,55
1656030937903,CSE 3,A50,083646,Miranda; Gregory Joseph,14,0,50,36
1656030943936,CSE 8A,A50,083650,Miranda; Gregory Joseph,4,11,56,52
1656030949962,CSE 11,A01,083080,Cao; Yingjun,0,65,40,40
1656030955988,CSE 12,A01,083652,Krause-Levy; Sophia Louisa,7,8,120,113
1656030962013,CSE 15L,A01,083654,Morris; Justin Loren,3,1,50,47
1656030962013,CSE 15L,A02,083655,Morris; Justin Loren,2,1,50,48
1656030968038,CSE 20,A01,083657,Tran; Khoa Dang,29,0,80,51
1656030974071,CSE 21,A01,095574,Bach; Quang Tran,23,0,48,25
1656030980094,CSE 30,A01,083084,Eldon; John,2,10,80,78
1656030980094,CSE 30,B01,095061,Bhaskar; Nishant,2,5,50,48
1656030986120,CSE 100,A01,083659,Cao; Yingjun,2,25,70,68
1656030992147,CSE 134B,A01,083661,Powell; Thomas Allan,6,6,100,94
1656030998174,CSE 140,A01,083663,Gungor; Onat,5,0,85,80
1656031004202,CSE 140L,A01,083088,Eldon; John,5,0,100,95
1656031010229,CSE 175,A01,083665,Kumar; Rakesh,0,0,25,25
1656031016252,CSE 190,A00,092507,Dubnov; Shlomo,1,0,20,19
1656031022275,ECE 45,A01,083139,Congero; Spencer William,1,1,75,74
1656031028299,ECE 65,A50,083695,Saad; Andrew S,6,0,30,24
1656031028299,ECE 65,A51,095125,Staff,23,0,26,3
1656031034325,ECE 109,A01,091882,Touri; Behrouz,3,5,70,67
1656031040348,ECE 180,A00,083140,Abi Samra; Nicholas Camill,1,0,30,29
1656031040348,ECE 180,B00,083141,Abi Samra; Nicholas Camill,0,8,28,28
1656031046376,MATH 10A,A01,083735,Patchell; Gregory David,0,0,30,30
1656031046376,MATH 10A,A02,083736,Patchell; Gregory David,20,0,30,10
1656031046376,MATH 10A,A03,083737,Patchell; Gregory David,16,0,30,14
1656031052405,MATH 10B,A01,083207,Lim; Seonhee,1,1,34,33
1656031052405,MATH 10B,A02,083208,Lim; Seonhee,1,1,35,34
1656031052405,MATH 10B,A03,093472,Staff,0,0,34,34
1656031052405,MATH 10B,B01,083739,Sinha; Shubham,10,0,30,20
1656031058438,MATH 18,A01,083743,Cinel; Cameron Alexander,5,0,30,25
1656031058438,MATH 18,A02,083744,Cinel; Cameron Alexander,11,0,30,19
1656031058438,MATH 18,A03,083745,Cinel; Cameron Alexander,1,0,30,29
1656031058438,MATH 18,B01,083748,Ma; Zilu,0,0,36,36
1656031058438,MATH 18,B02,083749,Ma; Zilu,0,0,36,36
1656031058438,MATH 18,B03,083750,Ma; Zilu,0,0,36,36
1656031058438,MATH 18,B04,083751,Ma; Zilu,0,0,36,36
1656031058438,MATH 18,B05,093473,Staff,0,0,36,36
1656031058438,MATH 18,B06,093474,Staff,3,0,36,33
1656031064462,MATH 20A,A01,083754,Zheng; Zequn,11,0,40,29
1656031070492,MATH 20B,A01,083756,Briones; Jor-el Thomas Caparas,0,0,36,36
1656031070492,MATH 20B,A02,083757,Briones; Jor-el Thomas Caparas,1,0,36,35
1656031070492,MATH 20B,A03,093475,Staff,0,0,36,36
1656031076527,MATH 20C,A01,083760,Briones; Jor-el Thomas Caparas,0,2,35,35
1656031076527,MATH 20C,A02,083761,Briones; Jor-el Thomas Caparas,6,1,35,29
1656031076527,MATH 20C,A03,093476,Staff,0,1,35,35
1656031076527,MATH 20C,B01,083762,Bach; Quang Tran,3,0,30,27
1656031082551,MATH 20D,A01,083765,Tran; Brian Kha,2,0,30,28
1656031082551,MATH 20D,A02,083766,Tran; Brian Kha,0,1,30,30
1656031082551,MATH 20D,A03,083767,Tran; Brian Kha,0,0,30,30
1656031088580,MATH 20E,A01,083771,Ganguly; Soumya,0,1,32,32
1656031088580,MATH 20E,A02,083772,Ganguly; Soumya,1,1,32,31
1656031088580,MATH 20E,B01,083773,Ciotti; Benjamin,13,0,35,22
1656031088580,MATH 20E,B02,083774,Ciotti; Benjamin,12,0,35,23
1656031094606,MATH 103A,A01,083777,Greenfeld; Be'Eri,2,1,36,34
1656031094606,MATH 103A,A02,083778,Greenfeld; Be'Eri,1,0,36,35
1656031094606,MATH 103A,A03,093561,Staff,0,1,36,36
1656031094606,MATH 103A,B01,083779,Greenfeld; Be'Eri,8,1,36,28
1656031094606,MATH 103A,B02,083780,Greenfeld; Be'Eri,0,0,36,36
1656031094606,MATH 103A,B03,093562,Staff,0,0,36,36
1656031100632,MATH 105,A01,085443,Carter; Anne Toulson,4,1,35,31
1656031100632,MATH 105,A02,093477,Staff,9,0,35,26
1656031106658,MATH 109,A01,083213,Ganzberger; Geoffrey Michael,0,1,34,34
1656031106658,MATH 109,A02,083214,Ganzberger; Geoffrey Michael,0,0,34,34
1656031106658,MATH 109,A03,093478,Staff,1,0,34,33
1656031106658,MATH 109,B01,083215,Ganzberger; Geoffrey Michael,2,0,32,30
1656031106658,MATH 109,B02,083216,Ganzberger; Geoffrey Michael,0,0,32,32
1656031106658,MATH 109,B03,093479,Staff,3,0,32,29
1656031112682,MATH 142A,A01,083219,Chow; Bennett,1,0,32,31
1656031112682,MATH 142A,A02,083220,Chow; Bennett,7,0,32,25
1656031112682,MATH 142A,A03,093480,Staff,4,0,32,28
1656031112682,MATH 142A,B03,093481,Staff,3,0,32,29
1656031112682,MATH 142A,B04,093558,Staff,6,0,32,26
1656031112682,MATH 142A,B05,093559,Staff,0,0,32,32
1656031118714,MATH 193A,A01,083224,Rotar; Vladimir,1,2,34,33
1656031118714,MATH 193A,A02,083225,Rotar; Vladimir,0,0,34,34
1656031118714,MATH 193A,A03,083781,Rotar; Vladimir,1,0,34,33
1656031118714,MATH 193A,A04,083782,Rotar; Vladimir,3,0,34,31
1656031118714,MATH 193A,A05,093482,Rotar; Vladimir,0,0,34,34
1656031124740,MATH 197,001,091859,McAuley; Julian John,9999,0,9999,0
1656031124740,MATH 197,002,095566,Kedlaya; Kiran S.,9997,0,9999,2
1656031124740,MATH 197,003,095567,Xiao; Ming,9999,0,9999,0
1656031124740,MATH 197,004,095571,Perols; Johan Lars,9998,0,9999,1
1656031131791,COGS 9,A01,083615,Shannon; Kyle Michael,3,1,75,72
1656031137812,COGS 11,A01,083617,Boyle; Mary E. T.,11,1,48,37
1656031143837,COGS 13,A01,083071,Bastos; Amalia Pinkusfeld,4,3,71,67
1656031149866,COGS 14A,A01,092681,Semenuks; Arturs,4,25,100,96
1656031155894,COGS 14B,A01,083073,Cheng; Tzu-Han,7,0,63,56
1656031161920,COGS 17,A01,092677,Semenuks; Arturs,8,7,81,73
1656031167943,COGS 100,A01,083619,Allen; Michael Gordon,2,2,70,68
1656031173971,COGS 101A,A01,083621,Davis; Joshua Daniel,4,3,68,64
1656031180004,COGS 101B,A01,091572,Allen; Michael Gordon,0,0,65,65
1656031186028,COGS 101C,A01,083625,Delgado; Tania,7,0,35,28
1656031192052,COGS 107A,A01,083627,Boyle; Mary E. T.,1,2,60,59
1656031198078,COGS 118A,A01,083075,Gupta; Anjum,21,16,76,55
1656031204101,CSE 3,A50,083646,Miranda; Gregory Joseph,14,0,50,36
1656031210124,CSE 8A,A50,083650,Miranda; Gregory Joseph,4,11,56,52
1656031216148,CSE 11,A01,083080,Cao; Yingjun,0,65,40,40
1656031222181,CSE 12,A01,083652,Krause-Levy; Sophia Louisa,7,8,120,113
1656031228209,CSE 15L,A01,083654,Morris; Justin Loren,3,1,50,47
1656031228209,CSE 15L,A02,083655,Morris; Justin Loren,2,1,50,48
1656031234233,CSE 20,A01,083657,Tran; Khoa Dang,29,0,80,51
1656031240259,CSE 21,A01,095574,Bach; Quang Tran,23,0,48,25
1656031246283,CSE 30,A01,083084,Eldon; John,2,10,80,78
1656031246283,CSE 30,B01,095061,Bhaskar; Nishant,2,5,50,48
1656031252312,CSE 100,A01,083659,Cao; Yingjun,2,25,70,68
1656031258338,CSE 134B,A01,083661,Powell; Thomas Allan,6,6,100,94
1656031264360,CSE 140,A01,083663,Gungor; Onat,5,0,85,80
1656031270394,CSE 140L,A01,083088,Eldon; John,5,0,100,95
1656031276418,CSE 175,A01,083665,Kumar; Rakesh,0,0,25,25
1656031282442,CSE 190,A00,092507,Dubnov; Shlomo,1,0,20,19
1656031288466,ECE 45,A01,083139,Congero; Spencer William,1,1,75,74
1656031294487,ECE 65,A50,083695,Saad; Andrew S,6,0,30,24
1656031294487,ECE 65,A51,095125,Staff,23,0,26,3
1656031300514,ECE 109,A01,091882,Touri; Behrouz,3,5,70,67
1656031306536,ECE 180,A00,083140,Abi Samra; Nicholas Camill,1,0,30,29
1656031306536,ECE 180,B00,083141,Abi Samra; Nicholas Camill,0,8,28,28
1656031312563,MATH 10A,A01,083735,Patchell; Gregory David,0,0,30,30
1656031312563,MATH 10A,A02,083736,Patchell; Gregory David,20,0,30,10
1656031312563,MATH 10A,A03,083737,Patchell; Gregory David,16,0,30,14
1656031318598,MATH 10B,A01,083207,Lim; Seonhee,1,1,34,33
1656031318598,MATH 10B,A02,083208,Lim; Seonhee,1,1,35,34
1656031318598,MATH 10B,A03,093472,Staff,0,0,34,34
1656031318598,MATH 10B,B01,083739,Sinha; Shubham,10,0,30,20
1656031324638,MATH 18,A01,083743,Cinel; Cameron Alexander,5,0,30,25
1656031324638,MATH 18,A02,083744,Cinel; Cameron Alexander,11,0,30,19
1656031324638,MATH 18,A03,083745,Cinel; Cameron Alexander,1,0,30,29
1656031324638,MATH 18,B01,083748,Ma; Zilu,0,0,36,36
1656031324638,MATH 18,B02,083749,Ma; Zilu,0,0,36,36
1656031324638,MATH 18,B03,083750,Ma; Zilu,0,0,36,36
1656031324638,MATH 18,B04,083751,Ma; Zilu,0,0,36,36
1656031324638,MATH 18,B05,093473,Staff,0,0,36,36
1656031324638,MATH 18,B06,093474,Staff,3,0,36,33
1656031330741,MATH 20A,A01,083754,Zheng; Zequn,11,0,40,29
1656031336764,MATH 20B,A01,083756,Briones; Jor-el Thomas Caparas,0,0,36,36
1656031336764,MATH 20B,A02,083757,Briones; Jor-el Thomas Caparas,1,0,36,35
1656031336764,MATH 20B,A03,093475,Staff,0,0,36,36
1656031342793,MATH 20C,A01,083760,Briones; Jor-el Thomas Caparas,0,2,35,35
1656031342793,MATH 20C,A02,083761,Briones; Jor-el Thomas Caparas,6,1,35,29
1656031342793,MATH 20C,A03,093476,Staff,0,1,35,35
1656031342793,MATH 20C,B01,083762,Bach; Quang Tran,3,0,30,27
1656031348816,MATH 20D,A01,083765,Tran; Brian Kha,2,0,30,28
1656031348816,MATH 20D,A02,083766,Tran; Brian Kha,0,1,30,30
1656031348816,MATH 20D,A03,083767,Tran; Brian Kha,0,0,30,30
1656031354847,MATH 20E,A01,083771,Ganguly; Soumya,0,1,32,32
1656031354847,MATH 20E,A02,083772,Ganguly; Soumya,1,1,32,31
1656031354847,MATH 20E,B01,083773,Ciotti; Benjamin,13,0,35,22
1656031354847,MATH 20E,B02,083774,Ciotti; Benjamin,12,0,35,23
1656031360871,MATH 103A,A01,083777,Greenfeld; Be'Eri,2,1,36,34
1656031360871,MATH 103A,A02,083778,Greenfeld; Be'Eri,1,0,36,35
1656031360871,MATH 103A,A03,093561,Staff,0,1,36,36
1656031360871,MATH 103A,B01,083779,Greenfeld; Be'Eri,8,1,36,28
1656031360871,MATH 103A,B02,083780,Greenfeld; Be'Eri,0,0,36,36
1656031360871,MATH 103A,B03,093562,Staff,0,0,36,36
1656031366894,MATH 105,A01,085443,Carter; Anne Toulson,4,1,35,31
1656031366894,MATH 105,A02,093477,Staff,9,0,35,26
1656031372925,MATH 109,A01,083213,Ganzberger; Geoffrey Michael,0,1,34,34
1656031372925,MATH 109,A02,083214,Ganzberger; Geoffrey Michael,0,0,34,34
1656031372925,MATH 109,A03,093478,Staff,1,0,34,33
1656031372925,MATH 109,B01,083215,Ganzberger; Geoffrey Michael,2,0,32,30
1656031372925,MATH 109,B02,083216,Ganzberger; Geoffrey Michael,0,0,32,32
1656031372925,MATH 109,B03,093479,Staff,3,0,32,29
1656031378953,MATH 142A,A01,083219,Chow; Bennett,1,0,32,31
1656031378953,MATH 142A,A02,083220,Chow; Bennett,7,0,32,25
1656031378953,MATH 142A,A03,093480,Staff,4,0,32,28
1656031378953,MATH 142A,B03,093481,Staff,3,0,32,29
1656031378953,MATH 142A,B04,093558,Staff,5,0,32,27
1656031378953,MATH 142A,B05,093559,Staff,0,0,32,32
1656031384976,MATH 193A,A01,083224,Rotar; Vladimir,1,2,34,33
1656031384976,MATH 193A,A02,083225,Rotar; Vladimir,0,0,34,34
1656031384976,MATH 193A,A03,083781,Rotar; Vladimir,1,0,34,33
1656031384976,MATH 193A,A04,083782,Rotar; Vladimir,3,0,34,31
1656031384976,MATH 193A,A05,093482,Rotar; Vladimir,0,0,34,34
1656031391009,MATH 197,001,091859,McAuley; Julian John,9999,0,9999,0
1656031391009,MATH 197,002,095566,Kedlaya; Kiran S.,9997,0,9999,2
1656031391009,MATH 197,003,095567,Xiao; Ming,9999,0,9999,0
1656031391009,MATH 197,004,095571,Perols; Johan Lars,9998,0,9999,1
1656031398072,COGS 9,A01,083615,Shannon; Kyle Michael,3,1,75,72
1656031404095,COGS 11,A01,083617,Boyle; Mary E. T.,11,1,48,37
1656031410118,COGS 13,A01,083071,Bastos; Amalia Pinkusfeld,4,3,71,67
1656031416143,COGS 14A,A01,092681,Semenuks; Arturs,4,25,100,96
1656031422181,COGS 14B,A01,083073,Cheng; Tzu-Han,7,0,63,56
1656031428207,COGS 17,A01,092677,Semenuks; Arturs,8,7,81,73
1656031434230,COGS 100,A01,083619,Allen; Michael Gordon,2,2,70,68
1656031440253,COGS 101A,A01,083621,Davis; Joshua Daniel,4,3,68,64
1656031446276,COGS 101B,A01,091572,Allen; Michael Gordon,0,0,65,65
1656031452297,COGS 101C,A01,083625,Delgado; Tania,7,0,35,28
1656031458321,COGS 107A,A01,083627,Boyle; Mary E. T.,1,2,60,59
1656031464344,COGS 118A,A01,083075,Gupta; Anjum,21,16,76,55
1656031470373,CSE 3,A50,083646,Miranda; Gregory Joseph,14,0,50,36
1656031476395,CSE 8A,A50,083650,Miranda; Gregory Joseph,4,11,56,52
1656031482422,CSE 11,A01,083080,Cao; Yingjun,0,65,40,40
1656031488449,CSE 12,A01,083652,Krause-Levy; Sophia Louisa,7,8,120,113
1656031494479,CSE 15L,A01,083654,Morris; Justin Loren,3,1,50,47
1656031494479,CSE 15L,A02,083655,Morris; Justin Loren,2,1,50,48
1656031500503,CSE 20,A01,083657,Tran; Khoa Dang,29,0,80,51
1656031506526,CSE 21,A01,095574,Bach; Quang Tran,23,0,48,25
1656031512554,CSE 30,A01,083084,Eldon; John,2,10,80,78
1656031512554,CSE 30,B01,095061,Bhaskar; Nishant,2,5,50,48
1656031518579,CSE 100,A01,083659,Cao; Yingjun,2,25,70,68
1656031524695,CSE 134B,A01,083661,Powell; Thomas Allan,6,6,100,94
1656031530718,CSE 140,A01,083663,Gungor; Onat,5,0,85,80
1656031536742,CSE 140L,A01,083088,Eldon; John,5,0,100,95
1656031542769,CSE 175,A01,083665,Kumar; Rakesh,0,0,25,25
1656031548796,CSE 190,A00,092507,Dubnov; Shlomo,1,0,20,19
1656031554820,ECE 45,A01,083139,Congero; Spencer William,1,1,75,74
1656031560859,ECE 65,A50,083695,Saad; Andrew S,6,0,30,24
1656031560859,ECE 65,A51,095125,Staff,23,0,26,3
1656031566887,ECE 109,A01,091882,Touri; Behrouz,3,5,70,67
1656031572912,ECE 180,A00,083140,Abi Samra; Nicholas Camill,1,0,30,29
1656031572912,ECE 180,B00,083141,Abi Samra; Nicholas Camill,0,8,28,28
1656031578942,MATH 10A,A01,083735,Patchell; Gregory David,0,0,30,30
1656031578942,MATH 10A,A02,083736,Patchell; Gregory David,20,0,30,10
1656031578942,MATH 10A,A03,083737,Patchell; Gregory David,16,0,30,14
1656031584983,MATH 10B,A01,083207,Lim; Seonhee,1,1,34,33
1656031584983,MATH 10B,A02,083208,Lim; Seonhee,1,1,35,34
1656031584983,MATH 10B,A03,093472,Staff,0,0,34,34
1656031584983,MATH 10B,B01,083739,Sinha; Shubham,10,0,30,20
1656031591016,MATH 18,A01,083743,Cinel; Cameron Alexander,5,0,30,25
1656031591016,MATH 18,A02,083744,Cinel; Cameron Alexander,11,0,30,19
1656031591016,MATH 18,A03,083745,Cinel; Cameron Alexander,1,0,30,29
1656031591016,MATH 18,B01,083748,Ma; Zilu,0,0,36,36
1656031591016,MATH 18,B02,083749,Ma; Zilu,0,0,36,36
1656031591016,MATH 18,B03,083750,Ma; Zilu,0,0,36,36
1656031591016,MATH 18,B04,083751,Ma; Zilu,0,0,36,36
1656031591016,MATH 18,B05,093473,Staff,0,0,36,36
1656031591016,MATH 18,B06,093474,Staff,3,0,36,33
1656031597036,MATH 20A,A01,083754,Zheng; Zequn,11,0,40,29
1656031603061,MATH 20B,A01,083756,Briones; Jor-el Thomas Caparas,0,0,36,36
1656031603061,MATH 20B,A02,083757,Briones; Jor-el Thomas Caparas,1,0,36,35
1656031603061,MATH 20B,A03,093475,Staff,0,0,36,36
1656031609084,MATH 20C,A01,083760,Briones; Jor-el Thomas Caparas,0,2,35,35
1656031609084,MATH 20C,A02,083761,Briones; Jor-el Thomas Caparas,6,1,35,29
1656031609084,MATH 20C,A03,093476,Staff,0,1,35,35
1656031609084,MATH 20C,B01,083762,Bach; Quang Tran,3,0,30,27
1656031615108,MATH 20D,A01,083765,Tran; Brian Kha,2,0,30,28
1656031615108,MATH 20D,A02,083766,Tran; Brian Kha,0,1,30,30
1656031615108,MATH 20D,A03,083767,Tran; Brian Kha,0,0,30,30
1656031621136,MATH 20E,A01,083771,Ganguly; Soumya,0,1,32,32
1656031621136,MATH 20E,A02,083772,Ganguly; Soumya,1,1,32,31
1656031621136,MATH 20E,B01,083773,Ciotti; Benjamin,13,0,35,22
1656031621136,MATH 20E,B02,083774,Ciotti; Benjamin,12,0,35,23
1656031627172,MATH 103A,A01,083777,Greenfeld; Be'Eri,2,1,36,34
1656031627172,MATH 103A,A02,083778,Greenfeld; Be'Eri,1,0,36,35
1656031627172,MATH 103A,A03,093561,Staff,0,1,36,36
1656031627172,MATH 103A,B01,083779,Greenfeld; Be'Eri,8,1,36,28
1656031627172,MATH 103A,B02,083780,Greenfeld; Be'Eri,0,0,36,36
1656031627172,MATH 103A,B03,093562,Staff,0,0,36,36
1656031633200,MATH 105,A01,085443,Carter; Anne Toulson,4,1,35,31
1656031633200,MATH 105,A02,093477,Staff,9,0,35,26
1656031639226,MATH 109,A01,083213,Ganzberger; Geoffrey Michael,0,1,34,34
1656031639226,MATH 109,A02,083214,Ganzberger; Geoffrey Michael,0,0,34,34
1656031639226,MATH 109,A03,093478,Staff,1,0,34,33
1656031639226,MATH 109,B01,083215,Ganzberger; Geoffrey Michael,2,0,32,30
1656031639226,MATH 109,B02,083216,Ganzberger; Geoffrey Michael,0,0,32,32
1656031639226,MATH 109,B03,093479,Staff,3,0,32,29
1656031645250,MATH 142A,A01,083219,Chow; Bennett,1,0,32,31
1656031645250,MATH 142A,A02,083220,Chow; Bennett,7,0,32,25
1656031645250,MATH 142A,A03,093480,Staff,4,0,32,28
1656031645250,MATH 142A,B03,093481,Staff,3,0,32,29
1656031645250,MATH 142A,B04,093558,Staff,5,0,32,27
1656031645250,MATH 142A,B05,093559,Staff,0,0,32,32
1656031651273,MATH 193A,A01,083224,Rotar; Vladimir,1,2,34,33
1656031651273,MATH 193A,A02,083225,Rotar; Vladimir,0,0,34,34
1656031651273,MATH 193A,A03,083781,Rotar; Vladimir,1,0,34,33
1656031651273,MATH 193A,A04,083782,Rotar; Vladimir,3,0,34,31
1656031651273,MATH 193A,A05,093482,Rotar; Vladimir,0,0,34,34
1656031657295,MATH 197,001,091859,McAuley; Julian John,9999,0,9999,0
1656031657295,MATH 197,002,095566,Kedlaya; Kiran S.,9997,0,9999,2
1656031657295,MATH 197,003,095567,Xiao; Ming,9999,0,9999,0
1656031657295,MATH 197,004,095571,Perols; Johan Lars,9998,0,9999,1
1656031664358,COGS 9,A01,083615,Shannon; Kyle Michael,3,1,75,72
1656031670385,COGS 11,A01,083617,Boyle; Mary E. T.,11,1,48,37
1656031676412,COGS 13,A01,083071,Bastos; Amalia Pinkusfeld,4,3,71,67
1656031682439,COGS 14A,A01,092681,Semenuks; Arturs,4,25,100,96
1656031688467,COGS 14B,A01,083073,Cheng; Tzu-Han,7,0,63,56
1656031694495,COGS 17,A01,092677,Semenuks; Arturs,8,7,81,73
1656031700521,COGS 100,A01,083619,Allen; Michael Gordon,2,2,70,68
1656031706549,COGS 101A,A01,083621,Davis; Joshua Daniel,4,3,68,64
1656031712572,COGS 101B,A01,091572,Allen; Michael Gordon,0,0,65,65
1656031718596,COGS 101C,A01,083625,Delgado; Tania,7,0,35,28
1656031724620,COGS 107A,A01,083627,Boyle; Mary E. T.,1,2,60,59
1656031730643,COGS 118A,A01,083075,Gupta; Anjum,21,16,76,55
1656031736670,CSE 3,A50,083646,Miranda; Gregory Joseph,14,0,50,36
1656031742694,CSE 8A,A50,083650,Miranda; Gregory Joseph,4,11,56,52
1656031748718,CSE 11,A01,083080,Cao; Yingjun,0,65,40,40
1656031754742,CSE 12,A01,083652,Krause-Levy; Sophia Louisa,7,8,120,113
1656031760769,CSE 15L,A01,083654,Morris; Justin Loren,3,1,50,47
1656031760769,CSE 15L,A02,083655,Morris; Justin Loren,2,1,50,48
1656031766797,CSE 20,A01,083657,Tran; Khoa Dang,29,0,80,51
1656031772820,CSE 21,A01,095574,Bach; Quang Tran,23,0,48,25
1656031778843,CSE 30,A01,083084,Eldon; John,2,10,80,78
1656031778843,CSE 30,B01,095061,Bhaskar; Nishant,2,5,50,48
1656031784887,CSE 100,A01,083659,Cao; Yingjun,2,25,70,68
1656031790914,CSE 134B,A01,083661,Powell; Thomas Allan,6,6,100,94
1656031796946,CSE 140,A01,083663,Gungor; Onat,5,0,85,80
1656031802980,CSE 140L,A01,083088,Eldon; John,5,0,100,95
1656031809004,CSE 175,A01,083665,Kumar; Rakesh,0,0,25,25
1656031815031,CSE 190,A00,092507,Dubnov; Shlomo,1,0,20,19
1656031821058,ECE 45,A01,083139,Congero; Spencer William,1,1,75,74
1656031827081,ECE 65,A50,083695,Saad; Andrew S,6,0,30,24
1656031827081,ECE 65,A51,095125,Staff,23,0,26,3
1656031833103,ECE 109,A01,091882,Touri; Behrouz,3,5,70,67
1656031839127,ECE 180,A00,083140,Abi Samra; Nicholas Camill,1,0,30,29
1656031839127,ECE 180,B00,083141,Abi Samra; Nicholas Camill,0,8,28,28
1656031845152,MATH 10A,A01,083735,Patchell; Gregory David,0,0,30,30
1656031845152,MATH 10A,A02,083736,Patchell; Gregory David,20,0,30,10
1656031845152,MATH 10A,A03,083737,Patchell; Gregory David,16,0,30,14
1656031851181,MATH 10B,A01,083207,Lim; Seonhee,1,1,34,33
1656031851181,MATH 10B,A02,083208,Lim; Seonhee,1,1,35,34
1656031851181,MATH 10B,A03,093472,Staff,0,0,34,34
1656031851181,MATH 10B,B01,083739,Sinha; Shubham,10,0,30,20
1656031857207,MATH 18,A01,083743,Cinel; Cameron Alexander,5,0,30,25
1656031857207,MATH 18,A02,083744,Cinel; Cameron Alexander,11,0,30,19
1656031857207,MATH 18,A03,083745,Cinel; Cameron Alexander,1,0,30,29
1656031857207,MATH 18,B01,083748,Ma; Zilu,0,0,36,36
1656031857207,MATH 18,B02,083749,Ma; Zilu,0,0,36,36
1656031857207,MATH 18,B03,083750,Ma; Zilu,0,0,36,36
1656031857207,MATH 18,B04,083751,Ma; Zilu,0,0,36,36
1656031857207,MATH 18,B05,093473,Staff,0,0,36,36
1656031857207,MATH 18,B06,093474,Staff,3,0,36,33
1656031863232,MATH 20A,A01,083754,Zheng; Zequn,11,0,40,29
1656031869255,MATH 20B,A01,083756,Briones; Jor-el Thomas Caparas,0,0,36,36
1656031869255,MATH 20B,A02,083757,Briones; Jor-el Thomas Caparas,1,0,36,35
1656031869255,MATH 20B,A03,093475,Staff,0,0,36,36
1656031875284,MATH 20C,A01,083760,Briones; Jor-el Thomas Caparas,0,2,35,35
1656031875284,MATH 20C,A02,083761,Briones; Jor-el Thomas Caparas,6,1,35,29
1656031875284,MATH 20C,A03,093476,Staff,0,1,35,35
1656031875284,MATH 20C,B01,083762,Bach; Quang Tran,3,0,30,27
1656031881307,MATH 20D,A01,083765,Tran; Brian Kha,2,0,30,28
1656031881307,MATH 20D,A02,083766,Tran; Brian Kha,0,1,30,30
1656031881307,MATH 20D,A03,083767,Tran; Brian Kha,0,0,30,30
1656031887331,MATH 20E,A01,083771,Ganguly; Soumya,0,1,32,32
1656031887331,MATH 20E,A02,083772,Ganguly; Soumya,1,1,32,31
1656031887331,MATH 20E,B01,083773,Ciotti; Benjamin,13,0,35,22
1656031887331,MATH 20E,B02,083774,Ciotti; Benjamin,12,0,35,23
1656031893361,MATH 103A,A01,083777,Greenfeld; Be'Eri,2,1,36,34
1656031893361,MATH 103A,A02,083778,Greenfeld; Be'Eri,1,0,36,35
1656031893361,MATH 103A,A03,093561,Staff,0,1,36,36
1656031893361,MATH 103A,B01,083779,Greenfeld; Be'Eri,8,1,36,28
1656031893361,MATH 103A,B02,083780,Greenfeld; Be'Eri,0,0,36,36
1656031893361,MATH 103A,B03,093562,Staff,0,0,36,36
1656031899385,MATH 105,A01,085443,Carter; Anne Toulson,4,1,35,31
1656031899385,MATH 105,A02,093477,Staff,9,0,35,26
1656031905408,MATH 109,A01,083213,Ganzberger; Geoffrey Michael,0,1,34,34
1656031905408,MATH 109,A02,083214,Ganzberger; Geoffrey Michael,0,0,34,34
1656031905408,MATH 109,A03,093478,Staff,1,0,34,33
1656031905408,MATH 109,B01,083215,Ganzberger; Geoffrey Michael,2,0,32,30
1656031905408,MATH 109,B02,083216,Ganzberger; Geoffrey Michael,0,0,32,32
1656031905408,MATH 109,B03,093479,Staff,3,0,32,29
1656031911433,MATH 142A,A01,083219,Chow; Bennett,1,0,32,31
1656031911433,MATH 142A,A02,083220,Chow; Bennett,7,0,32,25
1656031911433,MATH 142A,A03,093480,Staff,4,0,32,28
1656031911433,MATH 142A,B03,093481,Staff,3,0,32,29
1656031911433,MATH 142A,B04,093558,Staff,5,0,32,27
1656031911433,MATH 142A,B05,093559,Staff,0,0,32,32
1656031917456,MATH 193A,A01,083224,Rotar; Vladimir,1,2,34,33
1656031917456,MATH 193A,A02,083225,Rotar; Vladimir,0,0,34,34
1656031917456,MATH 193A,A03,083781,Rotar; Vladimir,1,0,34,33
1656031917456,MATH 193A,A04,083782,Rotar; Vladimir,3,0,34,31
1656031917456,MATH 193A,A05,093482,Rotar; Vladimir,0,0,34,34
1656031923480,MATH 197,001,091859,McAuley; Julian John,9999,0,9999,0
1656031923480,MATH 197,002,095566,Kedlaya; Kiran S.,9997,0,9999,2
1656031923480,MATH 197,003,095567,Xiao; Ming,9999,0,9999,0
1656031923480,MATH 197,004,095571,Perols; Johan Lars,9998,0,9999,1
1656031930540,COGS 9,A01,083615,Shannon; Kyle Michael,3,1,75,72
1656031936565,COGS 11,A01,083617,Boyle; Mary E. T.,11,1,48,37
1656031942591,COGS 13,A01,083071,Bastos; Amalia Pinkusfeld,4,3,71,67
1656031948621,COGS 14A,A01,092681,Semenuks; Arturs,4,25,100,96
1656031954648,COGS 14B,A01,083073,Cheng; Tzu-Han,7,0,63,56
1656031960675,COGS 17,A01,092677,Semenuks; Arturs,8,7,81,73
1656031966702,COGS 100,A01,083619,Allen; Michael Gordon,2,2,70,68
1656031972726,COGS 101A,A01,083621,Davis; Joshua Daniel,4,3,68,64
1656031978753,COGS 101B,A01,091572,Allen; Michael Gordon,0,0,65,65
1656031984775,COGS 101C,A01,083625,Delgado; Tania,7,0,35,28
1656031990799,COGS 107A,A01,083627,Boyle; Mary E. T.,1,2,60,59
1656031996821,COGS 118A,A01,083075,Gupta; Anjum,21,16,76,55
1656032002844,CSE 3,A50,083646,Miranda; Gregory Joseph,14,0,50,36
1656032008874,CSE 8A,A50,083650,Miranda; Gregory Joseph,4,11,56,52
1656032014906,CSE 11,A01,083080,Cao; Yingjun,0,65,40,40
1656032020932,CSE 12,A01,083652,Krause-Levy; Sophia Louisa,7,8,120,113
1656032026955,CSE 15L,A01,083654,Morris; Justin Loren,3,1,50,47
1656032026955,CSE 15L,A02,083655,Morris; Justin Loren,2,1,50,48
1656032032982,CSE 20,A01,083657,Tran; Khoa Dang,29,0,80,51
1656032039004,CSE 21,A01,095574,Bach; Quang Tran,23,0,48,25
1656032045033,CSE 30,A01,083084,Eldon; John,2,10,80,78
1656032045033,CSE 30,B01,095061,Bhaskar; Nishant,2,5,50,48
1656032051059,CSE 100,A01,083659,Cao; Yingjun,2,25,70,68
1656032057086,CSE 134B,A01,083661,Powell; Thomas Allan,6,6,100,94
1656032063114,CSE 140,A01,083663,Gungor; Onat,5,0,85,80
1656032069141,CSE 140L,A01,083088,Eldon; John,5,0,100,95
1656032075168,CSE 175,A01,083665,Kumar; Rakesh,0,0,25,25
1656032081192,CSE 190,A00,092507,Dubnov; Shlomo,1,0,20,19
1656032087219,ECE 45,A01,083139,Congero; Spencer William,1,1,75,74
1656032093243,ECE 65,A50,083695,Saad; Andrew S,6,0,30,24
1656032093243,ECE 65,A51,095125,Staff,23,0,26,3
1656032099273,ECE 109,A01,091882,Touri; Behrouz,3,5,70,67
1656032105296,ECE 180,A00,083140,Abi Samra; Nicholas Camill,1,0,30,29
1656032105296,ECE 180,B00,083141,Abi Samra; Nicholas Camill,0,8,28,28
1656032111319,MATH 10A,A01,083735,Patchell; Gregory David,0,0,30,30
1656032111319,MATH 10A,A02,083736,Patchell; Gregory David,20,0,30,10
1656032111319,MATH 10A,A03,083737,Patchell; Gregory David,16,0,30,14
1656032117346,MATH 10B,A01,083207,Lim; Seonhee,1,1,34,33
1656032117346,MATH 10B,A02,083208,Lim; Seonhee,1,1,35,34
1656032117346,MATH 10B,A03,093472,Staff,0,0,34,34
1656032117346,MATH 10B,B01,083739,Sinha; Shubham,10,0,30,20
1656032123465,MATH 18,A01,083743,Cinel; Cameron Alexander,5,0,30,25
1656032123465,MATH 18,A02,083744,Cinel; Cameron Alexander,11,0,30,19
1656032123465,MATH 18,A03,083745,Cinel; Cameron Alexander,1,0,30,29
1656032123465,MATH 18,B01,083748,Ma; Zilu,0,0,36,36
1656032123465,MATH 18,B02,083749,Ma; Zilu,0,0,36,36
1656032123465,MATH 18,B03,083750,Ma; Zilu,0,0,36,36
1656032123465,MATH 18,B04,083751,Ma; Zilu,0,0,36,36
1656032123465,MATH 18,B05,093473,Staff,0,0,36,36
1656032123465,MATH 18,B06,093474,Staff,3,0,36,33
1656032129488,MATH 20A,A01,083754,Zheng; Zequn,11,0,40,29
1656032135511,MATH 20B,A01,083756,Briones; Jor-el Thomas Caparas,0,0,36,36
1656032135511,MATH 20B,A02,083757,Briones; Jor-el Thomas Caparas,1,0,36,35
1656032135511,MATH 20B,A03,093475,Staff,0,0,36,36
1656032141539,MATH 20C,A01,083760,Briones; Jor-el Thomas Caparas,0,2,35,35
1656032141539,MATH 20C,A02,083761,Briones; Jor-el Thomas Caparas,6,1,35,29
1656032141539,MATH 20C,A03,093476,Staff,0,1,35,35
1656032141539,MATH 20C,B01,083762,Bach; Quang Tran,3,0,30,27
1656032147563,MATH 20D,A01,083765,Tran; Brian Kha,2,0,30,28
1656032147563,MATH 20D,A02,083766,Tran; Brian Kha,0,1,30,30
1656032147563,MATH 20D,A03,083767,Tran; Brian Kha,0,0,30,30
1656032153594,MATH 20E,A01,083771,Ganguly; Soumya,0,1,32,32
1656032153594,MATH 20E,A02,083772,Ganguly; Soumya,1,1,32,31
1656032153594,MATH 20E,B01,083773,Ciotti; Benjamin,13,0,35,22
1656032153594,MATH 20E,B02,083774,Ciotti; Benjamin,12,0,35,23
1656032159623,MATH 103A,A01,083777,Greenfeld; Be'Eri,2,1,36,34
1656032159623,MATH 103A,A02,083778,Greenfeld; Be'Eri,1,0,36,35
1656032159623,MATH 103A,A03,093561,Staff,0,1,36,36
1656032159623,MATH 103A,B01,083779,Greenfeld; Be'Eri,8,1,36,28
1656032159623,MATH 103A,B02,083780,Greenfeld; Be'Eri,0,0,36,36
1656032159623,MATH 103A,B03,093562,Staff,0,0,36,36
1656032165650,MATH 105,A01,085443,Carter; Anne Toulson,4,1,35,31
1656032165650,MATH 105,A02,093477,Staff,9,0,35,26
1656032171673,MATH 109,A01,083213,Ganzberger; Geoffrey Michael,0,1,34,34
1656032171673,MATH 109,A02,083214,Ganzberger; Geoffrey Michael,0,0,34,34
1656032171673,MATH 109,A03,093478,Staff,1,0,34,33
1656032171673,MATH 109,B01,083215,Ganzberger; Geoffrey Michael,2,0,32,30
1656032171673,MATH 109,B02,083216,Ganzberger; Geoffrey Michael,0,0,32,32
1656032171673,MATH 109,B03,093479,Staff,3,0,32,29
1656032177702,MATH 142A,A01,083219,Chow; Bennett,1,0,32,31
1656032177702,MATH 142A,A02,083220,Chow; Bennett,7,0,32,25
1656032177702,MATH 142A,A03,093480,Staff,4,0,32,28
1656032177702,MATH 142A,B03,093481,Staff,3,0,32,29
1656032177702,MATH 142A,B04,093558,Staff,5,0,32,27
1656032177702,MATH 142A,B05,093559,Staff,0,0,32,32
1656032183726,MATH 193A,A01,083224,Rotar; Vladimir,1,2,34,33
1656032183726,MATH 193A,A02,083225,Rotar; Vladimir,0,0,34,34
1656032183726,MATH 193A,A03,083781,Rotar; Vladimir,1,0,34,33
1656032183726,MATH 193A,A04,083782,Rotar; Vladimir,3,0,34,31
1656032183726,MATH 193A,A05,093482,Rotar; Vladimir,0,0,34,34
1656032189749,MATH 197,001,091859,McAuley; Julian John,9999,0,9999,0
1656032189749,MATH 197,002,095566,Kedlaya; Kiran S.,9997,0,9999,2
1656032189749,MATH 197,003,095567,Xiao; Ming,9999,0,9999,0
1656032189749,MATH 197,004,095571,Perols; Johan Lars,9998,0,9999,1
1656032196803,COGS 9,A01,083615,Shannon; Kyle Michael,3,1,75,72
1656032202826,COGS 11,A01,083617,Boyle; Mary E. T.,11,1,48,37
1656032208850,COGS 13,A01,083071,Bastos; Amalia Pinkusfeld,4,3,71,67
1656032214875,COGS 14A,A01,092681,Semenuks; Arturs,4,25,100,96
1656032220907,COGS 14B,A01,083073,Cheng; Tzu-Han,7,0,63,56
1656032226933,COGS 17,A01,092677,Semenuks; Arturs,8,7,81,73
1656032232962,COGS 100,A01,083619,Allen; Michael Gordon,2,2,70,68
1656032238988,COGS 101A,A01,083621,Davis; Joshua Daniel,4,3,68,64
1656032245012,COGS 101B,A01,091572,Allen; Michael Gordon,0,0,65,65
1656032251038,COGS 101C,A01,083625,Delgado; Tania,7,0,35,28
1656032257062,COGS 107A,A01,083627,Boyle; Mary E. T.,1,2,60,59
1656032263085,COGS 118A,A01,083075,Gupta; Anjum,21,16,76,55
1656032269109,CSE 3,A50,083646,Miranda; Gregory Joseph,14,0,50,36
1656032275138,CSE 8A,A50,083650,Miranda; Gregory Joseph,4,11,56,52
1656032281167,CSE 11,A01,083080,Cao; Yingjun,0,65,40,40
1656032287195,CSE 12,A01,083652,Krause-Levy; Sophia Louisa,7,8,120,113
1656032293243,CSE 15L,A01,083654,Morris; Justin Loren,3,1,50,47
1656032293243,CSE 15L,A02,083655,Morris; Justin Loren,2,1,50,48
1656032299279,CSE 20,A01,083657,Tran; Khoa Dang,29,0,80,51
1656032305303,CSE 21,A01,095574,Bach; Quang Tran,23,0,48,25
1656032311328,CSE 30,A01,083084,Eldon; John,2,10,80,78
1656032311328,CSE 30,B01,095061,Bhaskar; Nishant,2,5,50,48
1656032317351,CSE 100,A01,083659,Cao; Yingjun,2,25,70,68
1656032323374,CSE 134B,A01,083661,Powell; Thomas Allan,6,6,100,94
1656032329399,CSE 140,A01,083663,Gungor; Onat,5,0,85,80
1656032335431,CSE 140L,A01,083088,Eldon; John,5,0,100,95
1656032341454,CSE 175,A01,083665,Kumar; Rakesh,0,0,25,25
1656032347476,CSE 190,A00,092507,Dubnov; Shlomo,1,0,20,19
1656032353502,ECE 45,A01,083139,Congero; Spencer William,1,1,75,74
1656032359527,ECE 65,A50,083695,Saad; Andrew S,6,0,30,24
1656032359527,ECE 65,A51,095125,Staff,23,0,26,3
1656032365550,ECE 109,A01,091882,Touri; Behrouz,3,5,70,67
1656032371577,ECE 180,A00,083140,Abi Samra; Nicholas Camill,1,0,30,29
1656032371577,ECE 180,B00,083141,Abi Samra; Nicholas Camill,0,8,28,28
1656032377598,MATH 10A,A01,083735,Patchell; Gregory David,0,0,30,30
1656032377598,MATH 10A,A02,083736,Patchell; Gregory David,20,0,30,10
1656032377598,MATH 10A,A03,083737,Patchell; Gregory David,16,0,30,14
1656032383624,MATH 10B,A01,083207,Lim; Seonhee,1,1,34,33
1656032383624,MATH 10B,A02,083208,Lim; Seonhee,1,1,35,34
1656032383624,MATH 10B,A03,093472,Staff,0,0,34,34
1656032383624,MATH 10B,B01,083739,Sinha; Shubham,10,0,30,20
1656032389652,MATH 18,A01,083743,Cinel; Cameron Alexander,5,0,30,25
1656032389652,MATH 18,A02,083744,Cinel; Cameron Alexander,11,0,30,19
1656032389652,MATH 18,A03,083745,Cinel; Cameron Alexander,1,0,30,29
1656032389652,MATH 18,B01,083748,Ma; Zilu,0,0,36,36
1656032389652,MATH 18,B02,083749,Ma; Zilu,0,0,36,36
1656032389652,MATH 18,B03,083750,Ma; Zilu,0,0,36,36
1656032389652,MATH 18,B04,083751,Ma; Zilu,0,0,36,36
1656032389652,MATH 18,B05,093473,Staff,0,0,36,36
1656032389652,MATH 18,B06,093474,Staff,3,0,36,33
1656032395675,MATH 20A,A01,083754,Zheng; Zequn,11,0,40,29
1656032401712,MATH 20B,A01,083756,Briones; Jor-el Thomas Caparas,0,0,36,36
1656032401712,MATH 20B,A02,083757,Briones; Jor-el Thomas Caparas,1,0,36,35
1656032401712,MATH 20B,A03,093475,Staff,0,0,36,36
1656032407741,MATH 20C,A01,083760,Briones; Jor-el Thomas Caparas,0,2,35,35
1656032407741,MATH 20C,A02,083761,Briones; Jor-el Thomas Caparas,6,1,35,29
1656032407741,MATH 20C,A03,093476,Staff,0,1,35,35
1656032407741,MATH 20C,B01,083762,Bach; Quang Tran,3,0,30,27
1656032413768,MATH 20D,A01,083765,Tran; Brian Kha,2,0,30,28
1656032413768,MATH 20D,A02,083766,Tran; Brian Kha,0,1,30,30
1656032413768,MATH 20D,A03,083767,Tran; Brian Kha,0,0,30,30
1656032419792,MATH 20E,A01,083771,Ganguly; Soumya,0,1,32,32
1656032419792,MATH 20E,A02,083772,Ganguly; Soumya,1,1,32,31
1656032419792,MATH 20E,B01,083773,Ciotti; Benjamin,13,0,35,22
1656032419792,MATH 20E,B02,083774,Ciotti; Benjamin,12,0,35,23
1656032425820,MATH 103A,A01,083777,Greenfeld; Be'Eri,2,1,36,34
1656032425820,MATH 103A,A02,083778,Greenfeld; Be'Eri,1,0,36,35
1656032425820,MATH 103A,A03,093561,Staff,0,1,36,36
1656032425820,MATH 103A,B01,083779,Greenfeld; Be'Eri,8,1,36,28
1656032425820,MATH 103A,B02,083780,Greenfeld; Be'Eri,0,0,36,36
1656032425820,MATH 103A,B03,093562,Staff,0,0,36,36
1656032431856,MATH 105,A01,085443,Carter; Anne Toulson,4,1,35,31
1656032431856,MATH 105,A02,093477,Staff,9,0,35,26
1656032437883,MATH 109,A01,083213,Ganzberger; Geoffrey Michael,0,1,34,34
1656032437883,MATH 109,A02,083214,Ganzberger; Geoffrey Michael,0,0,34,34
1656032437883,MATH 109,A03,093478,Staff,1,0,34,33
1656032437883,MATH 109,B01,083215,Ganzberger; Geoffrey Michael,2,0,32,30
1656032437883,MATH 109,B02,083216,Ganzberger; Geoffrey Michael,0,0,32,32
1656032437883,MATH 109,B03,093479,Staff,3,0,32,29
1656032443908,MATH 142A,A01,083219,Chow; Bennett,1,0,32,31
1656032443908,MATH 142A,A02,083220,Chow; Bennett,7,0,32,25
1656032443908,MATH 142A,A03,093480,Staff,4,0,32,28
1656032443908,MATH 142A,B03,093481,Staff,3,0,32,29
1656032443908,MATH 142A,B04,093558,Staff,5,0,32,27
1656032443908,MATH 142A,B05,093559,Staff,0,0,32,32
1656032449938,MATH 193A,A01,083224,Rotar; Vladimir,1,2,34,33
1656032449938,MATH 193A,A02,083225,Rotar; Vladimir,0,0,34,34
1656032449938,MATH 193A,A03,083781,Rotar; Vladimir,1,0,34,33
1656032449938,MATH 193A,A04,083782,Rotar; Vladimir,3,0,34,31
1656032449938,MATH 193A,A05,093482,Rotar; Vladimir,0,0,34,34
1656032455966,MATH 197,001,091859,McAuley; Julian John,9999,0,9999,0
1656032455966,MATH 197,002,095566,Kedlaya; Kiran S.,9997,0,9999,2
1656032455966,MATH 197,003,095567,Xiao; Ming,9999,0,9999,0
1656032455966,MATH 197,004,095571,Perols; Johan Lars,9998,0,9999,1
1656032463036,COGS 9,A01,083615,Shannon; Kyle Michael,3,1,75,72
1656032469062,COGS 11,A01,083617,Boyle; Mary E. T.,11,1,48,37
1656032475089,COGS 13,A01,083071,Bastos; Amalia Pinkusfeld,4,3,71,67
1656032481116,COGS 14A,A01,092681,Semenuks; Arturs,4,25,100,96
1656032487153,COGS 14B,A01,083073,Cheng; Tzu-Han,7,0,63,56
1656032493184,COGS 17,A01,092677,Semenuks; Arturs,8,7,81,73
1656032499211,COGS 100,A01,083619,Allen; Michael Gordon,2,2,70,68
1656032505234,COGS 101A,A01,083621,Davis; Joshua Daniel,4,3,68,64
1656032511256,COGS 101B,A01,091572,Allen; Michael Gordon,0,0,65,65
1656032517283,COGS 101C,A01,083625,Delgado; Tania,7,0,35,28
1656032523305,COGS 107A,A01,083627,Boyle; Mary E. T.,1,2,60,59
1656032529328,COGS 118A,A01,083075,Gupta; Anjum,21,16,76,55
1656032535357,CSE 3,A50,083646,Miranda; Gregory Joseph,14,0,50,36
1656032541380,CSE 8A,A50,083650,Miranda; Gregory Joseph,4,11,56,52
1656032547408,CSE 11,A01,083080,Cao; Yingjun,0,65,40,40
1656032553436,CSE 12,A01,083652,Krause-Levy; Sophia Louisa,7,8,120,113
1656032559459,CSE 15L,A01,083654,Morris; Justin Loren,3,1,50,47
1656032559459,CSE 15L,A02,083655,Morris; Justin Loren,2,1,50,48
1656032565483,CSE 20,A01,083657,Tran; Khoa Dang,29,0,80,51
1656032571510,CSE 21,A01,095574,Bach; Quang Tran,23,0,48,25
1656032577534,CSE 30,A01,083084,Eldon; John,2,10,80,78
1656032577534,CSE 30,B01,095061,Bhaskar; Nishant,2,5,50,48
1656032583556,CSE 100,A01,083659,Cao; Yingjun,2,25,70,68
1656032589579,CSE 134B,A01,083661,Powell; Thomas Allan,6,6,100,94
1656032595608,CSE 140,A01,083663,Gungor; Onat,5,0,85,80
1656032601631,CSE 140L,A01,083088,Eldon; John,5,0,100,95
1656032607654,CSE 175,A01,083665,Kumar; Rakesh,0,0,25,25
1656032613681,CSE 190,A00,092507,Dubnov; Shlomo,1,0,20,19
1656032619704,ECE 45,A01,083139,Congero; Spencer William,1,1,75,74
1656032625730,ECE 65,A50,083695,Saad; Andrew S,6,0,30,24
1656032625730,ECE 65,A51,095125,Staff,23,0,26,3
1656032631754,ECE 109,A01,091882,Touri; Behrouz,3,5,70,67
1656032637778,ECE 180,A00,083140,Abi Samra; Nicholas Camill,1,0,30,29
1656032637778,ECE 180,B00,083141,Abi Samra; Nicholas Camill,0,8,28,28
1656032643802,MATH 10A,A01,083735,Patchell; Gregory David,0,0,30,30
1656032643802,MATH 10A,A02,083736,Patchell; Gregory David,20,0,30,10
1656032643802,MATH 10A,A03,083737,Patchell; Gregory David,16,0,30,14
1656032649839,MATH 10B,A01,083207,Lim; Seonhee,1,1,34,33
1656032649839,MATH 10B,A02,083208,Lim; Seonhee,1,1,35,34
1656032649839,MATH 10B,A03,093472,Staff,0,0,34,34
1656032649839,MATH 10B,B01,083739,Sinha; Shubham,10,0,30,20
1656032655871,MATH 18,A01,083743,Cinel; Cameron Alexander,5,0,30,25
1656032655871,MATH 18,A02,083744,Cinel; Cameron Alexander,11,0,30,19
1656032655871,MATH 18,A03,083745,Cinel; Cameron Alexander,1,0,30,29
1656032655871,MATH 18,B01,083748,Ma; Zilu,0,0,36,36
1656032655871,MATH 18,B02,083749,Ma; Zilu,0,0,36,36
1656032655871,MATH 18,B03,083750,Ma; Zilu,0,0,36,36
1656032655871,MATH 18,B04,083751,Ma; Zilu,0,0,36,36
1656032655871,MATH 18,B05,093473,Staff,0,0,36,36
1656032655871,MATH 18,B06,093474,Staff,3,0,36,33
1656032661898,MATH 20A,A01,083754,Zheng; Zequn,11,0,40,29
1656032667936,MATH 20B,A01,083756,Briones; Jor-el Thomas Caparas,0,0,36,36
1656032667936,MATH 20B,A02,083757,Briones; Jor-el Thomas Caparas,1,0,36,35
1656032667936,MATH 20B,A03,093475,Staff,0,0,36,36
1656032673966,MATH 20C,A01,083760,Briones; Jor-el Thomas Caparas,0,2,35,35
1656032673966,MATH 20C,A02,083761,Briones; Jor-el Thomas Caparas,6,1,35,29
1656032673966,MATH 20C,A03,093476,Staff,0,1,35,35
1656032673966,MATH 20C,B01,083762,Bach; Quang Tran,3,0,30,27
1656032679991,MATH 20D,A01,083765,Tran; Brian Kha,2,0,30,28
1656032679991,MATH 20D,A02,083766,Tran; Brian Kha,0,1,30,30
1656032679991,MATH 20D,A03,083767,Tran; Brian Kha,0,0,30,30
1656032686017,MATH 20E,A01,083771,Ganguly; Soumya,0,1,32,32
1656032686017,MATH 20E,A02,083772,Ganguly; Soumya,1,1,32,31
1656032686017,MATH 20E,B01,083773,Ciotti; Benjamin,13,0,35,22
1656032686017,MATH 20E,B02,083774,Ciotti; Benjamin,12,0,35,23
1656032692044,MATH 103A,A01,083777,Greenfeld; Be'Eri,2,1,36,34
1656032692044,MATH 103A,A02,083778,Greenfeld; Be'Eri,1,0,36,35
1656032692044,MATH 103A,A03,093561,Staff,0,1,36,36
1656032692044,MATH 103A,B01,083779,Greenfeld; Be'Eri,8,1,36,28
1656032692044,MATH 103A,B02,083780,Greenfeld; Be'Eri,0,0,36,36
1656032692044,MATH 103A,B03,093562,Staff,0,0,36,36
1656032698072,MATH 105,A01,085443,Carter; Anne Toulson,4,1,35,31
1656032698072,MATH 105,A02,093477,Staff,9,0,35,26
1656032704097,MATH 109,A01,083213,Ganzberger; Geoffrey Michael,0,1,34,34
1656032704097,MATH 109,A02,083214,Ganzberger; Geoffrey Michael,0,0,34,34
1656032704097,MATH 109,A03,093478,Staff,1,0,34,33
1656032704097,MATH 109,B01,083215,Ganzberger; Geoffrey Michael,2,0,32,30
1656032704097,MATH 109,B02,083216,Ganzberger; Geoffrey Michael,0,0,32,32
1656032704097,MATH 109,B03,093479,Staff,3,0,32,29
1656032710122,MATH 142A,A01,083219,Chow; Bennett,1,0,32,31
1656032710122,MATH 142A,A02,083220,Chow; Bennett,7,0,32,25
1656032710122,MATH 142A,A03,093480,Staff,4,0,32,28
1656032710122,MATH 142A,B03,093481,Staff,3,0,32,29
1656032710122,MATH 142A,B04,093558,Staff,5,0,32,27
1656032710122,MATH 142A,B05,093559,Staff,0,0,32,32
1656032716162,MATH 193A,A01,083224,Rotar; Vladimir,1,2,34,33
1656032716162,MATH 193A,A02,083225,Rotar; Vladimir,0,0,34,34
1656032716162,MATH 193A,A03,083781,Rotar; Vladimir,1,0,34,33
1656032716162,MATH 193A,A04,083782,Rotar; Vladimir,3,0,34,31
1656032716162,MATH 193A,A05,093482,Rotar; Vladimir,0,0,34,34
1656032722271,MATH 197,001,091859,McAuley; Julian John,9999,0,9999,0
1656032722271,MATH 197,002,095566,Kedlaya; Kiran S.,9997,0,9999,2
1656032722271,MATH 197,003,095567,Xiao; Ming,9999,0,9999,0
1656032722271,MATH 197,004,095571,Perols; Johan Lars,9998,0,9999,1
1656032729334,COGS 9,A01,083615,Shannon; Kyle Michael,3,1,75,72
1656032735357,COGS 11,A01,083617,Boyle; Mary E. T.,11,1,48,37
1656032741384,COGS 13,A01,083071,Bastos; Amalia Pinkusfeld,4,3,71,67
1656032747412,COGS 14A,A01,092681,Semenuks; Arturs,4,25,100,96
1656032753436,COGS 14B,A01,083073,Cheng; Tzu-Han,7,0,63,56
1656032759459,COGS 17,A01,092677,Semenuks; Arturs,8,7,81,73
1656032765484,COGS 100,A01,083619,Allen; Michael Gordon,2,2,70,68
1656032771516,COGS 101A,A01,083621,Davis; Joshua Daniel,4,3,68,64
1656032777544,COGS 101B,A01,091572,Allen; Michael Gordon,0,0,65,65
1656032783570,COGS 101C,A01,083625,Delgado; Tania,7,0,35,28
1656032789597,COGS 107A,A01,083627,Boyle; Mary E. T.,1,2,60,59
1656032795634,COGS 118A,A01,083075,Gupta; Anjum,21,16,76,55
1656032801657,CSE 3,A50,083646,Miranda; Gregory Joseph,14,0,50,36
1656032807680,CSE 8A,A50,083650,Miranda; Gregory Joseph,4,11,56,52
1656032813703,CSE 11,A01,083080,Cao; Yingjun,0,65,40,40
1656032819732,CSE 12,A01,083652,Krause-Levy; Sophia Louisa,7,8,120,113
1656032825755,CSE 15L,A01,083654,Morris; Justin Loren,3,1,50,47
1656032825755,CSE 15L,A02,083655,Morris; Justin Loren,2,1,50,48
1656032831781,CSE 20,A01,083657,Tran; Khoa Dang,29,0,80,51
1656032837812,CSE 21,A01,095574,Bach; Quang Tran,23,0,48,25
1656032843836,CSE 30,A01,083084,Eldon; John,2,10,80,78
1656032843836,CSE 30,B01,095061,Bhaskar; Nishant,2,5,50,48
1656032849872,CSE 100,A01,083659,Cao; Yingjun,2,25,70,68
1656032855895,CSE 134B,A01,083661,Powell; Thomas Allan,6,6,100,94
1656032861918,CSE 140,A01,083663,Gungor; Onat,5,0,85,80
1656032867944,CSE 140L,A01,083088,Eldon; John,5,0,100,95
1656032873968,CSE 175,A01,083665,Kumar; Rakesh,0,0,25,25
1656032879994,CSE 190,A00,092507,Dubnov; Shlomo,1,0,20,19
1656032886021,ECE 45,A01,083139,Congero; Spencer William,1,1,75,74
1656032892049,ECE 65,A50,083695,Saad; Andrew S,6,0,30,24
1656032892049,ECE 65,A51,095125,Staff,23,0,26,3
1656032898076,ECE 109,A01,091882,Touri; Behrouz,3,5,70,67
1656032904100,ECE 180,A00,083140,Abi Samra; Nicholas Camill,1,0,30,29
1656032904100,ECE 180,B00,083141,Abi Samra; Nicholas Camill,0,8,28,28
1656032910122,MATH 10A,A01,083735,Patchell; Gregory David,0,0,30,30
1656032910122,MATH 10A,A02,083736,Patchell; Gregory David,20,0,30,10
1656032910122,MATH 10A,A03,083737,Patchell; Gregory David,16,0,30,14
1656032916151,MATH 10B,A01,083207,Lim; Seonhee,1,1,34,33
1656032916151,MATH 10B,A02,083208,Lim; Seonhee,1,1,35,34
1656032916151,MATH 10B,A03,093472,Staff,0,0,34,34
1656032916151,MATH 10B,B01,083739,Sinha; Shubham,10,0,30,20
1656032922176,MATH 18,A01,083743,Cinel; Cameron Alexander,5,0,30,25
1656032922176,MATH 18,A02,083744,Cinel; Cameron Alexander,11,0,30,19
1656032922176,MATH 18,A03,083745,Cinel; Cameron Alexander,1,0,30,29
1656032922176,MATH 18,B01,083748,Ma; Zilu,0,0,36,36
1656032922176,MATH 18,B02,083749,Ma; Zilu,0,0,36,36
1656032922176,MATH 18,B03,083750,Ma; Zilu,0,0,36,36
1656032922176,MATH 18,B04,083751,Ma; Zilu,0,0,36,36
1656032922176,MATH 18,B05,093473,Staff,0,0,36,36
1656032922176,MATH 18,B06,093474,Staff,3,0,36,33
1656032928202,MATH 20A,A01,083754,Zheng; Zequn,11,0,40,29
1656032934229,MATH 20B,A01,083756,Briones; Jor-el Thomas Caparas,0,0,36,36
1656032934229,MATH 20B,A02,083757,Briones; Jor-el Thomas Caparas,1,0,36,35
1656032934229,MATH 20B,A03,093475,Staff,0,0,36,36
1656032940256,MATH 20C,A01,083760,Briones; Jor-el Thomas Caparas,0,2,35,35
1656032940256,MATH 20C,A02,083761,Briones; Jor-el Thomas Caparas,6,1,35,29
1656032940256,MATH 20C,A03,093476,Staff,0,1,35,35
1656032940256,MATH 20C,B01,083762,Bach; Quang Tran,3,0,30,27
1656032946284,MATH 20D,A01,083765,Tran; Brian Kha,2,0,30,28
1656032946284,MATH 20D,A02,083766,Tran; Brian Kha,0,1,30,30
1656032946284,MATH 20D,A03,083767,Tran; Brian Kha,0,0,30,30
1656032952310,MATH 20E,A01,083771,Ganguly; Soumya,0,1,32,32
1656032952310,MATH 20E,A02,083772,Ganguly; Soumya,1,1,32,31
1656032952310,MATH 20E,B01,083773,Ciotti; Benjamin,13,0,35,22
1656032952310,MATH 20E,B02,083774,Ciotti; Benjamin,12,0,35,23
1656032958339,MATH 103A,A01,083777,Greenfeld; Be'Eri,2,1,36,34
1656032958339,MATH 103A,A02,083778,Greenfeld; Be'Eri,1,0,36,35
1656032958339,MATH 103A,A03,093561,Staff,0,1,36,36
1656032958339,MATH 103A,B01,083779,Greenfeld; Be'Eri,8,1,36,28
1656032958339,MATH 103A,B02,083780,Greenfeld; Be'Eri,0,0,36,36
1656032958339,MATH 103A,B03,093562,Staff,0,0,36,36
1656032964364,MATH 105,A01,085443,Carter; Anne Toulson,4,1,35,31
1656032964364,MATH 105,A02,093477,Staff,9,0,35,26
1656032970388,MATH 109,A01,083213,Ganzberger; Geoffrey Michael,0,1,34,34
1656032970388,MATH 109,A02,083214,Ganzberger; Geoffrey Michael,0,0,34,34
1656032970388,MATH 109,A03,093478,Staff,1,0,34,33
1656032970388,MATH 109,B01,083215,Ganzberger; Geoffrey Michael,2,0,32,30
1656032970388,MATH 109,B02,083216,Ganzberger; Geoffrey Michael,0,0,32,32
1656032970388,MATH 109,B03,093479,Staff,3,0,32,29
1656032976419,MATH 142A,A01,083219,Chow; Bennett,1,0,32,31
1656032976419,MATH 142A,A02,083220,Chow; Bennett,7,0,32,25
1656032976419,MATH 142A,A03,093480,Staff,4,0,32,28
1656032976419,MATH 142A,B03,093481,Staff,3,0,32,29
1656032976419,MATH 142A,B04,093558,Staff,5,0,32,27
1656032976419,MATH 142A,B05,093559,Staff,0,0,32,32
1656032982450,MATH 193A,A01,083224,Rotar; Vladimir,1,2,34,33
1656032982450,MATH 193A,A02,083225,Rotar; Vladimir,0,0,34,34
1656032982450,MATH 193A,A03,083781,Rotar; Vladimir,1,0,34,33
1656032982450,MATH 193A,A04,083782,Rotar; Vladimir,3,0,34,31
1656032982450,MATH 193A,A05,093482,Rotar; Vladimir,0,0,34,34
1656032988473,MATH 197,001,091859,McAuley; Julian John,9999,0,9999,0
1656032988473,MATH 197,002,095566,Kedlaya; Kiran S.,9997,0,9999,2
1656032988473,MATH 197,003,095567,Xiao; Ming,9999,0,9999,0
1656032988473,MATH 197,004,095571,Perols; Johan Lars,9998,0,9999,1
1656032995523,COGS 9,A01,083615,Shannon; Kyle Michael,3,1,75,72
1656033001549,COGS 11,A01,083617,Boyle; Mary E. T.,11,1,48,37
1656033007570,COGS 13,A01,083071,Bastos; Amalia Pinkusfeld,4,3,71,67
1656033013593,COGS 14A,A01,092681,Semenuks; Arturs,4,25,100,96
1656033019634,COGS 14B,A01,083073,Cheng; Tzu-Han,7,0,63,56
1656033025656,COGS 17,A01,092677,Semenuks; Arturs,8,7,81,73
1656033031682,COGS 100,A01,083619,Allen; Michael Gordon,3,2,70,67
1656033037704,COGS 101A,A01,083621,Davis; Joshua Daniel,4,3,68,64
1656033043732,COGS 101B,A01,091572,Allen; Michael Gordon,0,0,65,65
1656033049757,COGS 101C,A01,083625,Delgado; Tania,7,0,35,28
1656033055784,COGS 107A,A01,083627,Boyle; Mary E. T.,1,2,60,59
1656033061809,COGS 118A,A01,083075,Gupta; Anjum,21,16,76,55
1656033067832,CSE 3,A50,083646,Miranda; Gregory Joseph,14,0,50,36
1656033073855,CSE 8A,A50,083650,Miranda; Gregory Joseph,4,11,56,52
1656033079884,CSE 11,A01,083080,Cao; Yingjun,0,65,40,40
1656033085914,CSE 12,A01,083652,Krause-Levy; Sophia Louisa,7,8,120,113
1656033091941,CSE 15L,A01,083654,Morris; Justin Loren,3,1,50,47
1656033091941,CSE 15L,A02,083655,Morris; Justin Loren,2,1,50,48
1656033097969,CSE 20,A01,083657,Tran; Khoa Dang,29,0,80,51
1656033103998,CSE 21,A01,095574,Bach; Quang Tran,23,0,48,25
1656033110023,CSE 30,A01,083084,Eldon; John,2,10,80,78
1656033110023,CSE 30,B01,095061,Bhaskar; Nishant,2,5,50,48
1656033116049,CSE 100,A01,083659,Cao; Yingjun,2,25,70,68
1656033122071,CSE 134B,A01,083661,Powell; Thomas Allan,6,6,100,94
1656033128097,CSE 140,A01,083663,Gungor; Onat,5,0,85,80
1656033134124,CSE 140L,A01,083088,Eldon; John,5,0,100,95
1656033140147,CSE 175,A01,083665,Kumar; Rakesh,0,0,25,25
1656033146179,CSE 190,A00,092507,Dubnov; Shlomo,1,0,20,19
1656033152202,ECE 45,A01,083139,Congero; Spencer William,1,1,75,74
1656033158229,ECE 65,A50,083695,Saad; Andrew S,6,0,30,24
1656033158229,ECE 65,A51,095125,Staff,23,0,26,3
1656033164252,ECE 109,A01,091882,Touri; Behrouz,3,5,70,67
1656033170280,ECE 180,A00,083140,Abi Samra; Nicholas Camill,1,0,30,29
1656033170280,ECE 180,B00,083141,Abi Samra; Nicholas Camill,0,8,28,28
1656033176305,MATH 10A,A01,083735,Patchell; Gregory David,0,0,30,30
1656033176305,MATH 10A,A02,083736,Patchell; Gregory David,20,0,30,10
1656033176305,MATH 10A,A03,083737,Patchell; Gregory David,16,0,30,14
1656033182329,MATH 10B,A01,083207,Lim; Seonhee,1,1,34,33
1656033182329,MATH 10B,A02,083208,Lim; Seonhee,1,1,35,34
1656033182329,MATH 10B,A03,093472,Staff,0,0,34,34
1656033182329,MATH 10B,B01,083739,Sinha; Shubham,10,0,30,20
1656033188367,MATH 18,A01,083743,Cinel; Cameron Alexander,5,0,30,25
1656033188367,MATH 18,A02,083744,Cinel; Cameron Alexander,11,0,30,19
1656033188367,MATH 18,A03,083745,Cinel; Cameron Alexander,1,0,30,29
1656033188367,MATH 18,B01,083748,Ma; Zilu,0,0,36,36
1656033188367,MATH 18,B02,083749,Ma; Zilu,0,0,36,36
1656033188367,MATH 18,B03,083750,Ma; Zilu,0,0,36,36
1656033188367,MATH 18,B04,083751,Ma; Zilu,0,0,36,36
1656033188367,MATH 18,B05,093473,Staff,0,0,36,36
1656033188367,MATH 18,B06,093474,Staff,3,0,36,33
1656033194393,MATH 20A,A01,083754,Zheng; Zequn,11,0,40,29
1656033200427,MATH 20B,A01,083756,Briones; Jor-el Thomas Caparas,0,0,36,36
1656033200427,MATH 20B,A02,083757,Briones; Jor-el Thomas Caparas,1,0,36,35
1656033200427,MATH 20B,A03,093475,Staff,0,0,36,36
1656033206456,MATH 20C,A01,083760,Briones; Jor-el Thomas Caparas,0,2,35,35
1656033206456,MATH 20C,A02,083761,Briones; Jor-el Thomas Caparas,6,1,35,29
1656033206456,MATH 20C,A03,093476,Staff,0,1,35,35
1656033206456,MATH 20C,B01,083762,Bach; Quang Tran,3,0,30,27
1656033212483,MATH 20D,A01,083765,Tran; Brian Kha,2,0,30,28
1656033212483,MATH 20D,A02,083766,Tran; Brian Kha,0,1,30,30
1656033212483,MATH 20D,A03,083767,Tran; Brian Kha,0,0,30,30
1656033218508,MATH 20E,A01,083771,Ganguly; Soumya,0,1,32,32
1656033218508,MATH 20E,A02,083772,Ganguly; Soumya,1,1,32,31
1656033218508,MATH 20E,B01,083773,Ciotti; Benjamin,13,0,35,22
1656033218508,MATH 20E,B02,083774,Ciotti; Benjamin,12,0,35,23
1656033224536,MATH 103A,A01,083777,Greenfeld; Be'Eri,2,1,36,34
1656033224536,MATH 103A,A02,083778,Greenfeld; Be'Eri,1,0,36,35
1656033224536,MATH 103A,A03,093561,Staff,0,1,36,36
1656033224536,MATH 103A,B01,083779,Greenfeld; Be'Eri,8,1,36,28
1656033224536,MATH 103A,B02,083780,Greenfeld; Be'Eri,0,0,36,36
1656033224536,MATH 103A,B03,093562,Staff,0,0,36,36
1656033230561,MATH 105,A01,085443,Carter; Anne Toulson,4,1,35,31
1656033230561,MATH 105,A02,093477,Staff,9,0,35,26
1656033236591,MATH 109,A01,083213,Ganzberger; Geoffrey Michael,0,1,34,34
1656033236591,MATH 109,A02,083214,Ganzberger; Geoffrey Michael,0,0,34,34
1656033236591,MATH 109,A03,093478,Staff,1,0,34,33
1656033236591,MATH 109,B01,083215,Ganzberger; Geoffrey Michael,2,0,32,30
1656033236591,MATH 109,B02,083216,Ganzberger; Geoffrey Michael,0,0,32,32
1656033236591,MATH 109,B03,093479,Staff,3,0,32,29
1656033242614,MATH 142A,A01,083219,Chow; Bennett,1,0,32,31
1656033242614,MATH 142A,A02,083220,Chow; Bennett,7,0,32,25
1656033242614,MATH 142A,A03,093480,Staff,4,0,32,28
1656033242614,MATH 142A,B03,093481,Staff,3,0,32,29
1656033242614,MATH 142A,B04,093558,Staff,5,0,32,27
1656033242614,MATH 142A,B05,093559,Staff,0,0,32,32
1656033248643,MATH 193A,A01,083224,Rotar; Vladimir,1,2,34,33
1656033248643,MATH 193A,A02,083225,Rotar; Vladimir,0,0,34,34
1656033248643,MATH 193A,A03,083781,Rotar; Vladimir,1,0,34,33
1656033248643,MATH 193A,A04,083782,Rotar; Vladimir,3,0,34,31
1656033248643,MATH 193A,A05,093482,Rotar; Vladimir,0,0,34,34
1656033254665,MATH 197,001,091859,McAuley; Julian John,9999,0,9999,0
1656033254665,MATH 197,002,095566,Kedlaya; Kiran S.,9997,0,9999,2
1656033254665,MATH 197,003,095567,Xiao; Ming,9999,0,9999,0
1656033254665,MATH 197,004,095571,Perols; Johan Lars,9998,0,9999,1
1656033261719,COGS 9,A01,083615,Shannon; Kyle Michael,3,1,75,72
1656033267742,COGS 11,A01,083617,Boyle; Mary E. T.,11,1,48,37
1656033273775,COGS 13,A01,083071,Bastos; Amalia Pinkusfeld,4,3,71,67
1656033279796,COGS 14A,A01,092681,Semenuks; Arturs,4,25,100,96
1656033285827,COGS 14B,A01,083073,Cheng; Tzu-Han,7,0,63,56
1656033291857,COGS 17,A01,092677,Semenuks; Arturs,8,7,81,73
1656033297884,COGS 100,A01,083619,Allen; Michael Gordon,3,2,70,67
1656033303912,COGS 101A,A01,083621,Davis; Joshua Daniel,4,3,68,64
1656033309936,COGS 101B,A01,091572,Allen; Michael Gordon,0,0,65,65
1656033316055,COGS 101C,A01,083625,Delgado; Tania,7,0,35,28
1656033322079,COGS 107A,A01,083627,Boyle; Mary E. T.,1,2,60,59
1656033328104,COGS 118A,A01,083075,Gupta; Anjum,21,16,76,55
1656033334131,CSE 3,A50,083646,Miranda; Gregory Joseph,14,0,50,36
1656033340153,CSE 8A,A50,083650,Miranda; Gregory Joseph,4,11,56,52
1656033346194,CSE 11,A01,083080,Cao; Yingjun,0,65,40,40
1656033352222,CSE 12,A01,083652,Krause-Levy; Sophia Louisa,7,8,120,113
1656033358254,CSE 15L,A01,083654,Morris; Justin Loren,3,1,50,47
1656033358254,CSE 15L,A02,083655,Morris; Justin Loren,2,1,50,48
1656033364276,CSE 20,A01,083657,Tran; Khoa Dang,29,0,80,51
1656033370310,CSE 21,A01,095574,Bach; Quang Tran,23,0,48,25
1656033376335,CSE 30,A01,083084,Eldon; John,2,10,80,78
1656033376335,CSE 30,B01,095061,Bhaskar; Nishant,2,5,50,48
1656033382359,CSE 100,A01,083659,Cao; Yingjun,2,25,70,68
1656033388384,CSE 134B,A01,083661,Powell; Thomas Allan,6,6,100,94
1656033394411,CSE 140,A01,083663,Gungor; Onat,5,0,85,80
1656033400438,CSE 140L,A01,083088,Eldon; John,5,0,100,95
1656033406473,CSE 175,A01,083665,Kumar; Rakesh,0,0,25,25
1656033412500,CSE 190,A00,092507,Dubnov; Shlomo,1,0,20,19
1656033418527,ECE 45,A01,083139,Congero; Spencer William,1,1,75,74
1656033424551,ECE 65,A50,083695,Saad; Andrew S,6,0,30,24
1656033424551,ECE 65,A51,095125,Staff,23,0,26,3
1656033430574,ECE 109,A01,091882,Touri; Behrouz,3,5,70,67
1656033436598,ECE 180,A00,083140,Abi Samra; Nicholas Camill,1,0,30,29
1656033436598,ECE 180,B00,083141,Abi Samra; Nicholas Camill,0,8,28,28
1656033442626,MATH 10A,A01,083735,Patchell; Gregory David,0,0,30,30
1656033442626,MATH 10A,A02,083736,Patchell; Gregory David,20,0,30,10
1656033442626,MATH 10A,A03,083737,Patchell; Gregory David,16,0,30,14
1656033448649,MATH 10B,A01,083207,Lim; Seonhee,1,1,34,33
1656033448649,MATH 10B,A02,083208,Lim; Seonhee,1,1,35,34
1656033448649,MATH 10B,A03,093472,Staff,0,0,34,34
1656033448649,MATH 10B,B01,083739,Sinha; Shubham,10,0,30,20
1656033454672,MATH 18,A01,083743,Cinel; Cameron Alexander,5,0,30,25
1656033454672,MATH 18,A02,083744,Cinel; Cameron Alexander,11,0,30,19
1656033454672,MATH 18,A03,083745,Cinel; Cameron Alexander,1,0,30,29
1656033454672,MATH 18,B01,083748,Ma; Zilu,0,0,36,36
1656033454672,MATH 18,B02,083749,Ma; Zilu,0,0,36,36
1656033454672,MATH 18,B03,083750,Ma; Zilu,0,0,36,36
1656033454672,MATH 18,B04,083751,Ma; Zilu,0,0,36,36
1656033454672,MATH 18,B05,093473,Staff,0,0,36,36
1656033454672,MATH 18,B06,093474,Staff,3,0,36,33
1656033460698,MATH 20A,A01,083754,Zheng; Zequn,11,0,40,29
1656033466739,MATH 20B,A01,083756,Briones; Jor-el Thomas Caparas,0,0,36,36
1656033466739,MATH 20B,A02,083757,Briones; Jor-el Thomas Caparas,1,0,36,35
1656033466739,MATH 20B,A03,093475,Staff,0,0,36,36
1656033472771,MATH 20C,A01,083760,Briones; Jor-el Thomas Caparas,0,2,35,35
1656033472771,MATH 20C,A02,083761,Briones; Jor-el Thomas Caparas,6,1,35,29
1656033472771,MATH 20C,A03,093476,Staff,0,1,35,35
1656033472771,MATH 20C,B01,083762,Bach; Quang Tran,3,0,30,27
1656033478802,MATH 20D,A01,083765,Tran; Brian Kha,2,0,30,28
1656033478802,MATH 20D,A02,083766,Tran; Brian Kha,0,1,30,30
1656033478802,MATH 20D,A03,083767,Tran; Brian Kha,0,0,30,30
1656033484831,MATH 20E,A01,083771,Ganguly; Soumya,0,1,32,32
1656033484831,MATH 20E,A02,083772,Ganguly; Soumya,1,1,32,31
1656033484831,MATH 20E,B01,083773,Ciotti; Benjamin,13,0,35,22
1656033484831,MATH 20E,B02,083774,Ciotti; Benjamin,12,0,35,23
1656033490861,MATH 103A,A01,083777,Greenfeld; Be'Eri,2,1,36,34
1656033490861,MATH 103A,A02,083778,Greenfeld; Be'Eri,1,0,36,35
1656033490861,MATH 103A,A03,093561,Staff,0,1,36,36
1656033490861,MATH 103A,B01,083779,Greenfeld; Be'Eri,8,1,36,28
1656033490861,MATH 103A,B02,083780,Greenfeld; Be'Eri,0,0,36,36
1656033490861,MATH 103A,B03,093562,Staff,0,0,36,36
1656033496884,MATH 105,A01,085443,Carter; Anne Toulson,4,1,35,31
1656033496884,MATH 105,A02,093477,Staff,9,0,35,26
1656033502907,MATH 109,A01,083213,Ganzberger; Geoffrey Michael,0,1,34,34
1656033502907,MATH 109,A02,083214,Ganzberger; Geoffrey Michael,0,0,34,34
1656033502907,MATH 109,A03,093478,Staff,1,0,34,33
1656033502907,MATH 109,B01,083215,Ganzberger; Geoffrey Michael,2,0,32,30
1656033502907,MATH 109,B02,083216,Ganzberger; Geoffrey Michael,0,0,32,32
1656033502907,MATH 109,B03,093479,Staff,3,0,32,29
1656033508938,MATH 142A,A01,083219,Chow; Bennett,1,0,32,31
1656033508938,MATH 142A,A02,083220,Chow; Bennett,7,0,32,25
1656033508938,MATH 142A,A03,093480,Staff,4,0,32,28
1656033508938,MATH 142A,B03,093481,Staff,3,0,32,29
1656033508938,MATH 142A,B04,093558,Staff,5,0,32,27
1656033508938,MATH 142A,B05,093559,Staff,0,0,32,32
1656033514965,MATH 193A,A01,083224,Rotar; Vladimir,1,2,34,33
1656033514965,MATH 193A,A02,083225,Rotar; Vladimir,0,0,34,34
1656033514965,MATH 193A,A03,083781,Rotar; Vladimir,1,0,34,33
1656033514965,MATH 193A,A04,083782,Rotar; Vladimir,3,0,34,31
1656033514965,MATH 193A,A05,093482,Rotar; Vladimir,0,0,34,34
1656033521010,MATH 197,001,091859,McAuley; Julian John,9999,0,9999,0
1656033521010,MATH 197,002,095566,Kedlaya; Kiran S.,9997,0,9999,2
1656033521010,MATH 197,003,095567,Xiao; Ming,9999,0,9999,0
1656033521010,MATH 197,004,095571,Perols; Johan Lars,9998,0,9999,1
1656033528062,COGS 9,A01,083615,Shannon; Kyle Michael,3,1,75,72
1656033534084,COGS 11,A01,083617,Boyle; Mary E. T.,11,2,48,37
1656033540108,COGS 13,A01,083071,Bastos; Amalia Pinkusfeld,4,3,71,67
1656033546131,COGS 14A,A01,092681,Semenuks; Arturs,4,25,100,96
1656033552154,COGS 14B,A01,083073,Cheng; Tzu-Han,7,0,63,56
1656033558179,COGS 17,A01,092677,Semenuks; Arturs,8,7,81,73
1656033564206,COGS 100,A01,083619,Allen; Michael Gordon,3,2,70,67
1656033570229,COGS 101A,A01,083621,Davis; Joshua Daniel,4,3,68,64
1656033576256,COGS 101B,A01,091572,Allen; Michael Gordon,0,0,65,65
1656033582291,COGS 101C,A01,083625,Delgado; Tania,7,0,35,28
1656033588314,COGS 107A,A01,083627,Boyle; Mary E. T.,1,2,60,59
1656033594337,COGS 118A,A01,083075,Gupta; Anjum,21,16,76,55
1656033600365,CSE 3,A50,083646,Miranda; Gregory Joseph,14,0,50,36
1656033606394,CSE 8A,A50,083650,Miranda; Gregory Joseph,4,11,56,52
1656033612423,CSE 11,A01,083080,Cao; Yingjun,0,65,40,40
1656033618450,CSE 12,A01,083652,Krause-Levy; Sophia Louisa,7,8,120,113
1656033624481,CSE 15L,A01,083654,Morris; Justin Loren,3,1,50,47
1656033624481,CSE 15L,A02,083655,Morris; Justin Loren,2,1,50,48
1656033630508,CSE 20,A01,083657,Tran; Khoa Dang,29,0,80,51
1656033636535,CSE 21,A01,095574,Bach; Quang Tran,23,0,48,25
1656033642567,CSE 30,A01,083084,Eldon; John,2,10,80,78
1656033642567,CSE 30,B01,095061,Bhaskar; Nishant,2,5,50,48
1656033648593,CSE 100,A01,083659,Cao; Yingjun,2,25,70,68
1656033654618,CSE 134B,A01,083661,Powell; Thomas Allan,6,6,100,94
1656033660646,CSE 140,A01,083663,Gungor; Onat,5,0,85,80
1656033666680,CSE 140L,A01,083088,Eldon; John,5,0,100,95
1656033672707,CSE 175,A01,083665,Kumar; Rakesh,0,0,25,25
1656033678733,CSE 190,A00,092507,Dubnov; Shlomo,1,0,20,19
1656033684761,ECE 45,A01,083139,Congero; Spencer William,1,1,75,74
1656033690784,ECE 65,A50,083695,Saad; Andrew S,6,0,30,24
1656033690784,ECE 65,A51,095125,Staff,23,0,26,3
1656033696808,ECE 109,A01,091882,Touri; Behrouz,3,5,70,67
1656033702831,ECE 180,A00,083140,Abi Samra; Nicholas Camill,1,0,30,29
1656033702831,ECE 180,B00,083141,Abi Samra; Nicholas Camill,0,8,28,28
1656033708856,MATH 10A,A01,083735,Patchell; Gregory David,0,0,30,30
1656033708856,MATH 10A,A02,083736,Patchell; Gregory David,20,0,30,10
1656033708856,MATH 10A,A03,083737,Patchell; Gregory David,16,0,30,14
1656033714880,MATH 10B,A01,083207,Lim; Seonhee,1,1,34,33
1656033714880,MATH 10B,A02,083208,Lim; Seonhee,1,1,35,34
1656033714880,MATH 10B,A03,093472,Staff,0,0,34,34
1656033714880,MATH 10B,B01,083739,Sinha; Shubham,10,0,30,20
1656033720915,MATH 18,A01,083743,Cinel; Cameron Alexander,5,0,30,25
1656033720915,MATH 18,A02,083744,Cinel; Cameron Alexander,11,0,30,19
1656033720915,MATH 18,A03,083745,Cinel; Cameron Alexander,1,0,30,29
1656033720915,MATH 18,B01,083748,Ma; Zilu,0,0,36,36
1656033720915,MATH 18,B02,083749,Ma; Zilu,0,0,36,36
1656033720915,MATH 18,B03,083750,Ma; Zilu,0,0,36,36
1656033720915,MATH 18,B04,083751,Ma; Zilu,0,0,36,36
1656033720915,MATH 18,B05,093473,Staff,0,0,36,36
1656033720915,MATH 18,B06,093474,Staff,3,0,36,33
1656033726939,MATH 20A,A01,083754,Zheng; Zequn,11,0,40,29
1656033732973,MATH 20B,A01,083756,Briones; Jor-el Thomas Caparas,0,0,36,36
1656033732973,MATH 20B,A02,083757,Briones; Jor-el Thomas Caparas,1,0,36,35
1656033732973,MATH 20B,A03,093475,Staff,0,0,36,36
1656033738997,MATH 20C,A01,083760,Briones; Jor-el Thomas Caparas,0,2,35,35
1656033738997,MATH 20C,A02,083761,Briones; Jor-el Thomas Caparas,6,1,35,29
1656033738997,MATH 20C,A03,093476,Staff,0,1,35,35
1656033738997,MATH 20C,B01,083762,Bach; Quang Tran,3,0,30,27
1656033745027,MATH 20D,A01,083765,Tran; Brian Kha,2,0,30,28
1656033745027,MATH 20D,A02,083766,Tran; Brian Kha,0,1,30,30
1656033745027,MATH 20D,A03,083767,Tran; Brian Kha,0,0,30,30
1656033751057,MATH 20E,A01,083771,Ganguly; Soumya,0,1,32,32
1656033751057,MATH 20E,A02,083772,Ganguly; Soumya,1,1,32,31
1656033751057,MATH 20E,B01,083773,Ciotti; Benjamin,13,0,35,22
1656033751057,MATH 20E,B02,083774,Ciotti; Benjamin,12,0,35,23
1656033757089,MATH 103A,A01,083777,Greenfeld; Be'Eri,2,1,36,34
1656033757089,MATH 103A,A02,083778,Greenfeld; Be'Eri,1,0,36,35
1656033757089,MATH 103A,A03,093561,Staff,0,1,36,36
1656033757089,MATH 103A,B01,083779,Greenfeld; Be'Eri,8,1,36,28
1656033757089,MATH 103A,B02,083780,Greenfeld; Be'Eri,0,0,36,36
1656033757089,MATH 103A,B03,093562,Staff,0,0,36,36
1656033763115,MATH 105,A01,085443,Carter; Anne Toulson,4,1,35,31
1656033763115,MATH 105,A02,093477,Staff,9,0,35,26
1656033769148,MATH 109,A01,083213,Ganzberger; Geoffrey Michael,0,1,34,34
1656033769148,MATH 109,A02,083214,Ganzberger; Geoffrey Michael,0,0,34,34
1656033769148,MATH 109,A03,093478,Staff,1,0,34,33
1656033769148,MATH 109,B01,083215,Ganzberger; Geoffrey Michael,2,0,32,30
1656033769148,MATH 109,B02,083216,Ganzberger; Geoffrey Michael,0,0,32,32
1656033769148,MATH 109,B03,093479,Staff,3,0,32,29
1656033775179,MATH 142A,A01,083219,Chow; Bennett,1,0,32,31
1656033775179,MATH 142A,A02,083220,Chow; Bennett,7,0,32,25
1656033775179,MATH 142A,A03,093480,Staff,4,0,32,28
1656033775179,MATH 142A,B03,093481,Staff,3,0,32,29
1656033775179,MATH 142A,B04,093558,Staff,5,0,32,27
1656033775179,MATH 142A,B05,093559,Staff,0,0,32,32
1656033781203,MATH 193A,A01,083224,Rotar; Vladimir,1,2,34,33
1656033781203,MATH 193A,A02,083225,Rotar; Vladimir,0,0,34,34
1656033781203,MATH 193A,A03,083781,Rotar; Vladimir,1,0,34,33
1656033781203,MATH 193A,A04,083782,Rotar; Vladimir,3,0,34,31
1656033781203,MATH 193A,A05,093482,Rotar; Vladimir,0,0,34,34
1656033787226,MATH 197,001,091859,McAuley; Julian John,9999,0,9999,0
1656033787226,MATH 197,002,095566,Kedlaya; Kiran S.,9997,0,9999,2
1656033787226,MATH 197,003,095567,Xiao; Ming,9999,0,9999,0
1656033787226,MATH 197,004,095571,Perols; Johan Lars,9998,0,9999,1
1656033794277,COGS 9,A01,083615,Shannon; Kyle Michael,3,1,75,72
1656033800299,COGS 11,A01,083617,Boyle; Mary E. T.,11,2,48,37
1656033806323,COGS 13,A01,083071,Bastos; Amalia Pinkusfeld,4,3,71,67
1656033812346,COGS 14A,A01,092681,Semenuks; Arturs,4,25,100,96
1656033818373,COGS 14B,A01,083073,Cheng; Tzu-Han,7,0,63,56
1656033824401,COGS 17,A01,092677,Semenuks; Arturs,8,7,81,73
1656033830429,COGS 100,A01,083619,Allen; Michael Gordon,3,2,70,67
1656033836460,COGS 101A,A01,083621,Davis; Joshua Daniel,4,3,68,64
1656033842487,COGS 101B,A01,091572,Allen; Michael Gordon,0,0,65,65
1656033848510,COGS 101C,A01,083625,Delgado; Tania,7,0,35,28
1656033854539,COGS 107A,A01,083627,Boyle; Mary E. T.,1,2,60,59
1656033860562,COGS 118A,A01,083075,Gupta; Anjum,21,16,76,55
1656033866592,CSE 3,A50,083646,Miranda; Gregory Joseph,14,0,50,36
1656033872615,CSE 8A,A50,083650,Miranda; Gregory Joseph,4,11,56,52
1656033878639,CSE 11,A01,083080,Cao; Yingjun,0,65,40,40
1656033884663,CSE 12,A01,083652,Krause-Levy; Sophia Louisa,7,8,120,113
1656033890690,CSE 15L,A01,083654,Morris; Justin Loren,3,1,50,47
1656033890690,CSE 15L,A02,083655,Morris; Justin Loren,2,1,50,48
1656033896725,CSE 20,A01,083657,Tran; Khoa Dang,29,0,80,51
1656033902753,CSE 21,A01,095574,Bach; Quang Tran,23,0,48,25
1656033908777,CSE 30,A01,083084,Eldon; John,2,10,80,78
1656033908777,CSE 30,B01,095061,Bhaskar; Nishant,2,5,50,48
1656033914889,CSE 100,A01,083659,Cao; Yingjun,2,25,70,68
1656033920916,CSE 134B,A01,083661,Powell; Thomas Allan,6,6,100,94
1656033926938,CSE 140,A01,083663,Gungor; Onat,5,0,85,80
1656033932962,CSE 140L,A01,083088,Eldon; John,5,0,100,95
1656033938986,CSE 175,A01,083665,Kumar; Rakesh,0,0,25,25
1656033945013,CSE 190,A00,092507,Dubnov; Shlomo,1,0,20,19
1656033951041,ECE 45,A01,083139,Congero; Spencer William,1,1,75,74
1656033957065,ECE 65,A50,083695,Saad; Andrew S,6,0,30,24
1656033957065,ECE 65,A51,095125,Staff,23,0,26,3
1656033963091,ECE 109,A01,091882,Touri; Behrouz,3,5,70,67
1656033969119,ECE 180,A00,083140,Abi Samra; Nicholas Camill,1,0,30,29
1656033969119,ECE 180,B00,083141,Abi Samra; Nicholas Camill,0,8,28,28
1656033975147,MATH 10A,A01,083735,Patchell; Gregory David,0,0,30,30
1656033975147,MATH 10A,A02,083736,Patchell; Gregory David,20,0,30,10
1656033975147,MATH 10A,A03,083737,Patchell; Gregory David,16,0,30,14
1656033981179,MATH 10B,A01,083207,Lim; Seonhee,1,1,34,33
1656033981179,MATH 10B,A02,083208,Lim; Seonhee,1,1,35,34
1656033981179,MATH 10B,A03,093472,Staff,0,0,34,34
1656033981179,MATH 10B,B01,083739,Sinha; Shubham,10,0,30,20
1656033987205,MATH 18,A01,083743,Cinel; Cameron Alexander,5,0,30,25
1656033987205,MATH 18,A02,083744,Cinel; Cameron Alexander,11,0,30,19
1656033987205,MATH 18,A03,083745,Cinel; Cameron Alexander,1,0,30,29
1656033987205,MATH 18,B01,083748,Ma; Zilu,0,0,36,36
1656033987205,MATH 18,B02,083749,Ma; Zilu,0,0,36,36
1656033987205,MATH 18,B03,083750,Ma; Zilu,0,0,36,36
1656033987205,MATH 18,B04,083751,Ma; Zilu,0,0,36,36
1656033987205,MATH 18,B05,093473,Staff,0,0,36,36
1656033987205,MATH 18,B06,093474,Staff,3,0,36,33
1656033993232,MATH 20A,A01,083754,Zheng; Zequn,11,0,40,29
1656033999260,MATH 20B,A01,083756,Briones; Jor-el Thomas Caparas,0,0,36,36
1656033999260,MATH 20B,A02,083757,Briones; Jor-el Thomas Caparas,1,0,36,35
1656033999260,MATH 20B,A03,093475,Staff,0,0,36,36
1656034005284,MATH 20C,A01,083760,Briones; Jor-el Thomas Caparas,0,2,35,35
1656034005284,MATH 20C,A02,083761,Briones; Jor-el Thomas Caparas,6,1,35,29
1656034005284,MATH 20C,A03,093476,Staff,0,1,35,35
1656034005284,MATH 20C,B01,083762,Bach; Quang Tran,3,0,30,27
1656034011311,MATH 20D,A01,083765,Tran; Brian Kha,2,0,30,28
1656034011311,MATH 20D,A02,083766,Tran; Brian Kha,0,1,30,30
1656034011311,MATH 20D,A03,083767,Tran; Brian Kha,0,0,30,30
1656034017356,MATH 20E,A01,083771,Ganguly; Soumya,0,1,32,32
1656034017356,MATH 20E,A02,083772,Ganguly; Soumya,1,1,32,31
1656034017356,MATH 20E,B01,083773,Ciotti; Benjamin,13,0,35,22
1656034017356,MATH 20E,B02,083774,Ciotti; Benjamin,12,0,35,23
1656034023380,MATH 103A,A01,083777,Greenfeld; Be'Eri,2,1,36,34
1656034023380,MATH 103A,A02,083778,Greenfeld; Be'Eri,1,0,36,35
1656034023380,MATH 103A,A03,093561,Staff,0,1,36,36
1656034023380,MATH 103A,B01,083779,Greenfeld; Be'Eri,8,1,36,28
1656034023380,MATH 103A,B02,083780,Greenfeld; Be'Eri,0,0,36,36
1656034023380,MATH 103A,B03,093562,Staff,0,0,36,36
1656034029403,MATH 105,A01,085443,Carter; Anne Toulson,4,1,35,31
1656034029403,MATH 105,A02,093477,Staff,9,0,35,26
1656034035432,MATH 109,A01,083213,Ganzberger; Geoffrey Michael,0,1,34,34
1656034035432,MATH 109,A02,083214,Ganzberger; Geoffrey Michael,0,0,34,34
1656034035432,MATH 109,A03,093478,Staff,1,0,34,33
1656034035432,MATH 109,B01,083215,Ganzberger; Geoffrey Michael,2,0,32,30
1656034035432,MATH 109,B02,083216,Ganzberger; Geoffrey Michael,0,0,32,32
1656034035432,MATH 109,B03,093479,Staff,3,0,32,29
1656034041461,MATH 142A,A01,083219,Chow; Bennett,1,0,32,31
1656034041461,MATH 142A,A02,083220,Chow; Bennett,7,0,32,25
1656034041461,MATH 142A,A03,093480,Staff,4,0,32,28
1656034041461,MATH 142A,B03,093481,Staff,3,0,32,29
1656034041461,MATH 142A,B04,093558,Staff,5,0,32,27
1656034041461,MATH 142A,B05,093559,Staff,0,0,32,32
1656034047485,MATH 193A,A01,083224,Rotar; Vladimir,1,2,34,33
1656034047485,MATH 193A,A02,083225,Rotar; Vladimir,0,0,34,34
1656034047485,MATH 193A,A03,083781,Rotar; Vladimir,1,0,34,33
1656034047485,MATH 193A,A04,083782,Rotar; Vladimir,3,0,34,31
1656034047485,MATH 193A,A05,093482,Rotar; Vladimir,0,0,34,34
1656034053524,MATH 197,001,091859,McAuley; Julian John,9999,0,9999,0
1656034053524,MATH 197,002,095566,Kedlaya; Kiran S.,9997,0,9999,2
1656034053524,MATH 197,003,095567,Xiao; Ming,9999,0,9999,0
1656034053524,MATH 197,004,095571,Perols; Johan Lars,9998,0,9999,1
1656034060579,COGS 9,A01,083615,Shannon; Kyle Michael,3,1,75,72
1656034066606,COGS 11,A01,083617,Boyle; Mary E. T.,11,2,48,37
1656034072628,COGS 13,A01,083071,Bastos; Amalia Pinkusfeld,4,3,71,67
1656034078657,COGS 14A,A01,092681,Semenuks; Arturs,4,25,100,96
1656034084681,COGS 14B,A01,083073,Cheng; Tzu-Han,7,0,63,56
1656034090708,COGS 17,A01,092677,Semenuks; Arturs,8,7,81,73
1656034096731,COGS 100,A01,083619,Allen; Michael Gordon,3,2,70,67
1656034102760,COGS 101A,A01,083621,Davis; Joshua Daniel,4,3,68,64
1656034108783,COGS 101B,A01,091572,Allen; Michael Gordon,0,0,65,65
1656034114809,COGS 101C,A01,083625,Delgado; Tania,7,0,35,28
1656034120836,COGS 107A,A01,083627,Boyle; Mary E. T.,1,2,60,59
1656034126883,COGS 118A,A01,083075,Gupta; Anjum,21,16,76,55
1656034132908,CSE 3,A50,083646,Miranda; Gregory Joseph,14,0,50,36
1656034138933,CSE 8A,A50,083650,Miranda; Gregory Joseph,4,11,56,52
1656034144957,CSE 11,A01,083080,Cao; Yingjun,0,65,40,40
1656034150984,CSE 12,A01,083652,Krause-Levy; Sophia Louisa,7,8,120,113
1656034157012,CSE 15L,A01,083654,Morris; Justin Loren,3,1,50,47
1656034157012,CSE 15L,A02,083655,Morris; Justin Loren,2,1,50,48
1656034163039,CSE 20,A01,083657,Tran; Khoa Dang,29,0,80,51
1656034169067,CSE 21,A01,095574,Bach; Quang Tran,23,0,48,25
1656034175090,CSE 30,A01,083084,Eldon; John,2,10,80,78
1656034175090,CSE 30,B01,095061,Bhaskar; Nishant,2,5,50,48
1656034181122,CSE 100,A01,083659,Cao; Yingjun,2,25,70,68
1656034187146,CSE 134B,A01,083661,Powell; Thomas Allan,6,6,100,94
1656034193174,CSE 140,A01,083663,Gungor; Onat,5,0,85,80
1656034199207,CSE 140L,A01,083088,Eldon; John,5,0,100,95
1656034205239,CSE 175,A01,083665,Kumar; Rakesh,0,0,25,25
1656034211263,CSE 190,A00,092507,Dubnov; Shlomo,1,0,20,19
1656034217287,ECE 45,A01,083139,Congero; Spencer William,1,1,75,74
1656034223314,ECE 65,A50,083695,Saad; Andrew S,6,0,30,24
1656034223314,ECE 65,A51,095125,Staff,23,0,26,3
1656034229338,ECE 109,A01,091882,Touri; Behrouz,3,5,70,67
1656034235367,ECE 180,A00,083140,Abi Samra; Nicholas Camill,1,0,30,29
1656034235367,ECE 180,B00,083141,Abi Samra; Nicholas Camill,0,8,28,28
1656034241396,MATH 10A,A01,083735,Patchell; Gregory David,0,0,30,30
1656034241396,MATH 10A,A02,083736,Patchell; Gregory David,20,0,30,10
1656034241396,MATH 10A,A03,083737,Patchell; Gregory David,16,0,30,14
1656034247419,MATH 10B,A01,083207,Lim; Seonhee,1,1,34,33
1656034247419,MATH 10B,A02,083208,Lim; Seonhee,1,1,35,34
1656034247419,MATH 10B,A03,093472,Staff,0,0,34,34
1656034247419,MATH 10B,B01,083739,Sinha; Shubham,10,0,30,20
1656034253445,MATH 18,A01,083743,Cinel; Cameron Alexander,5,0,30,25
1656034253445,MATH 18,A02,083744,Cinel; Cameron Alexander,11,0,30,19
1656034253445,MATH 18,A03,083745,Cinel; Cameron Alexander,1,0,30,29
1656034253445,MATH 18,B01,083748,Ma; Zilu,0,0,36,36
1656034253445,MATH 18,B02,083749,Ma; Zilu,0,0,36,36
1656034253445,MATH 18,B03,083750,Ma; Zilu,0,0,36,36
1656034253445,MATH 18,B04,083751,Ma; Zilu,0,0,36,36
1656034253445,MATH 18,B05,093473,Staff,0,0,36,36
1656034253445,MATH 18,B06,093474,Staff,3,0,36,33
1656034259469,MATH 20A,A01,083754,Zheng; Zequn,11,0,40,29
1656034265497,MATH 20B,A01,083756,Briones; Jor-el Thomas Caparas,0,0,36,36
1656034265497,MATH 20B,A02,083757,Briones; Jor-el Thomas Caparas,1,0,36,35
1656034265497,MATH 20B,A03,093475,Staff,0,0,36,36
1656034271525,MATH 20C,A01,083760,Briones; Jor-el Thomas Caparas,0,2,35,35
1656034271525,MATH 20C,A02,083761,Briones; Jor-el Thomas Caparas,6,1,35,29
1656034271525,MATH 20C,A03,093476,Staff,0,1,35,35
1656034271525,MATH 20C,B01,083762,Bach; Quang Tran,3,0,30,27
1656034277554,MATH 20D,A01,083765,Tran; Brian Kha,2,0,30,28
1656034277554,MATH 20D,A02,083766,Tran; Brian Kha,0,1,30,30
1656034277554,MATH 20D,A03,083767,Tran; Brian Kha,0,0,30,30
1656034283578,MATH 20E,A01,083771,Ganguly; Soumya,0,1,32,32
1656034283578,MATH 20E,A02,083772,Ganguly; Soumya,1,1,32,31
1656034283578,MATH 20E,B01,083773,Ciotti; Benjamin,13,0,35,22
1656034283578,MATH 20E,B02,083774,Ciotti; Benjamin,12,0,35,23
1656034289612,MATH 103A,A01,083777,Greenfeld; Be'Eri,2,1,36,34
1656034289612,MATH 103A,A02,083778,Greenfeld; Be'Eri,1,0,36,35
1656034289612,MATH 103A,A03,093561,Staff,0,1,36,36
1656034289612,MATH 103A,B01,083779,Greenfeld; Be'Eri,8,1,36,28
1656034289612,MATH 103A,B02,083780,Greenfeld; Be'Eri,0,0,36,36
1656034289612,MATH 103A,B03,093562,Staff,0,0,36,36
1656034295640,MATH 105,A01,085443,Carter; Anne Toulson,4,1,35,31
1656034295640,MATH 105,A02,093477,Staff,9,0,35,26
1656034301687,MATH 109,A01,083213,Ganzberger; Geoffrey Michael,0,1,34,34
1656034301687,MATH 109,A02,083214,Ganzberger; Geoffrey Michael,0,0,34,34
1656034301687,MATH 109,A03,093478,Staff,1,0,34,33
1656034301687,MATH 109,B01,083215,Ganzberger; Geoffrey Michael,2,0,32,30
1656034301687,MATH 109,B02,083216,Ganzberger; Geoffrey Michael,0,0,32,32
1656034301687,MATH 109,B03,093479,Staff,3,0,32,29
1656034307710,MATH 142A,A01,083219,Chow; Bennett,1,0,32,31
1656034307710,MATH 142A,A02,083220,Chow; Bennett,7,0,32,25
1656034307710,MATH 142A,A03,093480,Staff,4,0,32,28
1656034307710,MATH 142A,B03,093481,Staff,3,0,32,29
1656034307710,MATH 142A,B04,093558,Staff,5,0,32,27
1656034307710,MATH 142A,B05,093559,Staff,0,0,32,32
1656034313734,MATH 193A,A01,083224,Rotar; Vladimir,1,2,34,33
1656034313734,MATH 193A,A02,083225,Rotar; Vladimir,0,0,34,34
1656034313734,MATH 193A,A03,083781,Rotar; Vladimir,1,0,34,33
1656034313734,MATH 193A,A04,083782,Rotar; Vladimir,3,0,34,31
1656034313734,MATH 193A,A05,093482,Rotar; Vladimir,0,0,34,34
1656034319760,MATH 197,001,091859,McAuley; Julian John,9999,0,9999,0
1656034319760,MATH 197,002,095566,Kedlaya; Kiran S.,9997,0,9999,2
1656034319760,MATH 197,003,095567,Xiao; Ming,9999,0,9999,0
1656034319760,MATH 197,004,095571,Perols; Johan Lars,9998,0,9999,1
1656034326817,COGS 9,A01,083615,Shannon; Kyle Michael,3,1,75,72
1656034332845,COGS 11,A01,083617,Boyle; Mary E. T.,11,2,48,37
1656034338868,COGS 13,A01,083071,Bastos; Amalia Pinkusfeld,4,3,71,67
1656034344894,COGS 14A,A01,092681,Semenuks; Arturs,4,25,100,96
1656034350925,COGS 14B,A01,083073,Cheng; Tzu-Han,7,0,63,56
1656034356948,COGS 17,A01,092677,Semenuks; Arturs,8,7,81,73
1656034362974,COGS 100,A01,083619,Allen; Michael Gordon,3,2,70,67
1656034369000,COGS 101A,A01,083621,Davis; Joshua Daniel,4,3,68,64
1656034375028,COGS 101B,A01,091572,Allen; Michael Gordon,0,0,65,65
1656034381050,COGS 101C,A01,083625,Delgado; Tania,7,0,35,28
1656034387079,COGS 107A,A01,083627,Boyle; Mary E. T.,1,2,60,59
1656034393106,COGS 118A,A01,083075,Gupta; Anjum,21,16,76,55
1656034399134,CSE 3,A50,083646,Miranda; Gregory Joseph,14,0,50,36
1656034405173,CSE 8A,A50,083650,Miranda; Gregory Joseph,4,11,56,52
1656034411199,CSE 11,A01,083080,Cao; Yingjun,0,65,40,40
1656034417222,CSE 12,A01,083652,Krause-Levy; Sophia Louisa,7,8,120,113
1656034423246,CSE 15L,A01,083654,Morris; Justin Loren,3,1,50,47
1656034423246,CSE 15L,A02,083655,Morris; Justin Loren,2,1,50,48
1656034429270,CSE 20,A01,083657,Tran; Khoa Dang,29,0,80,51
1656034435300,CSE 21,A01,095574,Bach; Quang Tran,23,0,48,25
1656034441331,CSE 30,A01,083084,Eldon; John,2,10,80,78
1656034441331,CSE 30,B01,095061,Bhaskar; Nishant,2,5,50,48
1656034447358,CSE 100,A01,083659,Cao; Yingjun,2,25,70,68
1656034453385,CSE 134B,A01,083661,Powell; Thomas Allan,6,6,100,94
1656034459409,CSE 140,A01,083663,Gungor; Onat,5,0,85,80
1656034465432,CSE 140L,A01,083088,Eldon; John,5,0,100,95
1656034471454,CSE 175,A01,083665,Kumar; Rakesh,0,0,25,25
1656034477514,CSE 190,A00,092507,Dubnov; Shlomo,1,0,20,19
1656034483541,ECE 45,A01,083139,Congero; Spencer William,1,1,75,74
1656034489564,ECE 65,A50,083695,Saad; Andrew S,6,0,30,24
1656034489564,ECE 65,A51,095125,Staff,23,0,26,3
1656034495591,ECE 109,A01,091882,Touri; Behrouz,3,5,70,67
1656034501614,ECE 180,A00,083140,Abi Samra; Nicholas Camill,1,0,30,29
1656034501614,ECE 180,B00,083141,Abi Samra; Nicholas Camill,0,8,28,28
1656034507636,MATH 10A,A01,083735,Patchell; Gregory David,0,0,30,30
1656034507636,MATH 10A,A02,083736,Patchell; Gregory David,20,0,30,10
1656034507636,MATH 10A,A03,083737,Patchell; Gregory David,16,0,30,14
1656034513732,MATH 10B,A01,083207,Lim; Seonhee,1,1,34,33
1656034513732,MATH 10B,A02,083208,Lim; Seonhee,1,1,35,34
1656034513732,MATH 10B,A03,093472,Staff,0,0,34,34
1656034513732,MATH 10B,B01,083739,Sinha; Shubham,10,0,30,20
1656034519757,MATH 18,A01,083743,Cinel; Cameron Alexander,5,0,30,25
1656034519757,MATH 18,A02,083744,Cinel; Cameron Alexander,11,0,30,19
1656034519757,MATH 18,A03,083745,Cinel; Cameron Alexander,1,0,30,29
1656034519757,MATH 18,B01,083748,Ma; Zilu,0,0,36,36
1656034519757,MATH 18,B02,083749,Ma; Zilu,0,0,36,36
1656034519757,MATH 18,B03,083750,Ma; Zilu,0,0,36,36
1656034519757,MATH 18,B04,083751,Ma; Zilu,0,0,36,36
1656034519757,MATH 18,B05,093473,Staff,0,0,36,36
1656034519757,MATH 18,B06,093474,Staff,3,0,36,33
1656034525779,MATH 20A,A01,083754,Zheng; Zequn,11,0,40,29
1656034531818,MATH 20B,A01,083756,Briones; Jor-el Thomas Caparas,0,0,36,36
1656034531818,MATH 20B,A02,083757,Briones; Jor-el Thomas Caparas,1,0,36,35
1656034531818,MATH 20B,A03,093475,Staff,0,0,36,36
1656034537842,MATH 20C,A01,083760,Briones; Jor-el Thomas Caparas,0,2,35,35
1656034537842,MATH 20C,A02,083761,Briones; Jor-el Thomas Caparas,6,1,35,29
1656034537842,MATH 20C,A03,093476,Staff,0,1,35,35
1656034537842,MATH 20C,B01,083762,Bach; Quang Tran,3,0,30,27
1656034543878,MATH 20D,A01,083765,Tran; Brian Kha,2,0,30,28
1656034543878,MATH 20D,A02,083766,Tran; Brian Kha,0,1,30,30
1656034543878,MATH 20D,A03,083767,Tran; Brian Kha,0,0,30,30
1656034549906,MATH 20E,A01,083771,Ganguly; Soumya,0,1,32,32
1656034549906,MATH 20E,A02,083772,Ganguly; Soumya,1,1,32,31
1656034549906,MATH 20E,B01,083773,Ciotti; Benjamin,13,0,35,22
1656034549906,MATH 20E,B02,083774,Ciotti; Benjamin,12,0,35,23
1656034555929,MATH 103A,A01,083777,Greenfeld; Be'Eri,2,1,36,34
1656034555929,MATH 103A,A02,083778,Greenfeld; Be'Eri,1,0,36,35
1656034555929,MATH 103A,A03,093561,Staff,0,1,36,36
1656034555929,MATH 103A,B01,083779,Greenfeld; Be'Eri,8,1,36,28
1656034555929,MATH 103A,B02,083780,Greenfeld; Be'Eri,0,0,36,36
1656034555929,MATH 103A,B03,093562,Staff,0,0,36,36
1656034561952,MATH 105,A01,085443,Carter; Anne Toulson,4,1,35,31
1656034561952,MATH 105,A02,093477,Staff,9,0,35,26
1656034567977,MATH 109,A01,083213,Ganzberger; Geoffrey Michael,0,1,34,34
1656034567977,MATH 109,A02,083214,Ganzberger; Geoffrey Michael,0,0,34,34
1656034567977,MATH 109,A03,093478,Staff,1,0,34,33
1656034567977,MATH 109,B01,083215,Ganzberger; Geoffrey Michael,2,0,32,30
1656034567977,MATH 109,B02,083216,Ganzberger; Geoffrey Michael,0,0,32,32
1656034567977,MATH 109,B03,093479,Staff,3,0,32,29
1656034574001,MATH 142A,A01,083219,Chow; Bennett,1,0,32,31
1656034574001,MATH 142A,A02,083220,Chow; Bennett,7,0,32,25
1656034574001,MATH 142A,A03,093480,Staff,4,0,32,28
1656034574001,MATH 142A,B03,093481,Staff,3,0,32,29
1656034574001,MATH 142A,B04,093558,Staff,5,0,32,27
1656034574001,MATH 142A,B05,093559,Staff,0,0,32,32
1656034580027,MATH 193A,A01,083224,Rotar; Vladimir,1,2,34,33
1656034580027,MATH 193A,A02,083225,Rotar; Vladimir,0,0,34,34
1656034580027,MATH 193A,A03,083781,Rotar; Vladimir,1,0,34,33
1656034580027,MATH 193A,A04,083782,Rotar; Vladimir,3,0,34,31
1656034580027,MATH 193A,A05,093482,Rotar; Vladimir,0,0,34,34
1656034586051,MATH 197,001,091859,McAuley; Julian John,9999,0,9999,0
1656034586051,MATH 197,002,095566,Kedlaya; Kiran S.,9997,0,9999,2
1656034586051,MATH 197,003,095567,Xiao; Ming,9999,0,9999,0
1656034586051,MATH 197,004,095571,Perols; Johan Lars,9998,0,9999,1
1656034593115,COGS 9,A01,083615,Shannon; Kyle Michael,3,1,75,72
1656034599141,COGS 11,A01,083617,Boyle; Mary E. T.,11,2,48,37
1656034605177,COGS 13,A01,083071,Bastos; Amalia Pinkusfeld,4,3,71,67
1656034611209,COGS 14A,A01,092681,Semenuks; Arturs,4,25,100,96
1656034617236,COGS 14B,A01,083073,Cheng; Tzu-Han,7,0,63,56
1656034623260,COGS 17,A01,092677,Semenuks; Arturs,8,7,81,73
1656034629288,COGS 100,A01,083619,Allen; Michael Gordon,3,2,70,67
1656034635309,COGS 101A,A01,083621,Davis; Joshua Daniel,4,3,68,64
1656034641340,COGS 101B,A01,091572,Allen; Michael Gordon,0,0,65,65
1656034647362,COGS 101C,A01,083625,Delgado; Tania,7,0,35,28
1656034653385,COGS 107A,A01,083627,Boyle; Mary E. T.,1,2,60,59
1656034659409,COGS 118A,A01,083075,Gupta; Anjum,21,16,76,55
1656034665434,CSE 3,A50,083646,Miranda; Gregory Joseph,14,0,50,36
1656034671460,CSE 8A,A50,083650,Miranda; Gregory Joseph,4,11,56,52
1656034677484,CSE 11,A01,083080,Cao; Yingjun,0,65,40,40
1656034683512,CSE 12,A01,083652,Krause-Levy; Sophia Louisa,7,8,120,113
1656034689534,CSE 15L,A01,083654,Morris; Justin Loren,3,1,50,47
1656034689534,CSE 15L,A02,083655,Morris; Justin Loren,2,1,50,48
1656034695555,CSE 20,A01,083657,Tran; Khoa Dang,29,0,80,51
1656034701582,CSE 21,A01,095574,Bach; Quang Tran,23,0,48,25
1656034707617,CSE 30,A01,083084,Eldon; John,2,10,80,78
1656034707617,CSE 30,B01,095061,Bhaskar; Nishant,2,5,50,48
1656034713640,CSE 100,A01,083659,Cao; Yingjun,2,25,70,68
1656034719666,CSE 134B,A01,083661,Powell; Thomas Allan,6,6,100,94
1656034725689,CSE 140,A01,083663,Gungor; Onat,5,0,85,80
1656034731713,CSE 140L,A01,083088,Eldon; John,5,0,100,95
1656034737736,CSE 175,A01,083665,Kumar; Rakesh,0,0,25,25
1656034743762,CSE 190,A00,092507,Dubnov; Shlomo,1,0,20,19
1656034749793,ECE 45,A01,083139,Congero; Spencer William,1,1,75,74
1656034755819,ECE 65,A50,083695,Saad; Andrew S,6,0,30,24
1656034755819,ECE 65,A51,095125,Staff,23,0,26,3
1656034761843,ECE 109,A01,091882,Touri; Behrouz,3,5,70,67
1656034767867,ECE 180,A00,083140,Abi Samra; Nicholas Camill,1,0,30,29
1656034767867,ECE 180,B00,083141,Abi Samra; Nicholas Camill,0,8,28,28
1656034773890,MATH 10A,A01,083735,Patchell; Gregory David,0,0,30,30
1656034773890,MATH 10A,A02,083736,Patchell; Gregory David,20,0,30,10
1656034773890,MATH 10A,A03,083737,Patchell; Gregory David,16,0,30,14
1656034779916,MATH 10B,A01,083207,Lim; Seonhee,1,1,34,33
1656034779916,MATH 10B,A02,083208,Lim; Seonhee,1,1,35,34
1656034779916,MATH 10B,A03,093472,Staff,0,0,34,34
1656034779916,MATH 10B,B01,083739,Sinha; Shubham,10,0,30,20
1656034785940,MATH 18,A01,083743,Cinel; Cameron Alexander,5,0,30,25
1656034785940,MATH 18,A02,083744,Cinel; Cameron Alexander,11,0,30,19
1656034785940,MATH 18,A03,083745,Cinel; Cameron Alexander,1,0,30,29
1656034785940,MATH 18,B01,083748,Ma; Zilu,0,0,36,36
1656034785940,MATH 18,B02,083749,Ma; Zilu,0,0,36,36
1656034785940,MATH 18,B03,083750,Ma; Zilu,0,0,36,36
1656034785940,MATH 18,B04,083751,Ma; Zilu,0,0,36,36
1656034785940,MATH 18,B05,093473,Staff,0,0,36,36
1656034785940,MATH 18,B06,093474,Staff,3,0,36,33
1656034791966,MATH 20A,A01,083754,Zheng; Zequn,11,0,40,29
1656034797993,MATH 20B,A01,083756,Briones; Jor-el Thomas Caparas,0,0,36,36
1656034797993,MATH 20B,A02,083757,Briones; Jor-el Thomas Caparas,1,0,36,35
1656034797993,MATH 20B,A03,093475,Staff,0,0,36,36
1656034804033,MATH 20C,A01,083760,Briones; Jor-el Thomas Caparas,0,2,35,35
1656034804033,MATH 20C,A02,083761,Briones; Jor-el Thomas Caparas,6,1,35,29
1656034804033,MATH 20C,A03,093476,Staff,0,1,35,35
1656034804033,MATH 20C,B01,083762,Bach; Quang Tran,3,0,30,27
1656034810060,MATH 20D,A01,083765,Tran; Brian Kha,2,0,30,28
1656034810060,MATH 20D,A02,083766,Tran; Brian Kha,0,1,30,30
1656034810060,MATH 20D,A03,083767,Tran; Brian Kha,0,0,30,30
1656034816089,MATH 20E,A01,083771,Ganguly; Soumya,0,1,32,32
1656034816089,MATH 20E,A02,083772,Ganguly; Soumya,1,1,32,31
1656034816089,MATH 20E,B01,083773,Ciotti; Benjamin,13,0,35,22
1656034816089,MATH 20E,B02,083774,Ciotti; Benjamin,12,0,35,23
1656034822112,MATH 103A,A01,083777,Greenfeld; Be'Eri,2,1,36,34
1656034822112,MATH 103A,A02,083778,Greenfeld; Be'Eri,1,0,36,35
1656034822112,MATH 103A,A03,093561,Staff,0,1,36,36
1656034822112,MATH 103A,B01,083779,Greenfeld; Be'Eri,8,1,36,28
1656034822112,MATH 103A,B02,083780,Greenfeld; Be'Eri,0,0,36,36
1656034822112,MATH 103A,B03,093562,Staff,0,0,36,36
1656034828134,MATH 105,A01,085443,Carter; Anne Toulson,4,1,35,31
1656034828134,MATH 105,A02,093477,Staff,9,0,35,26
1656034834161,MATH 109,A01,083213,Ganzberger; Geoffrey Michael,0,1,34,34
1656034834161,MATH 109,A02,083214,Ganzberger; Geoffrey Michael,0,0,34,34
1656034834161,MATH 109,A03,093478,Staff,1,0,34,33
1656034834161,MATH 109,B01,083215,Ganzberger; Geoffrey Michael,2,0,32,30
1656034834161,MATH 109,B02,083216,Ganzberger; Geoffrey Michael,0,0,32,32
1656034834161,MATH 109,B03,093479,Staff,3,0,32,29
1656034840186,MATH 142A,A01,083219,Chow; Bennett,1,0,32,31
1656034840186,MATH 142A,A02,083220,Chow; Bennett,7,0,32,25
1656034840186,MATH 142A,A03,093480,Staff,4,0,32,28
1656034840186,MATH 142A,B03,093481,Staff,3,0,32,29
1656034840186,MATH 142A,B04,093558,Staff,5,0,32,27
1656034840186,MATH 142A,B05,093559,Staff,0,0,32,32
1656034846217,MATH 193A,A01,083224,Rotar; Vladimir,1,2,34,33
1656034846217,MATH 193A,A02,083225,Rotar; Vladimir,0,0,34,34
1656034846217,MATH 193A,A03,083781,Rotar; Vladimir,1,0,34,33
1656034846217,MATH 193A,A04,083782,Rotar; Vladimir,3,0,34,31
1656034846217,MATH 193A,A05,093482,Rotar; Vladimir,0,0,34,34
1656034852242,MATH 197,001,091859,McAuley; Julian John,9999,0,9999,0
1656034852242,MATH 197,002,095566,Kedlaya; Kiran S.,9997,0,9999,2
1656034852242,MATH 197,003,095567,Xiao; Ming,9999,0,9999,0
1656034852242,MATH 197,004,095571,Perols; Johan Lars,9998,0,9999,1
1656034859309,COGS 9,A01,083615,Shannon; Kyle Michael,3,1,75,72
1656034865332,COGS 11,A01,083617,Boyle; Mary E. T.,11,2,48,37
1656034871361,COGS 13,A01,083071,Bastos; Amalia Pinkusfeld,4,3,71,67
1656034877384,COGS 14A,A01,092681,Semenuks; Arturs,4,25,100,96
1656034883416,COGS 14B,A01,083073,Cheng; Tzu-Han,7,0,63,56
1656034889440,COGS 17,A01,092677,Semenuks; Arturs,8,7,81,73
1656034895464,COGS 100,A01,083619,Allen; Michael Gordon,3,2,70,67
1656034901489,COGS 101A,A01,083621,Davis; Joshua Daniel,4,3,68,64
1656034907516,COGS 101B,A01,091572,Allen; Michael Gordon,0,0,65,65
1656034913539,COGS 101C,A01,083625,Delgado; Tania,7,0,35,28
1656034919562,COGS 107A,A01,083627,Boyle; Mary E. T.,1,2,60,59
1656034925585,COGS 118A,A01,083075,Gupta; Anjum,21,16,76,55
1656034931609,CSE 3,A50,083646,Miranda; Gregory Joseph,14,0,50,36
1656034937637,CSE 8A,A50,083650,Miranda; Gregory Joseph,4,11,56,52
1656034943669,CSE 11,A01,083080,Cao; Yingjun,0,65,40,40
1656034949695,CSE 12,A01,083652,Krause-Levy; Sophia Louisa,7,8,120,113
1656034955738,CSE 15L,A01,083654,Morris; Justin Loren,3,1,50,47
1656034955738,CSE 15L,A02,083655,Morris; Justin Loren,2,1,50,48
1656034961765,CSE 20,A01,083657,Tran; Khoa Dang,29,0,80,51
1656034967792,CSE 21,A01,095574,Bach; Quang Tran,23,0,48,25
1656034973817,CSE 30,A01,083084,Eldon; John,2,10,80,78
1656034973817,CSE 30,B01,095061,Bhaskar; Nishant,2,5,50,48
1656034979841,CSE 100,A01,083659,Cao; Yingjun,2,25,70,68
1656034985870,CSE 134B,A01,083661,Powell; Thomas Allan,6,6,100,94
1656034991899,CSE 140,A01,083663,Gungor; Onat,5,0,85,80
1656034997925,CSE 140L,A01,083088,Eldon; John,5,0,100,95
1656035003949,CSE 175,A01,083665,Kumar; Rakesh,0,0,25,25
1656035009973,CSE 190,A00,092507,Dubnov; Shlomo,1,0,20,19
1656035015996,ECE 45,A01,083139,Congero; Spencer William,1,1,75,74
1656035022020,ECE 65,A50,083695,Saad; Andrew S,6,0,30,24
1656035022020,ECE 65,A51,095125,Staff,23,0,26,3
1656035028046,ECE 109,A01,091882,Touri; Behrouz,3,5,70,67
1656035034068,ECE 180,A00,083140,Abi Samra; Nicholas Camill,1,0,30,29
1656035034068,ECE 180,B00,083141,Abi Samra; Nicholas Camill,0,8,28,28
1656035040092,MATH 10A,A01,083735,Patchell; Gregory David,0,0,30,30
1656035040092,MATH 10A,A02,083736,Patchell; Gregory David,20,0,30,10
1656035040092,MATH 10A,A03,083737,Patchell; Gregory David,16,0,30,14
1656035046116,MATH 10B,A01,083207,Lim; Seonhee,1,1,34,33
1656035046116,MATH 10B,A02,083208,Lim; Seonhee,1,1,35,34
1656035046116,MATH 10B,A03,093472,Staff,0,0,34,34
1656035046116,MATH 10B,B01,083739,Sinha; Shubham,10,0,30,20
1656035052140,MATH 18,A01,083743,Cinel; Cameron Alexander,5,0,30,25
1656035052140,MATH 18,A02,083744,Cinel; Cameron Alexander,11,0,30,19
1656035052140,MATH 18,A03,083745,Cinel; Cameron Alexander,1,0,30,29
1656035052140,MATH 18,B01,083748,Ma; Zilu,0,0,36,36
1656035052140,MATH 18,B02,083749,Ma; Zilu,0,0,36,36
1656035052140,MATH 18,B03,083750,Ma; Zilu,0,0,36,36
1656035052140,MATH 18,B04,083751,Ma; Zilu,0,0,36,36
1656035052140,MATH 18,B05,093473,Staff,0,0,36,36
1656035052140,MATH 18,B06,093474,Staff,3,0,36,33
1656035058165,MATH 20A,A01,083754,Zheng; Zequn,11,0,40,29
1656035064191,MATH 20B,A01,083756,Briones; Jor-el Thomas Caparas,0,0,36,36
1656035064191,MATH 20B,A02,083757,Briones; Jor-el Thomas Caparas,1,0,36,35
1656035064191,MATH 20B,A03,093475,Staff,0,0,36,36
1656035070216,MATH 20C,A01,083760,Briones; Jor-el Thomas Caparas,0,2,35,35
1656035070216,MATH 20C,A02,083761,Briones; Jor-el Thomas Caparas,6,1,35,29
1656035070216,MATH 20C,A03,093476,Staff,0,1,35,35
1656035070216,MATH 20C,B01,083762,Bach; Quang Tran,3,0,30,27
1656035076244,MATH 20D,A01,083765,Tran; Brian Kha,2,0,30,28
1656035076244,MATH 20D,A02,083766,Tran; Brian Kha,0,1,30,30
1656035076244,MATH 20D,A03,083767,Tran; Brian Kha,0,0,30,30
1656035082274,MATH 20E,A01,083771,Ganguly; Soumya,0,1,32,32
1656035082274,MATH 20E,A02,083772,Ganguly; Soumya,1,1,32,31
1656035082274,MATH 20E,B01,083773,Ciotti; Benjamin,13,0,35,22
1656035082274,MATH 20E,B02,083774,Ciotti; Benjamin,12,0,35,23
1656035088304,MATH 103A,A01,083777,Greenfeld; Be'Eri,2,1,36,34
1656035088304,MATH 103A,A02,083778,Greenfeld; Be'Eri,1,0,36,35
1656035088304,MATH 103A,A03,093561,Staff,0,1,36,36
1656035088304,MATH 103A,B01,083779,Greenfeld; Be'Eri,8,1,36,28
1656035088304,MATH 103A,B02,083780,Greenfeld; Be'Eri,0,0,36,36
1656035088304,MATH 103A,B03,093562,Staff,0,0,36,36
1656035094327,MATH 105,A01,085443,Carter; Anne Toulson,4,1,35,31
1656035094327,MATH 105,A02,093477,Staff,9,0,35,26
1656035100353,MATH 109,A01,083213,Ganzberger; Geoffrey Michael,0,1,34,34
1656035100353,MATH 109,A02,083214,Ganzberger; Geoffrey Michael,0,0,34,34
1656035100353,MATH 109,A03,093478,Staff,1,0,34,33
1656035100353,MATH 109,B01,083215,Ganzberger; Geoffrey Michael,2,0,32,30
1656035100353,MATH 109,B02,083216,Ganzberger; Geoffrey Michael,0,0,32,32
1656035100353,MATH 109,B03,093479,Staff,3,0,32,29
1656035106381,MATH 142A,A01,083219,Chow; Bennett,1,0,32,31
1656035106381,MATH 142A,A02,083220,Chow; Bennett,7,0,32,25
1656035106381,MATH 142A,A03,093480,Staff,4,0,32,28
1656035106381,MATH 142A,B03,093481,Staff,3,0,32,29
1656035106381,MATH 142A,B04,093558,Staff,5,0,32,27
1656035106381,MATH 142A,B05,093559,Staff,0,0,32,32
1656035112519,MATH 193A,A01,083224,Rotar; Vladimir,1,2,34,33
1656035112519,MATH 193A,A02,083225,Rotar; Vladimir,0,0,34,34
1656035112519,MATH 193A,A03,083781,Rotar; Vladimir,1,0,34,33
1656035112519,MATH 193A,A04,083782,Rotar; Vladimir,3,0,34,31
1656035112519,MATH 193A,A05,093482,Rotar; Vladimir,0,0,34,34
1656035118543,MATH 197,001,091859,McAuley; Julian John,9999,0,9999,0
1656035118543,MATH 197,002,095566,Kedlaya; Kiran S.,9997,0,9999,2
1656035118543,MATH 197,003,095567,Xiao; Ming,9999,0,9999,0
1656035118543,MATH 197,004,095571,Perols; Johan Lars,9998,0,9999,1
1656035125598,COGS 9,A01,083615,Shannon; Kyle Michael,3,1,75,72
1656035131624,COGS 11,A01,083617,Boyle; Mary E. T.,11,2,48,37
1656035137645,COGS 13,A01,083071,Bastos; Amalia Pinkusfeld,4,3,71,67
1656035143668,COGS 14A,A01,092681,Semenuks; Arturs,4,25,100,96
1656035149696,COGS 14B,A01,083073,Cheng; Tzu-Han,7,0,63,56
1656035155721,COGS 17,A01,092677,Semenuks; Arturs,8,7,81,73
1656035161748,COGS 100,A01,083619,Allen; Michael Gordon,3,2,70,67
1656035167772,COGS 101A,A01,083621,Davis; Joshua Daniel,4,3,68,64
1656035173799,COGS 101B,A01,091572,Allen; Michael Gordon,0,0,65,65
1656035179825,COGS 101C,A01,083625,Delgado; Tania,7,0,35,28
1656035185847,COGS 107A,A01,083627,Boyle; Mary E. T.,1,2,60,59
1656035191870,COGS 118A,A01,083075,Gupta; Anjum,21,16,76,55
1656035197927,CSE 3,A50,083646,Miranda; Gregory Joseph,14,0,50,36
1656035203952,CSE 8A,A50,083650,Miranda; Gregory Joseph,4,11,56,52
1656035209974,CSE 11,A01,083080,Cao; Yingjun,0,65,40,40
1656035216000,CSE 12,A01,083652,Krause-Levy; Sophia Louisa,7,8,120,113
1656035222026,CSE 15L,A01,083654,Morris; Justin Loren,3,1,50,47
1656035222026,CSE 15L,A02,083655,Morris; Justin Loren,2,1,50,48
1656035228049,CSE 20,A01,083657,Tran; Khoa Dang,29,0,80,51
1656035234075,CSE 21,A01,095574,Bach; Quang Tran,23,0,48,25
1656035240102,CSE 30,A01,083084,Eldon; John,2,10,80,78
1656035240102,CSE 30,B01,095061,Bhaskar; Nishant,2,5,50,48
1656035246128,CSE 100,A01,083659,Cao; Yingjun,2,25,70,68
1656035252152,CSE 134B,A01,083661,Powell; Thomas Allan,6,6,100,94
1656035258176,CSE 140,A01,083663,Gungor; Onat,5,0,85,80
1656035264198,CSE 140L,A01,083088,Eldon; John,5,0,100,95
1656035270220,CSE 175,A01,083665,Kumar; Rakesh,0,0,25,25
1656035276244,CSE 190,A00,092507,Dubnov; Shlomo,1,0,20,19
1656035282270,ECE 45,A01,083139,Congero; Spencer William,1,1,75,74
1656035288294,ECE 65,A50,083695,Saad; Andrew S,6,0,30,24
1656035288294,ECE 65,A51,095125,Staff,23,0,26,3
1656035294318,ECE 109,A01,091882,Touri; Behrouz,3,5,70,67
1656035300341,ECE 180,A00,083140,Abi Samra; Nicholas Camill,1,0,30,29
1656035300341,ECE 180,B00,083141,Abi Samra; Nicholas Camill,0,8,28,28
1656035306365,MATH 10A,A01,083735,Patchell; Gregory David,0,0,30,30
1656035306365,MATH 10A,A02,083736,Patchell; Gregory David,20,0,30,10
1656035306365,MATH 10A,A03,083737,Patchell; Gregory David,16,0,30,14
1656035312393,MATH 10B,A01,083207,Lim; Seonhee,1,1,34,33
1656035312393,MATH 10B,A02,083208,Lim; Seonhee,1,1,35,34
1656035312393,MATH 10B,A03,093472,Staff,0,1,34,34
1656035312393,MATH 10B,B01,083739,Sinha; Shubham,10,0,30,20
1656035318417,MATH 18,A01,083743,Cinel; Cameron Alexander,5,0,30,25
1656035318417,MATH 18,A02,083744,Cinel; Cameron Alexander,11,0,30,19
1656035318417,MATH 18,A03,083745,Cinel; Cameron Alexander,1,0,30,29
1656035318417,MATH 18,B01,083748,Ma; Zilu,0,0,36,36
1656035318417,MATH 18,B02,083749,Ma; Zilu,0,0,36,36
1656035318417,MATH 18,B03,083750,Ma; Zilu,0,0,36,36
1656035318417,MATH 18,B04,083751,Ma; Zilu,0,0,36,36
1656035318417,MATH 18,B05,093473,Staff,0,0,36,36
1656035318417,MATH 18,B06,093474,Staff,3,0,36,33
1656035324439,MATH 20A,A01,083754,Zheng; Zequn,11,0,40,29
1656035330466,MATH 20B,A01,083756,Briones; Jor-el Thomas Caparas,0,0,36,36
1656035330466,MATH 20B,A02,083757,Briones; Jor-el Thomas Caparas,1,0,36,35
1656035330466,MATH 20B,A03,093475,Staff,0,0,36,36
1656035336495,MATH 20C,A01,083760,Briones; Jor-el Thomas Caparas,0,2,35,35
1656035336495,MATH 20C,A02,083761,Briones; Jor-el Thomas Caparas,6,1,35,29
1656035336495,MATH 20C,A03,093476,Staff,0,1,35,35
1656035336495,MATH 20C,B01,083762,Bach; Quang Tran,3,0,30,27
1656035342517,MATH 20D,A01,083765,Tran; Brian Kha,2,0,30,28
1656035342517,MATH 20D,A02,083766,Tran; Brian Kha,0,1,30,30
1656035342517,MATH 20D,A03,083767,Tran; Brian Kha,0,0,30,30
1656035348542,MATH 20E,A01,083771,Ganguly; Soumya,0,1,32,32
1656035348542,MATH 20E,A02,083772,Ganguly; Soumya,1,1,32,31
1656035348542,MATH 20E,B01,083773,Ciotti; Benjamin,13,0,35,22
1656035348542,MATH 20E,B02,083774,Ciotti; Benjamin,12,0,35,23
1656035354566,MATH 103A,A01,083777,Greenfeld; Be'Eri,2,1,36,34
1656035354566,MATH 103A,A02,083778,Greenfeld; Be'Eri,1,0,36,35
1656035354566,MATH 103A,A03,093561,Staff,0,1,36,36
1656035354566,MATH 103A,B01,083779,Greenfeld; Be'Eri,8,1,36,28
1656035354566,MATH 103A,B02,083780,Greenfeld; Be'Eri,0,0,36,36
1656035354566,MATH 103A,B03,093562,Staff,0,0,36,36
1656035360590,MATH 105,A01,085443,Carter; Anne Toulson,4,1,35,31
1656035360590,MATH 105,A02,093477,Staff,9,0,35,26
1656035366613,MATH 109,A01,083213,Ganzberger; Geoffrey Michael,0,1,34,34
1656035366613,MATH 109,A02,083214,Ganzberger; Geoffrey Michael,0,0,34,34
1656035366613,MATH 109,A03,093478,Staff,1,0,34,33
1656035366613,MATH 109,B01,083215,Ganzberger; Geoffrey Michael,2,0,32,30
1656035366613,MATH 109,B02,083216,Ganzberger; Geoffrey Michael,0,0,32,32
1656035366613,MATH 109,B03,093479,Staff,3,0,32,29
1656035372643,MATH 142A,A01,083219,Chow; Bennett,1,0,32,31
1656035372643,MATH 142A,A02,083220,Chow; Bennett,7,0,32,25
1656035372643,MATH 142A,A03,093480,Staff,4,0,32,28
1656035372643,MATH 142A,B03,093481,Staff,3,0,32,29
1656035372643,MATH 142A,B04,093558,Staff,5,0,32,27
1656035372643,MATH 142A,B05,093559,Staff,0,0,32,32
1656035378667,MATH 193A,A01,083224,Rotar; Vladimir,1,2,34,33
1656035378667,MATH 193A,A02,083225,Rotar; Vladimir,0,0,34,34
1656035378667,MATH 193A,A03,083781,Rotar; Vladimir,1,0,34,33
1656035378667,MATH 193A,A04,083782,Rotar; Vladimir,3,0,34,31
1656035378667,MATH 193A,A05,093482,Rotar; Vladimir,0,0,34,34
1656035384688,MATH 197,001,091859,McAuley; Julian John,9999,0,9999,0
1656035384688,MATH 197,002,095566,Kedlaya; Kiran S.,9997,0,9999,2
1656035384688,MATH 197,003,095567,Xiao; Ming,9999,0,9999,0
1656035384688,MATH 197,004,095571,Perols; Johan Lars,9998,0,9999,1
1656035391741,COGS 9,A01,083615,Shannon; Kyle Michael,3,1,75,72
1656035397767,COGS 11,A01,083617,Boyle; Mary E. T.,11,2,48,37
1656035403791,COGS 13,A01,083071,Bastos; Amalia Pinkusfeld,4,3,71,67
1656035409814,COGS 14A,A01,092681,Semenuks; Arturs,4,25,100,96
1656035415836,COGS 14B,A01,083073,Cheng; Tzu-Han,7,0,63,56
1656035421859,COGS 17,A01,092677,Semenuks; Arturs,8,7,81,73
1656035427881,COGS 100,A01,083619,Allen; Michael Gordon,3,2,70,67
1656035433911,COGS 101A,A01,083621,Davis; Joshua Daniel,4,3,68,64
1656035439943,COGS 101B,A01,091572,Allen; Michael Gordon,0,0,65,65
1656035445966,COGS 101C,A01,083625,Delgado; Tania,7,0,35,28
1656035451989,COGS 107A,A01,083627,Boyle; Mary E. T.,1,2,60,59
1656035458024,COGS 118A,A01,083075,Gupta; Anjum,21,16,76,55
1656035464047,CSE 3,A50,083646,Miranda; Gregory Joseph,14,0,50,36
1656035470071,CSE 8A,A50,083650,Miranda; Gregory Joseph,4,11,56,52
1656035476093,CSE 11,A01,083080,Cao; Yingjun,0,65,40,40
1656035482121,CSE 12,A01,083652,Krause-Levy; Sophia Louisa,7,8,120,113
1656035488144,CSE 15L,A01,083654,Morris; Justin Loren,3,1,50,47
1656035488144,CSE 15L,A02,083655,Morris; Justin Loren,2,1,50,48
1656035494172,CSE 20,A01,083657,Tran; Khoa Dang,29,0,80,51
1656035500194,CSE 21,A01,095574,Bach; Quang Tran,23,0,48,25
1656035506223,CSE 30,A01,083084,Eldon; John,2,10,80,78
1656035506223,CSE 30,B01,095061,Bhaskar; Nishant,2,5,50,48
1656035512245,CSE 100,A01,083659,Cao; Yingjun,2,25,70,68
1656035518268,CSE 134B,A01,083661,Powell; Thomas Allan,6,6,100,94
1656035524295,CSE 140,A01,083663,Gungor; Onat,5,0,85,80
1656035530321,CSE 140L,A01,083088,Eldon; John,5,0,100,95
1656035536349,CSE 175,A01,083665,Kumar; Rakesh,0,0,25,25
1656035542375,CSE 190,A00,092507,Dubnov; Shlomo,1,0,20,19
1656035548396,ECE 45,A01,083139,Congero; Spencer William,1,1,75,74
1656035554420,ECE 65,A50,083695,Saad; Andrew S,6,0,30,24
1656035554420,ECE 65,A51,095125,Staff,23,0,26,3
1656035560445,ECE 109,A01,091882,Touri; Behrouz,3,5,70,67
1656035566470,ECE 180,A00,083140,Abi Samra; Nicholas Camill,1,0,30,29
1656035566470,ECE 180,B00,083141,Abi Samra; Nicholas Camill,0,8,28,28
1656035572497,MATH 10A,A01,083735,Patchell; Gregory David,0,0,30,30
1656035572497,MATH 10A,A02,083736,Patchell; Gregory David,20,0,30,10
1656035572497,MATH 10A,A03,083737,Patchell; Gregory David,16,0,30,14
1656035578523,MATH 10B,A01,083207,Lim; Seonhee,1,1,34,33
1656035578523,MATH 10B,A02,083208,Lim; Seonhee,1,1,35,34
1656035578523,MATH 10B,A03,093472,Staff,0,1,34,34
1656035578523,MATH 10B,B01,083739,Sinha; Shubham,10,0,30,20
1656035584555,MATH 18,A01,083743,Cinel; Cameron Alexander,5,0,30,25
1656035584555,MATH 18,A02,083744,Cinel; Cameron Alexander,11,0,30,19
1656035584555,MATH 18,A03,083745,Cinel; Cameron Alexander,1,0,30,29
1656035584555,MATH 18,B01,083748,Ma; Zilu,0,0,36,36
1656035584555,MATH 18,B02,083749,Ma; Zilu,0,0,36,36
1656035584555,MATH 18,B03,083750,Ma; Zilu,0,0,36,36
1656035584555,MATH 18,B04,083751,Ma; Zilu,0,0,36,36
1656035584555,MATH 18,B05,093473,Staff,0,0,36,36
1656035584555,MATH 18,B06,093474,Staff,3,0,36,33
1656035590587,MATH 20A,A01,083754,Zheng; Zequn,11,0,40,29
1656035596609,MATH 20B,A01,083756,Briones; Jor-el Thomas Caparas,0,0,36,36
1656035596609,MATH 20B,A02,083757,Briones; Jor-el Thomas Caparas,1,0,36,35
1656035596609,MATH 20B,A03,093475,Staff,0,0,36,36
1656035602638,MATH 20C,A01,083760,Briones; Jor-el Thomas Caparas,0,2,35,35
1656035602638,MATH 20C,A02,083761,Briones; Jor-el Thomas Caparas,6,1,35,29
1656035602638,MATH 20C,A03,093476,Staff,0,1,35,35
1656035602638,MATH 20C,B01,083762,Bach; Quang Tran,3,0,30,27
1656035608660,MATH 20D,A01,083765,Tran; Brian Kha,2,0,30,28
1656035608660,MATH 20D,A02,083766,Tran; Brian Kha,0,1,30,30
1656035608660,MATH 20D,A03,083767,Tran; Brian Kha,0,0,30,30
1656035614682,MATH 20E,A01,083771,Ganguly; Soumya,0,1,32,32
1656035614682,MATH 20E,A02,083772,Ganguly; Soumya,1,1,32,31
1656035614682,MATH 20E,B01,083773,Ciotti; Benjamin,13,0,35,22
1656035614682,MATH 20E,B02,083774,Ciotti; Benjamin,12,0,35,23
1656035620712,MATH 103A,A01,083777,Greenfeld; Be'Eri,2,1,36,34
1656035620712,MATH 103A,A02,083778,Greenfeld; Be'Eri,1,0,36,35
1656035620712,MATH 103A,A03,093561,Staff,0,1,36,36
1656035620712,MATH 103A,B01,083779,Greenfeld; Be'Eri,8,1,36,28
1656035620712,MATH 103A,B02,083780,Greenfeld; Be'Eri,0,0,36,36
1656035620712,MATH 103A,B03,093562,Staff,0,0,36,36
1656035626736,MATH 105,A01,085443,Carter; Anne Toulson,4,1,35,31
1656035626736,MATH 105,A02,093477,Staff,9,0,35,26
1656035632761,MATH 109,A01,083213,Ganzberger; Geoffrey Michael,0,1,34,34
1656035632761,MATH 109,A02,083214,Ganzberger; Geoffrey Michael,0,0,34,34
1656035632761,MATH 109,A03,093478,Staff,1,0,34,33
1656035632761,MATH 109,B01,083215,Ganzberger; Geoffrey Michael,2,0,32,30
1656035632761,MATH 109,B02,083216,Ganzberger; Geoffrey Michael,0,0,32,32
1656035632761,MATH 109,B03,093479,Staff,3,0,32,29
1656035638790,MATH 142A,A01,083219,Chow; Bennett,1,0,32,31
1656035638790,MATH 142A,A02,083220,Chow; Bennett,7,0,32,25
1656035638790,MATH 142A,A03,093480,Staff,4,0,32,28
1656035638790,MATH 142A,B03,093481,Staff,3,0,32,29
1656035638790,MATH 142A,B04,093558,Staff,5,0,32,27
1656035638790,MATH 142A,B05,093559,Staff,0,0,32,32
1656035644813,MATH 193A,A01,083224,Rotar; Vladimir,1,2,34,33
1656035644813,MATH 193A,A02,083225,Rotar; Vladimir,0,0,34,34
1656035644813,MATH 193A,A03,083781,Rotar; Vladimir,1,0,34,33
1656035644813,MATH 193A,A04,083782,Rotar; Vladimir,3,0,34,31
1656035644813,MATH 193A,A05,093482,Rotar; Vladimir,0,0,34,34
1656035650836,MATH 197,001,091859,McAuley; Julian John,9999,0,9999,0
1656035650836,MATH 197,002,095566,Kedlaya; Kiran S.,9997,0,9999,2
1656035650836,MATH 197,003,095567,Xiao; Ming,9999,0,9999,0
1656035650836,MATH 197,004,095571,Perols; Johan Lars,9998,0,9999,1
1656035657891,COGS 9,A01,083615,Shannon; Kyle Michael,3,1,75,72
1656035663913,COGS 11,A01,083617,Boyle; Mary E. T.,11,2,48,37
1656035669936,COGS 13,A01,083071,Bastos; Amalia Pinkusfeld,4,3,71,67
1656035675960,COGS 14A,A01,092681,Semenuks; Arturs,4,25,100,96
1656035681983,COGS 14B,A01,083073,Cheng; Tzu-Han,7,0,63,56
1656035688006,COGS 17,A01,092677,Semenuks; Arturs,8,7,81,73
1656035694028,COGS 100,A01,083619,Allen; Michael Gordon,3,2,70,67
1656035700051,COGS 101A,A01,083621,Davis; Joshua Daniel,4,3,68,64
1656035706159,COGS 101B,A01,091572,Allen; Michael Gordon,0,0,65,65
1656035712182,COGS 101C,A01,083625,Delgado; Tania,7,0,35,28
1656035718206,COGS 107A,A01,083627,Boyle; Mary E. T.,1,2,60,59
1656035724228,COGS 118A,A01,083075,Gupta; Anjum,21,16,76,55
1656035730254,CSE 3,A50,083646,Miranda; Gregory Joseph,14,0,50,36
1656035736277,CSE 8A,A50,083650,Miranda; Gregory Joseph,4,11,56,52
1656035742303,CSE 11,A01,083080,Cao; Yingjun,0,65,40,40
1656035748328,CSE 12,A01,083652,Krause-Levy; Sophia Louisa,7,8,120,113
1656035754354,CSE 15L,A01,083654,Morris; Justin Loren,3,1,50,47
1656035754354,CSE 15L,A02,083655,Morris; Justin Loren,2,1,50,48
1656035760381,CSE 20,A01,083657,Tran; Khoa Dang,29,0,80,51
1656035766413,CSE 21,A01,095574,Bach; Quang Tran,23,0,48,25
1656035772441,CSE 30,A01,083084,Eldon; John,2,10,80,78
1656035772441,CSE 30,B01,095061,Bhaskar; Nishant,2,5,50,48
1656035778467,CSE 100,A01,083659,Cao; Yingjun,2,25,70,68
1656035784490,CSE 134B,A01,083661,Powell; Thomas Allan,6,6,100,94
1656035790514,CSE 140,A01,083663,Gungor; Onat,5,0,85,80
1656035796540,CSE 140L,A01,083088,Eldon; John,5,0,100,95
1656035802564,CSE 175,A01,083665,Kumar; Rakesh,0,0,25,25
1656035808589,CSE 190,A00,092507,Dubnov; Shlomo,1,0,20,19
1656035814615,ECE 45,A01,083139,Congero; Spencer William,1,1,75,74
1656035820642,ECE 65,A50,083695,Saad; Andrew S,6,0,30,24
1656035820642,ECE 65,A51,095125,Staff,23,0,26,3
1656035826668,ECE 109,A01,091882,Touri; Behrouz,3,5,70,67
1656035832691,ECE 180,A00,083140,Abi Samra; Nicholas Camill,1,0,30,29
1656035832691,ECE 180,B00,083141,Abi Samra; Nicholas Camill,0,8,28,28
1656035838718,MATH 10A,A01,083735,Patchell; Gregory David,0,0,30,30
1656035838718,MATH 10A,A02,083736,Patchell; Gregory David,20,0,30,10
1656035838718,MATH 10A,A03,083737,Patchell; Gregory David,16,0,30,14
1656035844743,MATH 10B,A01,083207,Lim; Seonhee,1,1,34,33
1656035844743,MATH 10B,A02,083208,Lim; Seonhee,1,1,35,34
1656035844743,MATH 10B,A03,093472,Staff,0,1,34,34
1656035844743,MATH 10B,B01,083739,Sinha; Shubham,10,0,30,20
1656035850767,MATH 18,A01,083743,Cinel; Cameron Alexander,5,0,30,25
1656035850767,MATH 18,A02,083744,Cinel; Cameron Alexander,11,0,30,19
1656035850767,MATH 18,A03,083745,Cinel; Cameron Alexander,1,0,30,29
1656035850767,MATH 18,B01,083748,Ma; Zilu,0,0,36,36
1656035850767,MATH 18,B02,083749,Ma; Zilu,0,0,36,36
1656035850767,MATH 18,B03,083750,Ma; Zilu,0,0,36,36
1656035850767,MATH 18,B04,083751,Ma; Zilu,0,0,36,36
1656035850767,MATH 18,B05,093473,Staff,0,0,36,36
1656035850767,MATH 18,B06,093474,Staff,3,0,36,33
1656035856791,MATH 20A,A01,083754,Zheng; Zequn,11,0,40,29
1656035862815,MATH 20B,A01,083756,Briones; Jor-el Thomas Caparas,0,0,36,36
1656035862815,MATH 20B,A02,083757,Briones; Jor-el Thomas Caparas,1,0,36,35
1656035862815,MATH 20B,A03,093475,Staff,0,0,36,36
1656035868839,MATH 20C,A01,083760,Briones; Jor-el Thomas Caparas,0,2,35,35
1656035868839,MATH 20C,A02,083761,Briones; Jor-el Thomas Caparas,6,1,35,29
1656035868839,MATH 20C,A03,093476,Staff,0,1,35,35
1656035868839,MATH 20C,B01,083762,Bach; Quang Tran,3,0,30,27
1656035874866,MATH 20D,A01,083765,Tran; Brian Kha,2,0,30,28
1656035874866,MATH 20D,A02,083766,Tran; Brian Kha,0,1,30,30
1656035874866,MATH 20D,A03,083767,Tran; Brian Kha,0,0,30,30
1656035880895,MATH 20E,A01,083771,Ganguly; Soumya,0,1,32,32
1656035880895,MATH 20E,A02,083772,Ganguly; Soumya,1,1,32,31
1656035880895,MATH 20E,B01,083773,Ciotti; Benjamin,13,0,35,22
1656035880895,MATH 20E,B02,083774,Ciotti; Benjamin,12,0,35,23
1656035886930,MATH 103A,A01,083777,Greenfeld; Be'Eri,2,1,36,34
1656035886930,MATH 103A,A02,083778,Greenfeld; Be'Eri,1,0,36,35
1656035886930,MATH 103A,A03,093561,Staff,0,1,36,36
1656035886930,MATH 103A,B01,083779,Greenfeld; Be'Eri,8,1,36,28
1656035886930,MATH 103A,B02,083780,Greenfeld; Be'Eri,0,0,36,36
1656035886930,MATH 103A,B03,093562,Staff,0,0,36,36
1656035892954,MATH 105,A01,085443,Carter; Anne Toulson,4,1,35,31
1656035892954,MATH 105,A02,093477,Staff,9,0,35,26
1656035898978,MATH 109,A01,083213,Ganzberger; Geoffrey Michael,0,1,34,34
1656035898978,MATH 109,A02,083214,Ganzberger; Geoffrey Michael,0,0,34,34
1656035898978,MATH 109,A03,093478,Staff,1,0,34,33
1656035898978,MATH 109,B01,083215,Ganzberger; Geoffrey Michael,2,0,32,30
1656035898978,MATH 109,B02,083216,Ganzberger; Geoffrey Michael,0,0,32,32
1656035898978,MATH 109,B03,093479,Staff,3,0,32,29
1656035905001,MATH 142A,A01,083219,Chow; Bennett,1,0,32,31
1656035905001,MATH 142A,A02,083220,Chow; Bennett,7,0,32,25
1656035905001,MATH 142A,A03,093480,Staff,4,0,32,28
1656035905001,MATH 142A,B03,093481,Staff,3,0,32,29
1656035905001,MATH 142A,B04,093558,Staff,5,0,32,27
1656035905001,MATH 142A,B05,093559,Staff,0,0,32,32
1656035911028,MATH 193A,A01,083224,Rotar; Vladimir,1,2,34,33
1656035911028,MATH 193A,A02,083225,Rotar; Vladimir,0,0,34,34
1656035911028,MATH 193A,A03,083781,Rotar; Vladimir,1,0,34,33
1656035911028,MATH 193A,A04,083782,Rotar; Vladimir,3,0,34,31
1656035911028,MATH 193A,A05,093482,Rotar; Vladimir,0,0,34,34
1656035917053,MATH 197,001,091859,McAuley; Julian John,9999,0,9999,0
1656035917053,MATH 197,002,095566,Kedlaya; Kiran S.,9997,0,9999,2
1656035917053,MATH 197,003,095567,Xiao; Ming,9999,0,9999,0
1656035917053,MATH 197,004,095571,Perols; Johan Lars,9998,0,9999,1
1656035924104,COGS 9,A01,083615,Shannon; Kyle Michael,3,1,75,72
1656035930130,COGS 11,A01,083617,Boyle; Mary E. T.,11,2,48,37
1656035936154,COGS 13,A01,083071,Bastos; Amalia Pinkusfeld,4,3,71,67
1656035942183,COGS 14A,A01,092681,Semenuks; Arturs,4,25,100,96
1656035948206,COGS 14B,A01,083073,Cheng; Tzu-Han,7,0,63,56
1656035954231,COGS 17,A01,092677,Semenuks; Arturs,8,7,81,73
1656035960254,COGS 100,A01,083619,Allen; Michael Gordon,3,2,70,67
1656035966291,COGS 101A,A01,083621,Davis; Joshua Daniel,4,3,68,64
1656035972314,COGS 101B,A01,091572,Allen; Michael Gordon,0,0,65,65
1656035978377,COGS 101C,A01,083625,Delgado; Tania,7,0,35,28
1656035984401,COGS 107A,A01,083627,Boyle; Mary E. T.,1,2,60,59
1656035990434,COGS 118A,A01,083075,Gupta; Anjum,21,16,76,55
1656035996457,CSE 3,A50,083646,Miranda; Gregory Joseph,14,0,50,36
1656036002488,CSE 8A,A50,083650,Miranda; Gregory Joseph,4,11,56,52
1656036008514,CSE 11,A01,083080,Cao; Yingjun,0,65,40,40
1656036014537,CSE 12,A01,083652,Krause-Levy; Sophia Louisa,7,8,120,113
1656036020560,CSE 15L,A01,083654,Morris; Justin Loren,3,1,50,47
1656036020560,CSE 15L,A02,083655,Morris; Justin Loren,2,1,50,48
1656036026586,CSE 20,A01,083657,Tran; Khoa Dang,29,0,80,51
1656036032609,CSE 21,A01,095574,Bach; Quang Tran,23,0,48,25
1656036038635,CSE 30,A01,083084,Eldon; John,2,10,80,78
1656036038635,CSE 30,B01,095061,Bhaskar; Nishant,2,5,50,48
1656036044659,CSE 100,A01,083659,Cao; Yingjun,2,25,70,68
1656036050682,CSE 134B,A01,083661,Powell; Thomas Allan,6,6,100,94
1656036056707,CSE 140,A01,083663,Gungor; Onat,5,0,85,80
1656036062736,CSE 140L,A01,083088,Eldon; John,5,0,100,95
1656036068764,CSE 175,A01,083665,Kumar; Rakesh,0,0,25,25
1656036074787,CSE 190,A00,092507,Dubnov; Shlomo,1,0,20,19
1656036080810,ECE 45,A01,083139,Congero; Spencer William,1,1,75,74
1656036086832,ECE 65,A50,083695,Saad; Andrew S,6,0,30,24
1656036086832,ECE 65,A51,095125,Staff,23,0,26,3
1656036092855,ECE 109,A01,091882,Touri; Behrouz,3,5,70,67
1656036098878,ECE 180,A00,083140,Abi Samra; Nicholas Camill,1,0,30,29
1656036098878,ECE 180,B00,083141,Abi Samra; Nicholas Camill,0,8,28,28
1656036104899,MATH 10A,A01,083735,Patchell; Gregory David,0,0,30,30
1656036104899,MATH 10A,A02,083736,Patchell; Gregory David,20,0,30,10
1656036104899,MATH 10A,A03,083737,Patchell; Gregory David,16,0,30,14
1656036110924,MATH 10B,A01,083207,Lim; Seonhee,1,1,34,33
1656036110924,MATH 10B,A02,083208,Lim; Seonhee,1,1,35,34
1656036110924,MATH 10B,A03,093472,Staff,0,1,34,34
1656036110924,MATH 10B,B01,083739,Sinha; Shubham,10,0,30,20
1656036116955,MATH 18,A01,083743,Cinel; Cameron Alexander,5,0,30,25
1656036116955,MATH 18,A02,083744,Cinel; Cameron Alexander,11,0,30,19
1656036116955,MATH 18,A03,083745,Cinel; Cameron Alexander,1,0,30,29
1656036116955,MATH 18,B01,083748,Ma; Zilu,0,0,36,36
1656036116955,MATH 18,B02,083749,Ma; Zilu,0,0,36,36
1656036116955,MATH 18,B03,083750,Ma; Zilu,0,0,36,36
1656036116955,MATH 18,B04,083751,Ma; Zilu,0,0,36,36
1656036116955,MATH 18,B05,093473,Staff,0,0,36,36
1656036116955,MATH 18,B06,093474,Staff,3,0,36,33
1656036122977,MATH 20A,A01,083754,Zheng; Zequn,11,0,40,29
1656036129000,MATH 20B,A01,083756,Briones; Jor-el Thomas Caparas,0,0,36,36
1656036129000,MATH 20B,A02,083757,Briones; Jor-el Thomas Caparas,1,0,36,35
1656036129000,MATH 20B,A03,093475,Staff,0,0,36,36
1656036135029,MATH 20C,A01,083760,Briones; Jor-el Thomas Caparas,0,2,35,35
1656036135029,MATH 20C,A02,083761,Briones; Jor-el Thomas Caparas,6,1,35,29
1656036135029,MATH 20C,A03,093476,Staff,0,1,35,35
1656036135029,MATH 20C,B01,083762,Bach; Quang Tran,3,0,30,27
1656036141052,MATH 20D,A01,083765,Tran; Brian Kha,2,0,30,28
1656036141052,MATH 20D,A02,083766,Tran; Brian Kha,0,1,30,30
1656036141052,MATH 20D,A03,083767,Tran; Brian Kha,0,0,30,30
1656036147085,MATH 20E,A01,083771,Ganguly; Soumya,0,1,32,32
1656036147085,MATH 20E,A02,083772,Ganguly; Soumya,1,1,32,31
1656036147085,MATH 20E,B01,083773,Ciotti; Benjamin,13,0,35,22
1656036147085,MATH 20E,B02,083774,Ciotti; Benjamin,12,0,35,23
1656036153109,MATH 103A,A01,083777,Greenfeld; Be'Eri,2,1,36,34
1656036153109,MATH 103A,A02,083778,Greenfeld; Be'Eri,1,0,36,35
1656036153109,MATH 103A,A03,093561,Staff,0,1,36,36
1656036153109,MATH 103A,B01,083779,Greenfeld; Be'Eri,8,1,36,28
1656036153109,MATH 103A,B02,083780,Greenfeld; Be'Eri,0,0,36,36
1656036153109,MATH 103A,B03,093562,Staff,0,0,36,36
1656036159136,MATH 105,A01,085443,Carter; Anne Toulson,4,1,35,31
1656036159136,MATH 105,A02,093477,Staff,9,0,35,26
1656036165165,MATH 109,A01,083213,Ganzberger; Geoffrey Michael,0,1,34,34
1656036165165,MATH 109,A02,083214,Ganzberger; Geoffrey Michael,0,0,34,34
1656036165165,MATH 109,A03,093478,Staff,1,0,34,33
1656036165165,MATH 109,B01,083215,Ganzberger; Geoffrey Michael,2,0,32,30
1656036165165,MATH 109,B02,083216,Ganzberger; Geoffrey Michael,0,0,32,32
1656036165165,MATH 109,B03,093479,Staff,3,0,32,29
1656036171190,MATH 142A,A01,083219,Chow; Bennett,1,0,32,31
1656036171190,MATH 142A,A02,083220,Chow; Bennett,7,0,32,25
1656036171190,MATH 142A,A03,093480,Staff,4,0,32,28
1656036171190,MATH 142A,B03,093481,Staff,3,0,32,29
1656036171190,MATH 142A,B04,093558,Staff,5,0,32,27
1656036171190,MATH 142A,B05,093559,Staff,0,0,32,32
1656036177216,MATH 193A,A01,083224,Rotar; Vladimir,1,2,34,33
1656036177216,MATH 193A,A02,083225,Rotar; Vladimir,0,0,34,34
1656036177216,MATH 193A,A03,083781,Rotar; Vladimir,1,0,34,33
1656036177216,MATH 193A,A04,083782,Rotar; Vladimir,3,0,34,31
1656036177216,MATH 193A,A05,093482,Rotar; Vladimir,0,0,34,34
1656036183243,MATH 197,001,091859,McAuley; Julian John,9999,0,9999,0
1656036183243,MATH 197,002,095566,Kedlaya; Kiran S.,9997,0,9999,2
1656036183243,MATH 197,003,095567,Xiao; Ming,9999,0,9999,0
1656036183243,MATH 197,004,095571,Perols; Johan Lars,9998,0,9999,1
1656036190302,COGS 9,A01,083615,Shannon; Kyle Michael,3,1,75,72
1656036196326,COGS 11,A01,083617,Boyle; Mary E. T.,11,2,48,37
1656036202348,COGS 13,A01,083071,Bastos; Amalia Pinkusfeld,4,3,71,67
1656036208371,COGS 14A,A01,092681,Semenuks; Arturs,4,25,100,96
1656036214395,COGS 14B,A01,083073,Cheng; Tzu-Han,7,0,63,56
1656036220422,COGS 17,A01,092677,Semenuks; Arturs,8,7,81,73
1656036226447,COGS 100,A01,083619,Allen; Michael Gordon,3,2,70,67
1656036232470,COGS 101A,A01,083621,Davis; Joshua Daniel,4,3,68,64
1656036238513,COGS 101B,A01,091572,Allen; Michael Gordon,0,0,65,65
1656036244534,COGS 101C,A01,083625,Delgado; Tania,7,0,35,28
1656036250560,COGS 107A,A01,083627,Boyle; Mary E. T.,1,2,60,59
1656036256587,COGS 118A,A01,083075,Gupta; Anjum,21,16,76,55
1656036262609,CSE 3,A50,083646,Miranda; Gregory Joseph,14,0,50,36
1656036268633,CSE 8A,A50,083650,Miranda; Gregory Joseph,4,11,56,52
1656036274656,CSE 11,A01,083080,Cao; Yingjun,0,65,40,40
1656036280681,CSE 12,A01,083652,Krause-Levy; Sophia Louisa,7,8,120,113
1656036286707,CSE 15L,A01,083654,Morris; Justin Loren,3,1,50,47
1656036286707,CSE 15L,A02,083655,Morris; Justin Loren,2,1,50,48
1656036292734,CSE 20,A01,083657,Tran; Khoa Dang,29,0,80,51
1656036298759,CSE 21,A01,095574,Bach; Quang Tran,23,0,48,25
1656036304861,CSE 30,A01,083084,Eldon; John,2,10,80,78
1656036304861,CSE 30,B01,095061,Bhaskar; Nishant,2,5,50,48
1656036310888,CSE 100,A01,083659,Cao; Yingjun,2,25,70,68
1656036316915,CSE 134B,A01,083661,Powell; Thomas Allan,6,6,100,94
1656036322937,CSE 140,A01,083663,Gungor; Onat,5,0,85,80
1656036328960,CSE 140L,A01,083088,Eldon; John,5,0,100,95
1656036334982,CSE 175,A01,083665,Kumar; Rakesh,0,0,25,25
1656036341008,CSE 190,A00,092507,Dubnov; Shlomo,1,0,20,19
1656036347035,ECE 45,A01,083139,Congero; Spencer William,1,1,75,74
1656036353057,ECE 65,A50,083695,Saad; Andrew S,6,0,30,24
1656036353057,ECE 65,A51,095125,Staff,23,0,26,3
1656036359080,ECE 109,A01,091882,Touri; Behrouz,3,5,70,67
1656036365117,ECE 180,A00,083140,Abi Samra; Nicholas Camill,1,0,30,29
1656036365117,ECE 180,B00,083141,Abi Samra; Nicholas Camill,0,8,28,28
1656036371142,MATH 10A,A01,083735,Patchell; Gregory David,0,0,30,30
1656036371142,MATH 10A,A02,083736,Patchell; Gregory David,20,0,30,10
1656036371142,MATH 10A,A03,083737,Patchell; Gregory David,16,0,30,14
1656036377171,MATH 10B,A01,083207,Lim; Seonhee,1,1,34,33
1656036377171,MATH 10B,A02,083208,Lim; Seonhee,1,1,35,34
1656036377171,MATH 10B,A03,093472,Staff,0,1,34,34
1656036377171,MATH 10B,B01,083739,Sinha; Shubham,10,0,30,20
1656036383196,MATH 18,A01,083743,Cinel; Cameron Alexander,5,0,30,25
1656036383196,MATH 18,A02,083744,Cinel; Cameron Alexander,11,0,30,19
1656036383196,MATH 18,A03,083745,Cinel; Cameron Alexander,1,0,30,29
1656036383196,MATH 18,B01,083748,Ma; Zilu,0,0,36,36
1656036383196,MATH 18,B02,083749,Ma; Zilu,0,0,36,36
1656036383196,MATH 18,B03,083750,Ma; Zilu,0,0,36,36
1656036383196,MATH 18,B04,083751,Ma; Zilu,0,0,36,36
1656036383196,MATH 18,B05,093473,Staff,0,0,36,36
1656036383196,MATH 18,B06,093474,Staff,3,0,36,33
1656036389225,MATH 20A,A01,083754,Zheng; Zequn,11,0,40,29
1656036395251,MATH 20B,A01,083756,Briones; Jor-el Thomas Caparas,0,0,36,36
1656036395251,MATH 20B,A02,083757,Briones; Jor-el Thomas Caparas,1,0,36,35
1656036395251,MATH 20B,A03,093475,Staff,0,0,36,36
1656036401274,MATH 20C,A01,083760,Briones; Jor-el Thomas Caparas,0,2,35,35
1656036401274,MATH 20C,A02,083761,Briones; Jor-el Thomas Caparas,6,1,35,29
1656036401274,MATH 20C,A03,093476,Staff,0,1,35,35
1656036401274,MATH 20C,B01,083762,Bach; Quang Tran,3,0,30,27
1656036407297,MATH 20D,A01,083765,Tran; Brian Kha,2,0,30,28
1656036407297,MATH 20D,A02,083766,Tran; Brian Kha,0,1,30,30
1656036407297,MATH 20D,A03,083767,Tran; Brian Kha,0,0,30,30
1656036413325,MATH 20E,A01,083771,Ganguly; Soumya,0,1,32,32
1656036413325,MATH 20E,A02,083772,Ganguly; Soumya,1,1,32,31
1656036413325,MATH 20E,B01,083773,Ciotti; Benjamin,13,0,35,22
1656036413325,MATH 20E,B02,083774,Ciotti; Benjamin,12,0,35,23
1656036419359,MATH 103A,A01,083777,Greenfeld; Be'Eri,2,1,36,34
1656036419359,MATH 103A,A02,083778,Greenfeld; Be'Eri,1,0,36,35
1656036419359,MATH 103A,A03,093561,Staff,0,1,36,36
1656036419359,MATH 103A,B01,083779,Greenfeld; Be'Eri,8,1,36,28
1656036419359,MATH 103A,B02,083780,Greenfeld; Be'Eri,0,0,36,36
1656036419359,MATH 103A,B03,093562,Staff,0,0,36,36
1656036425383,MATH 105,A01,085443,Carter; Anne Toulson,4,1,35,31
1656036425383,MATH 105,A02,093477,Staff,9,0,35,26
1656036431411,MATH 109,A01,083213,Ganzberger; Geoffrey Michael,0,1,34,34
1656036431411,MATH 109,A02,083214,Ganzberger; Geoffrey Michael,0,0,34,34
1656036431411,MATH 109,A03,093478,Staff,1,0,34,33
1656036431411,MATH 109,B01,083215,Ganzberger; Geoffrey Michael,2,0,32,30
1656036431411,MATH 109,B02,083216,Ganzberger; Geoffrey Michael,0,0,32,32
1656036431411,MATH 109,B03,093479,Staff,3,0,32,29
1656036437440,MATH 142A,A01,083219,Chow; Bennett,1,0,32,31
1656036437440,MATH 142A,A02,083220,Chow; Bennett,7,0,32,25
1656036437440,MATH 142A,A03,093480,Staff,4,0,32,28
1656036437440,MATH 142A,B03,093481,Staff,3,0,32,29
1656036437440,MATH 142A,B04,093558,Staff,5,0,32,27
1656036437440,MATH 142A,B05,093559,Staff,0,0,32,32
1656036443472,MATH 193A,A01,083224,Rotar; Vladimir,1,2,34,33
1656036443472,MATH 193A,A02,083225,Rotar; Vladimir,0,0,34,34
1656036443472,MATH 193A,A03,083781,Rotar; Vladimir,1,0,34,33
1656036443472,MATH 193A,A04,083782,Rotar; Vladimir,3,0,34,31
1656036443472,MATH 193A,A05,093482,Rotar; Vladimir,0,0,34,34
1656036449495,MATH 197,001,091859,McAuley; Julian John,9999,0,9999,0
1656036449495,MATH 197,002,095566,Kedlaya; Kiran S.,9997,0,9999,2
1656036449495,MATH 197,003,095567,Xiao; Ming,9999,0,9999,0
1656036449495,MATH 197,004,095571,Perols; Johan Lars,9998,0,9999,1
1656036456555,COGS 9,A01,083615,Shannon; Kyle Michael,3,1,75,72
1656036462577,COGS 11,A01,083617,Boyle; Mary E. T.,11,2,48,37
1656036468604,COGS 13,A01,083071,Bastos; Amalia Pinkusfeld,4,3,71,67
1656036474630,COGS 14A,A01,092681,Semenuks; Arturs,4,25,100,96
1656036480658,COGS 14B,A01,083073,Cheng; Tzu-Han,7,0,63,56
1656036486680,COGS 17,A01,092677,Semenuks; Arturs,8,7,81,73
1656036492703,COGS 100,A01,083619,Allen; Michael Gordon,3,2,70,67
1656036498730,COGS 101A,A01,083621,Davis; Joshua Daniel,4,3,68,64
1656036504756,COGS 101B,A01,091572,Allen; Michael Gordon,0,0,65,65
1656036510783,COGS 101C,A01,083625,Delgado; Tania,7,0,35,28
1656036516814,COGS 107A,A01,083627,Boyle; Mary E. T.,1,2,60,59
1656036522838,COGS 118A,A01,083075,Gupta; Anjum,21,16,76,55
1656036528867,CSE 3,A50,083646,Miranda; Gregory Joseph,14,0,50,36
1656036534889,CSE 8A,A50,083650,Miranda; Gregory Joseph,4,11,56,52
1656036540918,CSE 11,A01,083080,Cao; Yingjun,0,65,40,40
1656036546945,CSE 12,A01,083652,Krause-Levy; Sophia Louisa,7,8,120,113
1656036552968,CSE 15L,A01,083654,Morris; Justin Loren,3,1,50,47
1656036552968,CSE 15L,A02,083655,Morris; Justin Loren,2,1,50,48
1656036558990,CSE 20,A01,083657,Tran; Khoa Dang,29,0,80,51
1656036565018,CSE 21,A01,095574,Bach; Quang Tran,23,0,48,25
1656036571042,CSE 30,A01,083084,Eldon; John,2,10,80,78
1656036571042,CSE 30,B01,095061,Bhaskar; Nishant,2,5,50,48
1656036577069,CSE 100,A01,083659,Cao; Yingjun,2,25,70,68
1656036583091,CSE 134B,A01,083661,Powell; Thomas Allan,6,6,100,94
1656036589115,CSE 140,A01,083663,Gungor; Onat,5,0,85,80
1656036595142,CSE 140L,A01,083088,Eldon; John,5,0,100,95
1656036601169,CSE 175,A01,083665,Kumar; Rakesh,0,0,25,25
1656036607193,CSE 190,A00,092507,Dubnov; Shlomo,1,0,20,19
1656036613218,ECE 45,A01,083139,Congero; Spencer William,1,1,75,74
1656036619241,ECE 65,A50,083695,Saad; Andrew S,6,0,30,24
1656036619241,ECE 65,A51,095125,Staff,23,0,26,3
1656036625263,ECE 109,A01,091882,Touri; Behrouz,3,5,70,67
1656036631285,ECE 180,A00,083140,Abi Samra; Nicholas Camill,1,0,30,29
1656036631285,ECE 180,B00,083141,Abi Samra; Nicholas Camill,0,8,28,28
1656036637310,MATH 10A,A01,083735,Patchell; Gregory David,0,0,30,30
1656036637310,MATH 10A,A02,083736,Patchell; Gregory David,20,0,30,10
1656036637310,MATH 10A,A03,083737,Patchell; Gregory David,16,0,30,14
1656036643335,MATH 10B,A01,083207,Lim; Seonhee,1,1,34,33
1656036643335,MATH 10B,A02,083208,Lim; Seonhee,1,1,35,34
1656036643335,MATH 10B,A03,093472,Staff,0,1,34,34
1656036643335,MATH 10B,B01,083739,Sinha; Shubham,10,0,30,20
1656036649365,MATH 18,A01,083743,Cinel; Cameron Alexander,5,0,30,25
1656036649365,MATH 18,A02,083744,Cinel; Cameron Alexander,11,0,30,19
1656036649365,MATH 18,A03,083745,Cinel; Cameron Alexander,1,0,30,29
1656036649365,MATH 18,B01,083748,Ma; Zilu,0,0,36,36
1656036649365,MATH 18,B02,083749,Ma; Zilu,0,0,36,36
1656036649365,MATH 18,B03,083750,Ma; Zilu,0,0,36,36
1656036649365,MATH 18,B04,083751,Ma; Zilu,0,0,36,36
1656036649365,MATH 18,B05,093473,Staff,0,0,36,36
1656036649365,MATH 18,B06,093474,Staff,3,0,36,33
1656036655387,MATH 20A,A01,083754,Zheng; Zequn,11,0,40,29
1656036661416,MATH 20B,A01,083756,Briones; Jor-el Thomas Caparas,0,0,36,36
1656036661416,MATH 20B,A02,083757,Briones; Jor-el Thomas Caparas,1,0,36,35
1656036661416,MATH 20B,A03,093475,Staff,0,0,36,36
1656036667438,MATH 20C,A01,083760,Briones; Jor-el Thomas Caparas,0,2,35,35
1656036667438,MATH 20C,A02,083761,Briones; Jor-el Thomas Caparas,6,1,35,29
1656036667438,MATH 20C,A03,093476,Staff,0,1,35,35
1656036667438,MATH 20C,B01,083762,Bach; Quang Tran,3,0,30,27
1656036673461,MATH 20D,A01,083765,Tran; Brian Kha,2,0,30,28
1656036673461,MATH 20D,A02,083766,Tran; Brian Kha,0,1,30,30
1656036673461,MATH 20D,A03,083767,Tran; Brian Kha,0,0,30,30
1656036679483,MATH 20E,A01,083771,Ganguly; Soumya,0,1,32,32
1656036679483,MATH 20E,A02,083772,Ganguly; Soumya,1,1,32,31
1656036679483,MATH 20E,B01,083773,Ciotti; Benjamin,13,0,35,22
1656036679483,MATH 20E,B02,083774,Ciotti; Benjamin,12,0,35,23
1656036685506,MATH 103A,A01,083777,Greenfeld; Be'Eri,2,1,36,34
1656036685506,MATH 103A,A02,083778,Greenfeld; Be'Eri,1,0,36,35
1656036685506,MATH 103A,A03,093561,Staff,0,1,36,36
1656036685506,MATH 103A,B01,083779,Greenfeld; Be'Eri,8,1,36,28
1656036685506,MATH 103A,B02,083780,Greenfeld; Be'Eri,0,0,36,36
1656036685506,MATH 103A,B03,093562,Staff,0,0,36,36
1656036691528,MATH 105,A01,085443,Carter; Anne Toulson,4,1,35,31
1656036691528,MATH 105,A02,093477,Staff,9,0,35,26
1656036697550,MATH 109,A01,083213,Ganzberger; Geoffrey Michael,0,1,34,34
1656036697550,MATH 109,A02,083214,Ganzberger; Geoffrey Michael,0,0,34,34
1656036697550,MATH 109,A03,093478,Staff,1,0,34,33
1656036697550,MATH 109,B01,083215,Ganzberger; Geoffrey Michael,2,0,32,30
1656036697550,MATH 109,B02,083216,Ganzberger; Geoffrey Michael,0,0,32,32
1656036697550,MATH 109,B03,093479,Staff,3,0,32,29
1656036703575,MATH 142A,A01,083219,Chow; Bennett,1,0,32,31
1656036703575,MATH 142A,A02,083220,Chow; Bennett,7,0,32,25
1656036703575,MATH 142A,A03,093480,Staff,4,0,32,28
1656036703575,MATH 142A,B03,093481,Staff,3,0,32,29
1656036703575,MATH 142A,B04,093558,Staff,5,0,32,27
1656036703575,MATH 142A,B05,093559,Staff,0,0,32,32
1656036709604,MATH 193A,A01,083224,Rotar; Vladimir,1,2,34,33
1656036709604,MATH 193A,A02,083225,Rotar; Vladimir,0,0,34,34
1656036709604,MATH 193A,A03,083781,Rotar; Vladimir,1,0,34,33
1656036709604,MATH 193A,A04,083782,Rotar; Vladimir,3,0,34,31
1656036709604,MATH 193A,A05,093482,Rotar; Vladimir,0,0,34,34
1656036715626,MATH 197,001,091859,McAuley; Julian John,9999,0,9999,0
1656036715626,MATH 197,002,095566,Kedlaya; Kiran S.,9997,0,9999,2
1656036715626,MATH 197,003,095567,Xiao; Ming,9999,0,9999,0
1656036715626,MATH 197,004,095571,Perols; Johan Lars,9998,0,9999,1
1656036722689,COGS 9,A01,083615,Shannon; Kyle Michael,3,1,75,72
1656036728718,COGS 11,A01,083617,Boyle; Mary E. T.,11,2,48,37
1656036734748,COGS 13,A01,083071,Bastos; Amalia Pinkusfeld,4,3,71,67
1656036740777,COGS 14A,A01,092681,Semenuks; Arturs,4,25,100,96
1656036746803,COGS 14B,A01,083073,Cheng; Tzu-Han,7,0,63,56
1656036752825,COGS 17,A01,092677,Semenuks; Arturs,8,7,81,73
1656036758853,COGS 100,A01,083619,Allen; Michael Gordon,3,2,70,67
1656036764880,COGS 101A,A01,083621,Davis; Joshua Daniel,4,3,68,64
1656036770902,COGS 101B,A01,091572,Allen; Michael Gordon,0,0,65,65
1656036776926,COGS 101C,A01,083625,Delgado; Tania,7,0,35,28
1656036782952,COGS 107A,A01,083627,Boyle; Mary E. T.,1,2,60,59
1656036788987,COGS 118A,A01,083075,Gupta; Anjum,21,16,76,55
1656036795010,CSE 3,A50,083646,Miranda; Gregory Joseph,14,0,50,36
1656036801035,CSE 8A,A50,083650,Miranda; Gregory Joseph,4,11,56,52
1656036807059,CSE 11,A01,083080,Cao; Yingjun,0,65,40,40
1656036813085,CSE 12,A01,083652,Krause-Levy; Sophia Louisa,7,8,120,113
1656036819112,CSE 15L,A01,083654,Morris; Justin Loren,3,1,50,47
1656036819112,CSE 15L,A02,083655,Morris; Justin Loren,2,1,50,48
1656036825145,CSE 20,A01,083657,Tran; Khoa Dang,29,0,80,51
1656036831167,CSE 21,A01,095574,Bach; Quang Tran,23,0,48,25
1656036837191,CSE 30,A01,083084,Eldon; John,2,10,80,78
1656036837191,CSE 30,B01,095061,Bhaskar; Nishant,2,5,50,48
1656036843219,CSE 100,A01,083659,Cao; Yingjun,2,25,70,68
1656036849241,CSE 134B,A01,083661,Powell; Thomas Allan,6,6,100,94
1656036855267,CSE 140,A01,083663,Gungor; Onat,5,0,85,80
1656036861294,CSE 140L,A01,083088,Eldon; John,5,0,100,95
1656036867319,CSE 175,A01,083665,Kumar; Rakesh,0,0,25,25
1656036873342,CSE 190,A00,092507,Dubnov; Shlomo,1,0,20,19
1656036879366,ECE 45,A01,083139,Congero; Spencer William,1,1,75,74
1656036885390,ECE 65,A50,083695,Saad; Andrew S,6,0,30,24
1656036885390,ECE 65,A51,095125,Staff,23,0,26,3
1656036891414,ECE 109,A01,091882,Touri; Behrouz,3,5,70,67
1656036897440,ECE 180,A00,083140,Abi Samra; Nicholas Camill,1,0,30,29
1656036897440,ECE 180,B00,083141,Abi Samra; Nicholas Camill,0,8,28,28
1656036903538,MATH 10A,A01,083735,Patchell; Gregory David,0,0,30,30
1656036903538,MATH 10A,A02,083736,Patchell; Gregory David,20,0,30,10
1656036903538,MATH 10A,A03,083737,Patchell; Gregory David,16,0,30,14
1656036909570,MATH 10B,A01,083207,Lim; Seonhee,1,1,34,33
1656036909570,MATH 10B,A02,083208,Lim; Seonhee,1,1,35,34
1656036909570,MATH 10B,A03,093472,Staff,0,1,34,34
1656036909570,MATH 10B,B01,083739,Sinha; Shubham,10,0,30,20
1656036915601,MATH 18,A01,083743,Cinel; Cameron Alexander,5,0,30,25
1656036915601,MATH 18,A02,083744,Cinel; Cameron Alexander,11,0,30,19
1656036915601,MATH 18,A03,083745,Cinel; Cameron Alexander,1,0,30,29
1656036915601,MATH 18,B01,083748,Ma; Zilu,0,0,36,36
1656036915601,MATH 18,B02,083749,Ma; Zilu,0,0,36,36
1656036915601,MATH 18,B03,083750,Ma; Zilu,0,0,36,36
1656036915601,MATH 18,B04,083751,Ma; Zilu,0,0,36,36
1656036915601,MATH 18,B05,093473,Staff,0,0,36,36
1656036915601,MATH 18,B06,093474,Staff,3,0,36,33
1656036921628,MATH 20A,A01,083754,Zheng; Zequn,11,0,40,29
1656036927660,MATH 20B,A01,083756,Briones; Jor-el Thomas Caparas,0,0,36,36
1656036927660,MATH 20B,A02,083757,Briones; Jor-el Thomas Caparas,1,0,36,35
1656036927660,MATH 20B,A03,093475,Staff,0,0,36,36
1656036933684,MATH 20C,A01,083760,Briones; Jor-el Thomas Caparas,0,2,35,35
1656036933684,MATH 20C,A02,083761,Briones; Jor-el Thomas Caparas,6,1,35,29
1656036933684,MATH 20C,A03,093476,Staff,0,1,35,35
1656036933684,MATH 20C,B01,083762,Bach; Quang Tran,3,0,30,27
1656036939715,MATH 20D,A01,083765,Tran; Brian Kha,2,0,30,28
1656036939715,MATH 20D,A02,083766,Tran; Brian Kha,0,1,30,30
1656036939715,MATH 20D,A03,083767,Tran; Brian Kha,0,0,30,30
1656036945743,MATH 20E,A01,083771,Ganguly; Soumya,0,1,32,32
1656036945743,MATH 20E,A02,083772,Ganguly; Soumya,1,1,32,31
1656036945743,MATH 20E,B01,083773,Ciotti; Benjamin,13,0,35,22
1656036945743,MATH 20E,B02,083774,Ciotti; Benjamin,12,0,35,23
1656036951768,MATH 103A,A01,083777,Greenfeld; Be'Eri,2,1,36,34
1656036951768,MATH 103A,A02,083778,Greenfeld; Be'Eri,1,0,36,35
1656036951768,MATH 103A,A03,093561,Staff,0,1,36,36
1656036951768,MATH 103A,B01,083779,Greenfeld; Be'Eri,8,1,36,28
1656036951768,MATH 103A,B02,083780,Greenfeld; Be'Eri,0,0,36,36
1656036951768,MATH 103A,B03,093562,Staff,0,0,36,36
1656036957792,MATH 105,A01,085443,Carter; Anne Toulson,4,1,35,31
1656036957792,MATH 105,A02,093477,Staff,9,0,35,26
1656036963820,MATH 109,A01,083213,Ganzberger; Geoffrey Michael,0,1,34,34
1656036963820,MATH 109,A02,083214,Ganzberger; Geoffrey Michael,0,0,34,34
1656036963820,MATH 109,A03,093478,Staff,1,0,34,33
1656036963820,MATH 109,B01,083215,Ganzberger; Geoffrey Michael,2,0,32,30
1656036963820,MATH 109,B02,083216,Ganzberger; Geoffrey Michael,0,0,32,32
1656036963820,MATH 109,B03,093479,Staff,3,0,32,29
1656036969857,MATH 142A,A01,083219,Chow; Bennett,1,0,32,31
1656036969857,MATH 142A,A02,083220,Chow; Bennett,7,0,32,25
1656036969857,MATH 142A,A03,093480,Staff,4,0,32,28
1656036969857,MATH 142A,B03,093481,Staff,3,0,32,29
1656036969857,MATH 142A,B04,093558,Staff,5,0,32,27
1656036969857,MATH 142A,B05,093559,Staff,0,0,32,32
1656036975888,MATH 193A,A01,083224,Rotar; Vladimir,1,2,34,33
1656036975888,MATH 193A,A02,083225,Rotar; Vladimir,0,0,34,34
1656036975888,MATH 193A,A03,083781,Rotar; Vladimir,1,0,34,33
1656036975888,MATH 193A,A04,083782,Rotar; Vladimir,3,0,34,31
1656036975888,MATH 193A,A05,093482,Rotar; Vladimir,0,0,34,34
1656036981917,MATH 197,001,091859,McAuley; Julian John,9999,0,9999,0
1656036981917,MATH 197,002,095566,Kedlaya; Kiran S.,9997,0,9999,2
1656036981917,MATH 197,003,095567,Xiao; Ming,9999,0,9999,0
1656036981917,MATH 197,004,095571,Perols; Johan Lars,9998,0,9999,1
1656036988999,COGS 9,A01,083615,Shannon; Kyle Michael,3,1,75,72
1656036995028,COGS 11,A01,083617,Boyle; Mary E. T.,11,2,48,37
1656037001052,COGS 13,A01,083071,Bastos; Amalia Pinkusfeld,4,3,71,67
1656037007076,COGS 14A,A01,092681,Semenuks; Arturs,4,25,100,96
1656037013099,COGS 14B,A01,083073,Cheng; Tzu-Han,7,0,63,56
1656037019125,COGS 17,A01,092677,Semenuks; Arturs,8,7,81,73
1656037025152,COGS 100,A01,083619,Allen; Michael Gordon,3,2,70,67
1656037031179,COGS 101A,A01,083621,Davis; Joshua Daniel,4,3,68,64
1656037037203,COGS 101B,A01,091572,Allen; Michael Gordon,0,0,65,65
1656037043230,COGS 101C,A01,083625,Delgado; Tania,7,0,35,28
1656037049254,COGS 107A,A01,083627,Boyle; Mary E. T.,1,2,60,59
1656037055277,COGS 118A,A01,083075,Gupta; Anjum,21,16,76,55
1656037061305,CSE 3,A50,083646,Miranda; Gregory Joseph,14,0,50,36
1656037067328,CSE 8A,A50,083650,Miranda; Gregory Joseph,4,11,56,52
1656037073355,CSE 11,A01,083080,Cao; Yingjun,0,65,40,40
1656037079381,CSE 12,A01,083652,Krause-Levy; Sophia Louisa,7,8,120,113
1656037085411,CSE 15L,A01,083654,Morris; Justin Loren,3,1,50,47
1656037085411,CSE 15L,A02,083655,Morris; Justin Loren,2,1,50,48
1656037091434,CSE 20,A01,083657,Tran; Khoa Dang,29,0,80,51
1656037097466,CSE 21,A01,095574,Bach; Quang Tran,23,0,48,25
1656037103494,CSE 30,A01,083084,Eldon; John,2,10,80,78
1656037103494,CSE 30,B01,095061,Bhaskar; Nishant,2,5,50,48
1656037109526,CSE 100,A01,083659,Cao; Yingjun,2,25,70,68
1656037115552,CSE 134B,A01,083661,Powell; Thomas Allan,6,6,100,94
1656037121580,CSE 140,A01,083663,Gungor; Onat,5,0,85,80
1656037127603,CSE 140L,A01,083088,Eldon; John,5,0,100,95
1656037133633,CSE 175,A01,083665,Kumar; Rakesh,0,0,25,25
1656037139663,CSE 190,A00,092507,Dubnov; Shlomo,1,0,20,19
1656037145691,ECE 45,A01,083139,Congero; Spencer William,1,1,75,74
1656037151717,ECE 65,A50,083695,Saad; Andrew S,6,0,30,24
1656037151717,ECE 65,A51,095125,Staff,23,0,26,3
1656037157741,ECE 109,A01,091882,Touri; Behrouz,3,5,70,67
1656037163766,ECE 180,A00,083140,Abi Samra; Nicholas Camill,1,0,30,29
1656037163766,ECE 180,B00,083141,Abi Samra; Nicholas Camill,0,8,28,28
1656037169796,MATH 10A,A01,083735,Patchell; Gregory David,0,0,30,30
1656037169796,MATH 10A,A02,083736,Patchell; Gregory David,20,0,30,10
1656037169796,MATH 10A,A03,083737,Patchell; Gregory David,16,0,30,14
1656037175832,MATH 10B,A01,083207,Lim; Seonhee,1,1,34,33
1656037175832,MATH 10B,A02,083208,Lim; Seonhee,1,1,35,34
1656037175832,MATH 10B,A03,093472,Staff,0,1,34,34
1656037175832,MATH 10B,B01,083739,Sinha; Shubham,10,0,30,20
1656037181867,MATH 18,A01,083743,Cinel; Cameron Alexander,5,0,30,25
1656037181867,MATH 18,A02,083744,Cinel; Cameron Alexander,11,0,30,19
1656037181867,MATH 18,A03,083745,Cinel; Cameron Alexander,1,0,30,29
1656037181867,MATH 18,B01,083748,Ma; Zilu,0,0,36,36
1656037181867,MATH 18,B02,083749,Ma; Zilu,0,0,36,36
1656037181867,MATH 18,B03,083750,Ma; Zilu,0,0,36,36
1656037181867,MATH 18,B04,083751,Ma; Zilu,0,0,36,36
1656037181867,MATH 18,B05,093473,Staff,0,0,36,36
1656037181867,MATH 18,B06,093474,Staff,3,0,36,33
1656037187891,MATH 20A,A01,083754,Zheng; Zequn,11,0,40,29
1656037193919,MATH 20B,A01,083756,Briones; Jor-el Thomas Caparas,0,0,36,36
1656037193919,MATH 20B,A02,083757,Briones; Jor-el Thomas Caparas,1,0,36,35
1656037193919,MATH 20B,A03,093475,Staff,0,0,36,36
1656037199945,MATH 20C,A01,083760,Briones; Jor-el Thomas Caparas,0,2,35,35
1656037199945,MATH 20C,A02,083761,Briones; Jor-el Thomas Caparas,6,1,35,29
1656037199945,MATH 20C,A03,093476,Staff,0,1,35,35
1656037199945,MATH 20C,B01,083762,Bach; Quang Tran,3,0,30,27
1656037205970,MATH 20D,A01,083765,Tran; Brian Kha,2,0,30,28
1656037205970,MATH 20D,A02,083766,Tran; Brian Kha,0,1,30,30
1656037205970,MATH 20D,A03,083767,Tran; Brian Kha,0,0,30,30
1656037212013,MATH 20E,A01,083771,Ganguly; Soumya,0,1,32,32
1656037212013,MATH 20E,A02,083772,Ganguly; Soumya,1,1,32,31
1656037212013,MATH 20E,B01,083773,Ciotti; Benjamin,13,0,35,22
1656037212013,MATH 20E,B02,083774,Ciotti; Benjamin,12,0,35,23
1656037218046,MATH 103A,A01,083777,Greenfeld; Be'Eri,2,1,36,34
1656037218046,MATH 103A,A02,083778,Greenfeld; Be'Eri,1,0,36,35
1656037218046,MATH 103A,A03,093561,Staff,0,1,36,36
1656037218046,MATH 103A,B01,083779,Greenfeld; Be'Eri,8,1,36,28
1656037218046,MATH 103A,B02,083780,Greenfeld; Be'Eri,0,0,36,36
1656037218046,MATH 103A,B03,093562,Staff,0,0,36,36
1656037224075,MATH 105,A01,085443,Carter; Anne Toulson,4,1,35,31
1656037224075,MATH 105,A02,093477,Staff,9,0,35,26
1656037230106,MATH 109,A01,083213,Ganzberger; Geoffrey Michael,0,1,34,34
1656037230106,MATH 109,A02,083214,Ganzberger; Geoffrey Michael,0,0,34,34
1656037230106,MATH 109,A03,093478,Staff,1,0,34,33
1656037230106,MATH 109,B01,083215,Ganzberger; Geoffrey Michael,2,0,32,30
1656037230106,MATH 109,B02,083216,Ganzberger; Geoffrey Michael,0,0,32,32
1656037230106,MATH 109,B03,093479,Staff,3,0,32,29
1656037236132,MATH 142A,A01,083219,Chow; Bennett,1,0,32,31
1656037236132,MATH 142A,A02,083220,Chow; Bennett,7,0,32,25
1656037236132,MATH 142A,A03,093480,Staff,4,0,32,28
1656037236132,MATH 142A,B03,093481,Staff,3,0,32,29
1656037236132,MATH 142A,B04,093558,Staff,5,0,32,27
1656037236132,MATH 142A,B05,093559,Staff,0,0,32,32
1656037242164,MATH 193A,A01,083224,Rotar; Vladimir,1,2,34,33
1656037242164,MATH 193A,A02,083225,Rotar; Vladimir,0,0,34,34
1656037242164,MATH 193A,A03,083781,Rotar; Vladimir,1,0,34,33
1656037242164,MATH 193A,A04,083782,Rotar; Vladimir,3,0,34,31
1656037242164,MATH 193A,A05,093482,Rotar; Vladimir,0,0,34,34
1656037248187,MATH 197,001,091859,McAuley; Julian John,9999,0,9999,0
1656037248187,MATH 197,002,095566,Kedlaya; Kiran S.,9997,0,9999,2
1656037248187,MATH 197,003,095567,Xiao; Ming,9999,0,9999,0
1656037248187,MATH 197,004,095571,Perols; Johan Lars,9998,0,9999,1
1656037255246,COGS 9,A01,083615,Shannon; Kyle Michael,3,1,75,72
1656037261269,COGS 11,A01,083617,Boyle; Mary E. T.,11,2,48,37
1656037267302,COGS 13,A01,083071,Bastos; Amalia Pinkusfeld,4,3,71,67
1656037273329,COGS 14A,A01,092681,Semenuks; Arturs,4,25,100,96
1656037279357,COGS 14B,A01,083073,Cheng; Tzu-Han,7,0,63,56
1656037285381,COGS 17,A01,092677,Semenuks; Arturs,8,7,81,73
1656037291406,COGS 100,A01,083619,Allen; Michael Gordon,3,2,70,67
1656037297433,COGS 101A,A01,083621,Davis; Joshua Daniel,4,3,68,64
1656037303457,COGS 101B,A01,091572,Allen; Michael Gordon,0,0,65,65
1656037309487,COGS 101C,A01,083625,Delgado; Tania,7,0,35,28
1656037315509,COGS 107A,A01,083627,Boyle; Mary E. T.,1,2,60,59
1656037321543,COGS 118A,A01,083075,Gupta; Anjum,21,16,76,55
1656037327568,CSE 3,A50,083646,Miranda; Gregory Joseph,14,0,50,36
1656037333598,CSE 8A,A50,083650,Miranda; Gregory Joseph,4,11,56,52
1656037339622,CSE 11,A01,083080,Cao; Yingjun,0,65,40,40
1656037345646,CSE 12,A01,083652,Krause-Levy; Sophia Louisa,7,8,120,113
1656037351672,CSE 15L,A01,083654,Morris; Justin Loren,3,1,50,47
1656037351672,CSE 15L,A02,083655,Morris; Justin Loren,2,1,50,48
1656037357700,CSE 20,A01,083657,Tran; Khoa Dang,29,0,80,51
1656037363725,CSE 21,A01,095574,Bach; Quang Tran,23,0,48,25
1656037369753,CSE 30,A01,083084,Eldon; John,2,10,80,78
1656037369753,CSE 30,B01,095061,Bhaskar; Nishant,2,5,50,48
1656037375775,CSE 100,A01,083659,Cao; Yingjun,2,25,70,68
1656037381798,CSE 134B,A01,083661,Powell; Thomas Allan,6,6,100,94
1656037387823,CSE 140,A01,083663,Gungor; Onat,5,0,85,80
1656037393850,CSE 140L,A01,083088,Eldon; John,5,0,100,95
1656037399873,CSE 175,A01,083665,Kumar; Rakesh,0,0,25,25
1656037405895,CSE 190,A00,092507,Dubnov; Shlomo,1,0,20,19
1656037411919,ECE 45,A01,083139,Congero; Spencer William,1,1,75,74
1656037417944,ECE 65,A50,083695,Saad; Andrew S,6,0,30,24
1656037417944,ECE 65,A51,095125,Staff,23,0,26,3
1656037423971,ECE 109,A01,091882,Touri; Behrouz,3,5,70,67
1656037429996,ECE 180,A00,083140,Abi Samra; Nicholas Camill,1,0,30,29
1656037429996,ECE 180,B00,083141,Abi Samra; Nicholas Camill,0,8,28,28
1656037436024,MATH 10A,A01,083735,Patchell; Gregory David,0,0,30,30
1656037436024,MATH 10A,A02,083736,Patchell; Gregory David,20,0,30,10
1656037436024,MATH 10A,A03,083737,Patchell; Gregory David,16,0,30,14
1656037442065,MATH 10B,A01,083207,Lim; Seonhee,1,1,34,33
1656037442065,MATH 10B,A02,083208,Lim; Seonhee,1,1,35,34
1656037442065,MATH 10B,A03,093472,Staff,0,1,34,34
1656037442065,MATH 10B,B01,083739,Sinha; Shubham,10,0,30,20
1656037448091,MATH 18,A01,083743,Cinel; Cameron Alexander,5,0,30,25
1656037448091,MATH 18,A02,083744,Cinel; Cameron Alexander,11,0,30,19
1656037448091,MATH 18,A03,083745,Cinel; Cameron Alexander,1,0,30,29
1656037448091,MATH 18,B01,083748,Ma; Zilu,0,0,36,36
1656037448091,MATH 18,B02,083749,Ma; Zilu,0,0,36,36
1656037448091,MATH 18,B03,083750,Ma; Zilu,0,0,36,36
1656037448091,MATH 18,B04,083751,Ma; Zilu,0,0,36,36
1656037448091,MATH 18,B05,093473,Staff,0,0,36,36
1656037448091,MATH 18,B06,093474,Staff,3,0,36,33
1656037454125,MATH 20A,A01,083754,Zheng; Zequn,11,0,40,29
1656037460155,MATH 20B,A01,083756,Briones; Jor-el Thomas Caparas,0,0,36,36
1656037460155,MATH 20B,A02,083757,Briones; Jor-el Thomas Caparas,1,0,36,35
1656037460155,MATH 20B,A03,093475,Staff,0,0,36,36
1656037466183,MATH 20C,A01,083760,Briones; Jor-el Thomas Caparas,0,2,35,35
1656037466183,MATH 20C,A02,083761,Briones; Jor-el Thomas Caparas,6,1,35,29
1656037466183,MATH 20C,A03,093476,Staff,0,1,35,35
1656037466183,MATH 20C,B01,083762,Bach; Quang Tran,3,0,30,27
1656037472211,MATH 20D,A01,083765,Tran; Brian Kha,2,0,30,28
1656037472211,MATH 20D,A02,083766,Tran; Brian Kha,0,1,30,30
1656037472211,MATH 20D,A03,083767,Tran; Brian Kha,0,0,30,30
1656037478236,MATH 20E,A01,083771,Ganguly; Soumya,0,1,32,32
1656037478236,MATH 20E,A02,083772,Ganguly; Soumya,1,1,32,31
1656037478236,MATH 20E,B01,083773,Ciotti; Benjamin,13,0,35,22
1656037478236,MATH 20E,B02,083774,Ciotti; Benjamin,12,0,35,23
1656037484265,MATH 103A,A01,083777,Greenfeld; Be'Eri,2,1,36,34
1656037484265,MATH 103A,A02,083778,Greenfeld; Be'Eri,1,0,36,35
1656037484265,MATH 103A,A03,093561,Staff,0,1,36,36
1656037484265,MATH 103A,B01,083779,Greenfeld; Be'Eri,8,1,36,28
1656037484265,MATH 103A,B02,083780,Greenfeld; Be'Eri,0,0,36,36
1656037484265,MATH 103A,B03,093562,Staff,0,0,36,36
1656037490288,MATH 105,A01,085443,Carter; Anne Toulson,4,1,35,31
1656037490288,MATH 105,A02,093477,Staff,9,0,35,26
1656037496313,MATH 109,A01,083213,Ganzberger; Geoffrey Michael,0,1,34,34
1656037496313,MATH 109,A02,083214,Ganzberger; Geoffrey Michael,0,0,34,34
1656037496313,MATH 109,A03,093478,Staff,1,0,34,33
1656037496313,MATH 109,B01,083215,Ganzberger; Geoffrey Michael,2,0,32,30
1656037496313,MATH 109,B02,083216,Ganzberger; Geoffrey Michael,0,0,32,32
1656037496313,MATH 109,B03,093479,Staff,3,0,32,29
1656037502414,MATH 142A,A01,083219,Chow; Bennett,1,0,32,31
1656037502414,MATH 142A,A02,083220,Chow; Bennett,7,0,32,25
1656037502414,MATH 142A,A03,093480,Staff,4,0,32,28
1656037502414,MATH 142A,B03,093481,Staff,3,0,32,29
1656037502414,MATH 142A,B04,093558,Staff,5,0,32,27
1656037502414,MATH 142A,B05,093559,Staff,0,0,32,32
1656037508439,MATH 193A,A01,083224,Rotar; Vladimir,1,2,34,33
1656037508439,MATH 193A,A02,083225,Rotar; Vladimir,0,0,34,34
1656037508439,MATH 193A,A03,083781,Rotar; Vladimir,1,0,34,33
1656037508439,MATH 193A,A04,083782,Rotar; Vladimir,3,0,34,31
1656037508439,MATH 193A,A05,093482,Rotar; Vladimir,0,0,34,34
1656037514467,MATH 197,001,091859,McAuley; Julian John,9999,0,9999,0
1656037514467,MATH 197,002,095566,Kedlaya; Kiran S.,9997,0,9999,2
1656037514467,MATH 197,003,095567,Xiao; Ming,9999,0,9999,0
1656037514467,MATH 197,004,095571,Perols; Johan Lars,9998,0,9999,1
1656037521521,COGS 9,A01,083615,Shannon; Kyle Michael,3,1,75,72
1656037527545,COGS 11,A01,083617,Boyle; Mary E. T.,11,2,48,37
1656037533573,COGS 13,A01,083071,Bastos; Amalia Pinkusfeld,4,3,71,67
1656037539602,COGS 14A,A01,092681,Semenuks; Arturs,4,25,100,96
1656037545625,COGS 14B,A01,083073,Cheng; Tzu-Han,7,0,63,56
1656037551651,COGS 17,A01,092677,Semenuks; Arturs,8,7,81,73
1656037557674,COGS 100,A01,083619,Allen; Michael Gordon,3,2,70,67
1656037563698,COGS 101A,A01,083621,Davis; Joshua Daniel,4,3,68,64
1656037569725,COGS 101B,A01,091572,Allen; Michael Gordon,0,0,65,65
1656037575751,COGS 101C,A01,083625,Delgado; Tania,7,0,35,28
1656037581779,COGS 107A,A01,083627,Boyle; Mary E. T.,1,2,60,59
1656037587806,COGS 118A,A01,083075,Gupta; Anjum,21,16,76,55
1656037593836,CSE 3,A50,083646,Miranda; Gregory Joseph,14,0,50,36
1656037599860,CSE 8A,A50,083650,Miranda; Gregory Joseph,4,11,56,52
1656037605884,CSE 11,A01,083080,Cao; Yingjun,0,65,40,40
1656037611912,CSE 12,A01,083652,Krause-Levy; Sophia Louisa,7,8,120,113
1656037617938,CSE 15L,A01,083654,Morris; Justin Loren,3,1,50,47
1656037617938,CSE 15L,A02,083655,Morris; Justin Loren,2,1,50,48
1656037623964,CSE 20,A01,083657,Tran; Khoa Dang,29,0,80,51
1656037629994,CSE 21,A01,095574,Bach; Quang Tran,23,0,48,25
1656037636022,CSE 30,A01,083084,Eldon; John,2,10,80,78
1656037636022,CSE 30,B01,095061,Bhaskar; Nishant,2,5,50,48
1656037642049,CSE 100,A01,083659,Cao; Yingjun,2,25,70,68
1656037648072,CSE 134B,A01,083661,Powell; Thomas Allan,6,6,100,94
1656037654099,CSE 140,A01,083663,Gungor; Onat,6,0,85,79
1656037660127,CSE 140L,A01,083088,Eldon; John,5,0,100,95
1656037666151,CSE 175,A01,083665,Kumar; Rakesh,0,0,25,25
1656037672177,CSE 190,A00,092507,Dubnov; Shlomo,1,0,20,19
1656037678201,ECE 45,A01,083139,Congero; Spencer William,1,1,75,74
1656037684225,ECE 65,A50,083695,Saad; Andrew S,6,0,30,24
1656037684225,ECE 65,A51,095125,Staff,23,0,26,3
1656037690248,ECE 109,A01,091882,Touri; Behrouz,3,5,70,67
1656037696271,ECE 180,A00,083140,Abi Samra; Nicholas Camill,1,0,30,29
1656037696271,ECE 180,B00,083141,Abi Samra; Nicholas Camill,0,8,28,28
1656037702294,MATH 10A,A01,083735,Patchell; Gregory David,0,0,30,30
1656037702294,MATH 10A,A02,083736,Patchell; Gregory David,20,0,30,10
1656037702294,MATH 10A,A03,083737,Patchell; Gregory David,16,0,30,14
1656037708326,MATH 10B,A01,083207,Lim; Seonhee,1,1,34,33
1656037708326,MATH 10B,A02,083208,Lim; Seonhee,1,1,35,34
1656037708326,MATH 10B,A03,093472,Staff,0,1,34,34
1656037708326,MATH 10B,B01,083739,Sinha; Shubham,10,0,30,20
1656037714354,MATH 18,A01,083743,Cinel; Cameron Alexander,5,0,30,25
1656037714354,MATH 18,A02,083744,Cinel; Cameron Alexander,11,0,30,19
1656037714354,MATH 18,A03,083745,Cinel; Cameron Alexander,1,0,30,29
1656037714354,MATH 18,B01,083748,Ma; Zilu,0,0,36,36
1656037714354,MATH 18,B02,083749,Ma; Zilu,0,0,36,36
1656037714354,MATH 18,B03,083750,Ma; Zilu,0,0,36,36
1656037714354,MATH 18,B04,083751,Ma; Zilu,0,0,36,36
1656037714354,MATH 18,B05,093473,Staff,0,0,36,36
1656037714354,MATH 18,B06,093474,Staff,3,0,36,33
1656037720380,MATH 20A,A01,083754,Zheng; Zequn,11,0,40,29
1656037726408,MATH 20B,A01,083756,Briones; Jor-el Thomas Caparas,0,0,36,36
1656037726408,MATH 20B,A02,083757,Briones; Jor-el Thomas Caparas,1,0,36,35
1656037726408,MATH 20B,A03,093475,Staff,0,0,36,36
1656037732432,MATH 20C,A01,083760,Briones; Jor-el Thomas Caparas,0,2,35,35
1656037732432,MATH 20C,A02,083761,Briones; Jor-el Thomas Caparas,6,1,35,29
1656037732432,MATH 20C,A03,093476,Staff,0,1,35,35
1656037732432,MATH 20C,B01,083762,Bach; Quang Tran,3,0,30,27
1656037738455,MATH 20D,A01,083765,Tran; Brian Kha,2,0,30,28
1656037738455,MATH 20D,A02,083766,Tran; Brian Kha,0,1,30,30
1656037738455,MATH 20D,A03,083767,Tran; Brian Kha,0,0,30,30
1656037744478,MATH 20E,A01,083771,Ganguly; Soumya,0,1,32,32
1656037744478,MATH 20E,A02,083772,Ganguly; Soumya,1,1,32,31
1656037744478,MATH 20E,B01,083773,Ciotti; Benjamin,13,0,35,22
1656037744478,MATH 20E,B02,083774,Ciotti; Benjamin,12,0,35,23
1656037750503,MATH 103A,A01,083777,Greenfeld; Be'Eri,2,1,36,34
1656037750503,MATH 103A,A02,083778,Greenfeld; Be'Eri,1,0,36,35
1656037750503,MATH 103A,A03,093561,Staff,0,1,36,36
1656037750503,MATH 103A,B01,083779,Greenfeld; Be'Eri,8,1,36,28
1656037750503,MATH 103A,B02,083780,Greenfeld; Be'Eri,0,0,36,36
1656037750503,MATH 103A,B03,093562,Staff,0,0,36,36
1656037756524,MATH 105,A01,085443,Carter; Anne Toulson,4,1,35,31
1656037756524,MATH 105,A02,093477,Staff,9,0,35,26
1656037762547,MATH 109,A01,083213,Ganzberger; Geoffrey Michael,0,1,34,34
1656037762547,MATH 109,A02,083214,Ganzberger; Geoffrey Michael,0,0,34,34
1656037762547,MATH 109,A03,093478,Staff,1,0,34,33
1656037762547,MATH 109,B01,083215,Ganzberger; Geoffrey Michael,2,0,32,30
1656037762547,MATH 109,B02,083216,Ganzberger; Geoffrey Michael,0,0,32,32
1656037762547,MATH 109,B03,093479,Staff,3,0,32,29
1656037768573,MATH 142A,A01,083219,Chow; Bennett,1,0,32,31
1656037768573,MATH 142A,A02,083220,Chow; Bennett,7,0,32,25
1656037768573,MATH 142A,A03,093480,Staff,4,0,32,28
1656037768573,MATH 142A,B03,093481,Staff,3,0,32,29
1656037768573,MATH 142A,B04,093558,Staff,5,0,32,27
1656037768573,MATH 142A,B05,093559,Staff,0,0,32,32
1656037774597,MATH 193A,A01,083224,Rotar; Vladimir,1,2,34,33
1656037774597,MATH 193A,A02,083225,Rotar; Vladimir,0,0,34,34
1656037774597,MATH 193A,A03,083781,Rotar; Vladimir,1,0,34,33
1656037774597,MATH 193A,A04,083782,Rotar; Vladimir,3,0,34,31
1656037774597,MATH 193A,A05,093482,Rotar; Vladimir,0,0,34,34
1656037780623,MATH 197,001,091859,McAuley; Julian John,9999,0,9999,0
1656037780623,MATH 197,002,095566,Kedlaya; Kiran S.,9997,0,9999,2
1656037780623,MATH 197,003,095567,Xiao; Ming,9999,0,9999,0
1656037780623,MATH 197,004,095571,Perols; Johan Lars,9998,0,9999,1
1656037787673,COGS 9,A01,083615,Shannon; Kyle Michael,3,1,75,72
1656037793700,COGS 11,A01,083617,Boyle; Mary E. T.,11,2,48,37
1656037799726,COGS 13,A01,083071,Bastos; Amalia Pinkusfeld,4,3,71,67
1656037805753,COGS 14A,A01,092681,Semenuks; Arturs,4,25,100,96
1656037811785,COGS 14B,A01,083073,Cheng; Tzu-Han,7,0,63,56
1656037817808,COGS 17,A01,092677,Semenuks; Arturs,8,7,81,73
1656037823832,COGS 100,A01,083619,Allen; Michael Gordon,3,2,70,67
1656037829859,COGS 101A,A01,083621,Davis; Joshua Daniel,4,3,68,64
1656037835882,COGS 101B,A01,091572,Allen; Michael Gordon,0,0,65,65
1656037841905,COGS 101C,A01,083625,Delgado; Tania,7,0,35,28
1656037847932,COGS 107A,A01,083627,Boyle; Mary E. T.,1,2,60,59
1656037853960,COGS 118A,A01,083075,Gupta; Anjum,21,16,76,55
1656037859984,CSE 3,A50,083646,Miranda; Gregory Joseph,14,0,50,36
1656037866022,CSE 8A,A50,083650,Miranda; Gregory Joseph,4,11,56,52
1656037872046,CSE 11,A01,083080,Cao; Yingjun,0,65,40,40
1656037878073,CSE 12,A01,083652,Krause-Levy; Sophia Louisa,7,8,120,113
1656037884100,CSE 15L,A01,083654,Morris; Justin Loren,3,1,50,47
1656037884100,CSE 15L,A02,083655,Morris; Justin Loren,2,1,50,48
1656037890128,CSE 20,A01,083657,Tran; Khoa Dang,29,0,80,51
1656037896155,CSE 21,A01,095574,Bach; Quang Tran,23,0,48,25
1656037902177,CSE 30,A01,083084,Eldon; John,2,10,80,78
1656037902177,CSE 30,B01,095061,Bhaskar; Nishant,2,5,50,48
1656037908200,CSE 100,A01,083659,Cao; Yingjun,2,25,70,68
1656037914223,CSE 134B,A01,083661,Powell; Thomas Allan,6,6,100,94
1656037920256,CSE 140,A01,083663,Gungor; Onat,6,0,85,79
1656037926280,CSE 140L,A01,083088,Eldon; John,5,0,100,95
1656037932303,CSE 175,A01,083665,Kumar; Rakesh,0,0,25,25
1656037938327,CSE 190,A00,092507,Dubnov; Shlomo,1,0,20,19
1656037944369,ECE 45,A01,083139,Congero; Spencer William,1,1,75,74
1656037950408,ECE 65,A50,083695,Saad; Andrew S,6,0,30,24
1656037950408,ECE 65,A51,095125,Staff,23,0,26,3
1656037956431,ECE 109,A01,091882,Touri; Behrouz,3,5,70,67
1656037962454,ECE 180,A00,083140,Abi Samra; Nicholas Camill,1,0,30,29
1656037962454,ECE 180,B00,083141,Abi Samra; Nicholas Camill,0,8,28,28
1656037968479,MATH 10A,A01,083735,Patchell; Gregory David,0,0,30,30
1656037968479,MATH 10A,A02,083736,Patchell; Gregory David,20,0,30,10
1656037968479,MATH 10A,A03,083737,Patchell; Gregory David,16,0,30,14
1656037974507,MATH 10B,A01,083207,Lim; Seonhee,1,1,34,33
1656037974507,MATH 10B,A02,083208,Lim; Seonhee,1,1,35,34
1656037974507,MATH 10B,A03,093472,Staff,0,1,34,34
1656037974507,MATH 10B,B01,083739,Sinha; Shubham,10,0,30,20
1656037980533,MATH 18,A01,083743,Cinel; Cameron Alexander,5,0,30,25
1656037980533,MATH 18,A02,083744,Cinel; Cameron Alexander,11,0,30,19
1656037980533,MATH 18,A03,083745,Cinel; Cameron Alexander,1,0,30,29
1656037980533,MATH 18,B01,083748,Ma; Zilu,0,0,36,36
1656037980533,MATH 18,B02,083749,Ma; Zilu,0,0,36,36
1656037980533,MATH 18,B03,083750,Ma; Zilu,0,0,36,36
1656037980533,MATH 18,B04,083751,Ma; Zilu,0,0,36,36
1656037980533,MATH 18,B05,093473,Staff,0,0,36,36
1656037980533,MATH 18,B06,093474,Staff,3,0,36,33
1656037986557,MATH 20A,A01,083754,Zheng; Zequn,11,0,40,29
1656037992583,MATH 20B,A01,083756,Briones; Jor-el Thomas Caparas,0,0,36,36
1656037992583,MATH 20B,A02,083757,Briones; Jor-el Thomas Caparas,1,0,36,35
1656037992583,MATH 20B,A03,093475,Staff,0,0,36,36
1656037998607,MATH 20C,A01,083760,Briones; Jor-el Thomas Caparas,0,2,35,35
1656037998607,MATH 20C,A02,083761,Briones; Jor-el Thomas Caparas,6,1,35,29
1656037998607,MATH 20C,A03,093476,Staff,0,1,35,35
1656037998607,MATH 20C,B01,083762,Bach; Quang Tran,3,0,30,27
1656038004635,MATH 20D,A01,083765,Tran; Brian Kha,2,0,30,28
1656038004635,MATH 20D,A02,083766,Tran; Brian Kha,0,1,30,30
1656038004635,MATH 20D,A03,083767,Tran; Brian Kha,0,0,30,30
1656038010660,MATH 20E,A01,083771,Ganguly; Soumya,0,1,32,32
1656038010660,MATH 20E,A02,083772,Ganguly; Soumya,1,1,32,31
1656038010660,MATH 20E,B01,083773,Ciotti; Benjamin,13,0,35,22
1656038010660,MATH 20E,B02,083774,Ciotti; Benjamin,12,0,35,23
1656038016687,MATH 103A,A01,083777,Greenfeld; Be'Eri,2,1,36,34
1656038016687,MATH 103A,A02,083778,Greenfeld; Be'Eri,1,0,36,35
1656038016687,MATH 103A,A03,093561,Staff,0,1,36,36
1656038016687,MATH 103A,B01,083779,Greenfeld; Be'Eri,8,1,36,28
1656038016687,MATH 103A,B02,083780,Greenfeld; Be'Eri,0,0,36,36
1656038016687,MATH 103A,B03,093562,Staff,0,0,36,36
1656038022713,MATH 105,A01,085443,Carter; Anne Toulson,4,1,35,31
1656038022713,MATH 105,A02,093477,Staff,9,0,35,26
1656038028736,MATH 109,A01,083213,Ganzberger; Geoffrey Michael,0,1,34,34
1656038028736,MATH 109,A02,083214,Ganzberger; Geoffrey Michael,0,0,34,34
1656038028736,MATH 109,A03,093478,Staff,1,0,34,33
1656038028736,MATH 109,B01,083215,Ganzberger; Geoffrey Michael,2,0,32,30
1656038028736,MATH 109,B02,083216,Ganzberger; Geoffrey Michael,0,0,32,32
1656038028736,MATH 109,B03,093479,Staff,3,0,32,29
1656038034761,MATH 142A,A01,083219,Chow; Bennett,1,0,32,31
1656038034761,MATH 142A,A02,083220,Chow; Bennett,7,0,32,25
1656038034761,MATH 142A,A03,093480,Staff,4,0,32,28
1656038034761,MATH 142A,B03,093481,Staff,3,0,32,29
1656038034761,MATH 142A,B04,093558,Staff,5,0,32,27
1656038034761,MATH 142A,B05,093559,Staff,0,0,32,32
1656038040785,MATH 193A,A01,083224,Rotar; Vladimir,1,2,34,33
1656038040785,MATH 193A,A02,083225,Rotar; Vladimir,0,0,34,34
1656038040785,MATH 193A,A03,083781,Rotar; Vladimir,1,0,34,33
1656038040785,MATH 193A,A04,083782,Rotar; Vladimir,3,0,34,31
1656038040785,MATH 193A,A05,093482,Rotar; Vladimir,0,0,34,34
1656038046808,MATH 197,001,091859,McAuley; Julian John,9999,0,9999,0
1656038046808,MATH 197,002,095566,Kedlaya; Kiran S.,9997,0,9999,2
1656038046808,MATH 197,003,095567,Xiao; Ming,9999,0,9999,0
1656038046808,MATH 197,004,095571,Perols; Johan Lars,9998,0,9999,1
1656038053870,COGS 9,A01,083615,Shannon; Kyle Michael,3,1,75,72
1656038059895,COGS 11,A01,083617,Boyle; Mary E. T.,11,2,48,37
1656038065918,COGS 13,A01,083071,Bastos; Amalia Pinkusfeld,4,3,71,67
1656038071946,COGS 14A,A01,092681,Semenuks; Arturs,4,25,100,96
1656038077968,COGS 14B,A01,083073,Cheng; Tzu-Han,7,0,63,56
1656038083994,COGS 17,A01,092677,Semenuks; Arturs,8,7,81,73
1656038090016,COGS 100,A01,083619,Allen; Michael Gordon,3,2,70,67
1656038096126,COGS 101A,A01,083621,Davis; Joshua Daniel,4,3,68,64
1656038102150,COGS 101B,A01,091572,Allen; Michael Gordon,0,0,65,65
1656038108174,COGS 101C,A01,083625,Delgado; Tania,7,0,35,28
1656038114200,COGS 107A,A01,083627,Boyle; Mary E. T.,1,2,60,59
1656038120223,COGS 118A,A01,083075,Gupta; Anjum,21,16,76,55
1656038126251,CSE 3,A50,083646,Miranda; Gregory Joseph,14,0,50,36
1656038132286,CSE 8A,A50,083650,Miranda; Gregory Joseph,4,11,56,52
1656038138329,CSE 11,A01,083080,Cao; Yingjun,0,65,40,40
1656038144353,CSE 12,A01,083652,Krause-Levy; Sophia Louisa,7,8,120,113
1656038150375,CSE 15L,A01,083654,Morris; Justin Loren,3,1,50,47
1656038150375,CSE 15L,A02,083655,Morris; Justin Loren,2,1,50,48
1656038156400,CSE 20,A01,083657,Tran; Khoa Dang,29,0,80,51
1656038162424,CSE 21,A01,095574,Bach; Quang Tran,23,0,48,25
1656038168452,CSE 30,A01,083084,Eldon; John,2,10,80,78
1656038168452,CSE 30,B01,095061,Bhaskar; Nishant,2,5,50,48
1656038174487,CSE 100,A01,083659,Cao; Yingjun,2,25,70,68
1656038180513,CSE 134B,A01,083661,Powell; Thomas Allan,6,6,100,94
1656038186536,CSE 140,A01,083663,Gungor; Onat,6,0,85,79
1656038192559,CSE 140L,A01,083088,Eldon; John,5,0,100,95
1656038198584,CSE 175,A01,083665,Kumar; Rakesh,0,0,25,25
1656038204606,CSE 190,A00,092507,Dubnov; Shlomo,1,0,20,19
1656038210630,ECE 45,A01,083139,Congero; Spencer William,1,1,75,74
1656038216660,ECE 65,A50,083695,Saad; Andrew S,6,0,30,24
1656038216660,ECE 65,A51,095125,Staff,23,0,26,3
1656038222684,ECE 109,A01,091882,Touri; Behrouz,3,5,70,67
1656038228711,ECE 180,A00,083140,Abi Samra; Nicholas Camill,1,0,30,29
1656038228711,ECE 180,B00,083141,Abi Samra; Nicholas Camill,0,8,28,28
1656038234738,MATH 10A,A01,083735,Patchell; Gregory David,0,0,30,30
1656038234738,MATH 10A,A02,083736,Patchell; Gregory David,20,0,30,10
1656038234738,MATH 10A,A03,083737,Patchell; Gregory David,16,0,30,14
1656038240767,MATH 10B,A01,083207,Lim; Seonhee,1,1,34,33
1656038240767,MATH 10B,A02,083208,Lim; Seonhee,1,1,35,34
1656038240767,MATH 10B,A03,093472,Staff,0,1,34,34
1656038240767,MATH 10B,B01,083739,Sinha; Shubham,10,0,30,20
1656038246793,MATH 18,A01,083743,Cinel; Cameron Alexander,5,0,30,25
1656038246793,MATH 18,A02,083744,Cinel; Cameron Alexander,11,0,30,19
1656038246793,MATH 18,A03,083745,Cinel; Cameron Alexander,1,0,30,29
1656038246793,MATH 18,B01,083748,Ma; Zilu,0,0,36,36
1656038246793,MATH 18,B02,083749,Ma; Zilu,0,0,36,36
1656038246793,MATH 18,B03,083750,Ma; Zilu,0,0,36,36
1656038246793,MATH 18,B04,083751,Ma; Zilu,0,0,36,36
1656038246793,MATH 18,B05,093473,Staff,0,0,36,36
1656038246793,MATH 18,B06,093474,Staff,3,0,36,33
1656038252820,MATH 20A,A01,083754,Zheng; Zequn,11,0,40,29
1656038258848,MATH 20B,A01,083756,Briones; Jor-el Thomas Caparas,0,0,36,36
1656038258848,MATH 20B,A02,083757,Briones; Jor-el Thomas Caparas,1,0,36,35
1656038258848,MATH 20B,A03,093475,Staff,0,0,36,36
1656038264873,MATH 20C,A01,083760,Briones; Jor-el Thomas Caparas,0,2,35,35
1656038264873,MATH 20C,A02,083761,Briones; Jor-el Thomas Caparas,6,1,35,29
1656038264873,MATH 20C,A03,093476,Staff,0,1,35,35
1656038264873,MATH 20C,B01,083762,Bach; Quang Tran,3,0,30,27
1656038270896,MATH 20D,A01,083765,Tran; Brian Kha,2,0,30,28
1656038270896,MATH 20D,A02,083766,Tran; Brian Kha,0,1,30,30
1656038270896,MATH 20D,A03,083767,Tran; Brian Kha,0,0,30,30
1656038276920,MATH 20E,A01,083771,Ganguly; Soumya,0,1,32,32
1656038276920,MATH 20E,A02,083772,Ganguly; Soumya,1,1,32,31
1656038276920,MATH 20E,B01,083773,Ciotti; Benjamin,13,0,35,22
1656038276920,MATH 20E,B02,083774,Ciotti; Benjamin,12,0,35,23
1656038282950,MATH 103A,A01,083777,Greenfeld; Be'Eri,2,1,36,34
1656038282950,MATH 103A,A02,083778,Greenfeld; Be'Eri,1,0,36,35
1656038282950,MATH 103A,A03,093561,Staff,0,1,36,36
1656038282950,MATH 103A,B01,083779,Greenfeld; Be'Eri,8,1,36,28
1656038282950,MATH 103A,B02,083780,Greenfeld; Be'Eri,0,0,36,36
1656038282950,MATH 103A,B03,093562,Staff,0,0,36,36
1656038288973,MATH 105,A01,085443,Carter; Anne Toulson,4,1,35,31
1656038288973,MATH 105,A02,093477,Staff,9,0,35,26
1656038294995,MATH 109,A01,083213,Ganzberger; Geoffrey Michael,0,1,34,34
1656038294995,MATH 109,A02,083214,Ganzberger; Geoffrey Michael,0,0,34,34
1656038294995,MATH 109,A03,093478,Staff,1,0,34,33
1656038294995,MATH 109,B01,083215,Ganzberger; Geoffrey Michael,2,0,32,30
1656038294995,MATH 109,B02,083216,Ganzberger; Geoffrey Michael,0,0,32,32
1656038294995,MATH 109,B03,093479,Staff,3,0,32,29
1656038301024,MATH 142A,A01,083219,Chow; Bennett,1,0,32,31
1656038301024,MATH 142A,A02,083220,Chow; Bennett,7,0,32,25
1656038301024,MATH 142A,A03,093480,Staff,4,0,32,28
1656038301024,MATH 142A,B03,093481,Staff,3,0,32,29
1656038301024,MATH 142A,B04,093558,Staff,5,0,32,27
1656038301024,MATH 142A,B05,093559,Staff,0,0,32,32
1656038307049,MATH 193A,A01,083224,Rotar; Vladimir,1,2,34,33
1656038307049,MATH 193A,A02,083225,Rotar; Vladimir,0,0,34,34
1656038307049,MATH 193A,A03,083781,Rotar; Vladimir,1,0,34,33
1656038307049,MATH 193A,A04,083782,Rotar; Vladimir,3,0,34,31
1656038307049,MATH 193A,A05,093482,Rotar; Vladimir,0,0,34,34
1656038313075,MATH 197,001,091859,McAuley; Julian John,9999,0,9999,0
1656038313075,MATH 197,002,095566,Kedlaya; Kiran S.,9997,0,9999,2
1656038313075,MATH 197,003,095567,Xiao; Ming,9999,0,9999,0
1656038313075,MATH 197,004,095571,Perols; Johan Lars,9998,0,9999,1
1656038320135,COGS 9,A01,083615,Shannon; Kyle Michael,3,1,75,72
1656038326159,COGS 11,A01,083617,Boyle; Mary E. T.,11,2,48,37
1656038332186,COGS 13,A01,083071,Bastos; Amalia Pinkusfeld,4,3,71,67
1656038338208,COGS 14A,A01,092681,Semenuks; Arturs,4,25,100,96
1656038344237,COGS 14B,A01,083073,Cheng; Tzu-Han,7,0,63,56
1656038350260,COGS 17,A01,092677,Semenuks; Arturs,8,7,81,73
1656038356284,COGS 100,A01,083619,Allen; Michael Gordon,3,2,70,67
1656038362315,COGS 101A,A01,083621,Davis; Joshua Daniel,4,3,68,64
1656038368341,COGS 101B,A01,091572,Allen; Michael Gordon,0,0,65,65
1656038374367,COGS 101C,A01,083625,Delgado; Tania,7,0,35,28
1656038380397,COGS 107A,A01,083627,Boyle; Mary E. T.,1,2,60,59
1656038386421,COGS 118A,A01,083075,Gupta; Anjum,21,16,76,55
1656038392445,CSE 3,A50,083646,Miranda; Gregory Joseph,14,0,50,36
1656038398467,CSE 8A,A50,083650,Miranda; Gregory Joseph,4,11,56,52
1656038404490,CSE 11,A01,083080,Cao; Yingjun,0,65,40,40
1656038410513,CSE 12,A01,083652,Krause-Levy; Sophia Louisa,7,8,120,113
1656038416538,CSE 15L,A01,083654,Morris; Justin Loren,3,1,50,47
1656038416538,CSE 15L,A02,083655,Morris; Justin Loren,2,1,50,48
1656038422560,CSE 20,A01,083657,Tran; Khoa Dang,29,0,80,51
1656038428587,CSE 21,A01,095574,Bach; Quang Tran,23,0,48,25
1656038434614,CSE 30,A01,083084,Eldon; John,2,10,80,78
1656038434614,CSE 30,B01,095061,Bhaskar; Nishant,2,5,50,48
1656038440637,CSE 100,A01,083659,Cao; Yingjun,2,25,70,68
1656038446664,CSE 134B,A01,083661,Powell; Thomas Allan,6,6,100,94
1656038452694,CSE 140,A01,083663,Gungor; Onat,6,0,85,79
1656038458717,CSE 140L,A01,083088,Eldon; John,5,0,100,95
1656038464741,CSE 175,A01,083665,Kumar; Rakesh,0,0,25,25
1656038470764,CSE 190,A00,092507,Dubnov; Shlomo,1,0,20,19
1656038476791,ECE 45,A01,083139,Congero; Spencer William,1,1,75,74
1656038482814,ECE 65,A50,083695,Saad; Andrew S,6,0,30,24
1656038482814,ECE 65,A51,095125,Staff,23,0,26,3
1656038488854,ECE 109,A01,091882,Touri; Behrouz,3,5,70,67
1656038494882,ECE 180,A00,083140,Abi Samra; Nicholas Camill,1,0,30,29
1656038494882,ECE 180,B00,083141,Abi Samra; Nicholas Camill,0,8,28,28
1656038500908,MATH 10A,A01,083735,Patchell; Gregory David,0,0,30,30
1656038500908,MATH 10A,A02,083736,Patchell; Gregory David,20,0,30,10
1656038500908,MATH 10A,A03,083737,Patchell; Gregory David,16,0,30,14
1656038506937,MATH 10B,A01,083207,Lim; Seonhee,1,1,34,33
1656038506937,MATH 10B,A02,083208,Lim; Seonhee,1,1,35,34
1656038506937,MATH 10B,A03,093472,Staff,0,1,34,34
1656038506937,MATH 10B,B01,083739,Sinha; Shubham,10,0,30,20
1656038512962,MATH 18,A01,083743,Cinel; Cameron Alexander,5,0,30,25
1656038512962,MATH 18,A02,083744,Cinel; Cameron Alexander,11,0,30,19
1656038512962,MATH 18,A03,083745,Cinel; Cameron Alexander,1,0,30,29
1656038512962,MATH 18,B01,083748,Ma; Zilu,0,0,36,36
1656038512962,MATH 18,B02,083749,Ma; Zilu,0,0,36,36
1656038512962,MATH 18,B03,083750,Ma; Zilu,0,0,36,36
1656038512962,MATH 18,B04,083751,Ma; Zilu,0,0,36,36
1656038512962,MATH 18,B05,093473,Staff,0,0,36,36
1656038512962,MATH 18,B06,093474,Staff,3,0,36,33
1656038518985,MATH 20A,A01,083754,Zheng; Zequn,11,0,40,29
1656038525012,MATH 20B,A01,083756,Briones; Jor-el Thomas Caparas,0,0,36,36
1656038525012,MATH 20B,A02,083757,Briones; Jor-el Thomas Caparas,1,0,36,35
1656038525012,MATH 20B,A03,093475,Staff,0,0,36,36
1656038531036,MATH 20C,A01,083760,Briones; Jor-el Thomas Caparas,0,2,35,35
1656038531036,MATH 20C,A02,083761,Briones; Jor-el Thomas Caparas,6,1,35,29
1656038531036,MATH 20C,A03,093476,Staff,0,1,35,35
1656038531036,MATH 20C,B01,083762,Bach; Quang Tran,3,0,30,27
1656038537064,MATH 20D,A01,083765,Tran; Brian Kha,2,0,30,28
1656038537064,MATH 20D,A02,083766,Tran; Brian Kha,0,1,30,30
1656038537064,MATH 20D,A03,083767,Tran; Brian Kha,0,0,30,30
1656038543088,MATH 20E,A01,083771,Ganguly; Soumya,0,1,32,32
1656038543088,MATH 20E,A02,083772,Ganguly; Soumya,1,1,32,31
1656038543088,MATH 20E,B01,083773,Ciotti; Benjamin,13,0,35,22
1656038543088,MATH 20E,B02,083774,Ciotti; Benjamin,12,0,35,23
1656038549117,MATH 103A,A01,083777,Greenfeld; Be'Eri,2,1,36,34
1656038549117,MATH 103A,A02,083778,Greenfeld; Be'Eri,1,0,36,35
1656038549117,MATH 103A,A03,093561,Staff,0,1,36,36
1656038549117,MATH 103A,B01,083779,Greenfeld; Be'Eri,8,1,36,28
1656038549117,MATH 103A,B02,083780,Greenfeld; Be'Eri,0,0,36,36
1656038549117,MATH 103A,B03,093562,Staff,0,0,36,36
1656038555139,MATH 105,A01,085443,Carter; Anne Toulson,4,1,35,31
1656038555139,MATH 105,A02,093477,Staff,9,0,35,26
1656038561164,MATH 109,A01,083213,Ganzberger; Geoffrey Michael,0,1,34,34
1656038561164,MATH 109,A02,083214,Ganzberger; Geoffrey Michael,0,0,34,34
1656038561164,MATH 109,A03,093478,Staff,1,0,34,33
1656038561164,MATH 109,B01,083215,Ganzberger; Geoffrey Michael,2,0,32,30
1656038561164,MATH 109,B02,083216,Ganzberger; Geoffrey Michael,0,0,32,32
1656038561164,MATH 109,B03,093479,Staff,3,0,32,29
1656038567195,MATH 142A,A01,083219,Chow; Bennett,1,0,32,31
1656038567195,MATH 142A,A02,083220,Chow; Bennett,7,0,32,25
1656038567195,MATH 142A,A03,093480,Staff,4,0,32,28
1656038567195,MATH 142A,B03,093481,Staff,3,0,32,29
1656038567195,MATH 142A,B04,093558,Staff,5,0,32,27
1656038567195,MATH 142A,B05,093559,Staff,0,0,32,32
1656038573225,MATH 193A,A01,083224,Rotar; Vladimir,1,2,34,33
1656038573225,MATH 193A,A02,083225,Rotar; Vladimir,0,0,34,34
1656038573225,MATH 193A,A03,083781,Rotar; Vladimir,1,0,34,33
1656038573225,MATH 193A,A04,083782,Rotar; Vladimir,3,0,34,31
1656038573225,MATH 193A,A05,093482,Rotar; Vladimir,0,0,34,34
1656038579248,MATH 197,001,091859,McAuley; Julian John,9999,0,9999,0
1656038579248,MATH 197,002,095566,Kedlaya; Kiran S.,9997,0,9999,2
1656038579248,MATH 197,003,095567,Xiao; Ming,9999,0,9999,0
1656038579248,MATH 197,004,095571,Perols; Johan Lars,9998,0,9999,1
1656038586314,COGS 9,A01,083615,Shannon; Kyle Michael,3,1,75,72
1656038592337,COGS 11,A01,083617,Boyle; Mary E. T.,11,2,48,37
1656038598364,COGS 13,A01,083071,Bastos; Amalia Pinkusfeld,4,3,71,67
1656038604388,COGS 14A,A01,092681,Semenuks; Arturs,4,25,100,96
1656038610412,COGS 14B,A01,083073,Cheng; Tzu-Han,7,0,63,56
1656038616441,COGS 17,A01,092677,Semenuks; Arturs,8,7,81,73
1656038622467,COGS 100,A01,083619,Allen; Michael Gordon,3,2,70,67
1656038628494,COGS 101A,A01,083621,Davis; Joshua Daniel,4,3,68,64
1656038634516,COGS 101B,A01,091572,Allen; Michael Gordon,0,0,65,65
1656038640548,COGS 101C,A01,083625,Delgado; Tania,7,0,35,28
1656038646571,COGS 107A,A01,083627,Boyle; Mary E. T.,1,2,60,59
1656038652594,COGS 118A,A01,083075,Gupta; Anjum,21,16,76,55
1656038658619,CSE 3,A50,083646,Miranda; Gregory Joseph,14,0,50,36
1656038664642,CSE 8A,A50,083650,Miranda; Gregory Joseph,4,11,56,52
1656038670670,CSE 11,A01,083080,Cao; Yingjun,0,65,40,40
1656038676703,CSE 12,A01,083652,Krause-Levy; Sophia Louisa,7,8,120,113
1656038682727,CSE 15L,A01,083654,Morris; Justin Loren,3,1,50,47
1656038682727,CSE 15L,A02,083655,Morris; Justin Loren,2,1,50,48
1656038688750,CSE 20,A01,083657,Tran; Khoa Dang,29,0,80,51
1656038694848,CSE 21,A01,095574,Bach; Quang Tran,23,0,48,25
1656038700873,CSE 30,A01,083084,Eldon; John,2,10,80,78
1656038700873,CSE 30,B01,095061,Bhaskar; Nishant,2,5,50,48
1656038706912,CSE 100,A01,083659,Cao; Yingjun,2,25,70,68
1656038712933,CSE 134B,A01,083661,Powell; Thomas Allan,6,6,100,94
1656038718956,CSE 140,A01,083663,Gungor; Onat,6,0,85,79
1656038724981,CSE 140L,A01,083088,Eldon; John,5,0,100,95
1656038731006,CSE 175,A01,083665,Kumar; Rakesh,0,0,25,25
1656038737033,CSE 190,A00,092507,Dubnov; Shlomo,1,0,20,19
1656038743056,ECE 45,A01,083139,Congero; Spencer William,1,1,75,74
1656038749083,ECE 65,A50,083695,Saad; Andrew S,6,0,30,24
1656038749083,ECE 65,A51,095125,Staff,23,0,26,3
1656038755112,ECE 109,A01,091882,Touri; Behrouz,3,5,70,67
1656038761136,ECE 180,A00,083140,Abi Samra; Nicholas Camill,1,0,30,29
1656038761136,ECE 180,B00,083141,Abi Samra; Nicholas Camill,0,8,28,28
1656038767161,MATH 10A,A01,083735,Patchell; Gregory David,0,0,30,30
1656038767161,MATH 10A,A02,083736,Patchell; Gregory David,20,0,30,10
1656038767161,MATH 10A,A03,083737,Patchell; Gregory David,16,0,30,14
1656038773198,MATH 10B,A01,083207,Lim; Seonhee,1,1,34,33
1656038773198,MATH 10B,A02,083208,Lim; Seonhee,1,1,35,34
1656038773198,MATH 10B,A03,093472,Staff,0,1,34,34
1656038773198,MATH 10B,B01,083739,Sinha; Shubham,10,0,30,20
1656038779223,MATH 18,A01,083743,Cinel; Cameron Alexander,5,0,30,25
1656038779223,MATH 18,A02,083744,Cinel; Cameron Alexander,11,0,30,19
1656038779223,MATH 18,A03,083745,Cinel; Cameron Alexander,1,0,30,29
1656038779223,MATH 18,B01,083748,Ma; Zilu,0,0,36,36
1656038779223,MATH 18,B02,083749,Ma; Zilu,0,0,36,36
1656038779223,MATH 18,B03,083750,Ma; Zilu,0,0,36,36
1656038779223,MATH 18,B04,083751,Ma; Zilu,0,0,36,36
1656038779223,MATH 18,B05,093473,Staff,0,0,36,36
1656038779223,MATH 18,B06,093474,Staff,3,0,36,33
1656038785252,MATH 20A,A01,083754,Zheng; Zequn,11,0,40,29
1656038791279,MATH 20B,A01,083756,Briones; Jor-el Thomas Caparas,0,0,36,36
1656038791279,MATH 20B,A02,083757,Briones; Jor-el Thomas Caparas,1,0,36,35
1656038791279,MATH 20B,A03,093475,Staff,0,0,36,36
1656038797302,MATH 20C,A01,083760,Briones; Jor-el Thomas Caparas,0,2,35,35
1656038797302,MATH 20C,A02,083761,Briones; Jor-el Thomas Caparas,6,1,35,29
1656038797302,MATH 20C,A03,093476,Staff,0,1,35,35
1656038797302,MATH 20C,B01,083762,Bach; Quang Tran,3,0,30,27
1656038803327,MATH 20D,A01,083765,Tran; Brian Kha,2,0,30,28
1656038803327,MATH 20D,A02,083766,Tran; Brian Kha,0,1,30,30
1656038803327,MATH 20D,A03,083767,Tran; Brian Kha,0,0,30,30
1656038809355,MATH 20E,A01,083771,Ganguly; Soumya,0,1,32,32
1656038809355,MATH 20E,A02,083772,Ganguly; Soumya,1,1,32,31
1656038809355,MATH 20E,B01,083773,Ciotti; Benjamin,13,0,35,22
1656038809355,MATH 20E,B02,083774,Ciotti; Benjamin,12,0,35,23
1656038815386,MATH 103A,A01,083777,Greenfeld; Be'Eri,2,1,36,34
1656038815386,MATH 103A,A02,083778,Greenfeld; Be'Eri,1,0,36,35
1656038815386,MATH 103A,A03,093561,Staff,0,1,36,36
1656038815386,MATH 103A,B01,083779,Greenfeld; Be'Eri,8,1,36,28
1656038815386,MATH 103A,B02,083780,Greenfeld; Be'Eri,0,0,36,36
1656038815386,MATH 103A,B03,093562,Staff,0,0,36,36
1656038821417,MATH 105,A01,085443,Carter; Anne Toulson,4,1,35,31
1656038821417,MATH 105,A02,093477,Staff,9,0,35,26
1656038827443,MATH 109,A01,083213,Ganzberger; Geoffrey Michael,0,1,34,34
1656038827443,MATH 109,A02,083214,Ganzberger; Geoffrey Michael,0,0,34,34
1656038827443,MATH 109,A03,093478,Staff,1,0,34,33
1656038827443,MATH 109,B01,083215,Ganzberger; Geoffrey Michael,2,0,32,30
1656038827443,MATH 109,B02,083216,Ganzberger; Geoffrey Michael,0,0,32,32
1656038827443,MATH 109,B03,093479,Staff,3,0,32,29
1656038833467,MATH 142A,A01,083219,Chow; Bennett,1,0,32,31
1656038833467,MATH 142A,A02,083220,Chow; Bennett,7,0,32,25
1656038833467,MATH 142A,A03,093480,Staff,4,0,32,28
1656038833467,MATH 142A,B03,093481,Staff,3,0,32,29
1656038833467,MATH 142A,B04,093558,Staff,5,0,32,27
1656038833467,MATH 142A,B05,093559,Staff,0,0,32,32
1656038839496,MATH 193A,A01,083224,Rotar; Vladimir,1,2,34,33
1656038839496,MATH 193A,A02,083225,Rotar; Vladimir,0,0,34,34
1656038839496,MATH 193A,A03,083781,Rotar; Vladimir,1,0,34,33
1656038839496,MATH 193A,A04,083782,Rotar; Vladimir,3,0,34,31
1656038839496,MATH 193A,A05,093482,Rotar; Vladimir,0,0,34,34
1656038845521,MATH 197,001,091859,McAuley; Julian John,9999,0,9999,0
1656038845521,MATH 197,002,095566,Kedlaya; Kiran S.,9997,0,9999,2
1656038845521,MATH 197,003,095567,Xiao; Ming,9999,0,9999,0
1656038845521,MATH 197,004,095571,Perols; Johan Lars,9998,0,9999,1
1656038852576,COGS 9,A01,083615,Shannon; Kyle Michael,3,1,75,72
1656038858600,COGS 11,A01,083617,Boyle; Mary E. T.,11,2,48,37
1656038864624,COGS 13,A01,083071,Bastos; Amalia Pinkusfeld,4,3,71,67
1656038870648,COGS 14A,A01,092681,Semenuks; Arturs,4,25,100,96
1656038876670,COGS 14B,A01,083073,Cheng; Tzu-Han,7,0,63,56
1656038882695,COGS 17,A01,092677,Semenuks; Arturs,8,7,81,73
1656038888719,COGS 100,A01,083619,Allen; Michael Gordon,3,2,70,67
1656038894745,COGS 101A,A01,083621,Davis; Joshua Daniel,4,3,68,64
1656038900772,COGS 101B,A01,091572,Allen; Michael Gordon,0,0,65,65
1656038906798,COGS 101C,A01,083625,Delgado; Tania,7,0,35,28
1656038912824,COGS 107A,A01,083627,Boyle; Mary E. T.,1,2,60,59
1656038918848,COGS 118A,A01,083075,Gupta; Anjum,21,16,76,55
1656038924876,CSE 3,A50,083646,Miranda; Gregory Joseph,14,0,50,36
1656038930902,CSE 8A,A50,083650,Miranda; Gregory Joseph,4,11,56,52
1656038936929,CSE 11,A01,083080,Cao; Yingjun,0,65,40,40
1656038942954,CSE 12,A01,083652,Krause-Levy; Sophia Louisa,7,8,120,113
1656038948978,CSE 15L,A01,083654,Morris; Justin Loren,3,1,50,47
1656038948978,CSE 15L,A02,083655,Morris; Justin Loren,2,1,50,48
1656038955001,CSE 20,A01,083657,Tran; Khoa Dang,29,0,80,51
1656038961026,CSE 21,A01,095574,Bach; Quang Tran,23,0,48,25
1656038967057,CSE 30,A01,083084,Eldon; John,2,10,80,78
1656038967057,CSE 30,B01,095061,Bhaskar; Nishant,2,5,50,48
1656038973082,CSE 100,A01,083659,Cao; Yingjun,2,25,70,68
1656038979108,CSE 134B,A01,083661,Powell; Thomas Allan,6,6,100,94
1656038985132,CSE 140,A01,083663,Gungor; Onat,6,0,85,79
1656038991154,CSE 140L,A01,083088,Eldon; John,5,0,100,95
1656038997186,CSE 175,A01,083665,Kumar; Rakesh,0,0,25,25
1656039003214,CSE 190,A00,092507,Dubnov; Shlomo,1,0,20,19
1656039009241,ECE 45,A01,083139,Congero; Spencer William,1,1,75,74
1656039015267,ECE 65,A50,083695,Saad; Andrew S,6,0,30,24
1656039015267,ECE 65,A51,095125,Staff,23,0,26,3
1656039021295,ECE 109,A01,091882,Touri; Behrouz,3,5,70,67
1656039027318,ECE 180,A00,083140,Abi Samra; Nicholas Camill,1,0,30,29
1656039027318,ECE 180,B00,083141,Abi Samra; Nicholas Camill,0,8,28,28
1656039033349,MATH 10A,A01,083735,Patchell; Gregory David,0,0,30,30
1656039033349,MATH 10A,A02,083736,Patchell; Gregory David,20,0,30,10
1656039033349,MATH 10A,A03,083737,Patchell; Gregory David,16,0,30,14
1656039039378,MATH 10B,A01,083207,Lim; Seonhee,1,1,34,33
1656039039378,MATH 10B,A02,083208,Lim; Seonhee,1,1,35,34
1656039039378,MATH 10B,A03,093472,Staff,0,1,34,34
1656039039378,MATH 10B,B01,083739,Sinha; Shubham,10,0,30,20
1656039045402,MATH 18,A01,083743,Cinel; Cameron Alexander,5,0,30,25
1656039045402,MATH 18,A02,083744,Cinel; Cameron Alexander,11,0,30,19
1656039045402,MATH 18,A03,083745,Cinel; Cameron Alexander,1,0,30,29
1656039045402,MATH 18,B01,083748,Ma; Zilu,0,0,36,36
1656039045402,MATH 18,B02,083749,Ma; Zilu,0,0,36,36
1656039045402,MATH 18,B03,083750,Ma; Zilu,0,0,36,36
1656039045402,MATH 18,B04,083751,Ma; Zilu,0,0,36,36
1656039045402,MATH 18,B05,093473,Staff,0,0,36,36
1656039045402,MATH 18,B06,093474,Staff,3,0,36,33
1656039051429,MATH 20A,A01,083754,Zheng; Zequn,11,0,40,29
1656039057452,MATH 20B,A01,083756,Briones; Jor-el Thomas Caparas,0,0,36,36
1656039057452,MATH 20B,A02,083757,Briones; Jor-el Thomas Caparas,1,0,36,35
1656039057452,MATH 20B,A03,093475,Staff,0,0,36,36
1656039063486,MATH 20C,A01,083760,Briones; Jor-el Thomas Caparas,0,2,35,35
1656039063486,MATH 20C,A02,083761,Briones; Jor-el Thomas Caparas,6,1,35,29
1656039063486,MATH 20C,A03,093476,Staff,0,1,35,35
1656039063486,MATH 20C,B01,083762,Bach; Quang Tran,3,0,30,27
1656039069511,MATH 20D,A01,083765,Tran; Brian Kha,2,0,30,28
1656039069511,MATH 20D,A02,083766,Tran; Brian Kha,0,1,30,30
1656039069511,MATH 20D,A03,083767,Tran; Brian Kha,0,0,30,30
1656039075541,MATH 20E,A01,083771,Ganguly; Soumya,0,1,32,32
1656039075541,MATH 20E,A02,083772,Ganguly; Soumya,1,1,32,31
1656039075541,MATH 20E,B01,083773,Ciotti; Benjamin,13,0,35,22
1656039075541,MATH 20E,B02,083774,Ciotti; Benjamin,12,0,35,23
1656039081566,MATH 103A,A01,083777,Greenfeld; Be'Eri,2,1,36,34
1656039081566,MATH 103A,A02,083778,Greenfeld; Be'Eri,1,0,36,35
1656039081566,MATH 103A,A03,093561,Staff,0,1,36,36
1656039081566,MATH 103A,B01,083779,Greenfeld; Be'Eri,8,1,36,28
1656039081566,MATH 103A,B02,083780,Greenfeld; Be'Eri,0,0,36,36
1656039081566,MATH 103A,B03,093562,Staff,0,0,36,36
1656039087599,MATH 105,A01,085443,Carter; Anne Toulson,4,1,35,31
1656039087599,MATH 105,A02,093477,Staff,9,0,35,26
1656039093626,MATH 109,A01,083213,Ganzberger; Geoffrey Michael,0,1,34,34
1656039093626,MATH 109,A02,083214,Ganzberger; Geoffrey Michael,0,0,34,34
1656039093626,MATH 109,A03,093478,Staff,1,0,34,33
1656039093626,MATH 109,B01,083215,Ganzberger; Geoffrey Michael,2,0,32,30
1656039093626,MATH 109,B02,083216,Ganzberger; Geoffrey Michael,0,0,32,32
1656039093626,MATH 109,B03,093479,Staff,3,0,32,29
1656039099651,MATH 142A,A01,083219,Chow; Bennett,1,0,32,31
1656039099651,MATH 142A,A02,083220,Chow; Bennett,7,0,32,25
1656039099651,MATH 142A,A03,093480,Staff,4,0,32,28
1656039099651,MATH 142A,B03,093481,Staff,3,0,32,29
1656039099651,MATH 142A,B04,093558,Staff,5,0,32,27
1656039099651,MATH 142A,B05,093559,Staff,0,0,32,32
1656039105675,MATH 193A,A01,083224,Rotar; Vladimir,1,2,34,33
1656039105675,MATH 193A,A02,083225,Rotar; Vladimir,0,0,34,34
1656039105675,MATH 193A,A03,083781,Rotar; Vladimir,1,0,34,33
1656039105675,MATH 193A,A04,083782,Rotar; Vladimir,3,0,34,31
1656039105675,MATH 193A,A05,093482,Rotar; Vladimir,0,0,34,34
1656039111698,MATH 197,001,091859,McAuley; Julian John,9999,0,9999,0
1656039111698,MATH 197,002,095566,Kedlaya; Kiran S.,9997,0,9999,2
1656039111698,MATH 197,003,095567,Xiao; Ming,9999,0,9999,0
1656039111698,MATH 197,004,095571,Perols; Johan Lars,9998,0,9999,1
1656039118765,COGS 9,A01,083615,Shannon; Kyle Michael,3,1,75,72
1656039124791,COGS 11,A01,083617,Boyle; Mary E. T.,11,2,48,37
1656039130815,COGS 13,A01,083071,Bastos; Amalia Pinkusfeld,4,3,71,67
1656039136841,COGS 14A,A01,092681,Semenuks; Arturs,4,25,100,96
1656039142864,COGS 14B,A01,083073,Cheng; Tzu-Han,7,0,63,56
1656039148891,COGS 17,A01,092677,Semenuks; Arturs,8,7,81,73
1656039154914,COGS 100,A01,083619,Allen; Michael Gordon,3,2,70,67
1656039160942,COGS 101A,A01,083621,Davis; Joshua Daniel,4,3,68,64
1656039166966,COGS 101B,A01,091572,Allen; Michael Gordon,0,0,65,65
1656039172989,COGS 101C,A01,083625,Delgado; Tania,7,0,35,28
1656039179013,COGS 107A,A01,083627,Boyle; Mary E. T.,1,2,60,59
1656039185041,COGS 118A,A01,083075,Gupta; Anjum,21,16,76,55
1656039191069,CSE 3,A50,083646,Miranda; Gregory Joseph,14,0,50,36
1656039197092,CSE 8A,A50,083650,Miranda; Gregory Joseph,4,11,56,52
1656039203121,CSE 11,A01,083080,Cao; Yingjun,0,65,40,40
1656039209152,CSE 12,A01,083652,Krause-Levy; Sophia Louisa,7,8,120,113
1656039215174,CSE 15L,A01,083654,Morris; Justin Loren,3,1,50,47
1656039215174,CSE 15L,A02,083655,Morris; Justin Loren,2,1,50,48
1656039221197,CSE 20,A01,083657,Tran; Khoa Dang,29,0,80,51
1656039227225,CSE 21,A01,095574,Bach; Quang Tran,23,0,48,25
1656039233248,CSE 30,A01,083084,Eldon; John,2,10,80,78
1656039233248,CSE 30,B01,095061,Bhaskar; Nishant,2,5,50,48
1656039239274,CSE 100,A01,083659,Cao; Yingjun,2,25,70,68
1656039245301,CSE 134B,A01,083661,Powell; Thomas Allan,6,6,100,94
1656039251325,CSE 140,A01,083663,Gungor; Onat,6,0,85,79
1656039257352,CSE 140L,A01,083088,Eldon; John,5,0,100,95
1656039263378,CSE 175,A01,083665,Kumar; Rakesh,0,0,25,25
1656039269405,CSE 190,A00,092507,Dubnov; Shlomo,1,0,20,19
1656039275432,ECE 45,A01,083139,Congero; Spencer William,1,1,75,74
1656039281454,ECE 65,A50,083695,Saad; Andrew S,6,0,30,24
1656039281454,ECE 65,A51,095125,Staff,23,0,26,3
1656039287482,ECE 109,A01,091882,Touri; Behrouz,3,5,70,67
1656039293601,ECE 180,A00,083140,Abi Samra; Nicholas Camill,1,0,30,29
1656039293601,ECE 180,B00,083141,Abi Samra; Nicholas Camill,0,8,28,28
1656039299625,MATH 10A,A01,083735,Patchell; Gregory David,0,0,30,30
1656039299625,MATH 10A,A02,083736,Patchell; Gregory David,20,0,30,10
1656039299625,MATH 10A,A03,083737,Patchell; Gregory David,16,0,30,14
1656039305655,MATH 10B,A01,083207,Lim; Seonhee,1,1,34,33
1656039305655,MATH 10B,A02,083208,Lim; Seonhee,1,1,35,34
1656039305655,MATH 10B,A03,093472,Staff,0,1,34,34
1656039305655,MATH 10B,B01,083739,Sinha; Shubham,10,0,30,20
1656039311685,MATH 18,A01,083743,Cinel; Cameron Alexander,5,0,30,25
1656039311685,MATH 18,A02,083744,Cinel; Cameron Alexander,11,0,30,19
1656039311685,MATH 18,A03,083745,Cinel; Cameron Alexander,1,0,30,29
1656039311685,MATH 18,B01,083748,Ma; Zilu,0,0,36,36
1656039311685,MATH 18,B02,083749,Ma; Zilu,0,0,36,36
1656039311685,MATH 18,B03,083750,Ma; Zilu,0,0,36,36
1656039311685,MATH 18,B04,083751,Ma; Zilu,0,0,36,36
1656039311685,MATH 18,B05,093473,Staff,0,0,36,36
1656039311685,MATH 18,B06,093474,Staff,3,0,36,33
1656039317710,MATH 20A,A01,083754,Zheng; Zequn,11,0,40,29
1656039323737,MATH 20B,A01,083756,Briones; Jor-el Thomas Caparas,0,0,36,36
1656039323737,MATH 20B,A02,083757,Briones; Jor-el Thomas Caparas,1,0,36,35
1656039323737,MATH 20B,A03,093475,Staff,0,0,36,36
1656039329761,MATH 20C,A01,083760,Briones; Jor-el Thomas Caparas,0,2,35,35
1656039329761,MATH 20C,A02,083761,Briones; Jor-el Thomas Caparas,6,1,35,29
1656039329761,MATH 20C,A03,093476,Staff,0,1,35,35
1656039329761,MATH 20C,B01,083762,Bach; Quang Tran,3,0,30,27
1656039335785,MATH 20D,A01,083765,Tran; Brian Kha,2,0,30,28
1656039335785,MATH 20D,A02,083766,Tran; Brian Kha,0,1,30,30
1656039335785,MATH 20D,A03,083767,Tran; Brian Kha,0,0,30,30
1656039341808,MATH 20E,A01,083771,Ganguly; Soumya,0,1,32,32
1656039341808,MATH 20E,A02,083772,Ganguly; Soumya,1,1,32,31
1656039341808,MATH 20E,B01,083773,Ciotti; Benjamin,13,0,35,22
1656039341808,MATH 20E,B02,083774,Ciotti; Benjamin,12,0,35,23
1656039347833,MATH 103A,A01,083777,Greenfeld; Be'Eri,2,1,36,34
1656039347833,MATH 103A,A02,083778,Greenfeld; Be'Eri,1,0,36,35
1656039347833,MATH 103A,A03,093561,Staff,0,1,36,36
1656039347833,MATH 103A,B01,083779,Greenfeld; Be'Eri,8,1,36,28
1656039347833,MATH 103A,B02,083780,Greenfeld; Be'Eri,0,0,36,36
1656039347833,MATH 103A,B03,093562,Staff,0,0,36,36
1656039353862,MATH 105,A01,085443,Carter; Anne Toulson,4,1,35,31
1656039353862,MATH 105,A02,093477,Staff,9,0,35,26
1656039359899,MATH 109,A01,083213,Ganzberger; Geoffrey Michael,0,1,34,34
1656039359899,MATH 109,A02,083214,Ganzberger; Geoffrey Michael,0,0,34,34
1656039359899,MATH 109,A03,093478,Staff,1,0,34,33
1656039359899,MATH 109,B01,083215,Ganzberger; Geoffrey Michael,2,0,32,30
1656039359899,MATH 109,B02,083216,Ganzberger; Geoffrey Michael,0,0,32,32
1656039359899,MATH 109,B03,093479,Staff,3,0,32,29
1656039365938,MATH 142A,A01,083219,Chow; Bennett,1,0,32,31
1656039365938,MATH 142A,A02,083220,Chow; Bennett,7,0,32,25
1656039365938,MATH 142A,A03,093480,Staff,4,0,32,28
1656039365938,MATH 142A,B03,093481,Staff,3,0,32,29
1656039365938,MATH 142A,B04,093558,Staff,5,0,32,27
1656039365938,MATH 142A,B05,093559,Staff,0,0,32,32
1656039371961,MATH 193A,A01,083224,Rotar; Vladimir,1,2,34,33
1656039371961,MATH 193A,A02,083225,Rotar; Vladimir,0,0,34,34
1656039371961,MATH 193A,A03,083781,Rotar; Vladimir,1,0,34,33
1656039371961,MATH 193A,A04,083782,Rotar; Vladimir,3,0,34,31
1656039371961,MATH 193A,A05,093482,Rotar; Vladimir,0,0,34,34
1656039377988,MATH 197,001,091859,McAuley; Julian John,9999,0,9999,0
1656039377988,MATH 197,002,095566,Kedlaya; Kiran S.,9997,0,9999,2
1656039377988,MATH 197,003,095567,Xiao; Ming,9999,0,9999,0
1656039377988,MATH 197,004,095571,Perols; Johan Lars,9998,0,9999,1
1656039385046,COGS 9,A01,083615,Shannon; Kyle Michael,3,1,75,72
1656039391071,COGS 11,A01,083617,Boyle; Mary E. T.,11,2,48,37
1656039397095,COGS 13,A01,083071,Bastos; Amalia Pinkusfeld,4,3,71,67
1656039403119,COGS 14A,A01,092681,Semenuks; Arturs,4,25,100,96
1656039409142,COGS 14B,A01,083073,Cheng; Tzu-Han,7,0,63,56
1656039415165,COGS 17,A01,092677,Semenuks; Arturs,8,7,81,73
1656039421189,COGS 100,A01,083619,Allen; Michael Gordon,3,2,70,67
1656039427212,COGS 101A,A01,083621,Davis; Joshua Daniel,4,3,68,64
1656039433234,COGS 101B,A01,091572,Allen; Michael Gordon,0,0,65,65
1656039439258,COGS 101C,A01,083625,Delgado; Tania,7,0,35,28
1656039445282,COGS 107A,A01,083627,Boyle; Mary E. T.,1,2,60,59
1656039451306,COGS 118A,A01,083075,Gupta; Anjum,21,16,76,55
1656039457327,CSE 3,A50,083646,Miranda; Gregory Joseph,14,0,50,36
1656039463348,CSE 8A,A50,083650,Miranda; Gregory Joseph,4,11,56,52
1656039469372,CSE 11,A01,083080,Cao; Yingjun,0,65,40,40
1656039475405,CSE 12,A01,083652,Krause-Levy; Sophia Louisa,7,8,120,113
1656039481429,CSE 15L,A01,083654,Morris; Justin Loren,3,1,50,47
1656039481429,CSE 15L,A02,083655,Morris; Justin Loren,2,1,50,48
1656039487461,CSE 20,A01,083657,Tran; Khoa Dang,29,0,80,51
1656039493485,CSE 21,A01,095574,Bach; Quang Tran,23,0,48,25
1656039499507,CSE 30,A01,083084,Eldon; John,2,10,80,78
1656039499507,CSE 30,B01,095061,Bhaskar; Nishant,2,5,50,48
1656039505532,CSE 100,A01,083659,Cao; Yingjun,2,25,70,68
1656039511555,CSE 134B,A01,083661,Powell; Thomas Allan,6,6,100,94
1656039517587,CSE 140,A01,083663,Gungor; Onat,6,0,85,79
1656039523624,CSE 140L,A01,083088,Eldon; John,5,0,100,95
1656039529651,CSE 175,A01,083665,Kumar; Rakesh,0,0,25,25
1656039535681,CSE 190,A00,092507,Dubnov; Shlomo,1,0,20,19
1656039541707,ECE 45,A01,083139,Congero; Spencer William,1,1,75,74
1656039547731,ECE 65,A50,083695,Saad; Andrew S,6,0,30,24
1656039547731,ECE 65,A51,095125,Staff,23,0,26,3
1656039553758,ECE 109,A01,091882,Touri; Behrouz,3,5,70,67
1656039559784,ECE 180,A00,083140,Abi Samra; Nicholas Camill,1,0,30,29
1656039559784,ECE 180,B00,083141,Abi Samra; Nicholas Camill,0,8,28,28
1656039565816,MATH 10A,A01,083735,Patchell; Gregory David,0,0,30,30
1656039565816,MATH 10A,A02,083736,Patchell; Gregory David,20,0,30,10
1656039565816,MATH 10A,A03,083737,Patchell; Gregory David,16,0,30,14
1656039571842,MATH 10B,A01,083207,Lim; Seonhee,1,1,34,33
1656039571842,MATH 10B,A02,083208,Lim; Seonhee,1,1,35,34
1656039571842,MATH 10B,A03,093472,Staff,0,1,34,34
1656039571842,MATH 10B,B01,083739,Sinha; Shubham,10,0,30,20
1656039577872,MATH 18,A01,083743,Cinel; Cameron Alexander,5,0,30,25
1656039577872,MATH 18,A02,083744,Cinel; Cameron Alexander,11,0,30,19
1656039577872,MATH 18,A03,083745,Cinel; Cameron Alexander,1,0,30,29
1656039577872,MATH 18,B01,083748,Ma; Zilu,0,0,36,36
1656039577872,MATH 18,B02,083749,Ma; Zilu,0,0,36,36
1656039577872,MATH 18,B03,083750,Ma; Zilu,0,0,36,36
1656039577872,MATH 18,B04,083751,Ma; Zilu,0,0,36,36
1656039577872,MATH 18,B05,093473,Staff,0,0,36,36
1656039577872,MATH 18,B06,093474,Staff,3,0,36,33
1656039583900,MATH 20A,A01,083754,Zheng; Zequn,11,0,40,29
1656039589924,MATH 20B,A01,083756,Briones; Jor-el Thomas Caparas,0,0,36,36
1656039589924,MATH 20B,A02,083757,Briones; Jor-el Thomas Caparas,1,0,36,35
1656039589924,MATH 20B,A03,093475,Staff,0,0,36,36
1656039595947,MATH 20C,A01,083760,Briones; Jor-el Thomas Caparas,0,2,35,35
1656039595947,MATH 20C,A02,083761,Briones; Jor-el Thomas Caparas,6,1,35,29
1656039595947,MATH 20C,A03,093476,Staff,0,1,35,35
1656039595947,MATH 20C,B01,083762,Bach; Quang Tran,3,0,30,27
1656039601973,MATH 20D,A01,083765,Tran; Brian Kha,2,0,30,28
1656039601973,MATH 20D,A02,083766,Tran; Brian Kha,0,1,30,30
1656039601973,MATH 20D,A03,083767,Tran; Brian Kha,0,0,30,30
1656039607998,MATH 20E,A01,083771,Ganguly; Soumya,0,1,32,32
1656039607998,MATH 20E,A02,083772,Ganguly; Soumya,1,1,32,31
1656039607998,MATH 20E,B01,083773,Ciotti; Benjamin,13,0,35,22
1656039607998,MATH 20E,B02,083774,Ciotti; Benjamin,12,0,35,23
1656039614036,MATH 103A,A01,083777,Greenfeld; Be'Eri,2,1,36,34
1656039614036,MATH 103A,A02,083778,Greenfeld; Be'Eri,1,0,36,35
1656039614036,MATH 103A,A03,093561,Staff,0,1,36,36
1656039614036,MATH 103A,B01,083779,Greenfeld; Be'Eri,8,1,36,28
1656039614036,MATH 103A,B02,083780,Greenfeld; Be'Eri,0,0,36,36
1656039614036,MATH 103A,B03,093562,Staff,0,0,36,36
1656039620060,MATH 105,A01,085443,Carter; Anne Toulson,4,1,35,31
1656039620060,MATH 105,A02,093477,Staff,9,0,35,26
1656039626085,MATH 109,A01,083213,Ganzberger; Geoffrey Michael,0,1,34,34
1656039626085,MATH 109,A02,083214,Ganzberger; Geoffrey Michael,0,0,34,34
1656039626085,MATH 109,A03,093478,Staff,1,0,34,33
1656039626085,MATH 109,B01,083215,Ganzberger; Geoffrey Michael,2,0,32,30
1656039626085,MATH 109,B02,083216,Ganzberger; Geoffrey Michael,0,0,32,32
1656039626085,MATH 109,B03,093479,Staff,3,0,32,29
1656039632110,MATH 142A,A01,083219,Chow; Bennett,1,0,32,31
1656039632110,MATH 142A,A02,083220,Chow; Bennett,7,0,32,25
1656039632110,MATH 142A,A03,093480,Staff,4,0,32,28
1656039632110,MATH 142A,B03,093481,Staff,3,0,32,29
1656039632110,MATH 142A,B04,093558,Staff,5,0,32,27
1656039632110,MATH 142A,B05,093559,Staff,0,0,32,32
1656039638134,MATH 193A,A01,083224,Rotar; Vladimir,1,2,34,33
1656039638134,MATH 193A,A02,083225,Rotar; Vladimir,0,0,34,34
1656039638134,MATH 193A,A03,083781,Rotar; Vladimir,1,0,34,33
1656039638134,MATH 193A,A04,083782,Rotar; Vladimir,3,0,34,31
1656039638134,MATH 193A,A05,093482,Rotar; Vladimir,0,0,34,34
1656039644159,MATH 197,001,091859,McAuley; Julian John,9999,0,9999,0
1656039644159,MATH 197,002,095566,Kedlaya; Kiran S.,9997,0,9999,2
1656039644159,MATH 197,003,095567,Xiao; Ming,9999,0,9999,0
1656039644159,MATH 197,004,095571,Perols; Johan Lars,9998,0,9999,1
1656039651221,COGS 9,A01,083615,Shannon; Kyle Michael,3,1,75,72
1656039657246,COGS 11,A01,083617,Boyle; Mary E. T.,11,2,48,37
1656039663283,COGS 13,A01,083071,Bastos; Amalia Pinkusfeld,4,3,71,67
1656039669307,COGS 14A,A01,092681,Semenuks; Arturs,4,25,100,96
1656039675336,COGS 14B,A01,083073,Cheng; Tzu-Han,7,0,63,56
1656039681362,COGS 17,A01,092677,Semenuks; Arturs,8,7,81,73
1656039687385,COGS 100,A01,083619,Allen; Michael Gordon,3,2,70,67
1656039693409,COGS 101A,A01,083621,Davis; Joshua Daniel,4,3,68,64
1656039699433,COGS 101B,A01,091572,Allen; Michael Gordon,0,0,65,65
1656039705457,COGS 101C,A01,083625,Delgado; Tania,7,0,35,28
1656039711481,COGS 107A,A01,083627,Boyle; Mary E. T.,1,2,60,59
1656039717504,COGS 118A,A01,083075,Gupta; Anjum,21,16,76,55
1656039723530,CSE 3,A50,083646,Miranda; Gregory Joseph,14,0,50,36
1656039729554,CSE 8A,A50,083650,Miranda; Gregory Joseph,4,11,56,52
1656039735578,CSE 11,A01,083080,Cao; Yingjun,0,65,40,40
1656039741605,CSE 12,A01,083652,Krause-Levy; Sophia Louisa,7,8,120,113
1656039747629,CSE 15L,A01,083654,Morris; Justin Loren,3,1,50,47
1656039747629,CSE 15L,A02,083655,Morris; Justin Loren,2,1,50,48
1656039753662,CSE 20,A01,083657,Tran; Khoa Dang,29,0,80,51
1656039759690,CSE 21,A01,095574,Bach; Quang Tran,23,0,48,25
1656039765714,CSE 30,A01,083084,Eldon; John,2,10,80,78
1656039765714,CSE 30,B01,095061,Bhaskar; Nishant,2,5,50,48
1656039771740,CSE 100,A01,083659,Cao; Yingjun,2,25,70,68
1656039777767,CSE 134B,A01,083661,Powell; Thomas Allan,6,6,100,94
1656039783794,CSE 140,A01,083663,Gungor; Onat,6,0,85,79
1656039789830,CSE 140L,A01,083088,Eldon; John,5,0,100,95
1656039795858,CSE 175,A01,083665,Kumar; Rakesh,0,0,25,25
1656039801883,CSE 190,A00,092507,Dubnov; Shlomo,1,0,20,19
1656039807906,ECE 45,A01,083139,Congero; Spencer William,1,1,75,74
1656039813935,ECE 65,A50,083695,Saad; Andrew S,6,0,30,24
1656039813935,ECE 65,A51,095125,Staff,23,0,26,3
1656039819966,ECE 109,A01,091882,Touri; Behrouz,3,5,70,67
1656039825990,ECE 180,A00,083140,Abi Samra; Nicholas Camill,1,0,30,29
1656039825990,ECE 180,B00,083141,Abi Samra; Nicholas Camill,0,8,28,28
1656039832014,MATH 10A,A01,083735,Patchell; Gregory David,0,0,30,30
1656039832014,MATH 10A,A02,083736,Patchell; Gregory David,20,0,30,10
1656039832014,MATH 10A,A03,083737,Patchell; Gregory David,16,0,30,14
1656039838038,MATH 10B,A01,083207,Lim; Seonhee,1,1,34,33
1656039838038,MATH 10B,A02,083208,Lim; Seonhee,1,1,35,34
1656039838038,MATH 10B,A03,093472,Staff,0,1,34,34
1656039838038,MATH 10B,B01,083739,Sinha; Shubham,10,0,30,20
1656039844069,MATH 18,A01,083743,Cinel; Cameron Alexander,5,0,30,25
1656039844069,MATH 18,A02,083744,Cinel; Cameron Alexander,11,0,30,19
1656039844069,MATH 18,A03,083745,Cinel; Cameron Alexander,1,0,30,29
1656039844069,MATH 18,B01,083748,Ma; Zilu,0,0,36,36
1656039844069,MATH 18,B02,083749,Ma; Zilu,0,0,36,36
1656039844069,MATH 18,B03,083750,Ma; Zilu,0,0,36,36
1656039844069,MATH 18,B04,083751,Ma; Zilu,0,0,36,36
1656039844069,MATH 18,B05,093473,Staff,0,0,36,36
1656039844069,MATH 18,B06,093474,Staff,3,0,36,33
1656039850092,MATH 20A,A01,083754,Zheng; Zequn,11,0,40,29
1656039856120,MATH 20B,A01,083756,Briones; Jor-el Thomas Caparas,0,0,36,36
1656039856120,MATH 20B,A02,083757,Briones; Jor-el Thomas Caparas,1,0,36,35
1656039856120,MATH 20B,A03,093475,Staff,0,0,36,36
1656039862148,MATH 20C,A01,083760,Briones; Jor-el Thomas Caparas,0,2,35,35
1656039862148,MATH 20C,A02,083761,Briones; Jor-el Thomas Caparas,6,1,35,29
1656039862148,MATH 20C,A03,093476,Staff,0,1,35,35
1656039862148,MATH 20C,B01,083762,Bach; Quang Tran,3,0,30,27
1656039868177,MATH 20D,A01,083765,Tran; Brian Kha,2,0,30,28
1656039868177,MATH 20D,A02,083766,Tran; Brian Kha,0,1,30,30
1656039868177,MATH 20D,A03,083767,Tran; Brian Kha,0,0,30,30
1656039874201,MATH 20E,A01,083771,Ganguly; Soumya,0,1,32,32
1656039874201,MATH 20E,A02,083772,Ganguly; Soumya,1,1,32,31
1656039874201,MATH 20E,B01,083773,Ciotti; Benjamin,13,0,35,22
1656039874201,MATH 20E,B02,083774,Ciotti; Benjamin,12,0,35,23
1656039880229,MATH 103A,A01,083777,Greenfeld; Be'Eri,2,1,36,34
1656039880229,MATH 103A,A02,083778,Greenfeld; Be'Eri,1,0,36,35
1656039880229,MATH 103A,A03,093561,Staff,0,1,36,36
1656039880229,MATH 103A,B01,083779,Greenfeld; Be'Eri,8,1,36,28
1656039880229,MATH 103A,B02,083780,Greenfeld; Be'Eri,0,0,36,36
1656039880229,MATH 103A,B03,093562,Staff,0,0,36,36
1656039886253,MATH 105,A01,085443,Carter; Anne Toulson,4,1,35,31
1656039886253,MATH 105,A02,093477,Staff,9,0,35,26
1656039892353,MATH 109,A01,083213,Ganzberger; Geoffrey Michael,0,1,34,34
1656039892353,MATH 109,A02,083214,Ganzberger; Geoffrey Michael,0,0,34,34
1656039892353,MATH 109,A03,093478,Staff,1,0,34,33
1656039892353,MATH 109,B01,083215,Ganzberger; Geoffrey Michael,2,0,32,30
1656039892353,MATH 109,B02,083216,Ganzberger; Geoffrey Michael,0,0,32,32
1656039892353,MATH 109,B03,093479,Staff,3,0,32,29
1656039898385,MATH 142A,A01,083219,Chow; Bennett,1,0,32,31
1656039898385,MATH 142A,A02,083220,Chow; Bennett,7,0,32,25
1656039898385,MATH 142A,A03,093480,Staff,4,0,32,28
1656039898385,MATH 142A,B03,093481,Staff,3,0,32,29
1656039898385,MATH 142A,B04,093558,Staff,5,0,32,27
1656039898385,MATH 142A,B05,093559,Staff,0,0,32,32
1656039904409,MATH 193A,A01,083224,Rotar; Vladimir,1,2,34,33
1656039904409,MATH 193A,A02,083225,Rotar; Vladimir,0,0,34,34
1656039904409,MATH 193A,A03,083781,Rotar; Vladimir,1,0,34,33
1656039904409,MATH 193A,A04,083782,Rotar; Vladimir,3,0,34,31
1656039904409,MATH 193A,A05,093482,Rotar; Vladimir,0,0,34,34
1656039910432,MATH 197,001,091859,McAuley; Julian John,9999,0,9999,0
1656039910432,MATH 197,002,095566,Kedlaya; Kiran S.,9997,0,9999,2
1656039910432,MATH 197,003,095567,Xiao; Ming,9999,0,9999,0
1656039910432,MATH 197,004,095571,Perols; Johan Lars,9998,0,9999,1
1656039917497,COGS 9,A01,083615,Shannon; Kyle Michael,3,1,75,72
1656039923522,COGS 11,A01,083617,Boyle; Mary E. T.,11,2,48,37
1656039929544,COGS 13,A01,083071,Bastos; Amalia Pinkusfeld,4,3,71,67
1656039935571,COGS 14A,A01,092681,Semenuks; Arturs,4,25,100,96
1656039941598,COGS 14B,A01,083073,Cheng; Tzu-Han,7,0,63,56
1656039947622,COGS 17,A01,092677,Semenuks; Arturs,8,7,81,73
1656039953645,COGS 100,A01,083619,Allen; Michael Gordon,3,2,70,67
1656039959673,COGS 101A,A01,083621,Davis; Joshua Daniel,4,3,68,64
1656039965697,COGS 101B,A01,091572,Allen; Michael Gordon,0,0,65,65
1656039971720,COGS 101C,A01,083625,Delgado; Tania,7,0,35,28
1656039977747,COGS 107A,A01,083627,Boyle; Mary E. T.,1,2,60,59
1656039983777,COGS 118A,A01,083075,Gupta; Anjum,21,16,76,55
1656039989816,CSE 3,A50,083646,Miranda; Gregory Joseph,14,0,50,36
1656039995844,CSE 8A,A50,083650,Miranda; Gregory Joseph,4,11,56,52
1656040001877,CSE 11,A01,083080,Cao; Yingjun,0,65,40,40
1656040007898,CSE 12,A01,083652,Krause-Levy; Sophia Louisa,7,8,120,113
1656040013930,CSE 15L,A01,083654,Morris; Justin Loren,3,1,50,47
1656040013930,CSE 15L,A02,083655,Morris; Justin Loren,2,1,50,48
1656040019954,CSE 20,A01,083657,Tran; Khoa Dang,29,0,80,51
1656040025981,CSE 21,A01,095574,Bach; Quang Tran,23,0,48,25
1656040032004,CSE 30,A01,083084,Eldon; John,2,10,80,78
1656040032004,CSE 30,B01,095061,Bhaskar; Nishant,2,5,50,48
1656040038030,CSE 100,A01,083659,Cao; Yingjun,2,25,70,68
1656040044057,CSE 134B,A01,083661,Powell; Thomas Allan,6,6,100,94
1656040050083,CSE 140,A01,083663,Gungor; Onat,6,0,85,79
1656040056110,CSE 140L,A01,083088,Eldon; John,5,0,100,95
1656040062136,CSE 175,A01,083665,Kumar; Rakesh,0,0,25,25
1656040068161,CSE 190,A00,092507,Dubnov; Shlomo,1,0,20,19
1656040074183,ECE 45,A01,083139,Congero; Spencer William,1,1,75,74
1656040080204,ECE 65,A50,083695,Saad; Andrew S,6,0,30,24
1656040080204,ECE 65,A51,095125,Staff,23,0,26,3
1656040086233,ECE 109,A01,091882,Touri; Behrouz,3,5,70,67
1656040092265,ECE 180,A00,083140,Abi Samra; Nicholas Camill,1,0,30,29
1656040092265,ECE 180,B00,083141,Abi Samra; Nicholas Camill,0,8,28,28
1656040098289,MATH 10A,A01,083735,Patchell; Gregory David,0,0,30,30
1656040098289,MATH 10A,A02,083736,Patchell; Gregory David,20,0,30,10
1656040098289,MATH 10A,A03,083737,Patchell; Gregory David,16,0,30,14
1656040104319,MATH 10B,A01,083207,Lim; Seonhee,1,1,34,33
1656040104319,MATH 10B,A02,083208,Lim; Seonhee,1,1,35,34
1656040104319,MATH 10B,A03,093472,Staff,0,1,34,34
1656040104319,MATH 10B,B01,083739,Sinha; Shubham,10,0,30,20
1656040110350,MATH 18,A01,083743,Cinel; Cameron Alexander,5,0,30,25
1656040110350,MATH 18,A02,083744,Cinel; Cameron Alexander,11,0,30,19
1656040110350,MATH 18,A03,083745,Cinel; Cameron Alexander,1,0,30,29
1656040110350,MATH 18,B01,083748,Ma; Zilu,0,0,36,36
1656040110350,MATH 18,B02,083749,Ma; Zilu,0,0,36,36
1656040110350,MATH 18,B03,083750,Ma; Zilu,0,0,36,36
1656040110350,MATH 18,B04,083751,Ma; Zilu,0,0,36,36
1656040110350,MATH 18,B05,093473,Staff,0,0,36,36
1656040110350,MATH 18,B06,093474,Staff,3,0,36,33
1656040116378,MATH 20A,A01,083754,Zheng; Zequn,11,0,40,29
1656040122406,MATH 20B,A01,083756,Briones; Jor-el Thomas Caparas,0,0,36,36
1656040122406,MATH 20B,A02,083757,Briones; Jor-el Thomas Caparas,1,0,36,35
1656040122406,MATH 20B,A03,093475,Staff,0,0,36,36
1656040128429,MATH 20C,A01,083760,Briones; Jor-el Thomas Caparas,0,2,35,35
1656040128429,MATH 20C,A02,083761,Briones; Jor-el Thomas Caparas,6,1,35,29
1656040128429,MATH 20C,A03,093476,Staff,0,1,35,35
1656040128429,MATH 20C,B01,083762,Bach; Quang Tran,3,0,30,27
1656040134452,MATH 20D,A01,083765,Tran; Brian Kha,2,0,30,28
1656040134452,MATH 20D,A02,083766,Tran; Brian Kha,0,1,30,30
1656040134452,MATH 20D,A03,083767,Tran; Brian Kha,0,0,30,30
1656040140482,MATH 20E,A01,083771,Ganguly; Soumya,0,1,32,32
1656040140482,MATH 20E,A02,083772,Ganguly; Soumya,1,1,32,31
1656040140482,MATH 20E,B01,083773,Ciotti; Benjamin,13,0,35,22
1656040140482,MATH 20E,B02,083774,Ciotti; Benjamin,12,0,35,23
1656040146512,MATH 103A,A01,083777,Greenfeld; Be'Eri,2,1,36,34
1656040146512,MATH 103A,A02,083778,Greenfeld; Be'Eri,1,0,36,35
1656040146512,MATH 103A,A03,093561,Staff,0,1,36,36
1656040146512,MATH 103A,B01,083779,Greenfeld; Be'Eri,8,1,36,28
1656040146512,MATH 103A,B02,083780,Greenfeld; Be'Eri,0,0,36,36
1656040146512,MATH 103A,B03,093562,Staff,0,0,36,36
1656040152536,MATH 105,A01,085443,Carter; Anne Toulson,4,1,35,31
1656040152536,MATH 105,A02,093477,Staff,9,0,35,26
1656040158559,MATH 109,A01,083213,Ganzberger; Geoffrey Michael,0,1,34,34
1656040158559,MATH 109,A02,083214,Ganzberger; Geoffrey Michael,0,0,34,34
1656040158559,MATH 109,A03,093478,Staff,1,0,34,33
1656040158559,MATH 109,B01,083215,Ganzberger; Geoffrey Michael,2,0,32,30
1656040158559,MATH 109,B02,083216,Ganzberger; Geoffrey Michael,0,0,32,32
1656040158559,MATH 109,B03,093479,Staff,3,0,32,29
1656040164585,MATH 142A,A01,083219,Chow; Bennett,1,0,32,31
1656040164585,MATH 142A,A02,083220,Chow; Bennett,7,0,32,25
1656040164585,MATH 142A,A03,093480,Staff,4,0,32,28
1656040164585,MATH 142A,B03,093481,Staff,3,0,32,29
1656040164585,MATH 142A,B04,093558,Staff,5,0,32,27
1656040164585,MATH 142A,B05,093559,Staff,0,0,32,32
1656040170613,MATH 193A,A01,083224,Rotar; Vladimir,1,2,34,33
1656040170613,MATH 193A,A02,083225,Rotar; Vladimir,0,0,34,34
1656040170613,MATH 193A,A03,083781,Rotar; Vladimir,1,0,34,33
1656040170613,MATH 193A,A04,083782,Rotar; Vladimir,3,0,34,31
1656040170613,MATH 193A,A05,093482,Rotar; Vladimir,0,0,34,34
1656040176641,MATH 197,001,091859,McAuley; Julian John,9999,0,9999,0
1656040176641,MATH 197,002,095566,Kedlaya; Kiran S.,9997,0,9999,2
1656040176641,MATH 197,003,095567,Xiao; Ming,9999,0,9999,0
1656040176641,MATH 197,004,095571,Perols; Johan Lars,9998,0,9999,1
1656040183702,COGS 9,A01,083615,Shannon; Kyle Michael,3,1,75,72
1656040189729,COGS 11,A01,083617,Boyle; Mary E. T.,11,2,48,37
1656040195755,COGS 13,A01,083071,Bastos; Amalia Pinkusfeld,4,3,71,67
1656040201781,COGS 14A,A01,092681,Semenuks; Arturs,4,25,100,96
1656040207815,COGS 14B,A01,083073,Cheng; Tzu-Han,7,0,63,56
1656040213839,COGS 17,A01,092677,Semenuks; Arturs,8,7,81,73
1656040219862,COGS 100,A01,083619,Allen; Michael Gordon,3,2,70,67
1656040225890,COGS 101A,A01,083621,Davis; Joshua Daniel,4,3,68,64
1656040231912,COGS 101B,A01,091572,Allen; Michael Gordon,0,0,65,65
1656040237936,COGS 101C,A01,083625,Delgado; Tania,7,0,35,28
1656040243964,COGS 107A,A01,083627,Boyle; Mary E. T.,1,2,60,59
1656040249991,COGS 118A,A01,083075,Gupta; Anjum,21,16,76,55
1656040256014,CSE 3,A50,083646,Miranda; Gregory Joseph,14,0,50,36
1656040262040,CSE 8A,A50,083650,Miranda; Gregory Joseph,4,11,56,52
1656040268063,CSE 11,A01,083080,Cao; Yingjun,0,65,40,40
1656040274092,CSE 12,A01,083652,Krause-Levy; Sophia Louisa,7,8,120,113
1656040280116,CSE 15L,A01,083654,Morris; Justin Loren,3,1,50,47
1656040280116,CSE 15L,A02,083655,Morris; Justin Loren,2,1,50,48
1656040286142,CSE 20,A01,083657,Tran; Khoa Dang,29,0,80,51
1656040292170,CSE 21,A01,095574,Bach; Quang Tran,23,0,48,25
1656040298193,CSE 30,A01,083084,Eldon; John,2,10,80,78
1656040298193,CSE 30,B01,095061,Bhaskar; Nishant,2,5,50,48
1656040304216,CSE 100,A01,083659,Cao; Yingjun,2,25,70,68
1656040310241,CSE 134B,A01,083661,Powell; Thomas Allan,6,6,100,94
1656040316276,CSE 140,A01,083663,Gungor; Onat,6,0,85,79
1656040322299,CSE 140L,A01,083088,Eldon; John,5,0,100,95
1656040328323,CSE 175,A01,083665,Kumar; Rakesh,0,0,25,25
1656040334345,CSE 190,A00,092507,Dubnov; Shlomo,1,0,20,19
1656040340383,ECE 45,A01,083139,Congero; Spencer William,1,1,75,74
1656040346406,ECE 65,A50,083695,Saad; Andrew S,6,0,30,24
1656040346406,ECE 65,A51,095125,Staff,23,0,26,3
1656040352428,ECE 109,A01,091882,Touri; Behrouz,3,5,70,67
1656040358455,ECE 180,A00,083140,Abi Samra; Nicholas Camill,1,0,30,29
1656040358455,ECE 180,B00,083141,Abi Samra; Nicholas Camill,0,8,28,28
1656040364481,MATH 10A,A01,083735,Patchell; Gregory David,0,0,30,30
1656040364481,MATH 10A,A02,083736,Patchell; Gregory David,20,0,30,10
1656040364481,MATH 10A,A03,083737,Patchell; Gregory David,16,0,30,14
1656040370520,MATH 10B,A01,083207,Lim; Seonhee,1,1,34,33
1656040370520,MATH 10B,A02,083208,Lim; Seonhee,1,1,35,34
1656040370520,MATH 10B,A03,093472,Staff,0,1,34,34
1656040370520,MATH 10B,B01,083739,Sinha; Shubham,10,0,30,20
1656040376544,MATH 18,A01,083743,Cinel; Cameron Alexander,5,0,30,25
1656040376544,MATH 18,A02,083744,Cinel; Cameron Alexander,11,0,30,19
1656040376544,MATH 18,A03,083745,Cinel; Cameron Alexander,1,0,30,29
1656040376544,MATH 18,B01,083748,Ma; Zilu,0,0,36,36
1656040376544,MATH 18,B02,083749,Ma; Zilu,0,0,36,36
1656040376544,MATH 18,B03,083750,Ma; Zilu,0,0,36,36
1656040376544,MATH 18,B04,083751,Ma; Zilu,0,0,36,36
1656040376544,MATH 18,B05,093473,Staff,0,0,36,36
1656040376544,MATH 18,B06,093474,Staff,3,0,36,33
1656040382570,MATH 20A,A01,083754,Zheng; Zequn,11,0,40,29
1656040388599,MATH 20B,A01,083756,Briones; Jor-el Thomas Caparas,0,0,36,36
1656040388599,MATH 20B,A02,083757,Briones; Jor-el Thomas Caparas,1,0,36,35
1656040388599,MATH 20B,A03,093475,Staff,0,0,36,36
1656040394630,MATH 20C,A01,083760,Briones; Jor-el Thomas Caparas,0,2,35,35
1656040394630,MATH 20C,A02,083761,Briones; Jor-el Thomas Caparas,6,1,35,29
1656040394630,MATH 20C,A03,093476,Staff,0,1,35,35
1656040394630,MATH 20C,B01,083762,Bach; Quang Tran,3,0,30,27
1656040400652,MATH 20D,A01,083765,Tran; Brian Kha,2,0,30,28
1656040400652,MATH 20D,A02,083766,Tran; Brian Kha,0,1,30,30
1656040400652,MATH 20D,A03,083767,Tran; Brian Kha,0,0,30,30
1656040406676,MATH 20E,A01,083771,Ganguly; Soumya,0,1,32,32
1656040406676,MATH 20E,A02,083772,Ganguly; Soumya,1,1,32,31
1656040406676,MATH 20E,B01,083773,Ciotti; Benjamin,13,0,35,22
1656040406676,MATH 20E,B02,083774,Ciotti; Benjamin,12,0,35,23
1656040412700,MATH 103A,A01,083777,Greenfeld; Be'Eri,2,1,36,34
1656040412700,MATH 103A,A02,083778,Greenfeld; Be'Eri,1,0,36,35
1656040412700,MATH 103A,A03,093561,Staff,0,1,36,36
1656040412700,MATH 103A,B01,083779,Greenfeld; Be'Eri,8,1,36,28
1656040412700,MATH 103A,B02,083780,Greenfeld; Be'Eri,0,0,36,36
1656040412700,MATH 103A,B03,093562,Staff,0,0,36,36
1656040418723,MATH 105,A01,085443,Carter; Anne Toulson,4,1,35,31
1656040418723,MATH 105,A02,093477,Staff,9,0,35,26
1656040424747,MATH 109,A01,083213,Ganzberger; Geoffrey Michael,0,1,34,34
1656040424747,MATH 109,A02,083214,Ganzberger; Geoffrey Michael,0,0,34,34
1656040424747,MATH 109,A03,093478,Staff,1,0,34,33
1656040424747,MATH 109,B01,083215,Ganzberger; Geoffrey Michael,2,0,32,30
1656040424747,MATH 109,B02,083216,Ganzberger; Geoffrey Michael,0,0,32,32
1656040424747,MATH 109,B03,093479,Staff,3,0,32,29
1656040430769,MATH 142A,A01,083219,Chow; Bennett,1,0,32,31
1656040430769,MATH 142A,A02,083220,Chow; Bennett,7,0,32,25
1656040430769,MATH 142A,A03,093480,Staff,4,0,32,28
1656040430769,MATH 142A,B03,093481,Staff,3,0,32,29
1656040430769,MATH 142A,B04,093558,Staff,5,0,32,27
1656040430769,MATH 142A,B05,093559,Staff,0,0,32,32
1656040436798,MATH 193A,A01,083224,Rotar; Vladimir,1,2,34,33
1656040436798,MATH 193A,A02,083225,Rotar; Vladimir,0,0,34,34
1656040436798,MATH 193A,A03,083781,Rotar; Vladimir,1,0,34,33
1656040436798,MATH 193A,A04,083782,Rotar; Vladimir,3,0,34,31
1656040436798,MATH 193A,A05,093482,Rotar; Vladimir,0,0,34,34
1656040442819,MATH 197,001,091859,McAuley; Julian John,9999,0,9999,0
1656040442819,MATH 197,002,095566,Kedlaya; Kiran S.,9997,0,9999,2
1656040442819,MATH 197,003,095567,Xiao; Ming,9999,0,9999,0
1656040442819,MATH 197,004,095571,Perols; Johan Lars,9998,0,9999,1
1656040449873,COGS 9,A01,083615,Shannon; Kyle Michael,3,1,75,72
1656040455896,COGS 11,A01,083617,Boyle; Mary E. T.,11,2,48,37
1656040461920,COGS 13,A01,083071,Bastos; Amalia Pinkusfeld,4,3,71,67
1656040467942,COGS 14A,A01,092681,Semenuks; Arturs,4,25,100,96
1656040473970,COGS 14B,A01,083073,Cheng; Tzu-Han,7,0,63,56
1656040479993,COGS 17,A01,092677,Semenuks; Arturs,8,7,81,73
1656040486088,COGS 100,A01,083619,Allen; Michael Gordon,3,2,70,67
1656040492124,COGS 101A,A01,083621,Davis; Joshua Daniel,4,3,68,64
1656040498150,COGS 101B,A01,091572,Allen; Michael Gordon,0,0,65,65
1656040504175,COGS 101C,A01,083625,Delgado; Tania,7,0,35,28
1656040510198,COGS 107A,A01,083627,Boyle; Mary E. T.,1,2,60,59
1656040516222,COGS 118A,A01,083075,Gupta; Anjum,21,16,76,55
1656040522249,CSE 3,A50,083646,Miranda; Gregory Joseph,14,0,50,36
1656040528276,CSE 8A,A50,083650,Miranda; Gregory Joseph,4,11,56,52
1656040534297,CSE 11,A01,083080,Cao; Yingjun,0,64,40,40
1656040540330,CSE 12,A01,083652,Krause-Levy; Sophia Louisa,7,8,120,113
1656040546355,CSE 15L,A01,083654,Morris; Justin Loren,3,1,50,47
1656040546355,CSE 15L,A02,083655,Morris; Justin Loren,2,1,50,48
1656040552377,CSE 20,A01,083657,Tran; Khoa Dang,29,0,80,51
1656040558403,CSE 21,A01,095574,Bach; Quang Tran,23,0,48,25
1656040564427,CSE 30,A01,083084,Eldon; John,2,10,80,78
1656040564427,CSE 30,B01,095061,Bhaskar; Nishant,2,5,50,48
1656040570450,CSE 100,A01,083659,Cao; Yingjun,2,25,70,68
1656040576472,CSE 134B,A01,083661,Powell; Thomas Allan,6,6,100,94
1656040582509,CSE 140,A01,083663,Gungor; Onat,6,0,85,79
1656040588534,CSE 140L,A01,083088,Eldon; John,5,0,100,95
1656040594558,CSE 175,A01,083665,Kumar; Rakesh,0,0,25,25
1656040600584,CSE 190,A00,092507,Dubnov; Shlomo,1,0,20,19
1656040606609,ECE 45,A01,083139,Congero; Spencer William,1,1,75,74
1656040612634,ECE 65,A50,083695,Saad; Andrew S,6,0,30,24
1656040612634,ECE 65,A51,095125,Staff,23,0,26,3
1656040618658,ECE 109,A01,091882,Touri; Behrouz,3,5,70,67
1656040624692,ECE 180,A00,083140,Abi Samra; Nicholas Camill,1,0,30,29
1656040624692,ECE 180,B00,083141,Abi Samra; Nicholas Camill,0,8,28,28
1656040630719,MATH 10A,A01,083735,Patchell; Gregory David,0,0,30,30
1656040630719,MATH 10A,A02,083736,Patchell; Gregory David,20,0,30,10
1656040630719,MATH 10A,A03,083737,Patchell; Gregory David,16,0,30,14
1656040636743,MATH 10B,A01,083207,Lim; Seonhee,1,1,34,33
1656040636743,MATH 10B,A02,083208,Lim; Seonhee,1,1,35,34
1656040636743,MATH 10B,A03,093472,Staff,0,1,34,34
1656040636743,MATH 10B,B01,083739,Sinha; Shubham,10,0,30,20
1656040642766,MATH 18,A01,083743,Cinel; Cameron Alexander,5,0,30,25
1656040642766,MATH 18,A02,083744,Cinel; Cameron Alexander,11,0,30,19
1656040642766,MATH 18,A03,083745,Cinel; Cameron Alexander,1,0,30,29
1656040642766,MATH 18,B01,083748,Ma; Zilu,0,0,36,36
1656040642766,MATH 18,B02,083749,Ma; Zilu,0,0,36,36
1656040642766,MATH 18,B03,083750,Ma; Zilu,0,0,36,36
1656040642766,MATH 18,B04,083751,Ma; Zilu,0,0,36,36
1656040642766,MATH 18,B05,093473,Staff,0,0,36,36
1656040642766,MATH 18,B06,093474,Staff,3,0,36,33
1656040648793,MATH 20A,A01,083754,Zheng; Zequn,11,0,40,29
1656040654818,MATH 20B,A01,083756,Briones; Jor-el Thomas Caparas,0,0,36,36
1656040654818,MATH 20B,A02,083757,Briones; Jor-el Thomas Caparas,1,0,36,35
1656040654818,MATH 20B,A03,093475,Staff,0,0,36,36
1656040660845,MATH 20C,A01,083760,Briones; Jor-el Thomas Caparas,0,2,35,35
1656040660845,MATH 20C,A02,083761,Briones; Jor-el Thomas Caparas,6,1,35,29
1656040660845,MATH 20C,A03,093476,Staff,0,1,35,35
1656040660845,MATH 20C,B01,083762,Bach; Quang Tran,3,0,30,27
1656040666869,MATH 20D,A01,083765,Tran; Brian Kha,2,0,30,28
1656040666869,MATH 20D,A02,083766,Tran; Brian Kha,0,1,30,30
1656040666869,MATH 20D,A03,083767,Tran; Brian Kha,0,0,30,30
1656040672893,MATH 20E,A01,083771,Ganguly; Soumya,0,1,32,32
1656040672893,MATH 20E,A02,083772,Ganguly; Soumya,1,1,32,31
1656040672893,MATH 20E,B01,083773,Ciotti; Benjamin,13,0,35,22
1656040672893,MATH 20E,B02,083774,Ciotti; Benjamin,12,0,35,23
1656040678924,MATH 103A,A01,083777,Greenfeld; Be'Eri,2,1,36,34
1656040678924,MATH 103A,A02,083778,Greenfeld; Be'Eri,1,0,36,35
1656040678924,MATH 103A,A03,093561,Staff,0,1,36,36
1656040678924,MATH 103A,B01,083779,Greenfeld; Be'Eri,8,1,36,28
1656040678924,MATH 103A,B02,083780,Greenfeld; Be'Eri,0,0,36,36
1656040678924,MATH 103A,B03,093562,Staff,0,0,36,36
1656040684951,MATH 105,A01,085443,Carter; Anne Toulson,4,1,35,31
1656040684951,MATH 105,A02,093477,Staff,9,0,35,26
1656040690974,MATH 109,A01,083213,Ganzberger; Geoffrey Michael,0,1,34,34
1656040690974,MATH 109,A02,083214,Ganzberger; Geoffrey Michael,0,0,34,34
1656040690974,MATH 109,A03,093478,Staff,1,0,34,33
1656040690974,MATH 109,B01,083215,Ganzberger; Geoffrey Michael,2,0,32,30
1656040690974,MATH 109,B02,083216,Ganzberger; Geoffrey Michael,0,0,32,32
1656040690974,MATH 109,B03,093479,Staff,3,0,32,29
1656040696998,MATH 142A,A01,083219,Chow; Bennett,1,0,32,31
1656040696998,MATH 142A,A02,083220,Chow; Bennett,7,0,32,25
1656040696998,MATH 142A,A03,093480,Staff,4,0,32,28
1656040696998,MATH 142A,B03,093481,Staff,3,0,32,29
1656040696998,MATH 142A,B04,093558,Staff,5,0,32,27
1656040696998,MATH 142A,B05,093559,Staff,0,0,32,32
1656040703023,MATH 193A,A01,083224,Rotar; Vladimir,1,2,34,33
1656040703023,MATH 193A,A02,083225,Rotar; Vladimir,0,0,34,34
1656040703023,MATH 193A,A03,083781,Rotar; Vladimir,1,0,34,33
1656040703023,MATH 193A,A04,083782,Rotar; Vladimir,3,0,34,31
1656040703023,MATH 193A,A05,093482,Rotar; Vladimir,0,0,34,34
1656040709046,MATH 197,001,091859,McAuley; Julian John,9999,0,9999,0
1656040709046,MATH 197,002,095566,Kedlaya; Kiran S.,9997,0,9999,2
1656040709046,MATH 197,003,095567,Xiao; Ming,9999,0,9999,0
1656040709046,MATH 197,004,095571,Perols; Johan Lars,9998,0,9999,1
1656040716109,COGS 9,A01,083615,Shannon; Kyle Michael,3,1,75,72
1656040722133,COGS 11,A01,083617,Boyle; Mary E. T.,11,2,48,37
1656040728156,COGS 13,A01,083071,Bastos; Amalia Pinkusfeld,4,3,71,67
1656040734179,COGS 14A,A01,092681,Semenuks; Arturs,4,25,100,96
1656040740202,COGS 14B,A01,083073,Cheng; Tzu-Han,7,0,63,56
1656040746227,COGS 17,A01,092677,Semenuks; Arturs,8,7,81,73
1656040752250,COGS 100,A01,083619,Allen; Michael Gordon,3,2,70,67
1656040758272,COGS 101A,A01,083621,Davis; Joshua Daniel,4,3,68,64
1656040764295,COGS 101B,A01,091572,Allen; Michael Gordon,0,0,65,65
1656040770319,COGS 101C,A01,083625,Delgado; Tania,7,0,35,28
1656040776346,COGS 107A,A01,083627,Boyle; Mary E. T.,1,2,60,59
1656040782374,COGS 118A,A01,083075,Gupta; Anjum,21,16,76,55
1656040788399,CSE 3,A50,083646,Miranda; Gregory Joseph,14,0,50,36
1656040794426,CSE 8A,A50,083650,Miranda; Gregory Joseph,4,11,56,52
1656040800448,CSE 11,A01,083080,Cao; Yingjun,0,64,40,40
1656040806476,CSE 12,A01,083652,Krause-Levy; Sophia Louisa,7,8,120,113
1656040812502,CSE 15L,A01,083654,Morris; Justin Loren,3,1,50,47
1656040812502,CSE 15L,A02,083655,Morris; Justin Loren,2,1,50,48
1656040818527,CSE 20,A01,083657,Tran; Khoa Dang,29,0,80,51
1656040824550,CSE 21,A01,095574,Bach; Quang Tran,23,0,48,25
1656040830576,CSE 30,A01,083084,Eldon; John,2,10,80,78
1656040830576,CSE 30,B01,095061,Bhaskar; Nishant,2,5,50,48
1656040836601,CSE 100,A01,083659,Cao; Yingjun,2,25,70,68
1656040842624,CSE 134B,A01,083661,Powell; Thomas Allan,6,6,100,94
1656040848654,CSE 140,A01,083663,Gungor; Onat,6,0,85,79
1656040854677,CSE 140L,A01,083088,Eldon; John,5,0,100,95
1656040860704,CSE 175,A01,083665,Kumar; Rakesh,0,0,25,25
1656040866727,CSE 190,A00,092507,Dubnov; Shlomo,1,0,20,19
1656040872760,ECE 45,A01,083139,Congero; Spencer William,1,1,75,74
1656040878783,ECE 65,A50,083695,Saad; Andrew S,6,0,30,24
1656040878783,ECE 65,A51,095125,Staff,23,0,26,3
1656040884806,ECE 109,A01,091882,Touri; Behrouz,3,5,70,67
1656040890830,ECE 180,A00,083140,Abi Samra; Nicholas Camill,1,0,30,29
1656040890830,ECE 180,B00,083141,Abi Samra; Nicholas Camill,0,8,28,28
1656040896853,MATH 10A,A01,083735,Patchell; Gregory David,0,0,30,30
1656040896853,MATH 10A,A02,083736,Patchell; Gregory David,20,0,30,10
1656040896853,MATH 10A,A03,083737,Patchell; Gregory David,16,0,30,14
1656040902876,MATH 10B,A01,083207,Lim; Seonhee,1,1,34,33
1656040902876,MATH 10B,A02,083208,Lim; Seonhee,1,1,35,34
1656040902876,MATH 10B,A03,093472,Staff,0,1,34,34
1656040902876,MATH 10B,B01,083739,Sinha; Shubham,10,0,30,20
1656040908915,MATH 18,A01,083743,Cinel; Cameron Alexander,5,0,30,25
1656040908915,MATH 18,A02,083744,Cinel; Cameron Alexander,11,0,30,19
1656040908915,MATH 18,A03,083745,Cinel; Cameron Alexander,1,0,30,29
1656040908915,MATH 18,B01,083748,Ma; Zilu,0,0,36,36
1656040908915,MATH 18,B02,083749,Ma; Zilu,0,0,36,36
1656040908915,MATH 18,B03,083750,Ma; Zilu,0,0,36,36
1656040908915,MATH 18,B04,083751,Ma; Zilu,0,0,36,36
1656040908915,MATH 18,B05,093473,Staff,0,0,36,36
1656040908915,MATH 18,B06,093474,Staff,3,0,36,33
1656040914943,MATH 20A,A01,083754,Zheng; Zequn,11,0,40,29
1656040920967,MATH 20B,A01,083756,Briones; Jor-el Thomas Caparas,0,0,36,36
1656040920967,MATH 20B,A02,083757,Briones; Jor-el Thomas Caparas,1,0,36,35
1656040920967,MATH 20B,A03,093475,Staff,0,0,36,36
1656040926990,MATH 20C,A01,083760,Briones; Jor-el Thomas Caparas,0,2,35,35
1656040926990,MATH 20C,A02,083761,Briones; Jor-el Thomas Caparas,6,1,35,29
1656040926990,MATH 20C,A03,093476,Staff,0,1,35,35
1656040926990,MATH 20C,B01,083762,Bach; Quang Tran,3,0,30,27
1656040933016,MATH 20D,A01,083765,Tran; Brian Kha,2,0,30,28
1656040933016,MATH 20D,A02,083766,Tran; Brian Kha,0,1,30,30
1656040933016,MATH 20D,A03,083767,Tran; Brian Kha,0,0,30,30
1656040939039,MATH 20E,A01,083771,Ganguly; Soumya,0,1,32,32
1656040939039,MATH 20E,A02,083772,Ganguly; Soumya,1,1,32,31
1656040939039,MATH 20E,B01,083773,Ciotti; Benjamin,13,0,35,22
1656040939039,MATH 20E,B02,083774,Ciotti; Benjamin,12,0,35,23
1656040945063,MATH 103A,A01,083777,Greenfeld; Be'Eri,2,1,36,34
1656040945063,MATH 103A,A02,083778,Greenfeld; Be'Eri,1,0,36,35
1656040945063,MATH 103A,A03,093561,Staff,0,1,36,36
1656040945063,MATH 103A,B01,083779,Greenfeld; Be'Eri,8,1,36,28
1656040945063,MATH 103A,B02,083780,Greenfeld; Be'Eri,0,0,36,36
1656040945063,MATH 103A,B03,093562,Staff,0,0,36,36
1656040951091,MATH 105,A01,085443,Carter; Anne Toulson,4,1,35,31
1656040951091,MATH 105,A02,093477,Staff,9,0,35,26
1656040957131,MATH 109,A01,083213,Ganzberger; Geoffrey Michael,0,1,34,34
1656040957131,MATH 109,A02,083214,Ganzberger; Geoffrey Michael,0,0,34,34
1656040957131,MATH 109,A03,093478,Staff,1,0,34,33
1656040957131,MATH 109,B01,083215,Ganzberger; Geoffrey Michael,2,0,32,30
1656040957131,MATH 109,B02,083216,Ganzberger; Geoffrey Michael,0,0,32,32
1656040957131,MATH 109,B03,093479,Staff,3,0,32,29
1656040963155,MATH 142A,A01,083219,Chow; Bennett,1,0,32,31
1656040963155,MATH 142A,A02,083220,Chow; Bennett,7,0,32,25
1656040963155,MATH 142A,A03,093480,Staff,4,0,32,28
1656040963155,MATH 142A,B03,093481,Staff,3,0,32,29
1656040963155,MATH 142A,B04,093558,Staff,5,0,32,27
1656040963155,MATH 142A,B05,093559,Staff,0,0,32,32
1656040969178,MATH 193A,A01,083224,Rotar; Vladimir,1,2,34,33
1656040969178,MATH 193A,A02,083225,Rotar; Vladimir,0,0,34,34
1656040969178,MATH 193A,A03,083781,Rotar; Vladimir,1,0,34,33
1656040969178,MATH 193A,A04,083782,Rotar; Vladimir,3,0,34,31
1656040969178,MATH 193A,A05,093482,Rotar; Vladimir,0,0,34,34
1656040975201,MATH 197,001,091859,McAuley; Julian John,9999,0,9999,0
1656040975201,MATH 197,002,095566,Kedlaya; Kiran S.,9997,0,9999,2
1656040975201,MATH 197,003,095567,Xiao; Ming,9999,0,9999,0
1656040975201,MATH 197,004,095571,Perols; Johan Lars,9998,0,9999,1
1656040982260,COGS 9,A01,083615,Shannon; Kyle Michael,3,1,75,72
1656040988287,COGS 11,A01,083617,Boyle; Mary E. T.,11,2,48,37
1656040994310,COGS 13,A01,083071,Bastos; Amalia Pinkusfeld,4,3,71,67
1656041000337,COGS 14A,A01,092681,Semenuks; Arturs,4,25,100,96
1656041006370,COGS 14B,A01,083073,Cheng; Tzu-Han,7,0,63,56
1656041012393,COGS 17,A01,092677,Semenuks; Arturs,8,7,81,73
1656041018417,COGS 100,A01,083619,Allen; Michael Gordon,3,2,70,67
1656041024440,COGS 101A,A01,083621,Davis; Joshua Daniel,4,3,68,64
1656041030521,COGS 101B,A01,091572,Allen; Michael Gordon,0,0,65,65
1656041036547,COGS 101C,A01,083625,Delgado; Tania,7,0,35,28
1656041042571,COGS 107A,A01,083627,Boyle; Mary E. T.,1,2,60,59
1656041048594,COGS 118A,A01,083075,Gupta; Anjum,21,16,76,55
1656041054621,CSE 3,A50,083646,Miranda; Gregory Joseph,14,0,50,36
1656041060650,CSE 8A,A50,083650,Miranda; Gregory Joseph,4,11,56,52
1656041066677,CSE 11,A01,083080,Cao; Yingjun,0,64,40,40
1656041072704,CSE 12,A01,083652,Krause-Levy; Sophia Louisa,7,8,120,113
1656041078728,CSE 15L,A01,083654,Morris; Justin Loren,3,1,50,47
1656041078728,CSE 15L,A02,083655,Morris; Justin Loren,2,1,50,48
1656041084823,CSE 20,A01,083657,Tran; Khoa Dang,29,0,80,51
1656041090851,CSE 21,A01,095574,Bach; Quang Tran,23,0,48,25
1656041096874,CSE 30,A01,083084,Eldon; John,2,10,80,78
1656041096874,CSE 30,B01,095061,Bhaskar; Nishant,2,5,50,48
1656041102907,CSE 100,A01,083659,Cao; Yingjun,2,25,70,68
1656041108930,CSE 134B,A01,083661,Powell; Thomas Allan,6,6,100,94
1656041114958,CSE 140,A01,083663,Gungor; Onat,6,0,85,79
1656041120985,CSE 140L,A01,083088,Eldon; John,5,0,100,95
1656041127010,CSE 175,A01,083665,Kumar; Rakesh,0,0,25,25
1656041133033,CSE 190,A00,092507,Dubnov; Shlomo,1,0,20,19
1656041139056,ECE 45,A01,083139,Congero; Spencer William,1,1,75,74
1656041145086,ECE 65,A50,083695,Saad; Andrew S,6,0,30,24
1656041145086,ECE 65,A51,095125,Staff,23,0,26,3
1656041151111,ECE 109,A01,091882,Touri; Behrouz,3,5,70,67
1656041157135,ECE 180,A00,083140,Abi Samra; Nicholas Camill,1,0,30,29
1656041157135,ECE 180,B00,083141,Abi Samra; Nicholas Camill,0,8,28,28
1656041163159,MATH 10A,A01,083735,Patchell; Gregory David,0,0,30,30
1656041163159,MATH 10A,A02,083736,Patchell; Gregory David,20,0,30,10
1656041163159,MATH 10A,A03,083737,Patchell; Gregory David,16,0,30,14
1656041169181,MATH 10B,A01,083207,Lim; Seonhee,1,1,34,33
1656041169181,MATH 10B,A02,083208,Lim; Seonhee,1,1,35,34
1656041169181,MATH 10B,A03,093472,Staff,0,1,34,34
1656041169181,MATH 10B,B01,083739,Sinha; Shubham,10,0,30,20
1656041175212,MATH 18,A01,083743,Cinel; Cameron Alexander,5,0,30,25
1656041175212,MATH 18,A02,083744,Cinel; Cameron Alexander,11,0,30,19
1656041175212,MATH 18,A03,083745,Cinel; Cameron Alexander,1,0,30,29
1656041175212,MATH 18,B01,083748,Ma; Zilu,0,0,36,36
1656041175212,MATH 18,B02,083749,Ma; Zilu,0,0,36,36
1656041175212,MATH 18,B03,083750,Ma; Zilu,0,0,36,36
1656041175212,MATH 18,B04,083751,Ma; Zilu,0,0,36,36
1656041175212,MATH 18,B05,093473,Staff,0,0,36,36
1656041175212,MATH 18,B06,093474,Staff,3,0,36,33
1656041181249,MATH 20A,A01,083754,Zheng; Zequn,11,0,40,29
1656041187274,MATH 20B,A01,083756,Briones; Jor-el Thomas Caparas,0,0,36,36
1656041187274,MATH 20B,A02,083757,Briones; Jor-el Thomas Caparas,1,0,36,35
1656041187274,MATH 20B,A03,093475,Staff,0,0,36,36
1656041193298,MATH 20C,A01,083760,Briones; Jor-el Thomas Caparas,0,2,35,35
1656041193298,MATH 20C,A02,083761,Briones; Jor-el Thomas Caparas,6,1,35,29
1656041193298,MATH 20C,A03,093476,Staff,0,1,35,35
1656041193298,MATH 20C,B01,083762,Bach; Quang Tran,3,0,30,27
1656041199322,MATH 20D,A01,083765,Tran; Brian Kha,2,0,30,28
1656041199322,MATH 20D,A02,083766,Tran; Brian Kha,0,1,30,30
1656041199322,MATH 20D,A03,083767,Tran; Brian Kha,0,0,30,30
1656041205347,MATH 20E,A01,083771,Ganguly; Soumya,0,1,32,32
1656041205347,MATH 20E,A02,083772,Ganguly; Soumya,1,1,32,31
1656041205347,MATH 20E,B01,083773,Ciotti; Benjamin,13,0,35,22
1656041205347,MATH 20E,B02,083774,Ciotti; Benjamin,12,0,35,23
1656041211375,MATH 103A,A01,083777,Greenfeld; Be'Eri,2,1,36,34
1656041211375,MATH 103A,A02,083778,Greenfeld; Be'Eri,1,0,36,35
1656041211375,MATH 103A,A03,093561,Staff,0,1,36,36
1656041211375,MATH 103A,B01,083779,Greenfeld; Be'Eri,8,1,36,28
1656041211375,MATH 103A,B02,083780,Greenfeld; Be'Eri,0,0,36,36
1656041211375,MATH 103A,B03,093562,Staff,0,0,36,36
1656041217402,MATH 105,A01,085443,Carter; Anne Toulson,4,1,35,31
1656041217402,MATH 105,A02,093477,Staff,9,0,35,26
1656041223426,MATH 109,A01,083213,Ganzberger; Geoffrey Michael,0,1,34,34
1656041223426,MATH 109,A02,083214,Ganzberger; Geoffrey Michael,0,0,34,34
1656041223426,MATH 109,A03,093478,Staff,1,0,34,33
1656041223426,MATH 109,B01,083215,Ganzberger; Geoffrey Michael,2,0,32,30
1656041223426,MATH 109,B02,083216,Ganzberger; Geoffrey Michael,0,0,32,32
1656041223426,MATH 109,B03,093479,Staff,3,0,32,29
1656041229456,MATH 142A,A01,083219,Chow; Bennett,1,0,32,31
1656041229456,MATH 142A,A02,083220,Chow; Bennett,7,0,32,25
1656041229456,MATH 142A,A03,093480,Staff,4,0,32,28
1656041229456,MATH 142A,B03,093481,Staff,3,0,32,29
1656041229456,MATH 142A,B04,093558,Staff,5,0,32,27
1656041229456,MATH 142A,B05,093559,Staff,0,0,32,32
1656041235480,MATH 193A,A01,083224,Rotar; Vladimir,1,2,34,33
1656041235480,MATH 193A,A02,083225,Rotar; Vladimir,0,0,34,34
1656041235480,MATH 193A,A03,083781,Rotar; Vladimir,1,0,34,33
1656041235480,MATH 193A,A04,083782,Rotar; Vladimir,3,0,34,31
1656041235480,MATH 193A,A05,093482,Rotar; Vladimir,0,0,34,34
1656041241501,MATH 197,001,091859,McAuley; Julian John,9999,0,9999,0
1656041241501,MATH 197,002,095566,Kedlaya; Kiran S.,9997,0,9999,2
1656041241501,MATH 197,003,095567,Xiao; Ming,9999,0,9999,0
1656041241501,MATH 197,004,095571,Perols; Johan Lars,9998,0,9999,1
1656041248555,COGS 9,A01,083615,Shannon; Kyle Michael,3,1,75,72
1656041254581,COGS 11,A01,083617,Boyle; Mary E. T.,11,2,48,37
1656041260607,COGS 13,A01,083071,Bastos; Amalia Pinkusfeld,4,3,71,67
1656041266631,COGS 14A,A01,092681,Semenuks; Arturs,4,25,100,96
1656041272653,COGS 14B,A01,083073,Cheng; Tzu-Han,7,0,63,56
1656041278676,COGS 17,A01,092677,Semenuks; Arturs,8,7,81,73
1656041284706,COGS 100,A01,083619,Allen; Michael Gordon,3,2,70,67
1656041290733,COGS 101A,A01,083621,Davis; Joshua Daniel,4,3,68,64
1656041296756,COGS 101B,A01,091572,Allen; Michael Gordon,0,0,65,65
1656041302786,COGS 101C,A01,083625,Delgado; Tania,7,0,35,28
1656041308812,COGS 107A,A01,083627,Boyle; Mary E. T.,1,2,60,59
1656041314840,COGS 118A,A01,083075,Gupta; Anjum,21,16,76,55
1656041320864,CSE 3,A50,083646,Miranda; Gregory Joseph,14,0,50,36
1656041326887,CSE 8A,A50,083650,Miranda; Gregory Joseph,4,11,56,52
1656041332911,CSE 11,A01,083080,Cao; Yingjun,0,64,40,40
1656041338939,CSE 12,A01,083652,Krause-Levy; Sophia Louisa,7,8,120,113
1656041344964,CSE 15L,A01,083654,Morris; Justin Loren,3,1,50,47
1656041344964,CSE 15L,A02,083655,Morris; Justin Loren,2,1,50,48
1656041350992,CSE 20,A01,083657,Tran; Khoa Dang,29,0,80,51
1656041357017,CSE 21,A01,095574,Bach; Quang Tran,23,0,48,25
1656041363039,CSE 30,A01,083084,Eldon; John,2,10,80,78
1656041363039,CSE 30,B01,095061,Bhaskar; Nishant,2,5,50,48
1656041369071,CSE 100,A01,083659,Cao; Yingjun,2,25,70,68
1656041375094,CSE 134B,A01,083661,Powell; Thomas Allan,6,6,100,94
1656041381118,CSE 140,A01,083663,Gungor; Onat,6,0,85,79
1656041387142,CSE 140L,A01,083088,Eldon; John,5,0,100,95
1656041393169,CSE 175,A01,083665,Kumar; Rakesh,0,0,25,25
1656041399192,CSE 190,A00,092507,Dubnov; Shlomo,1,0,20,19
1656041405214,ECE 45,A01,083139,Congero; Spencer William,1,1,75,74
1656041411239,ECE 65,A50,083695,Saad; Andrew S,6,0,30,24
1656041411239,ECE 65,A51,095125,Staff,23,0,26,3
1656041417264,ECE 109,A01,091882,Touri; Behrouz,3,5,70,67
1656041423290,ECE 180,A00,083140,Abi Samra; Nicholas Camill,1,0,30,29
1656041423290,ECE 180,B00,083141,Abi Samra; Nicholas Camill,0,8,28,28
1656041429315,MATH 10A,A01,083735,Patchell; Gregory David,0,0,30,30
1656041429315,MATH 10A,A02,083736,Patchell; Gregory David,20,0,30,10
1656041429315,MATH 10A,A03,083737,Patchell; Gregory David,16,0,30,14
1656041435341,MATH 10B,A01,083207,Lim; Seonhee,1,1,34,33
1656041435341,MATH 10B,A02,083208,Lim; Seonhee,1,1,35,34
1656041435341,MATH 10B,A03,093472,Staff,0,1,34,34
1656041435341,MATH 10B,B01,083739,Sinha; Shubham,10,0,30,20
1656041441409,MATH 18,A01,083743,Cinel; Cameron Alexander,5,0,30,25
1656041441409,MATH 18,A02,083744,Cinel; Cameron Alexander,11,0,30,19
1656041441409,MATH 18,A03,083745,Cinel; Cameron Alexander,1,0,30,29
1656041441409,MATH 18,B01,083748,Ma; Zilu,0,0,36,36
1656041441409,MATH 18,B02,083749,Ma; Zilu,0,0,36,36
1656041441409,MATH 18,B03,083750,Ma; Zilu,0,0,36,36
1656041441409,MATH 18,B04,083751,Ma; Zilu,0,0,36,36
1656041441409,MATH 18,B05,093473,Staff,0,0,36,36
1656041441409,MATH 18,B06,093474,Staff,3,0,36,33
1656041447433,MATH 20A,A01,083754,Zheng; Zequn,11,0,40,29
1656041453467,MATH 20B,A01,083756,Briones; Jor-el Thomas Caparas,0,0,36,36
1656041453467,MATH 20B,A02,083757,Briones; Jor-el Thomas Caparas,1,0,36,35
1656041453467,MATH 20B,A03,093475,Staff,0,0,36,36
1656041459490,MATH 20C,A01,083760,Briones; Jor-el Thomas Caparas,0,2,35,35
1656041459490,MATH 20C,A02,083761,Briones; Jor-el Thomas Caparas,6,1,35,29
1656041459490,MATH 20C,A03,093476,Staff,0,1,35,35
1656041459490,MATH 20C,B01,083762,Bach; Quang Tran,3,0,30,27
1656041465518,MATH 20D,A01,083765,Tran; Brian Kha,2,0,30,28
1656041465518,MATH 20D,A02,083766,Tran; Brian Kha,0,1,30,30
1656041465518,MATH 20D,A03,083767,Tran; Brian Kha,0,0,30,30
1656041471546,MATH 20E,A01,083771,Ganguly; Soumya,0,1,32,32
1656041471546,MATH 20E,A02,083772,Ganguly; Soumya,1,1,32,31
1656041471546,MATH 20E,B01,083773,Ciotti; Benjamin,13,0,35,22
1656041471546,MATH 20E,B02,083774,Ciotti; Benjamin,12,0,35,23
1656041477579,MATH 103A,A01,083777,Greenfeld; Be'Eri,2,1,36,34
1656041477579,MATH 103A,A02,083778,Greenfeld; Be'Eri,1,0,36,35
1656041477579,MATH 103A,A03,093561,Staff,0,1,36,36
1656041477579,MATH 103A,B01,083779,Greenfeld; Be'Eri,8,1,36,28
1656041477579,MATH 103A,B02,083780,Greenfeld; Be'Eri,0,0,36,36
1656041477579,MATH 103A,B03,093562,Staff,0,0,36,36
1656041483606,MATH 105,A01,085443,Carter; Anne Toulson,4,1,35,31
1656041483606,MATH 105,A02,093477,Staff,9,0,35,26
1656041489630,MATH 109,A01,083213,Ganzberger; Geoffrey Michael,0,1,34,34
1656041489630,MATH 109,A02,083214,Ganzberger; Geoffrey Michael,0,0,34,34
1656041489630,MATH 109,A03,093478,Staff,1,0,34,33
1656041489630,MATH 109,B01,083215,Ganzberger; Geoffrey Michael,2,0,32,30
1656041489630,MATH 109,B02,083216,Ganzberger; Geoffrey Michael,0,0,32,32
1656041489630,MATH 109,B03,093479,Staff,3,0,32,29
1656041495654,MATH 142A,A01,083219,Chow; Bennett,1,0,32,31
1656041495654,MATH 142A,A02,083220,Chow; Bennett,7,0,32,25
1656041495654,MATH 142A,A03,093480,Staff,4,0,32,28
1656041495654,MATH 142A,B03,093481,Staff,3,0,32,29
1656041495654,MATH 142A,B04,093558,Staff,5,0,32,27
1656041495654,MATH 142A,B05,093559,Staff,0,0,32,32
1656041501679,MATH 193A,A01,083224,Rotar; Vladimir,1,2,34,33
1656041501679,MATH 193A,A02,083225,Rotar; Vladimir,0,0,34,34
1656041501679,MATH 193A,A03,083781,Rotar; Vladimir,1,0,34,33
1656041501679,MATH 193A,A04,083782,Rotar; Vladimir,3,0,34,31
1656041501679,MATH 193A,A05,093482,Rotar; Vladimir,0,0,34,34
1656041507705,MATH 197,001,091859,McAuley; Julian John,9999,0,9999,0
1656041507705,MATH 197,002,095566,Kedlaya; Kiran S.,9997,0,9999,2
1656041507705,MATH 197,003,095567,Xiao; Ming,9999,0,9999,0
1656041507705,MATH 197,004,095571,Perols; Johan Lars,9998,0,9999,1
1656041514768,COGS 9,A01,083615,Shannon; Kyle Michael,3,1,75,72
1656041520794,COGS 11,A01,083617,Boyle; Mary E. T.,11,2,48,37
1656041526817,COGS 13,A01,083071,Bastos; Amalia Pinkusfeld,4,3,71,67
1656041532845,COGS 14A,A01,092681,Semenuks; Arturs,4,25,100,96
1656041538871,COGS 14B,A01,083073,Cheng; Tzu-Han,7,0,63,56
1656041544894,COGS 17,A01,092677,Semenuks; Arturs,8,7,81,73
1656041550918,COGS 100,A01,083619,Allen; Michael Gordon,3,2,70,67
1656041556948,COGS 101A,A01,083621,Davis; Joshua Daniel,4,3,68,64
1656041562975,COGS 101B,A01,091572,Allen; Michael Gordon,0,0,65,65
1656041569003,COGS 101C,A01,083625,Delgado; Tania,7,0,35,28
1656041575030,COGS 107A,A01,083627,Boyle; Mary E. T.,1,2,60,59
1656041581053,COGS 118A,A01,083075,Gupta; Anjum,21,16,76,55
1656041587089,CSE 3,A50,083646,Miranda; Gregory Joseph,14,0,50,36
1656041593117,CSE 8A,A50,083650,Miranda; Gregory Joseph,4,11,56,52
1656041599140,CSE 11,A01,083080,Cao; Yingjun,0,64,40,40
1656041605164,CSE 12,A01,083652,Krause-Levy; Sophia Louisa,7,8,120,113
1656041611193,CSE 15L,A01,083654,Morris; Justin Loren,3,1,50,47
1656041611193,CSE 15L,A02,083655,Morris; Justin Loren,2,1,50,48
1656041617216,CSE 20,A01,083657,Tran; Khoa Dang,29,0,80,51
1656041623240,CSE 21,A01,095574,Bach; Quang Tran,23,0,48,25
1656041629264,CSE 30,A01,083084,Eldon; John,2,10,80,78
1656041629264,CSE 30,B01,095061,Bhaskar; Nishant,2,5,50,48
1656041635298,CSE 100,A01,083659,Cao; Yingjun,2,25,70,68
1656041641323,CSE 134B,A01,083661,Powell; Thomas Allan,6,6,100,94
1656041647359,CSE 140,A01,083663,Gungor; Onat,6,0,85,79
1656041653386,CSE 140L,A01,083088,Eldon; John,5,0,100,95
1656041659411,CSE 175,A01,083665,Kumar; Rakesh,0,0,25,25
1656041665435,CSE 190,A00,092507,Dubnov; Shlomo,1,0,20,19
1656041671461,ECE 45,A01,083139,Congero; Spencer William,1,1,75,74
1656041677482,ECE 65,A50,083695,Saad; Andrew S,6,0,30,24
1656041677482,ECE 65,A51,095125,Staff,23,0,26,3
1656041683583,ECE 109,A01,091882,Touri; Behrouz,3,5,70,67
1656041689605,ECE 180,A00,083140,Abi Samra; Nicholas Camill,1,0,30,29
1656041689605,ECE 180,B00,083141,Abi Samra; Nicholas Camill,0,8,28,28
1656041695632,MATH 10A,A01,083735,Patchell; Gregory David,0,0,30,30
1656041695632,MATH 10A,A02,083736,Patchell; Gregory David,20,0,30,10
1656041695632,MATH 10A,A03,083737,Patchell; Gregory David,16,0,30,14
1656041701655,MATH 10B,A01,083207,Lim; Seonhee,1,1,34,33
1656041701655,MATH 10B,A02,083208,Lim; Seonhee,1,1,35,34
1656041701655,MATH 10B,A03,093472,Staff,0,1,34,34
1656041701655,MATH 10B,B01,083739,Sinha; Shubham,10,0,30,20
1656041707680,MATH 18,A01,083743,Cinel; Cameron Alexander,5,0,30,25
1656041707680,MATH 18,A02,083744,Cinel; Cameron Alexander,11,0,30,19
1656041707680,MATH 18,A03,083745,Cinel; Cameron Alexander,1,0,30,29
1656041707680,MATH 18,B01,083748,Ma; Zilu,0,0,36,36
1656041707680,MATH 18,B02,083749,Ma; Zilu,0,0,36,36
1656041707680,MATH 18,B03,083750,Ma; Zilu,0,0,36,36
1656041707680,MATH 18,B04,083751,Ma; Zilu,0,0,36,36
1656041707680,MATH 18,B05,093473,Staff,0,0,36,36
1656041707680,MATH 18,B06,093474,Staff,3,0,36,33
1656041713708,MATH 20A,A01,083754,Zheng; Zequn,11,0,40,29
1656041719741,MATH 20B,A01,083756,Briones; Jor-el Thomas Caparas,0,0,36,36
1656041719741,MATH 20B,A02,083757,Briones; Jor-el Thomas Caparas,1,0,36,35
1656041719741,MATH 20B,A03,093475,Staff,0,0,36,36
1656041725770,MATH 20C,A01,083760,Briones; Jor-el Thomas Caparas,0,2,35,35
1656041725770,MATH 20C,A02,083761,Briones; Jor-el Thomas Caparas,6,1,35,29
1656041725770,MATH 20C,A03,093476,Staff,0,1,35,35
1656041725770,MATH 20C,B01,083762,Bach; Quang Tran,3,0,30,27
1656041731797,MATH 20D,A01,083765,Tran; Brian Kha,2,0,30,28
1656041731797,MATH 20D,A02,083766,Tran; Brian Kha,0,1,30,30
1656041731797,MATH 20D,A03,083767,Tran; Brian Kha,0,0,30,30
1656041737836,MATH 20E,A01,083771,Ganguly; Soumya,0,1,32,32
1656041737836,MATH 20E,A02,083772,Ganguly; Soumya,1,1,32,31
1656041737836,MATH 20E,B01,083773,Ciotti; Benjamin,13,0,35,22
1656041737836,MATH 20E,B02,083774,Ciotti; Benjamin,12,0,35,23
1656041743859,MATH 103A,A01,083777,Greenfeld; Be'Eri,2,1,36,34
1656041743859,MATH 103A,A02,083778,Greenfeld; Be'Eri,1,0,36,35
1656041743859,MATH 103A,A03,093561,Staff,0,1,36,36
1656041743859,MATH 103A,B01,083779,Greenfeld; Be'Eri,8,1,36,28
1656041743859,MATH 103A,B02,083780,Greenfeld; Be'Eri,0,0,36,36
1656041743859,MATH 103A,B03,093562,Staff,0,0,36,36
1656041749891,MATH 105,A01,085443,Carter; Anne Toulson,4,1,35,31
1656041749891,MATH 105,A02,093477,Staff,9,0,35,26
1656041755921,MATH 109,A01,083213,Ganzberger; Geoffrey Michael,0,1,34,34
1656041755921,MATH 109,A02,083214,Ganzberger; Geoffrey Michael,0,0,34,34
1656041755921,MATH 109,A03,093478,Staff,1,0,34,33
1656041755921,MATH 109,B01,083215,Ganzberger; Geoffrey Michael,2,0,32,30
1656041755921,MATH 109,B02,083216,Ganzberger; Geoffrey Michael,0,0,32,32
1656041755921,MATH 109,B03,093479,Staff,3,0,32,29
1656041761952,MATH 142A,A01,083219,Chow; Bennett,1,0,32,31
1656041761952,MATH 142A,A02,083220,Chow; Bennett,7,0,32,25
1656041761952,MATH 142A,A03,093480,Staff,4,0,32,28
1656041761952,MATH 142A,B03,093481,Staff,3,0,32,29
1656041761952,MATH 142A,B04,093558,Staff,5,0,32,27
1656041761952,MATH 142A,B05,093559,Staff,0,0,32,32
1656041767975,MATH 193A,A01,083224,Rotar; Vladimir,1,2,34,33
1656041767975,MATH 193A,A02,083225,Rotar; Vladimir,0,0,34,34
1656041767975,MATH 193A,A03,083781,Rotar; Vladimir,1,0,34,33
1656041767975,MATH 193A,A04,083782,Rotar; Vladimir,3,0,34,31
1656041767975,MATH 193A,A05,093482,Rotar; Vladimir,0,0,34,34
1656041774008,MATH 197,001,091859,McAuley; Julian John,9999,0,9999,0
1656041774008,MATH 197,002,095566,Kedlaya; Kiran S.,9997,0,9999,2
1656041774008,MATH 197,003,095567,Xiao; Ming,9999,0,9999,0
1656041774008,MATH 197,004,095571,Perols; Johan Lars,9998,0,9999,1
1656041781062,COGS 9,A01,083615,Shannon; Kyle Michael,3,1,75,72
1656041787088,COGS 11,A01,083617,Boyle; Mary E. T.,11,2,48,37
1656041793111,COGS 13,A01,083071,Bastos; Amalia Pinkusfeld,4,3,71,67
1656041799137,COGS 14A,A01,092681,Semenuks; Arturs,4,25,100,96
1656041805160,COGS 14B,A01,083073,Cheng; Tzu-Han,7,0,63,56
1656041811183,COGS 17,A01,092677,Semenuks; Arturs,8,7,81,73
1656041817211,COGS 100,A01,083619,Allen; Michael Gordon,3,2,70,67
1656041823233,COGS 101A,A01,083621,Davis; Joshua Daniel,4,3,68,64
1656041829256,COGS 101B,A01,091572,Allen; Michael Gordon,0,0,65,65
1656041835282,COGS 101C,A01,083625,Delgado; Tania,7,0,35,28
1656041841305,COGS 107A,A01,083627,Boyle; Mary E. T.,1,2,60,59
1656041847327,COGS 118A,A01,083075,Gupta; Anjum,21,16,76,55
1656041853350,CSE 3,A50,083646,Miranda; Gregory Joseph,14,0,50,36
1656041859374,CSE 8A,A50,083650,Miranda; Gregory Joseph,4,11,56,52
1656041865400,CSE 11,A01,083080,Cao; Yingjun,0,64,40,40
1656041871424,CSE 12,A01,083652,Krause-Levy; Sophia Louisa,7,8,120,113
1656041877451,CSE 15L,A01,083654,Morris; Justin Loren,3,1,50,47
1656041877451,CSE 15L,A02,083655,Morris; Justin Loren,2,1,50,48
1656041883474,CSE 20,A01,083657,Tran; Khoa Dang,29,0,80,51
1656041889499,CSE 21,A01,095574,Bach; Quang Tran,23,0,48,25
1656041895522,CSE 30,A01,083084,Eldon; John,2,10,80,78
1656041895522,CSE 30,B01,095061,Bhaskar; Nishant,2,5,50,48
1656041901556,CSE 100,A01,083659,Cao; Yingjun,2,25,70,68
1656041907579,CSE 134B,A01,083661,Powell; Thomas Allan,6,6,100,94
1656041913603,CSE 140,A01,083663,Gungor; Onat,6,0,85,79
1656041919635,CSE 140L,A01,083088,Eldon; John,5,0,100,95
1656041925662,CSE 175,A01,083665,Kumar; Rakesh,0,0,25,25
1656041931689,CSE 190,A00,092507,Dubnov; Shlomo,1,0,20,19
1656041937712,ECE 45,A01,083139,Congero; Spencer William,1,1,75,74
1656041943735,ECE 65,A50,083695,Saad; Andrew S,6,0,30,24
1656041943735,ECE 65,A51,095125,Staff,23,0,26,3
1656041949759,ECE 109,A01,091882,Touri; Behrouz,3,5,70,67
1656041955784,ECE 180,A00,083140,Abi Samra; Nicholas Camill,1,0,30,29
1656041955784,ECE 180,B00,083141,Abi Samra; Nicholas Camill,0,8,28,28
1656041961811,MATH 10A,A01,083735,Patchell; Gregory David,0,0,30,30
1656041961811,MATH 10A,A02,083736,Patchell; Gregory David,20,0,30,10
1656041961811,MATH 10A,A03,083737,Patchell; Gregory David,16,0,30,14
1656041967836,MATH 10B,A01,083207,Lim; Seonhee,1,1,34,33
1656041967836,MATH 10B,A02,083208,Lim; Seonhee,1,1,35,34
1656041967836,MATH 10B,A03,093472,Staff,0,1,34,34
1656041967836,MATH 10B,B01,083739,Sinha; Shubham,10,0,30,20
1656041973860,MATH 18,A01,083743,Cinel; Cameron Alexander,5,0,30,25
1656041973860,MATH 18,A02,083744,Cinel; Cameron Alexander,11,0,30,19
1656041973860,MATH 18,A03,083745,Cinel; Cameron Alexander,1,0,30,29
1656041973860,MATH 18,B01,083748,Ma; Zilu,0,0,36,36
1656041973860,MATH 18,B02,083749,Ma; Zilu,0,0,36,36
1656041973860,MATH 18,B03,083750,Ma; Zilu,0,0,36,36
1656041973860,MATH 18,B04,083751,Ma; Zilu,0,0,36,36
1656041973860,MATH 18,B05,093473,Staff,0,0,36,36
1656041973860,MATH 18,B06,093474,Staff,3,0,36,33
1656041979890,MATH 20A,A01,083754,Zheng; Zequn,11,0,40,29
1656041985918,MATH 20B,A01,083756,Briones; Jor-el Thomas Caparas,0,0,36,36
1656041985918,MATH 20B,A02,083757,Briones; Jor-el Thomas Caparas,1,0,36,35
1656041985918,MATH 20B,A03,093475,Staff,0,0,36,36
1656041991939,MATH 20C,A01,083760,Briones; Jor-el Thomas Caparas,0,2,35,35
1656041991939,MATH 20C,A02,083761,Briones; Jor-el Thomas Caparas,6,1,35,29
1656041991939,MATH 20C,A03,093476,Staff,0,1,35,35
1656041991939,MATH 20C,B01,083762,Bach; Quang Tran,3,0,30,27
1656041997966,MATH 20D,A01,083765,Tran; Brian Kha,2,0,30,28
1656041997966,MATH 20D,A02,083766,Tran; Brian Kha,0,1,30,30
1656041997966,MATH 20D,A03,083767,Tran; Brian Kha,0,0,30,30
1656042003992,MATH 20E,A01,083771,Ganguly; Soumya,0,1,32,32
1656042003992,MATH 20E,A02,083772,Ganguly; Soumya,1,1,32,31
1656042003992,MATH 20E,B01,083773,Ciotti; Benjamin,13,0,35,22
1656042003992,MATH 20E,B02,083774,Ciotti; Benjamin,12,0,35,23
1656042010020,MATH 103A,A01,083777,Greenfeld; Be'Eri,2,1,36,34
1656042010020,MATH 103A,A02,083778,Greenfeld; Be'Eri,1,0,36,35
1656042010020,MATH 103A,A03,093561,Staff,0,1,36,36
1656042010020,MATH 103A,B01,083779,Greenfeld; Be'Eri,8,1,36,28
1656042010020,MATH 103A,B02,083780,Greenfeld; Be'Eri,0,0,36,36
1656042010020,MATH 103A,B03,093562,Staff,0,0,36,36
1656042016041,MATH 105,A01,085443,Carter; Anne Toulson,4,1,35,31
1656042016041,MATH 105,A02,093477,Staff,9,0,35,26
1656042022067,MATH 109,A01,083213,Ganzberger; Geoffrey Michael,0,1,34,34
1656042022067,MATH 109,A02,083214,Ganzberger; Geoffrey Michael,0,0,34,34
1656042022067,MATH 109,A03,093478,Staff,1,0,34,33
1656042022067,MATH 109,B01,083215,Ganzberger; Geoffrey Michael,2,0,32,30
1656042022067,MATH 109,B02,083216,Ganzberger; Geoffrey Michael,0,0,32,32
1656042022067,MATH 109,B03,093479,Staff,3,0,32,29
1656042028091,MATH 142A,A01,083219,Chow; Bennett,1,0,32,31
1656042028091,MATH 142A,A02,083220,Chow; Bennett,7,0,32,25
1656042028091,MATH 142A,A03,093480,Staff,4,0,32,28
1656042028091,MATH 142A,B03,093481,Staff,3,0,32,29
1656042028091,MATH 142A,B04,093558,Staff,5,0,32,27
1656042028091,MATH 142A,B05,093559,Staff,0,0,32,32
1656042034118,MATH 193A,A01,083224,Rotar; Vladimir,1,2,34,33
1656042034118,MATH 193A,A02,083225,Rotar; Vladimir,0,0,34,34
1656042034118,MATH 193A,A03,083781,Rotar; Vladimir,1,0,34,33
1656042034118,MATH 193A,A04,083782,Rotar; Vladimir,3,0,34,31
1656042034118,MATH 193A,A05,093482,Rotar; Vladimir,0,0,34,34
1656042040141,MATH 197,001,091859,McAuley; Julian John,9999,0,9999,0
1656042040141,MATH 197,002,095566,Kedlaya; Kiran S.,9997,0,9999,2
1656042040141,MATH 197,003,095567,Xiao; Ming,9999,0,9999,0
1656042040141,MATH 197,004,095571,Perols; Johan Lars,9998,0,9999,1
1656042047198,COGS 9,A01,083615,Shannon; Kyle Michael,3,1,75,72
1656042053227,COGS 11,A01,083617,Boyle; Mary E. T.,11,2,48,37
1656042059254,COGS 13,A01,083071,Bastos; Amalia Pinkusfeld,4,3,71,67
1656042065279,COGS 14A,A01,092681,Semenuks; Arturs,4,25,100,96
1656042071309,COGS 14B,A01,083073,Cheng; Tzu-Han,7,0,63,56
1656042077331,COGS 17,A01,092677,Semenuks; Arturs,8,7,81,73
1656042083354,COGS 100,A01,083619,Allen; Michael Gordon,3,2,70,67
1656042089377,COGS 101A,A01,083621,Davis; Joshua Daniel,4,3,68,64
1656042095401,COGS 101B,A01,091572,Allen; Michael Gordon,0,0,65,65
1656042101428,COGS 101C,A01,083625,Delgado; Tania,7,0,35,28
1656042107451,COGS 107A,A01,083627,Boyle; Mary E. T.,1,2,60,59
1656042113474,COGS 118A,A01,083075,Gupta; Anjum,21,16,76,55
1656042119500,CSE 3,A50,083646,Miranda; Gregory Joseph,14,0,50,36
1656042125524,CSE 8A,A50,083650,Miranda; Gregory Joseph,4,11,56,52
1656042131547,CSE 11,A01,083080,Cao; Yingjun,0,64,40,40
1656042137575,CSE 12,A01,083652,Krause-Levy; Sophia Louisa,7,8,120,113
1656042143603,CSE 15L,A01,083654,Morris; Justin Loren,3,1,50,47
1656042143603,CSE 15L,A02,083655,Morris; Justin Loren,2,1,50,48
1656042149625,CSE 20,A01,083657,Tran; Khoa Dang,29,0,80,51
1656042155648,CSE 21,A01,095574,Bach; Quang Tran,23,0,48,25
1656042161674,CSE 30,A01,083084,Eldon; John,2,10,80,78
1656042161674,CSE 30,B01,095061,Bhaskar; Nishant,2,5,50,48
1656042167696,CSE 100,A01,083659,Cao; Yingjun,2,25,70,68
1656042173718,CSE 134B,A01,083661,Powell; Thomas Allan,6,6,100,94
1656042179746,CSE 140,A01,083663,Gungor; Onat,6,0,85,79
1656042185770,CSE 140L,A01,083088,Eldon; John,5,0,100,95
1656042191793,CSE 175,A01,083665,Kumar; Rakesh,0,0,25,25
1656042197819,CSE 190,A00,092507,Dubnov; Shlomo,1,0,20,19
1656042203844,ECE 45,A01,083139,Congero; Spencer William,1,1,75,74
1656042209875,ECE 65,A50,083695,Saad; Andrew S,6,0,30,24
1656042209875,ECE 65,A51,095125,Staff,23,0,26,3
1656042215909,ECE 109,A01,091882,Touri; Behrouz,3,5,70,67
1656042221931,ECE 180,A00,083140,Abi Samra; Nicholas Camill,1,0,30,29
1656042221931,ECE 180,B00,083141,Abi Samra; Nicholas Camill,0,8,28,28
1656042227963,MATH 10A,A01,083735,Patchell; Gregory David,0,0,30,30
1656042227963,MATH 10A,A02,083736,Patchell; Gregory David,20,0,30,10
1656042227963,MATH 10A,A03,083737,Patchell; Gregory David,16,0,30,14
1656042234002,MATH 10B,A01,083207,Lim; Seonhee,1,1,34,33
1656042234002,MATH 10B,A02,083208,Lim; Seonhee,1,1,35,34
1656042234002,MATH 10B,A03,093472,Staff,0,1,34,34
1656042234002,MATH 10B,B01,083739,Sinha; Shubham,10,0,30,20
1656042240027,MATH 18,A01,083743,Cinel; Cameron Alexander,5,0,30,25
1656042240027,MATH 18,A02,083744,Cinel; Cameron Alexander,11,0,30,19
1656042240027,MATH 18,A03,083745,Cinel; Cameron Alexander,1,0,30,29
1656042240027,MATH 18,B01,083748,Ma; Zilu,0,0,36,36
1656042240027,MATH 18,B02,083749,Ma; Zilu,0,0,36,36
1656042240027,MATH 18,B03,083750,Ma; Zilu,0,0,36,36
1656042240027,MATH 18,B04,083751,Ma; Zilu,0,0,36,36
1656042240027,MATH 18,B05,093473,Staff,0,0,36,36
1656042240027,MATH 18,B06,093474,Staff,3,0,36,33
1656042246052,MATH 20A,A01,083754,Zheng; Zequn,11,0,40,29
1656042252075,MATH 20B,A01,083756,Briones; Jor-el Thomas Caparas,0,0,36,36
1656042252075,MATH 20B,A02,083757,Briones; Jor-el Thomas Caparas,1,0,36,35
1656042252075,MATH 20B,A03,093475,Staff,0,0,36,36
1656042258099,MATH 20C,A01,083760,Briones; Jor-el Thomas Caparas,0,2,35,35
1656042258099,MATH 20C,A02,083761,Briones; Jor-el Thomas Caparas,6,1,35,29
1656042258099,MATH 20C,A03,093476,Staff,0,1,35,35
1656042258099,MATH 20C,B01,083762,Bach; Quang Tran,3,0,30,27
1656042264125,MATH 20D,A01,083765,Tran; Brian Kha,2,0,30,28
1656042264125,MATH 20D,A02,083766,Tran; Brian Kha,0,1,30,30
1656042264125,MATH 20D,A03,083767,Tran; Brian Kha,0,0,30,30
1656042270148,MATH 20E,A01,083771,Ganguly; Soumya,0,1,32,32
1656042270148,MATH 20E,A02,083772,Ganguly; Soumya,1,1,32,31
1656042270148,MATH 20E,B01,083773,Ciotti; Benjamin,13,0,35,22
1656042270148,MATH 20E,B02,083774,Ciotti; Benjamin,12,0,35,23
1656042276180,MATH 103A,A01,083777,Greenfeld; Be'Eri,2,1,36,34
1656042276180,MATH 103A,A02,083778,Greenfeld; Be'Eri,1,0,36,35
1656042276180,MATH 103A,A03,093561,Staff,0,1,36,36
1656042276180,MATH 103A,B01,083779,Greenfeld; Be'Eri,8,1,36,28
1656042276180,MATH 103A,B02,083780,Greenfeld; Be'Eri,0,0,36,36
1656042276180,MATH 103A,B03,093562,Staff,0,0,36,36
1656042282275,MATH 105,A01,085443,Carter; Anne Toulson,4,1,35,31
1656042282275,MATH 105,A02,093477,Staff,9,0,35,26
1656042288298,MATH 109,A01,083213,Ganzberger; Geoffrey Michael,0,1,34,34
1656042288298,MATH 109,A02,083214,Ganzberger; Geoffrey Michael,0,0,34,34
1656042288298,MATH 109,A03,093478,Staff,1,0,34,33
1656042288298,MATH 109,B01,083215,Ganzberger; Geoffrey Michael,2,0,32,30
1656042288298,MATH 109,B02,083216,Ganzberger; Geoffrey Michael,0,0,32,32
1656042288298,MATH 109,B03,093479,Staff,3,0,32,29
1656042294322,MATH 142A,A01,083219,Chow; Bennett,1,0,32,31
1656042294322,MATH 142A,A02,083220,Chow; Bennett,7,0,32,25
1656042294322,MATH 142A,A03,093480,Staff,4,0,32,28
1656042294322,MATH 142A,B03,093481,Staff,3,0,32,29
1656042294322,MATH 142A,B04,093558,Staff,5,0,32,27
1656042294322,MATH 142A,B05,093559,Staff,0,0,32,32
1656042300346,MATH 193A,A01,083224,Rotar; Vladimir,1,2,34,33
1656042300346,MATH 193A,A02,083225,Rotar; Vladimir,0,0,34,34
1656042300346,MATH 193A,A03,083781,Rotar; Vladimir,1,0,34,33
1656042300346,MATH 193A,A04,083782,Rotar; Vladimir,3,0,34,31
1656042300346,MATH 193A,A05,093482,Rotar; Vladimir,0,0,34,34
1656042306369,MATH 197,001,091859,McAuley; Julian John,9999,0,9999,0
1656042306369,MATH 197,002,095566,Kedlaya; Kiran S.,9997,0,9999,2
1656042306369,MATH 197,003,095567,Xiao; Ming,9999,0,9999,0
1656042306369,MATH 197,004,095571,Perols; Johan Lars,9998,0,9999,1
1656042313417,COGS 9,A01,083615,Shannon; Kyle Michael,3,1,75,72
1656042319439,COGS 11,A01,083617,Boyle; Mary E. T.,11,2,48,37
1656042325464,COGS 13,A01,083071,Bastos; Amalia Pinkusfeld,4,3,71,67
1656042331489,COGS 14A,A01,092681,Semenuks; Arturs,4,25,100,96
1656042337515,COGS 14B,A01,083073,Cheng; Tzu-Han,7,0,63,56
1656042343543,COGS 17,A01,092677,Semenuks; Arturs,8,7,81,73
1656042349566,COGS 100,A01,083619,Allen; Michael Gordon,3,2,70,67
1656042355590,COGS 101A,A01,083621,Davis; Joshua Daniel,4,3,68,64
1656042361615,COGS 101B,A01,091572,Allen; Michael Gordon,0,0,65,65
1656042367639,COGS 101C,A01,083625,Delgado; Tania,7,0,35,28
1656042373666,COGS 107A,A01,083627,Boyle; Mary E. T.,1,2,60,59
1656042379691,COGS 118A,A01,083075,Gupta; Anjum,21,16,76,55
1656042385714,CSE 3,A50,083646,Miranda; Gregory Joseph,14,0,50,36
1656042391738,CSE 8A,A50,083650,Miranda; Gregory Joseph,4,11,56,52
1656042397762,CSE 11,A01,083080,Cao; Yingjun,0,64,40,40
1656042403789,CSE 12,A01,083652,Krause-Levy; Sophia Louisa,7,8,120,113
1656042409816,CSE 15L,A01,083654,Morris; Justin Loren,3,1,50,47
1656042409816,CSE 15L,A02,083655,Morris; Justin Loren,2,1,50,48
1656042415843,CSE 20,A01,083657,Tran; Khoa Dang,29,0,80,51
1656042421867,CSE 21,A01,095574,Bach; Quang Tran,23,0,48,25
1656042427894,CSE 30,A01,083084,Eldon; John,2,10,80,78
1656042427894,CSE 30,B01,095061,Bhaskar; Nishant,2,5,50,48
1656042433918,CSE 100,A01,083659,Cao; Yingjun,2,25,70,68
1656042439945,CSE 134B,A01,083661,Powell; Thomas Allan,6,6,100,94
1656042445978,CSE 140,A01,083663,Gungor; Onat,6,0,85,79
1656042452000,CSE 140L,A01,083088,Eldon; John,5,0,100,95
1656042458026,CSE 175,A01,083665,Kumar; Rakesh,0,0,25,25
1656042464050,CSE 190,A00,092507,Dubnov; Shlomo,1,0,20,19
1656042470076,ECE 45,A01,083139,Congero; Spencer William,1,1,75,74
1656042476109,ECE 65,A50,083695,Saad; Andrew S,6,0,30,24
1656042476109,ECE 65,A51,095125,Staff,23,0,26,3
1656042482133,ECE 109,A01,091882,Touri; Behrouz,3,5,70,67
1656042488156,ECE 180,A00,083140,Abi Samra; Nicholas Camill,1,0,30,29
1656042488156,ECE 180,B00,083141,Abi Samra; Nicholas Camill,0,8,28,28
1656042494184,MATH 10A,A01,083735,Patchell; Gregory David,0,0,30,30
1656042494184,MATH 10A,A02,083736,Patchell; Gregory David,20,0,30,10
1656042494184,MATH 10A,A03,083737,Patchell; Gregory David,16,0,30,14
1656042500214,MATH 10B,A01,083207,Lim; Seonhee,1,1,34,33
1656042500214,MATH 10B,A02,083208,Lim; Seonhee,1,1,35,34
1656042500214,MATH 10B,A03,093472,Staff,0,1,34,34
1656042500214,MATH 10B,B01,083739,Sinha; Shubham,10,0,30,20
1656042506253,MATH 18,A01,083743,Cinel; Cameron Alexander,5,0,30,25
1656042506253,MATH 18,A02,083744,Cinel; Cameron Alexander,11,0,30,19
1656042506253,MATH 18,A03,083745,Cinel; Cameron Alexander,1,0,30,29
1656042506253,MATH 18,B01,083748,Ma; Zilu,0,0,36,36
1656042506253,MATH 18,B02,083749,Ma; Zilu,0,0,36,36
1656042506253,MATH 18,B03,083750,Ma; Zilu,0,0,36,36
1656042506253,MATH 18,B04,083751,Ma; Zilu,0,0,36,36
1656042506253,MATH 18,B05,093473,Staff,0,0,36,36
1656042506253,MATH 18,B06,093474,Staff,3,0,36,33
1656042512275,MATH 20A,A01,083754,Zheng; Zequn,11,0,40,29
1656042518305,MATH 20B,A01,083756,Briones; Jor-el Thomas Caparas,0,0,36,36
1656042518305,MATH 20B,A02,083757,Briones; Jor-el Thomas Caparas,1,0,36,35
1656042518305,MATH 20B,A03,093475,Staff,0,0,36,36
1656042524329,MATH 20C,A01,083760,Briones; Jor-el Thomas Caparas,0,2,35,35
1656042524329,MATH 20C,A02,083761,Briones; Jor-el Thomas Caparas,6,1,35,29
1656042524329,MATH 20C,A03,093476,Staff,0,1,35,35
1656042524329,MATH 20C,B01,083762,Bach; Quang Tran,3,0,30,27
1656042530358,MATH 20D,A01,083765,Tran; Brian Kha,2,0,30,28
1656042530358,MATH 20D,A02,083766,Tran; Brian Kha,0,1,30,30
1656042530358,MATH 20D,A03,083767,Tran; Brian Kha,0,0,30,30
1656042536424,MATH 20E,A01,083771,Ganguly; Soumya,0,1,32,32
1656042536424,MATH 20E,A02,083772,Ganguly; Soumya,1,1,32,31
1656042536424,MATH 20E,B01,083773,Ciotti; Benjamin,13,0,35,22
1656042536424,MATH 20E,B02,083774,Ciotti; Benjamin,12,0,35,23
1656042542455,MATH 103A,A01,083777,Greenfeld; Be'Eri,2,1,36,34
1656042542455,MATH 103A,A02,083778,Greenfeld; Be'Eri,1,0,36,35
1656042542455,MATH 103A,A03,093561,Staff,0,1,36,36
1656042542455,MATH 103A,B01,083779,Greenfeld; Be'Eri,8,1,36,28
1656042542455,MATH 103A,B02,083780,Greenfeld; Be'Eri,0,0,36,36
1656042542455,MATH 103A,B03,093562,Staff,0,0,36,36
1656042548479,MATH 105,A01,085443,Carter; Anne Toulson,4,1,35,31
1656042548479,MATH 105,A02,093477,Staff,9,0,35,26
1656042554508,MATH 109,A01,083213,Ganzberger; Geoffrey Michael,0,1,34,34
1656042554508,MATH 109,A02,083214,Ganzberger; Geoffrey Michael,0,0,34,34
1656042554508,MATH 109,A03,093478,Staff,1,0,34,33
1656042554508,MATH 109,B01,083215,Ganzberger; Geoffrey Michael,2,0,32,30
1656042554508,MATH 109,B02,083216,Ganzberger; Geoffrey Michael,0,0,32,32
1656042554508,MATH 109,B03,093479,Staff,3,0,32,29
1656042560534,MATH 142A,A01,083219,Chow; Bennett,1,0,32,31
1656042560534,MATH 142A,A02,083220,Chow; Bennett,7,0,32,25
1656042560534,MATH 142A,A03,093480,Staff,4,0,32,28
1656042560534,MATH 142A,B03,093481,Staff,3,0,32,29
1656042560534,MATH 142A,B04,093558,Staff,5,0,32,27
1656042560534,MATH 142A,B05,093559,Staff,0,0,32,32
1656042566560,MATH 193A,A01,083224,Rotar; Vladimir,1,2,34,33
1656042566560,MATH 193A,A02,083225,Rotar; Vladimir,0,0,34,34
1656042566560,MATH 193A,A03,083781,Rotar; Vladimir,1,0,34,33
1656042566560,MATH 193A,A04,083782,Rotar; Vladimir,3,0,34,31
1656042566560,MATH 193A,A05,093482,Rotar; Vladimir,0,0,34,34
1656042572587,MATH 197,001,091859,McAuley; Julian John,9999,0,9999,0
1656042572587,MATH 197,002,095566,Kedlaya; Kiran S.,9997,0,9999,2
1656042572587,MATH 197,003,095567,Xiao; Ming,9999,0,9999,0
1656042572587,MATH 197,004,095571,Perols; Johan Lars,9998,0,9999,1
1656042579654,COGS 9,A01,083615,Shannon; Kyle Michael,3,1,75,72
1656042585677,COGS 11,A01,083617,Boyle; Mary E. T.,11,2,48,37
1656042591711,COGS 13,A01,083071,Bastos; Amalia Pinkusfeld,4,3,71,67
1656042597739,COGS 14A,A01,092681,Semenuks; Arturs,4,25,100,96
1656042603762,COGS 14B,A01,083073,Cheng; Tzu-Han,7,0,63,56
1656042609789,COGS 17,A01,092677,Semenuks; Arturs,8,7,81,73
1656042615813,COGS 100,A01,083619,Allen; Michael Gordon,3,2,70,67
1656042621844,COGS 101A,A01,083621,Davis; Joshua Daniel,4,3,68,64
1656042627867,COGS 101B,A01,091572,Allen; Michael Gordon,0,0,65,65
1656042633891,COGS 101C,A01,083625,Delgado; Tania,7,0,35,28
1656042639916,COGS 107A,A01,083627,Boyle; Mary E. T.,1,2,60,59
1656042645940,COGS 118A,A01,083075,Gupta; Anjum,21,16,76,55
1656042651963,CSE 3,A50,083646,Miranda; Gregory Joseph,14,0,50,36
1656042658001,CSE 8A,A50,083650,Miranda; Gregory Joseph,4,11,56,52
1656042664027,CSE 11,A01,083080,Cao; Yingjun,0,64,40,40
1656042670054,CSE 12,A01,083652,Krause-Levy; Sophia Louisa,7,8,120,113
1656042676078,CSE 15L,A01,083654,Morris; Justin Loren,3,1,50,47
1656042676078,CSE 15L,A02,083655,Morris; Justin Loren,2,1,50,48
1656042682107,CSE 20,A01,083657,Tran; Khoa Dang,29,0,80,51
1656042688138,CSE 21,A01,095574,Bach; Quang Tran,23,0,48,25
1656042694161,CSE 30,A01,083084,Eldon; John,2,10,80,78
1656042694161,CSE 30,B01,095061,Bhaskar; Nishant,2,5,50,48
1656042700188,CSE 100,A01,083659,Cao; Yingjun,2,25,70,68
1656042706212,CSE 134B,A01,083661,Powell; Thomas Allan,6,6,100,94
1656042712234,CSE 140,A01,083663,Gungor; Onat,6,0,85,79
1656042718258,CSE 140L,A01,083088,Eldon; John,5,0,100,95
1656042724284,CSE 175,A01,083665,Kumar; Rakesh,0,0,25,25
1656042730309,CSE 190,A00,092507,Dubnov; Shlomo,1,0,20,19
1656042736334,ECE 45,A01,083139,Congero; Spencer William,1,1,75,74
1656042742360,ECE 65,A50,083695,Saad; Andrew S,6,0,30,24
1656042742360,ECE 65,A51,095125,Staff,23,0,26,3
1656042748387,ECE 109,A01,091882,Touri; Behrouz,3,5,70,67
1656042754412,ECE 180,A00,083140,Abi Samra; Nicholas Camill,1,0,30,29
1656042754412,ECE 180,B00,083141,Abi Samra; Nicholas Camill,0,8,28,28
1656042760442,MATH 10A,A01,083735,Patchell; Gregory David,0,0,30,30
1656042760442,MATH 10A,A02,083736,Patchell; Gregory David,20,0,30,10
1656042760442,MATH 10A,A03,083737,Patchell; Gregory David,16,0,30,14
1656042766466,MATH 10B,A01,083207,Lim; Seonhee,1,1,34,33
1656042766466,MATH 10B,A02,083208,Lim; Seonhee,1,1,35,34
1656042766466,MATH 10B,A03,093472,Staff,0,1,34,34
1656042766466,MATH 10B,B01,083739,Sinha; Shubham,10,0,30,20
1656042772489,MATH 18,A01,083743,Cinel; Cameron Alexander,5,0,30,25
1656042772489,MATH 18,A02,083744,Cinel; Cameron Alexander,11,0,30,19
1656042772489,MATH 18,A03,083745,Cinel; Cameron Alexander,1,0,30,29
1656042772489,MATH 18,B01,083748,Ma; Zilu,0,0,36,36
1656042772489,MATH 18,B02,083749,Ma; Zilu,0,0,36,36
1656042772489,MATH 18,B03,083750,Ma; Zilu,0,0,36,36
1656042772489,MATH 18,B04,083751,Ma; Zilu,0,0,36,36
1656042772489,MATH 18,B05,093473,Staff,0,0,36,36
1656042772489,MATH 18,B06,093474,Staff,3,0,36,33
1656042778513,MATH 20A,A01,083754,Zheng; Zequn,11,0,40,29
1656042784544,MATH 20B,A01,083756,Briones; Jor-el Thomas Caparas,0,0,36,36
1656042784544,MATH 20B,A02,083757,Briones; Jor-el Thomas Caparas,1,0,36,35
1656042784544,MATH 20B,A03,093475,Staff,0,0,36,36
1656042790566,MATH 20C,A01,083760,Briones; Jor-el Thomas Caparas,0,2,35,35
1656042790566,MATH 20C,A02,083761,Briones; Jor-el Thomas Caparas,6,1,35,29
1656042790566,MATH 20C,A03,093476,Staff,0,1,35,35
1656042790566,MATH 20C,B01,083762,Bach; Quang Tran,3,0,30,27
1656042796592,MATH 20D,A01,083765,Tran; Brian Kha,2,0,30,28
1656042796592,MATH 20D,A02,083766,Tran; Brian Kha,0,1,30,30
1656042796592,MATH 20D,A03,083767,Tran; Brian Kha,0,0,30,30
1656042802619,MATH 20E,A01,083771,Ganguly; Soumya,0,1,32,32
1656042802619,MATH 20E,A02,083772,Ganguly; Soumya,1,1,32,31
1656042802619,MATH 20E,B01,083773,Ciotti; Benjamin,13,0,35,22
1656042802619,MATH 20E,B02,083774,Ciotti; Benjamin,12,0,35,23
1656042808642,MATH 103A,A01,083777,Greenfeld; Be'Eri,2,1,36,34
1656042808642,MATH 103A,A02,083778,Greenfeld; Be'Eri,1,0,36,35
1656042808642,MATH 103A,A03,093561,Staff,0,1,36,36
1656042808642,MATH 103A,B01,083779,Greenfeld; Be'Eri,8,1,36,28
1656042808642,MATH 103A,B02,083780,Greenfeld; Be'Eri,0,0,36,36
1656042808642,MATH 103A,B03,093562,Staff,0,0,36,36
1656042814670,MATH 105,A01,085443,Carter; Anne Toulson,4,1,35,31
1656042814670,MATH 105,A02,093477,Staff,9,0,35,26
1656042820693,MATH 109,A01,083213,Ganzberger; Geoffrey Michael,0,1,34,34
1656042820693,MATH 109,A02,083214,Ganzberger; Geoffrey Michael,0,0,34,34
1656042820693,MATH 109,A03,093478,Staff,1,0,34,33
1656042820693,MATH 109,B01,083215,Ganzberger; Geoffrey Michael,2,0,32,30
1656042820693,MATH 109,B02,083216,Ganzberger; Geoffrey Michael,0,0,32,32
1656042820693,MATH 109,B03,093479,Staff,3,0,32,29
1656042826722,MATH 142A,A01,083219,Chow; Bennett,1,0,32,31
1656042826722,MATH 142A,A02,083220,Chow; Bennett,7,0,32,25
1656042826722,MATH 142A,A03,093480,Staff,4,0,32,28
1656042826722,MATH 142A,B03,093481,Staff,3,0,32,29
1656042826722,MATH 142A,B04,093558,Staff,5,0,32,27
1656042826722,MATH 142A,B05,093559,Staff,0,0,32,32
1656042832750,MATH 193A,A01,083224,Rotar; Vladimir,1,2,34,33
1656042832750,MATH 193A,A02,083225,Rotar; Vladimir,0,0,34,34
1656042832750,MATH 193A,A03,083781,Rotar; Vladimir,1,0,34,33
1656042832750,MATH 193A,A04,083782,Rotar; Vladimir,3,0,34,31
1656042832750,MATH 193A,A05,093482,Rotar; Vladimir,0,0,34,34
1656042838774,MATH 197,001,091859,McAuley; Julian John,9999,0,9999,0
1656042838774,MATH 197,002,095566,Kedlaya; Kiran S.,9997,0,9999,2
1656042838774,MATH 197,003,095567,Xiao; Ming,9999,0,9999,0
1656042838774,MATH 197,004,095571,Perols; Johan Lars,9998,0,9999,1
1656042845835,COGS 9,A01,083615,Shannon; Kyle Michael,3,1,75,72
1656042851862,COGS 11,A01,083617,Boyle; Mary E. T.,11,2,48,37
1656042857889,COGS 13,A01,083071,Bastos; Amalia Pinkusfeld,4,3,71,67
1656042863915,COGS 14A,A01,092681,Semenuks; Arturs,4,25,100,96
1656042869938,COGS 14B,A01,083073,Cheng; Tzu-Han,7,0,63,56
1656042876042,COGS 17,A01,092677,Semenuks; Arturs,8,7,81,73
1656042882065,COGS 100,A01,083619,Allen; Michael Gordon,3,2,70,67
1656042888089,COGS 101A,A01,083621,Davis; Joshua Daniel,4,3,68,64
1656042894110,COGS 101B,A01,091572,Allen; Michael Gordon,0,0,65,65
1656042900133,COGS 101C,A01,083625,Delgado; Tania,7,0,35,28
1656042906161,COGS 107A,A01,083627,Boyle; Mary E. T.,1,2,60,59
1656042912204,COGS 118A,A01,083075,Gupta; Anjum,21,16,76,55
1656042918228,CSE 3,A50,083646,Miranda; Gregory Joseph,14,0,50,36
1656042924251,CSE 8A,A50,083650,Miranda; Gregory Joseph,4,11,56,52
1656042930277,CSE 11,A01,083080,Cao; Yingjun,0,64,40,40
1656042936303,CSE 12,A01,083652,Krause-Levy; Sophia Louisa,7,8,120,113
1656042942326,CSE 15L,A01,083654,Morris; Justin Loren,3,1,50,47
1656042942326,CSE 15L,A02,083655,Morris; Justin Loren,2,1,50,48
1656042948359,CSE 20,A01,083657,Tran; Khoa Dang,29,0,80,51
1656042954383,CSE 21,A01,095574,Bach; Quang Tran,23,0,48,25
1656042960405,CSE 30,A01,083084,Eldon; John,2,10,80,78
1656042960405,CSE 30,B01,095061,Bhaskar; Nishant,2,5,50,48
1656042966431,CSE 100,A01,083659,Cao; Yingjun,2,25,70,68
1656042972455,CSE 134B,A01,083661,Powell; Thomas Allan,6,6,100,94
1656042978479,CSE 140,A01,083663,Gungor; Onat,6,0,85,79
1656042984507,CSE 140L,A01,083088,Eldon; John,5,0,100,95
1656042990531,CSE 175,A01,083665,Kumar; Rakesh,0,0,25,25
1656042996554,CSE 190,A00,092507,Dubnov; Shlomo,1,0,20,19
1656043002578,ECE 45,A01,083139,Congero; Spencer William,1,1,75,74
1656043008601,ECE 65,A50,083695,Saad; Andrew S,6,0,30,24
1656043008601,ECE 65,A51,095125,Staff,23,0,26,3
1656043014625,ECE 109,A01,091882,Touri; Behrouz,3,5,70,67
1656043020652,ECE 180,A00,083140,Abi Samra; Nicholas Camill,1,0,30,29
1656043020652,ECE 180,B00,083141,Abi Samra; Nicholas Camill,0,8,28,28
1656043026676,MATH 10A,A01,083735,Patchell; Gregory David,0,0,30,30
1656043026676,MATH 10A,A02,083736,Patchell; Gregory David,20,0,30,10
1656043026676,MATH 10A,A03,083737,Patchell; Gregory David,16,0,30,14
1656043032701,MATH 10B,A01,083207,Lim; Seonhee,1,1,34,33
1656043032701,MATH 10B,A02,083208,Lim; Seonhee,1,1,35,34
1656043032701,MATH 10B,A03,093472,Staff,0,1,34,34
1656043032701,MATH 10B,B01,083739,Sinha; Shubham,10,0,30,20
1656043038726,MATH 18,A01,083743,Cinel; Cameron Alexander,5,0,30,25
1656043038726,MATH 18,A02,083744,Cinel; Cameron Alexander,11,0,30,19
1656043038726,MATH 18,A03,083745,Cinel; Cameron Alexander,1,0,30,29
1656043038726,MATH 18,B01,083748,Ma; Zilu,0,0,36,36
1656043038726,MATH 18,B02,083749,Ma; Zilu,0,0,36,36
1656043038726,MATH 18,B03,083750,Ma; Zilu,0,0,36,36
1656043038726,MATH 18,B04,083751,Ma; Zilu,0,0,36,36
1656043038726,MATH 18,B05,093473,Staff,0,0,36,36
1656043038726,MATH 18,B06,093474,Staff,3,0,36,33
1656043044748,MATH 20A,A01,083754,Zheng; Zequn,11,0,40,29
1656043050770,MATH 20B,A01,083756,Briones; Jor-el Thomas Caparas,0,0,36,36
1656043050770,MATH 20B,A02,083757,Briones; Jor-el Thomas Caparas,1,0,36,35
1656043050770,MATH 20B,A03,093475,Staff,0,0,36,36
1656043056800,MATH 20C,A01,083760,Briones; Jor-el Thomas Caparas,0,2,35,35
1656043056800,MATH 20C,A02,083761,Briones; Jor-el Thomas Caparas,6,1,35,29
1656043056800,MATH 20C,A03,093476,Staff,0,1,35,35
1656043056800,MATH 20C,B01,083762,Bach; Quang Tran,3,0,30,27
1656043062828,MATH 20D,A01,083765,Tran; Brian Kha,2,0,30,28
1656043062828,MATH 20D,A02,083766,Tran; Brian Kha,0,1,30,30
1656043062828,MATH 20D,A03,083767,Tran; Brian Kha,0,0,30,30
1656043068851,MATH 20E,A01,083771,Ganguly; Soumya,0,1,32,32
1656043068851,MATH 20E,A02,083772,Ganguly; Soumya,1,1,32,31
1656043068851,MATH 20E,B01,083773,Ciotti; Benjamin,13,0,35,22
1656043068851,MATH 20E,B02,083774,Ciotti; Benjamin,12,0,35,23
1656043074877,MATH 103A,A01,083777,Greenfeld; Be'Eri,2,1,36,34
1656043074877,MATH 103A,A02,083778,Greenfeld; Be'Eri,1,0,36,35
1656043074877,MATH 103A,A03,093561,Staff,0,1,36,36
1656043074877,MATH 103A,B01,083779,Greenfeld; Be'Eri,8,1,36,28
1656043074877,MATH 103A,B02,083780,Greenfeld; Be'Eri,0,0,36,36
1656043074877,MATH 103A,B03,093562,Staff,0,0,36,36
1656043080901,MATH 105,A01,085443,Carter; Anne Toulson,4,1,35,31
1656043080901,MATH 105,A02,093477,Staff,9,0,35,26
1656043086925,MATH 109,A01,083213,Ganzberger; Geoffrey Michael,0,1,34,34
1656043086925,MATH 109,A02,083214,Ganzberger; Geoffrey Michael,0,0,34,34
1656043086925,MATH 109,A03,093478,Staff,1,0,34,33
1656043086925,MATH 109,B01,083215,Ganzberger; Geoffrey Michael,2,0,32,30
1656043086925,MATH 109,B02,083216,Ganzberger; Geoffrey Michael,0,0,32,32
1656043086925,MATH 109,B03,093479,Staff,3,0,32,29
1656043092954,MATH 142A,A01,083219,Chow; Bennett,1,0,32,31
1656043092954,MATH 142A,A02,083220,Chow; Bennett,7,0,32,25
1656043092954,MATH 142A,A03,093480,Staff,4,0,32,28
1656043092954,MATH 142A,B03,093481,Staff,3,0,32,29
1656043092954,MATH 142A,B04,093558,Staff,5,0,32,27
1656043092954,MATH 142A,B05,093559,Staff,0,0,32,32
1656043098978,MATH 193A,A01,083224,Rotar; Vladimir,1,2,34,33
1656043098978,MATH 193A,A02,083225,Rotar; Vladimir,0,0,34,34
1656043098978,MATH 193A,A03,083781,Rotar; Vladimir,1,0,34,33
1656043098978,MATH 193A,A04,083782,Rotar; Vladimir,3,0,34,31
1656043098978,MATH 193A,A05,093482,Rotar; Vladimir,0,0,34,34
1656043105002,MATH 197,001,091859,McAuley; Julian John,9999,0,9999,0
1656043105002,MATH 197,002,095566,Kedlaya; Kiran S.,9997,0,9999,2
1656043105002,MATH 197,003,095567,Xiao; Ming,9999,0,9999,0
1656043105002,MATH 197,004,095571,Perols; Johan Lars,9998,0,9999,1
1656043112065,COGS 9,A01,083615,Shannon; Kyle Michael,3,1,75,72
1656043118088,COGS 11,A01,083617,Boyle; Mary E. T.,11,2,48,37
1656043124114,COGS 13,A01,083071,Bastos; Amalia Pinkusfeld,4,3,71,67
1656043130141,COGS 14A,A01,092681,Semenuks; Arturs,4,25,100,96
1656043136166,COGS 14B,A01,083073,Cheng; Tzu-Han,7,0,63,56
1656043142198,COGS 17,A01,092677,Semenuks; Arturs,8,7,81,73
1656043148227,COGS 100,A01,083619,Allen; Michael Gordon,3,2,70,67
1656043154255,COGS 101A,A01,083621,Davis; Joshua Daniel,4,3,68,64
1656043160282,COGS 101B,A01,091572,Allen; Michael Gordon,0,0,65,65
1656043166305,COGS 101C,A01,083625,Delgado; Tania,7,0,35,28
1656043172330,COGS 107A,A01,083627,Boyle; Mary E. T.,1,2,60,59
1656043178356,COGS 118A,A01,083075,Gupta; Anjum,21,16,76,55
1656043184382,CSE 3,A50,083646,Miranda; Gregory Joseph,14,0,50,36
1656043190410,CSE 8A,A50,083650,Miranda; Gregory Joseph,4,11,56,52
1656043196434,CSE 11,A01,083080,Cao; Yingjun,0,64,40,40
1656043202459,CSE 12,A01,083652,Krause-Levy; Sophia Louisa,7,8,120,113
1656043208486,CSE 15L,A01,083654,Morris; Justin Loren,3,1,50,47
1656043208486,CSE 15L,A02,083655,Morris; Justin Loren,2,1,50,48
1656043214510,CSE 20,A01,083657,Tran; Khoa Dang,29,0,80,51
1656043220538,CSE 21,A01,095574,Bach; Quang Tran,23,0,48,25
1656043226563,CSE 30,A01,083084,Eldon; John,2,10,80,78
1656043226563,CSE 30,B01,095061,Bhaskar; Nishant,2,5,50,48
1656043232589,CSE 100,A01,083659,Cao; Yingjun,2,25,70,68
1656043238616,CSE 134B,A01,083661,Powell; Thomas Allan,6,6,100,94
1656043244640,CSE 140,A01,083663,Gungor; Onat,6,0,85,79
1656043250670,CSE 140L,A01,083088,Eldon; John,5,0,100,95
1656043256693,CSE 175,A01,083665,Kumar; Rakesh,0,0,25,25
1656043262728,CSE 190,A00,092507,Dubnov; Shlomo,1,0,20,19
1656043268751,ECE 45,A01,083139,Congero; Spencer William,1,1,75,74
1656043274776,ECE 65,A50,083695,Saad; Andrew S,6,0,30,24
1656043274776,ECE 65,A51,095125,Staff,23,0,26,3
1656043280800,ECE 109,A01,091882,Touri; Behrouz,3,5,70,67
1656043286823,ECE 180,A00,083140,Abi Samra; Nicholas Camill,1,0,30,29
1656043286823,ECE 180,B00,083141,Abi Samra; Nicholas Camill,0,8,28,28
1656043292847,MATH 10A,A01,083735,Patchell; Gregory David,0,0,30,30
1656043292847,MATH 10A,A02,083736,Patchell; Gregory David,20,0,30,10
1656043292847,MATH 10A,A03,083737,Patchell; Gregory David,16,0,30,14
1656043298873,MATH 10B,A01,083207,Lim; Seonhee,1,1,34,33
1656043298873,MATH 10B,A02,083208,Lim; Seonhee,1,1,35,34
1656043298873,MATH 10B,A03,093472,Staff,0,1,34,34
1656043298873,MATH 10B,B01,083739,Sinha; Shubham,10,0,30,20
1656043304898,MATH 18,A01,083743,Cinel; Cameron Alexander,5,0,30,25
1656043304898,MATH 18,A02,083744,Cinel; Cameron Alexander,11,0,30,19
1656043304898,MATH 18,A03,083745,Cinel; Cameron Alexander,1,0,30,29
1656043304898,MATH 18,B01,083748,Ma; Zilu,0,0,36,36
1656043304898,MATH 18,B02,083749,Ma; Zilu,0,0,36,36
1656043304898,MATH 18,B03,083750,Ma; Zilu,0,0,36,36
1656043304898,MATH 18,B04,083751,Ma; Zilu,0,0,36,36
1656043304898,MATH 18,B05,093473,Staff,0,0,36,36
1656043304898,MATH 18,B06,093474,Staff,3,0,36,33
1656043310921,MATH 20A,A01,083754,Zheng; Zequn,11,0,40,29
1656043316948,MATH 20B,A01,083756,Briones; Jor-el Thomas Caparas,0,0,36,36
1656043316948,MATH 20B,A02,083757,Briones; Jor-el Thomas Caparas,1,0,36,35
1656043316948,MATH 20B,A03,093475,Staff,0,0,36,36
1656043322973,MATH 20C,A01,083760,Briones; Jor-el Thomas Caparas,0,2,35,35
1656043322973,MATH 20C,A02,083761,Briones; Jor-el Thomas Caparas,6,1,35,29
1656043322973,MATH 20C,A03,093476,Staff,0,1,35,35
1656043322973,MATH 20C,B01,083762,Bach; Quang Tran,3,0,30,27
1656043329001,MATH 20D,A01,083765,Tran; Brian Kha,2,0,30,28
1656043329001,MATH 20D,A02,083766,Tran; Brian Kha,0,1,30,30
1656043329001,MATH 20D,A03,083767,Tran; Brian Kha,0,0,30,30
1656043335030,MATH 20E,A01,083771,Ganguly; Soumya,0,1,32,32
1656043335030,MATH 20E,A02,083772,Ganguly; Soumya,1,1,32,31
1656043335030,MATH 20E,B01,083773,Ciotti; Benjamin,13,0,35,22
1656043335030,MATH 20E,B02,083774,Ciotti; Benjamin,12,0,35,23
1656043341055,MATH 103A,A01,083777,Greenfeld; Be'Eri,2,1,36,34
1656043341055,MATH 103A,A02,083778,Greenfeld; Be'Eri,1,0,36,35
1656043341055,MATH 103A,A03,093561,Staff,0,1,36,36
1656043341055,MATH 103A,B01,083779,Greenfeld; Be'Eri,8,1,36,28
1656043341055,MATH 103A,B02,083780,Greenfeld; Be'Eri,0,0,36,36
1656043341055,MATH 103A,B03,093562,Staff,0,0,36,36
1656043347079,MATH 105,A01,085443,Carter; Anne Toulson,4,1,35,31
1656043347079,MATH 105,A02,093477,Staff,9,0,35,26
1656043353103,MATH 109,A01,083213,Ganzberger; Geoffrey Michael,0,1,34,34
1656043353103,MATH 109,A02,083214,Ganzberger; Geoffrey Michael,0,0,34,34
1656043353103,MATH 109,A03,093478,Staff,1,0,34,33
1656043353103,MATH 109,B01,083215,Ganzberger; Geoffrey Michael,2,0,32,30
1656043353103,MATH 109,B02,083216,Ganzberger; Geoffrey Michael,0,0,32,32
1656043353103,MATH 109,B03,093479,Staff,3,0,32,29
1656043359127,MATH 142A,A01,083219,Chow; Bennett,1,0,32,31
1656043359127,MATH 142A,A02,083220,Chow; Bennett,7,0,32,25
1656043359127,MATH 142A,A03,093480,Staff,4,0,32,28
1656043359127,MATH 142A,B03,093481,Staff,3,0,32,29
1656043359127,MATH 142A,B04,093558,Staff,5,0,32,27
1656043359127,MATH 142A,B05,093559,Staff,0,0,32,32
1656043365152,MATH 193A,A01,083224,Rotar; Vladimir,1,2,34,33
1656043365152,MATH 193A,A02,083225,Rotar; Vladimir,0,0,34,34
1656043365152,MATH 193A,A03,083781,Rotar; Vladimir,1,0,34,33
1656043365152,MATH 193A,A04,083782,Rotar; Vladimir,3,0,34,31
1656043365152,MATH 193A,A05,093482,Rotar; Vladimir,0,0,34,34
1656043371182,MATH 197,001,091859,McAuley; Julian John,9999,0,9999,0
1656043371182,MATH 197,002,095566,Kedlaya; Kiran S.,9997,0,9999,2
1656043371182,MATH 197,003,095567,Xiao; Ming,9999,0,9999,0
1656043371182,MATH 197,004,095571,Perols; Johan Lars,9998,0,9999,1
1656043378242,COGS 9,A01,083615,Shannon; Kyle Michael,3,1,75,72
1656043384274,COGS 11,A01,083617,Boyle; Mary E. T.,11,2,48,37
1656043390301,COGS 13,A01,083071,Bastos; Amalia Pinkusfeld,4,3,71,67
1656043396326,COGS 14A,A01,092681,Semenuks; Arturs,4,25,100,96
1656043402348,COGS 14B,A01,083073,Cheng; Tzu-Han,7,0,63,56
1656043408371,COGS 17,A01,092677,Semenuks; Arturs,8,7,81,73
1656043414397,COGS 100,A01,083619,Allen; Michael Gordon,3,2,70,67
1656043420422,COGS 101A,A01,083621,Davis; Joshua Daniel,4,3,68,64
1656043426445,COGS 101B,A01,091572,Allen; Michael Gordon,0,0,65,65
1656043432471,COGS 101C,A01,083625,Delgado; Tania,7,0,35,28
1656043438494,COGS 107A,A01,083627,Boyle; Mary E. T.,1,2,60,59
1656043444517,COGS 118A,A01,083075,Gupta; Anjum,21,16,76,55
1656043450542,CSE 3,A50,083646,Miranda; Gregory Joseph,14,0,50,36
1656043456565,CSE 8A,A50,083650,Miranda; Gregory Joseph,4,11,56,52
1656043462596,CSE 11,A01,083080,Cao; Yingjun,0,64,40,40
1656043468625,CSE 12,A01,083652,Krause-Levy; Sophia Louisa,7,8,120,113
1656043474721,CSE 15L,A01,083654,Morris; Justin Loren,3,1,50,47
1656043474721,CSE 15L,A02,083655,Morris; Justin Loren,2,1,50,48
1656043480750,CSE 20,A01,083657,Tran; Khoa Dang,29,0,80,51
1656043486773,CSE 21,A01,095574,Bach; Quang Tran,23,0,48,25
1656043492801,CSE 30,A01,083084,Eldon; John,2,10,80,78
1656043492801,CSE 30,B01,095061,Bhaskar; Nishant,2,5,50,48
1656043498825,CSE 100,A01,083659,Cao; Yingjun,2,25,70,68
1656043504848,CSE 134B,A01,083661,Powell; Thomas Allan,6,6,100,94
1656043510872,CSE 140,A01,083663,Gungor; Onat,6,0,85,79
1656043516895,CSE 140L,A01,083088,Eldon; John,5,0,100,95
1656043522919,CSE 175,A01,083665,Kumar; Rakesh,0,0,25,25
1656043528946,CSE 190,A00,092507,Dubnov; Shlomo,1,0,20,19
1656043534970,ECE 45,A01,083139,Congero; Spencer William,1,1,75,74
1656043540998,ECE 65,A50,083695,Saad; Andrew S,6,0,30,24
1656043540998,ECE 65,A51,095125,Staff,23,0,26,3
1656043547025,ECE 109,A01,091882,Touri; Behrouz,3,5,70,67
1656043553052,ECE 180,A00,083140,Abi Samra; Nicholas Camill,1,0,30,29
1656043553052,ECE 180,B00,083141,Abi Samra; Nicholas Camill,0,8,28,28
1656043559076,MATH 10A,A01,083735,Patchell; Gregory David,0,0,30,30
1656043559076,MATH 10A,A02,083736,Patchell; Gregory David,20,0,30,10
1656043559076,MATH 10A,A03,083737,Patchell; Gregory David,16,0,30,14
1656043565104,MATH 10B,A01,083207,Lim; Seonhee,1,1,34,33
1656043565104,MATH 10B,A02,083208,Lim; Seonhee,1,1,35,34
1656043565104,MATH 10B,A03,093472,Staff,0,1,34,34
1656043565104,MATH 10B,B01,083739,Sinha; Shubham,10,0,30,20
1656043571135,MATH 18,A01,083743,Cinel; Cameron Alexander,5,0,30,25
1656043571135,MATH 18,A02,083744,Cinel; Cameron Alexander,11,0,30,19
1656043571135,MATH 18,A03,083745,Cinel; Cameron Alexander,1,0,30,29
1656043571135,MATH 18,B01,083748,Ma; Zilu,0,0,36,36
1656043571135,MATH 18,B02,083749,Ma; Zilu,0,0,36,36
1656043571135,MATH 18,B03,083750,Ma; Zilu,0,0,36,36
1656043571135,MATH 18,B04,083751,Ma; Zilu,0,0,36,36
1656043571135,MATH 18,B05,093473,Staff,0,0,36,36
1656043571135,MATH 18,B06,093474,Staff,3,0,36,33
1656043577163,MATH 20A,A01,083754,Zheng; Zequn,11,0,40,29
1656043583192,MATH 20B,A01,083756,Briones; Jor-el Thomas Caparas,0,0,36,36
1656043583192,MATH 20B,A02,083757,Briones; Jor-el Thomas Caparas,0,0,36,36
1656043583192,MATH 20B,A03,093475,Staff,0,0,36,36
1656043589217,MATH 20C,A01,083760,Briones; Jor-el Thomas Caparas,0,2,35,35
1656043589217,MATH 20C,A02,083761,Briones; Jor-el Thomas Caparas,6,1,35,29
1656043589217,MATH 20C,A03,093476,Staff,0,1,35,35
1656043589217,MATH 20C,B01,083762,Bach; Quang Tran,3,0,30,27
1656043595240,MATH 20D,A01,083765,Tran; Brian Kha,2,0,30,28
1656043595240,MATH 20D,A02,083766,Tran; Brian Kha,0,1,30,30
1656043595240,MATH 20D,A03,083767,Tran; Brian Kha,0,0,30,30
1656043601270,MATH 20E,A01,083771,Ganguly; Soumya,0,1,32,32
1656043601270,MATH 20E,A02,083772,Ganguly; Soumya,1,1,32,31
1656043601270,MATH 20E,B01,083773,Ciotti; Benjamin,13,0,35,22
1656043601270,MATH 20E,B02,083774,Ciotti; Benjamin,13,0,35,22
1656043607298,MATH 103A,A01,083777,Greenfeld; Be'Eri,2,1,36,34
1656043607298,MATH 103A,A02,083778,Greenfeld; Be'Eri,1,0,36,35
1656043607298,MATH 103A,A03,093561,Staff,0,1,36,36
1656043607298,MATH 103A,B01,083779,Greenfeld; Be'Eri,8,1,36,28
1656043607298,MATH 103A,B02,083780,Greenfeld; Be'Eri,0,0,36,36
1656043607298,MATH 103A,B03,093562,Staff,0,0,36,36
1656043613323,MATH 105,A01,085443,Carter; Anne Toulson,4,1,35,31
1656043613323,MATH 105,A02,093477,Staff,9,0,35,26
1656043619347,MATH 109,A01,083213,Ganzberger; Geoffrey Michael,0,1,34,34
1656043619347,MATH 109,A02,083214,Ganzberger; Geoffrey Michael,0,0,34,34
1656043619347,MATH 109,A03,093478,Staff,1,0,34,33
1656043619347,MATH 109,B01,083215,Ganzberger; Geoffrey Michael,2,0,32,30
1656043619347,MATH 109,B02,083216,Ganzberger; Geoffrey Michael,0,0,32,32
1656043619347,MATH 109,B03,093479,Staff,3,0,32,29
1656043625371,MATH 142A,A01,083219,Chow; Bennett,1,0,32,31
1656043625371,MATH 142A,A02,083220,Chow; Bennett,7,0,32,25
1656043625371,MATH 142A,A03,093480,Staff,4,0,32,28
1656043625371,MATH 142A,B03,093481,Staff,3,0,32,29
1656043625371,MATH 142A,B04,093558,Staff,5,0,32,27
1656043625371,MATH 142A,B05,093559,Staff,0,0,32,32
1656043631400,MATH 193A,A01,083224,Rotar; Vladimir,1,2,34,33
1656043631400,MATH 193A,A02,083225,Rotar; Vladimir,0,0,34,34
1656043631400,MATH 193A,A03,083781,Rotar; Vladimir,1,0,34,33
1656043631400,MATH 193A,A04,083782,Rotar; Vladimir,3,0,34,31
1656043631400,MATH 193A,A05,093482,Rotar; Vladimir,0,0,34,34
1656043637425,MATH 197,001,091859,McAuley; Julian John,9999,0,9999,0
1656043637425,MATH 197,002,095566,Kedlaya; Kiran S.,9997,0,9999,2
1656043637425,MATH 197,003,095567,Xiao; Ming,9999,0,9999,0
1656043637425,MATH 197,004,095571,Perols; Johan Lars,9998,0,9999,1
1656043644493,COGS 9,A01,083615,Shannon; Kyle Michael,3,1,75,72
1656043650521,COGS 11,A01,083617,Boyle; Mary E. T.,11,2,48,37
1656043656550,COGS 13,A01,083071,Bastos; Amalia Pinkusfeld,4,3,71,67
1656043662573,COGS 14A,A01,092681,Semenuks; Arturs,4,25,100,96
1656043668601,COGS 14B,A01,083073,Cheng; Tzu-Han,7,0,63,56
1656043674625,COGS 17,A01,092677,Semenuks; Arturs,8,7,81,73
1656043680657,COGS 100,A01,083619,Allen; Michael Gordon,3,2,70,67
1656043686687,COGS 101A,A01,083621,Davis; Joshua Daniel,4,3,68,64
1656043692711,COGS 101B,A01,091572,Allen; Michael Gordon,0,0,65,65
1656043698734,COGS 101C,A01,083625,Delgado; Tania,7,0,35,28
1656043704756,COGS 107A,A01,083627,Boyle; Mary E. T.,1,2,60,59
1656043710788,COGS 118A,A01,083075,Gupta; Anjum,21,16,76,55
1656043716811,CSE 3,A50,083646,Miranda; Gregory Joseph,14,0,50,36
1656043722838,CSE 8A,A50,083650,Miranda; Gregory Joseph,4,11,56,52
1656043728864,CSE 11,A01,083080,Cao; Yingjun,0,64,40,40
1656043734886,CSE 12,A01,083652,Krause-Levy; Sophia Louisa,7,8,120,113
1656043740910,CSE 15L,A01,083654,Morris; Justin Loren,3,1,50,47
1656043740910,CSE 15L,A02,083655,Morris; Justin Loren,2,1,50,48
1656043746936,CSE 20,A01,083657,Tran; Khoa Dang,29,0,80,51
1656043752962,CSE 21,A01,095574,Bach; Quang Tran,23,0,48,25
1656043759001,CSE 30,A01,083084,Eldon; John,2,10,80,78
1656043759001,CSE 30,B01,095061,Bhaskar; Nishant,2,5,50,48
1656043765025,CSE 100,A01,083659,Cao; Yingjun,2,25,70,68
1656043771059,CSE 134B,A01,083661,Powell; Thomas Allan,6,6,100,94
1656043777085,CSE 140,A01,083663,Gungor; Onat,6,0,85,79
1656043783109,CSE 140L,A01,083088,Eldon; John,5,0,100,95
1656043789143,CSE 175,A01,083665,Kumar; Rakesh,0,0,25,25
1656043795170,CSE 190,A00,092507,Dubnov; Shlomo,1,0,20,19
1656043801194,ECE 45,A01,083139,Congero; Spencer William,1,1,75,74
1656043807218,ECE 65,A50,083695,Saad; Andrew S,6,0,30,24
1656043807218,ECE 65,A51,095125,Staff,23,0,26,3
1656043813245,ECE 109,A01,091882,Touri; Behrouz,3,5,70,67
1656043819271,ECE 180,A00,083140,Abi Samra; Nicholas Camill,1,0,30,29
1656043819271,ECE 180,B00,083141,Abi Samra; Nicholas Camill,0,8,28,28
1656043825298,MATH 10A,A01,083735,Patchell; Gregory David,0,0,30,30
1656043825298,MATH 10A,A02,083736,Patchell; Gregory David,20,0,30,10
1656043825298,MATH 10A,A03,083737,Patchell; Gregory David,16,0,30,14
1656043831322,MATH 10B,A01,083207,Lim; Seonhee,1,1,34,33
1656043831322,MATH 10B,A02,083208,Lim; Seonhee,1,1,35,34
1656043831322,MATH 10B,A03,093472,Staff,0,1,34,34
1656043831322,MATH 10B,B01,083739,Sinha; Shubham,10,0,30,20
1656043837355,MATH 18,A01,083743,Cinel; Cameron Alexander,5,0,30,25
1656043837355,MATH 18,A02,083744,Cinel; Cameron Alexander,11,0,30,19
1656043837355,MATH 18,A03,083745,Cinel; Cameron Alexander,1,0,30,29
1656043837355,MATH 18,B01,083748,Ma; Zilu,0,0,36,36
1656043837355,MATH 18,B02,083749,Ma; Zilu,0,0,36,36
1656043837355,MATH 18,B03,083750,Ma; Zilu,0,0,36,36
1656043837355,MATH 18,B04,083751,Ma; Zilu,0,0,36,36
1656043837355,MATH 18,B05,093473,Staff,0,0,36,36
1656043837355,MATH 18,B06,093474,Staff,3,0,36,33
1656043843380,MATH 20A,A01,083754,Zheng; Zequn,11,0,40,29
1656043849404,MATH 20B,A01,083756,Briones; Jor-el Thomas Caparas,0,0,36,36
1656043849404,MATH 20B,A02,083757,Briones; Jor-el Thomas Caparas,0,0,36,36
1656043849404,MATH 20B,A03,093475,Staff,0,0,36,36
1656043855427,MATH 20C,A01,083760,Briones; Jor-el Thomas Caparas,0,2,35,35
1656043855427,MATH 20C,A02,083761,Briones; Jor-el Thomas Caparas,6,1,35,29
1656043855427,MATH 20C,A03,093476,Staff,0,1,35,35
1656043855427,MATH 20C,B01,083762,Bach; Quang Tran,3,0,30,27
1656043861449,MATH 20D,A01,083765,Tran; Brian Kha,2,0,30,28
1656043861449,MATH 20D,A02,083766,Tran; Brian Kha,0,1,30,30
1656043861449,MATH 20D,A03,083767,Tran; Brian Kha,0,0,30,30
1656043867484,MATH 20E,A01,083771,Ganguly; Soumya,0,1,32,32
1656043867484,MATH 20E,A02,083772,Ganguly; Soumya,1,1,32,31
1656043867484,MATH 20E,B01,083773,Ciotti; Benjamin,13,0,35,22
1656043867484,MATH 20E,B02,083774,Ciotti; Benjamin,13,0,35,22
1656043873516,MATH 103A,A01,083777,Greenfeld; Be'Eri,2,1,36,34
1656043873516,MATH 103A,A02,083778,Greenfeld; Be'Eri,1,0,36,35
1656043873516,MATH 103A,A03,093561,Staff,0,1,36,36
1656043873516,MATH 103A,B01,083779,Greenfeld; Be'Eri,8,1,36,28
1656043873516,MATH 103A,B02,083780,Greenfeld; Be'Eri,0,0,36,36
1656043873516,MATH 103A,B03,093562,Staff,0,0,36,36
1656043879538,MATH 105,A01,085443,Carter; Anne Toulson,4,1,35,31
1656043879538,MATH 105,A02,093477,Staff,9,0,35,26
1656043885566,MATH 109,A01,083213,Ganzberger; Geoffrey Michael,0,1,34,34
1656043885566,MATH 109,A02,083214,Ganzberger; Geoffrey Michael,0,0,34,34
1656043885566,MATH 109,A03,093478,Staff,1,0,34,33
1656043885566,MATH 109,B01,083215,Ganzberger; Geoffrey Michael,2,0,32,30
1656043885566,MATH 109,B02,083216,Ganzberger; Geoffrey Michael,0,0,32,32
1656043885566,MATH 109,B03,093479,Staff,3,0,32,29
1656043891592,MATH 142A,A01,083219,Chow; Bennett,1,0,32,31
1656043891592,MATH 142A,A02,083220,Chow; Bennett,7,0,32,25
1656043891592,MATH 142A,A03,093480,Staff,4,0,32,28
1656043891592,MATH 142A,B03,093481,Staff,3,0,32,29
1656043891592,MATH 142A,B04,093558,Staff,5,0,32,27
1656043891592,MATH 142A,B05,093559,Staff,0,0,32,32
1656043897614,MATH 193A,A01,083224,Rotar; Vladimir,1,2,34,33
1656043897614,MATH 193A,A02,083225,Rotar; Vladimir,0,0,34,34
1656043897614,MATH 193A,A03,083781,Rotar; Vladimir,1,0,34,33
1656043897614,MATH 193A,A04,083782,Rotar; Vladimir,3,0,34,31
1656043897614,MATH 193A,A05,093482,Rotar; Vladimir,0,0,34,34
1656043903637,MATH 197,001,091859,McAuley; Julian John,9999,0,9999,0
1656043903637,MATH 197,002,095566,Kedlaya; Kiran S.,9997,0,9999,2
1656043903637,MATH 197,003,095567,Xiao; Ming,9999,0,9999,0
1656043903637,MATH 197,004,095571,Perols; Johan Lars,9998,0,9999,1
1656043910691,COGS 9,A01,083615,Shannon; Kyle Michael,3,1,75,72
1656043916716,COGS 11,A01,083617,Boyle; Mary E. T.,11,2,48,37
1656043922758,COGS 13,A01,083071,Bastos; Amalia Pinkusfeld,4,3,71,67
1656043928785,COGS 14A,A01,092681,Semenuks; Arturs,4,25,100,96
1656043934809,COGS 14B,A01,083073,Cheng; Tzu-Han,7,0,63,56
1656043940832,COGS 17,A01,092677,Semenuks; Arturs,8,7,81,73
1656043946854,COGS 100,A01,083619,Allen; Michael Gordon,3,2,70,67
1656043952882,COGS 101A,A01,083621,Davis; Joshua Daniel,4,3,68,64
1656043958914,COGS 101B,A01,091572,Allen; Michael Gordon,0,0,65,65
1656043964938,COGS 101C,A01,083625,Delgado; Tania,7,0,35,28
1656043970961,COGS 107A,A01,083627,Boyle; Mary E. T.,1,2,60,59
1656043976985,COGS 118A,A01,083075,Gupta; Anjum,21,16,76,55
1656043983022,CSE 3,A50,083646,Miranda; Gregory Joseph,14,0,50,36
1656043989050,CSE 8A,A50,083650,Miranda; Gregory Joseph,4,11,56,52
1656043995077,CSE 11,A01,083080,Cao; Yingjun,0,64,40,40
1656044001103,CSE 12,A01,083652,Krause-Levy; Sophia Louisa,7,8,120,113
1656044007128,CSE 15L,A01,083654,Morris; Justin Loren,3,1,50,47
1656044007128,CSE 15L,A02,083655,Morris; Justin Loren,2,1,50,48
1656044013156,CSE 20,A01,083657,Tran; Khoa Dang,29,0,80,51
1656044019183,CSE 21,A01,095574,Bach; Quang Tran,23,0,48,25
1656044025213,CSE 30,A01,083084,Eldon; John,2,10,80,78
1656044025213,CSE 30,B01,095061,Bhaskar; Nishant,2,5,50,48
1656044031241,CSE 100,A01,083659,Cao; Yingjun,2,25,70,68
1656044037262,CSE 134B,A01,083661,Powell; Thomas Allan,6,6,100,94
1656044043289,CSE 140,A01,083663,Gungor; Onat,6,0,85,79
1656044049312,CSE 140L,A01,083088,Eldon; John,5,0,100,95
1656044055336,CSE 175,A01,083665,Kumar; Rakesh,0,0,25,25
1656044061360,CSE 190,A00,092507,Dubnov; Shlomo,1,0,20,19
1656044067386,ECE 45,A01,083139,Congero; Spencer William,1,1,75,74
1656044073484,ECE 65,A50,083695,Saad; Andrew S,6,0,30,24
1656044073484,ECE 65,A51,095125,Staff,23,0,26,3
1656044079511,ECE 109,A01,091882,Touri; Behrouz,3,5,70,67
1656044085538,ECE 180,A00,083140,Abi Samra; Nicholas Camill,1,0,30,29
1656044085538,ECE 180,B00,083141,Abi Samra; Nicholas Camill,0,8,28,28
1656044091566,MATH 10A,A01,083735,Patchell; Gregory David,0,0,30,30
1656044091566,MATH 10A,A02,083736,Patchell; Gregory David,20,0,30,10
1656044091566,MATH 10A,A03,083737,Patchell; Gregory David,16,0,30,14
1656044097595,MATH 10B,A01,083207,Lim; Seonhee,1,1,34,33
1656044097595,MATH 10B,A02,083208,Lim; Seonhee,1,1,35,34
1656044097595,MATH 10B,A03,093472,Staff,0,1,34,34
1656044097595,MATH 10B,B01,083739,Sinha; Shubham,10,0,30,20
1656044103625,MATH 18,A01,083743,Cinel; Cameron Alexander,5,0,30,25
1656044103625,MATH 18,A02,083744,Cinel; Cameron Alexander,11,0,30,19
1656044103625,MATH 18,A03,083745,Cinel; Cameron Alexander,1,0,30,29
1656044103625,MATH 18,B01,083748,Ma; Zilu,0,0,36,36
1656044103625,MATH 18,B02,083749,Ma; Zilu,0,0,36,36
1656044103625,MATH 18,B03,083750,Ma; Zilu,0,0,36,36
1656044103625,MATH 18,B04,083751,Ma; Zilu,0,0,36,36
1656044103625,MATH 18,B05,093473,Staff,0,0,36,36
1656044103625,MATH 18,B06,093474,Staff,3,0,36,33
1656044109653,MATH 20A,A01,083754,Zheng; Zequn,11,0,40,29
1656044115677,MATH 20B,A01,083756,Briones; Jor-el Thomas Caparas,0,0,36,36
1656044115677,MATH 20B,A02,083757,Briones; Jor-el Thomas Caparas,0,0,36,36
1656044115677,MATH 20B,A03,093475,Staff,0,0,36,36
1656044121705,MATH 20C,A01,083760,Briones; Jor-el Thomas Caparas,0,2,35,35
1656044121705,MATH 20C,A02,083761,Briones; Jor-el Thomas Caparas,6,1,35,29
1656044121705,MATH 20C,A03,093476,Staff,0,1,35,35
1656044121705,MATH 20C,B01,083762,Bach; Quang Tran,3,0,30,27
1656044127742,MATH 20D,A01,083765,Tran; Brian Kha,2,0,30,28
1656044127742,MATH 20D,A02,083766,Tran; Brian Kha,0,1,30,30
1656044127742,MATH 20D,A03,083767,Tran; Brian Kha,0,0,30,30
1656044133769,MATH 20E,A01,083771,Ganguly; Soumya,0,1,32,32
1656044133769,MATH 20E,A02,083772,Ganguly; Soumya,1,1,32,31
1656044133769,MATH 20E,B01,083773,Ciotti; Benjamin,13,0,35,22
1656044133769,MATH 20E,B02,083774,Ciotti; Benjamin,13,0,35,22
1656044139811,MATH 103A,A01,083777,Greenfeld; Be'Eri,2,1,36,34
1656044139811,MATH 103A,A02,083778,Greenfeld; Be'Eri,1,0,36,35
1656044139811,MATH 103A,A03,093561,Staff,0,1,36,36
1656044139811,MATH 103A,B01,083779,Greenfeld; Be'Eri,8,1,36,28
1656044139811,MATH 103A,B02,083780,Greenfeld; Be'Eri,0,0,36,36
1656044139811,MATH 103A,B03,093562,Staff,0,0,36,36
1656044145838,MATH 105,A01,085443,Carter; Anne Toulson,4,1,35,31
1656044145838,MATH 105,A02,093477,Staff,9,0,35,26
1656044151860,MATH 109,A01,083213,Ganzberger; Geoffrey Michael,0,1,34,34
1656044151860,MATH 109,A02,083214,Ganzberger; Geoffrey Michael,0,0,34,34
1656044151860,MATH 109,A03,093478,Staff,1,0,34,33
1656044151860,MATH 109,B01,083215,Ganzberger; Geoffrey Michael,2,0,32,30
1656044151860,MATH 109,B02,083216,Ganzberger; Geoffrey Michael,0,0,32,32
1656044151860,MATH 109,B03,093479,Staff,3,0,32,29
1656044157888,MATH 142A,A01,083219,Chow; Bennett,1,0,32,31
1656044157888,MATH 142A,A02,083220,Chow; Bennett,7,0,32,25
1656044157888,MATH 142A,A03,093480,Staff,4,0,32,28
1656044157888,MATH 142A,B03,093481,Staff,3,0,32,29
1656044157888,MATH 142A,B04,093558,Staff,5,0,32,27
1656044157888,MATH 142A,B05,093559,Staff,0,0,32,32
1656044163913,MATH 193A,A01,083224,Rotar; Vladimir,1,2,34,33
1656044163913,MATH 193A,A02,083225,Rotar; Vladimir,0,0,34,34
1656044163913,MATH 193A,A03,083781,Rotar; Vladimir,1,0,34,33
1656044163913,MATH 193A,A04,083782,Rotar; Vladimir,3,0,34,31
1656044163913,MATH 193A,A05,093482,Rotar; Vladimir,0,0,34,34
1656044169935,MATH 197,001,091859,McAuley; Julian John,9999,0,9999,0
1656044169935,MATH 197,002,095566,Kedlaya; Kiran S.,9997,0,9999,2
1656044169935,MATH 197,003,095567,Xiao; Ming,9999,0,9999,0
1656044169935,MATH 197,004,095571,Perols; Johan Lars,9998,0,9999,1
1656044176992,COGS 9,A01,083615,Shannon; Kyle Michael,3,1,75,72
1656044183020,COGS 11,A01,083617,Boyle; Mary E. T.,11,2,48,37
1656044189056,COGS 13,A01,083071,Bastos; Amalia Pinkusfeld,4,3,71,67
1656044195082,COGS 14A,A01,092681,Semenuks; Arturs,4,25,100,96
1656044201116,COGS 14B,A01,083073,Cheng; Tzu-Han,7,0,63,56
1656044207144,COGS 17,A01,092677,Semenuks; Arturs,8,7,81,73
1656044213167,COGS 100,A01,083619,Allen; Michael Gordon,3,2,70,67
1656044219190,COGS 101A,A01,083621,Davis; Joshua Daniel,4,3,68,64
1656044225217,COGS 101B,A01,091572,Allen; Michael Gordon,0,0,65,65
1656044231239,COGS 101C,A01,083625,Delgado; Tania,7,0,35,28
1656044237263,COGS 107A,A01,083627,Boyle; Mary E. T.,1,2,60,59
1656044243290,COGS 118A,A01,083075,Gupta; Anjum,21,16,76,55
1656044249323,CSE 3,A50,083646,Miranda; Gregory Joseph,14,0,50,36
1656044255347,CSE 8A,A50,083650,Miranda; Gregory Joseph,4,11,56,52
1656044261382,CSE 11,A01,083080,Cao; Yingjun,0,64,40,40
1656044267410,CSE 12,A01,083652,Krause-Levy; Sophia Louisa,7,8,120,113
1656044273435,CSE 15L,A01,083654,Morris; Justin Loren,3,1,50,47
1656044273435,CSE 15L,A02,083655,Morris; Justin Loren,2,1,50,48
1656044279462,CSE 20,A01,083657,Tran; Khoa Dang,29,0,80,51
1656044285485,CSE 21,A01,095574,Bach; Quang Tran,23,0,48,25
1656044300211,CSE 30,A01,083084,Eldon; John,2,10,80,78
1656044300211,CSE 30,B01,095061,Bhaskar; Nishant,2,5,50,48
1656044306235,CSE 100,A01,083659,Cao; Yingjun,2,25,70,68
1656044312265,CSE 134B,A01,083661,Powell; Thomas Allan,6,6,100,94
1656044318303,CSE 140,A01,083663,Gungor; Onat,6,0,85,79
1656044324330,CSE 140L,A01,083088,Eldon; John,5,0,100,95
1656044330353,CSE 175,A01,083665,Kumar; Rakesh,0,0,25,25
1656044336381,CSE 190,A00,092507,Dubnov; Shlomo,1,0,20,19
1656044342405,ECE 45,A01,083139,Congero; Spencer William,1,1,75,74
1656044348430,ECE 65,A50,083695,Saad; Andrew S,6,0,30,24
1656044348430,ECE 65,A51,095125,Staff,23,0,26,3
1656044354458,ECE 109,A01,091882,Touri; Behrouz,3,5,70,67
1656044360482,ECE 180,A00,083140,Abi Samra; Nicholas Camill,1,0,30,29
1656044360482,ECE 180,B00,083141,Abi Samra; Nicholas Camill,0,8,28,28
1656044366509,MATH 10A,A01,083735,Patchell; Gregory David,0,0,30,30
1656044366509,MATH 10A,A02,083736,Patchell; Gregory David,20,0,30,10
1656044366509,MATH 10A,A03,083737,Patchell; Gregory David,16,0,30,14
1656044372533,MATH 10B,A01,083207,Lim; Seonhee,1,1,34,33
1656044372533,MATH 10B,A02,083208,Lim; Seonhee,1,1,35,34
1656044372533,MATH 10B,A03,093472,Staff,0,1,34,34
1656044372533,MATH 10B,B01,083739,Sinha; Shubham,10,0,30,20
1656044378563,MATH 18,A01,083743,Cinel; Cameron Alexander,5,0,30,25
1656044378563,MATH 18,A02,083744,Cinel; Cameron Alexander,11,0,30,19
1656044378563,MATH 18,A03,083745,Cinel; Cameron Alexander,1,0,30,29
1656044378563,MATH 18,B01,083748,Ma; Zilu,0,0,36,36
1656044378563,MATH 18,B02,083749,Ma; Zilu,0,0,36,36
1656044378563,MATH 18,B03,083750,Ma; Zilu,0,0,36,36
1656044378563,MATH 18,B04,083751,Ma; Zilu,0,0,36,36
1656044378563,MATH 18,B05,093473,Staff,0,0,36,36
1656044378563,MATH 18,B06,093474,Staff,3,0,36,33
1656044384590,MATH 20A,A01,083754,Zheng; Zequn,11,0,40,29
1656044390614,MATH 20B,A01,083756,Briones; Jor-el Thomas Caparas,0,0,36,36
1656044390614,MATH 20B,A02,083757,Briones; Jor-el Thomas Caparas,0,0,36,36
1656044390614,MATH 20B,A03,093475,Staff,0,0,36,36
1656044396638,MATH 20C,A01,083760,Briones; Jor-el Thomas Caparas,0,2,35,35
1656044396638,MATH 20C,A02,083761,Briones; Jor-el Thomas Caparas,6,1,35,29
1656044396638,MATH 20C,A03,093476,Staff,0,1,35,35
1656044396638,MATH 20C,B01,083762,Bach; Quang Tran,3,0,30,27
1656044402665,MATH 20D,A01,083765,Tran; Brian Kha,2,0,30,28
1656044402665,MATH 20D,A02,083766,Tran; Brian Kha,0,1,30,30
1656044402665,MATH 20D,A03,083767,Tran; Brian Kha,0,0,30,30
1656044408690,MATH 20E,A01,083771,Ganguly; Soumya,0,1,32,32
1656044408690,MATH 20E,A02,083772,Ganguly; Soumya,1,1,32,31
1656044408690,MATH 20E,B01,083773,Ciotti; Benjamin,13,0,35,22
1656044408690,MATH 20E,B02,083774,Ciotti; Benjamin,13,0,35,22
1656044414720,MATH 103A,A01,083777,Greenfeld; Be'Eri,2,1,36,34
1656044414720,MATH 103A,A02,083778,Greenfeld; Be'Eri,1,0,36,35
1656044414720,MATH 103A,A03,093561,Staff,0,1,36,36
1656044414720,MATH 103A,B01,083779,Greenfeld; Be'Eri,8,1,36,28
1656044414720,MATH 103A,B02,083780,Greenfeld; Be'Eri,0,0,36,36
1656044414720,MATH 103A,B03,093562,Staff,0,0,36,36
1656044420746,MATH 105,A01,085443,Carter; Anne Toulson,4,1,35,31
1656044420746,MATH 105,A02,093477,Staff,9,0,35,26
1656044426772,MATH 109,A01,083213,Ganzberger; Geoffrey Michael,0,1,34,34
1656044426772,MATH 109,A02,083214,Ganzberger; Geoffrey Michael,0,0,34,34
1656044426772,MATH 109,A03,093478,Staff,1,0,34,33
1656044426772,MATH 109,B01,083215,Ganzberger; Geoffrey Michael,2,0,32,30
1656044426772,MATH 109,B02,083216,Ganzberger; Geoffrey Michael,0,0,32,32
1656044426772,MATH 109,B03,093479,Staff,3,0,32,29
1656044432803,MATH 142A,A01,083219,Chow; Bennett,1,0,32,31
1656044432803,MATH 142A,A02,083220,Chow; Bennett,7,0,32,25
1656044432803,MATH 142A,A03,093480,Staff,4,0,32,28
1656044432803,MATH 142A,B03,093481,Staff,3,0,32,29
1656044432803,MATH 142A,B04,093558,Staff,5,0,32,27
1656044432803,MATH 142A,B05,093559,Staff,0,0,32,32
1656044438829,MATH 193A,A01,083224,Rotar; Vladimir,1,2,34,33
1656044438829,MATH 193A,A02,083225,Rotar; Vladimir,0,0,34,34
1656044438829,MATH 193A,A03,083781,Rotar; Vladimir,1,0,34,33
1656044438829,MATH 193A,A04,083782,Rotar; Vladimir,3,0,34,31
1656044438829,MATH 193A,A05,093482,Rotar; Vladimir,0,0,34,34
1656044444856,MATH 197,001,091859,McAuley; Julian John,9999,0,9999,0
1656044444856,MATH 197,002,095566,Kedlaya; Kiran S.,9997,0,9999,2
1656044444856,MATH 197,003,095567,Xiao; Ming,9999,0,9999,0
1656044444856,MATH 197,004,095571,Perols; Johan Lars,9998,0,9999,1
1656044451920,COGS 9,A01,083615,Shannon; Kyle Michael,3,1,75,72
1656044457948,COGS 11,A01,083617,Boyle; Mary E. T.,11,2,48,37
1656044463978,COGS 13,A01,083071,Bastos; Amalia Pinkusfeld,4,3,71,67
1656044469999,COGS 14A,A01,092681,Semenuks; Arturs,4,25,100,96
1656044476032,COGS 14B,A01,083073,Cheng; Tzu-Han,7,0,63,56
1656044482066,COGS 17,A01,092677,Semenuks; Arturs,8,7,81,73
1656044488091,COGS 100,A01,083619,Allen; Michael Gordon,3,2,70,67
1656044494117,COGS 101A,A01,083621,Davis; Joshua Daniel,4,3,68,64
1656044500141,COGS 101B,A01,091572,Allen; Michael Gordon,0,0,65,65
1656044506172,COGS 101C,A01,083625,Delgado; Tania,7,0,35,28
1656044512197,COGS 107A,A01,083627,Boyle; Mary E. T.,1,2,60,59
1656044518221,COGS 118A,A01,083075,Gupta; Anjum,21,16,76,55
1656044524249,CSE 3,A50,083646,Miranda; Gregory Joseph,14,0,50,36
1656044530272,CSE 8A,A50,083650,Miranda; Gregory Joseph,4,11,56,52
1656044536295,CSE 11,A01,083080,Cao; Yingjun,0,64,40,40
1656044542319,CSE 12,A01,083652,Krause-Levy; Sophia Louisa,7,8,120,113
1656044548343,CSE 15L,A01,083654,Morris; Justin Loren,3,1,50,47
1656044548343,CSE 15L,A02,083655,Morris; Justin Loren,2,1,50,48
1656044554369,CSE 20,A01,083657,Tran; Khoa Dang,29,0,80,51
1656044560391,CSE 21,A01,095574,Bach; Quang Tran,23,0,48,25
1656044566415,CSE 30,A01,083084,Eldon; John,2,10,80,78
1656044566415,CSE 30,B01,095061,Bhaskar; Nishant,2,5,50,48
1656044572440,CSE 100,A01,083659,Cao; Yingjun,2,25,70,68
1656044578465,CSE 134B,A01,083661,Powell; Thomas Allan,6,6,100,94
1656044584487,CSE 140,A01,083663,Gungor; Onat,6,0,85,79
1656044590513,CSE 140L,A01,083088,Eldon; John,5,0,100,95
1656044596536,CSE 175,A01,083665,Kumar; Rakesh,0,0,25,25
1656044602562,CSE 190,A00,092507,Dubnov; Shlomo,1,0,20,19
1656044608585,ECE 45,A01,083139,Congero; Spencer William,1,1,75,74
1656044614613,ECE 65,A50,083695,Saad; Andrew S,6,0,30,24
1656044614613,ECE 65,A51,095125,Staff,23,0,26,3
1656044620654,ECE 109,A01,091882,Touri; Behrouz,3,5,70,67
1656044626675,ECE 180,A00,083140,Abi Samra; Nicholas Camill,1,0,30,29
1656044626675,ECE 180,B00,083141,Abi Samra; Nicholas Camill,0,8,28,28
1656044632702,MATH 10A,A01,083735,Patchell; Gregory David,0,0,30,30
1656044632702,MATH 10A,A02,083736,Patchell; Gregory David,20,0,30,10
1656044632702,MATH 10A,A03,083737,Patchell; Gregory David,16,0,30,14
1656044638724,MATH 10B,A01,083207,Lim; Seonhee,1,1,34,33
1656044638724,MATH 10B,A02,083208,Lim; Seonhee,1,1,35,34
1656044638724,MATH 10B,A03,093472,Staff,0,1,34,34
1656044638724,MATH 10B,B01,083739,Sinha; Shubham,10,0,30,20
1656044644753,MATH 18,A01,083743,Cinel; Cameron Alexander,5,0,30,25
1656044644753,MATH 18,A02,083744,Cinel; Cameron Alexander,11,0,30,19
1656044644753,MATH 18,A03,083745,Cinel; Cameron Alexander,1,0,30,29
1656044644753,MATH 18,B01,083748,Ma; Zilu,0,0,36,36
1656044644753,MATH 18,B02,083749,Ma; Zilu,0,0,36,36
1656044644753,MATH 18,B03,083750,Ma; Zilu,0,0,36,36
1656044644753,MATH 18,B04,083751,Ma; Zilu,0,0,36,36
1656044644753,MATH 18,B05,093473,Staff,0,0,36,36
1656044644753,MATH 18,B06,093474,Staff,3,0,36,33
1656044650777,MATH 20A,A01,083754,Zheng; Zequn,11,0,40,29
1656044656801,MATH 20B,A01,083756,Briones; Jor-el Thomas Caparas,0,0,36,36
1656044656801,MATH 20B,A02,083757,Briones; Jor-el Thomas Caparas,0,0,36,36
1656044656801,MATH 20B,A03,093475,Staff,0,0,36,36
1656044662825,MATH 20C,A01,083760,Briones; Jor-el Thomas Caparas,0,2,35,35
1656044662825,MATH 20C,A02,083761,Briones; Jor-el Thomas Caparas,6,1,35,29
1656044662825,MATH 20C,A03,093476,Staff,0,1,35,35
1656044662825,MATH 20C,B01,083762,Bach; Quang Tran,3,0,30,27
1656044668852,MATH 20D,A01,083765,Tran; Brian Kha,2,0,30,28
1656044668852,MATH 20D,A02,083766,Tran; Brian Kha,0,1,30,30
1656044668852,MATH 20D,A03,083767,Tran; Brian Kha,0,0,30,30
1656044674899,MATH 20E,A01,083771,Ganguly; Soumya,0,1,32,32
1656044674899,MATH 20E,A02,083772,Ganguly; Soumya,1,1,32,31
1656044674899,MATH 20E,B01,083773,Ciotti; Benjamin,13,0,35,22
1656044674899,MATH 20E,B02,083774,Ciotti; Benjamin,13,0,35,22
1656044681022,MATH 103A,A01,083777,Greenfeld; Be'Eri,2,1,36,34
1656044681022,MATH 103A,A02,083778,Greenfeld; Be'Eri,1,0,36,35
1656044681022,MATH 103A,A03,093561,Staff,0,1,36,36
1656044681022,MATH 103A,B01,083779,Greenfeld; Be'Eri,8,1,36,28
1656044681022,MATH 103A,B02,083780,Greenfeld; Be'Eri,0,0,36,36
1656044681022,MATH 103A,B03,093562,Staff,0,0,36,36
1656044687048,MATH 105,A01,085443,Carter; Anne Toulson,4,1,35,31
1656044687048,MATH 105,A02,093477,Staff,9,0,35,26
1656044693076,MATH 109,A01,083213,Ganzberger; Geoffrey Michael,0,1,34,34
1656044693076,MATH 109,A02,083214,Ganzberger; Geoffrey Michael,0,0,34,34
1656044693076,MATH 109,A03,093478,Staff,1,0,34,33
1656044693076,MATH 109,B01,083215,Ganzberger; Geoffrey Michael,2,0,32,30
1656044693076,MATH 109,B02,083216,Ganzberger; Geoffrey Michael,0,0,32,32
1656044693076,MATH 109,B03,093479,Staff,3,0,32,29
1656044699106,MATH 142A,A01,083219,Chow; Bennett,1,0,32,31
1656044699106,MATH 142A,A02,083220,Chow; Bennett,7,0,32,25
1656044699106,MATH 142A,A03,093480,Staff,4,0,32,28
1656044699106,MATH 142A,B03,093481,Staff,3,0,32,29
1656044699106,MATH 142A,B04,093558,Staff,5,0,32,27
1656044699106,MATH 142A,B05,093559,Staff,0,0,32,32
1656044705128,MATH 193A,A01,083224,Rotar; Vladimir,1,2,34,33
1656044705128,MATH 193A,A02,083225,Rotar; Vladimir,0,0,34,34
1656044705128,MATH 193A,A03,083781,Rotar; Vladimir,1,0,34,33
1656044705128,MATH 193A,A04,083782,Rotar; Vladimir,3,0,34,31
1656044705128,MATH 193A,A05,093482,Rotar; Vladimir,0,0,34,34
1656044711155,MATH 197,001,091859,McAuley; Julian John,9999,0,9999,0
1656044711155,MATH 197,002,095566,Kedlaya; Kiran S.,9997,0,9999,2
1656044711155,MATH 197,003,095567,Xiao; Ming,9999,0,9999,0
1656044711155,MATH 197,004,095571,Perols; Johan Lars,9998,0,9999,1
1656044718205,COGS 9,A01,083615,Shannon; Kyle Michael,3,1,75,72
1656044724231,COGS 11,A01,083617,Boyle; Mary E. T.,11,2,48,37
1656044730265,COGS 13,A01,083071,Bastos; Amalia Pinkusfeld,4,3,71,67
1656044736288,COGS 14A,A01,092681,Semenuks; Arturs,4,25,100,96
1656044742312,COGS 14B,A01,083073,Cheng; Tzu-Han,7,0,63,56
1656044748342,COGS 17,A01,092677,Semenuks; Arturs,8,7,81,73
1656044754366,COGS 100,A01,083619,Allen; Michael Gordon,3,2,70,67
1656044760389,COGS 101A,A01,083621,Davis; Joshua Daniel,4,3,68,64
1656044766416,COGS 101B,A01,091572,Allen; Michael Gordon,0,0,65,65
1656044772442,COGS 101C,A01,083625,Delgado; Tania,7,0,35,28
1656044778468,COGS 107A,A01,083627,Boyle; Mary E. T.,1,2,60,59
1656044784492,COGS 118A,A01,083075,Gupta; Anjum,21,16,76,55
1656044790524,CSE 3,A50,083646,Miranda; Gregory Joseph,14,0,50,36
1656044796547,CSE 8A,A50,083650,Miranda; Gregory Joseph,4,11,56,52
1656044802573,CSE 11,A01,083080,Cao; Yingjun,0,64,40,40
1656044808598,CSE 12,A01,083652,Krause-Levy; Sophia Louisa,7,8,120,113
1656044814622,CSE 15L,A01,083654,Morris; Justin Loren,3,1,50,47
1656044814622,CSE 15L,A02,083655,Morris; Justin Loren,2,1,50,48
1656044820647,CSE 20,A01,083657,Tran; Khoa Dang,29,0,80,51
1656044826673,CSE 21,A01,095574,Bach; Quang Tran,23,0,48,25
1656044832697,CSE 30,A01,083084,Eldon; John,2,10,80,78
1656044832697,CSE 30,B01,095061,Bhaskar; Nishant,2,5,50,48
1656044838722,CSE 100,A01,083659,Cao; Yingjun,2,25,70,68
1656044844747,CSE 134B,A01,083661,Powell; Thomas Allan,6,6,100,94
1656044850771,CSE 140,A01,083663,Gungor; Onat,6,0,85,79
1656044856794,CSE 140L,A01,083088,Eldon; John,5,0,100,95
1656044862817,CSE 175,A01,083665,Kumar; Rakesh,0,0,25,25
1656044868841,CSE 190,A00,092507,Dubnov; Shlomo,1,0,20,19
1656044874872,ECE 45,A01,083139,Congero; Spencer William,1,1,75,74
1656044880899,ECE 65,A50,083695,Saad; Andrew S,6,0,30,24
1656044880899,ECE 65,A51,095125,Staff,23,0,26,3
1656044886926,ECE 109,A01,091882,Touri; Behrouz,3,5,70,67
1656044892950,ECE 180,A00,083140,Abi Samra; Nicholas Camill,1,0,30,29
1656044892950,ECE 180,B00,083141,Abi Samra; Nicholas Camill,0,8,28,28
1656044898977,MATH 10A,A01,083735,Patchell; Gregory David,0,0,30,30
1656044898977,MATH 10A,A02,083736,Patchell; Gregory David,20,0,30,10
1656044898977,MATH 10A,A03,083737,Patchell; Gregory David,16,0,30,14
1656044905000,MATH 10B,A01,083207,Lim; Seonhee,1,1,34,33
1656044905000,MATH 10B,A02,083208,Lim; Seonhee,1,1,35,34
1656044905000,MATH 10B,A03,093472,Staff,0,1,34,34
1656044905000,MATH 10B,B01,083739,Sinha; Shubham,10,0,30,20
1656044911040,MATH 18,A01,083743,Cinel; Cameron Alexander,5,0,30,25
1656044911040,MATH 18,A02,083744,Cinel; Cameron Alexander,11,0,30,19
1656044911040,MATH 18,A03,083745,Cinel; Cameron Alexander,1,0,30,29
1656044911040,MATH 18,B01,083748,Ma; Zilu,0,0,36,36
1656044911040,MATH 18,B02,083749,Ma; Zilu,0,0,36,36
1656044911040,MATH 18,B03,083750,Ma; Zilu,0,0,36,36
1656044911040,MATH 18,B04,083751,Ma; Zilu,0,0,36,36
1656044911040,MATH 18,B05,093473,Staff,0,0,36,36
1656044911040,MATH 18,B06,093474,Staff,3,0,36,33
1656044917072,MATH 20A,A01,083754,Zheng; Zequn,11,0,40,29
1656044923099,MATH 20B,A01,083756,Briones; Jor-el Thomas Caparas,0,0,36,36
1656044923099,MATH 20B,A02,083757,Briones; Jor-el Thomas Caparas,0,0,36,36
1656044923099,MATH 20B,A03,093475,Staff,0,0,36,36
1656044929127,MATH 20C,A01,083760,Briones; Jor-el Thomas Caparas,0,2,35,35
1656044929127,MATH 20C,A02,083761,Briones; Jor-el Thomas Caparas,6,1,35,29
1656044929127,MATH 20C,A03,093476,Staff,0,1,35,35
1656044929127,MATH 20C,B01,083762,Bach; Quang Tran,3,0,30,27
1656044935151,MATH 20D,A01,083765,Tran; Brian Kha,2,0,30,28
1656044935151,MATH 20D,A02,083766,Tran; Brian Kha,0,1,30,30
1656044935151,MATH 20D,A03,083767,Tran; Brian Kha,0,0,30,30
1656044941174,MATH 20E,A01,083771,Ganguly; Soumya,0,1,32,32
1656044941174,MATH 20E,A02,083772,Ganguly; Soumya,1,1,32,31
1656044941174,MATH 20E,B01,083773,Ciotti; Benjamin,13,0,35,22
1656044941174,MATH 20E,B02,083774,Ciotti; Benjamin,13,0,35,22
1656044947202,MATH 103A,A01,083777,Greenfeld; Be'Eri,2,1,36,34
1656044947202,MATH 103A,A02,083778,Greenfeld; Be'Eri,1,0,36,35
1656044947202,MATH 103A,A03,093561,Staff,0,1,36,36
1656044947202,MATH 103A,B01,083779,Greenfeld; Be'Eri,8,1,36,28
1656044947202,MATH 103A,B02,083780,Greenfeld; Be'Eri,0,0,36,36
1656044947202,MATH 103A,B03,093562,Staff,0,0,36,36
1656044953224,MATH 105,A01,085443,Carter; Anne Toulson,4,1,35,31
1656044953224,MATH 105,A02,093477,Staff,9,0,35,26
1656044959252,MATH 109,A01,083213,Ganzberger; Geoffrey Michael,0,1,34,34
1656044959252,MATH 109,A02,083214,Ganzberger; Geoffrey Michael,0,0,34,34
1656044959252,MATH 109,A03,093478,Staff,1,0,34,33
1656044959252,MATH 109,B01,083215,Ganzberger; Geoffrey Michael,2,0,32,30
1656044959252,MATH 109,B02,083216,Ganzberger; Geoffrey Michael,0,0,32,32
1656044959252,MATH 109,B03,093479,Staff,3,0,32,29
1656044965281,MATH 142A,A01,083219,Chow; Bennett,1,0,32,31
1656044965281,MATH 142A,A02,083220,Chow; Bennett,7,0,32,25
1656044965281,MATH 142A,A03,093480,Staff,4,0,32,28
1656044965281,MATH 142A,B03,093481,Staff,3,0,32,29
1656044965281,MATH 142A,B04,093558,Staff,5,0,32,27
1656044965281,MATH 142A,B05,093559,Staff,0,0,32,32
1656044971303,MATH 193A,A01,083224,Rotar; Vladimir,1,2,34,33
1656044971303,MATH 193A,A02,083225,Rotar; Vladimir,0,0,34,34
1656044971303,MATH 193A,A03,083781,Rotar; Vladimir,1,0,34,33
1656044971303,MATH 193A,A04,083782,Rotar; Vladimir,3,0,34,31
1656044971303,MATH 193A,A05,093482,Rotar; Vladimir,0,0,34,34
1656044977324,MATH 197,001,091859,McAuley; Julian John,9999,0,9999,0
1656044977324,MATH 197,002,095566,Kedlaya; Kiran S.,9997,0,9999,2
1656044977324,MATH 197,003,095567,Xiao; Ming,9999,0,9999,0
1656044977324,MATH 197,004,095571,Perols; Johan Lars,9998,0,9999,1
1656044984378,COGS 9,A01,083615,Shannon; Kyle Michael,3,1,75,72
1656044990402,COGS 11,A01,083617,Boyle; Mary E. T.,11,2,48,37
1656044996426,COGS 13,A01,083071,Bastos; Amalia Pinkusfeld,4,3,71,67
1656045002449,COGS 14A,A01,092681,Semenuks; Arturs,4,25,100,96
1656045008473,COGS 14B,A01,083073,Cheng; Tzu-Han,7,0,63,56
1656045014496,COGS 17,A01,092677,Semenuks; Arturs,8,7,81,73
1656045020520,COGS 100,A01,083619,Allen; Michael Gordon,3,2,70,67
1656045026550,COGS 101A,A01,083621,Davis; Joshua Daniel,4,3,68,64
1656045032577,COGS 101B,A01,091572,Allen; Michael Gordon,0,0,65,65
1656045038604,COGS 101C,A01,083625,Delgado; Tania,7,0,35,28
1656045044635,COGS 107A,A01,083627,Boyle; Mary E. T.,1,2,60,59
1656045050663,COGS 118A,A01,083075,Gupta; Anjum,21,16,76,55
1656045056693,CSE 3,A50,083646,Miranda; Gregory Joseph,14,0,50,36
1656045062729,CSE 8A,A50,083650,Miranda; Gregory Joseph,4,11,56,52
1656045068757,CSE 11,A01,083080,Cao; Yingjun,0,64,40,40
1656045074781,CSE 12,A01,083652,Krause-Levy; Sophia Louisa,7,8,120,113
1656045080806,CSE 15L,A01,083654,Morris; Justin Loren,3,1,50,47
1656045080806,CSE 15L,A02,083655,Morris; Justin Loren,2,1,50,48
1656045086829,CSE 20,A01,083657,Tran; Khoa Dang,29,0,80,51
1656045092857,CSE 21,A01,095574,Bach; Quang Tran,23,0,48,25
1656045098881,CSE 30,A01,083084,Eldon; John,2,10,80,78
1656045098881,CSE 30,B01,095061,Bhaskar; Nishant,2,5,50,48
1656045104905,CSE 100,A01,083659,Cao; Yingjun,2,25,70,68
1656045110932,CSE 134B,A01,083661,Powell; Thomas Allan,6,6,100,94
1656045116956,CSE 140,A01,083663,Gungor; Onat,6,0,85,79
1656045122983,CSE 140L,A01,083088,Eldon; John,5,0,100,95
1656045129006,CSE 175,A01,083665,Kumar; Rakesh,0,0,25,25
1656045135030,CSE 190,A00,092507,Dubnov; Shlomo,1,0,20,19
1656045141054,ECE 45,A01,083139,Congero; Spencer William,1,1,75,74
1656045147078,ECE 65,A50,083695,Saad; Andrew S,6,0,30,24
1656045147078,ECE 65,A51,095125,Staff,23,0,26,3
1656045153102,ECE 109,A01,091882,Touri; Behrouz,3,5,70,67
1656045159126,ECE 180,A00,083140,Abi Samra; Nicholas Camill,1,0,30,29
1656045159126,ECE 180,B00,083141,Abi Samra; Nicholas Camill,0,8,28,28
1656045165149,MATH 10A,A01,083735,Patchell; Gregory David,0,0,30,30
1656045165149,MATH 10A,A02,083736,Patchell; Gregory David,20,0,30,10
1656045165149,MATH 10A,A03,083737,Patchell; Gregory David,16,0,30,14
1656045171178,MATH 10B,A01,083207,Lim; Seonhee,1,1,34,33
1656045171178,MATH 10B,A02,083208,Lim; Seonhee,1,1,35,34
1656045171178,MATH 10B,A03,093472,Staff,0,1,34,34
1656045171178,MATH 10B,B01,083739,Sinha; Shubham,10,0,30,20
1656045177204,MATH 18,A01,083743,Cinel; Cameron Alexander,5,0,30,25
1656045177204,MATH 18,A02,083744,Cinel; Cameron Alexander,11,0,30,19
1656045177204,MATH 18,A03,083745,Cinel; Cameron Alexander,1,0,30,29
1656045177204,MATH 18,B01,083748,Ma; Zilu,0,0,36,36
1656045177204,MATH 18,B02,083749,Ma; Zilu,0,0,36,36
1656045177204,MATH 18,B03,083750,Ma; Zilu,0,0,36,36
1656045177204,MATH 18,B04,083751,Ma; Zilu,0,0,36,36
1656045177204,MATH 18,B05,093473,Staff,0,0,36,36
1656045177204,MATH 18,B06,093474,Staff,3,0,36,33
1656045183231,MATH 20A,A01,083754,Zheng; Zequn,11,0,40,29
1656045189257,MATH 20B,A01,083756,Briones; Jor-el Thomas Caparas,0,0,36,36
1656045189257,MATH 20B,A02,083757,Briones; Jor-el Thomas Caparas,0,0,36,36
1656045189257,MATH 20B,A03,093475,Staff,0,0,36,36
1656045195282,MATH 20C,A01,083760,Briones; Jor-el Thomas Caparas,0,2,35,35
1656045195282,MATH 20C,A02,083761,Briones; Jor-el Thomas Caparas,6,1,35,29
1656045195282,MATH 20C,A03,093476,Staff,0,1,35,35
1656045195282,MATH 20C,B01,083762,Bach; Quang Tran,3,0,30,27
1656045201309,MATH 20D,A01,083765,Tran; Brian Kha,2,0,30,28
1656045201309,MATH 20D,A02,083766,Tran; Brian Kha,0,1,30,30
1656045201309,MATH 20D,A03,083767,Tran; Brian Kha,0,0,30,30
1656045207333,MATH 20E,A01,083771,Ganguly; Soumya,0,1,32,32
1656045207333,MATH 20E,A02,083772,Ganguly; Soumya,1,1,32,31
1656045207333,MATH 20E,B01,083773,Ciotti; Benjamin,13,0,35,22
1656045207333,MATH 20E,B02,083774,Ciotti; Benjamin,13,0,35,22
1656045213363,MATH 103A,A01,083777,Greenfeld; Be'Eri,2,1,36,34
1656045213363,MATH 103A,A02,083778,Greenfeld; Be'Eri,1,0,36,35
1656045213363,MATH 103A,A03,093561,Staff,0,1,36,36
1656045213363,MATH 103A,B01,083779,Greenfeld; Be'Eri,8,1,36,28
1656045213363,MATH 103A,B02,083780,Greenfeld; Be'Eri,0,0,36,36
1656045213363,MATH 103A,B03,093562,Staff,0,0,36,36
1656045219396,MATH 105,A01,085443,Carter; Anne Toulson,4,1,35,31
1656045219396,MATH 105,A02,093477,Staff,9,0,35,26
1656045225419,MATH 109,A01,083213,Ganzberger; Geoffrey Michael,0,1,34,34
1656045225419,MATH 109,A02,083214,Ganzberger; Geoffrey Michael,0,0,34,34
1656045225419,MATH 109,A03,093478,Staff,1,0,34,33
1656045225419,MATH 109,B01,083215,Ganzberger; Geoffrey Michael,2,0,32,30
1656045225419,MATH 109,B02,083216,Ganzberger; Geoffrey Michael,0,0,32,32
1656045225419,MATH 109,B03,093479,Staff,3,0,32,29
1656045231448,MATH 142A,A01,083219,Chow; Bennett,1,0,32,31
1656045231448,MATH 142A,A02,083220,Chow; Bennett,7,0,32,25
1656045231448,MATH 142A,A03,093480,Staff,4,0,32,28
1656045231448,MATH 142A,B03,093481,Staff,3,0,32,29
1656045231448,MATH 142A,B04,093558,Staff,5,0,32,27
1656045231448,MATH 142A,B05,093559,Staff,0,0,32,32
1656045237474,MATH 193A,A01,083224,Rotar; Vladimir,1,2,34,33
1656045237474,MATH 193A,A02,083225,Rotar; Vladimir,0,0,34,34
1656045237474,MATH 193A,A03,083781,Rotar; Vladimir,1,0,34,33
1656045237474,MATH 193A,A04,083782,Rotar; Vladimir,3,0,34,31
1656045237474,MATH 193A,A05,093482,Rotar; Vladimir,0,0,34,34
1656045243501,MATH 197,001,091859,McAuley; Julian John,9999,0,9999,0
1656045243501,MATH 197,002,095566,Kedlaya; Kiran S.,9997,0,9999,2
1656045243501,MATH 197,003,095567,Xiao; Ming,9999,0,9999,0
1656045243501,MATH 197,004,095571,Perols; Johan Lars,9998,0,9999,1
1656045250560,COGS 9,A01,083615,Shannon; Kyle Michael,3,1,75,72
1656045256586,COGS 11,A01,083617,Boyle; Mary E. T.,11,2,48,37
1656045262610,COGS 13,A01,083071,Bastos; Amalia Pinkusfeld,4,3,71,67
1656045268632,COGS 14A,A01,092681,Semenuks; Arturs,4,25,100,96
1656045274732,COGS 14B,A01,083073,Cheng; Tzu-Han,7,0,63,56
1656045280768,COGS 17,A01,092677,Semenuks; Arturs,8,7,81,73
1656045286796,COGS 100,A01,083619,Allen; Michael Gordon,3,2,70,67
1656045292822,COGS 101A,A01,083621,Davis; Joshua Daniel,4,3,68,64
1656045298848,COGS 101B,A01,091572,Allen; Michael Gordon,0,0,65,65
1656045304873,COGS 101C,A01,083625,Delgado; Tania,7,0,35,28
1656045310900,COGS 107A,A01,083627,Boyle; Mary E. T.,1,2,60,59
1656045316929,COGS 118A,A01,083075,Gupta; Anjum,21,16,76,55
1656045322955,CSE 3,A50,083646,Miranda; Gregory Joseph,14,0,50,36
1656045328978,CSE 8A,A50,083650,Miranda; Gregory Joseph,4,11,56,52
1656045335001,CSE 11,A01,083080,Cao; Yingjun,0,64,40,40
1656045341031,CSE 12,A01,083652,Krause-Levy; Sophia Louisa,7,8,120,113
1656045347054,CSE 15L,A01,083654,Morris; Justin Loren,3,1,50,47
1656045347054,CSE 15L,A02,083655,Morris; Justin Loren,2,1,50,48
1656045353077,CSE 20,A01,083657,Tran; Khoa Dang,29,0,80,51
1656045359100,CSE 21,A01,095574,Bach; Quang Tran,23,0,48,25
1656045365128,CSE 30,A01,083084,Eldon; John,2,10,80,78
1656045365128,CSE 30,B01,095061,Bhaskar; Nishant,2,5,50,48
1656045371155,CSE 100,A01,083659,Cao; Yingjun,2,25,70,68
1656045377186,CSE 134B,A01,083661,Powell; Thomas Allan,6,6,100,94
1656045383213,CSE 140,A01,083663,Gungor; Onat,6,0,85,79
1656045389237,CSE 140L,A01,083088,Eldon; John,5,0,100,95
1656045395277,CSE 175,A01,083665,Kumar; Rakesh,0,0,25,25
1656045401300,CSE 190,A00,092507,Dubnov; Shlomo,1,0,20,19
1656045407324,ECE 45,A01,083139,Congero; Spencer William,1,1,75,74
1656045413351,ECE 65,A50,083695,Saad; Andrew S,6,0,30,24
1656045413351,ECE 65,A51,095125,Staff,23,0,26,3
1656045419373,ECE 109,A01,091882,Touri; Behrouz,3,5,70,67
1656045425395,ECE 180,A00,083140,Abi Samra; Nicholas Camill,1,0,30,29
1656045425395,ECE 180,B00,083141,Abi Samra; Nicholas Camill,0,8,28,28
1656045431419,MATH 10A,A01,083735,Patchell; Gregory David,0,0,30,30
1656045431419,MATH 10A,A02,083736,Patchell; Gregory David,20,0,30,10
1656045431419,MATH 10A,A03,083737,Patchell; Gregory David,16,0,30,14
1656045437449,MATH 10B,A01,083207,Lim; Seonhee,1,1,34,33
1656045437449,MATH 10B,A02,083208,Lim; Seonhee,1,1,35,34
1656045437449,MATH 10B,A03,093472,Staff,0,1,34,34
1656045437449,MATH 10B,B01,083739,Sinha; Shubham,10,0,30,20
1656045443474,MATH 18,A01,083743,Cinel; Cameron Alexander,5,0,30,25
1656045443474,MATH 18,A02,083744,Cinel; Cameron Alexander,11,0,30,19
1656045443474,MATH 18,A03,083745,Cinel; Cameron Alexander,1,0,30,29
1656045443474,MATH 18,B01,083748,Ma; Zilu,0,0,36,36
1656045443474,MATH 18,B02,083749,Ma; Zilu,0,0,36,36
1656045443474,MATH 18,B03,083750,Ma; Zilu,0,0,36,36
1656045443474,MATH 18,B04,083751,Ma; Zilu,0,0,36,36
1656045443474,MATH 18,B05,093473,Staff,0,0,36,36
1656045443474,MATH 18,B06,093474,Staff,3,0,36,33
1656045449499,MATH 20A,A01,083754,Zheng; Zequn,11,0,40,29
1656045455524,MATH 20B,A01,083756,Briones; Jor-el Thomas Caparas,0,0,36,36
1656045455524,MATH 20B,A02,083757,Briones; Jor-el Thomas Caparas,0,0,36,36
1656045455524,MATH 20B,A03,093475,Staff,0,0,36,36
1656045461553,MATH 20C,A01,083760,Briones; Jor-el Thomas Caparas,0,2,35,35
1656045461553,MATH 20C,A02,083761,Briones; Jor-el Thomas Caparas,6,1,35,29
1656045461553,MATH 20C,A03,093476,Staff,0,1,35,35
1656045461553,MATH 20C,B01,083762,Bach; Quang Tran,3,0,30,27
1656045467576,MATH 20D,A01,083765,Tran; Brian Kha,2,0,30,28
1656045467576,MATH 20D,A02,083766,Tran; Brian Kha,0,1,30,30
1656045467576,MATH 20D,A03,083767,Tran; Brian Kha,0,0,30,30
1656045473600,MATH 20E,A01,083771,Ganguly; Soumya,0,1,32,32
1656045473600,MATH 20E,A02,083772,Ganguly; Soumya,1,1,32,31
1656045473600,MATH 20E,B01,083773,Ciotti; Benjamin,13,0,35,22
1656045473600,MATH 20E,B02,083774,Ciotti; Benjamin,13,0,35,22
1656045479634,MATH 103A,A01,083777,Greenfeld; Be'Eri,2,1,36,34
1656045479634,MATH 103A,A02,083778,Greenfeld; Be'Eri,1,0,36,35
1656045479634,MATH 103A,A03,093561,Staff,0,1,36,36
1656045479634,MATH 103A,B01,083779,Greenfeld; Be'Eri,8,1,36,28
1656045479634,MATH 103A,B02,083780,Greenfeld; Be'Eri,0,0,36,36
1656045479634,MATH 103A,B03,093562,Staff,0,0,36,36
1656045485658,MATH 105,A01,085443,Carter; Anne Toulson,4,1,35,31
1656045485658,MATH 105,A02,093477,Staff,9,0,35,26
1656045491685,MATH 109,A01,083213,Ganzberger; Geoffrey Michael,0,1,34,34
1656045491685,MATH 109,A02,083214,Ganzberger; Geoffrey Michael,0,0,34,34
1656045491685,MATH 109,A03,093478,Staff,1,0,34,33
1656045491685,MATH 109,B01,083215,Ganzberger; Geoffrey Michael,2,0,32,30
1656045491685,MATH 109,B02,083216,Ganzberger; Geoffrey Michael,0,0,32,32
1656045491685,MATH 109,B03,093479,Staff,3,0,32,29
1656045497717,MATH 142A,A01,083219,Chow; Bennett,1,0,32,31
1656045497717,MATH 142A,A02,083220,Chow; Bennett,7,0,32,25
1656045497717,MATH 142A,A03,093480,Staff,4,0,32,28
1656045497717,MATH 142A,B03,093481,Staff,3,0,32,29
1656045497717,MATH 142A,B04,093558,Staff,5,0,32,27
1656045497717,MATH 142A,B05,093559,Staff,0,0,32,32
1656045503748,MATH 193A,A01,083224,Rotar; Vladimir,1,2,34,33
1656045503748,MATH 193A,A02,083225,Rotar; Vladimir,0,0,34,34
1656045503748,MATH 193A,A03,083781,Rotar; Vladimir,1,0,34,33
1656045503748,MATH 193A,A04,083782,Rotar; Vladimir,3,0,34,31
1656045503748,MATH 193A,A05,093482,Rotar; Vladimir,0,0,34,34
1656045509772,MATH 197,001,091859,McAuley; Julian John,9999,0,9999,0
1656045509772,MATH 197,002,095566,Kedlaya; Kiran S.,9997,0,9999,2
1656045509772,MATH 197,003,095567,Xiao; Ming,9999,0,9999,0
1656045509772,MATH 197,004,095571,Perols; Johan Lars,9998,0,9999,1
1656045516838,COGS 9,A01,083615,Shannon; Kyle Michael,3,1,75,72
1656045522862,COGS 11,A01,083617,Boyle; Mary E. T.,11,2,48,37
1656045528886,COGS 13,A01,083071,Bastos; Amalia Pinkusfeld,4,3,71,67
1656045534913,COGS 14A,A01,092681,Semenuks; Arturs,4,25,100,96
1656045540940,COGS 14B,A01,083073,Cheng; Tzu-Han,7,0,63,56
1656045546962,COGS 17,A01,092677,Semenuks; Arturs,8,7,81,73
1656045552989,COGS 100,A01,083619,Allen; Michael Gordon,3,2,70,67
1656045559016,COGS 101A,A01,083621,Davis; Joshua Daniel,4,3,68,64
1656045565040,COGS 101B,A01,091572,Allen; Michael Gordon,0,0,65,65
1656045571066,COGS 101C,A01,083625,Delgado; Tania,7,0,35,28
1656045577089,COGS 107A,A01,083627,Boyle; Mary E. T.,1,2,60,59
1656045583119,COGS 118A,A01,083075,Gupta; Anjum,21,16,76,55
1656045589147,CSE 3,A50,083646,Miranda; Gregory Joseph,14,0,50,36
1656045595185,CSE 8A,A50,083650,Miranda; Gregory Joseph,4,11,56,52
1656045601213,CSE 11,A01,083080,Cao; Yingjun,0,64,40,40
1656045607247,CSE 12,A01,083652,Krause-Levy; Sophia Louisa,7,8,120,113
1656045613274,CSE 15L,A01,083654,Morris; Justin Loren,3,1,50,47
1656045613274,CSE 15L,A02,083655,Morris; Justin Loren,2,1,50,48
1656045619301,CSE 20,A01,083657,Tran; Khoa Dang,29,0,80,51
1656045625325,CSE 21,A01,095574,Bach; Quang Tran,23,0,48,25
1656045631350,CSE 30,A01,083084,Eldon; John,2,10,80,78
1656045631350,CSE 30,B01,095061,Bhaskar; Nishant,2,5,50,48
1656045637372,CSE 100,A01,083659,Cao; Yingjun,2,25,70,68
1656045643397,CSE 134B,A01,083661,Powell; Thomas Allan,6,6,100,94
1656045649428,CSE 140,A01,083663,Gungor; Onat,6,0,85,79
1656045655449,CSE 140L,A01,083088,Eldon; John,5,0,100,95
1656045661476,CSE 175,A01,083665,Kumar; Rakesh,0,0,25,25
1656045667499,CSE 190,A00,092507,Dubnov; Shlomo,1,0,20,19
1656045673523,ECE 45,A01,083139,Congero; Spencer William,1,1,75,74
1656045679545,ECE 65,A50,083695,Saad; Andrew S,6,0,30,24
1656045679545,ECE 65,A51,095125,Staff,23,0,26,3
1656045685573,ECE 109,A01,091882,Touri; Behrouz,3,5,70,67
1656045691599,ECE 180,A00,083140,Abi Samra; Nicholas Camill,1,0,30,29
1656045691599,ECE 180,B00,083141,Abi Samra; Nicholas Camill,0,8,28,28
1656045697621,MATH 10A,A01,083735,Patchell; Gregory David,0,0,30,30
1656045697621,MATH 10A,A02,083736,Patchell; Gregory David,20,0,30,10
1656045697621,MATH 10A,A03,083737,Patchell; Gregory David,16,0,30,14
1656045703653,MATH 10B,A01,083207,Lim; Seonhee,1,1,34,33
1656045703653,MATH 10B,A02,083208,Lim; Seonhee,1,1,35,34
1656045703653,MATH 10B,A03,093472,Staff,0,1,34,34
1656045703653,MATH 10B,B01,083739,Sinha; Shubham,10,0,30,20
1656045709677,MATH 18,A01,083743,Cinel; Cameron Alexander,5,0,30,25
1656045709677,MATH 18,A02,083744,Cinel; Cameron Alexander,11,0,30,19
1656045709677,MATH 18,A03,083745,Cinel; Cameron Alexander,1,0,30,29
1656045709677,MATH 18,B01,083748,Ma; Zilu,0,0,36,36
1656045709677,MATH 18,B02,083749,Ma; Zilu,0,0,36,36
1656045709677,MATH 18,B03,083750,Ma; Zilu,0,0,36,36
1656045709677,MATH 18,B04,083751,Ma; Zilu,0,0,36,36
1656045709677,MATH 18,B05,093473,Staff,0,0,36,36
1656045709677,MATH 18,B06,093474,Staff,3,0,36,33
1656045715702,MATH 20A,A01,083754,Zheng; Zequn,11,0,40,29
1656045721734,MATH 20B,A01,083756,Briones; Jor-el Thomas Caparas,0,0,36,36
1656045721734,MATH 20B,A02,083757,Briones; Jor-el Thomas Caparas,0,0,36,36
1656045721734,MATH 20B,A03,093475,Staff,0,0,36,36
1656045727757,MATH 20C,A01,083760,Briones; Jor-el Thomas Caparas,0,2,35,35
1656045727757,MATH 20C,A02,083761,Briones; Jor-el Thomas Caparas,6,1,35,29
1656045727757,MATH 20C,A03,093476,Staff,0,1,35,35
1656045727757,MATH 20C,B01,083762,Bach; Quang Tran,3,0,30,27
1656045733785,MATH 20D,A01,083765,Tran; Brian Kha,2,0,30,28
1656045733785,MATH 20D,A02,083766,Tran; Brian Kha,0,1,30,30
1656045733785,MATH 20D,A03,083767,Tran; Brian Kha,0,0,30,30
1656045739814,MATH 20E,A01,083771,Ganguly; Soumya,0,1,32,32
1656045739814,MATH 20E,A02,083772,Ganguly; Soumya,1,1,32,31
1656045739814,MATH 20E,B01,083773,Ciotti; Benjamin,13,0,35,22
1656045739814,MATH 20E,B02,083774,Ciotti; Benjamin,13,0,35,22
1656045745838,MATH 103A,A01,083777,Greenfeld; Be'Eri,2,1,36,34
1656045745838,MATH 103A,A02,083778,Greenfeld; Be'Eri,2,0,36,34
1656045745838,MATH 103A,A03,093561,Staff,0,1,36,36
1656045745838,MATH 103A,B01,083779,Greenfeld; Be'Eri,8,1,36,28
1656045745838,MATH 103A,B02,083780,Greenfeld; Be'Eri,0,0,36,36
1656045745838,MATH 103A,B03,093562,Staff,0,0,36,36
1656045751863,MATH 105,A01,085443,Carter; Anne Toulson,4,1,35,31
1656045751863,MATH 105,A02,093477,Staff,9,0,35,26
1656045757887,MATH 109,A01,083213,Ganzberger; Geoffrey Michael,0,1,34,34
1656045757887,MATH 109,A02,083214,Ganzberger; Geoffrey Michael,0,0,34,34
1656045757887,MATH 109,A03,093478,Staff,1,0,34,33
1656045757887,MATH 109,B01,083215,Ganzberger; Geoffrey Michael,2,0,32,30
1656045757887,MATH 109,B02,083216,Ganzberger; Geoffrey Michael,0,0,32,32
1656045757887,MATH 109,B03,093479,Staff,3,0,32,29
1656045763913,MATH 142A,A01,083219,Chow; Bennett,1,0,32,31
1656045763913,MATH 142A,A02,083220,Chow; Bennett,7,0,32,25
1656045763913,MATH 142A,A03,093480,Staff,4,0,32,28
1656045763913,MATH 142A,B03,093481,Staff,3,0,32,29
1656045763913,MATH 142A,B04,093558,Staff,5,0,32,27
1656045763913,MATH 142A,B05,093559,Staff,0,0,32,32
1656045769938,MATH 193A,A01,083224,Rotar; Vladimir,1,2,34,33
1656045769938,MATH 193A,A02,083225,Rotar; Vladimir,0,0,34,34
1656045769938,MATH 193A,A03,083781,Rotar; Vladimir,1,0,34,33
1656045769938,MATH 193A,A04,083782,Rotar; Vladimir,3,0,34,31
1656045769938,MATH 193A,A05,093482,Rotar; Vladimir,0,0,34,34
1656045775964,MATH 197,001,091859,McAuley; Julian John,9999,0,9999,0
1656045775964,MATH 197,002,095566,Kedlaya; Kiran S.,9997,0,9999,2
1656045775964,MATH 197,003,095567,Xiao; Ming,9999,0,9999,0
1656045775964,MATH 197,004,095571,Perols; Johan Lars,9998,0,9999,1
1656045783025,COGS 9,A01,083615,Shannon; Kyle Michael,3,1,75,72
1656045789057,COGS 11,A01,083617,Boyle; Mary E. T.,11,2,48,37
1656045795083,COGS 13,A01,083071,Bastos; Amalia Pinkusfeld,4,3,71,67
1656045801110,COGS 14A,A01,092681,Semenuks; Arturs,4,25,100,96
1656045807133,COGS 14B,A01,083073,Cheng; Tzu-Han,7,0,63,56
1656045813155,COGS 17,A01,092677,Semenuks; Arturs,8,7,81,73
1656045819179,COGS 100,A01,083619,Allen; Michael Gordon,3,2,70,67
1656045825201,COGS 101A,A01,083621,Davis; Joshua Daniel,4,3,68,64
1656045831233,COGS 101B,A01,091572,Allen; Michael Gordon,0,0,65,65
1656045837255,COGS 101C,A01,083625,Delgado; Tania,7,0,35,28
1656045843279,COGS 107A,A01,083627,Boyle; Mary E. T.,1,2,60,59
1656045849320,COGS 118A,A01,083075,Gupta; Anjum,21,16,76,55
1656045855342,CSE 3,A50,083646,Miranda; Gregory Joseph,14,0,50,36
1656045861366,CSE 8A,A50,083650,Miranda; Gregory Joseph,4,11,56,52
1656045867390,CSE 11,A01,083080,Cao; Yingjun,0,64,40,40
1656045873509,CSE 12,A01,083652,Krause-Levy; Sophia Louisa,7,8,120,113
1656045879538,CSE 15L,A01,083654,Morris; Justin Loren,3,1,50,47
1656045879538,CSE 15L,A02,083655,Morris; Justin Loren,2,1,50,48
1656045885565,CSE 20,A01,083657,Tran; Khoa Dang,29,0,80,51
1656045891589,CSE 21,A01,095574,Bach; Quang Tran,23,0,48,25
1656045897625,CSE 30,A01,083084,Eldon; John,2,10,80,78
1656045897625,CSE 30,B01,095061,Bhaskar; Nishant,2,5,50,48
1656045903663,CSE 100,A01,083659,Cao; Yingjun,2,25,70,68
1656045909690,CSE 134B,A01,083661,Powell; Thomas Allan,6,6,100,94
1656045915713,CSE 140,A01,083663,Gungor; Onat,6,0,85,79
1656045921739,CSE 140L,A01,083088,Eldon; John,5,0,100,95
1656045927763,CSE 175,A01,083665,Kumar; Rakesh,0,0,25,25
1656045933790,CSE 190,A00,092507,Dubnov; Shlomo,1,0,20,19
1656045939816,ECE 45,A01,083139,Congero; Spencer William,1,1,75,74
1656045945843,ECE 65,A50,083695,Saad; Andrew S,6,0,30,24
1656045945843,ECE 65,A51,095125,Staff,23,0,26,3
1656045951868,ECE 109,A01,091882,Touri; Behrouz,3,5,70,67
1656045957892,ECE 180,A00,083140,Abi Samra; Nicholas Camill,1,0,30,29
1656045957892,ECE 180,B00,083141,Abi Samra; Nicholas Camill,0,8,28,28
1656045963919,MATH 10A,A01,083735,Patchell; Gregory David,0,0,30,30
1656045963919,MATH 10A,A02,083736,Patchell; Gregory David,20,0,30,10
1656045963919,MATH 10A,A03,083737,Patchell; Gregory David,16,0,30,14
1656045969945,MATH 10B,A01,083207,Lim; Seonhee,1,1,34,33
1656045969945,MATH 10B,A02,083208,Lim; Seonhee,1,1,35,34
1656045969945,MATH 10B,A03,093472,Staff,0,1,34,34
1656045969945,MATH 10B,B01,083739,Sinha; Shubham,10,0,30,20
1656045975974,MATH 18,A01,083743,Cinel; Cameron Alexander,5,0,30,25
1656045975974,MATH 18,A02,083744,Cinel; Cameron Alexander,11,0,30,19
1656045975974,MATH 18,A03,083745,Cinel; Cameron Alexander,1,0,30,29
1656045975974,MATH 18,B01,083748,Ma; Zilu,0,0,36,36
1656045975974,MATH 18,B02,083749,Ma; Zilu,0,0,36,36
1656045975974,MATH 18,B03,083750,Ma; Zilu,0,0,36,36
1656045975974,MATH 18,B04,083751,Ma; Zilu,0,0,36,36
1656045975974,MATH 18,B05,093473,Staff,0,0,36,36
1656045975974,MATH 18,B06,093474,Staff,3,0,36,33
1656045982000,MATH 20A,A01,083754,Zheng; Zequn,11,0,40,29
1656045988025,MATH 20B,A01,083756,Briones; Jor-el Thomas Caparas,0,0,36,36
1656045988025,MATH 20B,A02,083757,Briones; Jor-el Thomas Caparas,0,0,36,36
1656045988025,MATH 20B,A03,093475,Staff,0,0,36,36
1656045994052,MATH 20C,A01,083760,Briones; Jor-el Thomas Caparas,0,2,35,35
1656045994052,MATH 20C,A02,083761,Briones; Jor-el Thomas Caparas,6,1,35,29
1656045994052,MATH 20C,A03,093476,Staff,0,1,35,35
1656045994052,MATH 20C,B01,083762,Bach; Quang Tran,3,0,30,27
1656046000079,MATH 20D,A01,083765,Tran; Brian Kha,2,0,30,28
1656046000079,MATH 20D,A02,083766,Tran; Brian Kha,0,1,30,30
1656046000079,MATH 20D,A03,083767,Tran; Brian Kha,0,0,30,30
1656046006102,MATH 20E,A01,083771,Ganguly; Soumya,0,1,32,32
1656046006102,MATH 20E,A02,083772,Ganguly; Soumya,1,1,32,31
1656046006102,MATH 20E,B01,083773,Ciotti; Benjamin,13,0,35,22
1656046006102,MATH 20E,B02,083774,Ciotti; Benjamin,13,0,35,22
1656046012131,MATH 103A,A01,083777,Greenfeld; Be'Eri,2,1,36,34
1656046012131,MATH 103A,A02,083778,Greenfeld; Be'Eri,2,0,36,34
1656046012131,MATH 103A,A03,093561,Staff,0,1,36,36
1656046012131,MATH 103A,B01,083779,Greenfeld; Be'Eri,8,1,36,28
1656046012131,MATH 103A,B02,083780,Greenfeld; Be'Eri,0,0,36,36
1656046012131,MATH 103A,B03,093562,Staff,0,0,36,36
1656046018155,MATH 105,A01,085443,Carter; Anne Toulson,4,1,35,31
1656046018155,MATH 105,A02,093477,Staff,9,0,35,26
1656046024183,MATH 109,A01,083213,Ganzberger; Geoffrey Michael,0,1,34,34
1656046024183,MATH 109,A02,083214,Ganzberger; Geoffrey Michael,0,0,34,34
1656046024183,MATH 109,A03,093478,Staff,1,0,34,33
1656046024183,MATH 109,B01,083215,Ganzberger; Geoffrey Michael,2,0,32,30
1656046024183,MATH 109,B02,083216,Ganzberger; Geoffrey Michael,0,0,32,32
1656046024183,MATH 109,B03,093479,Staff,3,0,32,29
1656046030212,MATH 142A,A01,083219,Chow; Bennett,1,0,32,31
1656046030212,MATH 142A,A02,083220,Chow; Bennett,7,0,32,25
1656046030212,MATH 142A,A03,093480,Staff,4,0,32,28
1656046030212,MATH 142A,B03,093481,Staff,3,0,32,29
1656046030212,MATH 142A,B04,093558,Staff,5,0,32,27
1656046030212,MATH 142A,B05,093559,Staff,0,0,32,32
1656046036235,MATH 193A,A01,083224,Rotar; Vladimir,1,2,34,33
1656046036235,MATH 193A,A02,083225,Rotar; Vladimir,0,0,34,34
1656046036235,MATH 193A,A03,083781,Rotar; Vladimir,1,0,34,33
1656046036235,MATH 193A,A04,083782,Rotar; Vladimir,3,0,34,31
1656046036235,MATH 193A,A05,093482,Rotar; Vladimir,0,0,34,34
1656046042257,MATH 197,001,091859,McAuley; Julian John,9999,0,9999,0
1656046042257,MATH 197,002,095566,Kedlaya; Kiran S.,9997,0,9999,2
1656046042257,MATH 197,003,095567,Xiao; Ming,9999,0,9999,0
1656046042257,MATH 197,004,095571,Perols; Johan Lars,9998,0,9999,1
1656046049319,COGS 9,A01,083615,Shannon; Kyle Michael,3,1,75,72
1656046055340,COGS 11,A01,083617,Boyle; Mary E. T.,11,2,48,37
1656046061372,COGS 13,A01,083071,Bastos; Amalia Pinkusfeld,4,3,71,67
1656046067396,COGS 14A,A01,092681,Semenuks; Arturs,4,25,100,96
1656046073420,COGS 14B,A01,083073,Cheng; Tzu-Han,7,0,63,56
1656046079445,COGS 17,A01,092677,Semenuks; Arturs,8,7,81,73
1656046085480,COGS 100,A01,083619,Allen; Michael Gordon,3,2,70,67
1656046091507,COGS 101A,A01,083621,Davis; Joshua Daniel,4,3,68,64
1656046097530,COGS 101B,A01,091572,Allen; Michael Gordon,0,0,65,65
1656046103553,COGS 101C,A01,083625,Delgado; Tania,7,0,35,28
1656046109576,COGS 107A,A01,083627,Boyle; Mary E. T.,1,2,60,59
1656046115600,COGS 118A,A01,083075,Gupta; Anjum,21,16,76,55
1656046121624,CSE 3,A50,083646,Miranda; Gregory Joseph,14,0,50,36
1656046127658,CSE 8A,A50,083650,Miranda; Gregory Joseph,4,11,56,52
1656046133681,CSE 11,A01,083080,Cao; Yingjun,0,64,40,40
1656046139705,CSE 12,A01,083652,Krause-Levy; Sophia Louisa,7,8,120,113
1656046145728,CSE 15L,A01,083654,Morris; Justin Loren,3,1,50,47
1656046145728,CSE 15L,A02,083655,Morris; Justin Loren,2,1,50,48
1656046151752,CSE 20,A01,083657,Tran; Khoa Dang,29,0,80,51
1656046157778,CSE 21,A01,095574,Bach; Quang Tran,23,0,48,25
1656046163802,CSE 30,A01,083084,Eldon; John,2,10,80,78
1656046163802,CSE 30,B01,095061,Bhaskar; Nishant,2,5,50,48
1656046169825,CSE 100,A01,083659,Cao; Yingjun,2,25,70,68
1656046175859,CSE 134B,A01,083661,Powell; Thomas Allan,6,6,100,94
1656046181882,CSE 140,A01,083663,Gungor; Onat,6,0,85,79
1656046187911,CSE 140L,A01,083088,Eldon; John,5,0,100,95
1656046193934,CSE 175,A01,083665,Kumar; Rakesh,0,0,25,25
1656046199957,CSE 190,A00,092507,Dubnov; Shlomo,1,0,20,19
1656046205980,ECE 45,A01,083139,Congero; Spencer William,1,1,75,74
1656046212004,ECE 65,A50,083695,Saad; Andrew S,6,0,30,24
1656046212004,ECE 65,A51,095125,Staff,23,0,26,3
1656046218026,ECE 109,A01,091882,Touri; Behrouz,3,5,70,67
1656046224050,ECE 180,A00,083140,Abi Samra; Nicholas Camill,1,0,30,29
1656046224050,ECE 180,B00,083141,Abi Samra; Nicholas Camill,0,8,28,28
1656046230073,MATH 10A,A01,083735,Patchell; Gregory David,0,0,30,30
1656046230073,MATH 10A,A02,083736,Patchell; Gregory David,20,0,30,10
1656046230073,MATH 10A,A03,083737,Patchell; Gregory David,16,0,30,14
1656046236104,MATH 10B,A01,083207,Lim; Seonhee,1,1,34,33
1656046236104,MATH 10B,A02,083208,Lim; Seonhee,1,1,35,34
1656046236104,MATH 10B,A03,093472,Staff,0,1,34,34
1656046236104,MATH 10B,B01,083739,Sinha; Shubham,10,0,30,20
1656046242134,MATH 18,A01,083743,Cinel; Cameron Alexander,5,0,30,25
1656046242134,MATH 18,A02,083744,Cinel; Cameron Alexander,11,0,30,19
1656046242134,MATH 18,A03,083745,Cinel; Cameron Alexander,1,0,30,29
1656046242134,MATH 18,B01,083748,Ma; Zilu,0,0,36,36
1656046242134,MATH 18,B02,083749,Ma; Zilu,0,0,36,36
1656046242134,MATH 18,B03,083750,Ma; Zilu,0,0,36,36
1656046242134,MATH 18,B04,083751,Ma; Zilu,0,0,36,36
1656046242134,MATH 18,B05,093473,Staff,0,0,36,36
1656046242134,MATH 18,B06,093474,Staff,3,0,36,33
1656046248159,MATH 20A,A01,083754,Zheng; Zequn,11,0,40,29
1656046254182,MATH 20B,A01,083756,Briones; Jor-el Thomas Caparas,0,0,36,36
1656046254182,MATH 20B,A02,083757,Briones; Jor-el Thomas Caparas,0,0,36,36
1656046254182,MATH 20B,A03,093475,Staff,0,0,36,36
1656046260207,MATH 20C,A01,083760,Briones; Jor-el Thomas Caparas,0,2,35,35
1656046260207,MATH 20C,A02,083761,Briones; Jor-el Thomas Caparas,6,1,35,29
1656046260207,MATH 20C,A03,093476,Staff,0,1,35,35
1656046260207,MATH 20C,B01,083762,Bach; Quang Tran,3,0,30,27
1656046266237,MATH 20D,A01,083765,Tran; Brian Kha,2,0,30,28
1656046266237,MATH 20D,A02,083766,Tran; Brian Kha,0,1,30,30
1656046266237,MATH 20D,A03,083767,Tran; Brian Kha,0,0,30,30
1656046272270,MATH 20E,A01,083771,Ganguly; Soumya,0,1,32,32
1656046272270,MATH 20E,A02,083772,Ganguly; Soumya,1,1,32,31
1656046272270,MATH 20E,B01,083773,Ciotti; Benjamin,13,0,35,22
1656046272270,MATH 20E,B02,083774,Ciotti; Benjamin,13,0,35,22
1656046278295,MATH 103A,A01,083777,Greenfeld; Be'Eri,2,1,36,34
1656046278295,MATH 103A,A02,083778,Greenfeld; Be'Eri,2,0,36,34
1656046278295,MATH 103A,A03,093561,Staff,0,1,36,36
1656046278295,MATH 103A,B01,083779,Greenfeld; Be'Eri,8,1,36,28
1656046278295,MATH 103A,B02,083780,Greenfeld; Be'Eri,0,0,36,36
1656046278295,MATH 103A,B03,093562,Staff,0,0,36,36
1656046284320,MATH 105,A01,085443,Carter; Anne Toulson,4,1,35,31
1656046284320,MATH 105,A02,093477,Staff,9,0,35,26
1656046290344,MATH 109,A01,083213,Ganzberger; Geoffrey Michael,0,1,34,34
1656046290344,MATH 109,A02,083214,Ganzberger; Geoffrey Michael,0,0,34,34
1656046290344,MATH 109,A03,093478,Staff,1,0,34,33
1656046290344,MATH 109,B01,083215,Ganzberger; Geoffrey Michael,2,0,32,30
1656046290344,MATH 109,B02,083216,Ganzberger; Geoffrey Michael,0,0,32,32
1656046290344,MATH 109,B03,093479,Staff,3,0,32,29
1656046296369,MATH 142A,A01,083219,Chow; Bennett,1,0,32,31
1656046296369,MATH 142A,A02,083220,Chow; Bennett,7,0,32,25
1656046296369,MATH 142A,A03,093480,Staff,4,0,32,28
1656046296369,MATH 142A,B03,093481,Staff,3,0,32,29
1656046296369,MATH 142A,B04,093558,Staff,5,0,32,27
1656046296369,MATH 142A,B05,093559,Staff,0,0,32,32
1656046302394,MATH 193A,A01,083224,Rotar; Vladimir,1,2,34,33
1656046302394,MATH 193A,A02,083225,Rotar; Vladimir,0,0,34,34
1656046302394,MATH 193A,A03,083781,Rotar; Vladimir,1,0,34,33
1656046302394,MATH 193A,A04,083782,Rotar; Vladimir,3,0,34,31
1656046302394,MATH 193A,A05,093482,Rotar; Vladimir,0,0,34,34
1656046308419,MATH 197,001,091859,McAuley; Julian John,9999,0,9999,0
1656046308419,MATH 197,002,095566,Kedlaya; Kiran S.,9997,0,9999,2
1656046308419,MATH 197,003,095567,Xiao; Ming,9999,0,9999,0
1656046308419,MATH 197,004,095571,Perols; Johan Lars,9998,0,9999,1
1656046315481,COGS 9,A01,083615,Shannon; Kyle Michael,3,1,75,72
1656046321506,COGS 11,A01,083617,Boyle; Mary E. T.,11,2,48,37
1656046327528,COGS 13,A01,083071,Bastos; Amalia Pinkusfeld,4,3,71,67
1656046333555,COGS 14A,A01,092681,Semenuks; Arturs,4,25,100,96
1656046339582,COGS 14B,A01,083073,Cheng; Tzu-Han,7,0,63,56
1656046345605,COGS 17,A01,092677,Semenuks; Arturs,8,7,81,73
1656046351643,COGS 100,A01,083619,Allen; Michael Gordon,3,2,70,67
1656046357666,COGS 101A,A01,083621,Davis; Joshua Daniel,4,3,68,64
1656046363692,COGS 101B,A01,091572,Allen; Michael Gordon,0,0,65,65
1656046369719,COGS 101C,A01,083625,Delgado; Tania,7,0,35,28
1656046375749,COGS 107A,A01,083627,Boyle; Mary E. T.,1,2,60,59
1656046381781,COGS 118A,A01,083075,Gupta; Anjum,21,16,76,55
1656046387808,CSE 3,A50,083646,Miranda; Gregory Joseph,14,0,50,36
1656046393831,CSE 8A,A50,083650,Miranda; Gregory Joseph,4,11,56,52
1656046399857,CSE 11,A01,083080,Cao; Yingjun,0,64,40,40
1656046405880,CSE 12,A01,083652,Krause-Levy; Sophia Louisa,7,8,120,113
1656046411902,CSE 15L,A01,083654,Morris; Justin Loren,3,1,50,47
1656046411902,CSE 15L,A02,083655,Morris; Justin Loren,2,1,50,48
1656046417925,CSE 20,A01,083657,Tran; Khoa Dang,29,0,80,51
1656046423951,CSE 21,A01,095574,Bach; Quang Tran,23,0,48,25
1656046429975,CSE 30,A01,083084,Eldon; John,2,10,80,78
1656046429975,CSE 30,B01,095061,Bhaskar; Nishant,2,5,50,48
1656046436000,CSE 100,A01,083659,Cao; Yingjun,2,25,70,68
1656046442033,CSE 134B,A01,083661,Powell; Thomas Allan,6,6,100,94
1656046448056,CSE 140,A01,083663,Gungor; Onat,6,0,85,79
1656046454079,CSE 140L,A01,083088,Eldon; John,5,0,100,95
1656046460105,CSE 175,A01,083665,Kumar; Rakesh,0,0,25,25
1656046466127,CSE 190,A00,092507,Dubnov; Shlomo,1,0,20,19
1656046472219,ECE 45,A01,083139,Congero; Spencer William,1,2,75,74
1656046478243,ECE 65,A50,083695,Saad; Andrew S,6,0,30,24
1656046478243,ECE 65,A51,095125,Staff,23,0,26,3
1656046484264,ECE 109,A01,091882,Touri; Behrouz,3,5,70,67
1656046490290,ECE 180,A00,083140,Abi Samra; Nicholas Camill,1,0,30,29
1656046490290,ECE 180,B00,083141,Abi Samra; Nicholas Camill,0,8,28,28
1656046496312,MATH 10A,A01,083735,Patchell; Gregory David,0,0,30,30
1656046496312,MATH 10A,A02,083736,Patchell; Gregory David,20,0,30,10
1656046496312,MATH 10A,A03,083737,Patchell; Gregory David,16,0,30,14
1656046502341,MATH 10B,A01,083207,Lim; Seonhee,1,1,34,33
1656046502341,MATH 10B,A02,083208,Lim; Seonhee,1,1,35,34
1656046502341,MATH 10B,A03,093472,Staff,0,1,34,34
1656046502341,MATH 10B,B01,083739,Sinha; Shubham,10,0,30,20
1656046508365,MATH 18,A01,083743,Cinel; Cameron Alexander,5,0,30,25
1656046508365,MATH 18,A02,083744,Cinel; Cameron Alexander,11,0,30,19
1656046508365,MATH 18,A03,083745,Cinel; Cameron Alexander,1,0,30,29
1656046508365,MATH 18,B01,083748,Ma; Zilu,0,0,36,36
1656046508365,MATH 18,B02,083749,Ma; Zilu,0,0,36,36
1656046508365,MATH 18,B03,083750,Ma; Zilu,0,0,36,36
1656046508365,MATH 18,B04,083751,Ma; Zilu,0,0,36,36
1656046508365,MATH 18,B05,093473,Staff,0,0,36,36
1656046508365,MATH 18,B06,093474,Staff,3,0,36,33
1656046514387,MATH 20A,A01,083754,Zheng; Zequn,11,0,40,29
1656046520411,MATH 20B,A01,083756,Briones; Jor-el Thomas Caparas,0,0,36,36
1656046520411,MATH 20B,A02,083757,Briones; Jor-el Thomas Caparas,0,0,36,36
1656046520411,MATH 20B,A03,093475,Staff,0,0,36,36
1656046526439,MATH 20C,A01,083760,Briones; Jor-el Thomas Caparas,0,2,35,35
1656046526439,MATH 20C,A02,083761,Briones; Jor-el Thomas Caparas,6,1,35,29
1656046526439,MATH 20C,A03,093476,Staff,0,1,35,35
1656046526439,MATH 20C,B01,083762,Bach; Quang Tran,3,0,30,27
1656046532465,MATH 20D,A01,083765,Tran; Brian Kha,2,0,30,28
1656046532465,MATH 20D,A02,083766,Tran; Brian Kha,0,1,30,30
1656046532465,MATH 20D,A03,083767,Tran; Brian Kha,0,0,30,30
1656046538489,MATH 20E,A01,083771,Ganguly; Soumya,0,1,32,32
1656046538489,MATH 20E,A02,083772,Ganguly; Soumya,1,1,32,31
1656046538489,MATH 20E,B01,083773,Ciotti; Benjamin,13,0,35,22
1656046538489,MATH 20E,B02,083774,Ciotti; Benjamin,13,0,35,22
1656046544516,MATH 103A,A01,083777,Greenfeld; Be'Eri,2,1,36,34
1656046544516,MATH 103A,A02,083778,Greenfeld; Be'Eri,2,0,36,34
1656046544516,MATH 103A,A03,093561,Staff,0,1,36,36
1656046544516,MATH 103A,B01,083779,Greenfeld; Be'Eri,8,1,36,28
1656046544516,MATH 103A,B02,083780,Greenfeld; Be'Eri,0,0,36,36
1656046544516,MATH 103A,B03,093562,Staff,0,0,36,36
1656046550540,MATH 105,A01,085443,Carter; Anne Toulson,4,1,35,31
1656046550540,MATH 105,A02,093477,Staff,9,0,35,26
1656046556562,MATH 109,A01,083213,Ganzberger; Geoffrey Michael,0,1,34,34
1656046556562,MATH 109,A02,083214,Ganzberger; Geoffrey Michael,0,0,34,34
1656046556562,MATH 109,A03,093478,Staff,1,0,34,33
1656046556562,MATH 109,B01,083215,Ganzberger; Geoffrey Michael,2,0,32,30
1656046556562,MATH 109,B02,083216,Ganzberger; Geoffrey Michael,0,0,32,32
1656046556562,MATH 109,B03,093479,Staff,3,0,32,29
1656046562588,MATH 142A,A01,083219,Chow; Bennett,1,0,32,31
1656046562588,MATH 142A,A02,083220,Chow; Bennett,7,0,32,25
1656046562588,MATH 142A,A03,093480,Staff,4,0,32,28
1656046562588,MATH 142A,B03,093481,Staff,4,0,32,28
1656046562588,MATH 142A,B04,093558,Staff,5,0,32,27
1656046562588,MATH 142A,B05,093559,Staff,0,0,32,32
1656046568612,MATH 193A,A01,083224,Rotar; Vladimir,1,2,34,33
1656046568612,MATH 193A,A02,083225,Rotar; Vladimir,0,0,34,34
1656046568612,MATH 193A,A03,083781,Rotar; Vladimir,1,0,34,33
1656046568612,MATH 193A,A04,083782,Rotar; Vladimir,3,0,34,31
1656046568612,MATH 193A,A05,093482,Rotar; Vladimir,0,0,34,34
1656046574640,MATH 197,001,091859,McAuley; Julian John,9999,0,9999,0
1656046574640,MATH 197,002,095566,Kedlaya; Kiran S.,9997,0,9999,2
1656046574640,MATH 197,003,095567,Xiao; Ming,9999,0,9999,0
1656046574640,MATH 197,004,095571,Perols; Johan Lars,9998,0,9999,1
1656046581699,COGS 9,A01,083615,Shannon; Kyle Michael,3,1,75,72
1656046587723,COGS 11,A01,083617,Boyle; Mary E. T.,11,2,48,37
1656046593746,COGS 13,A01,083071,Bastos; Amalia Pinkusfeld,4,3,71,67
1656046599769,COGS 14A,A01,092681,Semenuks; Arturs,4,25,100,96
1656046605793,COGS 14B,A01,083073,Cheng; Tzu-Han,7,0,63,56
1656046611820,COGS 17,A01,092677,Semenuks; Arturs,8,7,81,73
1656046617847,COGS 100,A01,083619,Allen; Michael Gordon,3,2,70,67
1656046623871,COGS 101A,A01,083621,Davis; Joshua Daniel,4,3,68,64
1656046629893,COGS 101B,A01,091572,Allen; Michael Gordon,0,0,65,65
1656046635916,COGS 101C,A01,083625,Delgado; Tania,7,0,35,28
1656046641944,COGS 107A,A01,083627,Boyle; Mary E. T.,1,2,60,59
1656046647971,COGS 118A,A01,083075,Gupta; Anjum,21,16,76,55
1656046653995,CSE 3,A50,083646,Miranda; Gregory Joseph,14,0,50,36
1656046660023,CSE 8A,A50,083650,Miranda; Gregory Joseph,4,11,56,52
1656046666048,CSE 11,A01,083080,Cao; Yingjun,0,64,40,40
1656046672075,CSE 12,A01,083652,Krause-Levy; Sophia Louisa,7,8,120,113
1656046678102,CSE 15L,A01,083654,Morris; Justin Loren,3,1,50,47
1656046678102,CSE 15L,A02,083655,Morris; Justin Loren,2,1,50,48
1656046684126,CSE 20,A01,083657,Tran; Khoa Dang,29,0,80,51
1656046690152,CSE 21,A01,095574,Bach; Quang Tran,23,0,48,25
1656046696179,CSE 30,A01,083084,Eldon; John,2,10,80,78
1656046696179,CSE 30,B01,095061,Bhaskar; Nishant,2,5,50,48
1656046702203,CSE 100,A01,083659,Cao; Yingjun,2,25,70,68
1656046708232,CSE 134B,A01,083661,Powell; Thomas Allan,6,6,100,94
1656046714256,CSE 140,A01,083663,Gungor; Onat,6,0,85,79
1656046720280,CSE 140L,A01,083088,Eldon; John,5,0,100,95
1656046726305,CSE 175,A01,083665,Kumar; Rakesh,0,0,25,25
1656046732329,CSE 190,A00,092507,Dubnov; Shlomo,1,0,20,19
1656046738356,ECE 45,A01,083139,Congero; Spencer William,1,2,75,74
1656046744379,ECE 65,A50,083695,Saad; Andrew S,6,0,30,24
1656046744379,ECE 65,A51,095125,Staff,23,0,26,3
1656046750405,ECE 109,A01,091882,Touri; Behrouz,3,5,70,67
1656046756427,ECE 180,A00,083140,Abi Samra; Nicholas Camill,1,0,30,29
1656046756427,ECE 180,B00,083141,Abi Samra; Nicholas Camill,0,8,28,28
1656046762452,MATH 10A,A01,083735,Patchell; Gregory David,0,0,30,30
1656046762452,MATH 10A,A02,083736,Patchell; Gregory David,20,0,30,10
1656046762452,MATH 10A,A03,083737,Patchell; Gregory David,16,0,30,14
1656046768480,MATH 10B,A01,083207,Lim; Seonhee,1,1,34,33
1656046768480,MATH 10B,A02,083208,Lim; Seonhee,1,1,35,34
1656046768480,MATH 10B,A03,093472,Staff,0,1,34,34
1656046768480,MATH 10B,B01,083739,Sinha; Shubham,10,0,30,20
1656046774504,MATH 18,A01,083743,Cinel; Cameron Alexander,5,0,30,25
1656046774504,MATH 18,A02,083744,Cinel; Cameron Alexander,11,0,30,19
1656046774504,MATH 18,A03,083745,Cinel; Cameron Alexander,1,0,30,29
1656046774504,MATH 18,B01,083748,Ma; Zilu,0,0,36,36
1656046774504,MATH 18,B02,083749,Ma; Zilu,0,0,36,36
1656046774504,MATH 18,B03,083750,Ma; Zilu,0,0,36,36
1656046774504,MATH 18,B04,083751,Ma; Zilu,0,0,36,36
1656046774504,MATH 18,B05,093473,Staff,0,0,36,36
1656046774504,MATH 18,B06,093474,Staff,3,0,36,33
1656046780529,MATH 20A,A01,083754,Zheng; Zequn,11,0,40,29
1656046786556,MATH 20B,A01,083756,Briones; Jor-el Thomas Caparas,0,0,36,36
1656046786556,MATH 20B,A02,083757,Briones; Jor-el Thomas Caparas,0,0,36,36
1656046786556,MATH 20B,A03,093475,Staff,0,0,36,36
1656046792580,MATH 20C,A01,083760,Briones; Jor-el Thomas Caparas,0,2,35,35
1656046792580,MATH 20C,A02,083761,Briones; Jor-el Thomas Caparas,6,1,35,29
1656046792580,MATH 20C,A03,093476,Staff,0,1,35,35
1656046792580,MATH 20C,B01,083762,Bach; Quang Tran,3,0,30,27
1656046798603,MATH 20D,A01,083765,Tran; Brian Kha,2,0,30,28
1656046798603,MATH 20D,A02,083766,Tran; Brian Kha,0,1,30,30
1656046798603,MATH 20D,A03,083767,Tran; Brian Kha,0,0,30,30
1656046804630,MATH 20E,A01,083771,Ganguly; Soumya,0,1,32,32
1656046804630,MATH 20E,A02,083772,Ganguly; Soumya,1,1,32,31
1656046804630,MATH 20E,B01,083773,Ciotti; Benjamin,13,0,35,22
1656046804630,MATH 20E,B02,083774,Ciotti; Benjamin,13,0,35,22
1656046810660,MATH 103A,A01,083777,Greenfeld; Be'Eri,2,1,36,34
1656046810660,MATH 103A,A02,083778,Greenfeld; Be'Eri,2,0,36,34
1656046810660,MATH 103A,A03,093561,Staff,0,1,36,36
1656046810660,MATH 103A,B01,083779,Greenfeld; Be'Eri,8,1,36,28
1656046810660,MATH 103A,B02,083780,Greenfeld; Be'Eri,0,0,36,36
1656046810660,MATH 103A,B03,093562,Staff,0,0,36,36
1656046816683,MATH 105,A01,085443,Carter; Anne Toulson,4,1,35,31
1656046816683,MATH 105,A02,093477,Staff,9,0,35,26
1656046822705,MATH 109,A01,083213,Ganzberger; Geoffrey Michael,0,1,34,34
1656046822705,MATH 109,A02,083214,Ganzberger; Geoffrey Michael,0,0,34,34
1656046822705,MATH 109,A03,093478,Staff,1,0,34,33
1656046822705,MATH 109,B01,083215,Ganzberger; Geoffrey Michael,2,0,32,30
1656046822705,MATH 109,B02,083216,Ganzberger; Geoffrey Michael,0,0,32,32
1656046822705,MATH 109,B03,093479,Staff,3,0,32,29
1656046828732,MATH 142A,A01,083219,Chow; Bennett,1,0,32,31
1656046828732,MATH 142A,A02,083220,Chow; Bennett,7,0,32,25
1656046828732,MATH 142A,A03,093480,Staff,4,0,32,28
1656046828732,MATH 142A,B03,093481,Staff,4,0,32,28
1656046828732,MATH 142A,B04,093558,Staff,5,0,32,27
1656046828732,MATH 142A,B05,093559,Staff,0,0,32,32
1656046834755,MATH 193A,A01,083224,Rotar; Vladimir,1,2,34,33
1656046834755,MATH 193A,A02,083225,Rotar; Vladimir,0,0,34,34
1656046834755,MATH 193A,A03,083781,Rotar; Vladimir,1,0,34,33
1656046834755,MATH 193A,A04,083782,Rotar; Vladimir,3,0,34,31
1656046834755,MATH 193A,A05,093482,Rotar; Vladimir,0,0,34,34
1656046840784,MATH 197,001,091859,McAuley; Julian John,9999,0,9999,0
1656046840784,MATH 197,002,095566,Kedlaya; Kiran S.,9997,0,9999,2
1656046840784,MATH 197,003,095567,Xiao; Ming,9999,0,9999,0
1656046840784,MATH 197,004,095571,Perols; Johan Lars,9998,0,9999,1
1656046847845,COGS 9,A01,083615,Shannon; Kyle Michael,3,1,75,72
1656046853870,COGS 11,A01,083617,Boyle; Mary E. T.,11,2,48,37
1656046859896,COGS 13,A01,083071,Bastos; Amalia Pinkusfeld,4,3,71,67
1656046865919,COGS 14A,A01,092681,Semenuks; Arturs,4,25,100,96
1656046871947,COGS 14B,A01,083073,Cheng; Tzu-Han,7,0,63,56
1656046877974,COGS 17,A01,092677,Semenuks; Arturs,8,7,81,73
1656046884002,COGS 100,A01,083619,Allen; Michael Gordon,3,2,70,67
1656046890026,COGS 101A,A01,083621,Davis; Joshua Daniel,4,3,68,64
1656046896051,COGS 101B,A01,091572,Allen; Michael Gordon,0,0,65,65
1656046902075,COGS 101C,A01,083625,Delgado; Tania,7,0,35,28
1656046908103,COGS 107A,A01,083627,Boyle; Mary E. T.,1,2,60,59
1656046914131,COGS 118A,A01,083075,Gupta; Anjum,21,16,76,55
1656046920155,CSE 3,A50,083646,Miranda; Gregory Joseph,14,0,50,36
1656046926178,CSE 8A,A50,083650,Miranda; Gregory Joseph,4,11,56,52
1656046932202,CSE 11,A01,083080,Cao; Yingjun,0,64,40,40
1656046938228,CSE 12,A01,083652,Krause-Levy; Sophia Louisa,7,8,120,113
1656046944256,CSE 15L,A01,083654,Morris; Justin Loren,3,1,50,47
1656046944256,CSE 15L,A02,083655,Morris; Justin Loren,2,1,50,48
1656046950280,CSE 20,A01,083657,Tran; Khoa Dang,29,0,80,51
1656046956304,CSE 21,A01,095574,Bach; Quang Tran,23,0,48,25
1656046962330,CSE 30,A01,083084,Eldon; John,2,10,80,78
1656046962330,CSE 30,B01,095061,Bhaskar; Nishant,2,5,50,48
1656046968357,CSE 100,A01,083659,Cao; Yingjun,2,25,70,68
1656046974383,CSE 134B,A01,083661,Powell; Thomas Allan,6,6,100,94
1656046980409,CSE 140,A01,083663,Gungor; Onat,6,0,85,79
1656046986431,CSE 140L,A01,083088,Eldon; John,5,0,100,95
1656046992454,CSE 175,A01,083665,Kumar; Rakesh,0,0,25,25
1656046998478,CSE 190,A00,092507,Dubnov; Shlomo,1,0,20,19
1656047004624,ECE 45,A01,083139,Congero; Spencer William,1,2,75,74
1656047010652,ECE 65,A50,083695,Saad; Andrew S,6,0,30,24
1656047010652,ECE 65,A51,095125,Staff,23,0,26,3
1656047016675,ECE 109,A01,091882,Touri; Behrouz,3,5,70,67
1656047022697,ECE 180,A00,083140,Abi Samra; Nicholas Camill,1,0,30,29
1656047022697,ECE 180,B00,083141,Abi Samra; Nicholas Camill,0,8,28,28
1656047028722,MATH 10A,A01,083735,Patchell; Gregory David,0,0,30,30
1656047028722,MATH 10A,A02,083736,Patchell; Gregory David,20,0,30,10
1656047028722,MATH 10A,A03,083737,Patchell; Gregory David,16,0,30,14
1656047034745,MATH 10B,A01,083207,Lim; Seonhee,1,1,34,33
1656047034745,MATH 10B,A02,083208,Lim; Seonhee,1,1,35,34
1656047034745,MATH 10B,A03,093472,Staff,0,1,34,34
1656047034745,MATH 10B,B01,083739,Sinha; Shubham,10,0,30,20
1656047040770,MATH 18,A01,083743,Cinel; Cameron Alexander,5,0,30,25
1656047040770,MATH 18,A02,083744,Cinel; Cameron Alexander,11,0,30,19
1656047040770,MATH 18,A03,083745,Cinel; Cameron Alexander,1,0,30,29
1656047040770,MATH 18,B01,083748,Ma; Zilu,0,0,36,36
1656047040770,MATH 18,B02,083749,Ma; Zilu,0,0,36,36
1656047040770,MATH 18,B03,083750,Ma; Zilu,0,0,36,36
1656047040770,MATH 18,B04,083751,Ma; Zilu,0,0,36,36
1656047040770,MATH 18,B05,093473,Staff,0,0,36,36
1656047040770,MATH 18,B06,093474,Staff,3,0,36,33
1656047046799,MATH 20A,A01,083754,Zheng; Zequn,11,0,40,29
1656047052823,MATH 20B,A01,083756,Briones; Jor-el Thomas Caparas,0,0,36,36
1656047052823,MATH 20B,A02,083757,Briones; Jor-el Thomas Caparas,0,0,36,36
1656047052823,MATH 20B,A03,093475,Staff,0,0,36,36
1656047058846,MATH 20C,A01,083760,Briones; Jor-el Thomas Caparas,0,2,35,35
1656047058846,MATH 20C,A02,083761,Briones; Jor-el Thomas Caparas,6,1,35,29
1656047058846,MATH 20C,A03,093476,Staff,0,1,35,35
1656047058846,MATH 20C,B01,083762,Bach; Quang Tran,3,0,30,27
1656047064872,MATH 20D,A01,083765,Tran; Brian Kha,2,0,30,28
1656047064872,MATH 20D,A02,083766,Tran; Brian Kha,0,1,30,30
1656047064872,MATH 20D,A03,083767,Tran; Brian Kha,0,0,30,30
1656047070992,MATH 20E,A01,083771,Ganguly; Soumya,0,1,32,32
1656047070992,MATH 20E,A02,083772,Ganguly; Soumya,1,1,32,31
1656047070992,MATH 20E,B01,083773,Ciotti; Benjamin,13,0,35,22
1656047070992,MATH 20E,B02,083774,Ciotti; Benjamin,13,0,35,22
1656047077024,MATH 103A,A01,083777,Greenfeld; Be'Eri,2,1,36,34
1656047077024,MATH 103A,A02,083778,Greenfeld; Be'Eri,2,0,36,34
1656047077024,MATH 103A,A03,093561,Staff,0,1,36,36
1656047077024,MATH 103A,B01,083779,Greenfeld; Be'Eri,8,1,36,28
1656047077024,MATH 103A,B02,083780,Greenfeld; Be'Eri,0,0,36,36
1656047077024,MATH 103A,B03,093562,Staff,0,0,36,36
1656047083051,MATH 105,A01,085443,Carter; Anne Toulson,4,1,35,31
1656047083051,MATH 105,A02,093477,Staff,9,0,35,26
1656047089077,MATH 109,A01,083213,Ganzberger; Geoffrey Michael,0,1,34,34
1656047089077,MATH 109,A02,083214,Ganzberger; Geoffrey Michael,0,0,34,34
1656047089077,MATH 109,A03,093478,Staff,1,0,34,33
1656047089077,MATH 109,B01,083215,Ganzberger; Geoffrey Michael,2,0,32,30
1656047089077,MATH 109,B02,083216,Ganzberger; Geoffrey Michael,0,0,32,32
1656047089077,MATH 109,B03,093479,Staff,3,0,32,29
1656047095101,MATH 142A,A01,083219,Chow; Bennett,1,0,32,31
1656047095101,MATH 142A,A02,083220,Chow; Bennett,7,0,32,25
1656047095101,MATH 142A,A03,093480,Staff,4,0,32,28
1656047095101,MATH 142A,B03,093481,Staff,4,0,32,28
1656047095101,MATH 142A,B04,093558,Staff,5,0,32,27
1656047095101,MATH 142A,B05,093559,Staff,0,0,32,32
1656047101130,MATH 193A,A01,083224,Rotar; Vladimir,1,2,34,33
1656047101130,MATH 193A,A02,083225,Rotar; Vladimir,0,0,34,34
1656047101130,MATH 193A,A03,083781,Rotar; Vladimir,1,0,34,33
1656047101130,MATH 193A,A04,083782,Rotar; Vladimir,3,0,34,31
1656047101130,MATH 193A,A05,093482,Rotar; Vladimir,0,0,34,34
1656047107155,MATH 197,001,091859,McAuley; Julian John,9999,0,9999,0
1656047107155,MATH 197,002,095566,Kedlaya; Kiran S.,9997,0,9999,2
1656047107155,MATH 197,003,095567,Xiao; Ming,9999,0,9999,0
1656047107155,MATH 197,004,095571,Perols; Johan Lars,9998,0,9999,1
1656047114221,COGS 9,A01,083615,Shannon; Kyle Michael,3,1,75,72
1656047120243,COGS 11,A01,083617,Boyle; Mary E. T.,11,2,48,37
1656047126277,COGS 13,A01,083071,Bastos; Amalia Pinkusfeld,4,3,71,67
1656047132303,COGS 14A,A01,092681,Semenuks; Arturs,4,25,100,96
1656047138328,COGS 14B,A01,083073,Cheng; Tzu-Han,7,0,63,56
1656047144352,COGS 17,A01,092677,Semenuks; Arturs,8,7,81,73
1656047150376,COGS 100,A01,083619,Allen; Michael Gordon,3,2,70,67
1656047156401,COGS 101A,A01,083621,Davis; Joshua Daniel,4,3,68,64
1656047162427,COGS 101B,A01,091572,Allen; Michael Gordon,0,0,65,65
1656047168450,COGS 101C,A01,083625,Delgado; Tania,7,0,35,28
1656047174478,COGS 107A,A01,083627,Boyle; Mary E. T.,1,2,60,59
1656047180505,COGS 118A,A01,083075,Gupta; Anjum,21,16,76,55
1656047186540,CSE 3,A50,083646,Miranda; Gregory Joseph,14,0,50,36
1656047192564,CSE 8A,A50,083650,Miranda; Gregory Joseph,4,11,56,52
1656047198588,CSE 11,A01,083080,Cao; Yingjun,0,64,40,40
1656047204612,CSE 12,A01,083652,Krause-Levy; Sophia Louisa,7,8,120,113
1656047210639,CSE 15L,A01,083654,Morris; Justin Loren,3,1,50,47
1656047210639,CSE 15L,A02,083655,Morris; Justin Loren,2,1,50,48
1656047216666,CSE 20,A01,083657,Tran; Khoa Dang,29,0,80,51
1656047222689,CSE 21,A01,095574,Bach; Quang Tran,23,0,48,25
1656047228717,CSE 30,A01,083084,Eldon; John,2,10,80,78
1656047228717,CSE 30,B01,095061,Bhaskar; Nishant,2,5,50,48
1656047234744,CSE 100,A01,083659,Cao; Yingjun,2,25,70,68
1656047240765,CSE 134B,A01,083661,Powell; Thomas Allan,6,6,100,94
1656047246793,CSE 140,A01,083663,Gungor; Onat,6,0,85,79
1656047252826,CSE 140L,A01,083088,Eldon; John,5,0,100,95
1656047258858,CSE 175,A01,083665,Kumar; Rakesh,0,0,25,25
1656047264895,CSE 190,A00,092507,Dubnov; Shlomo,1,0,20,19
1656047270918,ECE 45,A01,083139,Congero; Spencer William,1,2,75,74
1656047276945,ECE 65,A50,083695,Saad; Andrew S,6,0,30,24
1656047276945,ECE 65,A51,095125,Staff,23,0,26,3
1656047282971,ECE 109,A01,091882,Touri; Behrouz,3,5,70,67
1656047288993,ECE 180,A00,083140,Abi Samra; Nicholas Camill,1,0,30,29
1656047288993,ECE 180,B00,083141,Abi Samra; Nicholas Camill,0,8,28,28
1656047295017,MATH 10A,A01,083735,Patchell; Gregory David,0,0,30,30
1656047295017,MATH 10A,A02,083736,Patchell; Gregory David,20,0,30,10
1656047295017,MATH 10A,A03,083737,Patchell; Gregory David,16,0,30,14
1656047301042,MATH 10B,A01,083207,Lim; Seonhee,1,1,34,33
1656047301042,MATH 10B,A02,083208,Lim; Seonhee,1,1,35,34
1656047301042,MATH 10B,A03,093472,Staff,0,1,34,34
1656047301042,MATH 10B,B01,083739,Sinha; Shubham,10,0,30,20
1656047307073,MATH 18,A01,083743,Cinel; Cameron Alexander,5,0,30,25
1656047307073,MATH 18,A02,083744,Cinel; Cameron Alexander,11,0,30,19
1656047307073,MATH 18,A03,083745,Cinel; Cameron Alexander,1,0,30,29
1656047307073,MATH 18,B01,083748,Ma; Zilu,0,0,36,36
1656047307073,MATH 18,B02,083749,Ma; Zilu,0,0,36,36
1656047307073,MATH 18,B03,083750,Ma; Zilu,0,0,36,36
1656047307073,MATH 18,B04,083751,Ma; Zilu,0,0,36,36
1656047307073,MATH 18,B05,093473,Staff,0,0,36,36
1656047307073,MATH 18,B06,093474,Staff,3,0,36,33
1656047313097,MATH 20A,A01,083754,Zheng; Zequn,11,0,40,29
1656047319120,MATH 20B,A01,083756,Briones; Jor-el Thomas Caparas,0,0,36,36
1656047319120,MATH 20B,A02,083757,Briones; Jor-el Thomas Caparas,0,0,36,36
1656047319120,MATH 20B,A03,093475,Staff,0,0,36,36
1656047325148,MATH 20C,A01,083760,Briones; Jor-el Thomas Caparas,0,2,35,35
1656047325148,MATH 20C,A02,083761,Briones; Jor-el Thomas Caparas,6,1,35,29
1656047325148,MATH 20C,A03,093476,Staff,0,1,35,35
1656047325148,MATH 20C,B01,083762,Bach; Quang Tran,3,0,30,27
1656047331175,MATH 20D,A01,083765,Tran; Brian Kha,2,0,30,28
1656047331175,MATH 20D,A02,083766,Tran; Brian Kha,0,1,30,30
1656047331175,MATH 20D,A03,083767,Tran; Brian Kha,0,0,30,30
1656047337204,MATH 20E,A01,083771,Ganguly; Soumya,0,1,32,32
1656047337204,MATH 20E,A02,083772,Ganguly; Soumya,1,1,32,31
1656047337204,MATH 20E,B01,083773,Ciotti; Benjamin,13,0,35,22
1656047337204,MATH 20E,B02,083774,Ciotti; Benjamin,13,0,35,22
1656047343244,MATH 103A,A01,083777,Greenfeld; Be'Eri,2,1,36,34
1656047343244,MATH 103A,A02,083778,Greenfeld; Be'Eri,2,0,36,34
1656047343244,MATH 103A,A03,093561,Staff,0,1,36,36
1656047343244,MATH 103A,B01,083779,Greenfeld; Be'Eri,8,1,36,28
1656047343244,MATH 103A,B02,083780,Greenfeld; Be'Eri,0,0,36,36
1656047343244,MATH 103A,B03,093562,Staff,0,0,36,36
1656047349266,MATH 105,A01,085443,Carter; Anne Toulson,4,1,35,31
1656047349266,MATH 105,A02,093477,Staff,9,0,35,26
1656047355292,MATH 109,A01,083213,Ganzberger; Geoffrey Michael,0,1,34,34
1656047355292,MATH 109,A02,083214,Ganzberger; Geoffrey Michael,0,0,34,34
1656047355292,MATH 109,A03,093478,Staff,1,0,34,33
1656047355292,MATH 109,B01,083215,Ganzberger; Geoffrey Michael,2,0,32,30
1656047355292,MATH 109,B02,083216,Ganzberger; Geoffrey Michael,0,0,32,32
1656047355292,MATH 109,B03,093479,Staff,3,0,32,29
1656047361319,MATH 142A,A01,083219,Chow; Bennett,1,0,32,31
1656047361319,MATH 142A,A02,083220,Chow; Bennett,7,0,32,25
1656047361319,MATH 142A,A03,093480,Staff,4,0,32,28
1656047361319,MATH 142A,B03,093481,Staff,4,0,32,28
1656047361319,MATH 142A,B04,093558,Staff,5,0,32,27
1656047361319,MATH 142A,B05,093559,Staff,0,0,32,32
1656047367349,MATH 193A,A01,083224,Rotar; Vladimir,1,2,34,33
1656047367349,MATH 193A,A02,083225,Rotar; Vladimir,0,0,34,34
1656047367349,MATH 193A,A03,083781,Rotar; Vladimir,1,0,34,33
1656047367349,MATH 193A,A04,083782,Rotar; Vladimir,3,0,34,31
1656047367349,MATH 193A,A05,093482,Rotar; Vladimir,0,0,34,34
1656047373372,MATH 197,001,091859,McAuley; Julian John,9999,0,9999,0
1656047373372,MATH 197,002,095566,Kedlaya; Kiran S.,9997,0,9999,2
1656047373372,MATH 197,003,095567,Xiao; Ming,9999,0,9999,0
1656047373372,MATH 197,004,095571,Perols; Johan Lars,9998,0,9999,1
1656047380442,COGS 9,A01,083615,Shannon; Kyle Michael,3,1,75,72
1656047386464,COGS 11,A01,083617,Boyle; Mary E. T.,11,2,48,37
1656047392493,COGS 13,A01,083071,Bastos; Amalia Pinkusfeld,4,3,71,67
1656047398516,COGS 14A,A01,092681,Semenuks; Arturs,4,25,100,96
1656047404541,COGS 14B,A01,083073,Cheng; Tzu-Han,7,0,63,56
1656047410568,COGS 17,A01,092677,Semenuks; Arturs,8,7,81,73
1656047416592,COGS 100,A01,083619,Allen; Michael Gordon,3,2,70,67
1656047422617,COGS 101A,A01,083621,Davis; Joshua Daniel,4,3,68,64
1656047428641,COGS 101B,A01,091572,Allen; Michael Gordon,0,0,65,65
1656047434679,COGS 101C,A01,083625,Delgado; Tania,7,0,35,28
1656047440703,COGS 107A,A01,083627,Boyle; Mary E. T.,1,2,60,59
1656047446725,COGS 118A,A01,083075,Gupta; Anjum,21,16,76,55
1656047452748,CSE 3,A50,083646,Miranda; Gregory Joseph,14,0,50,36
1656047458772,CSE 8A,A50,083650,Miranda; Gregory Joseph,4,11,56,52
1656047464795,CSE 11,A01,083080,Cao; Yingjun,0,64,40,40
1656047470824,CSE 12,A01,083652,Krause-Levy; Sophia Louisa,7,8,120,113
1656047476848,CSE 15L,A01,083654,Morris; Justin Loren,3,1,50,47
1656047476848,CSE 15L,A02,083655,Morris; Justin Loren,2,1,50,48
1656047482872,CSE 20,A01,083657,Tran; Khoa Dang,29,0,80,51
1656047488902,CSE 21,A01,095574,Bach; Quang Tran,23,0,48,25
1656047494931,CSE 30,A01,083084,Eldon; John,2,10,80,78
1656047494931,CSE 30,B01,095061,Bhaskar; Nishant,2,5,50,48
1656047500954,CSE 100,A01,083659,Cao; Yingjun,2,25,70,68
1656047506979,CSE 134B,A01,083661,Powell; Thomas Allan,6,6,100,94
1656047513003,CSE 140,A01,083663,Gungor; Onat,6,0,85,79
1656047519030,CSE 140L,A01,083088,Eldon; John,5,0,100,95
1656047525054,CSE 175,A01,083665,Kumar; Rakesh,0,0,25,25
1656047531081,CSE 190,A00,092507,Dubnov; Shlomo,1,0,20,19
1656047537115,ECE 45,A01,083139,Congero; Spencer William,1,2,75,74
1656047543143,ECE 65,A50,083695,Saad; Andrew S,6,0,30,24
1656047543143,ECE 65,A51,095125,Staff,23,0,26,3
1656047549165,ECE 109,A01,091882,Touri; Behrouz,3,5,70,67
1656047555187,ECE 180,A00,083140,Abi Samra; Nicholas Camill,1,0,30,29
1656047555187,ECE 180,B00,083141,Abi Samra; Nicholas Camill,0,8,28,28
1656047561212,MATH 10A,A01,083735,Patchell; Gregory David,0,0,30,30
1656047561212,MATH 10A,A02,083736,Patchell; Gregory David,20,0,30,10
1656047561212,MATH 10A,A03,083737,Patchell; Gregory David,16,0,30,14
1656047567242,MATH 10B,A01,083207,Lim; Seonhee,1,1,34,33
1656047567242,MATH 10B,A02,083208,Lim; Seonhee,1,1,35,34
1656047567242,MATH 10B,A03,093472,Staff,0,1,34,34
1656047567242,MATH 10B,B01,083739,Sinha; Shubham,10,0,30,20
1656047573273,MATH 18,A01,083743,Cinel; Cameron Alexander,5,0,30,25
1656047573273,MATH 18,A02,083744,Cinel; Cameron Alexander,11,0,30,19
1656047573273,MATH 18,A03,083745,Cinel; Cameron Alexander,1,0,30,29
1656047573273,MATH 18,B01,083748,Ma; Zilu,0,0,36,36
1656047573273,MATH 18,B02,083749,Ma; Zilu,0,0,36,36
1656047573273,MATH 18,B03,083750,Ma; Zilu,0,0,36,36
1656047573273,MATH 18,B04,083751,Ma; Zilu,0,0,36,36
1656047573273,MATH 18,B05,093473,Staff,0,0,36,36
1656047573273,MATH 18,B06,093474,Staff,3,0,36,33
1656047579301,MATH 20A,A01,083754,Zheng; Zequn,11,0,40,29
1656047585329,MATH 20B,A01,083756,Briones; Jor-el Thomas Caparas,0,0,36,36
1656047585329,MATH 20B,A02,083757,Briones; Jor-el Thomas Caparas,0,0,36,36
1656047585329,MATH 20B,A03,093475,Staff,0,0,36,36
1656047591358,MATH 20C,A01,083760,Briones; Jor-el Thomas Caparas,0,2,35,35
1656047591358,MATH 20C,A02,083761,Briones; Jor-el Thomas Caparas,6,1,35,29
1656047591358,MATH 20C,A03,093476,Staff,0,1,35,35
1656047591358,MATH 20C,B01,083762,Bach; Quang Tran,3,0,30,27
1656047597396,MATH 20D,A01,083765,Tran; Brian Kha,2,0,30,28
1656047597396,MATH 20D,A02,083766,Tran; Brian Kha,0,1,30,30
1656047597396,MATH 20D,A03,083767,Tran; Brian Kha,0,0,30,30
1656047603420,MATH 20E,A01,083771,Ganguly; Soumya,0,1,32,32
1656047603420,MATH 20E,A02,083772,Ganguly; Soumya,1,1,32,31
1656047603420,MATH 20E,B01,083773,Ciotti; Benjamin,13,0,35,22
1656047603420,MATH 20E,B02,083774,Ciotti; Benjamin,13,0,35,22
1656047609445,MATH 103A,A01,083777,Greenfeld; Be'Eri,2,1,36,34
1656047609445,MATH 103A,A02,083778,Greenfeld; Be'Eri,2,0,36,34
1656047609445,MATH 103A,A03,093561,Staff,0,1,36,36
1656047609445,MATH 103A,B01,083779,Greenfeld; Be'Eri,8,1,36,28
1656047609445,MATH 103A,B02,083780,Greenfeld; Be'Eri,0,0,36,36
1656047609445,MATH 103A,B03,093562,Staff,0,0,36,36
1656047615470,MATH 105,A01,085443,Carter; Anne Toulson,4,1,35,31
1656047615470,MATH 105,A02,093477,Staff,9,0,35,26
1656047621493,MATH 109,A01,083213,Ganzberger; Geoffrey Michael,0,1,34,34
1656047621493,MATH 109,A02,083214,Ganzberger; Geoffrey Michael,0,0,34,34
1656047621493,MATH 109,A03,093478,Staff,1,0,34,33
1656047621493,MATH 109,B01,083215,Ganzberger; Geoffrey Michael,2,0,32,30
1656047621493,MATH 109,B02,083216,Ganzberger; Geoffrey Michael,0,0,32,32
1656047621493,MATH 109,B03,093479,Staff,3,0,32,29
1656047627517,MATH 142A,A01,083219,Chow; Bennett,1,0,32,31
1656047627517,MATH 142A,A02,083220,Chow; Bennett,7,0,32,25
1656047627517,MATH 142A,A03,093480,Staff,4,0,32,28
1656047627517,MATH 142A,B03,093481,Staff,4,0,32,28
1656047627517,MATH 142A,B04,093558,Staff,5,0,32,27
1656047627517,MATH 142A,B05,093559,Staff,0,0,32,32
1656047633546,MATH 193A,A01,083224,Rotar; Vladimir,1,2,34,33
1656047633546,MATH 193A,A02,083225,Rotar; Vladimir,0,0,34,34
1656047633546,MATH 193A,A03,083781,Rotar; Vladimir,1,0,34,33
1656047633546,MATH 193A,A04,083782,Rotar; Vladimir,3,0,34,31
1656047633546,MATH 193A,A05,093482,Rotar; Vladimir,0,0,34,34
1656047639570,MATH 197,001,091859,McAuley; Julian John,9999,0,9999,0
1656047639570,MATH 197,002,095566,Kedlaya; Kiran S.,9997,0,9999,2
1656047639570,MATH 197,003,095567,Xiao; Ming,9999,0,9999,0
1656047639570,MATH 197,004,095571,Perols; Johan Lars,9998,0,9999,1
1656047646631,COGS 9,A01,083615,Shannon; Kyle Michael,3,1,75,72
1656047652660,COGS 11,A01,083617,Boyle; Mary E. T.,11,2,48,37
1656047658684,COGS 13,A01,083071,Bastos; Amalia Pinkusfeld,4,3,71,67
1656047664800,COGS 14A,A01,092681,Semenuks; Arturs,4,25,100,96
1656047670829,COGS 14B,A01,083073,Cheng; Tzu-Han,7,0,63,56
1656047676852,COGS 17,A01,092677,Semenuks; Arturs,8,7,81,73
1656047682876,COGS 100,A01,083619,Allen; Michael Gordon,3,2,70,67
1656047688904,COGS 101A,A01,083621,Davis; Joshua Daniel,4,3,68,64
1656047694927,COGS 101B,A01,091572,Allen; Michael Gordon,0,0,65,65
1656047700950,COGS 101C,A01,083625,Delgado; Tania,7,0,35,28
1656047706974,COGS 107A,A01,083627,Boyle; Mary E. T.,1,2,60,59
1656047713001,COGS 118A,A01,083075,Gupta; Anjum,21,16,76,55
1656047719028,CSE 3,A50,083646,Miranda; Gregory Joseph,14,0,50,36
1656047725056,CSE 8A,A50,083650,Miranda; Gregory Joseph,4,11,56,52
1656047731079,CSE 11,A01,083080,Cao; Yingjun,0,64,40,40
1656047737111,CSE 12,A01,083652,Krause-Levy; Sophia Louisa,7,8,120,113
1656047743137,CSE 15L,A01,083654,Morris; Justin Loren,3,1,50,47
1656047743137,CSE 15L,A02,083655,Morris; Justin Loren,2,1,50,48
1656047749161,CSE 20,A01,083657,Tran; Khoa Dang,29,0,80,51
1656047755186,CSE 21,A01,095574,Bach; Quang Tran,23,0,48,25
1656047761212,CSE 30,A01,083084,Eldon; John,2,10,80,78
1656047761212,CSE 30,B01,095061,Bhaskar; Nishant,2,5,50,48
1656047767234,CSE 100,A01,083659,Cao; Yingjun,2,25,70,68
1656047773258,CSE 134B,A01,083661,Powell; Thomas Allan,6,6,100,94
1656047779284,CSE 140,A01,083663,Gungor; Onat,6,0,85,79
1656047785306,CSE 140L,A01,083088,Eldon; John,5,0,100,95
1656047791327,CSE 175,A01,083665,Kumar; Rakesh,0,0,25,25
1656047797356,CSE 190,A00,092507,Dubnov; Shlomo,1,0,20,19
1656047803383,ECE 45,A01,083139,Congero; Spencer William,1,2,75,74
1656047809407,ECE 65,A50,083695,Saad; Andrew S,6,0,30,24
1656047809407,ECE 65,A51,095125,Staff,23,0,26,3
1656047815429,ECE 109,A01,091882,Touri; Behrouz,3,5,70,67
1656047821454,ECE 180,A00,083140,Abi Samra; Nicholas Camill,1,0,30,29
1656047821454,ECE 180,B00,083141,Abi Samra; Nicholas Camill,0,8,28,28
1656047827486,MATH 10A,A01,083735,Patchell; Gregory David,0,0,30,30
1656047827486,MATH 10A,A02,083736,Patchell; Gregory David,20,0,30,10
1656047827486,MATH 10A,A03,083737,Patchell; Gregory David,16,0,30,14
1656047833511,MATH 10B,A01,083207,Lim; Seonhee,1,1,34,33
1656047833511,MATH 10B,A02,083208,Lim; Seonhee,1,1,35,34
1656047833511,MATH 10B,A03,093472,Staff,0,1,34,34
1656047833511,MATH 10B,B01,083739,Sinha; Shubham,10,0,30,20
1656047839538,MATH 18,A01,083743,Cinel; Cameron Alexander,5,0,30,25
1656047839538,MATH 18,A02,083744,Cinel; Cameron Alexander,11,0,30,19
1656047839538,MATH 18,A03,083745,Cinel; Cameron Alexander,1,0,30,29
1656047839538,MATH 18,B01,083748,Ma; Zilu,0,0,36,36
1656047839538,MATH 18,B02,083749,Ma; Zilu,0,0,36,36
1656047839538,MATH 18,B03,083750,Ma; Zilu,0,0,36,36
1656047839538,MATH 18,B04,083751,Ma; Zilu,0,0,36,36
1656047839538,MATH 18,B05,093473,Staff,0,0,36,36
1656047839538,MATH 18,B06,093474,Staff,3,0,36,33
1656047845576,MATH 20A,A01,083754,Zheng; Zequn,11,0,40,29
1656047851601,MATH 20B,A01,083756,Briones; Jor-el Thomas Caparas,0,0,36,36
1656047851601,MATH 20B,A02,083757,Briones; Jor-el Thomas Caparas,0,0,36,36
1656047851601,MATH 20B,A03,093475,Staff,0,0,36,36
1656047857628,MATH 20C,A01,083760,Briones; Jor-el Thomas Caparas,0,2,35,35
1656047857628,MATH 20C,A02,083761,Briones; Jor-el Thomas Caparas,6,1,35,29
1656047857628,MATH 20C,A03,093476,Staff,0,1,35,35
1656047857628,MATH 20C,B01,083762,Bach; Quang Tran,3,0,30,27
1656047863655,MATH 20D,A01,083765,Tran; Brian Kha,2,0,30,28
1656047863655,MATH 20D,A02,083766,Tran; Brian Kha,0,1,30,30
1656047863655,MATH 20D,A03,083767,Tran; Brian Kha,0,0,30,30
1656047869684,MATH 20E,A01,083771,Ganguly; Soumya,0,1,32,32
1656047869684,MATH 20E,A02,083772,Ganguly; Soumya,1,1,32,31
1656047869684,MATH 20E,B01,083773,Ciotti; Benjamin,13,0,35,22
1656047869684,MATH 20E,B02,083774,Ciotti; Benjamin,13,0,35,22
1656047875707,MATH 103A,A01,083777,Greenfeld; Be'Eri,2,1,36,34
1656047875707,MATH 103A,A02,083778,Greenfeld; Be'Eri,2,0,36,34
1656047875707,MATH 103A,A03,093561,Staff,0,1,36,36
1656047875707,MATH 103A,B01,083779,Greenfeld; Be'Eri,8,1,36,28
1656047875707,MATH 103A,B02,083780,Greenfeld; Be'Eri,0,0,36,36
1656047875707,MATH 103A,B03,093562,Staff,0,0,36,36
1656047881732,MATH 105,A01,085443,Carter; Anne Toulson,4,1,35,31
1656047881732,MATH 105,A02,093477,Staff,9,0,35,26
1656047887756,MATH 109,A01,083213,Ganzberger; Geoffrey Michael,0,1,34,34
1656047887756,MATH 109,A02,083214,Ganzberger; Geoffrey Michael,0,0,34,34
1656047887756,MATH 109,A03,093478,Staff,1,0,34,33
1656047887756,MATH 109,B01,083215,Ganzberger; Geoffrey Michael,2,0,32,30
1656047887756,MATH 109,B02,083216,Ganzberger; Geoffrey Michael,0,0,32,32
1656047887756,MATH 109,B03,093479,Staff,3,0,32,29
1656047893785,MATH 142A,A01,083219,Chow; Bennett,1,0,32,31
1656047893785,MATH 142A,A02,083220,Chow; Bennett,7,0,32,25
1656047893785,MATH 142A,A03,093480,Staff,4,0,32,28
1656047893785,MATH 142A,B03,093481,Staff,4,0,32,28
1656047893785,MATH 142A,B04,093558,Staff,5,0,32,27
1656047893785,MATH 142A,B05,093559,Staff,0,0,32,32
1656047899814,MATH 193A,A01,083224,Rotar; Vladimir,1,2,34,33
1656047899814,MATH 193A,A02,083225,Rotar; Vladimir,0,0,34,34
1656047899814,MATH 193A,A03,083781,Rotar; Vladimir,1,0,34,33
1656047899814,MATH 193A,A04,083782,Rotar; Vladimir,3,0,34,31
1656047899814,MATH 193A,A05,093482,Rotar; Vladimir,0,0,34,34
1656047905837,MATH 197,001,091859,McAuley; Julian John,9999,0,9999,0
1656047905837,MATH 197,002,095566,Kedlaya; Kiran S.,9997,0,9999,2
1656047905837,MATH 197,003,095567,Xiao; Ming,9999,0,9999,0
1656047905837,MATH 197,004,095571,Perols; Johan Lars,9998,0,9999,1
1656047912892,COGS 9,A01,083615,Shannon; Kyle Michael,3,1,75,72
1656047918916,COGS 11,A01,083617,Boyle; Mary E. T.,11,2,48,37
1656047924950,COGS 13,A01,083071,Bastos; Amalia Pinkusfeld,4,3,71,67
1656047930974,COGS 14A,A01,092681,Semenuks; Arturs,4,25,100,96
1656047936998,COGS 14B,A01,083073,Cheng; Tzu-Han,7,0,63,56
1656047943024,COGS 17,A01,092677,Semenuks; Arturs,8,7,81,73
1656047949047,COGS 100,A01,083619,Allen; Michael Gordon,3,2,70,67
1656047955076,COGS 101A,A01,083621,Davis; Joshua Daniel,4,3,68,64
1656047961099,COGS 101B,A01,091572,Allen; Michael Gordon,0,0,65,65
1656047967122,COGS 101C,A01,083625,Delgado; Tania,7,0,35,28
1656047973145,COGS 107A,A01,083627,Boyle; Mary E. T.,1,2,60,59
1656047979170,COGS 118A,A01,083075,Gupta; Anjum,21,16,76,55
1656047985199,CSE 3,A50,083646,Miranda; Gregory Joseph,14,0,50,36
1656047991222,CSE 8A,A50,083650,Miranda; Gregory Joseph,4,11,56,52
1656047997248,CSE 11,A01,083080,Cao; Yingjun,0,64,40,40
1656048003281,CSE 12,A01,083652,Krause-Levy; Sophia Louisa,7,8,120,113
1656048009305,CSE 15L,A01,083654,Morris; Justin Loren,3,1,50,47
1656048009305,CSE 15L,A02,083655,Morris; Justin Loren,2,1,50,48
1656048015328,CSE 20,A01,083657,Tran; Khoa Dang,29,0,80,51
1656048021354,CSE 21,A01,095574,Bach; Quang Tran,23,0,48,25
1656048027378,CSE 30,A01,083084,Eldon; John,2,10,80,78
1656048027378,CSE 30,B01,095061,Bhaskar; Nishant,2,5,50,48
1656048033402,CSE 100,A01,083659,Cao; Yingjun,2,25,70,68
1656048039427,CSE 134B,A01,083661,Powell; Thomas Allan,6,6,100,94
1656048045454,CSE 140,A01,083663,Gungor; Onat,6,0,85,79
1656048051486,CSE 140L,A01,083088,Eldon; John,5,0,100,95
1656048057511,CSE 175,A01,083665,Kumar; Rakesh,0,0,25,25
1656048063534,CSE 190,A00,092507,Dubnov; Shlomo,1,0,20,19
1656048069563,ECE 45,A01,083139,Congero; Spencer William,1,2,75,74
1656048075591,ECE 65,A50,083695,Saad; Andrew S,6,0,30,24
1656048075591,ECE 65,A51,095125,Staff,23,0,26,3
1656048081614,ECE 109,A01,091882,Touri; Behrouz,3,5,70,67
1656048087637,ECE 180,A00,083140,Abi Samra; Nicholas Camill,1,0,30,29
1656048087637,ECE 180,B00,083141,Abi Samra; Nicholas Camill,0,8,28,28
1656048093662,MATH 10A,A01,083735,Patchell; Gregory David,0,0,30,30
1656048093662,MATH 10A,A02,083736,Patchell; Gregory David,20,0,30,10
1656048093662,MATH 10A,A03,083737,Patchell; Gregory David,16,0,30,14
1656048099687,MATH 10B,A01,083207,Lim; Seonhee,1,1,34,33
1656048099687,MATH 10B,A02,083208,Lim; Seonhee,1,1,35,34
1656048099687,MATH 10B,A03,093472,Staff,0,1,34,34
1656048099687,MATH 10B,B01,083739,Sinha; Shubham,10,0,30,20
1656048105719,MATH 18,A01,083743,Cinel; Cameron Alexander,5,0,30,25
1656048105719,MATH 18,A02,083744,Cinel; Cameron Alexander,11,0,30,19
1656048105719,MATH 18,A03,083745,Cinel; Cameron Alexander,1,0,30,29
1656048105719,MATH 18,B01,083748,Ma; Zilu,0,0,36,36
1656048105719,MATH 18,B02,083749,Ma; Zilu,0,0,36,36
1656048105719,MATH 18,B03,083750,Ma; Zilu,0,0,36,36
1656048105719,MATH 18,B04,083751,Ma; Zilu,0,0,36,36
1656048105719,MATH 18,B05,093473,Staff,0,0,36,36
1656048105719,MATH 18,B06,093474,Staff,3,0,36,33
1656048111746,MATH 20A,A01,083754,Zheng; Zequn,11,0,40,29
1656048117771,MATH 20B,A01,083756,Briones; Jor-el Thomas Caparas,0,0,36,36
1656048117771,MATH 20B,A02,083757,Briones; Jor-el Thomas Caparas,0,0,36,36
1656048117771,MATH 20B,A03,093475,Staff,0,0,36,36
1656048123795,MATH 20C,A01,083760,Briones; Jor-el Thomas Caparas,0,2,35,35
1656048123795,MATH 20C,A02,083761,Briones; Jor-el Thomas Caparas,6,1,35,29
1656048123795,MATH 20C,A03,093476,Staff,0,1,35,35
1656048123795,MATH 20C,B01,083762,Bach; Quang Tran,3,0,30,27
1656048129823,MATH 20D,A01,083765,Tran; Brian Kha,2,0,30,28
1656048129823,MATH 20D,A02,083766,Tran; Brian Kha,0,1,30,30
1656048129823,MATH 20D,A03,083767,Tran; Brian Kha,0,0,30,30
1656048135847,MATH 20E,A01,083771,Ganguly; Soumya,0,1,32,32
1656048135847,MATH 20E,A02,083772,Ganguly; Soumya,1,1,32,31
1656048135847,MATH 20E,B01,083773,Ciotti; Benjamin,13,0,35,22
1656048135847,MATH 20E,B02,083774,Ciotti; Benjamin,13,0,35,22
1656048141876,MATH 103A,A01,083777,Greenfeld; Be'Eri,2,1,36,34
1656048141876,MATH 103A,A02,083778,Greenfeld; Be'Eri,2,0,36,34
1656048141876,MATH 103A,A03,093561,Staff,0,1,36,36
1656048141876,MATH 103A,B01,083779,Greenfeld; Be'Eri,8,1,36,28
1656048141876,MATH 103A,B02,083780,Greenfeld; Be'Eri,0,0,36,36
1656048141876,MATH 103A,B03,093562,Staff,0,0,36,36
1656048147906,MATH 105,A01,085443,Carter; Anne Toulson,4,1,35,31
1656048147906,MATH 105,A02,093477,Staff,9,0,35,26
1656048153931,MATH 109,A01,083213,Ganzberger; Geoffrey Michael,0,1,34,34
1656048153931,MATH 109,A02,083214,Ganzberger; Geoffrey Michael,0,0,34,34
1656048153931,MATH 109,A03,093478,Staff,1,0,34,33
1656048153931,MATH 109,B01,083215,Ganzberger; Geoffrey Michael,2,0,32,30
1656048153931,MATH 109,B02,083216,Ganzberger; Geoffrey Michael,0,0,32,32
1656048153931,MATH 109,B03,093479,Staff,3,0,32,29
1656048159962,MATH 142A,A01,083219,Chow; Bennett,1,0,32,31
1656048159962,MATH 142A,A02,083220,Chow; Bennett,7,0,32,25
1656048159962,MATH 142A,A03,093480,Staff,4,0,32,28
1656048159962,MATH 142A,B03,093481,Staff,4,0,32,28
1656048159962,MATH 142A,B04,093558,Staff,5,0,32,27
1656048159962,MATH 142A,B05,093559,Staff,0,0,32,32
1656048165989,MATH 193A,A01,083224,Rotar; Vladimir,1,2,34,33
1656048165989,MATH 193A,A02,083225,Rotar; Vladimir,0,0,34,34
1656048165989,MATH 193A,A03,083781,Rotar; Vladimir,1,0,34,33
1656048165989,MATH 193A,A04,083782,Rotar; Vladimir,3,0,34,31
1656048165989,MATH 193A,A05,093482,Rotar; Vladimir,0,0,34,34
1656048172015,MATH 197,001,091859,McAuley; Julian John,9999,0,9999,0
1656048172015,MATH 197,002,095566,Kedlaya; Kiran S.,9997,0,9999,2
1656048172015,MATH 197,003,095567,Xiao; Ming,9999,0,9999,0
1656048172015,MATH 197,004,095571,Perols; Johan Lars,9998,0,9999,1
1656048179073,COGS 9,A01,083615,Shannon; Kyle Michael,3,1,75,72
1656048185102,COGS 11,A01,083617,Boyle; Mary E. T.,11,2,48,37
1656048191129,COGS 13,A01,083071,Bastos; Amalia Pinkusfeld,4,3,71,67
1656048197155,COGS 14A,A01,092681,Semenuks; Arturs,4,25,100,96
1656048203179,COGS 14B,A01,083073,Cheng; Tzu-Han,7,0,63,56
1656048209206,COGS 17,A01,092677,Semenuks; Arturs,9,7,81,72
1656048215233,COGS 100,A01,083619,Allen; Michael Gordon,3,2,70,67
1656048221261,COGS 101A,A01,083621,Davis; Joshua Daniel,4,3,68,64
1656048227295,COGS 101B,A01,091572,Allen; Michael Gordon,0,0,65,65
1656048233324,COGS 101C,A01,083625,Delgado; Tania,7,0,35,28
1656048239350,COGS 107A,A01,083627,Boyle; Mary E. T.,1,2,60,59
1656048245372,COGS 118A,A01,083075,Gupta; Anjum,21,16,76,55
1656048251401,CSE 3,A50,083646,Miranda; Gregory Joseph,14,0,50,36
1656048257425,CSE 8A,A50,083650,Miranda; Gregory Joseph,4,11,56,52
1656048263527,CSE 11,A01,083080,Cao; Yingjun,0,64,40,40
1656048269551,CSE 12,A01,083652,Krause-Levy; Sophia Louisa,7,8,120,113
1656048275578,CSE 15L,A01,083654,Morris; Justin Loren,3,1,50,47
1656048275578,CSE 15L,A02,083655,Morris; Justin Loren,2,1,50,48
1656048281601,CSE 20,A01,083657,Tran; Khoa Dang,29,0,80,51
1656048287626,CSE 21,A01,095574,Bach; Quang Tran,23,0,48,25
1656048293660,CSE 30,A01,083084,Eldon; John,2,10,80,78
1656048293660,CSE 30,B01,095061,Bhaskar; Nishant,2,5,50,48
1656048299691,CSE 100,A01,083659,Cao; Yingjun,2,25,70,68
1656048305719,CSE 134B,A01,083661,Powell; Thomas Allan,6,6,100,94
1656048311753,CSE 140,A01,083663,Gungor; Onat,6,0,85,79
1656048317776,CSE 140L,A01,083088,Eldon; John,5,0,100,95
1656048323800,CSE 175,A01,083665,Kumar; Rakesh,0,0,25,25
1656048329832,CSE 190,A00,092507,Dubnov; Shlomo,1,0,20,19
1656048335859,ECE 45,A01,083139,Congero; Spencer William,1,2,75,74
1656048341882,ECE 65,A50,083695,Saad; Andrew S,6,0,30,24
1656048341882,ECE 65,A51,095125,Staff,23,0,26,3
1656048347907,ECE 109,A01,091882,Touri; Behrouz,3,5,70,67
1656048353935,ECE 180,A00,083140,Abi Samra; Nicholas Camill,1,0,30,29
1656048353935,ECE 180,B00,083141,Abi Samra; Nicholas Camill,0,8,28,28
1656048359963,MATH 10A,A01,083735,Patchell; Gregory David,0,0,30,30
1656048359963,MATH 10A,A02,083736,Patchell; Gregory David,20,0,30,10
1656048359963,MATH 10A,A03,083737,Patchell; Gregory David,16,0,30,14
1656048365988,MATH 10B,A01,083207,Lim; Seonhee,1,1,34,33
1656048365988,MATH 10B,A02,083208,Lim; Seonhee,1,1,35,34
1656048365988,MATH 10B,A03,093472,Staff,0,1,34,34
1656048365988,MATH 10B,B01,083739,Sinha; Shubham,10,0,30,20
1656048372013,MATH 18,A01,083743,Cinel; Cameron Alexander,5,0,30,25
1656048372013,MATH 18,A02,083744,Cinel; Cameron Alexander,11,0,30,19
1656048372013,MATH 18,A03,083745,Cinel; Cameron Alexander,1,0,30,29
1656048372013,MATH 18,B01,083748,Ma; Zilu,0,0,36,36
1656048372013,MATH 18,B02,083749,Ma; Zilu,0,0,36,36
1656048372013,MATH 18,B03,083750,Ma; Zilu,0,0,36,36
1656048372013,MATH 18,B04,083751,Ma; Zilu,0,0,36,36
1656048372013,MATH 18,B05,093473,Staff,0,0,36,36
1656048372013,MATH 18,B06,093474,Staff,3,0,36,33
1656048378037,MATH 20A,A01,083754,Zheng; Zequn,11,0,40,29
1656048384065,MATH 20B,A01,083756,Briones; Jor-el Thomas Caparas,0,0,36,36
1656048384065,MATH 20B,A02,083757,Briones; Jor-el Thomas Caparas,0,0,36,36
1656048384065,MATH 20B,A03,093475,Staff,0,0,36,36
1656048390089,MATH 20C,A01,083760,Briones; Jor-el Thomas Caparas,0,2,35,35
1656048390089,MATH 20C,A02,083761,Briones; Jor-el Thomas Caparas,6,1,35,29
1656048390089,MATH 20C,A03,093476,Staff,0,1,35,35
1656048390089,MATH 20C,B01,083762,Bach; Quang Tran,3,0,30,27
1656048396119,MATH 20D,A01,083765,Tran; Brian Kha,2,0,30,28
1656048396119,MATH 20D,A02,083766,Tran; Brian Kha,0,1,30,30
1656048396119,MATH 20D,A03,083767,Tran; Brian Kha,0,0,30,30
1656048402149,MATH 20E,A01,083771,Ganguly; Soumya,0,1,32,32
1656048402149,MATH 20E,A02,083772,Ganguly; Soumya,1,1,32,31
1656048402149,MATH 20E,B01,083773,Ciotti; Benjamin,13,0,35,22
1656048402149,MATH 20E,B02,083774,Ciotti; Benjamin,13,0,35,22
1656048408180,MATH 103A,A01,083777,Greenfeld; Be'Eri,2,1,36,34
1656048408180,MATH 103A,A02,083778,Greenfeld; Be'Eri,2,0,36,34
1656048408180,MATH 103A,A03,093561,Staff,0,1,36,36
1656048408180,MATH 103A,B01,083779,Greenfeld; Be'Eri,8,1,36,28
1656048408180,MATH 103A,B02,083780,Greenfeld; Be'Eri,0,0,36,36
1656048408180,MATH 103A,B03,093562,Staff,0,0,36,36
1656048414206,MATH 105,A01,085443,Carter; Anne Toulson,4,1,35,31
1656048414206,MATH 105,A02,093477,Staff,9,0,35,26
1656048420232,MATH 109,A01,083213,Ganzberger; Geoffrey Michael,0,1,34,34
1656048420232,MATH 109,A02,083214,Ganzberger; Geoffrey Michael,0,0,34,34
1656048420232,MATH 109,A03,093478,Staff,1,0,34,33
1656048420232,MATH 109,B01,083215,Ganzberger; Geoffrey Michael,2,0,32,30
1656048420232,MATH 109,B02,083216,Ganzberger; Geoffrey Michael,0,0,32,32
1656048420232,MATH 109,B03,093479,Staff,3,0,32,29
1656048426268,MATH 142A,A01,083219,Chow; Bennett,1,0,32,31
1656048426268,MATH 142A,A02,083220,Chow; Bennett,7,0,32,25
1656048426268,MATH 142A,A03,093480,Staff,4,0,32,28
1656048426268,MATH 142A,B03,093481,Staff,4,0,32,28
1656048426268,MATH 142A,B04,093558,Staff,5,0,32,27
1656048426268,MATH 142A,B05,093559,Staff,0,0,32,32
1656048432292,MATH 193A,A01,083224,Rotar; Vladimir,1,2,34,33
1656048432292,MATH 193A,A02,083225,Rotar; Vladimir,0,0,34,34
1656048432292,MATH 193A,A03,083781,Rotar; Vladimir,1,0,34,33
1656048432292,MATH 193A,A04,083782,Rotar; Vladimir,3,0,34,31
1656048432292,MATH 193A,A05,093482,Rotar; Vladimir,0,0,34,34
1656048438317,MATH 197,001,091859,McAuley; Julian John,9999,0,9999,0
1656048438317,MATH 197,002,095566,Kedlaya; Kiran S.,9997,0,9999,2
1656048438317,MATH 197,003,095567,Xiao; Ming,9999,0,9999,0
1656048438317,MATH 197,004,095571,Perols; Johan Lars,9998,0,9999,1
1656048445370,COGS 9,A01,083615,Shannon; Kyle Michael,3,1,75,72
1656048451392,COGS 11,A01,083617,Boyle; Mary E. T.,11,2,48,37
1656048457418,COGS 13,A01,083071,Bastos; Amalia Pinkusfeld,4,3,71,67
1656048463447,COGS 14A,A01,092681,Semenuks; Arturs,4,25,100,96
1656048469468,COGS 14B,A01,083073,Cheng; Tzu-Han,7,0,63,56
1656048475503,COGS 17,A01,092677,Semenuks; Arturs,9,7,81,72
1656048481526,COGS 100,A01,083619,Allen; Michael Gordon,3,2,70,67
1656048487553,COGS 101A,A01,083621,Davis; Joshua Daniel,4,3,68,64
1656048493576,COGS 101B,A01,091572,Allen; Michael Gordon,0,0,65,65
1656048499602,COGS 101C,A01,083625,Delgado; Tania,7,0,35,28
1656048505630,COGS 107A,A01,083627,Boyle; Mary E. T.,1,2,60,59
1656048511656,COGS 118A,A01,083075,Gupta; Anjum,21,16,76,55
1656048517680,CSE 3,A50,083646,Miranda; Gregory Joseph,14,0,50,36
1656048523704,CSE 8A,A50,083650,Miranda; Gregory Joseph,4,11,56,52
1656048529729,CSE 11,A01,083080,Cao; Yingjun,0,64,40,40
1656048535754,CSE 12,A01,083652,Krause-Levy; Sophia Louisa,7,8,120,113
1656048541783,CSE 15L,A01,083654,Morris; Justin Loren,3,1,50,47
1656048541783,CSE 15L,A02,083655,Morris; Justin Loren,2,1,50,48
1656048547807,CSE 20,A01,083657,Tran; Khoa Dang,29,0,80,51
1656048553832,CSE 21,A01,095574,Bach; Quang Tran,23,0,48,25
1656048559854,CSE 30,A01,083084,Eldon; John,2,10,80,78
1656048559854,CSE 30,B01,095061,Bhaskar; Nishant,2,5,50,48
1656048565879,CSE 100,A01,083659,Cao; Yingjun,2,25,70,68
1656048571910,CSE 134B,A01,083661,Powell; Thomas Allan,6,6,100,94
1656048577958,CSE 140,A01,083663,Gungor; Onat,6,0,85,79
1656048583982,CSE 140L,A01,083088,Eldon; John,5,0,100,95
1656048590008,CSE 175,A01,083665,Kumar; Rakesh,0,0,25,25
1656048596030,CSE 190,A00,092507,Dubnov; Shlomo,1,0,20,19
1656048602053,ECE 45,A01,083139,Congero; Spencer William,1,2,75,74
1656048608075,ECE 65,A50,083695,Saad; Andrew S,6,0,30,24
1656048608075,ECE 65,A51,095125,Staff,23,0,26,3
1656048614102,ECE 109,A01,091882,Touri; Behrouz,3,5,70,67
1656048620126,ECE 180,A00,083140,Abi Samra; Nicholas Camill,1,0,30,29
1656048620126,ECE 180,B00,083141,Abi Samra; Nicholas Camill,0,8,28,28
1656048626151,MATH 10A,A01,083735,Patchell; Gregory David,0,0,30,30
1656048626151,MATH 10A,A02,083736,Patchell; Gregory David,20,0,30,10
1656048626151,MATH 10A,A03,083737,Patchell; Gregory David,16,0,30,14
1656048632175,MATH 10B,A01,083207,Lim; Seonhee,1,1,34,33
1656048632175,MATH 10B,A02,083208,Lim; Seonhee,1,1,35,34
1656048632175,MATH 10B,A03,093472,Staff,0,1,34,34
1656048632175,MATH 10B,B01,083739,Sinha; Shubham,10,0,30,20
1656048638201,MATH 18,A01,083743,Cinel; Cameron Alexander,5,0,30,25
1656048638201,MATH 18,A02,083744,Cinel; Cameron Alexander,11,0,30,19
1656048638201,MATH 18,A03,083745,Cinel; Cameron Alexander,1,0,30,29
1656048638201,MATH 18,B01,083748,Ma; Zilu,0,0,36,36
1656048638201,MATH 18,B02,083749,Ma; Zilu,0,0,36,36
1656048638201,MATH 18,B03,083750,Ma; Zilu,0,0,36,36
1656048638201,MATH 18,B04,083751,Ma; Zilu,0,0,36,36
1656048638201,MATH 18,B05,093473,Staff,0,0,36,36
1656048638201,MATH 18,B06,093474,Staff,3,0,36,33
1656048644227,MATH 20A,A01,083754,Zheng; Zequn,11,0,40,29
1656048650254,MATH 20B,A01,083756,Briones; Jor-el Thomas Caparas,0,0,36,36
1656048650254,MATH 20B,A02,083757,Briones; Jor-el Thomas Caparas,0,0,36,36
1656048650254,MATH 20B,A03,093475,Staff,0,0,36,36
1656048656278,MATH 20C,A01,083760,Briones; Jor-el Thomas Caparas,0,2,35,35
1656048656278,MATH 20C,A02,083761,Briones; Jor-el Thomas Caparas,6,1,35,29
1656048656278,MATH 20C,A03,093476,Staff,0,1,35,35
1656048656278,MATH 20C,B01,083762,Bach; Quang Tran,3,0,30,27
1656048662302,MATH 20D,A01,083765,Tran; Brian Kha,2,0,30,28
1656048662302,MATH 20D,A02,083766,Tran; Brian Kha,0,1,30,30
1656048662302,MATH 20D,A03,083767,Tran; Brian Kha,0,0,30,30
1656048668325,MATH 20E,A01,083771,Ganguly; Soumya,0,1,32,32
1656048668325,MATH 20E,A02,083772,Ganguly; Soumya,1,1,32,31
1656048668325,MATH 20E,B01,083773,Ciotti; Benjamin,13,0,35,22
1656048668325,MATH 20E,B02,083774,Ciotti; Benjamin,13,0,35,22
1656048674357,MATH 103A,A01,083777,Greenfeld; Be'Eri,2,1,36,34
1656048674357,MATH 103A,A02,083778,Greenfeld; Be'Eri,2,0,36,34
1656048674357,MATH 103A,A03,093561,Staff,0,1,36,36
1656048674357,MATH 103A,B01,083779,Greenfeld; Be'Eri,8,1,36,28
1656048674357,MATH 103A,B02,083780,Greenfeld; Be'Eri,0,0,36,36
1656048674357,MATH 103A,B03,093562,Staff,0,0,36,36
1656048680390,MATH 105,A01,085443,Carter; Anne Toulson,4,1,35,31
1656048680390,MATH 105,A02,093477,Staff,9,0,35,26
1656048686414,MATH 109,A01,083213,Ganzberger; Geoffrey Michael,0,1,34,34
1656048686414,MATH 109,A02,083214,Ganzberger; Geoffrey Michael,0,0,34,34
1656048686414,MATH 109,A03,093478,Staff,1,0,34,33
1656048686414,MATH 109,B01,083215,Ganzberger; Geoffrey Michael,2,0,32,30
1656048686414,MATH 109,B02,083216,Ganzberger; Geoffrey Michael,0,0,32,32
1656048686414,MATH 109,B03,093479,Staff,3,0,32,29
1656048692439,MATH 142A,A01,083219,Chow; Bennett,1,0,32,31
1656048692439,MATH 142A,A02,083220,Chow; Bennett,7,0,32,25
1656048692439,MATH 142A,A03,093480,Staff,4,0,32,28
1656048692439,MATH 142A,B03,093481,Staff,4,0,32,28
1656048692439,MATH 142A,B04,093558,Staff,5,0,32,27
1656048692439,MATH 142A,B05,093559,Staff,0,0,32,32
1656048698470,MATH 193A,A01,083224,Rotar; Vladimir,1,2,34,33
1656048698470,MATH 193A,A02,083225,Rotar; Vladimir,0,0,34,34
1656048698470,MATH 193A,A03,083781,Rotar; Vladimir,1,0,34,33
1656048698470,MATH 193A,A04,083782,Rotar; Vladimir,3,0,34,31
1656048698470,MATH 193A,A05,093482,Rotar; Vladimir,0,0,34,34
1656048704507,MATH 197,001,091859,McAuley; Julian John,9999,0,9999,0
1656048704507,MATH 197,002,095566,Kedlaya; Kiran S.,9997,0,9999,2
1656048704507,MATH 197,003,095567,Xiao; Ming,9999,0,9999,0
1656048704507,MATH 197,004,095571,Perols; Johan Lars,9998,0,9999,1
1656048711563,COGS 9,A01,083615,Shannon; Kyle Michael,3,1,75,72
1656048717586,COGS 11,A01,083617,Boyle; Mary E. T.,11,2,48,37
1656048723610,COGS 13,A01,083071,Bastos; Amalia Pinkusfeld,4,3,71,67
1656048729634,COGS 14A,A01,092681,Semenuks; Arturs,4,25,100,96
1656048735672,COGS 14B,A01,083073,Cheng; Tzu-Han,7,0,63,56
1656048741695,COGS 17,A01,092677,Semenuks; Arturs,9,7,81,72
1656048747722,COGS 100,A01,083619,Allen; Michael Gordon,3,2,70,67
1656048753745,COGS 101A,A01,083621,Davis; Joshua Daniel,4,3,68,64
1656048759774,COGS 101B,A01,091572,Allen; Michael Gordon,0,0,65,65
1656048765798,COGS 101C,A01,083625,Delgado; Tania,7,0,35,28
1656048771832,COGS 107A,A01,083627,Boyle; Mary E. T.,1,2,60,59
1656048777863,COGS 118A,A01,083075,Gupta; Anjum,21,16,76,55
1656048783888,CSE 3,A50,083646,Miranda; Gregory Joseph,14,0,50,36
1656048789915,CSE 8A,A50,083650,Miranda; Gregory Joseph,4,11,56,52
1656048795942,CSE 11,A01,083080,Cao; Yingjun,0,64,40,40
1656048801967,CSE 12,A01,083652,Krause-Levy; Sophia Louisa,7,8,120,113
1656048807995,CSE 15L,A01,083654,Morris; Justin Loren,3,1,50,47
1656048807995,CSE 15L,A02,083655,Morris; Justin Loren,2,1,50,48
1656048814018,CSE 20,A01,083657,Tran; Khoa Dang,29,0,80,51
1656048820046,CSE 21,A01,095574,Bach; Quang Tran,23,0,48,25
1656048826074,CSE 30,A01,083084,Eldon; John,2,10,80,78
1656048826074,CSE 30,B01,095061,Bhaskar; Nishant,2,5,50,48
1656048832099,CSE 100,A01,083659,Cao; Yingjun,2,25,70,68
1656048838126,CSE 134B,A01,083661,Powell; Thomas Allan,6,6,100,94
1656048844152,CSE 140,A01,083663,Gungor; Onat,6,0,85,79
1656048850179,CSE 140L,A01,083088,Eldon; John,5,0,100,95
1656048856207,CSE 175,A01,083665,Kumar; Rakesh,0,0,25,25
1656048862300,CSE 190,A00,092507,Dubnov; Shlomo,1,0,20,19
1656048868333,ECE 45,A01,083139,Congero; Spencer William,1,2,75,74
1656048874357,ECE 65,A50,083695,Saad; Andrew S,6,0,30,24
1656048874357,ECE 65,A51,095125,Staff,23,0,26,3
1656048880380,ECE 109,A01,091882,Touri; Behrouz,3,5,70,67
1656048886403,ECE 180,A00,083140,Abi Samra; Nicholas Camill,1,0,30,29
1656048886403,ECE 180,B00,083141,Abi Samra; Nicholas Camill,0,8,28,28
1656048892426,MATH 10A,A01,083735,Patchell; Gregory David,0,0,30,30
1656048892426,MATH 10A,A02,083736,Patchell; Gregory David,20,0,30,10
1656048892426,MATH 10A,A03,083737,Patchell; Gregory David,16,0,30,14
1656048898454,MATH 10B,A01,083207,Lim; Seonhee,1,1,34,33
1656048898454,MATH 10B,A02,083208,Lim; Seonhee,1,1,35,34
1656048898454,MATH 10B,A03,093472,Staff,0,1,34,34
1656048898454,MATH 10B,B01,083739,Sinha; Shubham,10,0,30,20
1656048904482,MATH 18,A01,083743,Cinel; Cameron Alexander,5,0,30,25
1656048904482,MATH 18,A02,083744,Cinel; Cameron Alexander,11,0,30,19
1656048904482,MATH 18,A03,083745,Cinel; Cameron Alexander,1,0,30,29
1656048904482,MATH 18,B01,083748,Ma; Zilu,0,0,36,36
1656048904482,MATH 18,B02,083749,Ma; Zilu,0,0,36,36
1656048904482,MATH 18,B03,083750,Ma; Zilu,0,0,36,36
1656048904482,MATH 18,B04,083751,Ma; Zilu,0,0,36,36
1656048904482,MATH 18,B05,093473,Staff,0,0,36,36
1656048904482,MATH 18,B06,093474,Staff,3,0,36,33
1656048910507,MATH 20A,A01,083754,Zheng; Zequn,11,0,40,29
1656048916532,MATH 20B,A01,083756,Briones; Jor-el Thomas Caparas,0,0,36,36
1656048916532,MATH 20B,A02,083757,Briones; Jor-el Thomas Caparas,0,0,36,36
1656048916532,MATH 20B,A03,093475,Staff,0,0,36,36
1656048922559,MATH 20C,A01,083760,Briones; Jor-el Thomas Caparas,0,2,35,35
1656048922559,MATH 20C,A02,083761,Briones; Jor-el Thomas Caparas,6,1,35,29
1656048922559,MATH 20C,A03,093476,Staff,0,1,35,35
1656048922559,MATH 20C,B01,083762,Bach; Quang Tran,3,0,30,27
1656048928593,MATH 20D,A01,083765,Tran; Brian Kha,2,0,30,28
1656048928593,MATH 20D,A02,083766,Tran; Brian Kha,0,1,30,30
1656048928593,MATH 20D,A03,083767,Tran; Brian Kha,0,0,30,30
1656048934624,MATH 20E,A01,083771,Ganguly; Soumya,0,1,32,32
1656048934624,MATH 20E,A02,083772,Ganguly; Soumya,1,1,32,31
1656048934624,MATH 20E,B01,083773,Ciotti; Benjamin,13,0,35,22
1656048934624,MATH 20E,B02,083774,Ciotti; Benjamin,13,0,35,22
1656048940649,MATH 103A,A01,083777,Greenfeld; Be'Eri,2,1,36,34
1656048940649,MATH 103A,A02,083778,Greenfeld; Be'Eri,2,0,36,34
1656048940649,MATH 103A,A03,093561,Staff,0,1,36,36
1656048940649,MATH 103A,B01,083779,Greenfeld; Be'Eri,8,1,36,28
1656048940649,MATH 103A,B02,083780,Greenfeld; Be'Eri,0,0,36,36
1656048940649,MATH 103A,B03,093562,Staff,0,0,36,36
1656048946675,MATH 105,A01,085443,Carter; Anne Toulson,4,1,35,31
1656048946675,MATH 105,A02,093477,Staff,9,0,35,26
1656048952709,MATH 109,A01,083213,Ganzberger; Geoffrey Michael,0,1,34,34
1656048952709,MATH 109,A02,083214,Ganzberger; Geoffrey Michael,0,0,34,34
1656048952709,MATH 109,A03,093478,Staff,1,0,34,33
1656048952709,MATH 109,B01,083215,Ganzberger; Geoffrey Michael,2,0,32,30
1656048952709,MATH 109,B02,083216,Ganzberger; Geoffrey Michael,0,0,32,32
1656048952709,MATH 109,B03,093479,Staff,3,0,32,29
1656048958743,MATH 142A,A01,083219,Chow; Bennett,1,0,32,31
1656048958743,MATH 142A,A02,083220,Chow; Bennett,7,0,32,25
1656048958743,MATH 142A,A03,093480,Staff,4,0,32,28
1656048958743,MATH 142A,B03,093481,Staff,4,0,32,28
1656048958743,MATH 142A,B04,093558,Staff,5,0,32,27
1656048958743,MATH 142A,B05,093559,Staff,0,0,32,32
1656048964786,MATH 193A,A01,083224,Rotar; Vladimir,1,2,34,33
1656048964786,MATH 193A,A02,083225,Rotar; Vladimir,0,0,34,34
1656048964786,MATH 193A,A03,083781,Rotar; Vladimir,1,0,34,33
1656048964786,MATH 193A,A04,083782,Rotar; Vladimir,3,0,34,31
1656048964786,MATH 193A,A05,093482,Rotar; Vladimir,0,0,34,34
1656048970819,MATH 197,001,091859,McAuley; Julian John,9999,0,9999,0
1656048970819,MATH 197,002,095566,Kedlaya; Kiran S.,9997,0,9999,2
1656048970819,MATH 197,003,095567,Xiao; Ming,9999,0,9999,0
1656048970819,MATH 197,004,095571,Perols; Johan Lars,9998,0,9999,1
1656048977873,COGS 9,A01,083615,Shannon; Kyle Michael,3,1,75,72
1656048983896,COGS 11,A01,083617,Boyle; Mary E. T.,11,2,48,37
1656048989922,COGS 13,A01,083071,Bastos; Amalia Pinkusfeld,4,3,71,67
1656048995963,COGS 14A,A01,092681,Semenuks; Arturs,4,25,100,96
1656049001993,COGS 14B,A01,083073,Cheng; Tzu-Han,7,0,63,56
1656049008016,COGS 17,A01,092677,Semenuks; Arturs,9,7,81,72
1656049014043,COGS 100,A01,083619,Allen; Michael Gordon,3,2,70,67
1656049020065,COGS 101A,A01,083621,Davis; Joshua Daniel,4,3,68,64
1656049026091,COGS 101B,A01,091572,Allen; Michael Gordon,0,0,65,65
1656049032119,COGS 101C,A01,083625,Delgado; Tania,7,0,35,28
1656049038150,COGS 107A,A01,083627,Boyle; Mary E. T.,1,2,60,59
1656049044177,COGS 118A,A01,083075,Gupta; Anjum,21,16,76,55
1656049050201,CSE 3,A50,083646,Miranda; Gregory Joseph,14,0,50,36
1656049056238,CSE 8A,A50,083650,Miranda; Gregory Joseph,4,11,56,52
1656049062265,CSE 11,A01,083080,Cao; Yingjun,0,64,40,40
1656049068289,CSE 12,A01,083652,Krause-Levy; Sophia Louisa,7,8,120,113
1656049074315,CSE 15L,A01,083654,Morris; Justin Loren,3,1,50,47
1656049074315,CSE 15L,A02,083655,Morris; Justin Loren,2,1,50,48
1656049080348,CSE 20,A01,083657,Tran; Khoa Dang,29,0,80,51
1656049086371,CSE 21,A01,095574,Bach; Quang Tran,23,0,48,25
1656049092397,CSE 30,A01,083084,Eldon; John,2,10,80,78
1656049092397,CSE 30,B01,095061,Bhaskar; Nishant,2,5,50,48
1656049098424,CSE 100,A01,083659,Cao; Yingjun,2,25,70,68
1656049104452,CSE 134B,A01,083661,Powell; Thomas Allan,6,6,100,94
1656049110476,CSE 140,A01,083663,Gungor; Onat,6,0,85,79
1656049116500,CSE 140L,A01,083088,Eldon; John,5,0,100,95
1656049122523,CSE 175,A01,083665,Kumar; Rakesh,0,0,25,25
1656049128546,CSE 190,A00,092507,Dubnov; Shlomo,1,0,20,19
1656049134578,ECE 45,A01,083139,Congero; Spencer William,1,2,75,74
1656049140601,ECE 65,A50,083695,Saad; Andrew S,6,0,30,24
1656049140601,ECE 65,A51,095125,Staff,23,0,26,3
1656049146627,ECE 109,A01,091882,Touri; Behrouz,3,5,70,67
1656049152650,ECE 180,A00,083140,Abi Samra; Nicholas Camill,1,0,30,29
1656049152650,ECE 180,B00,083141,Abi Samra; Nicholas Camill,0,8,28,28
1656049158678,MATH 10A,A01,083735,Patchell; Gregory David,0,0,30,30
1656049158678,MATH 10A,A02,083736,Patchell; Gregory David,20,0,30,10
1656049158678,MATH 10A,A03,083737,Patchell; Gregory David,16,0,30,14
1656049164702,MATH 10B,A01,083207,Lim; Seonhee,1,1,34,33
1656049164702,MATH 10B,A02,083208,Lim; Seonhee,1,1,35,34
1656049164702,MATH 10B,A03,093472,Staff,0,1,34,34
1656049164702,MATH 10B,B01,083739,Sinha; Shubham,10,0,30,20
1656049170738,MATH 18,A01,083743,Cinel; Cameron Alexander,5,0,30,25
1656049170738,MATH 18,A02,083744,Cinel; Cameron Alexander,11,0,30,19
1656049170738,MATH 18,A03,083745,Cinel; Cameron Alexander,1,0,30,29
1656049170738,MATH 18,B01,083748,Ma; Zilu,0,0,36,36
1656049170738,MATH 18,B02,083749,Ma; Zilu,0,0,36,36
1656049170738,MATH 18,B03,083750,Ma; Zilu,0,0,36,36
1656049170738,MATH 18,B04,083751,Ma; Zilu,0,0,36,36
1656049170738,MATH 18,B05,093473,Staff,0,0,36,36
1656049170738,MATH 18,B06,093474,Staff,3,0,36,33
1656049176761,MATH 20A,A01,083754,Zheng; Zequn,11,0,40,29
1656049182784,MATH 20B,A01,083756,Briones; Jor-el Thomas Caparas,0,0,36,36
1656049182784,MATH 20B,A02,083757,Briones; Jor-el Thomas Caparas,0,0,36,36
1656049182784,MATH 20B,A03,093475,Staff,0,0,36,36
1656049188807,MATH 20C,A01,083760,Briones; Jor-el Thomas Caparas,0,2,35,35
1656049188807,MATH 20C,A02,083761,Briones; Jor-el Thomas Caparas,6,1,35,29
1656049188807,MATH 20C,A03,093476,Staff,0,1,35,35
1656049188807,MATH 20C,B01,083762,Bach; Quang Tran,3,0,30,27
1656049194832,MATH 20D,A01,083765,Tran; Brian Kha,2,0,30,28
1656049194832,MATH 20D,A02,083766,Tran; Brian Kha,0,1,30,30
1656049194832,MATH 20D,A03,083767,Tran; Brian Kha,0,0,30,30
1656049200856,MATH 20E,A01,083771,Ganguly; Soumya,0,1,32,32
1656049200856,MATH 20E,A02,083772,Ganguly; Soumya,1,1,32,31
1656049200856,MATH 20E,B01,083773,Ciotti; Benjamin,13,0,35,22
1656049200856,MATH 20E,B02,083774,Ciotti; Benjamin,13,0,35,22
1656049206881,MATH 103A,A01,083777,Greenfeld; Be'Eri,2,1,36,34
1656049206881,MATH 103A,A02,083778,Greenfeld; Be'Eri,2,0,36,34
1656049206881,MATH 103A,A03,093561,Staff,0,1,36,36
1656049206881,MATH 103A,B01,083779,Greenfeld; Be'Eri,8,1,36,28
1656049206881,MATH 103A,B02,083780,Greenfeld; Be'Eri,0,0,36,36
1656049206881,MATH 103A,B03,093562,Staff,0,0,36,36
1656049212906,MATH 105,A01,085443,Carter; Anne Toulson,4,1,35,31
1656049212906,MATH 105,A02,093477,Staff,9,0,35,26
1656049218934,MATH 109,A01,083213,Ganzberger; Geoffrey Michael,0,1,34,34
1656049218934,MATH 109,A02,083214,Ganzberger; Geoffrey Michael,0,0,34,34
1656049218934,MATH 109,A03,093478,Staff,1,0,34,33
1656049218934,MATH 109,B01,083215,Ganzberger; Geoffrey Michael,2,0,32,30
1656049218934,MATH 109,B02,083216,Ganzberger; Geoffrey Michael,0,0,32,32
1656049218934,MATH 109,B03,093479,Staff,3,0,32,29
1656049224959,MATH 142A,A01,083219,Chow; Bennett,1,0,32,31
1656049224959,MATH 142A,A02,083220,Chow; Bennett,7,0,32,25
1656049224959,MATH 142A,A03,093480,Staff,4,0,32,28
1656049224959,MATH 142A,B03,093481,Staff,4,0,32,28
1656049224959,MATH 142A,B04,093558,Staff,5,0,32,27
1656049224959,MATH 142A,B05,093559,Staff,0,0,32,32
1656049230998,MATH 193A,A01,083224,Rotar; Vladimir,1,2,34,33
1656049230998,MATH 193A,A02,083225,Rotar; Vladimir,0,0,34,34
1656049230998,MATH 193A,A03,083781,Rotar; Vladimir,1,0,34,33
1656049230998,MATH 193A,A04,083782,Rotar; Vladimir,3,0,34,31
1656049230998,MATH 193A,A05,093482,Rotar; Vladimir,0,0,34,34
1656049237024,MATH 197,001,091859,McAuley; Julian John,9999,0,9999,0
1656049237024,MATH 197,002,095566,Kedlaya; Kiran S.,9997,0,9999,2
1656049237024,MATH 197,003,095567,Xiao; Ming,9999,0,9999,0
1656049237024,MATH 197,004,095571,Perols; Johan Lars,9998,0,9999,1
1656049244100,COGS 9,A01,083615,Shannon; Kyle Michael,3,1,75,72
1656049250124,COGS 11,A01,083617,Boyle; Mary E. T.,11,2,48,37
1656049256151,COGS 13,A01,083071,Bastos; Amalia Pinkusfeld,4,3,71,67
1656049262185,COGS 14A,A01,092681,Semenuks; Arturs,4,25,100,96
1656049268209,COGS 14B,A01,083073,Cheng; Tzu-Han,7,0,63,56
1656049274233,COGS 17,A01,092677,Semenuks; Arturs,9,7,81,72
1656049280258,COGS 100,A01,083619,Allen; Michael Gordon,3,2,70,67
1656049286284,COGS 101A,A01,083621,Davis; Joshua Daniel,4,3,68,64
1656049292311,COGS 101B,A01,091572,Allen; Michael Gordon,0,0,65,65
1656049298342,COGS 101C,A01,083625,Delgado; Tania,7,0,35,28
1656049304373,COGS 107A,A01,083627,Boyle; Mary E. T.,1,2,60,59
1656049310396,COGS 118A,A01,083075,Gupta; Anjum,21,16,76,55
1656049316419,CSE 3,A50,083646,Miranda; Gregory Joseph,14,0,50,36
1656049322450,CSE 8A,A50,083650,Miranda; Gregory Joseph,4,11,56,52
1656049328482,CSE 11,A01,083080,Cao; Yingjun,0,64,40,40
1656049334504,CSE 12,A01,083652,Krause-Levy; Sophia Louisa,7,8,120,113
1656049340525,CSE 15L,A01,083654,Morris; Justin Loren,3,1,50,47
1656049340525,CSE 15L,A02,083655,Morris; Justin Loren,2,1,50,48
1656049346556,CSE 20,A01,083657,Tran; Khoa Dang,29,0,80,51
1656049352583,CSE 21,A01,095574,Bach; Quang Tran,23,0,48,25
1656049358607,CSE 30,A01,083084,Eldon; John,2,10,80,78
1656049358607,CSE 30,B01,095061,Bhaskar; Nishant,2,5,50,48
1656049364631,CSE 100,A01,083659,Cao; Yingjun,2,25,70,68
1656049370654,CSE 134B,A01,083661,Powell; Thomas Allan,6,6,100,94
1656049376678,CSE 140,A01,083663,Gungor; Onat,6,0,85,79
1656049382712,CSE 140L,A01,083088,Eldon; John,5,0,100,95
1656049388750,CSE 175,A01,083665,Kumar; Rakesh,0,0,25,25
1656049394778,CSE 190,A00,092507,Dubnov; Shlomo,1,0,20,19
1656049400804,ECE 45,A01,083139,Congero; Spencer William,1,2,75,74
1656049406833,ECE 65,A50,083695,Saad; Andrew S,6,0,30,24
1656049406833,ECE 65,A51,095125,Staff,23,0,26,3
1656049412858,ECE 109,A01,091882,Touri; Behrouz,3,5,70,67
1656049418885,ECE 180,A00,083140,Abi Samra; Nicholas Camill,1,0,30,29
1656049418885,ECE 180,B00,083141,Abi Samra; Nicholas Camill,0,8,28,28
1656049424912,MATH 10A,A01,083735,Patchell; Gregory David,0,0,30,30
1656049424912,MATH 10A,A02,083736,Patchell; Gregory David,20,0,30,10
1656049424912,MATH 10A,A03,083737,Patchell; Gregory David,16,0,30,14
1656049430941,MATH 10B,A01,083207,Lim; Seonhee,1,1,34,33
1656049430941,MATH 10B,A02,083208,Lim; Seonhee,1,1,35,34
1656049430941,MATH 10B,A03,093472,Staff,0,1,34,34
1656049430941,MATH 10B,B01,083739,Sinha; Shubham,10,0,30,20
1656049436965,MATH 18,A01,083743,Cinel; Cameron Alexander,5,0,30,25
1656049436965,MATH 18,A02,083744,Cinel; Cameron Alexander,11,0,30,19
1656049436965,MATH 18,A03,083745,Cinel; Cameron Alexander,1,0,30,29
1656049436965,MATH 18,B01,083748,Ma; Zilu,0,0,36,36
1656049436965,MATH 18,B02,083749,Ma; Zilu,0,0,36,36
1656049436965,MATH 18,B03,083750,Ma; Zilu,0,0,36,36
1656049436965,MATH 18,B04,083751,Ma; Zilu,0,0,36,36
1656049436965,MATH 18,B05,093473,Staff,0,0,36,36
1656049436965,MATH 18,B06,093474,Staff,3,0,36,33
1656049442992,MATH 20A,A01,083754,Zheng; Zequn,11,0,40,29
1656049449020,MATH 20B,A01,083756,Briones; Jor-el Thomas Caparas,0,0,36,36
1656049449020,MATH 20B,A02,083757,Briones; Jor-el Thomas Caparas,0,0,36,36
1656049449020,MATH 20B,A03,093475,Staff,0,0,36,36
1656049455045,MATH 20C,A01,083760,Briones; Jor-el Thomas Caparas,0,2,35,35
1656049455045,MATH 20C,A02,083761,Briones; Jor-el Thomas Caparas,6,1,35,29
1656049455045,MATH 20C,A03,093476,Staff,0,1,35,35
1656049455045,MATH 20C,B01,083762,Bach; Quang Tran,3,0,30,27
1656049461164,MATH 20D,A01,083765,Tran; Brian Kha,2,0,30,28
1656049461164,MATH 20D,A02,083766,Tran; Brian Kha,0,1,30,30
1656049461164,MATH 20D,A03,083767,Tran; Brian Kha,0,0,30,30
1656049467195,MATH 20E,A01,083771,Ganguly; Soumya,0,1,32,32
1656049467195,MATH 20E,A02,083772,Ganguly; Soumya,1,1,32,31
1656049467195,MATH 20E,B01,083773,Ciotti; Benjamin,13,0,35,22
1656049467195,MATH 20E,B02,083774,Ciotti; Benjamin,13,0,35,22
1656049473226,MATH 103A,A01,083777,Greenfeld; Be'Eri,2,1,36,34
1656049473226,MATH 103A,A02,083778,Greenfeld; Be'Eri,2,0,36,34
1656049473226,MATH 103A,A03,093561,Staff,0,1,36,36
1656049473226,MATH 103A,B01,083779,Greenfeld; Be'Eri,8,1,36,28
1656049473226,MATH 103A,B02,083780,Greenfeld; Be'Eri,0,0,36,36
1656049473226,MATH 103A,B03,093562,Staff,0,0,36,36
1656049479249,MATH 105,A01,085443,Carter; Anne Toulson,4,1,35,31
1656049479249,MATH 105,A02,093477,Staff,9,0,35,26
1656049485288,MATH 109,A01,083213,Ganzberger; Geoffrey Michael,0,1,34,34
1656049485288,MATH 109,A02,083214,Ganzberger; Geoffrey Michael,0,0,34,34
1656049485288,MATH 109,A03,093478,Staff,1,0,34,33
1656049485288,MATH 109,B01,083215,Ganzberger; Geoffrey Michael,2,0,32,30
1656049485288,MATH 109,B02,083216,Ganzberger; Geoffrey Michael,0,0,32,32
1656049485288,MATH 109,B03,093479,Staff,3,0,32,29
1656049491313,MATH 142A,A01,083219,Chow; Bennett,1,0,32,31
1656049491313,MATH 142A,A02,083220,Chow; Bennett,7,0,32,25
1656049491313,MATH 142A,A03,093480,Staff,4,0,32,28
1656049491313,MATH 142A,B03,093481,Staff,4,0,32,28
1656049491313,MATH 142A,B04,093558,Staff,5,0,32,27
1656049491313,MATH 142A,B05,093559,Staff,0,0,32,32
1656049497337,MATH 193A,A01,083224,Rotar; Vladimir,1,2,34,33
1656049497337,MATH 193A,A02,083225,Rotar; Vladimir,0,0,34,34
1656049497337,MATH 193A,A03,083781,Rotar; Vladimir,1,0,34,33
1656049497337,MATH 193A,A04,083782,Rotar; Vladimir,3,0,34,31
1656049497337,MATH 193A,A05,093482,Rotar; Vladimir,0,0,34,34
1656049503360,MATH 197,001,091859,McAuley; Julian John,9999,0,9999,0
1656049503360,MATH 197,002,095566,Kedlaya; Kiran S.,9997,0,9999,2
1656049503360,MATH 197,003,095567,Xiao; Ming,9999,0,9999,0
1656049503360,MATH 197,004,095571,Perols; Johan Lars,9998,0,9999,1
1656049510420,COGS 9,A01,083615,Shannon; Kyle Michael,3,1,75,72
1656049516442,COGS 11,A01,083617,Boyle; Mary E. T.,11,2,48,37
1656049522464,COGS 13,A01,083071,Bastos; Amalia Pinkusfeld,4,3,71,67
1656049528487,COGS 14A,A01,092681,Semenuks; Arturs,4,25,100,96
1656049534514,COGS 14B,A01,083073,Cheng; Tzu-Han,7,0,63,56
1656049540539,COGS 17,A01,092677,Semenuks; Arturs,9,7,81,72
1656049546564,COGS 100,A01,083619,Allen; Michael Gordon,3,2,70,67
1656049552587,COGS 101A,A01,083621,Davis; Joshua Daniel,4,3,68,64
1656049558611,COGS 101B,A01,091572,Allen; Michael Gordon,0,0,65,65
1656049564636,COGS 101C,A01,083625,Delgado; Tania,7,0,35,28
1656049570662,COGS 107A,A01,083627,Boyle; Mary E. T.,1,2,60,59
1656049576701,COGS 118A,A01,083075,Gupta; Anjum,21,16,76,55
1656049582725,CSE 3,A50,083646,Miranda; Gregory Joseph,14,0,50,36
1656049588748,CSE 8A,A50,083650,Miranda; Gregory Joseph,4,11,56,52
1656049594771,CSE 11,A01,083080,Cao; Yingjun,0,64,40,40
1656049600795,CSE 12,A01,083652,Krause-Levy; Sophia Louisa,7,8,120,113
1656049606818,CSE 15L,A01,083654,Morris; Justin Loren,3,1,50,47
1656049606818,CSE 15L,A02,083655,Morris; Justin Loren,2,1,50,48
1656049612842,CSE 20,A01,083657,Tran; Khoa Dang,29,0,80,51
1656049618867,CSE 21,A01,095574,Bach; Quang Tran,23,0,48,25
1656049624889,CSE 30,A01,083084,Eldon; John,2,10,80,78
1656049624889,CSE 30,B01,095061,Bhaskar; Nishant,2,5,50,48
1656049630916,CSE 100,A01,083659,Cao; Yingjun,2,25,70,68
1656049636943,CSE 134B,A01,083661,Powell; Thomas Allan,6,6,100,94
1656049642976,CSE 140,A01,083663,Gungor; Onat,6,0,85,79
1656049649003,CSE 140L,A01,083088,Eldon; John,5,0,100,95
1656049655028,CSE 175,A01,083665,Kumar; Rakesh,0,0,25,25
1656049661056,CSE 190,A00,092507,Dubnov; Shlomo,1,0,20,19
1656049667081,ECE 45,A01,083139,Congero; Spencer William,1,2,75,74
1656049673117,ECE 65,A50,083695,Saad; Andrew S,6,0,30,24
1656049673117,ECE 65,A51,095125,Staff,23,0,26,3
1656049679143,ECE 109,A01,091882,Touri; Behrouz,3,5,70,67
1656049685171,ECE 180,A00,083140,Abi Samra; Nicholas Camill,1,0,30,29
1656049685171,ECE 180,B00,083141,Abi Samra; Nicholas Camill,0,8,28,28
1656049691193,MATH 10A,A01,083735,Patchell; Gregory David,0,0,30,30
1656049691193,MATH 10A,A02,083736,Patchell; Gregory David,20,0,30,10
1656049691193,MATH 10A,A03,083737,Patchell; Gregory David,16,0,30,14
1656049697221,MATH 10B,A01,083207,Lim; Seonhee,1,1,34,33
1656049697221,MATH 10B,A02,083208,Lim; Seonhee,1,1,35,34
1656049697221,MATH 10B,A03,093472,Staff,0,1,34,34
1656049697221,MATH 10B,B01,083739,Sinha; Shubham,10,0,30,20
1656049703254,MATH 18,A01,083743,Cinel; Cameron Alexander,5,0,30,25
1656049703254,MATH 18,A02,083744,Cinel; Cameron Alexander,11,0,30,19
1656049703254,MATH 18,A03,083745,Cinel; Cameron Alexander,1,0,30,29
1656049703254,MATH 18,B01,083748,Ma; Zilu,0,0,36,36
1656049703254,MATH 18,B02,083749,Ma; Zilu,0,0,36,36
1656049703254,MATH 18,B03,083750,Ma; Zilu,0,0,36,36
1656049703254,MATH 18,B04,083751,Ma; Zilu,0,0,36,36
1656049703254,MATH 18,B05,093473,Staff,0,0,36,36
1656049703254,MATH 18,B06,093474,Staff,3,0,36,33
1656049709282,MATH 20A,A01,083754,Zheng; Zequn,11,0,40,29
1656049715308,MATH 20B,A01,083756,Briones; Jor-el Thomas Caparas,0,0,36,36
1656049715308,MATH 20B,A02,083757,Briones; Jor-el Thomas Caparas,0,0,36,36
1656049715308,MATH 20B,A03,093475,Staff,0,0,36,36
1656049721331,MATH 20C,A01,083760,Briones; Jor-el Thomas Caparas,0,2,35,35
1656049721331,MATH 20C,A02,083761,Briones; Jor-el Thomas Caparas,6,1,35,29
1656049721331,MATH 20C,A03,093476,Staff,0,1,35,35
1656049721331,MATH 20C,B01,083762,Bach; Quang Tran,3,0,30,27
1656049727354,MATH 20D,A01,083765,Tran; Brian Kha,2,0,30,28
1656049727354,MATH 20D,A02,083766,Tran; Brian Kha,0,1,30,30
1656049727354,MATH 20D,A03,083767,Tran; Brian Kha,0,0,30,30
1656049733394,MATH 20E,A01,083771,Ganguly; Soumya,0,1,32,32
1656049733394,MATH 20E,A02,083772,Ganguly; Soumya,1,1,32,31
1656049733394,MATH 20E,B01,083773,Ciotti; Benjamin,13,0,35,22
1656049733394,MATH 20E,B02,083774,Ciotti; Benjamin,13,0,35,22
1656049739425,MATH 103A,A01,083777,Greenfeld; Be'Eri,2,1,36,34
1656049739425,MATH 103A,A02,083778,Greenfeld; Be'Eri,2,0,36,34
1656049739425,MATH 103A,A03,093561,Staff,0,1,36,36
1656049739425,MATH 103A,B01,083779,Greenfeld; Be'Eri,8,1,36,28
1656049739425,MATH 103A,B02,083780,Greenfeld; Be'Eri,0,0,36,36
1656049739425,MATH 103A,B03,093562,Staff,0,0,36,36
1656049745453,MATH 105,A01,085443,Carter; Anne Toulson,4,1,35,31
1656049745453,MATH 105,A02,093477,Staff,9,0,35,26
1656049751478,MATH 109,A01,083213,Ganzberger; Geoffrey Michael,0,1,34,34
1656049751478,MATH 109,A02,083214,Ganzberger; Geoffrey Michael,0,0,34,34
1656049751478,MATH 109,A03,093478,Staff,1,0,34,33
1656049751478,MATH 109,B01,083215,Ganzberger; Geoffrey Michael,2,0,32,30
1656049751478,MATH 109,B02,083216,Ganzberger; Geoffrey Michael,0,0,32,32
1656049751478,MATH 109,B03,093479,Staff,3,0,32,29
1656049757500,MATH 142A,A01,083219,Chow; Bennett,1,0,32,31
1656049757500,MATH 142A,A02,083220,Chow; Bennett,7,0,32,25
1656049757500,MATH 142A,A03,093480,Staff,4,0,32,28
1656049757500,MATH 142A,B03,093481,Staff,4,0,32,28
1656049757500,MATH 142A,B04,093558,Staff,6,0,32,26
1656049757500,MATH 142A,B05,093559,Staff,0,0,32,32
1656049763529,MATH 193A,A01,083224,Rotar; Vladimir,1,2,34,33
1656049763529,MATH 193A,A02,083225,Rotar; Vladimir,0,0,34,34
1656049763529,MATH 193A,A03,083781,Rotar; Vladimir,1,0,34,33
1656049763529,MATH 193A,A04,083782,Rotar; Vladimir,3,0,34,31
1656049763529,MATH 193A,A05,093482,Rotar; Vladimir,0,0,34,34
1656049769551,MATH 197,001,091859,McAuley; Julian John,9999,0,9999,0
1656049769551,MATH 197,002,095566,Kedlaya; Kiran S.,9997,0,9999,2
1656049769551,MATH 197,003,095567,Xiao; Ming,9999,0,9999,0
1656049769551,MATH 197,004,095571,Perols; Johan Lars,9998,0,9999,1
1656049776604,COGS 9,A01,083615,Shannon; Kyle Michael,3,1,75,72
1656049782641,COGS 11,A01,083617,Boyle; Mary E. T.,11,2,48,37
1656049788668,COGS 13,A01,083071,Bastos; Amalia Pinkusfeld,4,3,71,67
1656049794692,COGS 14A,A01,092681,Semenuks; Arturs,4,25,100,96
1656049800716,COGS 14B,A01,083073,Cheng; Tzu-Han,7,0,63,56
1656049806745,COGS 17,A01,092677,Semenuks; Arturs,9,7,81,72
1656049812768,COGS 100,A01,083619,Allen; Michael Gordon,3,2,70,67
1656049818796,COGS 101A,A01,083621,Davis; Joshua Daniel,4,3,68,64
1656049824821,COGS 101B,A01,091572,Allen; Michael Gordon,0,0,65,65
1656049830847,COGS 101C,A01,083625,Delgado; Tania,7,0,35,28
1656049836871,COGS 107A,A01,083627,Boyle; Mary E. T.,1,2,60,59
1656049842894,COGS 118A,A01,083075,Gupta; Anjum,21,16,76,55
1656049848916,CSE 3,A50,083646,Miranda; Gregory Joseph,14,0,50,36
1656049854944,CSE 8A,A50,083650,Miranda; Gregory Joseph,4,11,56,52
1656049860968,CSE 11,A01,083080,Cao; Yingjun,0,64,40,40
1656049866991,CSE 12,A01,083652,Krause-Levy; Sophia Louisa,7,8,120,113
1656049873015,CSE 15L,A01,083654,Morris; Justin Loren,3,1,50,47
1656049873015,CSE 15L,A02,083655,Morris; Justin Loren,2,1,50,48
1656049879043,CSE 20,A01,083657,Tran; Khoa Dang,29,0,80,51
1656049885072,CSE 21,A01,095574,Bach; Quang Tran,23,0,48,25
1656049891099,CSE 30,A01,083084,Eldon; John,2,10,80,78
1656049891099,CSE 30,B01,095061,Bhaskar; Nishant,2,5,50,48
1656049897123,CSE 100,A01,083659,Cao; Yingjun,2,25,70,68
1656049903150,CSE 134B,A01,083661,Powell; Thomas Allan,6,6,100,94
1656049909174,CSE 140,A01,083663,Gungor; Onat,6,0,85,79
1656049915201,CSE 140L,A01,083088,Eldon; John,5,0,100,95
1656049921223,CSE 175,A01,083665,Kumar; Rakesh,0,0,25,25
1656049927249,CSE 190,A00,092507,Dubnov; Shlomo,1,0,20,19
1656049933289,ECE 45,A01,083139,Congero; Spencer William,1,2,75,74
1656049939312,ECE 65,A50,083695,Saad; Andrew S,6,0,30,24
1656049939312,ECE 65,A51,095125,Staff,23,0,26,3
1656049945344,ECE 109,A01,091882,Touri; Behrouz,3,5,70,67
1656049951368,ECE 180,A00,083140,Abi Samra; Nicholas Camill,1,0,30,29
1656049951368,ECE 180,B00,083141,Abi Samra; Nicholas Camill,0,8,28,28
1656049957396,MATH 10A,A01,083735,Patchell; Gregory David,0,0,30,30
1656049957396,MATH 10A,A02,083736,Patchell; Gregory David,20,0,30,10
1656049957396,MATH 10A,A03,083737,Patchell; Gregory David,16,0,30,14
1656049963420,MATH 10B,A01,083207,Lim; Seonhee,1,1,34,33
1656049963420,MATH 10B,A02,083208,Lim; Seonhee,1,1,35,34
1656049963420,MATH 10B,A03,093472,Staff,0,1,34,34
1656049963420,MATH 10B,B01,083739,Sinha; Shubham,10,0,30,20
1656049969446,MATH 18,A01,083743,Cinel; Cameron Alexander,5,0,30,25
1656049969446,MATH 18,A02,083744,Cinel; Cameron Alexander,11,0,30,19
1656049969446,MATH 18,A03,083745,Cinel; Cameron Alexander,1,0,30,29
1656049969446,MATH 18,B01,083748,Ma; Zilu,0,0,36,36
1656049969446,MATH 18,B02,083749,Ma; Zilu,0,0,36,36
1656049969446,MATH 18,B03,083750,Ma; Zilu,0,0,36,36
1656049969446,MATH 18,B04,083751,Ma; Zilu,0,0,36,36
1656049969446,MATH 18,B05,093473,Staff,0,0,36,36
1656049969446,MATH 18,B06,093474,Staff,3,0,36,33
1656049975474,MATH 20A,A01,083754,Zheng; Zequn,11,0,40,29
1656049981500,MATH 20B,A01,083756,Briones; Jor-el Thomas Caparas,0,0,36,36
1656049981500,MATH 20B,A02,083757,Briones; Jor-el Thomas Caparas,0,0,36,36
1656049981500,MATH 20B,A03,093475,Staff,0,0,36,36
1656049987521,MATH 20C,A01,083760,Briones; Jor-el Thomas Caparas,0,2,35,35
1656049987521,MATH 20C,A02,083761,Briones; Jor-el Thomas Caparas,6,1,35,29
1656049987521,MATH 20C,A03,093476,Staff,0,1,35,35
1656049987521,MATH 20C,B01,083762,Bach; Quang Tran,3,0,30,27
1656049993543,MATH 20D,A01,083765,Tran; Brian Kha,2,0,30,28
1656049993543,MATH 20D,A02,083766,Tran; Brian Kha,0,1,30,30
1656049993543,MATH 20D,A03,083767,Tran; Brian Kha,0,0,30,30
1656049999568,MATH 20E,A01,083771,Ganguly; Soumya,0,1,32,32
1656049999568,MATH 20E,A02,083772,Ganguly; Soumya,1,1,32,31
1656049999568,MATH 20E,B01,083773,Ciotti; Benjamin,13,0,35,22
1656049999568,MATH 20E,B02,083774,Ciotti; Benjamin,13,0,35,22
1656050005592,MATH 103A,A01,083777,Greenfeld; Be'Eri,2,1,36,34
1656050005592,MATH 103A,A02,083778,Greenfeld; Be'Eri,2,0,36,34
1656050005592,MATH 103A,A03,093561,Staff,0,1,36,36
1656050005592,MATH 103A,B01,083779,Greenfeld; Be'Eri,8,1,36,28
1656050005592,MATH 103A,B02,083780,Greenfeld; Be'Eri,0,0,36,36
1656050005592,MATH 103A,B03,093562,Staff,0,0,36,36
1656050011615,MATH 105,A01,085443,Carter; Anne Toulson,4,1,35,31
1656050011615,MATH 105,A02,093477,Staff,9,0,35,26
1656050017638,MATH 109,A01,083213,Ganzberger; Geoffrey Michael,0,1,34,34
1656050017638,MATH 109,A02,083214,Ganzberger; Geoffrey Michael,0,0,34,34
1656050017638,MATH 109,A03,093478,Staff,1,0,34,33
1656050017638,MATH 109,B01,083215,Ganzberger; Geoffrey Michael,2,0,32,30
1656050017638,MATH 109,B02,083216,Ganzberger; Geoffrey Michael,0,0,32,32
1656050017638,MATH 109,B03,093479,Staff,3,0,32,29
1656050023662,MATH 142A,A01,083219,Chow; Bennett,1,0,32,31
1656050023662,MATH 142A,A02,083220,Chow; Bennett,7,0,32,25
1656050023662,MATH 142A,A03,093480,Staff,4,0,32,28
1656050023662,MATH 142A,B03,093481,Staff,4,0,32,28
1656050023662,MATH 142A,B04,093558,Staff,6,0,32,26
1656050023662,MATH 142A,B05,093559,Staff,0,0,32,32
1656050029686,MATH 193A,A01,083224,Rotar; Vladimir,1,2,34,33
1656050029686,MATH 193A,A02,083225,Rotar; Vladimir,0,0,34,34
1656050029686,MATH 193A,A03,083781,Rotar; Vladimir,1,0,34,33
1656050029686,MATH 193A,A04,083782,Rotar; Vladimir,3,0,34,31
1656050029686,MATH 193A,A05,093482,Rotar; Vladimir,0,0,34,34
1656050035712,MATH 197,001,091859,McAuley; Julian John,9999,0,9999,0
1656050035712,MATH 197,002,095566,Kedlaya; Kiran S.,9997,0,9999,2
1656050035712,MATH 197,003,095567,Xiao; Ming,9999,0,9999,0
1656050035712,MATH 197,004,095571,Perols; Johan Lars,9998,0,9999,1
1656050042764,COGS 9,A01,083615,Shannon; Kyle Michael,3,1,75,72
1656050048792,COGS 11,A01,083617,Boyle; Mary E. T.,11,2,48,37
1656050054903,COGS 13,A01,083071,Bastos; Amalia Pinkusfeld,4,3,71,67
1656050060929,COGS 14A,A01,092681,Semenuks; Arturs,4,25,100,96
1656050066956,COGS 14B,A01,083073,Cheng; Tzu-Han,7,0,63,56
1656050072986,COGS 17,A01,092677,Semenuks; Arturs,9,7,81,72
1656050079009,COGS 100,A01,083619,Allen; Michael Gordon,3,2,70,67
1656050085037,COGS 101A,A01,083621,Davis; Joshua Daniel,4,3,68,64
1656050091061,COGS 101B,A01,091572,Allen; Michael Gordon,0,0,65,65
1656050097090,COGS 101C,A01,083625,Delgado; Tania,7,0,35,28
1656050103119,COGS 107A,A01,083627,Boyle; Mary E. T.,1,2,60,59
1656050109141,COGS 118A,A01,083075,Gupta; Anjum,21,16,76,55
1656050115166,CSE 3,A50,083646,Miranda; Gregory Joseph,14,0,50,36
1656050121192,CSE 8A,A50,083650,Miranda; Gregory Joseph,4,11,56,52
1656050127215,CSE 11,A01,083080,Cao; Yingjun,0,64,40,40
1656050133237,CSE 12,A01,083652,Krause-Levy; Sophia Louisa,7,8,120,113
1656050139262,CSE 15L,A01,083654,Morris; Justin Loren,3,1,50,47
1656050139262,CSE 15L,A02,083655,Morris; Justin Loren,2,1,50,48
1656050145289,CSE 20,A01,083657,Tran; Khoa Dang,29,0,80,51
1656050151315,CSE 21,A01,095574,Bach; Quang Tran,23,0,48,25
1656050157341,CSE 30,A01,083084,Eldon; John,2,10,80,78
1656050157341,CSE 30,B01,095061,Bhaskar; Nishant,2,5,50,48
1656050163376,CSE 100,A01,083659,Cao; Yingjun,2,25,70,68
1656050169400,CSE 134B,A01,083661,Powell; Thomas Allan,6,6,100,94
1656050175426,CSE 140,A01,083663,Gungor; Onat,6,0,85,79
1656050181448,CSE 140L,A01,083088,Eldon; John,5,0,100,95
1656050187475,CSE 175,A01,083665,Kumar; Rakesh,0,0,25,25
1656050193499,CSE 190,A00,092507,Dubnov; Shlomo,1,0,20,19
1656050199525,ECE 45,A01,083139,Congero; Spencer William,1,2,75,74
1656050205553,ECE 65,A50,083695,Saad; Andrew S,6,0,30,24
1656050205553,ECE 65,A51,095125,Staff,23,0,26,3
1656050211576,ECE 109,A01,091882,Touri; Behrouz,3,5,70,67
1656050217600,ECE 180,A00,083140,Abi Samra; Nicholas Camill,1,0,30,29
1656050217600,ECE 180,B00,083141,Abi Samra; Nicholas Camill,0,8,28,28
1656050223624,MATH 10A,A01,083735,Patchell; Gregory David,0,0,30,30
1656050223624,MATH 10A,A02,083736,Patchell; Gregory David,20,0,30,10
1656050223624,MATH 10A,A03,083737,Patchell; Gregory David,16,0,30,14
1656050229647,MATH 10B,A01,083207,Lim; Seonhee,1,1,34,33
1656050229647,MATH 10B,A02,083208,Lim; Seonhee,1,1,35,34
1656050229647,MATH 10B,A03,093472,Staff,0,1,34,34
1656050229647,MATH 10B,B01,083739,Sinha; Shubham,10,0,30,20
1656050235678,MATH 18,A01,083743,Cinel; Cameron Alexander,5,0,30,25
1656050235678,MATH 18,A02,083744,Cinel; Cameron Alexander,11,0,30,19
1656050235678,MATH 18,A03,083745,Cinel; Cameron Alexander,1,0,30,29
1656050235678,MATH 18,B01,083748,Ma; Zilu,0,0,36,36
1656050235678,MATH 18,B02,083749,Ma; Zilu,0,0,36,36
1656050235678,MATH 18,B03,083750,Ma; Zilu,0,0,36,36
1656050235678,MATH 18,B04,083751,Ma; Zilu,0,0,36,36
1656050235678,MATH 18,B05,093473,Staff,0,0,36,36
1656050235678,MATH 18,B06,093474,Staff,3,0,36,33
1656050241701,MATH 20A,A01,083754,Zheng; Zequn,11,0,40,29
1656050247725,MATH 20B,A01,083756,Briones; Jor-el Thomas Caparas,0,0,36,36
1656050247725,MATH 20B,A02,083757,Briones; Jor-el Thomas Caparas,0,0,36,36
1656050247725,MATH 20B,A03,093475,Staff,0,0,36,36
1656050253749,MATH 20C,A01,083760,Briones; Jor-el Thomas Caparas,0,2,35,35
1656050253749,MATH 20C,A02,083761,Briones; Jor-el Thomas Caparas,6,1,35,29
1656050253749,MATH 20C,A03,093476,Staff,0,1,35,35
1656050253749,MATH 20C,B01,083762,Bach; Quang Tran,3,0,30,27
1656050259776,MATH 20D,A01,083765,Tran; Brian Kha,3,0,30,27
1656050259776,MATH 20D,A02,083766,Tran; Brian Kha,0,1,30,30
1656050259776,MATH 20D,A03,083767,Tran; Brian Kha,0,0,30,30
1656050265802,MATH 20E,A01,083771,Ganguly; Soumya,0,1,32,32
1656050265802,MATH 20E,A02,083772,Ganguly; Soumya,1,1,32,31
1656050265802,MATH 20E,B01,083773,Ciotti; Benjamin,13,0,35,22
1656050265802,MATH 20E,B02,083774,Ciotti; Benjamin,13,0,35,22
1656050271836,MATH 103A,A01,083777,Greenfeld; Be'Eri,2,1,36,34
1656050271836,MATH 103A,A02,083778,Greenfeld; Be'Eri,2,0,36,34
1656050271836,MATH 103A,A03,093561,Staff,0,1,36,36
1656050271836,MATH 103A,B01,083779,Greenfeld; Be'Eri,8,1,36,28
1656050271836,MATH 103A,B02,083780,Greenfeld; Be'Eri,0,0,36,36
1656050271836,MATH 103A,B03,093562,Staff,0,0,36,36
1656050277864,MATH 105,A01,085443,Carter; Anne Toulson,4,1,35,31
1656050277864,MATH 105,A02,093477,Staff,9,0,35,26
1656050283889,MATH 109,A01,083213,Ganzberger; Geoffrey Michael,0,1,34,34
1656050283889,MATH 109,A02,083214,Ganzberger; Geoffrey Michael,0,0,34,34
1656050283889,MATH 109,A03,093478,Staff,1,0,34,33
1656050283889,MATH 109,B01,083215,Ganzberger; Geoffrey Michael,2,0,32,30
1656050283889,MATH 109,B02,083216,Ganzberger; Geoffrey Michael,0,0,32,32
1656050283889,MATH 109,B03,093479,Staff,3,0,32,29
1656050289924,MATH 142A,A01,083219,Chow; Bennett,1,0,32,31
1656050289924,MATH 142A,A02,083220,Chow; Bennett,7,0,32,25
1656050289924,MATH 142A,A03,093480,Staff,4,0,32,28
1656050289924,MATH 142A,B03,093481,Staff,4,0,32,28
1656050289924,MATH 142A,B04,093558,Staff,6,0,32,26
1656050289924,MATH 142A,B05,093559,Staff,0,0,32,32
1656050295953,MATH 193A,A01,083224,Rotar; Vladimir,1,2,34,33
1656050295953,MATH 193A,A02,083225,Rotar; Vladimir,0,0,34,34
1656050295953,MATH 193A,A03,083781,Rotar; Vladimir,1,0,34,33
1656050295953,MATH 193A,A04,083782,Rotar; Vladimir,3,0,34,31
1656050295953,MATH 193A,A05,093482,Rotar; Vladimir,0,0,34,34
1656050301979,MATH 197,001,091859,McAuley; Julian John,9999,0,9999,0
1656050301979,MATH 197,002,095566,Kedlaya; Kiran S.,9997,0,9999,2
1656050301979,MATH 197,003,095567,Xiao; Ming,9999,0,9999,0
1656050301979,MATH 197,004,095571,Perols; Johan Lars,9998,0,9999,1
1656050309035,COGS 9,A01,083615,Shannon; Kyle Michael,3,1,75,72
1656050315058,COGS 11,A01,083617,Boyle; Mary E. T.,11,2,48,37
1656050321104,COGS 13,A01,083071,Bastos; Amalia Pinkusfeld,4,3,71,67
1656050327127,COGS 14A,A01,092681,Semenuks; Arturs,4,25,100,96
1656050333149,COGS 14B,A01,083073,Cheng; Tzu-Han,7,0,63,56
1656050339175,COGS 17,A01,092677,Semenuks; Arturs,9,7,81,72
1656050345199,COGS 100,A01,083619,Allen; Michael Gordon,3,2,70,67
1656050351223,COGS 101A,A01,083621,Davis; Joshua Daniel,4,3,68,64
1656050357246,COGS 101B,A01,091572,Allen; Michael Gordon,0,0,65,65
1656050363272,COGS 101C,A01,083625,Delgado; Tania,7,0,35,28
1656050369299,COGS 107A,A01,083627,Boyle; Mary E. T.,1,2,60,59
1656050375323,COGS 118A,A01,083075,Gupta; Anjum,21,16,76,55
1656050381351,CSE 3,A50,083646,Miranda; Gregory Joseph,14,0,50,36
1656050387375,CSE 8A,A50,083650,Miranda; Gregory Joseph,4,11,56,52
1656050393396,CSE 11,A01,083080,Cao; Yingjun,0,64,40,40
1656050399420,CSE 12,A01,083652,Krause-Levy; Sophia Louisa,7,8,120,113
1656050405446,CSE 15L,A01,083654,Morris; Justin Loren,3,1,50,47
1656050405446,CSE 15L,A02,083655,Morris; Justin Loren,2,1,50,48
1656050411470,CSE 20,A01,083657,Tran; Khoa Dang,29,0,80,51
1656050417494,CSE 21,A01,095574,Bach; Quang Tran,23,0,48,25
1656050423518,CSE 30,A01,083084,Eldon; John,2,10,80,78
1656050423518,CSE 30,B01,095061,Bhaskar; Nishant,2,5,50,48
1656050429541,CSE 100,A01,083659,Cao; Yingjun,2,25,70,68
1656050435565,CSE 134B,A01,083661,Powell; Thomas Allan,6,6,100,94
1656050441592,CSE 140,A01,083663,Gungor; Onat,6,0,85,79
1656050447621,CSE 140L,A01,083088,Eldon; John,5,0,100,95
1656050453652,CSE 175,A01,083665,Kumar; Rakesh,0,0,25,25
1656050459677,CSE 190,A00,092507,Dubnov; Shlomo,1,0,20,19
1656050465703,ECE 45,A01,083139,Congero; Spencer William,1,2,75,74
1656050471728,ECE 65,A50,083695,Saad; Andrew S,6,0,30,24
1656050471728,ECE 65,A51,095125,Staff,23,0,26,3
1656050477754,ECE 109,A01,091882,Touri; Behrouz,3,5,70,67
1656050483785,ECE 180,A00,083140,Abi Samra; Nicholas Camill,1,0,30,29
1656050483785,ECE 180,B00,083141,Abi Samra; Nicholas Camill,0,8,28,28
1656050489809,MATH 10A,A01,083735,Patchell; Gregory David,0,0,30,30
1656050489809,MATH 10A,A02,083736,Patchell; Gregory David,20,0,30,10
1656050489809,MATH 10A,A03,083737,Patchell; Gregory David,16,0,30,14
1656050495839,MATH 10B,A01,083207,Lim; Seonhee,1,1,34,33
1656050495839,MATH 10B,A02,083208,Lim; Seonhee,1,1,35,34
1656050495839,MATH 10B,A03,093472,Staff,0,1,34,34
1656050495839,MATH 10B,B01,083739,Sinha; Shubham,10,0,30,20
1656050501865,MATH 18,A01,083743,Cinel; Cameron Alexander,5,0,30,25
1656050501865,MATH 18,A02,083744,Cinel; Cameron Alexander,11,0,30,19
1656050501865,MATH 18,A03,083745,Cinel; Cameron Alexander,1,0,30,29
1656050501865,MATH 18,B01,083748,Ma; Zilu,0,0,36,36
1656050501865,MATH 18,B02,083749,Ma; Zilu,0,0,36,36
1656050501865,MATH 18,B03,083750,Ma; Zilu,0,0,36,36
1656050501865,MATH 18,B04,083751,Ma; Zilu,0,0,36,36
1656050501865,MATH 18,B05,093473,Staff,0,0,36,36
1656050501865,MATH 18,B06,093474,Staff,3,0,36,33
1656050507890,MATH 20A,A01,083754,Zheng; Zequn,11,0,40,29
1656050513920,MATH 20B,A01,083756,Briones; Jor-el Thomas Caparas,0,0,36,36
1656050513920,MATH 20B,A02,083757,Briones; Jor-el Thomas Caparas,0,0,36,36
1656050513920,MATH 20B,A03,093475,Staff,0,0,36,36
1656050519954,MATH 20C,A01,083760,Briones; Jor-el Thomas Caparas,0,2,35,35
1656050519954,MATH 20C,A02,083761,Briones; Jor-el Thomas Caparas,6,1,35,29
1656050519954,MATH 20C,A03,093476,Staff,0,1,35,35
1656050519954,MATH 20C,B01,083762,Bach; Quang Tran,3,0,30,27
1656050525979,MATH 20D,A01,083765,Tran; Brian Kha,3,0,30,27
1656050525979,MATH 20D,A02,083766,Tran; Brian Kha,0,1,30,30
1656050525979,MATH 20D,A03,083767,Tran; Brian Kha,0,0,30,30
1656050532006,MATH 20E,A01,083771,Ganguly; Soumya,0,1,32,32
1656050532006,MATH 20E,A02,083772,Ganguly; Soumya,1,1,32,31
1656050532006,MATH 20E,B01,083773,Ciotti; Benjamin,13,0,35,22
1656050532006,MATH 20E,B02,083774,Ciotti; Benjamin,13,0,35,22
1656050538037,MATH 103A,A01,083777,Greenfeld; Be'Eri,2,1,36,34
1656050538037,MATH 103A,A02,083778,Greenfeld; Be'Eri,2,0,36,34
1656050538037,MATH 103A,A03,093561,Staff,0,1,36,36
1656050538037,MATH 103A,B01,083779,Greenfeld; Be'Eri,8,1,36,28
1656050538037,MATH 103A,B02,083780,Greenfeld; Be'Eri,0,0,36,36
1656050538037,MATH 103A,B03,093562,Staff,0,0,36,36
1656050544065,MATH 105,A01,085443,Carter; Anne Toulson,4,1,35,31
1656050544065,MATH 105,A02,093477,Staff,9,0,35,26
1656050550093,MATH 109,A01,083213,Ganzberger; Geoffrey Michael,0,1,34,34
1656050550093,MATH 109,A02,083214,Ganzberger; Geoffrey Michael,0,0,34,34
1656050550093,MATH 109,A03,093478,Staff,1,0,34,33
1656050550093,MATH 109,B01,083215,Ganzberger; Geoffrey Michael,2,0,32,30
1656050550093,MATH 109,B02,083216,Ganzberger; Geoffrey Michael,0,0,32,32
1656050550093,MATH 109,B03,093479,Staff,3,0,32,29
1656050556119,MATH 142A,A01,083219,Chow; Bennett,1,0,32,31
1656050556119,MATH 142A,A02,083220,Chow; Bennett,7,0,32,25
1656050556119,MATH 142A,A03,093480,Staff,4,0,32,28
1656050556119,MATH 142A,B03,093481,Staff,4,0,32,28
1656050556119,MATH 142A,B04,093558,Staff,6,0,32,26
1656050556119,MATH 142A,B05,093559,Staff,0,0,32,32
1656050562149,MATH 193A,A01,083224,Rotar; Vladimir,1,2,34,33
1656050562149,MATH 193A,A02,083225,Rotar; Vladimir,0,0,34,34
1656050562149,MATH 193A,A03,083781,Rotar; Vladimir,1,0,34,33
1656050562149,MATH 193A,A04,083782,Rotar; Vladimir,3,0,34,31
1656050562149,MATH 193A,A05,093482,Rotar; Vladimir,0,0,34,34
1656050568176,MATH 197,001,091859,McAuley; Julian John,9999,0,9999,0
1656050568176,MATH 197,002,095566,Kedlaya; Kiran S.,9997,0,9999,2
1656050568176,MATH 197,003,095567,Xiao; Ming,9999,0,9999,0
1656050568176,MATH 197,004,095571,Perols; Johan Lars,9998,0,9999,1
1656050575230,COGS 9,A01,083615,Shannon; Kyle Michael,3,1,75,72
1656050581259,COGS 11,A01,083617,Boyle; Mary E. T.,11,2,48,37
1656050587286,COGS 13,A01,083071,Bastos; Amalia Pinkusfeld,4,3,71,67
1656050593315,COGS 14A,A01,092681,Semenuks; Arturs,4,25,100,96
1656050599344,COGS 14B,A01,083073,Cheng; Tzu-Han,7,0,63,56
1656050605368,COGS 17,A01,092677,Semenuks; Arturs,9,7,81,72
1656050611391,COGS 100,A01,083619,Allen; Michael Gordon,3,2,70,67
1656050617423,COGS 101A,A01,083621,Davis; Joshua Daniel,4,3,68,64
1656050623446,COGS 101B,A01,091572,Allen; Michael Gordon,0,0,65,65
1656050629469,COGS 101C,A01,083625,Delgado; Tania,7,0,35,28
1656050635491,COGS 107A,A01,083627,Boyle; Mary E. T.,1,2,60,59
1656050641513,COGS 118A,A01,083075,Gupta; Anjum,21,16,76,55
1656050647537,CSE 3,A50,083646,Miranda; Gregory Joseph,14,0,50,36
1656050653632,CSE 8A,A50,083650,Miranda; Gregory Joseph,4,11,56,52
1656050659657,CSE 11,A01,083080,Cao; Yingjun,0,64,40,40
1656050665699,CSE 12,A01,083652,Krause-Levy; Sophia Louisa,7,8,120,113
1656050671725,CSE 15L,A01,083654,Morris; Justin Loren,3,1,50,47
1656050671725,CSE 15L,A02,083655,Morris; Justin Loren,2,1,50,48
1656050677756,CSE 20,A01,083657,Tran; Khoa Dang,29,0,80,51
1656050683777,CSE 21,A01,095574,Bach; Quang Tran,23,0,48,25
1656050689805,CSE 30,A01,083084,Eldon; John,2,10,80,78
1656050689805,CSE 30,B01,095061,Bhaskar; Nishant,2,5,50,48
1656050695833,CSE 100,A01,083659,Cao; Yingjun,2,25,70,68
1656050701860,CSE 134B,A01,083661,Powell; Thomas Allan,6,6,100,94
1656050707884,CSE 140,A01,083663,Gungor; Onat,6,0,85,79
1656050713916,CSE 140L,A01,083088,Eldon; John,5,0,100,95
1656050719940,CSE 175,A01,083665,Kumar; Rakesh,0,0,25,25
1656050725974,CSE 190,A00,092507,Dubnov; Shlomo,1,0,20,19
1656050732013,ECE 45,A01,083139,Congero; Spencer William,1,2,75,74
1656050738037,ECE 65,A50,083695,Saad; Andrew S,6,0,30,24
1656050738037,ECE 65,A51,095125,Staff,23,0,26,3
1656050744065,ECE 109,A01,091882,Touri; Behrouz,3,5,70,67
1656050750088,ECE 180,A00,083140,Abi Samra; Nicholas Camill,1,0,30,29
1656050750088,ECE 180,B00,083141,Abi Samra; Nicholas Camill,0,8,28,28
1656050756113,MATH 10A,A01,083735,Patchell; Gregory David,0,0,30,30
1656050756113,MATH 10A,A02,083736,Patchell; Gregory David,20,0,30,10
1656050756113,MATH 10A,A03,083737,Patchell; Gregory David,16,0,30,14
1656050762138,MATH 10B,A01,083207,Lim; Seonhee,1,1,34,33
1656050762138,MATH 10B,A02,083208,Lim; Seonhee,1,1,35,34
1656050762138,MATH 10B,A03,093472,Staff,0,1,34,34
1656050762138,MATH 10B,B01,083739,Sinha; Shubham,10,0,30,20
1656050768177,MATH 18,A01,083743,Cinel; Cameron Alexander,5,0,30,25
1656050768177,MATH 18,A02,083744,Cinel; Cameron Alexander,11,0,30,19
1656050768177,MATH 18,A03,083745,Cinel; Cameron Alexander,1,0,30,29
1656050768177,MATH 18,B01,083748,Ma; Zilu,0,0,36,36
1656050768177,MATH 18,B02,083749,Ma; Zilu,0,0,36,36
1656050768177,MATH 18,B03,083750,Ma; Zilu,0,0,36,36
1656050768177,MATH 18,B04,083751,Ma; Zilu,0,0,36,36
1656050768177,MATH 18,B05,093473,Staff,0,0,36,36
1656050768177,MATH 18,B06,093474,Staff,3,0,36,33
1656050774201,MATH 20A,A01,083754,Zheng; Zequn,11,0,40,29
1656050780233,MATH 20B,A01,083756,Briones; Jor-el Thomas Caparas,0,0,36,36
1656050780233,MATH 20B,A02,083757,Briones; Jor-el Thomas Caparas,0,0,36,36
1656050780233,MATH 20B,A03,093475,Staff,0,0,36,36
1656050786256,MATH 20C,A01,083760,Briones; Jor-el Thomas Caparas,0,2,35,35
1656050786256,MATH 20C,A02,083761,Briones; Jor-el Thomas Caparas,6,1,35,29
1656050786256,MATH 20C,A03,093476,Staff,0,1,35,35
1656050786256,MATH 20C,B01,083762,Bach; Quang Tran,3,0,30,27
1656050792280,MATH 20D,A01,083765,Tran; Brian Kha,3,0,30,27
1656050792280,MATH 20D,A02,083766,Tran; Brian Kha,0,1,30,30
1656050792280,MATH 20D,A03,083767,Tran; Brian Kha,0,0,30,30
1656050798310,MATH 20E,A01,083771,Ganguly; Soumya,0,1,32,32
1656050798310,MATH 20E,A02,083772,Ganguly; Soumya,1,1,32,31
1656050798310,MATH 20E,B01,083773,Ciotti; Benjamin,14,0,35,21
1656050798310,MATH 20E,B02,083774,Ciotti; Benjamin,13,0,35,22
1656050804336,MATH 103A,A01,083777,Greenfeld; Be'Eri,2,1,36,34
1656050804336,MATH 103A,A02,083778,Greenfeld; Be'Eri,2,0,36,34
1656050804336,MATH 103A,A03,093561,Staff,0,1,36,36
1656050804336,MATH 103A,B01,083779,Greenfeld; Be'Eri,8,1,36,28
1656050804336,MATH 103A,B02,083780,Greenfeld; Be'Eri,0,0,36,36
1656050804336,MATH 103A,B03,093562,Staff,0,0,36,36
1656050810371,MATH 105,A01,085443,Carter; Anne Toulson,4,1,35,31
1656050810371,MATH 105,A02,093477,Staff,9,0,35,26
1656050816394,MATH 109,A01,083213,Ganzberger; Geoffrey Michael,1,1,34,33
1656050816394,MATH 109,A02,083214,Ganzberger; Geoffrey Michael,0,0,34,34
1656050816394,MATH 109,A03,093478,Staff,1,0,34,33
1656050816394,MATH 109,B01,083215,Ganzberger; Geoffrey Michael,2,0,32,30
1656050816394,MATH 109,B02,083216,Ganzberger; Geoffrey Michael,0,0,32,32
1656050816394,MATH 109,B03,093479,Staff,3,0,32,29
1656050822434,MATH 142A,A01,083219,Chow; Bennett,1,0,32,31
1656050822434,MATH 142A,A02,083220,Chow; Bennett,7,0,32,25
1656050822434,MATH 142A,A03,093480,Staff,4,0,32,28
1656050822434,MATH 142A,B03,093481,Staff,4,0,32,28
1656050822434,MATH 142A,B04,093558,Staff,6,0,32,26
1656050822434,MATH 142A,B05,093559,Staff,0,0,32,32
1656050828460,MATH 193A,A01,083224,Rotar; Vladimir,1,2,34,33
1656050828460,MATH 193A,A02,083225,Rotar; Vladimir,0,0,34,34
1656050828460,MATH 193A,A03,083781,Rotar; Vladimir,1,0,34,33
1656050828460,MATH 193A,A04,083782,Rotar; Vladimir,3,0,34,31
1656050828460,MATH 193A,A05,093482,Rotar; Vladimir,0,0,34,34
1656050834487,MATH 197,001,091859,McAuley; Julian John,9999,0,9999,0
1656050834487,MATH 197,002,095566,Kedlaya; Kiran S.,9997,0,9999,2
1656050834487,MATH 197,003,095567,Xiao; Ming,9999,0,9999,0
1656050834487,MATH 197,004,095571,Perols; Johan Lars,9998,0,9999,1
1656050841550,COGS 9,A01,083615,Shannon; Kyle Michael,3,1,75,72
1656050847585,COGS 11,A01,083617,Boyle; Mary E. T.,11,2,48,37
1656050853614,COGS 13,A01,083071,Bastos; Amalia Pinkusfeld,4,3,71,67
1656050859646,COGS 14A,A01,092681,Semenuks; Arturs,4,25,100,96
1656050865670,COGS 14B,A01,083073,Cheng; Tzu-Han,7,0,63,56
1656050871693,COGS 17,A01,092677,Semenuks; Arturs,9,7,81,72
1656050877718,COGS 100,A01,083619,Allen; Michael Gordon,3,2,70,67
1656050883741,COGS 101A,A01,083621,Davis; Joshua Daniel,4,3,68,64
1656050889763,COGS 101B,A01,091572,Allen; Michael Gordon,0,0,65,65
1656050895789,COGS 101C,A01,083625,Delgado; Tania,7,0,35,28
1656050901816,COGS 107A,A01,083627,Boyle; Mary E. T.,1,2,60,59
1656050907846,COGS 118A,A01,083075,Gupta; Anjum,21,16,76,55
1656050913878,CSE 3,A50,083646,Miranda; Gregory Joseph,14,0,50,36
1656050919902,CSE 8A,A50,083650,Miranda; Gregory Joseph,4,11,56,52
1656050925931,CSE 11,A01,083080,Cao; Yingjun,0,64,40,40
1656050931958,CSE 12,A01,083652,Krause-Levy; Sophia Louisa,7,8,120,113
1656050937985,CSE 15L,A01,083654,Morris; Justin Loren,3,1,50,47
1656050937985,CSE 15L,A02,083655,Morris; Justin Loren,2,1,50,48
1656050944013,CSE 20,A01,083657,Tran; Khoa Dang,29,0,80,51
1656050950041,CSE 21,A01,095574,Bach; Quang Tran,23,0,48,25
1656050956066,CSE 30,A01,083084,Eldon; John,2,10,80,78
1656050956066,CSE 30,B01,095061,Bhaskar; Nishant,2,5,50,48
1656050962093,CSE 100,A01,083659,Cao; Yingjun,2,25,70,68
1656050968120,CSE 134B,A01,083661,Powell; Thomas Allan,6,6,100,94
1656050974143,CSE 140,A01,083663,Gungor; Onat,6,0,85,79
1656050980169,CSE 140L,A01,083088,Eldon; John,5,0,100,95
1656050986193,CSE 175,A01,083665,Kumar; Rakesh,0,0,25,25
1656050992217,CSE 190,A00,092507,Dubnov; Shlomo,1,0,20,19
1656050998240,ECE 45,A01,083139,Congero; Spencer William,1,2,75,74
1656051004264,ECE 65,A50,083695,Saad; Andrew S,6,0,30,24
1656051004264,ECE 65,A51,095125,Staff,23,0,26,3
1656051010291,ECE 109,A01,091882,Touri; Behrouz,3,5,70,67
1656051016318,ECE 180,A00,083140,Abi Samra; Nicholas Camill,1,0,30,29
1656051016318,ECE 180,B00,083141,Abi Samra; Nicholas Camill,0,8,28,28
1656051022340,MATH 10A,A01,083735,Patchell; Gregory David,0,0,30,30
1656051022340,MATH 10A,A02,083736,Patchell; Gregory David,20,0,30,10
1656051022340,MATH 10A,A03,083737,Patchell; Gregory David,16,0,30,14
1656051028365,MATH 10B,A01,083207,Lim; Seonhee,1,1,34,33
1656051028365,MATH 10B,A02,083208,Lim; Seonhee,1,1,35,34
1656051028365,MATH 10B,A03,093472,Staff,0,1,34,34
1656051028365,MATH 10B,B01,083739,Sinha; Shubham,10,0,30,20
1656051034396,MATH 18,A01,083743,Cinel; Cameron Alexander,5,0,30,25
1656051034396,MATH 18,A02,083744,Cinel; Cameron Alexander,11,0,30,19
1656051034396,MATH 18,A03,083745,Cinel; Cameron Alexander,1,0,30,29
1656051034396,MATH 18,B01,083748,Ma; Zilu,0,0,36,36
1656051034396,MATH 18,B02,083749,Ma; Zilu,0,0,36,36
1656051034396,MATH 18,B03,083750,Ma; Zilu,0,0,36,36
1656051034396,MATH 18,B04,083751,Ma; Zilu,0,0,36,36
1656051034396,MATH 18,B05,093473,Staff,0,0,36,36
1656051034396,MATH 18,B06,093474,Staff,3,0,36,33
1656051040427,MATH 20A,A01,083754,Zheng; Zequn,11,0,40,29
1656051046461,MATH 20B,A01,083756,Briones; Jor-el Thomas Caparas,0,0,36,36
1656051046461,MATH 20B,A02,083757,Briones; Jor-el Thomas Caparas,0,0,36,36
1656051046461,MATH 20B,A03,093475,Staff,0,0,36,36
1656051052498,MATH 20C,A01,083760,Briones; Jor-el Thomas Caparas,0,2,35,35
1656051052498,MATH 20C,A02,083761,Briones; Jor-el Thomas Caparas,6,1,35,29
1656051052498,MATH 20C,A03,093476,Staff,0,1,35,35
1656051052498,MATH 20C,B01,083762,Bach; Quang Tran,3,0,30,27
1656051058525,MATH 20D,A01,083765,Tran; Brian Kha,3,0,30,27
1656051058525,MATH 20D,A02,083766,Tran; Brian Kha,0,1,30,30
1656051058525,MATH 20D,A03,083767,Tran; Brian Kha,0,0,30,30
1656051064547,MATH 20E,A01,083771,Ganguly; Soumya,0,1,32,32
1656051064547,MATH 20E,A02,083772,Ganguly; Soumya,1,1,32,31
1656051064547,MATH 20E,B01,083773,Ciotti; Benjamin,14,0,35,21
1656051064547,MATH 20E,B02,083774,Ciotti; Benjamin,13,0,35,22
1656051070572,MATH 103A,A01,083777,Greenfeld; Be'Eri,2,1,36,34
1656051070572,MATH 103A,A02,083778,Greenfeld; Be'Eri,2,0,36,34
1656051070572,MATH 103A,A03,093561,Staff,0,1,36,36
1656051070572,MATH 103A,B01,083779,Greenfeld; Be'Eri,8,1,36,28
1656051070572,MATH 103A,B02,083780,Greenfeld; Be'Eri,0,0,36,36
1656051070572,MATH 103A,B03,093562,Staff,0,0,36,36
1656051076595,MATH 105,A01,085443,Carter; Anne Toulson,4,1,35,31
1656051076595,MATH 105,A02,093477,Staff,9,0,35,26
1656051082620,MATH 109,A01,083213,Ganzberger; Geoffrey Michael,1,1,34,33
1656051082620,MATH 109,A02,083214,Ganzberger; Geoffrey Michael,0,0,34,34
1656051082620,MATH 109,A03,093478,Staff,1,0,34,33
1656051082620,MATH 109,B01,083215,Ganzberger; Geoffrey Michael,2,0,32,30
1656051082620,MATH 109,B02,083216,Ganzberger; Geoffrey Michael,0,0,32,32
1656051082620,MATH 109,B03,093479,Staff,3,0,32,29
1656051088645,MATH 142A,A01,083219,Chow; Bennett,1,0,32,31
1656051088645,MATH 142A,A02,083220,Chow; Bennett,7,0,32,25
1656051088645,MATH 142A,A03,093480,Staff,4,0,32,28
1656051088645,MATH 142A,B03,093481,Staff,4,0,32,28
1656051088645,MATH 142A,B04,093558,Staff,6,0,32,26
1656051088645,MATH 142A,B05,093559,Staff,0,0,32,32
1656051094674,MATH 193A,A01,083224,Rotar; Vladimir,1,2,34,33
1656051094674,MATH 193A,A02,083225,Rotar; Vladimir,0,0,34,34
1656051094674,MATH 193A,A03,083781,Rotar; Vladimir,1,0,34,33
1656051094674,MATH 193A,A04,083782,Rotar; Vladimir,3,0,34,31
1656051094674,MATH 193A,A05,093482,Rotar; Vladimir,0,0,34,34
1656051100701,MATH 197,001,091859,McAuley; Julian John,9999,0,9999,0
1656051100701,MATH 197,002,095566,Kedlaya; Kiran S.,9997,0,9999,2
1656051100701,MATH 197,003,095567,Xiao; Ming,9999,0,9999,0
1656051100701,MATH 197,004,095571,Perols; Johan Lars,9998,0,9999,1
1656051107753,COGS 9,A01,083615,Shannon; Kyle Michael,3,1,75,72
1656051113781,COGS 11,A01,083617,Boyle; Mary E. T.,11,2,48,37
1656051119807,COGS 13,A01,083071,Bastos; Amalia Pinkusfeld,4,3,71,67
1656051125840,COGS 14A,A01,092681,Semenuks; Arturs,4,25,100,96
1656051131864,COGS 14B,A01,083073,Cheng; Tzu-Han,7,0,63,56
1656051137887,COGS 17,A01,092677,Semenuks; Arturs,9,7,81,72
1656051143914,COGS 100,A01,083619,Allen; Michael Gordon,3,2,70,67
1656051149938,COGS 101A,A01,083621,Davis; Joshua Daniel,4,3,68,64
1656051155959,COGS 101B,A01,091572,Allen; Michael Gordon,0,0,65,65
1656051161983,COGS 101C,A01,083625,Delgado; Tania,7,0,35,28
1656051168006,COGS 107A,A01,083627,Boyle; Mary E. T.,1,2,60,59
1656051174029,COGS 118A,A01,083075,Gupta; Anjum,21,16,76,55
1656051180052,CSE 3,A50,083646,Miranda; Gregory Joseph,14,0,50,36
1656051186077,CSE 8A,A50,083650,Miranda; Gregory Joseph,4,11,56,52
1656051192099,CSE 11,A01,083080,Cao; Yingjun,0,64,40,40
1656051198123,CSE 12,A01,083652,Krause-Levy; Sophia Louisa,7,8,120,113
1656051204147,CSE 15L,A01,083654,Morris; Justin Loren,3,1,50,47
1656051204147,CSE 15L,A02,083655,Morris; Justin Loren,2,1,50,48
1656051210170,CSE 20,A01,083657,Tran; Khoa Dang,29,0,80,51
1656051216198,CSE 21,A01,095574,Bach; Quang Tran,23,0,48,25
1656051222222,CSE 30,A01,083084,Eldon; John,2,10,80,78
1656051222222,CSE 30,B01,095061,Bhaskar; Nishant,2,5,50,48
1656051228250,CSE 100,A01,083659,Cao; Yingjun,2,25,70,68
1656051234275,CSE 134B,A01,083661,Powell; Thomas Allan,6,6,100,94
1656051240301,CSE 140,A01,083663,Gungor; Onat,6,0,85,79
1656051246326,CSE 140L,A01,083088,Eldon; John,5,0,100,95
1656051252451,CSE 175,A01,083665,Kumar; Rakesh,0,0,25,25
1656051258482,CSE 190,A00,092507,Dubnov; Shlomo,1,0,20,19
1656051264509,ECE 45,A01,083139,Congero; Spencer William,1,2,75,74
1656051270538,ECE 65,A50,083695,Saad; Andrew S,6,0,30,24
1656051270538,ECE 65,A51,095125,Staff,23,0,26,3
1656051276565,ECE 109,A01,091882,Touri; Behrouz,3,5,70,67
1656051282592,ECE 180,A00,083140,Abi Samra; Nicholas Camill,1,0,30,29
1656051282592,ECE 180,B00,083141,Abi Samra; Nicholas Camill,0,8,28,28
1656051288624,MATH 10A,A01,083735,Patchell; Gregory David,0,0,30,30
1656051288624,MATH 10A,A02,083736,Patchell; Gregory David,20,0,30,10
1656051288624,MATH 10A,A03,083737,Patchell; Gregory David,16,0,30,14
1656051294651,MATH 10B,A01,083207,Lim; Seonhee,1,1,34,33
1656051294651,MATH 10B,A02,083208,Lim; Seonhee,1,1,35,34
1656051294651,MATH 10B,A03,093472,Staff,0,1,34,34
1656051294651,MATH 10B,B01,083739,Sinha; Shubham,10,0,30,20
1656051300683,MATH 18,A01,083743,Cinel; Cameron Alexander,5,0,30,25
1656051300683,MATH 18,A02,083744,Cinel; Cameron Alexander,11,0,30,19
1656051300683,MATH 18,A03,083745,Cinel; Cameron Alexander,1,0,30,29
1656051300683,MATH 18,B01,083748,Ma; Zilu,0,0,36,36
1656051300683,MATH 18,B02,083749,Ma; Zilu,0,0,36,36
1656051300683,MATH 18,B03,083750,Ma; Zilu,0,0,36,36
1656051300683,MATH 18,B04,083751,Ma; Zilu,0,0,36,36
1656051300683,MATH 18,B05,093473,Staff,0,0,36,36
1656051300683,MATH 18,B06,093474,Staff,3,0,36,33
1656051306709,MATH 20A,A01,083754,Zheng; Zequn,11,0,40,29
1656051312734,MATH 20B,A01,083756,Briones; Jor-el Thomas Caparas,0,0,36,36
1656051312734,MATH 20B,A02,083757,Briones; Jor-el Thomas Caparas,0,0,36,36
1656051312734,MATH 20B,A03,093475,Staff,0,0,36,36
1656051318760,MATH 20C,A01,083760,Briones; Jor-el Thomas Caparas,0,2,35,35
1656051318760,MATH 20C,A02,083761,Briones; Jor-el Thomas Caparas,6,1,35,29
1656051318760,MATH 20C,A03,093476,Staff,0,1,35,35
1656051318760,MATH 20C,B01,083762,Bach; Quang Tran,3,0,30,27
1656051324783,MATH 20D,A01,083765,Tran; Brian Kha,3,0,30,27
1656051324783,MATH 20D,A02,083766,Tran; Brian Kha,0,1,30,30
1656051324783,MATH 20D,A03,083767,Tran; Brian Kha,1,0,30,29
1656051330814,MATH 20E,A01,083771,Ganguly; Soumya,0,1,32,32
1656051330814,MATH 20E,A02,083772,Ganguly; Soumya,1,1,32,31
1656051330814,MATH 20E,B01,083773,Ciotti; Benjamin,14,0,35,21
1656051330814,MATH 20E,B02,083774,Ciotti; Benjamin,13,0,35,22
1656051336839,MATH 103A,A01,083777,Greenfeld; Be'Eri,2,1,36,34
1656051336839,MATH 103A,A02,083778,Greenfeld; Be'Eri,2,0,36,34
1656051336839,MATH 103A,A03,093561,Staff,0,1,36,36
1656051336839,MATH 103A,B01,083779,Greenfeld; Be'Eri,8,1,36,28
1656051336839,MATH 103A,B02,083780,Greenfeld; Be'Eri,0,0,36,36
1656051336839,MATH 103A,B03,093562,Staff,0,0,36,36
1656051342863,MATH 105,A01,085443,Carter; Anne Toulson,4,1,35,31
1656051342863,MATH 105,A02,093477,Staff,9,0,35,26
1656051348891,MATH 109,A01,083213,Ganzberger; Geoffrey Michael,1,1,34,33
1656051348891,MATH 109,A02,083214,Ganzberger; Geoffrey Michael,0,0,34,34
1656051348891,MATH 109,A03,093478,Staff,1,0,34,33
1656051348891,MATH 109,B01,083215,Ganzberger; Geoffrey Michael,2,0,32,30
1656051348891,MATH 109,B02,083216,Ganzberger; Geoffrey Michael,0,0,32,32
1656051348891,MATH 109,B03,093479,Staff,3,0,32,29
1656051354927,MATH 142A,A01,083219,Chow; Bennett,1,0,32,31
1656051354927,MATH 142A,A02,083220,Chow; Bennett,7,0,32,25
1656051354927,MATH 142A,A03,093480,Staff,4,0,32,28
1656051354927,MATH 142A,B03,093481,Staff,4,0,32,28
1656051354927,MATH 142A,B04,093558,Staff,6,0,32,26
1656051354927,MATH 142A,B05,093559,Staff,0,0,32,32
1656051360950,MATH 193A,A01,083224,Rotar; Vladimir,1,2,34,33
1656051360950,MATH 193A,A02,083225,Rotar; Vladimir,0,0,34,34
1656051360950,MATH 193A,A03,083781,Rotar; Vladimir,1,0,34,33
1656051360950,MATH 193A,A04,083782,Rotar; Vladimir,3,0,34,31
1656051360950,MATH 193A,A05,093482,Rotar; Vladimir,0,0,34,34
1656051366977,MATH 197,001,091859,McAuley; Julian John,9999,0,9999,0
1656051366977,MATH 197,002,095566,Kedlaya; Kiran S.,9997,0,9999,2
1656051366977,MATH 197,003,095567,Xiao; Ming,9999,0,9999,0
1656051366977,MATH 197,004,095571,Perols; Johan Lars,9998,0,9999,1
1656051374044,COGS 9,A01,083615,Shannon; Kyle Michael,3,1,75,72
1656051380071,COGS 11,A01,083617,Boyle; Mary E. T.,11,2,48,37
1656051386098,COGS 13,A01,083071,Bastos; Amalia Pinkusfeld,4,3,71,67
1656051392121,COGS 14A,A01,092681,Semenuks; Arturs,4,25,100,96
1656051398148,COGS 14B,A01,083073,Cheng; Tzu-Han,7,0,63,56
1656051404171,COGS 17,A01,092677,Semenuks; Arturs,9,7,81,72
1656051410195,COGS 100,A01,083619,Allen; Michael Gordon,3,2,70,67
1656051416220,COGS 101A,A01,083621,Davis; Joshua Daniel,4,3,68,64
1656051422249,COGS 101B,A01,091572,Allen; Michael Gordon,0,0,65,65
1656051428275,COGS 101C,A01,083625,Delgado; Tania,7,0,35,28
1656051434307,COGS 107A,A01,083627,Boyle; Mary E. T.,1,2,60,59
1656051440330,COGS 118A,A01,083075,Gupta; Anjum,21,16,76,55
1656051446352,CSE 3,A50,083646,Miranda; Gregory Joseph,14,0,50,36
1656051452379,CSE 8A,A50,083650,Miranda; Gregory Joseph,4,11,56,52
1656051458408,CSE 11,A01,083080,Cao; Yingjun,0,64,40,40
1656051464434,CSE 12,A01,083652,Krause-Levy; Sophia Louisa,7,8,120,113
1656051470475,CSE 15L,A01,083654,Morris; Justin Loren,3,1,50,47
1656051470475,CSE 15L,A02,083655,Morris; Justin Loren,2,1,50,48
1656051476502,CSE 20,A01,083657,Tran; Khoa Dang,29,0,80,51
1656051482530,CSE 21,A01,095574,Bach; Quang Tran,23,0,48,25
1656051488560,CSE 30,A01,083084,Eldon; John,2,10,80,78
1656051488560,CSE 30,B01,095061,Bhaskar; Nishant,2,5,50,48
1656051494583,CSE 100,A01,083659,Cao; Yingjun,2,25,70,68
1656051500612,CSE 134B,A01,083661,Powell; Thomas Allan,6,6,100,94
1656051506636,CSE 140,A01,083663,Gungor; Onat,6,0,85,79
1656051512659,CSE 140L,A01,083088,Eldon; John,5,0,100,95
1656051518685,CSE 175,A01,083665,Kumar; Rakesh,0,0,25,25
1656051524712,CSE 190,A00,092507,Dubnov; Shlomo,1,0,20,19
1656051530753,ECE 45,A01,083139,Congero; Spencer William,1,2,75,74
1656051536794,ECE 65,A50,083695,Saad; Andrew S,6,0,30,24
1656051536794,ECE 65,A51,095125,Staff,23,0,26,3
1656051542834,ECE 109,A01,091882,Touri; Behrouz,3,5,70,67
1656051548862,ECE 180,A00,083140,Abi Samra; Nicholas Camill,1,0,30,29
1656051548862,ECE 180,B00,083141,Abi Samra; Nicholas Camill,0,8,28,28
1656051554892,MATH 10A,A01,083735,Patchell; Gregory David,0,0,30,30
1656051554892,MATH 10A,A02,083736,Patchell; Gregory David,20,0,30,10
1656051554892,MATH 10A,A03,083737,Patchell; Gregory David,16,0,30,14
1656051560916,MATH 10B,A01,083207,Lim; Seonhee,1,1,34,33
1656051560916,MATH 10B,A02,083208,Lim; Seonhee,1,1,35,34
1656051560916,MATH 10B,A03,093472,Staff,0,1,34,34
1656051560916,MATH 10B,B01,083739,Sinha; Shubham,10,0,30,20
1656051566948,MATH 18,A01,083743,Cinel; Cameron Alexander,5,0,30,25
1656051566948,MATH 18,A02,083744,Cinel; Cameron Alexander,11,0,30,19
1656051566948,MATH 18,A03,083745,Cinel; Cameron Alexander,1,0,30,29
1656051566948,MATH 18,B01,083748,Ma; Zilu,0,0,36,36
1656051566948,MATH 18,B02,083749,Ma; Zilu,0,0,36,36
1656051566948,MATH 18,B03,083750,Ma; Zilu,0,0,36,36
1656051566948,MATH 18,B04,083751,Ma; Zilu,0,0,36,36
1656051566948,MATH 18,B05,093473,Staff,0,0,36,36
1656051566948,MATH 18,B06,093474,Staff,3,0,36,33
1656051572972,MATH 20A,A01,083754,Zheng; Zequn,11,0,40,29
1656051578997,MATH 20B,A01,083756,Briones; Jor-el Thomas Caparas,0,0,36,36
1656051578997,MATH 20B,A02,083757,Briones; Jor-el Thomas Caparas,0,0,36,36
1656051578997,MATH 20B,A03,093475,Staff,0,0,36,36
1656051585028,MATH 20C,A01,083760,Briones; Jor-el Thomas Caparas,0,2,35,35
1656051585028,MATH 20C,A02,083761,Briones; Jor-el Thomas Caparas,6,1,35,29
1656051585028,MATH 20C,A03,093476,Staff,0,1,35,35
1656051585028,MATH 20C,B01,083762,Bach; Quang Tran,3,0,30,27
1656051591050,MATH 20D,A01,083765,Tran; Brian Kha,3,0,30,27
1656051591050,MATH 20D,A02,083766,Tran; Brian Kha,0,1,30,30
1656051591050,MATH 20D,A03,083767,Tran; Brian Kha,1,0,30,29
1656051597076,MATH 20E,A01,083771,Ganguly; Soumya,0,1,32,32
1656051597076,MATH 20E,A02,083772,Ganguly; Soumya,1,1,32,31
1656051597076,MATH 20E,B01,083773,Ciotti; Benjamin,14,0,35,21
1656051597076,MATH 20E,B02,083774,Ciotti; Benjamin,13,0,35,22
1656051603100,MATH 103A,A01,083777,Greenfeld; Be'Eri,2,1,36,34
1656051603100,MATH 103A,A02,083778,Greenfeld; Be'Eri,2,0,36,34
1656051603100,MATH 103A,A03,093561,Staff,0,1,36,36
1656051603100,MATH 103A,B01,083779,Greenfeld; Be'Eri,8,1,36,28
1656051603100,MATH 103A,B02,083780,Greenfeld; Be'Eri,0,0,36,36
1656051603100,MATH 103A,B03,093562,Staff,0,0,36,36
1656051609128,MATH 105,A01,085443,Carter; Anne Toulson,4,1,35,31
1656051609128,MATH 105,A02,093477,Staff,9,0,35,26
1656051615153,MATH 109,A01,083213,Ganzberger; Geoffrey Michael,1,1,34,33
1656051615153,MATH 109,A02,083214,Ganzberger; Geoffrey Michael,0,0,34,34
1656051615153,MATH 109,A03,093478,Staff,1,0,34,33
1656051615153,MATH 109,B01,083215,Ganzberger; Geoffrey Michael,2,0,32,30
1656051615153,MATH 109,B02,083216,Ganzberger; Geoffrey Michael,0,0,32,32
1656051615153,MATH 109,B03,093479,Staff,3,0,32,29
1656051621184,MATH 142A,A01,083219,Chow; Bennett,1,0,32,31
1656051621184,MATH 142A,A02,083220,Chow; Bennett,7,0,32,25
1656051621184,MATH 142A,A03,093480,Staff,4,0,32,28
1656051621184,MATH 142A,B03,093481,Staff,4,0,32,28
1656051621184,MATH 142A,B04,093558,Staff,6,0,32,26
1656051621184,MATH 142A,B05,093559,Staff,0,0,32,32
1656051627212,MATH 193A,A01,083224,Rotar; Vladimir,1,2,34,33
1656051627212,MATH 193A,A02,083225,Rotar; Vladimir,0,0,34,34
1656051627212,MATH 193A,A03,083781,Rotar; Vladimir,1,0,34,33
1656051627212,MATH 193A,A04,083782,Rotar; Vladimir,3,0,34,31
1656051627212,MATH 193A,A05,093482,Rotar; Vladimir,0,0,34,34
1656051633236,MATH 197,001,091859,McAuley; Julian John,9999,0,9999,0
1656051633236,MATH 197,002,095566,Kedlaya; Kiran S.,9997,0,9999,2
1656051633236,MATH 197,003,095567,Xiao; Ming,9999,0,9999,0
1656051633236,MATH 197,004,095571,Perols; Johan Lars,9998,0,9999,1
1656051640286,COGS 9,A01,083615,Shannon; Kyle Michael,3,1,75,72
1656051646320,COGS 11,A01,083617,Boyle; Mary E. T.,11,2,48,37
1656051652351,COGS 13,A01,083071,Bastos; Amalia Pinkusfeld,4,3,71,67
1656051658378,COGS 14A,A01,092681,Semenuks; Arturs,4,25,100,96
1656051664402,COGS 14B,A01,083073,Cheng; Tzu-Han,7,0,63,56
1656051670425,COGS 17,A01,092677,Semenuks; Arturs,9,7,81,72
1656051676447,COGS 100,A01,083619,Allen; Michael Gordon,3,2,70,67
1656051682472,COGS 101A,A01,083621,Davis; Joshua Daniel,4,3,68,64
1656051688498,COGS 101B,A01,091572,Allen; Michael Gordon,0,0,65,65
1656051694525,COGS 101C,A01,083625,Delgado; Tania,7,0,35,28
1656051700548,COGS 107A,A01,083627,Boyle; Mary E. T.,1,2,60,59
1656051706572,COGS 118A,A01,083075,Gupta; Anjum,21,16,76,55
1656051712596,CSE 3,A50,083646,Miranda; Gregory Joseph,14,0,50,36
1656051718618,CSE 8A,A50,083650,Miranda; Gregory Joseph,4,11,56,52
1656051724641,CSE 11,A01,083080,Cao; Yingjun,0,64,40,40
1656051730666,CSE 12,A01,083652,Krause-Levy; Sophia Louisa,7,8,120,113
1656051736694,CSE 15L,A01,083654,Morris; Justin Loren,3,1,50,47
1656051736694,CSE 15L,A02,083655,Morris; Justin Loren,2,1,50,48
1656051742720,CSE 20,A01,083657,Tran; Khoa Dang,29,0,80,51
1656051748748,CSE 21,A01,095574,Bach; Quang Tran,23,0,48,25
1656051754772,CSE 30,A01,083084,Eldon; John,2,10,80,78
1656051754772,CSE 30,B01,095061,Bhaskar; Nishant,2,5,50,48
1656051760796,CSE 100,A01,083659,Cao; Yingjun,2,25,70,68
1656051766819,CSE 134B,A01,083661,Powell; Thomas Allan,6,6,100,94
1656051772848,CSE 140,A01,083663,Gungor; Onat,6,0,85,79
1656051778874,CSE 140L,A01,083088,Eldon; John,5,0,100,95
1656051784910,CSE 175,A01,083665,Kumar; Rakesh,0,0,25,25
1656051790938,CSE 190,A00,092507,Dubnov; Shlomo,1,0,20,19
1656051796976,ECE 45,A01,083139,Congero; Spencer William,1,2,75,74
1656051803000,ECE 65,A50,083695,Saad; Andrew S,6,0,30,24
1656051803000,ECE 65,A51,095125,Staff,23,0,26,3
1656051809024,ECE 109,A01,091882,Touri; Behrouz,3,5,70,67
1656051815046,ECE 180,A00,083140,Abi Samra; Nicholas Camill,1,0,30,29
1656051815046,ECE 180,B00,083141,Abi Samra; Nicholas Camill,0,8,28,28
1656051821084,MATH 10A,A01,083735,Patchell; Gregory David,0,0,30,30
1656051821084,MATH 10A,A02,083736,Patchell; Gregory David,20,0,30,10
1656051821084,MATH 10A,A03,083737,Patchell; Gregory David,16,0,30,14
1656051827108,MATH 10B,A01,083207,Lim; Seonhee,1,1,34,33
1656051827108,MATH 10B,A02,083208,Lim; Seonhee,1,1,35,34
1656051827108,MATH 10B,A03,093472,Staff,0,1,34,34
1656051827108,MATH 10B,B01,083739,Sinha; Shubham,10,0,30,20
1656051833136,MATH 18,A01,083743,Cinel; Cameron Alexander,5,0,30,25
1656051833136,MATH 18,A02,083744,Cinel; Cameron Alexander,11,0,30,19
1656051833136,MATH 18,A03,083745,Cinel; Cameron Alexander,2,0,30,28
1656051833136,MATH 18,B01,083748,Ma; Zilu,0,0,36,36
1656051833136,MATH 18,B02,083749,Ma; Zilu,0,0,36,36
1656051833136,MATH 18,B03,083750,Ma; Zilu,0,0,36,36
1656051833136,MATH 18,B04,083751,Ma; Zilu,0,0,36,36
1656051833136,MATH 18,B05,093473,Staff,0,0,36,36
1656051833136,MATH 18,B06,093474,Staff,3,0,36,33
1656051839164,MATH 20A,A01,083754,Zheng; Zequn,11,0,40,29
1656051845201,MATH 20B,A01,083756,Briones; Jor-el Thomas Caparas,0,0,36,36
1656051845201,MATH 20B,A02,083757,Briones; Jor-el Thomas Caparas,0,0,36,36
1656051845201,MATH 20B,A03,093475,Staff,0,0,36,36
1656051851318,MATH 20C,A01,083760,Briones; Jor-el Thomas Caparas,0,2,35,35
1656051851318,MATH 20C,A02,083761,Briones; Jor-el Thomas Caparas,6,1,35,29
1656051851318,MATH 20C,A03,093476,Staff,0,1,35,35
1656051851318,MATH 20C,B01,083762,Bach; Quang Tran,3,0,30,27
1656051857343,MATH 20D,A01,083765,Tran; Brian Kha,3,0,30,27
1656051857343,MATH 20D,A02,083766,Tran; Brian Kha,0,1,30,30
1656051857343,MATH 20D,A03,083767,Tran; Brian Kha,1,0,30,29
1656051863376,MATH 20E,A01,083771,Ganguly; Soumya,0,1,32,32
1656051863376,MATH 20E,A02,083772,Ganguly; Soumya,1,1,32,31
1656051863376,MATH 20E,B01,083773,Ciotti; Benjamin,14,0,35,21
1656051863376,MATH 20E,B02,083774,Ciotti; Benjamin,13,0,35,22
1656051869407,MATH 103A,A01,083777,Greenfeld; Be'Eri,2,1,36,34
1656051869407,MATH 103A,A02,083778,Greenfeld; Be'Eri,2,0,36,34
1656051869407,MATH 103A,A03,093561,Staff,0,1,36,36
1656051869407,MATH 103A,B01,083779,Greenfeld; Be'Eri,8,1,36,28
1656051869407,MATH 103A,B02,083780,Greenfeld; Be'Eri,0,0,36,36
1656051869407,MATH 103A,B03,093562,Staff,0,0,36,36
1656051875433,MATH 105,A01,085443,Carter; Anne Toulson,4,1,35,31
1656051875433,MATH 105,A02,093477,Staff,9,0,35,26
1656051881463,MATH 109,A01,083213,Ganzberger; Geoffrey Michael,1,1,34,33
1656051881463,MATH 109,A02,083214,Ganzberger; Geoffrey Michael,0,0,34,34
1656051881463,MATH 109,A03,093478,Staff,1,0,34,33
1656051881463,MATH 109,B01,083215,Ganzberger; Geoffrey Michael,2,0,32,30
1656051881463,MATH 109,B02,083216,Ganzberger; Geoffrey Michael,0,0,32,32
1656051881463,MATH 109,B03,093479,Staff,3,0,32,29
1656051887488,MATH 142A,A01,083219,Chow; Bennett,1,0,32,31
1656051887488,MATH 142A,A02,083220,Chow; Bennett,7,0,32,25
1656051887488,MATH 142A,A03,093480,Staff,4,0,32,28
1656051887488,MATH 142A,B03,093481,Staff,4,0,32,28
1656051887488,MATH 142A,B04,093558,Staff,6,0,32,26
1656051887488,MATH 142A,B05,093559,Staff,0,0,32,32
1656051893518,MATH 193A,A01,083224,Rotar; Vladimir,1,2,34,33
1656051893518,MATH 193A,A02,083225,Rotar; Vladimir,0,0,34,34
1656051893518,MATH 193A,A03,083781,Rotar; Vladimir,1,0,34,33
1656051893518,MATH 193A,A04,083782,Rotar; Vladimir,3,0,34,31
1656051893518,MATH 193A,A05,093482,Rotar; Vladimir,0,0,34,34
1656051899542,MATH 197,001,091859,McAuley; Julian John,9999,0,9999,0
1656051899542,MATH 197,002,095566,Kedlaya; Kiran S.,9997,0,9999,2
1656051899542,MATH 197,003,095567,Xiao; Ming,9999,0,9999,0
1656051899542,MATH 197,004,095571,Perols; Johan Lars,9998,0,9999,1
1656051906596,COGS 9,A01,083615,Shannon; Kyle Michael,3,1,75,72
1656051912620,COGS 11,A01,083617,Boyle; Mary E. T.,11,2,48,37
1656051918647,COGS 13,A01,083071,Bastos; Amalia Pinkusfeld,4,3,71,67
1656051924673,COGS 14A,A01,092681,Semenuks; Arturs,4,25,100,96
1656051930698,COGS 14B,A01,083073,Cheng; Tzu-Han,7,0,63,56
1656051936727,COGS 17,A01,092677,Semenuks; Arturs,9,7,81,72
1656051942750,COGS 100,A01,083619,Allen; Michael Gordon,3,2,70,67
1656051948774,COGS 101A,A01,083621,Davis; Joshua Daniel,4,3,68,64
1656051954797,COGS 101B,A01,091572,Allen; Michael Gordon,0,0,65,65
1656051960820,COGS 101C,A01,083625,Delgado; Tania,7,0,35,28
1656051966852,COGS 107A,A01,083627,Boyle; Mary E. T.,1,2,60,59
1656051972876,COGS 118A,A01,083075,Gupta; Anjum,21,16,76,55
1656051978901,CSE 3,A50,083646,Miranda; Gregory Joseph,14,0,50,36
1656051984933,CSE 8A,A50,083650,Miranda; Gregory Joseph,4,11,56,52
1656051990961,CSE 11,A01,083080,Cao; Yingjun,0,64,40,40
1656051996988,CSE 12,A01,083652,Krause-Levy; Sophia Louisa,7,8,120,113
1656052003016,CSE 15L,A01,083654,Morris; Justin Loren,3,1,50,47
1656052003016,CSE 15L,A02,083655,Morris; Justin Loren,2,1,50,48
1656052009042,CSE 20,A01,083657,Tran; Khoa Dang,29,0,80,51
1656052015068,CSE 21,A01,095574,Bach; Quang Tran,23,0,48,25
1656052021112,CSE 30,A01,083084,Eldon; John,2,10,80,78
1656052021112,CSE 30,B01,095061,Bhaskar; Nishant,2,5,50,48
1656052027140,CSE 100,A01,083659,Cao; Yingjun,2,25,70,68
1656052033164,CSE 134B,A01,083661,Powell; Thomas Allan,6,6,100,94
1656052039191,CSE 140,A01,083663,Gungor; Onat,6,0,85,79
1656052045218,CSE 140L,A01,083088,Eldon; John,5,0,100,95
1656052051242,CSE 175,A01,083665,Kumar; Rakesh,0,0,25,25
1656052057266,CSE 190,A00,092507,Dubnov; Shlomo,1,0,20,19
1656052063300,ECE 45,A01,083139,Congero; Spencer William,1,2,75,74
1656052069326,ECE 65,A50,083695,Saad; Andrew S,6,0,30,24
1656052069326,ECE 65,A51,095125,Staff,23,0,26,3
1656052075367,ECE 109,A01,091882,Touri; Behrouz,3,5,70,67
1656052081406,ECE 180,A00,083140,Abi Samra; Nicholas Camill,1,0,30,29
1656052081406,ECE 180,B00,083141,Abi Samra; Nicholas Camill,0,8,28,28
1656052087429,MATH 10A,A01,083735,Patchell; Gregory David,0,0,30,30
1656052087429,MATH 10A,A02,083736,Patchell; Gregory David,20,0,30,10
1656052087429,MATH 10A,A03,083737,Patchell; Gregory David,16,0,30,14
1656052093456,MATH 10B,A01,083207,Lim; Seonhee,1,1,34,33
1656052093456,MATH 10B,A02,083208,Lim; Seonhee,1,1,35,34
1656052093456,MATH 10B,A03,093472,Staff,0,1,34,34
1656052093456,MATH 10B,B01,083739,Sinha; Shubham,10,0,30,20
1656052099481,MATH 18,A01,083743,Cinel; Cameron Alexander,5,0,30,25
1656052099481,MATH 18,A02,083744,Cinel; Cameron Alexander,11,0,30,19
1656052099481,MATH 18,A03,083745,Cinel; Cameron Alexander,2,0,30,28
1656052099481,MATH 18,B01,083748,Ma; Zilu,0,0,36,36
1656052099481,MATH 18,B02,083749,Ma; Zilu,0,0,36,36
1656052099481,MATH 18,B03,083750,Ma; Zilu,0,0,36,36
1656052099481,MATH 18,B04,083751,Ma; Zilu,0,0,36,36
1656052099481,MATH 18,B05,093473,Staff,0,0,36,36
1656052099481,MATH 18,B06,093474,Staff,3,0,36,33
1656052105505,MATH 20A,A01,083754,Zheng; Zequn,11,0,40,29
1656052111529,MATH 20B,A01,083756,Briones; Jor-el Thomas Caparas,0,0,36,36
1656052111529,MATH 20B,A02,083757,Briones; Jor-el Thomas Caparas,0,0,36,36
1656052111529,MATH 20B,A03,093475,Staff,0,0,36,36
1656052117552,MATH 20C,A01,083760,Briones; Jor-el Thomas Caparas,0,2,35,35
1656052117552,MATH 20C,A02,083761,Briones; Jor-el Thomas Caparas,6,1,35,29
1656052117552,MATH 20C,A03,093476,Staff,0,1,35,35
1656052117552,MATH 20C,B01,083762,Bach; Quang Tran,3,0,30,27
1656052123590,MATH 20D,A01,083765,Tran; Brian Kha,3,0,30,27
1656052123590,MATH 20D,A02,083766,Tran; Brian Kha,0,1,30,30
1656052123590,MATH 20D,A03,083767,Tran; Brian Kha,1,0,30,29
1656052129614,MATH 20E,A01,083771,Ganguly; Soumya,0,1,32,32
1656052129614,MATH 20E,A02,083772,Ganguly; Soumya,1,1,32,31
1656052129614,MATH 20E,B01,083773,Ciotti; Benjamin,14,0,35,21
1656052129614,MATH 20E,B02,083774,Ciotti; Benjamin,13,0,35,22
1656052135643,MATH 103A,A01,083777,Greenfeld; Be'Eri,2,1,36,34
1656052135643,MATH 103A,A02,083778,Greenfeld; Be'Eri,2,0,36,34
1656052135643,MATH 103A,A03,093561,Staff,0,1,36,36
1656052135643,MATH 103A,B01,083779,Greenfeld; Be'Eri,8,1,36,28
1656052135643,MATH 103A,B02,083780,Greenfeld; Be'Eri,0,0,36,36
1656052135643,MATH 103A,B03,093562,Staff,0,0,36,36
1656052141665,MATH 105,A01,085443,Carter; Anne Toulson,4,1,35,31
1656052141665,MATH 105,A02,093477,Staff,9,0,35,26
1656052147692,MATH 109,A01,083213,Ganzberger; Geoffrey Michael,1,1,34,33
1656052147692,MATH 109,A02,083214,Ganzberger; Geoffrey Michael,0,0,34,34
1656052147692,MATH 109,A03,093478,Staff,1,0,34,33
1656052147692,MATH 109,B01,083215,Ganzberger; Geoffrey Michael,2,0,32,30
1656052147692,MATH 109,B02,083216,Ganzberger; Geoffrey Michael,0,0,32,32
1656052147692,MATH 109,B03,093479,Staff,3,0,32,29
1656052153724,MATH 142A,A01,083219,Chow; Bennett,1,0,32,31
1656052153724,MATH 142A,A02,083220,Chow; Bennett,7,0,32,25
1656052153724,MATH 142A,A03,093480,Staff,4,0,32,28
1656052153724,MATH 142A,B03,093481,Staff,4,0,32,28
1656052153724,MATH 142A,B04,093558,Staff,6,0,32,26
1656052153724,MATH 142A,B05,093559,Staff,0,0,32,32
1656052159760,MATH 193A,A01,083224,Rotar; Vladimir,1,2,34,33
1656052159760,MATH 193A,A02,083225,Rotar; Vladimir,0,0,34,34
1656052159760,MATH 193A,A03,083781,Rotar; Vladimir,1,0,34,33
1656052159760,MATH 193A,A04,083782,Rotar; Vladimir,3,0,34,31
1656052159760,MATH 193A,A05,093482,Rotar; Vladimir,0,0,34,34
1656052165788,MATH 197,001,091859,McAuley; Julian John,9999,0,9999,0
1656052165788,MATH 197,002,095566,Kedlaya; Kiran S.,9997,0,9999,2
1656052165788,MATH 197,003,095567,Xiao; Ming,9999,0,9999,0
1656052165788,MATH 197,004,095571,Perols; Johan Lars,9998,0,9999,1
1656052172847,COGS 9,A01,083615,Shannon; Kyle Michael,3,1,75,72
1656052178875,COGS 11,A01,083617,Boyle; Mary E. T.,11,2,48,37
1656052184904,COGS 13,A01,083071,Bastos; Amalia Pinkusfeld,4,3,71,67
1656052190930,COGS 14A,A01,092681,Semenuks; Arturs,4,25,100,96
1656052196955,COGS 14B,A01,083073,Cheng; Tzu-Han,7,0,63,56
1656052202983,COGS 17,A01,092677,Semenuks; Arturs,9,7,81,72
1656052209012,COGS 100,A01,083619,Allen; Michael Gordon,3,2,70,67
1656052215037,COGS 101A,A01,083621,Davis; Joshua Daniel,4,3,68,64
1656052221062,COGS 101B,A01,091572,Allen; Michael Gordon,0,0,65,65
1656052227086,COGS 101C,A01,083625,Delgado; Tania,7,0,35,28
1656052233112,COGS 107A,A01,083627,Boyle; Mary E. T.,1,2,60,59
1656052239136,COGS 118A,A01,083075,Gupta; Anjum,21,16,76,55
1656052245171,CSE 3,A50,083646,Miranda; Gregory Joseph,14,0,50,36
1656052251195,CSE 8A,A50,083650,Miranda; Gregory Joseph,4,11,56,52
1656052257219,CSE 11,A01,083080,Cao; Yingjun,0,64,40,40
1656052263241,CSE 12,A01,083652,Krause-Levy; Sophia Louisa,7,8,120,113
1656052269273,CSE 15L,A01,083654,Morris; Justin Loren,3,1,50,47
1656052269273,CSE 15L,A02,083655,Morris; Justin Loren,2,1,50,48
1656052275310,CSE 20,A01,083657,Tran; Khoa Dang,29,0,80,51
1656052281337,CSE 21,A01,095574,Bach; Quang Tran,23,0,48,25
1656052287364,CSE 30,A01,083084,Eldon; John,2,10,80,78
1656052287364,CSE 30,B01,095061,Bhaskar; Nishant,2,5,50,48
1656052293386,CSE 100,A01,083659,Cao; Yingjun,2,25,70,68
1656052299419,CSE 134B,A01,083661,Powell; Thomas Allan,6,6,100,94
1656052305443,CSE 140,A01,083663,Gungor; Onat,6,0,85,79
1656052311466,CSE 140L,A01,083088,Eldon; John,5,0,100,95
1656052317489,CSE 175,A01,083665,Kumar; Rakesh,0,0,25,25
1656052323517,CSE 190,A00,092507,Dubnov; Shlomo,1,0,20,19
1656052329542,ECE 45,A01,083139,Congero; Spencer William,1,2,75,74
1656052335565,ECE 65,A50,083695,Saad; Andrew S,6,0,30,24
1656052335565,ECE 65,A51,095125,Staff,23,0,26,3
1656052341592,ECE 109,A01,091882,Touri; Behrouz,3,5,70,67
1656052347619,ECE 180,A00,083140,Abi Samra; Nicholas Camill,1,0,30,29
1656052347619,ECE 180,B00,083141,Abi Samra; Nicholas Camill,0,8,28,28
1656052353648,MATH 10A,A01,083735,Patchell; Gregory David,0,0,30,30
1656052353648,MATH 10A,A02,083736,Patchell; Gregory David,20,0,30,10
1656052353648,MATH 10A,A03,083737,Patchell; Gregory David,16,0,30,14
1656052359673,MATH 10B,A01,083207,Lim; Seonhee,1,1,34,33
1656052359673,MATH 10B,A02,083208,Lim; Seonhee,1,1,35,34
1656052359673,MATH 10B,A03,093472,Staff,0,1,34,34
1656052359673,MATH 10B,B01,083739,Sinha; Shubham,10,0,30,20
1656052365704,MATH 18,A01,083743,Cinel; Cameron Alexander,5,0,30,25
1656052365704,MATH 18,A02,083744,Cinel; Cameron Alexander,11,0,30,19
1656052365704,MATH 18,A03,083745,Cinel; Cameron Alexander,2,0,30,28
1656052365704,MATH 18,B01,083748,Ma; Zilu,0,0,36,36
1656052365704,MATH 18,B02,083749,Ma; Zilu,0,0,36,36
1656052365704,MATH 18,B03,083750,Ma; Zilu,0,0,36,36
1656052365704,MATH 18,B04,083751,Ma; Zilu,0,0,36,36
1656052365704,MATH 18,B05,093473,Staff,0,0,36,36
1656052365704,MATH 18,B06,093474,Staff,3,0,36,33
1656052371728,MATH 20A,A01,083754,Zheng; Zequn,11,0,40,29
1656052377781,MATH 20B,A01,083756,Briones; Jor-el Thomas Caparas,0,0,36,36
1656052377781,MATH 20B,A02,083757,Briones; Jor-el Thomas Caparas,0,0,36,36
1656052377781,MATH 20B,A03,093475,Staff,0,0,36,36
1656052383808,MATH 20C,A01,083760,Briones; Jor-el Thomas Caparas,0,2,35,35
1656052383808,MATH 20C,A02,083761,Briones; Jor-el Thomas Caparas,6,1,35,29
1656052383808,MATH 20C,A03,093476,Staff,0,1,35,35
1656052383808,MATH 20C,B01,083762,Bach; Quang Tran,3,0,30,27
1656052389831,MATH 20D,A01,083765,Tran; Brian Kha,3,0,30,27
1656052389831,MATH 20D,A02,083766,Tran; Brian Kha,0,1,30,30
1656052389831,MATH 20D,A03,083767,Tran; Brian Kha,1,0,30,29
1656052395860,MATH 20E,A01,083771,Ganguly; Soumya,0,1,32,32
1656052395860,MATH 20E,A02,083772,Ganguly; Soumya,1,1,32,31
1656052395860,MATH 20E,B01,083773,Ciotti; Benjamin,14,0,35,21
1656052395860,MATH 20E,B02,083774,Ciotti; Benjamin,13,0,35,22
1656052401892,MATH 103A,A01,083777,Greenfeld; Be'Eri,2,1,36,34
1656052401892,MATH 103A,A02,083778,Greenfeld; Be'Eri,2,0,36,34
1656052401892,MATH 103A,A03,093561,Staff,0,1,36,36
1656052401892,MATH 103A,B01,083779,Greenfeld; Be'Eri,8,1,36,28
1656052401892,MATH 103A,B02,083780,Greenfeld; Be'Eri,0,0,36,36
1656052401892,MATH 103A,B03,093562,Staff,0,0,36,36
1656052407916,MATH 105,A01,085443,Carter; Anne Toulson,4,1,35,31
1656052407916,MATH 105,A02,093477,Staff,9,0,35,26
1656052413946,MATH 109,A01,083213,Ganzberger; Geoffrey Michael,1,1,34,33
1656052413946,MATH 109,A02,083214,Ganzberger; Geoffrey Michael,0,0,34,34
1656052413946,MATH 109,A03,093478,Staff,1,0,34,33
1656052413946,MATH 109,B01,083215,Ganzberger; Geoffrey Michael,2,0,32,30
1656052413946,MATH 109,B02,083216,Ganzberger; Geoffrey Michael,0,0,32,32
1656052413946,MATH 109,B03,093479,Staff,3,0,32,29
1656052419977,MATH 142A,A01,083219,Chow; Bennett,1,0,32,31
1656052419977,MATH 142A,A02,083220,Chow; Bennett,7,0,32,25
1656052419977,MATH 142A,A03,093480,Staff,4,0,32,28
1656052419977,MATH 142A,B03,093481,Staff,4,0,32,28
1656052419977,MATH 142A,B04,093558,Staff,6,0,32,26
1656052419977,MATH 142A,B05,093559,Staff,0,0,32,32
1656052426001,MATH 193A,A01,083224,Rotar; Vladimir,1,2,34,33
1656052426001,MATH 193A,A02,083225,Rotar; Vladimir,0,0,34,34
1656052426001,MATH 193A,A03,083781,Rotar; Vladimir,1,0,34,33
1656052426001,MATH 193A,A04,083782,Rotar; Vladimir,3,0,34,31
1656052426001,MATH 193A,A05,093482,Rotar; Vladimir,0,0,34,34
1656052432027,MATH 197,001,091859,McAuley; Julian John,9999,0,9999,0
1656052432027,MATH 197,002,095566,Kedlaya; Kiran S.,9997,0,9999,2
1656052432027,MATH 197,003,095567,Xiao; Ming,9999,0,9999,0
1656052432027,MATH 197,004,095571,Perols; Johan Lars,9998,0,9999,1
1656052439080,COGS 9,A01,083615,Shannon; Kyle Michael,3,1,75,72
1656052445176,COGS 11,A01,083617,Boyle; Mary E. T.,11,2,48,37
1656052451201,COGS 13,A01,083071,Bastos; Amalia Pinkusfeld,4,3,71,67
1656052457225,COGS 14A,A01,092681,Semenuks; Arturs,4,25,100,96
1656052463251,COGS 14B,A01,083073,Cheng; Tzu-Han,7,0,63,56
1656052469274,COGS 17,A01,092677,Semenuks; Arturs,9,7,81,72
1656052475297,COGS 100,A01,083619,Allen; Michael Gordon,3,2,70,67
1656052481323,COGS 101A,A01,083621,Davis; Joshua Daniel,4,3,68,64
1656052487347,COGS 101B,A01,091572,Allen; Michael Gordon,0,0,65,65
1656052493376,COGS 101C,A01,083625,Delgado; Tania,7,0,35,28
1656052499401,COGS 107A,A01,083627,Boyle; Mary E. T.,1,2,60,59
1656052505437,COGS 118A,A01,083075,Gupta; Anjum,21,16,76,55
1656052511466,CSE 3,A50,083646,Miranda; Gregory Joseph,14,0,50,36
1656052517496,CSE 8A,A50,083650,Miranda; Gregory Joseph,4,11,56,52
1656052523520,CSE 11,A01,083080,Cao; Yingjun,0,64,40,40
1656052529547,CSE 12,A01,083652,Krause-Levy; Sophia Louisa,7,8,120,113
1656052535571,CSE 15L,A01,083654,Morris; Justin Loren,3,1,50,47
1656052535571,CSE 15L,A02,083655,Morris; Justin Loren,2,1,50,48
1656052541595,CSE 20,A01,083657,Tran; Khoa Dang,29,0,80,51
1656052547619,CSE 21,A01,095574,Bach; Quang Tran,23,0,48,25
1656052553648,CSE 30,A01,083084,Eldon; John,2,10,80,78
1656052553648,CSE 30,B01,095061,Bhaskar; Nishant,2,5,50,48
1656052559673,CSE 100,A01,083659,Cao; Yingjun,2,25,70,68
1656052565700,CSE 134B,A01,083661,Powell; Thomas Allan,6,6,100,94
1656052571723,CSE 140,A01,083663,Gungor; Onat,6,0,85,79
1656052577758,CSE 140L,A01,083088,Eldon; John,5,0,100,95
1656052583779,CSE 175,A01,083665,Kumar; Rakesh,0,0,25,25
1656052589805,CSE 190,A00,092507,Dubnov; Shlomo,1,0,20,19
1656052595832,ECE 45,A01,083139,Congero; Spencer William,1,2,75,74
1656052601857,ECE 65,A50,083695,Saad; Andrew S,6,0,30,24
1656052601857,ECE 65,A51,095125,Staff,23,0,26,3
1656052607882,ECE 109,A01,091882,Touri; Behrouz,3,5,70,67
1656052613910,ECE 180,A00,083140,Abi Samra; Nicholas Camill,1,0,30,29
1656052613910,ECE 180,B00,083141,Abi Samra; Nicholas Camill,0,8,28,28
1656052619934,MATH 10A,A01,083735,Patchell; Gregory David,0,0,30,30
1656052619934,MATH 10A,A02,083736,Patchell; Gregory David,20,0,30,10
1656052619934,MATH 10A,A03,083737,Patchell; Gregory David,16,0,30,14
1656052625965,MATH 10B,A01,083207,Lim; Seonhee,1,1,34,33
1656052625965,MATH 10B,A02,083208,Lim; Seonhee,1,1,35,34
1656052625965,MATH 10B,A03,093472,Staff,0,1,34,34
1656052625965,MATH 10B,B01,083739,Sinha; Shubham,10,0,30,20
1656052631996,MATH 18,A01,083743,Cinel; Cameron Alexander,5,0,30,25
1656052631996,MATH 18,A02,083744,Cinel; Cameron Alexander,11,0,30,19
1656052631996,MATH 18,A03,083745,Cinel; Cameron Alexander,2,0,30,28
1656052631996,MATH 18,B01,083748,Ma; Zilu,0,0,36,36
1656052631996,MATH 18,B02,083749,Ma; Zilu,0,0,36,36
1656052631996,MATH 18,B03,083750,Ma; Zilu,0,0,36,36
1656052631996,MATH 18,B04,083751,Ma; Zilu,0,0,36,36
1656052631996,MATH 18,B05,093473,Staff,0,0,36,36
1656052631996,MATH 18,B06,093474,Staff,3,0,36,33
1656052638024,MATH 20A,A01,083754,Zheng; Zequn,11,0,40,29
1656052644053,MATH 20B,A01,083756,Briones; Jor-el Thomas Caparas,0,0,36,36
1656052644053,MATH 20B,A02,083757,Briones; Jor-el Thomas Caparas,0,0,36,36
1656052644053,MATH 20B,A03,093475,Staff,0,0,36,36
1656052650077,MATH 20C,A01,083760,Briones; Jor-el Thomas Caparas,0,2,35,35
1656052650077,MATH 20C,A02,083761,Briones; Jor-el Thomas Caparas,6,1,35,29
1656052650077,MATH 20C,A03,093476,Staff,0,1,35,35
1656052650077,MATH 20C,B01,083762,Bach; Quang Tran,3,0,30,27
1656052656103,MATH 20D,A01,083765,Tran; Brian Kha,3,0,30,27
1656052656103,MATH 20D,A02,083766,Tran; Brian Kha,0,1,30,30
1656052656103,MATH 20D,A03,083767,Tran; Brian Kha,1,0,30,29
1656052662127,MATH 20E,A01,083771,Ganguly; Soumya,0,1,32,32
1656052662127,MATH 20E,A02,083772,Ganguly; Soumya,1,1,32,31
1656052662127,MATH 20E,B01,083773,Ciotti; Benjamin,14,0,35,21
1656052662127,MATH 20E,B02,083774,Ciotti; Benjamin,13,0,35,22
1656052668152,MATH 103A,A01,083777,Greenfeld; Be'Eri,2,1,36,34
1656052668152,MATH 103A,A02,083778,Greenfeld; Be'Eri,2,0,36,34
1656052668152,MATH 103A,A03,093561,Staff,0,1,36,36
1656052668152,MATH 103A,B01,083779,Greenfeld; Be'Eri,8,1,36,28
1656052668152,MATH 103A,B02,083780,Greenfeld; Be'Eri,0,0,36,36
1656052668152,MATH 103A,B03,093562,Staff,0,0,36,36
1656052674184,MATH 105,A01,085443,Carter; Anne Toulson,4,1,35,31
1656052674184,MATH 105,A02,093477,Staff,9,0,35,26
1656052680216,MATH 109,A01,083213,Ganzberger; Geoffrey Michael,1,1,34,33
1656052680216,MATH 109,A02,083214,Ganzberger; Geoffrey Michael,0,0,34,34
1656052680216,MATH 109,A03,093478,Staff,1,0,34,33
1656052680216,MATH 109,B01,083215,Ganzberger; Geoffrey Michael,2,0,32,30
1656052680216,MATH 109,B02,083216,Ganzberger; Geoffrey Michael,0,0,32,32
1656052680216,MATH 109,B03,093479,Staff,3,0,32,29
1656052686241,MATH 142A,A01,083219,Chow; Bennett,1,0,32,31
1656052686241,MATH 142A,A02,083220,Chow; Bennett,7,0,32,25
1656052686241,MATH 142A,A03,093480,Staff,4,0,32,28
1656052686241,MATH 142A,B03,093481,Staff,4,0,32,28
1656052686241,MATH 142A,B04,093558,Staff,6,0,32,26
1656052686241,MATH 142A,B05,093559,Staff,0,0,32,32
1656052692270,MATH 193A,A01,083224,Rotar; Vladimir,1,2,34,33
1656052692270,MATH 193A,A02,083225,Rotar; Vladimir,0,0,34,34
1656052692270,MATH 193A,A03,083781,Rotar; Vladimir,1,0,34,33
1656052692270,MATH 193A,A04,083782,Rotar; Vladimir,3,0,34,31
1656052692270,MATH 193A,A05,093482,Rotar; Vladimir,0,0,34,34
1656052698294,MATH 197,001,091859,McAuley; Julian John,9999,0,9999,0
1656052698294,MATH 197,002,095566,Kedlaya; Kiran S.,9997,0,9999,2
1656052698294,MATH 197,003,095567,Xiao; Ming,9999,0,9999,0
1656052698294,MATH 197,004,095571,Perols; Johan Lars,9998,0,9999,1
1656052705350,COGS 9,A01,083615,Shannon; Kyle Michael,3,1,75,72
1656052711374,COGS 11,A01,083617,Boyle; Mary E. T.,11,2,48,37
1656052717400,COGS 13,A01,083071,Bastos; Amalia Pinkusfeld,4,3,71,67
1656052723428,COGS 14A,A01,092681,Semenuks; Arturs,4,25,100,96
1656052729452,COGS 14B,A01,083073,Cheng; Tzu-Han,7,0,63,56
1656052735477,COGS 17,A01,092677,Semenuks; Arturs,9,7,81,72
1656052741500,COGS 100,A01,083619,Allen; Michael Gordon,3,2,70,67
1656052747527,COGS 101A,A01,083621,Davis; Joshua Daniel,4,3,68,64
1656052753556,COGS 101B,A01,091572,Allen; Michael Gordon,0,0,65,65
1656052759579,COGS 101C,A01,083625,Delgado; Tania,7,0,35,28
1656052765604,COGS 107A,A01,083627,Boyle; Mary E. T.,1,2,60,59
1656052771633,COGS 118A,A01,083075,Gupta; Anjum,21,16,76,55
1656052777659,CSE 3,A50,083646,Miranda; Gregory Joseph,14,0,50,36
1656052783684,CSE 8A,A50,083650,Miranda; Gregory Joseph,4,11,56,52
1656052789710,CSE 11,A01,083080,Cao; Yingjun,0,64,40,40
1656052795746,CSE 12,A01,083652,Krause-Levy; Sophia Louisa,7,8,120,113
1656052801770,CSE 15L,A01,083654,Morris; Justin Loren,3,1,50,47
1656052801770,CSE 15L,A02,083655,Morris; Justin Loren,2,1,50,48
1656052807794,CSE 20,A01,083657,Tran; Khoa Dang,29,0,80,51
1656052813818,CSE 21,A01,095574,Bach; Quang Tran,23,0,48,25
1656052819846,CSE 30,A01,083084,Eldon; John,2,10,80,78
1656052819846,CSE 30,B01,095061,Bhaskar; Nishant,2,5,50,48
1656052825876,CSE 100,A01,083659,Cao; Yingjun,2,25,70,68
1656052831899,CSE 134B,A01,083661,Powell; Thomas Allan,6,6,100,94
1656052837924,CSE 140,A01,083663,Gungor; Onat,6,0,85,79
1656052843948,CSE 140L,A01,083088,Eldon; John,5,0,100,95
1656052849973,CSE 175,A01,083665,Kumar; Rakesh,0,0,25,25
1656052855998,CSE 190,A00,092507,Dubnov; Shlomo,1,0,20,19
1656052862026,ECE 45,A01,083139,Congero; Spencer William,1,2,75,74
1656052868052,ECE 65,A50,083695,Saad; Andrew S,6,0,30,24
1656052868052,ECE 65,A51,095125,Staff,23,0,26,3
1656052874079,ECE 109,A01,091882,Touri; Behrouz,3,5,70,67
1656052880105,ECE 180,A00,083140,Abi Samra; Nicholas Camill,1,0,30,29
1656052880105,ECE 180,B00,083141,Abi Samra; Nicholas Camill,0,8,28,28
1656052886141,MATH 10A,A01,083735,Patchell; Gregory David,0,0,30,30
1656052886141,MATH 10A,A02,083736,Patchell; Gregory David,20,0,30,10
1656052886141,MATH 10A,A03,083737,Patchell; Gregory David,16,0,30,14
1656052892165,MATH 10B,A01,083207,Lim; Seonhee,1,1,34,33
1656052892165,MATH 10B,A02,083208,Lim; Seonhee,1,1,35,34
1656052892165,MATH 10B,A03,093472,Staff,0,1,34,34
1656052892165,MATH 10B,B01,083739,Sinha; Shubham,10,0,30,20
1656052898196,MATH 18,A01,083743,Cinel; Cameron Alexander,5,0,30,25
1656052898196,MATH 18,A02,083744,Cinel; Cameron Alexander,11,0,30,19
1656052898196,MATH 18,A03,083745,Cinel; Cameron Alexander,2,0,30,28
1656052898196,MATH 18,B01,083748,Ma; Zilu,0,0,36,36
1656052898196,MATH 18,B02,083749,Ma; Zilu,0,0,36,36
1656052898196,MATH 18,B03,083750,Ma; Zilu,0,0,36,36
1656052898196,MATH 18,B04,083751,Ma; Zilu,0,0,36,36
1656052898196,MATH 18,B05,093473,Staff,0,0,36,36
1656052898196,MATH 18,B06,093474,Staff,3,0,36,33
1656052904219,MATH 20A,A01,083754,Zheng; Zequn,11,0,40,29
1656052910245,MATH 20B,A01,083756,Briones; Jor-el Thomas Caparas,0,0,36,36
1656052910245,MATH 20B,A02,083757,Briones; Jor-el Thomas Caparas,0,0,36,36
1656052910245,MATH 20B,A03,093475,Staff,0,0,36,36
1656052916269,MATH 20C,A01,083760,Briones; Jor-el Thomas Caparas,0,2,35,35
1656052916269,MATH 20C,A02,083761,Briones; Jor-el Thomas Caparas,6,1,35,29
1656052916269,MATH 20C,A03,093476,Staff,0,1,35,35
1656052916269,MATH 20C,B01,083762,Bach; Quang Tran,3,0,30,27
1656052922293,MATH 20D,A01,083765,Tran; Brian Kha,3,0,30,27
1656052922293,MATH 20D,A02,083766,Tran; Brian Kha,0,1,30,30
1656052922293,MATH 20D,A03,083767,Tran; Brian Kha,1,0,30,29
1656052928323,MATH 20E,A01,083771,Ganguly; Soumya,0,1,32,32
1656052928323,MATH 20E,A02,083772,Ganguly; Soumya,1,1,32,31
1656052928323,MATH 20E,B01,083773,Ciotti; Benjamin,14,0,35,21
1656052928323,MATH 20E,B02,083774,Ciotti; Benjamin,13,0,35,22
1656052934348,MATH 103A,A01,083777,Greenfeld; Be'Eri,2,1,36,34
1656052934348,MATH 103A,A02,083778,Greenfeld; Be'Eri,2,0,36,34
1656052934348,MATH 103A,A03,093561,Staff,0,1,36,36
1656052934348,MATH 103A,B01,083779,Greenfeld; Be'Eri,8,1,36,28
1656052934348,MATH 103A,B02,083780,Greenfeld; Be'Eri,0,0,36,36
1656052934348,MATH 103A,B03,093562,Staff,0,0,36,36
1656052940374,MATH 105,A01,085443,Carter; Anne Toulson,4,1,35,31
1656052940374,MATH 105,A02,093477,Staff,9,0,35,26
1656052946406,MATH 109,A01,083213,Ganzberger; Geoffrey Michael,1,1,34,33
1656052946406,MATH 109,A02,083214,Ganzberger; Geoffrey Michael,0,0,34,34
1656052946406,MATH 109,A03,093478,Staff,1,0,34,33
1656052946406,MATH 109,B01,083215,Ganzberger; Geoffrey Michael,2,0,32,30
1656052946406,MATH 109,B02,083216,Ganzberger; Geoffrey Michael,0,0,32,32
1656052946406,MATH 109,B03,093479,Staff,3,0,32,29
1656052952431,MATH 142A,A01,083219,Chow; Bennett,1,0,32,31
1656052952431,MATH 142A,A02,083220,Chow; Bennett,7,0,32,25
1656052952431,MATH 142A,A03,093480,Staff,4,0,32,28
1656052952431,MATH 142A,B03,093481,Staff,4,0,32,28
1656052952431,MATH 142A,B04,093558,Staff,6,0,32,26
1656052952431,MATH 142A,B05,093559,Staff,0,0,32,32
1656052958456,MATH 193A,A01,083224,Rotar; Vladimir,1,2,34,33
1656052958456,MATH 193A,A02,083225,Rotar; Vladimir,0,0,34,34
1656052958456,MATH 193A,A03,083781,Rotar; Vladimir,1,0,34,33
1656052958456,MATH 193A,A04,083782,Rotar; Vladimir,3,0,34,31
1656052958456,MATH 193A,A05,093482,Rotar; Vladimir,0,0,34,34
1656052964482,MATH 197,001,091859,McAuley; Julian John,9999,0,9999,0
1656052964482,MATH 197,002,095566,Kedlaya; Kiran S.,9997,0,9999,2
1656052964482,MATH 197,003,095567,Xiao; Ming,9999,0,9999,0
1656052964482,MATH 197,004,095571,Perols; Johan Lars,9998,0,9999,1
1656052971544,COGS 9,A01,083615,Shannon; Kyle Michael,3,1,75,72
1656052977571,COGS 11,A01,083617,Boyle; Mary E. T.,11,2,48,37
1656052983595,COGS 13,A01,083071,Bastos; Amalia Pinkusfeld,4,3,71,67
1656052989626,COGS 14A,A01,092681,Semenuks; Arturs,4,25,100,96
1656052995652,COGS 14B,A01,083073,Cheng; Tzu-Han,7,0,63,56
1656053001683,COGS 17,A01,092677,Semenuks; Arturs,9,7,81,72
1656053007707,COGS 100,A01,083619,Allen; Michael Gordon,3,2,70,67
1656053013732,COGS 101A,A01,083621,Davis; Joshua Daniel,4,3,68,64
1656053019759,COGS 101B,A01,091572,Allen; Michael Gordon,0,0,65,65
1656053025789,COGS 101C,A01,083625,Delgado; Tania,7,0,35,28
1656053031812,COGS 107A,A01,083627,Boyle; Mary E. T.,1,2,60,59
1656053037836,COGS 118A,A01,083075,Gupta; Anjum,21,16,76,55
1656053043948,CSE 3,A50,083646,Miranda; Gregory Joseph,14,0,50,36
1656053049976,CSE 8A,A50,083650,Miranda; Gregory Joseph,4,11,56,52
1656053056000,CSE 11,A01,083080,Cao; Yingjun,0,64,40,40
1656053062025,CSE 12,A01,083652,Krause-Levy; Sophia Louisa,7,8,120,113
1656053068049,CSE 15L,A01,083654,Morris; Justin Loren,3,1,50,47
1656053068049,CSE 15L,A02,083655,Morris; Justin Loren,2,1,50,48
1656053074077,CSE 20,A01,083657,Tran; Khoa Dang,29,0,80,51
1656053080101,CSE 21,A01,095574,Bach; Quang Tran,23,0,48,25
1656053086125,CSE 30,A01,083084,Eldon; John,2,10,80,78
1656053086125,CSE 30,B01,095061,Bhaskar; Nishant,2,5,50,48
1656053092149,CSE 100,A01,083659,Cao; Yingjun,2,25,70,68
1656053098173,CSE 134B,A01,083661,Powell; Thomas Allan,6,6,100,94
1656053104200,CSE 140,A01,083663,Gungor; Onat,6,0,85,79
1656053110223,CSE 140L,A01,083088,Eldon; John,5,0,100,95
1656053116248,CSE 175,A01,083665,Kumar; Rakesh,0,0,25,25
1656053122275,CSE 190,A00,092507,Dubnov; Shlomo,1,0,20,19
1656053128305,ECE 45,A01,083139,Congero; Spencer William,1,2,75,74
1656053134332,ECE 65,A50,083695,Saad; Andrew S,6,0,30,24
1656053134332,ECE 65,A51,095125,Staff,23,0,26,3
1656053140354,ECE 109,A01,091882,Touri; Behrouz,3,5,70,67
1656053146377,ECE 180,A00,083140,Abi Samra; Nicholas Camill,1,0,30,29
1656053146377,ECE 180,B00,083141,Abi Samra; Nicholas Camill,0,8,28,28
1656053152404,MATH 10A,A01,083735,Patchell; Gregory David,0,0,30,30
1656053152404,MATH 10A,A02,083736,Patchell; Gregory David,20,0,30,10
1656053152404,MATH 10A,A03,083737,Patchell; Gregory David,16,0,30,14
1656053158429,MATH 10B,A01,083207,Lim; Seonhee,1,1,34,33
1656053158429,MATH 10B,A02,083208,Lim; Seonhee,1,1,35,34
1656053158429,MATH 10B,A03,093472,Staff,0,1,34,34
1656053158429,MATH 10B,B01,083739,Sinha; Shubham,10,0,30,20
1656053164459,MATH 18,A01,083743,Cinel; Cameron Alexander,5,0,30,25
1656053164459,MATH 18,A02,083744,Cinel; Cameron Alexander,11,0,30,19
1656053164459,MATH 18,A03,083745,Cinel; Cameron Alexander,2,0,30,28
1656053164459,MATH 18,B01,083748,Ma; Zilu,0,0,36,36
1656053164459,MATH 18,B02,083749,Ma; Zilu,0,0,36,36
1656053164459,MATH 18,B03,083750,Ma; Zilu,0,0,36,36
1656053164459,MATH 18,B04,083751,Ma; Zilu,0,0,36,36
1656053164459,MATH 18,B05,093473,Staff,0,0,36,36
1656053164459,MATH 18,B06,093474,Staff,3,0,36,33
1656053170486,MATH 20A,A01,083754,Zheng; Zequn,11,0,40,29
1656053176511,MATH 20B,A01,083756,Briones; Jor-el Thomas Caparas,0,0,36,36
1656053176511,MATH 20B,A02,083757,Briones; Jor-el Thomas Caparas,0,0,36,36
1656053176511,MATH 20B,A03,093475,Staff,0,0,36,36
1656053182535,MATH 20C,A01,083760,Briones; Jor-el Thomas Caparas,0,2,35,35
1656053182535,MATH 20C,A02,083761,Briones; Jor-el Thomas Caparas,6,1,35,29
1656053182535,MATH 20C,A03,093476,Staff,0,1,35,35
1656053182535,MATH 20C,B01,083762,Bach; Quang Tran,3,0,30,27
1656053188563,MATH 20D,A01,083765,Tran; Brian Kha,3,0,30,27
1656053188563,MATH 20D,A02,083766,Tran; Brian Kha,0,1,30,30
1656053188563,MATH 20D,A03,083767,Tran; Brian Kha,1,0,30,29
1656053194586,MATH 20E,A01,083771,Ganguly; Soumya,1,1,32,31
1656053194586,MATH 20E,A02,083772,Ganguly; Soumya,1,1,32,31
1656053194586,MATH 20E,B01,083773,Ciotti; Benjamin,14,0,35,21
1656053194586,MATH 20E,B02,083774,Ciotti; Benjamin,13,0,35,22
1656053200611,MATH 103A,A01,083777,Greenfeld; Be'Eri,2,1,36,34
1656053200611,MATH 103A,A02,083778,Greenfeld; Be'Eri,1,0,36,35
1656053200611,MATH 103A,A03,093561,Staff,0,1,36,36
1656053200611,MATH 103A,B01,083779,Greenfeld; Be'Eri,8,1,36,28
1656053200611,MATH 103A,B02,083780,Greenfeld; Be'Eri,0,0,36,36
1656053200611,MATH 103A,B03,093562,Staff,0,0,36,36
1656053206634,MATH 105,A01,085443,Carter; Anne Toulson,4,1,35,31
1656053206634,MATH 105,A02,093477,Staff,9,0,35,26
1656053212659,MATH 109,A01,083213,Ganzberger; Geoffrey Michael,1,1,34,33
1656053212659,MATH 109,A02,083214,Ganzberger; Geoffrey Michael,0,0,34,34
1656053212659,MATH 109,A03,093478,Staff,1,0,34,33
1656053212659,MATH 109,B01,083215,Ganzberger; Geoffrey Michael,2,0,32,30
1656053212659,MATH 109,B02,083216,Ganzberger; Geoffrey Michael,0,0,32,32
1656053212659,MATH 109,B03,093479,Staff,3,0,32,29
1656053218688,MATH 142A,A01,083219,Chow; Bennett,1,0,32,31
1656053218688,MATH 142A,A02,083220,Chow; Bennett,7,0,32,25
1656053218688,MATH 142A,A03,093480,Staff,4,0,32,28
1656053218688,MATH 142A,B03,093481,Staff,4,0,32,28
1656053218688,MATH 142A,B04,093558,Staff,6,0,32,26
1656053218688,MATH 142A,B05,093559,Staff,0,0,32,32
1656053224717,MATH 193A,A01,083224,Rotar; Vladimir,1,2,34,33
1656053224717,MATH 193A,A02,083225,Rotar; Vladimir,1,0,34,33
1656053224717,MATH 193A,A03,083781,Rotar; Vladimir,1,0,34,33
1656053224717,MATH 193A,A04,083782,Rotar; Vladimir,3,0,34,31
1656053224717,MATH 193A,A05,093482,Rotar; Vladimir,0,0,34,34
1656053230740,MATH 197,001,091859,McAuley; Julian John,9999,0,9999,0
1656053230740,MATH 197,002,095566,Kedlaya; Kiran S.,9997,0,9999,2
1656053230740,MATH 197,003,095567,Xiao; Ming,9999,0,9999,0
1656053230740,MATH 197,004,095571,Perols; Johan Lars,9998,0,9999,1
1656053237799,COGS 9,A01,083615,Shannon; Kyle Michael,3,1,75,72
1656053243825,COGS 11,A01,083617,Boyle; Mary E. T.,11,2,48,37
1656053249852,COGS 13,A01,083071,Bastos; Amalia Pinkusfeld,4,3,71,67
1656053255880,COGS 14A,A01,092681,Semenuks; Arturs,4,25,100,96
1656053261905,COGS 14B,A01,083073,Cheng; Tzu-Han,7,0,63,56
1656053267931,COGS 17,A01,092677,Semenuks; Arturs,9,7,81,72
1656053273955,COGS 100,A01,083619,Allen; Michael Gordon,3,2,70,67
1656053279982,COGS 101A,A01,083621,Davis; Joshua Daniel,4,3,68,64
1656053286004,COGS 101B,A01,091572,Allen; Michael Gordon,0,0,65,65
1656053292032,COGS 101C,A01,083625,Delgado; Tania,7,0,35,28
1656053298059,COGS 107A,A01,083627,Boyle; Mary E. T.,1,2,60,59
1656053304084,COGS 118A,A01,083075,Gupta; Anjum,21,16,76,55
1656053310111,CSE 3,A50,083646,Miranda; Gregory Joseph,14,0,50,36
1656053316138,CSE 8A,A50,083650,Miranda; Gregory Joseph,4,11,56,52
1656053322162,CSE 11,A01,083080,Cao; Yingjun,0,64,40,40
1656053328184,CSE 12,A01,083652,Krause-Levy; Sophia Louisa,7,8,120,113
1656053334211,CSE 15L,A01,083654,Morris; Justin Loren,3,1,50,47
1656053334211,CSE 15L,A02,083655,Morris; Justin Loren,2,1,50,48
1656053340234,CSE 20,A01,083657,Tran; Khoa Dang,29,0,80,51
1656053346260,CSE 21,A01,095574,Bach; Quang Tran,23,0,48,25
1656053352288,CSE 30,A01,083084,Eldon; John,2,10,80,78
1656053352288,CSE 30,B01,095061,Bhaskar; Nishant,2,5,50,48
1656053358311,CSE 100,A01,083659,Cao; Yingjun,2,25,70,68
1656053364335,CSE 134B,A01,083661,Powell; Thomas Allan,6,6,100,94
1656053370368,CSE 140,A01,083663,Gungor; Onat,6,0,85,79
1656053376392,CSE 140L,A01,083088,Eldon; John,5,0,100,95
1656053382416,CSE 175,A01,083665,Kumar; Rakesh,0,0,25,25
1656053388438,CSE 190,A00,092507,Dubnov; Shlomo,1,0,20,19
1656053394461,ECE 45,A01,083139,Congero; Spencer William,1,2,75,74
1656053400485,ECE 65,A50,083695,Saad; Andrew S,6,0,30,24
1656053400485,ECE 65,A51,095125,Staff,23,0,26,3
1656053406509,ECE 109,A01,091882,Touri; Behrouz,3,5,70,67
1656053412531,ECE 180,A00,083140,Abi Samra; Nicholas Camill,1,0,30,29
1656053412531,ECE 180,B00,083141,Abi Samra; Nicholas Camill,0,8,28,28
1656053418555,MATH 10A,A01,083735,Patchell; Gregory David,0,0,30,30
1656053418555,MATH 10A,A02,083736,Patchell; Gregory David,20,0,30,10
1656053418555,MATH 10A,A03,083737,Patchell; Gregory David,16,0,30,14
1656053424587,MATH 10B,A01,083207,Lim; Seonhee,1,1,34,33
1656053424587,MATH 10B,A02,083208,Lim; Seonhee,1,1,35,34
1656053424587,MATH 10B,A03,093472,Staff,0,1,34,34
1656053424587,MATH 10B,B01,083739,Sinha; Shubham,10,0,30,20
1656053430619,MATH 18,A01,083743,Cinel; Cameron Alexander,5,0,30,25
1656053430619,MATH 18,A02,083744,Cinel; Cameron Alexander,11,0,30,19
1656053430619,MATH 18,A03,083745,Cinel; Cameron Alexander,2,0,30,28
1656053430619,MATH 18,B01,083748,Ma; Zilu,0,0,36,36
1656053430619,MATH 18,B02,083749,Ma; Zilu,0,0,36,36
1656053430619,MATH 18,B03,083750,Ma; Zilu,0,0,36,36
1656053430619,MATH 18,B04,083751,Ma; Zilu,0,0,36,36
1656053430619,MATH 18,B05,093473,Staff,0,0,36,36
1656053430619,MATH 18,B06,093474,Staff,3,0,36,33
1656053436646,MATH 20A,A01,083754,Zheng; Zequn,11,0,40,29
1656053442674,MATH 20B,A01,083756,Briones; Jor-el Thomas Caparas,0,0,36,36
1656053442674,MATH 20B,A02,083757,Briones; Jor-el Thomas Caparas,0,0,36,36
1656053442674,MATH 20B,A03,093475,Staff,0,0,36,36
1656053448699,MATH 20C,A01,083760,Briones; Jor-el Thomas Caparas,0,2,35,35
1656053448699,MATH 20C,A02,083761,Briones; Jor-el Thomas Caparas,6,1,35,29
1656053448699,MATH 20C,A03,093476,Staff,0,1,35,35
1656053448699,MATH 20C,B01,083762,Bach; Quang Tran,3,0,30,27
1656053454739,MATH 20D,A01,083765,Tran; Brian Kha,3,0,30,27
1656053454739,MATH 20D,A02,083766,Tran; Brian Kha,0,1,30,30
1656053454739,MATH 20D,A03,083767,Tran; Brian Kha,1,0,30,29
1656053460763,MATH 20E,A01,083771,Ganguly; Soumya,1,1,32,31
1656053460763,MATH 20E,A02,083772,Ganguly; Soumya,1,1,32,31
1656053460763,MATH 20E,B01,083773,Ciotti; Benjamin,14,0,35,21
1656053460763,MATH 20E,B02,083774,Ciotti; Benjamin,13,0,35,22
1656053466792,MATH 103A,A01,083777,Greenfeld; Be'Eri,2,1,36,34
1656053466792,MATH 103A,A02,083778,Greenfeld; Be'Eri,1,0,36,35
1656053466792,MATH 103A,A03,093561,Staff,0,1,36,36
1656053466792,MATH 103A,B01,083779,Greenfeld; Be'Eri,8,1,36,28
1656053466792,MATH 103A,B02,083780,Greenfeld; Be'Eri,0,0,36,36
1656053466792,MATH 103A,B03,093562,Staff,0,0,36,36
1656053472821,MATH 105,A01,085443,Carter; Anne Toulson,4,1,35,31
1656053472821,MATH 105,A02,093477,Staff,9,0,35,26
1656053478850,MATH 109,A01,083213,Ganzberger; Geoffrey Michael,1,1,34,33
1656053478850,MATH 109,A02,083214,Ganzberger; Geoffrey Michael,0,0,34,34
1656053478850,MATH 109,A03,093478,Staff,1,0,34,33
1656053478850,MATH 109,B01,083215,Ganzberger; Geoffrey Michael,2,0,32,30
1656053478850,MATH 109,B02,083216,Ganzberger; Geoffrey Michael,0,0,32,32
1656053478850,MATH 109,B03,093479,Staff,3,0,32,29
1656053484880,MATH 142A,A01,083219,Chow; Bennett,1,0,32,31
1656053484880,MATH 142A,A02,083220,Chow; Bennett,7,0,32,25
1656053484880,MATH 142A,A03,093480,Staff,4,0,32,28
1656053484880,MATH 142A,B03,093481,Staff,5,0,32,27
1656053484880,MATH 142A,B04,093558,Staff,6,0,32,26
1656053484880,MATH 142A,B05,093559,Staff,0,0,32,32
1656053490903,MATH 193A,A01,083224,Rotar; Vladimir,1,2,34,33
1656053490903,MATH 193A,A02,083225,Rotar; Vladimir,1,0,34,33
1656053490903,MATH 193A,A03,083781,Rotar; Vladimir,1,0,34,33
1656053490903,MATH 193A,A04,083782,Rotar; Vladimir,3,0,34,31
1656053490903,MATH 193A,A05,093482,Rotar; Vladimir,0,0,34,34
1656053496933,MATH 197,001,091859,McAuley; Julian John,9999,0,9999,0
1656053496933,MATH 197,002,095566,Kedlaya; Kiran S.,9997,0,9999,2
1656053496933,MATH 197,003,095567,Xiao; Ming,9999,0,9999,0
1656053496933,MATH 197,004,095571,Perols; Johan Lars,9998,0,9999,1
1656053503985,COGS 9,A01,083615,Shannon; Kyle Michael,3,1,75,72
1656053510012,COGS 11,A01,083617,Boyle; Mary E. T.,11,2,48,37
1656053516035,COGS 13,A01,083071,Bastos; Amalia Pinkusfeld,4,3,71,67
1656053522062,COGS 14A,A01,092681,Semenuks; Arturs,4,25,100,96
1656053528085,COGS 14B,A01,083073,Cheng; Tzu-Han,7,0,63,56
1656053534111,COGS 17,A01,092677,Semenuks; Arturs,9,7,81,72
1656053540138,COGS 100,A01,083619,Allen; Michael Gordon,3,2,70,67
1656053546164,COGS 101A,A01,083621,Davis; Joshua Daniel,4,3,68,64
1656053552188,COGS 101B,A01,091572,Allen; Michael Gordon,0,0,65,65
1656053558216,COGS 101C,A01,083625,Delgado; Tania,7,0,35,28
1656053564244,COGS 107A,A01,083627,Boyle; Mary E. T.,1,2,60,59
1656053570268,COGS 118A,A01,083075,Gupta; Anjum,21,16,76,55
1656053576296,CSE 3,A50,083646,Miranda; Gregory Joseph,14,0,50,36
1656053582325,CSE 8A,A50,083650,Miranda; Gregory Joseph,4,11,56,52
1656053588352,CSE 11,A01,083080,Cao; Yingjun,0,64,40,40
1656053594375,CSE 12,A01,083652,Krause-Levy; Sophia Louisa,7,8,120,113
1656053600400,CSE 15L,A01,083654,Morris; Justin Loren,3,1,50,47
1656053600400,CSE 15L,A02,083655,Morris; Justin Loren,2,1,50,48
1656053606425,CSE 20,A01,083657,Tran; Khoa Dang,29,0,80,51
1656053612447,CSE 21,A01,095574,Bach; Quang Tran,23,0,48,25
1656053618473,CSE 30,A01,083084,Eldon; John,2,10,80,78
1656053618473,CSE 30,B01,095061,Bhaskar; Nishant,2,5,50,48
1656053624497,CSE 100,A01,083659,Cao; Yingjun,2,25,70,68
1656053630524,CSE 134B,A01,083661,Powell; Thomas Allan,6,6,100,94
1656053636549,CSE 140,A01,083663,Gungor; Onat,6,0,85,79
1656053642675,CSE 140L,A01,083088,Eldon; John,5,0,100,95
1656053648703,CSE 175,A01,083665,Kumar; Rakesh,0,0,25,25
1656053654726,CSE 190,A00,092507,Dubnov; Shlomo,1,0,20,19
1656053660754,ECE 45,A01,083139,Congero; Spencer William,1,2,75,74
1656053666779,ECE 65,A50,083695,Saad; Andrew S,6,0,30,24
1656053666779,ECE 65,A51,095125,Staff,23,0,26,3
1656053672801,ECE 109,A01,091882,Touri; Behrouz,3,5,70,67
1656053678832,ECE 180,A00,083140,Abi Samra; Nicholas Camill,1,0,30,29
1656053678832,ECE 180,B00,083141,Abi Samra; Nicholas Camill,0,8,28,28
1656053684860,MATH 10A,A01,083735,Patchell; Gregory David,0,0,30,30
1656053684860,MATH 10A,A02,083736,Patchell; Gregory David,20,0,30,10
1656053684860,MATH 10A,A03,083737,Patchell; Gregory David,16,0,30,14
1656053690886,MATH 10B,A01,083207,Lim; Seonhee,1,1,34,33
1656053690886,MATH 10B,A02,083208,Lim; Seonhee,1,1,35,34
1656053690886,MATH 10B,A03,093472,Staff,0,1,34,34
1656053690886,MATH 10B,B01,083739,Sinha; Shubham,10,0,30,20
1656053696916,MATH 18,A01,083743,Cinel; Cameron Alexander,5,0,30,25
1656053696916,MATH 18,A02,083744,Cinel; Cameron Alexander,11,0,30,19
1656053696916,MATH 18,A03,083745,Cinel; Cameron Alexander,2,0,30,28
1656053696916,MATH 18,B01,083748,Ma; Zilu,0,0,36,36
1656053696916,MATH 18,B02,083749,Ma; Zilu,0,0,36,36
1656053696916,MATH 18,B03,083750,Ma; Zilu,0,0,36,36
1656053696916,MATH 18,B04,083751,Ma; Zilu,0,0,36,36
1656053696916,MATH 18,B05,093473,Staff,0,0,36,36
1656053696916,MATH 18,B06,093474,Staff,3,0,36,33
1656053702943,MATH 20A,A01,083754,Zheng; Zequn,11,0,40,29
1656053708967,MATH 20B,A01,083756,Briones; Jor-el Thomas Caparas,0,0,36,36
1656053708967,MATH 20B,A02,083757,Briones; Jor-el Thomas Caparas,0,0,36,36
1656053708967,MATH 20B,A03,093475,Staff,0,0,36,36
1656053714995,MATH 20C,A01,083760,Briones; Jor-el Thomas Caparas,0,2,35,35
1656053714995,MATH 20C,A02,083761,Briones; Jor-el Thomas Caparas,6,1,35,29
1656053714995,MATH 20C,A03,093476,Staff,0,1,35,35
1656053714995,MATH 20C,B01,083762,Bach; Quang Tran,3,0,30,27
1656053721022,MATH 20D,A01,083765,Tran; Brian Kha,3,0,30,27
1656053721022,MATH 20D,A02,083766,Tran; Brian Kha,0,1,30,30
1656053721022,MATH 20D,A03,083767,Tran; Brian Kha,1,0,30,29
1656053727048,MATH 20E,A01,083771,Ganguly; Soumya,1,1,32,31
1656053727048,MATH 20E,A02,083772,Ganguly; Soumya,1,1,32,31
1656053727048,MATH 20E,B01,083773,Ciotti; Benjamin,14,0,35,21
1656053727048,MATH 20E,B02,083774,Ciotti; Benjamin,13,0,35,22
1656053733076,MATH 103A,A01,083777,Greenfeld; Be'Eri,2,1,36,34
1656053733076,MATH 103A,A02,083778,Greenfeld; Be'Eri,1,0,36,35
1656053733076,MATH 103A,A03,093561,Staff,0,1,36,36
1656053733076,MATH 103A,B01,083779,Greenfeld; Be'Eri,8,1,36,28
1656053733076,MATH 103A,B02,083780,Greenfeld; Be'Eri,0,0,36,36
1656053733076,MATH 103A,B03,093562,Staff,0,0,36,36
1656053739102,MATH 105,A01,085443,Carter; Anne Toulson,4,1,35,31
1656053739102,MATH 105,A02,093477,Staff,9,0,35,26
1656053745129,MATH 109,A01,083213,Ganzberger; Geoffrey Michael,1,1,34,33
1656053745129,MATH 109,A02,083214,Ganzberger; Geoffrey Michael,0,0,34,34
1656053745129,MATH 109,A03,093478,Staff,1,0,34,33
1656053745129,MATH 109,B01,083215,Ganzberger; Geoffrey Michael,2,0,32,30
1656053745129,MATH 109,B02,083216,Ganzberger; Geoffrey Michael,0,0,32,32
1656053745129,MATH 109,B03,093479,Staff,3,0,32,29
1656053751154,MATH 142A,A01,083219,Chow; Bennett,1,0,32,31
1656053751154,MATH 142A,A02,083220,Chow; Bennett,7,0,32,25
1656053751154,MATH 142A,A03,093480,Staff,4,0,32,28
1656053751154,MATH 142A,B03,093481,Staff,5,0,32,27
1656053751154,MATH 142A,B04,093558,Staff,6,0,32,26
1656053751154,MATH 142A,B05,093559,Staff,0,0,32,32
1656053757178,MATH 193A,A01,083224,Rotar; Vladimir,1,2,34,33
1656053757178,MATH 193A,A02,083225,Rotar; Vladimir,1,0,34,33
1656053757178,MATH 193A,A03,083781,Rotar; Vladimir,1,0,34,33
1656053757178,MATH 193A,A04,083782,Rotar; Vladimir,3,0,34,31
1656053757178,MATH 193A,A05,093482,Rotar; Vladimir,0,0,34,34
1656053763207,MATH 197,001,091859,McAuley; Julian John,9999,0,9999,0
1656053763207,MATH 197,002,095566,Kedlaya; Kiran S.,9997,0,9999,2
1656053763207,MATH 197,003,095567,Xiao; Ming,9999,0,9999,0
1656053763207,MATH 197,004,095571,Perols; Johan Lars,9998,0,9999,1
1656053770268,COGS 9,A01,083615,Shannon; Kyle Michael,3,1,75,72
1656053776292,COGS 11,A01,083617,Boyle; Mary E. T.,11,2,48,37
1656053782316,COGS 13,A01,083071,Bastos; Amalia Pinkusfeld,4,3,71,67
1656053788338,COGS 14A,A01,092681,Semenuks; Arturs,4,25,100,96
1656053794362,COGS 14B,A01,083073,Cheng; Tzu-Han,7,0,63,56
1656053800384,COGS 17,A01,092677,Semenuks; Arturs,9,7,81,72
1656053806407,COGS 100,A01,083619,Allen; Michael Gordon,3,2,70,67
1656053812430,COGS 101A,A01,083621,Davis; Joshua Daniel,4,3,68,64
1656053818454,COGS 101B,A01,091572,Allen; Michael Gordon,0,0,65,65
1656053824477,COGS 101C,A01,083625,Delgado; Tania,7,0,35,28
1656053830508,COGS 107A,A01,083627,Boyle; Mary E. T.,1,2,60,59
1656053836531,COGS 118A,A01,083075,Gupta; Anjum,21,16,76,55
1656053842556,CSE 3,A50,083646,Miranda; Gregory Joseph,14,0,50,36
1656053848580,CSE 8A,A50,083650,Miranda; Gregory Joseph,4,11,56,52
1656053854603,CSE 11,A01,083080,Cao; Yingjun,0,64,40,40
1656053860627,CSE 12,A01,083652,Krause-Levy; Sophia Louisa,7,8,120,113
1656053866658,CSE 15L,A01,083654,Morris; Justin Loren,3,1,50,47
1656053866658,CSE 15L,A02,083655,Morris; Justin Loren,2,1,50,48
1656053872685,CSE 20,A01,083657,Tran; Khoa Dang,29,0,80,51
1656053878709,CSE 21,A01,095574,Bach; Quang Tran,23,0,48,25
1656053884747,CSE 30,A01,083084,Eldon; John,2,10,80,78
1656053884747,CSE 30,B01,095061,Bhaskar; Nishant,2,5,50,48
1656053890770,CSE 100,A01,083659,Cao; Yingjun,2,25,70,68
1656053896797,CSE 134B,A01,083661,Powell; Thomas Allan,6,6,100,94
1656053902820,CSE 140,A01,083663,Gungor; Onat,6,0,85,79
1656053908844,CSE 140L,A01,083088,Eldon; John,5,0,100,95
1656053914867,CSE 175,A01,083665,Kumar; Rakesh,0,0,25,25
1656053920905,CSE 190,A00,092507,Dubnov; Shlomo,1,0,20,19
1656053926928,ECE 45,A01,083139,Congero; Spencer William,1,2,75,74
1656053932953,ECE 65,A50,083695,Saad; Andrew S,6,0,30,24
1656053932953,ECE 65,A51,095125,Staff,23,0,26,3
1656053938980,ECE 109,A01,091882,Touri; Behrouz,3,5,70,67
1656053945003,ECE 180,A00,083140,Abi Samra; Nicholas Camill,1,0,30,29
1656053945003,ECE 180,B00,083141,Abi Samra; Nicholas Camill,0,8,28,28
1656053951026,MATH 10A,A01,083735,Patchell; Gregory David,0,0,30,30
1656053951026,MATH 10A,A02,083736,Patchell; Gregory David,20,0,30,10
1656053951026,MATH 10A,A03,083737,Patchell; Gregory David,16,0,30,14
1656053957051,MATH 10B,A01,083207,Lim; Seonhee,1,1,34,33
1656053957051,MATH 10B,A02,083208,Lim; Seonhee,1,1,35,34
1656053957051,MATH 10B,A03,093472,Staff,0,1,34,34
1656053957051,MATH 10B,B01,083739,Sinha; Shubham,10,0,30,20
1656053963083,MATH 18,A01,083743,Cinel; Cameron Alexander,5,0,30,25
1656053963083,MATH 18,A02,083744,Cinel; Cameron Alexander,11,0,30,19
1656053963083,MATH 18,A03,083745,Cinel; Cameron Alexander,2,0,30,28
1656053963083,MATH 18,B01,083748,Ma; Zilu,0,0,36,36
1656053963083,MATH 18,B02,083749,Ma; Zilu,0,0,36,36
1656053963083,MATH 18,B03,083750,Ma; Zilu,0,0,36,36
1656053963083,MATH 18,B04,083751,Ma; Zilu,0,0,36,36
1656053963083,MATH 18,B05,093473,Staff,0,0,36,36
1656053963083,MATH 18,B06,093474,Staff,3,0,36,33
1656053969106,MATH 20A,A01,083754,Zheng; Zequn,11,0,40,29
1656053975133,MATH 20B,A01,083756,Briones; Jor-el Thomas Caparas,0,0,36,36
1656053975133,MATH 20B,A02,083757,Briones; Jor-el Thomas Caparas,0,0,36,36
1656053975133,MATH 20B,A03,093475,Staff,0,0,36,36
1656053981157,MATH 20C,A01,083760,Briones; Jor-el Thomas Caparas,0,2,35,35
1656053981157,MATH 20C,A02,083761,Briones; Jor-el Thomas Caparas,6,1,35,29
1656053981157,MATH 20C,A03,093476,Staff,0,1,35,35
1656053981157,MATH 20C,B01,083762,Bach; Quang Tran,3,0,30,27
1656053987180,MATH 20D,A01,083765,Tran; Brian Kha,3,0,30,27
1656053987180,MATH 20D,A02,083766,Tran; Brian Kha,0,1,30,30
1656053987180,MATH 20D,A03,083767,Tran; Brian Kha,1,0,30,29
1656053993205,MATH 20E,A01,083771,Ganguly; Soumya,1,1,32,31
1656053993205,MATH 20E,A02,083772,Ganguly; Soumya,1,1,32,31
1656053993205,MATH 20E,B01,083773,Ciotti; Benjamin,14,0,35,21
1656053993205,MATH 20E,B02,083774,Ciotti; Benjamin,13,0,35,22
1656053999230,MATH 103A,A01,083777,Greenfeld; Be'Eri,2,1,36,34
1656053999230,MATH 103A,A02,083778,Greenfeld; Be'Eri,1,0,36,35
1656053999230,MATH 103A,A03,093561,Staff,0,1,36,36
1656053999230,MATH 103A,B01,083779,Greenfeld; Be'Eri,8,1,36,28
1656053999230,MATH 103A,B02,083780,Greenfeld; Be'Eri,0,0,36,36
1656053999230,MATH 103A,B03,093562,Staff,0,0,36,36
1656054005260,MATH 105,A01,085443,Carter; Anne Toulson,4,1,35,31
1656054005260,MATH 105,A02,093477,Staff,9,0,35,26
1656054011292,MATH 109,A01,083213,Ganzberger; Geoffrey Michael,1,1,34,33
1656054011292,MATH 109,A02,083214,Ganzberger; Geoffrey Michael,0,0,34,34
1656054011292,MATH 109,A03,093478,Staff,1,0,34,33
1656054011292,MATH 109,B01,083215,Ganzberger; Geoffrey Michael,2,0,32,30
1656054011292,MATH 109,B02,083216,Ganzberger; Geoffrey Michael,0,0,32,32
1656054011292,MATH 109,B03,093479,Staff,3,0,32,29
1656054017318,MATH 142A,A01,083219,Chow; Bennett,1,0,32,31
1656054017318,MATH 142A,A02,083220,Chow; Bennett,7,0,32,25
1656054017318,MATH 142A,A03,093480,Staff,4,0,32,28
1656054017318,MATH 142A,B03,093481,Staff,5,0,32,27
1656054017318,MATH 142A,B04,093558,Staff,6,0,32,26
1656054017318,MATH 142A,B05,093559,Staff,0,0,32,32
1656054023342,MATH 193A,A01,083224,Rotar; Vladimir,1,2,34,33
1656054023342,MATH 193A,A02,083225,Rotar; Vladimir,1,0,34,33
1656054023342,MATH 193A,A03,083781,Rotar; Vladimir,1,0,34,33
1656054023342,MATH 193A,A04,083782,Rotar; Vladimir,3,0,34,31
1656054023342,MATH 193A,A05,093482,Rotar; Vladimir,0,0,34,34
1656054029369,MATH 197,001,091859,McAuley; Julian John,9999,0,9999,0
1656054029369,MATH 197,002,095566,Kedlaya; Kiran S.,9997,0,9999,2
1656054029369,MATH 197,003,095567,Xiao; Ming,9999,0,9999,0
1656054029369,MATH 197,004,095571,Perols; Johan Lars,9998,0,9999,1
1656054036427,COGS 9,A01,083615,Shannon; Kyle Michael,3,1,75,72
1656054042450,COGS 11,A01,083617,Boyle; Mary E. T.,11,2,48,37
1656054048480,COGS 13,A01,083071,Bastos; Amalia Pinkusfeld,4,3,71,67
1656054054503,COGS 14A,A01,092681,Semenuks; Arturs,4,25,100,96
1656054060527,COGS 14B,A01,083073,Cheng; Tzu-Han,7,0,63,56
1656054066551,COGS 17,A01,092677,Semenuks; Arturs,9,7,81,72
1656054072575,COGS 100,A01,083619,Allen; Michael Gordon,3,2,70,67
1656054078599,COGS 101A,A01,083621,Davis; Joshua Daniel,4,3,68,64
1656054084624,COGS 101B,A01,091572,Allen; Michael Gordon,0,0,65,65
1656054090652,COGS 101C,A01,083625,Delgado; Tania,7,0,35,28
1656054096676,COGS 107A,A01,083627,Boyle; Mary E. T.,1,2,60,59
1656054102700,COGS 118A,A01,083075,Gupta; Anjum,21,16,76,55
1656054108726,CSE 3,A50,083646,Miranda; Gregory Joseph,14,0,50,36
1656054114756,CSE 8A,A50,083650,Miranda; Gregory Joseph,4,11,56,52
1656054120784,CSE 11,A01,083080,Cao; Yingjun,0,64,40,40
1656054126818,CSE 12,A01,083652,Krause-Levy; Sophia Louisa,7,8,120,113
1656054132843,CSE 15L,A01,083654,Morris; Justin Loren,3,1,50,47
1656054132843,CSE 15L,A02,083655,Morris; Justin Loren,2,1,50,48
1656054138877,CSE 20,A01,083657,Tran; Khoa Dang,29,0,80,51
1656054144900,CSE 21,A01,095574,Bach; Quang Tran,23,0,48,25
1656054150925,CSE 30,A01,083084,Eldon; John,2,10,80,78
1656054150925,CSE 30,B01,095061,Bhaskar; Nishant,2,5,50,48
1656054156954,CSE 100,A01,083659,Cao; Yingjun,2,25,70,68
1656054162977,CSE 134B,A01,083661,Powell; Thomas Allan,6,6,100,94
1656054169001,CSE 140,A01,083663,Gungor; Onat,6,0,85,79
1656054175030,CSE 140L,A01,083088,Eldon; John,5,0,100,95
1656054181057,CSE 175,A01,083665,Kumar; Rakesh,0,0,25,25
1656054187081,CSE 190,A00,092507,Dubnov; Shlomo,1,0,20,19
1656054193111,ECE 45,A01,083139,Congero; Spencer William,1,2,75,74
1656054199136,ECE 65,A50,083695,Saad; Andrew S,6,0,30,24
1656054199136,ECE 65,A51,095125,Staff,23,0,26,3
1656054205161,ECE 109,A01,091882,Touri; Behrouz,3,5,70,67
1656054211192,ECE 180,A00,083140,Abi Samra; Nicholas Camill,1,0,30,29
1656054211192,ECE 180,B00,083141,Abi Samra; Nicholas Camill,0,8,28,28
1656054217226,MATH 10A,A01,083735,Patchell; Gregory David,0,0,30,30
1656054217226,MATH 10A,A02,083736,Patchell; Gregory David,20,0,30,10
1656054217226,MATH 10A,A03,083737,Patchell; Gregory David,16,0,30,14
1656054223251,MATH 10B,A01,083207,Lim; Seonhee,1,1,34,33
1656054223251,MATH 10B,A02,083208,Lim; Seonhee,1,1,35,34
1656054223251,MATH 10B,A03,093472,Staff,0,1,34,34
1656054223251,MATH 10B,B01,083739,Sinha; Shubham,10,0,30,20
1656054229276,MATH 18,A01,083743,Cinel; Cameron Alexander,5,0,30,25
1656054229276,MATH 18,A02,083744,Cinel; Cameron Alexander,11,0,30,19
1656054229276,MATH 18,A03,083745,Cinel; Cameron Alexander,2,0,30,28
1656054229276,MATH 18,B01,083748,Ma; Zilu,0,0,36,36
1656054229276,MATH 18,B02,083749,Ma; Zilu,0,0,36,36
1656054229276,MATH 18,B03,083750,Ma; Zilu,0,0,36,36
1656054229276,MATH 18,B04,083751,Ma; Zilu,0,0,36,36
1656054229276,MATH 18,B05,093473,Staff,0,0,36,36
1656054229276,MATH 18,B06,093474,Staff,3,0,36,33
1656054235300,MATH 20A,A01,083754,Zheng; Zequn,11,0,40,29
1656054241409,MATH 20B,A01,083756,Briones; Jor-el Thomas Caparas,0,0,36,36
1656054241409,MATH 20B,A02,083757,Briones; Jor-el Thomas Caparas,0,0,36,36
1656054241409,MATH 20B,A03,093475,Staff,0,0,36,36
1656054247439,MATH 20C,A01,083760,Briones; Jor-el Thomas Caparas,0,2,35,35
1656054247439,MATH 20C,A02,083761,Briones; Jor-el Thomas Caparas,6,1,35,29
1656054247439,MATH 20C,A03,093476,Staff,0,1,35,35
1656054247439,MATH 20C,B01,083762,Bach; Quang Tran,3,0,30,27
1656054253469,MATH 20D,A01,083765,Tran; Brian Kha,3,0,30,27
1656054253469,MATH 20D,A02,083766,Tran; Brian Kha,0,1,30,30
1656054253469,MATH 20D,A03,083767,Tran; Brian Kha,1,0,30,29
1656054259498,MATH 20E,A01,083771,Ganguly; Soumya,1,1,32,31
1656054259498,MATH 20E,A02,083772,Ganguly; Soumya,1,1,32,31
1656054259498,MATH 20E,B01,083773,Ciotti; Benjamin,14,0,35,21
1656054259498,MATH 20E,B02,083774,Ciotti; Benjamin,13,0,35,22
1656054265522,MATH 103A,A01,083777,Greenfeld; Be'Eri,2,1,36,34
1656054265522,MATH 103A,A02,083778,Greenfeld; Be'Eri,1,0,36,35
1656054265522,MATH 103A,A03,093561,Staff,0,1,36,36
1656054265522,MATH 103A,B01,083779,Greenfeld; Be'Eri,8,1,36,28
1656054265522,MATH 103A,B02,083780,Greenfeld; Be'Eri,0,0,36,36
1656054265522,MATH 103A,B03,093562,Staff,0,0,36,36
1656054271545,MATH 105,A01,085443,Carter; Anne Toulson,4,1,35,31
1656054271545,MATH 105,A02,093477,Staff,9,0,35,26
1656054277569,MATH 109,A01,083213,Ganzberger; Geoffrey Michael,1,1,34,33
1656054277569,MATH 109,A02,083214,Ganzberger; Geoffrey Michael,0,0,34,34
1656054277569,MATH 109,A03,093478,Staff,1,0,34,33
1656054277569,MATH 109,B01,083215,Ganzberger; Geoffrey Michael,2,0,32,30
1656054277569,MATH 109,B02,083216,Ganzberger; Geoffrey Michael,0,0,32,32
1656054277569,MATH 109,B03,093479,Staff,3,0,32,29
1656054283598,MATH 142A,A01,083219,Chow; Bennett,1,0,32,31
1656054283598,MATH 142A,A02,083220,Chow; Bennett,7,0,32,25
1656054283598,MATH 142A,A03,093480,Staff,4,0,32,28
1656054283598,MATH 142A,B03,093481,Staff,5,0,32,27
1656054283598,MATH 142A,B04,093558,Staff,6,0,32,26
1656054283598,MATH 142A,B05,093559,Staff,0,0,32,32
1656054289622,MATH 193A,A01,083224,Rotar; Vladimir,1,2,34,33
1656054289622,MATH 193A,A02,083225,Rotar; Vladimir,1,0,34,33
1656054289622,MATH 193A,A03,083781,Rotar; Vladimir,1,0,34,33
1656054289622,MATH 193A,A04,083782,Rotar; Vladimir,3,0,34,31
1656054289622,MATH 193A,A05,093482,Rotar; Vladimir,0,0,34,34
1656054295648,MATH 197,001,091859,McAuley; Julian John,9999,0,9999,0
1656054295648,MATH 197,002,095566,Kedlaya; Kiran S.,9997,0,9999,2
1656054295648,MATH 197,003,095567,Xiao; Ming,9999,0,9999,0
1656054295648,MATH 197,004,095571,Perols; Johan Lars,9998,0,9999,1
1656054302709,COGS 9,A01,083615,Shannon; Kyle Michael,3,1,75,72
1656054308734,COGS 11,A01,083617,Boyle; Mary E. T.,11,2,48,37
1656054314762,COGS 13,A01,083071,Bastos; Amalia Pinkusfeld,4,3,71,67
1656054320786,COGS 14A,A01,092681,Semenuks; Arturs,4,25,100,96
1656054326815,COGS 14B,A01,083073,Cheng; Tzu-Han,7,0,63,56
1656054332843,COGS 17,A01,092677,Semenuks; Arturs,9,7,81,72
1656054338867,COGS 100,A01,083619,Allen; Michael Gordon,3,2,70,67
1656054344894,COGS 101A,A01,083621,Davis; Joshua Daniel,4,3,68,64
1656054350923,COGS 101B,A01,091572,Allen; Michael Gordon,0,0,65,65
1656054356945,COGS 101C,A01,083625,Delgado; Tania,7,0,35,28
1656054362970,COGS 107A,A01,083627,Boyle; Mary E. T.,1,2,60,59
1656054368999,COGS 118A,A01,083075,Gupta; Anjum,21,16,76,55
1656054375030,CSE 3,A50,083646,Miranda; Gregory Joseph,14,0,50,36
1656054381055,CSE 8A,A50,083650,Miranda; Gregory Joseph,4,11,56,52
1656054387079,CSE 11,A01,083080,Cao; Yingjun,0,64,40,40
1656054393105,CSE 12,A01,083652,Krause-Levy; Sophia Louisa,7,8,120,113
1656054399140,CSE 15L,A01,083654,Morris; Justin Loren,3,1,50,47
1656054399140,CSE 15L,A02,083655,Morris; Justin Loren,2,1,50,48
1656054405163,CSE 20,A01,083657,Tran; Khoa Dang,29,0,80,51
1656054411196,CSE 21,A01,095574,Bach; Quang Tran,23,0,48,25
1656054417220,CSE 30,A01,083084,Eldon; John,2,10,80,78
1656054417220,CSE 30,B01,095061,Bhaskar; Nishant,2,5,50,48
1656054423248,CSE 100,A01,083659,Cao; Yingjun,2,25,70,68
1656054429277,CSE 134B,A01,083661,Powell; Thomas Allan,6,6,100,94
1656054435309,CSE 140,A01,083663,Gungor; Onat,6,0,85,79
1656054441344,CSE 140L,A01,083088,Eldon; John,5,0,100,95
1656054447368,CSE 175,A01,083665,Kumar; Rakesh,0,0,25,25
1656054453392,CSE 190,A00,092507,Dubnov; Shlomo,1,0,20,19
1656054459419,ECE 45,A01,083139,Congero; Spencer William,1,2,75,74
1656054465449,ECE 65,A50,083695,Saad; Andrew S,6,0,30,24
1656054465449,ECE 65,A51,095125,Staff,23,0,26,3
1656054471477,ECE 109,A01,091882,Touri; Behrouz,3,5,70,67
1656054477501,ECE 180,A00,083140,Abi Samra; Nicholas Camill,1,0,30,29
1656054477501,ECE 180,B00,083141,Abi Samra; Nicholas Camill,0,8,28,28
1656054483537,MATH 10A,A01,083735,Patchell; Gregory David,0,0,30,30
1656054483537,MATH 10A,A02,083736,Patchell; Gregory David,20,0,30,10
1656054483537,MATH 10A,A03,083737,Patchell; Gregory David,16,0,30,14
1656054489566,MATH 10B,A01,083207,Lim; Seonhee,1,1,34,33
1656054489566,MATH 10B,A02,083208,Lim; Seonhee,1,1,35,34
1656054489566,MATH 10B,A03,093472,Staff,0,1,34,34
1656054489566,MATH 10B,B01,083739,Sinha; Shubham,10,0,30,20
1656054495592,MATH 18,A01,083743,Cinel; Cameron Alexander,5,0,30,25
1656054495592,MATH 18,A02,083744,Cinel; Cameron Alexander,11,0,30,19
1656054495592,MATH 18,A03,083745,Cinel; Cameron Alexander,2,0,30,28
1656054495592,MATH 18,B01,083748,Ma; Zilu,0,0,36,36
1656054495592,MATH 18,B02,083749,Ma; Zilu,0,0,36,36
1656054495592,MATH 18,B03,083750,Ma; Zilu,0,0,36,36
1656054495592,MATH 18,B04,083751,Ma; Zilu,0,0,36,36
1656054495592,MATH 18,B05,093473,Staff,0,0,36,36
1656054495592,MATH 18,B06,093474,Staff,3,0,36,33
1656054501620,MATH 20A,A01,083754,Zheng; Zequn,11,0,40,29
1656054507650,MATH 20B,A01,083756,Briones; Jor-el Thomas Caparas,0,0,36,36
1656054507650,MATH 20B,A02,083757,Briones; Jor-el Thomas Caparas,0,0,36,36
1656054507650,MATH 20B,A03,093475,Staff,0,0,36,36
1656054513675,MATH 20C,A01,083760,Briones; Jor-el Thomas Caparas,0,2,35,35
1656054513675,MATH 20C,A02,083761,Briones; Jor-el Thomas Caparas,6,1,35,29
1656054513675,MATH 20C,A03,093476,Staff,0,1,35,35
1656054513675,MATH 20C,B01,083762,Bach; Quang Tran,3,0,30,27
1656054519699,MATH 20D,A01,083765,Tran; Brian Kha,3,0,30,27
1656054519699,MATH 20D,A02,083766,Tran; Brian Kha,0,1,30,30
1656054519699,MATH 20D,A03,083767,Tran; Brian Kha,1,0,30,29
1656054525724,MATH 20E,A01,083771,Ganguly; Soumya,1,1,32,31
1656054525724,MATH 20E,A02,083772,Ganguly; Soumya,1,1,32,31
1656054525724,MATH 20E,B01,083773,Ciotti; Benjamin,14,0,35,21
1656054525724,MATH 20E,B02,083774,Ciotti; Benjamin,13,0,35,22
1656054531756,MATH 103A,A01,083777,Greenfeld; Be'Eri,2,1,36,34
1656054531756,MATH 103A,A02,083778,Greenfeld; Be'Eri,1,0,36,35
1656054531756,MATH 103A,A03,093561,Staff,0,1,36,36
1656054531756,MATH 103A,B01,083779,Greenfeld; Be'Eri,8,1,36,28
1656054531756,MATH 103A,B02,083780,Greenfeld; Be'Eri,0,0,36,36
1656054531756,MATH 103A,B03,093562,Staff,0,0,36,36
1656054537783,MATH 105,A01,085443,Carter; Anne Toulson,4,1,35,31
1656054537783,MATH 105,A02,093477,Staff,9,0,35,26
1656054543808,MATH 109,A01,083213,Ganzberger; Geoffrey Michael,1,1,34,33
1656054543808,MATH 109,A02,083214,Ganzberger; Geoffrey Michael,0,0,34,34
1656054543808,MATH 109,A03,093478,Staff,1,0,34,33
1656054543808,MATH 109,B01,083215,Ganzberger; Geoffrey Michael,2,0,32,30
1656054543808,MATH 109,B02,083216,Ganzberger; Geoffrey Michael,0,0,32,32
1656054543808,MATH 109,B03,093479,Staff,3,0,32,29
1656054549832,MATH 142A,A01,083219,Chow; Bennett,1,0,32,31
1656054549832,MATH 142A,A02,083220,Chow; Bennett,7,0,32,25
1656054549832,MATH 142A,A03,093480,Staff,4,0,32,28
1656054549832,MATH 142A,B03,093481,Staff,5,0,32,27
1656054549832,MATH 142A,B04,093558,Staff,6,0,32,26
1656054549832,MATH 142A,B05,093559,Staff,0,0,32,32
1656054555857,MATH 193A,A01,083224,Rotar; Vladimir,1,2,34,33
1656054555857,MATH 193A,A02,083225,Rotar; Vladimir,1,0,34,33
1656054555857,MATH 193A,A03,083781,Rotar; Vladimir,1,0,34,33
1656054555857,MATH 193A,A04,083782,Rotar; Vladimir,3,0,34,31
1656054555857,MATH 193A,A05,093482,Rotar; Vladimir,0,0,34,34
1656054561892,MATH 197,001,091859,McAuley; Julian John,9999,0,9999,0
1656054561892,MATH 197,002,095566,Kedlaya; Kiran S.,9997,0,9999,2
1656054561892,MATH 197,003,095567,Xiao; Ming,9999,0,9999,0
1656054561892,MATH 197,004,095571,Perols; Johan Lars,9998,0,9999,1
1656054568952,COGS 9,A01,083615,Shannon; Kyle Michael,3,1,75,72
1656054574980,COGS 11,A01,083617,Boyle; Mary E. T.,11,2,48,37
1656054581004,COGS 13,A01,083071,Bastos; Amalia Pinkusfeld,4,3,71,67
1656054587032,COGS 14A,A01,092681,Semenuks; Arturs,4,25,100,96
1656054593068,COGS 14B,A01,083073,Cheng; Tzu-Han,7,0,63,56
1656054599100,COGS 17,A01,092677,Semenuks; Arturs,9,7,81,72
1656054605128,COGS 100,A01,083619,Allen; Michael Gordon,3,2,70,67
1656054611152,COGS 101A,A01,083621,Davis; Joshua Daniel,4,3,68,64
1656054617186,COGS 101B,A01,091572,Allen; Michael Gordon,0,0,65,65
1656054623210,COGS 101C,A01,083625,Delgado; Tania,7,0,35,28
1656054629234,COGS 107A,A01,083627,Boyle; Mary E. T.,1,2,60,59
1656054635261,COGS 118A,A01,083075,Gupta; Anjum,21,16,76,55
1656054641289,CSE 3,A50,083646,Miranda; Gregory Joseph,14,0,50,36
1656054647315,CSE 8A,A50,083650,Miranda; Gregory Joseph,4,11,56,52
1656054653340,CSE 11,A01,083080,Cao; Yingjun,0,64,40,40
1656054659369,CSE 12,A01,083652,Krause-Levy; Sophia Louisa,7,8,120,113
1656054665396,CSE 15L,A01,083654,Morris; Justin Loren,3,1,50,47
1656054665396,CSE 15L,A02,083655,Morris; Justin Loren,2,1,50,48
1656054671419,CSE 20,A01,083657,Tran; Khoa Dang,29,0,80,51
1656054677442,CSE 21,A01,095574,Bach; Quang Tran,23,0,48,25
1656054683466,CSE 30,A01,083084,Eldon; John,2,10,80,78
1656054683466,CSE 30,B01,095061,Bhaskar; Nishant,2,5,50,48
1656054689489,CSE 100,A01,083659,Cao; Yingjun,2,25,70,68
1656054695520,CSE 134B,A01,083661,Powell; Thomas Allan,6,6,100,94
1656054701543,CSE 140,A01,083663,Gungor; Onat,6,0,85,79
1656054707578,CSE 140L,A01,083088,Eldon; John,5,0,100,95
1656054713601,CSE 175,A01,083665,Kumar; Rakesh,0,0,25,25
1656054719662,CSE 190,A00,092507,Dubnov; Shlomo,1,0,20,19
1656054725727,ECE 45,A01,083139,Congero; Spencer William,1,2,75,74
1656054731755,ECE 65,A50,083695,Saad; Andrew S,6,0,30,24
1656054731755,ECE 65,A51,095125,Staff,23,0,26,3
1656054737781,ECE 109,A01,091882,Touri; Behrouz,3,5,70,67
1656054743807,ECE 180,A00,083140,Abi Samra; Nicholas Camill,1,0,30,29
1656054743807,ECE 180,B00,083141,Abi Samra; Nicholas Camill,0,8,28,28
1656054749833,MATH 10A,A01,083735,Patchell; Gregory David,0,0,30,30
1656054749833,MATH 10A,A02,083736,Patchell; Gregory David,20,0,30,10
1656054749833,MATH 10A,A03,083737,Patchell; Gregory David,16,0,30,14
1656054755859,MATH 10B,A01,083207,Lim; Seonhee,1,1,34,33
1656054755859,MATH 10B,A02,083208,Lim; Seonhee,1,1,35,34
1656054755859,MATH 10B,A03,093472,Staff,0,1,34,34
1656054755859,MATH 10B,B01,083739,Sinha; Shubham,10,0,30,20
1656054761897,MATH 18,A01,083743,Cinel; Cameron Alexander,5,0,30,25
1656054761897,MATH 18,A02,083744,Cinel; Cameron Alexander,11,0,30,19
1656054761897,MATH 18,A03,083745,Cinel; Cameron Alexander,2,0,30,28
1656054761897,MATH 18,B01,083748,Ma; Zilu,0,0,36,36
1656054761897,MATH 18,B02,083749,Ma; Zilu,0,0,36,36
1656054761897,MATH 18,B03,083750,Ma; Zilu,0,0,36,36
1656054761897,MATH 18,B04,083751,Ma; Zilu,0,0,36,36
1656054761897,MATH 18,B05,093473,Staff,0,0,36,36
1656054761897,MATH 18,B06,093474,Staff,3,0,36,33
1656054767923,MATH 20A,A01,083754,Zheng; Zequn,11,0,40,29
1656054773957,MATH 20B,A01,083756,Briones; Jor-el Thomas Caparas,0,0,36,36
1656054773957,MATH 20B,A02,083757,Briones; Jor-el Thomas Caparas,0,0,36,36
1656054773957,MATH 20B,A03,093475,Staff,0,0,36,36
1656054779988,MATH 20C,A01,083760,Briones; Jor-el Thomas Caparas,0,2,35,35
1656054779988,MATH 20C,A02,083761,Briones; Jor-el Thomas Caparas,6,1,35,29
1656054779988,MATH 20C,A03,093476,Staff,0,1,35,35
1656054779988,MATH 20C,B01,083762,Bach; Quang Tran,3,0,30,27
1656054786012,MATH 20D,A01,083765,Tran; Brian Kha,3,0,30,27
1656054786012,MATH 20D,A02,083766,Tran; Brian Kha,0,1,30,30
1656054786012,MATH 20D,A03,083767,Tran; Brian Kha,1,0,30,29
1656054792037,MATH 20E,A01,083771,Ganguly; Soumya,1,1,32,31
1656054792037,MATH 20E,A02,083772,Ganguly; Soumya,1,1,32,31
1656054792037,MATH 20E,B01,083773,Ciotti; Benjamin,14,0,35,21
1656054792037,MATH 20E,B02,083774,Ciotti; Benjamin,13,0,35,22
1656054798062,MATH 103A,A01,083777,Greenfeld; Be'Eri,2,1,36,34
1656054798062,MATH 103A,A02,083778,Greenfeld; Be'Eri,1,0,36,35
1656054798062,MATH 103A,A03,093561,Staff,0,1,36,36
1656054798062,MATH 103A,B01,083779,Greenfeld; Be'Eri,8,1,36,28
1656054798062,MATH 103A,B02,083780,Greenfeld; Be'Eri,0,0,36,36
1656054798062,MATH 103A,B03,093562,Staff,0,0,36,36
1656054804086,MATH 105,A01,085443,Carter; Anne Toulson,4,1,35,31
1656054804086,MATH 105,A02,093477,Staff,9,0,35,26
1656054810121,MATH 109,A01,083213,Ganzberger; Geoffrey Michael,1,1,34,33
1656054810121,MATH 109,A02,083214,Ganzberger; Geoffrey Michael,0,0,34,34
1656054810121,MATH 109,A03,093478,Staff,1,0,34,33
1656054810121,MATH 109,B01,083215,Ganzberger; Geoffrey Michael,2,0,32,30
1656054810121,MATH 109,B02,083216,Ganzberger; Geoffrey Michael,0,0,32,32
1656054810121,MATH 109,B03,093479,Staff,3,0,32,29
1656054816148,MATH 142A,A01,083219,Chow; Bennett,1,0,32,31
1656054816148,MATH 142A,A02,083220,Chow; Bennett,7,0,32,25
1656054816148,MATH 142A,A03,093480,Staff,4,0,32,28
1656054816148,MATH 142A,B03,093481,Staff,5,0,32,27
1656054816148,MATH 142A,B04,093558,Staff,6,0,32,26
1656054816148,MATH 142A,B05,093559,Staff,0,0,32,32
1656054822172,MATH 193A,A01,083224,Rotar; Vladimir,1,2,34,33
1656054822172,MATH 193A,A02,083225,Rotar; Vladimir,1,0,34,33
1656054822172,MATH 193A,A03,083781,Rotar; Vladimir,1,0,34,33
1656054822172,MATH 193A,A04,083782,Rotar; Vladimir,3,0,34,31
1656054822172,MATH 193A,A05,093482,Rotar; Vladimir,0,0,34,34
1656054828197,MATH 197,001,091859,McAuley; Julian John,9999,0,9999,0
1656054828197,MATH 197,002,095566,Kedlaya; Kiran S.,9997,0,9999,2
1656054828197,MATH 197,003,095567,Xiao; Ming,9999,0,9999,0
1656054828197,MATH 197,004,095571,Perols; Johan Lars,9998,0,9999,1
1656054835338,COGS 9,A01,083615,Shannon; Kyle Michael,3,1,75,72
1656054841367,COGS 11,A01,083617,Boyle; Mary E. T.,11,2,48,37
1656054847398,COGS 13,A01,083071,Bastos; Amalia Pinkusfeld,4,3,71,67
1656054853422,COGS 14A,A01,092681,Semenuks; Arturs,4,25,100,96
1656054859447,COGS 14B,A01,083073,Cheng; Tzu-Han,7,0,63,56
1656054872745,COGS 17,A01,092677,Semenuks; Arturs,9,7,81,72
1656054878776,COGS 100,A01,083619,Allen; Michael Gordon,3,2,70,67
1656054884809,COGS 101A,A01,083621,Davis; Joshua Daniel,4,3,68,64
1656054890834,COGS 101B,A01,091572,Allen; Michael Gordon,0,0,65,65
1656054896872,COGS 101C,A01,083625,Delgado; Tania,7,0,35,28
1656054902920,COGS 107A,A01,083627,Boyle; Mary E. T.,1,2,60,59
1656054908961,COGS 118A,A01,083075,Gupta; Anjum,21,16,76,55
1656054914984,CSE 3,A50,083646,Miranda; Gregory Joseph,14,0,50,36
1656054921013,CSE 8A,A50,083650,Miranda; Gregory Joseph,4,11,56,52
1656054927036,CSE 11,A01,083080,Cao; Yingjun,0,64,40,40
1656054933108,CSE 12,A01,083652,Krause-Levy; Sophia Louisa,7,8,120,113
1656054939141,CSE 15L,A01,083654,Morris; Justin Loren,3,1,50,47
1656054939141,CSE 15L,A02,083655,Morris; Justin Loren,2,1,50,48
1656054945168,CSE 20,A01,083657,Tran; Khoa Dang,29,0,80,51
1656054951201,CSE 21,A01,095574,Bach; Quang Tran,23,0,48,25
1656054957231,CSE 30,A01,083084,Eldon; John,2,10,80,78
1656054957231,CSE 30,B01,095061,Bhaskar; Nishant,2,5,50,48
1656054963258,CSE 100,A01,083659,Cao; Yingjun,2,25,70,68
1656054969292,CSE 134B,A01,083661,Powell; Thomas Allan,6,6,100,94
1656054975325,CSE 140,A01,083663,Gungor; Onat,6,0,85,79
1656054981349,CSE 140L,A01,083088,Eldon; John,5,0,100,95
1656054987373,CSE 175,A01,083665,Kumar; Rakesh,0,0,25,25
1656054993397,CSE 190,A00,092507,Dubnov; Shlomo,1,0,20,19
1656054999439,ECE 45,A01,083139,Congero; Spencer William,1,2,75,74
1656055005467,ECE 65,A50,083695,Saad; Andrew S,6,0,30,24
1656055005467,ECE 65,A51,095125,Staff,23,0,26,3
1656055011496,ECE 109,A01,091882,Touri; Behrouz,3,5,70,67
1656055017535,ECE 180,A00,083140,Abi Samra; Nicholas Camill,1,0,30,29
1656055017535,ECE 180,B00,083141,Abi Samra; Nicholas Camill,0,8,28,28
1656055023569,MATH 10A,A01,083735,Patchell; Gregory David,0,0,30,30
1656055023569,MATH 10A,A02,083736,Patchell; Gregory David,20,0,30,10
1656055023569,MATH 10A,A03,083737,Patchell; Gregory David,16,0,30,14
1656055029605,MATH 10B,A01,083207,Lim; Seonhee,1,1,34,33
1656055029605,MATH 10B,A02,083208,Lim; Seonhee,1,1,35,34
1656055029605,MATH 10B,A03,093472,Staff,0,1,34,34
1656055029605,MATH 10B,B01,083739,Sinha; Shubham,10,0,30,20
1656055035633,MATH 18,A01,083743,Cinel; Cameron Alexander,5,0,30,25
1656055035633,MATH 18,A02,083744,Cinel; Cameron Alexander,11,0,30,19
1656055035633,MATH 18,A03,083745,Cinel; Cameron Alexander,2,0,30,28
1656055035633,MATH 18,B01,083748,Ma; Zilu,0,0,36,36
1656055035633,MATH 18,B02,083749,Ma; Zilu,0,0,36,36
1656055035633,MATH 18,B03,083750,Ma; Zilu,0,0,36,36
1656055035633,MATH 18,B04,083751,Ma; Zilu,0,0,36,36
1656055035633,MATH 18,B05,093473,Staff,0,0,36,36
1656055035633,MATH 18,B06,093474,Staff,3,0,36,33
1656055041658,MATH 20A,A01,083754,Zheng; Zequn,11,0,40,29
1656055047688,MATH 20B,A01,083756,Briones; Jor-el Thomas Caparas,0,0,36,36
1656055047688,MATH 20B,A02,083757,Briones; Jor-el Thomas Caparas,0,0,36,36
1656055047688,MATH 20B,A03,093475,Staff,0,0,36,36
1656055053720,MATH 20C,A01,083760,Briones; Jor-el Thomas Caparas,0,2,35,35
1656055053720,MATH 20C,A02,083761,Briones; Jor-el Thomas Caparas,6,1,35,29
1656055053720,MATH 20C,A03,093476,Staff,0,1,35,35
1656055053720,MATH 20C,B01,083762,Bach; Quang Tran,3,0,30,27
1656055059744,MATH 20D,A01,083765,Tran; Brian Kha,3,0,30,27
1656055059744,MATH 20D,A02,083766,Tran; Brian Kha,0,1,30,30
1656055059744,MATH 20D,A03,083767,Tran; Brian Kha,1,0,30,29
1656055065771,MATH 20E,A01,083771,Ganguly; Soumya,1,1,32,31
1656055065771,MATH 20E,A02,083772,Ganguly; Soumya,1,1,32,31
1656055065771,MATH 20E,B01,083773,Ciotti; Benjamin,14,0,35,21
1656055065771,MATH 20E,B02,083774,Ciotti; Benjamin,13,0,35,22
1656055071799,MATH 103A,A01,083777,Greenfeld; Be'Eri,2,1,36,34
1656055071799,MATH 103A,A02,083778,Greenfeld; Be'Eri,1,0,36,35
1656055071799,MATH 103A,A03,093561,Staff,0,1,36,36
1656055071799,MATH 103A,B01,083779,Greenfeld; Be'Eri,8,1,36,28
1656055071799,MATH 103A,B02,083780,Greenfeld; Be'Eri,0,0,36,36
1656055071799,MATH 103A,B03,093562,Staff,0,0,36,36
1656055077829,MATH 105,A01,085443,Carter; Anne Toulson,4,1,35,31
1656055077829,MATH 105,A02,093477,Staff,9,0,35,26
1656055083853,MATH 109,A01,083213,Ganzberger; Geoffrey Michael,1,1,34,33
1656055083853,MATH 109,A02,083214,Ganzberger; Geoffrey Michael,0,0,34,34
1656055083853,MATH 109,A03,093478,Staff,1,0,34,33
1656055083853,MATH 109,B01,083215,Ganzberger; Geoffrey Michael,2,0,32,30
1656055083853,MATH 109,B02,083216,Ganzberger; Geoffrey Michael,0,0,32,32
1656055083853,MATH 109,B03,093479,Staff,3,0,32,29
1656055089879,MATH 142A,A01,083219,Chow; Bennett,1,0,32,31
1656055089879,MATH 142A,A02,083220,Chow; Bennett,7,0,32,25
1656055089879,MATH 142A,A03,093480,Staff,4,0,32,28
1656055089879,MATH 142A,B03,093481,Staff,5,0,32,27
1656055089879,MATH 142A,B04,093558,Staff,6,0,32,26
1656055089879,MATH 142A,B05,093559,Staff,0,0,32,32
1656055095905,MATH 193A,A01,083224,Rotar; Vladimir,1,2,34,33
1656055095905,MATH 193A,A02,083225,Rotar; Vladimir,1,0,34,33
1656055095905,MATH 193A,A03,083781,Rotar; Vladimir,1,0,34,33
1656055095905,MATH 193A,A04,083782,Rotar; Vladimir,3,0,34,31
1656055095905,MATH 193A,A05,093482,Rotar; Vladimir,0,0,34,34
1656055101935,MATH 197,001,091859,McAuley; Julian John,9999,0,9999,0
1656055101935,MATH 197,002,095566,Kedlaya; Kiran S.,9997,0,9999,2
1656055101935,MATH 197,003,095567,Xiao; Ming,9999,0,9999,0
1656055101935,MATH 197,004,095571,Perols; Johan Lars,9998,0,9999,1
1656055109010,COGS 9,A01,083615,Shannon; Kyle Michael,3,1,75,72
1656055115033,COGS 11,A01,083617,Boyle; Mary E. T.,11,2,48,37
1656055121063,COGS 13,A01,083071,Bastos; Amalia Pinkusfeld,4,3,71,67
1656055127087,COGS 14A,A01,092681,Semenuks; Arturs,4,25,100,96
1656055133110,COGS 14B,A01,083073,Cheng; Tzu-Han,7,0,63,56
1656055139139,COGS 17,A01,092677,Semenuks; Arturs,9,7,81,72
1656055145163,COGS 100,A01,083619,Allen; Michael Gordon,3,2,70,67
1656055151193,COGS 101A,A01,083621,Davis; Joshua Daniel,4,3,68,64
1656055157222,COGS 101B,A01,091572,Allen; Michael Gordon,0,0,65,65
1656055163250,COGS 101C,A01,083625,Delgado; Tania,7,0,35,28
1656055169275,COGS 107A,A01,083627,Boyle; Mary E. T.,1,2,60,59
1656055175300,COGS 118A,A01,083075,Gupta; Anjum,21,16,76,55
1656055181325,CSE 3,A50,083646,Miranda; Gregory Joseph,14,0,50,36
1656055187350,CSE 8A,A50,083650,Miranda; Gregory Joseph,4,11,56,52
1656055193378,CSE 11,A01,083080,Cao; Yingjun,0,64,40,40
1656055199410,CSE 12,A01,083652,Krause-Levy; Sophia Louisa,7,8,120,113
1656055205433,CSE 15L,A01,083654,Morris; Justin Loren,3,1,50,47
1656055205433,CSE 15L,A02,083655,Morris; Justin Loren,2,1,50,48
1656055211456,CSE 20,A01,083657,Tran; Khoa Dang,29,0,80,51
1656055217481,CSE 21,A01,095574,Bach; Quang Tran,23,0,48,25
1656055223506,CSE 30,A01,083084,Eldon; John,2,10,80,78
1656055223506,CSE 30,B01,095061,Bhaskar; Nishant,2,5,50,48
1656055229533,CSE 100,A01,083659,Cao; Yingjun,2,25,70,68
1656055235556,CSE 134B,A01,083661,Powell; Thomas Allan,6,6,100,94
1656055241579,CSE 140,A01,083663,Gungor; Onat,6,0,85,79
1656055247607,CSE 140L,A01,083088,Eldon; John,5,0,100,95
1656055253635,CSE 175,A01,083665,Kumar; Rakesh,0,0,25,25
1656055259658,CSE 190,A00,092507,Dubnov; Shlomo,1,0,20,19
1656055265683,ECE 45,A01,083139,Congero; Spencer William,1,2,75,74
1656055271715,ECE 65,A50,083695,Saad; Andrew S,6,0,30,24
1656055271715,ECE 65,A51,095125,Staff,23,0,26,3
1656055277740,ECE 109,A01,091882,Touri; Behrouz,3,5,70,67
1656055283766,ECE 180,A00,083140,Abi Samra; Nicholas Camill,1,0,30,29
1656055283766,ECE 180,B00,083141,Abi Samra; Nicholas Camill,0,8,28,28
1656055289792,MATH 10A,A01,083735,Patchell; Gregory David,0,0,30,30
1656055289792,MATH 10A,A02,083736,Patchell; Gregory David,20,0,30,10
1656055289792,MATH 10A,A03,083737,Patchell; Gregory David,16,0,30,14
1656055295827,MATH 10B,A01,083207,Lim; Seonhee,1,1,34,33
1656055295827,MATH 10B,A02,083208,Lim; Seonhee,1,1,35,34
1656055295827,MATH 10B,A03,093472,Staff,1,1,34,33
1656055295827,MATH 10B,B01,083739,Sinha; Shubham,10,0,30,20
1656055301862,MATH 18,A01,083743,Cinel; Cameron Alexander,5,0,30,25
1656055301862,MATH 18,A02,083744,Cinel; Cameron Alexander,11,0,30,19
1656055301862,MATH 18,A03,083745,Cinel; Cameron Alexander,2,0,30,28
1656055301862,MATH 18,B01,083748,Ma; Zilu,0,0,36,36
1656055301862,MATH 18,B02,083749,Ma; Zilu,0,0,36,36
1656055301862,MATH 18,B03,083750,Ma; Zilu,0,0,36,36
1656055301862,MATH 18,B04,083751,Ma; Zilu,0,0,36,36
1656055301862,MATH 18,B05,093473,Staff,0,0,36,36
1656055301862,MATH 18,B06,093474,Staff,3,0,36,33
1656055307895,MATH 20A,A01,083754,Zheng; Zequn,11,0,40,29
1656055313923,MATH 20B,A01,083756,Briones; Jor-el Thomas Caparas,0,0,36,36
1656055313923,MATH 20B,A02,083757,Briones; Jor-el Thomas Caparas,0,0,36,36
1656055313923,MATH 20B,A03,093475,Staff,0,0,36,36
1656055319953,MATH 20C,A01,083760,Briones; Jor-el Thomas Caparas,0,2,35,35
1656055319953,MATH 20C,A02,083761,Briones; Jor-el Thomas Caparas,6,1,35,29
1656055319953,MATH 20C,A03,093476,Staff,0,1,35,35
1656055319953,MATH 20C,B01,083762,Bach; Quang Tran,3,0,30,27
1656055325983,MATH 20D,A01,083765,Tran; Brian Kha,3,0,30,27
1656055325983,MATH 20D,A02,083766,Tran; Brian Kha,0,1,30,30
1656055325983,MATH 20D,A03,083767,Tran; Brian Kha,1,0,30,29
1656055332016,MATH 20E,A01,083771,Ganguly; Soumya,1,1,32,31
1656055332016,MATH 20E,A02,083772,Ganguly; Soumya,1,1,32,31
1656055332016,MATH 20E,B01,083773,Ciotti; Benjamin,14,0,35,21
1656055332016,MATH 20E,B02,083774,Ciotti; Benjamin,13,0,35,22
1656055338049,MATH 103A,A01,083777,Greenfeld; Be'Eri,2,1,36,34
1656055338049,MATH 103A,A02,083778,Greenfeld; Be'Eri,1,0,36,35
1656055338049,MATH 103A,A03,093561,Staff,0,1,36,36
1656055338049,MATH 103A,B01,083779,Greenfeld; Be'Eri,8,1,36,28
1656055338049,MATH 103A,B02,083780,Greenfeld; Be'Eri,0,0,36,36
1656055338049,MATH 103A,B03,093562,Staff,0,0,36,36
1656055344073,MATH 105,A01,085443,Carter; Anne Toulson,4,1,35,31
1656055344073,MATH 105,A02,093477,Staff,9,0,35,26
1656055350104,MATH 109,A01,083213,Ganzberger; Geoffrey Michael,1,1,34,33
1656055350104,MATH 109,A02,083214,Ganzberger; Geoffrey Michael,0,0,34,34
1656055350104,MATH 109,A03,093478,Staff,1,0,34,33
1656055350104,MATH 109,B01,083215,Ganzberger; Geoffrey Michael,2,0,32,30
1656055350104,MATH 109,B02,083216,Ganzberger; Geoffrey Michael,0,0,32,32
1656055350104,MATH 109,B03,093479,Staff,3,0,32,29
1656055356129,MATH 142A,A01,083219,Chow; Bennett,1,0,32,31
1656055356129,MATH 142A,A02,083220,Chow; Bennett,7,0,32,25
1656055356129,MATH 142A,A03,093480,Staff,4,0,32,28
1656055356129,MATH 142A,B03,093481,Staff,5,0,32,27
1656055356129,MATH 142A,B04,093558,Staff,6,0,32,26
1656055356129,MATH 142A,B05,093559,Staff,0,0,32,32
1656055362159,MATH 193A,A01,083224,Rotar; Vladimir,1,2,34,33
1656055362159,MATH 193A,A02,083225,Rotar; Vladimir,1,0,34,33
1656055362159,MATH 193A,A03,083781,Rotar; Vladimir,1,0,34,33
1656055362159,MATH 193A,A04,083782,Rotar; Vladimir,3,0,34,31
1656055362159,MATH 193A,A05,093482,Rotar; Vladimir,0,0,34,34
1656055368184,MATH 197,001,091859,McAuley; Julian John,9999,0,9999,0
1656055368184,MATH 197,002,095566,Kedlaya; Kiran S.,9997,0,9999,2
1656055368184,MATH 197,003,095567,Xiao; Ming,9999,0,9999,0
1656055368184,MATH 197,004,095571,Perols; Johan Lars,9998,0,9999,1
1656055375247,COGS 9,A01,083615,Shannon; Kyle Michael,3,1,75,72
1656055381273,COGS 11,A01,083617,Boyle; Mary E. T.,11,2,48,37
1656055387297,COGS 13,A01,083071,Bastos; Amalia Pinkusfeld,4,3,71,67
1656055393321,COGS 14A,A01,092681,Semenuks; Arturs,4,25,100,96
1656055399346,COGS 14B,A01,083073,Cheng; Tzu-Han,7,0,63,56
1656055405370,COGS 17,A01,092677,Semenuks; Arturs,9,7,81,72
1656055411402,COGS 100,A01,083619,Allen; Michael Gordon,3,2,70,67
1656055417423,COGS 101A,A01,083621,Davis; Joshua Daniel,4,3,68,64
1656055423450,COGS 101B,A01,091572,Allen; Michael Gordon,0,0,65,65
1656055429474,COGS 101C,A01,083625,Delgado; Tania,7,0,35,28
1656055435501,COGS 107A,A01,083627,Boyle; Mary E. T.,1,2,60,59
1656055441598,COGS 118A,A01,083075,Gupta; Anjum,21,16,76,55
1656055447630,CSE 3,A50,083646,Miranda; Gregory Joseph,14,0,50,36
1656055453654,CSE 8A,A50,083650,Miranda; Gregory Joseph,4,11,56,52
1656055459680,CSE 11,A01,083080,Cao; Yingjun,0,64,40,40
1656055465706,CSE 12,A01,083652,Krause-Levy; Sophia Louisa,7,8,120,113
1656055471735,CSE 15L,A01,083654,Morris; Justin Loren,3,1,50,47
1656055471735,CSE 15L,A02,083655,Morris; Justin Loren,2,1,50,48
1656055477759,CSE 20,A01,083657,Tran; Khoa Dang,29,0,80,51
1656055483785,CSE 21,A01,095574,Bach; Quang Tran,23,0,48,25
1656055489817,CSE 30,A01,083084,Eldon; John,2,10,80,78
1656055489817,CSE 30,B01,095061,Bhaskar; Nishant,2,5,50,48
1656055495841,CSE 100,A01,083659,Cao; Yingjun,2,25,70,68
1656055501866,CSE 134B,A01,083661,Powell; Thomas Allan,6,6,100,94
1656055507891,CSE 140,A01,083663,Gungor; Onat,6,0,85,79
1656055513919,CSE 140L,A01,083088,Eldon; John,5,0,100,95
1656055519947,CSE 175,A01,083665,Kumar; Rakesh,0,0,25,25
1656055525975,CSE 190,A00,092507,Dubnov; Shlomo,1,0,20,19
1656055531998,ECE 45,A01,083139,Congero; Spencer William,1,2,75,74
1656055538024,ECE 65,A50,083695,Saad; Andrew S,6,0,30,24
1656055538024,ECE 65,A51,095125,Staff,23,0,26,3
1656055544053,ECE 109,A01,091882,Touri; Behrouz,3,5,70,67
1656055550077,ECE 180,A00,083140,Abi Samra; Nicholas Camill,1,0,30,29
1656055550077,ECE 180,B00,083141,Abi Samra; Nicholas Camill,0,8,28,28
1656055556103,MATH 10A,A01,083735,Patchell; Gregory David,0,0,30,30
1656055556103,MATH 10A,A02,083736,Patchell; Gregory David,20,0,30,10
1656055556103,MATH 10A,A03,083737,Patchell; Gregory David,16,0,30,14
1656055562129,MATH 10B,A01,083207,Lim; Seonhee,1,1,34,33
1656055562129,MATH 10B,A02,083208,Lim; Seonhee,1,1,35,34
1656055562129,MATH 10B,A03,093472,Staff,1,1,34,33
1656055562129,MATH 10B,B01,083739,Sinha; Shubham,10,0,30,20
1656055568153,MATH 18,A01,083743,Cinel; Cameron Alexander,5,0,30,25
1656055568153,MATH 18,A02,083744,Cinel; Cameron Alexander,11,0,30,19
1656055568153,MATH 18,A03,083745,Cinel; Cameron Alexander,2,0,30,28
1656055568153,MATH 18,B01,083748,Ma; Zilu,0,0,36,36
1656055568153,MATH 18,B02,083749,Ma; Zilu,0,0,36,36
1656055568153,MATH 18,B03,083750,Ma; Zilu,0,0,36,36
1656055568153,MATH 18,B04,083751,Ma; Zilu,0,0,36,36
1656055568153,MATH 18,B05,093473,Staff,0,0,36,36
1656055568153,MATH 18,B06,093474,Staff,3,0,36,33
1656055574181,MATH 20A,A01,083754,Zheng; Zequn,11,0,40,29
1656055580214,MATH 20B,A01,083756,Briones; Jor-el Thomas Caparas,0,0,36,36
1656055580214,MATH 20B,A02,083757,Briones; Jor-el Thomas Caparas,0,0,36,36
1656055580214,MATH 20B,A03,093475,Staff,0,0,36,36
1656055586238,MATH 20C,A01,083760,Briones; Jor-el Thomas Caparas,0,2,35,35
1656055586238,MATH 20C,A02,083761,Briones; Jor-el Thomas Caparas,6,1,35,29
1656055586238,MATH 20C,A03,093476,Staff,0,1,35,35
1656055586238,MATH 20C,B01,083762,Bach; Quang Tran,3,0,30,27
1656055592263,MATH 20D,A01,083765,Tran; Brian Kha,3,0,30,27
1656055592263,MATH 20D,A02,083766,Tran; Brian Kha,0,1,30,30
1656055592263,MATH 20D,A03,083767,Tran; Brian Kha,1,0,30,29
1656055598297,MATH 20E,A01,083771,Ganguly; Soumya,1,1,32,31
1656055598297,MATH 20E,A02,083772,Ganguly; Soumya,1,1,32,31
1656055598297,MATH 20E,B01,083773,Ciotti; Benjamin,14,0,35,21
1656055598297,MATH 20E,B02,083774,Ciotti; Benjamin,13,0,35,22
1656055604323,MATH 103A,A01,083777,Greenfeld; Be'Eri,2,1,36,34
1656055604323,MATH 103A,A02,083778,Greenfeld; Be'Eri,1,0,36,35
1656055604323,MATH 103A,A03,093561,Staff,0,1,36,36
1656055604323,MATH 103A,B01,083779,Greenfeld; Be'Eri,8,1,36,28
1656055604323,MATH 103A,B02,083780,Greenfeld; Be'Eri,0,0,36,36
1656055604323,MATH 103A,B03,093562,Staff,0,0,36,36
1656055610350,MATH 105,A01,085443,Carter; Anne Toulson,4,1,35,31
1656055610350,MATH 105,A02,093477,Staff,9,0,35,26
1656055616385,MATH 109,A01,083213,Ganzberger; Geoffrey Michael,1,1,34,33
1656055616385,MATH 109,A02,083214,Ganzberger; Geoffrey Michael,0,0,34,34
1656055616385,MATH 109,A03,093478,Staff,1,0,34,33
1656055616385,MATH 109,B01,083215,Ganzberger; Geoffrey Michael,2,0,32,30
1656055616385,MATH 109,B02,083216,Ganzberger; Geoffrey Michael,0,0,32,32
1656055616385,MATH 109,B03,093479,Staff,3,0,32,29
1656055622472,MATH 142A,A01,083219,Chow; Bennett,1,0,32,31
1656055622472,MATH 142A,A02,083220,Chow; Bennett,7,0,32,25
1656055622472,MATH 142A,A03,093480,Staff,4,0,32,28
1656055622472,MATH 142A,B03,093481,Staff,5,0,32,27
1656055622472,MATH 142A,B04,093558,Staff,6,0,32,26
1656055622472,MATH 142A,B05,093559,Staff,0,0,32,32
1656055628505,MATH 193A,A01,083224,Rotar; Vladimir,1,2,34,33
1656055628505,MATH 193A,A02,083225,Rotar; Vladimir,1,0,34,33
1656055628505,MATH 193A,A03,083781,Rotar; Vladimir,1,0,34,33
1656055628505,MATH 193A,A04,083782,Rotar; Vladimir,3,0,34,31
1656055628505,MATH 193A,A05,093482,Rotar; Vladimir,0,0,34,34
1656055634531,MATH 197,001,091859,McAuley; Julian John,9999,0,9999,0
1656055634531,MATH 197,002,095566,Kedlaya; Kiran S.,9997,0,9999,2
1656055634531,MATH 197,003,095567,Xiao; Ming,9999,0,9999,0
1656055634531,MATH 197,004,095571,Perols; Johan Lars,9998,0,9999,1
1656055641598,COGS 9,A01,083615,Shannon; Kyle Michael,3,1,75,72
1656055647629,COGS 11,A01,083617,Boyle; Mary E. T.,11,2,48,37
1656055653660,COGS 13,A01,083071,Bastos; Amalia Pinkusfeld,4,3,71,67
1656055659686,COGS 14A,A01,092681,Semenuks; Arturs,4,25,100,96
1656055665711,COGS 14B,A01,083073,Cheng; Tzu-Han,7,0,63,56
1656055671736,COGS 17,A01,092677,Semenuks; Arturs,9,7,81,72
1656055677762,COGS 100,A01,083619,Allen; Michael Gordon,3,2,70,67
1656055683793,COGS 101A,A01,083621,Davis; Joshua Daniel,4,3,68,64
1656055689821,COGS 101B,A01,091572,Allen; Michael Gordon,0,0,65,65
1656055695850,COGS 101C,A01,083625,Delgado; Tania,7,0,35,28
1656055701878,COGS 107A,A01,083627,Boyle; Mary E. T.,1,2,60,59
1656055707903,COGS 118A,A01,083075,Gupta; Anjum,21,16,76,55
1656055713931,CSE 3,A50,083646,Miranda; Gregory Joseph,14,0,50,36
1656055719960,CSE 8A,A50,083650,Miranda; Gregory Joseph,4,11,56,52
1656055725990,CSE 11,A01,083080,Cao; Yingjun,0,64,40,40
1656055732014,CSE 12,A01,083652,Krause-Levy; Sophia Louisa,7,8,120,113
1656055738039,CSE 15L,A01,083654,Morris; Justin Loren,3,1,50,47
1656055738039,CSE 15L,A02,083655,Morris; Justin Loren,2,1,50,48
1656055744063,CSE 20,A01,083657,Tran; Khoa Dang,29,0,80,51
1656055750088,CSE 21,A01,095574,Bach; Quang Tran,23,0,48,25
1656055756117,CSE 30,A01,083084,Eldon; John,2,10,80,78
1656055756117,CSE 30,B01,095061,Bhaskar; Nishant,2,5,50,48
1656055762141,CSE 100,A01,083659,Cao; Yingjun,2,25,70,68
1656055768177,CSE 134B,A01,083661,Powell; Thomas Allan,6,6,100,94
1656055774202,CSE 140,A01,083663,Gungor; Onat,6,0,85,79
1656055780230,CSE 140L,A01,083088,Eldon; John,5,0,100,95
1656055786258,CSE 175,A01,083665,Kumar; Rakesh,0,0,25,25
1656055792282,CSE 190,A00,092507,Dubnov; Shlomo,1,0,20,19
1656055798307,ECE 45,A01,083139,Congero; Spencer William,1,2,75,74
1656055804329,ECE 65,A50,083695,Saad; Andrew S,6,0,30,24
1656055804329,ECE 65,A51,095125,Staff,23,0,26,3
1656055810356,ECE 109,A01,091882,Touri; Behrouz,3,5,70,67
1656055816380,ECE 180,A00,083140,Abi Samra; Nicholas Camill,1,0,30,29
1656055816380,ECE 180,B00,083141,Abi Samra; Nicholas Camill,0,8,28,28
1656055822406,MATH 10A,A01,083735,Patchell; Gregory David,0,0,30,30
1656055822406,MATH 10A,A02,083736,Patchell; Gregory David,20,0,30,10
1656055822406,MATH 10A,A03,083737,Patchell; Gregory David,16,0,30,14
1656055828429,MATH 10B,A01,083207,Lim; Seonhee,1,1,34,33
1656055828429,MATH 10B,A02,083208,Lim; Seonhee,1,1,35,34
1656055828429,MATH 10B,A03,093472,Staff,1,1,34,33
1656055828429,MATH 10B,B01,083739,Sinha; Shubham,10,0,30,20
1656055834452,MATH 18,A01,083743,Cinel; Cameron Alexander,5,0,30,25
1656055834452,MATH 18,A02,083744,Cinel; Cameron Alexander,11,0,30,19
1656055834452,MATH 18,A03,083745,Cinel; Cameron Alexander,2,0,30,28
1656055834452,MATH 18,B01,083748,Ma; Zilu,0,0,36,36
1656055834452,MATH 18,B02,083749,Ma; Zilu,0,0,36,36
1656055834452,MATH 18,B03,083750,Ma; Zilu,0,0,36,36
1656055834452,MATH 18,B04,083751,Ma; Zilu,0,0,36,36
1656055834452,MATH 18,B05,093473,Staff,0,0,36,36
1656055834452,MATH 18,B06,093474,Staff,3,0,36,33
1656055840478,MATH 20A,A01,083754,Zheng; Zequn,11,0,40,29
1656055846511,MATH 20B,A01,083756,Briones; Jor-el Thomas Caparas,0,0,36,36
1656055846511,MATH 20B,A02,083757,Briones; Jor-el Thomas Caparas,0,0,36,36
1656055846511,MATH 20B,A03,093475,Staff,0,0,36,36
1656055852534,MATH 20C,A01,083760,Briones; Jor-el Thomas Caparas,0,2,35,35
1656055852534,MATH 20C,A02,083761,Briones; Jor-el Thomas Caparas,6,1,35,29
1656055852534,MATH 20C,A03,093476,Staff,0,1,35,35
1656055852534,MATH 20C,B01,083762,Bach; Quang Tran,3,0,30,27
1656055858558,MATH 20D,A01,083765,Tran; Brian Kha,3,0,30,27
1656055858558,MATH 20D,A02,083766,Tran; Brian Kha,0,1,30,30
1656055858558,MATH 20D,A03,083767,Tran; Brian Kha,1,0,30,29
1656055864582,MATH 20E,A01,083771,Ganguly; Soumya,1,1,32,31
1656055864582,MATH 20E,A02,083772,Ganguly; Soumya,1,1,32,31
1656055864582,MATH 20E,B01,083773,Ciotti; Benjamin,14,0,35,21
1656055864582,MATH 20E,B02,083774,Ciotti; Benjamin,13,0,35,22
1656055870607,MATH 103A,A01,083777,Greenfeld; Be'Eri,2,1,36,34
1656055870607,MATH 103A,A02,083778,Greenfeld; Be'Eri,1,0,36,35
1656055870607,MATH 103A,A03,093561,Staff,0,1,36,36
1656055870607,MATH 103A,B01,083779,Greenfeld; Be'Eri,8,1,36,28
1656055870607,MATH 103A,B02,083780,Greenfeld; Be'Eri,0,0,36,36
1656055870607,MATH 103A,B03,093562,Staff,0,0,36,36
1656055876638,MATH 105,A01,085443,Carter; Anne Toulson,4,1,35,31
1656055876638,MATH 105,A02,093477,Staff,9,0,35,26
1656055882666,MATH 109,A01,083213,Ganzberger; Geoffrey Michael,1,1,34,33
1656055882666,MATH 109,A02,083214,Ganzberger; Geoffrey Michael,0,0,34,34
1656055882666,MATH 109,A03,093478,Staff,1,0,34,33
1656055882666,MATH 109,B01,083215,Ganzberger; Geoffrey Michael,2,0,32,30
1656055882666,MATH 109,B02,083216,Ganzberger; Geoffrey Michael,0,0,32,32
1656055882666,MATH 109,B03,093479,Staff,3,0,32,29
1656055888696,MATH 142A,A01,083219,Chow; Bennett,1,0,32,31
1656055888696,MATH 142A,A02,083220,Chow; Bennett,7,0,32,25
1656055888696,MATH 142A,A03,093480,Staff,4,0,32,28
1656055888696,MATH 142A,B03,093481,Staff,5,0,32,27
1656055888696,MATH 142A,B04,093558,Staff,6,0,32,26
1656055888696,MATH 142A,B05,093559,Staff,0,0,32,32
1656055894749,MATH 193A,A01,083224,Rotar; Vladimir,1,2,34,33
1656055894749,MATH 193A,A02,083225,Rotar; Vladimir,1,0,34,33
1656055894749,MATH 193A,A03,083781,Rotar; Vladimir,1,0,34,33
1656055894749,MATH 193A,A04,083782,Rotar; Vladimir,3,0,34,31
1656055894749,MATH 193A,A05,093482,Rotar; Vladimir,0,0,34,34
1656055900774,MATH 197,001,091859,McAuley; Julian John,9999,0,9999,0
1656055900774,MATH 197,002,095566,Kedlaya; Kiran S.,9997,0,9999,2
1656055900774,MATH 197,003,095567,Xiao; Ming,9999,0,9999,0
1656055900774,MATH 197,004,095571,Perols; Johan Lars,9998,0,9999,1
1656055907840,COGS 9,A01,083615,Shannon; Kyle Michael,3,1,75,72
1656055913863,COGS 11,A01,083617,Boyle; Mary E. T.,11,2,48,37
1656055919888,COGS 13,A01,083071,Bastos; Amalia Pinkusfeld,4,3,71,67
1656055925918,COGS 14A,A01,092681,Semenuks; Arturs,4,25,100,96
1656055931947,COGS 14B,A01,083073,Cheng; Tzu-Han,7,0,63,56
1656055937977,COGS 17,A01,092677,Semenuks; Arturs,9,7,81,72
1656055944005,COGS 100,A01,083619,Allen; Michael Gordon,3,2,70,67
1656055950032,COGS 101A,A01,083621,Davis; Joshua Daniel,4,3,68,64
1656055956057,COGS 101B,A01,091572,Allen; Michael Gordon,0,0,65,65
1656055962086,COGS 101C,A01,083625,Delgado; Tania,7,0,35,28
1656055968111,COGS 107A,A01,083627,Boyle; Mary E. T.,1,2,60,59
1656055974138,COGS 118A,A01,083075,Gupta; Anjum,21,16,76,55
1656055980167,CSE 3,A50,083646,Miranda; Gregory Joseph,14,0,50,36
1656055986192,CSE 8A,A50,083650,Miranda; Gregory Joseph,4,11,56,52
1656055992222,CSE 11,A01,083080,Cao; Yingjun,0,64,40,40
1656055998255,CSE 12,A01,083652,Krause-Levy; Sophia Louisa,7,8,120,113
1656056004280,CSE 15L,A01,083654,Morris; Justin Loren,3,1,50,47
1656056004280,CSE 15L,A02,083655,Morris; Justin Loren,2,1,50,48
1656056010309,CSE 20,A01,083657,Tran; Khoa Dang,29,0,80,51
1656056016340,CSE 21,A01,095574,Bach; Quang Tran,23,0,48,25
1656056022367,CSE 30,A01,083084,Eldon; John,2,10,80,78
1656056022367,CSE 30,B01,095061,Bhaskar; Nishant,2,5,50,48
1656056028392,CSE 100,A01,083659,Cao; Yingjun,2,25,70,68
1656056034417,CSE 134B,A01,083661,Powell; Thomas Allan,6,6,100,94
1656056040526,CSE 140,A01,083663,Gungor; Onat,6,0,85,79
1656056046555,CSE 140L,A01,083088,Eldon; John,5,0,100,95
1656056052591,CSE 175,A01,083665,Kumar; Rakesh,0,0,25,25
1656056058616,CSE 190,A00,092507,Dubnov; Shlomo,1,0,20,19
1656056064647,ECE 45,A01,083139,Congero; Spencer William,1,2,75,74
1656056070679,ECE 65,A50,083695,Saad; Andrew S,6,0,30,24
1656056070679,ECE 65,A51,095125,Staff,23,0,26,3
1656056076707,ECE 109,A01,091882,Touri; Behrouz,3,5,70,67
1656056082733,ECE 180,A00,083140,Abi Samra; Nicholas Camill,1,0,30,29
1656056082733,ECE 180,B00,083141,Abi Samra; Nicholas Camill,0,8,28,28
1656056088758,MATH 10A,A01,083735,Patchell; Gregory David,0,0,30,30
1656056088758,MATH 10A,A02,083736,Patchell; Gregory David,20,0,30,10
1656056088758,MATH 10A,A03,083737,Patchell; Gregory David,16,0,30,14
1656056094792,MATH 10B,A01,083207,Lim; Seonhee,1,1,34,33
1656056094792,MATH 10B,A02,083208,Lim; Seonhee,1,1,35,34
1656056094792,MATH 10B,A03,093472,Staff,1,1,34,33
1656056094792,MATH 10B,B01,083739,Sinha; Shubham,10,0,30,20
1656056100817,MATH 18,A01,083743,Cinel; Cameron Alexander,5,0,30,25
1656056100817,MATH 18,A02,083744,Cinel; Cameron Alexander,11,0,30,19
1656056100817,MATH 18,A03,083745,Cinel; Cameron Alexander,2,0,30,28
1656056100817,MATH 18,B01,083748,Ma; Zilu,0,0,36,36
1656056100817,MATH 18,B02,083749,Ma; Zilu,0,0,36,36
1656056100817,MATH 18,B03,083750,Ma; Zilu,0,0,36,36
1656056100817,MATH 18,B04,083751,Ma; Zilu,0,0,36,36
1656056100817,MATH 18,B05,093473,Staff,0,0,36,36
1656056100817,MATH 18,B06,093474,Staff,3,0,36,33
1656056106862,MATH 20A,A01,083754,Zheng; Zequn,11,0,40,29
1656056112889,MATH 20B,A01,083756,Briones; Jor-el Thomas Caparas,0,0,36,36
1656056112889,MATH 20B,A02,083757,Briones; Jor-el Thomas Caparas,0,0,36,36
1656056112889,MATH 20B,A03,093475,Staff,0,0,36,36
1656056118916,MATH 20C,A01,083760,Briones; Jor-el Thomas Caparas,0,2,35,35
1656056118916,MATH 20C,A02,083761,Briones; Jor-el Thomas Caparas,6,1,35,29
1656056118916,MATH 20C,A03,093476,Staff,0,1,35,35
1656056118916,MATH 20C,B01,083762,Bach; Quang Tran,3,0,30,27
1656056124943,MATH 20D,A01,083765,Tran; Brian Kha,3,0,30,27
1656056124943,MATH 20D,A02,083766,Tran; Brian Kha,0,1,30,30
1656056124943,MATH 20D,A03,083767,Tran; Brian Kha,1,0,30,29
1656056130968,MATH 20E,A01,083771,Ganguly; Soumya,1,1,32,31
1656056130968,MATH 20E,A02,083772,Ganguly; Soumya,1,1,32,31
1656056130968,MATH 20E,B01,083773,Ciotti; Benjamin,14,0,35,21
1656056130968,MATH 20E,B02,083774,Ciotti; Benjamin,13,0,35,22
1656056136996,MATH 103A,A01,083777,Greenfeld; Be'Eri,2,1,36,34
1656056136996,MATH 103A,A02,083778,Greenfeld; Be'Eri,1,0,36,35
1656056136996,MATH 103A,A03,093561,Staff,0,1,36,36
1656056136996,MATH 103A,B01,083779,Greenfeld; Be'Eri,8,1,36,28
1656056136996,MATH 103A,B02,083780,Greenfeld; Be'Eri,0,0,36,36
1656056136996,MATH 103A,B03,093562,Staff,0,0,36,36
1656056143030,MATH 105,A01,085443,Carter; Anne Toulson,4,1,35,31
1656056143030,MATH 105,A02,093477,Staff,9,0,35,26
1656056149058,MATH 109,A01,083213,Ganzberger; Geoffrey Michael,1,1,34,33
1656056149058,MATH 109,A02,083214,Ganzberger; Geoffrey Michael,0,0,34,34
1656056149058,MATH 109,A03,093478,Staff,1,0,34,33
1656056149058,MATH 109,B01,083215,Ganzberger; Geoffrey Michael,2,0,32,30
1656056149058,MATH 109,B02,083216,Ganzberger; Geoffrey Michael,0,0,32,32
1656056149058,MATH 109,B03,093479,Staff,3,0,32,29
1656056155093,MATH 142A,A01,083219,Chow; Bennett,1,0,32,31
1656056155093,MATH 142A,A02,083220,Chow; Bennett,7,0,32,25
1656056155093,MATH 142A,A03,093480,Staff,4,0,32,28
1656056155093,MATH 142A,B03,093481,Staff,5,0,32,27
1656056155093,MATH 142A,B04,093558,Staff,6,0,32,26
1656056155093,MATH 142A,B05,093559,Staff,0,0,32,32
1656056161129,MATH 193A,A01,083224,Rotar; Vladimir,1,2,34,33
1656056161129,MATH 193A,A02,083225,Rotar; Vladimir,1,0,34,33
1656056161129,MATH 193A,A03,083781,Rotar; Vladimir,1,0,34,33
1656056161129,MATH 193A,A04,083782,Rotar; Vladimir,3,0,34,31
1656056161129,MATH 193A,A05,093482,Rotar; Vladimir,0,0,34,34
1656056167162,MATH 197,001,091859,McAuley; Julian John,9999,0,9999,0
1656056167162,MATH 197,002,095566,Kedlaya; Kiran S.,9997,0,9999,2
1656056167162,MATH 197,003,095567,Xiao; Ming,9999,0,9999,0
1656056167162,MATH 197,004,095571,Perols; Johan Lars,9998,0,9999,1
1656056174247,COGS 9,A01,083615,Shannon; Kyle Michael,3,1,75,72
1656056180271,COGS 11,A01,083617,Boyle; Mary E. T.,11,2,48,37
1656056186295,COGS 13,A01,083071,Bastos; Amalia Pinkusfeld,4,3,71,67
1656056192325,COGS 14A,A01,092681,Semenuks; Arturs,4,25,100,96
1656056198355,COGS 14B,A01,083073,Cheng; Tzu-Han,7,0,63,56
1656056204379,COGS 17,A01,092677,Semenuks; Arturs,9,7,81,72
1656056210410,COGS 100,A01,083619,Allen; Michael Gordon,3,2,70,67
1656056216435,COGS 101A,A01,083621,Davis; Joshua Daniel,4,3,68,64
1656056222465,COGS 101B,A01,091572,Allen; Michael Gordon,0,0,65,65
1656056228494,COGS 101C,A01,083625,Delgado; Tania,7,0,35,28
1656056234522,COGS 107A,A01,083627,Boyle; Mary E. T.,1,2,60,59
1656056240548,COGS 118A,A01,083075,Gupta; Anjum,21,16,76,55
1656056246573,CSE 3,A50,083646,Miranda; Gregory Joseph,14,0,50,36
1656056252602,CSE 8A,A50,083650,Miranda; Gregory Joseph,4,11,56,52
1656056258631,CSE 11,A01,083080,Cao; Yingjun,0,64,40,40
1656056264658,CSE 12,A01,083652,Krause-Levy; Sophia Louisa,7,8,120,113
1656056270682,CSE 15L,A01,083654,Morris; Justin Loren,3,1,50,47
1656056270682,CSE 15L,A02,083655,Morris; Justin Loren,2,1,50,48
1656056276711,CSE 20,A01,083657,Tran; Khoa Dang,29,0,80,51
1656056282736,CSE 21,A01,095574,Bach; Quang Tran,23,0,48,25
1656056288763,CSE 30,A01,083084,Eldon; John,2,10,80,78
1656056288763,CSE 30,B01,095061,Bhaskar; Nishant,2,5,50,48
1656056294788,CSE 100,A01,083659,Cao; Yingjun,2,25,70,68
1656056300815,CSE 134B,A01,083661,Powell; Thomas Allan,6,6,100,94
1656056306841,CSE 140,A01,083663,Gungor; Onat,6,0,85,79
1656056312873,CSE 140L,A01,083088,Eldon; John,5,0,100,95
1656056318905,CSE 175,A01,083665,Kumar; Rakesh,0,0,25,25
1656056324929,CSE 190,A00,092507,Dubnov; Shlomo,1,0,20,19
1656056330956,ECE 45,A01,083139,Congero; Spencer William,1,2,75,74
1656056336986,ECE 65,A50,083695,Saad; Andrew S,6,0,30,24
1656056336986,ECE 65,A51,095125,Staff,23,0,26,3
1656056343012,ECE 109,A01,091882,Touri; Behrouz,3,5,70,67
1656056349042,ECE 180,A00,083140,Abi Samra; Nicholas Camill,1,0,30,29
1656056349042,ECE 180,B00,083141,Abi Samra; Nicholas Camill,0,8,28,28
1656056355071,MATH 10A,A01,083735,Patchell; Gregory David,0,0,30,30
1656056355071,MATH 10A,A02,083736,Patchell; Gregory David,20,0,30,10
1656056355071,MATH 10A,A03,083737,Patchell; Gregory David,16,0,30,14
1656056361104,MATH 10B,A01,083207,Lim; Seonhee,1,1,34,33
1656056361104,MATH 10B,A02,083208,Lim; Seonhee,1,1,35,34
1656056361104,MATH 10B,A03,093472,Staff,1,1,34,33
1656056361104,MATH 10B,B01,083739,Sinha; Shubham,10,0,30,20
1656056367134,MATH 18,A01,083743,Cinel; Cameron Alexander,5,0,30,25
1656056367134,MATH 18,A02,083744,Cinel; Cameron Alexander,11,0,30,19
1656056367134,MATH 18,A03,083745,Cinel; Cameron Alexander,2,0,30,28
1656056367134,MATH 18,B01,083748,Ma; Zilu,0,0,36,36
1656056367134,MATH 18,B02,083749,Ma; Zilu,0,0,36,36
1656056367134,MATH 18,B03,083750,Ma; Zilu,0,0,36,36
1656056367134,MATH 18,B04,083751,Ma; Zilu,0,0,36,36
1656056367134,MATH 18,B05,093473,Staff,0,0,36,36
1656056367134,MATH 18,B06,093474,Staff,3,0,36,33
1656056373161,MATH 20A,A01,083754,Zheng; Zequn,11,0,40,29
1656056379189,MATH 20B,A01,083756,Briones; Jor-el Thomas Caparas,0,0,36,36
1656056379189,MATH 20B,A02,083757,Briones; Jor-el Thomas Caparas,0,0,36,36
1656056379189,MATH 20B,A03,093475,Staff,0,0,36,36
1656056385215,MATH 20C,A01,083760,Briones; Jor-el Thomas Caparas,0,2,35,35
1656056385215,MATH 20C,A02,083761,Briones; Jor-el Thomas Caparas,6,1,35,29
1656056385215,MATH 20C,A03,093476,Staff,0,1,35,35
1656056385215,MATH 20C,B01,083762,Bach; Quang Tran,3,0,30,27
1656056391240,MATH 20D,A01,083765,Tran; Brian Kha,3,0,30,27
1656056391240,MATH 20D,A02,083766,Tran; Brian Kha,0,1,30,30
1656056391240,MATH 20D,A03,083767,Tran; Brian Kha,1,0,30,29
1656056397271,MATH 20E,A01,083771,Ganguly; Soumya,1,1,32,31
1656056397271,MATH 20E,A02,083772,Ganguly; Soumya,1,1,32,31
1656056397271,MATH 20E,B01,083773,Ciotti; Benjamin,14,0,35,21
1656056397271,MATH 20E,B02,083774,Ciotti; Benjamin,13,0,35,22
1656056403305,MATH 103A,A01,083777,Greenfeld; Be'Eri,2,1,36,34
1656056403305,MATH 103A,A02,083778,Greenfeld; Be'Eri,1,0,36,35
1656056403305,MATH 103A,A03,093561,Staff,0,1,36,36
1656056403305,MATH 103A,B01,083779,Greenfeld; Be'Eri,8,1,36,28
1656056403305,MATH 103A,B02,083780,Greenfeld; Be'Eri,0,0,36,36
1656056403305,MATH 103A,B03,093562,Staff,0,0,36,36
1656056409339,MATH 105,A01,085443,Carter; Anne Toulson,4,1,35,31
1656056409339,MATH 105,A02,093477,Staff,9,0,35,26
1656056415365,MATH 109,A01,083213,Ganzberger; Geoffrey Michael,1,1,34,33
1656056415365,MATH 109,A02,083214,Ganzberger; Geoffrey Michael,0,0,34,34
1656056415365,MATH 109,A03,093478,Staff,1,0,34,33
1656056415365,MATH 109,B01,083215,Ganzberger; Geoffrey Michael,2,0,32,30
1656056415365,MATH 109,B02,083216,Ganzberger; Geoffrey Michael,0,0,32,32
1656056415365,MATH 109,B03,093479,Staff,3,0,32,29
1656056421394,MATH 142A,A01,083219,Chow; Bennett,1,0,32,31
1656056421394,MATH 142A,A02,083220,Chow; Bennett,7,0,32,25
1656056421394,MATH 142A,A03,093480,Staff,4,0,32,28
1656056421394,MATH 142A,B03,093481,Staff,5,0,32,27
1656056421394,MATH 142A,B04,093558,Staff,6,0,32,26
1656056421394,MATH 142A,B05,093559,Staff,0,0,32,32
1656056427421,MATH 193A,A01,083224,Rotar; Vladimir,1,2,34,33
1656056427421,MATH 193A,A02,083225,Rotar; Vladimir,1,0,34,33
1656056427421,MATH 193A,A03,083781,Rotar; Vladimir,1,0,34,33
1656056427421,MATH 193A,A04,083782,Rotar; Vladimir,3,0,34,31
1656056427421,MATH 193A,A05,093482,Rotar; Vladimir,0,0,34,34
1656056433445,MATH 197,001,091859,McAuley; Julian John,9999,0,9999,0
1656056433445,MATH 197,002,095566,Kedlaya; Kiran S.,9997,0,9999,2
1656056433445,MATH 197,003,095567,Xiao; Ming,9999,0,9999,0
1656056433445,MATH 197,004,095571,Perols; Johan Lars,9998,0,9999,1
1656056440521,COGS 9,A01,083615,Shannon; Kyle Michael,3,1,75,72
1656056446547,COGS 11,A01,083617,Boyle; Mary E. T.,11,2,48,37
1656056452572,COGS 13,A01,083071,Bastos; Amalia Pinkusfeld,4,3,71,67
1656056458597,COGS 14A,A01,092681,Semenuks; Arturs,4,25,100,96
1656056464627,COGS 14B,A01,083073,Cheng; Tzu-Han,7,0,63,56
1656056470649,COGS 17,A01,092677,Semenuks; Arturs,9,7,81,72
1656056476680,COGS 100,A01,083619,Allen; Michael Gordon,3,2,70,67
1656056482707,COGS 101A,A01,083621,Davis; Joshua Daniel,4,3,68,64
1656056488732,COGS 101B,A01,091572,Allen; Michael Gordon,0,0,65,65
1656056494758,COGS 101C,A01,083625,Delgado; Tania,7,0,35,28
1656056500786,COGS 107A,A01,083627,Boyle; Mary E. T.,1,2,60,59
1656056506815,COGS 118A,A01,083075,Gupta; Anjum,21,16,76,55
1656056512846,CSE 3,A50,083646,Miranda; Gregory Joseph,14,0,50,36
1656056518876,CSE 8A,A50,083650,Miranda; Gregory Joseph,4,11,56,52
1656056524904,CSE 11,A01,083080,Cao; Yingjun,0,64,40,40
1656056530928,CSE 12,A01,083652,Krause-Levy; Sophia Louisa,7,8,120,113
1656056536956,CSE 15L,A01,083654,Morris; Justin Loren,3,1,50,47
1656056536956,CSE 15L,A02,083655,Morris; Justin Loren,2,1,50,48
1656056542984,CSE 20,A01,083657,Tran; Khoa Dang,29,0,80,51
1656056549011,CSE 21,A01,095574,Bach; Quang Tran,23,0,48,25
1656056555037,CSE 30,A01,083084,Eldon; John,2,10,80,78
1656056555037,CSE 30,B01,095061,Bhaskar; Nishant,2,5,50,48
1656056561066,CSE 100,A01,083659,Cao; Yingjun,2,25,70,68
1656056567096,CSE 134B,A01,083661,Powell; Thomas Allan,6,6,100,94
1656056573121,CSE 140,A01,083663,Gungor; Onat,6,0,85,79
1656056579147,CSE 140L,A01,083088,Eldon; John,5,0,100,95
1656056585180,CSE 175,A01,083665,Kumar; Rakesh,0,0,25,25
1656056591218,CSE 190,A00,092507,Dubnov; Shlomo,1,0,20,19
1656056597244,ECE 45,A01,083139,Congero; Spencer William,1,2,75,74
1656056603271,ECE 65,A50,083695,Saad; Andrew S,6,0,30,24
1656056603271,ECE 65,A51,095125,Staff,23,0,26,3
1656056609295,ECE 109,A01,091882,Touri; Behrouz,3,5,70,67
1656056615328,ECE 180,A00,083140,Abi Samra; Nicholas Camill,1,0,30,29
1656056615328,ECE 180,B00,083141,Abi Samra; Nicholas Camill,0,8,28,28
1656056621357,MATH 10A,A01,083735,Patchell; Gregory David,0,0,30,30
1656056621357,MATH 10A,A02,083736,Patchell; Gregory David,20,0,30,10
1656056621357,MATH 10A,A03,083737,Patchell; Gregory David,16,0,30,14
1656056627387,MATH 10B,A01,083207,Lim; Seonhee,1,1,34,33
1656056627387,MATH 10B,A02,083208,Lim; Seonhee,1,1,35,34
1656056627387,MATH 10B,A03,093472,Staff,1,1,34,33
1656056627387,MATH 10B,B01,083739,Sinha; Shubham,10,0,30,20
1656056633434,MATH 18,A01,083743,Cinel; Cameron Alexander,5,0,30,25
1656056633434,MATH 18,A02,083744,Cinel; Cameron Alexander,11,0,30,19
1656056633434,MATH 18,A03,083745,Cinel; Cameron Alexander,2,0,30,28
1656056633434,MATH 18,B01,083748,Ma; Zilu,0,0,36,36
1656056633434,MATH 18,B02,083749,Ma; Zilu,0,0,36,36
1656056633434,MATH 18,B03,083750,Ma; Zilu,0,0,36,36
1656056633434,MATH 18,B04,083751,Ma; Zilu,0,0,36,36
1656056633434,MATH 18,B05,093473,Staff,0,0,36,36
1656056633434,MATH 18,B06,093474,Staff,3,0,36,33
1656056639535,MATH 20A,A01,083754,Zheng; Zequn,11,0,40,29
1656056645561,MATH 20B,A01,083756,Briones; Jor-el Thomas Caparas,0,0,36,36
1656056645561,MATH 20B,A02,083757,Briones; Jor-el Thomas Caparas,0,0,36,36
1656056645561,MATH 20B,A03,093475,Staff,0,0,36,36
1656056651589,MATH 20C,A01,083760,Briones; Jor-el Thomas Caparas,0,2,35,35
1656056651589,MATH 20C,A02,083761,Briones; Jor-el Thomas Caparas,6,1,35,29
1656056651589,MATH 20C,A03,093476,Staff,0,1,35,35
1656056651589,MATH 20C,B01,083762,Bach; Quang Tran,3,0,30,27
1656056657618,MATH 20D,A01,083765,Tran; Brian Kha,3,0,30,27
1656056657618,MATH 20D,A02,083766,Tran; Brian Kha,0,1,30,30
1656056657618,MATH 20D,A03,083767,Tran; Brian Kha,1,0,30,29
1656056663650,MATH 20E,A01,083771,Ganguly; Soumya,1,1,32,31
1656056663650,MATH 20E,A02,083772,Ganguly; Soumya,1,1,32,31
1656056663650,MATH 20E,B01,083773,Ciotti; Benjamin,14,0,35,21
1656056663650,MATH 20E,B02,083774,Ciotti; Benjamin,13,0,35,22
1656056669681,MATH 103A,A01,083777,Greenfeld; Be'Eri,2,1,36,34
1656056669681,MATH 103A,A02,083778,Greenfeld; Be'Eri,1,0,36,35
1656056669681,MATH 103A,A03,093561,Staff,0,1,36,36
1656056669681,MATH 103A,B01,083779,Greenfeld; Be'Eri,8,1,36,28
1656056669681,MATH 103A,B02,083780,Greenfeld; Be'Eri,0,0,36,36
1656056669681,MATH 103A,B03,093562,Staff,0,0,36,36
1656056675709,MATH 105,A01,085443,Carter; Anne Toulson,4,1,35,31
1656056675709,MATH 105,A02,093477,Staff,9,0,35,26
1656056681735,MATH 109,A01,083213,Ganzberger; Geoffrey Michael,1,1,34,33
1656056681735,MATH 109,A02,083214,Ganzberger; Geoffrey Michael,0,0,34,34
1656056681735,MATH 109,A03,093478,Staff,1,0,34,33
1656056681735,MATH 109,B01,083215,Ganzberger; Geoffrey Michael,2,0,32,30
1656056681735,MATH 109,B02,083216,Ganzberger; Geoffrey Michael,0,0,32,32
1656056681735,MATH 109,B03,093479,Staff,3,0,32,29
1656056687777,MATH 142A,A01,083219,Chow; Bennett,1,0,32,31
1656056687777,MATH 142A,A02,083220,Chow; Bennett,7,0,32,25
1656056687777,MATH 142A,A03,093480,Staff,4,0,32,28
1656056687777,MATH 142A,B03,093481,Staff,5,0,32,27
1656056687777,MATH 142A,B04,093558,Staff,6,0,32,26
1656056687777,MATH 142A,B05,093559,Staff,0,0,32,32
1656056693815,MATH 193A,A01,083224,Rotar; Vladimir,1,2,34,33
1656056693815,MATH 193A,A02,083225,Rotar; Vladimir,1,0,34,33
1656056693815,MATH 193A,A03,083781,Rotar; Vladimir,1,0,34,33
1656056693815,MATH 193A,A04,083782,Rotar; Vladimir,3,0,34,31
1656056693815,MATH 193A,A05,093482,Rotar; Vladimir,0,0,34,34
1656056699845,MATH 197,001,091859,McAuley; Julian John,9999,0,9999,0
1656056699845,MATH 197,002,095566,Kedlaya; Kiran S.,9997,0,9999,2
1656056699845,MATH 197,003,095567,Xiao; Ming,9999,0,9999,0
1656056699845,MATH 197,004,095571,Perols; Johan Lars,9998,0,9999,1
1656056706945,COGS 9,A01,083615,Shannon; Kyle Michael,3,1,75,72
1656056712970,COGS 11,A01,083617,Boyle; Mary E. T.,11,2,48,37
1656056718997,COGS 13,A01,083071,Bastos; Amalia Pinkusfeld,4,3,71,67
1656056725029,COGS 14A,A01,092681,Semenuks; Arturs,4,25,100,96
1656056731059,COGS 14B,A01,083073,Cheng; Tzu-Han,7,0,63,56
1656056737083,COGS 17,A01,092677,Semenuks; Arturs,9,7,81,72
1656056743113,COGS 100,A01,083619,Allen; Michael Gordon,3,2,70,67
1656056749146,COGS 101A,A01,083621,Davis; Joshua Daniel,4,3,68,64
1656056755173,COGS 101B,A01,091572,Allen; Michael Gordon,0,0,65,65
1656056761211,COGS 101C,A01,083625,Delgado; Tania,7,0,35,28
1656056767241,COGS 107A,A01,083627,Boyle; Mary E. T.,1,2,60,59
1656056773273,COGS 118A,A01,083075,Gupta; Anjum,21,16,76,55
1656056779299,CSE 3,A50,083646,Miranda; Gregory Joseph,14,0,50,36
1656056785323,CSE 8A,A50,083650,Miranda; Gregory Joseph,4,11,56,52
1656056791364,CSE 11,A01,083080,Cao; Yingjun,0,64,40,40
1656056797394,CSE 12,A01,083652,Krause-Levy; Sophia Louisa,7,8,120,113
1656056803420,CSE 15L,A01,083654,Morris; Justin Loren,3,1,50,47
1656056803420,CSE 15L,A02,083655,Morris; Justin Loren,2,1,50,48
1656056809450,CSE 20,A01,083657,Tran; Khoa Dang,29,0,80,51
1656056815479,CSE 21,A01,095574,Bach; Quang Tran,23,0,48,25
1656056821505,CSE 30,A01,083084,Eldon; John,2,10,80,78
1656056821505,CSE 30,B01,095061,Bhaskar; Nishant,2,5,50,48
1656056827529,CSE 100,A01,083659,Cao; Yingjun,2,25,70,68
1656056833554,CSE 134B,A01,083661,Powell; Thomas Allan,6,6,100,94
1656056839584,CSE 140,A01,083663,Gungor; Onat,6,0,85,79
1656056845607,CSE 140L,A01,083088,Eldon; John,5,0,100,95
1656056851633,CSE 175,A01,083665,Kumar; Rakesh,0,0,25,25
1656056857663,CSE 190,A00,092507,Dubnov; Shlomo,1,0,20,19
1656056863688,ECE 45,A01,083139,Congero; Spencer William,1,2,75,74
1656056869715,ECE 65,A50,083695,Saad; Andrew S,6,0,30,24
1656056869715,ECE 65,A51,095125,Staff,23,0,26,3
1656056875745,ECE 109,A01,091882,Touri; Behrouz,3,5,70,67
1656056881771,ECE 180,A00,083140,Abi Samra; Nicholas Camill,1,0,30,29
1656056881771,ECE 180,B00,083141,Abi Samra; Nicholas Camill,0,8,28,28
1656056887803,MATH 10A,A01,083735,Patchell; Gregory David,0,0,30,30
1656056887803,MATH 10A,A02,083736,Patchell; Gregory David,20,0,30,10
1656056887803,MATH 10A,A03,083737,Patchell; Gregory David,16,0,30,14
1656056893841,MATH 10B,A01,083207,Lim; Seonhee,1,1,34,33
1656056893841,MATH 10B,A02,083208,Lim; Seonhee,1,1,35,34
1656056893841,MATH 10B,A03,093472,Staff,1,1,34,33
1656056893841,MATH 10B,B01,083739,Sinha; Shubham,10,0,30,20
1656056899872,MATH 18,A01,083743,Cinel; Cameron Alexander,5,0,30,25
1656056899872,MATH 18,A02,083744,Cinel; Cameron Alexander,11,0,30,19
1656056899872,MATH 18,A03,083745,Cinel; Cameron Alexander,2,0,30,28
1656056899872,MATH 18,B01,083748,Ma; Zilu,0,0,36,36
1656056899872,MATH 18,B02,083749,Ma; Zilu,0,0,36,36
1656056899872,MATH 18,B03,083750,Ma; Zilu,0,0,36,36
1656056899872,MATH 18,B04,083751,Ma; Zilu,0,0,36,36
1656056899872,MATH 18,B05,093473,Staff,0,0,36,36
1656056899872,MATH 18,B06,093474,Staff,3,0,36,33
1656056905910,MATH 20A,A01,083754,Zheng; Zequn,11,0,40,29
1656056911945,MATH 20B,A01,083756,Briones; Jor-el Thomas Caparas,0,0,36,36
1656056911945,MATH 20B,A02,083757,Briones; Jor-el Thomas Caparas,0,0,36,36
1656056911945,MATH 20B,A03,093475,Staff,0,0,36,36
1656056917980,MATH 20C,A01,083760,Briones; Jor-el Thomas Caparas,0,2,35,35
1656056917980,MATH 20C,A02,083761,Briones; Jor-el Thomas Caparas,6,1,35,29
1656056917980,MATH 20C,A03,093476,Staff,0,1,35,35
1656056917980,MATH 20C,B01,083762,Bach; Quang Tran,3,0,30,27
1656056924004,MATH 20D,A01,083765,Tran; Brian Kha,3,0,30,27
1656056924004,MATH 20D,A02,083766,Tran; Brian Kha,0,1,30,30
1656056924004,MATH 20D,A03,083767,Tran; Brian Kha,1,0,30,29
1656056930032,MATH 20E,A01,083771,Ganguly; Soumya,1,1,32,31
1656056930032,MATH 20E,A02,083772,Ganguly; Soumya,1,1,32,31
1656056930032,MATH 20E,B01,083773,Ciotti; Benjamin,14,0,35,21
1656056930032,MATH 20E,B02,083774,Ciotti; Benjamin,13,0,35,22
1656056936076,MATH 103A,A01,083777,Greenfeld; Be'Eri,2,1,36,34
1656056936076,MATH 103A,A02,083778,Greenfeld; Be'Eri,1,0,36,35
1656056936076,MATH 103A,A03,093561,Staff,0,1,36,36
1656056936076,MATH 103A,B01,083779,Greenfeld; Be'Eri,8,1,36,28
1656056936076,MATH 103A,B02,083780,Greenfeld; Be'Eri,0,0,36,36
1656056936076,MATH 103A,B03,093562,Staff,0,0,36,36
1656056942103,MATH 105,A01,085443,Carter; Anne Toulson,4,1,35,31
1656056942103,MATH 105,A02,093477,Staff,9,0,35,26
1656056948131,MATH 109,A01,083213,Ganzberger; Geoffrey Michael,1,1,34,33
1656056948131,MATH 109,A02,083214,Ganzberger; Geoffrey Michael,0,0,34,34
1656056948131,MATH 109,A03,093478,Staff,1,0,34,33
1656056948131,MATH 109,B01,083215,Ganzberger; Geoffrey Michael,2,0,32,30
1656056948131,MATH 109,B02,083216,Ganzberger; Geoffrey Michael,0,0,32,32
1656056948131,MATH 109,B03,093479,Staff,3,0,32,29
1656056954160,MATH 142A,A01,083219,Chow; Bennett,1,0,32,31
1656056954160,MATH 142A,A02,083220,Chow; Bennett,7,0,32,25
1656056954160,MATH 142A,A03,093480,Staff,4,0,32,28
1656056954160,MATH 142A,B03,093481,Staff,5,0,32,27
1656056954160,MATH 142A,B04,093558,Staff,6,0,32,26
1656056954160,MATH 142A,B05,093559,Staff,0,0,32,32
1656056960198,MATH 193A,A01,083224,Rotar; Vladimir,1,2,34,33
1656056960198,MATH 193A,A02,083225,Rotar; Vladimir,1,0,34,33
1656056960198,MATH 193A,A03,083781,Rotar; Vladimir,1,0,34,33
1656056960198,MATH 193A,A04,083782,Rotar; Vladimir,3,0,34,31
1656056960198,MATH 193A,A05,093482,Rotar; Vladimir,0,0,34,34
1656056966223,MATH 197,001,091859,McAuley; Julian John,9999,0,9999,0
1656056966223,MATH 197,002,095566,Kedlaya; Kiran S.,9997,0,9999,2
1656056966223,MATH 197,003,095567,Xiao; Ming,9999,0,9999,0
1656056966223,MATH 197,004,095571,Perols; Johan Lars,9998,0,9999,1
1656056973293,COGS 9,A01,083615,Shannon; Kyle Michael,3,1,75,72
1656056979318,COGS 11,A01,083617,Boyle; Mary E. T.,11,2,48,37
1656056985345,COGS 13,A01,083071,Bastos; Amalia Pinkusfeld,4,3,71,67
1656056991370,COGS 14A,A01,092681,Semenuks; Arturs,4,25,100,96
1656056997401,COGS 14B,A01,083073,Cheng; Tzu-Han,7,0,63,56
1656057003425,COGS 17,A01,092677,Semenuks; Arturs,9,7,81,72
1656057009455,COGS 100,A01,083619,Allen; Michael Gordon,3,2,70,67
1656057015481,COGS 101A,A01,083621,Davis; Joshua Daniel,4,3,68,64
1656057021506,COGS 101B,A01,091572,Allen; Michael Gordon,0,0,65,65
1656057027538,COGS 101C,A01,083625,Delgado; Tania,7,0,35,28
1656057033563,COGS 107A,A01,083627,Boyle; Mary E. T.,1,2,60,59
1656057039587,COGS 118A,A01,083075,Gupta; Anjum,21,16,76,55
1656057045623,CSE 3,A50,083646,Miranda; Gregory Joseph,14,0,50,36
1656057051655,CSE 8A,A50,083650,Miranda; Gregory Joseph,4,11,56,52
1656057057680,CSE 11,A01,083080,Cao; Yingjun,0,64,40,40
1656057063706,CSE 12,A01,083652,Krause-Levy; Sophia Louisa,7,8,120,113
1656057069730,CSE 15L,A01,083654,Morris; Justin Loren,3,1,50,47
1656057069730,CSE 15L,A02,083655,Morris; Justin Loren,2,1,50,48
1656057075755,CSE 20,A01,083657,Tran; Khoa Dang,29,0,80,51
1656057081784,CSE 21,A01,095574,Bach; Quang Tran,23,0,48,25
1656057087810,CSE 30,A01,083084,Eldon; John,2,10,80,78
1656057087810,CSE 30,B01,095061,Bhaskar; Nishant,2,5,50,48
1656057093835,CSE 100,A01,083659,Cao; Yingjun,2,25,70,68
1656057099865,CSE 134B,A01,083661,Powell; Thomas Allan,6,6,100,94
1656057105897,CSE 140,A01,083663,Gungor; Onat,6,0,85,79
1656057111922,CSE 140L,A01,083088,Eldon; John,5,0,100,95
1656057117946,CSE 175,A01,083665,Kumar; Rakesh,0,0,25,25
1656057123974,CSE 190,A00,092507,Dubnov; Shlomo,1,0,20,19
1656057130004,ECE 45,A01,083139,Congero; Spencer William,1,2,75,74
1656057136032,ECE 65,A50,083695,Saad; Andrew S,6,0,30,24
1656057136032,ECE 65,A51,095125,Staff,23,0,26,3
1656057142056,ECE 109,A01,091882,Touri; Behrouz,3,5,70,67
1656057148079,ECE 180,A00,083140,Abi Samra; Nicholas Camill,1,0,30,29
1656057148079,ECE 180,B00,083141,Abi Samra; Nicholas Camill,0,8,28,28
1656057154111,MATH 10A,A01,083735,Patchell; Gregory David,0,0,30,30
1656057154111,MATH 10A,A02,083736,Patchell; Gregory David,20,0,30,10
1656057154111,MATH 10A,A03,083737,Patchell; Gregory David,16,0,30,14
1656057160138,MATH 10B,A01,083207,Lim; Seonhee,1,1,34,33
1656057160138,MATH 10B,A02,083208,Lim; Seonhee,1,1,35,34
1656057160138,MATH 10B,A03,093472,Staff,1,1,34,33
1656057160138,MATH 10B,B01,083739,Sinha; Shubham,10,0,30,20
1656057166166,MATH 18,A01,083743,Cinel; Cameron Alexander,5,0,30,25
1656057166166,MATH 18,A02,083744,Cinel; Cameron Alexander,11,0,30,19
1656057166166,MATH 18,A03,083745,Cinel; Cameron Alexander,2,0,30,28
1656057166166,MATH 18,B01,083748,Ma; Zilu,0,0,36,36
1656057166166,MATH 18,B02,083749,Ma; Zilu,0,0,36,36
1656057166166,MATH 18,B03,083750,Ma; Zilu,0,0,36,36
1656057166166,MATH 18,B04,083751,Ma; Zilu,0,0,36,36
1656057166166,MATH 18,B05,093473,Staff,0,0,36,36
1656057166166,MATH 18,B06,093474,Staff,3,0,36,33
1656057172191,MATH 20A,A01,083754,Zheng; Zequn,11,0,40,29
1656057178232,MATH 20B,A01,083756,Briones; Jor-el Thomas Caparas,0,0,36,36
1656057178232,MATH 20B,A02,083757,Briones; Jor-el Thomas Caparas,0,0,36,36
1656057178232,MATH 20B,A03,093475,Staff,0,0,36,36
1656057184264,MATH 20C,A01,083760,Briones; Jor-el Thomas Caparas,0,2,35,35
1656057184264,MATH 20C,A02,083761,Briones; Jor-el Thomas Caparas,6,1,35,29
1656057184264,MATH 20C,A03,093476,Staff,0,1,35,35
1656057184264,MATH 20C,B01,083762,Bach; Quang Tran,3,0,30,27
1656057190292,MATH 20D,A01,083765,Tran; Brian Kha,3,0,30,27
1656057190292,MATH 20D,A02,083766,Tran; Brian Kha,0,1,30,30
1656057190292,MATH 20D,A03,083767,Tran; Brian Kha,1,0,30,29
1656057196316,MATH 20E,A01,083771,Ganguly; Soumya,1,1,32,31
1656057196316,MATH 20E,A02,083772,Ganguly; Soumya,1,1,32,31
1656057196316,MATH 20E,B01,083773,Ciotti; Benjamin,14,0,35,21
1656057196316,MATH 20E,B02,083774,Ciotti; Benjamin,13,0,35,22
1656057202344,MATH 103A,A01,083777,Greenfeld; Be'Eri,2,1,36,34
1656057202344,MATH 103A,A02,083778,Greenfeld; Be'Eri,1,0,36,35
1656057202344,MATH 103A,A03,093561,Staff,0,1,36,36
1656057202344,MATH 103A,B01,083779,Greenfeld; Be'Eri,8,1,36,28
1656057202344,MATH 103A,B02,083780,Greenfeld; Be'Eri,0,0,36,36
1656057202344,MATH 103A,B03,093562,Staff,0,0,36,36
1656057208368,MATH 105,A01,085443,Carter; Anne Toulson,4,1,35,31
1656057208368,MATH 105,A02,093477,Staff,9,0,35,26
1656057214393,MATH 109,A01,083213,Ganzberger; Geoffrey Michael,1,1,34,33
1656057214393,MATH 109,A02,083214,Ganzberger; Geoffrey Michael,0,0,34,34
1656057214393,MATH 109,A03,093478,Staff,1,0,34,33
1656057214393,MATH 109,B01,083215,Ganzberger; Geoffrey Michael,2,0,32,30
1656057214393,MATH 109,B02,083216,Ganzberger; Geoffrey Michael,0,0,32,32
1656057214393,MATH 109,B03,093479,Staff,3,0,32,29
1656057220417,MATH 142A,A01,083219,Chow; Bennett,1,0,32,31
1656057220417,MATH 142A,A02,083220,Chow; Bennett,7,0,32,25
1656057220417,MATH 142A,A03,093480,Staff,4,0,32,28
1656057220417,MATH 142A,B03,093481,Staff,5,0,32,27
1656057220417,MATH 142A,B04,093558,Staff,6,0,32,26
1656057220417,MATH 142A,B05,093559,Staff,0,0,32,32
1656057226447,MATH 193A,A01,083224,Rotar; Vladimir,1,2,34,33
1656057226447,MATH 193A,A02,083225,Rotar; Vladimir,1,0,34,33
1656057226447,MATH 193A,A03,083781,Rotar; Vladimir,1,0,34,33
1656057226447,MATH 193A,A04,083782,Rotar; Vladimir,3,0,34,31
1656057226447,MATH 193A,A05,093482,Rotar; Vladimir,0,0,34,34
1656057232471,MATH 197,001,091859,McAuley; Julian John,9999,0,9999,0
1656057232471,MATH 197,002,095566,Kedlaya; Kiran S.,9997,0,9999,2
1656057232471,MATH 197,003,095567,Xiao; Ming,9999,0,9999,0
1656057232471,MATH 197,004,095571,Perols; Johan Lars,9998,0,9999,1
1656057239628,COGS 9,A01,083615,Shannon; Kyle Michael,3,1,75,72
1656057245664,COGS 11,A01,083617,Boyle; Mary E. T.,11,2,48,37
1656057251689,COGS 13,A01,083071,Bastos; Amalia Pinkusfeld,4,3,71,67
1656057257714,COGS 14A,A01,092681,Semenuks; Arturs,4,25,100,96
1656057263744,COGS 14B,A01,083073,Cheng; Tzu-Han,7,0,63,56
1656057269772,COGS 17,A01,092677,Semenuks; Arturs,9,7,81,72
1656057275799,COGS 100,A01,083619,Allen; Michael Gordon,3,2,70,67
1656057281829,COGS 101A,A01,083621,Davis; Joshua Daniel,4,3,68,64
1656057287859,COGS 101B,A01,091572,Allen; Michael Gordon,0,0,65,65
1656057293892,COGS 101C,A01,083625,Delgado; Tania,7,0,35,28
1656057299916,COGS 107A,A01,083627,Boyle; Mary E. T.,1,2,60,59
1656057305946,COGS 118A,A01,083075,Gupta; Anjum,21,16,76,55
1656057311994,CSE 3,A50,083646,Miranda; Gregory Joseph,14,0,50,36
1656057318023,CSE 8A,A50,083650,Miranda; Gregory Joseph,4,11,56,52
1656057324048,CSE 11,A01,083080,Cao; Yingjun,0,64,40,40
1656057330074,CSE 12,A01,083652,Krause-Levy; Sophia Louisa,7,8,120,113
1656057336104,CSE 15L,A01,083654,Morris; Justin Loren,3,1,50,47
1656057336104,CSE 15L,A02,083655,Morris; Justin Loren,2,1,50,48
1656057342140,CSE 20,A01,083657,Tran; Khoa Dang,29,0,80,51
1656057348171,CSE 21,A01,095574,Bach; Quang Tran,23,0,48,25
1656057354204,CSE 30,A01,083084,Eldon; John,2,10,80,78
1656057354204,CSE 30,B01,095061,Bhaskar; Nishant,2,5,50,48
1656057360231,CSE 100,A01,083659,Cao; Yingjun,2,25,70,68
1656057366263,CSE 134B,A01,083661,Powell; Thomas Allan,6,6,100,94
1656057372288,CSE 140,A01,083663,Gungor; Onat,6,0,85,79
1656057378318,CSE 140L,A01,083088,Eldon; John,5,0,100,95
1656057384344,CSE 175,A01,083665,Kumar; Rakesh,0,0,25,25
1656057390372,CSE 190,A00,092507,Dubnov; Shlomo,1,0,20,19
1656057396405,ECE 45,A01,083139,Congero; Spencer William,1,2,75,74
1656057402442,ECE 65,A50,083695,Saad; Andrew S,6,0,30,24
1656057402442,ECE 65,A51,095125,Staff,23,0,26,3
1656057408467,ECE 109,A01,091882,Touri; Behrouz,3,5,70,67
1656057414492,ECE 180,A00,083140,Abi Samra; Nicholas Camill,1,0,30,29
1656057414492,ECE 180,B00,083141,Abi Samra; Nicholas Camill,0,8,28,28
1656057420521,MATH 10A,A01,083735,Patchell; Gregory David,0,0,30,30
1656057420521,MATH 10A,A02,083736,Patchell; Gregory David,20,0,30,10
1656057420521,MATH 10A,A03,083737,Patchell; Gregory David,16,0,30,14
1656057426557,MATH 10B,A01,083207,Lim; Seonhee,1,1,34,33
1656057426557,MATH 10B,A02,083208,Lim; Seonhee,1,1,35,34
1656057426557,MATH 10B,A03,093472,Staff,1,1,34,33
1656057426557,MATH 10B,B01,083739,Sinha; Shubham,10,0,30,20
1656057432614,MATH 18,A01,083743,Cinel; Cameron Alexander,5,0,30,25
1656057432614,MATH 18,A02,083744,Cinel; Cameron Alexander,11,0,30,19
1656057432614,MATH 18,A03,083745,Cinel; Cameron Alexander,2,0,30,28
1656057432614,MATH 18,B01,083748,Ma; Zilu,0,0,36,36
1656057432614,MATH 18,B02,083749,Ma; Zilu,0,0,36,36
1656057432614,MATH 18,B03,083750,Ma; Zilu,0,0,36,36
1656057432614,MATH 18,B04,083751,Ma; Zilu,0,0,36,36
1656057432614,MATH 18,B05,093473,Staff,0,0,36,36
1656057432614,MATH 18,B06,093474,Staff,3,0,36,33
1656057438640,MATH 20A,A01,083754,Zheng; Zequn,11,0,40,29
1656057444671,MATH 20B,A01,083756,Briones; Jor-el Thomas Caparas,0,0,36,36
1656057444671,MATH 20B,A02,083757,Briones; Jor-el Thomas Caparas,0,0,36,36
1656057444671,MATH 20B,A03,093475,Staff,0,0,36,36
1656057450697,MATH 20C,A01,083760,Briones; Jor-el Thomas Caparas,0,2,35,35
1656057450697,MATH 20C,A02,083761,Briones; Jor-el Thomas Caparas,6,1,35,29
1656057450697,MATH 20C,A03,093476,Staff,0,1,35,35
1656057450697,MATH 20C,B01,083762,Bach; Quang Tran,3,0,30,27
1656057456732,MATH 20D,A01,083765,Tran; Brian Kha,3,0,30,27
1656057456732,MATH 20D,A02,083766,Tran; Brian Kha,0,1,30,30
1656057456732,MATH 20D,A03,083767,Tran; Brian Kha,1,0,30,29
1656057462766,MATH 20E,A01,083771,Ganguly; Soumya,1,1,32,31
1656057462766,MATH 20E,A02,083772,Ganguly; Soumya,1,1,32,31
1656057462766,MATH 20E,B01,083773,Ciotti; Benjamin,14,0,35,21
1656057462766,MATH 20E,B02,083774,Ciotti; Benjamin,13,0,35,22
1656057468808,MATH 103A,A01,083777,Greenfeld; Be'Eri,2,1,36,34
1656057468808,MATH 103A,A02,083778,Greenfeld; Be'Eri,1,0,36,35
1656057468808,MATH 103A,A03,093561,Staff,0,1,36,36
1656057468808,MATH 103A,B01,083779,Greenfeld; Be'Eri,8,1,36,28
1656057468808,MATH 103A,B02,083780,Greenfeld; Be'Eri,0,0,36,36
1656057468808,MATH 103A,B03,093562,Staff,0,0,36,36
1656057474836,MATH 105,A01,085443,Carter; Anne Toulson,4,1,35,31
1656057474836,MATH 105,A02,093477,Staff,9,0,35,26
1656057480872,MATH 109,A01,083213,Ganzberger; Geoffrey Michael,1,1,34,33
1656057480872,MATH 109,A02,083214,Ganzberger; Geoffrey Michael,0,0,34,34
1656057480872,MATH 109,A03,093478,Staff,1,0,34,33
1656057480872,MATH 109,B01,083215,Ganzberger; Geoffrey Michael,2,0,32,30
1656057480872,MATH 109,B02,083216,Ganzberger; Geoffrey Michael,0,0,32,32
1656057480872,MATH 109,B03,093479,Staff,3,0,32,29
1656057486910,MATH 142A,A01,083219,Chow; Bennett,1,0,32,31
1656057486910,MATH 142A,A02,083220,Chow; Bennett,7,0,32,25
1656057486910,MATH 142A,A03,093480,Staff,4,0,32,28
1656057486910,MATH 142A,B03,093481,Staff,5,0,32,27
1656057486910,MATH 142A,B04,093558,Staff,6,0,32,26
1656057486910,MATH 142A,B05,093559,Staff,0,0,32,32
1656057492944,MATH 193A,A01,083224,Rotar; Vladimir,1,2,34,33
1656057492944,MATH 193A,A02,083225,Rotar; Vladimir,1,0,34,33
1656057492944,MATH 193A,A03,083781,Rotar; Vladimir,1,0,34,33
1656057492944,MATH 193A,A04,083782,Rotar; Vladimir,3,0,34,31
1656057492944,MATH 193A,A05,093482,Rotar; Vladimir,0,0,34,34
1656057498978,MATH 197,001,091859,McAuley; Julian John,9999,0,9999,0
1656057498978,MATH 197,002,095566,Kedlaya; Kiran S.,9997,0,9999,2
1656057498978,MATH 197,003,095567,Xiao; Ming,9999,0,9999,0
1656057498978,MATH 197,004,095571,Perols; Johan Lars,9998,0,9999,1
1656057506051,COGS 9,A01,083615,Shannon; Kyle Michael,3,1,75,72
1656057512084,COGS 11,A01,083617,Boyle; Mary E. T.,11,2,48,37
1656057518123,COGS 13,A01,083071,Bastos; Amalia Pinkusfeld,4,3,71,67
1656057524151,COGS 14A,A01,092681,Semenuks; Arturs,4,25,100,96
1656057530186,COGS 14B,A01,083073,Cheng; Tzu-Han,7,0,63,56
1656057536217,COGS 17,A01,092677,Semenuks; Arturs,9,7,81,72
1656057542244,COGS 100,A01,083619,Allen; Michael Gordon,3,2,70,67
1656057548271,COGS 101A,A01,083621,Davis; Joshua Daniel,4,3,68,64
1656057554302,COGS 101B,A01,091572,Allen; Michael Gordon,0,0,65,65
1656057560335,COGS 101C,A01,083625,Delgado; Tania,7,0,35,28
1656057566360,COGS 107A,A01,083627,Boyle; Mary E. T.,1,2,60,59
1656057572390,COGS 118A,A01,083075,Gupta; Anjum,21,16,76,55
1656057578415,CSE 3,A50,083646,Miranda; Gregory Joseph,14,0,50,36
1656057584440,CSE 8A,A50,083650,Miranda; Gregory Joseph,4,11,56,52
1656057590464,CSE 11,A01,083080,Cao; Yingjun,0,64,40,40
1656057596489,CSE 12,A01,083652,Krause-Levy; Sophia Louisa,7,8,120,113
1656057602518,CSE 15L,A01,083654,Morris; Justin Loren,3,1,50,47
1656057602518,CSE 15L,A02,083655,Morris; Justin Loren,2,1,50,48
1656057608543,CSE 20,A01,083657,Tran; Khoa Dang,29,0,80,51
1656057614577,CSE 21,A01,095574,Bach; Quang Tran,23,0,48,25
1656057620610,CSE 30,A01,083084,Eldon; John,2,10,80,78
1656057620610,CSE 30,B01,095061,Bhaskar; Nishant,2,5,50,48
1656057626635,CSE 100,A01,083659,Cao; Yingjun,2,25,70,68
1656057632660,CSE 134B,A01,083661,Powell; Thomas Allan,6,6,100,94
1656057638687,CSE 140,A01,083663,Gungor; Onat,6,0,85,79
1656057644717,CSE 140L,A01,083088,Eldon; John,5,0,100,95
1656057650740,CSE 175,A01,083665,Kumar; Rakesh,0,0,25,25
1656057656772,CSE 190,A00,092507,Dubnov; Shlomo,1,0,20,19
1656057662832,ECE 45,A01,083139,Congero; Spencer William,1,2,75,74
1656057668864,ECE 65,A50,083695,Saad; Andrew S,6,0,30,24
1656057668864,ECE 65,A51,095125,Staff,23,0,26,3
1656057674894,ECE 109,A01,091882,Touri; Behrouz,3,5,70,67
1656057680920,ECE 180,A00,083140,Abi Samra; Nicholas Camill,1,0,30,29
1656057680920,ECE 180,B00,083141,Abi Samra; Nicholas Camill,0,8,28,28
1656057686964,MATH 10A,A01,083735,Patchell; Gregory David,0,0,30,30
1656057686964,MATH 10A,A02,083736,Patchell; Gregory David,20,0,30,10
1656057686964,MATH 10A,A03,083737,Patchell; Gregory David,16,0,30,14
1656057692999,MATH 10B,A01,083207,Lim; Seonhee,1,1,34,33
1656057692999,MATH 10B,A02,083208,Lim; Seonhee,1,1,35,34
1656057692999,MATH 10B,A03,093472,Staff,1,1,34,33
1656057692999,MATH 10B,B01,083739,Sinha; Shubham,10,0,30,20
1656057699036,MATH 18,A01,083743,Cinel; Cameron Alexander,5,0,30,25
1656057699036,MATH 18,A02,083744,Cinel; Cameron Alexander,11,0,30,19
1656057699036,MATH 18,A03,083745,Cinel; Cameron Alexander,2,0,30,28
1656057699036,MATH 18,B01,083748,Ma; Zilu,0,0,36,36
1656057699036,MATH 18,B02,083749,Ma; Zilu,0,0,36,36
1656057699036,MATH 18,B03,083750,Ma; Zilu,0,0,36,36
1656057699036,MATH 18,B04,083751,Ma; Zilu,0,0,36,36
1656057699036,MATH 18,B05,093473,Staff,0,0,36,36
1656057699036,MATH 18,B06,093474,Staff,3,0,36,33
1656057705060,MATH 20A,A01,083754,Zheng; Zequn,11,0,40,29
1656057711123,MATH 20B,A01,083756,Briones; Jor-el Thomas Caparas,0,0,36,36
1656057711123,MATH 20B,A02,083757,Briones; Jor-el Thomas Caparas,0,0,36,36
1656057711123,MATH 20B,A03,093475,Staff,0,0,36,36
1656057717156,MATH 20C,A01,083760,Briones; Jor-el Thomas Caparas,0,2,35,35
1656057717156,MATH 20C,A02,083761,Briones; Jor-el Thomas Caparas,6,1,35,29
1656057717156,MATH 20C,A03,093476,Staff,0,1,35,35
1656057717156,MATH 20C,B01,083762,Bach; Quang Tran,3,0,30,27
1656057723179,MATH 20D,A01,083765,Tran; Brian Kha,3,0,30,27
1656057723179,MATH 20D,A02,083766,Tran; Brian Kha,0,1,30,30
1656057723179,MATH 20D,A03,083767,Tran; Brian Kha,1,0,30,29
1656057729215,MATH 20E,A01,083771,Ganguly; Soumya,1,1,32,31
1656057729215,MATH 20E,A02,083772,Ganguly; Soumya,1,1,32,31
1656057729215,MATH 20E,B01,083773,Ciotti; Benjamin,14,0,35,21
1656057729215,MATH 20E,B02,083774,Ciotti; Benjamin,13,0,35,22
1656057735250,MATH 103A,A01,083777,Greenfeld; Be'Eri,2,1,36,34
1656057735250,MATH 103A,A02,083778,Greenfeld; Be'Eri,1,0,36,35
1656057735250,MATH 103A,A03,093561,Staff,0,1,36,36
1656057735250,MATH 103A,B01,083779,Greenfeld; Be'Eri,8,1,36,28
1656057735250,MATH 103A,B02,083780,Greenfeld; Be'Eri,0,0,36,36
1656057735250,MATH 103A,B03,093562,Staff,0,0,36,36
1656057741274,MATH 105,A01,085443,Carter; Anne Toulson,4,1,35,31
1656057741274,MATH 105,A02,093477,Staff,9,0,35,26
1656057747300,MATH 109,A01,083213,Ganzberger; Geoffrey Michael,1,1,34,33
1656057747300,MATH 109,A02,083214,Ganzberger; Geoffrey Michael,0,0,34,34
1656057747300,MATH 109,A03,093478,Staff,1,0,34,33
1656057747300,MATH 109,B01,083215,Ganzberger; Geoffrey Michael,2,0,32,30
1656057747300,MATH 109,B02,083216,Ganzberger; Geoffrey Michael,0,0,32,32
1656057747300,MATH 109,B03,093479,Staff,3,0,32,29
1656057753334,MATH 142A,A01,083219,Chow; Bennett,1,0,32,31
1656057753334,MATH 142A,A02,083220,Chow; Bennett,7,0,32,25
1656057753334,MATH 142A,A03,093480,Staff,4,0,32,28
1656057753334,MATH 142A,B03,093481,Staff,5,0,32,27
1656057753334,MATH 142A,B04,093558,Staff,6,0,32,26
1656057753334,MATH 142A,B05,093559,Staff,0,0,32,32
1656057759368,MATH 193A,A01,083224,Rotar; Vladimir,1,2,34,33
1656057759368,MATH 193A,A02,083225,Rotar; Vladimir,1,0,34,33
1656057759368,MATH 193A,A03,083781,Rotar; Vladimir,1,0,34,33
1656057759368,MATH 193A,A04,083782,Rotar; Vladimir,3,0,34,31
1656057759368,MATH 193A,A05,093482,Rotar; Vladimir,0,0,34,34
1656057765394,MATH 197,001,091859,McAuley; Julian John,9999,0,9999,0
1656057765394,MATH 197,002,095566,Kedlaya; Kiran S.,9997,0,9999,2
1656057765394,MATH 197,003,095567,Xiao; Ming,9999,0,9999,0
1656057765394,MATH 197,004,095571,Perols; Johan Lars,9998,0,9999,1
1656057772472,COGS 9,A01,083615,Shannon; Kyle Michael,3,1,75,72
1656057778498,COGS 11,A01,083617,Boyle; Mary E. T.,11,2,48,37
1656057784521,COGS 13,A01,083071,Bastos; Amalia Pinkusfeld,4,3,71,67
1656057790546,COGS 14A,A01,092681,Semenuks; Arturs,4,25,100,96
1656057796571,COGS 14B,A01,083073,Cheng; Tzu-Han,7,0,63,56
1656057802600,COGS 17,A01,092677,Semenuks; Arturs,9,7,81,72
1656057808626,COGS 100,A01,083619,Allen; Michael Gordon,3,2,70,67
1656057814661,COGS 101A,A01,083621,Davis; Joshua Daniel,4,3,68,64
1656057820692,COGS 101B,A01,091572,Allen; Michael Gordon,0,0,65,65
1656057826723,COGS 101C,A01,083625,Delgado; Tania,7,0,35,28
1656057832819,COGS 107A,A01,083627,Boyle; Mary E. T.,1,2,60,59
1656057838855,COGS 118A,A01,083075,Gupta; Anjum,21,16,76,55
1656057844895,CSE 3,A50,083646,Miranda; Gregory Joseph,14,0,50,36
1656057850922,CSE 8A,A50,083650,Miranda; Gregory Joseph,4,11,56,52
1656057856965,CSE 11,A01,083080,Cao; Yingjun,0,64,40,40
1656057862993,CSE 12,A01,083652,Krause-Levy; Sophia Louisa,7,8,120,113
1656057869017,CSE 15L,A01,083654,Morris; Justin Loren,3,1,50,47
1656057869017,CSE 15L,A02,083655,Morris; Justin Loren,2,1,50,48
1656057875046,CSE 20,A01,083657,Tran; Khoa Dang,29,0,80,51
1656057881074,CSE 21,A01,095574,Bach; Quang Tran,23,0,48,25
1656057887107,CSE 30,A01,083084,Eldon; John,2,10,80,78
1656057887107,CSE 30,B01,095061,Bhaskar; Nishant,2,5,50,48
1656057893134,CSE 100,A01,083659,Cao; Yingjun,2,25,70,68
1656057899160,CSE 134B,A01,083661,Powell; Thomas Allan,6,6,100,94
1656057905185,CSE 140,A01,083663,Gungor; Onat,6,0,85,79
1656057911208,CSE 140L,A01,083088,Eldon; John,5,0,100,95
1656057917241,CSE 175,A01,083665,Kumar; Rakesh,0,0,25,25
1656057923268,CSE 190,A00,092507,Dubnov; Shlomo,1,0,20,19
1656057929299,ECE 45,A01,083139,Congero; Spencer William,1,2,75,74
1656057935328,ECE 65,A50,083695,Saad; Andrew S,6,0,30,24
1656057935328,ECE 65,A51,095125,Staff,23,0,26,3
1656057941353,ECE 109,A01,091882,Touri; Behrouz,3,5,70,67
1656057947384,ECE 180,A00,083140,Abi Samra; Nicholas Camill,1,0,30,29
1656057947384,ECE 180,B00,083141,Abi Samra; Nicholas Camill,0,8,28,28
1656057953415,MATH 10A,A01,083735,Patchell; Gregory David,0,0,30,30
1656057953415,MATH 10A,A02,083736,Patchell; Gregory David,20,0,30,10
1656057953415,MATH 10A,A03,083737,Patchell; Gregory David,16,0,30,14
1656057959444,MATH 10B,A01,083207,Lim; Seonhee,1,1,34,33
1656057959444,MATH 10B,A02,083208,Lim; Seonhee,1,1,35,34
1656057959444,MATH 10B,A03,093472,Staff,1,1,34,33
1656057959444,MATH 10B,B01,083739,Sinha; Shubham,10,0,30,20
1656057965473,MATH 18,A01,083743,Cinel; Cameron Alexander,5,0,30,25
1656057965473,MATH 18,A02,083744,Cinel; Cameron Alexander,11,0,30,19
1656057965473,MATH 18,A03,083745,Cinel; Cameron Alexander,2,0,30,28
1656057965473,MATH 18,B01,083748,Ma; Zilu,0,0,36,36
1656057965473,MATH 18,B02,083749,Ma; Zilu,0,0,36,36
1656057965473,MATH 18,B03,083750,Ma; Zilu,0,0,36,36
1656057965473,MATH 18,B04,083751,Ma; Zilu,0,0,36,36
1656057965473,MATH 18,B05,093473,Staff,0,0,36,36
1656057965473,MATH 18,B06,093474,Staff,3,0,36,33
1656057971504,MATH 20A,A01,083754,Zheng; Zequn,11,0,40,29
1656057977533,MATH 20B,A01,083756,Briones; Jor-el Thomas Caparas,0,0,36,36
1656057977533,MATH 20B,A02,083757,Briones; Jor-el Thomas Caparas,0,0,36,36
1656057977533,MATH 20B,A03,093475,Staff,0,0,36,36
1656057983567,MATH 20C,A01,083760,Briones; Jor-el Thomas Caparas,0,2,35,35
1656057983567,MATH 20C,A02,083761,Briones; Jor-el Thomas Caparas,6,1,35,29
1656057983567,MATH 20C,A03,093476,Staff,0,1,35,35
1656057983567,MATH 20C,B01,083762,Bach; Quang Tran,3,0,30,27
1656057989598,MATH 20D,A01,083765,Tran; Brian Kha,3,0,30,27
1656057989598,MATH 20D,A02,083766,Tran; Brian Kha,0,1,30,30
1656057989598,MATH 20D,A03,083767,Tran; Brian Kha,1,0,30,29
1656057995624,MATH 20E,A01,083771,Ganguly; Soumya,1,1,32,31
1656057995624,MATH 20E,A02,083772,Ganguly; Soumya,1,1,32,31
1656057995624,MATH 20E,B01,083773,Ciotti; Benjamin,14,0,35,21
1656057995624,MATH 20E,B02,083774,Ciotti; Benjamin,13,0,35,22
1656058001651,MATH 103A,A01,083777,Greenfeld; Be'Eri,2,1,36,34
1656058001651,MATH 103A,A02,083778,Greenfeld; Be'Eri,1,0,36,35
1656058001651,MATH 103A,A03,093561,Staff,0,1,36,36
1656058001651,MATH 103A,B01,083779,Greenfeld; Be'Eri,8,1,36,28
1656058001651,MATH 103A,B02,083780,Greenfeld; Be'Eri,0,0,36,36
1656058001651,MATH 103A,B03,093562,Staff,0,0,36,36
1656058007682,MATH 105,A01,085443,Carter; Anne Toulson,4,1,35,31
1656058007682,MATH 105,A02,093477,Staff,9,0,35,26
1656058013715,MATH 109,A01,083213,Ganzberger; Geoffrey Michael,1,1,34,33
1656058013715,MATH 109,A02,083214,Ganzberger; Geoffrey Michael,0,0,34,34
1656058013715,MATH 109,A03,093478,Staff,1,0,34,33
1656058013715,MATH 109,B01,083215,Ganzberger; Geoffrey Michael,2,0,32,30
1656058013715,MATH 109,B02,083216,Ganzberger; Geoffrey Michael,0,0,32,32
1656058013715,MATH 109,B03,093479,Staff,3,0,32,29
1656058019756,MATH 142A,A01,083219,Chow; Bennett,1,0,32,31
1656058019756,MATH 142A,A02,083220,Chow; Bennett,7,0,32,25
1656058019756,MATH 142A,A03,093480,Staff,4,0,32,28
1656058019756,MATH 142A,B03,093481,Staff,5,0,32,27
1656058019756,MATH 142A,B04,093558,Staff,6,0,32,26
1656058019756,MATH 142A,B05,093559,Staff,0,0,32,32
1656058025782,MATH 193A,A01,083224,Rotar; Vladimir,1,2,34,33
1656058025782,MATH 193A,A02,083225,Rotar; Vladimir,1,0,34,33
1656058025782,MATH 193A,A03,083781,Rotar; Vladimir,1,0,34,33
1656058025782,MATH 193A,A04,083782,Rotar; Vladimir,3,0,34,31
1656058025782,MATH 193A,A05,093482,Rotar; Vladimir,0,0,34,34
1656058031813,MATH 197,001,091859,McAuley; Julian John,9999,0,9999,0
1656058031813,MATH 197,002,095566,Kedlaya; Kiran S.,9997,0,9999,2
1656058031813,MATH 197,003,095567,Xiao; Ming,9999,0,9999,0
1656058031813,MATH 197,004,095571,Perols; Johan Lars,9998,0,9999,1
1656058038894,COGS 9,A01,083615,Shannon; Kyle Michael,3,1,75,72
1656058044925,COGS 11,A01,083617,Boyle; Mary E. T.,11,2,48,37
1656058050951,COGS 13,A01,083071,Bastos; Amalia Pinkusfeld,4,3,71,67
1656058056977,COGS 14A,A01,092681,Semenuks; Arturs,4,25,100,96
1656058063001,COGS 14B,A01,083073,Cheng; Tzu-Han,7,0,63,56
1656058069025,COGS 17,A01,092677,Semenuks; Arturs,9,7,81,72
1656058075055,COGS 100,A01,083619,Allen; Michael Gordon,3,2,70,67
1656058081080,COGS 101A,A01,083621,Davis; Joshua Daniel,4,3,68,64
1656058087109,COGS 101B,A01,091572,Allen; Michael Gordon,0,0,65,65
1656058093133,COGS 101C,A01,083625,Delgado; Tania,7,0,35,28
1656058099164,COGS 107A,A01,083627,Boyle; Mary E. T.,1,2,60,59
1656058105190,COGS 118A,A01,083075,Gupta; Anjum,21,16,76,55
1656058111214,CSE 3,A50,083646,Miranda; Gregory Joseph,14,0,50,36
1656058117244,CSE 8A,A50,083650,Miranda; Gregory Joseph,4,11,56,52
1656058123271,CSE 11,A01,083080,Cao; Yingjun,0,64,40,40
1656058129301,CSE 12,A01,083652,Krause-Levy; Sophia Louisa,7,8,120,113
1656058135325,CSE 15L,A01,083654,Morris; Justin Loren,3,1,50,47
1656058135325,CSE 15L,A02,083655,Morris; Justin Loren,2,1,50,48
1656058141350,CSE 20,A01,083657,Tran; Khoa Dang,29,0,80,51
1656058147385,CSE 21,A01,095574,Bach; Quang Tran,23,0,48,25
1656058153410,CSE 30,A01,083084,Eldon; John,2,10,80,78
1656058153410,CSE 30,B01,095061,Bhaskar; Nishant,2,5,50,48
1656058159443,CSE 100,A01,083659,Cao; Yingjun,2,25,70,68
1656058165465,CSE 134B,A01,083661,Powell; Thomas Allan,6,6,100,94
1656058171492,CSE 140,A01,083663,Gungor; Onat,6,0,85,79
1656058177518,CSE 140L,A01,083088,Eldon; John,5,0,100,95
1656058183542,CSE 175,A01,083665,Kumar; Rakesh,0,0,25,25
1656058189571,CSE 190,A00,092507,Dubnov; Shlomo,1,0,20,19
1656058195602,ECE 45,A01,083139,Congero; Spencer William,1,2,75,74
1656058201633,ECE 65,A50,083695,Saad; Andrew S,6,0,30,24
1656058201633,ECE 65,A51,095125,Staff,23,0,26,3
1656058207658,ECE 109,A01,091882,Touri; Behrouz,3,5,70,67
1656058213688,ECE 180,A00,083140,Abi Samra; Nicholas Camill,1,0,30,29
1656058213688,ECE 180,B00,083141,Abi Samra; Nicholas Camill,0,8,28,28
1656058219715,MATH 10A,A01,083735,Patchell; Gregory David,0,0,30,30
1656058219715,MATH 10A,A02,083736,Patchell; Gregory David,20,0,30,10
1656058219715,MATH 10A,A03,083737,Patchell; Gregory David,16,0,30,14
1656058225746,MATH 10B,A01,083207,Lim; Seonhee,1,1,34,33
1656058225746,MATH 10B,A02,083208,Lim; Seonhee,1,1,35,34
1656058225746,MATH 10B,A03,093472,Staff,1,1,34,33
1656058225746,MATH 10B,B01,083739,Sinha; Shubham,10,0,30,20
1656058231781,MATH 18,A01,083743,Cinel; Cameron Alexander,5,0,30,25
1656058231781,MATH 18,A02,083744,Cinel; Cameron Alexander,11,0,30,19
1656058231781,MATH 18,A03,083745,Cinel; Cameron Alexander,2,0,30,28
1656058231781,MATH 18,B01,083748,Ma; Zilu,0,0,36,36
1656058231781,MATH 18,B02,083749,Ma; Zilu,0,0,36,36
1656058231781,MATH 18,B03,083750,Ma; Zilu,0,0,36,36
1656058231781,MATH 18,B04,083751,Ma; Zilu,0,0,36,36
1656058231781,MATH 18,B05,093473,Staff,0,0,36,36
1656058231781,MATH 18,B06,093474,Staff,3,0,36,33
1656058237819,MATH 20A,A01,083754,Zheng; Zequn,11,0,40,29
1656058243856,MATH 20B,A01,083756,Briones; Jor-el Thomas Caparas,0,0,36,36
1656058243856,MATH 20B,A02,083757,Briones; Jor-el Thomas Caparas,0,0,36,36
1656058243856,MATH 20B,A03,093475,Staff,0,0,36,36
1656058249881,MATH 20C,A01,083760,Briones; Jor-el Thomas Caparas,0,2,35,35
1656058249881,MATH 20C,A02,083761,Briones; Jor-el Thomas Caparas,6,1,35,29
1656058249881,MATH 20C,A03,093476,Staff,0,1,35,35
1656058249881,MATH 20C,B01,083762,Bach; Quang Tran,3,0,30,27
1656058255912,MATH 20D,A01,083765,Tran; Brian Kha,3,0,30,27
1656058255912,MATH 20D,A02,083766,Tran; Brian Kha,0,1,30,30
1656058255912,MATH 20D,A03,083767,Tran; Brian Kha,1,0,30,29
1656058261939,MATH 20E,A01,083771,Ganguly; Soumya,1,1,32,31
1656058261939,MATH 20E,A02,083772,Ganguly; Soumya,1,1,32,31
1656058261939,MATH 20E,B01,083773,Ciotti; Benjamin,14,0,35,21
1656058261939,MATH 20E,B02,083774,Ciotti; Benjamin,13,0,35,22
1656058267963,MATH 103A,A01,083777,Greenfeld; Be'Eri,2,1,36,34
1656058267963,MATH 103A,A02,083778,Greenfeld; Be'Eri,1,0,36,35
1656058267963,MATH 103A,A03,093561,Staff,0,1,36,36
1656058267963,MATH 103A,B01,083779,Greenfeld; Be'Eri,8,1,36,28
1656058267963,MATH 103A,B02,083780,Greenfeld; Be'Eri,0,0,36,36
1656058267963,MATH 103A,B03,093562,Staff,0,0,36,36
1656058273989,MATH 105,A01,085443,Carter; Anne Toulson,4,1,35,31
1656058273989,MATH 105,A02,093477,Staff,9,0,35,26
1656058280022,MATH 109,A01,083213,Ganzberger; Geoffrey Michael,1,1,34,33
1656058280022,MATH 109,A02,083214,Ganzberger; Geoffrey Michael,0,0,34,34
1656058280022,MATH 109,A03,093478,Staff,1,0,34,33
1656058280022,MATH 109,B01,083215,Ganzberger; Geoffrey Michael,2,0,32,30
1656058280022,MATH 109,B02,083216,Ganzberger; Geoffrey Michael,0,0,32,32
1656058280022,MATH 109,B03,093479,Staff,3,0,32,29
1656058286050,MATH 142A,A01,083219,Chow; Bennett,1,0,32,31
1656058286050,MATH 142A,A02,083220,Chow; Bennett,7,0,32,25
1656058286050,MATH 142A,A03,093480,Staff,4,0,32,28
1656058286050,MATH 142A,B03,093481,Staff,5,0,32,27
1656058286050,MATH 142A,B04,093558,Staff,6,0,32,26
1656058286050,MATH 142A,B05,093559,Staff,0,0,32,32
1656058292081,MATH 193A,A01,083224,Rotar; Vladimir,1,2,34,33
1656058292081,MATH 193A,A02,083225,Rotar; Vladimir,1,0,34,33
1656058292081,MATH 193A,A03,083781,Rotar; Vladimir,1,0,34,33
1656058292081,MATH 193A,A04,083782,Rotar; Vladimir,3,0,34,31
1656058292081,MATH 193A,A05,093482,Rotar; Vladimir,0,0,34,34
1656058298121,MATH 197,001,091859,McAuley; Julian John,9999,0,9999,0
1656058298121,MATH 197,002,095566,Kedlaya; Kiran S.,9997,0,9999,2
1656058298121,MATH 197,003,095567,Xiao; Ming,9999,0,9999,0
1656058298121,MATH 197,004,095571,Perols; Johan Lars,9998,0,9999,1
1656058305196,COGS 9,A01,083615,Shannon; Kyle Michael,3,1,75,72
1656058311227,COGS 11,A01,083617,Boyle; Mary E. T.,11,2,48,37
1656058317251,COGS 13,A01,083071,Bastos; Amalia Pinkusfeld,4,3,71,67
1656058323296,COGS 14A,A01,092681,Semenuks; Arturs,4,25,100,96
1656058329324,COGS 14B,A01,083073,Cheng; Tzu-Han,7,0,63,56
1656058335349,COGS 17,A01,092677,Semenuks; Arturs,9,7,81,72
1656058341378,COGS 100,A01,083619,Allen; Michael Gordon,3,2,70,67
1656058347402,COGS 101A,A01,083621,Davis; Joshua Daniel,4,3,68,64
1656058353430,COGS 101B,A01,091572,Allen; Michael Gordon,0,0,65,65
1656058359455,COGS 101C,A01,083625,Delgado; Tania,7,0,35,28
1656058365483,COGS 107A,A01,083627,Boyle; Mary E. T.,1,2,60,59
1656058371509,COGS 118A,A01,083075,Gupta; Anjum,21,16,76,55
1656058377540,CSE 3,A50,083646,Miranda; Gregory Joseph,14,0,50,36
1656058383565,CSE 8A,A50,083650,Miranda; Gregory Joseph,4,11,56,52
1656058389594,CSE 11,A01,083080,Cao; Yingjun,0,64,40,40
1656058395619,CSE 12,A01,083652,Krause-Levy; Sophia Louisa,7,8,120,113
1656058401644,CSE 15L,A01,083654,Morris; Justin Loren,3,1,50,47
1656058401644,CSE 15L,A02,083655,Morris; Justin Loren,2,1,50,48
1656058407667,CSE 20,A01,083657,Tran; Khoa Dang,29,0,80,51
1656058413722,CSE 21,A01,095574,Bach; Quang Tran,23,0,48,25
1656058419755,CSE 30,A01,083084,Eldon; John,2,10,80,78
1656058419755,CSE 30,B01,095061,Bhaskar; Nishant,2,5,50,48
1656058425782,CSE 100,A01,083659,Cao; Yingjun,2,25,70,68
1656058431880,CSE 134B,A01,083661,Powell; Thomas Allan,6,6,100,94
1656058437911,CSE 140,A01,083663,Gungor; Onat,6,0,85,79
1656058443935,CSE 140L,A01,083088,Eldon; John,5,0,100,95
1656058449967,CSE 175,A01,083665,Kumar; Rakesh,0,0,25,25
1656058455998,CSE 190,A00,092507,Dubnov; Shlomo,1,0,20,19
1656058462025,ECE 45,A01,083139,Congero; Spencer William,1,2,75,74
1656058468051,ECE 65,A50,083695,Saad; Andrew S,6,0,30,24
1656058468051,ECE 65,A51,095125,Staff,23,0,26,3
1656058474078,ECE 109,A01,091882,Touri; Behrouz,3,5,70,67
1656058480104,ECE 180,A00,083140,Abi Samra; Nicholas Camill,1,0,30,29
1656058480104,ECE 180,B00,083141,Abi Samra; Nicholas Camill,0,8,28,28
1656058486139,MATH 10A,A01,083735,Patchell; Gregory David,0,0,30,30
1656058486139,MATH 10A,A02,083736,Patchell; Gregory David,20,0,30,10
1656058486139,MATH 10A,A03,083737,Patchell; Gregory David,16,0,30,14
1656058492175,MATH 10B,A01,083207,Lim; Seonhee,1,1,34,33
1656058492175,MATH 10B,A02,083208,Lim; Seonhee,1,1,35,34
1656058492175,MATH 10B,A03,093472,Staff,1,1,34,33
1656058492175,MATH 10B,B01,083739,Sinha; Shubham,10,0,30,20
1656058498212,MATH 18,A01,083743,Cinel; Cameron Alexander,5,0,30,25
1656058498212,MATH 18,A02,083744,Cinel; Cameron Alexander,11,0,30,19
1656058498212,MATH 18,A03,083745,Cinel; Cameron Alexander,2,0,30,28
1656058498212,MATH 18,B01,083748,Ma; Zilu,0,0,36,36
1656058498212,MATH 18,B02,083749,Ma; Zilu,0,0,36,36
1656058498212,MATH 18,B03,083750,Ma; Zilu,0,0,36,36
1656058498212,MATH 18,B04,083751,Ma; Zilu,0,0,36,36
1656058498212,MATH 18,B05,093473,Staff,0,0,36,36
1656058498212,MATH 18,B06,093474,Staff,3,0,36,33
1656058504245,MATH 20A,A01,083754,Zheng; Zequn,11,0,40,29
1656058510270,MATH 20B,A01,083756,Briones; Jor-el Thomas Caparas,0,0,36,36
1656058510270,MATH 20B,A02,083757,Briones; Jor-el Thomas Caparas,0,0,36,36
1656058510270,MATH 20B,A03,093475,Staff,0,0,36,36
1656058516296,MATH 20C,A01,083760,Briones; Jor-el Thomas Caparas,0,2,35,35
1656058516296,MATH 20C,A02,083761,Briones; Jor-el Thomas Caparas,6,1,35,29
1656058516296,MATH 20C,A03,093476,Staff,0,1,35,35
1656058516296,MATH 20C,B01,083762,Bach; Quang Tran,3,0,30,27
1656058522323,MATH 20D,A01,083765,Tran; Brian Kha,3,0,30,27
1656058522323,MATH 20D,A02,083766,Tran; Brian Kha,0,1,30,30
1656058522323,MATH 20D,A03,083767,Tran; Brian Kha,1,0,30,29
1656058528357,MATH 20E,A01,083771,Ganguly; Soumya,1,1,32,31
1656058528357,MATH 20E,A02,083772,Ganguly; Soumya,1,1,32,31
1656058528357,MATH 20E,B01,083773,Ciotti; Benjamin,14,0,35,21
1656058528357,MATH 20E,B02,083774,Ciotti; Benjamin,13,0,35,22
1656058534412,MATH 103A,A01,083777,Greenfeld; Be'Eri,2,1,36,34
1656058534412,MATH 103A,A02,083778,Greenfeld; Be'Eri,1,0,36,35
1656058534412,MATH 103A,A03,093561,Staff,0,1,36,36
1656058534412,MATH 103A,B01,083779,Greenfeld; Be'Eri,8,1,36,28
1656058534412,MATH 103A,B02,083780,Greenfeld; Be'Eri,0,0,36,36
1656058534412,MATH 103A,B03,093562,Staff,0,0,36,36
1656058540437,MATH 105,A01,085443,Carter; Anne Toulson,4,1,35,31
1656058540437,MATH 105,A02,093477,Staff,9,0,35,26
1656058546468,MATH 109,A01,083213,Ganzberger; Geoffrey Michael,1,1,34,33
1656058546468,MATH 109,A02,083214,Ganzberger; Geoffrey Michael,0,0,34,34
1656058546468,MATH 109,A03,093478,Staff,1,0,34,33
1656058546468,MATH 109,B01,083215,Ganzberger; Geoffrey Michael,2,0,32,30
1656058546468,MATH 109,B02,083216,Ganzberger; Geoffrey Michael,0,0,32,32
1656058546468,MATH 109,B03,093479,Staff,3,0,32,29
1656058552492,MATH 142A,A01,083219,Chow; Bennett,1,0,32,31
1656058552492,MATH 142A,A02,083220,Chow; Bennett,7,0,32,25
1656058552492,MATH 142A,A03,093480,Staff,4,0,32,28
1656058552492,MATH 142A,B03,093481,Staff,5,0,32,27
1656058552492,MATH 142A,B04,093558,Staff,6,0,32,26
1656058552492,MATH 142A,B05,093559,Staff,0,0,32,32
1656058558518,MATH 193A,A01,083224,Rotar; Vladimir,1,2,34,33
1656058558518,MATH 193A,A02,083225,Rotar; Vladimir,1,0,34,33
1656058558518,MATH 193A,A03,083781,Rotar; Vladimir,1,0,34,33
1656058558518,MATH 193A,A04,083782,Rotar; Vladimir,3,0,34,31
1656058558518,MATH 193A,A05,093482,Rotar; Vladimir,0,0,34,34
1656058564544,MATH 197,001,091859,McAuley; Julian John,9999,0,9999,0
1656058564544,MATH 197,002,095566,Kedlaya; Kiran S.,9997,0,9999,2
1656058564544,MATH 197,003,095567,Xiao; Ming,9999,0,9999,0
1656058564544,MATH 197,004,095571,Perols; Johan Lars,9998,0,9999,1
1656058571604,COGS 9,A01,083615,Shannon; Kyle Michael,3,1,75,72
1656058577631,COGS 11,A01,083617,Boyle; Mary E. T.,11,2,48,37
1656058583660,COGS 13,A01,083071,Bastos; Amalia Pinkusfeld,4,3,71,67
1656058589685,COGS 14A,A01,092681,Semenuks; Arturs,4,25,100,96
1656058595711,COGS 14B,A01,083073,Cheng; Tzu-Han,7,0,63,56
1656058601735,COGS 17,A01,092677,Semenuks; Arturs,9,7,81,72
1656058607760,COGS 100,A01,083619,Allen; Michael Gordon,3,2,70,67
1656058613785,COGS 101A,A01,083621,Davis; Joshua Daniel,4,3,68,64
1656058619808,COGS 101B,A01,091572,Allen; Michael Gordon,0,0,65,65
1656058625837,COGS 101C,A01,083625,Delgado; Tania,7,0,35,28
1656058631868,COGS 107A,A01,083627,Boyle; Mary E. T.,1,2,60,59
1656058637892,COGS 118A,A01,083075,Gupta; Anjum,21,16,76,55
1656058643917,CSE 3,A50,083646,Miranda; Gregory Joseph,14,0,50,36
1656058649940,CSE 8A,A50,083650,Miranda; Gregory Joseph,4,11,56,52
1656058655965,CSE 11,A01,083080,Cao; Yingjun,0,64,40,40
1656058661995,CSE 12,A01,083652,Krause-Levy; Sophia Louisa,7,8,120,113
1656058668027,CSE 15L,A01,083654,Morris; Justin Loren,3,1,50,47
1656058668027,CSE 15L,A02,083655,Morris; Justin Loren,2,1,50,48
1656058674055,CSE 20,A01,083657,Tran; Khoa Dang,29,0,80,51
1656058680080,CSE 21,A01,095574,Bach; Quang Tran,23,0,48,25
1656058686106,CSE 30,A01,083084,Eldon; John,2,10,80,78
1656058686106,CSE 30,B01,095061,Bhaskar; Nishant,2,5,50,48
1656058692137,CSE 100,A01,083659,Cao; Yingjun,2,25,70,68
1656058698167,CSE 134B,A01,083661,Powell; Thomas Allan,6,6,100,94
1656058704196,CSE 140,A01,083663,Gungor; Onat,6,0,85,79
1656058710222,CSE 140L,A01,083088,Eldon; John,5,0,100,95
1656058716246,CSE 175,A01,083665,Kumar; Rakesh,0,0,25,25
1656058722277,CSE 190,A00,092507,Dubnov; Shlomo,1,0,20,19
1656058728303,ECE 45,A01,083139,Congero; Spencer William,1,2,75,74
1656058734329,ECE 65,A50,083695,Saad; Andrew S,6,0,30,24
1656058734329,ECE 65,A51,095125,Staff,23,0,26,3
1656058740357,ECE 109,A01,091882,Touri; Behrouz,3,5,70,67
1656058746382,ECE 180,A00,083140,Abi Samra; Nicholas Camill,1,0,30,29
1656058746382,ECE 180,B00,083141,Abi Samra; Nicholas Camill,0,8,28,28
1656058752408,MATH 10A,A01,083735,Patchell; Gregory David,0,0,30,30
1656058752408,MATH 10A,A02,083736,Patchell; Gregory David,20,0,30,10
1656058752408,MATH 10A,A03,083737,Patchell; Gregory David,16,0,30,14
1656058758445,MATH 10B,A01,083207,Lim; Seonhee,1,1,34,33
1656058758445,MATH 10B,A02,083208,Lim; Seonhee,1,1,35,34
1656058758445,MATH 10B,A03,093472,Staff,1,1,34,33
1656058758445,MATH 10B,B01,083739,Sinha; Shubham,10,0,30,20
1656058764475,MATH 18,A01,083743,Cinel; Cameron Alexander,5,0,30,25
1656058764475,MATH 18,A02,083744,Cinel; Cameron Alexander,11,0,30,19
1656058764475,MATH 18,A03,083745,Cinel; Cameron Alexander,2,0,30,28
1656058764475,MATH 18,B01,083748,Ma; Zilu,0,0,36,36
1656058764475,MATH 18,B02,083749,Ma; Zilu,0,0,36,36
1656058764475,MATH 18,B03,083750,Ma; Zilu,0,0,36,36
1656058764475,MATH 18,B04,083751,Ma; Zilu,0,0,36,36
1656058764475,MATH 18,B05,093473,Staff,0,0,36,36
1656058764475,MATH 18,B06,093474,Staff,3,0,36,33
1656058770503,MATH 20A,A01,083754,Zheng; Zequn,11,0,40,29
1656058776530,MATH 20B,A01,083756,Briones; Jor-el Thomas Caparas,0,0,36,36
1656058776530,MATH 20B,A02,083757,Briones; Jor-el Thomas Caparas,0,0,36,36
1656058776530,MATH 20B,A03,093475,Staff,0,0,36,36
1656058782554,MATH 20C,A01,083760,Briones; Jor-el Thomas Caparas,0,2,35,35
1656058782554,MATH 20C,A02,083761,Briones; Jor-el Thomas Caparas,6,1,35,29
1656058782554,MATH 20C,A03,093476,Staff,0,1,35,35
1656058782554,MATH 20C,B01,083762,Bach; Quang Tran,3,0,30,27
1656058788586,MATH 20D,A01,083765,Tran; Brian Kha,3,0,30,27
1656058788586,MATH 20D,A02,083766,Tran; Brian Kha,0,1,30,30
1656058788586,MATH 20D,A03,083767,Tran; Brian Kha,1,0,30,29
1656058794613,MATH 20E,A01,083771,Ganguly; Soumya,1,1,32,31
1656058794613,MATH 20E,A02,083772,Ganguly; Soumya,1,1,32,31
1656058794613,MATH 20E,B01,083773,Ciotti; Benjamin,14,0,35,21
1656058794613,MATH 20E,B02,083774,Ciotti; Benjamin,13,0,35,22
1656058800649,MATH 103A,A01,083777,Greenfeld; Be'Eri,2,1,36,34
1656058800649,MATH 103A,A02,083778,Greenfeld; Be'Eri,1,0,36,35
1656058800649,MATH 103A,A03,093561,Staff,0,1,36,36
1656058800649,MATH 103A,B01,083779,Greenfeld; Be'Eri,8,1,36,28
1656058800649,MATH 103A,B02,083780,Greenfeld; Be'Eri,0,0,36,36
1656058800649,MATH 103A,B03,093562,Staff,0,0,36,36
1656058806737,MATH 105,A01,085443,Carter; Anne Toulson,4,1,35,31
1656058806737,MATH 105,A02,093477,Staff,9,0,35,26
1656058812764,MATH 109,A01,083213,Ganzberger; Geoffrey Michael,1,1,34,33
1656058812764,MATH 109,A02,083214,Ganzberger; Geoffrey Michael,0,0,34,34
1656058812764,MATH 109,A03,093478,Staff,1,0,34,33
1656058812764,MATH 109,B01,083215,Ganzberger; Geoffrey Michael,2,0,32,30
1656058812764,MATH 109,B02,083216,Ganzberger; Geoffrey Michael,0,0,32,32
1656058812764,MATH 109,B03,093479,Staff,3,0,32,29
1656058818790,MATH 142A,A01,083219,Chow; Bennett,1,0,32,31
1656058818790,MATH 142A,A02,083220,Chow; Bennett,7,0,32,25
1656058818790,MATH 142A,A03,093480,Staff,4,0,32,28
1656058818790,MATH 142A,B03,093481,Staff,5,0,32,27
1656058818790,MATH 142A,B04,093558,Staff,6,0,32,26
1656058818790,MATH 142A,B05,093559,Staff,0,0,32,32
1656058824814,MATH 193A,A01,083224,Rotar; Vladimir,1,2,34,33
1656058824814,MATH 193A,A02,083225,Rotar; Vladimir,1,0,34,33
1656058824814,MATH 193A,A03,083781,Rotar; Vladimir,1,0,34,33
1656058824814,MATH 193A,A04,083782,Rotar; Vladimir,3,0,34,31
1656058824814,MATH 193A,A05,093482,Rotar; Vladimir,0,0,34,34
1656058830840,MATH 197,001,091859,McAuley; Julian John,9999,0,9999,0
1656058830840,MATH 197,002,095566,Kedlaya; Kiran S.,9997,0,9999,2
1656058830840,MATH 197,003,095567,Xiao; Ming,9999,0,9999,0
1656058830840,MATH 197,004,095571,Perols; Johan Lars,9998,0,9999,1
1656058837911,COGS 9,A01,083615,Shannon; Kyle Michael,3,1,75,72
1656058843952,COGS 11,A01,083617,Boyle; Mary E. T.,11,2,48,37
1656058849980,COGS 13,A01,083071,Bastos; Amalia Pinkusfeld,4,3,71,67
1656058856015,COGS 14A,A01,092681,Semenuks; Arturs,4,25,100,96
1656058862057,COGS 14B,A01,083073,Cheng; Tzu-Han,7,0,63,56
1656058868091,COGS 17,A01,092677,Semenuks; Arturs,9,7,81,72
1656058874129,COGS 100,A01,083619,Allen; Michael Gordon,3,2,70,67
1656058880158,COGS 101A,A01,083621,Davis; Joshua Daniel,4,3,68,64
1656058886187,COGS 101B,A01,091572,Allen; Michael Gordon,0,0,65,65
1656058892213,COGS 101C,A01,083625,Delgado; Tania,7,0,35,28
1656058898245,COGS 107A,A01,083627,Boyle; Mary E. T.,1,2,60,59
1656058904269,COGS 118A,A01,083075,Gupta; Anjum,21,16,76,55
1656058910302,CSE 3,A50,083646,Miranda; Gregory Joseph,14,0,50,36
1656058916333,CSE 8A,A50,083650,Miranda; Gregory Joseph,4,11,56,52
1656058922358,CSE 11,A01,083080,Cao; Yingjun,0,64,40,40
1656058928386,CSE 12,A01,083652,Krause-Levy; Sophia Louisa,7,8,120,113
1656058934412,CSE 15L,A01,083654,Morris; Justin Loren,3,1,50,47
1656058934412,CSE 15L,A02,083655,Morris; Justin Loren,2,1,50,48
1656058940437,CSE 20,A01,083657,Tran; Khoa Dang,29,0,80,51
1656058946473,CSE 21,A01,095574,Bach; Quang Tran,23,0,48,25
1656058952501,CSE 30,A01,083084,Eldon; John,2,10,80,78
1656058952501,CSE 30,B01,095061,Bhaskar; Nishant,2,5,50,48
1656058958527,CSE 100,A01,083659,Cao; Yingjun,2,25,70,68
1656058964556,CSE 134B,A01,083661,Powell; Thomas Allan,6,6,100,94
1656058970580,CSE 140,A01,083663,Gungor; Onat,6,0,85,79
1656058976608,CSE 140L,A01,083088,Eldon; John,5,0,100,95
1656058982635,CSE 175,A01,083665,Kumar; Rakesh,0,0,25,25
1656058988660,CSE 190,A00,092507,Dubnov; Shlomo,1,0,20,19
1656058994694,ECE 45,A01,083139,Congero; Spencer William,1,2,75,74
1656059000721,ECE 65,A50,083695,Saad; Andrew S,6,0,30,24
1656059000721,ECE 65,A51,095125,Staff,23,0,26,3
1656059006747,ECE 109,A01,091882,Touri; Behrouz,3,5,70,67
1656059012773,ECE 180,A00,083140,Abi Samra; Nicholas Camill,1,0,30,29
1656059012773,ECE 180,B00,083141,Abi Samra; Nicholas Camill,0,8,28,28
1656059018805,MATH 10A,A01,083735,Patchell; Gregory David,0,0,30,30
1656059018805,MATH 10A,A02,083736,Patchell; Gregory David,20,0,30,10
1656059018805,MATH 10A,A03,083737,Patchell; Gregory David,16,0,30,14
1656059024836,MATH 10B,A01,083207,Lim; Seonhee,1,1,34,33
1656059024836,MATH 10B,A02,083208,Lim; Seonhee,1,1,35,34
1656059024836,MATH 10B,A03,093472,Staff,1,1,34,33
1656059024836,MATH 10B,B01,083739,Sinha; Shubham,10,0,30,20
1656059030961,MATH 18,A01,083743,Cinel; Cameron Alexander,5,0,30,25
1656059030961,MATH 18,A02,083744,Cinel; Cameron Alexander,11,0,30,19
1656059030961,MATH 18,A03,083745,Cinel; Cameron Alexander,2,0,30,28
1656059030961,MATH 18,B01,083748,Ma; Zilu,0,0,36,36
1656059030961,MATH 18,B02,083749,Ma; Zilu,0,0,36,36
1656059030961,MATH 18,B03,083750,Ma; Zilu,0,0,36,36
1656059030961,MATH 18,B04,083751,Ma; Zilu,0,0,36,36
1656059030961,MATH 18,B05,093473,Staff,0,0,36,36
1656059030961,MATH 18,B06,093474,Staff,3,0,36,33
1656059036987,MATH 20A,A01,083754,Zheng; Zequn,11,0,40,29
1656059043013,MATH 20B,A01,083756,Briones; Jor-el Thomas Caparas,0,0,36,36
1656059043013,MATH 20B,A02,083757,Briones; Jor-el Thomas Caparas,0,0,36,36
1656059043013,MATH 20B,A03,093475,Staff,0,0,36,36
1656059049047,MATH 20C,A01,083760,Briones; Jor-el Thomas Caparas,0,2,35,35
1656059049047,MATH 20C,A02,083761,Briones; Jor-el Thomas Caparas,6,1,35,29
1656059049047,MATH 20C,A03,093476,Staff,0,1,35,35
1656059049047,MATH 20C,B01,083762,Bach; Quang Tran,3,0,30,27
1656059055079,MATH 20D,A01,083765,Tran; Brian Kha,3,0,30,27
1656059055079,MATH 20D,A02,083766,Tran; Brian Kha,0,1,30,30
1656059055079,MATH 20D,A03,083767,Tran; Brian Kha,1,0,30,29
1656059061107,MATH 20E,A01,083771,Ganguly; Soumya,1,1,32,31
1656059061107,MATH 20E,A02,083772,Ganguly; Soumya,1,1,32,31
1656059061107,MATH 20E,B01,083773,Ciotti; Benjamin,14,0,35,21
1656059061107,MATH 20E,B02,083774,Ciotti; Benjamin,13,0,35,22
1656059067146,MATH 103A,A01,083777,Greenfeld; Be'Eri,2,1,36,34
1656059067146,MATH 103A,A02,083778,Greenfeld; Be'Eri,1,0,36,35
1656059067146,MATH 103A,A03,093561,Staff,0,1,36,36
1656059067146,MATH 103A,B01,083779,Greenfeld; Be'Eri,8,1,36,28
1656059067146,MATH 103A,B02,083780,Greenfeld; Be'Eri,0,0,36,36
1656059067146,MATH 103A,B03,093562,Staff,0,0,36,36
1656059073172,MATH 105,A01,085443,Carter; Anne Toulson,4,1,35,31
1656059073172,MATH 105,A02,093477,Staff,9,0,35,26
1656059079207,MATH 109,A01,083213,Ganzberger; Geoffrey Michael,1,1,34,33
1656059079207,MATH 109,A02,083214,Ganzberger; Geoffrey Michael,0,0,34,34
1656059079207,MATH 109,A03,093478,Staff,1,0,34,33
1656059079207,MATH 109,B01,083215,Ganzberger; Geoffrey Michael,2,0,32,30
1656059079207,MATH 109,B02,083216,Ganzberger; Geoffrey Michael,0,0,32,32
1656059079207,MATH 109,B03,093479,Staff,3,0,32,29
1656059085234,MATH 142A,A01,083219,Chow; Bennett,1,0,32,31
1656059085234,MATH 142A,A02,083220,Chow; Bennett,7,0,32,25
1656059085234,MATH 142A,A03,093480,Staff,4,0,32,28
1656059085234,MATH 142A,B03,093481,Staff,5,0,32,27
1656059085234,MATH 142A,B04,093558,Staff,6,0,32,26
1656059085234,MATH 142A,B05,093559,Staff,0,0,32,32
1656059091261,MATH 193A,A01,083224,Rotar; Vladimir,1,2,34,33
1656059091261,MATH 193A,A02,083225,Rotar; Vladimir,1,0,34,33
1656059091261,MATH 193A,A03,083781,Rotar; Vladimir,1,0,34,33
1656059091261,MATH 193A,A04,083782,Rotar; Vladimir,3,0,34,31
1656059091261,MATH 193A,A05,093482,Rotar; Vladimir,0,0,34,34
1656059097286,MATH 197,001,091859,McAuley; Julian John,9999,0,9999,0
1656059097286,MATH 197,002,095566,Kedlaya; Kiran S.,9997,0,9999,2
1656059097286,MATH 197,003,095567,Xiao; Ming,9999,0,9999,0
1656059097286,MATH 197,004,095571,Perols; Johan Lars,9998,0,9999,1
1656059104352,COGS 9,A01,083615,Shannon; Kyle Michael,3,1,75,72
1656059110374,COGS 11,A01,083617,Boyle; Mary E. T.,11,2,48,37
1656059116404,COGS 13,A01,083071,Bastos; Amalia Pinkusfeld,4,3,71,67
1656059122438,COGS 14A,A01,092681,Semenuks; Arturs,4,25,100,96
1656059128465,COGS 14B,A01,083073,Cheng; Tzu-Han,7,0,63,56
1656059134489,COGS 17,A01,092677,Semenuks; Arturs,9,7,81,72
1656059140515,COGS 100,A01,083619,Allen; Michael Gordon,3,2,70,67
1656059146540,COGS 101A,A01,083621,Davis; Joshua Daniel,4,3,68,64
1656059152573,COGS 101B,A01,091572,Allen; Michael Gordon,0,0,65,65
1656059158605,COGS 101C,A01,083625,Delgado; Tania,7,0,35,28
1656059164634,COGS 107A,A01,083627,Boyle; Mary E. T.,1,2,60,59
1656059170663,COGS 118A,A01,083075,Gupta; Anjum,21,16,76,55
1656059176692,CSE 3,A50,083646,Miranda; Gregory Joseph,14,0,50,36
1656059182717,CSE 8A,A50,083650,Miranda; Gregory Joseph,4,11,56,52
1656059188745,CSE 11,A01,083080,Cao; Yingjun,0,64,40,40
1656059194772,CSE 12,A01,083652,Krause-Levy; Sophia Louisa,7,8,120,113
1656059200798,CSE 15L,A01,083654,Morris; Justin Loren,3,1,50,47
1656059200798,CSE 15L,A02,083655,Morris; Justin Loren,2,1,50,48
1656059206823,CSE 20,A01,083657,Tran; Khoa Dang,29,0,80,51
1656059212848,CSE 21,A01,095574,Bach; Quang Tran,23,0,48,25
1656059218876,CSE 30,A01,083084,Eldon; John,2,10,80,78
1656059218876,CSE 30,B01,095061,Bhaskar; Nishant,2,5,50,48
1656059224908,CSE 100,A01,083659,Cao; Yingjun,2,25,70,68
1656059230937,CSE 134B,A01,083661,Powell; Thomas Allan,6,6,100,94
1656059236962,CSE 140,A01,083663,Gungor; Onat,6,0,85,79
1656059242995,CSE 140L,A01,083088,Eldon; John,5,0,100,95
1656059249022,CSE 175,A01,083665,Kumar; Rakesh,0,0,25,25
1656059255049,CSE 190,A00,092507,Dubnov; Shlomo,1,0,20,19
1656059261088,ECE 45,A01,083139,Congero; Spencer William,1,2,75,74
1656059267115,ECE 65,A50,083695,Saad; Andrew S,6,0,30,24
1656059267115,ECE 65,A51,095125,Staff,23,0,26,3
1656059273138,ECE 109,A01,091882,Touri; Behrouz,3,5,70,67
1656059279163,ECE 180,A00,083140,Abi Samra; Nicholas Camill,1,0,30,29
1656059279163,ECE 180,B00,083141,Abi Samra; Nicholas Camill,0,8,28,28
1656059285197,MATH 10A,A01,083735,Patchell; Gregory David,0,0,30,30
1656059285197,MATH 10A,A02,083736,Patchell; Gregory David,20,0,30,10
1656059285197,MATH 10A,A03,083737,Patchell; Gregory David,16,0,30,14
1656059291226,MATH 10B,A01,083207,Lim; Seonhee,1,1,34,33
1656059291226,MATH 10B,A02,083208,Lim; Seonhee,1,1,35,34
1656059291226,MATH 10B,A03,093472,Staff,1,1,34,33
1656059291226,MATH 10B,B01,083739,Sinha; Shubham,10,0,30,20
1656059297256,MATH 18,A01,083743,Cinel; Cameron Alexander,5,0,30,25
1656059297256,MATH 18,A02,083744,Cinel; Cameron Alexander,11,0,30,19
1656059297256,MATH 18,A03,083745,Cinel; Cameron Alexander,2,0,30,28
1656059297256,MATH 18,B01,083748,Ma; Zilu,0,0,36,36
1656059297256,MATH 18,B02,083749,Ma; Zilu,0,0,36,36
1656059297256,MATH 18,B03,083750,Ma; Zilu,0,0,36,36
1656059297256,MATH 18,B04,083751,Ma; Zilu,0,0,36,36
1656059297256,MATH 18,B05,093473,Staff,0,0,36,36
1656059297256,MATH 18,B06,093474,Staff,3,0,36,33
1656059303281,MATH 20A,A01,083754,Zheng; Zequn,11,0,40,29
1656059309321,MATH 20B,A01,083756,Briones; Jor-el Thomas Caparas,0,0,36,36
1656059309321,MATH 20B,A02,083757,Briones; Jor-el Thomas Caparas,0,0,36,36
1656059309321,MATH 20B,A03,093475,Staff,0,0,36,36
1656059315358,MATH 20C,A01,083760,Briones; Jor-el Thomas Caparas,0,2,35,35
1656059315358,MATH 20C,A02,083761,Briones; Jor-el Thomas Caparas,6,1,35,29
1656059315358,MATH 20C,A03,093476,Staff,0,1,35,35
1656059315358,MATH 20C,B01,083762,Bach; Quang Tran,3,0,30,27
1656059321387,MATH 20D,A01,083765,Tran; Brian Kha,3,0,30,27
1656059321387,MATH 20D,A02,083766,Tran; Brian Kha,0,1,30,30
1656059321387,MATH 20D,A03,083767,Tran; Brian Kha,1,0,30,29
1656059327415,MATH 20E,A01,083771,Ganguly; Soumya,1,1,32,31
1656059327415,MATH 20E,A02,083772,Ganguly; Soumya,1,1,32,31
1656059327415,MATH 20E,B01,083773,Ciotti; Benjamin,14,0,35,21
1656059327415,MATH 20E,B02,083774,Ciotti; Benjamin,13,0,35,22
1656059333442,MATH 103A,A01,083777,Greenfeld; Be'Eri,2,1,36,34
1656059333442,MATH 103A,A02,083778,Greenfeld; Be'Eri,1,0,36,35
1656059333442,MATH 103A,A03,093561,Staff,0,1,36,36
1656059333442,MATH 103A,B01,083779,Greenfeld; Be'Eri,8,1,36,28
1656059333442,MATH 103A,B02,083780,Greenfeld; Be'Eri,0,0,36,36
1656059333442,MATH 103A,B03,093562,Staff,0,0,36,36
1656059339467,MATH 105,A01,085443,Carter; Anne Toulson,4,1,35,31
1656059339467,MATH 105,A02,093477,Staff,9,0,35,26
1656059345499,MATH 109,A01,083213,Ganzberger; Geoffrey Michael,1,1,34,33
1656059345499,MATH 109,A02,083214,Ganzberger; Geoffrey Michael,0,0,34,34
1656059345499,MATH 109,A03,093478,Staff,1,0,34,33
1656059345499,MATH 109,B01,083215,Ganzberger; Geoffrey Michael,2,0,32,30
1656059345499,MATH 109,B02,083216,Ganzberger; Geoffrey Michael,0,0,32,32
1656059345499,MATH 109,B03,093479,Staff,3,0,32,29
1656059351535,MATH 142A,A01,083219,Chow; Bennett,1,0,32,31
1656059351535,MATH 142A,A02,083220,Chow; Bennett,7,0,32,25
1656059351535,MATH 142A,A03,093480,Staff,4,0,32,28
1656059351535,MATH 142A,B03,093481,Staff,5,0,32,27
1656059351535,MATH 142A,B04,093558,Staff,6,0,32,26
1656059351535,MATH 142A,B05,093559,Staff,0,0,32,32
1656059357560,MATH 193A,A01,083224,Rotar; Vladimir,1,2,34,33
1656059357560,MATH 193A,A02,083225,Rotar; Vladimir,1,0,34,33
1656059357560,MATH 193A,A03,083781,Rotar; Vladimir,1,0,34,33
1656059357560,MATH 193A,A04,083782,Rotar; Vladimir,3,0,34,31
1656059357560,MATH 193A,A05,093482,Rotar; Vladimir,0,0,34,34
1656059363593,MATH 197,001,091859,McAuley; Julian John,9999,0,9999,0
1656059363593,MATH 197,002,095566,Kedlaya; Kiran S.,9997,0,9999,2
1656059363593,MATH 197,003,095567,Xiao; Ming,9999,0,9999,0
1656059363593,MATH 197,004,095571,Perols; Johan Lars,9998,0,9999,1
1656059370651,COGS 9,A01,083615,Shannon; Kyle Michael,3,1,75,72
1656059376685,COGS 11,A01,083617,Boyle; Mary E. T.,11,2,48,37
1656059382714,COGS 13,A01,083071,Bastos; Amalia Pinkusfeld,4,3,71,67
1656059388740,COGS 14A,A01,092681,Semenuks; Arturs,4,25,100,96
1656059394769,COGS 14B,A01,083073,Cheng; Tzu-Han,7,0,63,56
1656059400792,COGS 17,A01,092677,Semenuks; Arturs,9,7,81,72
1656059406822,COGS 100,A01,083619,Allen; Michael Gordon,3,2,70,67
1656059412851,COGS 101A,A01,083621,Davis; Joshua Daniel,4,3,68,64
1656059418879,COGS 101B,A01,091572,Allen; Michael Gordon,0,0,65,65
1656059424903,COGS 101C,A01,083625,Delgado; Tania,7,0,35,28
1656059430929,COGS 107A,A01,083627,Boyle; Mary E. T.,1,2,60,59
1656059436960,COGS 118A,A01,083075,Gupta; Anjum,21,16,76,55
1656059442985,CSE 3,A50,083646,Miranda; Gregory Joseph,14,0,50,36
1656059449016,CSE 8A,A50,083650,Miranda; Gregory Joseph,4,11,56,52
1656059455040,CSE 11,A01,083080,Cao; Yingjun,0,64,40,40
1656059461065,CSE 12,A01,083652,Krause-Levy; Sophia Louisa,7,8,120,113
1656059467091,CSE 15L,A01,083654,Morris; Justin Loren,3,1,50,47
1656059467091,CSE 15L,A02,083655,Morris; Justin Loren,2,1,50,48
1656059473120,CSE 20,A01,083657,Tran; Khoa Dang,29,0,80,51
1656059479150,CSE 21,A01,095574,Bach; Quang Tran,23,0,48,25
1656059485176,CSE 30,A01,083084,Eldon; John,2,10,80,78
1656059485176,CSE 30,B01,095061,Bhaskar; Nishant,2,5,50,48
1656059491200,CSE 100,A01,083659,Cao; Yingjun,2,25,70,68
1656059497226,CSE 134B,A01,083661,Powell; Thomas Allan,6,6,100,94
1656059503254,CSE 140,A01,083663,Gungor; Onat,6,0,85,79
1656059509279,CSE 140L,A01,083088,Eldon; John,5,0,100,95
1656059515302,CSE 175,A01,083665,Kumar; Rakesh,0,0,25,25
1656059521325,CSE 190,A00,092507,Dubnov; Shlomo,1,0,20,19
1656059527354,ECE 45,A01,083139,Congero; Spencer William,1,2,75,74
1656059533378,ECE 65,A50,083695,Saad; Andrew S,6,0,30,24
1656059533378,ECE 65,A51,095125,Staff,23,0,26,3
1656059539403,ECE 109,A01,091882,Touri; Behrouz,3,5,70,67
1656059545427,ECE 180,A00,083140,Abi Samra; Nicholas Camill,1,0,30,29
1656059545427,ECE 180,B00,083141,Abi Samra; Nicholas Camill,0,8,28,28
1656059551460,MATH 10A,A01,083735,Patchell; Gregory David,0,0,30,30
1656059551460,MATH 10A,A02,083736,Patchell; Gregory David,20,0,30,10
1656059551460,MATH 10A,A03,083737,Patchell; Gregory David,16,0,30,14
1656059557493,MATH 10B,A01,083207,Lim; Seonhee,1,1,34,33
1656059557493,MATH 10B,A02,083208,Lim; Seonhee,1,1,35,34
1656059557493,MATH 10B,A03,093472,Staff,1,1,34,33
1656059557493,MATH 10B,B01,083739,Sinha; Shubham,10,0,30,20
1656059563531,MATH 18,A01,083743,Cinel; Cameron Alexander,5,0,30,25
1656059563531,MATH 18,A02,083744,Cinel; Cameron Alexander,11,0,30,19
1656059563531,MATH 18,A03,083745,Cinel; Cameron Alexander,2,0,30,28
1656059563531,MATH 18,B01,083748,Ma; Zilu,0,0,36,36
1656059563531,MATH 18,B02,083749,Ma; Zilu,0,0,36,36
1656059563531,MATH 18,B03,083750,Ma; Zilu,0,0,36,36
1656059563531,MATH 18,B04,083751,Ma; Zilu,0,0,36,36
1656059563531,MATH 18,B05,093473,Staff,0,0,36,36
1656059563531,MATH 18,B06,093474,Staff,3,0,36,33
1656059569561,MATH 20A,A01,083754,Zheng; Zequn,11,0,40,29
1656059575585,MATH 20B,A01,083756,Briones; Jor-el Thomas Caparas,0,0,36,36
1656059575585,MATH 20B,A02,083757,Briones; Jor-el Thomas Caparas,0,0,36,36
1656059575585,MATH 20B,A03,093475,Staff,0,0,36,36
1656059581619,MATH 20C,A01,083760,Briones; Jor-el Thomas Caparas,0,2,35,35
1656059581619,MATH 20C,A02,083761,Briones; Jor-el Thomas Caparas,6,1,35,29
1656059581619,MATH 20C,A03,093476,Staff,0,1,35,35
1656059581619,MATH 20C,B01,083762,Bach; Quang Tran,3,0,30,27
1656059587649,MATH 20D,A01,083765,Tran; Brian Kha,3,0,30,27
1656059587649,MATH 20D,A02,083766,Tran; Brian Kha,0,1,30,30
1656059587649,MATH 20D,A03,083767,Tran; Brian Kha,1,0,30,29
1656059593680,MATH 20E,A01,083771,Ganguly; Soumya,1,1,32,31
1656059593680,MATH 20E,A02,083772,Ganguly; Soumya,1,1,32,31
1656059593680,MATH 20E,B01,083773,Ciotti; Benjamin,14,0,35,21
1656059593680,MATH 20E,B02,083774,Ciotti; Benjamin,13,0,35,22
1656059599707,MATH 103A,A01,083777,Greenfeld; Be'Eri,2,1,36,34
1656059599707,MATH 103A,A02,083778,Greenfeld; Be'Eri,1,0,36,35
1656059599707,MATH 103A,A03,093561,Staff,0,1,36,36
1656059599707,MATH 103A,B01,083779,Greenfeld; Be'Eri,8,1,36,28
1656059599707,MATH 103A,B02,083780,Greenfeld; Be'Eri,0,0,36,36
1656059599707,MATH 103A,B03,093562,Staff,0,0,36,36
1656059605731,MATH 105,A01,085443,Carter; Anne Toulson,4,1,35,31
1656059605731,MATH 105,A02,093477,Staff,9,0,35,26
1656059611761,MATH 109,A01,083213,Ganzberger; Geoffrey Michael,1,1,34,33
1656059611761,MATH 109,A02,083214,Ganzberger; Geoffrey Michael,0,0,34,34
1656059611761,MATH 109,A03,093478,Staff,1,0,34,33
1656059611761,MATH 109,B01,083215,Ganzberger; Geoffrey Michael,2,0,32,30
1656059611761,MATH 109,B02,083216,Ganzberger; Geoffrey Michael,0,0,32,32
1656059611761,MATH 109,B03,093479,Staff,3,0,32,29
1656059617787,MATH 142A,A01,083219,Chow; Bennett,1,0,32,31
1656059617787,MATH 142A,A02,083220,Chow; Bennett,7,0,32,25
1656059617787,MATH 142A,A03,093480,Staff,4,0,32,28
1656059617787,MATH 142A,B03,093481,Staff,5,0,32,27
1656059617787,MATH 142A,B04,093558,Staff,6,0,32,26
1656059617787,MATH 142A,B05,093559,Staff,0,0,32,32
1656059623812,MATH 193A,A01,083224,Rotar; Vladimir,1,2,34,33
1656059623812,MATH 193A,A02,083225,Rotar; Vladimir,1,0,34,33
1656059623812,MATH 193A,A03,083781,Rotar; Vladimir,1,0,34,33
1656059623812,MATH 193A,A04,083782,Rotar; Vladimir,3,0,34,31
1656059623812,MATH 193A,A05,093482,Rotar; Vladimir,0,0,34,34
1656059629925,MATH 197,001,091859,McAuley; Julian John,9999,0,9999,0
1656059629925,MATH 197,002,095566,Kedlaya; Kiran S.,9997,0,9999,2
1656059629925,MATH 197,003,095567,Xiao; Ming,9999,0,9999,0
1656059629925,MATH 197,004,095571,Perols; Johan Lars,9998,0,9999,1
1656059636987,COGS 9,A01,083615,Shannon; Kyle Michael,3,1,75,72
1656059643016,COGS 11,A01,083617,Boyle; Mary E. T.,11,2,48,37
1656059649042,COGS 13,A01,083071,Bastos; Amalia Pinkusfeld,4,3,71,67
1656059655066,COGS 14A,A01,092681,Semenuks; Arturs,4,25,100,96
1656059661090,COGS 14B,A01,083073,Cheng; Tzu-Han,7,0,63,56
1656059667118,COGS 17,A01,092677,Semenuks; Arturs,9,7,81,72
1656059673143,COGS 100,A01,083619,Allen; Michael Gordon,3,2,70,67
1656059679169,COGS 101A,A01,083621,Davis; Joshua Daniel,4,3,68,64
1656059685193,COGS 101B,A01,091572,Allen; Michael Gordon,0,0,65,65
1656059691217,COGS 101C,A01,083625,Delgado; Tania,7,0,35,28
1656059697253,COGS 107A,A01,083627,Boyle; Mary E. T.,1,2,60,59
1656059703284,COGS 118A,A01,083075,Gupta; Anjum,21,16,76,55
1656059709309,CSE 3,A50,083646,Miranda; Gregory Joseph,14,0,50,36
1656059715333,CSE 8A,A50,083650,Miranda; Gregory Joseph,4,11,56,52
1656059721359,CSE 11,A01,083080,Cao; Yingjun,0,64,40,40
1656059727383,CSE 12,A01,083652,Krause-Levy; Sophia Louisa,7,8,120,113
1656059733408,CSE 15L,A01,083654,Morris; Justin Loren,3,1,50,47
1656059733408,CSE 15L,A02,083655,Morris; Justin Loren,2,1,50,48
1656059739437,CSE 20,A01,083657,Tran; Khoa Dang,29,0,80,51
1656059745461,CSE 21,A01,095574,Bach; Quang Tran,23,0,48,25
1656059751489,CSE 30,A01,083084,Eldon; John,2,10,80,78
1656059751489,CSE 30,B01,095061,Bhaskar; Nishant,2,5,50,48
1656059757512,CSE 100,A01,083659,Cao; Yingjun,2,25,70,68
1656059763536,CSE 134B,A01,083661,Powell; Thomas Allan,6,6,100,94
1656059769560,CSE 140,A01,083663,Gungor; Onat,6,0,85,79
1656059775584,CSE 140L,A01,083088,Eldon; John,5,0,100,95
1656059781606,CSE 175,A01,083665,Kumar; Rakesh,0,0,25,25
1656059787633,CSE 190,A00,092507,Dubnov; Shlomo,1,0,20,19
1656059793658,ECE 45,A01,083139,Congero; Spencer William,1,2,75,74
1656059799683,ECE 65,A50,083695,Saad; Andrew S,6,0,30,24
1656059799683,ECE 65,A51,095125,Staff,23,0,26,3
1656059805709,ECE 109,A01,091882,Touri; Behrouz,3,5,70,67
1656059811738,ECE 180,A00,083140,Abi Samra; Nicholas Camill,1,0,30,29
1656059811738,ECE 180,B00,083141,Abi Samra; Nicholas Camill,0,8,28,28
1656059817762,MATH 10A,A01,083735,Patchell; Gregory David,0,0,30,30
1656059817762,MATH 10A,A02,083736,Patchell; Gregory David,20,0,30,10
1656059817762,MATH 10A,A03,083737,Patchell; Gregory David,16,0,30,14
1656059823787,MATH 10B,A01,083207,Lim; Seonhee,1,1,34,33
1656059823787,MATH 10B,A02,083208,Lim; Seonhee,1,1,35,34
1656059823787,MATH 10B,A03,093472,Staff,1,1,34,33
1656059823787,MATH 10B,B01,083739,Sinha; Shubham,10,0,30,20
1656059829813,MATH 18,A01,083743,Cinel; Cameron Alexander,5,0,30,25
1656059829813,MATH 18,A02,083744,Cinel; Cameron Alexander,11,0,30,19
1656059829813,MATH 18,A03,083745,Cinel; Cameron Alexander,2,0,30,28
1656059829813,MATH 18,B01,083748,Ma; Zilu,0,0,36,36
1656059829813,MATH 18,B02,083749,Ma; Zilu,0,0,36,36
1656059829813,MATH 18,B03,083750,Ma; Zilu,0,0,36,36
1656059829813,MATH 18,B04,083751,Ma; Zilu,0,0,36,36
1656059829813,MATH 18,B05,093473,Staff,0,0,36,36
1656059829813,MATH 18,B06,093474,Staff,3,0,36,33
1656059835835,MATH 20A,A01,083754,Zheng; Zequn,11,0,40,29
1656059841865,MATH 20B,A01,083756,Briones; Jor-el Thomas Caparas,0,0,36,36
1656059841865,MATH 20B,A02,083757,Briones; Jor-el Thomas Caparas,0,0,36,36
1656059841865,MATH 20B,A03,093475,Staff,0,0,36,36
1656059847894,MATH 20C,A01,083760,Briones; Jor-el Thomas Caparas,0,2,35,35
1656059847894,MATH 20C,A02,083761,Briones; Jor-el Thomas Caparas,6,1,35,29
1656059847894,MATH 20C,A03,093476,Staff,0,1,35,35
1656059847894,MATH 20C,B01,083762,Bach; Quang Tran,3,0,30,27
1656059853918,MATH 20D,A01,083765,Tran; Brian Kha,3,0,30,27
1656059853918,MATH 20D,A02,083766,Tran; Brian Kha,0,1,30,30
1656059853918,MATH 20D,A03,083767,Tran; Brian Kha,1,0,30,29
1656059859946,MATH 20E,A01,083771,Ganguly; Soumya,1,1,32,31
1656059859946,MATH 20E,A02,083772,Ganguly; Soumya,1,1,32,31
1656059859946,MATH 20E,B01,083773,Ciotti; Benjamin,14,0,35,21
1656059859946,MATH 20E,B02,083774,Ciotti; Benjamin,13,0,35,22
1656059865976,MATH 103A,A01,083777,Greenfeld; Be'Eri,2,1,36,34
1656059865976,MATH 103A,A02,083778,Greenfeld; Be'Eri,1,0,36,35
1656059865976,MATH 103A,A03,093561,Staff,0,1,36,36
1656059865976,MATH 103A,B01,083779,Greenfeld; Be'Eri,8,1,36,28
1656059865976,MATH 103A,B02,083780,Greenfeld; Be'Eri,0,0,36,36
1656059865976,MATH 103A,B03,093562,Staff,0,0,36,36
1656059872008,MATH 105,A01,085443,Carter; Anne Toulson,4,1,35,31
1656059872008,MATH 105,A02,093477,Staff,9,0,35,26
1656059878033,MATH 109,A01,083213,Ganzberger; Geoffrey Michael,1,1,34,33
1656059878033,MATH 109,A02,083214,Ganzberger; Geoffrey Michael,0,0,34,34
1656059878033,MATH 109,A03,093478,Staff,1,0,34,33
1656059878033,MATH 109,B01,083215,Ganzberger; Geoffrey Michael,2,0,32,30
1656059878033,MATH 109,B02,083216,Ganzberger; Geoffrey Michael,0,0,32,32
1656059878033,MATH 109,B03,093479,Staff,3,0,32,29
1656059884061,MATH 142A,A01,083219,Chow; Bennett,1,0,32,31
1656059884061,MATH 142A,A02,083220,Chow; Bennett,7,0,32,25
1656059884061,MATH 142A,A03,093480,Staff,4,0,32,28
1656059884061,MATH 142A,B03,093481,Staff,5,0,32,27
1656059884061,MATH 142A,B04,093558,Staff,6,0,32,26
1656059884061,MATH 142A,B05,093559,Staff,0,0,32,32
1656059890088,MATH 193A,A01,083224,Rotar; Vladimir,1,2,34,33
1656059890088,MATH 193A,A02,083225,Rotar; Vladimir,1,0,34,33
1656059890088,MATH 193A,A03,083781,Rotar; Vladimir,1,0,34,33
1656059890088,MATH 193A,A04,083782,Rotar; Vladimir,3,0,34,31
1656059890088,MATH 193A,A05,093482,Rotar; Vladimir,0,0,34,34
1656059896112,MATH 197,001,091859,McAuley; Julian John,9999,0,9999,0
1656059896112,MATH 197,002,095566,Kedlaya; Kiran S.,9997,0,9999,2
1656059896112,MATH 197,003,095567,Xiao; Ming,9999,0,9999,0
1656059896112,MATH 197,004,095571,Perols; Johan Lars,9998,0,9999,1
1656059903186,COGS 9,A01,083615,Shannon; Kyle Michael,3,1,75,72
1656059909209,COGS 11,A01,083617,Boyle; Mary E. T.,11,2,48,37
1656059915251,COGS 13,A01,083071,Bastos; Amalia Pinkusfeld,4,3,71,67
1656059921278,COGS 14A,A01,092681,Semenuks; Arturs,4,25,100,96
1656059927303,COGS 14B,A01,083073,Cheng; Tzu-Han,7,0,63,56
1656059933326,COGS 17,A01,092677,Semenuks; Arturs,9,7,81,72
1656059939353,COGS 100,A01,083619,Allen; Michael Gordon,3,2,70,67
1656059945376,COGS 101A,A01,083621,Davis; Joshua Daniel,4,3,68,64
1656059951403,COGS 101B,A01,091572,Allen; Michael Gordon,0,0,65,65
1656059957425,COGS 101C,A01,083625,Delgado; Tania,7,0,35,28
1656059963453,COGS 107A,A01,083627,Boyle; Mary E. T.,1,2,60,59
1656059969477,COGS 118A,A01,083075,Gupta; Anjum,21,16,76,55
1656059975504,CSE 3,A50,083646,Miranda; Gregory Joseph,14,0,50,36
1656059981529,CSE 8A,A50,083650,Miranda; Gregory Joseph,4,11,56,52
1656059987552,CSE 11,A01,083080,Cao; Yingjun,0,64,40,40
1656059993578,CSE 12,A01,083652,Krause-Levy; Sophia Louisa,7,8,120,113
1656059999602,CSE 15L,A01,083654,Morris; Justin Loren,3,1,50,47
1656059999602,CSE 15L,A02,083655,Morris; Justin Loren,2,1,50,48
1656060005629,CSE 20,A01,083657,Tran; Khoa Dang,29,0,80,51
1656060011656,CSE 21,A01,095574,Bach; Quang Tran,23,0,48,25
1656060017679,CSE 30,A01,083084,Eldon; John,2,10,80,78
1656060017679,CSE 30,B01,095061,Bhaskar; Nishant,2,5,50,48
1656060023700,CSE 100,A01,083659,Cao; Yingjun,2,25,70,68
1656060029727,CSE 134B,A01,083661,Powell; Thomas Allan,6,6,100,94
1656060035755,CSE 140,A01,083663,Gungor; Onat,6,0,85,79
1656060041777,CSE 140L,A01,083088,Eldon; John,5,0,100,95
1656060047800,CSE 175,A01,083665,Kumar; Rakesh,0,0,25,25
1656060053823,CSE 190,A00,092507,Dubnov; Shlomo,1,0,20,19
1656060059847,ECE 45,A01,083139,Congero; Spencer William,1,2,75,74
1656060065877,ECE 65,A50,083695,Saad; Andrew S,6,0,30,24
1656060065877,ECE 65,A51,095125,Staff,23,0,26,3
1656060071900,ECE 109,A01,091882,Touri; Behrouz,3,5,70,67
1656060077924,ECE 180,A00,083140,Abi Samra; Nicholas Camill,1,0,30,29
1656060077924,ECE 180,B00,083141,Abi Samra; Nicholas Camill,0,8,28,28
1656060083949,MATH 10A,A01,083735,Patchell; Gregory David,0,0,30,30
1656060083949,MATH 10A,A02,083736,Patchell; Gregory David,20,0,30,10
1656060083949,MATH 10A,A03,083737,Patchell; Gregory David,16,0,30,14
1656060089983,MATH 10B,A01,083207,Lim; Seonhee,1,1,34,33
1656060089983,MATH 10B,A02,083208,Lim; Seonhee,1,1,35,34
1656060089983,MATH 10B,A03,093472,Staff,1,1,34,33
1656060089983,MATH 10B,B01,083739,Sinha; Shubham,10,0,30,20
1656060096017,MATH 18,A01,083743,Cinel; Cameron Alexander,5,0,30,25
1656060096017,MATH 18,A02,083744,Cinel; Cameron Alexander,11,0,30,19
1656060096017,MATH 18,A03,083745,Cinel; Cameron Alexander,2,0,30,28
1656060096017,MATH 18,B01,083748,Ma; Zilu,0,0,36,36
1656060096017,MATH 18,B02,083749,Ma; Zilu,0,0,36,36
1656060096017,MATH 18,B03,083750,Ma; Zilu,0,0,36,36
1656060096017,MATH 18,B04,083751,Ma; Zilu,0,0,36,36
1656060096017,MATH 18,B05,093473,Staff,0,0,36,36
1656060096017,MATH 18,B06,093474,Staff,3,0,36,33
1656060102046,MATH 20A,A01,083754,Zheng; Zequn,11,0,40,29
1656060108079,MATH 20B,A01,083756,Briones; Jor-el Thomas Caparas,0,0,36,36
1656060108079,MATH 20B,A02,083757,Briones; Jor-el Thomas Caparas,0,0,36,36
1656060108079,MATH 20B,A03,093475,Staff,0,0,36,36
1656060114105,MATH 20C,A01,083760,Briones; Jor-el Thomas Caparas,0,2,35,35
1656060114105,MATH 20C,A02,083761,Briones; Jor-el Thomas Caparas,6,1,35,29
1656060114105,MATH 20C,A03,093476,Staff,0,1,35,35
1656060114105,MATH 20C,B01,083762,Bach; Quang Tran,3,0,30,27
1656060120130,MATH 20D,A01,083765,Tran; Brian Kha,3,0,30,27
1656060120130,MATH 20D,A02,083766,Tran; Brian Kha,0,1,30,30
1656060120130,MATH 20D,A03,083767,Tran; Brian Kha,1,0,30,29
1656060126163,MATH 20E,A01,083771,Ganguly; Soumya,1,1,32,31
1656060126163,MATH 20E,A02,083772,Ganguly; Soumya,1,1,32,31
1656060126163,MATH 20E,B01,083773,Ciotti; Benjamin,14,0,35,21
1656060126163,MATH 20E,B02,083774,Ciotti; Benjamin,13,0,35,22
1656060132209,MATH 103A,A01,083777,Greenfeld; Be'Eri,2,1,36,34
1656060132209,MATH 103A,A02,083778,Greenfeld; Be'Eri,1,0,36,35
1656060132209,MATH 103A,A03,093561,Staff,0,1,36,36
1656060132209,MATH 103A,B01,083779,Greenfeld; Be'Eri,8,1,36,28
1656060132209,MATH 103A,B02,083780,Greenfeld; Be'Eri,0,0,36,36
1656060132209,MATH 103A,B03,093562,Staff,0,0,36,36
1656060138241,MATH 105,A01,085443,Carter; Anne Toulson,4,1,35,31
1656060138241,MATH 105,A02,093477,Staff,9,0,35,26
1656060144273,MATH 109,A01,083213,Ganzberger; Geoffrey Michael,1,1,34,33
1656060144273,MATH 109,A02,083214,Ganzberger; Geoffrey Michael,0,0,34,34
1656060144273,MATH 109,A03,093478,Staff,1,0,34,33
1656060144273,MATH 109,B01,083215,Ganzberger; Geoffrey Michael,2,0,32,30
1656060144273,MATH 109,B02,083216,Ganzberger; Geoffrey Michael,0,0,32,32
1656060144273,MATH 109,B03,093479,Staff,3,0,32,29
1656060150300,MATH 142A,A01,083219,Chow; Bennett,1,0,32,31
1656060150300,MATH 142A,A02,083220,Chow; Bennett,7,0,32,25
1656060150300,MATH 142A,A03,093480,Staff,4,0,32,28
1656060150300,MATH 142A,B03,093481,Staff,5,0,32,27
1656060150300,MATH 142A,B04,093558,Staff,6,0,32,26
1656060150300,MATH 142A,B05,093559,Staff,0,0,32,32
1656060156333,MATH 193A,A01,083224,Rotar; Vladimir,1,2,34,33
1656060156333,MATH 193A,A02,083225,Rotar; Vladimir,1,0,34,33
1656060156333,MATH 193A,A03,083781,Rotar; Vladimir,1,0,34,33
1656060156333,MATH 193A,A04,083782,Rotar; Vladimir,3,0,34,31
1656060156333,MATH 193A,A05,093482,Rotar; Vladimir,0,0,34,34
1656060162362,MATH 197,001,091859,McAuley; Julian John,9999,0,9999,0
1656060162362,MATH 197,002,095566,Kedlaya; Kiran S.,9997,0,9999,2
1656060162362,MATH 197,003,095567,Xiao; Ming,9999,0,9999,0
1656060162362,MATH 197,004,095571,Perols; Johan Lars,9998,0,9999,1
1656060169441,COGS 9,A01,083615,Shannon; Kyle Michael,3,1,75,72
1656060175470,COGS 11,A01,083617,Boyle; Mary E. T.,11,2,48,37
1656060181496,COGS 13,A01,083071,Bastos; Amalia Pinkusfeld,4,3,71,67
1656060187521,COGS 14A,A01,092681,Semenuks; Arturs,4,25,100,96
1656060193545,COGS 14B,A01,083073,Cheng; Tzu-Han,7,0,63,56
1656060199571,COGS 17,A01,092677,Semenuks; Arturs,9,7,81,72
1656060205625,COGS 100,A01,083619,Allen; Michael Gordon,3,2,70,67
1656060211654,COGS 101A,A01,083621,Davis; Joshua Daniel,4,3,68,64
1656060217681,COGS 101B,A01,091572,Allen; Michael Gordon,0,0,65,65
1656060223779,COGS 101C,A01,083625,Delgado; Tania,7,0,35,28
1656060229806,COGS 107A,A01,083627,Boyle; Mary E. T.,1,2,60,59
1656060235851,COGS 118A,A01,083075,Gupta; Anjum,21,16,76,55
1656060241882,CSE 3,A50,083646,Miranda; Gregory Joseph,14,0,50,36
1656060247908,CSE 8A,A50,083650,Miranda; Gregory Joseph,4,11,56,52
1656060253931,CSE 11,A01,083080,Cao; Yingjun,0,64,40,40
1656060259976,CSE 12,A01,083652,Krause-Levy; Sophia Louisa,7,8,120,113
1656060266004,CSE 15L,A01,083654,Morris; Justin Loren,3,1,50,47
1656060266004,CSE 15L,A02,083655,Morris; Justin Loren,2,1,50,48
1656060272047,CSE 20,A01,083657,Tran; Khoa Dang,29,0,80,51
1656060278074,CSE 21,A01,095574,Bach; Quang Tran,23,0,48,25
1656060284115,CSE 30,A01,083084,Eldon; John,2,10,80,78
1656060284115,CSE 30,B01,095061,Bhaskar; Nishant,2,5,50,48
1656060290143,CSE 100,A01,083659,Cao; Yingjun,2,25,70,68
1656060296167,CSE 134B,A01,083661,Powell; Thomas Allan,6,6,100,94
1656060302192,CSE 140,A01,083663,Gungor; Onat,6,0,85,79
1656060308216,CSE 140L,A01,083088,Eldon; John,5,0,100,95
1656060314241,CSE 175,A01,083665,Kumar; Rakesh,0,0,25,25
1656060320270,CSE 190,A00,092507,Dubnov; Shlomo,1,0,20,19
1656060326298,ECE 45,A01,083139,Congero; Spencer William,1,2,75,74
1656060332327,ECE 65,A50,083695,Saad; Andrew S,6,0,30,24
1656060332327,ECE 65,A51,095125,Staff,23,0,26,3
1656060338352,ECE 109,A01,091882,Touri; Behrouz,3,5,70,67
1656060344387,ECE 180,A00,083140,Abi Samra; Nicholas Camill,1,0,30,29
1656060344387,ECE 180,B00,083141,Abi Samra; Nicholas Camill,0,8,28,28
1656060350418,MATH 10A,A01,083735,Patchell; Gregory David,0,0,30,30
1656060350418,MATH 10A,A02,083736,Patchell; Gregory David,20,0,30,10
1656060350418,MATH 10A,A03,083737,Patchell; Gregory David,16,0,30,14
1656060356446,MATH 10B,A01,083207,Lim; Seonhee,1,1,34,33
1656060356446,MATH 10B,A02,083208,Lim; Seonhee,1,1,35,34
1656060356446,MATH 10B,A03,093472,Staff,1,1,34,33
1656060356446,MATH 10B,B01,083739,Sinha; Shubham,10,0,30,20
1656060362483,MATH 18,A01,083743,Cinel; Cameron Alexander,5,0,30,25
1656060362483,MATH 18,A02,083744,Cinel; Cameron Alexander,11,0,30,19
1656060362483,MATH 18,A03,083745,Cinel; Cameron Alexander,2,0,30,28
1656060362483,MATH 18,B01,083748,Ma; Zilu,0,0,36,36
1656060362483,MATH 18,B02,083749,Ma; Zilu,0,0,36,36
1656060362483,MATH 18,B03,083750,Ma; Zilu,0,0,36,36
1656060362483,MATH 18,B04,083751,Ma; Zilu,0,0,36,36
1656060362483,MATH 18,B05,093473,Staff,0,0,36,36
1656060362483,MATH 18,B06,093474,Staff,3,0,36,33
1656060368513,MATH 20A,A01,083754,Zheng; Zequn,11,0,40,29
1656060374538,MATH 20B,A01,083756,Briones; Jor-el Thomas Caparas,0,0,36,36
1656060374538,MATH 20B,A02,083757,Briones; Jor-el Thomas Caparas,0,0,36,36
1656060374538,MATH 20B,A03,093475,Staff,0,0,36,36
1656060380564,MATH 20C,A01,083760,Briones; Jor-el Thomas Caparas,0,2,35,35
1656060380564,MATH 20C,A02,083761,Briones; Jor-el Thomas Caparas,6,1,35,29
1656060380564,MATH 20C,A03,093476,Staff,0,1,35,35
1656060380564,MATH 20C,B01,083762,Bach; Quang Tran,3,0,30,27
1656060386587,MATH 20D,A01,083765,Tran; Brian Kha,3,0,30,27
1656060386587,MATH 20D,A02,083766,Tran; Brian Kha,0,1,30,30
1656060386587,MATH 20D,A03,083767,Tran; Brian Kha,1,0,30,29
1656060392614,MATH 20E,A01,083771,Ganguly; Soumya,1,1,32,31
1656060392614,MATH 20E,A02,083772,Ganguly; Soumya,1,1,32,31
1656060392614,MATH 20E,B01,083773,Ciotti; Benjamin,14,0,35,21
1656060392614,MATH 20E,B02,083774,Ciotti; Benjamin,13,0,35,22
1656060398642,MATH 103A,A01,083777,Greenfeld; Be'Eri,2,1,36,34
1656060398642,MATH 103A,A02,083778,Greenfeld; Be'Eri,1,0,36,35
1656060398642,MATH 103A,A03,093561,Staff,0,1,36,36
1656060398642,MATH 103A,B01,083779,Greenfeld; Be'Eri,8,1,36,28
1656060398642,MATH 103A,B02,083780,Greenfeld; Be'Eri,0,0,36,36
1656060398642,MATH 103A,B03,093562,Staff,0,0,36,36
1656060404671,MATH 105,A01,085443,Carter; Anne Toulson,4,1,35,31
1656060404671,MATH 105,A02,093477,Staff,9,0,35,26
1656060410702,MATH 109,A01,083213,Ganzberger; Geoffrey Michael,1,1,34,33
1656060410702,MATH 109,A02,083214,Ganzberger; Geoffrey Michael,0,0,34,34
1656060410702,MATH 109,A03,093478,Staff,1,0,34,33
1656060410702,MATH 109,B01,083215,Ganzberger; Geoffrey Michael,2,0,32,30
1656060410702,MATH 109,B02,083216,Ganzberger; Geoffrey Michael,0,0,32,32
1656060410702,MATH 109,B03,093479,Staff,3,0,32,29
1656060416730,MATH 142A,A01,083219,Chow; Bennett,1,0,32,31
1656060416730,MATH 142A,A02,083220,Chow; Bennett,7,0,32,25
1656060416730,MATH 142A,A03,093480,Staff,4,0,32,28
1656060416730,MATH 142A,B03,093481,Staff,5,0,32,27
1656060416730,MATH 142A,B04,093558,Staff,6,0,32,26
1656060416730,MATH 142A,B05,093559,Staff,0,0,32,32
1656060422764,MATH 193A,A01,083224,Rotar; Vladimir,1,2,34,33
1656060422764,MATH 193A,A02,083225,Rotar; Vladimir,1,0,34,33
1656060422764,MATH 193A,A03,083781,Rotar; Vladimir,1,0,34,33
1656060422764,MATH 193A,A04,083782,Rotar; Vladimir,3,0,34,31
1656060422764,MATH 193A,A05,093482,Rotar; Vladimir,0,0,34,34
1656060428791,MATH 197,001,091859,McAuley; Julian John,9999,0,9999,0
1656060428791,MATH 197,002,095566,Kedlaya; Kiran S.,9997,0,9999,2
1656060428791,MATH 197,003,095567,Xiao; Ming,9999,0,9999,0
1656060428791,MATH 197,004,095571,Perols; Johan Lars,9998,0,9999,1
1656060435874,COGS 9,A01,083615,Shannon; Kyle Michael,3,1,75,72
1656060441903,COGS 11,A01,083617,Boyle; Mary E. T.,11,2,48,37
1656060447928,COGS 13,A01,083071,Bastos; Amalia Pinkusfeld,4,3,71,67
1656060453969,COGS 14A,A01,092681,Semenuks; Arturs,4,25,100,96
1656060459995,COGS 14B,A01,083073,Cheng; Tzu-Han,7,0,63,56
1656060466021,COGS 17,A01,092677,Semenuks; Arturs,9,7,81,72
1656060472047,COGS 100,A01,083619,Allen; Michael Gordon,3,2,70,67
1656060478072,COGS 101A,A01,083621,Davis; Joshua Daniel,4,3,68,64
1656060484104,COGS 101B,A01,091572,Allen; Michael Gordon,0,0,65,65
1656060490144,COGS 101C,A01,083625,Delgado; Tania,7,0,35,28
1656060496172,COGS 107A,A01,083627,Boyle; Mary E. T.,1,2,60,59
1656060502198,COGS 118A,A01,083075,Gupta; Anjum,21,16,76,55
1656060508250,CSE 3,A50,083646,Miranda; Gregory Joseph,14,0,50,36
1656060514276,CSE 8A,A50,083650,Miranda; Gregory Joseph,4,11,56,52
1656060520307,CSE 11,A01,083080,Cao; Yingjun,0,64,40,40
1656060526332,CSE 12,A01,083652,Krause-Levy; Sophia Louisa,7,8,120,113
1656060532356,CSE 15L,A01,083654,Morris; Justin Loren,3,1,50,47
1656060532356,CSE 15L,A02,083655,Morris; Justin Loren,2,1,50,48
1656060538384,CSE 20,A01,083657,Tran; Khoa Dang,29,0,80,51
1656060544422,CSE 21,A01,095574,Bach; Quang Tran,23,0,48,25
1656060550447,CSE 30,A01,083084,Eldon; John,2,10,80,78
1656060550447,CSE 30,B01,095061,Bhaskar; Nishant,2,5,50,48
1656060556473,CSE 100,A01,083659,Cao; Yingjun,2,25,70,68
1656060562536,CSE 134B,A01,083661,Powell; Thomas Allan,6,6,100,94
1656060568564,CSE 140,A01,083663,Gungor; Onat,6,0,85,79
1656060574589,CSE 140L,A01,083088,Eldon; John,5,0,100,95
1656060580623,CSE 175,A01,083665,Kumar; Rakesh,0,0,25,25
1656060586647,CSE 190,A00,092507,Dubnov; Shlomo,1,0,20,19
1656060592671,ECE 45,A01,083139,Congero; Spencer William,1,2,75,74
1656060598697,ECE 65,A50,083695,Saad; Andrew S,6,0,30,24
1656060598697,ECE 65,A51,095125,Staff,23,0,26,3
1656060604730,ECE 109,A01,091882,Touri; Behrouz,3,5,70,67
1656060610760,ECE 180,A00,083140,Abi Samra; Nicholas Camill,1,0,30,29
1656060610760,ECE 180,B00,083141,Abi Samra; Nicholas Camill,0,8,28,28
1656060616787,MATH 10A,A01,083735,Patchell; Gregory David,0,0,30,30
1656060616787,MATH 10A,A02,083736,Patchell; Gregory David,20,0,30,10
1656060616787,MATH 10A,A03,083737,Patchell; Gregory David,16,0,30,14
1656060622823,MATH 10B,A01,083207,Lim; Seonhee,1,1,34,33
1656060622823,MATH 10B,A02,083208,Lim; Seonhee,1,1,35,34
1656060622823,MATH 10B,A03,093472,Staff,1,1,34,33
1656060622823,MATH 10B,B01,083739,Sinha; Shubham,10,0,30,20
1656060628868,MATH 18,A01,083743,Cinel; Cameron Alexander,5,0,30,25
1656060628868,MATH 18,A02,083744,Cinel; Cameron Alexander,11,0,30,19
1656060628868,MATH 18,A03,083745,Cinel; Cameron Alexander,2,0,30,28
1656060628868,MATH 18,B01,083748,Ma; Zilu,0,0,36,36
1656060628868,MATH 18,B02,083749,Ma; Zilu,0,0,36,36
1656060628868,MATH 18,B03,083750,Ma; Zilu,0,0,36,36
1656060628868,MATH 18,B04,083751,Ma; Zilu,0,0,36,36
1656060628868,MATH 18,B05,093473,Staff,0,0,36,36
1656060628868,MATH 18,B06,093474,Staff,3,0,36,33
1656060634905,MATH 20A,A01,083754,Zheng; Zequn,11,0,40,29
1656060640930,MATH 20B,A01,083756,Briones; Jor-el Thomas Caparas,0,0,36,36
1656060640930,MATH 20B,A02,083757,Briones; Jor-el Thomas Caparas,0,0,36,36
1656060640930,MATH 20B,A03,093475,Staff,0,0,36,36
1656060646957,MATH 20C,A01,083760,Briones; Jor-el Thomas Caparas,0,2,35,35
1656060646957,MATH 20C,A02,083761,Briones; Jor-el Thomas Caparas,6,1,35,29
1656060646957,MATH 20C,A03,093476,Staff,0,1,35,35
1656060646957,MATH 20C,B01,083762,Bach; Quang Tran,3,0,30,27
1656060652997,MATH 20D,A01,083765,Tran; Brian Kha,3,0,30,27
1656060652997,MATH 20D,A02,083766,Tran; Brian Kha,0,1,30,30
1656060652997,MATH 20D,A03,083767,Tran; Brian Kha,1,0,30,29
1656060659052,MATH 20E,A01,083771,Ganguly; Soumya,1,1,32,31
1656060659052,MATH 20E,A02,083772,Ganguly; Soumya,1,1,32,31
1656060659052,MATH 20E,B01,083773,Ciotti; Benjamin,14,0,35,21
1656060659052,MATH 20E,B02,083774,Ciotti; Benjamin,13,0,35,22
1656060665089,MATH 103A,A01,083777,Greenfeld; Be'Eri,2,1,36,34
1656060665089,MATH 103A,A02,083778,Greenfeld; Be'Eri,1,0,36,35
1656060665089,MATH 103A,A03,093561,Staff,0,1,36,36
1656060665089,MATH 103A,B01,083779,Greenfeld; Be'Eri,8,1,36,28
1656060665089,MATH 103A,B02,083780,Greenfeld; Be'Eri,0,0,36,36
1656060665089,MATH 103A,B03,093562,Staff,0,0,36,36
1656060671115,MATH 105,A01,085443,Carter; Anne Toulson,4,1,35,31
1656060671115,MATH 105,A02,093477,Staff,9,0,35,26
1656060677149,MATH 109,A01,083213,Ganzberger; Geoffrey Michael,1,1,34,33
1656060677149,MATH 109,A02,083214,Ganzberger; Geoffrey Michael,0,0,34,34
1656060677149,MATH 109,A03,093478,Staff,1,0,34,33
1656060677149,MATH 109,B01,083215,Ganzberger; Geoffrey Michael,2,0,32,30
1656060677149,MATH 109,B02,083216,Ganzberger; Geoffrey Michael,0,0,32,32
1656060677149,MATH 109,B03,093479,Staff,3,0,32,29
1656060683197,MATH 142A,A01,083219,Chow; Bennett,1,0,32,31
1656060683197,MATH 142A,A02,083220,Chow; Bennett,7,0,32,25
1656060683197,MATH 142A,A03,093480,Staff,4,0,32,28
1656060683197,MATH 142A,B03,093481,Staff,5,0,32,27
1656060683197,MATH 142A,B04,093558,Staff,6,0,32,26
1656060683197,MATH 142A,B05,093559,Staff,0,0,32,32
1656060689232,MATH 193A,A01,083224,Rotar; Vladimir,1,2,34,33
1656060689232,MATH 193A,A02,083225,Rotar; Vladimir,1,0,34,33
1656060689232,MATH 193A,A03,083781,Rotar; Vladimir,1,0,34,33
1656060689232,MATH 193A,A04,083782,Rotar; Vladimir,3,0,34,31
1656060689232,MATH 193A,A05,093482,Rotar; Vladimir,0,0,34,34
1656060695276,MATH 197,001,091859,McAuley; Julian John,9999,0,9999,0
1656060695276,MATH 197,002,095566,Kedlaya; Kiran S.,9997,0,9999,2
1656060695276,MATH 197,003,095567,Xiao; Ming,9999,0,9999,0
1656060695276,MATH 197,004,095571,Perols; Johan Lars,9998,0,9999,1
1656060702356,COGS 9,A01,083615,Shannon; Kyle Michael,3,1,75,72
1656060708388,COGS 11,A01,083617,Boyle; Mary E. T.,11,2,48,37
1656060714422,COGS 13,A01,083071,Bastos; Amalia Pinkusfeld,4,3,71,67
1656060720458,COGS 14A,A01,092681,Semenuks; Arturs,4,25,100,96
1656060726487,COGS 14B,A01,083073,Cheng; Tzu-Han,7,0,63,56
1656060732524,COGS 17,A01,092677,Semenuks; Arturs,9,7,81,72
1656060738565,COGS 100,A01,083619,Allen; Michael Gordon,3,2,70,67
1656060744601,COGS 101A,A01,083621,Davis; Joshua Daniel,4,3,68,64
1656060750638,COGS 101B,A01,091572,Allen; Michael Gordon,0,0,65,65
1656060756667,COGS 101C,A01,083625,Delgado; Tania,7,0,35,28
1656060762691,COGS 107A,A01,083627,Boyle; Mary E. T.,1,2,60,59
1656060768715,COGS 118A,A01,083075,Gupta; Anjum,21,16,76,55
1656060774743,CSE 3,A50,083646,Miranda; Gregory Joseph,14,0,50,36
1656060780780,CSE 8A,A50,083650,Miranda; Gregory Joseph,4,11,56,52
1656060786825,CSE 11,A01,083080,Cao; Yingjun,0,64,40,40
1656060792866,CSE 12,A01,083652,Krause-Levy; Sophia Louisa,7,8,120,113
1656060798894,CSE 15L,A01,083654,Morris; Justin Loren,3,1,50,47
1656060798894,CSE 15L,A02,083655,Morris; Justin Loren,2,1,50,48
1656060804922,CSE 20,A01,083657,Tran; Khoa Dang,29,0,80,51
1656060810951,CSE 21,A01,095574,Bach; Quang Tran,23,0,48,25
1656060816985,CSE 30,A01,083084,Eldon; John,2,10,80,78
1656060816985,CSE 30,B01,095061,Bhaskar; Nishant,2,5,50,48
1656060823096,CSE 100,A01,083659,Cao; Yingjun,2,25,70,68
1656060829128,CSE 134B,A01,083661,Powell; Thomas Allan,6,6,100,94
1656060835156,CSE 140,A01,083663,Gungor; Onat,6,0,85,79
1656060841180,CSE 140L,A01,083088,Eldon; John,5,0,100,95
1656060847210,CSE 175,A01,083665,Kumar; Rakesh,0,0,25,25
1656060853237,CSE 190,A00,092507,Dubnov; Shlomo,1,0,20,19
1656060859276,ECE 45,A01,083139,Congero; Spencer William,1,2,75,74
1656060865301,ECE 65,A50,083695,Saad; Andrew S,6,0,30,24
1656060865301,ECE 65,A51,095125,Staff,23,0,26,3
1656060871326,ECE 109,A01,091882,Touri; Behrouz,3,5,70,67
1656060877349,ECE 180,A00,083140,Abi Samra; Nicholas Camill,1,0,30,29
1656060877349,ECE 180,B00,083141,Abi Samra; Nicholas Camill,0,8,28,28
1656060883394,MATH 10A,A01,083735,Patchell; Gregory David,0,0,30,30
1656060883394,MATH 10A,A02,083736,Patchell; Gregory David,20,0,30,10
1656060883394,MATH 10A,A03,083737,Patchell; Gregory David,16,0,30,14
1656060889419,MATH 10B,A01,083207,Lim; Seonhee,1,1,34,33
1656060889419,MATH 10B,A02,083208,Lim; Seonhee,1,1,35,34
1656060889419,MATH 10B,A03,093472,Staff,1,1,34,33
1656060889419,MATH 10B,B01,083739,Sinha; Shubham,10,0,30,20
1656060895443,MATH 18,A01,083743,Cinel; Cameron Alexander,5,0,30,25
1656060895443,MATH 18,A02,083744,Cinel; Cameron Alexander,11,0,30,19
1656060895443,MATH 18,A03,083745,Cinel; Cameron Alexander,2,0,30,28
1656060895443,MATH 18,B01,083748,Ma; Zilu,0,0,36,36
1656060895443,MATH 18,B02,083749,Ma; Zilu,0,0,36,36
1656060895443,MATH 18,B03,083750,Ma; Zilu,0,0,36,36
1656060895443,MATH 18,B04,083751,Ma; Zilu,0,0,36,36
1656060895443,MATH 18,B05,093473,Staff,0,0,36,36
1656060895443,MATH 18,B06,093474,Staff,3,0,36,33
1656060901471,MATH 20A,A01,083754,Zheng; Zequn,11,0,40,29
1656060907494,MATH 20B,A01,083756,Briones; Jor-el Thomas Caparas,0,0,36,36
1656060907494,MATH 20B,A02,083757,Briones; Jor-el Thomas Caparas,0,0,36,36
1656060907494,MATH 20B,A03,093475,Staff,0,0,36,36
1656060913521,MATH 20C,A01,083760,Briones; Jor-el Thomas Caparas,0,2,35,35
1656060913521,MATH 20C,A02,083761,Briones; Jor-el Thomas Caparas,6,1,35,29
1656060913521,MATH 20C,A03,093476,Staff,0,1,35,35
1656060913521,MATH 20C,B01,083762,Bach; Quang Tran,3,0,30,27
1656060919548,MATH 20D,A01,083765,Tran; Brian Kha,3,0,30,27
1656060919548,MATH 20D,A02,083766,Tran; Brian Kha,0,1,30,30
1656060919548,MATH 20D,A03,083767,Tran; Brian Kha,1,0,30,29
1656060925579,MATH 20E,A01,083771,Ganguly; Soumya,1,1,32,31
1656060925579,MATH 20E,A02,083772,Ganguly; Soumya,1,1,32,31
1656060925579,MATH 20E,B01,083773,Ciotti; Benjamin,14,0,35,21
1656060925579,MATH 20E,B02,083774,Ciotti; Benjamin,13,0,35,22
1656060931605,MATH 103A,A01,083777,Greenfeld; Be'Eri,2,1,36,34
1656060931605,MATH 103A,A02,083778,Greenfeld; Be'Eri,1,0,36,35
1656060931605,MATH 103A,A03,093561,Staff,0,1,36,36
1656060931605,MATH 103A,B01,083779,Greenfeld; Be'Eri,8,1,36,28
1656060931605,MATH 103A,B02,083780,Greenfeld; Be'Eri,0,0,36,36
1656060931605,MATH 103A,B03,093562,Staff,0,0,36,36
1656060937633,MATH 105,A01,085443,Carter; Anne Toulson,4,1,35,31
1656060937633,MATH 105,A02,093477,Staff,9,0,35,26
1656060943673,MATH 109,A01,083213,Ganzberger; Geoffrey Michael,1,1,34,33
1656060943673,MATH 109,A02,083214,Ganzberger; Geoffrey Michael,0,0,34,34
1656060943673,MATH 109,A03,093478,Staff,1,0,34,33
1656060943673,MATH 109,B01,083215,Ganzberger; Geoffrey Michael,2,0,32,30
1656060943673,MATH 109,B02,083216,Ganzberger; Geoffrey Michael,0,0,32,32
1656060943673,MATH 109,B03,093479,Staff,3,0,32,29
1656060949703,MATH 142A,A01,083219,Chow; Bennett,1,0,32,31
1656060949703,MATH 142A,A02,083220,Chow; Bennett,7,0,32,25
1656060949703,MATH 142A,A03,093480,Staff,4,0,32,28
1656060949703,MATH 142A,B03,093481,Staff,5,0,32,27
1656060949703,MATH 142A,B04,093558,Staff,6,0,32,26
1656060949703,MATH 142A,B05,093559,Staff,0,0,32,32
1656060955727,MATH 193A,A01,083224,Rotar; Vladimir,1,2,34,33
1656060955727,MATH 193A,A02,083225,Rotar; Vladimir,1,0,34,33
1656060955727,MATH 193A,A03,083781,Rotar; Vladimir,1,0,34,33
1656060955727,MATH 193A,A04,083782,Rotar; Vladimir,3,0,34,31
1656060955727,MATH 193A,A05,093482,Rotar; Vladimir,0,0,34,34
1656060961757,MATH 197,001,091859,McAuley; Julian John,9999,0,9999,0
1656060961757,MATH 197,002,095566,Kedlaya; Kiran S.,9997,0,9999,2
1656060961757,MATH 197,003,095567,Xiao; Ming,9999,0,9999,0
1656060961757,MATH 197,004,095571,Perols; Johan Lars,9998,0,9999,1
1656060968848,COGS 9,A01,083615,Shannon; Kyle Michael,3,1,75,72
1656060974873,COGS 11,A01,083617,Boyle; Mary E. T.,11,2,48,37
1656060980901,COGS 13,A01,083071,Bastos; Amalia Pinkusfeld,4,3,71,67
1656060986927,COGS 14A,A01,092681,Semenuks; Arturs,4,25,100,96
1656060992956,COGS 14B,A01,083073,Cheng; Tzu-Han,7,0,63,56
1656060998980,COGS 17,A01,092677,Semenuks; Arturs,9,7,81,72
1656061005005,COGS 100,A01,083619,Allen; Michael Gordon,3,2,70,67
1656061011030,COGS 101A,A01,083621,Davis; Joshua Daniel,4,3,68,64
1656061017053,COGS 101B,A01,091572,Allen; Michael Gordon,0,0,65,65
1656061023078,COGS 101C,A01,083625,Delgado; Tania,7,0,35,28
1656061029101,COGS 107A,A01,083627,Boyle; Mary E. T.,1,2,60,59
1656061035124,COGS 118A,A01,083075,Gupta; Anjum,21,16,76,55
1656061041153,CSE 3,A50,083646,Miranda; Gregory Joseph,14,0,50,36
1656061047181,CSE 8A,A50,083650,Miranda; Gregory Joseph,4,11,56,52
1656061053207,CSE 11,A01,083080,Cao; Yingjun,0,64,40,40
1656061059267,CSE 12,A01,083652,Krause-Levy; Sophia Louisa,7,8,120,113
1656061065305,CSE 15L,A01,083654,Morris; Justin Loren,3,1,50,47
1656061065305,CSE 15L,A02,083655,Morris; Justin Loren,2,1,50,48
1656061071335,CSE 20,A01,083657,Tran; Khoa Dang,29,0,80,51
1656061077374,CSE 21,A01,095574,Bach; Quang Tran,23,0,48,25
1656061083399,CSE 30,A01,083084,Eldon; John,2,10,80,78
1656061083399,CSE 30,B01,095061,Bhaskar; Nishant,2,5,50,48
1656061089424,CSE 100,A01,083659,Cao; Yingjun,2,25,70,68
1656061095452,CSE 134B,A01,083661,Powell; Thomas Allan,6,6,100,94
1656061101479,CSE 140,A01,083663,Gungor; Onat,6,0,85,79
1656061107502,CSE 140L,A01,083088,Eldon; John,5,0,100,95
1656061113540,CSE 175,A01,083665,Kumar; Rakesh,0,0,25,25
1656061119571,CSE 190,A00,092507,Dubnov; Shlomo,1,0,20,19
1656061125595,ECE 45,A01,083139,Congero; Spencer William,1,2,75,74
1656061131642,ECE 65,A50,083695,Saad; Andrew S,6,0,30,24
1656061131642,ECE 65,A51,095125,Staff,23,0,26,3
1656061137666,ECE 109,A01,091882,Touri; Behrouz,3,5,70,67
1656061143698,ECE 180,A00,083140,Abi Samra; Nicholas Camill,1,0,30,29
1656061143698,ECE 180,B00,083141,Abi Samra; Nicholas Camill,0,8,28,28
1656061149729,MATH 10A,A01,083735,Patchell; Gregory David,0,0,30,30
1656061149729,MATH 10A,A02,083736,Patchell; Gregory David,20,0,30,10
1656061149729,MATH 10A,A03,083737,Patchell; Gregory David,16,0,30,14
1656061155765,MATH 10B,A01,083207,Lim; Seonhee,1,1,34,33
1656061155765,MATH 10B,A02,083208,Lim; Seonhee,1,1,35,34
1656061155765,MATH 10B,A03,093472,Staff,1,1,34,33
1656061155765,MATH 10B,B01,083739,Sinha; Shubham,10,0,30,20
1656061161799,MATH 18,A01,083743,Cinel; Cameron Alexander,5,0,30,25
1656061161799,MATH 18,A02,083744,Cinel; Cameron Alexander,11,0,30,19
1656061161799,MATH 18,A03,083745,Cinel; Cameron Alexander,2,0,30,28
1656061161799,MATH 18,B01,083748,Ma; Zilu,0,0,36,36
1656061161799,MATH 18,B02,083749,Ma; Zilu,0,0,36,36
1656061161799,MATH 18,B03,083750,Ma; Zilu,0,0,36,36
1656061161799,MATH 18,B04,083751,Ma; Zilu,0,0,36,36
1656061161799,MATH 18,B05,093473,Staff,0,0,36,36
1656061161799,MATH 18,B06,093474,Staff,3,0,36,33
1656061167825,MATH 20A,A01,083754,Zheng; Zequn,11,0,40,29
1656061173862,MATH 20B,A01,083756,Briones; Jor-el Thomas Caparas,0,0,36,36
1656061173862,MATH 20B,A02,083757,Briones; Jor-el Thomas Caparas,0,0,36,36
1656061173862,MATH 20B,A03,093475,Staff,0,0,36,36
1656061179887,MATH 20C,A01,083760,Briones; Jor-el Thomas Caparas,0,2,35,35
1656061179887,MATH 20C,A02,083761,Briones; Jor-el Thomas Caparas,6,1,35,29
1656061179887,MATH 20C,A03,093476,Staff,0,1,35,35
1656061179887,MATH 20C,B01,083762,Bach; Quang Tran,3,0,30,27
1656061185911,MATH 20D,A01,083765,Tran; Brian Kha,3,0,30,27
1656061185911,MATH 20D,A02,083766,Tran; Brian Kha,0,1,30,30
1656061185911,MATH 20D,A03,083767,Tran; Brian Kha,1,0,30,29
1656061191952,MATH 20E,A01,083771,Ganguly; Soumya,1,1,32,31
1656061191952,MATH 20E,A02,083772,Ganguly; Soumya,1,1,32,31
1656061191952,MATH 20E,B01,083773,Ciotti; Benjamin,14,0,35,21
1656061191952,MATH 20E,B02,083774,Ciotti; Benjamin,13,0,35,22
1656061197990,MATH 103A,A01,083777,Greenfeld; Be'Eri,2,1,36,34
1656061197990,MATH 103A,A02,083778,Greenfeld; Be'Eri,1,0,36,35
1656061197990,MATH 103A,A03,093561,Staff,0,1,36,36
1656061197990,MATH 103A,B01,083779,Greenfeld; Be'Eri,8,1,36,28
1656061197990,MATH 103A,B02,083780,Greenfeld; Be'Eri,0,0,36,36
1656061197990,MATH 103A,B03,093562,Staff,0,0,36,36
1656061204015,MATH 105,A01,085443,Carter; Anne Toulson,4,1,35,31
1656061204015,MATH 105,A02,093477,Staff,9,0,35,26
1656061210043,MATH 109,A01,083213,Ganzberger; Geoffrey Michael,1,1,34,33
1656061210043,MATH 109,A02,083214,Ganzberger; Geoffrey Michael,0,0,34,34
1656061210043,MATH 109,A03,093478,Staff,1,0,34,33
1656061210043,MATH 109,B01,083215,Ganzberger; Geoffrey Michael,2,0,32,30
1656061210043,MATH 109,B02,083216,Ganzberger; Geoffrey Michael,0,0,32,32
1656061210043,MATH 109,B03,093479,Staff,3,0,32,29
1656061216068,MATH 142A,A01,083219,Chow; Bennett,1,0,32,31
1656061216068,MATH 142A,A02,083220,Chow; Bennett,7,0,32,25
1656061216068,MATH 142A,A03,093480,Staff,4,0,32,28
1656061216068,MATH 142A,B03,093481,Staff,5,0,32,27
1656061216068,MATH 142A,B04,093558,Staff,6,0,32,26
1656061216068,MATH 142A,B05,093559,Staff,0,0,32,32
1656061222099,MATH 193A,A01,083224,Rotar; Vladimir,1,2,34,33
1656061222099,MATH 193A,A02,083225,Rotar; Vladimir,1,0,34,33
1656061222099,MATH 193A,A03,083781,Rotar; Vladimir,1,0,34,33
1656061222099,MATH 193A,A04,083782,Rotar; Vladimir,3,0,34,31
1656061222099,MATH 193A,A05,093482,Rotar; Vladimir,0,0,34,34
1656061228136,MATH 197,001,091859,McAuley; Julian John,9999,0,9999,0
1656061228136,MATH 197,002,095566,Kedlaya; Kiran S.,9997,0,9999,2
1656061228136,MATH 197,003,095567,Xiao; Ming,9999,0,9999,0
1656061228136,MATH 197,004,095571,Perols; Johan Lars,9998,0,9999,1
1656061235188,COGS 9,A01,083615,Shannon; Kyle Michael,3,1,75,72
1656061241224,COGS 11,A01,083617,Boyle; Mary E. T.,11,2,48,37
1656061247249,COGS 13,A01,083071,Bastos; Amalia Pinkusfeld,4,3,71,67
1656061253273,COGS 14A,A01,092681,Semenuks; Arturs,4,25,100,96
1656061259299,COGS 14B,A01,083073,Cheng; Tzu-Han,7,0,63,56
1656061265323,COGS 17,A01,092677,Semenuks; Arturs,9,7,81,72
1656061271353,COGS 100,A01,083619,Allen; Michael Gordon,3,2,70,67
1656061277392,COGS 101A,A01,083621,Davis; Joshua Daniel,4,3,68,64
1656061283429,COGS 101B,A01,091572,Allen; Michael Gordon,0,0,65,65
1656061289458,COGS 101C,A01,083625,Delgado; Tania,7,0,35,28
1656061295481,COGS 107A,A01,083627,Boyle; Mary E. T.,1,2,60,59
1656061301516,COGS 118A,A01,083075,Gupta; Anjum,21,16,76,55
1656061307542,CSE 3,A50,083646,Miranda; Gregory Joseph,14,0,50,36
1656061313583,CSE 8A,A50,083650,Miranda; Gregory Joseph,4,11,56,52
1656061319630,CSE 11,A01,083080,Cao; Yingjun,0,64,40,40
1656061325655,CSE 12,A01,083652,Krause-Levy; Sophia Louisa,7,8,120,113
1656061331680,CSE 15L,A01,083654,Morris; Justin Loren,3,1,50,47
1656061331680,CSE 15L,A02,083655,Morris; Justin Loren,2,1,50,48
1656061337704,CSE 20,A01,083657,Tran; Khoa Dang,29,0,80,51
1656061343738,CSE 21,A01,095574,Bach; Quang Tran,23,0,48,25
1656061349763,CSE 30,A01,083084,Eldon; John,2,10,80,78
1656061349763,CSE 30,B01,095061,Bhaskar; Nishant,2,5,50,48
1656061355790,CSE 100,A01,083659,Cao; Yingjun,2,25,70,68
1656061361813,CSE 134B,A01,083661,Powell; Thomas Allan,6,6,100,94
1656061367837,CSE 140,A01,083663,Gungor; Onat,6,0,85,79
1656061373862,CSE 140L,A01,083088,Eldon; John,5,0,100,95
1656061379905,CSE 175,A01,083665,Kumar; Rakesh,0,0,25,25
1656061385946,CSE 190,A00,092507,Dubnov; Shlomo,1,0,20,19
1656061391977,ECE 45,A01,083139,Congero; Spencer William,1,2,75,74
1656061398013,ECE 65,A50,083695,Saad; Andrew S,6,0,30,24
1656061398013,ECE 65,A51,095125,Staff,23,0,26,3
1656061404040,ECE 109,A01,091882,Touri; Behrouz,3,5,70,67
1656061410067,ECE 180,A00,083140,Abi Samra; Nicholas Camill,1,0,30,29
1656061410067,ECE 180,B00,083141,Abi Samra; Nicholas Camill,0,8,28,28
1656061416093,MATH 10A,A01,083735,Patchell; Gregory David,0,0,30,30
1656061416093,MATH 10A,A02,083736,Patchell; Gregory David,20,0,30,10
1656061416093,MATH 10A,A03,083737,Patchell; Gregory David,16,0,30,14
1656061422212,MATH 10B,A01,083207,Lim; Seonhee,1,1,34,33
1656061422212,MATH 10B,A02,083208,Lim; Seonhee,1,1,35,34
1656061422212,MATH 10B,A03,093472,Staff,1,1,34,33
1656061422212,MATH 10B,B01,083739,Sinha; Shubham,10,0,30,20
1656061428241,MATH 18,A01,083743,Cinel; Cameron Alexander,5,0,30,25
1656061428241,MATH 18,A02,083744,Cinel; Cameron Alexander,11,0,30,19
1656061428241,MATH 18,A03,083745,Cinel; Cameron Alexander,2,0,30,28
1656061428241,MATH 18,B01,083748,Ma; Zilu,0,0,36,36
1656061428241,MATH 18,B02,083749,Ma; Zilu,0,0,36,36
1656061428241,MATH 18,B03,083750,Ma; Zilu,0,0,36,36
1656061428241,MATH 18,B04,083751,Ma; Zilu,0,0,36,36
1656061428241,MATH 18,B05,093473,Staff,0,0,36,36
1656061428241,MATH 18,B06,093474,Staff,3,0,36,33
1656061434272,MATH 20A,A01,083754,Zheng; Zequn,11,0,40,29
1656061440295,MATH 20B,A01,083756,Briones; Jor-el Thomas Caparas,0,0,36,36
1656061440295,MATH 20B,A02,083757,Briones; Jor-el Thomas Caparas,0,0,36,36
1656061440295,MATH 20B,A03,093475,Staff,0,0,36,36
1656061446318,MATH 20C,A01,083760,Briones; Jor-el Thomas Caparas,0,2,35,35
1656061446318,MATH 20C,A02,083761,Briones; Jor-el Thomas Caparas,6,1,35,29
1656061446318,MATH 20C,A03,093476,Staff,0,1,35,35
1656061446318,MATH 20C,B01,083762,Bach; Quang Tran,3,0,30,27
1656061452340,MATH 20D,A01,083765,Tran; Brian Kha,3,0,30,27
1656061452340,MATH 20D,A02,083766,Tran; Brian Kha,0,1,30,30
1656061452340,MATH 20D,A03,083767,Tran; Brian Kha,1,0,30,29
1656061458378,MATH 20E,A01,083771,Ganguly; Soumya,1,1,32,31
1656061458378,MATH 20E,A02,083772,Ganguly; Soumya,1,1,32,31
1656061458378,MATH 20E,B01,083773,Ciotti; Benjamin,14,0,35,21
1656061458378,MATH 20E,B02,083774,Ciotti; Benjamin,13,0,35,22
1656061464403,MATH 103A,A01,083777,Greenfeld; Be'Eri,2,1,36,34
1656061464403,MATH 103A,A02,083778,Greenfeld; Be'Eri,1,0,36,35
1656061464403,MATH 103A,A03,093561,Staff,0,1,36,36
1656061464403,MATH 103A,B01,083779,Greenfeld; Be'Eri,8,1,36,28
1656061464403,MATH 103A,B02,083780,Greenfeld; Be'Eri,0,0,36,36
1656061464403,MATH 103A,B03,093562,Staff,0,0,36,36
1656061470435,MATH 105,A01,085443,Carter; Anne Toulson,4,1,35,31
1656061470435,MATH 105,A02,093477,Staff,9,0,35,26
1656061476462,MATH 109,A01,083213,Ganzberger; Geoffrey Michael,1,1,34,33
1656061476462,MATH 109,A02,083214,Ganzberger; Geoffrey Michael,0,0,34,34
1656061476462,MATH 109,A03,093478,Staff,1,0,34,33
1656061476462,MATH 109,B01,083215,Ganzberger; Geoffrey Michael,2,0,32,30
1656061476462,MATH 109,B02,083216,Ganzberger; Geoffrey Michael,0,0,32,32
1656061476462,MATH 109,B03,093479,Staff,3,0,32,29
1656061482497,MATH 142A,A01,083219,Chow; Bennett,1,0,32,31
1656061482497,MATH 142A,A02,083220,Chow; Bennett,7,0,32,25
1656061482497,MATH 142A,A03,093480,Staff,4,0,32,28
1656061482497,MATH 142A,B03,093481,Staff,5,0,32,27
1656061482497,MATH 142A,B04,093558,Staff,6,0,32,26
1656061482497,MATH 142A,B05,093559,Staff,0,0,32,32
1656061488527,MATH 193A,A01,083224,Rotar; Vladimir,1,2,34,33
1656061488527,MATH 193A,A02,083225,Rotar; Vladimir,1,0,34,33
1656061488527,MATH 193A,A03,083781,Rotar; Vladimir,1,0,34,33
1656061488527,MATH 193A,A04,083782,Rotar; Vladimir,3,0,34,31
1656061488527,MATH 193A,A05,093482,Rotar; Vladimir,0,0,34,34
1656061494556,MATH 197,001,091859,McAuley; Julian John,9999,0,9999,0
1656061494556,MATH 197,002,095566,Kedlaya; Kiran S.,9997,0,9999,2
1656061494556,MATH 197,003,095567,Xiao; Ming,9999,0,9999,0
1656061494556,MATH 197,004,095571,Perols; Johan Lars,9998,0,9999,1
1656061501651,COGS 9,A01,083615,Shannon; Kyle Michael,3,1,75,72
1656061507697,COGS 11,A01,083617,Boyle; Mary E. T.,11,2,48,37
1656061513722,COGS 13,A01,083071,Bastos; Amalia Pinkusfeld,4,3,71,67
1656061519754,COGS 14A,A01,092681,Semenuks; Arturs,4,25,100,96
1656061525800,COGS 14B,A01,083073,Cheng; Tzu-Han,7,0,63,56
1656061531827,COGS 17,A01,092677,Semenuks; Arturs,9,7,81,72
1656061537852,COGS 100,A01,083619,Allen; Michael Gordon,3,2,70,67
1656061543881,COGS 101A,A01,083621,Davis; Joshua Daniel,4,3,68,64
1656061549908,COGS 101B,A01,091572,Allen; Michael Gordon,0,0,65,65
1656061555941,COGS 101C,A01,083625,Delgado; Tania,7,0,35,28
1656061561977,COGS 107A,A01,083627,Boyle; Mary E. T.,1,2,60,59
1656061568003,COGS 118A,A01,083075,Gupta; Anjum,21,16,76,55
1656061574032,CSE 3,A50,083646,Miranda; Gregory Joseph,14,0,50,36
1656061580056,CSE 8A,A50,083650,Miranda; Gregory Joseph,4,11,56,52
1656061586080,CSE 11,A01,083080,Cao; Yingjun,0,64,40,40
1656061592104,CSE 12,A01,083652,Krause-Levy; Sophia Louisa,7,8,120,113
1656061598141,CSE 15L,A01,083654,Morris; Justin Loren,3,1,50,47
1656061598141,CSE 15L,A02,083655,Morris; Justin Loren,2,1,50,48
1656061604181,CSE 20,A01,083657,Tran; Khoa Dang,29,0,80,51
1656061610215,CSE 21,A01,095574,Bach; Quang Tran,23,0,48,25
1656061616239,CSE 30,A01,083084,Eldon; John,2,10,80,78
1656061616239,CSE 30,B01,095061,Bhaskar; Nishant,2,5,50,48
1656061622264,CSE 100,A01,083659,Cao; Yingjun,2,25,70,68
1656061628293,CSE 134B,A01,083661,Powell; Thomas Allan,6,6,100,94
1656061634341,CSE 140,A01,083663,Gungor; Onat,6,0,85,79
1656061640364,CSE 140L,A01,083088,Eldon; John,5,0,100,95
1656061646389,CSE 175,A01,083665,Kumar; Rakesh,0,0,25,25
1656061652418,CSE 190,A00,092507,Dubnov; Shlomo,1,0,20,19
1656061658446,ECE 45,A01,083139,Congero; Spencer William,1,2,75,74
1656061664486,ECE 65,A50,083695,Saad; Andrew S,6,0,30,24
1656061664486,ECE 65,A51,095125,Staff,23,0,26,3
1656061670511,ECE 109,A01,091882,Touri; Behrouz,3,5,70,67
1656061676539,ECE 180,A00,083140,Abi Samra; Nicholas Camill,1,0,30,29
1656061676539,ECE 180,B00,083141,Abi Samra; Nicholas Camill,0,8,28,28
1656061682563,MATH 10A,A01,083735,Patchell; Gregory David,0,0,30,30
1656061682563,MATH 10A,A02,083736,Patchell; Gregory David,20,0,30,10
1656061682563,MATH 10A,A03,083737,Patchell; Gregory David,16,0,30,14
1656061688593,MATH 10B,A01,083207,Lim; Seonhee,1,1,34,33
1656061688593,MATH 10B,A02,083208,Lim; Seonhee,1,1,35,34
1656061688593,MATH 10B,A03,093472,Staff,1,1,34,33
1656061688593,MATH 10B,B01,083739,Sinha; Shubham,10,0,30,20
1656061694618,MATH 18,A01,083743,Cinel; Cameron Alexander,5,0,30,25
1656061694618,MATH 18,A02,083744,Cinel; Cameron Alexander,11,0,30,19
1656061694618,MATH 18,A03,083745,Cinel; Cameron Alexander,2,0,30,28
1656061694618,MATH 18,B01,083748,Ma; Zilu,0,0,36,36
1656061694618,MATH 18,B02,083749,Ma; Zilu,0,0,36,36
1656061694618,MATH 18,B03,083750,Ma; Zilu,0,0,36,36
1656061694618,MATH 18,B04,083751,Ma; Zilu,0,0,36,36
1656061694618,MATH 18,B05,093473,Staff,0,0,36,36
1656061694618,MATH 18,B06,093474,Staff,3,0,36,33
1656061700643,MATH 20A,A01,083754,Zheng; Zequn,11,0,40,29
1656061706671,MATH 20B,A01,083756,Briones; Jor-el Thomas Caparas,0,0,36,36
1656061706671,MATH 20B,A02,083757,Briones; Jor-el Thomas Caparas,0,0,36,36
1656061706671,MATH 20B,A03,093475,Staff,0,0,36,36
1656061712696,MATH 20C,A01,083760,Briones; Jor-el Thomas Caparas,0,2,35,35
1656061712696,MATH 20C,A02,083761,Briones; Jor-el Thomas Caparas,6,1,35,29
1656061712696,MATH 20C,A03,093476,Staff,0,1,35,35
1656061712696,MATH 20C,B01,083762,Bach; Quang Tran,3,0,30,27
1656061718719,MATH 20D,A01,083765,Tran; Brian Kha,3,0,30,27
1656061718719,MATH 20D,A02,083766,Tran; Brian Kha,0,1,30,30
1656061718719,MATH 20D,A03,083767,Tran; Brian Kha,1,0,30,29
1656061724751,MATH 20E,A01,083771,Ganguly; Soumya,1,1,32,31
1656061724751,MATH 20E,A02,083772,Ganguly; Soumya,1,1,32,31
1656061724751,MATH 20E,B01,083773,Ciotti; Benjamin,14,0,35,21
1656061724751,MATH 20E,B02,083774,Ciotti; Benjamin,13,0,35,22
1656061730790,MATH 103A,A01,083777,Greenfeld; Be'Eri,2,1,36,34
1656061730790,MATH 103A,A02,083778,Greenfeld; Be'Eri,1,0,36,35
1656061730790,MATH 103A,A03,093561,Staff,0,1,36,36
1656061730790,MATH 103A,B01,083779,Greenfeld; Be'Eri,8,1,36,28
1656061730790,MATH 103A,B02,083780,Greenfeld; Be'Eri,0,0,36,36
1656061730790,MATH 103A,B03,093562,Staff,0,0,36,36
1656061736826,MATH 105,A01,085443,Carter; Anne Toulson,4,1,35,31
1656061736826,MATH 105,A02,093477,Staff,9,0,35,26
1656061742857,MATH 109,A01,083213,Ganzberger; Geoffrey Michael,1,1,34,33
1656061742857,MATH 109,A02,083214,Ganzberger; Geoffrey Michael,0,0,34,34
1656061742857,MATH 109,A03,093478,Staff,1,0,34,33
1656061742857,MATH 109,B01,083215,Ganzberger; Geoffrey Michael,2,0,32,30
1656061742857,MATH 109,B02,083216,Ganzberger; Geoffrey Michael,0,0,32,32
1656061742857,MATH 109,B03,093479,Staff,3,0,32,29
1656061748899,MATH 142A,A01,083219,Chow; Bennett,1,0,32,31
1656061748899,MATH 142A,A02,083220,Chow; Bennett,7,0,32,25
1656061748899,MATH 142A,A03,093480,Staff,4,0,32,28
1656061748899,MATH 142A,B03,093481,Staff,5,0,32,27
1656061748899,MATH 142A,B04,093558,Staff,6,0,32,26
1656061748899,MATH 142A,B05,093559,Staff,0,0,32,32
1656061754922,MATH 193A,A01,083224,Rotar; Vladimir,1,2,34,33
1656061754922,MATH 193A,A02,083225,Rotar; Vladimir,1,0,34,33
1656061754922,MATH 193A,A03,083781,Rotar; Vladimir,1,0,34,33
1656061754922,MATH 193A,A04,083782,Rotar; Vladimir,3,0,34,31
1656061754922,MATH 193A,A05,093482,Rotar; Vladimir,0,0,34,34
1656061760951,MATH 197,001,091859,McAuley; Julian John,9999,0,9999,0
1656061760951,MATH 197,002,095566,Kedlaya; Kiran S.,9997,0,9999,2
1656061760951,MATH 197,003,095567,Xiao; Ming,9999,0,9999,0
1656061760951,MATH 197,004,095571,Perols; Johan Lars,9998,0,9999,1
1656061768022,COGS 9,A01,083615,Shannon; Kyle Michael,3,1,75,72
1656061774047,COGS 11,A01,083617,Boyle; Mary E. T.,11,2,48,37
1656061780071,COGS 13,A01,083071,Bastos; Amalia Pinkusfeld,4,3,71,67
1656061786096,COGS 14A,A01,092681,Semenuks; Arturs,4,25,100,96
1656061792143,COGS 14B,A01,083073,Cheng; Tzu-Han,7,0,63,56
1656061798175,COGS 17,A01,092677,Semenuks; Arturs,9,7,81,72
1656061804200,COGS 100,A01,083619,Allen; Michael Gordon,3,2,70,67
1656061810225,COGS 101A,A01,083621,Davis; Joshua Daniel,4,3,68,64
1656061816259,COGS 101B,A01,091572,Allen; Michael Gordon,0,0,65,65
1656061822287,COGS 101C,A01,083625,Delgado; Tania,7,0,35,28
1656061828312,COGS 107A,A01,083627,Boyle; Mary E. T.,1,2,60,59
1656061834339,COGS 118A,A01,083075,Gupta; Anjum,21,16,76,55
1656061840363,CSE 3,A50,083646,Miranda; Gregory Joseph,14,0,50,36
1656061846389,CSE 8A,A50,083650,Miranda; Gregory Joseph,4,11,56,52
1656061852411,CSE 11,A01,083080,Cao; Yingjun,0,64,40,40
1656061858440,CSE 12,A01,083652,Krause-Levy; Sophia Louisa,7,8,120,113
1656061864465,CSE 15L,A01,083654,Morris; Justin Loren,3,1,50,47
1656061864465,CSE 15L,A02,083655,Morris; Justin Loren,2,1,50,48
1656061870496,CSE 20,A01,083657,Tran; Khoa Dang,29,0,80,51
1656061876527,CSE 21,A01,095574,Bach; Quang Tran,23,0,48,25
1656061882559,CSE 30,A01,083084,Eldon; John,2,10,80,78
1656061882559,CSE 30,B01,095061,Bhaskar; Nishant,2,5,50,48
1656061888589,CSE 100,A01,083659,Cao; Yingjun,2,25,70,68
1656061894613,CSE 134B,A01,083661,Powell; Thomas Allan,6,6,100,94
1656061900637,CSE 140,A01,083663,Gungor; Onat,6,0,85,79
1656061906660,CSE 140L,A01,083088,Eldon; John,5,0,100,95
1656061912690,CSE 175,A01,083665,Kumar; Rakesh,0,0,25,25
1656061918717,CSE 190,A00,092507,Dubnov; Shlomo,1,0,20,19
1656061924741,ECE 45,A01,083139,Congero; Spencer William,1,2,75,74
1656061930776,ECE 65,A50,083695,Saad; Andrew S,6,0,30,24
1656061930776,ECE 65,A51,095125,Staff,23,0,26,3
1656061936800,ECE 109,A01,091882,Touri; Behrouz,3,5,70,67
1656061942824,ECE 180,A00,083140,Abi Samra; Nicholas Camill,1,0,30,29
1656061942824,ECE 180,B00,083141,Abi Samra; Nicholas Camill,0,8,28,28
1656061948850,MATH 10A,A01,083735,Patchell; Gregory David,0,0,30,30
1656061948850,MATH 10A,A02,083736,Patchell; Gregory David,20,0,30,10
1656061948850,MATH 10A,A03,083737,Patchell; Gregory David,16,0,30,14
1656061954877,MATH 10B,A01,083207,Lim; Seonhee,1,1,34,33
1656061954877,MATH 10B,A02,083208,Lim; Seonhee,1,1,35,34
1656061954877,MATH 10B,A03,093472,Staff,1,1,34,33
1656061954877,MATH 10B,B01,083739,Sinha; Shubham,10,0,30,20
1656061960931,MATH 18,A01,083743,Cinel; Cameron Alexander,5,0,30,25
1656061960931,MATH 18,A02,083744,Cinel; Cameron Alexander,11,0,30,19
1656061960931,MATH 18,A03,083745,Cinel; Cameron Alexander,2,0,30,28
1656061960931,MATH 18,B01,083748,Ma; Zilu,0,0,36,36
1656061960931,MATH 18,B02,083749,Ma; Zilu,0,0,36,36
1656061960931,MATH 18,B03,083750,Ma; Zilu,0,0,36,36
1656061960931,MATH 18,B04,083751,Ma; Zilu,0,0,36,36
1656061960931,MATH 18,B05,093473,Staff,0,0,36,36
1656061960931,MATH 18,B06,093474,Staff,3,0,36,33
1656061966954,MATH 20A,A01,083754,Zheng; Zequn,11,0,40,29
1656061972983,MATH 20B,A01,083756,Briones; Jor-el Thomas Caparas,0,0,36,36
1656061972983,MATH 20B,A02,083757,Briones; Jor-el Thomas Caparas,0,0,36,36
1656061972983,MATH 20B,A03,093475,Staff,0,0,36,36
1656061979015,MATH 20C,A01,083760,Briones; Jor-el Thomas Caparas,0,2,35,35
1656061979015,MATH 20C,A02,083761,Briones; Jor-el Thomas Caparas,6,1,35,29
1656061979015,MATH 20C,A03,093476,Staff,0,1,35,35
1656061979015,MATH 20C,B01,083762,Bach; Quang Tran,3,0,30,27
1656061985049,MATH 20D,A01,083765,Tran; Brian Kha,3,0,30,27
1656061985049,MATH 20D,A02,083766,Tran; Brian Kha,0,1,30,30
1656061985049,MATH 20D,A03,083767,Tran; Brian Kha,1,0,30,29
1656061991082,MATH 20E,A01,083771,Ganguly; Soumya,1,1,32,31
1656061991082,MATH 20E,A02,083772,Ganguly; Soumya,1,1,32,31
1656061991082,MATH 20E,B01,083773,Ciotti; Benjamin,14,0,35,21
1656061991082,MATH 20E,B02,083774,Ciotti; Benjamin,13,0,35,22
1656061997120,MATH 103A,A01,083777,Greenfeld; Be'Eri,2,1,36,34
1656061997120,MATH 103A,A02,083778,Greenfeld; Be'Eri,1,0,36,35
1656061997120,MATH 103A,A03,093561,Staff,0,1,36,36
1656061997120,MATH 103A,B01,083779,Greenfeld; Be'Eri,8,1,36,28
1656061997120,MATH 103A,B02,083780,Greenfeld; Be'Eri,0,0,36,36
1656061997120,MATH 103A,B03,093562,Staff,0,0,36,36
1656062003149,MATH 105,A01,085443,Carter; Anne Toulson,4,1,35,31
1656062003149,MATH 105,A02,093477,Staff,9,0,35,26
1656062009180,MATH 109,A01,083213,Ganzberger; Geoffrey Michael,1,1,34,33
1656062009180,MATH 109,A02,083214,Ganzberger; Geoffrey Michael,0,0,34,34
1656062009180,MATH 109,A03,093478,Staff,1,0,34,33
1656062009180,MATH 109,B01,083215,Ganzberger; Geoffrey Michael,2,0,32,30
1656062009180,MATH 109,B02,083216,Ganzberger; Geoffrey Michael,0,0,32,32
1656062009180,MATH 109,B03,093479,Staff,3,0,32,29
1656062015216,MATH 142A,A01,083219,Chow; Bennett,1,0,32,31
1656062015216,MATH 142A,A02,083220,Chow; Bennett,7,0,32,25
1656062015216,MATH 142A,A03,093480,Staff,4,0,32,28
1656062015216,MATH 142A,B03,093481,Staff,5,0,32,27
1656062015216,MATH 142A,B04,093558,Staff,6,0,32,26
1656062015216,MATH 142A,B05,093559,Staff,0,0,32,32
1656062021332,MATH 193A,A01,083224,Rotar; Vladimir,1,2,34,33
1656062021332,MATH 193A,A02,083225,Rotar; Vladimir,1,0,34,33
1656062021332,MATH 193A,A03,083781,Rotar; Vladimir,1,0,34,33
1656062021332,MATH 193A,A04,083782,Rotar; Vladimir,3,0,34,31
1656062021332,MATH 193A,A05,093482,Rotar; Vladimir,0,0,34,34
1656062027358,MATH 197,001,091859,McAuley; Julian John,9999,0,9999,0
1656062027358,MATH 197,002,095566,Kedlaya; Kiran S.,9997,0,9999,2
1656062027358,MATH 197,003,095567,Xiao; Ming,9999,0,9999,0
1656062027358,MATH 197,004,095571,Perols; Johan Lars,9998,0,9999,1
1656062034446,COGS 9,A01,083615,Shannon; Kyle Michael,3,1,75,72
1656062040481,COGS 11,A01,083617,Boyle; Mary E. T.,11,2,48,37
1656062046505,COGS 13,A01,083071,Bastos; Amalia Pinkusfeld,4,3,71,67
1656062052542,COGS 14A,A01,092681,Semenuks; Arturs,4,25,100,96
1656062058565,COGS 14B,A01,083073,Cheng; Tzu-Han,7,0,63,56
1656062064600,COGS 17,A01,092677,Semenuks; Arturs,9,7,81,72
1656062070638,COGS 100,A01,083619,Allen; Michael Gordon,3,2,70,67
1656062076666,COGS 101A,A01,083621,Davis; Joshua Daniel,4,3,68,64
1656062082704,COGS 101B,A01,091572,Allen; Michael Gordon,0,0,65,65
1656062088728,COGS 101C,A01,083625,Delgado; Tania,7,0,35,28
1656062094755,COGS 107A,A01,083627,Boyle; Mary E. T.,1,2,60,59
1656062100792,COGS 118A,A01,083075,Gupta; Anjum,21,16,76,55
1656062106823,CSE 3,A50,083646,Miranda; Gregory Joseph,14,0,50,36
1656062112854,CSE 8A,A50,083650,Miranda; Gregory Joseph,4,11,56,52
1656062118885,CSE 11,A01,083080,Cao; Yingjun,0,64,40,40
1656062124908,CSE 12,A01,083652,Krause-Levy; Sophia Louisa,7,8,120,113
1656062130931,CSE 15L,A01,083654,Morris; Justin Loren,3,1,50,47
1656062130931,CSE 15L,A02,083655,Morris; Justin Loren,2,1,50,48
1656062136970,CSE 20,A01,083657,Tran; Khoa Dang,29,0,80,51
1656062143006,CSE 21,A01,095574,Bach; Quang Tran,23,0,48,25
1656062149031,CSE 30,A01,083084,Eldon; John,2,10,80,78
1656062149031,CSE 30,B01,095061,Bhaskar; Nishant,2,5,50,48
1656062155066,CSE 100,A01,083659,Cao; Yingjun,2,25,70,68
1656062161090,CSE 134B,A01,083661,Powell; Thomas Allan,6,6,100,94
1656062167115,CSE 140,A01,083663,Gungor; Onat,6,0,85,79
1656062173144,CSE 140L,A01,083088,Eldon; John,5,0,100,95
1656062179172,CSE 175,A01,083665,Kumar; Rakesh,0,0,25,25
1656062185198,CSE 190,A00,092507,Dubnov; Shlomo,1,0,20,19
1656062191222,ECE 45,A01,083139,Congero; Spencer William,1,2,75,74
1656062197276,ECE 65,A50,083695,Saad; Andrew S,6,0,30,24
1656062197276,ECE 65,A51,095125,Staff,23,0,26,3
1656062203303,ECE 109,A01,091882,Touri; Behrouz,3,5,70,67
1656062209332,ECE 180,A00,083140,Abi Samra; Nicholas Camill,1,0,30,29
1656062209332,ECE 180,B00,083141,Abi Samra; Nicholas Camill,0,8,28,28
1656062215355,MATH 10A,A01,083735,Patchell; Gregory David,0,0,30,30
1656062215355,MATH 10A,A02,083736,Patchell; Gregory David,20,0,30,10
1656062215355,MATH 10A,A03,083737,Patchell; Gregory David,16,0,30,14
1656062221377,MATH 10B,A01,083207,Lim; Seonhee,1,1,34,33
1656062221377,MATH 10B,A02,083208,Lim; Seonhee,1,1,35,34
1656062221377,MATH 10B,A03,093472,Staff,1,1,34,33
1656062221377,MATH 10B,B01,083739,Sinha; Shubham,10,0,30,20
1656062227406,MATH 18,A01,083743,Cinel; Cameron Alexander,5,0,30,25
1656062227406,MATH 18,A02,083744,Cinel; Cameron Alexander,11,0,30,19
1656062227406,MATH 18,A03,083745,Cinel; Cameron Alexander,2,0,30,28
1656062227406,MATH 18,B01,083748,Ma; Zilu,0,0,36,36
1656062227406,MATH 18,B02,083749,Ma; Zilu,0,0,36,36
1656062227406,MATH 18,B03,083750,Ma; Zilu,0,0,36,36
1656062227406,MATH 18,B04,083751,Ma; Zilu,0,0,36,36
1656062227406,MATH 18,B05,093473,Staff,0,0,36,36
1656062227406,MATH 18,B06,093474,Staff,3,0,36,33
1656062233439,MATH 20A,A01,083754,Zheng; Zequn,11,0,40,29
1656062239463,MATH 20B,A01,083756,Briones; Jor-el Thomas Caparas,0,0,36,36
1656062239463,MATH 20B,A02,083757,Briones; Jor-el Thomas Caparas,0,0,36,36
1656062239463,MATH 20B,A03,093475,Staff,0,0,36,36
1656062245485,MATH 20C,A01,083760,Briones; Jor-el Thomas Caparas,0,2,35,35
1656062245485,MATH 20C,A02,083761,Briones; Jor-el Thomas Caparas,6,1,35,29
1656062245485,MATH 20C,A03,093476,Staff,0,1,35,35
1656062245485,MATH 20C,B01,083762,Bach; Quang Tran,3,0,30,27
1656062251508,MATH 20D,A01,083765,Tran; Brian Kha,3,0,30,27
1656062251508,MATH 20D,A02,083766,Tran; Brian Kha,0,1,30,30
1656062251508,MATH 20D,A03,083767,Tran; Brian Kha,1,0,30,29
1656062257562,MATH 20E,A01,083771,Ganguly; Soumya,1,1,32,31
1656062257562,MATH 20E,A02,083772,Ganguly; Soumya,1,1,32,31
1656062257562,MATH 20E,B01,083773,Ciotti; Benjamin,14,0,35,21
1656062257562,MATH 20E,B02,083774,Ciotti; Benjamin,13,0,35,22
1656062263585,MATH 103A,A01,083777,Greenfeld; Be'Eri,2,1,36,34
1656062263585,MATH 103A,A02,083778,Greenfeld; Be'Eri,1,0,36,35
1656062263585,MATH 103A,A03,093561,Staff,0,1,36,36
1656062263585,MATH 103A,B01,083779,Greenfeld; Be'Eri,8,1,36,28
1656062263585,MATH 103A,B02,083780,Greenfeld; Be'Eri,0,0,36,36
1656062263585,MATH 103A,B03,093562,Staff,0,0,36,36
1656062269621,MATH 105,A01,085443,Carter; Anne Toulson,4,1,35,31
1656062269621,MATH 105,A02,093477,Staff,9,0,35,26
1656062275663,MATH 109,A01,083213,Ganzberger; Geoffrey Michael,1,1,34,33
1656062275663,MATH 109,A02,083214,Ganzberger; Geoffrey Michael,0,0,34,34
1656062275663,MATH 109,A03,093478,Staff,1,0,34,33
1656062275663,MATH 109,B01,083215,Ganzberger; Geoffrey Michael,2,0,32,30
1656062275663,MATH 109,B02,083216,Ganzberger; Geoffrey Michael,0,0,32,32
1656062275663,MATH 109,B03,093479,Staff,3,0,32,29
1656062281687,MATH 142A,A01,083219,Chow; Bennett,1,0,32,31
1656062281687,MATH 142A,A02,083220,Chow; Bennett,7,0,32,25
1656062281687,MATH 142A,A03,093480,Staff,4,0,32,28
1656062281687,MATH 142A,B03,093481,Staff,5,0,32,27
1656062281687,MATH 142A,B04,093558,Staff,6,0,32,26
1656062281687,MATH 142A,B05,093559,Staff,0,0,32,32
1656062287715,MATH 193A,A01,083224,Rotar; Vladimir,1,2,34,33
1656062287715,MATH 193A,A02,083225,Rotar; Vladimir,1,0,34,33
1656062287715,MATH 193A,A03,083781,Rotar; Vladimir,1,0,34,33
1656062287715,MATH 193A,A04,083782,Rotar; Vladimir,3,0,34,31
1656062287715,MATH 193A,A05,093482,Rotar; Vladimir,0,0,34,34
1656062293744,MATH 197,001,091859,McAuley; Julian John,9999,0,9999,0
1656062293744,MATH 197,002,095566,Kedlaya; Kiran S.,9997,0,9999,2
1656062293744,MATH 197,003,095567,Xiao; Ming,9999,0,9999,0
1656062293744,MATH 197,004,095571,Perols; Johan Lars,9998,0,9999,1
1656062300802,COGS 9,A01,083615,Shannon; Kyle Michael,3,1,75,72
1656062306826,COGS 11,A01,083617,Boyle; Mary E. T.,11,2,48,37
1656062312854,COGS 13,A01,083071,Bastos; Amalia Pinkusfeld,4,3,71,67
1656062318895,COGS 14A,A01,092681,Semenuks; Arturs,4,25,100,96
1656062324929,COGS 14B,A01,083073,Cheng; Tzu-Han,7,0,63,56
1656062330956,COGS 17,A01,092677,Semenuks; Arturs,9,7,81,72
1656062336983,COGS 100,A01,083619,Allen; Michael Gordon,3,2,70,67
1656062343020,COGS 101A,A01,083621,Davis; Joshua Daniel,4,3,68,64
1656062349043,COGS 101B,A01,091572,Allen; Michael Gordon,0,0,65,65
1656062355077,COGS 101C,A01,083625,Delgado; Tania,7,0,35,28
1656062361110,COGS 107A,A01,083627,Boyle; Mary E. T.,1,2,60,59
1656062367140,COGS 118A,A01,083075,Gupta; Anjum,21,16,76,55
1656062373187,CSE 3,A50,083646,Miranda; Gregory Joseph,14,0,50,36
1656062379225,CSE 8A,A50,083650,Miranda; Gregory Joseph,4,11,56,52
1656062385249,CSE 11,A01,083080,Cao; Yingjun,0,64,40,40
1656062391273,CSE 12,A01,083652,Krause-Levy; Sophia Louisa,7,8,120,113
1656062397299,CSE 15L,A01,083654,Morris; Justin Loren,3,1,50,47
1656062397299,CSE 15L,A02,083655,Morris; Justin Loren,2,1,50,48
1656062403335,CSE 20,A01,083657,Tran; Khoa Dang,29,0,80,51
1656062409365,CSE 21,A01,095574,Bach; Quang Tran,23,0,48,25
1656062415399,CSE 30,A01,083084,Eldon; John,2,10,80,78
1656062415399,CSE 30,B01,095061,Bhaskar; Nishant,2,5,50,48
1656062421447,CSE 100,A01,083659,Cao; Yingjun,2,25,70,68
1656062427471,CSE 134B,A01,083661,Powell; Thomas Allan,6,6,100,94
1656062433494,CSE 140,A01,083663,Gungor; Onat,6,0,85,79
1656062439527,CSE 140L,A01,083088,Eldon; John,5,0,100,95
1656062445567,CSE 175,A01,083665,Kumar; Rakesh,0,0,25,25
1656062451590,CSE 190,A00,092507,Dubnov; Shlomo,1,0,20,19
1656062457643,ECE 45,A01,083139,Congero; Spencer William,1,2,75,74
1656062463672,ECE 65,A50,083695,Saad; Andrew S,6,0,30,24
1656062463672,ECE 65,A51,095125,Staff,23,0,26,3
1656062469699,ECE 109,A01,091882,Touri; Behrouz,3,5,70,67
1656062475740,ECE 180,A00,083140,Abi Samra; Nicholas Camill,1,0,30,29
1656062475740,ECE 180,B00,083141,Abi Samra; Nicholas Camill,0,8,28,28
1656062481774,MATH 10A,A01,083735,Patchell; Gregory David,0,0,30,30
1656062481774,MATH 10A,A02,083736,Patchell; Gregory David,20,0,30,10
1656062481774,MATH 10A,A03,083737,Patchell; Gregory David,16,0,30,14
1656062487805,MATH 10B,A01,083207,Lim; Seonhee,1,1,34,33
1656062487805,MATH 10B,A02,083208,Lim; Seonhee,1,1,35,34
1656062487805,MATH 10B,A03,093472,Staff,1,1,34,33
1656062487805,MATH 10B,B01,083739,Sinha; Shubham,10,0,30,20
1656062493836,MATH 18,A01,083743,Cinel; Cameron Alexander,5,0,30,25
1656062493836,MATH 18,A02,083744,Cinel; Cameron Alexander,11,0,30,19
1656062493836,MATH 18,A03,083745,Cinel; Cameron Alexander,2,0,30,28
1656062493836,MATH 18,B01,083748,Ma; Zilu,0,0,36,36
1656062493836,MATH 18,B02,083749,Ma; Zilu,0,0,36,36
1656062493836,MATH 18,B03,083750,Ma; Zilu,0,0,36,36
1656062493836,MATH 18,B04,083751,Ma; Zilu,0,0,36,36
1656062493836,MATH 18,B05,093473,Staff,0,0,36,36
1656062493836,MATH 18,B06,093474,Staff,3,0,36,33
1656062499868,MATH 20A,A01,083754,Zheng; Zequn,11,0,40,29
1656062505893,MATH 20B,A01,083756,Briones; Jor-el Thomas Caparas,0,0,36,36
1656062505893,MATH 20B,A02,083757,Briones; Jor-el Thomas Caparas,0,0,36,36
1656062505893,MATH 20B,A03,093475,Staff,0,0,36,36
1656062511921,MATH 20C,A01,083760,Briones; Jor-el Thomas Caparas,0,2,35,35
1656062511921,MATH 20C,A02,083761,Briones; Jor-el Thomas Caparas,6,1,35,29
1656062511921,MATH 20C,A03,093476,Staff,0,1,35,35
1656062511921,MATH 20C,B01,083762,Bach; Quang Tran,3,0,30,27
1656062517946,MATH 20D,A01,083765,Tran; Brian Kha,3,0,30,27
1656062517946,MATH 20D,A02,083766,Tran; Brian Kha,0,1,30,30
1656062517946,MATH 20D,A03,083767,Tran; Brian Kha,1,0,30,29
1656062523972,MATH 20E,A01,083771,Ganguly; Soumya,1,1,32,31
1656062523972,MATH 20E,A02,083772,Ganguly; Soumya,1,1,32,31
1656062523972,MATH 20E,B01,083773,Ciotti; Benjamin,14,0,35,21
1656062523972,MATH 20E,B02,083774,Ciotti; Benjamin,13,0,35,22
1656062530002,MATH 103A,A01,083777,Greenfeld; Be'Eri,2,1,36,34
1656062530002,MATH 103A,A02,083778,Greenfeld; Be'Eri,1,0,36,35
1656062530002,MATH 103A,A03,093561,Staff,0,1,36,36
1656062530002,MATH 103A,B01,083779,Greenfeld; Be'Eri,8,1,36,28
1656062530002,MATH 103A,B02,083780,Greenfeld; Be'Eri,0,0,36,36
1656062530002,MATH 103A,B03,093562,Staff,0,0,36,36
1656062536051,MATH 105,A01,085443,Carter; Anne Toulson,4,1,35,31
1656062536051,MATH 105,A02,093477,Staff,9,0,35,26
1656062542082,MATH 109,A01,083213,Ganzberger; Geoffrey Michael,1,1,34,33
1656062542082,MATH 109,A02,083214,Ganzberger; Geoffrey Michael,0,0,34,34
1656062542082,MATH 109,A03,093478,Staff,1,0,34,33
1656062542082,MATH 109,B01,083215,Ganzberger; Geoffrey Michael,2,0,32,30
1656062542082,MATH 109,B02,083216,Ganzberger; Geoffrey Michael,0,0,32,32
1656062542082,MATH 109,B03,093479,Staff,3,0,32,29
1656062548108,MATH 142A,A01,083219,Chow; Bennett,1,0,32,31
1656062548108,MATH 142A,A02,083220,Chow; Bennett,7,0,32,25
1656062548108,MATH 142A,A03,093480,Staff,4,0,32,28
1656062548108,MATH 142A,B03,093481,Staff,5,0,32,27
1656062548108,MATH 142A,B04,093558,Staff,6,0,32,26
1656062548108,MATH 142A,B05,093559,Staff,0,0,32,32
1656062554136,MATH 193A,A01,083224,Rotar; Vladimir,1,2,34,33
1656062554136,MATH 193A,A02,083225,Rotar; Vladimir,1,0,34,33
1656062554136,MATH 193A,A03,083781,Rotar; Vladimir,1,0,34,33
1656062554136,MATH 193A,A04,083782,Rotar; Vladimir,3,0,34,31
1656062554136,MATH 193A,A05,093482,Rotar; Vladimir,0,0,34,34
1656062560161,MATH 197,001,091859,McAuley; Julian John,9999,0,9999,0
1656062560161,MATH 197,002,095566,Kedlaya; Kiran S.,9997,0,9999,2
1656062560161,MATH 197,003,095567,Xiao; Ming,9999,0,9999,0
1656062560161,MATH 197,004,095571,Perols; Johan Lars,9998,0,9999,1
1656062567252,COGS 9,A01,083615,Shannon; Kyle Michael,3,1,75,72
1656062573288,COGS 11,A01,083617,Boyle; Mary E. T.,11,2,48,37
1656062579319,COGS 13,A01,083071,Bastos; Amalia Pinkusfeld,4,3,71,67
1656062585344,COGS 14A,A01,092681,Semenuks; Arturs,4,25,100,96
1656062591371,COGS 14B,A01,083073,Cheng; Tzu-Han,7,0,63,56
1656062597403,COGS 17,A01,092677,Semenuks; Arturs,9,7,81,72
1656062603429,COGS 100,A01,083619,Allen; Michael Gordon,3,2,70,67
1656062609453,COGS 101A,A01,083621,Davis; Joshua Daniel,4,3,68,64
1656062615610,COGS 101B,A01,091572,Allen; Michael Gordon,0,0,65,65
1656062621633,COGS 101C,A01,083625,Delgado; Tania,7,0,35,28
1656062627669,COGS 107A,A01,083627,Boyle; Mary E. T.,1,2,60,59
1656062633717,COGS 118A,A01,083075,Gupta; Anjum,21,16,76,55
1656062639749,CSE 3,A50,083646,Miranda; Gregory Joseph,14,0,50,36
1656062645791,CSE 8A,A50,083650,Miranda; Gregory Joseph,4,11,56,52
1656062651817,CSE 11,A01,083080,Cao; Yingjun,0,64,40,40
1656062657841,CSE 12,A01,083652,Krause-Levy; Sophia Louisa,7,8,120,113
1656062663866,CSE 15L,A01,083654,Morris; Justin Loren,3,1,50,47
1656062663866,CSE 15L,A02,083655,Morris; Justin Loren,2,1,50,48
1656062669891,CSE 20,A01,083657,Tran; Khoa Dang,29,0,80,51
1656062675940,CSE 21,A01,095574,Bach; Quang Tran,23,0,48,25
1656062681971,CSE 30,A01,083084,Eldon; John,2,10,80,78
1656062681971,CSE 30,B01,095061,Bhaskar; Nishant,2,5,50,48
1656062688008,CSE 100,A01,083659,Cao; Yingjun,2,25,70,68
1656062694046,CSE 134B,A01,083661,Powell; Thomas Allan,6,6,100,94
1656062700082,CSE 140,A01,083663,Gungor; Onat,6,0,85,79
1656062706106,CSE 140L,A01,083088,Eldon; John,5,0,100,95
1656062712130,CSE 175,A01,083665,Kumar; Rakesh,0,0,25,25
1656062718159,CSE 190,A00,092507,Dubnov; Shlomo,1,0,20,19
1656062724184,ECE 45,A01,083139,Congero; Spencer William,1,2,75,74
1656062730209,ECE 65,A50,083695,Saad; Andrew S,6,0,30,24
1656062730209,ECE 65,A51,095125,Staff,23,0,26,3
1656062736235,ECE 109,A01,091882,Touri; Behrouz,3,5,70,67
1656062742266,ECE 180,A00,083140,Abi Samra; Nicholas Camill,1,0,30,29
1656062742266,ECE 180,B00,083141,Abi Samra; Nicholas Camill,0,8,28,28
1656062748298,MATH 10A,A01,083735,Patchell; Gregory David,0,0,30,30
1656062748298,MATH 10A,A02,083736,Patchell; Gregory David,20,0,30,10
1656062748298,MATH 10A,A03,083737,Patchell; Gregory David,16,0,30,14
1656062754336,MATH 10B,A01,083207,Lim; Seonhee,1,1,34,33
1656062754336,MATH 10B,A02,083208,Lim; Seonhee,1,1,35,34
1656062754336,MATH 10B,A03,093472,Staff,1,1,34,33
1656062754336,MATH 10B,B01,083739,Sinha; Shubham,10,0,30,20
1656062760372,MATH 18,A01,083743,Cinel; Cameron Alexander,5,0,30,25
1656062760372,MATH 18,A02,083744,Cinel; Cameron Alexander,11,0,30,19
1656062760372,MATH 18,A03,083745,Cinel; Cameron Alexander,2,0,30,28
1656062760372,MATH 18,B01,083748,Ma; Zilu,0,0,36,36
1656062760372,MATH 18,B02,083749,Ma; Zilu,0,0,36,36
1656062760372,MATH 18,B03,083750,Ma; Zilu,0,0,36,36
1656062760372,MATH 18,B04,083751,Ma; Zilu,0,0,36,36
1656062760372,MATH 18,B05,093473,Staff,0,0,36,36
1656062760372,MATH 18,B06,093474,Staff,3,0,36,33
1656062766398,MATH 20A,A01,083754,Zheng; Zequn,11,0,40,29
1656062772425,MATH 20B,A01,083756,Briones; Jor-el Thomas Caparas,0,0,36,36
1656062772425,MATH 20B,A02,083757,Briones; Jor-el Thomas Caparas,0,0,36,36
1656062772425,MATH 20B,A03,093475,Staff,0,0,36,36
1656062778466,MATH 20C,A01,083760,Briones; Jor-el Thomas Caparas,0,2,35,35
1656062778466,MATH 20C,A02,083761,Briones; Jor-el Thomas Caparas,6,1,35,29
1656062778466,MATH 20C,A03,093476,Staff,0,1,35,35
1656062778466,MATH 20C,B01,083762,Bach; Quang Tran,3,0,30,27
1656062784492,MATH 20D,A01,083765,Tran; Brian Kha,3,0,30,27
1656062784492,MATH 20D,A02,083766,Tran; Brian Kha,0,1,30,30
1656062784492,MATH 20D,A03,083767,Tran; Brian Kha,1,0,30,29
1656062790516,MATH 20E,A01,083771,Ganguly; Soumya,1,1,32,31
1656062790516,MATH 20E,A02,083772,Ganguly; Soumya,1,1,32,31
1656062790516,MATH 20E,B01,083773,Ciotti; Benjamin,14,0,35,21
1656062790516,MATH 20E,B02,083774,Ciotti; Benjamin,13,0,35,22
1656062796565,MATH 103A,A01,083777,Greenfeld; Be'Eri,2,1,36,34
1656062796565,MATH 103A,A02,083778,Greenfeld; Be'Eri,1,0,36,35
1656062796565,MATH 103A,A03,093561,Staff,1,1,36,35
1656062796565,MATH 103A,B01,083779,Greenfeld; Be'Eri,8,1,36,28
1656062796565,MATH 103A,B02,083780,Greenfeld; Be'Eri,0,0,36,36
1656062796565,MATH 103A,B03,093562,Staff,0,0,36,36
1656062802597,MATH 105,A01,085443,Carter; Anne Toulson,4,1,35,31
1656062802597,MATH 105,A02,093477,Staff,9,0,35,26
1656062808635,MATH 109,A01,083213,Ganzberger; Geoffrey Michael,1,1,34,33
1656062808635,MATH 109,A02,083214,Ganzberger; Geoffrey Michael,0,0,34,34
1656062808635,MATH 109,A03,093478,Staff,1,0,34,33
1656062808635,MATH 109,B01,083215,Ganzberger; Geoffrey Michael,2,0,32,30
1656062808635,MATH 109,B02,083216,Ganzberger; Geoffrey Michael,0,0,32,32
1656062808635,MATH 109,B03,093479,Staff,3,0,32,29
1656062814661,MATH 142A,A01,083219,Chow; Bennett,1,0,32,31
1656062814661,MATH 142A,A02,083220,Chow; Bennett,8,0,32,24
1656062814661,MATH 142A,A03,093480,Staff,4,0,32,28
1656062814661,MATH 142A,B03,093481,Staff,5,0,32,27
1656062814661,MATH 142A,B04,093558,Staff,7,0,32,25
1656062814661,MATH 142A,B05,093559,Staff,0,0,32,32
1656062820688,MATH 193A,A01,083224,Rotar; Vladimir,1,2,34,33
1656062820688,MATH 193A,A02,083225,Rotar; Vladimir,3,0,34,31
1656062820688,MATH 193A,A03,083781,Rotar; Vladimir,1,0,34,33
1656062820688,MATH 193A,A04,083782,Rotar; Vladimir,5,0,34,29
1656062820688,MATH 193A,A05,093482,Rotar; Vladimir,0,0,34,34
1656062826718,MATH 197,001,091859,McAuley; Julian John,9999,0,9999,0
1656062826718,MATH 197,002,095566,Kedlaya; Kiran S.,9997,0,9999,2
1656062826718,MATH 197,003,095567,Xiao; Ming,9999,0,9999,0
1656062826718,MATH 197,004,095571,Perols; Johan Lars,9998,0,9999,1
1656062833801,COGS 9,A01,083615,Shannon; Kyle Michael,3,1,75,72
1656062839831,COGS 11,A01,083617,Boyle; Mary E. T.,15,1,48,33
1656062845867,COGS 13,A01,083071,Bastos; Amalia Pinkusfeld,8,2,71,63
1656062851892,COGS 14A,A01,092681,Semenuks; Arturs,8,23,100,92
1656062857924,COGS 14B,A01,083073,Cheng; Tzu-Han,9,0,63,54
1656062863952,COGS 17,A01,092677,Semenuks; Arturs,13,5,81,68
1656062869980,COGS 100,A01,083619,Allen; Michael Gordon,8,1,70,62
1656062876024,COGS 101A,A01,083621,Davis; Joshua Daniel,7,3,68,61
1656062882051,COGS 101B,A01,091572,Allen; Michael Gordon,7,0,65,58
1656062888090,COGS 101C,A01,083625,Delgado; Tania,11,0,35,24
1656062894114,COGS 107A,A01,083627,Boyle; Mary E. T.,5,2,60,55
1656062900147,COGS 118A,A01,083075,Gupta; Anjum,24,16,76,52
1656062906185,CSE 3,A50,083646,Miranda; Gregory Joseph,20,0,50,30
1656062912219,CSE 8A,A50,083650,Miranda; Gregory Joseph,13,11,56,43
1656062918255,CSE 11,A01,083080,Cao; Yingjun,1,60,40,39
1656062924294,CSE 12,A01,083652,Krause-Levy; Sophia Louisa,14,7,120,106
1656062930328,CSE 15L,A01,083654,Morris; Justin Loren,5,1,50,45
1656062930328,CSE 15L,A02,083655,Morris; Justin Loren,7,0,50,43
1656062936356,CSE 20,A01,083657,Tran; Khoa Dang,31,0,80,49
1656062942387,CSE 21,A01,095574,Bach; Quang Tran,28,0,48,20
1656062948418,CSE 30,A01,083084,Eldon; John,3,10,80,77
1656062948418,CSE 30,B01,095061,Bhaskar; Nishant,4,5,50,46
1656062954447,CSE 100,A01,083659,Cao; Yingjun,2,23,70,68
1656062960475,CSE 134B,A01,083661,Powell; Thomas Allan,11,6,100,89
1656062966508,CSE 140,A01,083663,Gungor; Onat,9,0,85,76
1656062972554,CSE 140L,A01,083088,Eldon; John,8,0,100,92
1656062978579,CSE 175,A01,083665,Kumar; Rakesh,2,0,25,23
1656062984614,CSE 190,A00,092507,Dubnov; Shlomo,3,0,20,17
1656062990645,ECE 45,A01,083139,Congero; Spencer William,5,2,75,70
1656062996681,ECE 65,A50,083695,Saad; Andrew S,8,0,30,22
1656062996681,ECE 65,A51,095125,Staff,23,0,26,3
1656063002719,ECE 109,A01,091882,Touri; Behrouz,5,4,70,65
1656063008745,ECE 180,A00,083140,Abi Samra; Nicholas Camill,1,0,30,29
1656063008745,ECE 180,B00,083141,Abi Samra; Nicholas Camill,2,8,28,26
1656063014772,MATH 10A,A01,083735,Patchell; Gregory David,1,0,30,29
1656063014772,MATH 10A,A02,083736,Patchell; Gregory David,23,0,30,7
1656063014772,MATH 10A,A03,083737,Patchell; Gregory David,16,0,30,14
1656063020800,MATH 10B,A01,083207,Lim; Seonhee,3,1,34,31
1656063020800,MATH 10B,A02,083208,Lim; Seonhee,10,1,35,25
1656063020800,MATH 10B,A03,093472,Staff,4,1,34,30
1656063020800,MATH 10B,B01,083739,Sinha; Shubham,12,0,30,18
1656063026828,MATH 18,A01,083743,Cinel; Cameron Alexander,7,0,30,23
1656063026828,MATH 18,A02,083744,Cinel; Cameron Alexander,12,0,30,18
1656063026828,MATH 18,A03,083745,Cinel; Cameron Alexander,3,0,30,27
1656063026828,MATH 18,B01,083748,Ma; Zilu,1,0,36,35
1656063026828,MATH 18,B02,083749,Ma; Zilu,2,0,36,34
1656063026828,MATH 18,B03,083750,Ma; Zilu,0,0,36,36
1656063026828,MATH 18,B04,083751,Ma; Zilu,1,0,36,35
1656063026828,MATH 18,B05,093473,Staff,3,0,36,33
1656063026828,MATH 18,B06,093474,Staff,4,0,36,32
1656063033000,MATH 20A,A01,083754,Zheng; Zequn,12,0,40,28
1656063039026,MATH 20B,A01,083756,Briones; Jor-el Thomas Caparas,0,0,36,36
1656063039026,MATH 20B,A02,083757,Briones; Jor-el Thomas Caparas,3,0,36,33
1656063039026,MATH 20B,A03,093475,Staff,3,0,36,33
1656063045049,MATH 20C,A01,083760,Briones; Jor-el Thomas Caparas,2,2,35,33
1656063045049,MATH 20C,A02,083761,Briones; Jor-el Thomas Caparas,9,1,35,26
1656063045049,MATH 20C,A03,093476,Staff,1,1,35,34
1656063045049,MATH 20C,B01,083762,Bach; Quang Tran,5,0,30,25
1656063051073,MATH 20D,A01,083765,Tran; Brian Kha,3,0,30,27
1656063051073,MATH 20D,A02,083766,Tran; Brian Kha,0,1,30,30
1656063051073,MATH 20D,A03,083767,Tran; Brian Kha,2,0,30,28
1656063057098,MATH 20E,A01,083771,Ganguly; Soumya,4,1,32,28
1656063057098,MATH 20E,A02,083772,Ganguly; Soumya,2,1,32,30
1656063057098,MATH 20E,B01,083773,Ciotti; Benjamin,15,0,35,20
1656063057098,MATH 20E,B02,083774,Ciotti; Benjamin,15,0,35,20
1656063063144,MATH 103A,A01,083777,Greenfeld; Be'Eri,3,0,36,33
1656063063144,MATH 103A,A02,083778,Greenfeld; Be'Eri,3,0,36,33
1656063063144,MATH 103A,A03,093561,Staff,4,1,36,32
1656063063144,MATH 103A,B01,083779,Greenfeld; Be'Eri,8,1,36,28
1656063063144,MATH 103A,B02,083780,Greenfeld; Be'Eri,1,0,36,35
1656063063144,MATH 103A,B03,093562,Staff,1,0,36,35
1656063069168,MATH 105,A01,085443,Carter; Anne Toulson,4,1,35,31
1656063069168,MATH 105,A02,093477,Staff,12,0,35,23
1656063075199,MATH 109,A01,083213,Ganzberger; Geoffrey Michael,1,1,34,33
1656063075199,MATH 109,A02,083214,Ganzberger; Geoffrey Michael,0,0,34,34
1656063075199,MATH 109,A03,093478,Staff,3,0,34,31
1656063075199,MATH 109,B01,083215,Ganzberger; Geoffrey Michael,4,0,32,28
1656063075199,MATH 109,B02,083216,Ganzberger; Geoffrey Michael,1,0,32,31
1656063075199,MATH 109,B03,093479,Staff,4,0,32,28
1656063081225,MATH 142A,A01,083219,Chow; Bennett,2,0,32,30
1656063081225,MATH 142A,A02,083220,Chow; Bennett,8,0,32,24
1656063081225,MATH 142A,A03,093480,Staff,5,0,32,27
1656063081225,MATH 142A,B03,093481,Staff,5,0,32,27
1656063081225,MATH 142A,B04,093558,Staff,7,0,32,25
1656063081225,MATH 142A,B05,093559,Staff,0,0,32,32
1656063087254,MATH 193A,A01,083224,Rotar; Vladimir,1,2,34,33
1656063087254,MATH 193A,A02,083225,Rotar; Vladimir,3,0,34,31
1656063087254,MATH 193A,A03,083781,Rotar; Vladimir,3,0,34,31
1656063087254,MATH 193A,A04,083782,Rotar; Vladimir,7,0,34,27
1656063087254,MATH 193A,A05,093482,Rotar; Vladimir,1,0,34,33
1656063093296,MATH 197,001,091859,McAuley; Julian John,9999,0,9999,0
1656063093296,MATH 197,002,095566,Kedlaya; Kiran S.,9997,0,9999,2
1656063093296,MATH 197,003,095567,Xiao; Ming,9999,0,9999,0
1656063093296,MATH 197,004,095571,Perols; Johan Lars,9998,0,9999,1
1656063100378,COGS 9,A01,083615,Shannon; Kyle Michael,4,1,75,71
1656063106410,COGS 11,A01,083617,Boyle; Mary E. T.,16,1,48,32
1656063112437,COGS 13,A01,083071,Bastos; Amalia Pinkusfeld,8,2,71,63
1656063118460,COGS 14A,A01,092681,Semenuks; Arturs,8,23,100,92
1656063124499,COGS 14B,A01,083073,Cheng; Tzu-Han,9,0,63,54
1656063130523,COGS 17,A01,092677,Semenuks; Arturs,13,5,81,68
1656063136555,COGS 100,A01,083619,Allen; Michael Gordon,8,1,70,62
1656063142606,COGS 101A,A01,083621,Davis; Joshua Daniel,7,3,68,61
1656063148653,COGS 101B,A01,091572,Allen; Michael Gordon,7,0,65,58
1656063154683,COGS 101C,A01,083625,Delgado; Tania,11,0,35,24
1656063160713,COGS 107A,A01,083627,Boyle; Mary E. T.,5,2,60,55
1656063166748,COGS 118A,A01,083075,Gupta; Anjum,24,16,76,52
1656063172774,CSE 3,A50,083646,Miranda; Gregory Joseph,20,0,50,30
1656063178812,CSE 8A,A50,083650,Miranda; Gregory Joseph,13,11,56,43
1656063184836,CSE 11,A01,083080,Cao; Yingjun,1,60,40,39
1656063190867,CSE 12,A01,083652,Krause-Levy; Sophia Louisa,14,7,120,106
1656063196895,CSE 15L,A01,083654,Morris; Justin Loren,5,1,50,45
1656063196895,CSE 15L,A02,083655,Morris; Justin Loren,7,0,50,43
1656063202920,CSE 20,A01,083657,Tran; Khoa Dang,31,0,80,49
1656063208959,CSE 21,A01,095574,Bach; Quang Tran,28,0,48,20
1656063215062,CSE 30,A01,083084,Eldon; John,3,10,80,77
1656063215062,CSE 30,B01,095061,Bhaskar; Nishant,4,5,50,46
1656063221086,CSE 100,A01,083659,Cao; Yingjun,2,23,70,68
1656063227116,CSE 134B,A01,083661,Powell; Thomas Allan,11,6,100,89
1656063233153,CSE 140,A01,083663,Gungor; Onat,9,0,85,76
1656063239175,CSE 140L,A01,083088,Eldon; John,8,0,100,92
1656063245215,CSE 175,A01,083665,Kumar; Rakesh,2,0,25,23
1656063251238,CSE 190,A00,092507,Dubnov; Shlomo,3,0,20,17
1656063257274,ECE 45,A01,083139,Congero; Spencer William,5,2,75,70
1656063263298,ECE 65,A50,083695,Saad; Andrew S,8,0,30,22
1656063263298,ECE 65,A51,095125,Staff,23,0,26,3
1656063269328,ECE 109,A01,091882,Touri; Behrouz,5,4,70,65
1656063275362,ECE 180,A00,083140,Abi Samra; Nicholas Camill,1,0,30,29
1656063275362,ECE 180,B00,083141,Abi Samra; Nicholas Camill,2,8,28,26
1656063281407,MATH 10A,A01,083735,Patchell; Gregory David,1,0,30,29
1656063281407,MATH 10A,A02,083736,Patchell; Gregory David,23,0,30,7
1656063281407,MATH 10A,A03,083737,Patchell; Gregory David,16,0,30,14
1656063287453,MATH 10B,A01,083207,Lim; Seonhee,3,1,34,31
1656063287453,MATH 10B,A02,083208,Lim; Seonhee,10,1,35,25
1656063287453,MATH 10B,A03,093472,Staff,4,1,34,30
1656063287453,MATH 10B,B01,083739,Sinha; Shubham,12,0,30,18
1656063293489,MATH 18,A01,083743,Cinel; Cameron Alexander,7,0,30,23
1656063293489,MATH 18,A02,083744,Cinel; Cameron Alexander,12,0,30,18
1656063293489,MATH 18,A03,083745,Cinel; Cameron Alexander,3,0,30,27
1656063293489,MATH 18,B01,083748,Ma; Zilu,1,0,36,35
1656063293489,MATH 18,B02,083749,Ma; Zilu,2,0,36,34
1656063293489,MATH 18,B03,083750,Ma; Zilu,0,0,36,36
1656063293489,MATH 18,B04,083751,Ma; Zilu,1,0,36,35
1656063293489,MATH 18,B05,093473,Staff,3,0,36,33
1656063293489,MATH 18,B06,093474,Staff,4,0,36,32
1656063299513,MATH 20A,A01,083754,Zheng; Zequn,12,0,40,28
1656063305557,MATH 20B,A01,083756,Briones; Jor-el Thomas Caparas,0,0,36,36
1656063305557,MATH 20B,A02,083757,Briones; Jor-el Thomas Caparas,3,0,36,33
1656063305557,MATH 20B,A03,093475,Staff,3,0,36,33
1656063311598,MATH 20C,A01,083760,Briones; Jor-el Thomas Caparas,2,2,35,33
1656063311598,MATH 20C,A02,083761,Briones; Jor-el Thomas Caparas,9,1,35,26
1656063311598,MATH 20C,A03,093476,Staff,1,1,35,34
1656063311598,MATH 20C,B01,083762,Bach; Quang Tran,5,0,30,25
1656063317639,MATH 20D,A01,083765,Tran; Brian Kha,3,0,30,27
1656063317639,MATH 20D,A02,083766,Tran; Brian Kha,0,1,30,30
1656063317639,MATH 20D,A03,083767,Tran; Brian Kha,2,0,30,28
1656063323676,MATH 20E,A01,083771,Ganguly; Soumya,4,1,32,28
1656063323676,MATH 20E,A02,083772,Ganguly; Soumya,2,1,32,30
1656063323676,MATH 20E,B01,083773,Ciotti; Benjamin,15,0,35,20
1656063323676,MATH 20E,B02,083774,Ciotti; Benjamin,15,0,35,20
1656063329711,MATH 103A,A01,083777,Greenfeld; Be'Eri,3,0,36,33
1656063329711,MATH 103A,A02,083778,Greenfeld; Be'Eri,3,0,36,33
1656063329711,MATH 103A,A03,093561,Staff,4,1,36,32
1656063329711,MATH 103A,B01,083779,Greenfeld; Be'Eri,8,1,36,28
1656063329711,MATH 103A,B02,083780,Greenfeld; Be'Eri,1,0,36,35
1656063329711,MATH 103A,B03,093562,Staff,1,0,36,35
1656063335739,MATH 105,A01,085443,Carter; Anne Toulson,4,1,35,31
1656063335739,MATH 105,A02,093477,Staff,12,0,35,23
1656063341776,MATH 109,A01,083213,Ganzberger; Geoffrey Michael,1,1,34,33
1656063341776,MATH 109,A02,083214,Ganzberger; Geoffrey Michael,0,0,34,34
1656063341776,MATH 109,A03,093478,Staff,3,0,34,31
1656063341776,MATH 109,B01,083215,Ganzberger; Geoffrey Michael,4,0,32,28
1656063341776,MATH 109,B02,083216,Ganzberger; Geoffrey Michael,1,0,32,31
1656063341776,MATH 109,B03,093479,Staff,4,0,32,28
1656063347819,MATH 142A,A01,083219,Chow; Bennett,2,0,32,30
1656063347819,MATH 142A,A02,083220,Chow; Bennett,8,0,32,24
1656063347819,MATH 142A,A03,093480,Staff,5,0,32,27
1656063347819,MATH 142A,B03,093481,Staff,5,0,32,27
1656063347819,MATH 142A,B04,093558,Staff,7,0,32,25
1656063347819,MATH 142A,B05,093559,Staff,0,0,32,32
1656063353849,MATH 193A,A01,083224,Rotar; Vladimir,1,2,34,33
1656063353849,MATH 193A,A02,083225,Rotar; Vladimir,3,0,34,31
1656063353849,MATH 193A,A03,083781,Rotar; Vladimir,3,0,34,31
1656063353849,MATH 193A,A04,083782,Rotar; Vladimir,7,0,34,27
1656063353849,MATH 193A,A05,093482,Rotar; Vladimir,1,0,34,33
1656063359876,MATH 197,001,091859,McAuley; Julian John,9999,0,9999,0
1656063359876,MATH 197,002,095566,Kedlaya; Kiran S.,9997,0,9999,2
1656063359876,MATH 197,003,095567,Xiao; Ming,9999,0,9999,0
1656063359876,MATH 197,004,095571,Perols; Johan Lars,9998,0,9999,1
1656063366978,COGS 9,A01,083615,Shannon; Kyle Michael,4,1,75,71
1656063373010,COGS 11,A01,083617,Boyle; Mary E. T.,16,1,48,32
1656063379034,COGS 13,A01,083071,Bastos; Amalia Pinkusfeld,8,2,71,63
1656063385080,COGS 14A,A01,092681,Semenuks; Arturs,8,23,100,92
1656063391107,COGS 14B,A01,083073,Cheng; Tzu-Han,9,0,63,54
1656063397149,COGS 17,A01,092677,Semenuks; Arturs,13,5,81,68
1656063403201,COGS 100,A01,083619,Allen; Michael Gordon,8,1,70,62
1656063409237,COGS 101A,A01,083621,Davis; Joshua Daniel,7,3,68,61
1656063415271,COGS 101B,A01,091572,Allen; Michael Gordon,7,0,65,58
1656063421297,COGS 101C,A01,083625,Delgado; Tania,11,0,35,24
1656063427320,COGS 107A,A01,083627,Boyle; Mary E. T.,5,2,60,55
1656063433360,COGS 118A,A01,083075,Gupta; Anjum,24,16,76,52
1656063439388,CSE 3,A50,083646,Miranda; Gregory Joseph,20,0,50,30
1656063445421,CSE 8A,A50,083650,Miranda; Gregory Joseph,13,11,56,43
1656063451454,CSE 11,A01,083080,Cao; Yingjun,1,60,40,39
1656063457476,CSE 12,A01,083652,Krause-Levy; Sophia Louisa,14,7,120,106
1656063463518,CSE 15L,A01,083654,Morris; Justin Loren,5,1,50,45
1656063463518,CSE 15L,A02,083655,Morris; Justin Loren,7,0,50,43
1656063469562,CSE 20,A01,083657,Tran; Khoa Dang,31,0,80,49
1656063475587,CSE 21,A01,095574,Bach; Quang Tran,28,0,48,20
1656063481615,CSE 30,A01,083084,Eldon; John,3,10,80,77
1656063481615,CSE 30,B01,095061,Bhaskar; Nishant,4,5,50,46
1656063487641,CSE 100,A01,083659,Cao; Yingjun,2,23,70,68
1656063493677,CSE 134B,A01,083661,Powell; Thomas Allan,11,6,100,89
1656063499700,CSE 140,A01,083663,Gungor; Onat,9,0,85,76
1656063505734,CSE 140L,A01,083088,Eldon; John,8,0,100,92
1656063511758,CSE 175,A01,083665,Kumar; Rakesh,2,0,25,23
1656063517784,CSE 190,A00,092507,Dubnov; Shlomo,3,0,20,17
1656063523815,ECE 45,A01,083139,Congero; Spencer William,5,2,75,70
1656063529854,ECE 65,A50,083695,Saad; Andrew S,8,0,30,22
1656063529854,ECE 65,A51,095125,Staff,23,0,26,3
1656063535894,ECE 109,A01,091882,Touri; Behrouz,5,4,70,65
1656063541925,ECE 180,A00,083140,Abi Samra; Nicholas Camill,1,0,30,29
1656063541925,ECE 180,B00,083141,Abi Samra; Nicholas Camill,2,8,28,26
1656063547954,MATH 10A,A01,083735,Patchell; Gregory David,1,0,30,29
1656063547954,MATH 10A,A02,083736,Patchell; Gregory David,23,0,30,7
1656063547954,MATH 10A,A03,083737,Patchell; Gregory David,16,0,30,14
1656063553993,MATH 10B,A01,083207,Lim; Seonhee,3,1,34,31
1656063553993,MATH 10B,A02,083208,Lim; Seonhee,10,1,35,25
1656063553993,MATH 10B,A03,093472,Staff,4,1,34,30
1656063553993,MATH 10B,B01,083739,Sinha; Shubham,12,0,30,18
1656063560042,MATH 18,A01,083743,Cinel; Cameron Alexander,7,0,30,23
1656063560042,MATH 18,A02,083744,Cinel; Cameron Alexander,12,0,30,18
1656063560042,MATH 18,A03,083745,Cinel; Cameron Alexander,3,0,30,27
1656063560042,MATH 18,B01,083748,Ma; Zilu,1,0,36,35
1656063560042,MATH 18,B02,083749,Ma; Zilu,2,0,36,34
1656063560042,MATH 18,B03,083750,Ma; Zilu,0,0,36,36
1656063560042,MATH 18,B04,083751,Ma; Zilu,1,0,36,35
1656063560042,MATH 18,B05,093473,Staff,3,0,36,33
1656063560042,MATH 18,B06,093474,Staff,4,0,36,32
1656063566069,MATH 20A,A01,083754,Zheng; Zequn,12,0,40,28
1656063572093,MATH 20B,A01,083756,Briones; Jor-el Thomas Caparas,0,0,36,36
1656063572093,MATH 20B,A02,083757,Briones; Jor-el Thomas Caparas,3,0,36,33
1656063572093,MATH 20B,A03,093475,Staff,3,0,36,33
1656063578129,MATH 20C,A01,083760,Briones; Jor-el Thomas Caparas,2,2,35,33
1656063578129,MATH 20C,A02,083761,Briones; Jor-el Thomas Caparas,9,1,35,26
1656063578129,MATH 20C,A03,093476,Staff,1,1,35,34
1656063578129,MATH 20C,B01,083762,Bach; Quang Tran,5,0,30,25
1656063584159,MATH 20D,A01,083765,Tran; Brian Kha,3,0,30,27
1656063584159,MATH 20D,A02,083766,Tran; Brian Kha,0,1,30,30
1656063584159,MATH 20D,A03,083767,Tran; Brian Kha,2,0,30,28
1656063590188,MATH 20E,A01,083771,Ganguly; Soumya,4,1,32,28
1656063590188,MATH 20E,A02,083772,Ganguly; Soumya,2,1,32,30
1656063590188,MATH 20E,B01,083773,Ciotti; Benjamin,15,0,35,20
1656063590188,MATH 20E,B02,083774,Ciotti; Benjamin,15,0,35,20
1656063596211,MATH 103A,A01,083777,Greenfeld; Be'Eri,3,0,36,33
1656063596211,MATH 103A,A02,083778,Greenfeld; Be'Eri,3,0,36,33
1656063596211,MATH 103A,A03,093561,Staff,4,1,36,32
1656063596211,MATH 103A,B01,083779,Greenfeld; Be'Eri,8,1,36,28
1656063596211,MATH 103A,B02,083780,Greenfeld; Be'Eri,1,0,36,35
1656063596211,MATH 103A,B03,093562,Staff,1,0,36,35
1656063602246,MATH 105,A01,085443,Carter; Anne Toulson,4,1,35,31
1656063602246,MATH 105,A02,093477,Staff,12,0,35,23
1656063608289,MATH 109,A01,083213,Ganzberger; Geoffrey Michael,1,1,34,33
1656063608289,MATH 109,A02,083214,Ganzberger; Geoffrey Michael,0,0,34,34
1656063608289,MATH 109,A03,093478,Staff,3,0,34,31
1656063608289,MATH 109,B01,083215,Ganzberger; Geoffrey Michael,4,0,32,28
1656063608289,MATH 109,B02,083216,Ganzberger; Geoffrey Michael,1,0,32,31
1656063608289,MATH 109,B03,093479,Staff,4,0,32,28
1656063614323,MATH 142A,A01,083219,Chow; Bennett,2,0,32,30
1656063614323,MATH 142A,A02,083220,Chow; Bennett,8,0,32,24
1656063614323,MATH 142A,A03,093480,Staff,5,0,32,27
1656063614323,MATH 142A,B03,093481,Staff,5,0,32,27
1656063614323,MATH 142A,B04,093558,Staff,7,0,32,25
1656063614323,MATH 142A,B05,093559,Staff,0,0,32,32
1656063620358,MATH 193A,A01,083224,Rotar; Vladimir,1,2,34,33
1656063620358,MATH 193A,A02,083225,Rotar; Vladimir,3,0,34,31
1656063620358,MATH 193A,A03,083781,Rotar; Vladimir,3,0,34,31
1656063620358,MATH 193A,A04,083782,Rotar; Vladimir,7,0,34,27
1656063620358,MATH 193A,A05,093482,Rotar; Vladimir,1,0,34,33
1656063626385,MATH 197,001,091859,McAuley; Julian John,9999,0,9999,0
1656063626385,MATH 197,002,095566,Kedlaya; Kiran S.,9997,0,9999,2
1656063626385,MATH 197,003,095567,Xiao; Ming,9999,0,9999,0
1656063626385,MATH 197,004,095571,Perols; Johan Lars,9998,0,9999,1
1656063633454,COGS 9,A01,083615,Shannon; Kyle Michael,4,1,75,71
1656063639487,COGS 11,A01,083617,Boyle; Mary E. T.,16,1,48,32
1656063645512,COGS 13,A01,083071,Bastos; Amalia Pinkusfeld,8,2,71,63
1656063651538,COGS 14A,A01,092681,Semenuks; Arturs,8,23,100,92
1656063657561,COGS 14B,A01,083073,Cheng; Tzu-Han,9,0,63,54
1656063663594,COGS 17,A01,092677,Semenuks; Arturs,13,5,81,68
1656063669625,COGS 100,A01,083619,Allen; Michael Gordon,8,1,70,62
1656063675656,COGS 101A,A01,083621,Davis; Joshua Daniel,7,3,68,61
1656063681693,COGS 101B,A01,091572,Allen; Michael Gordon,7,0,65,58
1656063687741,COGS 101C,A01,083625,Delgado; Tania,11,0,35,24
1656063693765,COGS 107A,A01,083627,Boyle; Mary E. T.,5,2,60,55
1656063699807,COGS 118A,A01,083075,Gupta; Anjum,24,16,76,52
1656063705836,CSE 3,A50,083646,Miranda; Gregory Joseph,20,0,50,30
1656063711863,CSE 8A,A50,083650,Miranda; Gregory Joseph,13,11,56,43
1656063717895,CSE 11,A01,083080,Cao; Yingjun,1,60,40,39
1656063723934,CSE 12,A01,083652,Krause-Levy; Sophia Louisa,14,7,120,106
1656063729958,CSE 15L,A01,083654,Morris; Justin Loren,5,1,50,45
1656063729958,CSE 15L,A02,083655,Morris; Justin Loren,7,0,50,43
1656063735986,CSE 20,A01,083657,Tran; Khoa Dang,31,0,80,49
1656063742013,CSE 21,A01,095574,Bach; Quang Tran,28,0,48,20
1656063748048,CSE 30,A01,083084,Eldon; John,3,10,80,77
1656063748048,CSE 30,B01,095061,Bhaskar; Nishant,4,5,50,46
1656063754082,CSE 100,A01,083659,Cao; Yingjun,2,23,70,68
1656063760105,CSE 134B,A01,083661,Powell; Thomas Allan,11,6,100,89
1656063766132,CSE 140,A01,083663,Gungor; Onat,9,0,85,76
1656063772159,CSE 140L,A01,083088,Eldon; John,8,0,100,92
1656063778184,CSE 175,A01,083665,Kumar; Rakesh,2,0,25,23
1656063784210,CSE 190,A00,092507,Dubnov; Shlomo,3,0,20,17
1656063790239,ECE 45,A01,083139,Congero; Spencer William,5,2,75,70
1656063796281,ECE 65,A50,083695,Saad; Andrew S,8,0,30,22
1656063796281,ECE 65,A51,095125,Staff,23,0,26,3
1656063802307,ECE 109,A01,091882,Touri; Behrouz,5,4,70,65
1656063808331,ECE 180,A00,083140,Abi Samra; Nicholas Camill,1,0,30,29
1656063808331,ECE 180,B00,083141,Abi Samra; Nicholas Camill,2,8,28,26
1656063814426,MATH 10A,A01,083735,Patchell; Gregory David,1,0,30,29
1656063814426,MATH 10A,A02,083736,Patchell; Gregory David,23,0,30,7
1656063814426,MATH 10A,A03,083737,Patchell; Gregory David,16,0,30,14
1656063820461,MATH 10B,A01,083207,Lim; Seonhee,3,1,34,31
1656063820461,MATH 10B,A02,083208,Lim; Seonhee,10,1,35,25
1656063820461,MATH 10B,A03,093472,Staff,4,1,34,30
1656063820461,MATH 10B,B01,083739,Sinha; Shubham,12,0,30,18
1656063826504,MATH 18,A01,083743,Cinel; Cameron Alexander,7,0,30,23
1656063826504,MATH 18,A02,083744,Cinel; Cameron Alexander,12,0,30,18
1656063826504,MATH 18,A03,083745,Cinel; Cameron Alexander,3,0,30,27
1656063826504,MATH 18,B01,083748,Ma; Zilu,1,0,36,35
1656063826504,MATH 18,B02,083749,Ma; Zilu,2,0,36,34
1656063826504,MATH 18,B03,083750,Ma; Zilu,0,0,36,36
1656063826504,MATH 18,B04,083751,Ma; Zilu,1,0,36,35
1656063826504,MATH 18,B05,093473,Staff,3,0,36,33
1656063826504,MATH 18,B06,093474,Staff,4,0,36,32
1656063832539,MATH 20A,A01,083754,Zheng; Zequn,12,0,40,28
1656063838563,MATH 20B,A01,083756,Briones; Jor-el Thomas Caparas,0,0,36,36
1656063838563,MATH 20B,A02,083757,Briones; Jor-el Thomas Caparas,3,0,36,33
1656063838563,MATH 20B,A03,093475,Staff,3,0,36,33
1656063844587,MATH 20C,A01,083760,Briones; Jor-el Thomas Caparas,2,2,35,33
1656063844587,MATH 20C,A02,083761,Briones; Jor-el Thomas Caparas,9,1,35,26
1656063844587,MATH 20C,A03,093476,Staff,1,1,35,34
1656063844587,MATH 20C,B01,083762,Bach; Quang Tran,5,0,30,25
1656063850634,MATH 20D,A01,083765,Tran; Brian Kha,3,0,30,27
1656063850634,MATH 20D,A02,083766,Tran; Brian Kha,0,1,30,30
1656063850634,MATH 20D,A03,083767,Tran; Brian Kha,2,0,30,28
1656063856658,MATH 20E,A01,083771,Ganguly; Soumya,4,1,32,28
1656063856658,MATH 20E,A02,083772,Ganguly; Soumya,2,1,32,30
1656063856658,MATH 20E,B01,083773,Ciotti; Benjamin,15,0,35,20
1656063856658,MATH 20E,B02,083774,Ciotti; Benjamin,15,0,35,20
1656063862702,MATH 103A,A01,083777,Greenfeld; Be'Eri,3,0,36,33
1656063862702,MATH 103A,A02,083778,Greenfeld; Be'Eri,3,0,36,33
1656063862702,MATH 103A,A03,093561,Staff,4,1,36,32
1656063862702,MATH 103A,B01,083779,Greenfeld; Be'Eri,8,1,36,28
1656063862702,MATH 103A,B02,083780,Greenfeld; Be'Eri,1,0,36,35
1656063862702,MATH 103A,B03,093562,Staff,1,0,36,35
1656063868746,MATH 105,A01,085443,Carter; Anne Toulson,4,1,35,31
1656063868746,MATH 105,A02,093477,Staff,12,0,35,23
1656063874771,MATH 109,A01,083213,Ganzberger; Geoffrey Michael,1,1,34,33
1656063874771,MATH 109,A02,083214,Ganzberger; Geoffrey Michael,0,0,34,34
1656063874771,MATH 109,A03,093478,Staff,3,0,34,31
1656063874771,MATH 109,B01,083215,Ganzberger; Geoffrey Michael,4,0,32,28
1656063874771,MATH 109,B02,083216,Ganzberger; Geoffrey Michael,1,0,32,31
1656063874771,MATH 109,B03,093479,Staff,4,0,32,28
1656063880797,MATH 142A,A01,083219,Chow; Bennett,2,0,32,30
1656063880797,MATH 142A,A02,083220,Chow; Bennett,8,0,32,24
1656063880797,MATH 142A,A03,093480,Staff,5,0,32,27
1656063880797,MATH 142A,B03,093481,Staff,5,0,32,27
1656063880797,MATH 142A,B04,093558,Staff,7,0,32,25
1656063880797,MATH 142A,B05,093559,Staff,0,0,32,32
1656063886835,MATH 193A,A01,083224,Rotar; Vladimir,1,2,34,33
1656063886835,MATH 193A,A02,083225,Rotar; Vladimir,3,0,34,31
1656063886835,MATH 193A,A03,083781,Rotar; Vladimir,3,0,34,31
1656063886835,MATH 193A,A04,083782,Rotar; Vladimir,7,0,34,27
1656063886835,MATH 193A,A05,093482,Rotar; Vladimir,1,0,34,33
1656063892860,MATH 197,001,091859,McAuley; Julian John,9999,0,9999,0
1656063892860,MATH 197,002,095566,Kedlaya; Kiran S.,9997,0,9999,2
1656063892860,MATH 197,003,095567,Xiao; Ming,9999,0,9999,0
1656063892860,MATH 197,004,095571,Perols; Johan Lars,9998,0,9999,1
1656063899934,COGS 9,A01,083615,Shannon; Kyle Michael,4,1,75,71
1656063905957,COGS 11,A01,083617,Boyle; Mary E. T.,16,1,48,32
1656063911984,COGS 13,A01,083071,Bastos; Amalia Pinkusfeld,8,2,71,63
1656063918007,COGS 14A,A01,092681,Semenuks; Arturs,8,23,100,92
1656063924031,COGS 14B,A01,083073,Cheng; Tzu-Han,9,0,63,54
1656063930056,COGS 17,A01,092677,Semenuks; Arturs,13,5,81,68
1656063936099,COGS 100,A01,083619,Allen; Michael Gordon,8,1,70,62
1656063942134,COGS 101A,A01,083621,Davis; Joshua Daniel,7,3,68,61
1656063948168,COGS 101B,A01,091572,Allen; Michael Gordon,7,0,65,58
1656063954194,COGS 101C,A01,083625,Delgado; Tania,11,0,35,24
1656063960230,COGS 107A,A01,083627,Boyle; Mary E. T.,5,2,60,55
1656063966274,COGS 118A,A01,083075,Gupta; Anjum,24,16,76,52
1656063972299,CSE 3,A50,083646,Miranda; Gregory Joseph,20,0,50,30
1656063978323,CSE 8A,A50,083650,Miranda; Gregory Joseph,13,11,56,43
1656063984365,CSE 11,A01,083080,Cao; Yingjun,1,60,40,39
1656063990394,CSE 12,A01,083652,Krause-Levy; Sophia Louisa,14,7,120,106
1656063996427,CSE 15L,A01,083654,Morris; Justin Loren,5,1,50,45
1656063996427,CSE 15L,A02,083655,Morris; Justin Loren,7,0,50,43
1656064002452,CSE 20,A01,083657,Tran; Khoa Dang,31,0,80,49
1656064008477,CSE 21,A01,095574,Bach; Quang Tran,28,0,48,20
1656064014509,CSE 30,A01,083084,Eldon; John,3,10,80,77
1656064014509,CSE 30,B01,095061,Bhaskar; Nishant,4,5,50,46
1656064020537,CSE 100,A01,083659,Cao; Yingjun,2,23,70,68
1656064026572,CSE 134B,A01,083661,Powell; Thomas Allan,11,6,100,89
1656064032604,CSE 140,A01,083663,Gungor; Onat,9,0,85,76
1656064038630,CSE 140L,A01,083088,Eldon; John,8,0,100,92
1656064044655,CSE 175,A01,083665,Kumar; Rakesh,2,0,25,23
1656064050690,CSE 190,A00,092507,Dubnov; Shlomo,3,0,20,17
1656064056719,ECE 45,A01,083139,Congero; Spencer William,5,2,75,70
1656064062746,ECE 65,A50,083695,Saad; Andrew S,8,0,30,22
1656064062746,ECE 65,A51,095125,Staff,23,0,26,3
1656064068774,ECE 109,A01,091882,Touri; Behrouz,5,4,70,65
1656064074810,ECE 180,A00,083140,Abi Samra; Nicholas Camill,1,0,30,29
1656064074810,ECE 180,B00,083141,Abi Samra; Nicholas Camill,2,8,28,26
1656064080834,MATH 10A,A01,083735,Patchell; Gregory David,1,0,30,29
1656064080834,MATH 10A,A02,083736,Patchell; Gregory David,23,0,30,7
1656064080834,MATH 10A,A03,083737,Patchell; Gregory David,16,0,30,14
1656064086869,MATH 10B,A01,083207,Lim; Seonhee,3,1,34,31
1656064086869,MATH 10B,A02,083208,Lim; Seonhee,10,1,35,25
1656064086869,MATH 10B,A03,093472,Staff,4,1,34,30
1656064086869,MATH 10B,B01,083739,Sinha; Shubham,12,0,30,18
1656064092916,MATH 18,A01,083743,Cinel; Cameron Alexander,7,0,30,23
1656064092916,MATH 18,A02,083744,Cinel; Cameron Alexander,12,0,30,18
1656064092916,MATH 18,A03,083745,Cinel; Cameron Alexander,3,0,30,27
1656064092916,MATH 18,B01,083748,Ma; Zilu,1,0,36,35
1656064092916,MATH 18,B02,083749,Ma; Zilu,2,0,36,34
1656064092916,MATH 18,B03,083750,Ma; Zilu,0,0,36,36
1656064092916,MATH 18,B04,083751,Ma; Zilu,1,0,36,35
1656064092916,MATH 18,B05,093473,Staff,3,0,36,33
1656064092916,MATH 18,B06,093474,Staff,4,0,36,32
1656064098944,MATH 20A,A01,083754,Zheng; Zequn,12,0,40,28
1656064104972,MATH 20B,A01,083756,Briones; Jor-el Thomas Caparas,0,0,36,36
1656064104972,MATH 20B,A02,083757,Briones; Jor-el Thomas Caparas,3,0,36,33
1656064104972,MATH 20B,A03,093475,Staff,3,0,36,33
1656064111008,MATH 20C,A01,083760,Briones; Jor-el Thomas Caparas,2,2,35,33
1656064111008,MATH 20C,A02,083761,Briones; Jor-el Thomas Caparas,9,1,35,26
1656064111008,MATH 20C,A03,093476,Staff,1,1,35,34
1656064111008,MATH 20C,B01,083762,Bach; Quang Tran,5,0,30,25
1656064117032,MATH 20D,A01,083765,Tran; Brian Kha,3,0,30,27
1656064117032,MATH 20D,A02,083766,Tran; Brian Kha,0,1,30,30
1656064117032,MATH 20D,A03,083767,Tran; Brian Kha,2,0,30,28
1656064123066,MATH 20E,A01,083771,Ganguly; Soumya,4,1,32,28
1656064123066,MATH 20E,A02,083772,Ganguly; Soumya,2,1,32,30
1656064123066,MATH 20E,B01,083773,Ciotti; Benjamin,15,0,35,20
1656064123066,MATH 20E,B02,083774,Ciotti; Benjamin,15,0,35,20
1656064129090,MATH 103A,A01,083777,Greenfeld; Be'Eri,3,0,36,33
1656064129090,MATH 103A,A02,083778,Greenfeld; Be'Eri,3,0,36,33
1656064129090,MATH 103A,A03,093561,Staff,4,1,36,32
1656064129090,MATH 103A,B01,083779,Greenfeld; Be'Eri,8,1,36,28
1656064129090,MATH 103A,B02,083780,Greenfeld; Be'Eri,1,0,36,35
1656064129090,MATH 103A,B03,093562,Staff,1,0,36,35
1656064135122,MATH 105,A01,085443,Carter; Anne Toulson,4,1,35,31
1656064135122,MATH 105,A02,093477,Staff,12,0,35,23
1656064141157,MATH 109,A01,083213,Ganzberger; Geoffrey Michael,1,1,34,33
1656064141157,MATH 109,A02,083214,Ganzberger; Geoffrey Michael,0,0,34,34
1656064141157,MATH 109,A03,093478,Staff,3,0,34,31
1656064141157,MATH 109,B01,083215,Ganzberger; Geoffrey Michael,4,0,32,28
1656064141157,MATH 109,B02,083216,Ganzberger; Geoffrey Michael,1,0,32,31
1656064141157,MATH 109,B03,093479,Staff,4,0,32,28
1656064147191,MATH 142A,A01,083219,Chow; Bennett,2,0,32,30
1656064147191,MATH 142A,A02,083220,Chow; Bennett,8,0,32,24
1656064147191,MATH 142A,A03,093480,Staff,5,0,32,27
1656064147191,MATH 142A,B03,093481,Staff,5,0,32,27
1656064147191,MATH 142A,B04,093558,Staff,7,0,32,25
1656064147191,MATH 142A,B05,093559,Staff,0,0,32,32
1656064153228,MATH 193A,A01,083224,Rotar; Vladimir,1,2,34,33
1656064153228,MATH 193A,A02,083225,Rotar; Vladimir,3,0,34,31
1656064153228,MATH 193A,A03,083781,Rotar; Vladimir,3,0,34,31
1656064153228,MATH 193A,A04,083782,Rotar; Vladimir,7,0,34,27
1656064153228,MATH 193A,A05,093482,Rotar; Vladimir,1,0,34,33
1656064159258,MATH 197,001,091859,McAuley; Julian John,9999,0,9999,0
1656064159258,MATH 197,002,095566,Kedlaya; Kiran S.,9997,0,9999,2
1656064159258,MATH 197,003,095567,Xiao; Ming,9999,0,9999,0
1656064159258,MATH 197,004,095571,Perols; Johan Lars,9998,0,9999,1
1656064166361,COGS 9,A01,083615,Shannon; Kyle Michael,4,1,75,71
1656064172391,COGS 11,A01,083617,Boyle; Mary E. T.,16,1,48,32
1656064178424,COGS 13,A01,083071,Bastos; Amalia Pinkusfeld,8,2,71,63
1656064184462,COGS 14A,A01,092681,Semenuks; Arturs,8,23,100,92
1656064190501,COGS 14B,A01,083073,Cheng; Tzu-Han,9,0,63,54
1656064196539,COGS 17,A01,092677,Semenuks; Arturs,13,5,81,68
1656064202562,COGS 100,A01,083619,Allen; Michael Gordon,8,1,70,62
1656064208606,COGS 101A,A01,083621,Davis; Joshua Daniel,7,3,68,61
1656064214634,COGS 101B,A01,091572,Allen; Michael Gordon,7,0,65,58
1656064220658,COGS 101C,A01,083625,Delgado; Tania,11,0,35,24
1656064226682,COGS 107A,A01,083627,Boyle; Mary E. T.,5,2,60,55
1656064232705,COGS 118A,A01,083075,Gupta; Anjum,24,16,76,52
1656064238733,CSE 3,A50,083646,Miranda; Gregory Joseph,20,0,50,30
1656064244773,CSE 8A,A50,083650,Miranda; Gregory Joseph,13,11,56,43
1656064250807,CSE 11,A01,083080,Cao; Yingjun,1,60,40,39
1656064256832,CSE 12,A01,083652,Krause-Levy; Sophia Louisa,14,7,120,106
1656064262859,CSE 15L,A01,083654,Morris; Justin Loren,5,1,50,45
1656064262859,CSE 15L,A02,083655,Morris; Justin Loren,7,0,50,43
1656064268897,CSE 20,A01,083657,Tran; Khoa Dang,31,0,80,49
1656064274933,CSE 21,A01,095574,Bach; Quang Tran,28,0,48,20
1656064280972,CSE 30,A01,083084,Eldon; John,3,10,80,77
1656064280972,CSE 30,B01,095061,Bhaskar; Nishant,4,5,50,46
1656064287004,CSE 100,A01,083659,Cao; Yingjun,2,23,70,68
1656064293028,CSE 134B,A01,083661,Powell; Thomas Allan,11,6,100,89
1656064299054,CSE 140,A01,083663,Gungor; Onat,9,0,85,76
1656064305078,CSE 140L,A01,083088,Eldon; John,8,0,100,92
1656064311120,CSE 175,A01,083665,Kumar; Rakesh,2,0,25,23
1656064317145,CSE 190,A00,092507,Dubnov; Shlomo,3,0,20,17
1656064323196,ECE 45,A01,083139,Congero; Spencer William,5,2,75,70
1656064329227,ECE 65,A50,083695,Saad; Andrew S,8,0,30,22
1656064329227,ECE 65,A51,095125,Staff,23,0,26,3
1656064335253,ECE 109,A01,091882,Touri; Behrouz,5,4,70,65
1656064341292,ECE 180,A00,083140,Abi Samra; Nicholas Camill,1,0,30,29
1656064341292,ECE 180,B00,083141,Abi Samra; Nicholas Camill,2,8,28,26
1656064347321,MATH 10A,A01,083735,Patchell; Gregory David,1,0,30,29
1656064347321,MATH 10A,A02,083736,Patchell; Gregory David,23,0,30,7
1656064347321,MATH 10A,A03,083737,Patchell; Gregory David,16,0,30,14
1656064353365,MATH 10B,A01,083207,Lim; Seonhee,3,1,34,31
1656064353365,MATH 10B,A02,083208,Lim; Seonhee,10,1,35,25
1656064353365,MATH 10B,A03,093472,Staff,4,1,34,30
1656064353365,MATH 10B,B01,083739,Sinha; Shubham,12,0,30,18
1656064359406,MATH 18,A01,083743,Cinel; Cameron Alexander,7,0,30,23
1656064359406,MATH 18,A02,083744,Cinel; Cameron Alexander,12,0,30,18
1656064359406,MATH 18,A03,083745,Cinel; Cameron Alexander,3,0,30,27
1656064359406,MATH 18,B01,083748,Ma; Zilu,1,0,36,35
1656064359406,MATH 18,B02,083749,Ma; Zilu,2,0,36,34
1656064359406,MATH 18,B03,083750,Ma; Zilu,0,0,36,36
1656064359406,MATH 18,B04,083751,Ma; Zilu,1,0,36,35
1656064359406,MATH 18,B05,093473,Staff,3,0,36,33
1656064359406,MATH 18,B06,093474,Staff,4,0,36,32
1656064365435,MATH 20A,A01,083754,Zheng; Zequn,12,0,40,28
1656064371460,MATH 20B,A01,083756,Briones; Jor-el Thomas Caparas,0,0,36,36
1656064371460,MATH 20B,A02,083757,Briones; Jor-el Thomas Caparas,3,0,36,33
1656064371460,MATH 20B,A03,093475,Staff,3,0,36,33
1656064377483,MATH 20C,A01,083760,Briones; Jor-el Thomas Caparas,2,2,35,33
1656064377483,MATH 20C,A02,083761,Briones; Jor-el Thomas Caparas,9,1,35,26
1656064377483,MATH 20C,A03,093476,Staff,1,1,35,34
1656064377483,MATH 20C,B01,083762,Bach; Quang Tran,5,0,30,25
1656064383511,MATH 20D,A01,083765,Tran; Brian Kha,3,0,30,27
1656064383511,MATH 20D,A02,083766,Tran; Brian Kha,0,1,30,30
1656064383511,MATH 20D,A03,083767,Tran; Brian Kha,2,0,30,28
1656064389543,MATH 20E,A01,083771,Ganguly; Soumya,4,1,32,28
1656064389543,MATH 20E,A02,083772,Ganguly; Soumya,2,1,32,30
1656064389543,MATH 20E,B01,083773,Ciotti; Benjamin,15,0,35,20
1656064389543,MATH 20E,B02,083774,Ciotti; Benjamin,15,0,35,20
1656064395568,MATH 103A,A01,083777,Greenfeld; Be'Eri,3,0,36,33
1656064395568,MATH 103A,A02,083778,Greenfeld; Be'Eri,3,0,36,33
1656064395568,MATH 103A,A03,093561,Staff,4,1,36,32
1656064395568,MATH 103A,B01,083779,Greenfeld; Be'Eri,8,1,36,28
1656064395568,MATH 103A,B02,083780,Greenfeld; Be'Eri,1,0,36,35
1656064395568,MATH 103A,B03,093562,Staff,1,0,36,35
1656064401599,MATH 105,A01,085443,Carter; Anne Toulson,4,1,35,31
1656064401599,MATH 105,A02,093477,Staff,12,0,35,23
1656064407647,MATH 109,A01,083213,Ganzberger; Geoffrey Michael,1,1,34,33
1656064407647,MATH 109,A02,083214,Ganzberger; Geoffrey Michael,0,0,34,34
1656064407647,MATH 109,A03,093478,Staff,3,0,34,31
1656064407647,MATH 109,B01,083215,Ganzberger; Geoffrey Michael,4,0,32,28
1656064407647,MATH 109,B02,083216,Ganzberger; Geoffrey Michael,1,0,32,31
1656064407647,MATH 109,B03,093479,Staff,4,0,32,28
1656064413776,MATH 142A,A01,083219,Chow; Bennett,2,0,32,30
1656064413776,MATH 142A,A02,083220,Chow; Bennett,8,0,32,24
1656064413776,MATH 142A,A03,093480,Staff,5,0,32,27
1656064413776,MATH 142A,B03,093481,Staff,5,0,32,27
1656064413776,MATH 142A,B04,093558,Staff,7,0,32,25
1656064413776,MATH 142A,B05,093559,Staff,0,0,32,32
1656064419814,MATH 193A,A01,083224,Rotar; Vladimir,1,2,34,33
1656064419814,MATH 193A,A02,083225,Rotar; Vladimir,3,0,34,31
1656064419814,MATH 193A,A03,083781,Rotar; Vladimir,3,0,34,31
1656064419814,MATH 193A,A04,083782,Rotar; Vladimir,7,0,34,27
1656064419814,MATH 193A,A05,093482,Rotar; Vladimir,1,0,34,33
1656064425840,MATH 197,001,091859,McAuley; Julian John,9999,0,9999,0
1656064425840,MATH 197,002,095566,Kedlaya; Kiran S.,9997,0,9999,2
1656064425840,MATH 197,003,095567,Xiao; Ming,9999,0,9999,0
1656064425840,MATH 197,004,095571,Perols; Johan Lars,9998,0,9999,1
1656064432915,COGS 9,A01,083615,Shannon; Kyle Michael,4,1,75,71
1656064438939,COGS 11,A01,083617,Boyle; Mary E. T.,16,1,48,32
1656064444967,COGS 13,A01,083071,Bastos; Amalia Pinkusfeld,8,2,71,63
1656064450992,COGS 14A,A01,092681,Semenuks; Arturs,8,23,100,92
1656064457035,COGS 14B,A01,083073,Cheng; Tzu-Han,9,0,63,54
1656064463058,COGS 17,A01,092677,Semenuks; Arturs,13,5,81,68
1656064469091,COGS 100,A01,083619,Allen; Michael Gordon,8,1,70,62
1656064475115,COGS 101A,A01,083621,Davis; Joshua Daniel,7,3,68,61
1656064481141,COGS 101B,A01,091572,Allen; Michael Gordon,7,0,65,58
1656064487169,COGS 101C,A01,083625,Delgado; Tania,11,0,35,24
1656064493206,COGS 107A,A01,083627,Boyle; Mary E. T.,5,2,60,55
1656064499232,COGS 118A,A01,083075,Gupta; Anjum,24,16,76,52
1656064505267,CSE 3,A50,083646,Miranda; Gregory Joseph,20,0,50,30
1656064511303,CSE 8A,A50,083650,Miranda; Gregory Joseph,13,11,56,43
1656064517326,CSE 11,A01,083080,Cao; Yingjun,1,60,40,39
1656064523355,CSE 12,A01,083652,Krause-Levy; Sophia Louisa,14,7,120,106
1656064529381,CSE 15L,A01,083654,Morris; Justin Loren,5,1,50,45
1656064529381,CSE 15L,A02,083655,Morris; Justin Loren,7,0,50,43
1656064535405,CSE 20,A01,083657,Tran; Khoa Dang,31,0,80,49
1656064541442,CSE 21,A01,095574,Bach; Quang Tran,28,0,48,20
1656064547478,CSE 30,A01,083084,Eldon; John,3,10,80,77
1656064547478,CSE 30,B01,095061,Bhaskar; Nishant,4,5,50,46
1656064553510,CSE 100,A01,083659,Cao; Yingjun,2,23,70,68
1656064559545,CSE 134B,A01,083661,Powell; Thomas Allan,11,6,100,89
1656064565569,CSE 140,A01,083663,Gungor; Onat,9,0,85,76
1656064571603,CSE 140L,A01,083088,Eldon; John,8,0,100,92
1656064577633,CSE 175,A01,083665,Kumar; Rakesh,2,0,25,23
1656064583672,CSE 190,A00,092507,Dubnov; Shlomo,3,0,20,17
1656064589720,ECE 45,A01,083139,Congero; Spencer William,5,2,75,70
1656064595772,ECE 65,A50,083695,Saad; Andrew S,8,0,30,22
1656064595772,ECE 65,A51,095125,Staff,23,0,26,3
1656064601796,ECE 109,A01,091882,Touri; Behrouz,5,4,70,65
1656064607826,ECE 180,A00,083140,Abi Samra; Nicholas Camill,1,0,30,29
1656064607826,ECE 180,B00,083141,Abi Samra; Nicholas Camill,2,8,28,26
1656064613859,MATH 10A,A01,083735,Patchell; Gregory David,1,0,30,29
1656064613859,MATH 10A,A02,083736,Patchell; Gregory David,23,0,30,7
1656064613859,MATH 10A,A03,083737,Patchell; Gregory David,16,0,30,14
1656064619897,MATH 10B,A01,083207,Lim; Seonhee,3,1,34,31
1656064619897,MATH 10B,A02,083208,Lim; Seonhee,10,1,35,25
1656064619897,MATH 10B,A03,093472,Staff,4,1,34,30
1656064619897,MATH 10B,B01,083739,Sinha; Shubham,12,0,30,18
1656064625937,MATH 18,A01,083743,Cinel; Cameron Alexander,7,0,30,23
1656064625937,MATH 18,A02,083744,Cinel; Cameron Alexander,12,0,30,18
1656064625937,MATH 18,A03,083745,Cinel; Cameron Alexander,3,0,30,27
1656064625937,MATH 18,B01,083748,Ma; Zilu,1,0,36,35
1656064625937,MATH 18,B02,083749,Ma; Zilu,2,0,36,34
1656064625937,MATH 18,B03,083750,Ma; Zilu,0,0,36,36
1656064625937,MATH 18,B04,083751,Ma; Zilu,1,0,36,35
1656064625937,MATH 18,B05,093473,Staff,3,0,36,33
1656064625937,MATH 18,B06,093474,Staff,4,0,36,32
1656064631966,MATH 20A,A01,083754,Zheng; Zequn,12,0,40,28
1656064638005,MATH 20B,A01,083756,Briones; Jor-el Thomas Caparas,0,0,36,36
1656064638005,MATH 20B,A02,083757,Briones; Jor-el Thomas Caparas,3,0,36,33
1656064638005,MATH 20B,A03,093475,Staff,3,0,36,33
1656064644046,MATH 20C,A01,083760,Briones; Jor-el Thomas Caparas,2,2,35,33
1656064644046,MATH 20C,A02,083761,Briones; Jor-el Thomas Caparas,9,1,35,26
1656064644046,MATH 20C,A03,093476,Staff,1,1,35,34
1656064644046,MATH 20C,B01,083762,Bach; Quang Tran,5,0,30,25
1656064650071,MATH 20D,A01,083765,Tran; Brian Kha,3,0,30,27
1656064650071,MATH 20D,A02,083766,Tran; Brian Kha,0,1,30,30
1656064650071,MATH 20D,A03,083767,Tran; Brian Kha,2,0,30,28
1656064656097,MATH 20E,A01,083771,Ganguly; Soumya,4,1,32,28
1656064656097,MATH 20E,A02,083772,Ganguly; Soumya,2,1,32,30
1656064656097,MATH 20E,B01,083773,Ciotti; Benjamin,15,0,35,20
1656064656097,MATH 20E,B02,083774,Ciotti; Benjamin,15,0,35,20
1656064662125,MATH 103A,A01,083777,Greenfeld; Be'Eri,3,0,36,33
1656064662125,MATH 103A,A02,083778,Greenfeld; Be'Eri,3,0,36,33
1656064662125,MATH 103A,A03,093561,Staff,4,1,36,32
1656064662125,MATH 103A,B01,083779,Greenfeld; Be'Eri,8,1,36,28
1656064662125,MATH 103A,B02,083780,Greenfeld; Be'Eri,1,0,36,35
1656064662125,MATH 103A,B03,093562,Staff,1,0,36,35
1656064668157,MATH 105,A01,085443,Carter; Anne Toulson,4,1,35,31
1656064668157,MATH 105,A02,093477,Staff,12,0,35,23
1656064674182,MATH 109,A01,083213,Ganzberger; Geoffrey Michael,1,1,34,33
1656064674182,MATH 109,A02,083214,Ganzberger; Geoffrey Michael,0,0,34,34
1656064674182,MATH 109,A03,093478,Staff,3,0,34,31
1656064674182,MATH 109,B01,083215,Ganzberger; Geoffrey Michael,4,0,32,28
1656064674182,MATH 109,B02,083216,Ganzberger; Geoffrey Michael,1,0,32,31
1656064674182,MATH 109,B03,093479,Staff,4,0,32,28
1656064680214,MATH 142A,A01,083219,Chow; Bennett,2,0,32,30
1656064680214,MATH 142A,A02,083220,Chow; Bennett,8,0,32,24
1656064680214,MATH 142A,A03,093480,Staff,5,0,32,27
1656064680214,MATH 142A,B03,093481,Staff,5,0,32,27
1656064680214,MATH 142A,B04,093558,Staff,7,0,32,25
1656064680214,MATH 142A,B05,093559,Staff,0,0,32,32
1656064686253,MATH 193A,A01,083224,Rotar; Vladimir,1,2,34,33
1656064686253,MATH 193A,A02,083225,Rotar; Vladimir,3,0,34,31
1656064686253,MATH 193A,A03,083781,Rotar; Vladimir,3,0,34,31
1656064686253,MATH 193A,A04,083782,Rotar; Vladimir,7,0,34,27
1656064686253,MATH 193A,A05,093482,Rotar; Vladimir,1,0,34,33
1656064692286,MATH 197,001,091859,McAuley; Julian John,9999,0,9999,0
1656064692286,MATH 197,002,095566,Kedlaya; Kiran S.,9997,0,9999,2
1656064692286,MATH 197,003,095567,Xiao; Ming,9999,0,9999,0
1656064692286,MATH 197,004,095571,Perols; Johan Lars,9998,0,9999,1
1656064699387,COGS 9,A01,083615,Shannon; Kyle Michael,4,1,75,71
1656064705420,COGS 11,A01,083617,Boyle; Mary E. T.,16,1,48,32
1656064711444,COGS 13,A01,083071,Bastos; Amalia Pinkusfeld,8,2,71,63
1656064717469,COGS 14A,A01,092681,Semenuks; Arturs,8,23,100,92
1656064723500,COGS 14B,A01,083073,Cheng; Tzu-Han,9,0,63,54
1656064729523,COGS 17,A01,092677,Semenuks; Arturs,13,5,81,68
1656064735562,COGS 100,A01,083619,Allen; Michael Gordon,8,1,70,62
1656064741604,COGS 101A,A01,083621,Davis; Joshua Daniel,7,3,68,61
1656064747633,COGS 101B,A01,091572,Allen; Michael Gordon,7,0,65,58
1656064753661,COGS 101C,A01,083625,Delgado; Tania,11,0,35,24
1656064759695,COGS 107A,A01,083627,Boyle; Mary E. T.,5,2,60,55
1656064765721,COGS 118A,A01,083075,Gupta; Anjum,24,16,76,52
1656064771755,CSE 3,A50,083646,Miranda; Gregory Joseph,20,0,50,30
1656064777783,CSE 8A,A50,083650,Miranda; Gregory Joseph,13,11,56,43
1656064783819,CSE 11,A01,083080,Cao; Yingjun,1,60,40,39
1656064789854,CSE 12,A01,083652,Krause-Levy; Sophia Louisa,14,7,120,106
1656064795895,CSE 15L,A01,083654,Morris; Justin Loren,5,1,50,45
1656064795895,CSE 15L,A02,083655,Morris; Justin Loren,7,0,50,43
1656064801931,CSE 20,A01,083657,Tran; Khoa Dang,31,0,80,49
1656064807967,CSE 21,A01,095574,Bach; Quang Tran,28,0,48,20
1656064814007,CSE 30,A01,083084,Eldon; John,3,10,80,77
1656064814007,CSE 30,B01,095061,Bhaskar; Nishant,4,5,50,46
1656064820042,CSE 100,A01,083659,Cao; Yingjun,2,23,70,68
1656064826101,CSE 134B,A01,083661,Powell; Thomas Allan,11,6,100,89
1656064832138,CSE 140,A01,083663,Gungor; Onat,9,0,85,76
1656064838178,CSE 140L,A01,083088,Eldon; John,8,0,100,92
1656064844204,CSE 175,A01,083665,Kumar; Rakesh,2,0,25,23
1656064850247,CSE 190,A00,092507,Dubnov; Shlomo,3,0,20,17
1656064856276,ECE 45,A01,083139,Congero; Spencer William,5,2,75,70
1656064862304,ECE 65,A50,083695,Saad; Andrew S,8,0,30,22
1656064862304,ECE 65,A51,095125,Staff,23,0,26,3
1656064868340,ECE 109,A01,091882,Touri; Behrouz,5,4,70,65
1656064874384,ECE 180,A00,083140,Abi Samra; Nicholas Camill,1,0,30,29
1656064874384,ECE 180,B00,083141,Abi Samra; Nicholas Camill,2,8,28,26
1656064880413,MATH 10A,A01,083735,Patchell; Gregory David,1,0,30,29
1656064880413,MATH 10A,A02,083736,Patchell; Gregory David,23,0,30,7
1656064880413,MATH 10A,A03,083737,Patchell; Gregory David,16,0,30,14
1656064886447,MATH 10B,A01,083207,Lim; Seonhee,3,1,34,31
1656064886447,MATH 10B,A02,083208,Lim; Seonhee,10,1,35,25
1656064886447,MATH 10B,A03,093472,Staff,4,1,34,30
1656064886447,MATH 10B,B01,083739,Sinha; Shubham,12,0,30,18
1656064892498,MATH 18,A01,083743,Cinel; Cameron Alexander,7,0,30,23
1656064892498,MATH 18,A02,083744,Cinel; Cameron Alexander,12,0,30,18
1656064892498,MATH 18,A03,083745,Cinel; Cameron Alexander,3,0,30,27
1656064892498,MATH 18,B01,083748,Ma; Zilu,1,0,36,35
1656064892498,MATH 18,B02,083749,Ma; Zilu,2,0,36,34
1656064892498,MATH 18,B03,083750,Ma; Zilu,0,0,36,36
1656064892498,MATH 18,B04,083751,Ma; Zilu,1,0,36,35
1656064892498,MATH 18,B05,093473,Staff,3,0,36,33
1656064892498,MATH 18,B06,093474,Staff,4,0,36,32
1656064898530,MATH 20A,A01,083754,Zheng; Zequn,12,0,40,28
1656064904563,MATH 20B,A01,083756,Briones; Jor-el Thomas Caparas,0,0,36,36
1656064904563,MATH 20B,A02,083757,Briones; Jor-el Thomas Caparas,3,0,36,33
1656064904563,MATH 20B,A03,093475,Staff,3,0,36,33
1656064910590,MATH 20C,A01,083760,Briones; Jor-el Thomas Caparas,2,2,35,33
1656064910590,MATH 20C,A02,083761,Briones; Jor-el Thomas Caparas,9,1,35,26
1656064910590,MATH 20C,A03,093476,Staff,1,1,35,34
1656064910590,MATH 20C,B01,083762,Bach; Quang Tran,5,0,30,25
1656064916620,MATH 20D,A01,083765,Tran; Brian Kha,3,0,30,27
1656064916620,MATH 20D,A02,083766,Tran; Brian Kha,0,1,30,30
1656064916620,MATH 20D,A03,083767,Tran; Brian Kha,2,0,30,28
1656064922657,MATH 20E,A01,083771,Ganguly; Soumya,4,1,32,28
1656064922657,MATH 20E,A02,083772,Ganguly; Soumya,2,1,32,30
1656064922657,MATH 20E,B01,083773,Ciotti; Benjamin,15,0,35,20
1656064922657,MATH 20E,B02,083774,Ciotti; Benjamin,15,0,35,20
1656064928692,MATH 103A,A01,083777,Greenfeld; Be'Eri,3,0,36,33
1656064928692,MATH 103A,A02,083778,Greenfeld; Be'Eri,3,0,36,33
1656064928692,MATH 103A,A03,093561,Staff,4,1,36,32
1656064928692,MATH 103A,B01,083779,Greenfeld; Be'Eri,8,1,36,28
1656064928692,MATH 103A,B02,083780,Greenfeld; Be'Eri,1,0,36,35
1656064928692,MATH 103A,B03,093562,Staff,1,0,36,35
1656064934749,MATH 105,A01,085443,Carter; Anne Toulson,4,1,35,31
1656064934749,MATH 105,A02,093477,Staff,12,0,35,23
1656064940776,MATH 109,A01,083213,Ganzberger; Geoffrey Michael,1,1,34,33
1656064940776,MATH 109,A02,083214,Ganzberger; Geoffrey Michael,0,0,34,34
1656064940776,MATH 109,A03,093478,Staff,3,0,34,31
1656064940776,MATH 109,B01,083215,Ganzberger; Geoffrey Michael,4,0,32,28
1656064940776,MATH 109,B02,083216,Ganzberger; Geoffrey Michael,1,0,32,31
1656064940776,MATH 109,B03,093479,Staff,4,0,32,28
1656064946804,MATH 142A,A01,083219,Chow; Bennett,2,0,32,30
1656064946804,MATH 142A,A02,083220,Chow; Bennett,8,0,32,24
1656064946804,MATH 142A,A03,093480,Staff,5,0,32,27
1656064946804,MATH 142A,B03,093481,Staff,5,0,32,27
1656064946804,MATH 142A,B04,093558,Staff,7,0,32,25
1656064946804,MATH 142A,B05,093559,Staff,0,0,32,32
1656064952833,MATH 193A,A01,083224,Rotar; Vladimir,1,2,34,33
1656064952833,MATH 193A,A02,083225,Rotar; Vladimir,3,0,34,31
1656064952833,MATH 193A,A03,083781,Rotar; Vladimir,3,0,34,31
1656064952833,MATH 193A,A04,083782,Rotar; Vladimir,7,0,34,27
1656064952833,MATH 193A,A05,093482,Rotar; Vladimir,1,0,34,33
1656064958864,MATH 197,001,091859,McAuley; Julian John,9999,0,9999,0
1656064958864,MATH 197,002,095566,Kedlaya; Kiran S.,9997,0,9999,2
1656064958864,MATH 197,003,095567,Xiao; Ming,9999,0,9999,0
1656064958864,MATH 197,004,095571,Perols; Johan Lars,9998,0,9999,1
1656064965985,COGS 9,A01,083615,Shannon; Kyle Michael,4,1,75,71
1656064972032,COGS 11,A01,083617,Boyle; Mary E. T.,16,1,48,32
1656064978057,COGS 13,A01,083071,Bastos; Amalia Pinkusfeld,8,2,71,63
1656064984095,COGS 14A,A01,092681,Semenuks; Arturs,8,23,100,92
1656064990134,COGS 14B,A01,083073,Cheng; Tzu-Han,9,0,63,54
1656064996178,COGS 17,A01,092677,Semenuks; Arturs,13,5,81,68
1656065002220,COGS 100,A01,083619,Allen; Michael Gordon,8,1,70,62
1656065008343,COGS 101A,A01,083621,Davis; Joshua Daniel,7,3,68,61
1656065014389,COGS 101B,A01,091572,Allen; Michael Gordon,7,0,65,58
1656065020422,COGS 101C,A01,083625,Delgado; Tania,11,0,35,24
1656065026455,COGS 107A,A01,083627,Boyle; Mary E. T.,5,2,60,55
1656065032502,COGS 118A,A01,083075,Gupta; Anjum,24,16,76,52
1656065038538,CSE 3,A50,083646,Miranda; Gregory Joseph,20,0,50,30
1656065044568,CSE 8A,A50,083650,Miranda; Gregory Joseph,13,11,56,43
1656065050595,CSE 11,A01,083080,Cao; Yingjun,1,60,40,39
1656065056631,CSE 12,A01,083652,Krause-Levy; Sophia Louisa,14,7,120,106
1656065062677,CSE 15L,A01,083654,Morris; Justin Loren,5,1,50,45
1656065062677,CSE 15L,A02,083655,Morris; Justin Loren,7,0,50,43
1656065068714,CSE 20,A01,083657,Tran; Khoa Dang,31,0,80,49
1656065074760,CSE 21,A01,095574,Bach; Quang Tran,28,0,48,20
1656065080794,CSE 30,A01,083084,Eldon; John,3,10,80,77
1656065080794,CSE 30,B01,095061,Bhaskar; Nishant,4,5,50,46
1656065086844,CSE 100,A01,083659,Cao; Yingjun,2,23,70,68
1656065092882,CSE 134B,A01,083661,Powell; Thomas Allan,11,6,100,89
1656065098905,CSE 140,A01,083663,Gungor; Onat,9,0,85,76
1656065104935,CSE 140L,A01,083088,Eldon; John,8,0,100,92
1656065110977,CSE 175,A01,083665,Kumar; Rakesh,2,0,25,23
1656065117034,CSE 190,A00,092507,Dubnov; Shlomo,3,0,20,17
1656065123085,ECE 45,A01,083139,Congero; Spencer William,5,2,75,70
1656065129124,ECE 65,A50,083695,Saad; Andrew S,8,0,30,22
1656065129124,ECE 65,A51,095125,Staff,23,0,26,3
1656065135162,ECE 109,A01,091882,Touri; Behrouz,5,4,70,65
1656065141187,ECE 180,A00,083140,Abi Samra; Nicholas Camill,1,0,30,29
1656065141187,ECE 180,B00,083141,Abi Samra; Nicholas Camill,2,8,28,26
1656065147221,MATH 10A,A01,083735,Patchell; Gregory David,1,0,30,29
1656065147221,MATH 10A,A02,083736,Patchell; Gregory David,23,0,30,7
1656065147221,MATH 10A,A03,083737,Patchell; Gregory David,16,0,30,14
1656065153250,MATH 10B,A01,083207,Lim; Seonhee,3,1,34,31
1656065153250,MATH 10B,A02,083208,Lim; Seonhee,10,1,35,25
1656065153250,MATH 10B,A03,093472,Staff,4,1,34,30
1656065153250,MATH 10B,B01,083739,Sinha; Shubham,12,0,30,18
1656065159296,MATH 18,A01,083743,Cinel; Cameron Alexander,7,0,30,23
1656065159296,MATH 18,A02,083744,Cinel; Cameron Alexander,12,0,30,18
1656065159296,MATH 18,A03,083745,Cinel; Cameron Alexander,3,0,30,27
1656065159296,MATH 18,B01,083748,Ma; Zilu,1,0,36,35
1656065159296,MATH 18,B02,083749,Ma; Zilu,2,0,36,34
1656065159296,MATH 18,B03,083750,Ma; Zilu,0,0,36,36
1656065159296,MATH 18,B04,083751,Ma; Zilu,1,0,36,35
1656065159296,MATH 18,B05,093473,Staff,3,0,36,33
1656065159296,MATH 18,B06,093474,Staff,4,0,36,32
1656065165321,MATH 20A,A01,083754,Zheng; Zequn,12,0,40,28
1656065171349,MATH 20B,A01,083756,Briones; Jor-el Thomas Caparas,0,0,36,36
1656065171349,MATH 20B,A02,083757,Briones; Jor-el Thomas Caparas,3,0,36,33
1656065171349,MATH 20B,A03,093475,Staff,3,0,36,33
1656065177374,MATH 20C,A01,083760,Briones; Jor-el Thomas Caparas,2,2,35,33
1656065177374,MATH 20C,A02,083761,Briones; Jor-el Thomas Caparas,9,1,35,26
1656065177374,MATH 20C,A03,093476,Staff,1,1,35,34
1656065177374,MATH 20C,B01,083762,Bach; Quang Tran,5,0,30,25
1656065183409,MATH 20D,A01,083765,Tran; Brian Kha,3,0,30,27
1656065183409,MATH 20D,A02,083766,Tran; Brian Kha,0,1,30,30
1656065183409,MATH 20D,A03,083767,Tran; Brian Kha,2,0,30,28
1656065189436,MATH 20E,A01,083771,Ganguly; Soumya,4,1,32,28
1656065189436,MATH 20E,A02,083772,Ganguly; Soumya,2,1,32,30
1656065189436,MATH 20E,B01,083773,Ciotti; Benjamin,15,0,35,20
1656065189436,MATH 20E,B02,083774,Ciotti; Benjamin,15,0,35,20
1656065195466,MATH 103A,A01,083777,Greenfeld; Be'Eri,3,0,36,33
1656065195466,MATH 103A,A02,083778,Greenfeld; Be'Eri,3,0,36,33
1656065195466,MATH 103A,A03,093561,Staff,4,1,36,32
1656065195466,MATH 103A,B01,083779,Greenfeld; Be'Eri,8,1,36,28
1656065195466,MATH 103A,B02,083780,Greenfeld; Be'Eri,1,0,36,35
1656065195466,MATH 103A,B03,093562,Staff,1,0,36,35
1656065201496,MATH 105,A01,085443,Carter; Anne Toulson,4,1,35,31
1656065201496,MATH 105,A02,093477,Staff,12,0,35,23
1656065207551,MATH 109,A01,083213,Ganzberger; Geoffrey Michael,1,1,34,33
1656065207551,MATH 109,A02,083214,Ganzberger; Geoffrey Michael,0,0,34,34
1656065207551,MATH 109,A03,093478,Staff,3,0,34,31
1656065207551,MATH 109,B01,083215,Ganzberger; Geoffrey Michael,4,0,32,28
1656065207551,MATH 109,B02,083216,Ganzberger; Geoffrey Michael,1,0,32,31
1656065207551,MATH 109,B03,093479,Staff,4,0,32,28
1656065213595,MATH 142A,A01,083219,Chow; Bennett,2,0,32,30
1656065213595,MATH 142A,A02,083220,Chow; Bennett,8,0,32,24
1656065213595,MATH 142A,A03,093480,Staff,5,0,32,27
1656065213595,MATH 142A,B03,093481,Staff,5,0,32,27
1656065213595,MATH 142A,B04,093558,Staff,7,0,32,25
1656065213595,MATH 142A,B05,093559,Staff,0,0,32,32
1656065219645,MATH 193A,A01,083224,Rotar; Vladimir,1,2,34,33
1656065219645,MATH 193A,A02,083225,Rotar; Vladimir,3,0,34,31
1656065219645,MATH 193A,A03,083781,Rotar; Vladimir,3,0,34,31
1656065219645,MATH 193A,A04,083782,Rotar; Vladimir,7,0,34,27
1656065219645,MATH 193A,A05,093482,Rotar; Vladimir,1,0,34,33
1656065225964,MATH 197,001,091859,McAuley; Julian John,9999,0,9999,0
1656065225964,MATH 197,002,095566,Kedlaya; Kiran S.,9997,0,9999,2
1656065225964,MATH 197,003,095567,Xiao; Ming,9999,0,9999,0
1656065225964,MATH 197,004,095571,Perols; Johan Lars,9998,0,9999,1
1656065233052,COGS 9,A01,083615,Shannon; Kyle Michael,4,1,75,71
1656065239077,COGS 11,A01,083617,Boyle; Mary E. T.,16,1,48,32
1656065245102,COGS 13,A01,083071,Bastos; Amalia Pinkusfeld,8,2,71,63
1656065251141,COGS 14A,A01,092681,Semenuks; Arturs,8,23,100,92
1656065257195,COGS 14B,A01,083073,Cheng; Tzu-Han,9,0,63,54
1656065263230,COGS 17,A01,092677,Semenuks; Arturs,13,5,81,68
1656065269283,COGS 100,A01,083619,Allen; Michael Gordon,8,1,70,62
1656065275307,COGS 101A,A01,083621,Davis; Joshua Daniel,7,3,68,61
1656065281367,COGS 101B,A01,091572,Allen; Michael Gordon,7,0,65,58
1656065287391,COGS 101C,A01,083625,Delgado; Tania,11,0,35,24
1656065293418,COGS 107A,A01,083627,Boyle; Mary E. T.,5,2,60,55
1656065299451,COGS 118A,A01,083075,Gupta; Anjum,24,16,76,52
1656065305508,CSE 3,A50,083646,Miranda; Gregory Joseph,20,0,50,30
1656065311540,CSE 8A,A50,083650,Miranda; Gregory Joseph,13,11,56,43
1656065317576,CSE 11,A01,083080,Cao; Yingjun,1,60,40,39
1656065323614,CSE 12,A01,083652,Krause-Levy; Sophia Louisa,14,7,120,106
1656065329640,CSE 15L,A01,083654,Morris; Justin Loren,5,1,50,45
1656065329640,CSE 15L,A02,083655,Morris; Justin Loren,7,0,50,43
1656065335684,CSE 20,A01,083657,Tran; Khoa Dang,31,0,80,49
1656065341714,CSE 21,A01,095574,Bach; Quang Tran,28,0,48,20
1656065347762,CSE 30,A01,083084,Eldon; John,3,10,80,77
1656065347762,CSE 30,B01,095061,Bhaskar; Nishant,4,5,50,46
1656065353797,CSE 100,A01,083659,Cao; Yingjun,2,23,70,68
1656065359823,CSE 134B,A01,083661,Powell; Thomas Allan,11,6,100,89
1656065365852,CSE 140,A01,083663,Gungor; Onat,9,0,85,76
1656065371900,CSE 140L,A01,083088,Eldon; John,8,0,100,92
1656065377944,CSE 175,A01,083665,Kumar; Rakesh,2,0,25,23
1656065383976,CSE 190,A00,092507,Dubnov; Shlomo,3,0,20,17
1656065390028,ECE 45,A01,083139,Congero; Spencer William,5,2,75,70
1656065396056,ECE 65,A50,083695,Saad; Andrew S,8,0,30,22
1656065396056,ECE 65,A51,095125,Staff,23,0,26,3
1656065402091,ECE 109,A01,091882,Touri; Behrouz,5,4,70,65
1656065408148,ECE 180,A00,083140,Abi Samra; Nicholas Camill,1,0,30,29
1656065408148,ECE 180,B00,083141,Abi Samra; Nicholas Camill,2,8,28,26
1656065414184,MATH 10A,A01,083735,Patchell; Gregory David,1,0,30,29
1656065414184,MATH 10A,A02,083736,Patchell; Gregory David,23,0,30,7
1656065414184,MATH 10A,A03,083737,Patchell; Gregory David,16,0,30,14
1656065420213,MATH 10B,A01,083207,Lim; Seonhee,3,1,34,31
1656065420213,MATH 10B,A02,083208,Lim; Seonhee,10,1,35,25
1656065420213,MATH 10B,A03,093472,Staff,4,1,34,30
1656065420213,MATH 10B,B01,083739,Sinha; Shubham,12,0,30,18
1656065426246,MATH 18,A01,083743,Cinel; Cameron Alexander,7,0,30,23
1656065426246,MATH 18,A02,083744,Cinel; Cameron Alexander,12,0,30,18
1656065426246,MATH 18,A03,083745,Cinel; Cameron Alexander,3,0,30,27
1656065426246,MATH 18,B01,083748,Ma; Zilu,1,0,36,35
1656065426246,MATH 18,B02,083749,Ma; Zilu,2,0,36,34
1656065426246,MATH 18,B03,083750,Ma; Zilu,0,0,36,36
1656065426246,MATH 18,B04,083751,Ma; Zilu,1,0,36,35
1656065426246,MATH 18,B05,093473,Staff,3,0,36,33
1656065426246,MATH 18,B06,093474,Staff,4,0,36,32
1656065432277,MATH 20A,A01,083754,Zheng; Zequn,12,0,40,28
1656065438336,MATH 20B,A01,083756,Briones; Jor-el Thomas Caparas,0,0,36,36
1656065438336,MATH 20B,A02,083757,Briones; Jor-el Thomas Caparas,3,0,36,33
1656065438336,MATH 20B,A03,093475,Staff,3,0,36,33
1656065444381,MATH 20C,A01,083760,Briones; Jor-el Thomas Caparas,2,2,35,33
1656065444381,MATH 20C,A02,083761,Briones; Jor-el Thomas Caparas,9,1,35,26
1656065444381,MATH 20C,A03,093476,Staff,1,1,35,34
1656065444381,MATH 20C,B01,083762,Bach; Quang Tran,5,0,30,25
1656065450417,MATH 20D,A01,083765,Tran; Brian Kha,3,0,30,27
1656065450417,MATH 20D,A02,083766,Tran; Brian Kha,0,1,30,30
1656065450417,MATH 20D,A03,083767,Tran; Brian Kha,2,0,30,28
1656065456444,MATH 20E,A01,083771,Ganguly; Soumya,4,1,32,28
1656065456444,MATH 20E,A02,083772,Ganguly; Soumya,2,1,32,30
1656065456444,MATH 20E,B01,083773,Ciotti; Benjamin,15,0,35,20
1656065456444,MATH 20E,B02,083774,Ciotti; Benjamin,15,0,35,20
1656065462486,MATH 103A,A01,083777,Greenfeld; Be'Eri,3,0,36,33
1656065462486,MATH 103A,A02,083778,Greenfeld; Be'Eri,3,0,36,33
1656065462486,MATH 103A,A03,093561,Staff,4,1,36,32
1656065462486,MATH 103A,B01,083779,Greenfeld; Be'Eri,8,1,36,28
1656065462486,MATH 103A,B02,083780,Greenfeld; Be'Eri,1,0,36,35
1656065462486,MATH 103A,B03,093562,Staff,1,0,36,35
1656065468534,MATH 105,A01,085443,Carter; Anne Toulson,4,1,35,31
1656065468534,MATH 105,A02,093477,Staff,12,0,35,23
1656065474593,MATH 109,A01,083213,Ganzberger; Geoffrey Michael,1,1,34,33
1656065474593,MATH 109,A02,083214,Ganzberger; Geoffrey Michael,0,0,34,34
1656065474593,MATH 109,A03,093478,Staff,3,0,34,31
1656065474593,MATH 109,B01,083215,Ganzberger; Geoffrey Michael,4,0,32,28
1656065474593,MATH 109,B02,083216,Ganzberger; Geoffrey Michael,1,0,32,31
1656065474593,MATH 109,B03,093479,Staff,4,0,32,28
1656065480619,MATH 142A,A01,083219,Chow; Bennett,2,0,32,30
1656065480619,MATH 142A,A02,083220,Chow; Bennett,8,0,32,24
1656065480619,MATH 142A,A03,093480,Staff,5,0,32,27
1656065480619,MATH 142A,B03,093481,Staff,5,0,32,27
1656065480619,MATH 142A,B04,093558,Staff,7,0,32,25
1656065480619,MATH 142A,B05,093559,Staff,0,0,32,32
1656065486646,MATH 193A,A01,083224,Rotar; Vladimir,1,2,34,33
1656065486646,MATH 193A,A02,083225,Rotar; Vladimir,3,0,34,31
1656065486646,MATH 193A,A03,083781,Rotar; Vladimir,3,0,34,31
1656065486646,MATH 193A,A04,083782,Rotar; Vladimir,7,0,34,27
1656065486646,MATH 193A,A05,093482,Rotar; Vladimir,1,0,34,33
1656065492696,MATH 197,001,091859,McAuley; Julian John,9999,0,9999,0
1656065492696,MATH 197,002,095566,Kedlaya; Kiran S.,9997,0,9999,2
1656065492696,MATH 197,003,095567,Xiao; Ming,9999,0,9999,0
1656065492696,MATH 197,004,095571,Perols; Johan Lars,9998,0,9999,1
1656065499775,COGS 9,A01,083615,Shannon; Kyle Michael,4,1,75,71
1656065505803,COGS 11,A01,083617,Boyle; Mary E. T.,16,1,48,32
1656065511849,COGS 13,A01,083071,Bastos; Amalia Pinkusfeld,8,2,71,63
1656065517886,COGS 14A,A01,092681,Semenuks; Arturs,8,23,100,92
1656065523909,COGS 14B,A01,083073,Cheng; Tzu-Han,9,0,63,54
1656065529937,COGS 17,A01,092677,Semenuks; Arturs,13,5,81,68
1656065535994,COGS 100,A01,083619,Allen; Michael Gordon,8,1,70,62
1656065542019,COGS 101A,A01,083621,Davis; Joshua Daniel,7,3,68,61
1656065548054,COGS 101B,A01,091572,Allen; Michael Gordon,7,0,65,58
1656065554097,COGS 101C,A01,083625,Delgado; Tania,11,0,35,24
1656065560135,COGS 107A,A01,083627,Boyle; Mary E. T.,5,2,60,55
1656065566173,COGS 118A,A01,083075,Gupta; Anjum,24,16,76,52
1656065572222,CSE 3,A50,083646,Miranda; Gregory Joseph,20,0,50,30
1656065578264,CSE 8A,A50,083650,Miranda; Gregory Joseph,13,11,56,43
1656065584298,CSE 11,A01,083080,Cao; Yingjun,1,60,40,39
1656065590348,CSE 12,A01,083652,Krause-Levy; Sophia Louisa,14,7,120,106
1656065596383,CSE 15L,A01,083654,Morris; Justin Loren,5,1,50,45
1656065596383,CSE 15L,A02,083655,Morris; Justin Loren,7,0,50,43
1656065602419,CSE 20,A01,083657,Tran; Khoa Dang,31,0,80,49
1656065608547,CSE 21,A01,095574,Bach; Quang Tran,28,0,48,20
1656065614600,CSE 30,A01,083084,Eldon; John,3,10,80,77
1656065614600,CSE 30,B01,095061,Bhaskar; Nishant,4,5,50,46
1656065620622,CSE 100,A01,083659,Cao; Yingjun,2,23,70,68
1656065626659,CSE 134B,A01,083661,Powell; Thomas Allan,11,6,100,89
1656065632695,CSE 140,A01,083663,Gungor; Onat,9,0,85,76
1656065638720,CSE 140L,A01,083088,Eldon; John,8,0,100,92
1656065644767,CSE 175,A01,083665,Kumar; Rakesh,2,0,25,23
1656065650813,CSE 190,A00,092507,Dubnov; Shlomo,3,0,20,17
1656065656856,ECE 45,A01,083139,Congero; Spencer William,5,2,75,70
1656065662912,ECE 65,A50,083695,Saad; Andrew S,8,0,30,22
1656065662912,ECE 65,A51,095125,Staff,23,0,26,3
1656065668938,ECE 109,A01,091882,Touri; Behrouz,5,4,70,65
1656065674973,ECE 180,A00,083140,Abi Samra; Nicholas Camill,1,0,30,29
1656065674973,ECE 180,B00,083141,Abi Samra; Nicholas Camill,2,8,28,26
1656065681014,MATH 10A,A01,083735,Patchell; Gregory David,1,0,30,29
1656065681014,MATH 10A,A02,083736,Patchell; Gregory David,23,0,30,7
1656065681014,MATH 10A,A03,083737,Patchell; Gregory David,16,0,30,14
1656065687068,MATH 10B,A01,083207,Lim; Seonhee,3,1,34,31
1656065687068,MATH 10B,A02,083208,Lim; Seonhee,10,1,35,25
1656065687068,MATH 10B,A03,093472,Staff,4,1,34,30
1656065687068,MATH 10B,B01,083739,Sinha; Shubham,12,0,30,18
1656065693120,MATH 18,A01,083743,Cinel; Cameron Alexander,7,0,30,23
1656065693120,MATH 18,A02,083744,Cinel; Cameron Alexander,12,0,30,18
1656065693120,MATH 18,A03,083745,Cinel; Cameron Alexander,3,0,30,27
1656065693120,MATH 18,B01,083748,Ma; Zilu,1,0,36,35
1656065693120,MATH 18,B02,083749,Ma; Zilu,2,0,36,34
1656065693120,MATH 18,B03,083750,Ma; Zilu,0,0,36,36
1656065693120,MATH 18,B04,083751,Ma; Zilu,1,0,36,35
1656065693120,MATH 18,B05,093473,Staff,3,0,36,33
1656065693120,MATH 18,B06,093474,Staff,4,0,36,32
1656065699147,MATH 20A,A01,083754,Zheng; Zequn,12,0,40,28
1656065705174,MATH 20B,A01,083756,Briones; Jor-el Thomas Caparas,0,0,36,36
1656065705174,MATH 20B,A02,083757,Briones; Jor-el Thomas Caparas,3,0,36,33
1656065705174,MATH 20B,A03,093475,Staff,3,0,36,33
1656065711209,MATH 20C,A01,083760,Briones; Jor-el Thomas Caparas,2,2,35,33
1656065711209,MATH 20C,A02,083761,Briones; Jor-el Thomas Caparas,9,1,35,26
1656065711209,MATH 20C,A03,093476,Staff,1,1,35,34
1656065711209,MATH 20C,B01,083762,Bach; Quang Tran,5,0,30,25
1656065717258,MATH 20D,A01,083765,Tran; Brian Kha,3,0,30,27
1656065717258,MATH 20D,A02,083766,Tran; Brian Kha,0,1,30,30
1656065717258,MATH 20D,A03,083767,Tran; Brian Kha,2,0,30,28
1656065723282,MATH 20E,A01,083771,Ganguly; Soumya,4,1,32,28
1656065723282,MATH 20E,A02,083772,Ganguly; Soumya,2,1,32,30
1656065723282,MATH 20E,B01,083773,Ciotti; Benjamin,15,0,35,20
1656065723282,MATH 20E,B02,083774,Ciotti; Benjamin,15,0,35,20
1656065729323,MATH 103A,A01,083777,Greenfeld; Be'Eri,3,0,36,33
1656065729323,MATH 103A,A02,083778,Greenfeld; Be'Eri,3,0,36,33
1656065729323,MATH 103A,A03,093561,Staff,4,1,36,32
1656065729323,MATH 103A,B01,083779,Greenfeld; Be'Eri,8,1,36,28
1656065729323,MATH 103A,B02,083780,Greenfeld; Be'Eri,1,0,36,35
1656065729323,MATH 103A,B03,093562,Staff,1,0,36,35
1656065735349,MATH 105,A01,085443,Carter; Anne Toulson,4,1,35,31
1656065735349,MATH 105,A02,093477,Staff,12,0,35,23
1656065741377,MATH 109,A01,083213,Ganzberger; Geoffrey Michael,1,1,34,33
1656065741377,MATH 109,A02,083214,Ganzberger; Geoffrey Michael,0,0,34,34
1656065741377,MATH 109,A03,093478,Staff,3,0,34,31
1656065741377,MATH 109,B01,083215,Ganzberger; Geoffrey Michael,4,0,32,28
1656065741377,MATH 109,B02,083216,Ganzberger; Geoffrey Michael,1,0,32,31
1656065741377,MATH 109,B03,093479,Staff,4,0,32,28
1656065747406,MATH 142A,A01,083219,Chow; Bennett,2,0,32,30
1656065747406,MATH 142A,A02,083220,Chow; Bennett,8,0,32,24
1656065747406,MATH 142A,A03,093480,Staff,5,0,32,27
1656065747406,MATH 142A,B03,093481,Staff,5,0,32,27
1656065747406,MATH 142A,B04,093558,Staff,7,0,32,25
1656065747406,MATH 142A,B05,093559,Staff,0,0,32,32
1656065753442,MATH 193A,A01,083224,Rotar; Vladimir,1,2,34,33
1656065753442,MATH 193A,A02,083225,Rotar; Vladimir,3,0,34,31
1656065753442,MATH 193A,A03,083781,Rotar; Vladimir,3,0,34,31
1656065753442,MATH 193A,A04,083782,Rotar; Vladimir,7,0,34,27
1656065753442,MATH 193A,A05,093482,Rotar; Vladimir,1,0,34,33
1656065759467,MATH 197,001,091859,McAuley; Julian John,9999,0,9999,0
1656065759467,MATH 197,002,095566,Kedlaya; Kiran S.,9997,0,9999,2
1656065759467,MATH 197,003,095567,Xiao; Ming,9999,0,9999,0
1656065759467,MATH 197,004,095571,Perols; Johan Lars,9998,0,9999,1
1656065766536,COGS 9,A01,083615,Shannon; Kyle Michael,4,1,75,71
1656065772570,COGS 11,A01,083617,Boyle; Mary E. T.,16,1,48,32
1656065778611,COGS 13,A01,083071,Bastos; Amalia Pinkusfeld,8,2,71,63
1656065784647,COGS 14A,A01,092681,Semenuks; Arturs,8,23,100,92
1656065790676,COGS 14B,A01,083073,Cheng; Tzu-Han,9,0,63,54
1656065796711,COGS 17,A01,092677,Semenuks; Arturs,13,5,81,68
1656065802748,COGS 100,A01,083619,Allen; Michael Gordon,8,1,70,62
1656065808780,COGS 101A,A01,083621,Davis; Joshua Daniel,7,3,68,61
1656065814807,COGS 101B,A01,091572,Allen; Michael Gordon,7,0,65,58
1656065820834,COGS 101C,A01,083625,Delgado; Tania,11,0,35,24
1656065826871,COGS 107A,A01,083627,Boyle; Mary E. T.,5,2,60,55
1656065832895,COGS 118A,A01,083075,Gupta; Anjum,24,16,76,52
1656065838931,CSE 3,A50,083646,Miranda; Gregory Joseph,20,0,50,30
1656065844968,CSE 8A,A50,083650,Miranda; Gregory Joseph,13,11,56,43
1656065851015,CSE 11,A01,083080,Cao; Yingjun,1,60,40,39
1656065857044,CSE 12,A01,083652,Krause-Levy; Sophia Louisa,14,7,120,106
1656065863089,CSE 15L,A01,083654,Morris; Justin Loren,5,1,50,45
1656065863089,CSE 15L,A02,083655,Morris; Justin Loren,7,0,50,43
1656065869117,CSE 20,A01,083657,Tran; Khoa Dang,31,0,80,49
1656065875151,CSE 21,A01,095574,Bach; Quang Tran,28,0,48,20
1656065881195,CSE 30,A01,083084,Eldon; John,3,10,80,77
1656065881195,CSE 30,B01,095061,Bhaskar; Nishant,4,5,50,46
1656065887219,CSE 100,A01,083659,Cao; Yingjun,2,23,70,68
1656065893249,CSE 134B,A01,083661,Powell; Thomas Allan,11,6,100,89
1656065899276,CSE 140,A01,083663,Gungor; Onat,9,0,85,76
1656065905308,CSE 140L,A01,083088,Eldon; John,8,0,100,92
1656065911338,CSE 175,A01,083665,Kumar; Rakesh,2,0,25,23
1656065917365,CSE 190,A00,092507,Dubnov; Shlomo,3,0,20,17
1656065923389,ECE 45,A01,083139,Congero; Spencer William,5,2,75,70
1656065929436,ECE 65,A50,083695,Saad; Andrew S,8,0,30,22
1656065929436,ECE 65,A51,095125,Staff,23,0,26,3
1656065935476,ECE 109,A01,091882,Touri; Behrouz,5,4,70,65
1656065941499,ECE 180,A00,083140,Abi Samra; Nicholas Camill,1,0,30,29
1656065941499,ECE 180,B00,083141,Abi Samra; Nicholas Camill,2,8,28,26
1656065947549,MATH 10A,A01,083735,Patchell; Gregory David,1,0,30,29
1656065947549,MATH 10A,A02,083736,Patchell; Gregory David,23,0,30,7
1656065947549,MATH 10A,A03,083737,Patchell; Gregory David,16,0,30,14
1656065953575,MATH 10B,A01,083207,Lim; Seonhee,3,1,34,31
1656065953575,MATH 10B,A02,083208,Lim; Seonhee,10,1,35,25
1656065953575,MATH 10B,A03,093472,Staff,4,1,34,30
1656065953575,MATH 10B,B01,083739,Sinha; Shubham,12,0,30,18
1656065959620,MATH 18,A01,083743,Cinel; Cameron Alexander,7,0,30,23
1656065959620,MATH 18,A02,083744,Cinel; Cameron Alexander,12,0,30,18
1656065959620,MATH 18,A03,083745,Cinel; Cameron Alexander,3,0,30,27
1656065959620,MATH 18,B01,083748,Ma; Zilu,1,0,36,35
1656065959620,MATH 18,B02,083749,Ma; Zilu,2,0,36,34
1656065959620,MATH 18,B03,083750,Ma; Zilu,0,0,36,36
1656065959620,MATH 18,B04,083751,Ma; Zilu,1,0,36,35
1656065959620,MATH 18,B05,093473,Staff,3,0,36,33
1656065959620,MATH 18,B06,093474,Staff,4,0,36,32
1656065965654,MATH 20A,A01,083754,Zheng; Zequn,12,0,40,28
1656065971701,MATH 20B,A01,083756,Briones; Jor-el Thomas Caparas,0,0,36,36
1656065971701,MATH 20B,A02,083757,Briones; Jor-el Thomas Caparas,3,0,36,33
1656065971701,MATH 20B,A03,093475,Staff,3,0,36,33
1656065977726,MATH 20C,A01,083760,Briones; Jor-el Thomas Caparas,2,2,35,33
1656065977726,MATH 20C,A02,083761,Briones; Jor-el Thomas Caparas,9,1,35,26
1656065977726,MATH 20C,A03,093476,Staff,1,1,35,34
1656065977726,MATH 20C,B01,083762,Bach; Quang Tran,5,0,30,25
1656065983769,MATH 20D,A01,083765,Tran; Brian Kha,3,0,30,27
1656065983769,MATH 20D,A02,083766,Tran; Brian Kha,0,1,30,30
1656065983769,MATH 20D,A03,083767,Tran; Brian Kha,2,0,30,28
1656065989808,MATH 20E,A01,083771,Ganguly; Soumya,4,1,32,28
1656065989808,MATH 20E,A02,083772,Ganguly; Soumya,2,1,32,30
1656065989808,MATH 20E,B01,083773,Ciotti; Benjamin,15,0,35,20
1656065989808,MATH 20E,B02,083774,Ciotti; Benjamin,15,0,35,20
1656065995834,MATH 103A,A01,083777,Greenfeld; Be'Eri,3,0,36,33
1656065995834,MATH 103A,A02,083778,Greenfeld; Be'Eri,3,0,36,33
1656065995834,MATH 103A,A03,093561,Staff,4,1,36,32
1656065995834,MATH 103A,B01,083779,Greenfeld; Be'Eri,8,1,36,28
1656065995834,MATH 103A,B02,083780,Greenfeld; Be'Eri,1,0,36,35
1656065995834,MATH 103A,B03,093562,Staff,1,0,36,35
1656066001876,MATH 105,A01,085443,Carter; Anne Toulson,4,1,35,31
1656066001876,MATH 105,A02,093477,Staff,12,0,35,23
1656066007915,MATH 109,A01,083213,Ganzberger; Geoffrey Michael,1,1,34,33
1656066007915,MATH 109,A02,083214,Ganzberger; Geoffrey Michael,0,0,34,34
1656066007915,MATH 109,A03,093478,Staff,3,0,34,31
1656066007915,MATH 109,B01,083215,Ganzberger; Geoffrey Michael,4,0,32,28
1656066007915,MATH 109,B02,083216,Ganzberger; Geoffrey Michael,1,0,32,31
1656066007915,MATH 109,B03,093479,Staff,4,0,32,28
1656066013949,MATH 142A,A01,083219,Chow; Bennett,2,0,32,30
1656066013949,MATH 142A,A02,083220,Chow; Bennett,8,0,32,24
1656066013949,MATH 142A,A03,093480,Staff,5,0,32,27
1656066013949,MATH 142A,B03,093481,Staff,5,0,32,27
1656066013949,MATH 142A,B04,093558,Staff,7,0,32,25
1656066013949,MATH 142A,B05,093559,Staff,0,0,32,32
1656066019994,MATH 193A,A01,083224,Rotar; Vladimir,1,2,34,33
1656066019994,MATH 193A,A02,083225,Rotar; Vladimir,3,0,34,31
1656066019994,MATH 193A,A03,083781,Rotar; Vladimir,3,0,34,31
1656066019994,MATH 193A,A04,083782,Rotar; Vladimir,7,0,34,27
1656066019994,MATH 193A,A05,093482,Rotar; Vladimir,1,0,34,33
1656066026023,MATH 197,001,091859,McAuley; Julian John,9999,0,9999,0
1656066026023,MATH 197,002,095566,Kedlaya; Kiran S.,9997,0,9999,2
1656066026023,MATH 197,003,095567,Xiao; Ming,9999,0,9999,0
1656066026023,MATH 197,004,095571,Perols; Johan Lars,9998,0,9999,1
1656066033106,COGS 9,A01,083615,Shannon; Kyle Michael,4,1,75,71
1656066039156,COGS 11,A01,083617,Boyle; Mary E. T.,16,1,48,32
1656066045181,COGS 13,A01,083071,Bastos; Amalia Pinkusfeld,8,2,71,63
1656066051227,COGS 14A,A01,092681,Semenuks; Arturs,8,23,100,92
1656066057262,COGS 14B,A01,083073,Cheng; Tzu-Han,9,0,63,54
1656066063313,COGS 17,A01,092677,Semenuks; Arturs,13,5,81,68
1656066069369,COGS 100,A01,083619,Allen; Michael Gordon,8,1,70,62
1656066075418,COGS 101A,A01,083621,Davis; Joshua Daniel,7,3,68,61
1656066081450,COGS 101B,A01,091572,Allen; Michael Gordon,7,0,65,58
1656066087489,COGS 101C,A01,083625,Delgado; Tania,11,0,35,24
1656066093525,COGS 107A,A01,083627,Boyle; Mary E. T.,5,2,60,55
1656066099573,COGS 118A,A01,083075,Gupta; Anjum,24,16,76,52
1656066105629,CSE 3,A50,083646,Miranda; Gregory Joseph,20,0,50,30
1656066111673,CSE 8A,A50,083650,Miranda; Gregory Joseph,13,11,56,43
1656066117711,CSE 11,A01,083080,Cao; Yingjun,1,60,40,39
1656066123737,CSE 12,A01,083652,Krause-Levy; Sophia Louisa,14,7,120,106
1656066129761,CSE 15L,A01,083654,Morris; Justin Loren,5,1,50,45
1656066129761,CSE 15L,A02,083655,Morris; Justin Loren,7,0,50,43
1656066135785,CSE 20,A01,083657,Tran; Khoa Dang,31,0,80,49
1656066141840,CSE 21,A01,095574,Bach; Quang Tran,28,0,48,20
1656066147883,CSE 30,A01,083084,Eldon; John,3,10,80,77
1656066147883,CSE 30,B01,095061,Bhaskar; Nishant,4,5,50,46
1656066153929,CSE 100,A01,083659,Cao; Yingjun,2,23,70,68
1656066159974,CSE 134B,A01,083661,Powell; Thomas Allan,11,6,100,89
1656066166028,CSE 140,A01,083663,Gungor; Onat,9,0,85,76
1656066172053,CSE 140L,A01,083088,Eldon; John,8,0,100,92
1656066178107,CSE 175,A01,083665,Kumar; Rakesh,2,0,25,23
1656066184134,CSE 190,A00,092507,Dubnov; Shlomo,3,0,20,17
1656066190173,ECE 45,A01,083139,Congero; Spencer William,5,2,75,70
1656066196210,ECE 65,A50,083695,Saad; Andrew S,8,0,30,22
1656066196210,ECE 65,A51,095125,Staff,23,0,26,3
1656066202252,ECE 109,A01,091882,Touri; Behrouz,5,4,70,65
1656066208435,ECE 180,A00,083140,Abi Samra; Nicholas Camill,1,0,30,29
1656066208435,ECE 180,B00,083141,Abi Samra; Nicholas Camill,2,8,28,26
1656066214492,MATH 10A,A01,083735,Patchell; Gregory David,1,0,30,29
1656066214492,MATH 10A,A02,083736,Patchell; Gregory David,23,0,30,7
1656066214492,MATH 10A,A03,083737,Patchell; Gregory David,16,0,30,14
1656066220535,MATH 10B,A01,083207,Lim; Seonhee,3,1,34,31
1656066220535,MATH 10B,A02,083208,Lim; Seonhee,10,1,35,25
1656066220535,MATH 10B,A03,093472,Staff,4,1,34,30
1656066220535,MATH 10B,B01,083739,Sinha; Shubham,12,0,30,18
1656066226585,MATH 18,A01,083743,Cinel; Cameron Alexander,7,0,30,23
1656066226585,MATH 18,A02,083744,Cinel; Cameron Alexander,12,0,30,18
1656066226585,MATH 18,A03,083745,Cinel; Cameron Alexander,3,0,30,27
1656066226585,MATH 18,B01,083748,Ma; Zilu,1,0,36,35
1656066226585,MATH 18,B02,083749,Ma; Zilu,2,0,36,34
1656066226585,MATH 18,B03,083750,Ma; Zilu,0,0,36,36
1656066226585,MATH 18,B04,083751,Ma; Zilu,1,0,36,35
1656066226585,MATH 18,B05,093473,Staff,3,0,36,33
1656066226585,MATH 18,B06,093474,Staff,4,0,36,32
1656066232631,MATH 20A,A01,083754,Zheng; Zequn,12,0,40,28
1656066238669,MATH 20B,A01,083756,Briones; Jor-el Thomas Caparas,0,0,36,36
1656066238669,MATH 20B,A02,083757,Briones; Jor-el Thomas Caparas,3,0,36,33
1656066238669,MATH 20B,A03,093475,Staff,3,0,36,33
1656066244715,MATH 20C,A01,083760,Briones; Jor-el Thomas Caparas,2,2,35,33
1656066244715,MATH 20C,A02,083761,Briones; Jor-el Thomas Caparas,9,1,35,26
1656066244715,MATH 20C,A03,093476,Staff,1,1,35,34
1656066244715,MATH 20C,B01,083762,Bach; Quang Tran,5,0,30,25
1656066250747,MATH 20D,A01,083765,Tran; Brian Kha,3,0,30,27
1656066250747,MATH 20D,A02,083766,Tran; Brian Kha,0,1,30,30
1656066250747,MATH 20D,A03,083767,Tran; Brian Kha,2,0,30,28
1656066256783,MATH 20E,A01,083771,Ganguly; Soumya,4,1,32,28
1656066256783,MATH 20E,A02,083772,Ganguly; Soumya,2,1,32,30
1656066256783,MATH 20E,B01,083773,Ciotti; Benjamin,15,0,35,20
1656066256783,MATH 20E,B02,083774,Ciotti; Benjamin,15,0,35,20
1656066262810,MATH 103A,A01,083777,Greenfeld; Be'Eri,3,0,36,33
1656066262810,MATH 103A,A02,083778,Greenfeld; Be'Eri,3,0,36,33
1656066262810,MATH 103A,A03,093561,Staff,4,1,36,32
1656066262810,MATH 103A,B01,083779,Greenfeld; Be'Eri,8,1,36,28
1656066262810,MATH 103A,B02,083780,Greenfeld; Be'Eri,1,0,36,35
1656066262810,MATH 103A,B03,093562,Staff,1,0,36,35
1656066268846,MATH 105,A01,085443,Carter; Anne Toulson,4,1,35,31
1656066268846,MATH 105,A02,093477,Staff,12,0,35,23
1656066274888,MATH 109,A01,083213,Ganzberger; Geoffrey Michael,1,1,34,33
1656066274888,MATH 109,A02,083214,Ganzberger; Geoffrey Michael,0,0,34,34
1656066274888,MATH 109,A03,093478,Staff,3,0,34,31
1656066274888,MATH 109,B01,083215,Ganzberger; Geoffrey Michael,4,0,32,28
1656066274888,MATH 109,B02,083216,Ganzberger; Geoffrey Michael,1,0,32,31
1656066274888,MATH 109,B03,093479,Staff,4,0,32,28
1656066280915,MATH 142A,A01,083219,Chow; Bennett,2,0,32,30
1656066280915,MATH 142A,A02,083220,Chow; Bennett,8,0,32,24
1656066280915,MATH 142A,A03,093480,Staff,5,0,32,27
1656066280915,MATH 142A,B03,093481,Staff,5,0,32,27
1656066280915,MATH 142A,B04,093558,Staff,7,0,32,25
1656066280915,MATH 142A,B05,093559,Staff,0,0,32,32
1656066286942,MATH 193A,A01,083224,Rotar; Vladimir,1,2,34,33
1656066286942,MATH 193A,A02,083225,Rotar; Vladimir,3,0,34,31
1656066286942,MATH 193A,A03,083781,Rotar; Vladimir,3,0,34,31
1656066286942,MATH 193A,A04,083782,Rotar; Vladimir,7,0,34,27
1656066286942,MATH 193A,A05,093482,Rotar; Vladimir,1,0,34,33
1656066292973,MATH 197,001,091859,McAuley; Julian John,9999,0,9999,0
1656066292973,MATH 197,002,095566,Kedlaya; Kiran S.,9997,0,9999,2
1656066292973,MATH 197,003,095567,Xiao; Ming,9999,0,9999,0
1656066292973,MATH 197,004,095571,Perols; Johan Lars,9998,0,9999,1
1656066300066,COGS 9,A01,083615,Shannon; Kyle Michael,4,1,75,71
1656066306104,COGS 11,A01,083617,Boyle; Mary E. T.,16,1,48,32
1656066312132,COGS 13,A01,083071,Bastos; Amalia Pinkusfeld,8,2,71,63
1656066318156,COGS 14A,A01,092681,Semenuks; Arturs,8,23,100,92
1656066324181,COGS 14B,A01,083073,Cheng; Tzu-Han,9,0,63,54
1656066330207,COGS 17,A01,092677,Semenuks; Arturs,13,5,81,68
1656066336253,COGS 100,A01,083619,Allen; Michael Gordon,8,1,70,62
1656066342279,COGS 101A,A01,083621,Davis; Joshua Daniel,7,3,68,61
1656066348331,COGS 101B,A01,091572,Allen; Michael Gordon,7,0,65,58
1656066354356,COGS 101C,A01,083625,Delgado; Tania,11,0,35,24
1656066360389,COGS 107A,A01,083627,Boyle; Mary E. T.,5,2,60,55
1656066366421,COGS 118A,A01,083075,Gupta; Anjum,24,16,76,52
1656066372461,CSE 3,A50,083646,Miranda; Gregory Joseph,20,0,50,30
1656066378486,CSE 8A,A50,083650,Miranda; Gregory Joseph,13,11,56,43
1656066384536,CSE 11,A01,083080,Cao; Yingjun,1,60,40,39
1656066390565,CSE 12,A01,083652,Krause-Levy; Sophia Louisa,14,7,120,106
1656066396598,CSE 15L,A01,083654,Morris; Justin Loren,5,1,50,45
1656066396598,CSE 15L,A02,083655,Morris; Justin Loren,7,0,50,43
1656066402620,CSE 20,A01,083657,Tran; Khoa Dang,31,0,80,49
1656066408649,CSE 21,A01,095574,Bach; Quang Tran,28,0,48,20
1656066414686,CSE 30,A01,083084,Eldon; John,3,10,80,77
1656066414686,CSE 30,B01,095061,Bhaskar; Nishant,4,5,50,46
1656066420711,CSE 100,A01,083659,Cao; Yingjun,2,23,70,68
1656066426745,CSE 134B,A01,083661,Powell; Thomas Allan,11,6,100,89
1656066432770,CSE 140,A01,083663,Gungor; Onat,9,0,85,76
1656066438795,CSE 140L,A01,083088,Eldon; John,8,0,100,92
1656066444819,CSE 175,A01,083665,Kumar; Rakesh,2,0,25,23
1656066450845,CSE 190,A00,092507,Dubnov; Shlomo,3,0,20,17
1656066456902,ECE 45,A01,083139,Congero; Spencer William,5,2,75,70
1656066462946,ECE 65,A50,083695,Saad; Andrew S,8,0,30,22
1656066462946,ECE 65,A51,095125,Staff,23,0,26,3
1656066468978,ECE 109,A01,091882,Touri; Behrouz,5,4,70,65
1656066475017,ECE 180,A00,083140,Abi Samra; Nicholas Camill,1,0,30,29
1656066475017,ECE 180,B00,083141,Abi Samra; Nicholas Camill,2,8,28,26
1656066481049,MATH 10A,A01,083735,Patchell; Gregory David,1,0,30,29
1656066481049,MATH 10A,A02,083736,Patchell; Gregory David,23,0,30,7
1656066481049,MATH 10A,A03,083737,Patchell; Gregory David,16,0,30,14
1656066487078,MATH 10B,A01,083207,Lim; Seonhee,3,1,34,31
1656066487078,MATH 10B,A02,083208,Lim; Seonhee,10,1,35,25
1656066487078,MATH 10B,A03,093472,Staff,4,1,34,30
1656066487078,MATH 10B,B01,083739,Sinha; Shubham,12,0,30,18
1656066493135,MATH 18,A01,083743,Cinel; Cameron Alexander,7,0,30,23
1656066493135,MATH 18,A02,083744,Cinel; Cameron Alexander,12,0,30,18
1656066493135,MATH 18,A03,083745,Cinel; Cameron Alexander,3,0,30,27
1656066493135,MATH 18,B01,083748,Ma; Zilu,1,0,36,35
1656066493135,MATH 18,B02,083749,Ma; Zilu,2,0,36,34
1656066493135,MATH 18,B03,083750,Ma; Zilu,0,0,36,36
1656066493135,MATH 18,B04,083751,Ma; Zilu,1,0,36,35
1656066493135,MATH 18,B05,093473,Staff,3,0,36,33
1656066493135,MATH 18,B06,093474,Staff,4,0,36,32
1656066499159,MATH 20A,A01,083754,Zheng; Zequn,11,0,40,29
1656066505204,MATH 20B,A01,083756,Briones; Jor-el Thomas Caparas,0,0,36,36
1656066505204,MATH 20B,A02,083757,Briones; Jor-el Thomas Caparas,3,0,36,33
1656066505204,MATH 20B,A03,093475,Staff,3,0,36,33
1656066511239,MATH 20C,A01,083760,Briones; Jor-el Thomas Caparas,2,2,35,33
1656066511239,MATH 20C,A02,083761,Briones; Jor-el Thomas Caparas,9,1,35,26
1656066511239,MATH 20C,A03,093476,Staff,1,1,35,34
1656066511239,MATH 20C,B01,083762,Bach; Quang Tran,5,0,30,25
1656066517282,MATH 20D,A01,083765,Tran; Brian Kha,3,0,30,27
1656066517282,MATH 20D,A02,083766,Tran; Brian Kha,0,1,30,30
1656066517282,MATH 20D,A03,083767,Tran; Brian Kha,2,0,30,28
1656066523334,MATH 20E,A01,083771,Ganguly; Soumya,4,1,32,28
1656066523334,MATH 20E,A02,083772,Ganguly; Soumya,2,1,32,30
1656066523334,MATH 20E,B01,083773,Ciotti; Benjamin,15,0,35,20
1656066523334,MATH 20E,B02,083774,Ciotti; Benjamin,15,0,35,20
1656066529391,MATH 103A,A01,083777,Greenfeld; Be'Eri,3,0,36,33
1656066529391,MATH 103A,A02,083778,Greenfeld; Be'Eri,3,0,36,33
1656066529391,MATH 103A,A03,093561,Staff,4,1,36,32
1656066529391,MATH 103A,B01,083779,Greenfeld; Be'Eri,8,1,36,28
1656066529391,MATH 103A,B02,083780,Greenfeld; Be'Eri,1,0,36,35
1656066529391,MATH 103A,B03,093562,Staff,1,0,36,35
1656066535435,MATH 105,A01,085443,Carter; Anne Toulson,4,1,35,31
1656066535435,MATH 105,A02,093477,Staff,12,0,35,23
1656066541464,MATH 109,A01,083213,Ganzberger; Geoffrey Michael,1,1,34,33
1656066541464,MATH 109,A02,083214,Ganzberger; Geoffrey Michael,0,0,34,34
1656066541464,MATH 109,A03,093478,Staff,3,0,34,31
1656066541464,MATH 109,B01,083215,Ganzberger; Geoffrey Michael,4,0,32,28
1656066541464,MATH 109,B02,083216,Ganzberger; Geoffrey Michael,1,0,32,31
1656066541464,MATH 109,B03,093479,Staff,4,0,32,28
1656066547506,MATH 142A,A01,083219,Chow; Bennett,2,0,32,30
1656066547506,MATH 142A,A02,083220,Chow; Bennett,8,0,32,24
1656066547506,MATH 142A,A03,093480,Staff,5,0,32,27
1656066547506,MATH 142A,B03,093481,Staff,5,0,32,27
1656066547506,MATH 142A,B04,093558,Staff,7,0,32,25
1656066547506,MATH 142A,B05,093559,Staff,0,0,32,32
1656066553530,MATH 193A,A01,083224,Rotar; Vladimir,1,2,34,33
1656066553530,MATH 193A,A02,083225,Rotar; Vladimir,3,0,34,31
1656066553530,MATH 193A,A03,083781,Rotar; Vladimir,3,0,34,31
1656066553530,MATH 193A,A04,083782,Rotar; Vladimir,7,0,34,27
1656066553530,MATH 193A,A05,093482,Rotar; Vladimir,1,0,34,33
1656066559555,MATH 197,001,091859,McAuley; Julian John,9999,0,9999,0
1656066559555,MATH 197,002,095566,Kedlaya; Kiran S.,9997,0,9999,2
1656066559555,MATH 197,003,095567,Xiao; Ming,9999,0,9999,0
1656066559555,MATH 197,004,095571,Perols; Johan Lars,9998,0,9999,1
1656066566634,COGS 9,A01,083615,Shannon; Kyle Michael,4,1,75,71
1656066572658,COGS 11,A01,083617,Boyle; Mary E. T.,16,1,48,32
1656066578712,COGS 13,A01,083071,Bastos; Amalia Pinkusfeld,8,2,71,63
1656066584759,COGS 14A,A01,092681,Semenuks; Arturs,8,23,100,92
1656066590794,COGS 14B,A01,083073,Cheng; Tzu-Han,9,0,63,54
1656066596832,COGS 17,A01,092677,Semenuks; Arturs,13,6,81,68
1656066602888,COGS 100,A01,083619,Allen; Michael Gordon,8,1,70,62
1656066608916,COGS 101A,A01,083621,Davis; Joshua Daniel,7,3,68,61
1656066614955,COGS 101B,A01,091572,Allen; Michael Gordon,7,0,65,58
1656066621013,COGS 101C,A01,083625,Delgado; Tania,11,0,35,24
1656066627067,COGS 107A,A01,083627,Boyle; Mary E. T.,5,2,60,55
1656066633102,COGS 118A,A01,083075,Gupta; Anjum,24,16,76,52
1656066639143,CSE 3,A50,083646,Miranda; Gregory Joseph,20,0,50,30
1656066645172,CSE 8A,A50,083650,Miranda; Gregory Joseph,13,11,56,43
1656066651198,CSE 11,A01,083080,Cao; Yingjun,1,60,40,39
1656066657231,CSE 12,A01,083652,Krause-Levy; Sophia Louisa,14,7,120,106
1656066663275,CSE 15L,A01,083654,Morris; Justin Loren,5,1,50,45
1656066663275,CSE 15L,A02,083655,Morris; Justin Loren,7,0,50,43
1656066669310,CSE 20,A01,083657,Tran; Khoa Dang,31,0,80,49
1656066675353,CSE 21,A01,095574,Bach; Quang Tran,28,0,48,20
1656066681383,CSE 30,A01,083084,Eldon; John,3,10,80,77
1656066681383,CSE 30,B01,095061,Bhaskar; Nishant,4,5,50,46
1656066687414,CSE 100,A01,083659,Cao; Yingjun,2,23,70,68
1656066693438,CSE 134B,A01,083661,Powell; Thomas Allan,11,6,100,89
1656066699482,CSE 140,A01,083663,Gungor; Onat,9,0,85,76
1656066705511,CSE 140L,A01,083088,Eldon; John,8,0,100,92
1656066711553,CSE 175,A01,083665,Kumar; Rakesh,2,0,25,23
1656066717587,CSE 190,A00,092507,Dubnov; Shlomo,3,0,20,17
1656066723652,ECE 45,A01,083139,Congero; Spencer William,5,2,75,70
1656066729685,ECE 65,A50,083695,Saad; Andrew S,8,0,30,22
1656066729685,ECE 65,A51,095125,Staff,23,0,26,3
1656066735715,ECE 109,A01,091882,Touri; Behrouz,5,4,70,65
1656066741762,ECE 180,A00,083140,Abi Samra; Nicholas Camill,1,0,30,29
1656066741762,ECE 180,B00,083141,Abi Samra; Nicholas Camill,2,8,28,26
1656066747790,MATH 10A,A01,083735,Patchell; Gregory David,1,0,30,29
1656066747790,MATH 10A,A02,083736,Patchell; Gregory David,23,0,30,7
1656066747790,MATH 10A,A03,083737,Patchell; Gregory David,16,0,30,14
1656066753834,MATH 10B,A01,083207,Lim; Seonhee,3,1,34,31
1656066753834,MATH 10B,A02,083208,Lim; Seonhee,10,1,35,25
1656066753834,MATH 10B,A03,093472,Staff,4,1,34,30
1656066753834,MATH 10B,B01,083739,Sinha; Shubham,12,0,30,18
1656066759860,MATH 18,A01,083743,Cinel; Cameron Alexander,7,0,30,23
1656066759860,MATH 18,A02,083744,Cinel; Cameron Alexander,12,0,30,18
1656066759860,MATH 18,A03,083745,Cinel; Cameron Alexander,3,0,30,27
1656066759860,MATH 18,B01,083748,Ma; Zilu,1,0,36,35
1656066759860,MATH 18,B02,083749,Ma; Zilu,2,0,36,34
1656066759860,MATH 18,B03,083750,Ma; Zilu,0,0,36,36
1656066759860,MATH 18,B04,083751,Ma; Zilu,1,0,36,35
1656066759860,MATH 18,B05,093473,Staff,3,0,36,33
1656066759860,MATH 18,B06,093474,Staff,4,0,36,32
1656066765908,MATH 20A,A01,083754,Zheng; Zequn,11,0,40,29
1656066771947,MATH 20B,A01,083756,Briones; Jor-el Thomas Caparas,0,0,36,36
1656066771947,MATH 20B,A02,083757,Briones; Jor-el Thomas Caparas,3,0,36,33
1656066771947,MATH 20B,A03,093475,Staff,3,0,36,33
1656066777973,MATH 20C,A01,083760,Briones; Jor-el Thomas Caparas,2,2,35,33
1656066777973,MATH 20C,A02,083761,Briones; Jor-el Thomas Caparas,9,1,35,26
1656066777973,MATH 20C,A03,093476,Staff,1,1,35,34
1656066777973,MATH 20C,B01,083762,Bach; Quang Tran,5,0,30,25
1656066783998,MATH 20D,A01,083765,Tran; Brian Kha,3,0,30,27
1656066783998,MATH 20D,A02,083766,Tran; Brian Kha,0,1,30,30
1656066783998,MATH 20D,A03,083767,Tran; Brian Kha,2,0,30,28
1656066790051,MATH 20E,A01,083771,Ganguly; Soumya,4,1,32,28
1656066790051,MATH 20E,A02,083772,Ganguly; Soumya,2,1,32,30
1656066790051,MATH 20E,B01,083773,Ciotti; Benjamin,15,0,35,20
1656066790051,MATH 20E,B02,083774,Ciotti; Benjamin,15,0,35,20
1656066796099,MATH 103A,A01,083777,Greenfeld; Be'Eri,3,0,36,33
1656066796099,MATH 103A,A02,083778,Greenfeld; Be'Eri,3,0,36,33
1656066796099,MATH 103A,A03,093561,Staff,4,1,36,32
1656066796099,MATH 103A,B01,083779,Greenfeld; Be'Eri,8,1,36,28
1656066796099,MATH 103A,B02,083780,Greenfeld; Be'Eri,1,0,36,35
1656066796099,MATH 103A,B03,093562,Staff,1,0,36,35
1656066802154,MATH 105,A01,085443,Carter; Anne Toulson,4,1,35,31
1656066802154,MATH 105,A02,093477,Staff,12,0,35,23
1656066808316,MATH 109,A01,083213,Ganzberger; Geoffrey Michael,1,1,34,33
1656066808316,MATH 109,A02,083214,Ganzberger; Geoffrey Michael,0,0,34,34
1656066808316,MATH 109,A03,093478,Staff,3,0,34,31
1656066808316,MATH 109,B01,083215,Ganzberger; Geoffrey Michael,4,0,32,28
1656066808316,MATH 109,B02,083216,Ganzberger; Geoffrey Michael,1,0,32,31
1656066808316,MATH 109,B03,093479,Staff,4,0,32,28
1656066814380,MATH 142A,A01,083219,Chow; Bennett,2,0,32,30
1656066814380,MATH 142A,A02,083220,Chow; Bennett,8,0,32,24
1656066814380,MATH 142A,A03,093480,Staff,5,0,32,27
1656066814380,MATH 142A,B03,093481,Staff,5,0,32,27
1656066814380,MATH 142A,B04,093558,Staff,7,0,32,25
1656066814380,MATH 142A,B05,093559,Staff,0,0,32,32
1656066820413,MATH 193A,A01,083224,Rotar; Vladimir,1,2,34,33
1656066820413,MATH 193A,A02,083225,Rotar; Vladimir,3,0,34,31
1656066820413,MATH 193A,A03,083781,Rotar; Vladimir,3,0,34,31
1656066820413,MATH 193A,A04,083782,Rotar; Vladimir,7,0,34,27
1656066820413,MATH 193A,A05,093482,Rotar; Vladimir,1,0,34,33
1656066826438,MATH 197,001,091859,McAuley; Julian John,9999,0,9999,0
1656066826438,MATH 197,002,095566,Kedlaya; Kiran S.,9997,0,9999,2
1656066826438,MATH 197,003,095567,Xiao; Ming,9999,0,9999,0
1656066826438,MATH 197,004,095571,Perols; Johan Lars,9998,0,9999,1
1656066833539,COGS 9,A01,083615,Shannon; Kyle Michael,4,1,75,71
1656066839578,COGS 11,A01,083617,Boyle; Mary E. T.,16,1,48,32
1656066845603,COGS 13,A01,083071,Bastos; Amalia Pinkusfeld,8,2,71,63
1656066851634,COGS 14A,A01,092681,Semenuks; Arturs,8,23,100,92
1656066857679,COGS 14B,A01,083073,Cheng; Tzu-Han,9,0,63,54
1656066863709,COGS 17,A01,092677,Semenuks; Arturs,13,6,81,68
1656066869757,COGS 100,A01,083619,Allen; Michael Gordon,8,1,70,62
1656066875787,COGS 101A,A01,083621,Davis; Joshua Daniel,7,3,68,61
1656066881827,COGS 101B,A01,091572,Allen; Michael Gordon,7,0,65,58
1656066887852,COGS 101C,A01,083625,Delgado; Tania,11,0,35,24
1656066893904,COGS 107A,A01,083627,Boyle; Mary E. T.,5,2,60,55
1656066899935,COGS 118A,A01,083075,Gupta; Anjum,24,16,76,52
1656066905963,CSE 3,A50,083646,Miranda; Gregory Joseph,20,0,50,30
1656066912004,CSE 8A,A50,083650,Miranda; Gregory Joseph,13,11,56,43
1656066918053,CSE 11,A01,083080,Cao; Yingjun,1,60,40,39
1656066924088,CSE 12,A01,083652,Krause-Levy; Sophia Louisa,14,7,120,106
1656066930145,CSE 15L,A01,083654,Morris; Justin Loren,5,1,50,45
1656066930145,CSE 15L,A02,083655,Morris; Justin Loren,7,0,50,43
1656066936168,CSE 20,A01,083657,Tran; Khoa Dang,31,0,80,49
1656066942261,CSE 21,A01,095574,Bach; Quang Tran,28,0,48,20
1656066948292,CSE 30,A01,083084,Eldon; John,3,10,80,77
1656066948292,CSE 30,B01,095061,Bhaskar; Nishant,4,5,50,46
1656066954322,CSE 100,A01,083659,Cao; Yingjun,2,23,70,68
1656066960367,CSE 134B,A01,083661,Powell; Thomas Allan,11,6,100,89
1656066966397,CSE 140,A01,083663,Gungor; Onat,9,0,85,76
1656066972425,CSE 140L,A01,083088,Eldon; John,8,0,100,92
1656066978460,CSE 175,A01,083665,Kumar; Rakesh,2,0,25,23
1656066984502,CSE 190,A00,092507,Dubnov; Shlomo,3,0,20,17
1656066990556,ECE 45,A01,083139,Congero; Spencer William,5,2,75,70
1656066996600,ECE 65,A50,083695,Saad; Andrew S,8,0,30,22
1656066996600,ECE 65,A51,095125,Staff,23,0,26,3
1656067002628,ECE 109,A01,091882,Touri; Behrouz,5,4,70,65
1656067008663,ECE 180,A00,083140,Abi Samra; Nicholas Camill,1,0,30,29
1656067008663,ECE 180,B00,083141,Abi Samra; Nicholas Camill,2,8,28,26
1656067014694,MATH 10A,A01,083735,Patchell; Gregory David,1,0,30,29
1656067014694,MATH 10A,A02,083736,Patchell; Gregory David,23,0,30,7
1656067014694,MATH 10A,A03,083737,Patchell; Gregory David,16,0,30,14
1656067020732,MATH 10B,A01,083207,Lim; Seonhee,3,1,34,31
1656067020732,MATH 10B,A02,083208,Lim; Seonhee,10,1,35,25
1656067020732,MATH 10B,A03,093472,Staff,4,1,34,30
1656067020732,MATH 10B,B01,083739,Sinha; Shubham,12,0,30,18
1656067026779,MATH 18,A01,083743,Cinel; Cameron Alexander,7,0,30,23
1656067026779,MATH 18,A02,083744,Cinel; Cameron Alexander,12,0,30,18
1656067026779,MATH 18,A03,083745,Cinel; Cameron Alexander,3,0,30,27
1656067026779,MATH 18,B01,083748,Ma; Zilu,1,0,36,35
1656067026779,MATH 18,B02,083749,Ma; Zilu,2,0,36,34
1656067026779,MATH 18,B03,083750,Ma; Zilu,0,0,36,36
1656067026779,MATH 18,B04,083751,Ma; Zilu,1,0,36,35
1656067026779,MATH 18,B05,093473,Staff,3,0,36,33
1656067026779,MATH 18,B06,093474,Staff,4,0,36,32
1656067032820,MATH 20A,A01,083754,Zheng; Zequn,11,0,40,29
1656067038861,MATH 20B,A01,083756,Briones; Jor-el Thomas Caparas,0,0,36,36
1656067038861,MATH 20B,A02,083757,Briones; Jor-el Thomas Caparas,3,0,36,33
1656067038861,MATH 20B,A03,093475,Staff,3,0,36,33
1656067044907,MATH 20C,A01,083760,Briones; Jor-el Thomas Caparas,2,2,35,33
1656067044907,MATH 20C,A02,083761,Briones; Jor-el Thomas Caparas,9,1,35,26
1656067044907,MATH 20C,A03,093476,Staff,1,1,35,34
1656067044907,MATH 20C,B01,083762,Bach; Quang Tran,5,0,30,25
1656067050956,MATH 20D,A01,083765,Tran; Brian Kha,3,0,30,27
1656067050956,MATH 20D,A02,083766,Tran; Brian Kha,0,1,30,30
1656067050956,MATH 20D,A03,083767,Tran; Brian Kha,2,0,30,28
1656067056998,MATH 20E,A01,083771,Ganguly; Soumya,4,1,32,28
1656067056998,MATH 20E,A02,083772,Ganguly; Soumya,2,1,32,30
1656067056998,MATH 20E,B01,083773,Ciotti; Benjamin,15,0,35,20
1656067056998,MATH 20E,B02,083774,Ciotti; Benjamin,15,0,35,20
1656067063047,MATH 103A,A01,083777,Greenfeld; Be'Eri,3,0,36,33
1656067063047,MATH 103A,A02,083778,Greenfeld; Be'Eri,3,0,36,33
1656067063047,MATH 103A,A03,093561,Staff,4,1,36,32
1656067063047,MATH 103A,B01,083779,Greenfeld; Be'Eri,8,1,36,28
1656067063047,MATH 103A,B02,083780,Greenfeld; Be'Eri,1,0,36,35
1656067063047,MATH 103A,B03,093562,Staff,1,0,36,35
1656067069088,MATH 105,A01,085443,Carter; Anne Toulson,4,1,35,31
1656067069088,MATH 105,A02,093477,Staff,12,0,35,23
1656067075134,MATH 109,A01,083213,Ganzberger; Geoffrey Michael,1,1,34,33
1656067075134,MATH 109,A02,083214,Ganzberger; Geoffrey Michael,0,0,34,34
1656067075134,MATH 109,A03,093478,Staff,3,0,34,31
1656067075134,MATH 109,B01,083215,Ganzberger; Geoffrey Michael,4,0,32,28
1656067075134,MATH 109,B02,083216,Ganzberger; Geoffrey Michael,1,0,32,31
1656067075134,MATH 109,B03,093479,Staff,4,0,32,28
1656067081168,MATH 142A,A01,083219,Chow; Bennett,2,0,32,30
1656067081168,MATH 142A,A02,083220,Chow; Bennett,8,0,32,24
1656067081168,MATH 142A,A03,093480,Staff,5,0,32,27
1656067081168,MATH 142A,B03,093481,Staff,5,0,32,27
1656067081168,MATH 142A,B04,093558,Staff,7,0,32,25
1656067081168,MATH 142A,B05,093559,Staff,0,0,32,32
1656067087210,MATH 193A,A01,083224,Rotar; Vladimir,1,2,34,33
1656067087210,MATH 193A,A02,083225,Rotar; Vladimir,3,0,34,31
1656067087210,MATH 193A,A03,083781,Rotar; Vladimir,3,0,34,31
1656067087210,MATH 193A,A04,083782,Rotar; Vladimir,7,0,34,27
1656067087210,MATH 193A,A05,093482,Rotar; Vladimir,1,0,34,33
1656067093249,MATH 197,001,091859,McAuley; Julian John,9999,0,9999,0
1656067093249,MATH 197,002,095566,Kedlaya; Kiran S.,9997,0,9999,2
1656067093249,MATH 197,003,095567,Xiao; Ming,9999,0,9999,0
1656067093249,MATH 197,004,095571,Perols; Johan Lars,9998,0,9999,1
1656067100387,COGS 9,A01,083615,Shannon; Kyle Michael,4,1,75,71
1656067106420,COGS 11,A01,083617,Boyle; Mary E. T.,16,1,48,32
1656067112471,COGS 13,A01,083071,Bastos; Amalia Pinkusfeld,8,2,71,63
1656067118522,COGS 14A,A01,092681,Semenuks; Arturs,8,23,100,92
1656067124549,COGS 14B,A01,083073,Cheng; Tzu-Han,9,0,63,54
1656067130573,COGS 17,A01,092677,Semenuks; Arturs,13,6,81,68
1656067136616,COGS 100,A01,083619,Allen; Michael Gordon,8,1,70,62
1656067142643,COGS 101A,A01,083621,Davis; Joshua Daniel,7,3,68,61
1656067148680,COGS 101B,A01,091572,Allen; Michael Gordon,7,0,65,58
1656067154713,COGS 101C,A01,083625,Delgado; Tania,11,0,35,24
1656067160741,COGS 107A,A01,083627,Boyle; Mary E. T.,5,2,60,55
1656067166774,COGS 118A,A01,083075,Gupta; Anjum,24,16,76,52
1656067172830,CSE 3,A50,083646,Miranda; Gregory Joseph,20,0,50,30
1656067178874,CSE 8A,A50,083650,Miranda; Gregory Joseph,13,11,56,43
1656067184917,CSE 11,A01,083080,Cao; Yingjun,1,60,40,39
1656067190953,CSE 12,A01,083652,Krause-Levy; Sophia Louisa,14,7,120,106
1656067196984,CSE 15L,A01,083654,Morris; Justin Loren,5,1,50,45
1656067196984,CSE 15L,A02,083655,Morris; Justin Loren,7,0,50,43
1656067203011,CSE 20,A01,083657,Tran; Khoa Dang,31,0,80,49
1656067209059,CSE 21,A01,095574,Bach; Quang Tran,28,0,48,20
1656067215115,CSE 30,A01,083084,Eldon; John,3,10,80,77
1656067215115,CSE 30,B01,095061,Bhaskar; Nishant,4,5,50,46
1656067221163,CSE 100,A01,083659,Cao; Yingjun,2,23,70,68
1656067227195,CSE 134B,A01,083661,Powell; Thomas Allan,11,6,100,89
1656067233223,CSE 140,A01,083663,Gungor; Onat,9,0,85,76
1656067239262,CSE 140L,A01,083088,Eldon; John,8,0,100,92
1656067245288,CSE 175,A01,083665,Kumar; Rakesh,2,0,25,23
1656067251329,CSE 190,A00,092507,Dubnov; Shlomo,3,0,20,17
1656067257379,ECE 45,A01,083139,Congero; Spencer William,5,2,75,70
1656067263420,ECE 65,A50,083695,Saad; Andrew S,8,0,30,22
1656067263420,ECE 65,A51,095125,Staff,23,0,26,3
1656067269472,ECE 109,A01,091882,Touri; Behrouz,5,4,70,65
1656067275520,ECE 180,A00,083140,Abi Samra; Nicholas Camill,1,0,30,29
1656067275520,ECE 180,B00,083141,Abi Samra; Nicholas Camill,2,8,28,26
1656067281552,MATH 10A,A01,083735,Patchell; Gregory David,1,0,30,29
1656067281552,MATH 10A,A02,083736,Patchell; Gregory David,23,0,30,7
1656067281552,MATH 10A,A03,083737,Patchell; Gregory David,16,0,30,14
1656067287616,MATH 10B,A01,083207,Lim; Seonhee,3,1,34,31
1656067287616,MATH 10B,A02,083208,Lim; Seonhee,10,1,35,25
1656067287616,MATH 10B,A03,093472,Staff,4,1,34,30
1656067287616,MATH 10B,B01,083739,Sinha; Shubham,12,0,30,18
1656067293673,MATH 18,A01,083743,Cinel; Cameron Alexander,7,0,30,23
1656067293673,MATH 18,A02,083744,Cinel; Cameron Alexander,12,0,30,18
1656067293673,MATH 18,A03,083745,Cinel; Cameron Alexander,3,0,30,27
1656067293673,MATH 18,B01,083748,Ma; Zilu,1,0,36,35
1656067293673,MATH 18,B02,083749,Ma; Zilu,2,0,36,34
1656067293673,MATH 18,B03,083750,Ma; Zilu,0,0,36,36
1656067293673,MATH 18,B04,083751,Ma; Zilu,1,0,36,35
1656067293673,MATH 18,B05,093473,Staff,3,0,36,33
1656067293673,MATH 18,B06,093474,Staff,4,0,36,32
1656067299701,MATH 20A,A01,083754,Zheng; Zequn,11,0,40,29
1656067305737,MATH 20B,A01,083756,Briones; Jor-el Thomas Caparas,0,0,36,36
1656067305737,MATH 20B,A02,083757,Briones; Jor-el Thomas Caparas,3,0,36,33
1656067305737,MATH 20B,A03,093475,Staff,3,0,36,33
1656067311773,MATH 20C,A01,083760,Briones; Jor-el Thomas Caparas,2,2,35,33
1656067311773,MATH 20C,A02,083761,Briones; Jor-el Thomas Caparas,9,1,35,26
1656067311773,MATH 20C,A03,093476,Staff,1,1,35,34
1656067311773,MATH 20C,B01,083762,Bach; Quang Tran,5,0,30,25
1656067317805,MATH 20D,A01,083765,Tran; Brian Kha,3,0,30,27
1656067317805,MATH 20D,A02,083766,Tran; Brian Kha,0,1,30,30
1656067317805,MATH 20D,A03,083767,Tran; Brian Kha,2,0,30,28
1656067323841,MATH 20E,A01,083771,Ganguly; Soumya,4,1,32,28
1656067323841,MATH 20E,A02,083772,Ganguly; Soumya,2,1,32,30
1656067323841,MATH 20E,B01,083773,Ciotti; Benjamin,15,0,35,20
1656067323841,MATH 20E,B02,083774,Ciotti; Benjamin,15,0,35,20
1656067329875,MATH 103A,A01,083777,Greenfeld; Be'Eri,3,0,36,33
1656067329875,MATH 103A,A02,083778,Greenfeld; Be'Eri,3,0,36,33
1656067329875,MATH 103A,A03,093561,Staff,4,1,36,32
1656067329875,MATH 103A,B01,083779,Greenfeld; Be'Eri,8,1,36,28
1656067329875,MATH 103A,B02,083780,Greenfeld; Be'Eri,1,0,36,35
1656067329875,MATH 103A,B03,093562,Staff,1,0,36,35
1656067335916,MATH 105,A01,085443,Carter; Anne Toulson,4,1,35,31
1656067335916,MATH 105,A02,093477,Staff,12,0,35,23
1656067341973,MATH 109,A01,083213,Ganzberger; Geoffrey Michael,1,1,34,33
1656067341973,MATH 109,A02,083214,Ganzberger; Geoffrey Michael,0,0,34,34
1656067341973,MATH 109,A03,093478,Staff,3,0,34,31
1656067341973,MATH 109,B01,083215,Ganzberger; Geoffrey Michael,4,0,32,28
1656067341973,MATH 109,B02,083216,Ganzberger; Geoffrey Michael,1,0,32,31
1656067341973,MATH 109,B03,093479,Staff,4,0,32,28
1656067348006,MATH 142A,A01,083219,Chow; Bennett,2,0,32,30
1656067348006,MATH 142A,A02,083220,Chow; Bennett,8,0,32,24
1656067348006,MATH 142A,A03,093480,Staff,5,0,32,27
1656067348006,MATH 142A,B03,093481,Staff,5,0,32,27
1656067348006,MATH 142A,B04,093558,Staff,7,0,32,25
1656067348006,MATH 142A,B05,093559,Staff,0,0,32,32
1656067354040,MATH 193A,A01,083224,Rotar; Vladimir,1,2,34,33
1656067354040,MATH 193A,A02,083225,Rotar; Vladimir,3,0,34,31
1656067354040,MATH 193A,A03,083781,Rotar; Vladimir,3,0,34,31
1656067354040,MATH 193A,A04,083782,Rotar; Vladimir,7,0,34,27
1656067354040,MATH 193A,A05,093482,Rotar; Vladimir,1,0,34,33
1656067360084,MATH 197,001,091859,McAuley; Julian John,9999,0,9999,0
1656067360084,MATH 197,002,095566,Kedlaya; Kiran S.,9997,0,9999,2
1656067360084,MATH 197,003,095567,Xiao; Ming,9999,0,9999,0
1656067360084,MATH 197,004,095571,Perols; Johan Lars,9998,0,9999,1
1656067367195,COGS 9,A01,083615,Shannon; Kyle Michael,4,1,75,71
1656067373221,COGS 11,A01,083617,Boyle; Mary E. T.,16,1,48,32
1656067379257,COGS 13,A01,083071,Bastos; Amalia Pinkusfeld,8,2,71,63
1656067385293,COGS 14A,A01,092681,Semenuks; Arturs,8,23,100,92
1656067391321,COGS 14B,A01,083073,Cheng; Tzu-Han,9,0,63,54
1656067397350,COGS 17,A01,092677,Semenuks; Arturs,13,6,81,68
1656067403494,COGS 100,A01,083619,Allen; Michael Gordon,8,1,70,62
1656067409523,COGS 101A,A01,083621,Davis; Joshua Daniel,7,3,68,61
1656067415561,COGS 101B,A01,091572,Allen; Michael Gordon,7,0,65,58
1656067421597,COGS 101C,A01,083625,Delgado; Tania,11,0,35,24
1656067427639,COGS 107A,A01,083627,Boyle; Mary E. T.,5,2,60,55
1656067433665,COGS 118A,A01,083075,Gupta; Anjum,24,16,76,52
1656067439720,CSE 3,A50,083646,Miranda; Gregory Joseph,20,0,50,30
1656067445746,CSE 8A,A50,083650,Miranda; Gregory Joseph,13,11,56,43
1656067451774,CSE 11,A01,083080,Cao; Yingjun,1,60,40,39
1656067457805,CSE 12,A01,083652,Krause-Levy; Sophia Louisa,14,7,120,106
1656067463842,CSE 15L,A01,083654,Morris; Justin Loren,5,1,50,45
1656067463842,CSE 15L,A02,083655,Morris; Justin Loren,7,0,50,43
1656067469870,CSE 20,A01,083657,Tran; Khoa Dang,31,0,80,49
1656067475902,CSE 21,A01,095574,Bach; Quang Tran,28,0,48,20
1656067481934,CSE 30,A01,083084,Eldon; John,3,10,80,77
1656067481934,CSE 30,B01,095061,Bhaskar; Nishant,4,5,50,46
1656067487979,CSE 100,A01,083659,Cao; Yingjun,2,23,70,68
1656067494010,CSE 134B,A01,083661,Powell; Thomas Allan,11,6,100,89
1656067500034,CSE 140,A01,083663,Gungor; Onat,9,0,85,76
1656067506069,CSE 140L,A01,083088,Eldon; John,8,0,100,92
1656067512112,CSE 175,A01,083665,Kumar; Rakesh,2,0,25,23
1656067518159,CSE 190,A00,092507,Dubnov; Shlomo,3,0,20,17
1656067524185,ECE 45,A01,083139,Congero; Spencer William,5,2,75,70
1656067530225,ECE 65,A50,083695,Saad; Andrew S,8,0,30,22
1656067530225,ECE 65,A51,095125,Staff,23,0,26,3
1656067536251,ECE 109,A01,091882,Touri; Behrouz,5,4,70,65
1656067542286,ECE 180,A00,083140,Abi Samra; Nicholas Camill,1,0,30,29
1656067542286,ECE 180,B00,083141,Abi Samra; Nicholas Camill,2,8,28,26
1656067548322,MATH 10A,A01,083735,Patchell; Gregory David,1,0,30,29
1656067548322,MATH 10A,A02,083736,Patchell; Gregory David,23,0,30,7
1656067548322,MATH 10A,A03,083737,Patchell; Gregory David,16,0,30,14
1656067554364,MATH 10B,A01,083207,Lim; Seonhee,3,1,34,31
1656067554364,MATH 10B,A02,083208,Lim; Seonhee,10,1,35,25
1656067554364,MATH 10B,A03,093472,Staff,4,1,34,30
1656067554364,MATH 10B,B01,083739,Sinha; Shubham,12,0,30,18
1656067560394,MATH 18,A01,083743,Cinel; Cameron Alexander,7,0,30,23
1656067560394,MATH 18,A02,083744,Cinel; Cameron Alexander,12,0,30,18
1656067560394,MATH 18,A03,083745,Cinel; Cameron Alexander,3,0,30,27
1656067560394,MATH 18,B01,083748,Ma; Zilu,1,0,36,35
1656067560394,MATH 18,B02,083749,Ma; Zilu,2,0,36,34
1656067560394,MATH 18,B03,083750,Ma; Zilu,0,0,36,36
1656067560394,MATH 18,B04,083751,Ma; Zilu,1,0,36,35
1656067560394,MATH 18,B05,093473,Staff,3,0,36,33
1656067560394,MATH 18,B06,093474,Staff,4,0,36,32
1656067566427,MATH 20A,A01,083754,Zheng; Zequn,11,0,40,29
1656067572478,MATH 20B,A01,083756,Briones; Jor-el Thomas Caparas,0,0,36,36
1656067572478,MATH 20B,A02,083757,Briones; Jor-el Thomas Caparas,3,0,36,33
1656067572478,MATH 20B,A03,093475,Staff,3,0,36,33
1656067578504,MATH 20C,A01,083760,Briones; Jor-el Thomas Caparas,2,2,35,33
1656067578504,MATH 20C,A02,083761,Briones; Jor-el Thomas Caparas,9,1,35,26
1656067578504,MATH 20C,A03,093476,Staff,1,1,35,34
1656067578504,MATH 20C,B01,083762,Bach; Quang Tran,5,0,30,25
1656067584557,MATH 20D,A01,083765,Tran; Brian Kha,3,0,30,27
1656067584557,MATH 20D,A02,083766,Tran; Brian Kha,0,1,30,30
1656067584557,MATH 20D,A03,083767,Tran; Brian Kha,2,0,30,28
1656067590612,MATH 20E,A01,083771,Ganguly; Soumya,4,1,32,28
1656067590612,MATH 20E,A02,083772,Ganguly; Soumya,2,1,32,30
1656067590612,MATH 20E,B01,083773,Ciotti; Benjamin,15,0,35,20
1656067590612,MATH 20E,B02,083774,Ciotti; Benjamin,15,0,35,20
1656067596662,MATH 103A,A01,083777,Greenfeld; Be'Eri,3,0,36,33
1656067596662,MATH 103A,A02,083778,Greenfeld; Be'Eri,3,0,36,33
1656067596662,MATH 103A,A03,093561,Staff,4,1,36,32
1656067596662,MATH 103A,B01,083779,Greenfeld; Be'Eri,8,1,36,28
1656067596662,MATH 103A,B02,083780,Greenfeld; Be'Eri,1,0,36,35
1656067596662,MATH 103A,B03,093562,Staff,1,0,36,35
1656067602688,MATH 105,A01,085443,Carter; Anne Toulson,4,1,35,31
1656067602688,MATH 105,A02,093477,Staff,12,0,35,23
1656067608717,MATH 109,A01,083213,Ganzberger; Geoffrey Michael,1,1,34,33
1656067608717,MATH 109,A02,083214,Ganzberger; Geoffrey Michael,0,0,34,34
1656067608717,MATH 109,A03,093478,Staff,3,0,34,31
1656067608717,MATH 109,B01,083215,Ganzberger; Geoffrey Michael,4,0,32,28
1656067608717,MATH 109,B02,083216,Ganzberger; Geoffrey Michael,1,0,32,31
1656067608717,MATH 109,B03,093479,Staff,4,0,32,28
1656067614771,MATH 142A,A01,083219,Chow; Bennett,2,0,32,30
1656067614771,MATH 142A,A02,083220,Chow; Bennett,8,0,32,24
1656067614771,MATH 142A,A03,093480,Staff,5,0,32,27
1656067614771,MATH 142A,B03,093481,Staff,5,0,32,27
1656067614771,MATH 142A,B04,093558,Staff,7,0,32,25
1656067614771,MATH 142A,B05,093559,Staff,0,0,32,32
1656067620812,MATH 193A,A01,083224,Rotar; Vladimir,1,2,34,33
1656067620812,MATH 193A,A02,083225,Rotar; Vladimir,3,0,34,31
1656067620812,MATH 193A,A03,083781,Rotar; Vladimir,3,0,34,31
1656067620812,MATH 193A,A04,083782,Rotar; Vladimir,7,0,34,27
1656067620812,MATH 193A,A05,093482,Rotar; Vladimir,1,0,34,33
1656067626848,MATH 197,001,091859,McAuley; Julian John,9999,0,9999,0
1656067626848,MATH 197,002,095566,Kedlaya; Kiran S.,9997,0,9999,2
1656067626848,MATH 197,003,095567,Xiao; Ming,9999,0,9999,0
1656067626848,MATH 197,004,095571,Perols; Johan Lars,9998,0,9999,1
1656067633914,COGS 9,A01,083615,Shannon; Kyle Michael,4,1,75,71
1656067639965,COGS 11,A01,083617,Boyle; Mary E. T.,16,1,48,32
1656067645996,COGS 13,A01,083071,Bastos; Amalia Pinkusfeld,8,2,71,63
1656067652021,COGS 14A,A01,092681,Semenuks; Arturs,8,23,100,92
1656067658046,COGS 14B,A01,083073,Cheng; Tzu-Han,9,0,63,54
1656067664085,COGS 17,A01,092677,Semenuks; Arturs,13,6,81,68
1656067670109,COGS 100,A01,083619,Allen; Michael Gordon,8,1,70,62
1656067676160,COGS 101A,A01,083621,Davis; Joshua Daniel,7,3,68,61
1656067682196,COGS 101B,A01,091572,Allen; Michael Gordon,7,0,65,58
1656067688243,COGS 101C,A01,083625,Delgado; Tania,11,0,35,24
1656067694273,COGS 107A,A01,083627,Boyle; Mary E. T.,5,2,60,55
1656067700305,COGS 118A,A01,083075,Gupta; Anjum,24,16,76,52
1656067706329,CSE 3,A50,083646,Miranda; Gregory Joseph,20,0,50,30
1656067712357,CSE 8A,A50,083650,Miranda; Gregory Joseph,13,11,56,43
1656067718401,CSE 11,A01,083080,Cao; Yingjun,1,60,40,39
1656067724445,CSE 12,A01,083652,Krause-Levy; Sophia Louisa,14,7,120,106
1656067730477,CSE 15L,A01,083654,Morris; Justin Loren,5,1,50,45
1656067730477,CSE 15L,A02,083655,Morris; Justin Loren,7,0,50,43
1656067736521,CSE 20,A01,083657,Tran; Khoa Dang,31,0,80,49
1656067742545,CSE 21,A01,095574,Bach; Quang Tran,28,0,48,20
1656067748583,CSE 30,A01,083084,Eldon; John,3,10,80,77
1656067748583,CSE 30,B01,095061,Bhaskar; Nishant,4,5,50,46
1656067754611,CSE 100,A01,083659,Cao; Yingjun,2,23,70,68
1656067760648,CSE 134B,A01,083661,Powell; Thomas Allan,11,6,100,89
1656067766678,CSE 140,A01,083663,Gungor; Onat,9,0,85,76
1656067772713,CSE 140L,A01,083088,Eldon; John,8,0,100,92
1656067778738,CSE 175,A01,083665,Kumar; Rakesh,2,0,25,23
1656067784782,CSE 190,A00,092507,Dubnov; Shlomo,3,0,20,17
1656067790833,ECE 45,A01,083139,Congero; Spencer William,5,2,75,70
1656067796874,ECE 65,A50,083695,Saad; Andrew S,8,0,30,22
1656067796874,ECE 65,A51,095125,Staff,23,0,26,3
1656067802904,ECE 109,A01,091882,Touri; Behrouz,5,4,70,65
1656067808954,ECE 180,A00,083140,Abi Samra; Nicholas Camill,1,0,30,29
1656067808954,ECE 180,B00,083141,Abi Samra; Nicholas Camill,2,8,28,26
1656067814982,MATH 10A,A01,083735,Patchell; Gregory David,1,0,30,29
1656067814982,MATH 10A,A02,083736,Patchell; Gregory David,23,0,30,7
1656067814982,MATH 10A,A03,083737,Patchell; Gregory David,16,0,30,14
1656067821012,MATH 10B,A01,083207,Lim; Seonhee,3,1,34,31
1656067821012,MATH 10B,A02,083208,Lim; Seonhee,10,1,35,25
1656067821012,MATH 10B,A03,093472,Staff,4,1,34,30
1656067821012,MATH 10B,B01,083739,Sinha; Shubham,12,0,30,18
1656067827038,MATH 18,A01,083743,Cinel; Cameron Alexander,7,0,30,23
1656067827038,MATH 18,A02,083744,Cinel; Cameron Alexander,12,0,30,18
1656067827038,MATH 18,A03,083745,Cinel; Cameron Alexander,3,0,30,27
1656067827038,MATH 18,B01,083748,Ma; Zilu,1,0,36,35
1656067827038,MATH 18,B02,083749,Ma; Zilu,2,0,36,34
1656067827038,MATH 18,B03,083750,Ma; Zilu,0,0,36,36
1656067827038,MATH 18,B04,083751,Ma; Zilu,1,0,36,35
1656067827038,MATH 18,B05,093473,Staff,3,0,36,33
1656067827038,MATH 18,B06,093474,Staff,4,0,36,32
1656067833075,MATH 20A,A01,083754,Zheng; Zequn,11,0,40,29
1656067839104,MATH 20B,A01,083756,Briones; Jor-el Thomas Caparas,0,0,36,36
1656067839104,MATH 20B,A02,083757,Briones; Jor-el Thomas Caparas,3,0,36,33
1656067839104,MATH 20B,A03,093475,Staff,3,0,36,33
1656067845133,MATH 20C,A01,083760,Briones; Jor-el Thomas Caparas,2,2,35,33
1656067845133,MATH 20C,A02,083761,Briones; Jor-el Thomas Caparas,9,1,35,26
1656067845133,MATH 20C,A03,093476,Staff,1,1,35,34
1656067845133,MATH 20C,B01,083762,Bach; Quang Tran,5,0,30,25
1656067851162,MATH 20D,A01,083765,Tran; Brian Kha,3,0,30,27
1656067851162,MATH 20D,A02,083766,Tran; Brian Kha,0,1,30,30
1656067851162,MATH 20D,A03,083767,Tran; Brian Kha,2,0,30,28
1656067857195,MATH 20E,A01,083771,Ganguly; Soumya,4,1,32,28
1656067857195,MATH 20E,A02,083772,Ganguly; Soumya,2,1,32,30
1656067857195,MATH 20E,B01,083773,Ciotti; Benjamin,15,0,35,20
1656067857195,MATH 20E,B02,083774,Ciotti; Benjamin,15,0,35,20
1656067863235,MATH 103A,A01,083777,Greenfeld; Be'Eri,3,0,36,33
1656067863235,MATH 103A,A02,083778,Greenfeld; Be'Eri,3,0,36,33
1656067863235,MATH 103A,A03,093561,Staff,4,1,36,32
1656067863235,MATH 103A,B01,083779,Greenfeld; Be'Eri,8,1,36,28
1656067863235,MATH 103A,B02,083780,Greenfeld; Be'Eri,1,0,36,35
1656067863235,MATH 103A,B03,093562,Staff,1,0,36,35
1656067869271,MATH 105,A01,085443,Carter; Anne Toulson,4,1,35,31
1656067869271,MATH 105,A02,093477,Staff,12,0,35,23
1656067875302,MATH 109,A01,083213,Ganzberger; Geoffrey Michael,1,1,34,33
1656067875302,MATH 109,A02,083214,Ganzberger; Geoffrey Michael,0,0,34,34
1656067875302,MATH 109,A03,093478,Staff,3,0,34,31
1656067875302,MATH 109,B01,083215,Ganzberger; Geoffrey Michael,4,0,32,28
1656067875302,MATH 109,B02,083216,Ganzberger; Geoffrey Michael,1,0,32,31
1656067875302,MATH 109,B03,093479,Staff,4,0,32,28
1656067881362,MATH 142A,A01,083219,Chow; Bennett,2,0,32,30
1656067881362,MATH 142A,A02,083220,Chow; Bennett,8,0,32,24
1656067881362,MATH 142A,A03,093480,Staff,5,0,32,27
1656067881362,MATH 142A,B03,093481,Staff,5,0,32,27
1656067881362,MATH 142A,B04,093558,Staff,7,0,32,25
1656067881362,MATH 142A,B05,093559,Staff,0,0,32,32
1656067887398,MATH 193A,A01,083224,Rotar; Vladimir,1,2,34,33
1656067887398,MATH 193A,A02,083225,Rotar; Vladimir,3,0,34,31
1656067887398,MATH 193A,A03,083781,Rotar; Vladimir,3,0,34,31
1656067887398,MATH 193A,A04,083782,Rotar; Vladimir,7,0,34,27
1656067887398,MATH 193A,A05,093482,Rotar; Vladimir,1,0,34,33
1656067893428,MATH 197,001,091859,McAuley; Julian John,9999,0,9999,0
1656067893428,MATH 197,002,095566,Kedlaya; Kiran S.,9997,0,9999,2
1656067893428,MATH 197,003,095567,Xiao; Ming,9999,0,9999,0
1656067893428,MATH 197,004,095571,Perols; Johan Lars,9998,0,9999,1
1656067900525,COGS 9,A01,083615,Shannon; Kyle Michael,4,1,75,71
1656067906550,COGS 11,A01,083617,Boyle; Mary E. T.,16,1,48,32
1656067912579,COGS 13,A01,083071,Bastos; Amalia Pinkusfeld,8,2,71,63
1656067918616,COGS 14A,A01,092681,Semenuks; Arturs,8,23,100,92
1656067924644,COGS 14B,A01,083073,Cheng; Tzu-Han,9,0,63,54
1656067930676,COGS 17,A01,092677,Semenuks; Arturs,13,6,81,68
1656067936721,COGS 100,A01,083619,Allen; Michael Gordon,8,1,70,62
1656067942747,COGS 101A,A01,083621,Davis; Joshua Daniel,7,3,68,61
1656067948781,COGS 101B,A01,091572,Allen; Michael Gordon,7,0,65,58
1656067954813,COGS 101C,A01,083625,Delgado; Tania,11,0,35,24
1656067960838,COGS 107A,A01,083627,Boyle; Mary E. T.,5,2,60,55
1656067966895,COGS 118A,A01,083075,Gupta; Anjum,24,16,76,52
1656067972946,CSE 3,A50,083646,Miranda; Gregory Joseph,20,0,50,30
1656067978974,CSE 8A,A50,083650,Miranda; Gregory Joseph,13,11,56,43
1656067985000,CSE 11,A01,083080,Cao; Yingjun,1,60,40,39
1656067991031,CSE 12,A01,083652,Krause-Levy; Sophia Louisa,14,7,120,106
1656067997072,CSE 15L,A01,083654,Morris; Justin Loren,5,1,50,45
1656067997072,CSE 15L,A02,083655,Morris; Justin Loren,7,0,50,43
1656068003178,CSE 20,A01,083657,Tran; Khoa Dang,31,0,80,49
1656068009201,CSE 21,A01,095574,Bach; Quang Tran,28,0,48,20
1656068015239,CSE 30,A01,083084,Eldon; John,3,10,80,77
1656068015239,CSE 30,B01,095061,Bhaskar; Nishant,4,5,50,46
1656068021272,CSE 100,A01,083659,Cao; Yingjun,2,23,70,68
1656068027320,CSE 134B,A01,083661,Powell; Thomas Allan,11,6,100,89
1656068033351,CSE 140,A01,083663,Gungor; Onat,9,0,85,76
1656068039379,CSE 140L,A01,083088,Eldon; John,8,0,100,92
1656068045404,CSE 175,A01,083665,Kumar; Rakesh,2,0,25,23
1656068051441,CSE 190,A00,092507,Dubnov; Shlomo,3,0,20,17
1656068057474,ECE 45,A01,083139,Congero; Spencer William,5,2,75,70
1656068063506,ECE 65,A50,083695,Saad; Andrew S,8,0,30,22
1656068063506,ECE 65,A51,095125,Staff,23,0,26,3
1656068069530,ECE 109,A01,091882,Touri; Behrouz,5,4,70,65
1656068075567,ECE 180,A00,083140,Abi Samra; Nicholas Camill,1,0,30,29
1656068075567,ECE 180,B00,083141,Abi Samra; Nicholas Camill,2,8,28,26
1656068081605,MATH 10A,A01,083735,Patchell; Gregory David,1,0,30,29
1656068081605,MATH 10A,A02,083736,Patchell; Gregory David,23,0,30,7
1656068081605,MATH 10A,A03,083737,Patchell; Gregory David,16,0,30,14
1656068087634,MATH 10B,A01,083207,Lim; Seonhee,3,1,34,31
1656068087634,MATH 10B,A02,083208,Lim; Seonhee,10,1,35,25
1656068087634,MATH 10B,A03,093472,Staff,4,1,34,30
1656068087634,MATH 10B,B01,083739,Sinha; Shubham,12,0,30,18
1656068093678,MATH 18,A01,083743,Cinel; Cameron Alexander,7,0,30,23
1656068093678,MATH 18,A02,083744,Cinel; Cameron Alexander,12,0,30,18
1656068093678,MATH 18,A03,083745,Cinel; Cameron Alexander,3,0,30,27
1656068093678,MATH 18,B01,083748,Ma; Zilu,1,0,36,35
1656068093678,MATH 18,B02,083749,Ma; Zilu,2,0,36,34
1656068093678,MATH 18,B03,083750,Ma; Zilu,0,0,36,36
1656068093678,MATH 18,B04,083751,Ma; Zilu,1,0,36,35
1656068093678,MATH 18,B05,093473,Staff,3,0,36,33
1656068093678,MATH 18,B06,093474,Staff,4,0,36,32
1656068099707,MATH 20A,A01,083754,Zheng; Zequn,11,0,40,29
1656068105742,MATH 20B,A01,083756,Briones; Jor-el Thomas Caparas,0,0,36,36
1656068105742,MATH 20B,A02,083757,Briones; Jor-el Thomas Caparas,3,0,36,33
1656068105742,MATH 20B,A03,093475,Staff,3,0,36,33
1656068111777,MATH 20C,A01,083760,Briones; Jor-el Thomas Caparas,2,2,35,33
1656068111777,MATH 20C,A02,083761,Briones; Jor-el Thomas Caparas,9,1,35,26
1656068111777,MATH 20C,A03,093476,Staff,1,1,35,34
1656068111777,MATH 20C,B01,083762,Bach; Quang Tran,5,0,30,25
1656068117809,MATH 20D,A01,083765,Tran; Brian Kha,3,0,30,27
1656068117809,MATH 20D,A02,083766,Tran; Brian Kha,0,1,30,30
1656068117809,MATH 20D,A03,083767,Tran; Brian Kha,2,0,30,28
1656068123846,MATH 20E,A01,083771,Ganguly; Soumya,4,1,32,28
1656068123846,MATH 20E,A02,083772,Ganguly; Soumya,2,1,32,30
1656068123846,MATH 20E,B01,083773,Ciotti; Benjamin,15,0,35,20
1656068123846,MATH 20E,B02,083774,Ciotti; Benjamin,15,0,35,20
1656068129875,MATH 103A,A01,083777,Greenfeld; Be'Eri,3,0,36,33
1656068129875,MATH 103A,A02,083778,Greenfeld; Be'Eri,3,0,36,33
1656068129875,MATH 103A,A03,093561,Staff,4,1,36,32
1656068129875,MATH 103A,B01,083779,Greenfeld; Be'Eri,8,1,36,28
1656068129875,MATH 103A,B02,083780,Greenfeld; Be'Eri,1,0,36,35
1656068129875,MATH 103A,B03,093562,Staff,1,0,36,35
1656068135906,MATH 105,A01,085443,Carter; Anne Toulson,4,1,35,31
1656068135906,MATH 105,A02,093477,Staff,12,0,35,23
1656068141932,MATH 109,A01,083213,Ganzberger; Geoffrey Michael,1,1,34,33
1656068141932,MATH 109,A02,083214,Ganzberger; Geoffrey Michael,0,0,34,34
1656068141932,MATH 109,A03,093478,Staff,3,0,34,31
1656068141932,MATH 109,B01,083215,Ganzberger; Geoffrey Michael,4,0,32,28
1656068141932,MATH 109,B02,083216,Ganzberger; Geoffrey Michael,1,0,32,31
1656068141932,MATH 109,B03,093479,Staff,4,0,32,28
1656068147979,MATH 142A,A01,083219,Chow; Bennett,2,0,32,30
1656068147979,MATH 142A,A02,083220,Chow; Bennett,8,0,32,24
1656068147979,MATH 142A,A03,093480,Staff,5,0,32,27
1656068147979,MATH 142A,B03,093481,Staff,5,0,32,27
1656068147979,MATH 142A,B04,093558,Staff,7,0,32,25
1656068147979,MATH 142A,B05,093559,Staff,0,0,32,32
1656068154030,MATH 193A,A01,083224,Rotar; Vladimir,1,2,34,33
1656068154030,MATH 193A,A02,083225,Rotar; Vladimir,3,0,34,31
1656068154030,MATH 193A,A03,083781,Rotar; Vladimir,3,0,34,31
1656068154030,MATH 193A,A04,083782,Rotar; Vladimir,7,0,34,27
1656068154030,MATH 193A,A05,093482,Rotar; Vladimir,1,0,34,33
1656068160069,MATH 197,001,091859,McAuley; Julian John,9999,0,9999,0
1656068160069,MATH 197,002,095566,Kedlaya; Kiran S.,9997,0,9999,2
1656068160069,MATH 197,003,095567,Xiao; Ming,9999,0,9999,0
1656068160069,MATH 197,004,095571,Perols; Johan Lars,9998,0,9999,1
1656068167175,COGS 9,A01,083615,Shannon; Kyle Michael,4,1,75,71
1656068173225,COGS 11,A01,083617,Boyle; Mary E. T.,16,1,48,32
1656068179252,COGS 13,A01,083071,Bastos; Amalia Pinkusfeld,8,2,71,63
1656068185309,COGS 14A,A01,092681,Semenuks; Arturs,8,23,100,92
1656068191334,COGS 14B,A01,083073,Cheng; Tzu-Han,9,0,63,54
1656068197381,COGS 17,A01,092677,Semenuks; Arturs,13,6,81,68
1656068203405,COGS 100,A01,083619,Allen; Michael Gordon,8,1,70,62
1656068209438,COGS 101A,A01,083621,Davis; Joshua Daniel,7,3,68,61
1656068215469,COGS 101B,A01,091572,Allen; Michael Gordon,7,0,65,58
1656068221499,COGS 101C,A01,083625,Delgado; Tania,11,0,35,24
1656068227525,COGS 107A,A01,083627,Boyle; Mary E. T.,5,2,60,55
1656068233548,COGS 118A,A01,083075,Gupta; Anjum,24,16,76,52
1656068239575,CSE 3,A50,083646,Miranda; Gregory Joseph,20,0,50,30
1656068245611,CSE 8A,A50,083650,Miranda; Gregory Joseph,13,11,56,43
1656068251646,CSE 11,A01,083080,Cao; Yingjun,1,60,40,39
1656068257677,CSE 12,A01,083652,Krause-Levy; Sophia Louisa,14,7,120,106
1656068263721,CSE 15L,A01,083654,Morris; Justin Loren,5,1,50,45
1656068263721,CSE 15L,A02,083655,Morris; Justin Loren,7,0,50,43
1656068269746,CSE 20,A01,083657,Tran; Khoa Dang,31,0,80,49
1656068275781,CSE 21,A01,095574,Bach; Quang Tran,28,0,48,20
1656068281831,CSE 30,A01,083084,Eldon; John,3,10,80,77
1656068281831,CSE 30,B01,095061,Bhaskar; Nishant,4,5,50,46
1656068287877,CSE 100,A01,083659,Cao; Yingjun,2,23,70,68
1656068293922,CSE 134B,A01,083661,Powell; Thomas Allan,11,6,100,89
1656068299961,CSE 140,A01,083663,Gungor; Onat,9,0,85,76
1656068305995,CSE 140L,A01,083088,Eldon; John,8,0,100,92
1656068312035,CSE 175,A01,083665,Kumar; Rakesh,2,0,25,23
1656068318069,CSE 190,A00,092507,Dubnov; Shlomo,3,0,20,17
1656068324105,ECE 45,A01,083139,Congero; Spencer William,5,2,75,70
1656068330131,ECE 65,A50,083695,Saad; Andrew S,8,0,30,22
1656068330131,ECE 65,A51,095125,Staff,23,0,26,3
1656068336171,ECE 109,A01,091882,Touri; Behrouz,5,4,70,65
1656068342207,ECE 180,A00,083140,Abi Samra; Nicholas Camill,1,0,30,29
1656068342207,ECE 180,B00,083141,Abi Samra; Nicholas Camill,2,8,28,26
1656068348232,MATH 10A,A01,083735,Patchell; Gregory David,1,0,30,29
1656068348232,MATH 10A,A02,083736,Patchell; Gregory David,23,0,30,7
1656068348232,MATH 10A,A03,083737,Patchell; Gregory David,16,0,30,14
1656068354264,MATH 10B,A01,083207,Lim; Seonhee,3,1,34,31
1656068354264,MATH 10B,A02,083208,Lim; Seonhee,10,1,35,25
1656068354264,MATH 10B,A03,093472,Staff,4,1,34,30
1656068354264,MATH 10B,B01,083739,Sinha; Shubham,12,0,30,18
1656068360307,MATH 18,A01,083743,Cinel; Cameron Alexander,7,0,30,23
1656068360307,MATH 18,A02,083744,Cinel; Cameron Alexander,12,0,30,18
1656068360307,MATH 18,A03,083745,Cinel; Cameron Alexander,3,0,30,27
1656068360307,MATH 18,B01,083748,Ma; Zilu,1,0,36,35
1656068360307,MATH 18,B02,083749,Ma; Zilu,2,0,36,34
1656068360307,MATH 18,B03,083750,Ma; Zilu,0,0,36,36
1656068360307,MATH 18,B04,083751,Ma; Zilu,1,0,36,35
1656068360307,MATH 18,B05,093473,Staff,3,0,36,33
1656068360307,MATH 18,B06,093474,Staff,4,0,36,32
1656068366344,MATH 20A,A01,083754,Zheng; Zequn,11,0,40,29
1656068372376,MATH 20B,A01,083756,Briones; Jor-el Thomas Caparas,0,0,36,36
1656068372376,MATH 20B,A02,083757,Briones; Jor-el Thomas Caparas,3,0,36,33
1656068372376,MATH 20B,A03,093475,Staff,3,0,36,33
1656068378418,MATH 20C,A01,083760,Briones; Jor-el Thomas Caparas,2,2,35,33
1656068378418,MATH 20C,A02,083761,Briones; Jor-el Thomas Caparas,9,1,35,26
1656068378418,MATH 20C,A03,093476,Staff,1,1,35,34
1656068378418,MATH 20C,B01,083762,Bach; Quang Tran,5,0,30,25
1656068384445,MATH 20D,A01,083765,Tran; Brian Kha,3,0,30,27
1656068384445,MATH 20D,A02,083766,Tran; Brian Kha,0,1,30,30
1656068384445,MATH 20D,A03,083767,Tran; Brian Kha,2,0,30,28
1656068390472,MATH 20E,A01,083771,Ganguly; Soumya,4,1,32,28
1656068390472,MATH 20E,A02,083772,Ganguly; Soumya,2,1,32,30
1656068390472,MATH 20E,B01,083773,Ciotti; Benjamin,15,0,35,20
1656068390472,MATH 20E,B02,083774,Ciotti; Benjamin,15,0,35,20
1656068396506,MATH 103A,A01,083777,Greenfeld; Be'Eri,3,0,36,33
1656068396506,MATH 103A,A02,083778,Greenfeld; Be'Eri,3,0,36,33
1656068396506,MATH 103A,A03,093561,Staff,4,1,36,32
1656068396506,MATH 103A,B01,083779,Greenfeld; Be'Eri,8,1,36,28
1656068396506,MATH 103A,B02,083780,Greenfeld; Be'Eri,1,0,36,35
1656068396506,MATH 103A,B03,093562,Staff,1,0,36,35
1656068402541,MATH 105,A01,085443,Carter; Anne Toulson,4,1,35,31
1656068402541,MATH 105,A02,093477,Staff,12,0,35,23
1656068408595,MATH 109,A01,083213,Ganzberger; Geoffrey Michael,1,1,34,33
1656068408595,MATH 109,A02,083214,Ganzberger; Geoffrey Michael,0,0,34,34
1656068408595,MATH 109,A03,093478,Staff,3,0,34,31
1656068408595,MATH 109,B01,083215,Ganzberger; Geoffrey Michael,4,0,32,28
1656068408595,MATH 109,B02,083216,Ganzberger; Geoffrey Michael,1,0,32,31
1656068408595,MATH 109,B03,093479,Staff,4,0,32,28
1656068414641,MATH 142A,A01,083219,Chow; Bennett,2,0,32,30
1656068414641,MATH 142A,A02,083220,Chow; Bennett,8,0,32,24
1656068414641,MATH 142A,A03,093480,Staff,5,0,32,27
1656068414641,MATH 142A,B03,093481,Staff,5,0,32,27
1656068414641,MATH 142A,B04,093558,Staff,7,0,32,25
1656068414641,MATH 142A,B05,093559,Staff,0,0,32,32
1656068420673,MATH 193A,A01,083224,Rotar; Vladimir,1,2,34,33
1656068420673,MATH 193A,A02,083225,Rotar; Vladimir,3,0,34,31
1656068420673,MATH 193A,A03,083781,Rotar; Vladimir,3,0,34,31
1656068420673,MATH 193A,A04,083782,Rotar; Vladimir,7,0,34,27
1656068420673,MATH 193A,A05,093482,Rotar; Vladimir,1,0,34,33
1656068426697,MATH 197,001,091859,McAuley; Julian John,9999,0,9999,0
1656068426697,MATH 197,002,095566,Kedlaya; Kiran S.,9997,0,9999,2
1656068426697,MATH 197,003,095567,Xiao; Ming,9999,0,9999,0
1656068426697,MATH 197,004,095571,Perols; Johan Lars,9998,0,9999,1
1656068433783,COGS 9,A01,083615,Shannon; Kyle Michael,4,1,75,71
1656068439813,COGS 11,A01,083617,Boyle; Mary E. T.,16,1,48,32
1656068445836,COGS 13,A01,083071,Bastos; Amalia Pinkusfeld,8,2,71,63
1656068451866,COGS 14A,A01,092681,Semenuks; Arturs,8,23,100,92
1656068457925,COGS 14B,A01,083073,Cheng; Tzu-Han,9,0,63,54
1656068463949,COGS 17,A01,092677,Semenuks; Arturs,13,6,81,68
1656068469997,COGS 100,A01,083619,Allen; Michael Gordon,8,1,70,62
1656068476027,COGS 101A,A01,083621,Davis; Joshua Daniel,7,3,68,61
1656068482068,COGS 101B,A01,091572,Allen; Michael Gordon,7,0,65,58
1656068488123,COGS 101C,A01,083625,Delgado; Tania,11,0,35,24
1656068494147,COGS 107A,A01,083627,Boyle; Mary E. T.,5,2,60,55
1656068500171,COGS 118A,A01,083075,Gupta; Anjum,24,16,76,52
1656068506228,CSE 3,A50,083646,Miranda; Gregory Joseph,20,0,50,30
1656068512252,CSE 8A,A50,083650,Miranda; Gregory Joseph,13,11,56,43
1656068518284,CSE 11,A01,083080,Cao; Yingjun,1,60,40,39
1656068524313,CSE 12,A01,083652,Krause-Levy; Sophia Louisa,14,7,120,106
1656068530340,CSE 15L,A01,083654,Morris; Justin Loren,5,1,50,45
1656068530340,CSE 15L,A02,083655,Morris; Justin Loren,7,0,50,43
1656068536369,CSE 20,A01,083657,Tran; Khoa Dang,31,0,80,49
1656068542408,CSE 21,A01,095574,Bach; Quang Tran,28,0,48,20
1656068548431,CSE 30,A01,083084,Eldon; John,3,10,80,77
1656068548431,CSE 30,B01,095061,Bhaskar; Nishant,4,5,50,46
1656068554476,CSE 100,A01,083659,Cao; Yingjun,2,23,70,68
1656068560505,CSE 134B,A01,083661,Powell; Thomas Allan,11,6,100,89
1656068566531,CSE 140,A01,083663,Gungor; Onat,9,0,85,76
1656068572559,CSE 140L,A01,083088,Eldon; John,8,0,100,92
1656068578600,CSE 175,A01,083665,Kumar; Rakesh,2,0,25,23
1656068584623,CSE 190,A00,092507,Dubnov; Shlomo,3,0,20,17
1656068590662,ECE 45,A01,083139,Congero; Spencer William,5,2,75,70
1656068596686,ECE 65,A50,083695,Saad; Andrew S,8,0,30,22
1656068596686,ECE 65,A51,095125,Staff,23,0,26,3
1656068602810,ECE 109,A01,091882,Touri; Behrouz,5,4,70,65
1656068608850,ECE 180,A00,083140,Abi Samra; Nicholas Camill,1,0,30,29
1656068608850,ECE 180,B00,083141,Abi Samra; Nicholas Camill,2,8,28,26
1656068614885,MATH 10A,A01,083735,Patchell; Gregory David,1,0,30,29
1656068614885,MATH 10A,A02,083736,Patchell; Gregory David,23,0,30,7
1656068614885,MATH 10A,A03,083737,Patchell; Gregory David,16,0,30,14
1656068620929,MATH 10B,A01,083207,Lim; Seonhee,3,1,34,31
1656068620929,MATH 10B,A02,083208,Lim; Seonhee,10,1,35,25
1656068620929,MATH 10B,A03,093472,Staff,4,1,34,30
1656068620929,MATH 10B,B01,083739,Sinha; Shubham,12,0,30,18
1656068626972,MATH 18,A01,083743,Cinel; Cameron Alexander,7,0,30,23
1656068626972,MATH 18,A02,083744,Cinel; Cameron Alexander,12,0,30,18
1656068626972,MATH 18,A03,083745,Cinel; Cameron Alexander,3,0,30,27
1656068626972,MATH 18,B01,083748,Ma; Zilu,1,0,36,35
1656068626972,MATH 18,B02,083749,Ma; Zilu,2,0,36,34
1656068626972,MATH 18,B03,083750,Ma; Zilu,0,0,36,36
1656068626972,MATH 18,B04,083751,Ma; Zilu,1,0,36,35
1656068626972,MATH 18,B05,093473,Staff,3,0,36,33
1656068626972,MATH 18,B06,093474,Staff,4,0,36,32
1656068632997,MATH 20A,A01,083754,Zheng; Zequn,11,0,40,29
1656068639035,MATH 20B,A01,083756,Briones; Jor-el Thomas Caparas,0,0,36,36
1656068639035,MATH 20B,A02,083757,Briones; Jor-el Thomas Caparas,3,0,36,33
1656068639035,MATH 20B,A03,093475,Staff,3,0,36,33
1656068645066,MATH 20C,A01,083760,Briones; Jor-el Thomas Caparas,2,2,35,33
1656068645066,MATH 20C,A02,083761,Briones; Jor-el Thomas Caparas,9,1,35,26
1656068645066,MATH 20C,A03,093476,Staff,1,1,35,34
1656068645066,MATH 20C,B01,083762,Bach; Quang Tran,5,0,30,25
1656068651112,MATH 20D,A01,083765,Tran; Brian Kha,3,0,30,27
1656068651112,MATH 20D,A02,083766,Tran; Brian Kha,0,1,30,30
1656068651112,MATH 20D,A03,083767,Tran; Brian Kha,2,0,30,28
1656068657168,MATH 20E,A01,083771,Ganguly; Soumya,4,1,32,28
1656068657168,MATH 20E,A02,083772,Ganguly; Soumya,2,1,32,30
1656068657168,MATH 20E,B01,083773,Ciotti; Benjamin,15,0,35,20
1656068657168,MATH 20E,B02,083774,Ciotti; Benjamin,15,0,35,20
1656068663211,MATH 103A,A01,083777,Greenfeld; Be'Eri,3,0,36,33
1656068663211,MATH 103A,A02,083778,Greenfeld; Be'Eri,3,0,36,33
1656068663211,MATH 103A,A03,093561,Staff,4,1,36,32
1656068663211,MATH 103A,B01,083779,Greenfeld; Be'Eri,8,1,36,28
1656068663211,MATH 103A,B02,083780,Greenfeld; Be'Eri,1,0,36,35
1656068663211,MATH 103A,B03,093562,Staff,1,0,36,35
1656068669252,MATH 105,A01,085443,Carter; Anne Toulson,4,1,35,31
1656068669252,MATH 105,A02,093477,Staff,12,0,35,23
1656068675276,MATH 109,A01,083213,Ganzberger; Geoffrey Michael,1,1,34,33
1656068675276,MATH 109,A02,083214,Ganzberger; Geoffrey Michael,0,0,34,34
1656068675276,MATH 109,A03,093478,Staff,3,0,34,31
1656068675276,MATH 109,B01,083215,Ganzberger; Geoffrey Michael,4,0,32,28
1656068675276,MATH 109,B02,083216,Ganzberger; Geoffrey Michael,1,0,32,31
1656068675276,MATH 109,B03,093479,Staff,4,0,32,28
1656068681317,MATH 142A,A01,083219,Chow; Bennett,2,0,32,30
1656068681317,MATH 142A,A02,083220,Chow; Bennett,8,0,32,24
1656068681317,MATH 142A,A03,093480,Staff,5,0,32,27
1656068681317,MATH 142A,B03,093481,Staff,5,0,32,27
1656068681317,MATH 142A,B04,093558,Staff,7,0,32,25
1656068681317,MATH 142A,B05,093559,Staff,0,0,32,32
1656068687360,MATH 193A,A01,083224,Rotar; Vladimir,1,2,34,33
1656068687360,MATH 193A,A02,083225,Rotar; Vladimir,3,0,34,31
1656068687360,MATH 193A,A03,083781,Rotar; Vladimir,3,0,34,31
1656068687360,MATH 193A,A04,083782,Rotar; Vladimir,7,0,34,27
1656068687360,MATH 193A,A05,093482,Rotar; Vladimir,1,0,34,33
1656068693389,MATH 197,001,091859,McAuley; Julian John,9999,0,9999,0
1656068693389,MATH 197,002,095566,Kedlaya; Kiran S.,9997,0,9999,2
1656068693389,MATH 197,003,095567,Xiao; Ming,9999,0,9999,0
1656068693389,MATH 197,004,095571,Perols; Johan Lars,9998,0,9999,1
1656068700488,COGS 9,A01,083615,Shannon; Kyle Michael,4,1,75,71
1656068706515,COGS 11,A01,083617,Boyle; Mary E. T.,16,1,48,32
1656068712541,COGS 13,A01,083071,Bastos; Amalia Pinkusfeld,8,2,71,63
1656068718603,COGS 14A,A01,092681,Semenuks; Arturs,8,23,100,92
1656068724633,COGS 14B,A01,083073,Cheng; Tzu-Han,9,0,63,54
1656068730681,COGS 17,A01,092677,Semenuks; Arturs,13,6,81,68
1656068736711,COGS 100,A01,083619,Allen; Michael Gordon,8,1,70,62
1656068742737,COGS 101A,A01,083621,Davis; Joshua Daniel,7,3,68,61
1656068748765,COGS 101B,A01,091572,Allen; Michael Gordon,7,0,65,58
1656068754805,COGS 101C,A01,083625,Delgado; Tania,11,0,35,24
1656068760829,COGS 107A,A01,083627,Boyle; Mary E. T.,5,2,60,55
1656068766884,COGS 118A,A01,083075,Gupta; Anjum,24,16,76,52
1656068772931,CSE 3,A50,083646,Miranda; Gregory Joseph,20,0,50,30
1656068778956,CSE 8A,A50,083650,Miranda; Gregory Joseph,13,11,56,43
1656068784988,CSE 11,A01,083080,Cao; Yingjun,1,60,40,39
1656068791044,CSE 12,A01,083652,Krause-Levy; Sophia Louisa,14,7,120,106
1656068797075,CSE 15L,A01,083654,Morris; Justin Loren,5,1,50,45
1656068797075,CSE 15L,A02,083655,Morris; Justin Loren,7,0,50,43
1656068803102,CSE 20,A01,083657,Tran; Khoa Dang,31,0,80,49
1656068809131,CSE 21,A01,095574,Bach; Quang Tran,28,0,48,20
1656068815174,CSE 30,A01,083084,Eldon; John,3,10,80,77
1656068815174,CSE 30,B01,095061,Bhaskar; Nishant,4,5,50,46
1656068821198,CSE 100,A01,083659,Cao; Yingjun,2,23,70,68
1656068827238,CSE 134B,A01,083661,Powell; Thomas Allan,11,6,100,89
1656068833261,CSE 140,A01,083663,Gungor; Onat,9,0,85,76
1656068839301,CSE 140L,A01,083088,Eldon; John,8,0,100,92
1656068845360,CSE 175,A01,083665,Kumar; Rakesh,2,0,25,23
1656068851399,CSE 190,A00,092507,Dubnov; Shlomo,3,0,20,17
1656068857425,ECE 45,A01,083139,Congero; Spencer William,5,2,75,70
1656068863474,ECE 65,A50,083695,Saad; Andrew S,8,0,30,22
1656068863474,ECE 65,A51,095125,Staff,23,0,26,3
1656068869501,ECE 109,A01,091882,Touri; Behrouz,5,4,70,65
1656068875550,ECE 180,A00,083140,Abi Samra; Nicholas Camill,1,0,30,29
1656068875550,ECE 180,B00,083141,Abi Samra; Nicholas Camill,2,8,28,26
1656068881583,MATH 10A,A01,083735,Patchell; Gregory David,1,0,30,29
1656068881583,MATH 10A,A02,083736,Patchell; Gregory David,23,0,30,7
1656068881583,MATH 10A,A03,083737,Patchell; Gregory David,16,0,30,14
1656068887612,MATH 10B,A01,083207,Lim; Seonhee,3,1,34,31
1656068887612,MATH 10B,A02,083208,Lim; Seonhee,10,1,35,25
1656068887612,MATH 10B,A03,093472,Staff,4,1,34,30
1656068887612,MATH 10B,B01,083739,Sinha; Shubham,12,0,30,18
1656068893642,MATH 18,A01,083743,Cinel; Cameron Alexander,7,0,30,23
1656068893642,MATH 18,A02,083744,Cinel; Cameron Alexander,12,0,30,18
1656068893642,MATH 18,A03,083745,Cinel; Cameron Alexander,3,0,30,27
1656068893642,MATH 18,B01,083748,Ma; Zilu,1,0,36,35
1656068893642,MATH 18,B02,083749,Ma; Zilu,2,0,36,34
1656068893642,MATH 18,B03,083750,Ma; Zilu,0,0,36,36
1656068893642,MATH 18,B04,083751,Ma; Zilu,1,0,36,35
1656068893642,MATH 18,B05,093473,Staff,3,0,36,33
1656068893642,MATH 18,B06,093474,Staff,4,0,36,32
1656068899665,MATH 20A,A01,083754,Zheng; Zequn,11,0,40,29
1656068905701,MATH 20B,A01,083756,Briones; Jor-el Thomas Caparas,0,0,36,36
1656068905701,MATH 20B,A02,083757,Briones; Jor-el Thomas Caparas,3,0,36,33
1656068905701,MATH 20B,A03,093475,Staff,3,0,36,33
1656068911732,MATH 20C,A01,083760,Briones; Jor-el Thomas Caparas,2,2,35,33
1656068911732,MATH 20C,A02,083761,Briones; Jor-el Thomas Caparas,9,1,35,26
1656068911732,MATH 20C,A03,093476,Staff,1,1,35,34
1656068911732,MATH 20C,B01,083762,Bach; Quang Tran,5,0,30,25
1656068917761,MATH 20D,A01,083765,Tran; Brian Kha,3,0,30,27
1656068917761,MATH 20D,A02,083766,Tran; Brian Kha,0,1,30,30
1656068917761,MATH 20D,A03,083767,Tran; Brian Kha,2,0,30,28
1656068923813,MATH 20E,A01,083771,Ganguly; Soumya,4,1,32,28
1656068923813,MATH 20E,A02,083772,Ganguly; Soumya,2,1,32,30
1656068923813,MATH 20E,B01,083773,Ciotti; Benjamin,15,0,35,20
1656068923813,MATH 20E,B02,083774,Ciotti; Benjamin,15,0,35,20
1656068929847,MATH 103A,A01,083777,Greenfeld; Be'Eri,3,0,36,33
1656068929847,MATH 103A,A02,083778,Greenfeld; Be'Eri,3,0,36,33
1656068929847,MATH 103A,A03,093561,Staff,4,1,36,32
1656068929847,MATH 103A,B01,083779,Greenfeld; Be'Eri,8,1,36,28
1656068929847,MATH 103A,B02,083780,Greenfeld; Be'Eri,1,0,36,35
1656068929847,MATH 103A,B03,093562,Staff,1,0,36,35
1656068935874,MATH 105,A01,085443,Carter; Anne Toulson,4,1,35,31
1656068935874,MATH 105,A02,093477,Staff,12,0,35,23
1656068941914,MATH 109,A01,083213,Ganzberger; Geoffrey Michael,1,1,34,33
1656068941914,MATH 109,A02,083214,Ganzberger; Geoffrey Michael,0,0,34,34
1656068941914,MATH 109,A03,093478,Staff,3,0,34,31
1656068941914,MATH 109,B01,083215,Ganzberger; Geoffrey Michael,4,0,32,28
1656068941914,MATH 109,B02,083216,Ganzberger; Geoffrey Michael,1,0,32,31
1656068941914,MATH 109,B03,093479,Staff,4,0,32,28
1656068947969,MATH 142A,A01,083219,Chow; Bennett,2,0,32,30
1656068947969,MATH 142A,A02,083220,Chow; Bennett,8,0,32,24
1656068947969,MATH 142A,A03,093480,Staff,5,0,32,27
1656068947969,MATH 142A,B03,093481,Staff,5,0,32,27
1656068947969,MATH 142A,B04,093558,Staff,7,0,32,25
1656068947969,MATH 142A,B05,093559,Staff,0,0,32,32
1656068953994,MATH 193A,A01,083224,Rotar; Vladimir,1,2,34,33
1656068953994,MATH 193A,A02,083225,Rotar; Vladimir,3,0,34,31
1656068953994,MATH 193A,A03,083781,Rotar; Vladimir,3,0,34,31
1656068953994,MATH 193A,A04,083782,Rotar; Vladimir,7,0,34,27
1656068953994,MATH 193A,A05,093482,Rotar; Vladimir,1,0,34,33
1656068960019,MATH 197,001,091859,McAuley; Julian John,9999,0,9999,0
1656068960019,MATH 197,002,095566,Kedlaya; Kiran S.,9997,0,9999,2
1656068960019,MATH 197,003,095567,Xiao; Ming,9999,0,9999,0
1656068960019,MATH 197,004,095571,Perols; Johan Lars,9998,0,9999,1
1656068967080,COGS 9,A01,083615,Shannon; Kyle Michael,4,1,75,71
1656068973124,COGS 11,A01,083617,Boyle; Mary E. T.,16,1,48,32
1656068979158,COGS 13,A01,083071,Bastos; Amalia Pinkusfeld,8,2,71,63
1656068985195,COGS 14A,A01,092681,Semenuks; Arturs,8,23,100,92
1656068991220,COGS 14B,A01,083073,Cheng; Tzu-Han,9,0,63,54
1656068997248,COGS 17,A01,092677,Semenuks; Arturs,13,6,81,68
1656069003274,COGS 100,A01,083619,Allen; Michael Gordon,8,1,70,62
1656069009306,COGS 101A,A01,083621,Davis; Joshua Daniel,7,3,68,61
1656069015356,COGS 101B,A01,091572,Allen; Michael Gordon,7,0,65,58
1656069021380,COGS 101C,A01,083625,Delgado; Tania,11,0,35,24
1656069027412,COGS 107A,A01,083627,Boyle; Mary E. T.,5,2,60,55
1656069033449,COGS 118A,A01,083075,Gupta; Anjum,24,16,76,52
1656069039474,CSE 3,A50,083646,Miranda; Gregory Joseph,20,0,50,30
1656069045505,CSE 8A,A50,083650,Miranda; Gregory Joseph,13,11,56,43
1656069051541,CSE 11,A01,083080,Cao; Yingjun,1,60,40,39
1656069057565,CSE 12,A01,083652,Krause-Levy; Sophia Louisa,14,7,120,106
1656069063601,CSE 15L,A01,083654,Morris; Justin Loren,5,1,50,45
1656069063601,CSE 15L,A02,083655,Morris; Justin Loren,7,0,50,43
1656069069626,CSE 20,A01,083657,Tran; Khoa Dang,31,0,80,49
1656069075658,CSE 21,A01,095574,Bach; Quang Tran,28,0,48,20
1656069081697,CSE 30,A01,083084,Eldon; John,3,10,80,77
1656069081697,CSE 30,B01,095061,Bhaskar; Nishant,4,5,50,46
1656069087726,CSE 100,A01,083659,Cao; Yingjun,2,23,70,68
1656069093757,CSE 134B,A01,083661,Powell; Thomas Allan,11,6,100,89
1656069099788,CSE 140,A01,083663,Gungor; Onat,9,0,85,76
1656069105839,CSE 140L,A01,083088,Eldon; John,8,0,100,92
1656069111884,CSE 175,A01,083665,Kumar; Rakesh,2,0,25,23
1656069117915,CSE 190,A00,092507,Dubnov; Shlomo,3,0,20,17
1656069123940,ECE 45,A01,083139,Congero; Spencer William,5,2,75,70
1656069129967,ECE 65,A50,083695,Saad; Andrew S,8,0,30,22
1656069129967,ECE 65,A51,095125,Staff,23,0,26,3
1656069135995,ECE 109,A01,091882,Touri; Behrouz,5,4,70,65
1656069142022,ECE 180,A00,083140,Abi Samra; Nicholas Camill,1,0,30,29
1656069142022,ECE 180,B00,083141,Abi Samra; Nicholas Camill,2,8,28,26
1656069148069,MATH 10A,A01,083735,Patchell; Gregory David,1,0,30,29
1656069148069,MATH 10A,A02,083736,Patchell; Gregory David,23,0,30,7
1656069148069,MATH 10A,A03,083737,Patchell; Gregory David,16,0,30,14
1656069154106,MATH 10B,A01,083207,Lim; Seonhee,3,1,34,31
1656069154106,MATH 10B,A02,083208,Lim; Seonhee,10,1,35,25
1656069154106,MATH 10B,A03,093472,Staff,4,1,34,30
1656069154106,MATH 10B,B01,083739,Sinha; Shubham,12,0,30,18
1656069160207,MATH 18,A01,083743,Cinel; Cameron Alexander,7,0,30,23
1656069160207,MATH 18,A02,083744,Cinel; Cameron Alexander,12,0,30,18
1656069160207,MATH 18,A03,083745,Cinel; Cameron Alexander,3,0,30,27
1656069160207,MATH 18,B01,083748,Ma; Zilu,1,0,36,35
1656069160207,MATH 18,B02,083749,Ma; Zilu,2,0,36,34
1656069160207,MATH 18,B03,083750,Ma; Zilu,0,0,36,36
1656069160207,MATH 18,B04,083751,Ma; Zilu,1,0,36,35
1656069160207,MATH 18,B05,093473,Staff,3,0,36,33
1656069160207,MATH 18,B06,093474,Staff,4,0,36,32
1656069166242,MATH 20A,A01,083754,Zheng; Zequn,11,0,40,29
1656069172267,MATH 20B,A01,083756,Briones; Jor-el Thomas Caparas,0,0,36,36
1656069172267,MATH 20B,A02,083757,Briones; Jor-el Thomas Caparas,3,0,36,33
1656069172267,MATH 20B,A03,093475,Staff,3,0,36,33
1656069178294,MATH 20C,A01,083760,Briones; Jor-el Thomas Caparas,2,2,35,33
1656069178294,MATH 20C,A02,083761,Briones; Jor-el Thomas Caparas,9,1,35,26
1656069178294,MATH 20C,A03,093476,Staff,1,1,35,34
1656069178294,MATH 20C,B01,083762,Bach; Quang Tran,5,0,30,25
1656069184323,MATH 20D,A01,083765,Tran; Brian Kha,3,0,30,27
1656069184323,MATH 20D,A02,083766,Tran; Brian Kha,0,1,30,30
1656069184323,MATH 20D,A03,083767,Tran; Brian Kha,2,0,30,28
1656069190366,MATH 20E,A01,083771,Ganguly; Soumya,4,1,32,28
1656069190366,MATH 20E,A02,083772,Ganguly; Soumya,2,1,32,30
1656069190366,MATH 20E,B01,083773,Ciotti; Benjamin,15,0,35,20
1656069190366,MATH 20E,B02,083774,Ciotti; Benjamin,15,0,35,20
1656069196408,MATH 103A,A01,083777,Greenfeld; Be'Eri,3,0,36,33
1656069196408,MATH 103A,A02,083778,Greenfeld; Be'Eri,3,0,36,33
1656069196408,MATH 103A,A03,093561,Staff,4,1,36,32
1656069196408,MATH 103A,B01,083779,Greenfeld; Be'Eri,8,1,36,28
1656069196408,MATH 103A,B02,083780,Greenfeld; Be'Eri,1,0,36,35
1656069196408,MATH 103A,B03,093562,Staff,1,0,36,35
1656069202512,MATH 105,A01,085443,Carter; Anne Toulson,4,1,35,31
1656069202512,MATH 105,A02,093477,Staff,12,0,35,23
1656069208536,MATH 109,A01,083213,Ganzberger; Geoffrey Michael,1,1,34,33
1656069208536,MATH 109,A02,083214,Ganzberger; Geoffrey Michael,0,0,34,34
1656069208536,MATH 109,A03,093478,Staff,3,0,34,31
1656069208536,MATH 109,B01,083215,Ganzberger; Geoffrey Michael,4,0,32,28
1656069208536,MATH 109,B02,083216,Ganzberger; Geoffrey Michael,1,0,32,31
1656069208536,MATH 109,B03,093479,Staff,4,0,32,28
1656069214568,MATH 142A,A01,083219,Chow; Bennett,2,0,32,30
1656069214568,MATH 142A,A02,083220,Chow; Bennett,8,0,32,24
1656069214568,MATH 142A,A03,093480,Staff,5,0,32,27
1656069214568,MATH 142A,B03,093481,Staff,5,0,32,27
1656069214568,MATH 142A,B04,093558,Staff,7,0,32,25
1656069214568,MATH 142A,B05,093559,Staff,0,0,32,32
1656069220592,MATH 193A,A01,083224,Rotar; Vladimir,1,2,34,33
1656069220592,MATH 193A,A02,083225,Rotar; Vladimir,3,0,34,31
1656069220592,MATH 193A,A03,083781,Rotar; Vladimir,3,0,34,31
1656069220592,MATH 193A,A04,083782,Rotar; Vladimir,7,0,34,27
1656069220592,MATH 193A,A05,093482,Rotar; Vladimir,1,0,34,33
1656069226625,MATH 197,001,091859,McAuley; Julian John,9999,0,9999,0
1656069226625,MATH 197,002,095566,Kedlaya; Kiran S.,9997,0,9999,2
1656069226625,MATH 197,003,095567,Xiao; Ming,9999,0,9999,0
1656069226625,MATH 197,004,095571,Perols; Johan Lars,9998,0,9999,1
1656069233706,COGS 9,A01,083615,Shannon; Kyle Michael,4,1,75,71
1656069239732,COGS 11,A01,083617,Boyle; Mary E. T.,16,1,48,32
1656069245759,COGS 13,A01,083071,Bastos; Amalia Pinkusfeld,8,2,71,63
1656069251811,COGS 14A,A01,092681,Semenuks; Arturs,8,23,100,92
1656069257836,COGS 14B,A01,083073,Cheng; Tzu-Han,9,0,63,54
1656069263864,COGS 17,A01,092677,Semenuks; Arturs,13,6,81,68
1656069269889,COGS 100,A01,083619,Allen; Michael Gordon,8,1,70,62
1656069275913,COGS 101A,A01,083621,Davis; Joshua Daniel,7,3,68,61
1656069281958,COGS 101B,A01,091572,Allen; Michael Gordon,7,0,65,58
1656069287989,COGS 101C,A01,083625,Delgado; Tania,11,0,35,24
1656069294014,COGS 107A,A01,083627,Boyle; Mary E. T.,5,2,60,55
1656069300043,COGS 118A,A01,083075,Gupta; Anjum,24,16,76,52
1656069306090,CSE 3,A50,083646,Miranda; Gregory Joseph,20,0,50,30
1656069312129,CSE 8A,A50,083650,Miranda; Gregory Joseph,13,11,56,43
1656069318154,CSE 11,A01,083080,Cao; Yingjun,1,60,40,39
1656069324179,CSE 12,A01,083652,Krause-Levy; Sophia Louisa,14,7,120,106
1656069330204,CSE 15L,A01,083654,Morris; Justin Loren,5,1,50,45
1656069330204,CSE 15L,A02,083655,Morris; Justin Loren,7,0,50,43
1656069336244,CSE 20,A01,083657,Tran; Khoa Dang,31,0,80,49
1656069342274,CSE 21,A01,095574,Bach; Quang Tran,28,0,48,20
1656069348314,CSE 30,A01,083084,Eldon; John,3,10,80,77
1656069348314,CSE 30,B01,095061,Bhaskar; Nishant,4,5,50,46
1656069354363,CSE 100,A01,083659,Cao; Yingjun,2,23,70,68
1656069360390,CSE 134B,A01,083661,Powell; Thomas Allan,11,6,100,89
1656069366429,CSE 140,A01,083663,Gungor; Onat,9,0,85,76
1656069372473,CSE 140L,A01,083088,Eldon; John,8,0,100,92
1656069378529,CSE 175,A01,083665,Kumar; Rakesh,2,0,25,23
1656069384581,CSE 190,A00,092507,Dubnov; Shlomo,3,0,20,17
1656069390608,ECE 45,A01,083139,Congero; Spencer William,5,2,75,70
1656069396663,ECE 65,A50,083695,Saad; Andrew S,8,0,30,22
1656069396663,ECE 65,A51,095125,Staff,23,0,26,3
1656069402691,ECE 109,A01,091882,Touri; Behrouz,5,4,70,65
1656069408720,ECE 180,A00,083140,Abi Samra; Nicholas Camill,1,0,30,29
1656069408720,ECE 180,B00,083141,Abi Samra; Nicholas Camill,2,8,28,26
1656069424009,MATH 10A,A01,083735,Patchell; Gregory David,1,0,30,29
1656069424009,MATH 10A,A02,083736,Patchell; Gregory David,23,0,30,7
1656069424009,MATH 10A,A03,083737,Patchell; Gregory David,16,0,30,14
1656069430040,MATH 10B,A01,083207,Lim; Seonhee,3,1,34,31
1656069430040,MATH 10B,A02,083208,Lim; Seonhee,10,1,35,25
1656069430040,MATH 10B,A03,093472,Staff,4,1,34,30
1656069430040,MATH 10B,B01,083739,Sinha; Shubham,12,0,30,18
1656069448003,MATH 18,A01,083743,Cinel; Cameron Alexander,7,0,30,23
1656069448003,MATH 18,A02,083744,Cinel; Cameron Alexander,12,0,30,18
1656069448003,MATH 18,A03,083745,Cinel; Cameron Alexander,3,0,30,27
1656069448003,MATH 18,B01,083748,Ma; Zilu,1,0,36,35
1656069448003,MATH 18,B02,083749,Ma; Zilu,2,0,36,34
1656069448003,MATH 18,B03,083750,Ma; Zilu,0,0,36,36
1656069448003,MATH 18,B04,083751,Ma; Zilu,1,0,36,35
1656069448003,MATH 18,B05,093473,Staff,3,0,36,33
1656069448003,MATH 18,B06,093474,Staff,4,0,36,32
1656069454039,MATH 20A,A01,083754,Zheng; Zequn,11,0,40,29
1656069471588,MATH 20B,A01,083756,Briones; Jor-el Thomas Caparas,0,0,36,36
1656069471588,MATH 20B,A02,083757,Briones; Jor-el Thomas Caparas,3,0,36,33
1656069471588,MATH 20B,A03,093475,Staff,3,0,36,33
1656069477616,MATH 20C,A01,083760,Briones; Jor-el Thomas Caparas,2,2,35,33
1656069477616,MATH 20C,A02,083761,Briones; Jor-el Thomas Caparas,9,1,35,26
1656069477616,MATH 20C,A03,093476,Staff,1,1,35,34
1656069477616,MATH 20C,B01,083762,Bach; Quang Tran,5,0,30,25
1656069495420,MATH 20D,A01,083765,Tran; Brian Kha,3,0,30,27
1656069495420,MATH 20D,A02,083766,Tran; Brian Kha,0,1,30,30
1656069495420,MATH 20D,A03,083767,Tran; Brian Kha,2,0,30,28
